Name,Opponent,Games,Wins,Losses,WR
Ambessa,Yone,289,138,151,47.75
Ambessa,Viego,261,160,101,61.3
Ambessa,Yasuo,306,134,172,43.79
Ambessa,Ezreal,404,227,177,56.19
Ambessa,Lux,364,183,181,50.27
Ambessa,Vladimir,69,41,28,59.42
Ambessa,Kayn,199,99,100,49.75
Ambessa,Velkoz,57,23,34,40.35
Ambessa,Xayah,119,51,68,42.86
Ambessa,Leblanc,100,55,45,55
Ambessa,Galio,195,110,85,56.41
Ambessa,Hecarim,47,28,19,59.57
Ambessa,Shen,135,53,82,39.26
Ambessa,Kaisa,275,128,147,46.55
Ambessa,Nami,136,54,82,39.71
Ambessa,Akali,158,80,78,50.63
Ambessa,LeeSin,328,189,139,57.62
Ambessa,Hwei,101,51,50,50.5
Ambessa,Pyke,110,72,38,65.45
Ambessa,Gnar,60,47,13,78.33
Ambessa,Mel,356,193,163,54.21
Ambessa,Twitch,93,44,49,47.31
Ambessa,Pantheon,282,125,157,44.33
Ambessa,Alistar,73,48,25,65.75
Ambessa,Nocturne,171,82,89,47.95
Ambessa,Urgot,50,25,25,50
Ambessa,Samira,120,64,56,53.33
Ambessa,Shaco,106,51,55,48.11
Ambessa,AurelionSol,66,38,28,57.58
Ambessa,Caitlyn,341,175,166,51.32
Ambessa,Brand,94,48,46,51.06
Ambessa,Warwick,192,99,93,51.56
Ambessa,Ornn,112,56,56,50
Ambessa,Katarina,107,63,44,58.88
Ambessa,Tristana,105,69,36,65.71
Ambessa,Renekton,168,64,104,38.1
Ambessa,JarvanIV,132,75,57,56.82
Ambessa,Seraphine,136,82,54,60.29
Ambessa,Jhin,268,172,96,64.18
Ambessa,Janna,63,29,34,46.03
Ambessa,Vayne,182,71,111,39.01
Ambessa,Ahri,218,103,115,47.25
Ambessa,Yuumi,103,68,35,66.02
Ambessa,Irelia,110,47,63,42.73
Ambessa,Lillia,86,39,47,45.35
Ambessa,Volibear,155,65,90,41.94
Ambessa,Jax,157,90,67,57.32
Ambessa,Ashe,309,145,164,46.93
Ambessa,Camille,110,52,58,47.27
Ambessa,Varus,167,103,64,61.68
Ambessa,Malzahar,150,77,73,51.33
Ambessa,Jayce,96,51,45,53.13
Ambessa,Sion,136,56,80,41.18
Ambessa,Amumu,170,69,101,40.59
Ambessa,Gwen,60,35,25,58.33
Ambessa,Diana,249,121,128,48.59
Ambessa,Lucian,128,75,53,58.59
Ambessa,Kennen,44,15,29,34.09
Ambessa,Zyra,107,55,52,51.4
Ambessa,Briar,59,26,33,44.07
Ambessa,TwistedFate,71,34,37,47.89
Ambessa,Sivir,93,46,47,49.46
Ambessa,Mordekaiser,153,65,88,42.48
Ambessa,Nautilus,250,114,136,45.6
Ambessa,Nunu,114,59,55,51.75
Ambessa,Lulu,213,110,103,51.64
Ambessa,Belveth,34,17,17,50
Ambessa,MissFortune,288,159,129,55.21
Ambessa,Leona,170,96,74,56.47
Ambessa,Thresh,241,138,103,57.26
Ambessa,Trundle,91,53,38,58.24
Ambessa,Smolder,131,54,77,41.22
Ambessa,Khazix,72,39,33,54.17
Ambessa,Zed,153,75,78,49.02
Ambessa,Jinx,384,181,203,47.14
Ambessa,Sona,47,18,29,38.3
Ambessa,Yorick,113,56,57,49.56
Ambessa,Elise,154,74,80,48.05
Ambessa,Veigar,127,61,66,48.03
Ambessa,Poppy,161,71,90,44.1
Ambessa,Swain,117,48,69,41.03
Ambessa,Ekko,139,81,58,58.27
Ambessa,TahmKench,136,71,65,52.21
Ambessa,Heimerdinger,47,19,28,40.43
Ambessa,Syndra,111,46,65,41.44
Ambessa,Karma,210,117,93,55.71
Ambessa,Darius,244,115,129,47.13
Ambessa,FiddleSticks,52,12,40,23.08
Ambessa,Chogath,169,77,92,45.56
Ambessa,MonkeyKing,107,39,68,36.45
Ambessa,Teemo,134,78,56,58.21
Ambessa,Malphite,169,76,93,44.97
Ambessa,Udyr,66,44,22,66.67
Ambessa,Aurora,140,74,66,52.86
Ambessa,Aphelios,69,25,44,36.23
Ambessa,Morgana,103,54,49,52.43
Ambessa,Zac,116,52,64,44.83
Ambessa,Aatrox,175,106,69,60.57
Ambessa,Viktor,145,76,69,52.41
Ambessa,Braum,135,67,68,49.63
Ambessa,Akshan,56,27,29,48.21
Ambessa,Gragas,111,67,44,60.36
Ambessa,Blitzcrank,161,64,97,39.75
Ambessa,Sett,259,133,126,51.35
Ambessa,Maokai,71,40,31,56.34
Ambessa,Nasus,72,30,42,41.67
Ambessa,DrMundo,44,16,28,36.36
Ambessa,Draven,93,44,49,47.31
Ambessa,Taliyah,56,25,31,44.64
Ambessa,Talon,70,36,34,51.43
Ambessa,Garen,190,94,96,49.47
Ambessa,MasterYi,134,70,64,52.24
Ambessa,Graves,91,41,50,45.05
Ambessa,KogMaw,50,29,21,58
Ambessa,Milio,109,36,73,33.03
Ambessa,Nilah,55,22,33,40
Ambessa,Rammus,49,26,23,53.06
Ambessa,Xerath,158,60,98,37.97
Ambessa,Riven,86,46,40,53.49
Ambessa,Vi,147,47,100,31.97
Ambessa,Renata,28,12,16,42.86
Ambessa,Kayle,75,29,46,38.67
Ambessa,Soraka,36,17,19,47.22
Ambessa,Orianna,76,39,37,51.32
Ambessa,Rakan,96,55,41,57.29
Ambessa,Bard,53,22,31,41.51
Ambessa,Nidalee,67,42,25,62.69
Ambessa,Ryze,83,43,40,51.81
Ambessa,Kalista,48,25,23,52.08
Ambessa,Skarner,60,38,22,63.33
Ambessa,Tryndamere,73,40,33,54.79
Ambessa,KSante,158,81,77,51.27
Ambessa,Karthus,46,22,24,47.83
Ambessa,Fizz,43,20,23,46.51
Ambessa,Vex,79,48,31,60.76
Ambessa,Kindred,70,45,25,64.29
Ambessa,Naafiri,67,42,25,62.69
Ambessa,Taric,38,18,20,47.37
Ambessa,Illaoi,78,35,43,44.87
Ambessa,Sylas,212,112,100,52.83
Ambessa,Evelynn,32,20,12,62.5
Ambessa,Senna,86,50,36,58.14
Ambessa,Gangplank,68,32,36,47.06
Ambessa,Kled,25,20,5,80
Ambessa,Rengar,39,14,25,35.9
Ambessa,Neeko,62,25,37,40.32
Ambessa,XinZhao,121,65,56,53.72
Ambessa,Annie,40,23,17,57.5
Ambessa,Zilean,31,9,22,29.03
Ambessa,Anivia,43,21,22,48.84
Ambessa,Zoe,69,39,30,56.52
Ambessa,Azir,90,40,50,44.44
Ambessa,Kassadin,37,18,19,48.65
Ambessa,Singed,39,17,22,43.59
Ambessa,Corki,58,34,24,58.62
Ambessa,Rell,104,37,67,35.58
Ambessa,Cassiopeia,46,24,22,52.17
Ambessa,Lissandra,30,10,20,33.33
Ambessa,Fiora,60,28,32,46.67
Ambessa,Quinn,39,16,23,41.03
Ambessa,Olaf,25,12,13,48
Ambessa,Ziggs,73,50,23,68.49
Ambessa,Sejuani,95,51,44,53.68
Ambessa,Qiyana,27,19,8,70.37
Ambessa,Ivern,35,18,17,51.43
Ambessa,Rumble,49,35,14,71.43
Ambessa,Shyvana,32,10,22,31.25
Ambessa,Zeri,51,25,26,49.02
Ambessa,RekSai,18,5,13,27.78
Volibear,Yone,348,185,163,53.16
Volibear,Viego,280,135,145,48.21
Volibear,Yasuo,380,199,181,52.37
Volibear,Ezreal,406,222,184,54.68
Volibear,Lux,553,322,231,58.23
Volibear,Urgot,90,38,52,42.22
Volibear,Diana,327,181,146,55.35
Volibear,Syndra,166,92,74,55.42
Volibear,MissFortune,376,214,162,56.91
Volibear,Braum,155,77,78,49.68
Volibear,Kayle,133,52,81,39.1
Volibear,Kindred,71,37,34,52.11
Volibear,AurelionSol,107,49,58,45.79
Volibear,Caitlyn,545,289,256,53.03
Volibear,Morgana,212,111,101,52.36
Volibear,Ornn,136,88,48,64.71
Volibear,Lillia,129,60,69,46.51
Volibear,Zed,225,108,117,48
Volibear,Tristana,210,101,109,48.1
Volibear,Nami,210,101,109,48.1
Volibear,Mordekaiser,362,196,166,54.14
Volibear,Poppy,166,97,69,58.43
Volibear,Varus,184,96,88,52.17
Volibear,Pyke,218,133,85,61.01
Volibear,Illaoi,136,51,85,37.5
Volibear,Briar,141,76,65,53.9
Volibear,Taliyah,71,37,34,52.11
Volibear,Twitch,148,68,80,45.95
Volibear,Nasus,149,65,84,43.62
Volibear,Shaco,177,105,72,59.32
Volibear,Xerath,203,104,99,51.23
Volibear,Lulu,291,142,149,48.8
Volibear,Yorick,168,107,61,63.69
Volibear,Katarina,134,76,58,56.72
Volibear,Neeko,96,50,46,52.08
Volibear,Darius,446,258,188,57.85
Volibear,Kayn,274,139,135,50.73
Volibear,Veigar,223,123,100,55.16
Volibear,Gangplank,118,67,51,56.78
Volibear,Pantheon,367,208,159,56.68
Volibear,TwistedFate,43,21,22,48.84
Volibear,Kaisa,295,137,158,46.44
Volibear,TahmKench,213,97,116,45.54
Volibear,Ziggs,82,51,31,62.2
Volibear,Vi,255,133,122,52.16
Volibear,Galio,226,127,99,56.19
Volibear,Smolder,182,95,87,52.2
Volibear,Vladimir,114,68,46,59.65
Volibear,RekSai,44,23,21,52.27
Volibear,Akali,207,108,99,52.17
Volibear,Ashe,384,224,160,58.33
Volibear,Bard,56,23,33,41.07
Volibear,Ambessa,155,90,65,58.06
Volibear,Khazix,93,57,36,61.29
Volibear,Vex,108,47,61,43.52
Volibear,Aphelios,130,52,78,40
Volibear,Jax,199,101,98,50.75
Volibear,Chogath,254,117,137,46.06
Volibear,Malphite,173,81,92,46.82
Volibear,MasterYi,224,127,97,56.7
Volibear,Lucian,161,93,68,57.76
Volibear,Teemo,204,100,104,49.02
Volibear,Graves,88,38,50,43.18
Volibear,Sylas,253,158,95,62.45
Volibear,Irelia,176,89,87,50.57
Volibear,Soraka,101,53,48,52.48
Volibear,Udyr,111,63,48,56.76
Volibear,Corki,117,65,52,55.56
Volibear,Alistar,112,61,51,54.46
Volibear,Trundle,113,64,49,56.64
Volibear,Mel,354,201,153,56.78
Volibear,Janna,60,29,31,48.33
Volibear,Jhin,454,209,245,46.04
Volibear,Leblanc,113,79,34,69.91
Volibear,Nilah,87,42,45,48.28
Volibear,Thresh,370,200,170,54.05
Volibear,Olaf,50,24,26,48
Volibear,Karma,181,80,101,44.2
Volibear,Ekko,209,110,99,52.63
Volibear,Ahri,305,159,146,52.13
Volibear,Gwen,133,63,70,47.37
Volibear,Samira,201,121,80,60.2
Volibear,JarvanIV,139,82,57,58.99
Volibear,Elise,160,91,69,56.88
Volibear,Draven,96,50,46,52.08
Volibear,Leona,213,124,89,58.22
Volibear,Gnar,98,63,35,64.29
Volibear,Nocturne,276,146,130,52.9
Volibear,MonkeyKing,123,55,68,44.72
Volibear,Rammus,84,41,43,48.81
Volibear,Zilean,70,26,44,37.14
Volibear,Singed,59,32,27,54.24
Volibear,Skarner,109,58,51,53.21
Volibear,Zeri,101,50,51,49.5
Volibear,Yuumi,157,88,69,56.05
Volibear,Amumu,231,89,142,38.53
Volibear,Naafiri,70,29,41,41.43
Volibear,Nautilus,273,141,132,51.65
Volibear,Milio,127,63,64,49.61
Volibear,Camille,59,25,34,42.37
Volibear,Brand,146,86,60,58.9
Volibear,Gragas,141,71,70,50.35
Volibear,Seraphine,134,80,54,59.7
Volibear,Sona,45,16,29,35.56
Volibear,Maokai,104,47,57,45.19
Volibear,Orianna,102,50,52,49.02
Volibear,Shyvana,60,34,26,56.67
Volibear,Fiora,66,36,30,54.55
Volibear,Sett,320,139,181,43.44
Volibear,Kled,58,26,32,44.83
Volibear,Jinx,510,267,243,52.35
Volibear,Rell,197,89,108,45.18
Volibear,Belveth,71,37,34,52.11
Volibear,Malzahar,225,127,98,56.44
Volibear,Garen,346,175,171,50.58
Volibear,Blitzcrank,208,105,103,50.48
Volibear,Ivern,46,26,20,56.52
Volibear,Shen,149,64,85,42.95
Volibear,Fizz,121,67,54,55.37
Volibear,Zac,109,35,74,32.11
Volibear,Warwick,379,199,180,52.51
Volibear,Cassiopeia,59,23,36,38.98
Volibear,Riven,60,33,27,55
Volibear,Qiyana,52,21,31,40.38
Volibear,DrMundo,138,69,69,50
Volibear,Vayne,270,130,140,48.15
Volibear,Sejuani,148,67,81,45.27
Volibear,Hwei,153,70,83,45.75
Volibear,Kassadin,35,19,16,54.29
Volibear,Nidalee,41,20,21,48.78
Volibear,FiddleSticks,104,60,44,57.69
Volibear,Zyra,145,62,83,42.76
Volibear,LeeSin,298,167,131,56.04
Volibear,Akshan,41,18,23,43.9
Volibear,Senna,113,61,52,53.98
Volibear,Rumble,40,33,7,82.5
Volibear,Sivir,137,70,67,51.09
Volibear,Evelynn,71,33,38,46.48
Volibear,Viktor,210,121,89,57.62
Volibear,Renekton,132,81,51,61.36
Volibear,Rengar,63,37,26,58.73
Volibear,Aurora,160,77,83,48.13
Volibear,Aatrox,231,100,131,43.29
Volibear,Xayah,113,55,58,48.67
Volibear,Sion,201,102,99,50.75
Volibear,XinZhao,136,72,64,52.94
Volibear,Swain,226,83,143,36.73
Volibear,KSante,114,55,59,48.25
Volibear,Ryze,74,40,34,54.05
Volibear,KogMaw,71,40,31,56.34
Volibear,Nunu,145,53,92,36.55
Volibear,Karthus,47,20,27,42.55
Volibear,Renata,51,25,26,49.02
Volibear,Zoe,68,40,28,58.82
Volibear,Velkoz,98,57,41,58.16
Volibear,Tryndamere,71,39,32,54.93
Volibear,Heimerdinger,77,30,47,38.96
Volibear,Hecarim,63,42,21,66.67
Volibear,Quinn,69,38,31,55.07
Volibear,Talon,76,47,29,61.84
Volibear,Azir,83,52,31,62.65
Volibear,Lissandra,88,38,50,43.18
Volibear,Taric,55,20,35,36.36
Volibear,Rakan,87,53,34,60.92
Volibear,Jayce,67,24,43,35.82
Volibear,Annie,73,30,43,41.1
Volibear,Kalista,40,17,23,42.5
Volibear,Kennen,67,44,23,65.67
Volibear,Anivia,51,14,37,27.45
Veigar,Yone,357,193,164,54.06
Veigar,Viego,228,108,120,47.37
Veigar,Yasuo,336,161,175,47.92
Veigar,Ezreal,428,205,223,47.9
Veigar,Lux,566,270,296,47.7
Veigar,DrMundo,132,72,60,54.55
Veigar,Sejuani,126,49,77,38.89
Veigar,Ashe,328,170,158,51.83
Veigar,TwistedFate,65,31,34,47.69
Veigar,Kayle,92,50,42,54.35
Veigar,Kindred,92,47,45,51.09
Veigar,AurelionSol,107,59,48,55.14
Veigar,Caitlyn,570,278,292,48.77
Veigar,Morgana,283,156,127,55.12
Veigar,Garen,375,196,179,52.27
Veigar,Warwick,354,162,192,45.76
Veigar,MissFortune,406,199,207,49.01
Veigar,Malzahar,269,125,144,46.47
Veigar,Kayn,277,145,132,52.35
Veigar,Ahri,321,158,163,49.22
Veigar,Amumu,292,122,170,41.78
Veigar,Nasus,139,59,80,42.45
Veigar,Seraphine,152,71,81,46.71
Veigar,Jax,193,106,87,54.92
Veigar,MasterYi,164,87,77,53.05
Veigar,Gwen,92,42,50,45.65
Veigar,Pantheon,316,156,160,49.37
Veigar,Irelia,159,96,63,60.38
Veigar,Varus,180,74,106,41.11
Veigar,Mordekaiser,271,145,126,53.51
Veigar,Karma,238,132,106,55.46
Veigar,Ekko,191,80,111,41.88
Veigar,Teemo,208,125,83,60.1
Veigar,Sivir,109,62,47,56.88
Veigar,Velkoz,148,65,83,43.92
Veigar,Mel,403,222,181,55.09
Veigar,Darius,393,178,215,45.29
Veigar,Riven,82,43,39,52.44
Veigar,Soraka,101,37,64,36.63
Veigar,Skarner,75,43,32,57.33
Veigar,Volibear,223,100,123,44.84
Veigar,Katarina,180,89,91,49.44
Veigar,Twitch,156,82,74,52.56
Veigar,Blitzcrank,200,121,79,60.5
Veigar,XinZhao,100,38,62,38
Veigar,Thresh,309,174,135,56.31
Veigar,Kaisa,328,174,154,53.05
Veigar,Jhin,393,201,192,51.15
Veigar,Yorick,196,91,105,46.43
Veigar,Chogath,290,121,169,41.72
Veigar,KSante,111,56,55,50.45
Veigar,Zac,100,67,33,67
Veigar,Annie,84,42,42,50
Veigar,Malphite,256,118,138,46.09
Veigar,Gragas,132,75,57,56.82
Veigar,Graves,93,35,58,37.63
Veigar,Qiyana,34,19,15,55.88
Veigar,Kalista,68,49,19,72.06
Veigar,Neeko,93,49,44,52.69
Veigar,Vladimir,111,62,49,55.86
Veigar,TahmKench,220,117,103,53.18
Veigar,JarvanIV,151,72,79,47.68
Veigar,Viktor,240,118,122,49.17
Veigar,Jinx,515,248,267,48.16
Veigar,Zeri,91,48,43,52.75
Veigar,Milio,102,46,56,45.1
Veigar,Vayne,229,96,133,41.92
Veigar,Zyra,155,77,78,49.68
Veigar,Orianna,90,51,39,56.67
Veigar,Shen,143,73,70,51.05
Veigar,Hecarim,69,31,38,44.93
Veigar,Kassadin,41,17,24,41.46
Veigar,Alistar,98,33,65,33.67
Veigar,Xerath,208,93,115,44.71
Veigar,Lucian,178,99,79,55.62
Veigar,Nami,183,82,101,44.81
Veigar,Swain,217,98,119,45.16
Veigar,Heimerdinger,132,60,72,45.45
Veigar,Sona,46,32,14,69.57
Veigar,Anivia,78,43,35,55.13
Veigar,Nunu,148,90,58,60.81
Veigar,Shaco,153,91,62,59.48
Veigar,Kennen,47,12,35,25.53
Veigar,Corki,62,32,30,51.61
Veigar,Bard,85,42,43,49.41
Veigar,Vex,129,74,55,57.36
Veigar,Jayce,104,38,66,36.54
Veigar,Diana,269,155,114,57.62
Veigar,Hwei,121,63,58,52.07
Veigar,Urgot,106,55,51,51.89
Veigar,Sion,195,118,77,60.51
Veigar,Rakan,101,50,51,49.5
Veigar,FiddleSticks,94,48,46,51.06
Veigar,Galio,192,103,89,53.65
Veigar,Fizz,176,107,69,60.8
Veigar,Taliyah,37,18,19,48.65
Veigar,LeeSin,268,126,142,47.01
Veigar,Lulu,252,139,113,55.16
Veigar,Sett,288,140,148,48.61
Veigar,Yuumi,173,86,87,49.71
Veigar,Gangplank,79,52,27,65.82
Veigar,Briar,110,53,57,48.18
Veigar,Zilean,80,41,39,51.25
Veigar,Aurora,160,96,64,60
Veigar,Senna,170,81,89,47.65
Veigar,Olaf,52,31,21,59.62
Veigar,Akali,183,90,93,49.18
Veigar,Taric,38,17,21,44.74
Veigar,Gnar,120,74,46,61.67
Veigar,Nocturne,246,128,118,52.03
Veigar,Singed,72,37,35,51.39
Veigar,Illaoi,99,53,46,53.54
Veigar,Pyke,144,76,68,52.78
Veigar,Ambessa,127,66,61,51.97
Veigar,Akshan,57,29,28,50.88
Veigar,Poppy,127,71,56,55.91
Veigar,Samira,153,84,69,54.9
Veigar,Vi,234,133,101,56.84
Veigar,Syndra,136,60,76,44.12
Veigar,Fiora,48,22,26,45.83
Veigar,Renekton,94,43,51,45.74
Veigar,Leona,204,101,103,49.51
Veigar,Evelynn,49,33,16,67.35
Veigar,Braum,125,91,34,72.8
Veigar,Rammus,75,34,41,45.33
Veigar,Nilah,57,31,26,54.39
Veigar,Zed,202,96,106,47.52
Veigar,Camille,82,52,30,63.41
Veigar,Aphelios,93,50,43,53.76
Veigar,Draven,132,70,62,53.03
Veigar,Azir,67,35,32,52.24
Veigar,Cassiopeia,48,29,19,60.42
Veigar,Maokai,80,36,44,45
Veigar,Smolder,138,83,55,60.14
Veigar,RekSai,34,23,11,67.65
Veigar,Xayah,132,83,49,62.88
Veigar,Leblanc,111,55,56,49.55
Veigar,Rell,114,67,47,58.77
Veigar,MonkeyKing,170,86,84,50.59
Veigar,Brand,129,64,65,49.61
Veigar,Tristana,209,105,104,50.24
Veigar,Talon,80,48,32,60
Veigar,Khazix,71,38,33,53.52
Veigar,Sylas,199,101,98,50.75
Veigar,Nautilus,264,115,149,43.56
Veigar,Tryndamere,76,33,43,43.42
Veigar,Janna,47,21,26,44.68
Veigar,Naafiri,66,37,29,56.06
Veigar,Shyvana,64,28,36,43.75
Veigar,Nidalee,60,41,19,68.33
Veigar,Ryze,80,39,41,48.75
Veigar,Elise,118,63,55,53.39
Veigar,Rengar,61,35,26,57.38
Veigar,Aatrox,187,94,93,50.27
Veigar,Lillia,150,71,79,47.33
Veigar,Udyr,63,45,18,71.43
Veigar,Kled,21,9,12,42.86
Veigar,Ornn,97,50,47,51.55
Veigar,Lissandra,83,51,32,61.45
Veigar,Trundle,106,55,51,51.89
Veigar,Karthus,48,19,29,39.58
Veigar,Ziggs,81,45,36,55.56
Veigar,Zoe,75,42,33,56
Veigar,Belveth,38,29,9,76.32
Veigar,Quinn,75,34,41,45.33
Veigar,KogMaw,55,26,29,47.27
Veigar,Ivern,40,17,23,42.5
Veigar,Rumble,45,27,18,60
Veigar,Renata,39,28,11,71.79
Vayne,Yone,379,185,194,48.81
Vayne,Viego,333,199,134,59.76
Vayne,Yasuo,416,236,180,56.73
Vayne,Ezreal,678,390,288,57.52
Vayne,Lux,521,260,261,49.9
Vayne,Kayle,139,77,62,55.4
Vayne,Kindred,100,58,42,58
Vayne,AurelionSol,98,58,40,59.18
Vayne,Caitlyn,572,280,292,48.95
Vayne,Morgana,240,147,93,61.25
Vayne,Ivern,45,18,27,40
Vayne,Renekton,148,71,77,47.97
Vayne,Vladimir,176,93,83,52.84
Vayne,Lucian,177,90,87,50.85
Vayne,Blitzcrank,205,122,83,59.51
Vayne,Thresh,417,222,195,53.24
Vayne,Annie,68,28,40,41.18
Vayne,Nasus,176,110,66,62.5
Vayne,Tristana,223,115,108,51.57
Vayne,Poppy,235,125,110,53.19
Vayne,Zac,197,80,117,40.61
Vayne,Malzahar,263,112,151,42.59
Vayne,MissFortune,530,265,265,50
Vayne,TahmKench,303,166,137,54.79
Vayne,Jayce,127,68,59,53.54
Vayne,Elise,191,111,80,58.12
Vayne,Yorick,223,104,119,46.64
Vayne,Zilean,85,46,39,54.12
Vayne,Evelynn,72,30,42,41.67
Vayne,Kaisa,481,261,220,54.26
Vayne,Maokai,124,63,61,50.81
Vayne,KSante,152,92,60,60.53
Vayne,Lillia,119,64,55,53.78
Vayne,Diana,382,202,180,52.88
Vayne,Twitch,219,109,110,49.77
Vayne,Bard,87,37,50,42.53
Vayne,Shen,258,133,125,51.55
Vayne,LeeSin,324,168,156,51.85
Vayne,Orianna,139,57,82,41.01
Vayne,Xayah,156,69,87,44.23
Vayne,Rakan,164,102,62,62.2
Vayne,Aatrox,227,116,111,51.1
Vayne,Amumu,295,156,139,52.88
Vayne,Taliyah,67,28,39,41.79
Vayne,Ashe,450,229,221,50.89
Vayne,Milio,178,114,64,64.04
Vayne,Kled,41,19,22,46.34
Vayne,Gragas,183,99,84,54.1
Vayne,Anivia,94,61,33,64.89
Vayne,Jinx,576,277,299,48.09
Vayne,Rell,184,94,90,51.09
Vayne,Darius,471,243,228,51.59
Vayne,Warwick,350,175,175,50
Vayne,Akali,220,129,91,58.64
Vayne,Malphite,323,145,178,44.89
Vayne,Nocturne,272,155,117,56.99
Vayne,Samira,245,121,124,49.39
Vayne,Pyke,186,92,94,49.46
Vayne,Ekko,230,102,128,44.35
Vayne,Smolder,183,100,83,54.64
Vayne,Soraka,85,44,41,51.76
Vayne,Kayn,254,128,126,50.39
Vayne,Gwen,93,43,50,46.24
Vayne,Ambessa,182,111,71,60.99
Vayne,Ryze,112,58,54,51.79
Vayne,Ornn,177,90,87,50.85
Vayne,Veigar,229,133,96,58.08
Vayne,Pantheon,449,235,214,52.34
Vayne,RekSai,23,19,4,82.61
Vayne,Sejuani,178,83,95,46.63
Vayne,Karma,257,150,107,58.37
Vayne,Garen,412,200,212,48.54
Vayne,Trundle,145,75,70,51.72
Vayne,Katarina,155,81,74,52.26
Vayne,Zoe,102,41,61,40.2
Vayne,Riven,123,64,59,52.03
Vayne,Shaco,181,90,91,49.72
Vayne,Teemo,221,99,122,44.8
Vayne,Graves,143,64,79,44.76
Vayne,Sylas,349,201,148,57.59
Vayne,Irelia,167,71,96,42.51
Vayne,Sion,234,140,94,59.83
Vayne,MasterYi,281,193,88,68.68
Vayne,Seraphine,157,89,68,56.69
Vayne,Karthus,72,43,29,59.72
Vayne,Leona,285,163,122,57.19
Vayne,XinZhao,180,93,87,51.67
Vayne,Mel,493,278,215,56.39
Vayne,MonkeyKing,179,81,98,45.25
Vayne,Heimerdinger,110,56,54,50.91
Vayne,Ahri,344,178,166,51.74
Vayne,Nami,235,99,136,42.13
Vayne,Quinn,103,42,61,40.78
Vayne,Galio,315,155,160,49.21
Vayne,Senna,166,94,72,56.63
Vayne,Aurora,179,97,82,54.19
Vayne,Chogath,428,209,219,48.83
Vayne,Gnar,131,87,44,66.41
Vayne,Zed,218,121,97,55.5
Vayne,Zyra,183,80,103,43.72
Vayne,Khazix,122,71,51,58.2
Vayne,Sona,42,20,22,47.62
Vayne,Lissandra,81,37,44,45.68
Vayne,Braum,170,82,88,48.24
Vayne,Vi,319,169,150,52.98
Vayne,FiddleSticks,90,41,49,45.56
Vayne,Hecarim,99,39,60,39.39
Vayne,Briar,132,70,62,53.03
Vayne,Gangplank,84,55,29,65.48
Vayne,Rammus,145,102,43,70.34
Vayne,Nilah,75,44,31,58.67
Vayne,Xerath,223,110,113,49.33
Vayne,JarvanIV,164,91,73,55.49
Vayne,Vex,134,73,61,54.48
Vayne,Singed,45,22,23,48.89
Vayne,Rengar,85,58,27,68.24
Vayne,Ziggs,106,79,27,74.53
Vayne,Talon,119,75,44,63.03
Vayne,Jhin,559,291,268,52.06
Vayne,Qiyana,46,23,23,50
Vayne,Leblanc,105,62,43,59.05
Vayne,Olaf,67,45,22,67.16
Vayne,Lulu,270,125,145,46.3
Vayne,Hwei,142,68,74,47.89
Vayne,Viktor,245,109,136,44.49
Vayne,Jax,179,96,83,53.63
Vayne,Corki,155,100,55,64.52
Vayne,Akshan,87,61,26,70.11
Vayne,KogMaw,65,36,29,55.38
Vayne,Brand,124,59,65,47.58
Vayne,Illaoi,103,51,52,49.51
Vayne,Nunu,153,86,67,56.21
Vayne,Alistar,162,77,85,47.53
Vayne,Fiora,63,37,26,58.73
Vayne,Fizz,129,76,53,58.91
Vayne,Draven,149,77,72,51.68
Vayne,Nautilus,357,188,169,52.66
Vayne,Mordekaiser,379,198,181,52.24
Vayne,Varus,224,128,96,57.14
Vayne,Nidalee,77,42,35,54.55
Vayne,Volibear,270,140,130,51.85
Vayne,Swain,257,135,122,52.53
Vayne,Syndra,186,105,81,56.45
Vayne,Rumble,80,46,34,57.5
Vayne,Sivir,134,79,55,58.96
Vayne,Neeko,125,84,41,67.2
Vayne,Urgot,134,81,53,60.45
Vayne,DrMundo,158,100,58,63.29
Vayne,Sett,343,164,179,47.81
Vayne,Kalista,74,46,28,62.16
Vayne,Udyr,105,68,37,64.76
Vayne,Camille,129,58,71,44.96
Vayne,Yuumi,202,91,111,45.05
Vayne,Skarner,117,64,53,54.7
Vayne,Janna,83,30,53,36.14
Vayne,Aphelios,120,78,42,65
Vayne,Kassadin,58,26,32,44.83
Vayne,Naafiri,61,30,31,49.18
Vayne,Tryndamere,85,54,31,63.53
Vayne,Velkoz,108,64,44,59.26
Vayne,Zeri,140,74,66,52.86
Vayne,Cassiopeia,101,46,55,45.54
Vayne,TwistedFate,81,33,48,40.74
Vayne,Belveth,31,15,16,48.39
Vayne,Renata,29,18,11,62.07
Vayne,Azir,85,45,40,52.94
Vayne,Taric,59,38,21,64.41
Vayne,Kennen,80,51,29,63.75
Vayne,Shyvana,53,18,35,33.96
Seraphine,Yone,214,113,101,52.8
Seraphine,Viego,187,65,122,34.76
Seraphine,Yasuo,259,136,123,52.51
Seraphine,Ezreal,303,169,134,55.78
Seraphine,Lux,453,240,213,52.98
Seraphine,Corki,68,41,27,60.29
Seraphine,Ekko,105,52,53,49.52
Seraphine,Leblanc,61,33,28,54.1
Seraphine,Caitlyn,385,183,202,47.53
Seraphine,Mel,301,149,152,49.5
Seraphine,Mordekaiser,189,102,87,53.97
Seraphine,Lucian,106,66,40,62.26
Seraphine,Rakan,80,48,32,60
Seraphine,Garen,232,104,128,44.83
Seraphine,Shyvana,53,35,18,66.04
Seraphine,Lissandra,71,31,40,43.66
Seraphine,Veigar,152,81,71,53.29
Seraphine,Akali,158,90,68,56.96
Seraphine,Belveth,28,22,6,78.57
Seraphine,Varus,147,78,69,53.06
Seraphine,Jhin,271,163,108,60.15
Seraphine,Lulu,234,137,97,58.55
Seraphine,Teemo,126,69,57,54.76
Seraphine,Renekton,65,30,35,46.15
Seraphine,Kassadin,33,22,11,66.67
Seraphine,Jinx,350,169,181,48.29
Seraphine,Soraka,91,41,50,45.05
Seraphine,Darius,266,118,148,44.36
Seraphine,Nocturne,179,83,96,46.37
Seraphine,Katarina,70,50,20,71.43
Seraphine,Nami,152,86,66,56.58
Seraphine,Yorick,117,51,66,43.59
Seraphine,Nunu,64,40,24,62.5
Seraphine,TwistedFate,45,22,23,48.89
Seraphine,Bard,43,15,28,34.88
Seraphine,Kled,34,10,24,29.41
Seraphine,Gragas,100,60,40,60
Seraphine,Anivia,37,11,26,29.73
Seraphine,Rell,87,45,42,51.72
Seraphine,Ambessa,136,54,82,39.71
Seraphine,Gnar,61,39,22,63.93
Seraphine,Hwei,100,48,52,48
Seraphine,Samira,138,64,74,46.38
Seraphine,TahmKench,144,60,84,41.67
Seraphine,Illaoi,73,35,38,47.95
Seraphine,Amumu,174,86,88,49.43
Seraphine,Vladimir,73,23,50,31.51
Seraphine,MasterYi,114,49,65,42.98
Seraphine,Tristana,160,88,72,55
Seraphine,Yuumi,103,49,54,47.57
Seraphine,Tryndamere,43,11,32,25.58
Seraphine,Aurora,118,59,59,50
Seraphine,Vayne,157,68,89,43.31
Seraphine,Senna,111,60,51,54.05
Seraphine,Aatrox,112,80,32,71.43
Seraphine,Karthus,22,11,11,50
Seraphine,Xayah,56,26,30,46.43
Seraphine,Annie,51,16,35,31.37
Seraphine,Viktor,97,64,33,65.98
Seraphine,Vi,187,79,108,42.25
Seraphine,Irelia,107,60,47,56.07
Seraphine,Urgot,72,29,43,40.28
Seraphine,Syndra,101,48,53,47.52
Seraphine,Milio,123,50,73,40.65
Seraphine,Azir,68,37,31,54.41
Seraphine,Sona,37,16,21,43.24
Seraphine,Zyra,152,87,65,57.24
Seraphine,Ashe,240,137,103,57.08
Seraphine,Qiyana,40,29,11,72.5
Seraphine,Karma,174,94,80,54.02
Seraphine,Pantheon,257,127,130,49.42
Seraphine,Kaisa,198,103,95,52.02
Seraphine,Alistar,40,18,22,45
Seraphine,Camille,58,29,29,50
Seraphine,Graves,78,34,44,43.59
Seraphine,Xerath,116,65,51,56.03
Seraphine,Smolder,104,63,41,60.58
Seraphine,Leona,138,66,72,47.83
Seraphine,Sett,210,90,120,42.86
Seraphine,LeeSin,269,146,123,54.28
Seraphine,Galio,170,95,75,55.88
Seraphine,Brand,135,73,62,54.07
Seraphine,Diana,221,107,114,48.42
Seraphine,Talon,69,35,34,50.72
Seraphine,Chogath,163,92,71,56.44
Seraphine,FiddleSticks,61,35,26,57.38
Seraphine,Kayn,170,91,79,53.53
Seraphine,Braum,113,50,63,44.25
Seraphine,Malphite,196,105,91,53.57
Seraphine,Warwick,184,98,86,53.26
Seraphine,Poppy,97,46,51,47.42
Seraphine,Riven,96,57,39,59.38
Seraphine,Zoe,41,21,20,51.22
Seraphine,Jax,97,48,49,49.48
Seraphine,Rumble,39,20,19,51.28
Seraphine,Volibear,134,54,80,40.3
Seraphine,Shaco,119,59,60,49.58
Seraphine,Swain,115,43,72,37.39
Seraphine,Ivern,13,8,5,61.54
Seraphine,Aphelios,111,71,40,63.96
Seraphine,MissFortune,351,182,169,51.85
Seraphine,Sejuani,85,45,40,52.94
Seraphine,Zed,160,82,78,51.25
Seraphine,Sivir,76,39,37,51.32
Seraphine,Gangplank,51,23,28,45.1
Seraphine,Vex,101,47,54,46.53
Seraphine,Hecarim,52,35,17,67.31
Seraphine,Ahri,206,89,117,43.2
Seraphine,MonkeyKing,97,45,52,46.39
Seraphine,Gwen,92,51,41,55.43
Seraphine,KSante,69,43,26,62.32
Seraphine,Skarner,66,39,27,59.09
Seraphine,Sylas,197,137,60,69.54
Seraphine,Heimerdinger,74,37,37,50
Seraphine,Nasus,117,66,51,56.41
Seraphine,Pyke,117,62,55,52.99
Seraphine,DrMundo,59,42,17,71.19
Seraphine,JarvanIV,122,76,46,62.3
Seraphine,Thresh,250,145,105,58
Seraphine,Kayle,83,35,48,42.17
Seraphine,Udyr,48,24,24,50
Seraphine,Cassiopeia,54,38,16,70.37
Seraphine,Orianna,86,40,46,46.51
Seraphine,Neeko,58,39,19,67.24
Seraphine,Blitzcrank,112,52,60,46.43
Seraphine,Ryze,57,34,23,59.65
Seraphine,Morgana,141,63,78,44.68
Seraphine,Khazix,67,48,19,71.64
Seraphine,Trundle,75,22,53,29.33
Seraphine,Lillia,65,34,31,52.31
Seraphine,Evelynn,45,22,23,48.89
Seraphine,Naafiri,43,34,9,79.07
Seraphine,Malzahar,139,62,77,44.6
Seraphine,Olaf,32,14,18,43.75
Seraphine,Singed,45,17,28,37.78
Seraphine,Draven,59,23,36,38.98
Seraphine,Elise,106,51,55,48.11
Seraphine,Zeri,34,14,20,41.18
Seraphine,KogMaw,47,18,29,38.3
Seraphine,Taliyah,27,20,7,74.07
Seraphine,Briar,87,42,45,48.28
Seraphine,Ziggs,57,28,29,49.12
Seraphine,Kindred,46,23,23,50
Seraphine,AurelionSol,67,31,36,46.27
Seraphine,Shen,111,41,70,36.94
Seraphine,Nidalee,54,38,16,70.37
Seraphine,Kalista,45,28,17,62.22
Seraphine,Akshan,36,16,20,44.44
Seraphine,Fiora,69,32,37,46.38
Seraphine,Rengar,47,32,15,68.09
Seraphine,Ornn,75,45,30,60
Seraphine,Zac,66,37,29,56.06
Seraphine,Nautilus,174,69,105,39.66
Seraphine,Maokai,90,36,54,40
Seraphine,Rammus,54,33,21,61.11
Seraphine,Kennen,33,14,19,42.42
Seraphine,Twitch,135,70,65,51.85
Seraphine,XinZhao,80,46,34,57.5
Seraphine,Velkoz,61,37,24,60.66
Seraphine,Quinn,49,19,30,38.78
Seraphine,Janna,32,14,18,43.75
Seraphine,Taric,30,19,11,63.33
Seraphine,Sion,115,70,45,60.87
Seraphine,Zilean,13,7,6,53.85
Seraphine,Nilah,59,31,28,52.54
Seraphine,Fizz,71,25,46,35.21
Seraphine,Jayce,51,24,27,47.06
Seraphine,RekSai,10,5,5,50
Seraphine,Renata,26,9,17,34.62
Yone,Ambessa,289,151,138,52.25
Yone,Volibear,348,163,185,46.84
Yone,Veigar,357,164,193,45.94
Yone,Vayne,379,194,185,51.19
Yone,Seraphine,214,101,113,47.2
Yone,Jax,364,185,179,50.82
Yone,Sejuani,230,99,131,43.04
Yone,Hwei,194,98,96,50.52
Yone,Ezreal,952,454,498,47.69
Yone,Zac,188,102,86,54.26
Yone,Mordekaiser,459,248,211,54.03
Yone,Kayn,397,198,199,49.87
Yone,Katarina,218,128,90,58.72
Yone,Caitlyn,914,416,498,45.51
Yone,Morgana,324,122,202,37.65
Yone,Maokai,130,78,52,60
Yone,Viego,501,262,239,52.3
Yone,Viktor,340,154,186,45.29
Yone,Smolder,274,132,142,48.18
Yone,Nami,305,143,162,46.89
Yone,Ivern,59,29,30,49.15
Yone,Renekton,298,130,168,43.62
Yone,Vladimir,239,127,112,53.14
Yone,Lucian,272,119,153,43.75
Yone,Blitzcrank,391,165,226,42.2
Yone,Nasus,231,118,113,51.08
Yone,FiddleSticks,148,66,82,44.59
Yone,Syndra,238,144,94,60.5
Yone,Mel,747,405,342,54.22
Yone,Heimerdinger,147,71,76,48.3
Yone,Gragas,264,146,118,55.3
Yone,Jinx,787,361,426,45.87
Yone,Pyke,359,166,193,46.24
Yone,MasterYi,349,167,182,47.85
Yone,Leona,399,176,223,44.11
Yone,Ashe,729,371,358,50.89
Yone,Trundle,167,71,96,42.51
Yone,Diana,576,290,286,50.35
Yone,Braum,282,139,143,49.29
Yone,Gangplank,150,77,73,51.33
Yone,Darius,645,328,317,50.85
Yone,Teemo,344,159,185,46.22
Yone,Nilah,96,51,45,53.13
Yone,Yorick,294,149,145,50.68
Yone,Akali,478,226,252,47.28
Yone,Milio,183,96,87,52.46
Yone,Yasuo,930,469,461,50.43
Yone,Tristana,238,135,103,56.72
Yone,Lux,805,369,436,45.84
Yone,Urgot,157,77,80,49.04
Yone,Malzahar,297,148,149,49.83
Yone,KSante,242,136,106,56.2
Yone,Annie,126,69,57,54.76
Yone,Malphite,432,192,240,44.44
Yone,Sett,600,282,318,47
Yone,LeeSin,653,325,328,49.77
Yone,Lissandra,124,76,48,61.29
Yone,Irelia,305,169,136,55.41
Yone,Lulu,516,240,276,46.51
Yone,Gwen,171,75,96,43.86
Yone,Amumu,396,152,244,38.38
Yone,DrMundo,175,64,111,36.57
Yone,Rammus,156,83,73,53.21
Yone,Zed,349,167,182,47.85
Yone,Jayce,155,71,84,45.81
Yone,Ekko,286,130,156,45.45
Yone,Xayah,236,96,140,40.68
Yone,Zyra,273,117,156,42.86
Yone,Aatrox,402,221,181,54.98
Yone,Orianna,109,45,64,41.28
Yone,Twitch,170,97,73,57.06
Yone,Pantheon,621,296,325,47.67
Yone,Singed,90,58,32,64.44
Yone,Leblanc,250,137,113,54.8
Yone,Skarner,204,97,107,47.55
Yone,KogMaw,110,69,41,62.73
Yone,Nautilus,421,188,233,44.66
Yone,Camille,142,68,74,47.89
Yone,Lillia,241,120,121,49.79
Yone,Varus,341,168,173,49.27
Yone,JarvanIV,202,92,110,45.54
Yone,Naafiri,135,65,70,48.15
Yone,Soraka,162,86,76,53.09
Yone,Azir,157,65,92,41.4
Yone,Gnar,151,69,82,45.7
Yone,Udyr,146,77,69,52.74
Yone,MissFortune,741,354,387,47.77
Yone,Sion,324,166,158,51.23
Yone,Kassadin,52,30,22,57.69
Yone,MonkeyKing,240,87,153,36.25
Yone,Chogath,402,187,215,46.52
Yone,Karma,371,168,203,45.28
Yone,Shen,226,105,121,46.46
Yone,Ornn,209,115,94,55.02
Yone,Elise,316,166,150,52.53
Yone,Draven,174,93,81,53.45
Yone,TahmKench,295,147,148,49.83
Yone,Khazix,183,85,98,46.45
Yone,Jhin,661,346,315,52.34
Yone,Kaisa,591,303,288,51.27
Yone,Shaco,275,146,129,53.09
Yone,Karthus,69,34,35,49.28
Yone,Riven,110,45,65,40.91
Yone,Sylas,613,316,297,51.55
Yone,Poppy,279,157,122,56.27
Yone,AurelionSol,136,68,68,50
Yone,Briar,200,100,100,50
Yone,Nocturne,390,210,180,53.85
Yone,Ahri,479,230,249,48.02
Yone,Taric,59,28,31,47.46
Yone,Vi,337,150,187,44.51
Yone,Xerath,308,168,140,54.55
Yone,Aurora,224,110,114,49.11
Yone,RekSai,52,18,34,34.62
Yone,Nunu,242,139,103,57.44
Yone,Belveth,77,49,28,63.64
Yone,Galio,456,204,252,44.74
Yone,Warwick,456,196,260,42.98
Yone,Brand,159,91,68,57.23
Yone,Vex,252,139,113,55.16
Yone,Zoe,148,55,93,37.16
Yone,Rakan,207,104,103,50.24
Yone,Swain,359,155,204,43.18
Yone,Kayle,180,99,81,55
Yone,Alistar,243,119,124,48.97
Yone,Rengar,95,47,48,49.47
Yone,Illaoi,189,96,93,50.79
Yone,Shyvana,68,30,38,44.12
Yone,Aphelios,179,96,83,53.63
Yone,Talon,160,69,91,43.13
Yone,Ryze,140,68,72,48.57
Yone,Janna,91,38,53,41.76
Yone,Sona,66,31,35,46.97
Yone,Zilean,106,52,54,49.06
Yone,XinZhao,233,110,123,47.21
Yone,Taliyah,73,27,46,36.99
Yone,Kalista,116,62,54,53.45
Yone,Nidalee,130,64,66,49.23
Yone,Garen,482,205,277,42.53
Yone,Kled,57,30,27,52.63
Yone,Fizz,103,43,60,41.75
Yone,TwistedFate,108,62,46,57.41
Yone,Tryndamere,125,65,60,52
Yone,Thresh,594,316,278,53.2
Yone,Qiyana,94,46,48,48.94
Yone,Neeko,178,88,90,49.44
Yone,Yuumi,231,127,104,54.98
Yone,Rell,195,85,110,43.59
Yone,Ziggs,170,67,103,39.41
Yone,Senna,214,131,83,61.21
Yone,Velkoz,161,75,86,46.58
Yone,Samira,287,129,158,44.95
Yone,Sivir,166,68,98,40.96
Yone,Kennen,100,42,58,42
Yone,Zeri,200,79,121,39.5
Yone,Bard,87,40,47,45.98
Yone,Akshan,110,69,41,62.73
Yone,Cassiopeia,93,39,54,41.94
Yone,Corki,159,89,70,55.97
Yone,Fiora,121,47,74,38.84
Yone,Graves,238,90,148,37.82
Yone,Anivia,102,42,60,41.18
Yone,Hecarim,107,59,48,55.14
Yone,Quinn,95,41,54,43.16
Yone,Renata,66,37,29,56.06
Yone,Rumble,118,57,61,48.31
Yone,Evelynn,87,37,50,42.53
Yone,Olaf,72,20,52,27.78
Yone,Kindred,144,64,80,44.44
Viego,Ambessa,261,101,160,38.7
Viego,Volibear,280,145,135,51.79
Viego,Veigar,228,120,108,52.63
Viego,Vayne,333,134,199,40.24
Viego,Seraphine,187,122,65,65.24
Viego,Yone,501,239,262,47.7
Viego,Nocturne,307,142,165,46.25
Viego,Akali,258,141,117,54.65
Viego,Ezreal,696,385,311,55.32
Viego,Renata,62,30,32,48.39
Viego,Nasus,161,87,74,54.04
Viego,FiddleSticks,120,65,55,54.17
Viego,Syndra,208,94,114,45.19
Viego,Mel,567,294,273,51.85
Viego,Sion,226,122,104,53.98
Viego,RekSai,47,25,22,53.19
Viego,Viktor,261,128,133,49.04
Viego,KogMaw,62,27,35,43.55
Viego,Ashe,559,342,217,61.18
Viego,Urgot,96,47,49,48.96
Viego,Kayn,388,199,189,51.29
Viego,Vladimir,153,81,72,52.94
Viego,Kaisa,471,243,228,51.59
Viego,Taric,58,38,20,65.52
Viego,Garen,368,171,197,46.47
Viego,Warwick,359,163,196,45.4
Viego,Ahri,375,191,184,50.93
Viego,Jinx,647,280,367,43.28
Viego,Milio,161,70,91,43.48
Viego,Jax,267,135,132,50.56
Viego,Diana,379,180,199,47.49
Viego,Akshan,49,30,19,61.22
Viego,Sylas,416,201,215,48.32
Viego,Evelynn,84,42,42,50
Viego,Varus,219,113,106,51.6
Viego,Karma,343,195,148,56.85
Viego,Aatrox,294,136,158,46.26
Viego,TwistedFate,91,42,49,46.15
Viego,Lux,524,274,250,52.29
Viego,Lulu,308,129,179,41.88
Viego,Olaf,87,48,39,55.17
Viego,Nidalee,105,71,34,67.62
Viego,Ryze,120,56,64,46.67
Viego,Caitlyn,625,288,337,46.08
Viego,Brand,138,88,50,63.77
Viego,Irelia,199,121,78,60.8
Viego,Ekko,234,99,135,42.31
Viego,Qiyana,80,42,38,52.5
Viego,Thresh,480,221,259,46.04
Viego,Amumu,321,154,167,47.98
Viego,Zeri,126,49,77,38.89
Viego,Pantheon,450,202,248,44.89
Viego,Zac,148,74,74,50
Viego,Janna,85,51,34,60
Viego,Vi,350,206,144,58.86
Viego,Orianna,167,106,61,63.47
Viego,Nilah,100,47,53,47
Viego,Leona,244,120,124,49.18
Viego,Gangplank,135,66,69,48.89
Viego,Taliyah,93,50,43,53.76
Viego,MissFortune,477,256,221,53.67
Viego,Mordekaiser,303,149,154,49.17
Viego,MonkeyKing,262,136,126,51.91
Viego,Samira,221,121,100,54.75
Viego,Rell,190,97,93,51.05
Viego,Lissandra,107,53,54,49.53
Viego,Senna,106,69,37,65.09
Viego,LeeSin,561,286,275,50.98
Viego,Yasuo,497,271,226,54.53
Viego,Katarina,161,87,74,54.04
Viego,Gwen,143,84,59,58.74
Viego,Aurora,208,90,118,43.27
Viego,Morgana,306,141,165,46.08
Viego,Gragas,174,99,75,56.9
Viego,Tryndamere,84,42,42,50
Viego,Poppy,216,118,98,54.63
Viego,Nautilus,379,199,180,52.51
Viego,Jayce,145,88,57,60.69
Viego,Draven,116,69,47,59.48
Viego,Lillia,116,48,68,41.38
Viego,Nami,247,126,121,51.01
Viego,Udyr,69,39,30,56.52
Viego,Blitzcrank,284,141,143,49.65
Viego,Sett,387,177,210,45.74
Viego,Sejuani,167,83,84,49.7
Viego,Yuumi,193,100,93,51.81
Viego,Fizz,86,45,41,52.33
Viego,Ornn,169,64,105,37.87
Viego,Corki,105,67,38,63.81
Viego,Soraka,137,92,45,67.15
Viego,Shaco,179,105,74,58.66
Viego,TahmKench,190,83,107,43.68
Viego,Yorick,236,110,126,46.61
Viego,Rakan,156,85,71,54.49
Viego,Rammus,94,47,47,50
Viego,Jhin,509,240,269,47.15
Viego,Velkoz,106,47,59,44.34
Viego,Braum,227,106,121,46.7
Viego,Graves,174,73,101,41.95
Viego,KSante,163,79,84,48.47
Viego,Trundle,102,62,40,60.78
Viego,Belveth,70,43,27,61.43
Viego,Malphite,313,158,155,50.48
Viego,Malzahar,224,98,126,43.75
Viego,Darius,421,209,212,49.64
Viego,Zyra,227,131,96,57.71
Viego,Khazix,139,69,70,49.64
Viego,Hwei,202,103,99,50.99
Viego,Rengar,75,30,45,40
Viego,Chogath,379,172,207,45.38
Viego,Zilean,63,21,42,33.33
Viego,Elise,264,129,135,48.86
Viego,Karthus,56,28,28,50
Viego,Leblanc,151,82,69,54.3
Viego,JarvanIV,203,112,91,55.17
Viego,Renekton,148,75,73,50.68
Viego,Maokai,133,76,57,57.14
Viego,Swain,247,122,125,49.39
Viego,Kennen,98,51,47,52.04
Viego,Heimerdinger,131,83,48,63.36
Viego,Kassadin,51,18,33,35.29
Viego,Rumble,84,45,39,53.57
Viego,Smolder,196,105,91,53.57
Viego,Gnar,151,87,64,57.62
Viego,Zed,317,147,170,46.37
Viego,Teemo,230,111,119,48.26
Viego,Shen,210,112,98,53.33
Viego,Kled,37,15,22,40.54
Viego,Kindred,97,65,32,67.01
Viego,Aphelios,159,80,79,50.31
Viego,Kalista,107,62,45,57.94
Viego,Xayah,150,82,68,54.67
Viego,Xerath,212,109,103,51.42
Viego,Quinn,102,49,53,48.04
Viego,Alistar,152,59,93,38.82
Viego,MasterYi,202,107,95,52.97
Viego,Fiora,84,43,41,51.19
Viego,Anivia,87,35,52,40.23
Viego,Twitch,165,75,90,45.45
Viego,Cassiopeia,37,24,13,64.86
Viego,Tristana,222,103,119,46.4
Viego,Hecarim,130,85,45,65.38
Viego,Camille,84,46,38,54.76
Viego,Nunu,154,82,72,53.25
Viego,Vex,153,84,69,54.9
Viego,Neeko,108,53,55,49.07
Viego,Sona,34,20,14,58.82
Viego,Lucian,202,106,96,52.48
Viego,Illaoi,100,74,26,74
Viego,Singed,61,25,36,40.98
Viego,Azir,124,49,75,39.52
Viego,Pyke,267,155,112,58.05
Viego,XinZhao,191,112,79,58.64
Viego,AurelionSol,86,45,41,52.33
Viego,Skarner,127,75,52,59.06
Viego,Briar,121,61,60,50.41
Viego,Ziggs,89,47,42,52.81
Viego,Galio,298,156,142,52.35
Viego,Shyvana,81,20,61,24.69
Viego,Kayle,160,72,88,45
Viego,Zoe,131,83,48,63.36
Viego,DrMundo,121,60,61,49.59
Viego,Naafiri,70,31,39,44.29
Viego,Ivern,58,35,23,60.34
Viego,Riven,78,39,39,50
Viego,Talon,121,59,62,48.76
Viego,Sivir,148,86,62,58.11
Viego,Bard,114,65,49,57.02
Viego,Annie,55,29,26,52.73
Yasuo,Ambessa,306,172,134,56.21
Yasuo,Volibear,380,181,199,47.63
Yasuo,Veigar,336,175,161,52.08
Yasuo,Vayne,416,180,236,43.27
Yasuo,Seraphine,259,123,136,47.49
Yasuo,Renekton,287,127,160,44.25
Yasuo,Udyr,191,100,91,52.36
Yasuo,Qiyana,78,47,31,60.26
Yasuo,Xayah,200,94,106,47
Yasuo,Morgana,345,154,191,44.64
Yasuo,Riven,131,62,69,47.33
Yasuo,Poppy,316,170,146,53.8
Yasuo,Ziggs,169,102,67,60.36
Yasuo,Yuumi,265,133,132,50.19
Yasuo,Diana,513,297,216,57.89
Yasuo,Ekko,304,131,173,43.09
Yasuo,Jinx,877,429,448,48.92
Yasuo,Lulu,479,229,250,47.81
Yasuo,DrMundo,139,70,69,50.36
Yasuo,Rammus,204,89,115,43.63
Yasuo,Annie,177,84,93,47.46
Yasuo,Ezreal,879,455,424,51.76
Yasuo,Renata,94,48,46,51.06
Yasuo,Akali,492,270,222,54.88
Yasuo,Amumu,439,192,247,43.74
Yasuo,Caitlyn,1010,498,512,49.31
Yasuo,Lux,883,457,426,51.76
Yasuo,Vladimir,290,136,154,46.9
Yasuo,MasterYi,414,215,199,51.93
Yasuo,Leona,391,176,215,45.01
Yasuo,Ashe,800,405,395,50.63
Yasuo,Mordekaiser,470,191,279,40.64
Yasuo,Shen,330,138,192,41.82
Yasuo,Katarina,237,116,121,48.95
Yasuo,Jhin,782,378,404,48.34
Yasuo,Karma,487,244,243,50.1
Yasuo,Shaco,359,183,176,50.97
Yasuo,Heimerdinger,180,99,81,55
Yasuo,Thresh,684,372,312,54.39
Yasuo,Sion,329,140,189,42.55
Yasuo,Aatrox,396,196,200,49.49
Yasuo,TwistedFate,95,54,41,56.84
Yasuo,Fizz,189,91,98,48.15
Yasuo,Vex,359,182,177,50.7
Yasuo,Sona,57,27,30,47.37
Yasuo,FiddleSticks,153,71,82,46.41
Yasuo,Hwei,228,147,81,64.47
Yasuo,Teemo,386,207,179,53.63
Yasuo,Janna,83,48,35,57.83
Yasuo,Hecarim,152,65,87,42.76
Yasuo,Sett,618,313,305,50.65
Yasuo,XinZhao,254,131,123,51.57
Yasuo,Kaisa,659,352,307,53.41
Yasuo,KSante,218,117,101,53.67
Yasuo,Yone,930,461,469,49.57
Yasuo,Zilean,116,53,63,45.69
Yasuo,Garen,628,285,343,45.38
Yasuo,Belveth,69,34,35,49.28
Yasuo,Malzahar,390,208,182,53.33
Yasuo,Varus,406,227,179,55.91
Yasuo,Kayn,553,260,293,47.02
Yasuo,KogMaw,104,42,62,40.38
Yasuo,Nocturne,482,218,264,45.23
Yasuo,Viktor,316,155,161,49.05
Yasuo,Gangplank,157,82,75,52.23
Yasuo,LeeSin,723,387,336,53.53
Yasuo,Anivia,168,87,81,51.79
Yasuo,Kennen,107,39,68,36.45
Yasuo,Talon,241,139,102,57.68
Yasuo,Aphelios,254,132,122,51.97
Yasuo,Pyke,275,131,144,47.64
Yasuo,Gwen,161,79,82,49.07
Yasuo,Kayle,213,102,111,47.89
Yasuo,Zed,525,247,278,47.05
Yasuo,Tristana,329,167,162,50.76
Yasuo,Mel,877,449,428,51.2
Yasuo,Soraka,196,90,106,45.92
Yasuo,Chogath,443,228,215,51.47
Yasuo,Singed,112,70,42,62.5
Yasuo,Zyra,280,142,138,50.71
Yasuo,Darius,757,365,392,48.22
Yasuo,Blitzcrank,386,175,211,45.34
Yasuo,Sejuani,225,124,101,55.11
Yasuo,Irelia,288,167,121,57.99
Yasuo,Aurora,290,155,135,53.45
Yasuo,Smolder,314,141,173,44.9
Yasuo,Nami,363,193,170,53.17
Yasuo,Samira,298,172,126,57.72
Yasuo,Pantheon,659,331,328,50.23
Yasuo,Taliyah,101,57,44,56.44
Yasuo,MissFortune,723,352,371,48.69
Yasuo,Orianna,148,71,77,47.97
Yasuo,Velkoz,202,88,114,43.56
Yasuo,Gnar,214,120,94,56.07
Yasuo,Lillia,230,103,127,44.78
Yasuo,Malphite,497,249,248,50.1
Yasuo,Galio,424,200,224,47.17
Yasuo,Khazix,175,95,80,54.29
Yasuo,Gragas,251,116,135,46.22
Yasuo,Neeko,217,101,116,46.54
Yasuo,Jayce,182,100,82,54.95
Yasuo,Milio,251,114,137,45.42
Yasuo,Nasus,238,136,102,57.14
Yasuo,Vi,430,217,213,50.47
Yasuo,Maokai,171,81,90,47.37
Yasuo,Warwick,548,271,277,49.45
Yasuo,Graves,255,98,157,38.43
Yasuo,Xerath,312,170,142,54.49
Yasuo,Draven,203,99,104,48.77
Yasuo,Nunu,176,109,67,61.93
Yasuo,Zoe,148,91,57,61.49
Yasuo,TahmKench,330,188,142,56.97
Yasuo,MonkeyKing,248,116,132,46.77
Yasuo,Zac,252,118,134,46.83
Yasuo,Lucian,322,170,152,52.8
Yasuo,Swain,375,187,188,49.87
Yasuo,Ornn,242,108,134,44.63
Yasuo,Ahri,465,229,236,49.25
Yasuo,Sylas,656,371,285,56.55
Yasuo,Briar,203,81,122,39.9
Yasuo,Braum,322,173,149,53.73
Yasuo,Jax,355,170,185,47.89
Yasuo,Trundle,178,105,73,58.99
Yasuo,Syndra,220,99,121,45
Yasuo,Viego,497,226,271,45.47
Yasuo,JarvanIV,255,129,126,50.59
Yasuo,Yorick,318,157,161,49.37
Yasuo,Brand,172,85,87,49.42
Yasuo,Corki,172,109,63,63.37
Yasuo,Senna,204,108,96,52.94
Yasuo,Twitch,261,128,133,49.04
Yasuo,Alistar,225,108,117,48
Yasuo,Rengar,136,86,50,63.24
Yasuo,AurelionSol,131,51,80,38.93
Yasuo,Nautilus,532,261,271,49.06
Yasuo,Illaoi,187,98,89,52.41
Yasuo,Rakan,196,100,96,51.02
Yasuo,Ivern,89,58,31,65.17
Yasuo,Sivir,180,75,105,41.67
Yasuo,Fiora,145,82,63,56.55
Yasuo,Kindred,153,89,64,58.17
Yasuo,Bard,94,51,43,54.26
Yasuo,Urgot,144,71,73,49.31
Yasuo,Evelynn,139,78,61,56.12
Yasuo,Kalista,126,64,62,50.79
Yasuo,Azir,166,75,91,45.18
Yasuo,Kled,58,18,40,31.03
Yasuo,Zeri,168,86,82,51.19
Yasuo,Tryndamere,122,53,69,43.44
Yasuo,Kassadin,65,20,45,30.77
Yasuo,Lissandra,181,106,75,58.56
Yasuo,RekSai,60,27,33,45
Yasuo,Taric,78,41,37,52.56
Yasuo,Skarner,128,68,60,53.13
Yasuo,Nilah,155,62,93,40
Yasuo,Leblanc,213,108,105,50.7
Yasuo,Ryze,152,64,88,42.11
Yasuo,Nidalee,97,68,29,70.1
Yasuo,Rell,250,134,116,53.6
Yasuo,Shyvana,103,51,52,49.51
Yasuo,Rumble,117,69,48,58.97
Yasuo,Elise,290,144,146,49.66
Yasuo,Cassiopeia,90,42,48,46.67
Yasuo,Olaf,99,42,57,42.42
Yasuo,Camille,137,80,57,58.39
Yasuo,Quinn,105,55,50,52.38
Yasuo,Akshan,114,71,43,62.28
Yasuo,Naafiri,99,37,62,37.37
Yasuo,Karthus,74,37,37,50
Ezreal,Ambessa,404,177,227,43.81
Ezreal,Volibear,406,184,222,45.32
Ezreal,Veigar,428,223,205,52.1
Ezreal,Vayne,678,288,390,42.48
Ezreal,Seraphine,303,134,169,44.22
Ezreal,Teemo,412,201,211,48.79
Ezreal,Kayn,539,281,258,52.13
Ezreal,Yone,952,498,454,52.31
Ezreal,Ryze,223,112,111,50.22
Ezreal,Lux,1064,511,553,48.03
Ezreal,Maokai,232,119,113,51.29
Ezreal,Viego,696,311,385,44.68
Ezreal,Viktor,561,253,308,45.1
Ezreal,Smolder,364,179,185,49.18
Ezreal,Nami,374,156,218,41.71
Ezreal,Olaf,156,75,81,48.08
Ezreal,Yasuo,879,424,455,48.24
Ezreal,Galio,601,319,282,53.08
Ezreal,Velkoz,247,111,136,44.94
Ezreal,Yorick,343,170,173,49.56
Ezreal,Warwick,602,293,309,48.67
Ezreal,Akali,438,236,202,53.88
Ezreal,Jhin,1006,520,486,51.69
Ezreal,Braum,374,171,203,45.72
Ezreal,Jax,453,238,215,52.54
Ezreal,MasterYi,472,228,244,48.31
Ezreal,Caitlyn,1572,845,727,53.75
Ezreal,Malzahar,468,224,244,47.86
Ezreal,Morgana,489,198,291,40.49
Ezreal,Nasus,265,130,135,49.06
Ezreal,Shaco,394,224,170,56.85
Ezreal,Xerath,472,252,220,53.39
Ezreal,Lulu,792,353,439,44.57
Ezreal,Diana,797,396,401,49.69
Ezreal,Ashe,1250,617,633,49.36
Ezreal,Leblanc,288,158,130,54.86
Ezreal,Nautilus,662,330,332,49.85
Ezreal,Aatrox,524,282,242,53.82
Ezreal,Mel,1000,517,483,51.7
Ezreal,Tristana,359,208,151,57.94
Ezreal,Sona,81,49,32,60.49
Ezreal,Nidalee,225,147,78,65.33
Ezreal,Brand,276,122,154,44.2
Ezreal,Malphite,667,334,333,50.07
Ezreal,Ivern,98,46,52,46.94
Ezreal,Ahri,788,377,411,47.84
Ezreal,MonkeyKing,375,155,220,41.33
Ezreal,Rakan,320,172,148,53.75
Ezreal,Katarina,293,156,137,53.24
Ezreal,Taric,99,53,46,53.54
Ezreal,Zed,547,270,277,49.36
Ezreal,FiddleSticks,203,83,120,40.89
Ezreal,Darius,938,423,515,45.1
Ezreal,Nocturne,618,292,326,47.25
Ezreal,Lucian,464,246,218,53.02
Ezreal,Mordekaiser,574,291,283,50.7
Ezreal,Hecarim,133,72,61,54.14
Ezreal,Sett,696,357,339,51.29
Ezreal,Xayah,299,139,160,46.49
Ezreal,Cassiopeia,104,45,59,43.27
Ezreal,Gragas,438,254,184,57.99
Ezreal,TahmKench,459,196,263,42.7
Ezreal,Trundle,248,116,132,46.77
Ezreal,Vi,590,283,307,47.97
Ezreal,Jinx,1273,554,719,43.52
Ezreal,Khazix,262,140,122,53.44
Ezreal,Zilean,131,62,69,47.33
Ezreal,Kennen,195,89,106,45.64
Ezreal,XinZhao,364,195,169,53.57
Ezreal,Quinn,148,80,68,54.05
Ezreal,LeeSin,1067,558,509,52.3
Ezreal,Milio,291,152,139,52.23
Ezreal,Evelynn,104,43,61,41.35
Ezreal,Fizz,214,89,125,41.59
Ezreal,Aphelios,302,138,164,45.7
Ezreal,Soraka,201,94,107,46.77
Ezreal,JarvanIV,331,165,166,49.85
Ezreal,Rumble,160,83,77,51.88
Ezreal,Kayle,249,115,134,46.18
Ezreal,Vex,256,130,126,50.78
Ezreal,Riven,177,101,76,57.06
Ezreal,Vladimir,273,120,153,43.96
Ezreal,Ziggs,191,81,110,42.41
Ezreal,Heimerdinger,186,104,82,55.91
Ezreal,Kindred,202,110,92,54.46
Ezreal,MissFortune,1027,479,548,46.64
Ezreal,Neeko,249,123,126,49.4
Ezreal,Karma,670,354,316,52.84
Ezreal,Renekton,304,154,150,50.66
Ezreal,TwistedFate,172,80,92,46.51
Ezreal,Thresh,903,411,492,45.51
Ezreal,Urgot,184,80,104,43.48
Ezreal,Elise,465,212,253,45.59
Ezreal,Qiyana,146,73,73,50
Ezreal,Kalista,217,108,109,49.77
Ezreal,Illaoi,226,121,105,53.54
Ezreal,Nunu,336,173,163,51.49
Ezreal,Zoe,184,88,96,47.83
Ezreal,Draven,240,133,107,55.42
Ezreal,Leona,526,251,275,47.72
Ezreal,Yuumi,342,180,162,52.63
Ezreal,Sylas,842,416,426,49.41
Ezreal,Rammus,138,63,75,45.65
Ezreal,Zyra,367,178,189,48.5
Ezreal,Kaisa,1071,523,548,48.83
Ezreal,Fiora,171,64,107,37.43
Ezreal,Samira,358,162,196,45.25
Ezreal,Rell,323,167,156,51.7
Ezreal,Zac,262,132,130,50.38
Ezreal,Irelia,367,189,178,51.5
Ezreal,Varus,523,260,263,49.71
Ezreal,Chogath,583,251,332,43.05
Ezreal,Blitzcrank,578,298,280,51.56
Ezreal,Amumu,513,226,287,44.05
Ezreal,Jayce,326,147,179,45.09
Ezreal,Renata,108,44,64,40.74
Ezreal,Gwen,222,125,97,56.31
Ezreal,Poppy,256,129,127,50.39
Ezreal,Hwei,333,138,195,41.44
Ezreal,AurelionSol,165,73,92,44.24
Ezreal,Azir,232,121,111,52.16
Ezreal,Gangplank,200,91,109,45.5
Ezreal,Aurora,397,195,202,49.12
Ezreal,DrMundo,234,119,115,50.85
Ezreal,Briar,283,123,160,43.46
Ezreal,Udyr,180,95,85,52.78
Ezreal,Pantheon,797,398,399,49.94
Ezreal,Garen,750,347,403,46.27
Ezreal,Sion,422,201,221,47.63
Ezreal,Camille,215,98,117,45.58
Ezreal,Alistar,237,111,126,46.84
Ezreal,Graves,319,164,155,51.41
Ezreal,Lillia,261,149,112,57.09
Ezreal,Gnar,241,140,101,58.09
Ezreal,Sivir,312,131,181,41.99
Ezreal,Ekko,378,188,190,49.74
Ezreal,Orianna,262,155,107,59.16
Ezreal,Shen,332,128,204,38.55
Ezreal,Swain,396,178,218,44.95
Ezreal,Shyvana,105,49,56,46.67
Ezreal,Twitch,287,145,142,50.52
Ezreal,Sejuani,304,125,179,41.12
Ezreal,Talon,249,141,108,56.63
Ezreal,Karthus,129,80,49,62.02
Ezreal,Ornn,262,122,140,46.56
Ezreal,KSante,284,126,158,44.37
Ezreal,Kassadin,113,54,59,47.79
Ezreal,Nilah,128,62,66,48.44
Ezreal,Akshan,158,69,89,43.67
Ezreal,Janna,139,72,67,51.8
Ezreal,Syndra,314,153,161,48.73
Ezreal,Anivia,146,71,75,48.63
Ezreal,Zeri,270,123,147,45.56
Ezreal,Tryndamere,160,87,73,54.38
Ezreal,Belveth,94,49,45,52.13
Ezreal,RekSai,93,30,63,32.26
Ezreal,Pyke,473,251,222,53.07
Ezreal,Senna,280,143,137,51.07
Ezreal,Taliyah,132,65,67,49.24
Ezreal,Singed,110,65,45,59.09
Ezreal,Naafiri,132,66,66,50
Ezreal,Skarner,226,102,124,45.13
Ezreal,KogMaw,168,81,87,48.21
Ezreal,Rengar,143,80,63,55.94
Ezreal,Kled,78,41,37,52.56
Ezreal,Lissandra,179,90,89,50.28
Ezreal,Bard,125,67,58,53.6
Ezreal,Corki,217,115,102,53
Ezreal,Annie,158,72,86,45.57
Lux,Ambessa,364,181,183,49.73
Lux,Volibear,553,231,322,41.77
Lux,Veigar,566,296,270,52.3
Lux,Vayne,521,261,260,50.1
Lux,Seraphine,453,213,240,47.02
Lux,Jax,417,224,193,53.72
Lux,Sejuani,325,141,184,43.38
Lux,Hwei,308,149,159,48.38
Lux,Ezreal,1064,553,511,51.97
Lux,Zac,236,89,147,37.71
Lux,Chogath,487,238,249,48.87
Lux,Lillia,236,132,104,55.93
Lux,Tryndamere,183,86,97,46.99
Lux,Caitlyn,1250,624,626,49.92
Lux,Karma,535,239,296,44.67
Lux,Malphite,497,266,231,53.52
Lux,Vi,470,219,251,46.6
Lux,Sivir,257,104,153,40.47
Lux,Senna,295,144,151,48.81
Lux,Riven,192,98,94,51.04
Lux,Poppy,304,138,166,45.39
Lux,Ziggs,223,122,101,54.71
Lux,Yuumi,354,176,178,49.72
Lux,Quinn,152,69,83,45.39
Lux,Leblanc,256,153,103,59.77
Lux,Twitch,327,162,165,49.54
Lux,Nautilus,661,295,366,44.63
Lux,Jayce,209,96,113,45.93
Lux,Hecarim,117,43,74,36.75
Lux,Milio,282,129,153,45.74
Lux,Zoe,199,77,122,38.69
Lux,Gnar,232,118,114,50.86
Lux,Viktor,415,185,230,44.58
Lux,MissFortune,957,428,529,44.72
Lux,Rell,254,127,127,50
Lux,Nasus,301,136,165,45.18
Lux,Malzahar,510,197,313,38.63
Lux,TwistedFate,146,70,76,47.95
Lux,Mordekaiser,597,315,282,52.76
Lux,Zed,551,213,338,38.66
Lux,Varus,387,230,157,59.43
Lux,Pyke,411,186,225,45.26
Lux,MasterYi,431,214,217,49.65
Lux,Morgana,577,282,295,48.87
Lux,Yasuo,883,426,457,48.24
Lux,Diana,703,315,388,44.81
Lux,Naafiri,130,56,74,43.08
Lux,Azir,202,103,99,50.99
Lux,MonkeyKing,289,153,136,52.94
Lux,Mel,868,391,477,45.05
Lux,Irelia,298,144,154,48.32
Lux,LeeSin,683,362,321,53
Lux,Katarina,304,135,169,44.41
Lux,Blitzcrank,472,222,250,47.03
Lux,Kayle,277,135,142,48.74
Lux,Viego,524,250,274,47.71
Lux,Jhin,845,381,464,45.09
Lux,Braum,289,133,156,46.02
Lux,TahmKench,473,197,276,41.65
Lux,Orianna,246,122,124,49.59
Lux,Camille,185,94,91,50.81
Lux,Graves,260,121,139,46.54
Lux,Nilah,179,84,95,46.93
Lux,Nami,481,253,228,52.6
Lux,Gangplank,226,109,117,48.23
Lux,Shaco,400,202,198,50.5
Lux,KSante,270,133,137,49.26
Lux,Yone,805,436,369,54.16
Lux,Zilean,134,51,83,38.06
Lux,Cassiopeia,101,58,43,57.43
Lux,Thresh,872,455,417,52.18
Lux,Lulu,642,321,321,50
Lux,Kindred,201,119,82,59.2
Lux,Jinx,1120,503,617,44.91
Lux,Trundle,274,141,133,51.46
Lux,Yorick,406,196,210,48.28
Lux,Nunu,301,149,152,49.5
Lux,Bard,190,77,113,40.53
Lux,Khazix,325,138,187,42.46
Lux,Smolder,356,163,193,45.79
Lux,Heimerdinger,223,126,97,56.5
Lux,Briar,260,122,138,46.92
Lux,Leona,460,247,213,53.7
Lux,Gragas,387,215,172,55.56
Lux,Qiyana,104,53,51,50.96
Lux,Kalista,125,77,48,61.6
Lux,Neeko,190,91,99,47.89
Lux,Darius,781,401,380,51.34
Lux,Warwick,569,227,342,39.89
Lux,Akali,465,203,262,43.66
Lux,Kaisa,681,340,341,49.93
Lux,Vladimir,274,120,154,43.8
Lux,Ekko,354,171,183,48.31
Lux,Soraka,288,139,149,48.26
Lux,Evelynn,146,83,63,56.85
Lux,Gwen,227,96,131,42.29
Lux,Renekton,217,100,117,46.08
Lux,JarvanIV,344,147,197,42.73
Lux,Janna,101,62,39,61.39
Lux,Akshan,145,84,61,57.93
Lux,Zeri,182,84,98,46.15
Lux,Rakan,241,115,126,47.72
Lux,Teemo,407,184,223,45.21
Lux,Alistar,214,107,107,50
Lux,Nocturne,487,235,252,48.25
Lux,Ashe,868,398,470,45.85
Lux,Pantheon,781,357,424,45.71
Lux,Xerath,432,194,238,44.91
Lux,Fizz,235,119,116,50.64
Lux,Garen,672,300,372,44.64
Lux,Rammus,142,74,68,52.11
Lux,Kled,74,50,24,67.57
Lux,Kayn,593,285,308,48.06
Lux,Maokai,230,143,87,62.17
Lux,Ryze,168,94,74,55.95
Lux,Tristana,402,208,194,51.74
Lux,Aatrox,457,214,243,46.83
Lux,Singed,120,56,64,46.67
Lux,Urgot,199,103,96,51.76
Lux,Lissandra,172,86,86,50
Lux,Brand,337,189,148,56.08
Lux,Velkoz,308,138,170,44.81
Lux,Elise,316,113,203,35.76
Lux,Rumble,102,57,45,55.88
Lux,Draven,196,97,99,49.49
Lux,Taric,104,48,56,46.15
Lux,Aurora,355,186,169,52.39
Lux,DrMundo,265,101,164,38.11
Lux,KogMaw,139,63,76,45.32
Lux,Ahri,696,366,330,52.59
Lux,Nidalee,176,100,76,56.82
Lux,Amumu,546,238,308,43.59
Lux,AurelionSol,217,98,119,45.16
Lux,Swain,417,194,223,46.52
Lux,Fiora,174,77,97,44.25
Lux,Rengar,166,96,70,57.83
Lux,Syndra,371,201,170,54.18
Lux,Sylas,637,270,367,42.39
Lux,Talon,233,123,110,52.79
Lux,Zyra,416,236,180,56.73
Lux,Samira,344,183,161,53.2
Lux,Vex,310,127,183,40.97
Lux,Kassadin,49,19,30,38.78
Lux,Lucian,373,202,171,54.16
Lux,Sett,622,267,355,42.93
Lux,Skarner,196,102,94,52.04
Lux,Corki,220,116,104,52.73
Lux,Shyvana,133,68,65,51.13
Lux,Ornn,315,140,175,44.44
Lux,Shen,289,138,151,47.75
Lux,Illaoi,250,116,134,46.4
Lux,XinZhao,267,138,129,51.69
Lux,FiddleSticks,165,75,90,45.45
Lux,Taliyah,115,73,42,63.48
Lux,Anivia,145,78,67,53.79
Lux,Aphelios,276,116,160,42.03
Lux,Belveth,101,53,48,52.48
Lux,Sion,422,204,218,48.34
Lux,Xayah,236,110,126,46.61
Lux,Karthus,94,47,47,50
Lux,Annie,142,68,74,47.89
Lux,Kennen,114,70,44,61.4
Lux,Renata,96,46,50,47.92
Lux,Galio,505,264,241,52.28
Lux,Sona,90,37,53,41.11
Lux,Olaf,117,47,70,40.17
Lux,Udyr,120,73,47,60.83
Lux,Ivern,64,30,34,46.88
Lux,RekSai,41,20,21,48.78
Mordekaiser,Ahri,374,198,176,52.94
Mordekaiser,Kayn,297,154,143,51.85
Mordekaiser,Mel,503,268,235,53.28
Mordekaiser,Caitlyn,623,341,282,54.74
Mordekaiser,Pyke,219,111,108,50.68
Mordekaiser,Darius,448,203,245,45.31
Mordekaiser,JarvanIV,157,78,79,49.68
Mordekaiser,Xerath,215,88,127,40.93
Mordekaiser,Yuumi,204,106,98,51.96
Mordekaiser,Jax,189,91,98,48.15
Mordekaiser,Udyr,66,36,30,54.55
Mordekaiser,Yone,459,211,248,45.97
Mordekaiser,Smolder,172,100,72,58.14
Mordekaiser,TahmKench,262,147,115,56.11
Mordekaiser,Nasus,177,78,99,44.07
Mordekaiser,FiddleSticks,118,76,42,64.41
Mordekaiser,Syndra,148,84,64,56.76
Mordekaiser,Seraphine,189,87,102,46.03
Mordekaiser,Volibear,362,166,196,45.86
Mordekaiser,Vi,295,140,155,47.46
Mordekaiser,Gragas,181,91,90,50.28
Mordekaiser,Lux,597,282,315,47.24
Mordekaiser,Diana,385,218,167,56.62
Mordekaiser,Yasuo,470,279,191,59.36
Mordekaiser,Nami,236,130,106,55.08
Mordekaiser,Trundle,130,60,70,46.15
Mordekaiser,Veigar,271,126,145,46.49
Mordekaiser,Ashe,455,231,224,50.77
Mordekaiser,Braum,196,105,91,53.57
Mordekaiser,Gangplank,89,46,43,51.69
Mordekaiser,Teemo,279,154,125,55.2
Mordekaiser,Nilah,100,54,46,54
Mordekaiser,Garen,449,221,228,49.22
Mordekaiser,Ezreal,574,283,291,49.3
Mordekaiser,Brand,145,78,67,53.79
Mordekaiser,Cassiopeia,73,28,45,38.36
Mordekaiser,Jinx,586,252,334,43
Mordekaiser,Morgana,269,115,154,42.75
Mordekaiser,Quinn,70,37,33,52.86
Mordekaiser,LeeSin,390,196,194,50.26
Mordekaiser,Akali,223,128,95,57.4
Mordekaiser,Milio,140,83,57,59.29
Mordekaiser,Chogath,347,172,175,49.57
Mordekaiser,Sivir,141,78,63,55.32
Mordekaiser,Tristana,209,107,102,51.2
Mordekaiser,Alistar,167,90,77,53.89
Mordekaiser,Gwen,151,68,83,45.03
Mordekaiser,Rammus,75,49,26,65.33
Mordekaiser,Zed,236,115,121,48.73
Mordekaiser,Sett,411,182,229,44.28
Mordekaiser,Warwick,466,239,227,51.29
Mordekaiser,Karma,239,133,106,55.65
Mordekaiser,Kayle,131,62,69,47.33
Mordekaiser,Irelia,190,94,96,49.47
Mordekaiser,MissFortune,585,266,319,45.47
Mordekaiser,Lulu,295,131,164,44.41
Mordekaiser,Aatrox,264,145,119,54.92
Mordekaiser,Sejuani,140,52,88,37.14
Mordekaiser,Malzahar,259,149,110,57.53
Mordekaiser,Blitzcrank,242,122,120,50.41
Mordekaiser,Graves,129,43,86,33.33
Mordekaiser,Ziggs,103,31,72,30.1
Mordekaiser,Hwei,167,76,91,45.51
Mordekaiser,Zoe,121,56,65,46.28
Mordekaiser,Katarina,155,78,77,50.32
Mordekaiser,Rumble,70,40,30,57.14
Mordekaiser,Pantheon,418,223,195,53.35
Mordekaiser,Nunu,157,78,79,49.68
Mordekaiser,Thresh,418,218,200,52.15
Mordekaiser,Fizz,101,62,39,61.39
Mordekaiser,Soraka,111,62,49,55.86
Mordekaiser,Gnar,129,73,56,56.59
Mordekaiser,Aurora,180,68,112,37.78
Mordekaiser,Illaoi,180,104,76,57.78
Mordekaiser,MasterYi,219,103,116,47.03
Mordekaiser,Lucian,214,118,96,55.14
Mordekaiser,Jayce,86,40,46,46.51
Mordekaiser,Viego,303,154,149,50.83
Mordekaiser,Galio,289,151,138,52.25
Mordekaiser,Draven,126,66,60,52.38
Mordekaiser,Urgot,130,62,68,47.69
Mordekaiser,Amumu,313,152,161,48.56
Mordekaiser,Nocturne,314,141,173,44.9
Mordekaiser,Lissandra,86,40,46,46.51
Mordekaiser,Kennen,81,43,38,53.09
Mordekaiser,Varus,267,134,133,50.19
Mordekaiser,Xayah,122,52,70,42.62
Mordekaiser,Fiora,127,71,56,55.91
Mordekaiser,Rengar,78,48,30,61.54
Mordekaiser,Shyvana,57,31,26,54.39
Mordekaiser,Shaco,195,114,81,58.46
Mordekaiser,Swain,248,120,128,48.39
Mordekaiser,Heimerdinger,108,42,66,38.89
Mordekaiser,Yorick,219,93,126,42.47
Mordekaiser,Velkoz,132,69,63,52.27
Mordekaiser,Vladimir,134,71,63,52.99
Mordekaiser,Ryze,88,42,46,47.73
Mordekaiser,Khazix,138,70,68,50.72
Mordekaiser,Jhin,442,215,227,48.64
Mordekaiser,Ambessa,153,88,65,57.52
Mordekaiser,Senna,180,106,74,58.89
Mordekaiser,Leblanc,185,107,78,57.84
Mordekaiser,Corki,112,82,30,73.21
Mordekaiser,Sona,54,30,24,55.56
Mordekaiser,Zyra,215,107,108,49.77
Mordekaiser,DrMundo,158,59,99,37.34
Mordekaiser,Olaf,114,52,62,45.61
Mordekaiser,Rakan,149,73,76,48.99
Mordekaiser,Taliyah,65,29,36,44.62
Mordekaiser,Samira,205,89,116,43.41
Mordekaiser,Azir,110,59,51,53.64
Mordekaiser,Shen,183,93,90,50.82
Mordekaiser,Briar,187,92,95,49.2
Mordekaiser,RekSai,39,15,24,38.46
Mordekaiser,Viktor,206,94,112,45.63
Mordekaiser,Belveth,52,24,28,46.15
Mordekaiser,Malphite,287,174,113,60.63
Mordekaiser,Kindred,101,46,55,45.54
Mordekaiser,MonkeyKing,160,67,93,41.88
Mordekaiser,Ekko,154,64,90,41.56
Mordekaiser,Riven,105,46,59,43.81
Mordekaiser,Sylas,329,162,167,49.24
Mordekaiser,Kaisa,365,187,178,51.23
Mordekaiser,Poppy,166,85,81,51.2
Mordekaiser,Naafiri,94,47,47,50
Mordekaiser,Vex,130,48,82,36.92
Mordekaiser,Tryndamere,129,66,63,51.16
Mordekaiser,Lillia,114,51,63,44.74
Mordekaiser,KogMaw,86,41,45,47.67
Mordekaiser,Sion,242,142,100,58.68
Mordekaiser,Nautilus,342,188,154,54.97
Mordekaiser,Zeri,95,51,44,53.68
Mordekaiser,Qiyana,45,31,14,68.89
Mordekaiser,Zac,159,93,66,58.49
Mordekaiser,Kassadin,57,30,27,52.63
Mordekaiser,Hecarim,70,32,38,45.71
Mordekaiser,Janna,79,30,49,37.97
Mordekaiser,Ornn,193,83,110,43.01
Mordekaiser,Singed,56,15,41,26.79
Mordekaiser,Anivia,82,37,45,45.12
Mordekaiser,Leona,223,106,117,47.53
Mordekaiser,Orianna,133,64,69,48.12
Mordekaiser,Vayne,379,181,198,47.76
Mordekaiser,Talon,109,56,53,51.38
Mordekaiser,Akshan,90,41,49,45.56
Mordekaiser,Twitch,154,81,73,52.6
Mordekaiser,Neeko,131,54,77,41.22
Mordekaiser,Skarner,146,71,75,48.63
Mordekaiser,Aphelios,95,60,35,63.16
Mordekaiser,Nidalee,84,36,48,42.86
Mordekaiser,Kalista,96,45,51,46.88
Mordekaiser,KSante,242,123,119,50.83
Mordekaiser,Renata,59,33,26,55.93
Mordekaiser,XinZhao,183,84,99,45.9
Mordekaiser,Elise,180,74,106,41.11
Mordekaiser,Rell,199,81,118,40.7
Mordekaiser,Maokai,134,74,60,55.22
Mordekaiser,Annie,68,40,28,58.82
Mordekaiser,Ivern,59,36,23,61.02
Mordekaiser,Kled,65,28,37,43.08
Mordekaiser,Bard,76,36,40,47.37
Mordekaiser,TwistedFate,81,51,30,62.96
Mordekaiser,Karthus,71,32,39,45.07
Mordekaiser,Evelynn,81,58,23,71.6
Mordekaiser,Renekton,99,44,55,44.44
Mordekaiser,AurelionSol,115,61,54,53.04
Mordekaiser,Camille,69,41,28,59.42
Mordekaiser,Zilean,59,33,26,55.93
Mordekaiser,Taric,35,13,22,37.14
Evelynn,Ahri,103,57,46,55.34
Evelynn,Kayn,86,38,48,44.19
Evelynn,Mel,167,94,73,56.29
Evelynn,Caitlyn,181,98,83,54.14
Evelynn,Pyke,39,22,17,56.41
Evelynn,Pantheon,97,41,56,42.27
Evelynn,Ekko,50,23,27,46
Evelynn,Talon,29,14,15,48.28
Evelynn,Kaisa,112,52,60,46.43
Evelynn,Soraka,26,12,14,46.15
Evelynn,KSante,36,13,23,36.11
Evelynn,Viego,84,42,42,50
Evelynn,Kassadin,18,9,9,50
Evelynn,Nasus,46,21,25,45.65
Evelynn,Bard,31,12,19,38.71
Evelynn,Singed,19,12,7,63.16
Evelynn,Darius,114,60,54,52.63
Evelynn,Smolder,54,23,31,42.59
Evelynn,XinZhao,32,10,22,31.25
Evelynn,Malzahar,67,32,35,47.76
Evelynn,Vayne,72,42,30,58.33
Evelynn,Rell,40,21,19,52.5
Evelynn,Gwen,30,10,20,33.33
Evelynn,Vladimir,35,21,14,60
Evelynn,Ezreal,104,61,43,58.65
Evelynn,Lux,146,63,83,43.15
Evelynn,Chogath,76,45,31,59.21
Evelynn,Khazix,42,30,12,71.43
Evelynn,Swain,79,33,46,41.77
Evelynn,Jhin,123,75,48,60.98
Evelynn,Karma,90,43,47,47.78
Evelynn,Diana,134,60,74,44.78
Evelynn,Velkoz,24,16,8,66.67
Evelynn,Ashe,97,32,65,32.99
Evelynn,MissFortune,98,46,52,46.94
Evelynn,Garen,78,36,42,46.15
Evelynn,Leblanc,27,19,8,70.37
Evelynn,Corki,31,26,5,83.87
Evelynn,Blitzcrank,66,42,24,63.64
Evelynn,Sett,89,46,43,51.69
Evelynn,LeeSin,87,38,49,43.68
Evelynn,Galio,66,34,32,51.52
Evelynn,Tristana,65,34,31,52.31
Evelynn,Brand,38,25,13,65.79
Evelynn,Aatrox,46,27,19,58.7
Evelynn,Sylas,72,35,37,48.61
Evelynn,Irelia,45,24,21,53.33
Evelynn,Zilean,28,19,9,67.86
Evelynn,Zac,31,14,17,45.16
Evelynn,Veigar,49,16,33,32.65
Evelynn,Gragas,59,37,22,62.71
Evelynn,Thresh,87,45,42,51.72
Evelynn,Jax,48,29,19,60.42
Evelynn,Nocturne,72,40,32,55.56
Evelynn,Zeri,33,15,18,45.45
Evelynn,Alistar,41,28,13,68.29
Evelynn,Yasuo,139,61,78,43.88
Evelynn,Poppy,32,16,16,50
Evelynn,Zed,49,24,25,48.98
Evelynn,Nautilus,83,40,43,48.19
Evelynn,MonkeyKing,25,14,11,56
Evelynn,Hwei,36,20,16,55.56
Evelynn,Trundle,24,10,14,41.67
Evelynn,Sejuani,59,33,26,55.93
Evelynn,Anivia,24,12,12,50
Evelynn,Braum,40,12,28,30
Evelynn,Cassiopeia,13,11,2,84.62
Evelynn,Warwick,55,21,34,38.18
Evelynn,Taliyah,12,6,6,50
Evelynn,Nami,90,40,50,44.44
Evelynn,Orianna,29,25,4,86.21
Evelynn,Neeko,33,19,14,57.58
Evelynn,Shyvana,9,0,9,0
Evelynn,Katarina,23,11,12,47.83
Evelynn,Draven,30,19,11,63.33
Evelynn,Malphite,56,33,23,58.93
Evelynn,Jinx,114,54,60,47.37
Evelynn,Milio,42,24,18,57.14
Evelynn,Akali,49,23,26,46.94
Evelynn,Vex,43,21,22,48.84
Evelynn,Morgana,60,33,27,55
Evelynn,Yorick,37,19,18,51.35
Evelynn,Nunu,71,32,39,45.07
Evelynn,AurelionSol,28,7,21,25
Evelynn,Gangplank,35,13,22,37.14
Evelynn,Fizz,41,20,21,48.78
Evelynn,Seraphine,45,23,22,51.11
Evelynn,DrMundo,36,19,17,52.78
Evelynn,Volibear,71,38,33,53.52
Evelynn,Ivern,18,9,9,50
Evelynn,Azir,36,19,17,52.78
Evelynn,FiddleSticks,31,14,17,45.16
Evelynn,Lucian,41,16,25,39.02
Evelynn,Riven,21,11,10,52.38
Evelynn,Aphelios,26,19,7,73.08
Evelynn,Renekton,17,8,9,47.06
Evelynn,Senna,39,14,25,35.9
Evelynn,Rammus,10,8,2,80
Evelynn,Kayle,14,11,3,78.57
Evelynn,Vi,51,16,35,31.37
Evelynn,Sion,50,25,25,50
Evelynn,Graves,26,21,5,80.77
Evelynn,Nilah,17,8,9,47.06
Evelynn,MasterYi,60,31,29,51.67
Evelynn,Fiora,35,25,10,71.43
Evelynn,Amumu,76,36,40,47.37
Evelynn,Viktor,56,31,25,55.36
Evelynn,Shen,47,27,20,57.45
Evelynn,Xayah,40,20,20,50
Evelynn,Rakan,24,15,9,62.5
Evelynn,Karthus,19,8,11,42.11
Evelynn,Varus,80,30,50,37.5
Evelynn,Udyr,32,19,13,59.38
Evelynn,Sona,6,0,6,0
Evelynn,Urgot,56,32,24,57.14
Evelynn,Aurora,47,32,15,68.09
Evelynn,Heimerdinger,25,11,14,44
Evelynn,Twitch,51,24,27,47.06
Evelynn,Lulu,67,25,42,37.31
Evelynn,Akshan,16,5,11,31.25
Evelynn,Shaco,54,26,28,48.15
Evelynn,Ambessa,32,12,20,37.5
Evelynn,Briar,55,29,26,52.73
Evelynn,Syndra,47,25,22,53.19
Evelynn,Xerath,52,20,32,38.46
Evelynn,Mordekaiser,81,23,58,28.4
Evelynn,Gnar,24,10,14,41.67
Evelynn,Teemo,53,11,42,20.75
Evelynn,Rumble,10,5,5,50
Evelynn,Hecarim,24,19,5,79.17
Evelynn,Elise,45,34,11,75.56
Evelynn,Sivir,28,20,8,71.43
Evelynn,Camille,14,7,7,50
Evelynn,Yone,87,50,37,57.47
Evelynn,TahmKench,44,26,18,59.09
Evelynn,Yuumi,27,13,14,48.15
Evelynn,Lissandra,29,10,19,34.48
Evelynn,Zoe,23,11,12,47.83
Evelynn,Samira,32,23,9,71.88
Evelynn,Renata,19,8,11,42.11
Evelynn,Kindred,20,6,14,30
Evelynn,Leona,37,14,23,37.84
Evelynn,Janna,21,9,12,42.86
Evelynn,Kennen,21,11,10,52.38
Evelynn,Zyra,32,19,13,59.38
Evelynn,Maokai,34,18,16,52.94
Evelynn,RekSai,12,0,12,0
Evelynn,Ziggs,10,3,7,30
Evelynn,Rengar,21,13,8,61.9
Evelynn,Olaf,7,5,2,71.43
Evelynn,Kalista,15,11,4,73.33
Evelynn,Ornn,39,20,19,51.28
Evelynn,Annie,13,7,6,53.85
Evelynn,Qiyana,9,4,5,44.44
Evelynn,JarvanIV,28,12,16,42.86
Evelynn,TwistedFate,23,12,11,52.17
Evelynn,Naafiri,13,4,9,30.77
Evelynn,Taric,9,4,5,44.44
Evelynn,Ryze,11,5,6,45.45
Evelynn,Quinn,21,14,7,66.67
Evelynn,Jayce,15,8,7,53.33
Evelynn,Tryndamere,31,11,20,35.48
Evelynn,Lillia,35,24,11,68.57
Evelynn,KogMaw,14,10,4,71.43
Evelynn,Illaoi,25,19,6,76
Evelynn,Skarner,14,7,7,50
Evelynn,Nidalee,10,2,8,20
Evelynn,Belveth,6,6,0,100
Evelynn,Kled,3,0,3,0
Riven,Ahri,117,43,74,36.75
Riven,Kayn,92,59,33,64.13
Riven,Mel,229,138,91,60.26
Riven,Caitlyn,227,110,117,48.46
Riven,Pyke,47,18,29,38.3
Riven,Garen,154,64,90,41.56
Riven,Warwick,96,54,42,56.25
Riven,Yasuo,131,69,62,52.67
Riven,MissFortune,153,70,83,45.75
Riven,Lux,192,94,98,48.96
Riven,Gangplank,44,22,22,50
Riven,LeeSin,145,85,60,58.62
Riven,Aurora,65,38,27,58.46
Riven,Ashe,162,102,60,62.96
Riven,Morgana,97,52,45,53.61
Riven,Darius,172,94,78,54.65
Riven,Vi,113,52,61,46.02
Riven,Malzahar,100,63,37,63
Riven,Aphelios,42,20,22,47.62
Riven,Soraka,57,29,28,50.88
Riven,Diana,125,46,79,36.8
Riven,Naafiri,29,18,11,62.07
Riven,Azir,36,16,20,44.44
Riven,Shaco,47,21,26,44.68
Riven,Veigar,82,39,43,47.56
Riven,Yuumi,58,22,36,37.93
Riven,Teemo,49,22,27,44.9
Riven,Rammus,31,10,21,32.26
Riven,Leblanc,35,16,19,45.71
Riven,Karma,135,75,60,55.56
Riven,Illaoi,38,17,21,44.74
Riven,Nunu,50,13,37,26
Riven,Rell,60,30,30,50
Riven,Renekton,53,24,29,45.28
Riven,Elise,88,37,51,42.05
Riven,Ezreal,177,76,101,42.94
Riven,Malphite,87,40,47,45.98
Riven,Sejuani,60,31,29,51.67
Riven,Ekko,73,31,42,42.47
Riven,Graves,71,30,41,42.25
Riven,Xerath,57,40,17,70.18
Riven,Draven,50,30,20,60
Riven,Thresh,135,71,64,52.59
Riven,Skarner,47,26,21,55.32
Riven,Hwei,59,44,15,74.58
Riven,KogMaw,19,11,8,57.89
Riven,Nautilus,115,54,61,46.96
Riven,Maokai,39,25,14,64.1
Riven,Zeri,31,13,18,41.94
Riven,Vayne,123,59,64,47.97
Riven,Sylas,125,67,58,53.6
Riven,Braum,61,28,33,45.9
Riven,Fiora,53,37,16,69.81
Riven,Samira,52,30,22,57.69
Riven,Gragas,50,29,21,58
Riven,Tryndamere,20,7,13,35
Riven,Urgot,57,31,26,54.39
Riven,Syndra,55,23,32,41.82
Riven,Milio,73,41,32,56.16
Riven,Pantheon,115,66,49,57.39
Riven,Trundle,27,10,17,37.04
Riven,Kaisa,141,78,63,55.32
Riven,Nidalee,29,18,11,62.07
Riven,Blitzcrank,86,50,36,58.14
Riven,MasterYi,70,40,30,57.14
Riven,Zed,98,55,43,56.12
Riven,Rakan,39,18,21,46.15
Riven,Kled,14,3,11,21.43
Riven,Briar,63,35,28,55.56
Riven,Velkoz,34,14,20,41.18
Riven,Ornn,43,30,13,69.77
Riven,Akali,76,40,36,52.63
Riven,Aatrox,60,28,32,46.67
Riven,Yone,110,65,45,59.09
Riven,Lulu,85,46,39,54.12
Riven,Lucian,93,50,43,53.76
Riven,Kassadin,25,14,11,56
Riven,Neeko,37,18,19,48.65
Riven,Senna,44,20,24,45.45
Riven,Zac,50,31,19,62
Riven,Akshan,27,19,8,70.37
Riven,DrMundo,18,13,5,72.22
Riven,Jhin,147,90,57,61.22
Riven,Sion,64,34,30,53.13
Riven,Varus,90,40,50,44.44
Riven,JarvanIV,70,47,23,67.14
Riven,Fizz,49,25,24,51.02
Riven,Seraphine,96,39,57,40.63
Riven,Mordekaiser,105,59,46,56.19
Riven,Talon,40,26,14,65
Riven,Jax,78,43,35,55.13
Riven,Khazix,48,29,19,60.42
Riven,TahmKench,65,23,42,35.38
Riven,MonkeyKing,79,41,38,51.9
Riven,Yorick,63,31,32,49.21
Riven,Kayle,40,22,18,55
Riven,Shen,61,29,32,47.54
Riven,Volibear,60,27,33,45
Riven,Zilean,19,10,9,52.63
Riven,KSante,48,17,31,35.42
Riven,Smolder,38,13,25,34.21
Riven,Lissandra,46,27,19,58.7
Riven,Karthus,26,8,18,30.77
Riven,Alistar,31,14,17,45.16
Riven,Amumu,94,31,63,32.98
Riven,Poppy,68,35,33,51.47
Riven,Ryze,32,14,18,43.75
Riven,Vex,24,8,16,33.33
Riven,Lillia,39,19,20,48.72
Riven,Jinx,219,108,111,49.32
Riven,AurelionSol,26,12,14,46.15
Riven,Nocturne,113,63,50,55.75
Riven,Katarina,67,37,30,55.22
Riven,Chogath,109,47,62,43.12
Riven,Evelynn,21,10,11,47.62
Riven,Ziggs,29,20,9,68.97
Riven,Ambessa,86,40,46,46.51
Riven,Galio,95,49,46,51.58
Riven,Xayah,33,22,11,66.67
Riven,Renata,28,17,11,60.71
Riven,Singed,23,11,12,47.83
Riven,Zoe,29,8,21,27.59
Riven,Tristana,78,34,44,43.59
Riven,Viktor,82,38,44,46.34
Riven,Sona,21,8,13,38.1
Riven,Gnar,40,23,17,57.5
Riven,Annie,19,11,8,57.89
Riven,Janna,21,8,13,38.1
Riven,Kindred,31,15,16,48.39
Riven,Nasus,59,27,32,45.76
Riven,Irelia,45,27,18,60
Riven,Nami,87,53,34,60.92
Riven,Rengar,25,9,16,36
Riven,Qiyana,16,8,8,50
Riven,Cassiopeia,15,9,6,60
Riven,Hecarim,16,6,10,37.5
Riven,TwistedFate,17,12,5,70.59
Riven,Zyra,50,25,25,50
Riven,Twitch,60,37,23,61.67
Riven,Kalista,14,8,6,57.14
Riven,Brand,42,32,10,76.19
Riven,Orianna,32,19,13,59.38
Riven,Camille,39,24,15,61.54
Riven,Leona,65,35,30,53.85
Riven,Sett,120,62,58,51.67
Riven,Sivir,42,13,29,30.95
Riven,Rumble,8,3,5,37.5
Riven,Kennen,12,9,3,75
Riven,Jayce,33,11,22,33.33
Riven,FiddleSticks,45,14,31,31.11
Riven,Anivia,14,6,8,42.86
Riven,Swain,56,25,31,44.64
Riven,Viego,78,39,39,50
Riven,XinZhao,65,30,35,46.15
Riven,Belveth,10,3,7,30
Riven,Heimerdinger,16,7,9,43.75
Riven,Corki,32,16,16,50
Riven,Taric,26,3,23,11.54
Riven,Vladimir,54,33,21,61.11
Riven,Gwen,48,25,23,52.08
Riven,Udyr,19,12,7,63.16
Riven,Olaf,19,10,9,52.63
Riven,Quinn,16,4,12,25
Riven,Bard,26,13,13,50
Riven,Shyvana,8,4,4,50
Riven,Taliyah,9,4,5,44.44
Riven,Ivern,22,12,10,54.55
Riven,RekSai,8,0,8,0
Riven,Nilah,18,7,11,38.89
MissFortune,Ahri,553,240,313,43.4
MissFortune,Kayn,515,277,238,53.79
MissFortune,Mel,792,393,399,49.62
MissFortune,Caitlyn,1156,557,599,48.18
MissFortune,Pyke,316,183,133,57.91
MissFortune,Gangplank,212,102,110,48.11
MissFortune,Volibear,376,162,214,43.09
MissFortune,Irelia,272,143,129,52.57
MissFortune,Kaisa,602,294,308,48.84
MissFortune,Nautilus,496,265,231,53.43
MissFortune,Sett,662,313,349,47.28
MissFortune,Katarina,274,161,113,58.76
MissFortune,Jinx,1204,557,647,46.26
MissFortune,Renata,106,53,53,50
MissFortune,Riven,153,83,70,54.25
MissFortune,Poppy,270,150,120,55.56
MissFortune,Veigar,406,207,199,50.99
MissFortune,Ziggs,148,72,76,48.65
MissFortune,Yuumi,287,138,149,48.08
MissFortune,Sion,328,169,159,51.52
MissFortune,RekSai,65,27,38,41.54
MissFortune,Viktor,314,164,150,52.23
MissFortune,KogMaw,112,64,48,57.14
MissFortune,Ashe,824,441,383,53.52
MissFortune,Kennen,97,43,54,44.33
MissFortune,Vi,404,220,184,54.46
MissFortune,Lux,957,529,428,55.28
MissFortune,Leona,396,187,209,47.22
MissFortune,DrMundo,271,148,123,54.61
MissFortune,Sejuani,237,86,151,36.29
MissFortune,Nami,434,190,244,43.78
MissFortune,Gragas,255,133,122,52.16
MissFortune,Elise,324,180,144,55.56
MissFortune,Vayne,530,265,265,50
MissFortune,Zyra,309,172,137,55.66
MissFortune,Akali,405,215,190,53.09
MissFortune,Belveth,55,26,29,47.27
MissFortune,Varus,391,198,193,50.64
MissFortune,Jhin,768,405,363,52.73
MissFortune,Lulu,508,256,252,50.39
MissFortune,LeeSin,617,336,281,54.46
MissFortune,Hwei,246,129,117,52.44
MissFortune,Zilean,94,50,44,53.19
MissFortune,Amumu,445,225,220,50.56
MissFortune,Teemo,443,240,203,54.18
MissFortune,Khazix,186,92,94,49.46
MissFortune,Zoe,186,96,90,51.61
MissFortune,Darius,722,347,375,48.06
MissFortune,Kindred,177,95,82,53.67
MissFortune,Tristana,424,213,211,50.24
MissFortune,Neeko,202,109,93,53.96
MissFortune,Fizz,204,115,89,56.37
MissFortune,Udyr,139,74,65,53.24
MissFortune,Vex,241,133,108,55.19
MissFortune,Sona,58,29,29,50
MissFortune,Naafiri,147,63,84,42.86
MissFortune,Warwick,546,238,308,43.59
MissFortune,Janna,88,42,46,47.73
MissFortune,Malzahar,440,222,218,50.45
MissFortune,Garen,566,275,291,48.59
MissFortune,Lucian,309,159,150,51.46
MissFortune,Camille,156,80,76,51.28
MissFortune,Zed,378,201,177,53.17
MissFortune,Briar,241,139,102,57.68
MissFortune,Trundle,236,104,132,44.07
MissFortune,Aurora,308,169,139,54.87
MissFortune,Pantheon,593,300,293,50.59
MissFortune,Mordekaiser,585,319,266,54.53
MissFortune,Ekko,408,199,209,48.77
MissFortune,Samira,319,187,132,58.62
MissFortune,Shen,315,176,139,55.87
MissFortune,Viego,477,221,256,46.33
MissFortune,Yasuo,723,371,352,51.31
MissFortune,Shaco,305,152,153,49.84
MissFortune,Thresh,665,348,317,52.33
MissFortune,Singed,102,45,57,44.12
MissFortune,Yorick,342,167,175,48.83
MissFortune,Leblanc,227,142,85,62.56
MissFortune,Nocturne,443,252,191,56.88
MissFortune,Soraka,148,75,73,50.68
MissFortune,Malphite,413,206,207,49.88
MissFortune,FiddleSticks,181,79,102,43.65
MissFortune,Galio,445,191,254,42.92
MissFortune,Ezreal,1027,548,479,53.36
MissFortune,Chogath,522,258,264,49.43
MissFortune,Swain,388,176,212,45.36
MissFortune,Karma,472,267,205,56.57
MissFortune,Nasus,222,92,130,41.44
MissFortune,Xayah,235,127,108,54.04
MissFortune,Maokai,178,63,115,35.39
MissFortune,Heimerdinger,194,89,105,45.88
MissFortune,Akshan,126,57,69,45.24
MissFortune,Evelynn,98,52,46,53.06
MissFortune,Brand,258,144,114,55.81
MissFortune,Aatrox,354,166,188,46.89
MissFortune,Diana,610,306,304,50.16
MissFortune,TahmKench,325,165,160,50.77
MissFortune,Nidalee,114,61,53,53.51
MissFortune,Yone,741,387,354,52.23
MissFortune,Twitch,257,133,124,51.75
MissFortune,Rell,239,106,133,44.35
MissFortune,Quinn,102,34,68,33.33
MissFortune,Aphelios,175,76,99,43.43
MissFortune,Sylas,568,266,302,46.83
MissFortune,Braum,370,185,185,50
MissFortune,Morgana,437,204,233,46.68
MissFortune,Xerath,343,183,160,53.35
MissFortune,Smolder,295,143,152,48.47
MissFortune,Blitzcrank,393,205,188,52.16
MissFortune,Urgot,189,89,100,47.09
MissFortune,Karthus,79,37,42,46.84
MissFortune,Illaoi,215,114,101,53.02
MissFortune,MasterYi,417,213,204,51.08
MissFortune,Gwen,176,97,79,55.11
MissFortune,Kayle,212,93,119,43.87
MissFortune,Nunu,265,152,113,57.36
MissFortune,Lissandra,154,76,78,49.35
MissFortune,Orianna,238,118,120,49.58
MissFortune,Talon,207,126,81,60.87
MissFortune,Nilah,149,79,70,53.02
MissFortune,Sivir,244,122,122,50
MissFortune,Olaf,111,54,57,48.65
MissFortune,Vladimir,189,122,67,64.55
MissFortune,Ambessa,288,129,159,44.79
MissFortune,MonkeyKing,275,163,112,59.27
MissFortune,Rammus,126,72,54,57.14
MissFortune,Draven,214,104,110,48.6
MissFortune,JarvanIV,305,139,166,45.57
MissFortune,Rengar,134,71,63,52.99
MissFortune,Milio,260,117,143,45
MissFortune,Annie,105,55,50,52.38
MissFortune,Syndra,250,126,124,50.4
MissFortune,Velkoz,246,111,135,45.12
MissFortune,Seraphine,351,169,182,48.15
MissFortune,Jax,301,136,165,45.18
MissFortune,Kled,60,27,33,45
MissFortune,Corki,214,113,101,52.8
MissFortune,Ornn,239,133,106,55.65
MissFortune,Senna,230,119,111,51.74
MissFortune,Renekton,208,120,88,57.69
MissFortune,Graves,250,113,137,45.2
MissFortune,Lillia,241,110,131,45.64
MissFortune,AurelionSol,156,90,66,57.69
MissFortune,Cassiopeia,83,41,42,49.4
MissFortune,Fiora,124,54,70,43.55
MissFortune,Taliyah,68,32,36,47.06
MissFortune,Hecarim,162,73,89,45.06
MissFortune,Gnar,207,112,95,54.11
MissFortune,Zac,200,116,84,58
MissFortune,Tryndamere,176,79,97,44.89
MissFortune,Rakan,191,90,101,47.12
MissFortune,TwistedFate,144,69,75,47.92
MissFortune,Alistar,182,96,86,52.75
MissFortune,Ryze,126,67,59,53.17
MissFortune,Kalista,147,72,75,48.98
MissFortune,Taric,98,40,58,40.82
MissFortune,Azir,130,66,64,50.77
MissFortune,XinZhao,264,128,136,48.48
MissFortune,Ivern,81,55,26,67.9
MissFortune,Jayce,153,81,72,52.94
MissFortune,Rumble,117,57,60,48.72
MissFortune,Skarner,153,84,69,54.9
MissFortune,Kassadin,82,48,34,58.54
MissFortune,KSante,207,106,101,51.21
MissFortune,Bard,111,66,45,59.46
MissFortune,Qiyana,84,57,27,67.86
MissFortune,Zeri,125,72,53,57.6
MissFortune,Shyvana,86,37,49,43.02
MissFortune,Anivia,134,72,62,53.73
Swain,Ahri,253,131,122,51.78
Swain,Kayn,265,137,128,51.7
Swain,Mel,449,217,232,48.33
Swain,Caitlyn,482,245,237,50.83
Swain,Pyke,159,83,76,52.2
Swain,Darius,324,137,187,42.28
Swain,JarvanIV,109,68,41,62.39
Swain,Xerath,117,52,65,44.44
Swain,Yuumi,147,73,74,49.66
Swain,Yorick,158,94,64,59.49
Swain,Warwick,269,142,127,52.79
Swain,Akali,190,104,86,54.74
Swain,Jhin,345,201,144,58.26
Swain,Braum,169,92,77,54.44
Swain,Rell,126,54,72,42.86
Swain,Rengar,57,30,27,52.63
Swain,Sett,314,181,133,57.64
Swain,Varus,166,92,74,55.42
Swain,Gangplank,70,45,25,64.29
Swain,Pantheon,347,219,128,63.11
Swain,TwistedFate,86,52,34,60.47
Swain,Kaisa,276,177,99,64.13
Swain,Jayce,93,47,46,50.54
Swain,Sejuani,104,55,49,52.88
Swain,Fizz,93,52,41,55.91
Swain,Alistar,120,66,54,55
Swain,Gwen,130,72,58,55.38
Swain,Amumu,265,118,147,44.53
Swain,DrMundo,106,45,61,42.45
Swain,Tristana,183,104,79,56.83
Swain,Lulu,228,124,104,54.39
Swain,Nasus,140,72,68,51.43
Swain,Vi,207,123,84,59.42
Swain,Galio,259,133,126,51.35
Swain,Smolder,157,87,70,55.41
Swain,Kayle,88,36,52,40.91
Swain,Viktor,208,128,80,61.54
Swain,Ashe,433,242,191,55.89
Swain,Milio,153,83,70,54.25
Swain,Evelynn,79,46,33,58.23
Swain,MissFortune,388,212,176,54.64
Swain,Nidalee,60,44,16,73.33
Swain,Veigar,217,119,98,54.84
Swain,Chogath,246,147,99,59.76
Swain,Olaf,63,35,28,55.56
Swain,Yasuo,375,188,187,50.13
Swain,Draven,76,44,32,57.89
Swain,Morgana,191,101,90,52.88
Swain,Quinn,66,39,27,59.09
Swain,Naafiri,43,26,17,60.47
Swain,Lux,417,223,194,53.48
Swain,Jinx,496,247,249,49.8
Swain,Heimerdinger,113,67,46,59.29
Swain,Tryndamere,64,30,34,46.88
Swain,MonkeyKing,107,43,64,40.19
Swain,Malzahar,211,118,93,55.92
Swain,Mordekaiser,248,128,120,51.61
Swain,Trundle,87,51,36,58.62
Swain,Briar,123,54,69,43.9
Swain,Vex,134,71,63,52.99
Swain,Lillia,135,59,76,43.7
Swain,Nami,197,75,122,38.07
Swain,TahmKench,184,114,70,61.96
Swain,Talon,82,50,32,60.98
Swain,Vladimir,139,73,66,52.52
Swain,Ornn,106,67,39,63.21
Swain,Diana,274,140,134,51.09
Swain,Corki,91,47,44,51.65
Swain,Soraka,81,42,39,51.85
Swain,Camille,77,45,32,58.44
Swain,LeeSin,246,163,83,66.26
Swain,Zyra,173,115,58,66.47
Swain,Irelia,147,83,64,56.46
Swain,Gragas,119,72,47,60.5
Swain,Xayah,120,58,62,48.33
Swain,Thresh,427,249,178,58.31
Swain,Garen,298,154,144,51.68
Swain,Orianna,116,69,47,59.48
Swain,Brand,137,68,69,49.64
Swain,Jax,195,110,85,56.41
Swain,Urgot,96,50,46,52.08
Swain,Teemo,186,99,87,53.23
Swain,Renekton,106,58,48,54.72
Swain,Ryze,75,42,33,56
Swain,Karma,207,128,79,61.84
Swain,Ambessa,117,69,48,58.97
Swain,Aurora,197,100,97,50.76
Swain,Syndra,134,72,62,53.73
Swain,Nautilus,290,192,98,66.21
Swain,Yone,359,204,155,56.82
Swain,Samira,148,85,63,57.43
Swain,Gnar,124,72,52,58.06
Swain,Illaoi,95,44,51,46.32
Swain,Shaco,136,76,60,55.88
Swain,Lucian,207,99,108,47.83
Swain,Malphite,214,121,93,56.54
Swain,Seraphine,115,72,43,62.61
Swain,Aatrox,202,110,92,54.46
Swain,XinZhao,119,76,43,63.87
Swain,Kassadin,41,15,26,36.59
Swain,Leona,211,133,78,63.03
Swain,Leblanc,92,60,32,65.22
Swain,Shen,155,96,59,61.94
Swain,Fiora,89,58,31,65.17
Swain,FiddleSticks,87,50,37,57.47
Swain,Ezreal,396,218,178,55.05
Swain,Nocturne,231,114,117,49.35
Swain,Elise,161,74,87,45.96
Swain,Senna,110,56,54,50.91
Swain,Viego,247,125,122,50.61
Swain,Aphelios,115,66,49,57.39
Swain,Poppy,141,85,56,60.28
Swain,Rammus,76,42,34,55.26
Swain,Hwei,123,62,61,50.41
Swain,Twitch,108,50,58,46.3
Swain,Ekko,171,93,78,54.39
Swain,Vayne,257,122,135,47.47
Swain,Cassiopeia,44,17,27,38.64
Swain,Nunu,130,70,60,53.85
Swain,Katarina,103,61,42,59.22
Swain,Khazix,103,49,54,47.57
Swain,Sylas,272,151,121,55.51
Swain,AurelionSol,85,38,47,44.71
Swain,Janna,52,18,34,34.62
Swain,Karthus,44,28,16,63.64
Swain,Blitzcrank,150,77,73,51.33
Swain,Zac,90,53,37,58.89
Swain,Sion,146,73,73,50
Swain,Hecarim,67,39,28,58.21
Swain,Ziggs,64,39,25,60.94
Swain,Volibear,226,143,83,63.27
Swain,Rumble,69,48,21,69.57
Swain,Neeko,87,50,37,57.47
Swain,Sivir,90,46,44,51.11
Swain,Graves,102,55,47,53.92
Swain,Singed,52,31,21,59.62
Swain,Zilean,33,25,8,75.76
Swain,MasterYi,198,83,115,41.92
Swain,Kennen,68,45,23,66.18
Swain,Maokai,107,63,44,58.88
Swain,Akshan,67,38,29,56.72
Swain,Udyr,52,26,26,50
Swain,Azir,84,49,35,58.33
Swain,Qiyana,41,23,18,56.1
Swain,Ivern,51,28,23,54.9
Swain,Zed,155,84,71,54.19
Swain,KSante,145,82,63,56.55
Swain,Nilah,72,42,30,58.33
Swain,Bard,68,27,41,39.71
Swain,Skarner,58,38,20,65.52
Swain,Annie,63,41,22,65.08
Swain,Kalista,67,45,22,67.16
Swain,Taric,50,29,21,58
Swain,Shyvana,53,30,23,56.6
Swain,Velkoz,151,69,82,45.7
Swain,Riven,56,31,25,55.36
Swain,Zeri,88,51,37,57.95
Swain,Kindred,70,28,42,40
Swain,KogMaw,63,31,32,49.21
Swain,Rakan,100,55,45,55
Swain,Belveth,37,22,15,59.46
Swain,Anivia,65,37,28,56.92
Swain,Sona,20,14,6,70
Swain,Zoe,62,45,17,72.58
Swain,Lissandra,61,47,14,77.05
Swain,Taliyah,44,25,19,56.82
Swain,Renata,58,28,30,48.28
Swain,Kled,34,18,16,52.94
Swain,RekSai,17,3,14,17.65
Ahri,Mordekaiser,374,176,198,47.06
Ahri,Evelynn,103,46,57,44.66
Ahri,Riven,117,74,43,63.25
Ahri,MissFortune,553,313,240,56.6
Ahri,Swain,253,122,131,48.22
Ahri,Warwick,387,183,204,47.29
Ahri,Udyr,89,52,37,58.43
Ahri,Mel,425,173,252,40.71
Ahri,Sivir,172,64,108,37.21
Ahri,Karma,324,178,146,54.94
Ahri,DrMundo,149,83,66,55.7
Ahri,Sejuani,197,69,128,35.03
Ahri,Veigar,321,163,158,50.78
Ahri,Jinx,686,306,380,44.61
Ahri,Nami,306,153,153,50
Ahri,Tryndamere,138,69,69,50
Ahri,Shaco,218,102,116,46.79
Ahri,Leblanc,248,138,110,55.65
Ahri,Caitlyn,652,307,345,47.09
Ahri,Morgana,242,128,114,52.89
Ahri,Olaf,69,38,31,55.07
Ahri,Viego,375,184,191,49.07
Ahri,Ryze,141,76,65,53.9
Ahri,Jhin,490,224,266,45.71
Ahri,Soraka,109,48,61,44.04
Ahri,Alistar,143,70,73,48.95
Ahri,Nocturne,309,172,137,55.66
Ahri,Galio,351,177,174,50.43
Ahri,Urgot,177,76,101,42.94
Ahri,Samira,236,134,102,56.78
Ahri,Jax,246,126,120,51.22
Ahri,RekSai,36,25,11,69.44
Ahri,Xayah,209,92,117,44.02
Ahri,Rakan,168,101,67,60.12
Ahri,Cassiopeia,81,47,34,58.02
Ahri,Darius,419,167,252,39.86
Ahri,XinZhao,188,98,90,52.13
Ahri,Orianna,179,86,93,48.04
Ahri,Ezreal,788,411,377,52.16
Ahri,Thresh,536,263,273,49.07
Ahri,Nasus,130,64,66,49.23
Ahri,MonkeyKing,214,88,126,41.12
Ahri,Viktor,269,124,145,46.1
Ahri,Ashe,592,264,328,44.59
Ahri,Trundle,174,88,86,50.57
Ahri,Khazix,142,86,56,60.56
Ahri,Smolder,217,113,104,52.07
Ahri,Zilean,86,40,46,46.51
Ahri,Yorick,202,102,100,50.5
Ahri,Hwei,199,109,90,54.77
Ahri,Zyra,228,109,119,47.81
Ahri,Kled,61,32,29,52.46
Ahri,Gragas,190,107,83,56.32
Ahri,Anivia,122,47,75,38.52
Ahri,Rell,215,115,100,53.49
Ahri,Ambessa,218,115,103,52.75
Ahri,LeeSin,471,251,220,53.29
Ahri,Renekton,147,71,76,48.3
Ahri,Gangplank,144,66,78,45.83
Ahri,Ekko,247,124,123,50.2
Ahri,Elise,206,113,93,54.85
Ahri,Draven,139,68,71,48.92
Ahri,Sion,229,101,128,44.1
Ahri,Vi,336,193,143,57.44
Ahri,Nilah,74,32,42,43.24
Ahri,Leona,302,155,147,51.32
Ahri,Akali,234,133,101,56.84
Ahri,Zoe,136,69,67,50.74
Ahri,JarvanIV,235,115,120,48.94
Ahri,Rumble,67,35,32,52.24
Ahri,Lulu,391,201,190,51.41
Ahri,Vladimir,165,89,76,53.94
Ahri,Ziggs,71,46,25,64.79
Ahri,Teemo,250,133,117,53.2
Ahri,Zac,181,81,100,44.75
Ahri,Pantheon,478,239,239,50
Ahri,Katarina,217,112,105,51.61
Ahri,Aatrox,266,127,139,47.74
Ahri,Yasuo,465,236,229,50.75
Ahri,Jayce,143,55,88,38.46
Ahri,Zed,260,119,141,45.77
Ahri,Graves,190,93,97,48.95
Ahri,Sylas,518,250,268,48.26
Ahri,Irelia,205,95,110,46.34
Ahri,Karthus,55,34,21,61.82
Ahri,Lux,696,330,366,47.41
Ahri,Annie,102,51,51,50
Ahri,Malzahar,247,127,120,51.42
Ahri,Nidalee,84,46,38,54.76
Ahri,Volibear,305,146,159,47.87
Ahri,Corki,160,83,77,51.88
Ahri,Sona,63,27,36,42.86
Ahri,Malphite,293,138,155,47.1
Ahri,Kayle,159,67,92,42.14
Ahri,Yuumi,254,140,114,55.12
Ahri,Vayne,344,166,178,48.26
Ahri,Ornn,164,76,88,46.34
Ahri,Skarner,131,44,87,33.59
Ahri,Bard,104,40,64,38.46
Ahri,Qiyana,57,30,27,52.63
Ahri,Zeri,116,89,27,76.72
Ahri,MasterYi,225,100,125,44.44
Ahri,Blitzcrank,324,159,165,49.07
Ahri,Twitch,156,90,66,57.69
Ahri,Kindred,129,77,52,59.69
Ahri,Varus,282,160,122,56.74
Ahri,Chogath,360,181,179,50.28
Ahri,Yone,479,249,230,51.98
Ahri,Tristana,231,114,117,49.35
Ahri,Gwen,138,67,71,48.55
Ahri,Briar,196,99,97,50.51
Ahri,Sett,362,192,170,53.04
Ahri,Hecarim,119,60,59,50.42
Ahri,Garen,401,236,165,58.85
Ahri,Akshan,90,52,38,57.78
Ahri,Syndra,290,140,150,48.28
Ahri,Lucian,251,133,118,52.99
Ahri,Milio,176,106,70,60.23
Ahri,Lillia,152,69,83,45.39
Ahri,AurelionSol,90,45,45,50
Ahri,Aphelios,174,88,86,50.57
Ahri,Kayn,315,189,126,60
Ahri,Amumu,313,136,177,43.45
Ahri,Senna,136,81,55,59.56
Ahri,Maokai,98,43,55,43.88
Ahri,Gnar,173,116,57,67.05
Ahri,Kaisa,431,241,190,55.92
Ahri,Seraphine,206,117,89,56.8
Ahri,Poppy,257,105,152,40.86
Ahri,Brand,151,83,68,54.97
Ahri,Aurora,292,151,141,51.71
Ahri,Belveth,48,20,28,41.67
Ahri,Nautilus,402,201,201,50
Ahri,Nunu,175,91,84,52
Ahri,Xerath,228,109,119,47.81
Ahri,Diana,414,181,233,43.72
Ahri,TwistedFate,96,41,55,42.71
Ahri,FiddleSticks,138,77,61,55.8
Ahri,Heimerdinger,99,43,56,43.43
Ahri,Neeko,136,73,63,53.68
Ahri,Taric,56,29,27,51.79
Ahri,Braum,235,119,116,50.64
Ahri,Singed,63,35,28,55.56
Ahri,TahmKench,204,91,113,44.61
Ahri,KSante,197,122,75,61.93
Ahri,Ivern,72,27,45,37.5
Ahri,Kassadin,58,22,36,37.93
Ahri,Kalista,102,57,45,55.88
Ahri,Renata,64,47,17,73.44
Ahri,Vex,161,75,86,46.58
Ahri,Camille,102,50,52,49.02
Ahri,Fiora,90,48,42,53.33
Ahri,Kennen,92,57,35,61.96
Ahri,Azir,107,62,45,57.94
Ahri,KogMaw,84,37,47,44.05
Ahri,Lissandra,145,73,72,50.34
Ahri,Illaoi,108,59,49,54.63
Ahri,Naafiri,76,40,36,52.63
Ahri,Quinn,74,33,41,44.59
Ahri,Taliyah,90,45,45,50
Ahri,Pyke,211,115,96,54.5
Ahri,Shen,165,81,84,49.09
Ahri,Janna,97,46,51,47.42
Ahri,Velkoz,160,97,63,60.63
Ahri,Rammus,80,25,55,31.25
Ahri,Shyvana,72,31,41,43.06
Ahri,Fizz,87,49,38,56.32
Ahri,Talon,121,67,54,55.37
Ahri,Rengar,80,43,37,53.75
Kayn,Mordekaiser,297,143,154,48.15
Kayn,Evelynn,86,48,38,55.81
Kayn,Riven,92,33,59,35.87
Kayn,MissFortune,515,238,277,46.21
Kayn,Swain,265,128,137,48.3
Kayn,Jax,249,110,139,44.18
Kayn,Sejuani,176,89,87,50.57
Kayn,Hwei,172,93,79,54.07
Kayn,Ezreal,539,258,281,47.87
Kayn,Zac,207,95,112,45.89
Kayn,Malphite,287,131,156,45.64
Kayn,Lissandra,93,40,53,43.01
Kayn,Lulu,339,168,171,49.56
Kayn,Ambessa,199,100,99,50.25
Kayn,Viktor,174,85,89,48.85
Kayn,Graves,152,74,78,48.68
Kayn,Caitlyn,596,280,316,46.98
Kayn,Braum,172,94,78,54.65
Kayn,Sion,215,103,112,47.91
Kayn,Nocturne,241,100,141,41.49
Kayn,Jhin,484,278,206,57.44
Kayn,Soraka,136,48,88,35.29
Kayn,Udyr,87,47,40,54.02
Kayn,Yone,397,199,198,50.13
Kayn,Smolder,172,86,86,50
Kayn,TahmKench,243,140,103,57.61
Kayn,DrMundo,165,59,106,35.76
Kayn,Rammus,112,65,47,58.04
Kayn,Annie,102,44,58,43.14
Kayn,Renata,53,24,29,45.28
Kayn,Teemo,282,123,159,43.62
Kayn,Warwick,389,170,219,43.7
Kayn,Nunu,154,78,76,50.65
Kayn,Lucian,146,83,63,56.85
Kayn,Leona,259,133,126,51.35
Kayn,Ekko,202,81,121,40.1
Kayn,Akali,216,129,87,59.72
Kayn,Karma,245,122,123,49.8
Kayn,Veigar,277,132,145,47.65
Kayn,Jinx,697,310,387,44.48
Kayn,Nami,203,71,132,34.98
Kayn,Yorick,179,81,98,45.25
Kayn,Viego,388,189,199,48.71
Kayn,AurelionSol,104,62,42,59.62
Kayn,Ashe,486,243,243,50
Kayn,Milio,182,73,109,40.11
Kayn,Nasus,179,95,84,53.07
Kayn,Amumu,341,153,188,44.87
Kayn,Sylas,360,190,170,52.78
Kayn,Twitch,185,76,109,41.08
Kayn,Zed,276,145,131,52.54
Kayn,Skarner,119,56,63,47.06
Kayn,Aurora,175,88,87,50.29
Kayn,Yuumi,159,88,71,55.35
Kayn,Pantheon,394,182,212,46.19
Kayn,Zoe,99,63,36,63.64
Kayn,Ziggs,104,55,49,52.88
Kayn,Darius,481,228,253,47.4
Kayn,Kindred,108,70,38,64.81
Kayn,Tristana,240,146,94,60.83
Kayn,Neeko,107,53,54,49.53
Kayn,Naafiri,74,32,42,43.24
Kayn,Mel,534,264,270,49.44
Kayn,Janna,83,43,40,51.81
Kayn,Gangplank,120,71,49,59.17
Kayn,Shaco,207,124,83,59.9
Kayn,Volibear,274,135,139,49.27
Kayn,Katarina,170,80,90,47.06
Kayn,Blitzcrank,258,141,117,54.65
Kayn,KSante,135,78,57,57.78
Kayn,Yasuo,553,293,260,52.98
Kayn,Gwen,114,69,45,60.53
Kayn,Briar,173,66,107,38.15
Kayn,Vayne,254,126,128,49.61
Kayn,Chogath,326,173,153,53.07
Kayn,JarvanIV,200,92,108,46
Kayn,Alistar,144,78,66,54.17
Kayn,MasterYi,277,120,157,43.32
Kayn,Singed,74,31,43,41.89
Kayn,Zyra,207,105,102,50.72
Kayn,Kayle,141,70,71,49.65
Kayn,Irelia,220,89,131,40.45
Kayn,Aatrox,228,131,97,57.46
Kayn,Malzahar,253,113,140,44.66
Kayn,Elise,200,105,95,52.5
Kayn,Draven,144,70,74,48.61
Kayn,Shen,170,74,96,43.53
Kayn,Heimerdinger,119,57,62,47.9
Kayn,Samira,227,110,117,48.46
Kayn,Nautilus,338,188,150,55.62
Kayn,Vi,289,131,158,45.33
Kayn,Jayce,93,36,57,38.71
Kayn,Orianna,115,48,67,41.74
Kayn,Lux,593,308,285,51.94
Kayn,Kaisa,392,193,199,49.23
Kayn,Pyke,202,107,95,52.97
Kayn,Diana,398,198,200,49.75
Kayn,Ryze,108,50,58,46.3
Kayn,Xayah,128,43,85,33.59
Kayn,Maokai,133,57,76,42.86
Kayn,Nidalee,63,38,25,60.32
Kayn,XinZhao,136,56,80,41.18
Kayn,Hecarim,76,46,30,60.53
Kayn,Sivir,136,70,66,51.47
Kayn,Poppy,139,56,83,40.29
Kayn,Zilean,72,35,37,48.61
Kayn,Brand,148,56,92,37.84
Kayn,Rakan,185,72,113,38.92
Kayn,Ivern,69,29,40,42.03
Kayn,Trundle,173,100,73,57.8
Kayn,Syndra,181,102,79,56.35
Kayn,Morgana,256,120,136,46.88
Kayn,LeeSin,370,184,186,49.73
Kayn,Khazix,124,58,66,46.77
Kayn,Vex,148,65,83,43.92
Kayn,Thresh,445,208,237,46.74
Kayn,Belveth,28,17,11,60.71
Kayn,Olaf,62,27,35,43.55
Kayn,Gnar,116,61,55,52.59
Kayn,KogMaw,71,39,32,54.93
Kayn,Garen,375,183,192,48.8
Kayn,Leblanc,135,72,63,53.33
Kayn,Bard,69,28,41,40.58
Kayn,Galio,285,128,157,44.91
Kayn,Ornn,161,91,70,56.52
Kayn,Gragas,177,107,70,60.45
Kayn,Sona,45,20,25,44.44
Kayn,Zeri,91,39,52,42.86
Kayn,Seraphine,170,79,91,46.47
Kayn,Varus,257,121,136,47.08
Kayn,RekSai,40,22,18,55
Kayn,Lillia,129,68,61,52.71
Kayn,Sett,422,222,200,52.61
Kayn,Renekton,131,62,69,47.33
Kayn,Rengar,116,51,65,43.97
Kayn,TwistedFate,70,33,37,47.14
Kayn,Ahri,315,126,189,40
Kayn,Qiyana,48,21,27,43.75
Kayn,Rumble,51,24,27,47.06
Kayn,Azir,133,63,70,47.37
Kayn,Vladimir,132,60,72,45.45
Kayn,Talon,132,71,61,53.79
Kayn,Urgot,114,70,44,61.4
Kayn,Rell,212,111,101,52.36
Kayn,Nilah,87,52,35,59.77
Kayn,FiddleSticks,110,38,72,34.55
Kayn,Aphelios,179,97,82,54.19
Kayn,Shyvana,67,13,54,19.4
Kayn,Xerath,179,103,76,57.54
Kayn,Fiora,81,47,34,58.02
Kayn,Illaoi,146,66,80,45.21
Kayn,Cassiopeia,77,30,47,38.96
Kayn,Tryndamere,100,54,46,54
Kayn,Senna,164,96,68,58.54
Kayn,Taric,55,17,38,30.91
Kayn,MonkeyKing,165,85,80,51.52
Kayn,Akshan,106,62,44,58.49
Kayn,Kennen,67,32,35,47.76
Kayn,Corki,120,65,55,54.17
Kayn,Velkoz,104,53,51,50.96
Kayn,Fizz,128,46,82,35.94
Kayn,Kassadin,59,26,33,44.07
Kayn,Karthus,76,36,40,47.37
Kayn,Kalista,73,27,46,36.99
Kayn,Quinn,65,28,37,43.08
Kayn,Camille,87,44,43,50.57
Kayn,Taliyah,67,33,34,49.25
Kayn,Kled,20,10,10,50
Kayn,Anivia,79,42,37,53.16
Mel,Mordekaiser,503,235,268,46.72
Mel,Evelynn,167,73,94,43.71
Mel,Riven,229,91,138,39.74
Mel,MissFortune,792,399,393,50.38
Mel,Swain,449,232,217,51.67
Mel,Chogath,573,270,303,47.12
Mel,Sivir,188,90,98,47.87
Mel,Ashe,754,412,342,54.64
Mel,Fiora,159,89,70,55.97
Mel,Teemo,473,246,227,52.01
Mel,Diana,616,285,331,46.27
Mel,Nilah,115,31,84,26.96
Mel,Leona,476,207,269,43.49
Mel,Sett,610,324,286,53.11
Mel,Hecarim,153,91,62,59.48
Mel,Ahri,425,252,173,59.29
Mel,Rakan,286,128,158,44.76
Mel,Draven,233,111,122,47.64
Mel,FiddleSticks,189,79,110,41.8
Mel,Hwei,245,112,133,45.71
Mel,Twitch,358,159,199,44.41
Mel,Seraphine,301,152,149,50.5
Mel,Viego,567,273,294,48.15
Mel,Yone,747,342,405,45.78
Mel,Lucian,343,173,170,50.44
Mel,Shen,328,158,170,48.17
Mel,Vi,422,202,220,47.87
Mel,Nami,454,200,254,44.05
Mel,Jhin,879,451,428,51.31
Mel,Ekko,404,206,198,50.99
Mel,Akali,443,231,212,52.14
Mel,Ambessa,356,163,193,45.79
Mel,Karma,504,235,269,46.63
Mel,Poppy,300,136,164,45.33
Mel,Zac,252,134,118,53.17
Mel,Malzahar,428,183,245,42.76
Mel,TahmKench,425,215,210,50.59
Mel,Nocturne,471,198,273,42.04
Mel,Orianna,276,104,172,37.68
Mel,Caitlyn,1094,576,518,52.65
Mel,Neeko,208,102,106,49.04
Mel,Pantheon,736,355,381,48.23
Mel,Talon,247,114,133,46.15
Mel,Kaisa,671,340,331,50.67
Mel,Soraka,185,92,93,49.73
Mel,Illaoi,190,101,89,53.16
Mel,Briar,224,101,123,45.09
Mel,Taliyah,109,52,57,47.71
Mel,Morgana,409,213,196,52.08
Mel,Nasus,284,127,157,44.72
Mel,Shaco,316,179,137,56.65
Mel,Xerath,489,218,271,44.58
Mel,Lulu,610,268,342,43.93
Mel,Darius,760,329,431,43.29
Mel,Aphelios,238,125,113,52.52
Mel,Gwen,211,104,107,49.29
Mel,Irelia,364,163,201,44.78
Mel,Varus,422,219,203,51.9
Mel,Lux,868,477,391,54.95
Mel,KSante,205,128,77,62.44
Mel,Kassadin,163,70,93,42.94
Mel,Bard,144,78,66,54.17
Mel,Kindred,161,71,90,44.1
Mel,Veigar,403,181,222,44.91
Mel,Tristana,384,162,222,42.19
Mel,Malphite,434,222,212,51.15
Mel,Graves,217,114,103,52.53
Mel,Vladimir,263,100,163,38.02
Mel,Ezreal,1000,483,517,48.3
Mel,Camille,189,101,88,53.44
Mel,Yorick,322,131,191,40.68
Mel,Kayn,534,270,264,50.56
Mel,Sylas,699,408,291,58.37
Mel,Renata,79,41,38,51.9
Mel,Kayle,231,97,134,41.99
Mel,Corki,176,64,112,36.36
Mel,Syndra,258,120,138,46.51
Mel,Cassiopeia,123,53,70,43.09
Mel,Gragas,295,138,157,46.78
Mel,Gangplank,176,92,84,52.27
Mel,XinZhao,263,98,165,37.26
Mel,Azir,233,93,140,39.91
Mel,Garen,595,279,316,46.89
Mel,Belveth,81,41,40,50.62
Mel,Tryndamere,144,80,64,55.56
Mel,Nunu,297,145,152,48.82
Mel,Kennen,142,69,73,48.59
Mel,Samira,334,153,181,45.81
Mel,Rell,297,141,156,47.47
Mel,Khazix,202,104,98,51.49
Mel,Katarina,237,123,114,51.9
Mel,AurelionSol,248,107,141,43.15
Mel,Brand,258,99,159,38.37
Mel,Heimerdinger,161,96,65,59.63
Mel,LeeSin,649,340,309,52.39
Mel,Jinx,907,410,497,45.2
Mel,Naafiri,112,49,63,43.75
Mel,Yasuo,877,428,449,48.8
Mel,Trundle,231,103,128,44.59
Mel,RekSai,69,42,27,60.87
Mel,Leblanc,203,112,91,55.17
Mel,Nautilus,579,278,301,48.01
Mel,Jayce,189,95,94,50.26
Mel,Viktor,502,257,245,51.2
Mel,MasterYi,388,172,216,44.33
Mel,Yuumi,329,142,187,43.16
Mel,Olaf,139,53,86,38.13
Mel,Zed,429,201,228,46.85
Mel,Singed,116,50,66,43.1
Mel,Fizz,282,143,139,50.71
Mel,Jax,316,153,163,48.42
Mel,DrMundo,236,127,109,53.81
Mel,Aurora,285,161,124,56.49
Mel,Sion,386,187,199,48.45
Mel,Ryze,110,50,60,45.45
Mel,Smolder,345,165,180,47.83
Mel,Volibear,354,153,201,43.22
Mel,Elise,310,143,167,46.13
Mel,Vex,148,82,66,55.41
Mel,Lillia,248,107,141,43.15
Mel,Rammus,108,58,50,53.7
Mel,KogMaw,135,62,73,45.93
Mel,Urgot,185,101,84,54.59
Mel,Sejuani,263,97,166,36.88
Mel,Thresh,701,342,359,48.79
Mel,Zyra,292,143,149,48.97
Mel,Qiyana,93,57,36,61.29
Mel,Amumu,554,267,287,48.19
Mel,Braum,274,140,134,51.09
Mel,Vayne,493,215,278,43.61
Mel,Senna,270,128,142,47.41
Mel,Ivern,87,41,46,47.13
Mel,Blitzcrank,342,186,156,54.39
Mel,Zeri,186,82,104,44.09
Mel,Warwick,517,237,280,45.84
Mel,Aatrox,360,190,170,52.78
Mel,Zilean,123,50,73,40.65
Mel,Milio,281,134,147,47.69
Mel,Sona,80,36,44,45
Mel,Skarner,157,91,66,57.96
Mel,Zoe,152,69,83,45.39
Mel,Rumble,120,63,57,52.5
Mel,Anivia,139,79,60,56.83
Mel,Xayah,260,101,159,38.85
Mel,Gnar,172,79,93,45.93
Mel,Taric,87,39,48,44.83
Mel,TwistedFate,93,36,57,38.71
Mel,Alistar,252,135,117,53.57
Mel,Rengar,126,72,54,57.14
Mel,Galio,498,223,275,44.78
Mel,JarvanIV,309,157,152,50.81
Mel,Pyke,385,184,201,47.79
Mel,Ornn,231,129,102,55.84
Mel,Ziggs,165,53,112,32.12
Mel,Lissandra,140,41,99,29.29
Mel,Renekton,237,120,117,50.63
Mel,Quinn,156,66,90,42.31
Mel,Udyr,148,66,82,44.59
Mel,Maokai,195,104,91,53.33
Mel,Janna,120,39,81,32.5
Mel,Nidalee,163,80,83,49.08
Mel,Karthus,106,53,53,50
Mel,MonkeyKing,284,130,154,45.77
Mel,Akshan,169,78,91,46.15
Mel,Velkoz,232,107,125,46.12
Mel,Shyvana,113,57,56,50.44
Mel,Annie,138,73,65,52.9
Mel,Kalista,128,82,46,64.06
Mel,Kled,76,26,50,34.21
Caitlyn,Mordekaiser,623,282,341,45.26
Caitlyn,Evelynn,181,83,98,45.86
Caitlyn,Riven,227,117,110,51.54
Caitlyn,MissFortune,1156,599,557,51.82
Caitlyn,Swain,482,237,245,49.17
Caitlyn,Vladimir,270,125,145,46.3
Caitlyn,Kayn,596,316,280,53.02
Caitlyn,Velkoz,336,167,169,49.7
Caitlyn,Xayah,312,174,138,55.77
Caitlyn,Leblanc,298,169,129,56.71
Caitlyn,Yorick,466,240,226,51.5
Caitlyn,Teemo,512,245,267,47.85
Caitlyn,Katarina,287,148,139,51.57
Caitlyn,Jhin,1240,649,591,52.34
Caitlyn,Lux,1250,626,624,50.08
Caitlyn,Jax,455,215,240,47.25
Caitlyn,Udyr,199,112,87,56.28
Caitlyn,Yone,914,498,416,54.49
Caitlyn,Smolder,410,185,225,45.12
Caitlyn,TahmKench,433,226,207,52.19
Caitlyn,Fiora,180,82,98,45.56
Caitlyn,Diana,678,335,343,49.41
Caitlyn,Nilah,159,59,100,37.11
Caitlyn,Leona,495,258,237,52.12
Caitlyn,Volibear,545,256,289,46.97
Caitlyn,LeeSin,922,498,424,54.01
Caitlyn,Veigar,570,292,278,51.23
Caitlyn,Vayne,572,292,280,51.05
Caitlyn,Yuumi,414,192,222,46.38
Caitlyn,Ornn,283,159,124,56.18
Caitlyn,Lillia,253,121,132,47.83
Caitlyn,Zed,515,249,266,48.35
Caitlyn,Tristana,482,243,239,50.41
Caitlyn,Nami,532,270,262,50.75
Caitlyn,FiddleSticks,237,128,109,54.01
Caitlyn,Hwei,353,163,190,46.18
Caitlyn,Twitch,365,197,168,53.97
Caitlyn,Seraphine,385,202,183,52.47
Caitlyn,Aatrox,469,252,217,53.73
Caitlyn,MasterYi,539,278,261,51.58
Caitlyn,TwistedFate,152,75,77,49.34
Caitlyn,Varus,541,273,268,50.46
Caitlyn,Gangplank,241,131,110,54.36
Caitlyn,Aurora,403,231,172,57.32
Caitlyn,Ashe,1220,607,613,49.75
Caitlyn,Morgana,433,197,236,45.5
Caitlyn,Poppy,370,185,185,50
Caitlyn,Pyke,432,227,205,52.55
Caitlyn,Sett,675,345,330,51.11
Caitlyn,Kindred,240,139,101,57.92
Caitlyn,Mel,1094,518,576,47.35
Caitlyn,Lulu,646,344,302,53.25
Caitlyn,Ezreal,1572,727,845,46.25
Caitlyn,Trundle,252,130,122,51.59
Caitlyn,Ahri,652,345,307,52.91
Caitlyn,Graves,284,146,138,51.41
Caitlyn,Blitzcrank,548,254,294,46.35
Caitlyn,Yasuo,1010,512,498,50.69
Caitlyn,Naafiri,126,64,62,50.79
Caitlyn,Azir,215,113,102,52.56
Caitlyn,Shen,379,159,220,41.95
Caitlyn,Karma,624,291,333,46.63
Caitlyn,Gwen,246,124,122,50.41
Caitlyn,Pantheon,819,404,415,49.33
Caitlyn,Irelia,376,186,190,49.47
Caitlyn,Akali,463,223,240,48.16
Caitlyn,Nunu,347,175,172,50.43
Caitlyn,Nautilus,623,300,323,48.15
Caitlyn,Amumu,612,290,322,47.39
Caitlyn,Darius,810,393,417,48.52
Caitlyn,Braum,370,161,209,43.51
Caitlyn,Vi,692,310,382,44.8
Caitlyn,Xerath,473,203,270,42.92
Caitlyn,Nasus,282,155,127,54.96
Caitlyn,Viego,625,337,288,53.92
Caitlyn,Cassiopeia,163,66,97,40.49
Caitlyn,Rakan,260,137,123,52.69
Caitlyn,Tryndamere,179,98,81,54.75
Caitlyn,KogMaw,168,104,64,61.9
Caitlyn,Sion,490,231,259,47.14
Caitlyn,Rengar,133,87,46,65.41
Caitlyn,Ambessa,341,166,175,48.68
Caitlyn,Viktor,477,229,248,48.01
Caitlyn,Jinx,1605,734,871,45.73
Caitlyn,Bard,187,91,96,48.66
Caitlyn,Warwick,653,359,294,54.98
Caitlyn,Chogath,636,320,316,50.31
Caitlyn,Sivir,263,120,143,45.63
Caitlyn,Brand,321,157,164,48.91
Caitlyn,Shyvana,145,70,75,48.28
Caitlyn,Ryze,228,128,100,56.14
Caitlyn,Renekton,296,156,140,52.7
Caitlyn,JarvanIV,346,145,201,41.91
Caitlyn,Janna,155,59,96,38.06
Caitlyn,Elise,367,166,201,45.23
Caitlyn,Sylas,751,394,357,52.46
Caitlyn,Thresh,906,488,418,53.86
Caitlyn,Alistar,280,136,144,48.57
Caitlyn,Singed,140,54,86,38.57
Caitlyn,Zyra,458,226,232,49.34
Caitlyn,Kayle,301,154,147,51.16
Caitlyn,Zac,301,155,146,51.5
Caitlyn,Soraka,252,126,126,50
Caitlyn,Galio,556,286,270,51.44
Caitlyn,DrMundo,250,125,125,50
Caitlyn,Zeri,183,86,97,46.99
Caitlyn,Kaisa,745,420,325,56.38
Caitlyn,Garen,703,314,389,44.67
Caitlyn,Sejuani,326,161,165,49.39
Caitlyn,Camille,177,82,95,46.33
Caitlyn,Shaco,384,189,195,49.22
Caitlyn,Milio,337,157,180,46.59
Caitlyn,Jayce,254,127,127,50
Caitlyn,Orianna,227,105,122,46.26
Caitlyn,Lucian,517,287,230,55.51
Caitlyn,Nidalee,185,109,76,58.92
Caitlyn,Urgot,269,112,157,41.64
Caitlyn,Lissandra,195,97,98,49.74
Caitlyn,Taliyah,138,75,63,54.35
Caitlyn,Illaoi,293,150,143,51.19
Caitlyn,Rammus,173,89,84,51.45
Caitlyn,Maokai,230,117,113,50.87
Caitlyn,Kassadin,95,35,60,36.84
Caitlyn,Heimerdinger,211,104,107,49.29
Caitlyn,Zilean,176,82,94,46.59
Caitlyn,Aphelios,299,141,158,47.16
Caitlyn,Gragas,354,164,190,46.33
Caitlyn,Neeko,238,120,118,50.42
Caitlyn,Vex,262,127,135,48.47
Caitlyn,Renata,107,48,59,44.86
Caitlyn,Kennen,159,89,70,55.97
Caitlyn,Samira,356,202,154,56.74
Caitlyn,Talon,254,124,130,48.82
Caitlyn,Ivern,103,58,45,56.31
Caitlyn,Anivia,174,93,81,53.45
Caitlyn,Khazix,286,161,125,56.29
Caitlyn,Hecarim,167,99,68,59.28
Caitlyn,Rell,360,178,182,49.44
Caitlyn,Ekko,425,223,202,52.47
Caitlyn,Malphite,574,284,290,49.48
Caitlyn,Karthus,125,51,74,40.8
Caitlyn,KSante,317,161,156,50.79
Caitlyn,RekSai,89,52,37,58.43
Caitlyn,Fizz,212,110,102,51.89
Caitlyn,Malzahar,546,257,289,47.07
Caitlyn,Gnar,210,118,92,56.19
Caitlyn,MonkeyKing,306,133,173,43.46
Caitlyn,Zoe,221,103,118,46.61
Caitlyn,Annie,138,61,77,44.2
Caitlyn,Senna,294,158,136,53.74
Caitlyn,AurelionSol,200,94,106,47
Caitlyn,Nocturne,594,256,338,43.1
Caitlyn,Draven,255,135,120,52.94
Caitlyn,Sona,84,31,53,36.9
Caitlyn,Skarner,201,113,88,56.22
Caitlyn,Kled,111,63,48,56.76
Caitlyn,Briar,311,162,149,52.09
Caitlyn,XinZhao,279,117,162,41.94
Caitlyn,Qiyana,96,36,60,37.5
Caitlyn,Syndra,386,183,203,47.41
Caitlyn,Kalista,148,80,68,54.05
Caitlyn,Ziggs,227,109,118,48.02
Caitlyn,Belveth,96,47,49,48.96
Caitlyn,Corki,232,117,115,50.43
Caitlyn,Taric,84,54,30,64.29
Caitlyn,Akshan,201,82,119,40.8
Caitlyn,Quinn,149,73,76,48.99
Caitlyn,Olaf,128,58,70,45.31
Caitlyn,Rumble,134,67,67,50
Pyke,Mordekaiser,219,108,111,49.32
Pyke,Evelynn,39,17,22,43.59
Pyke,Riven,47,29,18,61.7
Pyke,MissFortune,316,133,183,42.09
Pyke,Swain,159,76,83,47.8
Pyke,Ashe,349,165,184,47.28
Pyke,Twitch,67,35,32,52.24
Pyke,Viktor,169,77,92,45.56
Pyke,Xayah,102,44,58,43.14
Pyke,Xerath,190,73,117,38.42
Pyke,Ambessa,110,38,72,34.55
Pyke,Diana,250,121,129,48.4
Pyke,Ekko,94,43,51,45.74
Pyke,Jinx,427,222,205,51.99
Pyke,Lulu,220,92,128,41.82
Pyke,Yone,359,193,166,53.76
Pyke,JarvanIV,89,37,52,41.57
Pyke,Ryze,59,33,26,55.93
Pyke,Draven,59,28,31,47.46
Pyke,Blitzcrank,216,98,118,45.37
Pyke,Volibear,218,85,133,38.99
Pyke,Vi,224,97,127,43.3
Pyke,Gragas,109,57,52,52.29
Pyke,Caitlyn,432,205,227,47.45
Pyke,Lux,411,225,186,54.74
Pyke,Skarner,85,52,33,61.18
Pyke,Katarina,136,73,63,53.68
Pyke,RekSai,34,15,19,44.12
Pyke,Nunu,114,58,56,50.88
Pyke,Hwei,115,61,54,53.04
Pyke,Morgana,173,81,92,46.82
Pyke,Nautilus,258,125,133,48.45
Pyke,Aatrox,188,91,97,48.4
Pyke,Sejuani,119,35,84,29.41
Pyke,Yasuo,275,144,131,52.36
Pyke,Annie,57,28,29,49.12
Pyke,Nami,134,72,62,53.73
Pyke,Nasus,90,42,48,46.67
Pyke,MasterYi,176,93,83,52.84
Pyke,Anivia,74,27,47,36.49
Pyke,Vayne,186,94,92,50.54
Pyke,Yuumi,184,84,100,45.65
Pyke,Jax,156,79,77,50.64
Pyke,XinZhao,101,47,54,46.53
Pyke,Azir,92,34,58,36.96
Pyke,Rell,80,32,48,40
Pyke,LeeSin,312,163,149,52.24
Pyke,Thresh,343,182,161,53.06
Pyke,Pantheon,318,140,178,44.03
Pyke,Poppy,141,64,77,45.39
Pyke,Kled,57,27,30,47.37
Pyke,Kayn,202,95,107,47.03
Pyke,Qiyana,31,14,17,45.16
Pyke,Maokai,97,51,46,52.58
Pyke,Malphite,232,80,152,34.48
Pyke,Hecarim,74,32,42,43.24
Pyke,Aurora,111,55,56,49.55
Pyke,Sivir,109,41,68,37.61
Pyke,Soraka,93,46,47,49.46
Pyke,Ornn,114,52,62,45.61
Pyke,Kennen,69,41,28,59.42
Pyke,Varus,200,97,103,48.5
Pyke,Renata,32,16,16,50
Pyke,Rammus,82,32,50,39.02
Pyke,Zeri,82,28,54,34.15
Pyke,Yorick,175,82,93,46.86
Pyke,Orianna,87,45,42,51.72
Pyke,Alistar,88,44,44,50
Pyke,Zed,176,66,110,37.5
Pyke,Akali,151,68,83,45.03
Pyke,Karma,208,90,118,43.27
Pyke,Shen,127,45,82,35.43
Pyke,Shaco,143,70,73,48.95
Pyke,Smolder,113,52,61,46.02
Pyke,Garen,228,112,116,49.12
Pyke,Darius,282,138,144,48.94
Pyke,Veigar,144,68,76,47.22
Pyke,Warwick,238,110,128,46.22
Pyke,TahmKench,161,44,117,27.33
Pyke,Trundle,82,47,35,57.32
Pyke,Heimerdinger,59,30,29,50.85
Pyke,Quinn,50,14,36,28
Pyke,Zoe,52,27,25,51.92
Pyke,Nilah,78,43,35,55.13
Pyke,FiddleSticks,79,38,41,48.1
Pyke,Tristana,149,66,83,44.3
Pyke,Mel,385,201,184,52.21
Pyke,Kaisa,319,124,195,38.87
Pyke,Seraphine,117,55,62,47.01
Pyke,Karthus,47,16,31,34.04
Pyke,Rumble,67,54,13,80.6
Pyke,Lillia,69,32,37,46.38
Pyke,Renekton,98,42,56,42.86
Pyke,Leblanc,107,39,68,36.45
Pyke,Gwen,72,37,35,51.39
Pyke,Akshan,43,22,21,51.16
Pyke,Braum,126,59,67,46.83
Pyke,Lucian,142,78,64,54.93
Pyke,Galio,187,86,101,45.99
Pyke,Jhin,308,124,184,40.26
Pyke,KSante,88,38,50,43.18
Pyke,Syndra,93,38,55,40.86
Pyke,Graves,135,67,68,49.63
Pyke,Gnar,83,46,37,55.42
Pyke,Nocturne,166,98,68,59.04
Pyke,Ziggs,61,39,22,63.93
Pyke,Kayle,83,37,46,44.58
Pyke,Sylas,299,154,145,51.51
Pyke,Senna,74,27,47,36.49
Pyke,Irelia,142,71,71,50
Pyke,Briar,80,26,54,32.5
Pyke,Leona,172,75,97,43.6
Pyke,Fiora,59,35,24,59.32
Pyke,Cassiopeia,52,26,26,50
Pyke,Vladimir,77,39,38,50.65
Pyke,Ezreal,473,222,251,46.93
Pyke,KogMaw,57,33,24,57.89
Pyke,Teemo,176,82,94,46.59
Pyke,Shyvana,39,16,23,41.03
Pyke,Aphelios,71,35,36,49.3
Pyke,Belveth,17,12,5,70.59
Pyke,Naafiri,52,25,27,48.08
Pyke,Neeko,103,45,58,43.69
Pyke,Milio,80,27,53,33.75
Pyke,Illaoi,78,25,53,32.05
Pyke,Zac,98,47,51,47.96
Pyke,Taliyah,40,17,23,42.5
Pyke,Rengar,48,17,31,35.42
Pyke,Samira,148,55,93,37.16
Pyke,MonkeyKing,157,66,91,42.04
Pyke,Malzahar,165,65,100,39.39
Pyke,Kassadin,39,26,13,66.67
Pyke,Sona,41,23,18,56.1
Pyke,Rakan,118,51,67,43.22
Pyke,Sett,286,122,164,42.66
Pyke,Taric,51,21,30,41.18
Pyke,Jayce,90,44,46,48.89
Pyke,Vex,100,45,55,45
Pyke,Janna,49,21,28,42.86
Pyke,Amumu,168,64,104,38.1
Pyke,Fizz,93,43,50,46.24
Pyke,Urgot,71,25,46,35.21
Pyke,Kindred,90,37,53,41.11
Pyke,Ahri,211,96,115,45.5
Pyke,Gangplank,64,34,30,53.13
Pyke,Khazix,54,16,38,29.63
Pyke,Kalista,58,26,32,44.83
Pyke,Brand,75,36,39,48
Pyke,Viego,267,112,155,41.95
Pyke,Chogath,205,76,129,37.07
Pyke,Elise,165,79,86,47.88
Pyke,DrMundo,75,42,33,56
Pyke,AurelionSol,61,32,29,52.46
Pyke,Zyra,124,52,72,41.94
Pyke,Tryndamere,78,40,38,51.28
Pyke,Talon,79,37,42,46.84
Pyke,Velkoz,88,33,55,37.5
Pyke,Camille,61,36,25,59.02
Pyke,Lissandra,42,20,22,47.62
Pyke,Sion,149,77,72,51.68
Pyke,Corki,87,50,37,57.47
Pyke,Udyr,65,38,27,58.46
Pyke,Olaf,45,14,31,31.11
Pyke,Ivern,26,19,7,73.08
Pyke,Zilean,21,5,16,23.81
Pyke,Nidalee,59,30,29,50.85
Pyke,Bard,34,20,14,58.82
Pyke,Singed,22,7,15,31.82
Pyke,TwistedFate,41,14,27,34.15
Gangplank,Urgot,38,14,24,36.84
Gangplank,Diana,126,70,56,55.56
Gangplank,Syndra,45,22,23,48.89
Gangplank,MissFortune,212,110,102,51.89
Gangplank,Braum,74,28,46,37.84
Gangplank,Riven,44,22,22,50
Gangplank,MonkeyKing,102,36,66,35.29
Gangplank,Kassadin,23,5,18,21.74
Gangplank,Caitlyn,241,110,131,45.64
Gangplank,Taliyah,18,8,10,44.44
Gangplank,Jax,63,42,21,66.67
Gangplank,MasterYi,80,43,37,53.75
Gangplank,Malzahar,76,33,43,43.42
Gangplank,Morgana,72,33,39,45.83
Gangplank,Mordekaiser,89,43,46,48.31
Gangplank,Yone,150,73,77,48.67
Gangplank,Xerath,104,58,46,55.77
Gangplank,Darius,152,86,66,56.58
Gangplank,Kayn,120,49,71,40.83
Gangplank,Lux,226,117,109,51.77
Gangplank,Soraka,58,32,26,55.17
Gangplank,Swain,70,25,45,35.71
Gangplank,Volibear,118,51,67,43.22
Gangplank,Lissandra,35,16,19,45.71
Gangplank,Kalista,34,15,19,44.12
Gangplank,Rell,69,41,28,59.42
Gangplank,Karma,132,68,64,51.52
Gangplank,Mel,176,84,92,47.73
Gangplank,Cassiopeia,26,14,12,53.85
Gangplank,Thresh,178,77,101,43.26
Gangplank,Sett,137,48,89,35.04
Gangplank,Yasuo,157,75,82,47.77
Gangplank,KogMaw,39,8,31,20.51
Gangplank,Lulu,135,47,88,34.81
Gangplank,Gnar,60,30,30,50
Gangplank,Amumu,123,59,64,47.97
Gangplank,Aurora,94,32,62,34.04
Gangplank,Tristana,84,41,43,48.81
Gangplank,Pantheon,137,58,79,42.34
Gangplank,Ahri,144,78,66,54.17
Gangplank,Brand,53,22,31,41.51
Gangplank,Nami,87,42,45,48.28
Gangplank,Shen,90,36,54,40
Gangplank,Viego,135,69,66,51.11
Gangplank,Hwei,81,39,42,48.15
Gangplank,LeeSin,192,86,106,44.79
Gangplank,Leona,93,48,45,51.61
Gangplank,Yorick,62,33,29,53.23
Gangplank,Milio,61,19,42,31.15
Gangplank,Qiyana,22,10,12,45.45
Gangplank,Briar,45,21,24,46.67
Gangplank,Lucian,110,71,39,64.55
Gangplank,TahmKench,72,39,33,54.17
Gangplank,Elise,91,35,56,38.46
Gangplank,Jinx,204,70,134,34.31
Gangplank,Kled,25,17,8,68
Gangplank,Jhin,167,67,100,40.12
Gangplank,Veigar,79,27,52,34.18
Gangplank,Nocturne,124,55,69,44.35
Gangplank,Teemo,96,41,55,42.71
Gangplank,Ezreal,200,109,91,54.5
Gangplank,Maokai,33,12,21,36.36
Gangplank,Malphite,97,57,40,58.76
Gangplank,Vladimir,60,25,35,41.67
Gangplank,Nunu,34,15,19,44.12
Gangplank,Quinn,35,21,14,60
Gangplank,Warwick,94,60,34,63.83
Gangplank,Renekton,30,10,20,33.33
Gangplank,Shaco,78,49,29,62.82
Gangplank,Zed,90,31,59,34.44
Gangplank,Yuumi,63,24,39,38.1
Gangplank,Blitzcrank,76,34,42,44.74
Gangplank,Alistar,64,31,33,48.44
Gangplank,Nautilus,106,44,62,41.51
Gangplank,Sion,73,38,35,52.05
Gangplank,XinZhao,66,34,32,51.52
Gangplank,Lillia,53,29,24,54.72
Gangplank,Katarina,60,30,30,50
Gangplank,Kaisa,128,60,68,46.88
Gangplank,Anivia,44,10,34,22.73
Gangplank,Seraphine,51,28,23,54.9
Gangplank,FiddleSticks,25,9,16,36
Gangplank,Vayne,84,29,55,34.52
Gangplank,Ashe,174,80,94,45.98
Gangplank,Poppy,53,24,29,45.28
Gangplank,JarvanIV,59,23,36,38.98
Gangplank,Viktor,102,55,47,53.92
Gangplank,Singed,26,6,20,23.08
Gangplank,Vex,66,41,25,62.12
Gangplank,Orianna,53,24,29,45.28
Gangplank,Neeko,57,23,34,40.35
Gangplank,Chogath,105,48,57,45.71
Gangplank,Aatrox,126,69,57,54.76
Gangplank,Talon,49,20,29,40.82
Gangplank,Zyra,68,27,41,39.71
Gangplank,Sylas,156,62,94,39.74
Gangplank,Samira,72,44,28,61.11
Gangplank,Olaf,35,18,17,51.43
Gangplank,Vi,84,27,57,32.14
Gangplank,Evelynn,35,22,13,62.86
Gangplank,Naafiri,28,15,13,53.57
Gangplank,Aphelios,58,28,30,48.28
Gangplank,Hecarim,36,16,20,44.44
Gangplank,Zilean,18,8,10,44.44
Gangplank,Leblanc,60,34,26,56.67
Gangplank,Nasus,49,36,13,73.47
Gangplank,Irelia,71,40,31,56.34
Gangplank,Gragas,85,40,45,47.06
Gangplank,Ziggs,43,13,30,30.23
Gangplank,Smolder,69,34,35,49.28
Gangplank,Graves,62,28,34,45.16
Gangplank,Ekko,53,26,27,49.06
Gangplank,Khazix,40,14,26,35
Gangplank,Varus,122,64,58,52.46
Gangplank,Fizz,41,18,23,43.9
Gangplank,Jayce,45,28,17,62.22
Gangplank,Sejuani,54,16,38,29.63
Gangplank,Tryndamere,26,10,16,38.46
Gangplank,Gwen,25,11,14,44
Gangplank,Akshan,35,25,10,71.43
Gangplank,Sivir,43,23,20,53.49
Gangplank,Rumble,39,16,23,41.03
Gangplank,Corki,46,21,25,45.65
Gangplank,Bard,18,9,9,50
Gangplank,Akali,60,30,30,50
Gangplank,Xayah,51,17,34,33.33
Gangplank,Rakan,51,13,38,25.49
Gangplank,Kayle,52,24,28,46.15
Gangplank,Draven,45,25,20,55.56
Gangplank,Senna,51,29,22,56.86
Gangplank,Ryze,39,11,28,28.21
Gangplank,Twitch,47,27,20,57.45
Gangplank,Zac,55,28,27,50.91
Gangplank,Zoe,54,37,17,68.52
Gangplank,Pyke,64,30,34,46.88
Gangplank,Sona,15,0,15,0
Gangplank,Ambessa,68,36,32,52.94
Gangplank,DrMundo,32,9,23,28.13
Gangplank,Galio,123,51,72,41.46
Gangplank,Trundle,39,14,25,35.9
Gangplank,RekSai,14,5,9,35.71
Gangplank,Janna,26,8,18,30.77
Gangplank,Ornn,48,18,30,37.5
Gangplank,Garen,136,53,83,38.97
Gangplank,Nilah,19,11,8,57.89
Gangplank,Kennen,36,11,25,30.56
Gangplank,Udyr,46,27,19,58.7
Gangplank,Camille,34,22,12,64.71
Gangplank,Skarner,41,15,26,36.59
Gangplank,Illaoi,20,12,8,60
Gangplank,Velkoz,42,28,14,66.67
Gangplank,KSante,36,18,18,50
Gangplank,Belveth,14,3,11,21.43
Gangplank,Shyvana,17,7,10,41.18
Gangplank,Taric,25,9,16,36
Gangplank,Zeri,34,16,18,47.06
Gangplank,Heimerdinger,31,9,22,29.03
Gangplank,Kindred,26,17,9,65.38
Gangplank,Nidalee,30,23,7,76.67
Gangplank,Karthus,19,9,10,47.37
Gangplank,AurelionSol,34,18,16,52.94
Gangplank,TwistedFate,24,12,12,50
Gangplank,Rengar,26,16,10,61.54
Gangplank,Renata,18,9,9,50
Gangplank,Annie,32,15,17,46.88
Gangplank,Ivern,22,8,14,36.36
Gangplank,Fiora,28,12,16,42.86
Gangplank,Azir,27,9,18,33.33
Gangplank,Rammus,14,6,8,42.86
Irelia,Urgot,87,47,40,54.02
Irelia,Diana,254,125,129,49.21
Irelia,Syndra,93,42,51,45.16
Irelia,MissFortune,272,129,143,47.43
Irelia,Braum,139,61,78,43.88
Irelia,Chogath,149,53,96,35.57
Irelia,MonkeyKing,118,64,54,54.24
Irelia,Veigar,159,63,96,39.62
Irelia,Caitlyn,376,190,186,50.53
Irelia,Mel,364,201,163,55.22
Irelia,Akali,193,108,85,55.96
Irelia,Nunu,86,43,43,50
Irelia,Lux,298,154,144,51.68
Irelia,Tristana,109,47,62,43.12
Irelia,Nautilus,184,94,90,51.09
Irelia,Teemo,155,73,82,47.1
Irelia,Amumu,186,87,99,46.77
Irelia,Lissandra,46,24,22,52.17
Irelia,Lucian,137,76,61,55.47
Irelia,Xerath,135,85,50,62.96
Irelia,Malphite,191,78,113,40.84
Irelia,Khazix,79,42,37,53.16
Irelia,Galio,181,82,99,45.3
Irelia,Smolder,96,60,36,62.5
Irelia,Thresh,298,156,142,52.35
Irelia,Singed,33,23,10,69.7
Irelia,Darius,250,126,124,50.4
Irelia,Pantheon,311,172,139,55.31
Irelia,XinZhao,68,20,48,29.41
Irelia,Kaisa,279,158,121,56.63
Irelia,Jhin,231,93,138,40.26
Irelia,Morgana,144,57,87,39.58
Irelia,Shen,97,25,72,25.77
Irelia,Viego,199,78,121,39.2
Irelia,Corki,61,28,33,45.9
Irelia,TahmKench,117,58,59,49.57
Irelia,Aatrox,123,46,77,37.4
Irelia,Aurora,128,63,65,49.22
Irelia,Sivir,75,29,46,38.67
Irelia,Blitzcrank,142,79,63,55.63
Irelia,Vladimir,95,59,36,62.11
Irelia,Ashe,331,156,175,47.13
Irelia,Rell,104,59,45,56.73
Irelia,Poppy,146,64,82,43.84
Irelia,Yone,305,136,169,44.59
Irelia,Jinx,365,151,214,41.37
Irelia,Gragas,141,67,74,47.52
Irelia,MasterYi,133,73,60,54.89
Irelia,Zyra,109,48,61,44.04
Irelia,Ambessa,110,63,47,57.27
Irelia,Ryze,80,37,43,46.25
Irelia,LeeSin,268,139,129,51.87
Irelia,Renekton,87,32,55,36.78
Irelia,Elise,91,43,48,47.25
Irelia,Zed,156,78,78,50
Irelia,Milio,87,48,39,55.17
Irelia,Mordekaiser,190,96,94,50.53
Irelia,Kayn,220,131,89,59.55
Irelia,Ekko,81,46,35,56.79
Irelia,Nami,114,40,74,35.09
Irelia,Yasuo,288,121,167,42.01
Irelia,Xayah,92,47,45,51.09
Irelia,DrMundo,92,52,40,56.52
Irelia,Zeri,48,32,16,66.67
Irelia,Lulu,233,114,119,48.93
Irelia,Garen,175,64,111,36.57
Irelia,Rammus,78,31,47,39.74
Irelia,Kayle,111,54,57,48.65
Irelia,Jax,168,79,89,47.02
Irelia,Warwick,199,110,89,55.28
Irelia,Graves,87,33,54,37.93
Irelia,Azir,68,39,29,57.35
Irelia,Gnar,123,69,54,56.1
Irelia,Volibear,176,87,89,49.43
Irelia,Shaco,128,62,66,48.44
Irelia,Ahri,205,110,95,53.66
Irelia,Vayne,167,96,71,57.49
Irelia,Rakan,81,43,38,53.09
Irelia,Draven,100,49,51,49
Irelia,Sett,199,79,120,39.7
Irelia,Ezreal,367,178,189,48.5
Irelia,Yorick,137,64,73,46.72
Irelia,Briar,83,42,41,50.6
Irelia,Sylas,252,108,144,42.86
Irelia,Seraphine,107,47,60,43.93
Irelia,Fiora,53,32,21,60.38
Irelia,Rengar,44,19,25,43.18
Irelia,Nilah,41,20,21,48.78
Irelia,Kindred,65,32,33,49.23
Irelia,Sejuani,93,31,62,33.33
Irelia,Varus,158,71,87,44.94
Irelia,Illaoi,96,41,55,42.71
Irelia,Ziggs,44,18,26,40.91
Irelia,Sona,22,6,16,27.27
Irelia,Jayce,121,60,61,49.59
Irelia,Leona,135,76,59,56.3
Irelia,Taliyah,37,21,16,56.76
Irelia,Vi,179,71,108,39.66
Irelia,Twitch,105,44,61,41.9
Irelia,Renata,59,36,23,61.02
Irelia,Samira,96,48,48,50
Irelia,Bard,35,11,24,31.43
Irelia,JarvanIV,90,42,48,46.67
Irelia,Soraka,52,20,32,38.46
Irelia,Swain,147,64,83,43.54
Irelia,Evelynn,45,21,24,46.67
Irelia,Karma,186,75,111,40.32
Irelia,Camille,30,22,8,73.33
Irelia,FiddleSticks,58,20,38,34.48
Irelia,Zilean,44,19,25,43.18
Irelia,Gwen,64,33,31,51.56
Irelia,Rumble,41,25,16,60.98
Irelia,Lillia,80,51,29,63.75
Irelia,Senna,79,31,48,39.24
Irelia,Belveth,36,17,19,47.22
Irelia,Malzahar,160,73,87,45.63
Irelia,Neeko,70,39,31,55.71
Irelia,Zac,58,22,36,37.93
Irelia,Fizz,79,45,34,56.96
Irelia,Viktor,139,62,77,44.6
Irelia,Nidalee,45,29,16,64.44
Irelia,Janna,57,32,25,56.14
Irelia,Udyr,50,20,30,40
Irelia,Brand,70,38,32,54.29
Irelia,Taric,51,25,26,49.02
Irelia,Kennen,52,24,28,46.15
Irelia,Ornn,70,38,32,54.29
Irelia,Skarner,87,38,49,43.68
Irelia,Nocturne,163,82,81,50.31
Irelia,Sion,109,62,47,56.88
Irelia,AurelionSol,42,12,30,28.57
Irelia,Cassiopeia,32,20,12,62.5
Irelia,Pyke,142,71,71,50
Irelia,Olaf,23,8,15,34.78
Irelia,Aphelios,117,68,49,58.12
Irelia,TwistedFate,45,32,13,71.11
Irelia,Leblanc,93,43,50,46.24
Irelia,Katarina,89,34,55,38.2
Irelia,Gangplank,71,31,40,43.66
Irelia,Karthus,31,20,11,64.52
Irelia,Alistar,82,38,44,46.34
Irelia,Quinn,55,26,29,47.27
Irelia,Naafiri,35,24,11,68.57
Irelia,KSante,100,46,54,46
Irelia,Kalista,39,22,17,56.41
Irelia,Riven,45,18,27,40
Irelia,Vex,82,41,41,50
Irelia,Anivia,46,19,27,41.3
Irelia,Orianna,75,41,34,54.67
Irelia,Yuumi,93,33,60,35.48
Irelia,Hecarim,48,18,30,37.5
Irelia,Velkoz,77,29,48,37.66
Irelia,Talon,77,43,34,55.84
Irelia,KogMaw,32,11,21,34.38
Irelia,Hwei,82,33,49,40.24
Irelia,Annie,38,25,13,65.79
Irelia,Zoe,50,28,22,56
Irelia,Trundle,66,22,44,33.33
Irelia,Heimerdinger,78,47,31,60.26
Irelia,Akshan,30,7,23,23.33
Irelia,Shyvana,34,14,20,41.18
Irelia,Nasus,40,20,20,50
Irelia,Maokai,62,37,25,59.68
Irelia,Kled,22,14,8,63.64
Irelia,Ivern,19,10,9,52.63
Irelia,Tryndamere,55,32,23,58.18
Irelia,RekSai,12,6,6,50
Irelia,Qiyana,14,8,6,57.14
Irelia,Kassadin,32,13,19,40.63
Kaisa,Urgot,170,79,91,46.47
Kaisa,Diana,468,206,262,44.02
Kaisa,Syndra,226,123,103,54.42
Kaisa,MissFortune,602,308,294,51.16
Kaisa,Braum,316,147,169,46.52
Kaisa,Ambessa,275,147,128,53.45
Kaisa,Gragas,196,78,118,39.8
Kaisa,Pantheon,511,240,271,46.97
Kaisa,Samira,233,123,110,52.79
Kaisa,Hwei,238,128,110,53.78
Kaisa,Yorick,244,87,157,35.66
Kaisa,Viego,471,228,243,48.41
Kaisa,AurelionSol,123,50,73,40.65
Kaisa,Ashe,662,300,362,45.32
Kaisa,Milio,172,76,96,44.19
Kaisa,Gnar,160,68,92,42.5
Kaisa,Evelynn,112,60,52,53.57
Kaisa,Malphite,332,136,196,40.96
Kaisa,Lucian,286,140,146,48.95
Kaisa,Mel,671,331,340,49.33
Kaisa,Illaoi,163,77,86,47.24
Kaisa,Briar,167,89,78,53.29
Kaisa,Taliyah,79,40,39,50.63
Kaisa,Twitch,246,148,98,60.16
Kaisa,Morgana,311,144,167,46.3
Kaisa,Jax,270,143,127,52.96
Kaisa,RekSai,29,9,20,31.03
Kaisa,Xayah,258,114,144,44.19
Kaisa,Rakan,202,86,116,42.57
Kaisa,Cassiopeia,75,34,41,45.33
Kaisa,Swain,276,99,177,35.87
Kaisa,Volibear,295,158,137,53.56
Kaisa,Lissandra,134,44,90,32.84
Kaisa,Kalista,95,47,48,49.47
Kaisa,Rell,198,99,99,50
Kaisa,Nunu,186,90,96,48.39
Kaisa,Nautilus,349,130,219,37.25
Kaisa,Darius,605,311,294,51.4
Kaisa,XinZhao,194,93,101,47.94
Kaisa,Malzahar,305,142,163,46.56
Kaisa,Vayne,481,220,261,45.74
Kaisa,Aurora,253,128,125,50.59
Kaisa,Corki,171,109,62,63.74
Kaisa,Sejuani,196,90,106,45.92
Kaisa,Leblanc,182,80,102,43.96
Kaisa,Nilah,136,50,86,36.76
Kaisa,Karma,352,173,179,49.15
Kaisa,TahmKench,265,118,147,44.53
Kaisa,JarvanIV,238,91,147,38.24
Kaisa,Veigar,328,154,174,46.95
Kaisa,Yasuo,659,307,352,46.59
Kaisa,Irelia,279,121,158,43.37
Kaisa,MonkeyKing,218,99,119,45.41
Kaisa,Thresh,620,319,301,51.45
Kaisa,MasterYi,255,117,138,45.88
Kaisa,Shaco,218,106,112,48.62
Kaisa,Lux,681,341,340,50.07
Kaisa,Lulu,506,248,258,49.01
Kaisa,Olaf,66,34,32,51.52
Kaisa,Vi,390,198,192,50.77
Kaisa,Katarina,190,93,97,48.95
Kaisa,Bard,109,54,55,49.54
Kaisa,Sett,409,206,203,50.37
Kaisa,Jhin,536,290,246,54.1
Kaisa,Yuumi,284,140,144,49.3
Kaisa,Chogath,382,170,212,44.5
Kaisa,Sivir,192,75,117,39.06
Kaisa,Ryze,97,51,46,52.58
Kaisa,Senna,184,88,96,47.83
Kaisa,LeeSin,610,317,293,51.97
Kaisa,Viktor,289,158,131,54.67
Kaisa,Caitlyn,745,325,420,43.62
Kaisa,Akali,334,196,138,58.68
Kaisa,Kled,77,51,26,66.23
Kaisa,Kayn,392,199,193,50.77
Kaisa,Qiyana,93,50,43,53.76
Kaisa,Maokai,154,77,77,50
Kaisa,Anivia,131,43,88,32.82
Kaisa,Warwick,350,156,194,44.57
Kaisa,Graves,256,113,143,44.14
Kaisa,Azir,162,98,64,60.49
Kaisa,Nami,291,138,153,47.42
Kaisa,Jayce,167,88,79,52.69
Kaisa,Zed,344,186,158,54.07
Kaisa,Jinx,867,404,463,46.6
Kaisa,Gwen,173,86,87,49.71
Kaisa,Ezreal,1071,548,523,51.17
Kaisa,Sion,248,86,162,34.68
Kaisa,Elise,265,122,143,46.04
Kaisa,Leona,320,150,170,46.88
Kaisa,Riven,141,63,78,44.68
Kaisa,Poppy,265,127,138,47.92
Kaisa,Trundle,158,71,87,44.94
Kaisa,Vex,181,62,119,34.25
Kaisa,Seraphine,198,95,103,47.98
Kaisa,Heimerdinger,99,47,52,47.47
Kaisa,Yone,591,288,303,48.73
Kaisa,Karthus,99,45,54,45.45
Kaisa,Galio,379,177,202,46.7
Kaisa,Tristana,302,147,155,48.68
Kaisa,Brand,160,66,94,41.25
Kaisa,Ornn,202,88,114,43.56
Kaisa,Khazix,176,82,94,46.59
Kaisa,Rammus,94,45,49,47.87
Kaisa,Orianna,151,93,58,61.59
Kaisa,Alistar,181,71,110,39.23
Kaisa,Amumu,340,144,196,42.35
Kaisa,Naafiri,89,43,46,48.31
Kaisa,FiddleSticks,125,62,63,49.6
Kaisa,Quinn,119,62,57,52.1
Kaisa,Garen,479,195,284,40.71
Kaisa,Zac,252,120,132,47.62
Kaisa,Akshan,93,45,48,48.39
Kaisa,Aatrox,325,155,170,47.69
Kaisa,Teemo,279,114,165,40.86
Kaisa,Fizz,126,59,67,46.83
Kaisa,Vladimir,181,75,106,41.44
Kaisa,Varus,293,130,163,44.37
Kaisa,Sylas,524,254,270,48.47
Kaisa,Smolder,228,112,116,49.12
Kaisa,Draven,135,67,68,49.63
Kaisa,Renekton,181,81,100,44.75
Kaisa,Rengar,65,39,26,60
Kaisa,TwistedFate,105,48,57,45.71
Kaisa,Ivern,79,48,31,60.76
Kaisa,Aphelios,203,94,109,46.31
Kaisa,Mordekaiser,365,178,187,48.77
Kaisa,Talon,160,76,84,47.5
Kaisa,Kayle,158,65,93,41.14
Kaisa,Camille,108,50,58,46.3
Kaisa,Blitzcrank,258,124,134,48.06
Kaisa,DrMundo,180,90,90,50
Kaisa,Gangplank,128,68,60,53.13
Kaisa,Ahri,431,190,241,44.08
Kaisa,Rumble,112,65,47,58.04
Kaisa,Lillia,156,68,88,43.59
Kaisa,Nasus,196,95,101,48.47
Kaisa,Zoe,173,96,77,55.49
Kaisa,Pyke,319,195,124,61.13
Kaisa,Janna,84,29,55,34.52
Kaisa,Singed,77,35,42,45.45
Kaisa,Kindred,125,69,56,55.2
Kaisa,Ekko,212,102,110,48.11
Kaisa,Neeko,106,44,62,41.51
Kaisa,Skarner,180,72,108,40
Kaisa,Shen,272,134,138,49.26
Kaisa,Nocturne,379,205,174,54.09
Kaisa,Velkoz,176,84,92,47.73
Kaisa,Nidalee,144,93,51,64.58
Kaisa,Fiora,121,66,55,54.55
Kaisa,KSante,197,106,91,53.81
Kaisa,Shyvana,58,25,33,43.1
Kaisa,Hecarim,111,63,48,56.76
Kaisa,Ziggs,101,38,63,37.62
Kaisa,Kennen,105,54,51,51.43
Kaisa,Renata,78,41,37,52.56
Kaisa,Udyr,119,54,65,45.38
Kaisa,Xerath,289,135,154,46.71
Kaisa,Sona,56,20,36,35.71
Kaisa,Soraka,143,74,69,51.75
Kaisa,Kassadin,60,23,37,38.33
Kaisa,Belveth,53,24,29,45.28
Kaisa,Tryndamere,124,56,68,45.16
Kaisa,Annie,92,37,55,40.22
Kaisa,Zilean,90,32,58,35.56
Kaisa,Zeri,172,79,93,45.93
Kaisa,Zyra,224,110,114,49.11
Kaisa,KogMaw,102,29,73,28.43
Kaisa,Taric,72,30,42,41.67
Nautilus,Urgot,152,61,91,40.13
Nautilus,Diana,415,219,196,52.77
Nautilus,Syndra,192,108,84,56.25
Nautilus,MissFortune,496,231,265,46.57
Nautilus,Braum,307,143,164,46.58
Nautilus,Garen,423,237,186,56.03
Nautilus,MonkeyKing,196,104,92,53.06
Nautilus,Lux,661,366,295,55.37
Nautilus,Nilah,104,56,48,53.85
Nautilus,Lulu,340,162,178,47.65
Nautilus,Irelia,184,90,94,48.91
Nautilus,LeeSin,434,221,213,50.92
Nautilus,Zed,244,144,100,59.02
Nautilus,Caitlyn,623,323,300,51.85
Nautilus,Morgana,311,175,136,56.27
Nautilus,Ornn,157,73,84,46.5
Nautilus,Kindred,110,77,33,70
Nautilus,Talon,129,70,59,54.26
Nautilus,Samira,219,128,91,58.45
Nautilus,Ashe,557,302,255,54.22
Nautilus,Skarner,147,50,97,34.01
Nautilus,Aurora,193,109,84,56.48
Nautilus,Ezreal,662,332,330,50.15
Nautilus,Yuumi,234,102,132,43.59
Nautilus,Malphite,290,161,129,55.52
Nautilus,Khazix,148,88,60,59.46
Nautilus,Galio,341,164,177,48.09
Nautilus,Smolder,217,107,110,49.31
Nautilus,Thresh,506,294,212,58.1
Nautilus,MasterYi,242,144,98,59.5
Nautilus,Warwick,378,165,213,43.65
Nautilus,Kassadin,34,22,12,64.71
Nautilus,Kaisa,349,219,130,62.75
Nautilus,Pyke,258,133,125,51.55
Nautilus,Karma,292,140,152,47.95
Nautilus,Malzahar,309,128,181,41.42
Nautilus,Aatrox,251,119,132,47.41
Nautilus,Sejuani,171,106,65,61.99
Nautilus,Blitzcrank,316,154,162,48.73
Nautilus,Trundle,143,73,70,51.05
Nautilus,RekSai,17,8,9,47.06
Nautilus,Leblanc,152,64,88,42.11
Nautilus,Darius,474,219,255,46.2
Nautilus,Poppy,264,133,131,50.38
Nautilus,Ekko,192,93,99,48.44
Nautilus,Mel,579,301,278,51.99
Nautilus,Sett,386,173,213,44.82
Nautilus,Lucian,215,113,102,52.56
Nautilus,Ivern,66,35,31,53.03
Nautilus,Orianna,178,79,99,44.38
Nautilus,Twitch,241,108,133,44.81
Nautilus,Pantheon,444,232,212,52.25
Nautilus,Kayn,338,150,188,44.38
Nautilus,Sylas,417,209,208,50.12
Nautilus,Fizz,122,53,69,43.44
Nautilus,Jinx,680,280,400,41.18
Nautilus,Nasus,170,73,97,42.94
Nautilus,Vi,284,156,128,54.93
Nautilus,Xayah,195,80,115,41.03
Nautilus,Maokai,133,70,63,52.63
Nautilus,Graves,228,111,117,48.68
Nautilus,Xerath,267,115,152,43.07
Nautilus,Draven,174,100,74,57.47
Nautilus,Riven,115,61,54,53.04
Nautilus,Yone,421,233,188,55.34
Nautilus,Gnar,138,74,64,53.62
Nautilus,Yorick,215,103,112,47.91
Nautilus,Nidalee,110,77,33,70
Nautilus,Rell,258,138,120,53.49
Nautilus,Olaf,88,44,44,50
Nautilus,Zoe,95,52,43,54.74
Nautilus,Zyra,212,88,124,41.51
Nautilus,Heimerdinger,121,75,46,61.98
Nautilus,Zilean,86,49,37,56.98
Nautilus,Brand,176,83,93,47.16
Nautilus,Fiora,108,64,44,59.26
Nautilus,Zac,168,80,88,47.62
Nautilus,Hwei,195,90,105,46.15
Nautilus,Sion,258,122,136,47.29
Nautilus,Rakan,164,72,92,43.9
Nautilus,Kled,43,13,30,30.23
Nautilus,Briar,174,91,83,52.3
Nautilus,Velkoz,130,73,57,56.15
Nautilus,KSante,184,106,78,57.61
Nautilus,Viego,379,180,199,47.49
Nautilus,JarvanIV,227,85,142,37.44
Nautilus,KogMaw,69,35,34,50.72
Nautilus,Elise,176,88,88,50
Nautilus,Ambessa,250,136,114,54.4
Nautilus,Chogath,315,147,168,46.67
Nautilus,Sona,32,9,23,28.13
Nautilus,Annie,87,49,38,56.32
Nautilus,Ziggs,116,55,61,47.41
Nautilus,Azir,120,62,58,51.67
Nautilus,Milio,183,93,90,50.82
Nautilus,Shen,204,90,114,44.12
Nautilus,Shaco,183,87,96,47.54
Nautilus,Gwen,154,75,79,48.7
Nautilus,Illaoi,138,84,54,60.87
Nautilus,XinZhao,211,96,115,45.5
Nautilus,Akali,267,130,137,48.69
Nautilus,Hecarim,84,41,43,48.81
Nautilus,Tristana,236,139,97,58.9
Nautilus,Jax,238,136,102,57.14
Nautilus,Volibear,273,132,141,48.35
Nautilus,Gangplank,106,62,44,58.49
Nautilus,Swain,290,98,192,33.79
Nautilus,AurelionSol,81,34,47,41.98
Nautilus,Nami,245,83,162,33.88
Nautilus,FiddleSticks,105,46,59,43.81
Nautilus,Vex,143,53,90,37.06
Nautilus,Kayle,147,80,67,54.42
Nautilus,Nunu,163,113,50,69.33
Nautilus,Yasuo,532,271,261,50.94
Nautilus,Alistar,196,87,109,44.39
Nautilus,Vladimir,172,101,71,58.72
Nautilus,Lissandra,82,22,60,26.83
Nautilus,Soraka,101,57,44,56.44
Nautilus,Viktor,285,135,150,47.37
Nautilus,Jhin,504,259,245,51.39
Nautilus,Amumu,369,186,183,50.41
Nautilus,DrMundo,141,60,81,42.55
Nautilus,Nocturne,303,130,173,42.9
Nautilus,Rammus,96,44,52,45.83
Nautilus,Karthus,62,30,32,48.39
Nautilus,Teemo,234,136,98,58.12
Nautilus,Cassiopeia,97,44,53,45.36
Nautilus,Varus,275,126,149,45.82
Nautilus,Mordekaiser,342,154,188,45.03
Nautilus,Katarina,126,65,61,51.59
Nautilus,Corki,153,82,71,53.59
Nautilus,Janna,86,48,38,55.81
Nautilus,Evelynn,83,43,40,51.81
Nautilus,Ahri,402,201,201,50
Nautilus,TwistedFate,87,35,52,40.23
Nautilus,Quinn,76,41,35,53.95
Nautilus,TahmKench,258,131,127,50.78
Nautilus,Lillia,181,91,90,50.28
Nautilus,Sivir,179,74,105,41.34
Nautilus,Senna,129,60,69,46.51
Nautilus,Anivia,100,31,69,31
Nautilus,Vayne,357,169,188,47.34
Nautilus,Veigar,264,149,115,56.44
Nautilus,Bard,78,42,36,53.85
Nautilus,Kennen,66,38,28,57.58
Nautilus,Qiyana,58,36,22,62.07
Nautilus,Jayce,128,59,69,46.09
Nautilus,Rumble,88,43,45,48.86
Nautilus,Gragas,200,106,94,53
Nautilus,Leona,355,185,170,52.11
Nautilus,Shyvana,44,15,29,34.09
Nautilus,Kalista,86,40,46,46.51
Nautilus,Taric,87,47,40,54.02
Nautilus,Taliyah,91,57,34,62.64
Nautilus,Zeri,115,51,64,44.35
Nautilus,Rengar,51,30,21,58.82
Nautilus,Seraphine,174,105,69,60.34
Nautilus,Neeko,102,56,46,54.9
Nautilus,Akshan,86,64,22,74.42
Nautilus,Ryze,96,50,46,52.08
Nautilus,Singed,73,41,32,56.16
Nautilus,Aphelios,115,53,62,46.09
Nautilus,Renata,77,38,39,49.35
Nautilus,Camille,94,54,40,57.45
Nautilus,Udyr,97,52,45,53.61
Nautilus,Naafiri,63,36,27,57.14
Nautilus,Renekton,146,70,76,47.95
Nautilus,Tryndamere,82,44,38,53.66
Nautilus,Belveth,44,20,24,45.45
Urgot,Gangplank,38,24,14,63.16
Urgot,Volibear,90,52,38,57.78
Urgot,Irelia,87,40,47,45.98
Urgot,Kaisa,170,91,79,53.53
Urgot,Nautilus,152,91,61,59.87
Urgot,Yorick,94,41,53,43.62
Urgot,Viego,96,49,47,51.04
Urgot,AurelionSol,39,18,21,46.15
Urgot,Ashe,151,71,80,47.02
Urgot,Milio,57,25,32,43.86
Urgot,Ambessa,50,25,25,50
Urgot,Graves,43,23,20,53.49
Urgot,Ahri,177,101,76,57.06
Urgot,Rakan,56,27,29,48.21
Urgot,Cassiopeia,24,10,14,41.67
Urgot,Gragas,46,24,22,52.17
Urgot,Yone,157,80,77,50.96
Urgot,TahmKench,126,62,64,49.21
Urgot,Heimerdinger,38,30,8,78.95
Urgot,Teemo,96,39,57,40.63
Urgot,Ezreal,184,104,80,56.52
Urgot,Caitlyn,269,157,112,58.36
Urgot,Sona,17,12,5,70.59
Urgot,Sett,151,83,68,54.97
Urgot,Nunu,86,35,51,40.7
Urgot,Lux,199,96,103,48.24
Urgot,Mordekaiser,130,68,62,52.31
Urgot,Ryze,17,6,11,35.29
Urgot,Smolder,89,39,50,43.82
Urgot,Yuumi,58,14,44,24.14
Urgot,Darius,206,103,103,50
Urgot,LeeSin,128,84,44,65.63
Urgot,Veigar,106,51,55,48.11
Urgot,Shen,72,43,29,59.72
Urgot,Diana,134,62,72,46.27
Urgot,Nasus,69,41,28,59.42
Urgot,Riven,57,26,31,45.61
Urgot,Seraphine,72,43,29,59.72
Urgot,Samira,51,32,19,62.75
Urgot,Hwei,64,41,23,64.06
Urgot,Kayle,46,20,26,43.48
Urgot,Khazix,35,27,8,77.14
Urgot,Mel,185,84,101,45.41
Urgot,Lulu,82,38,44,46.34
Urgot,Brand,70,43,27,61.43
Urgot,Trundle,50,20,30,40
Urgot,Briar,51,19,32,37.25
Urgot,Vex,57,33,24,57.89
Urgot,MissFortune,189,100,89,52.91
Urgot,Rell,76,34,42,44.74
Urgot,Udyr,36,22,14,61.11
Urgot,Aurora,98,36,62,36.73
Urgot,Malphite,127,59,68,46.46
Urgot,Jhin,196,115,81,58.67
Urgot,Gwen,58,18,40,31.03
Urgot,Shaco,58,21,37,36.21
Urgot,Poppy,71,33,38,46.48
Urgot,Katarina,72,48,24,66.67
Urgot,KogMaw,44,22,22,50
Urgot,Blitzcrank,93,48,45,51.61
Urgot,KSante,63,37,26,58.73
Urgot,Warwick,139,78,61,56.12
Urgot,Orianna,57,25,32,43.86
Urgot,Nami,131,58,73,44.27
Urgot,Skarner,47,29,18,61.7
Urgot,Varus,109,53,56,48.62
Urgot,Neeko,43,21,22,48.84
Urgot,Jinx,221,61,160,27.6
Urgot,Swain,96,46,50,47.92
Urgot,Amumu,93,41,52,44.09
Urgot,Naafiri,37,18,19,48.65
Urgot,Zyra,74,37,37,50
Urgot,Vi,95,29,66,30.53
Urgot,Lucian,71,33,38,46.48
Urgot,Akali,89,33,56,37.08
Urgot,Ornn,59,24,35,40.68
Urgot,Aatrox,118,60,58,50.85
Urgot,Kayn,114,44,70,38.6
Urgot,Karma,108,58,50,53.7
Urgot,Taric,28,17,11,60.71
Urgot,Qiyana,32,20,12,62.5
Urgot,Yasuo,144,73,71,50.69
Urgot,Elise,96,44,52,45.83
Urgot,Garen,164,59,105,35.98
Urgot,Braum,71,24,47,33.8
Urgot,Sylas,92,37,55,40.22
Urgot,Sivir,40,15,25,37.5
Urgot,Taliyah,33,17,16,51.52
Urgot,Pantheon,169,79,90,46.75
Urgot,Chogath,135,59,76,43.7
Urgot,Zac,61,22,39,36.07
Urgot,Tryndamere,36,18,18,50
Urgot,Vladimir,35,14,21,40
Urgot,Shyvana,30,15,15,50
Urgot,Draven,46,19,27,41.3
Urgot,Gnar,44,22,22,50
Urgot,Thresh,138,70,68,50.72
Urgot,Nocturne,125,70,55,56
Urgot,TwistedFate,30,14,16,46.67
Urgot,Ziggs,43,18,25,41.86
Urgot,Renata,28,14,14,50
Urgot,JarvanIV,67,26,41,38.81
Urgot,Viktor,92,56,36,60.87
Urgot,Renekton,47,33,14,70.21
Urgot,Vayne,134,53,81,39.55
Urgot,Sion,87,35,52,40.23
Urgot,Malzahar,117,54,63,46.15
Urgot,Janna,32,9,23,28.13
Urgot,Olaf,12,4,8,33.33
Urgot,Zeri,27,16,11,59.26
Urgot,Nidalee,36,24,12,66.67
Urgot,Alistar,75,42,33,56
Urgot,Zilean,28,18,10,64.29
Urgot,Camille,36,26,10,72.22
Urgot,Tristana,98,58,40,59.18
Urgot,Karthus,24,13,11,54.17
Urgot,Rammus,52,38,14,73.08
Urgot,Kassadin,19,14,5,73.68
Urgot,Twitch,82,41,41,50
Urgot,Jax,77,43,34,55.84
Urgot,Evelynn,56,24,32,42.86
Urgot,Leblanc,62,28,34,45.16
Urgot,Rumble,36,20,16,55.56
Urgot,XinZhao,69,36,33,52.17
Urgot,Fizz,43,29,14,67.44
Urgot,Pyke,71,46,25,64.79
Urgot,Zed,84,63,21,75
Urgot,Talon,49,26,23,53.06
Urgot,Azir,38,18,20,47.37
Urgot,Ekko,68,39,29,57.35
Urgot,Bard,27,21,6,77.78
Urgot,MasterYi,87,43,44,49.43
Urgot,Akshan,46,22,24,47.83
Urgot,Soraka,50,22,28,44
Urgot,Morgana,84,39,45,46.43
Urgot,Illaoi,58,28,30,48.28
Urgot,Quinn,46,29,17,63.04
Urgot,Xerath,97,51,46,52.58
Urgot,Syndra,94,52,42,55.32
Urgot,MonkeyKing,56,24,32,42.86
Urgot,Anivia,32,18,14,56.25
Urgot,Corki,67,25,42,37.31
Urgot,Leona,102,50,52,49.02
Urgot,Senna,48,32,16,66.67
Urgot,Sejuani,63,36,27,57.14
Urgot,Galio,95,50,45,52.63
Urgot,DrMundo,55,28,27,50.91
Urgot,Fiora,25,23,2,92
Urgot,Lillia,60,31,29,51.67
Urgot,Belveth,12,12,0,100
Urgot,Kalista,26,18,8,69.23
Urgot,Xayah,46,23,23,50
Urgot,Aphelios,57,30,27,52.63
Urgot,Velkoz,71,37,34,52.11
Urgot,Nilah,40,21,19,52.5
Urgot,FiddleSticks,36,22,14,61.11
Urgot,Hecarim,38,33,5,86.84
Urgot,Rengar,32,17,15,53.13
Urgot,Jayce,30,15,15,50
Urgot,Maokai,46,20,26,43.48
Urgot,Kennen,26,12,14,46.15
Urgot,Lissandra,21,8,13,38.1
Urgot,Annie,34,8,26,23.53
Urgot,Kled,16,4,12,25
Urgot,Singed,24,14,10,58.33
Urgot,RekSai,15,10,5,66.67
Urgot,Kindred,49,29,20,59.18
Urgot,Zoe,18,7,11,38.89
Urgot,Ivern,14,11,3,78.57
Diana,Gangplank,126,56,70,44.44
Diana,Volibear,327,146,181,44.65
Diana,Irelia,254,129,125,50.79
Diana,Kaisa,468,262,206,55.98
Diana,Nautilus,415,196,219,47.23
Diana,Garen,409,204,205,49.88
Diana,Zed,272,147,125,54.04
Diana,Mel,616,331,285,53.73
Diana,Caitlyn,678,343,335,50.59
Diana,Morgana,271,131,140,48.34
Diana,Akali,296,144,152,48.65
Diana,LeeSin,546,273,273,50
Diana,Yasuo,513,216,297,42.11
Diana,Hwei,183,105,78,57.38
Diana,Pyke,250,129,121,51.6
Diana,Amumu,326,152,174,46.63
Diana,Riven,125,79,46,63.2
Diana,Lux,703,388,315,55.19
Diana,Vladimir,154,67,87,43.51
Diana,MasterYi,227,112,115,49.34
Diana,Leona,275,164,111,59.64
Diana,Ashe,521,255,266,48.94
Diana,Mordekaiser,385,167,218,43.38
Diana,Gragas,241,138,103,57.26
Diana,Viego,379,199,180,52.51
Diana,Xayah,169,64,105,37.87
Diana,Lucian,227,119,108,52.42
Diana,Rell,171,72,99,42.11
Diana,Shen,181,94,87,51.93
Diana,Shaco,235,127,108,54.04
Diana,Heimerdinger,119,65,54,54.62
Diana,Ezreal,797,401,396,50.31
Diana,Thresh,454,206,248,45.37
Diana,Yone,576,286,290,49.65
Diana,Varus,243,125,118,51.44
Diana,Karma,282,135,147,47.87
Diana,Darius,515,256,259,49.71
Diana,Teemo,293,145,148,49.49
Diana,Nilah,84,42,42,50
Diana,Braum,260,96,164,36.92
Diana,Illaoi,152,68,84,44.74
Diana,Pantheon,484,265,219,54.75
Diana,Vex,166,60,106,36.14
Diana,TahmKench,267,135,132,50.56
Diana,Rengar,77,50,27,64.94
Diana,Chogath,368,169,199,45.92
Diana,Zyra,249,115,134,46.18
Diana,Hecarim,91,49,42,53.85
Diana,Sett,421,198,223,47.03
Diana,Lulu,381,187,194,49.08
Diana,Lillia,151,72,79,47.68
Diana,Camille,128,53,75,41.41
Diana,Draven,175,84,91,48
Diana,Senna,171,89,82,52.05
Diana,MonkeyKing,184,74,110,40.22
Diana,Vayne,382,180,202,47.12
Diana,Fiora,100,49,51,49
Diana,Soraka,101,52,49,51.49
Diana,Azir,144,82,62,56.94
Diana,Ekko,211,95,116,45.02
Diana,Qiyana,68,38,30,55.88
Diana,Anivia,109,47,62,43.12
Diana,Jhin,518,286,232,55.21
Diana,Renekton,162,89,73,54.94
Diana,Jax,274,146,128,53.28
Diana,Leblanc,154,63,91,40.91
Diana,Gwen,170,79,91,46.47
Diana,Graves,201,90,111,44.78
Diana,Ziggs,122,72,50,59.02
Diana,Zoe,125,65,60,52
Diana,Rammus,111,49,62,44.14
Diana,Kayle,143,59,84,41.26
Diana,Kayn,398,200,198,50.25
Diana,Malphite,318,162,156,50.94
Diana,Jinx,647,284,363,43.89
Diana,Evelynn,134,74,60,55.22
Diana,Brand,177,90,87,50.85
Diana,MissFortune,610,304,306,49.84
Diana,Twitch,230,117,113,50.87
Diana,Gnar,164,90,74,54.88
Diana,Khazix,126,55,71,43.65
Diana,Nami,274,136,138,49.64
Diana,Sylas,511,250,261,48.92
Diana,Samira,185,78,107,42.16
Diana,Poppy,249,121,128,48.59
Diana,Vi,399,189,210,47.37
Diana,Veigar,269,114,155,42.38
Diana,Shyvana,88,23,65,26.14
Diana,Galio,360,151,209,41.94
Diana,Xerath,175,74,101,42.29
Diana,Urgot,134,72,62,53.73
Diana,FiddleSticks,144,61,83,42.36
Diana,Kalista,113,43,70,38.05
Diana,Trundle,132,72,60,54.55
Diana,Tristana,230,116,114,50.43
Diana,Blitzcrank,309,158,151,51.13
Diana,Nidalee,129,71,58,55.04
Diana,Ambessa,249,128,121,51.41
Diana,KogMaw,90,37,53,41.11
Diana,Smolder,236,108,128,45.76
Diana,Seraphine,221,114,107,51.58
Diana,Ornn,158,80,78,50.63
Diana,Sejuani,175,82,93,46.86
Diana,Lissandra,108,66,42,61.11
Diana,Malzahar,305,168,137,55.08
Diana,Milio,171,81,90,47.37
Diana,Swain,274,134,140,48.91
Diana,Velkoz,185,74,111,40
Diana,Briar,176,62,114,35.23
Diana,Zac,185,81,104,43.78
Diana,Corki,133,70,63,52.63
Diana,Warwick,349,186,163,53.3
Diana,Orianna,120,72,48,60
Diana,Aatrox,287,141,146,49.13
Diana,Maokai,161,66,95,40.99
Diana,Ivern,90,55,35,61.11
Diana,Quinn,84,47,37,55.95
Diana,Nasus,163,71,92,43.56
Diana,Naafiri,91,44,47,48.35
Diana,Ryze,83,51,32,61.45
Diana,Fizz,114,59,55,51.75
Diana,AurelionSol,103,60,43,58.25
Diana,Nunu,186,107,79,57.53
Diana,Alistar,182,85,97,46.7
Diana,Aurora,231,109,122,47.19
Diana,Nocturne,344,192,152,55.81
Diana,Syndra,236,101,135,42.8
Diana,Aphelios,170,84,86,49.41
Diana,DrMundo,128,66,62,51.56
Diana,Sion,224,119,105,53.13
Diana,Kled,65,34,31,52.31
Diana,Cassiopeia,64,27,37,42.19
Diana,Neeko,123,57,66,46.34
Diana,Rakan,170,85,85,50
Diana,Belveth,42,29,13,69.05
Diana,Ahri,414,233,181,56.28
Diana,Viktor,246,126,120,51.22
Diana,Janna,78,36,42,46.15
Diana,Sivir,128,53,75,41.41
Diana,Kassadin,61,33,28,54.1
Diana,Katarina,154,59,95,38.31
Diana,Yuumi,200,102,98,51
Diana,JarvanIV,215,99,116,46.05
Diana,Taric,84,42,42,50
Diana,Elise,235,115,120,48.94
Diana,Bard,96,43,53,44.79
Diana,Udyr,117,39,78,33.33
Diana,Jayce,130,64,66,49.23
Diana,Talon,115,72,43,62.61
Diana,Kindred,144,78,66,54.17
Diana,Zeri,131,60,71,45.8
Diana,Sona,44,23,21,52.27
Diana,Taliyah,69,31,38,44.93
Diana,Renata,65,39,26,60
Diana,KSante,187,98,89,52.41
Diana,Yorick,222,117,105,52.7
Diana,Skarner,136,57,79,41.91
Diana,TwistedFate,94,43,51,45.74
Diana,Annie,110,48,62,43.64
Diana,Karthus,61,39,22,63.93
Diana,Akshan,86,43,43,50
Diana,Singed,58,25,33,43.1
Diana,Zilean,86,40,46,46.51
Diana,Kennen,72,44,28,61.11
Diana,Rumble,102,42,60,41.18
Diana,XinZhao,211,93,118,44.08
Diana,Olaf,53,24,29,45.28
Diana,Tryndamere,103,52,51,50.49
Diana,RekSai,26,11,15,42.31
Syndra,Gangplank,45,23,22,51.11
Syndra,Volibear,166,74,92,44.58
Syndra,Irelia,93,51,42,54.84
Syndra,Kaisa,226,103,123,45.58
Syndra,Nautilus,192,84,108,43.75
Syndra,Mordekaiser,148,64,84,43.24
Syndra,Viego,208,114,94,54.81
Syndra,Yone,238,94,144,39.5
Syndra,Lucian,134,70,64,52.24
Syndra,Rakan,72,40,32,55.56
Syndra,Singed,32,16,16,50
Syndra,Darius,282,139,143,49.29
Syndra,Smolder,104,41,63,39.42
Syndra,Mel,258,138,120,53.49
Syndra,Pantheon,221,122,99,55.2
Syndra,Jayce,62,30,32,48.39
Syndra,Jhin,287,149,138,51.92
Syndra,JarvanIV,121,50,71,41.32
Syndra,Leblanc,88,49,39,55.68
Syndra,Vladimir,64,18,46,28.13
Syndra,Malzahar,158,81,77,51.27
Syndra,Sion,119,55,64,46.22
Syndra,Nasus,65,25,40,38.46
Syndra,MasterYi,119,80,39,67.23
Syndra,Morgana,129,70,59,54.26
Syndra,Trundle,77,45,32,58.44
Syndra,Janna,36,22,14,61.11
Syndra,Kayn,181,79,102,43.65
Syndra,Yasuo,220,121,99,55
Syndra,Yuumi,133,79,54,59.4
Syndra,Neeko,55,22,33,40
Syndra,Rammus,60,33,27,55
Syndra,KogMaw,57,30,27,52.63
Syndra,Lux,371,170,201,45.82
Syndra,Riven,55,32,23,58.18
Syndra,Seraphine,101,53,48,52.48
Syndra,Samira,104,47,57,45.19
Syndra,Hwei,157,80,77,50.96
Syndra,Sett,169,72,97,42.6
Syndra,Ivern,51,27,24,52.94
Syndra,Anivia,85,45,40,52.94
Syndra,Jinx,343,168,175,48.98
Syndra,Thresh,264,117,147,44.32
Syndra,Chogath,191,84,107,43.98
Syndra,LeeSin,243,157,86,64.61
Syndra,Lulu,223,115,108,51.57
Syndra,Xayah,92,46,46,50
Syndra,Warwick,195,100,95,51.28
Syndra,Swain,134,62,72,46.27
Syndra,Ekko,141,61,80,43.26
Syndra,TahmKench,138,57,81,41.3
Syndra,Ahri,290,150,140,51.72
Syndra,MissFortune,250,124,126,49.6
Syndra,Ambessa,111,65,46,58.56
Syndra,Nocturne,182,91,91,50
Syndra,Veigar,136,76,60,55.88
Syndra,Varus,142,72,70,50.7
Syndra,Malphite,150,60,90,40
Syndra,Diana,236,135,101,57.2
Syndra,Elise,134,44,90,32.84
Syndra,Aurora,150,70,80,46.67
Syndra,Kalista,82,43,39,52.44
Syndra,Vex,91,31,60,34.07
Syndra,Caitlyn,386,203,183,52.59
Syndra,Garen,237,110,127,46.41
Syndra,Braum,101,45,56,44.55
Syndra,Teemo,124,63,61,50.81
Syndra,Skarner,71,30,41,42.25
Syndra,Cassiopeia,46,17,29,36.96
Syndra,Zac,111,41,70,36.94
Syndra,MonkeyKing,93,36,57,38.71
Syndra,Xerath,134,71,63,52.99
Syndra,Rell,95,52,43,54.74
Syndra,Viktor,177,77,100,43.5
Syndra,Aatrox,136,65,71,47.79
Syndra,Udyr,56,29,27,51.79
Syndra,Lissandra,34,14,20,41.18
Syndra,Karthus,54,22,32,40.74
Syndra,Alistar,96,57,39,59.38
Syndra,Yorick,116,58,58,50
Syndra,Orianna,82,48,34,58.54
Syndra,Senna,64,20,44,31.25
Syndra,Graves,81,31,50,38.27
Syndra,Kassadin,26,14,12,53.85
Syndra,Aphelios,90,32,58,35.56
Syndra,Blitzcrank,130,45,85,34.62
Syndra,Tristana,109,59,50,54.13
Syndra,Leona,120,49,71,40.83
Syndra,Nilah,52,20,32,38.46
Syndra,Katarina,101,41,60,40.59
Syndra,Milio,129,74,55,57.36
Syndra,Fiora,52,23,29,44.23
Syndra,Karma,195,73,122,37.44
Syndra,Gwen,65,45,20,69.23
Syndra,Pyke,93,55,38,59.14
Syndra,Vayne,186,81,105,43.55
Syndra,Ezreal,314,161,153,51.27
Syndra,Sona,48,18,30,37.5
Syndra,Ashe,237,119,118,50.21
Syndra,Jax,134,69,65,51.49
Syndra,FiddleSticks,64,36,28,56.25
Syndra,AurelionSol,52,21,31,40.38
Syndra,Kayle,105,44,61,41.9
Syndra,Akali,115,71,44,61.74
Syndra,Zilean,59,32,27,54.24
Syndra,Renekton,69,36,33,52.17
Syndra,Camille,57,32,25,56.14
Syndra,Nami,166,69,97,41.57
Syndra,Twitch,125,72,53,57.6
Syndra,Nidalee,46,32,14,69.57
Syndra,Naafiri,42,28,14,66.67
Syndra,Draven,70,35,35,50
Syndra,Sejuani,88,34,54,38.64
Syndra,Lillia,60,25,35,41.67
Syndra,Zoe,64,32,32,50
Syndra,Gragas,88,38,50,43.18
Syndra,Sivir,86,46,40,53.49
Syndra,Qiyana,35,20,15,57.14
Syndra,Galio,176,80,96,45.45
Syndra,Brand,77,42,35,54.55
Syndra,Shyvana,48,15,33,31.25
Syndra,Shen,132,75,57,56.82
Syndra,Fizz,85,45,40,52.94
Syndra,Maokai,83,50,33,60.24
Syndra,Illaoi,54,26,28,48.15
Syndra,Heimerdinger,82,50,32,60.98
Syndra,Gnar,79,48,31,60.76
Syndra,Hecarim,45,13,32,28.89
Syndra,Evelynn,47,22,25,46.81
Syndra,Vi,149,60,89,40.27
Syndra,Urgot,94,42,52,44.68
Syndra,Renata,41,20,21,48.78
Syndra,Kindred,37,23,14,62.16
Syndra,Azir,84,48,36,57.14
Syndra,Taliyah,43,22,21,51.16
Syndra,Akshan,48,25,23,52.08
Syndra,Briar,65,24,41,36.92
Syndra,XinZhao,73,43,30,58.9
Syndra,Sylas,140,57,83,40.71
Syndra,Belveth,17,5,12,29.41
Syndra,Shaco,70,36,34,51.43
Syndra,Ryze,52,23,29,44.23
Syndra,Zyra,104,49,55,47.12
Syndra,Bard,46,31,15,67.39
Syndra,Amumu,112,46,66,41.07
Syndra,Kennen,28,10,18,35.71
Syndra,Quinn,58,28,30,48.28
Syndra,Zed,109,50,59,45.87
Syndra,RekSai,26,15,11,57.69
Syndra,Khazix,81,29,52,35.8
Syndra,Ornn,80,47,33,58.75
Syndra,Poppy,90,48,42,53.33
Syndra,KSante,78,44,34,56.41
Syndra,Kled,31,22,9,70.97
Syndra,Annie,63,27,36,42.86
Syndra,Corki,45,19,26,42.22
Syndra,Nunu,80,53,27,66.25
Syndra,Talon,40,23,17,57.5
Syndra,DrMundo,63,26,37,41.27
Syndra,Ziggs,44,18,26,40.91
Syndra,Velkoz,69,50,19,72.46
Syndra,Rengar,33,21,12,63.64
Syndra,Soraka,65,34,31,52.31
Syndra,Olaf,53,29,24,54.72
Syndra,Tryndamere,53,25,28,47.17
Syndra,TwistedFate,49,30,19,61.22
Syndra,Rumble,44,22,22,50
Syndra,Zeri,69,28,41,40.58
Syndra,Taric,44,17,27,38.64
Braum,Gangplank,74,46,28,62.16
Braum,Volibear,155,78,77,50.32
Braum,Irelia,139,78,61,56.12
Braum,Kaisa,316,169,147,53.48
Braum,Nautilus,307,164,143,53.42
Braum,Vladimir,93,48,45,51.61
Braum,Kayn,172,78,94,45.35
Braum,Velkoz,92,37,55,40.22
Braum,Xayah,81,38,43,46.91
Braum,Leblanc,80,47,33,58.75
Braum,Garen,273,116,157,42.49
Braum,Shaco,114,59,55,51.75
Braum,Tristana,116,42,74,36.21
Braum,Ezreal,374,203,171,54.28
Braum,Swain,169,77,92,45.56
Braum,Mordekaiser,196,91,105,46.43
Braum,Amumu,203,87,116,42.86
Braum,Yone,282,143,139,50.71
Braum,Varus,165,76,89,46.06
Braum,Karma,211,139,72,65.88
Braum,Diana,260,164,96,63.08
Braum,Caitlyn,370,209,161,56.49
Braum,Xerath,131,67,64,51.15
Braum,Sion,118,49,69,41.53
Braum,Aatrox,128,97,31,75.78
Braum,TwistedFate,61,43,18,70.49
Braum,Lux,289,156,133,53.98
Braum,Lulu,196,105,91,53.57
Braum,Yorick,148,78,70,52.7
Braum,Kindred,65,39,26,60
Braum,Katarina,75,35,40,46.67
Braum,Neeko,93,53,40,56.99
Braum,Camille,70,37,33,52.86
Braum,Malzahar,209,115,94,55.02
Braum,Sivir,75,38,37,50.67
Braum,Zyra,125,63,62,50.4
Braum,Graves,87,56,31,64.37
Braum,Hwei,121,60,61,49.59
Braum,Nilah,43,15,28,34.88
Braum,Nami,192,93,99,48.44
Braum,Lissandra,68,32,36,47.06
Braum,Kalista,66,31,35,46.97
Braum,Rell,132,57,75,43.18
Braum,Darius,291,152,139,52.23
Braum,LeeSin,237,159,78,67.09
Braum,Elise,137,82,55,59.85
Braum,Quinn,45,24,21,53.33
Braum,Jayce,87,33,54,37.93
Braum,Jhin,271,161,110,59.41
Braum,Singed,35,23,12,65.71
Braum,JarvanIV,154,75,79,48.7
Braum,Shen,137,65,72,47.45
Braum,Riven,61,33,28,54.1
Braum,Yasuo,322,149,173,46.27
Braum,MissFortune,370,185,185,50
Braum,Leona,196,101,95,51.53
Braum,Trundle,76,40,36,52.63
Braum,Warwick,228,140,88,61.4
Braum,Nocturne,167,77,90,46.11
Braum,Brand,114,64,50,56.14
Braum,Vi,177,82,95,46.33
Braum,Zed,134,81,53,60.45
Braum,Samira,108,70,38,64.81
Braum,Morgana,120,57,63,47.5
Braum,Mel,274,134,140,48.91
Braum,Renata,44,10,34,22.73
Braum,Teemo,106,53,53,50
Braum,Fiora,57,32,25,56.14
Braum,Akali,145,96,49,66.21
Braum,Yuumi,112,55,57,49.11
Braum,Renekton,88,41,47,46.59
Braum,AurelionSol,60,17,43,28.33
Braum,Nunu,107,72,35,67.29
Braum,Gragas,111,63,48,56.76
Braum,Corki,93,52,41,55.91
Braum,Thresh,368,216,152,58.7
Braum,Lucian,115,67,48,58.26
Braum,Belveth,44,22,22,50
Braum,Jax,121,75,46,61.98
Braum,Senna,128,59,69,46.09
Braum,Gwen,104,51,53,49.04
Braum,Galio,135,69,66,51.11
Braum,Vayne,170,88,82,51.76
Braum,Seraphine,113,63,50,55.75
Braum,Zac,129,82,47,63.57
Braum,Sylas,238,146,92,61.34
Braum,Veigar,125,34,91,27.2
Braum,Smolder,95,44,51,46.32
Braum,Nasus,78,33,45,42.31
Braum,Jinx,396,188,208,47.47
Braum,Viego,227,121,106,53.3
Braum,Urgot,71,47,24,66.2
Braum,Syndra,101,56,45,55.45
Braum,MasterYi,144,81,63,56.25
Braum,Ziggs,61,28,33,45.9
Braum,Evelynn,40,28,12,70
Braum,Aurora,126,68,58,53.97
Braum,Maokai,76,44,32,57.89
Braum,Vex,87,44,43,50.57
Braum,Zilean,55,26,29,47.27
Braum,Khazix,71,42,29,59.15
Braum,Draven,93,48,45,51.61
Braum,Ambessa,135,68,67,50.37
Braum,Rengar,40,22,18,55
Braum,Blitzcrank,145,65,80,44.83
Braum,KSante,120,77,43,64.17
Braum,Hecarim,56,31,25,55.36
Braum,TahmKench,147,91,56,61.9
Braum,XinZhao,98,44,54,44.9
Braum,Milio,90,49,41,54.44
Braum,DrMundo,98,44,54,44.9
Braum,Rumble,44,25,19,56.82
Braum,Illaoi,67,31,36,46.27
Braum,FiddleSticks,52,19,33,36.54
Braum,Pyke,126,67,59,53.17
Braum,Alistar,87,40,47,45.98
Braum,Ryze,69,37,32,53.62
Braum,Ashe,288,164,124,56.94
Braum,Pantheon,237,130,107,54.85
Braum,Janna,58,30,28,51.72
Braum,Olaf,43,22,21,51.16
Braum,Taliyah,36,20,16,55.56
Braum,Twitch,114,78,36,68.42
Braum,Lillia,116,58,58,50
Braum,Ahri,235,116,119,49.36
Braum,Rakan,70,30,40,42.86
Braum,Sett,242,102,140,42.15
Braum,Poppy,130,63,67,48.46
Braum,Kayle,71,34,37,47.89
Braum,Taric,26,13,13,50
Braum,Ornn,119,68,51,57.14
Braum,Zoe,65,42,23,64.62
Braum,Gnar,84,41,43,48.81
Braum,Briar,101,47,54,46.53
Braum,Ekko,113,57,56,50.44
Braum,Rammus,54,30,24,55.56
Braum,Aphelios,77,44,33,57.14
Braum,Annie,42,16,26,38.1
Braum,Fizz,120,67,53,55.83
Braum,Sejuani,115,51,64,44.35
Braum,Kassadin,36,14,22,38.89
Braum,Sona,27,15,12,55.56
Braum,Soraka,74,34,40,45.95
Braum,Karthus,51,19,32,37.25
Braum,Malphite,154,52,102,33.77
Braum,Chogath,200,108,92,54
Braum,KogMaw,69,20,49,28.99
Braum,Azir,66,45,21,68.18
Braum,Shyvana,35,14,21,40
Braum,Qiyana,27,17,10,62.96
Braum,Akshan,36,17,19,47.22
Braum,MonkeyKing,87,38,49,43.68
Braum,Orianna,66,28,38,42.42
Braum,Talon,61,33,28,54.1
Braum,Bard,60,22,38,36.67
Braum,Tryndamere,52,36,16,69.23
Braum,Nidalee,40,19,21,47.5
Braum,Heimerdinger,52,38,14,73.08
Braum,Udyr,34,21,13,61.76
Braum,Skarner,94,55,39,58.51
Braum,Viktor,143,78,65,54.55
Braum,Naafiri,32,13,19,40.63
Braum,Kennen,52,19,33,36.54
Braum,Kled,24,7,17,29.17
Braum,Cassiopeia,34,11,23,32.35
Braum,Anivia,38,17,21,44.74
Braum,Ivern,33,22,11,66.67
Braum,RekSai,28,13,15,46.43
Braum,Zeri,66,31,35,46.97
Teemo,Jax,175,90,85,51.43
Teemo,Sejuani,124,56,68,45.16
Teemo,Hwei,123,72,51,58.54
Teemo,Ezreal,412,211,201,51.21
Teemo,Zac,124,61,63,49.19
Teemo,Chogath,270,103,167,38.15
Teemo,Lillia,127,50,77,39.37
Teemo,Tryndamere,71,43,28,60.56
Teemo,Caitlyn,512,267,245,52.15
Teemo,Karma,213,103,110,48.36
Teemo,Garen,318,161,157,50.63
Teemo,Zed,228,115,113,50.44
Teemo,Mel,473,227,246,47.99
Teemo,Morgana,194,109,85,56.19
Teemo,Corki,64,25,39,39.06
Teemo,Ekko,163,81,82,49.69
Teemo,Leblanc,101,51,50,50.5
Teemo,Kled,23,21,2,91.3
Teemo,Kayn,282,159,123,56.38
Teemo,Katarina,132,63,69,47.73
Teemo,Twitch,182,105,77,57.69
Teemo,Thresh,294,155,139,52.72
Teemo,Sion,245,92,153,37.55
Teemo,RekSai,38,25,13,65.79
Teemo,Viktor,181,79,102,43.65
Teemo,KogMaw,72,44,28,61.11
Teemo,Ashe,350,147,203,42
Teemo,Malphite,299,142,157,47.49
Teemo,Vi,188,102,86,54.26
Teemo,Azir,71,34,37,47.89
Teemo,MissFortune,443,203,240,45.82
Teemo,Lulu,211,124,87,58.77
Teemo,Graves,86,33,53,38.37
Teemo,Kassadin,37,17,20,45.95
Teemo,Tristana,141,65,76,46.1
Teemo,Nami,219,85,134,38.81
Teemo,Irelia,155,82,73,52.9
Teemo,Jhin,356,190,166,53.37
Teemo,Skarner,76,40,36,52.63
Teemo,Aurora,171,86,85,50.29
Teemo,Yuumi,164,73,91,44.51
Teemo,Pantheon,308,157,151,50.97
Teemo,Zoe,80,41,39,51.25
Teemo,Ziggs,78,32,46,41.03
Teemo,Veigar,208,83,125,39.9
Teemo,Mordekaiser,279,125,154,44.8
Teemo,Diana,293,148,145,50.51
Teemo,Yone,344,185,159,53.78
Teemo,Xerath,157,79,78,50.32
Teemo,KSante,63,31,32,49.21
Teemo,Nunu,129,78,51,60.47
Teemo,Akshan,71,35,36,49.3
Teemo,Seraphine,126,57,69,45.24
Teemo,Malzahar,177,98,79,55.37
Teemo,Lucian,183,84,99,45.9
Teemo,Aphelios,107,52,55,48.6
Teemo,Udyr,73,34,39,46.58
Teemo,Yasuo,386,179,207,46.37
Teemo,Karthus,42,16,26,38.1
Teemo,Renekton,86,62,24,72.09
Teemo,Varus,203,98,105,48.28
Teemo,Kalista,71,40,31,56.34
Teemo,Amumu,252,128,124,50.79
Teemo,Milio,136,76,60,55.88
Teemo,Riven,49,27,22,55.1
Teemo,Shyvana,60,31,29,51.67
Teemo,Ryze,120,51,69,42.5
Teemo,Velkoz,107,49,58,45.79
Teemo,Sett,229,126,103,55.02
Teemo,Warwick,260,138,122,53.08
Teemo,Darius,378,187,191,49.47
Teemo,Smolder,152,76,76,50
Teemo,Vex,111,54,57,48.65
Teemo,Lux,407,223,184,54.79
Teemo,Sylas,244,121,123,49.59
Teemo,Ornn,98,51,47,52.04
Teemo,Ahri,250,117,133,46.8
Teemo,Urgot,96,57,39,59.38
Teemo,Kindred,78,51,27,65.38
Teemo,Volibear,204,104,100,50.98
Teemo,Shaco,119,71,48,59.66
Teemo,Vayne,221,122,99,55.2
Teemo,Rakan,117,57,60,48.72
Teemo,Aatrox,215,104,111,48.37
Teemo,AurelionSol,77,28,49,36.36
Teemo,MonkeyKing,103,37,66,35.92
Teemo,Poppy,124,67,57,54.03
Teemo,Akali,223,122,101,54.71
Teemo,Blitzcrank,174,89,85,51.15
Teemo,Zilean,83,50,33,60.24
Teemo,Braum,106,53,53,50
Teemo,Jinx,450,216,234,48
Teemo,LeeSin,292,144,148,49.32
Teemo,Zyra,149,65,84,43.62
Teemo,Heimerdinger,123,59,64,47.97
Teemo,Taliyah,41,26,15,63.41
Teemo,MasterYi,196,98,98,50
Teemo,Gangplank,96,55,41,57.29
Teemo,Galio,208,124,84,59.62
Teemo,Elise,132,73,59,55.3
Teemo,Fizz,86,49,37,56.98
Teemo,Sivir,90,43,47,47.78
Teemo,Brand,133,76,57,57.14
Teemo,Yorick,180,93,87,51.67
Teemo,Swain,186,87,99,46.77
Teemo,Samira,142,70,72,49.3
Teemo,Rell,117,69,48,58.97
Teemo,Zeri,81,38,43,46.91
Teemo,FiddleSticks,71,31,40,43.66
Teemo,Belveth,48,31,17,64.58
Teemo,Kaisa,279,165,114,59.14
Teemo,TahmKench,177,76,101,42.94
Teemo,Ambessa,134,56,78,41.79
Teemo,Taric,55,20,35,36.36
Teemo,Shen,105,40,65,38.1
Teemo,Jayce,81,41,40,50.62
Teemo,Draven,105,54,51,51.43
Teemo,Syndra,124,61,63,49.19
Teemo,Nautilus,234,98,136,41.88
Teemo,Talon,99,59,40,59.6
Teemo,Illaoi,77,36,41,46.75
Teemo,Vladimir,140,60,80,42.86
Teemo,Rammus,52,18,34,34.62
Teemo,XinZhao,82,28,54,34.15
Teemo,Maokai,81,41,40,50.62
Teemo,Neeko,112,50,62,44.64
Teemo,JarvanIV,113,46,67,40.71
Teemo,Nocturne,211,76,135,36.02
Teemo,Hecarim,68,19,49,27.94
Teemo,Lissandra,50,31,19,62
Teemo,Cassiopeia,54,27,27,50
Teemo,Khazix,81,43,38,53.09
Teemo,Leona,187,97,90,51.87
Teemo,Gnar,85,52,33,61.18
Teemo,Soraka,126,53,73,42.06
Teemo,Kayle,128,70,58,54.69
Teemo,Viego,230,119,111,51.74
Teemo,Fiora,37,25,12,67.57
Teemo,Gragas,127,69,58,54.33
Teemo,Senna,78,33,45,42.31
Teemo,Naafiri,77,39,38,50.65
Teemo,Renata,44,18,26,40.91
Teemo,Nasus,102,55,47,53.92
Teemo,Briar,106,66,40,62.26
Teemo,Pyke,176,94,82,53.41
Teemo,Camille,52,27,25,51.92
Teemo,Ivern,42,19,23,45.24
Teemo,Sona,41,13,28,31.71
Teemo,Rengar,47,29,18,61.7
Teemo,Gwen,80,32,48,40
Teemo,Xayah,116,56,60,48.28
Teemo,Trundle,109,68,41,62.39
Teemo,Quinn,64,38,26,59.38
Teemo,Janna,57,22,35,38.6
Teemo,Olaf,38,27,11,71.05
Teemo,Singed,46,15,31,32.61
Teemo,Alistar,130,59,71,45.38
Teemo,Rumble,68,44,24,64.71
Teemo,Annie,80,27,53,33.75
Teemo,Evelynn,53,42,11,79.25
Teemo,DrMundo,82,20,62,24.39
Teemo,TwistedFate,70,41,29,58.57
Teemo,Nilah,65,40,25,61.54
Teemo,Orianna,70,34,36,48.57
Teemo,Qiyana,56,25,31,44.64
Teemo,Nidalee,80,46,34,57.5
Teemo,Kennen,80,31,49,38.75
Teemo,Anivia,57,29,28,50.88
Teemo,Bard,59,22,37,37.29
Ryze,Jax,50,25,25,50
Ryze,Sejuani,62,23,39,37.1
Ryze,Hwei,56,32,24,57.14
Ryze,Ezreal,223,111,112,49.78
Ryze,Zac,54,15,39,27.78
Ryze,Heimerdinger,46,24,22,52.17
Ryze,Gragas,57,24,33,42.11
Ryze,Viktor,105,55,50,52.38
Ryze,Jinx,180,84,96,46.67
Ryze,Pyke,59,26,33,44.07
Ryze,Garen,106,48,58,45.28
Ryze,Warwick,125,50,75,40
Ryze,Ahri,141,65,76,46.1
Ryze,Milio,65,24,41,36.92
Ryze,Nasus,38,24,14,63.16
Ryze,Viego,120,64,56,53.33
Ryze,Cassiopeia,32,15,17,46.88
Ryze,Karma,112,52,60,46.43
Ryze,Teemo,120,69,51,57.5
Ryze,Rammus,26,6,20,23.08
Ryze,Leblanc,27,17,10,62.96
Ryze,Caitlyn,228,100,128,43.86
Ryze,Gwen,49,31,18,63.27
Ryze,Briar,43,19,24,44.19
Ryze,Aurora,69,25,44,36.23
Ryze,Soraka,40,17,23,42.5
Ryze,Vayne,112,54,58,48.21
Ryze,Yuumi,71,39,32,54.93
Ryze,JarvanIV,55,25,30,45.45
Ryze,Irelia,80,43,37,53.75
Ryze,KSante,57,15,42,26.32
Ryze,Kaisa,97,46,51,47.42
Ryze,Zilean,29,17,12,58.62
Ryze,Vladimir,60,24,36,40
Ryze,Tristana,52,32,20,61.54
Ryze,Lulu,124,73,51,58.87
Ryze,Kayn,108,58,50,53.7
Ryze,Malphite,91,40,51,43.96
Ryze,Lux,168,74,94,44.05
Ryze,Urgot,17,11,6,64.71
Ryze,Mel,110,60,50,54.55
Ryze,Amumu,100,47,53,47
Ryze,Aatrox,82,31,51,37.8
Ryze,Belveth,25,14,11,56
Ryze,Ziggs,29,6,23,20.69
Ryze,Morgana,71,41,30,57.75
Ryze,Gnar,37,19,18,51.35
Ryze,Shyvana,27,13,14,48.15
Ryze,Galio,93,40,53,43.01
Ryze,Xerath,71,29,42,40.85
Ryze,Darius,140,53,87,37.86
Ryze,Mordekaiser,88,46,42,52.27
Ryze,Nocturne,81,35,46,43.21
Ryze,Brand,34,16,18,47.06
Ryze,Nami,95,38,57,40
Ryze,Malzahar,87,38,49,43.68
Ryze,Diana,83,32,51,38.55
Ryze,Twitch,52,22,30,42.31
Ryze,Swain,75,33,42,44
Ryze,Nunu,56,23,33,41.07
Ryze,Zed,70,21,49,30
Ryze,MonkeyKing,46,26,20,56.52
Ryze,Elise,93,58,35,62.37
Ryze,Yorick,56,31,25,55.36
Ryze,Akali,88,49,39,55.68
Ryze,Sivir,55,24,31,43.64
Ryze,Yone,140,72,68,51.43
Ryze,Ekko,64,24,40,37.5
Ryze,Samira,75,42,33,56
Ryze,Ornn,55,28,27,50.91
Ryze,Shaco,41,22,19,53.66
Ryze,Zyra,50,28,22,56
Ryze,Thresh,135,69,66,51.11
Ryze,Braum,69,32,37,46.38
Ryze,Chogath,117,61,56,52.14
Ryze,Poppy,65,31,34,47.69
Ryze,Yasuo,152,88,64,57.89
Ryze,MissFortune,126,59,67,46.83
Ryze,Seraphine,57,23,34,40.35
Ryze,Varus,81,44,37,54.32
Ryze,Riven,32,18,14,56.25
Ryze,Qiyana,29,9,20,31.03
Ryze,Sona,26,11,15,42.31
Ryze,Ashe,127,76,51,59.84
Ryze,LeeSin,162,74,88,45.68
Ryze,Smolder,44,24,20,54.55
Ryze,TahmKench,70,26,44,37.14
Ryze,Jhin,138,71,67,51.45
Ryze,Trundle,39,22,17,56.41
Ryze,MasterYi,53,37,16,69.81
Ryze,Azir,56,22,34,39.29
Ryze,Nilah,21,12,9,57.14
Ryze,Vi,76,35,41,46.05
Ryze,DrMundo,52,22,30,42.31
Ryze,Katarina,33,19,14,57.58
Ryze,Draven,36,17,19,47.22
Ryze,KogMaw,20,3,17,15
Ryze,Anivia,33,9,24,27.27
Ryze,Quinn,25,14,11,56
Ryze,Talon,41,29,12,70.73
Ryze,Ambessa,83,40,43,48.19
Ryze,Udyr,23,12,11,52.17
Ryze,Veigar,80,41,39,51.25
Ryze,Sion,69,37,32,53.62
Ryze,Graves,55,11,44,20
Ryze,Pantheon,120,79,41,65.83
Ryze,Volibear,74,34,40,45.95
Ryze,Skarner,31,14,17,45.16
Ryze,Singed,25,12,13,48
Ryze,Lillia,30,17,13,56.67
Ryze,Gangplank,39,28,11,71.79
Ryze,Camille,30,11,19,36.67
Ryze,Alistar,44,26,18,59.09
Ryze,Orianna,37,27,10,72.97
Ryze,Renekton,37,17,20,45.95
Ryze,Hecarim,22,20,2,90.91
Ryze,Karthus,33,18,15,54.55
Ryze,Xayah,39,24,15,61.54
Ryze,Sett,78,48,30,61.54
Ryze,Zeri,48,22,26,45.83
Ryze,Rell,44,25,19,56.82
Ryze,Kennen,23,9,14,39.13
Ryze,FiddleSticks,39,19,20,48.72
Ryze,Akshan,27,8,19,29.63
Ryze,Illaoi,35,20,15,57.14
Ryze,Maokai,39,21,18,53.85
Ryze,Khazix,22,8,14,36.36
Ryze,Jayce,24,14,10,58.33
Ryze,Rengar,31,17,14,54.84
Ryze,TwistedFate,41,24,17,58.54
Ryze,Syndra,52,29,23,55.77
Ryze,Leona,78,47,31,60.26
Ryze,Blitzcrank,65,38,27,58.46
Ryze,Nautilus,96,46,50,47.92
Ryze,Sylas,127,73,54,57.48
Ryze,Velkoz,42,26,16,61.9
Ryze,Corki,29,16,13,55.17
Ryze,Kayle,30,15,15,50
Ryze,Aphelios,61,33,28,54.1
Ryze,AurelionSol,30,12,18,40
Ryze,Senna,56,30,26,53.57
Ryze,Vex,37,20,17,54.05
Ryze,Rakan,43,28,15,65.12
Ryze,Kindred,25,18,7,72
Ryze,Fiora,37,16,21,43.24
Ryze,XinZhao,56,31,25,55.36
Ryze,Lucian,62,21,41,33.87
Ryze,Taliyah,35,17,18,48.57
Ryze,Fizz,47,26,21,55.32
Ryze,Janna,16,5,11,31.25
Ryze,Shen,71,40,31,56.34
Ryze,Lissandra,19,8,11,42.11
Ryze,Bard,24,5,19,20.83
Ryze,Annie,14,7,7,50
Ryze,Kled,17,5,12,29.41
Ryze,Evelynn,11,6,5,54.55
Ryze,Zoe,25,10,15,40
Ryze,Ivern,19,8,11,42.11
Ryze,Neeko,41,23,18,56.1
Ryze,Olaf,20,8,12,40
Ryze,Tryndamere,13,8,5,61.54
Ryze,Renata,13,8,5,61.54
Ryze,Naafiri,12,4,8,33.33
Ryze,RekSai,11,6,5,54.55
Ryze,Kassadin,8,5,3,62.5
Ryze,Nidalee,27,21,6,77.78
Ryze,Kalista,19,9,10,47.37
Ryze,Rumble,15,9,6,60
Ryze,Taric,17,11,6,64.71
Jax,Teemo,175,85,90,48.57
Jax,Kayn,249,139,110,55.82
Jax,Yone,364,179,185,49.18
Jax,Ryze,50,25,25,50
Jax,Lux,417,193,224,46.28
Jax,Sett,258,128,130,49.61
Jax,Katarina,119,57,62,47.9
Jax,Jinx,456,184,272,40.35
Jax,Renata,40,19,21,47.5
Jax,Mordekaiser,189,98,91,51.85
Jax,Caitlyn,455,240,215,52.75
Jax,Morgana,166,81,85,48.8
Jax,Gangplank,63,21,42,33.33
Jax,FiddleSticks,77,37,40,48.05
Jax,Veigar,193,87,106,45.08
Jax,Ezreal,453,215,238,47.46
Jax,Gragas,150,82,68,54.67
Jax,Viego,267,132,135,49.44
Jax,Xayah,92,52,40,56.52
Jax,Lucian,156,72,84,46.15
Jax,Rell,98,53,45,54.08
Jax,Darius,282,162,120,57.45
Jax,Graves,117,62,55,52.99
Jax,Neeko,80,49,31,61.25
Jax,Draven,85,55,30,64.71
Jax,Alistar,86,54,32,62.79
Jax,MasterYi,238,122,116,51.26
Jax,Samira,117,59,58,50.43
Jax,Singed,39,15,24,38.46
Jax,Illaoi,117,45,72,38.46
Jax,Twitch,96,48,48,50
Jax,Ahri,246,120,126,48.78
Jax,Kaisa,270,127,143,47.04
Jax,Ashe,346,149,197,43.06
Jax,KSante,95,48,47,50.53
Jax,Shaco,148,71,77,47.97
Jax,Zilean,63,31,32,49.21
Jax,Garen,370,145,225,39.19
Jax,Belveth,36,14,22,38.89
Jax,Malzahar,168,77,91,45.83
Jax,Varus,144,67,77,46.53
Jax,Renekton,102,55,47,53.92
Jax,Elise,141,75,66,53.19
Jax,Zed,167,73,94,43.71
Jax,Milio,112,40,72,35.71
Jax,Vladimir,113,60,53,53.1
Jax,Hwei,106,57,49,53.77
Jax,Tristana,156,82,74,52.56
Jax,Lulu,260,109,151,41.92
Jax,Trundle,119,62,57,52.1
Jax,Diana,274,128,146,46.72
Jax,Janna,66,32,34,48.48
Jax,Warwick,241,106,135,43.98
Jax,Nunu,84,37,47,44.05
Jax,Pyke,156,77,79,49.36
Jax,Blitzcrank,171,101,70,59.06
Jax,Ambessa,157,67,90,42.68
Jax,Khazix,93,52,41,55.91
Jax,Vex,104,39,65,37.5
Jax,Aphelios,91,58,33,63.74
Jax,Rumble,68,22,46,32.35
Jax,Zoe,48,29,19,60.42
Jax,Jhin,346,169,177,48.84
Jax,Volibear,199,98,101,49.25
Jax,Fizz,66,36,30,54.55
Jax,Irelia,168,89,79,52.98
Jax,Soraka,63,38,25,60.32
Jax,Leblanc,105,51,54,48.57
Jax,TahmKench,119,73,46,61.34
Jax,Gnar,59,34,25,57.63
Jax,Mel,316,163,153,51.58
Jax,Nami,153,66,87,43.14
Jax,Yasuo,355,185,170,52.11
Jax,Yuumi,120,53,67,44.17
Jax,DrMundo,113,47,66,41.59
Jax,Zeri,85,40,45,47.06
Jax,Velkoz,104,49,55,47.12
Jax,Kennen,48,24,24,50
Jax,Kled,31,15,16,48.39
Jax,Briar,94,55,39,58.51
Jax,LeeSin,279,130,149,46.59
Jax,Galio,195,79,116,40.51
Jax,Brand,91,43,48,47.25
Jax,Aatrox,193,101,92,52.33
Jax,Akali,179,84,95,46.93
Jax,Leona,164,96,68,58.54
Jax,Tryndamere,85,42,43,49.41
Jax,Swain,195,85,110,43.59
Jax,Ivern,35,8,27,22.86
Jax,Braum,121,46,75,38.02
Jax,Amumu,189,85,104,44.97
Jax,Naafiri,59,25,34,42.37
Jax,Nautilus,238,102,136,42.86
Jax,AurelionSol,66,27,39,40.91
Jax,Senna,114,54,60,47.37
Jax,Seraphine,97,49,48,50.52
Jax,Jayce,86,44,42,51.16
Jax,Skarner,109,43,66,39.45
Jax,MissFortune,301,165,136,54.82
Jax,Evelynn,48,19,29,39.58
Jax,Sivir,110,47,63,42.73
Jax,Annie,65,24,41,36.92
Jax,Sejuani,146,64,82,43.84
Jax,Ekko,143,77,66,53.85
Jax,Riven,78,35,43,44.87
Jax,Fiora,82,49,33,59.76
Jax,Viktor,161,79,82,49.07
Jax,Sylas,263,130,133,49.43
Jax,Thresh,318,148,170,46.54
Jax,Chogath,207,92,115,44.44
Jax,Karma,229,112,117,48.91
Jax,Rengar,49,32,17,65.31
Jax,Nasus,129,62,67,48.06
Jax,Talon,58,24,34,41.38
Jax,XinZhao,116,58,58,50
Jax,Azir,61,21,40,34.43
Jax,Rammus,63,32,31,50.79
Jax,MonkeyKing,110,40,70,36.36
Jax,Xerath,168,101,67,60.12
Jax,TwistedFate,61,25,36,40.98
Jax,Poppy,155,66,89,42.58
Jax,Nocturne,155,76,79,49.03
Jax,Vayne,179,83,96,46.37
Jax,Vi,194,95,99,48.97
Jax,Ornn,77,39,38,50.65
Jax,Anivia,56,26,30,46.43
Jax,Udyr,43,29,14,67.44
Jax,Yorick,126,67,59,53.17
Jax,Shen,118,45,73,38.14
Jax,Pantheon,333,155,178,46.55
Jax,Sona,20,9,11,45
Jax,Lillia,117,44,73,37.61
Jax,Akshan,59,39,20,66.1
Jax,Kayle,128,78,50,60.94
Jax,Sion,118,58,60,49.15
Jax,Syndra,134,65,69,48.51
Jax,Olaf,44,28,16,63.64
Jax,KogMaw,82,42,40,51.22
Jax,Shyvana,33,25,8,75.76
Jax,Taliyah,41,23,18,56.1
Jax,Nilah,51,30,21,58.82
Jax,Qiyana,32,8,24,25
Jax,Karthus,31,12,19,38.71
Jax,Rakan,93,50,43,53.76
Jax,Orianna,93,51,42,54.84
Jax,Kalista,39,16,23,41.03
Jax,Kindred,50,33,17,66
Jax,Urgot,77,34,43,44.16
Jax,Gwen,79,38,41,48.1
Jax,Kassadin,23,12,11,52.17
Jax,Camille,66,35,31,53.03
Jax,Aurora,109,42,67,38.53
Jax,Zac,91,45,46,49.45
Jax,Malphite,127,60,67,47.24
Jax,Smolder,107,56,51,52.34
Jax,Ziggs,59,22,37,37.29
Jax,JarvanIV,109,60,49,55.05
Jax,Zyra,149,59,90,39.6
Jax,Corki,83,39,44,46.99
Jax,Nidalee,58,25,33,43.1
Jax,Hecarim,61,26,35,42.62
Jax,Heimerdinger,42,23,19,54.76
Jax,Lissandra,46,21,25,45.65
Jax,Maokai,61,22,39,36.07
Jax,Cassiopeia,38,17,21,44.74
Jax,Quinn,49,26,23,53.06
Jax,Taric,31,17,14,54.84
Jax,Bard,50,24,26,48
Jax,RekSai,15,6,9,40
Sejuani,Teemo,124,68,56,54.84
Sejuani,Kayn,176,87,89,49.43
Sejuani,Yone,230,131,99,56.96
Sejuani,Ryze,62,39,23,62.9
Sejuani,Lux,325,184,141,56.62
Sejuani,Ashe,290,165,125,56.9
Sejuani,Twitch,107,45,62,42.06
Sejuani,Viktor,127,70,57,55.12
Sejuani,Xayah,74,35,39,47.3
Sejuani,Xerath,114,60,54,52.63
Sejuani,Malphite,152,82,70,53.95
Sejuani,Vi,139,71,68,51.08
Sejuani,Veigar,126,77,49,61.11
Sejuani,Sivir,90,42,48,46.67
Sejuani,Senna,66,30,36,45.45
Sejuani,Garen,207,102,105,49.28
Sejuani,MonkeyKing,95,54,41,56.84
Sejuani,Nilah,44,19,25,43.18
Sejuani,Lulu,204,96,108,47.06
Sejuani,Malzahar,137,44,93,32.12
Sejuani,Ahri,197,128,69,64.97
Sejuani,MissFortune,237,151,86,63.71
Sejuani,Amumu,181,85,96,46.96
Sejuani,Shyvana,28,18,10,64.29
Sejuani,Lissandra,70,42,28,60
Sejuani,Lucian,127,96,31,75.59
Sejuani,TahmKench,127,59,68,46.46
Sejuani,LeeSin,206,134,72,65.05
Sejuani,Orianna,79,49,30,62.03
Sejuani,Morgana,123,65,58,52.85
Sejuani,Fizz,49,31,18,63.27
Sejuani,Kaisa,196,106,90,54.08
Sejuani,Karma,140,73,67,52.14
Sejuani,Darius,235,126,109,53.62
Sejuani,Shaco,96,54,42,56.25
Sejuani,Ekko,112,63,49,56.25
Sejuani,Neeko,55,36,19,65.45
Sejuani,Tryndamere,47,24,23,51.06
Sejuani,MasterYi,121,81,40,66.94
Sejuani,Akali,126,74,52,58.73
Sejuani,KogMaw,55,17,38,30.91
Sejuani,Swain,104,49,55,47.12
Sejuani,Kennen,34,16,18,47.06
Sejuani,Talon,66,40,26,60.61
Sejuani,Aphelios,62,35,27,56.45
Sejuani,Pyke,119,84,35,70.59
Sejuani,Jayce,72,49,23,68.06
Sejuani,Katarina,80,38,42,47.5
Sejuani,Mordekaiser,140,88,52,62.86
Sejuani,Yasuo,225,101,124,44.89
Sejuani,Ziggs,54,36,18,66.67
Sejuani,Nautilus,171,65,106,38.01
Sejuani,Elise,96,50,46,52.08
Sejuani,Leona,138,65,73,47.1
Sejuani,Kayle,68,25,43,36.76
Sejuani,Vex,99,67,32,67.68
Sejuani,Caitlyn,326,165,161,50.61
Sejuani,Soraka,55,26,29,47.27
Sejuani,KSante,88,56,32,63.64
Sejuani,Draven,61,32,29,52.46
Sejuani,Zoe,61,21,40,34.43
Sejuani,Riven,60,29,31,48.33
Sejuani,Nocturne,146,77,69,52.74
Sejuani,Galio,134,93,41,69.4
Sejuani,Vayne,178,95,83,53.37
Sejuani,Trundle,74,39,35,52.7
Sejuani,Warwick,188,107,81,56.91
Sejuani,Irelia,93,62,31,66.67
Sejuani,JarvanIV,131,62,69,47.33
Sejuani,Taliyah,46,29,17,63.04
Sejuani,Mel,263,166,97,63.12
Sejuani,Yorick,102,43,59,42.16
Sejuani,Gragas,107,55,52,51.4
Sejuani,Zyra,103,63,40,61.17
Sejuani,Yuumi,98,59,39,60.2
Sejuani,Qiyana,44,24,20,54.55
Sejuani,Heimerdinger,42,29,13,69.05
Sejuani,Velkoz,66,46,20,69.7
Sejuani,Viego,167,84,83,50.3
Sejuani,Samira,93,50,43,53.76
Sejuani,Thresh,213,117,96,54.93
Sejuani,Fiora,42,30,12,71.43
Sejuani,Diana,175,93,82,53.14
Sejuani,Nami,158,90,68,56.96
Sejuani,Smolder,84,47,37,55.95
Sejuani,Briar,83,58,25,69.88
Sejuani,Gwen,69,31,38,44.93
Sejuani,Ornn,69,35,34,50.72
Sejuani,Graves,111,51,60,45.95
Sejuani,Quinn,42,25,17,59.52
Sejuani,Gnar,64,42,22,65.63
Sejuani,Brand,69,32,37,46.38
Sejuani,Aatrox,113,76,37,67.26
Sejuani,Seraphine,85,40,45,47.06
Sejuani,Jinx,314,153,161,48.73
Sejuani,Jax,146,82,64,56.16
Sejuani,Corki,50,33,17,66
Sejuani,Janna,54,37,17,68.52
Sejuani,Renekton,61,21,40,34.43
Sejuani,Lillia,107,53,54,49.53
Sejuani,Poppy,93,47,46,50.54
Sejuani,Varus,136,101,35,74.26
Sejuani,Ezreal,304,179,125,58.88
Sejuani,Skarner,87,55,32,63.22
Sejuani,Evelynn,59,26,33,44.07
Sejuani,Aurora,119,78,41,65.55
Sejuani,Zeri,51,28,23,54.9
Sejuani,Karthus,17,8,9,47.06
Sejuani,Sion,117,64,53,54.7
Sejuani,Alistar,66,25,41,37.88
Sejuani,Nasus,69,27,42,39.13
Sejuani,Blitzcrank,112,62,50,55.36
Sejuani,Kassadin,31,14,17,45.16
Sejuani,Chogath,164,91,73,55.49
Sejuani,Volibear,148,81,67,54.73
Sejuani,Sylas,191,114,77,59.69
Sejuani,Illaoi,63,32,31,50.79
Sejuani,Khazix,78,36,42,46.15
Sejuani,Anivia,42,22,20,52.38
Sejuani,DrMundo,76,45,31,59.21
Sejuani,Taric,33,14,19,42.42
Sejuani,Vladimir,101,55,46,54.46
Sejuani,Tristana,121,64,57,52.89
Sejuani,Milio,93,37,56,39.78
Sejuani,AurelionSol,47,18,29,38.3
Sejuani,Sett,202,105,97,51.98
Sejuani,Rammus,30,15,15,50
Sejuani,Rell,95,56,39,58.95
Sejuani,Hecarim,41,21,20,51.22
Sejuani,Kalista,55,32,23,58.18
Sejuani,Gangplank,54,38,16,70.37
Sejuani,Syndra,88,54,34,61.36
Sejuani,Sona,17,12,5,70.59
Sejuani,Jhin,208,115,93,55.29
Sejuani,Braum,115,64,51,55.65
Sejuani,Nunu,71,44,27,61.97
Sejuani,Cassiopeia,31,16,15,51.61
Sejuani,Rakan,45,18,27,40
Sejuani,FiddleSticks,47,19,28,40.43
Sejuani,Akshan,23,13,10,56.52
Sejuani,Rumble,35,20,15,57.14
Sejuani,Zilean,50,37,13,74
Sejuani,Hwei,75,44,31,58.67
Sejuani,Naafiri,36,16,20,44.44
Sejuani,Camille,56,32,24,57.14
Sejuani,Zac,69,35,34,50.72
Sejuani,Kindred,73,44,29,60.27
Sejuani,Zed,135,74,61,54.81
Sejuani,Belveth,6,3,3,50
Sejuani,Olaf,41,24,17,58.54
Sejuani,Ivern,38,24,14,63.16
Sejuani,Nidalee,46,23,23,50
Sejuani,Shen,103,59,44,57.28
Sejuani,Maokai,71,32,39,45.07
Sejuani,Azir,47,26,21,55.32
Sejuani,Urgot,63,27,36,42.86
Sejuani,Rengar,35,23,12,65.71
Sejuani,Kled,22,12,10,54.55
Sejuani,Singed,33,11,22,33.33
Sejuani,Pantheon,176,109,67,61.93
Sejuani,XinZhao,92,56,36,60.87
Sejuani,Ambessa,95,44,51,46.32
Sejuani,TwistedFate,36,16,20,44.44
Sejuani,Udyr,27,18,9,66.67
Sejuani,Leblanc,64,36,28,56.25
Sejuani,Annie,53,29,24,54.72
Sejuani,RekSai,14,10,4,71.43
Sejuani,Renata,31,9,22,29.03
Sejuani,Bard,34,18,16,52.94
Hwei,Teemo,123,51,72,41.46
Hwei,Kayn,172,79,93,45.93
Hwei,Yone,194,96,98,49.48
Hwei,Ryze,56,24,32,42.86
Hwei,Lux,308,159,149,51.62
Hwei,XinZhao,100,63,37,63
Hwei,Morgana,100,54,46,54
Hwei,Jinx,311,137,174,44.05
Hwei,Karma,172,86,86,50
Hwei,Galio,163,79,84,48.47
Hwei,Hecarim,67,28,39,41.79
Hwei,Shen,113,54,59,47.79
Hwei,Kaisa,238,110,128,46.22
Hwei,Nami,129,57,72,44.19
Hwei,Ambessa,101,50,51,49.5
Hwei,Diana,183,78,105,42.62
Hwei,Ekko,131,62,69,47.33
Hwei,Lulu,187,92,95,49.2
Hwei,Corki,62,26,36,41.94
Hwei,Leblanc,63,35,28,55.56
Hwei,Caitlyn,353,190,163,53.82
Hwei,Mel,245,133,112,54.29
Hwei,Aatrox,148,70,78,47.3
Hwei,JarvanIV,101,51,50,50.5
Hwei,Chogath,180,79,101,43.89
Hwei,MissFortune,246,117,129,47.56
Hwei,Yuumi,106,49,57,46.23
Hwei,Briar,89,56,33,62.92
Hwei,Nocturne,158,84,74,53.16
Hwei,Lissandra,63,32,31,50.79
Hwei,Yorick,91,43,48,47.25
Hwei,Kindred,66,46,20,69.7
Hwei,Katarina,99,57,42,57.58
Hwei,Neeko,74,34,40,45.95
Hwei,Poppy,104,60,44,57.69
Hwei,FiddleSticks,38,16,22,42.11
Hwei,Ashe,271,126,145,46.49
Hwei,Braum,121,61,60,50.41
Hwei,MasterYi,86,45,41,52.33
Hwei,Warwick,123,39,84,31.71
Hwei,Kassadin,29,18,11,62.07
Hwei,Pyke,115,54,61,46.96
Hwei,Aphelios,69,25,44,36.23
Hwei,Udyr,58,32,26,55.17
Hwei,Yasuo,228,81,147,35.53
Hwei,Lucian,79,43,36,54.43
Hwei,Karthus,46,20,26,43.48
Hwei,Darius,238,95,143,39.92
Hwei,LeeSin,201,127,74,63.18
Hwei,Sylas,189,96,93,50.79
Hwei,Tristana,135,62,73,45.93
Hwei,Ahri,199,90,109,45.23
Hwei,Graves,71,41,30,57.75
Hwei,Blitzcrank,130,61,69,46.92
Hwei,Jayce,51,37,14,72.55
Hwei,Zac,99,45,54,45.45
Hwei,Jax,106,49,57,46.23
Hwei,Janna,41,13,28,31.71
Hwei,Viktor,163,79,84,48.47
Hwei,Samira,103,54,49,52.43
Hwei,Leona,147,73,74,49.66
Hwei,Mordekaiser,167,91,76,54.49
Hwei,Thresh,209,93,116,44.5
Hwei,Sion,91,40,51,43.96
Hwei,Vi,160,73,87,45.63
Hwei,Orianna,93,35,58,37.63
Hwei,Nilah,40,17,23,42.5
Hwei,Heimerdinger,65,30,35,46.15
Hwei,Seraphine,100,52,48,52
Hwei,Gangplank,81,42,39,51.85
Hwei,Taliyah,66,26,40,39.39
Hwei,Garen,203,92,111,45.32
Hwei,Akali,93,55,38,59.14
Hwei,Riven,59,15,44,25.42
Hwei,Smolder,83,28,55,33.73
Hwei,Camille,50,26,24,52
Hwei,Lillia,57,29,28,50.88
Hwei,Varus,167,81,86,48.5
Hwei,Zoe,53,26,27,49.06
Hwei,Veigar,121,58,63,47.93
Hwei,Ziggs,55,24,31,43.64
Hwei,Nautilus,195,105,90,53.85
Hwei,Xayah,98,48,50,48.98
Hwei,Urgot,64,23,41,35.94
Hwei,Syndra,157,77,80,49.04
Hwei,Milio,97,50,47,51.55
Hwei,Shaco,83,37,46,44.58
Hwei,Zed,147,55,92,37.41
Hwei,Zeri,49,18,31,36.73
Hwei,Sett,181,95,86,52.49
Hwei,Skarner,77,41,36,53.25
Hwei,AurelionSol,56,15,41,26.79
Hwei,RekSai,22,9,13,40.91
Hwei,Fizz,49,21,28,42.86
Hwei,Ezreal,333,195,138,58.56
Hwei,DrMundo,61,20,41,32.79
Hwei,Kled,24,10,14,41.67
Hwei,Jhin,272,127,145,46.69
Hwei,Rengar,39,23,16,58.97
Hwei,Brand,61,41,20,67.21
Hwei,TwistedFate,46,28,18,60.87
Hwei,Alistar,69,39,30,56.52
Hwei,Pantheon,210,115,95,54.76
Hwei,Twitch,99,49,50,49.49
Hwei,Ornn,59,25,34,42.37
Hwei,KogMaw,30,10,20,33.33
Hwei,Aurora,112,45,67,40.18
Hwei,Illaoi,76,28,48,36.84
Hwei,Vladimir,64,30,34,46.88
Hwei,Senna,81,43,38,53.09
Hwei,Xerath,124,66,58,53.23
Hwei,Talon,68,38,30,55.88
Hwei,Viego,202,99,103,49.01
Hwei,Malzahar,160,70,90,43.75
Hwei,Tryndamere,54,24,30,44.44
Hwei,Gragas,106,59,47,55.66
Hwei,Renata,45,17,28,37.78
Hwei,Malphite,126,53,73,42.06
Hwei,Sona,27,16,11,59.26
Hwei,Evelynn,36,16,20,44.44
Hwei,Qiyana,21,15,6,71.43
Hwei,Sivir,57,15,42,26.32
Hwei,Singed,36,23,13,63.89
Hwei,Zyra,103,34,69,33.01
Hwei,Amumu,152,59,93,38.82
Hwei,Vayne,142,74,68,52.11
Hwei,Ivern,34,17,17,50
Hwei,Renekton,66,40,26,60.61
Hwei,Trundle,76,42,34,55.26
Hwei,Nunu,89,29,60,32.58
Hwei,Swain,123,61,62,49.59
Hwei,Maokai,57,28,29,49.12
Hwei,Volibear,153,83,70,54.25
Hwei,Gwen,71,31,40,43.66
Hwei,Rakan,73,30,43,41.1
Hwei,Velkoz,99,41,58,41.41
Hwei,TahmKench,139,63,76,45.32
Hwei,Khazix,88,37,51,42.05
Hwei,Kalista,58,30,28,51.72
Hwei,Rammus,42,25,17,59.52
Hwei,KSante,66,41,25,62.12
Hwei,Olaf,50,21,29,42
Hwei,Naafiri,33,18,15,54.55
Hwei,Draven,64,40,24,62.5
Hwei,Fiora,46,20,26,43.48
Hwei,Rell,98,36,62,36.73
Hwei,Nidalee,70,24,46,34.29
Hwei,Rumble,38,20,18,52.63
Hwei,Sejuani,75,31,44,41.33
Hwei,Nasus,86,35,51,40.7
Hwei,Cassiopeia,39,17,22,43.59
Hwei,Kayle,82,36,46,43.9
Hwei,Soraka,41,27,14,65.85
Hwei,MonkeyKing,129,58,71,44.96
Hwei,Irelia,82,49,33,59.76
Hwei,Annie,50,25,25,50
Hwei,Bard,47,20,27,42.55
Hwei,Shyvana,20,10,10,50
Hwei,Akshan,43,24,19,55.81
Hwei,Anivia,40,20,20,50
Hwei,Quinn,36,15,21,41.67
Hwei,Vex,73,39,34,53.42
Hwei,Elise,97,41,56,42.27
Hwei,Azir,71,27,44,38.03
Hwei,Gnar,64,37,27,57.81
Hwei,Taric,40,15,25,37.5
Hwei,Belveth,17,6,11,35.29
Hwei,Zilean,40,15,25,37.5
Hwei,Kennen,50,35,15,70
Zac,Teemo,124,63,61,50.81
Zac,Kayn,207,112,95,54.11
Zac,Yone,188,86,102,45.74
Zac,Ryze,54,39,15,72.22
Zac,Lux,236,147,89,62.29
Zac,Gragas,71,38,33,53.52
Zac,Elise,128,62,66,48.44
Zac,Mel,252,118,134,46.83
Zac,Vayne,197,117,80,59.39
Zac,Zyra,102,28,74,27.45
Zac,Akali,127,65,62,51.18
Zac,Belveth,24,10,14,41.67
Zac,Varus,111,70,41,63.06
Zac,Jhin,209,115,94,55.02
Zac,Lulu,189,110,79,58.2
Zac,Malzahar,141,80,61,56.74
Zac,KogMaw,39,23,16,58.97
Zac,Veigar,100,33,67,33
Zac,Vladimir,77,35,42,45.45
Zac,Viego,148,74,74,50
Zac,Hwei,99,54,45,54.55
Zac,Tristana,94,45,49,47.87
Zac,DrMundo,79,38,41,48.1
Zac,MasterYi,96,50,46,52.08
Zac,Caitlyn,301,146,155,48.5
Zac,Thresh,220,103,117,46.82
Zac,Jayce,49,19,30,38.78
Zac,Vi,186,102,84,54.84
Zac,Orianna,60,25,35,41.67
Zac,Sett,186,77,109,41.4
Zac,Khazix,59,39,20,66.1
Zac,Ahri,181,100,81,55.25
Zac,Yasuo,252,134,118,53.17
Zac,Yuumi,87,50,37,57.47
Zac,Shaco,72,32,40,44.44
Zac,Kennen,57,38,19,66.67
Zac,Corki,71,33,38,46.48
Zac,Bard,51,19,32,37.25
Zac,Zed,93,42,51,45.16
Zac,Nunu,75,33,42,44
Zac,Ezreal,262,130,132,49.62
Zac,TahmKench,117,29,88,24.79
Zac,Darius,247,109,138,44.13
Zac,LeeSin,213,101,112,47.42
Zac,Smolder,99,46,53,46.46
Zac,Nautilus,168,88,80,52.38
Zac,Gwen,79,35,44,44.3
Zac,Ashe,268,118,150,44.03
Zac,Lillia,81,42,39,51.85
Zac,Nami,143,80,63,55.94
Zac,Yorick,81,37,44,45.68
Zac,Diana,185,104,81,56.22
Zac,Annie,60,28,32,46.67
Zac,Ziggs,32,17,15,53.13
Zac,Karma,138,80,58,57.97
Zac,Morgana,100,50,50,50
Zac,Rammus,46,28,18,60.87
Zac,Chogath,174,89,85,51.15
Zac,Aphelios,110,64,46,58.18
Zac,Renata,20,7,13,35
Zac,Pantheon,204,107,97,52.45
Zac,Viktor,108,66,42,61.11
Zac,Twitch,82,42,40,51.22
Zac,Alistar,77,49,28,63.64
Zac,Riven,50,19,31,38
Zac,Nocturne,148,64,84,43.24
Zac,Kaisa,252,132,120,52.38
Zac,Soraka,65,26,39,40
Zac,Fizz,65,15,50,23.08
Zac,Jinx,280,128,152,45.71
Zac,Velkoz,65,31,34,47.69
Zac,Gnar,73,54,19,73.97
Zac,Evelynn,31,17,14,54.84
Zac,Braum,129,47,82,36.43
Zac,Illaoi,48,27,21,56.25
Zac,MonkeyKing,74,33,41,44.59
Zac,Aurora,73,36,37,49.32
Zac,Xayah,85,39,46,45.88
Zac,Rakan,67,29,38,43.28
Zac,FiddleSticks,62,29,33,46.77
Zac,XinZhao,118,42,76,35.59
Zac,Blitzcrank,115,53,62,46.09
Zac,Rumble,53,11,42,20.75
Zac,Azir,59,29,30,49.15
Zac,Xerath,110,56,54,50.91
Zac,Syndra,111,70,41,63.06
Zac,Irelia,58,36,22,62.07
Zac,Leona,126,60,66,47.62
Zac,Mordekaiser,159,66,93,41.51
Zac,Udyr,66,35,31,53.03
Zac,Ivern,17,3,14,17.65
Zac,Lucian,105,40,65,38.1
Zac,Senna,75,31,44,41.33
Zac,Ambessa,116,64,52,55.17
Zac,JarvanIV,97,49,48,50.52
Zac,Kassadin,25,13,12,52
Zac,Camille,52,17,35,32.69
Zac,Rengar,54,33,21,61.11
Zac,Urgot,61,39,22,63.93
Zac,MissFortune,200,84,116,42
Zac,Volibear,109,74,35,67.89
Zac,Sion,152,82,70,53.95
Zac,Aatrox,118,55,63,46.61
Zac,Samira,78,39,39,50
Zac,Nasus,82,38,44,46.34
Zac,Nidalee,64,40,24,62.5
Zac,Garen,177,85,92,48.02
Zac,Skarner,81,32,49,39.51
Zac,Neeko,45,23,22,51.11
Zac,Poppy,126,54,72,42.86
Zac,Malphite,115,65,50,56.52
Zac,Leblanc,56,23,33,41.07
Zac,Renekton,83,47,36,56.63
Zac,Kindred,31,5,26,16.13
Zac,Draven,48,22,26,45.83
Zac,Heimerdinger,48,25,23,52.08
Zac,Anivia,60,24,36,40
Zac,Kalista,53,33,20,62.26
Zac,Swain,90,37,53,41.11
Zac,Katarina,103,57,46,55.34
Zac,Sivir,66,17,49,25.76
Zac,Sona,28,9,19,32.14
Zac,Galio,140,81,59,57.86
Zac,Shyvana,33,12,21,36.36
Zac,Warwick,134,74,60,55.22
Zac,Sylas,168,77,91,45.83
Zac,Pyke,98,51,47,52.04
Zac,Graves,74,33,41,44.59
Zac,Janna,50,28,22,56
Zac,Kayle,57,20,37,35.09
Zac,RekSai,14,2,12,14.29
Zac,Seraphine,66,29,37,43.94
Zac,Jax,91,46,45,50.55
Zac,Shen,79,39,40,49.37
Zac,Akshan,30,17,13,56.67
Zac,Gangplank,55,27,28,49.09
Zac,Singed,35,8,27,22.86
Zac,Cassiopeia,55,27,28,49.09
Zac,Sejuani,69,34,35,49.28
Zac,Amumu,157,78,79,49.68
Zac,Rell,86,41,45,47.67
Zac,KSante,69,29,40,42.03
Zac,Milio,80,48,32,60
Zac,Zeri,72,30,42,41.67
Zac,Nilah,43,23,20,53.49
Zac,Fiora,51,33,18,64.71
Zac,Vex,78,26,52,33.33
Zac,Trundle,67,37,30,55.22
Zac,Tryndamere,38,27,11,71.05
Zac,Brand,59,29,30,49.15
Zac,Talon,48,26,22,54.17
Zac,Ekko,79,21,58,26.58
Zac,Lissandra,47,31,16,65.96
Zac,TwistedFate,46,34,12,73.91
Zac,Hecarim,46,18,28,39.13
Zac,Briar,45,24,21,53.33
Zac,Ornn,68,27,41,39.71
Zac,Taric,33,12,21,36.36
Zac,Zilean,35,13,22,37.14
Zac,Olaf,40,19,21,47.5
Zac,Maokai,82,26,56,31.71
Zac,Zoe,43,9,34,20.93
Zac,Naafiri,27,11,16,40.74
Zac,AurelionSol,42,19,23,45.24
Zac,Karthus,21,12,9,57.14
Zac,Qiyana,25,14,11,56
Zac,Quinn,29,15,14,51.72
Zac,Taliyah,37,16,21,43.24
Zac,Kled,21,9,12,42.86
Darius,Chogath,448,212,236,47.32
Darius,Mordekaiser,448,245,203,54.69
Darius,Swain,324,187,137,57.72
Darius,Sivir,181,88,93,48.62
Darius,Ashe,670,378,292,56.42
Darius,Riven,172,78,94,45.35
Darius,Karthus,88,38,50,43.18
Darius,Mel,760,431,329,56.71
Darius,Lucian,307,158,149,51.47
Darius,Nami,338,172,166,50.89
Darius,Jax,282,120,162,42.55
Darius,Pantheon,558,306,252,54.84
Darius,TwistedFate,137,50,87,36.5
Darius,Milio,210,81,129,38.57
Darius,Garen,581,298,283,51.29
Darius,Kayn,481,253,228,52.6
Darius,MissFortune,722,375,347,51.94
Darius,Velkoz,205,113,92,55.12
Darius,Diana,515,259,256,50.29
Darius,Yone,645,317,328,49.15
Darius,Caitlyn,810,417,393,51.48
Darius,Xerath,284,136,148,47.89
Darius,Kayle,232,124,108,53.45
Darius,Evelynn,114,54,60,47.37
Darius,Irelia,250,124,126,49.6
Darius,Corki,135,57,78,42.22
Darius,Syndra,282,143,139,50.71
Darius,Gangplank,152,66,86,43.42
Darius,Shaco,281,150,131,53.38
Darius,Veigar,393,215,178,54.71
Darius,Yuumi,296,144,152,48.65
Darius,Skarner,178,95,83,53.37
Darius,Volibear,446,188,258,42.15
Darius,Katarina,204,104,100,50.98
Darius,Twitch,279,153,126,54.84
Darius,Blitzcrank,322,165,157,51.24
Darius,Malphite,379,186,193,49.08
Darius,Ivern,61,37,24,60.66
Darius,Ahri,419,252,167,60.14
Darius,Lulu,487,263,224,54
Darius,Vladimir,200,97,103,48.5
Darius,Kaisa,605,294,311,48.6
Darius,Maokai,165,101,64,61.21
Darius,Briar,231,111,120,48.05
Darius,Zed,348,186,162,53.45
Darius,Ezreal,938,515,423,54.9
Darius,Seraphine,266,148,118,55.64
Darius,Fizz,176,98,78,55.68
Darius,Karma,427,223,204,52.22
Darius,Yorick,286,120,166,41.96
Darius,Sejuani,235,109,126,46.38
Darius,Leblanc,163,85,78,52.15
Darius,Nilah,127,53,74,41.73
Darius,Camille,139,70,69,50.36
Darius,Kindred,140,80,60,57.14
Darius,Jinx,876,396,480,45.21
Darius,Sion,294,146,148,49.66
Darius,Rengar,82,52,30,63.41
Darius,Hwei,238,143,95,60.08
Darius,Braum,291,139,152,47.77
Darius,Aatrox,411,208,203,50.61
Darius,Amumu,445,202,243,45.39
Darius,Taliyah,102,50,52,49.02
Darius,AurelionSol,143,76,67,53.15
Darius,Lux,781,380,401,48.66
Darius,Vayne,471,228,243,48.41
Darius,Yasuo,757,392,365,51.78
Darius,Sett,650,318,332,48.92
Darius,Warwick,477,238,239,49.9
Darius,Teemo,378,191,187,50.53
Darius,Xayah,203,113,90,55.67
Darius,LeeSin,561,332,229,59.18
Darius,Nautilus,474,255,219,53.8
Darius,Akali,335,170,165,50.75
Darius,Jhin,605,328,277,54.21
Darius,FiddleSticks,159,72,87,45.28
Darius,Qiyana,80,52,28,65
Darius,Rell,256,129,127,50.39
Darius,Khazix,181,84,97,46.41
Darius,Kled,67,41,26,61.19
Darius,MasterYi,387,181,206,46.77
Darius,Aphelios,177,85,92,48.02
Darius,Tristana,327,145,182,44.34
Darius,Nasus,211,88,123,41.71
Darius,Heimerdinger,155,91,64,58.71
Darius,Vi,366,204,162,55.74
Darius,Leona,364,182,182,50
Darius,Elise,264,141,123,53.41
Darius,MonkeyKing,311,167,144,53.7
Darius,Samira,320,160,160,50
Darius,Morgana,310,131,179,42.26
Darius,Poppy,241,126,115,52.28
Darius,Zilean,89,41,48,46.07
Darius,Brand,164,94,70,57.32
Darius,Nidalee,115,59,56,51.3
Darius,Belveth,71,30,41,42.25
Darius,Ziggs,103,64,39,62.14
Darius,Aurora,282,156,126,55.32
Darius,Ryze,140,87,53,62.14
Darius,Urgot,206,103,103,50
Darius,Zac,247,138,109,55.87
Darius,Rakan,198,97,101,48.99
Darius,Malzahar,366,186,180,50.82
Darius,Ekko,292,168,124,57.53
Darius,Zeri,149,91,58,61.07
Darius,Alistar,208,115,93,55.29
Darius,Sylas,519,265,254,51.06
Darius,Renata,93,45,48,48.39
Darius,Nocturne,389,189,200,48.59
Darius,Thresh,649,327,322,50.39
Darius,Vex,211,96,115,45.5
Darius,Renekton,205,104,101,50.73
Darius,Kalista,109,58,51,53.21
Darius,Talon,156,91,65,58.33
Darius,Senna,200,124,76,62
Darius,DrMundo,162,86,76,53.09
Darius,Shen,265,143,122,53.96
Darius,Viktor,305,134,171,43.93
Darius,Smolder,262,140,122,53.44
Darius,Soraka,129,63,66,48.84
Darius,Illaoi,187,77,110,41.18
Darius,XinZhao,168,76,92,45.24
Darius,Pyke,282,144,138,51.06
Darius,TahmKench,337,159,178,47.18
Darius,Graves,231,111,120,48.05
Darius,Anivia,111,56,55,50.45
Darius,Tryndamere,142,63,79,44.37
Darius,Varus,340,177,163,52.06
Darius,Azir,196,93,103,47.45
Darius,Janna,100,52,48,52
Darius,Annie,93,55,38,59.14
Darius,Rumble,95,39,56,41.05
Darius,Ambessa,244,129,115,52.87
Darius,Galio,367,174,193,47.41
Darius,Orianna,180,80,100,44.44
Darius,Fiora,114,55,59,48.25
Darius,Singed,56,21,35,37.5
Darius,Gragas,273,158,115,57.88
Darius,Lillia,199,107,92,53.77
Darius,Trundle,198,105,93,53.03
Darius,JarvanIV,244,116,128,47.54
Darius,Naafiri,76,43,33,56.58
Darius,Viego,421,212,209,50.36
Darius,Zyra,254,116,138,45.67
Darius,Ornn,185,102,83,55.14
Darius,Gwen,139,59,80,42.45
Darius,Gnar,221,127,94,57.47
Darius,Akshan,119,81,38,68.07
Darius,Neeko,202,111,91,54.95
Darius,Rammus,131,83,48,63.36
Darius,Draven,171,99,72,57.89
Darius,Taric,89,43,46,48.31
Darius,Sona,76,43,33,56.58
Darius,Olaf,75,47,28,62.67
Darius,Udyr,144,89,55,61.81
Darius,Kassadin,50,22,28,44
Darius,Shyvana,76,40,36,52.63
Darius,Cassiopeia,114,63,51,55.26
Darius,Nunu,258,150,108,58.14
Darius,Quinn,151,95,56,62.91
Darius,Zoe,153,75,78,49.02
Darius,Kennen,136,63,73,46.32
Darius,Jayce,196,111,85,56.63
Darius,Bard,107,50,57,46.73
Darius,Lissandra,125,79,46,63.2
Darius,Hecarim,126,56,70,44.44
Darius,KSante,230,137,93,59.57
Darius,RekSai,49,23,26,46.94
Darius,KogMaw,78,37,41,47.44
JarvanIV,Chogath,171,75,96,43.86
JarvanIV,Mordekaiser,157,79,78,50.32
JarvanIV,Swain,109,41,68,37.61
JarvanIV,Sivir,63,22,41,34.92
JarvanIV,Ashe,326,157,169,48.16
JarvanIV,Heimerdinger,41,23,18,56.1
JarvanIV,Gragas,158,93,65,58.86
JarvanIV,Viktor,184,92,92,50
JarvanIV,Jinx,403,179,224,44.42
JarvanIV,Pyke,89,52,37,58.43
JarvanIV,Sett,208,110,98,52.88
JarvanIV,LeeSin,299,158,141,52.84
JarvanIV,Hwei,101,50,51,49.5
JarvanIV,Jhin,245,146,99,59.59
JarvanIV,Zilean,46,19,27,41.3
JarvanIV,XinZhao,126,70,56,55.56
JarvanIV,Thresh,291,158,133,54.3
JarvanIV,Kaisa,238,147,91,61.76
JarvanIV,Morgana,99,64,35,64.65
JarvanIV,Graves,97,56,41,57.73
JarvanIV,Qiyana,25,12,13,48
JarvanIV,Kalista,56,44,12,78.57
JarvanIV,Neeko,52,32,20,61.54
JarvanIV,Ambessa,132,57,75,43.18
JarvanIV,Ekko,126,75,51,59.52
JarvanIV,Lux,344,197,147,57.27
JarvanIV,Caitlyn,346,201,145,58.09
JarvanIV,Soraka,87,47,40,54.02
JarvanIV,Kayn,200,108,92,54
JarvanIV,Kayle,66,38,28,57.58
JarvanIV,Shen,128,63,65,49.22
JarvanIV,Olaf,40,21,19,52.5
JarvanIV,Vi,231,123,108,53.25
JarvanIV,Katarina,86,49,37,56.98
JarvanIV,Veigar,151,79,72,52.32
JarvanIV,Bard,55,27,28,49.09
JarvanIV,Ryze,55,30,25,54.55
JarvanIV,Gnar,87,39,48,44.83
JarvanIV,Kindred,43,25,18,58.14
JarvanIV,Syndra,121,71,50,58.68
JarvanIV,Braum,154,79,75,51.3
JarvanIV,Akali,105,54,51,51.43
JarvanIV,Xayah,82,51,31,62.2
JarvanIV,Zyra,134,73,61,54.48
JarvanIV,Aatrox,129,60,69,46.51
JarvanIV,Briar,66,26,40,39.39
JarvanIV,Ahri,235,120,115,51.06
JarvanIV,Ezreal,331,166,165,50.15
JarvanIV,Elise,115,45,70,39.13
JarvanIV,Renekton,95,27,68,28.42
JarvanIV,Karma,182,105,77,57.69
JarvanIV,Shaco,107,62,45,57.94
JarvanIV,Akshan,61,25,36,40.98
JarvanIV,Samira,100,47,53,47
JarvanIV,Lulu,218,100,118,45.87
JarvanIV,Lillia,51,16,35,31.37
JarvanIV,Yone,202,110,92,54.46
JarvanIV,Draven,85,34,51,40
JarvanIV,Sejuani,131,69,62,52.67
JarvanIV,Tristana,164,73,91,44.51
JarvanIV,Varus,159,89,70,55.97
JarvanIV,Poppy,167,89,78,53.29
JarvanIV,Taliyah,46,26,20,56.52
JarvanIV,Yasuo,255,126,129,49.41
JarvanIV,Nautilus,227,142,85,62.56
JarvanIV,Nasus,93,48,45,51.61
JarvanIV,Nunu,83,36,47,43.37
JarvanIV,Xerath,152,90,62,59.21
JarvanIV,Volibear,139,57,82,41.01
JarvanIV,Sylas,242,138,104,57.02
JarvanIV,Twitch,100,58,42,58
JarvanIV,Amumu,192,85,107,44.27
JarvanIV,AurelionSol,69,40,29,57.97
JarvanIV,Vex,80,40,40,50
JarvanIV,Blitzcrank,114,59,55,51.75
JarvanIV,Irelia,90,48,42,53.33
JarvanIV,Talon,77,46,31,59.74
JarvanIV,Pantheon,233,108,125,46.35
JarvanIV,TahmKench,109,58,51,53.21
JarvanIV,Azir,70,34,36,48.57
JarvanIV,MissFortune,305,166,139,54.43
JarvanIV,Janna,74,35,39,47.3
JarvanIV,Khazix,58,22,36,37.93
JarvanIV,Riven,70,23,47,32.86
JarvanIV,Zoe,34,16,18,47.06
JarvanIV,TwistedFate,62,25,37,40.32
JarvanIV,Nilah,60,34,26,56.67
JarvanIV,Kassadin,33,16,17,48.48
JarvanIV,Darius,244,128,116,52.46
JarvanIV,Vladimir,68,31,37,45.59
JarvanIV,Smolder,126,55,71,43.65
JarvanIV,Gangplank,59,36,23,61.02
JarvanIV,Mel,309,152,157,49.19
JarvanIV,Zed,137,71,66,51.82
JarvanIV,Brand,77,27,50,35.06
JarvanIV,Malphite,183,75,108,40.98
JarvanIV,MonkeyKing,116,63,53,54.31
JarvanIV,Aurora,104,42,62,40.38
JarvanIV,Vayne,164,73,91,44.51
JarvanIV,Zac,97,48,49,49.48
JarvanIV,Seraphine,122,46,76,37.7
JarvanIV,Hecarim,39,20,19,51.28
JarvanIV,Teemo,113,67,46,59.29
JarvanIV,Lucian,158,106,52,67.09
JarvanIV,Senna,85,46,39,54.12
JarvanIV,Illaoi,77,55,22,71.43
JarvanIV,Ornn,99,58,41,58.59
JarvanIV,Viego,203,91,112,44.83
JarvanIV,Malzahar,151,77,74,50.99
JarvanIV,Tryndamere,46,24,22,52.17
JarvanIV,Milio,132,46,86,34.85
JarvanIV,Diana,215,116,99,53.95
JarvanIV,Orianna,77,39,38,50.65
JarvanIV,Udyr,55,37,18,67.27
JarvanIV,Rengar,52,34,18,65.38
JarvanIV,Galio,168,94,74,55.95
JarvanIV,Leona,155,73,82,47.1
JarvanIV,Yorick,124,58,66,46.77
JarvanIV,Nidalee,69,31,38,44.93
JarvanIV,Urgot,67,41,26,61.19
JarvanIV,Corki,85,47,38,55.29
JarvanIV,Yuumi,120,60,60,50
JarvanIV,Camille,69,43,26,62.32
JarvanIV,KSante,107,73,34,68.22
JarvanIV,Taric,41,25,16,60.98
JarvanIV,Naafiri,51,21,30,41.18
JarvanIV,Garen,229,105,124,45.85
JarvanIV,Alistar,70,40,30,57.14
JarvanIV,Skarner,77,39,38,50.65
JarvanIV,Rakan,91,41,50,45.05
JarvanIV,Quinn,54,24,30,44.44
JarvanIV,Renata,37,21,16,56.76
JarvanIV,Kennen,57,39,18,68.42
JarvanIV,MasterYi,173,90,83,52.02
JarvanIV,Sion,115,73,42,63.48
JarvanIV,Leblanc,83,52,31,62.65
JarvanIV,Trundle,72,34,38,47.22
JarvanIV,Nocturne,170,99,71,58.24
JarvanIV,Karthus,37,19,18,51.35
JarvanIV,DrMundo,64,44,20,68.75
JarvanIV,Zeri,76,39,37,51.32
JarvanIV,Rell,127,81,46,63.78
JarvanIV,Jax,109,49,60,44.95
JarvanIV,Velkoz,106,56,50,52.83
JarvanIV,Fiora,61,36,25,59.02
JarvanIV,Nami,145,78,67,53.79
JarvanIV,Cassiopeia,56,12,44,21.43
JarvanIV,Warwick,178,92,86,51.69
JarvanIV,Lissandra,58,30,28,51.72
JarvanIV,Kled,32,15,17,46.88
JarvanIV,Gwen,118,60,58,50.85
JarvanIV,Anivia,49,17,32,34.69
JarvanIV,Rammus,39,11,28,28.21
JarvanIV,Annie,60,35,25,58.33
JarvanIV,Fizz,74,33,41,44.59
JarvanIV,Aphelios,82,46,36,56.1
JarvanIV,Shyvana,20,2,18,10
JarvanIV,Ziggs,57,21,36,36.84
JarvanIV,FiddleSticks,80,54,26,67.5
JarvanIV,Sona,22,13,9,59.09
JarvanIV,Maokai,55,23,32,41.82
JarvanIV,Belveth,31,22,9,70.97
JarvanIV,KogMaw,55,23,32,41.82
JarvanIV,Singed,36,11,25,30.56
JarvanIV,Jayce,92,33,59,35.87
JarvanIV,Evelynn,28,16,12,57.14
JarvanIV,RekSai,14,6,8,42.86
JarvanIV,Rumble,34,22,12,64.71
JarvanIV,Ivern,21,15,6,71.43
Xerath,Chogath,184,110,74,59.78
Xerath,Mordekaiser,215,127,88,59.07
Xerath,Swain,117,65,52,55.56
Xerath,Sivir,107,71,36,66.36
Xerath,Ashe,356,165,191,46.35
Xerath,Sejuani,114,54,60,47.37
Xerath,Pantheon,231,113,118,48.92
Xerath,Neeko,93,56,37,60.22
Xerath,Varus,203,111,92,54.68
Xerath,Pyke,190,117,73,61.58
Xerath,Volibear,203,99,104,48.77
Xerath,MasterYi,190,86,104,45.26
Xerath,Mel,489,271,218,55.42
Xerath,Ezreal,472,220,252,46.61
Xerath,Blitzcrank,165,91,74,55.15
Xerath,Irelia,135,50,85,37.04
Xerath,Malphite,157,86,71,54.78
Xerath,Jhin,336,183,153,54.46
Xerath,Karma,240,120,120,50
Xerath,Gangplank,104,46,58,44.23
Xerath,Darius,284,148,136,52.11
Xerath,Teemo,157,78,79,49.68
Xerath,Nilah,42,28,14,66.67
Xerath,Braum,131,64,67,48.85
Xerath,Yorick,117,59,58,50.43
Xerath,Kindred,91,46,45,50.55
Xerath,Katarina,121,57,64,47.11
Xerath,Caitlyn,473,270,203,57.08
Xerath,Quinn,59,29,30,49.15
Xerath,LeeSin,395,227,168,57.47
Xerath,Akali,146,83,63,56.85
Xerath,Milio,120,51,69,42.5
Xerath,Vi,237,118,119,49.79
Xerath,Lucian,186,113,73,60.75
Xerath,Lux,432,238,194,55.09
Xerath,Veigar,208,115,93,55.29
Xerath,Lillia,89,44,45,49.44
Xerath,Jayce,121,60,61,49.59
Xerath,Smolder,133,73,60,54.89
Xerath,Riven,57,17,40,29.82
Xerath,Yasuo,312,142,170,45.51
Xerath,Tristana,132,64,68,48.48
Xerath,Nautilus,267,152,115,56.93
Xerath,Kayle,99,53,46,53.54
Xerath,Aphelios,85,48,37,56.47
Xerath,Gragas,144,93,51,64.58
Xerath,Aurora,115,70,45,60.87
Xerath,Diana,175,101,74,57.71
Xerath,Ryze,71,42,29,59.15
Xerath,Maokai,70,58,12,82.86
Xerath,Tryndamere,71,45,26,63.38
Xerath,MonkeyKing,103,47,56,45.63
Xerath,Malzahar,179,91,88,50.84
Xerath,MissFortune,343,160,183,46.65
Xerath,Ornn,98,48,50,48.98
Xerath,Elise,172,89,83,51.74
Xerath,Draven,93,57,36,61.29
Xerath,Renekton,96,53,43,55.21
Xerath,Viktor,192,94,98,48.96
Xerath,Seraphine,116,51,65,43.97
Xerath,Nami,168,106,62,63.1
Xerath,JarvanIV,152,62,90,40.79
Xerath,Ekko,147,73,74,49.66
Xerath,Orianna,90,48,42,53.33
Xerath,Karthus,40,27,13,67.5
Xerath,Zed,176,89,87,50.57
Xerath,Warwick,211,100,111,47.39
Xerath,Vladimir,90,55,35,61.11
Xerath,Jinx,400,191,209,47.75
Xerath,Morgana,167,66,101,39.52
Xerath,Yone,308,140,168,45.45
Xerath,Galio,159,103,56,64.78
Xerath,Shaco,105,62,43,59.05
Xerath,Soraka,102,50,52,49.02
Xerath,Vayne,223,113,110,50.67
Xerath,Kassadin,36,22,14,61.11
Xerath,Rengar,80,51,29,63.75
Xerath,Yuumi,131,65,66,49.62
Xerath,Hwei,124,58,66,46.77
Xerath,Lulu,204,106,98,51.96
Xerath,Zac,110,54,56,49.09
Xerath,Shyvana,58,27,31,46.55
Xerath,Twitch,117,56,61,47.86
Xerath,Rell,106,68,38,64.15
Xerath,Poppy,108,65,43,60.19
Xerath,Nocturne,177,78,99,44.07
Xerath,Velkoz,120,67,53,55.83
Xerath,Kayn,179,76,103,42.46
Xerath,Shen,156,63,93,40.38
Xerath,Ahri,228,119,109,52.19
Xerath,Nasus,97,38,59,39.18
Xerath,Rammus,62,38,24,61.29
Xerath,Jax,168,67,101,39.88
Xerath,Taliyah,39,12,27,30.77
Xerath,Syndra,134,63,71,47.01
Xerath,Leona,151,73,78,48.34
Xerath,Nidalee,67,40,27,59.7
Xerath,Talon,91,52,39,57.14
Xerath,Janna,39,20,19,51.28
Xerath,Skarner,77,45,32,58.44
Xerath,Thresh,337,139,198,41.25
Xerath,Olaf,41,24,17,58.54
Xerath,Amumu,186,95,91,51.08
Xerath,Sion,134,69,65,51.49
Xerath,Akshan,53,31,22,58.49
Xerath,Aatrox,185,75,110,40.54
Xerath,FiddleSticks,64,40,24,62.5
Xerath,Ambessa,158,98,60,62.03
Xerath,Fizz,110,62,48,56.36
Xerath,Samira,138,61,77,44.2
Xerath,Nunu,135,78,57,57.78
Xerath,KogMaw,57,34,23,59.65
Xerath,Garen,237,98,139,41.35
Xerath,AurelionSol,60,36,24,60
Xerath,Viego,212,103,109,48.58
Xerath,Kaisa,289,154,135,53.29
Xerath,Ivern,27,16,11,59.26
Xerath,Rakan,89,38,51,42.7
Xerath,Senna,102,46,56,45.1
Xerath,Zyra,151,85,66,56.29
Xerath,Lissandra,81,43,38,53.09
Xerath,Graves,120,73,47,60.83
Xerath,Cassiopeia,52,35,17,67.31
Xerath,Alistar,88,60,28,68.18
Xerath,Heimerdinger,88,52,36,59.09
Xerath,Khazix,91,62,29,68.13
Xerath,Briar,83,52,31,62.65
Xerath,TwistedFate,84,49,35,58.33
Xerath,Ziggs,82,35,47,42.68
Xerath,Fiora,69,41,28,59.42
Xerath,Camille,50,29,21,58
Xerath,Evelynn,52,32,20,61.54
Xerath,Trundle,91,52,39,57.14
Xerath,Sylas,266,133,133,50
Xerath,Urgot,97,46,51,47.42
Xerath,RekSai,26,15,11,57.69
Xerath,TahmKench,145,55,90,37.93
Xerath,Bard,55,28,27,50.91
Xerath,DrMundo,73,52,21,71.23
Xerath,Sett,254,127,127,50
Xerath,Zeri,52,30,22,57.69
Xerath,Belveth,28,8,20,28.57
Xerath,Brand,80,39,41,48.75
Xerath,Singed,35,13,22,37.14
Xerath,XinZhao,135,58,77,42.96
Xerath,Zilean,32,9,23,28.13
Xerath,KSante,113,64,49,56.64
Xerath,Gnar,65,19,46,29.23
Xerath,Vex,104,51,53,49.04
Xerath,Kled,27,10,17,37.04
Xerath,Kalista,43,21,22,48.84
Xerath,Zoe,61,28,33,45.9
Xerath,Leblanc,131,66,65,50.38
Xerath,Annie,58,30,28,51.72
Xerath,Renata,23,7,16,30.43
Xerath,Taric,21,7,14,33.33
Xerath,Gwen,54,34,20,62.96
Xerath,Naafiri,69,33,36,47.83
Xerath,Corki,33,13,20,39.39
Xerath,Sona,30,15,15,50
Xerath,Rumble,57,33,24,57.89
Xerath,Udyr,73,49,24,67.12
Xerath,Azir,53,23,30,43.4
Xerath,Hecarim,48,29,19,60.42
Xerath,Anivia,78,30,48,38.46
Xerath,Kennen,78,44,34,56.41
Xerath,Xayah,77,46,31,59.74
Xerath,Qiyana,41,16,25,39.02
Xerath,Illaoi,79,37,42,46.84
Yuumi,Chogath,201,98,103,48.76
Yuumi,Mordekaiser,204,98,106,48.04
Yuumi,Swain,147,74,73,50.34
Yuumi,Sivir,54,32,22,59.26
Yuumi,Ashe,305,140,165,45.9
Yuumi,Kayle,91,34,57,37.36
Yuumi,Kindred,69,34,35,49.28
Yuumi,AurelionSol,94,57,37,60.64
Yuumi,Caitlyn,414,222,192,53.62
Yuumi,Morgana,130,60,70,46.15
Yuumi,Garen,242,130,112,53.72
Yuumi,Warwick,215,103,112,47.91
Yuumi,Yasuo,265,132,133,49.81
Yuumi,MissFortune,287,149,138,51.92
Yuumi,Lux,354,178,176,50.28
Yuumi,Sett,237,101,136,42.62
Yuumi,LeeSin,269,137,132,50.93
Yuumi,Hwei,106,57,49,53.77
Yuumi,Jhin,245,118,127,48.16
Yuumi,Zilean,49,26,23,53.06
Yuumi,Leblanc,92,61,31,66.3
Yuumi,Kayn,159,71,88,44.65
Yuumi,Teemo,164,91,73,55.49
Yuumi,Nautilus,234,132,102,56.41
Yuumi,Fizz,72,32,40,44.44
Yuumi,Udyr,49,44,5,89.8
Yuumi,Vex,45,17,28,37.78
Yuumi,Sona,28,11,17,39.29
Yuumi,Darius,296,152,144,51.35
Yuumi,Riven,58,36,22,62.07
Yuumi,Soraka,84,58,26,69.05
Yuumi,Aatrox,200,104,96,52
Yuumi,Amumu,177,98,79,55.37
Yuumi,Taliyah,65,33,32,50.77
Yuumi,Milio,142,74,68,52.11
Yuumi,Malphite,148,89,59,60.14
Yuumi,Nocturne,208,111,97,53.37
Yuumi,Malzahar,104,49,55,47.12
Yuumi,Samira,145,66,79,45.52
Yuumi,Pyke,184,100,84,54.35
Yuumi,Ambessa,103,35,68,33.98
Yuumi,Thresh,345,170,175,49.28
Yuumi,Ryze,71,32,39,45.07
Yuumi,Renekton,94,43,51,45.74
Yuumi,Elise,104,54,50,51.92
Yuumi,Zed,118,54,64,45.76
Yuumi,Kaisa,284,144,140,50.7
Yuumi,Gnar,111,51,60,45.95
Yuumi,Akali,147,82,65,55.78
Yuumi,Lucian,128,76,52,59.38
Yuumi,Rumble,58,33,25,56.9
Yuumi,Zoe,67,49,18,73.13
Yuumi,Mel,329,187,142,56.84
Yuumi,Seraphine,103,54,49,52.43
Yuumi,MonkeyKing,132,89,43,67.42
Yuumi,Zac,87,37,50,42.53
Yuumi,Pantheon,302,157,145,51.99
Yuumi,Katarina,123,49,74,39.84
Yuumi,Urgot,58,44,14,75.86
Yuumi,Ezreal,342,162,180,47.37
Yuumi,Jax,120,67,53,55.83
Yuumi,Trundle,54,30,24,55.56
Yuumi,Syndra,133,54,79,40.6
Yuumi,Khazix,74,52,22,70.27
Yuumi,Sejuani,98,39,59,39.8
Yuumi,Gwen,66,39,27,59.09
Yuumi,Lillia,85,59,26,69.41
Yuumi,Nami,149,56,93,37.58
Yuumi,Ahri,254,114,140,44.88
Yuumi,Blitzcrank,150,80,70,53.33
Yuumi,Viego,193,93,100,48.19
Yuumi,Veigar,173,87,86,50.29
Yuumi,Leona,142,58,84,40.85
Yuumi,Karma,195,95,100,48.72
Yuumi,Ornn,96,44,52,45.83
Yuumi,Lissandra,66,27,39,40.91
Yuumi,Braum,112,57,55,50.89
Yuumi,Rengar,70,43,27,61.43
Yuumi,Rammus,70,43,27,61.43
Yuumi,Camille,66,28,38,42.42
Yuumi,Orianna,73,51,22,69.86
Yuumi,Xayah,115,53,62,46.09
Yuumi,Draven,95,52,43,54.74
Yuumi,Gangplank,63,39,24,61.9
Yuumi,Qiyana,41,23,18,56.1
Yuumi,Vladimir,100,41,59,41
Yuumi,Volibear,157,69,88,43.95
Yuumi,Alistar,75,35,40,46.67
Yuumi,Illaoi,83,45,38,54.22
Yuumi,Naafiri,37,12,25,32.43
Yuumi,TahmKench,106,50,56,47.17
Yuumi,Azir,78,38,40,48.72
Yuumi,Janna,39,12,27,30.77
Yuumi,Vi,190,76,114,40
Yuumi,FiddleSticks,72,29,43,40.28
Yuumi,Jinx,390,202,188,51.79
Yuumi,Lulu,270,136,134,50.37
Yuumi,Poppy,126,53,73,42.06
Yuumi,Aphelios,99,47,52,47.47
Yuumi,Xerath,131,66,65,50.38
Yuumi,Aurora,149,86,63,57.72
Yuumi,Varus,137,73,64,53.28
Yuumi,Talon,69,26,43,37.68
Yuumi,Nasus,93,53,40,56.99
Yuumi,Brand,90,49,41,54.44
Yuumi,Rell,124,73,51,58.87
Yuumi,Yorick,119,64,55,53.78
Yuumi,RekSai,25,11,14,44
Yuumi,Neeko,60,34,26,56.67
Yuumi,Diana,200,98,102,49
Yuumi,Galio,191,119,72,62.3
Yuumi,Akshan,60,33,27,55
Yuumi,Ziggs,44,23,21,52.27
Yuumi,Nunu,105,50,55,47.62
Yuumi,Skarner,87,41,46,47.13
Yuumi,Gragas,112,83,29,74.11
Yuumi,Rakan,102,50,52,49.02
Yuumi,Tryndamere,50,22,28,44
Yuumi,Smolder,131,79,52,60.31
Yuumi,Tristana,138,69,69,50
Yuumi,Sion,108,52,56,48.15
Yuumi,Nidalee,79,43,36,54.43
Yuumi,Twitch,95,61,34,64.21
Yuumi,JarvanIV,120,60,60,50
Yuumi,Viktor,140,70,70,50
Yuumi,Yone,231,104,127,45.02
Yuumi,Taric,35,11,24,31.43
Yuumi,DrMundo,74,29,45,39.19
Yuumi,Jayce,77,38,39,49.35
Yuumi,Nilah,55,18,37,32.73
Yuumi,Senna,60,18,42,30
Yuumi,KSante,102,51,51,50
Yuumi,Ekko,115,65,50,56.52
Yuumi,Vayne,202,111,91,54.95
Yuumi,Sylas,177,96,81,54.24
Yuumi,Bard,63,31,32,49.21
Yuumi,Fiora,42,26,16,61.9
Yuumi,Annie,45,30,15,66.67
Yuumi,XinZhao,119,57,62,47.9
Yuumi,Ivern,43,31,12,72.09
Yuumi,MasterYi,173,91,82,52.6
Yuumi,Briar,73,34,39,46.58
Yuumi,Shen,91,32,59,35.16
Yuumi,Irelia,93,60,33,64.52
Yuumi,Kassadin,35,26,9,74.29
Yuumi,Zyra,98,66,32,67.35
Yuumi,Cassiopeia,55,17,38,30.91
Yuumi,Kennen,37,21,16,56.76
Yuumi,Zeri,99,58,41,58.59
Yuumi,Olaf,27,5,22,18.52
Yuumi,Singed,46,16,30,34.78
Yuumi,Anivia,78,41,37,52.56
Yuumi,Heimerdinger,83,43,40,51.81
Yuumi,Shaco,112,57,55,50.89
Yuumi,Belveth,26,23,3,88.46
Yuumi,Velkoz,72,44,28,61.11
Yuumi,Evelynn,27,14,13,51.85
Yuumi,Corki,71,28,43,39.44
Yuumi,Maokai,56,28,28,50
Yuumi,Hecarim,47,23,24,48.94
Yuumi,Kled,17,15,2,88.24
Yuumi,TwistedFate,58,32,26,55.17
Yuumi,Karthus,35,24,11,68.57
Yuumi,Kalista,54,31,23,57.41
Yuumi,Quinn,57,39,18,68.42
Yuumi,Graves,99,33,66,33.33
Yuumi,Shyvana,27,12,15,44.44
Yuumi,Renata,16,13,3,81.25
Yuumi,KogMaw,26,16,10,61.54
Chogath,Darius,448,236,212,52.68
Chogath,JarvanIV,171,96,75,56.14
Chogath,Xerath,184,74,110,40.22
Chogath,Mel,573,303,270,52.88
Chogath,Yuumi,201,103,98,51.24
Chogath,Yorick,247,148,99,59.92
Chogath,Teemo,270,167,103,61.85
Chogath,Katarina,203,115,88,56.65
Chogath,Jhin,487,235,252,48.25
Chogath,Lux,487,249,238,51.13
Chogath,Sett,433,204,229,47.11
Chogath,LeeSin,375,217,158,57.87
Chogath,Hwei,180,101,79,56.11
Chogath,Zilean,101,51,50,50.5
Chogath,Kindred,116,67,49,57.76
Chogath,Twitch,178,87,91,48.88
Chogath,Lulu,384,215,169,55.99
Chogath,Gwen,168,72,96,42.86
Chogath,Pantheon,384,208,176,54.17
Chogath,Irelia,149,96,53,64.43
Chogath,Varus,232,124,108,53.45
Chogath,Fizz,147,88,59,59.86
Chogath,Udyr,131,74,57,56.49
Chogath,Vex,135,80,55,59.26
Chogath,Sona,41,20,21,48.78
Chogath,Diana,368,199,169,54.08
Chogath,Akali,210,118,92,56.19
Chogath,Ashe,462,225,237,48.7
Chogath,Milio,152,92,60,60.53
Chogath,Garen,452,224,228,49.56
Chogath,Belveth,29,17,12,58.62
Chogath,Malzahar,284,147,137,51.76
Chogath,Kennen,95,60,35,63.16
Chogath,XinZhao,140,89,51,63.57
Chogath,Brand,100,48,52,48
Chogath,Veigar,290,169,121,58.28
Chogath,Morgana,249,104,145,41.77
Chogath,Mordekaiser,347,175,172,50.43
Chogath,Nocturne,292,146,146,50
Chogath,Viktor,254,134,120,52.76
Chogath,Poppy,163,92,71,56.44
Chogath,Caitlyn,636,316,320,49.69
Chogath,Gnar,157,88,69,56.05
Chogath,Amumu,345,164,181,47.54
Chogath,Aurora,197,114,83,57.87
Chogath,Tristana,211,138,73,65.4
Chogath,Thresh,483,286,197,59.21
Chogath,Kayn,326,153,173,46.93
Chogath,Kayle,138,47,91,34.06
Chogath,Shen,200,98,102,49
Chogath,Rammus,82,40,42,48.78
Chogath,Zed,211,105,106,49.76
Chogath,Yasuo,443,215,228,48.53
Chogath,Rell,185,102,83,55.14
Chogath,Trundle,166,84,82,50.6
Chogath,Khazix,120,76,44,63.33
Chogath,Jayce,124,81,43,65.32
Chogath,Ekko,236,116,120,49.15
Chogath,KSante,117,51,66,43.59
Chogath,Kaisa,382,212,170,55.5
Chogath,TahmKench,252,116,136,46.03
Chogath,Talon,112,65,47,58.04
Chogath,Lissandra,118,69,49,58.47
Chogath,Corki,132,73,59,55.3
Chogath,Evelynn,76,31,45,40.79
Chogath,MissFortune,522,264,258,50.57
Chogath,Volibear,254,137,117,53.94
Chogath,Soraka,159,91,68,57.23
Chogath,Shaco,192,122,70,63.54
Chogath,Lucian,205,100,105,48.78
Chogath,Swain,246,99,147,40.24
Chogath,Leblanc,157,95,62,60.51
Chogath,Jinx,718,405,313,56.41
Chogath,Yone,402,215,187,53.48
Chogath,Rakan,204,100,104,49.02
Chogath,Ivern,88,50,38,56.82
Chogath,Rengar,71,36,35,50.7
Chogath,Ziggs,87,48,39,55.17
Chogath,Senna,180,94,86,52.22
Chogath,Kassadin,56,37,19,66.07
Chogath,Ezreal,583,332,251,56.95
Chogath,Sylas,373,208,165,55.76
Chogath,Blitzcrank,242,156,86,64.46
Chogath,Anivia,98,50,48,51.02
Chogath,Zyra,178,83,95,46.63
Chogath,Qiyana,78,45,33,57.69
Chogath,RekSai,16,7,9,43.75
Chogath,Gragas,197,108,89,54.82
Chogath,Renekton,112,61,51,54.46
Chogath,Nautilus,315,168,147,53.33
Chogath,AurelionSol,132,70,62,53.03
Chogath,Nunu,205,120,85,58.54
Chogath,Syndra,191,107,84,56.02
Chogath,Seraphine,163,71,92,43.56
Chogath,TwistedFate,61,38,23,62.3
Chogath,Alistar,151,95,56,62.91
Chogath,MasterYi,262,153,109,58.4
Chogath,Smolder,194,78,116,40.21
Chogath,Zac,174,85,89,48.85
Chogath,Aatrox,228,131,97,57.46
Chogath,Warwick,356,183,173,51.4
Chogath,Vladimir,208,128,80,61.54
Chogath,Kalista,71,32,39,45.07
Chogath,Renata,52,23,29,44.23
Chogath,Olaf,100,61,39,61
Chogath,Vayne,428,219,209,51.17
Chogath,Ahri,360,179,181,49.72
Chogath,Taric,60,32,28,53.33
Chogath,Sion,248,121,127,48.79
Chogath,Samira,150,91,59,60.67
Chogath,Ambessa,169,92,77,54.44
Chogath,Elise,218,115,103,52.75
Chogath,Quinn,95,43,52,45.26
Chogath,Briar,168,71,97,42.26
Chogath,Karma,308,161,147,52.27
Chogath,Cassiopeia,93,50,43,53.76
Chogath,MonkeyKing,139,66,73,47.48
Chogath,Azir,95,45,50,47.37
Chogath,Nasus,122,59,63,48.36
Chogath,Karthus,58,19,39,32.76
Chogath,Draven,119,51,68,42.86
Chogath,Jax,207,115,92,55.56
Chogath,Urgot,135,76,59,56.3
Chogath,Janna,86,36,50,41.86
Chogath,Ornn,168,99,69,58.93
Chogath,Viego,379,207,172,54.62
Chogath,Nilah,103,54,49,52.43
Chogath,Nami,264,124,140,46.97
Chogath,Illaoi,123,47,76,38.21
Chogath,Malphite,286,159,127,55.59
Chogath,Gangplank,105,57,48,54.29
Chogath,DrMundo,194,115,79,59.28
Chogath,Ryze,117,56,61,47.86
Chogath,Leona,261,132,129,50.57
Chogath,Sejuani,164,73,91,44.51
Chogath,Bard,117,52,65,44.44
Chogath,Heimerdinger,101,65,36,64.36
Chogath,Fiora,153,60,93,39.22
Chogath,Hecarim,88,34,54,38.64
Chogath,Camille,110,68,42,61.82
Chogath,Sivir,123,69,54,56.1
Chogath,Riven,109,62,47,56.88
Chogath,Velkoz,132,77,55,58.33
Chogath,Taliyah,64,23,41,35.94
Chogath,Skarner,69,38,31,55.07
Chogath,Shyvana,54,17,37,31.48
Chogath,Galio,245,121,124,49.39
Chogath,FiddleSticks,114,56,58,49.12
Chogath,Naafiri,74,33,41,44.59
Chogath,Nidalee,81,43,38,53.09
Chogath,Braum,200,92,108,46
Chogath,Vi,313,154,159,49.2
Chogath,Orianna,134,64,70,47.76
Chogath,Zoe,96,48,48,50
Chogath,Lillia,153,79,74,51.63
Chogath,Zeri,130,74,56,56.92
Chogath,Pyke,205,129,76,62.93
Chogath,Maokai,124,55,69,44.35
Chogath,KogMaw,74,28,46,37.84
Chogath,Tryndamere,107,56,51,52.34
Chogath,Akshan,109,63,46,57.8
Chogath,Aphelios,163,100,63,61.35
Chogath,Xayah,158,103,55,65.19
Chogath,Rumble,66,34,32,51.52
Chogath,Kled,56,31,25,55.36
Chogath,Annie,90,43,47,47.78
Chogath,Graves,161,104,57,64.6
Chogath,Neeko,103,66,37,64.08
Chogath,Singed,45,25,20,55.56
Sivir,Darius,181,93,88,51.38
Sivir,JarvanIV,63,41,22,65.08
Sivir,Xerath,107,36,71,33.64
Sivir,Mel,188,98,90,52.13
Sivir,Yuumi,54,22,32,40.74
Sivir,DrMundo,77,42,35,54.55
Sivir,Sejuani,90,48,42,53.33
Sivir,Lux,257,153,104,59.53
Sivir,Ashe,255,140,115,54.9
Sivir,TwistedFate,48,35,13,72.92
Sivir,Sett,152,77,75,50.66
Sivir,Hecarim,45,22,23,48.89
Sivir,Ahri,172,108,64,62.79
Sivir,Rakan,57,35,22,61.4
Sivir,Draven,55,37,18,67.27
Sivir,Graves,54,21,33,38.89
Sivir,Neeko,60,40,20,66.67
Sivir,Alistar,93,58,35,62.37
Sivir,Sion,80,29,51,36.25
Sivir,Pantheon,213,109,104,51.17
Sivir,Zoe,52,30,22,57.69
Sivir,Ziggs,42,18,24,42.86
Sivir,Veigar,109,47,62,43.12
Sivir,Illaoi,71,31,40,43.66
Sivir,Vex,89,48,41,53.93
Sivir,Lucian,117,50,67,42.74
Sivir,Braum,75,37,38,49.33
Sivir,Kalista,47,34,13,72.34
Sivir,Amumu,144,68,76,47.22
Sivir,Irelia,75,46,29,61.33
Sivir,Milio,67,29,38,43.28
Sivir,Mordekaiser,141,63,78,44.68
Sivir,Nocturne,138,72,66,52.17
Sivir,Viktor,129,74,55,57.36
Sivir,Poppy,83,50,33,60.24
Sivir,Caitlyn,263,143,120,54.37
Sivir,Ekko,89,41,48,46.07
Sivir,Azir,73,39,34,53.42
Sivir,Jinx,266,135,131,50.75
Sivir,Nami,114,59,55,51.75
Sivir,KSante,81,59,22,72.84
Sivir,Rammus,20,10,10,50
Sivir,Aurora,111,44,67,39.64
Sivir,Kaisa,192,117,75,60.94
Sivir,Zilean,30,15,15,50
Sivir,Ornn,54,29,25,53.7
Sivir,Kayn,136,66,70,48.53
Sivir,Sylas,171,98,73,57.31
Sivir,Pyke,109,68,41,62.39
Sivir,Camille,54,15,39,27.78
Sivir,Udyr,41,23,18,56.1
Sivir,Jhin,236,114,122,48.31
Sivir,TahmKench,112,51,61,45.54
Sivir,Tristana,85,44,41,51.76
Sivir,Varus,128,66,62,51.56
Sivir,Quinn,56,29,27,51.79
Sivir,Ambessa,93,47,46,50.54
Sivir,Brand,36,20,16,55.56
Sivir,Nasus,71,34,37,47.89
Sivir,Nunu,62,32,30,51.61
Sivir,Morgana,145,86,59,59.31
Sivir,Teemo,90,47,43,52.22
Sivir,MissFortune,244,122,122,50
Sivir,FiddleSticks,53,20,33,37.74
Sivir,Malzahar,110,50,60,45.45
Sivir,Leona,123,78,45,63.41
Sivir,Garen,179,100,79,55.87
Sivir,LeeSin,194,98,96,50.52
Sivir,Renekton,53,22,31,41.51
Sivir,Zyra,96,54,42,56.25
Sivir,Warwick,202,93,109,46.04
Sivir,Yasuo,180,105,75,58.33
Sivir,Seraphine,76,37,39,48.68
Sivir,Galio,123,64,59,52.03
Sivir,Jax,110,63,47,57.27
Sivir,Zeri,54,32,22,59.26
Sivir,Singed,41,17,24,41.46
Sivir,Ezreal,312,181,131,58.01
Sivir,Khazix,33,14,19,42.42
Sivir,Gnar,43,23,20,53.49
Sivir,MonkeyKing,64,25,39,39.06
Sivir,Karma,149,74,75,49.66
Sivir,Urgot,40,25,15,62.5
Sivir,Ivern,36,20,16,55.56
Sivir,AurelionSol,43,19,24,44.19
Sivir,Lulu,153,68,85,44.44
Sivir,Belveth,25,17,8,68
Sivir,Ryze,55,31,24,56.36
Sivir,Rell,76,44,32,57.89
Sivir,Soraka,50,22,28,44
Sivir,Akali,132,66,66,50
Sivir,Vi,139,72,67,51.8
Sivir,Hwei,57,42,15,73.68
Sivir,Diana,128,75,53,58.59
Sivir,Trundle,54,29,25,53.7
Sivir,Nautilus,179,105,74,58.66
Sivir,Gwen,62,29,33,46.77
Sivir,Leblanc,50,27,23,54
Sivir,Blitzcrank,133,69,64,51.88
Sivir,Shaco,82,64,18,78.05
Sivir,Zed,86,53,33,61.63
Sivir,Olaf,39,17,22,43.59
Sivir,Volibear,137,67,70,48.91
Sivir,Vayne,134,55,79,41.04
Sivir,Katarina,50,11,39,22
Sivir,MasterYi,118,53,65,44.92
Sivir,Chogath,123,54,69,43.9
Sivir,Lissandra,40,26,14,65
Sivir,Kassadin,23,10,13,43.48
Sivir,Shyvana,27,8,19,29.63
Sivir,Nidalee,30,14,16,46.67
Sivir,Zac,66,49,17,74.24
Sivir,Skarner,59,28,31,47.46
Sivir,Yone,166,98,68,59.04
Sivir,Taric,17,11,6,64.71
Sivir,Fiora,41,16,25,39.02
Sivir,Syndra,86,40,46,46.51
Sivir,Kindred,46,27,19,58.7
Sivir,KogMaw,25,6,19,24
Sivir,Senna,56,43,13,76.79
Sivir,Gangplank,43,20,23,46.51
Sivir,Aphelios,77,35,42,45.45
Sivir,Anivia,38,21,17,55.26
Sivir,Swain,90,44,46,48.89
Sivir,Aatrox,110,66,44,60
Sivir,Cassiopeia,31,6,25,19.35
Sivir,Orianna,48,15,33,31.25
Sivir,Nilah,13,6,7,46.15
Sivir,Fizz,43,12,31,27.91
Sivir,Malphite,111,65,46,58.56
Sivir,Briar,44,29,15,65.91
Sivir,Thresh,248,130,118,52.42
Sivir,Riven,42,29,13,69.05
Sivir,Shen,83,60,23,72.29
Sivir,Vladimir,77,42,35,54.55
Sivir,Talon,75,26,49,34.67
Sivir,Samira,79,40,39,50.63
Sivir,Yorick,81,48,33,59.26
Sivir,Bard,28,10,18,35.71
Sivir,Evelynn,28,8,20,28.57
Sivir,Janna,22,6,16,27.27
Sivir,Xayah,40,33,7,82.5
Sivir,Smolder,58,32,26,55.17
Sivir,Rengar,32,18,14,56.25
Sivir,Rumble,35,19,16,54.29
Sivir,Corki,50,34,16,68
Sivir,Maokai,54,41,13,75.93
Sivir,Gragas,61,39,22,63.93
Sivir,Elise,107,67,40,62.62
Sivir,Naafiri,18,8,10,44.44
Sivir,Viego,148,62,86,41.89
Sivir,Renata,23,14,9,60.87
Sivir,Kled,12,9,3,75
Sivir,Twitch,74,34,40,45.95
Sivir,Qiyana,14,5,9,35.71
Sivir,Kayle,74,26,48,35.14
Sivir,Velkoz,47,23,24,48.94
Sivir,Jayce,43,32,11,74.42
Sivir,XinZhao,56,32,24,57.14
Sivir,Sona,16,2,14,12.5
Sivir,Taliyah,31,24,7,77.42
Sivir,Kennen,25,18,7,72
Sivir,Tryndamere,26,9,17,34.62
Sivir,Lillia,61,35,26,57.38
Sivir,Akshan,24,14,10,58.33
Sivir,Heimerdinger,51,24,27,47.06
Sivir,Annie,29,24,5,82.76
Sivir,Karthus,8,3,5,37.5
Sivir,RekSai,12,12,0,100
Ashe,Darius,670,292,378,43.58
Ashe,JarvanIV,326,169,157,51.84
Ashe,Xerath,356,191,165,53.65
Ashe,Mel,754,342,412,45.36
Ashe,Yuumi,305,165,140,54.1
Ashe,Sejuani,290,125,165,43.1
Ashe,Pantheon,583,311,272,53.34
Ashe,Neeko,194,92,102,47.42
Ashe,Varus,451,203,248,45.01
Ashe,Pyke,349,184,165,52.72
Ashe,Malphite,387,173,214,44.7
Ashe,Vi,415,183,232,44.1
Ashe,Veigar,328,158,170,48.17
Ashe,Sivir,255,115,140,45.1
Ashe,Senna,243,113,130,46.5
Ashe,Teemo,350,203,147,58
Ashe,Viego,559,217,342,38.82
Ashe,Anivia,133,62,71,46.62
Ashe,MissFortune,824,383,441,46.48
Ashe,TahmKench,378,193,185,51.06
Ashe,Thresh,706,347,359,49.15
Ashe,Annie,149,79,70,53.02
Ashe,Nasus,241,115,126,47.72
Ashe,Tristana,361,147,214,40.72
Ashe,Poppy,281,117,164,41.64
Ashe,Gnar,201,90,111,44.78
Ashe,Hecarim,136,70,66,51.47
Ashe,Viktor,322,156,166,48.45
Ashe,Rell,258,100,158,38.76
Ashe,Riven,162,60,102,37.04
Ashe,MonkeyKing,297,146,151,49.16
Ashe,Kassadin,71,37,34,52.11
Ashe,Caitlyn,1220,613,607,50.25
Ashe,Taliyah,98,61,37,62.24
Ashe,Urgot,151,80,71,52.98
Ashe,Kayn,486,243,243,50
Ashe,Vladimir,219,104,115,47.49
Ashe,Kaisa,662,362,300,54.68
Ashe,Taric,111,58,53,52.25
Ashe,Yone,729,358,371,49.11
Ashe,Diana,521,266,255,51.06
Ashe,Gragas,301,164,137,54.49
Ashe,Yasuo,800,395,405,49.38
Ashe,Nami,349,172,177,49.28
Ashe,Xayah,186,97,89,52.15
Ashe,Lucian,329,172,157,52.28
Ashe,Shen,310,161,149,51.94
Ashe,Shaco,283,147,136,51.94
Ashe,Heimerdinger,186,92,94,49.46
Ashe,Ezreal,1250,633,617,50.64
Ashe,Quinn,129,61,68,47.29
Ashe,MasterYi,362,171,191,47.24
Ashe,Garen,569,260,309,45.69
Ashe,Smolder,212,99,113,46.7
Ashe,Nautilus,557,255,302,45.78
Ashe,Zed,396,180,216,45.45
Ashe,Skarner,169,98,71,57.99
Ashe,Aurora,322,154,168,47.83
Ashe,Mordekaiser,455,224,231,49.23
Ashe,Amumu,401,201,200,50.12
Ashe,Karma,530,285,245,53.77
Ashe,Briar,224,89,135,39.73
Ashe,Nocturne,389,196,193,50.39
Ashe,Lissandra,162,77,85,47.53
Ashe,Khazix,169,73,96,43.2
Ashe,Galio,427,204,223,47.78
Ashe,Yorick,323,139,184,43.03
Ashe,Sylas,690,343,347,49.71
Ashe,Renata,108,40,68,37.04
Ashe,Camille,155,79,76,50.97
Ashe,Graves,248,102,146,41.13
Ashe,Hwei,271,145,126,53.51
Ashe,Nilah,131,59,72,45.04
Ashe,Jax,346,197,149,56.94
Ashe,RekSai,71,43,28,60.56
Ashe,Rakan,198,98,100,49.49
Ashe,Cassiopeia,98,38,60,38.78
Ashe,XinZhao,268,109,159,40.67
Ashe,Orianna,203,107,96,52.71
Ashe,Ahri,592,328,264,55.41
Ashe,Rengar,119,54,65,45.38
Ashe,Chogath,462,237,225,51.3
Ashe,Zyra,319,154,165,48.28
Ashe,Malzahar,409,201,208,49.14
Ashe,Corki,163,76,87,46.63
Ashe,LeeSin,839,447,392,53.28
Ashe,Katarina,222,103,119,46.4
Ashe,Aatrox,436,186,250,42.66
Ashe,Blitzcrank,386,170,216,44.04
Ashe,Irelia,331,175,156,52.87
Ashe,Jhin,748,357,391,47.73
Ashe,Leona,412,192,220,46.6
Ashe,Kindred,164,69,95,42.07
Ashe,Elise,317,168,149,53
Ashe,Vayne,450,221,229,49.11
Ashe,Akali,348,177,171,50.86
Ashe,Jinx,1157,523,634,45.2
Ashe,Milio,270,108,162,40
Ashe,KSante,270,152,118,56.3
Ashe,Rammus,127,61,66,48.03
Ashe,Zilean,138,79,59,57.25
Ashe,Ziggs,132,63,69,47.73
Ashe,Belveth,75,36,39,48
Ashe,Samira,234,105,129,44.87
Ashe,Sion,323,152,171,47.06
Ashe,Warwick,552,279,273,50.54
Ashe,Swain,433,191,242,44.11
Ashe,Illaoi,217,103,114,47.47
Ashe,Nunu,215,107,108,49.77
Ashe,Lux,868,470,398,54.15
Ashe,Volibear,384,160,224,41.67
Ashe,Ambessa,309,164,145,53.07
Ashe,Vex,236,117,119,49.58
Ashe,Aphelios,217,124,93,57.14
Ashe,Lulu,566,296,270,52.3
Ashe,Rumble,107,48,59,44.86
Ashe,Zoe,172,79,93,45.93
Ashe,Morgana,404,179,225,44.31
Ashe,Talon,206,104,102,50.49
Ashe,Udyr,154,86,68,55.84
Ashe,Sona,79,44,35,55.7
Ashe,Fizz,147,82,65,55.78
Ashe,Soraka,158,69,89,43.67
Ashe,Evelynn,97,65,32,67.01
Ashe,Brand,233,135,98,57.94
Ashe,Ornn,263,112,151,42.59
Ashe,Trundle,236,124,112,52.54
Ashe,Sett,561,264,297,47.06
Ashe,Lillia,191,72,119,37.7
Ashe,Renekton,160,72,88,45
Ashe,Tryndamere,105,52,53,49.52
Ashe,Ekko,301,122,179,40.53
Ashe,Olaf,125,67,58,53.6
Ashe,Leblanc,297,129,168,43.43
Ashe,Nidalee,149,70,79,46.98
Ashe,Kled,88,42,46,47.73
Ashe,Velkoz,166,82,84,49.4
Ashe,Seraphine,240,103,137,42.92
Ashe,Zac,268,150,118,55.97
Ashe,Azir,173,85,88,49.13
Ashe,Fiora,126,73,53,57.94
Ashe,DrMundo,202,110,92,54.46
Ashe,FiddleSticks,207,101,106,48.79
Ashe,Ivern,80,41,39,51.25
Ashe,Draven,189,87,102,46.03
Ashe,Alistar,221,121,100,54.75
Ashe,Gwen,208,98,110,47.12
Ashe,Jayce,205,108,97,52.68
Ashe,Shyvana,96,43,53,44.79
Ashe,Singed,94,35,59,37.23
Ashe,Naafiri,117,56,61,47.86
Ashe,Gangplank,174,94,80,54.02
Ashe,Twitch,281,148,133,52.67
Ashe,Kayle,188,93,95,49.47
Ashe,Kennen,132,50,82,37.88
Ashe,Maokai,162,71,91,43.83
Ashe,Braum,288,124,164,43.06
Ashe,Zeri,168,83,85,49.4
Ashe,Qiyana,60,25,35,41.67
Ashe,Ryze,127,51,76,40.16
Ashe,KogMaw,97,62,35,63.92
Ashe,Syndra,237,118,119,49.79
Ashe,Janna,107,54,53,50.47
Ashe,TwistedFate,115,50,65,43.48
Ashe,AurelionSol,148,76,72,51.35
Ashe,Kalista,153,85,68,55.56
Ashe,Karthus,93,44,49,47.31
Ashe,Akshan,88,54,34,61.36
Ashe,Bard,93,31,62,33.33
Malphite,Sett,346,169,177,48.84
Malphite,Kayn,287,156,131,54.36
Malphite,Katarina,115,72,43,62.61
Malphite,Jinx,529,245,284,46.31
Malphite,Renata,55,31,24,56.36
Malphite,DrMundo,91,47,44,51.65
Malphite,Sejuani,152,70,82,46.05
Malphite,Lux,497,231,266,46.48
Malphite,Ashe,387,214,173,55.3
Malphite,TwistedFate,53,22,31,41.51
Malphite,Pantheon,380,192,188,50.53
Malphite,Ekko,148,73,75,49.32
Malphite,Talon,89,31,58,34.83
Malphite,Kaisa,332,196,136,59.04
Malphite,Soraka,113,75,38,66.37
Malphite,Teemo,299,157,142,52.51
Malphite,Khazix,162,104,58,64.2
Malphite,Zoe,97,67,30,69.07
Malphite,Poppy,144,70,74,48.61
Malphite,Amumu,286,117,169,40.91
Malphite,Lissandra,83,48,35,57.83
Malphite,Lucian,182,95,87,52.2
Malphite,Xerath,157,71,86,45.22
Malphite,Aatrox,196,109,87,55.61
Malphite,MasterYi,245,108,137,44.08
Malphite,Mel,434,212,222,48.85
Malphite,Tristana,195,87,108,44.62
Malphite,Sona,34,13,21,38.24
Malphite,Rengar,95,59,36,62.11
Malphite,Warwick,292,137,155,46.92
Malphite,Irelia,191,113,78,59.16
Malphite,Nautilus,290,129,161,44.48
Malphite,Fizz,91,44,47,48.35
Malphite,Udyr,84,52,32,61.9
Malphite,Vex,137,86,51,62.77
Malphite,Darius,379,193,186,50.92
Malphite,XinZhao,106,58,48,54.72
Malphite,Orianna,145,68,77,46.9
Malphite,Ezreal,667,333,334,49.93
Malphite,Thresh,409,193,216,47.19
Malphite,Nocturne,278,145,133,52.16
Malphite,Nami,211,99,112,46.92
Malphite,Yone,432,240,192,55.56
Malphite,Malzahar,242,143,99,59.09
Malphite,KogMaw,76,35,41,46.05
Malphite,Veigar,256,138,118,53.91
Malphite,Gwen,135,74,61,54.81
Malphite,Briar,142,64,78,45.07
Malphite,Aurora,133,73,60,54.89
Malphite,TahmKench,173,66,107,38.15
Malphite,Nasus,154,72,82,46.75
Malphite,Anivia,74,43,31,58.11
Malphite,Vayne,323,178,145,55.11
Malphite,Yuumi,148,59,89,39.86
Malphite,Xayah,118,69,49,58.47
Malphite,Karthus,48,22,26,45.83
Malphite,Naafiri,58,44,14,75.86
Malphite,Heimerdinger,104,44,60,42.31
Malphite,Samira,167,94,73,56.29
Malphite,Kindred,94,59,35,62.77
Malphite,Yasuo,497,248,249,49.9
Malphite,MissFortune,413,207,206,50.12
Malphite,Riven,87,47,40,54.02
Malphite,Galio,222,107,115,48.2
Malphite,Lulu,276,149,127,53.99
Malphite,Diana,318,156,162,49.06
Malphite,Ryze,91,51,40,56.04
Malphite,Pyke,232,152,80,65.52
Malphite,Vi,213,102,111,47.89
Malphite,Smolder,193,99,94,51.3
Malphite,Volibear,173,92,81,53.18
Malphite,Gnar,184,110,74,59.78
Malphite,Elise,170,67,103,39.41
Malphite,Zyra,189,107,82,56.61
Malphite,Varus,221,104,117,47.06
Malphite,Leona,254,126,128,49.61
Malphite,Quinn,126,64,62,50.79
Malphite,Sylas,486,196,290,40.33
Malphite,Vladimir,150,64,86,42.67
Malphite,LeeSin,333,139,194,41.74
Malphite,Twitch,198,107,91,54.04
Malphite,Renekton,114,46,68,40.35
Malphite,Urgot,127,68,59,53.54
Malphite,Ahri,293,155,138,52.9
Malphite,Blitzcrank,208,111,97,53.37
Malphite,Caitlyn,574,290,284,50.52
Malphite,Zed,272,133,139,48.9
Malphite,Shaco,167,98,69,58.68
Malphite,Gangplank,97,40,57,41.24
Malphite,Karma,240,126,114,52.5
Malphite,Mordekaiser,287,113,174,39.37
Malphite,Maokai,87,45,42,51.72
Malphite,Ziggs,78,36,42,46.15
Malphite,Yorick,188,88,100,46.81
Malphite,Alistar,149,65,84,43.62
Malphite,Jhin,415,193,222,46.51
Malphite,Garen,300,132,168,44
Malphite,Senna,160,77,83,48.13
Malphite,FiddleSticks,64,29,35,45.31
Malphite,Seraphine,196,91,105,46.43
Malphite,Gragas,106,57,49,53.77
Malphite,Corki,95,40,55,42.11
Malphite,Swain,214,93,121,43.46
Malphite,Ivern,31,22,9,70.97
Malphite,Syndra,150,90,60,60
Malphite,Aphelios,122,74,48,60.66
Malphite,Viktor,225,115,110,51.11
Malphite,Illaoi,101,50,51,49.5
Malphite,Lillia,116,64,52,55.17
Malphite,Bard,66,30,36,45.45
Malphite,Akali,165,76,89,46.06
Malphite,Morgana,193,91,102,47.15
Malphite,Viego,313,155,158,49.52
Malphite,Leblanc,126,61,65,48.41
Malphite,JarvanIV,183,108,75,59.02
Malphite,Hwei,126,73,53,57.94
Malphite,Ambessa,169,93,76,55.03
Malphite,Qiyana,61,37,24,60.66
Malphite,Brand,113,57,56,50.44
Malphite,Nilah,82,48,34,58.54
Malphite,Taliyah,63,34,29,53.97
Malphite,Nidalee,62,21,41,33.87
Malphite,Rell,155,92,63,59.35
Malphite,Chogath,286,127,159,44.41
Malphite,Velkoz,116,70,46,60.34
Malphite,Tryndamere,114,59,55,51.75
Malphite,Rumble,69,39,30,56.52
Malphite,RekSai,33,21,12,63.64
Malphite,Rakan,130,66,64,50.77
Malphite,Shen,150,75,75,50
Malphite,Nunu,167,92,75,55.09
Malphite,Evelynn,56,23,33,41.07
Malphite,Ornn,160,65,95,40.63
Malphite,Kalista,69,38,31,55.07
Malphite,Milio,133,69,64,51.88
Malphite,Skarner,92,47,45,51.09
Malphite,Taric,50,33,17,66
Malphite,Shyvana,56,33,23,58.93
Malphite,Fiora,72,46,26,63.89
Malphite,Cassiopeia,81,25,56,30.86
Malphite,Zac,115,50,65,43.48
Malphite,Kayle,112,54,58,48.21
Malphite,Graves,157,93,64,59.24
Malphite,Azir,87,54,33,62.07
Malphite,Olaf,46,18,28,39.13
Malphite,Hecarim,80,51,29,63.75
Malphite,KSante,109,61,48,55.96
Malphite,Zeri,93,35,58,37.63
Malphite,AurelionSol,80,32,48,40
Malphite,Trundle,88,54,34,61.36
Malphite,Jayce,126,73,53,57.94
Malphite,Sion,212,97,115,45.75
Malphite,Janna,71,32,39,45.07
Malphite,Draven,99,68,31,68.69
Malphite,Zilean,53,25,28,47.17
Malphite,Singed,70,23,47,32.86
Malphite,MonkeyKing,135,66,69,48.89
Malphite,Jax,127,67,60,52.76
Malphite,Neeko,96,40,56,41.67
Malphite,Sivir,111,46,65,41.44
Malphite,Braum,154,102,52,66.23
Malphite,Camille,67,32,35,47.76
Malphite,Kassadin,46,26,20,56.52
Malphite,Rammus,106,55,51,51.89
Malphite,Akshan,88,41,47,46.59
Malphite,Kennen,62,34,28,54.84
Malphite,Belveth,46,25,21,54.35
Malphite,Annie,60,29,31,48.33
Malphite,Kled,21,10,11,47.62
Lissandra,Sett,139,65,74,46.76
Lissandra,Kayn,93,53,40,56.99
Lissandra,Katarina,40,20,20,50
Lissandra,Jinx,166,43,123,25.9
Lissandra,Renata,8,5,3,62.5
Lissandra,Nasus,32,18,14,56.25
Lissandra,Sejuani,70,28,42,40
Lissandra,Malzahar,54,29,25,53.7
Lissandra,TwistedFate,36,16,20,44.44
Lissandra,Seraphine,71,40,31,56.34
Lissandra,Irelia,46,22,24,47.83
Lissandra,Malphite,83,35,48,42.17
Lissandra,Jhin,141,63,78,44.68
Lissandra,Karma,79,41,38,51.9
Lissandra,Aatrox,70,51,19,72.86
Lissandra,Lillia,37,23,14,62.16
Lissandra,Hwei,63,31,32,49.21
Lissandra,Ashe,162,85,77,52.47
Lissandra,Amumu,91,54,37,59.34
Lissandra,Gangplank,35,19,16,54.29
Lissandra,Pantheon,115,61,54,53.04
Lissandra,Kaisa,134,90,44,67.16
Lissandra,Braum,68,36,32,52.94
Lissandra,Poppy,61,34,27,55.74
Lissandra,Khazix,48,26,22,54.17
Lissandra,Yone,124,48,76,38.71
Lissandra,Gragas,55,21,34,38.18
Lissandra,Trundle,43,23,20,53.49
Lissandra,Aurora,54,30,24,55.56
Lissandra,Varus,69,35,34,50.72
Lissandra,XinZhao,52,29,23,55.77
Lissandra,Chogath,118,49,69,41.53
Lissandra,Gwen,41,16,25,39.02
Lissandra,Rell,56,36,20,64.29
Lissandra,Nunu,69,31,38,44.93
Lissandra,Lux,172,86,86,50
Lissandra,Caitlyn,195,98,97,50.26
Lissandra,Milio,64,24,40,37.5
Lissandra,Yorick,78,25,53,32.05
Lissandra,Viego,107,54,53,50.47
Lissandra,Xayah,43,25,18,58.14
Lissandra,Rakan,36,9,27,25
Lissandra,Mordekaiser,86,46,40,53.49
Lissandra,Viktor,86,37,49,43.02
Lissandra,Fiora,32,22,10,68.75
Lissandra,Diana,108,42,66,38.89
Lissandra,Akali,92,36,56,39.13
Lissandra,Yuumi,66,39,27,59.09
Lissandra,Taliyah,17,11,6,64.71
Lissandra,Zed,119,79,40,66.39
Lissandra,MissFortune,154,78,76,50.65
Lissandra,Gnar,55,38,17,69.09
Lissandra,Nocturne,89,44,45,49.44
Lissandra,Galio,84,47,37,55.95
Lissandra,Vayne,81,44,37,54.32
Lissandra,LeeSin,132,59,73,44.7
Lissandra,Sylas,125,62,63,49.6
Lissandra,Tristana,79,36,43,45.57
Lissandra,Nautilus,82,60,22,73.17
Lissandra,Lulu,96,49,47,51.04
Lissandra,Mel,140,99,41,70.71
Lissandra,Soraka,36,15,21,41.67
Lissandra,Teemo,50,19,31,38
Lissandra,Shaco,67,45,22,67.16
Lissandra,Zoe,29,23,6,79.31
Lissandra,Nilah,39,24,15,61.54
Lissandra,Illaoi,55,25,30,45.45
Lissandra,Ziggs,37,14,23,37.84
Lissandra,Cassiopeia,40,19,21,47.5
Lissandra,Yasuo,181,75,106,41.44
Lissandra,Leona,88,52,36,59.09
Lissandra,Riven,46,19,27,41.3
Lissandra,Syndra,34,20,14,58.82
Lissandra,Blitzcrank,67,43,24,64.18
Lissandra,FiddleSticks,27,15,12,55.56
Lissandra,Nami,94,48,46,51.06
Lissandra,Akshan,23,9,14,39.13
Lissandra,Ornn,29,14,15,48.28
Lissandra,Qiyana,30,13,17,43.33
Lissandra,Neeko,34,23,11,67.65
Lissandra,DrMundo,39,28,11,71.79
Lissandra,Rengar,29,24,5,82.76
Lissandra,Zyra,83,30,53,36.14
Lissandra,Sion,51,24,27,47.06
Lissandra,Renekton,45,26,19,57.78
Lissandra,Brand,26,12,14,46.15
Lissandra,Sivir,40,14,26,35
Lissandra,Nidalee,29,19,10,65.52
Lissandra,TahmKench,96,58,38,60.42
Lissandra,Kayle,54,26,28,48.15
Lissandra,Naafiri,24,12,12,50
Lissandra,Alistar,38,19,19,50
Lissandra,Xerath,81,38,43,46.91
Lissandra,Graves,49,32,17,65.31
Lissandra,Zeri,39,27,12,69.23
Lissandra,Smolder,49,17,32,34.69
Lissandra,Janna,17,5,12,29.41
Lissandra,Jayce,21,8,13,38.1
Lissandra,Aphelios,53,30,23,56.6
Lissandra,Thresh,168,70,98,41.67
Lissandra,Annie,22,4,18,18.18
Lissandra,Garen,103,55,48,53.4
Lissandra,Warwick,109,32,77,29.36
Lissandra,Ahri,145,72,73,49.66
Lissandra,Morgana,76,23,53,30.26
Lissandra,Udyr,17,10,7,58.82
Lissandra,Leblanc,65,40,25,61.54
Lissandra,Vladimir,36,20,16,55.56
Lissandra,MonkeyKing,69,27,42,39.13
Lissandra,Ezreal,179,89,90,49.72
Lissandra,Samira,71,28,43,39.44
Lissandra,Rammus,42,14,28,33.33
Lissandra,KSante,47,20,27,42.55
Lissandra,AurelionSol,38,14,24,36.84
Lissandra,Quinn,24,10,14,41.67
Lissandra,Briar,31,12,19,38.71
Lissandra,Senna,44,23,21,52.27
Lissandra,Shyvana,14,8,6,57.14
Lissandra,Velkoz,31,19,12,61.29
Lissandra,Elise,88,45,43,51.14
Lissandra,Veigar,83,32,51,38.55
Lissandra,Darius,125,46,79,36.8
Lissandra,Azir,21,10,11,47.62
Lissandra,Karthus,23,8,15,34.78
Lissandra,Vex,33,3,30,9.09
Lissandra,Pyke,42,22,20,52.38
Lissandra,Talon,26,17,9,65.38
Lissandra,Heimerdinger,22,7,15,31.82
Lissandra,Anivia,26,5,21,19.23
Lissandra,MasterYi,75,41,34,54.67
Lissandra,Singed,30,20,10,66.67
Lissandra,Jax,46,25,21,54.35
Lissandra,Corki,35,20,15,57.14
Lissandra,Kindred,33,10,23,30.3
Lissandra,Zilean,25,7,18,28
Lissandra,Tryndamere,23,9,14,39.13
Lissandra,Fizz,39,28,11,71.79
Lissandra,Skarner,20,7,13,35
Lissandra,JarvanIV,58,28,30,48.28
Lissandra,Belveth,18,13,5,72.22
Lissandra,Evelynn,29,19,10,65.52
Lissandra,Volibear,88,50,38,56.82
Lissandra,Zac,47,16,31,34.04
Lissandra,Kassadin,23,5,18,21.74
Lissandra,Hecarim,28,20,8,71.43
Lissandra,Twitch,44,18,26,40.91
Lissandra,Lucian,59,34,25,57.63
Lissandra,Shen,51,31,20,60.78
Lissandra,Ambessa,30,20,10,66.67
Lissandra,Swain,61,14,47,22.95
Lissandra,Draven,38,21,17,55.26
Lissandra,Taric,19,6,13,31.58
Lissandra,Vi,58,22,36,37.93
Lissandra,Kalista,35,10,25,28.57
Lissandra,KogMaw,28,21,7,75
Lissandra,Urgot,21,13,8,61.9
Lissandra,Bard,17,8,9,47.06
Lissandra,Olaf,25,16,9,64
Lissandra,Orianna,33,10,23,30.3
Lissandra,Rumble,20,13,7,65
Lissandra,Camille,28,14,14,50
Lissandra,Ryze,19,11,8,57.89
Lissandra,Ekko,56,25,31,44.64
Lissandra,Kled,15,6,9,40
Lissandra,RekSai,21,8,13,38.1
Lissandra,Sona,13,9,4,69.23
Lissandra,Ivern,5,5,0,100
Lissandra,Maokai,39,17,22,43.59
Lissandra,Kennen,23,11,12,47.83
Lulu,Sett,373,182,191,48.79
Lulu,Kayn,339,171,168,50.44
Lulu,Katarina,210,128,82,60.95
Lulu,Jinx,660,325,335,49.24
Lulu,Renata,66,42,24,63.64
Lulu,Akali,276,137,139,49.64
Lulu,LeeSin,514,252,262,49.03
Lulu,Yasuo,479,250,229,52.19
Lulu,Hwei,187,95,92,50.8
Lulu,Pyke,220,128,92,58.18
Lulu,Quinn,102,44,58,43.14
Lulu,Sejuani,204,108,96,52.94
Lulu,Leblanc,198,132,66,66.67
Lulu,Twitch,208,120,88,57.69
Lulu,Nautilus,340,178,162,52.35
Lulu,Trundle,116,75,41,64.66
Lulu,Sylas,391,201,190,51.41
Lulu,Zac,189,79,110,41.8
Lulu,MissFortune,508,252,256,49.61
Lulu,Seraphine,234,97,137,41.45
Lulu,Shaco,216,121,95,56.02
Lulu,Zoe,150,69,81,46
Lulu,KogMaw,82,45,37,54.88
Lulu,TwistedFate,85,35,50,41.18
Lulu,Chogath,384,169,215,44.01
Lulu,Nocturne,389,178,211,45.76
Lulu,Orianna,165,92,73,55.76
Lulu,Caitlyn,646,302,344,46.75
Lulu,Neeko,107,64,43,59.81
Lulu,Tryndamere,93,52,41,55.91
Lulu,Morgana,277,131,146,47.29
Lulu,Volibear,291,149,142,51.2
Lulu,MasterYi,235,137,98,58.3
Lulu,Mel,610,342,268,56.07
Lulu,Ezreal,792,439,353,55.43
Lulu,Blitzcrank,267,141,126,52.81
Lulu,Teemo,211,87,124,41.23
Lulu,Khazix,133,75,58,56.39
Lulu,Poppy,179,88,91,49.16
Lulu,Shen,214,121,93,56.54
Lulu,Heimerdinger,102,50,52,49.02
Lulu,Thresh,516,258,258,50
Lulu,Kayle,165,71,94,43.03
Lulu,Viego,308,179,129,58.12
Lulu,Jhin,527,257,270,48.77
Lulu,Braum,196,91,105,46.43
Lulu,Darius,487,224,263,46
Lulu,XinZhao,207,89,118,43
Lulu,Garen,384,186,198,48.44
Lulu,Diana,381,194,187,50.92
Lulu,Brand,133,68,65,51.13
Lulu,Belveth,49,20,29,40.82
Lulu,Malzahar,268,128,140,47.76
Lulu,Varus,298,135,163,45.3
Lulu,Lux,642,321,321,50
Lulu,Yone,516,276,240,53.49
Lulu,Gragas,216,101,115,46.76
Lulu,Ekko,247,120,127,48.58
Lulu,Azir,118,67,51,56.78
Lulu,Nami,427,186,241,43.56
Lulu,Warwick,335,154,181,45.97
Lulu,Kaisa,506,258,248,50.99
Lulu,Gangplank,135,88,47,65.19
Lulu,Anivia,90,52,38,57.78
Lulu,Talon,130,57,73,43.85
Lulu,Vladimir,159,62,97,38.99
Lulu,Swain,228,104,124,45.61
Lulu,Ornn,154,68,86,44.16
Lulu,Tristana,242,124,118,51.24
Lulu,Fizz,142,82,60,57.75
Lulu,Aphelios,190,86,104,45.26
Lulu,Soraka,194,119,75,61.34
Lulu,Illaoi,117,64,53,54.7
Lulu,Rakan,148,86,62,58.11
Lulu,Mordekaiser,295,164,131,55.59
Lulu,Ryze,124,51,73,41.13
Lulu,Jax,260,151,109,58.08
Lulu,Janna,93,48,45,51.61
Lulu,Galio,330,184,146,55.76
Lulu,KSante,190,78,112,41.05
Lulu,Irelia,233,119,114,51.07
Lulu,Rell,192,92,100,47.92
Lulu,Aatrox,279,141,138,50.54
Lulu,Briar,134,74,60,55.22
Lulu,Ahri,391,190,201,48.59
Lulu,Elise,274,138,136,50.36
Lulu,Kindred,82,44,38,53.66
Lulu,Sona,44,24,20,54.55
Lulu,Ashe,566,270,296,47.7
Lulu,Pantheon,540,310,230,57.41
Lulu,Zed,311,163,148,52.41
Lulu,Vi,328,174,154,53.05
Lulu,Lucian,276,119,157,43.12
Lulu,Xayah,124,54,70,43.55
Lulu,Viktor,284,146,138,51.41
Lulu,Malphite,276,127,149,46.01
Lulu,Karma,435,194,241,44.6
Lulu,JarvanIV,218,118,100,54.13
Lulu,Vex,108,46,62,42.59
Lulu,Jayce,136,76,60,55.88
Lulu,Nilah,83,55,28,66.27
Lulu,Amumu,275,128,147,46.55
Lulu,AurelionSol,86,37,49,43.02
Lulu,Leona,253,127,126,50.2
Lulu,Renekton,155,89,66,57.42
Lulu,Corki,133,86,47,64.66
Lulu,Urgot,82,44,38,53.66
Lulu,Draven,130,61,69,46.92
Lulu,Nidalee,95,48,47,50.53
Lulu,Veigar,252,113,139,44.84
Lulu,Qiyana,56,25,31,44.64
Lulu,TahmKench,257,115,142,44.75
Lulu,Riven,85,39,46,45.88
Lulu,Milio,271,122,149,45.02
Lulu,Rumble,120,76,44,63.33
Lulu,Zilean,95,40,55,42.11
Lulu,Syndra,223,108,115,48.43
Lulu,Taliyah,83,47,36,56.63
Lulu,Ambessa,213,103,110,48.36
Lulu,DrMundo,166,84,82,50.6
Lulu,Senna,198,104,94,52.53
Lulu,Sion,231,106,125,45.89
Lulu,FiddleSticks,109,39,70,35.78
Lulu,Yuumi,270,134,136,49.63
Lulu,MonkeyKing,208,82,126,39.42
Lulu,Smolder,207,119,88,57.49
Lulu,Kassadin,43,21,22,48.84
Lulu,Hecarim,141,88,53,62.41
Lulu,Graves,190,82,108,43.16
Lulu,Lillia,145,71,74,48.97
Lulu,Rammus,104,52,52,50
Lulu,Zyra,197,88,109,44.67
Lulu,Xerath,204,98,106,48.04
Lulu,Gwen,130,59,71,45.38
Lulu,Sivir,153,85,68,55.56
Lulu,Gnar,142,82,60,57.75
Lulu,Velkoz,164,80,84,48.78
Lulu,Lissandra,96,47,49,48.96
Lulu,Camille,165,89,76,53.94
Lulu,Vayne,270,145,125,53.7
Lulu,Ivern,102,45,57,44.12
Lulu,Aurora,227,97,130,42.73
Lulu,Samira,167,77,90,46.11
Lulu,Nasus,114,73,41,64.04
Lulu,Kled,70,32,38,45.71
Lulu,RekSai,39,25,14,64.1
Lulu,Singed,75,36,39,48
Lulu,Rengar,89,34,55,38.2
Lulu,Bard,69,18,51,26.09
Lulu,Udyr,108,47,61,43.52
Lulu,Ziggs,65,34,31,52.31
Lulu,Shyvana,65,32,33,49.23
Lulu,Nunu,161,77,84,47.83
Lulu,Kennen,99,39,60,39.39
Lulu,Kalista,79,48,31,60.76
Lulu,Naafiri,77,29,48,37.66
Lulu,Yorick,191,81,110,42.41
Lulu,Karthus,61,31,30,50.82
Lulu,Alistar,151,73,78,48.34
Lulu,Cassiopeia,83,25,58,30.12
Lulu,Zeri,154,69,85,44.81
Lulu,Skarner,138,45,93,32.61
Lulu,Maokai,153,73,80,47.71
Lulu,Fiora,117,58,59,49.57
Lulu,Taric,57,27,30,47.37
Lulu,Evelynn,67,42,25,62.69
Lulu,Akshan,89,41,48,46.07
Lulu,Olaf,72,42,30,58.33
Lulu,Annie,71,39,32,54.93
Sett,Malphite,346,177,169,51.16
Sett,Jax,258,130,128,50.39
Sett,Lissandra,139,74,65,53.24
Sett,MissFortune,662,349,313,52.72
Sett,Lulu,373,191,182,51.21
Sett,Warwick,421,209,212,49.64
Sett,Udyr,111,59,52,53.15
Sett,Mel,610,286,324,46.89
Sett,Sivir,152,75,77,49.34
Sett,Karma,302,133,169,44.04
Sett,Shen,230,124,106,53.91
Sett,Vi,310,157,153,50.65
Sett,Swain,314,133,181,42.36
Sett,Nilah,109,41,68,37.61
Sett,Nami,233,125,108,53.65
Sett,Aatrox,269,153,116,56.88
Sett,JarvanIV,208,98,110,47.12
Sett,Chogath,433,229,204,52.89
Sett,Yuumi,237,136,101,57.38
Sett,Nocturne,272,140,132,51.47
Sett,Orianna,125,67,58,53.6
Sett,Caitlyn,675,330,345,48.89
Sett,Neeko,162,81,81,50
Sett,TahmKench,300,166,134,55.33
Sett,LeeSin,523,301,222,57.55
Sett,Twitch,202,107,95,52.97
Sett,Morgana,325,137,188,42.15
Sett,Garen,509,250,259,49.12
Sett,Diana,421,223,198,52.97
Sett,Yasuo,618,305,313,49.35
Sett,Ezreal,696,339,357,48.71
Sett,Brand,134,76,58,56.72
Sett,Camille,112,47,65,41.96
Sett,Kindred,143,94,49,65.73
Sett,Zed,304,146,158,48.03
Sett,Jinx,712,349,363,49.02
Sett,Gragas,203,113,90,55.67
Sett,Graves,203,86,117,42.36
Sett,Qiyana,79,57,22,72.15
Sett,Kalista,97,55,42,56.7
Sett,Poppy,197,97,100,49.24
Sett,Khazix,119,67,52,56.3
Sett,Yone,600,318,282,53
Sett,Viktor,268,118,150,44.03
Sett,Talon,142,89,53,62.68
Sett,Gangplank,137,89,48,64.96
Sett,Anivia,89,43,46,48.31
Sett,Jhin,564,274,290,48.58
Sett,Thresh,481,219,262,45.53
Sett,Renekton,201,114,87,56.72
Sett,Elise,260,151,109,58.08
Sett,Kaisa,409,203,206,49.63
Sett,Milio,150,64,86,42.67
Sett,Mordekaiser,411,229,182,55.72
Sett,Darius,650,332,318,51.08
Sett,Teemo,229,103,126,44.98
Sett,Blitzcrank,337,155,182,45.99
Sett,Trundle,175,85,90,48.57
Sett,RekSai,31,26,5,83.87
Sett,Leblanc,168,72,96,42.86
Sett,Jayce,112,58,54,51.79
Sett,Ekko,232,122,110,52.59
Sett,Samira,268,132,136,49.25
Sett,Leona,311,173,138,55.63
Sett,Akali,375,207,168,55.2
Sett,Nautilus,386,213,173,55.18
Sett,Katarina,177,87,90,49.15
Sett,Gnar,152,70,82,46.05
Sett,Lucian,230,134,96,58.26
Sett,Singed,42,24,18,57.14
Sett,Urgot,151,68,83,45.03
Sett,MonkeyKing,183,79,104,43.17
Sett,Zac,186,109,77,58.6
Sett,Pantheon,501,254,247,50.7
Sett,Rammus,102,50,52,49.02
Sett,Irelia,199,120,79,60.3
Sett,Nidalee,98,52,46,53.06
Sett,Vladimir,166,93,73,56.02
Sett,Nasus,157,95,62,60.51
Sett,Heimerdinger,127,63,64,49.61
Sett,Ashe,561,297,264,52.94
Sett,Taliyah,64,27,37,42.19
Sett,Syndra,169,97,72,57.4
Sett,Illaoi,158,82,76,51.9
Sett,MasterYi,253,142,111,56.13
Sett,Ziggs,123,73,50,59.35
Sett,Sona,63,47,16,74.6
Sett,Ornn,149,88,61,59.06
Sett,Hwei,181,86,95,47.51
Sett,Viego,387,210,177,54.26
Sett,Veigar,288,148,140,51.39
Sett,Shaco,219,111,108,50.68
Sett,Malzahar,292,133,159,45.55
Sett,Evelynn,89,43,46,48.31
Sett,Seraphine,210,120,90,57.14
Sett,Rell,160,81,79,50.63
Sett,Corki,124,76,48,61.29
Sett,Lux,622,355,267,57.07
Sett,Soraka,145,65,80,44.83
Sett,Xayah,146,89,57,60.96
Sett,Renata,33,15,18,45.45
Sett,Nunu,200,113,87,56.5
Sett,Tristana,255,153,102,60
Sett,Lillia,166,61,105,36.75
Sett,Ahri,362,170,192,46.96
Sett,Draven,135,78,57,57.78
Sett,DrMundo,163,94,69,57.67
Sett,Senna,155,89,66,57.42
Sett,Quinn,68,38,30,55.88
Sett,Kayle,146,71,75,48.63
Sett,Alistar,160,70,90,43.75
Sett,Kayn,422,200,222,47.39
Sett,Velkoz,131,57,74,43.51
Sett,Galio,364,170,194,46.7
Sett,Volibear,320,181,139,56.56
Sett,Zyra,224,113,111,50.45
Sett,Naafiri,78,41,37,52.56
Sett,Vex,154,78,76,50.65
Sett,Azir,158,74,84,46.84
Sett,Fiora,89,50,39,56.18
Sett,FiddleSticks,112,50,62,44.64
Sett,Gwen,142,79,63,55.63
Sett,Belveth,57,29,28,50.88
Sett,Aphelios,149,72,77,48.32
Sett,Fizz,132,63,69,47.73
Sett,Cassiopeia,69,28,41,40.58
Sett,Taric,48,15,33,31.25
Sett,Varus,297,155,142,52.19
Sett,Bard,92,37,55,40.22
Sett,Shyvana,77,28,49,36.36
Sett,Sion,329,181,148,55.02
Sett,Ambessa,259,126,133,48.65
Sett,Sylas,460,251,209,54.57
Sett,Rumble,62,35,27,56.45
Sett,Smolder,224,114,110,50.89
Sett,Zeri,128,71,57,55.47
Sett,Olaf,78,41,37,52.56
Sett,Amumu,292,139,153,47.6
Sett,Aurora,210,114,96,54.29
Sett,Skarner,141,70,71,49.65
Sett,Braum,242,140,102,57.85
Sett,XinZhao,180,82,98,45.56
Sett,Briar,171,77,94,45.03
Sett,Vayne,343,179,164,52.19
Sett,Sejuani,202,97,105,48.02
Sett,AurelionSol,116,55,61,47.41
Sett,Karthus,81,39,42,48.15
Sett,Zoe,129,64,65,49.61
Sett,KSante,204,102,102,50
Sett,Kled,60,28,32,46.67
Sett,Rakan,142,75,67,52.82
Sett,Rengar,71,45,26,63.38
Sett,Janna,83,56,27,67.47
Sett,Pyke,286,164,122,57.34
Sett,Ryze,78,30,48,38.46
Sett,Akshan,88,37,51,42.05
Sett,KogMaw,88,41,47,46.59
Sett,Riven,120,58,62,48.33
Sett,TwistedFate,110,46,64,41.82
Sett,Yorick,237,116,121,48.95
Sett,Annie,66,37,29,56.06
Sett,Hecarim,89,50,39,56.18
Sett,Xerath,254,127,127,50
Sett,Tryndamere,74,48,26,64.86
Sett,Zilean,72,45,27,62.5
Sett,Maokai,126,55,71,43.65
Sett,Kennen,74,28,46,37.84
Sett,Kassadin,35,17,18,48.57
Sett,Ivern,45,29,16,64.44
Katarina,Malphite,115,43,72,37.39
Katarina,Jax,119,62,57,52.1
Katarina,Lissandra,40,20,20,50
Katarina,MissFortune,274,113,161,41.24
Katarina,Lulu,210,82,128,39.05
Katarina,Chogath,203,88,115,43.35
Katarina,Lillia,70,33,37,47.14
Katarina,Tryndamere,62,34,28,54.84
Katarina,Caitlyn,287,139,148,48.43
Katarina,Karma,108,53,55,49.07
Katarina,Udyr,57,26,31,45.61
Katarina,Yone,218,90,128,41.28
Katarina,Smolder,90,55,35,61.11
Katarina,TahmKench,130,69,61,53.08
Katarina,Teemo,132,69,63,52.27
Katarina,Warwick,168,71,97,42.26
Katarina,Nunu,83,31,52,37.35
Katarina,Lucian,93,57,36,61.29
Katarina,Leona,103,52,51,50.49
Katarina,Fiora,59,30,29,50.85
Katarina,Singed,33,6,27,18.18
Katarina,Yasuo,237,121,116,51.05
Katarina,Milio,96,44,52,45.83
Katarina,Graves,67,36,31,53.73
Katarina,Kassadin,31,18,13,58.06
Katarina,Tristana,132,76,56,57.58
Katarina,Nami,204,107,97,52.45
Katarina,Jayce,62,30,32,48.39
Katarina,Elise,93,39,54,41.94
Katarina,Lux,304,169,135,55.59
Katarina,Yorick,94,18,76,19.15
Katarina,Zilean,44,15,29,34.09
Katarina,Volibear,134,58,76,43.28
Katarina,Hwei,99,42,57,42.42
Katarina,Vi,153,59,94,38.56
Katarina,Xerath,121,64,57,52.89
Katarina,Braum,75,40,35,53.33
Katarina,Darius,204,100,104,49.02
Katarina,Kayn,170,90,80,52.94
Katarina,Veigar,180,91,89,50.56
Katarina,Varus,95,42,53,44.21
Katarina,Pyke,136,63,73,46.32
Katarina,Shen,79,28,51,35.44
Katarina,Karthus,45,19,26,42.22
Katarina,Ekko,120,50,70,41.67
Katarina,Ezreal,293,137,156,46.76
Katarina,Soraka,45,30,15,66.67
Katarina,Briar,75,31,44,41.33
Katarina,Zed,122,61,61,50
Katarina,Seraphine,70,20,50,28.57
Katarina,Camille,33,11,22,33.33
Katarina,Draven,71,31,40,43.66
Katarina,Senna,68,30,38,44.12
Katarina,Trundle,43,21,22,48.84
Katarina,Mel,237,114,123,48.1
Katarina,Jinx,293,134,159,45.73
Katarina,Morgana,165,80,85,48.48
Katarina,Sion,86,48,38,55.81
Katarina,Rengar,24,11,13,45.83
Katarina,Ashe,222,119,103,53.6
Katarina,Ambessa,107,44,63,41.12
Katarina,Gwen,56,31,25,55.36
Katarina,Vladimir,68,33,35,48.53
Katarina,Twitch,100,42,58,42
Katarina,JarvanIV,86,37,49,43.02
Katarina,Viktor,134,58,76,43.28
Katarina,Kaisa,190,97,93,51.05
Katarina,Sejuani,80,42,38,52.5
Katarina,Blitzcrank,123,49,74,39.84
Katarina,Nasus,72,40,32,55.56
Katarina,Galio,170,91,79,53.53
Katarina,Kayle,78,33,45,42.31
Katarina,Sett,177,90,87,50.85
Katarina,Mordekaiser,155,77,78,49.68
Katarina,Akali,124,47,77,37.9
Katarina,Xayah,53,21,32,39.62
Katarina,Zyra,82,37,45,45.12
Katarina,Gnar,70,38,32,54.29
Katarina,Thresh,215,130,85,60.47
Katarina,LeeSin,239,99,140,41.42
Katarina,RekSai,17,8,9,47.06
Katarina,Bard,46,20,26,43.48
Katarina,Pantheon,200,105,95,52.5
Katarina,Kennen,47,17,30,36.17
Katarina,Illaoi,57,27,30,47.37
Katarina,Malzahar,120,56,64,46.67
Katarina,Vayne,155,74,81,47.74
Katarina,Maokai,69,34,35,49.28
Katarina,Zeri,53,30,23,56.6
Katarina,Khazix,84,33,51,39.29
Katarina,Ahri,217,105,112,48.39
Katarina,Yuumi,123,74,49,60.16
Katarina,Viego,161,74,87,45.96
Katarina,Vex,69,25,44,36.23
Katarina,Jhin,233,88,145,37.77
Katarina,Sylas,190,90,100,47.37
Katarina,Urgot,72,24,48,33.33
Katarina,Quinn,39,18,21,46.15
Katarina,MasterYi,137,87,50,63.5
Katarina,Garen,219,84,135,38.36
Katarina,DrMundo,77,38,39,49.35
Katarina,Fizz,51,17,34,33.33
Katarina,Aurora,89,44,45,49.44
Katarina,Gragas,106,75,31,70.75
Katarina,FiddleSticks,40,16,24,40
Katarina,XinZhao,76,31,45,40.79
Katarina,Corki,47,29,18,61.7
Katarina,Nilah,54,18,36,33.33
Katarina,Rumble,46,32,14,69.57
Katarina,Rakan,59,23,36,38.98
Katarina,Gangplank,60,30,30,50
Katarina,Poppy,91,31,60,34.07
Katarina,Aphelios,86,35,51,40.7
Katarina,KSante,87,47,40,54.02
Katarina,Hecarim,39,16,23,41.03
Katarina,Leblanc,69,29,40,42.03
Katarina,Aatrox,121,58,63,47.93
Katarina,Nautilus,126,61,65,48.41
Katarina,AurelionSol,61,35,26,57.38
Katarina,Samira,109,39,70,35.78
Katarina,Amumu,153,71,82,46.41
Katarina,Diana,154,95,59,61.69
Katarina,Akshan,50,25,25,50
Katarina,Evelynn,23,12,11,52.17
Katarina,Kalista,57,38,19,66.67
Katarina,Azir,49,27,22,55.1
Katarina,TwistedFate,51,28,23,54.9
Katarina,Velkoz,57,20,37,35.09
Katarina,KogMaw,49,20,29,40.82
Katarina,Brand,86,39,47,45.35
Katarina,Ornn,108,51,57,47.22
Katarina,Heimerdinger,56,32,24,57.14
Katarina,Syndra,101,60,41,59.41
Katarina,Talon,67,48,19,71.64
Katarina,Olaf,26,17,9,65.38
Katarina,Taliyah,24,13,11,54.17
Katarina,Swain,103,42,61,40.78
Katarina,Qiyana,34,13,21,38.24
Katarina,Rell,91,35,56,38.46
Katarina,Ziggs,54,23,31,42.59
Katarina,Ivern,26,15,11,57.69
Katarina,Riven,67,30,37,44.78
Katarina,Sivir,50,39,11,78
Katarina,Irelia,89,55,34,61.8
Katarina,Ryze,33,14,19,42.42
Katarina,Taric,48,25,23,52.08
Katarina,Janna,30,10,20,33.33
Katarina,MonkeyKing,56,27,29,48.21
Katarina,Zac,103,46,57,44.66
Katarina,Renekton,77,42,35,54.55
Katarina,Kindred,57,18,39,31.58
Katarina,Renata,44,8,36,18.18
Katarina,Orianna,52,28,24,53.85
Katarina,Shaco,83,45,38,54.22
Katarina,Zoe,37,20,17,54.05
Katarina,Alistar,62,23,39,37.1
Katarina,Skarner,45,23,22,51.11
Katarina,Nocturne,129,68,61,52.71
Katarina,Cassiopeia,31,10,21,32.26
Katarina,Sona,17,11,6,64.71
Katarina,Neeko,53,17,36,32.08
Katarina,Nidalee,37,20,17,54.05
Katarina,Rammus,26,13,13,50
Katarina,Annie,16,8,8,50
Katarina,Belveth,21,5,16,23.81
Katarina,Anivia,33,16,17,48.48
Katarina,Naafiri,32,14,18,43.75
Katarina,Kled,17,8,9,47.06
Katarina,Shyvana,14,5,9,35.71
Jinx,Malphite,529,284,245,53.69
Jinx,Jax,456,272,184,59.65
Jinx,Lissandra,166,123,43,74.1
Jinx,MissFortune,1204,647,557,53.74
Jinx,Lulu,660,335,325,50.76
Jinx,Sion,401,214,187,53.37
Jinx,Nocturne,558,270,288,48.39
Jinx,Hwei,311,174,137,55.95
Jinx,Jhin,956,506,450,52.93
Jinx,Soraka,244,156,88,63.93
Jinx,Akali,500,259,241,51.8
Jinx,LeeSin,821,456,365,55.54
Jinx,Yasuo,877,448,429,51.08
Jinx,Pyke,427,205,222,48.01
Jinx,Yone,787,426,361,54.13
Jinx,JarvanIV,403,224,179,55.58
Jinx,Ryze,180,96,84,53.33
Jinx,Draven,253,143,110,56.52
Jinx,Blitzcrank,415,224,191,53.98
Jinx,Malzahar,539,295,244,54.73
Jinx,Kayn,697,387,310,55.52
Jinx,Ahri,686,380,306,55.39
Jinx,Amumu,615,308,307,50.08
Jinx,Olaf,132,70,62,53.03
Jinx,Viego,647,367,280,56.72
Jinx,Vi,552,271,281,49.09
Jinx,Azir,201,101,100,50.25
Jinx,TahmKench,382,165,217,43.19
Jinx,Orianna,303,154,149,50.83
Jinx,Twitch,419,205,214,48.93
Jinx,Morgana,533,265,268,49.72
Jinx,KSante,301,199,102,66.11
Jinx,Nunu,323,180,143,55.73
Jinx,Akshan,157,89,68,56.69
Jinx,Ziggs,213,119,94,55.87
Jinx,Seraphine,350,181,169,51.71
Jinx,Sett,712,363,349,50.98
Jinx,Darius,876,480,396,54.79
Jinx,Leblanc,273,174,99,63.74
Jinx,Lux,1120,617,503,55.09
Jinx,Mordekaiser,586,334,252,57
Jinx,Khazix,226,124,102,54.87
Jinx,Katarina,293,159,134,54.27
Jinx,Ezreal,1273,719,554,56.48
Jinx,Shen,397,216,181,54.41
Jinx,Shaco,398,223,175,56.03
Jinx,AurelionSol,227,123,104,54.19
Jinx,Caitlyn,1605,871,734,54.27
Jinx,Brand,312,202,110,64.74
Jinx,Mel,907,497,410,54.8
Jinx,Galio,522,267,255,51.15
Jinx,Illaoi,198,113,85,57.07
Jinx,Senna,308,176,132,57.14
Jinx,Irelia,365,214,151,58.63
Jinx,Garen,742,385,357,51.89
Jinx,Viktor,500,273,227,54.6
Jinx,Talon,249,131,118,52.61
Jinx,Sivir,266,131,135,49.25
Jinx,Lucian,413,238,175,57.63
Jinx,Leona,490,295,195,60.2
Jinx,Vayne,576,299,277,51.91
Jinx,Ivern,148,85,63,57.43
Jinx,Qiyana,122,60,62,49.18
Jinx,Rengar,160,87,73,54.38
Jinx,Ashe,1157,634,523,54.8
Jinx,Yorick,321,151,170,47.04
Jinx,Graves,298,150,148,50.34
Jinx,Naafiri,172,92,80,53.49
Jinx,Jayce,277,139,138,50.18
Jinx,Singed,142,77,65,54.23
Jinx,Veigar,515,267,248,51.84
Jinx,Warwick,667,348,319,52.17
Jinx,Karma,508,260,248,51.18
Jinx,Samira,378,183,195,48.41
Jinx,MasterYi,454,240,214,52.86
Jinx,Zed,442,254,188,57.47
Jinx,Nilah,167,77,90,46.11
Jinx,Ornn,289,155,134,53.63
Jinx,Pantheon,817,461,356,56.43
Jinx,Annie,170,88,82,51.76
Jinx,Nautilus,680,400,280,58.82
Jinx,FiddleSticks,197,102,95,51.78
Jinx,Rell,330,183,147,55.45
Jinx,Diana,647,363,284,56.11
Jinx,Tristana,494,276,218,55.87
Jinx,XinZhao,323,183,140,56.66
Jinx,Hecarim,193,123,70,63.73
Jinx,Aurora,478,252,226,52.72
Jinx,Gnar,308,185,123,60.06
Jinx,Lillia,271,161,110,59.41
Jinx,Thresh,813,461,352,56.7
Jinx,Chogath,718,313,405,43.59
Jinx,Kaisa,867,463,404,53.4
Jinx,DrMundo,256,134,122,52.34
Jinx,Zeri,254,147,107,57.87
Jinx,Velkoz,242,113,129,46.69
Jinx,Vex,281,148,133,52.67
Jinx,Aatrox,425,248,177,58.35
Jinx,Belveth,117,65,52,55.56
Jinx,Neeko,206,93,113,45.15
Jinx,Swain,496,249,247,50.2
Jinx,Syndra,343,175,168,51.02
Jinx,Sylas,758,421,337,55.54
Jinx,Zoe,209,128,81,61.24
Jinx,Ekko,473,239,234,50.53
Jinx,Milio,323,174,149,53.87
Jinx,Gangplank,204,134,70,65.69
Jinx,Teemo,450,234,216,52
Jinx,Renata,99,58,41,58.59
Jinx,Kled,79,51,28,64.56
Jinx,Briar,280,149,131,53.21
Jinx,TwistedFate,166,99,67,59.64
Jinx,Alistar,300,163,137,54.33
Jinx,Nami,548,265,283,48.36
Jinx,Skarner,258,144,114,55.81
Jinx,Varus,547,292,255,53.38
Jinx,Renekton,246,121,125,49.19
Jinx,Xerath,400,209,191,52.25
Jinx,Vladimir,288,152,136,52.78
Jinx,Kalista,167,88,79,52.69
Jinx,Camille,183,98,85,53.55
Jinx,Xayah,310,200,110,64.52
Jinx,Gwen,266,124,142,46.62
Jinx,Urgot,221,160,61,72.4
Jinx,Ambessa,384,203,181,52.86
Jinx,Fizz,248,156,92,62.9
Jinx,Heimerdinger,232,153,79,65.95
Jinx,Kindred,225,135,90,60
Jinx,Yuumi,390,188,202,48.21
Jinx,Zac,280,152,128,54.29
Jinx,Gragas,410,236,174,57.56
Jinx,Corki,230,126,104,54.78
Jinx,Janna,166,86,80,51.81
Jinx,Aphelios,372,191,181,51.34
Jinx,Braum,396,208,188,52.53
Jinx,Sejuani,314,161,153,51.27
Jinx,Udyr,165,99,66,60
Jinx,Zyra,381,189,192,49.61
Jinx,KogMaw,186,95,91,51.08
Jinx,Volibear,510,243,267,47.65
Jinx,Cassiopeia,117,55,62,47.01
Jinx,Trundle,284,159,125,55.99
Jinx,MonkeyKing,322,170,152,52.8
Jinx,Elise,389,230,159,59.13
Jinx,Tryndamere,193,117,76,60.62
Jinx,Poppy,324,160,164,49.38
Jinx,Kayle,228,138,90,60.53
Jinx,Taric,146,79,67,54.11
Jinx,Anivia,172,82,90,47.67
Jinx,Bard,158,92,66,58.23
Jinx,Evelynn,114,60,54,52.63
Jinx,Rammus,159,90,69,56.6
Jinx,Nasus,359,164,195,45.68
Jinx,Kennen,131,66,65,50.38
Jinx,Smolder,357,197,160,55.18
Jinx,Riven,219,111,108,50.68
Jinx,Fiora,207,102,105,49.28
Jinx,Karthus,134,84,50,62.69
Jinx,Zilean,163,82,81,50.31
Jinx,Sona,120,65,55,54.17
Jinx,Rakan,280,165,115,58.93
Jinx,Shyvana,135,59,76,43.7
Jinx,Taliyah,124,74,50,59.68
Jinx,Rumble,143,78,65,54.55
Jinx,Quinn,208,118,90,56.73
Jinx,Maokai,263,146,117,55.51
Jinx,RekSai,52,25,27,48.08
Jinx,Kassadin,86,52,34,60.47
Jinx,Nidalee,189,104,85,55.03
Renata,Malphite,55,24,31,43.64
Renata,Jax,40,21,19,52.5
Renata,Lissandra,8,3,5,37.5
Renata,MissFortune,106,53,53,50
Renata,Lulu,66,24,42,36.36
Renata,Maokai,17,14,3,82.35
Renata,Viego,62,32,30,51.61
Renata,Viktor,51,29,22,56.86
Renata,Smolder,46,25,21,54.35
Renata,Nami,72,31,41,43.06
Renata,Olaf,12,12,0,100
Renata,Kayn,53,29,24,54.72
Renata,Yasuo,94,46,48,48.94
Renata,Galio,55,32,23,58.18
Renata,Velkoz,23,9,14,39.13
Renata,Naafiri,24,16,8,66.67
Renata,Warwick,49,24,25,48.98
Renata,Mel,79,38,41,48.1
Renata,Ashe,108,68,40,62.96
Renata,Janna,6,3,3,50
Renata,Kled,17,6,11,35.29
Renata,MasterYi,58,24,34,41.38
Renata,Vladimir,33,8,25,24.24
Renata,Jhin,99,52,47,52.53
Renata,Pyke,32,16,16,50
Renata,Gwen,20,7,13,35
Renata,Nocturne,54,32,22,59.26
Renata,Aurora,36,12,24,33.33
Renata,Caitlyn,107,59,48,55.14
Renata,Morgana,41,13,28,31.71
Renata,Garen,81,44,37,54.32
Renata,Amumu,61,29,32,47.54
Renata,Kennen,13,13,0,100
Renata,Ezreal,108,64,44,59.26
Renata,Braum,44,34,10,77.27
Renata,Darius,93,48,45,51.61
Renata,Karthus,8,5,3,62.5
Renata,Irelia,59,23,36,38.98
Renata,Jinx,99,41,58,41.41
Renata,Gragas,29,15,14,51.72
Renata,Zed,54,35,19,64.81
Renata,Rakan,36,19,17,52.78
Renata,Twitch,32,10,22,31.25
Renata,Zac,20,13,7,65
Renata,Aatrox,47,21,26,44.68
Renata,Thresh,98,44,54,44.9
Renata,Sett,33,18,15,54.55
Renata,Chogath,52,29,23,55.77
Renata,Sona,15,12,3,80
Renata,Yorick,37,19,18,51.35
Renata,Rumble,18,8,10,44.44
Renata,Xayah,29,18,11,62.07
Renata,Kayle,21,17,4,80.95
Renata,Hwei,45,28,17,62.22
Renata,Heimerdinger,27,20,7,74.07
Renata,Ivern,18,9,9,50
Renata,Lux,96,50,46,52.08
Renata,TahmKench,37,14,23,37.84
Renata,Urgot,28,14,14,50
Renata,Tryndamere,19,4,15,21.05
Renata,LeeSin,98,49,49,50
Renata,Karma,51,27,24,52.94
Renata,Vi,55,26,29,47.27
Renata,Orianna,27,12,15,44.44
Renata,Kaisa,78,37,41,47.44
Renata,Riven,28,11,17,39.29
Renata,Senna,27,21,6,77.78
Renata,Ambessa,28,16,12,57.14
Renata,MonkeyKing,46,22,24,47.83
Renata,Sylas,64,26,38,40.63
Renata,Milio,33,14,19,42.42
Renata,Renekton,22,9,13,40.91
Renata,Kindred,25,12,13,48
Renata,Ahri,64,17,47,26.56
Renata,Draven,25,15,10,60
Renata,Shaco,26,8,18,30.77
Renata,Cassiopeia,13,6,7,46.15
Renata,Pantheon,79,40,39,50.63
Renata,Teemo,44,26,18,59.09
Renata,Graves,40,14,26,35
Renata,Malzahar,46,24,22,52.17
Renata,Katarina,44,36,8,81.82
Renata,Mordekaiser,59,26,33,44.07
Renata,JarvanIV,37,16,21,43.24
Renata,AurelionSol,15,6,9,40
Renata,Diana,65,26,39,40
Renata,Rengar,18,5,13,27.78
Renata,Ekko,18,12,6,66.67
Renata,KSante,41,20,21,48.78
Renata,Alistar,34,16,18,47.06
Renata,Volibear,51,26,25,50.98
Renata,Akali,40,17,23,42.5
Renata,Talon,21,12,9,57.14
Renata,Illaoi,20,12,8,60
Renata,Gnar,32,18,14,56.25
Renata,FiddleSticks,32,16,16,50
Renata,Yone,66,29,37,43.94
Renata,Trundle,26,14,12,53.85
Renata,Syndra,41,21,20,51.22
Renata,Leona,52,36,16,69.23
Renata,Kassadin,11,2,9,18.18
Renata,Nautilus,77,39,38,50.65
Renata,Xerath,23,16,7,69.57
Renata,Elise,43,24,19,55.81
Renata,Vayne,29,11,18,37.93
Renata,Lillia,40,15,25,37.5
Renata,Tristana,55,38,17,69.09
Renata,Nilah,28,14,14,50
Renata,Zyra,42,29,13,69.05
Renata,Skarner,26,14,12,53.85
Renata,DrMundo,26,21,5,80.77
Renata,Evelynn,19,11,8,57.89
Renata,Poppy,35,19,16,54.29
Renata,Jayce,27,8,19,29.63
Renata,Khazix,19,15,4,78.95
Renata,XinZhao,24,16,8,66.67
Renata,Annie,17,7,10,41.18
Renata,Sivir,23,9,14,39.13
Renata,Zilean,27,14,13,51.85
Renata,Brand,21,7,14,33.33
Renata,Kalista,25,14,11,56
Renata,Leblanc,26,17,9,65.38
Renata,Nunu,18,9,9,50
Renata,Sion,20,2,18,10
Renata,Varus,42,18,24,42.86
Renata,Samira,42,26,16,61.9
Renata,Ornn,35,12,23,34.29
Renata,Ziggs,12,3,9,25
Renata,Blitzcrank,43,29,14,67.44
Renata,Azir,25,7,18,28
Renata,Swain,58,30,28,51.72
Renata,Fizz,16,7,9,43.75
Renata,Aphelios,29,17,12,58.62
Renata,Qiyana,13,5,8,38.46
Renata,Soraka,15,3,12,20
Renata,Belveth,7,4,3,57.14
Renata,Taric,18,13,5,72.22
Renata,RekSai,7,2,5,28.57
Renata,Veigar,39,11,28,28.21
Renata,KogMaw,8,3,5,37.5
Renata,Nasus,28,14,14,50
Renata,Yuumi,16,3,13,18.75
Renata,Anivia,15,5,10,33.33
Renata,Vex,31,16,15,51.61
Renata,Neeko,32,10,22,31.25
Renata,Singed,8,8,0,100
Renata,Corki,17,2,15,11.76
Renata,Shen,33,22,11,66.67
Renata,Akshan,23,12,11,52.17
Renata,Lucian,45,16,29,35.56
Renata,Rammus,20,14,6,70
Renata,Gangplank,18,9,9,50
Renata,Rell,38,26,12,68.42
Renata,Zeri,7,4,3,57.14
Renata,Briar,15,5,10,33.33
Renata,TwistedFate,16,12,4,75
Renata,Shyvana,24,14,10,58.33
Renata,Sejuani,31,22,9,70.97
Renata,Seraphine,26,17,9,65.38
Renata,Nidalee,8,3,5,37.5
Renata,Udyr,23,17,6,73.91
Renata,Taliyah,10,5,5,50
Renata,Bard,5,3,2,60
Renata,Fiora,11,6,5,54.55
Renata,Ryze,13,5,8,38.46
Renata,Camille,22,5,17,22.73
Renata,Hecarim,12,7,5,58.33
Renata,Quinn,6,3,3,50
Renata,Zoe,11,8,3,72.73
Vladimir,Ambessa,69,28,41,40.58
Vladimir,Viktor,102,44,58,43.14
Vladimir,Graves,75,39,36,52
Vladimir,Caitlyn,270,145,125,53.7
Vladimir,Braum,93,45,48,48.39
Vladimir,Yone,239,112,127,46.86
Vladimir,FiddleSticks,77,36,41,46.75
Vladimir,Aurora,112,62,50,55.36
Vladimir,Vayne,176,83,93,47.16
Vladimir,Senna,52,26,26,50
Vladimir,Yorick,103,40,63,38.83
Vladimir,Viego,153,72,81,47.06
Vladimir,AurelionSol,39,17,22,43.59
Vladimir,Ashe,219,115,104,52.51
Vladimir,Milio,87,25,62,28.74
Vladimir,Diana,154,87,67,56.49
Vladimir,Gragas,87,46,41,52.87
Vladimir,Yasuo,290,154,136,53.1
Vladimir,Nami,106,49,57,46.23
Vladimir,Aatrox,117,65,52,55.56
Vladimir,MasterYi,137,86,51,62.77
Vladimir,Mel,263,163,100,61.98
Vladimir,Tristana,117,82,35,70.09
Vladimir,Sona,15,12,3,80
Vladimir,Darius,200,103,97,51.5
Vladimir,XinZhao,83,37,46,44.58
Vladimir,Malzahar,136,61,75,44.85
Vladimir,Rell,112,57,55,50.89
Vladimir,Heimerdinger,59,31,28,52.54
Vladimir,Briar,71,39,32,54.93
Vladimir,Irelia,95,36,59,37.89
Vladimir,Jhin,221,121,100,54.75
Vladimir,Leona,107,58,49,54.21
Vladimir,Shen,108,66,42,61.11
Vladimir,LeeSin,204,117,87,57.35
Vladimir,Orianna,98,44,54,44.9
Vladimir,Xayah,79,52,27,65.82
Vladimir,Rakan,71,18,53,25.35
Vladimir,Karthus,28,10,18,35.71
Vladimir,Naafiri,39,25,14,64.1
Vladimir,Lux,274,154,120,56.2
Vladimir,Gwen,62,43,19,69.35
Vladimir,Amumu,161,96,65,59.63
Vladimir,DrMundo,65,41,24,63.08
Vladimir,Lulu,159,97,62,61.01
Vladimir,Evelynn,35,14,21,40
Vladimir,Veigar,111,49,62,44.14
Vladimir,Warwick,141,93,48,65.96
Vladimir,Ornn,92,38,54,41.3
Vladimir,Katarina,68,35,33,51.47
Vladimir,Zac,77,42,35,54.55
Vladimir,Ryze,60,36,24,60
Vladimir,Jax,113,53,60,46.9
Vladimir,Janna,22,8,14,36.36
Vladimir,Zed,122,73,49,59.84
Vladimir,Varus,121,59,62,48.76
Vladimir,Soraka,36,20,16,55.56
Vladimir,Poppy,102,53,49,51.96
Vladimir,Ekko,106,55,51,51.89
Vladimir,Samira,95,42,53,44.21
Vladimir,Thresh,232,121,111,52.16
Vladimir,Volibear,114,46,68,40.35
Vladimir,Renekton,57,30,27,52.63
Vladimir,Elise,113,46,67,40.71
Vladimir,Ahri,165,76,89,46.06
Vladimir,Ezreal,273,153,120,56.04
Vladimir,Karma,147,86,61,58.5
Vladimir,Gnar,80,59,21,73.75
Vladimir,Fizz,46,34,12,73.91
Vladimir,Seraphine,73,50,23,68.49
Vladimir,Udyr,58,38,20,65.52
Vladimir,Syndra,64,46,18,71.88
Vladimir,Corki,74,39,35,52.7
Vladimir,Alistar,81,49,32,60.49
Vladimir,Nocturne,123,78,45,63.41
Vladimir,KogMaw,39,24,15,61.54
Vladimir,Morgana,125,74,51,59.2
Vladimir,Vi,137,62,75,45.26
Vladimir,Kennen,36,29,7,80.56
Vladimir,Renata,33,25,8,75.76
Vladimir,Garen,160,73,87,45.63
Vladimir,Shaco,77,45,32,58.44
Vladimir,Sett,166,73,93,43.98
Vladimir,Malphite,150,86,64,57.33
Vladimir,Azir,53,30,23,56.6
Vladimir,Mordekaiser,134,63,71,47.01
Vladimir,Brand,75,37,38,49.33
Vladimir,Lucian,78,29,49,37.18
Vladimir,Swain,139,66,73,47.48
Vladimir,Zyra,99,45,54,45.45
Vladimir,KSante,77,45,32,58.44
Vladimir,Skarner,46,26,20,56.52
Vladimir,Smolder,69,45,24,65.22
Vladimir,Gangplank,60,35,25,58.33
Vladimir,Xerath,90,35,55,38.89
Vladimir,Chogath,208,80,128,38.46
Vladimir,Jinx,288,136,152,47.22
Vladimir,Belveth,34,25,9,73.53
Vladimir,MissFortune,189,67,122,35.45
Vladimir,Nunu,84,35,49,41.67
Vladimir,Ivern,23,8,15,34.78
Vladimir,Kindred,43,22,21,51.16
Vladimir,Zeri,71,36,35,50.7
Vladimir,Yuumi,100,59,41,59
Vladimir,Akali,79,55,24,69.62
Vladimir,Singed,20,9,11,45
Vladimir,Akshan,44,16,28,36.36
Vladimir,Velkoz,68,33,35,48.53
Vladimir,Trundle,58,34,24,58.62
Vladimir,Rammus,38,9,29,23.68
Vladimir,Kaisa,181,106,75,58.56
Vladimir,Sylas,173,91,82,52.6
Vladimir,Nautilus,172,71,101,41.28
Vladimir,Pantheon,176,80,96,45.45
Vladimir,Hwei,64,34,30,53.13
Vladimir,Rumble,42,23,19,54.76
Vladimir,Twitch,87,47,40,54.02
Vladimir,Kayn,132,72,60,54.55
Vladimir,Kled,25,20,5,80
Vladimir,JarvanIV,68,37,31,54.41
Vladimir,Aphelios,83,38,45,45.78
Vladimir,Shyvana,26,9,17,34.62
Vladimir,Tryndamere,53,25,28,47.17
Vladimir,Teemo,140,80,60,57.14
Vladimir,Leblanc,61,28,33,45.9
Vladimir,MonkeyKing,77,43,34,55.84
Vladimir,Urgot,35,21,14,60
Vladimir,Kalista,36,23,13,63.89
Vladimir,Rengar,33,18,15,54.55
Vladimir,Nidalee,56,34,22,60.71
Vladimir,Nilah,37,16,21,43.24
Vladimir,Nasus,69,39,30,56.52
Vladimir,Lillia,57,27,30,47.37
Vladimir,Annie,34,11,23,32.35
Vladimir,Kayle,67,33,34,49.25
Vladimir,RekSai,19,11,8,57.89
Vladimir,Draven,70,40,30,57.14
Vladimir,Galio,120,55,65,45.83
Vladimir,Zoe,48,25,23,52.08
Vladimir,Sejuani,101,46,55,45.54
Vladimir,Talon,72,31,41,43.06
Vladimir,Ziggs,51,19,32,37.25
Vladimir,Blitzcrank,87,54,33,62.07
Vladimir,Neeko,32,24,8,75
Vladimir,Jayce,59,26,33,44.07
Vladimir,TahmKench,93,33,60,35.48
Vladimir,Taliyah,23,11,12,47.83
Vladimir,Pyke,77,38,39,49.35
Vladimir,Khazix,47,21,26,44.68
Vladimir,Sion,82,45,37,54.88
Vladimir,Hecarim,40,17,23,42.5
Vladimir,Maokai,48,22,26,45.83
Vladimir,Taric,23,11,12,47.83
Vladimir,Fiora,42,25,17,59.52
Vladimir,Cassiopeia,47,18,29,38.3
Vladimir,Illaoi,45,16,29,35.56
Vladimir,Lissandra,36,16,20,44.44
Vladimir,Bard,38,28,10,73.68
Vladimir,Qiyana,23,13,10,56.52
Vladimir,Sivir,77,35,42,45.45
Vladimir,Quinn,37,25,12,67.57
Vladimir,Zilean,51,20,31,39.22
Vladimir,Camille,65,40,25,61.54
Vladimir,Vex,59,25,34,42.37
Vladimir,Kassadin,20,10,10,50
Vladimir,Riven,54,21,33,38.89
Vladimir,Anivia,28,12,16,42.86
Vladimir,Olaf,10,6,4,60
Vladimir,TwistedFate,27,9,18,33.33
Velkoz,Ambessa,57,34,23,59.65
Velkoz,Viktor,116,52,64,44.83
Velkoz,Graves,83,39,44,46.99
Velkoz,Caitlyn,336,169,167,50.3
Velkoz,Braum,92,55,37,59.78
Velkoz,DrMundo,64,23,41,35.94
Velkoz,Rammus,44,26,18,59.09
Velkoz,Annie,52,31,21,59.62
Velkoz,Ezreal,247,136,111,55.06
Velkoz,Renata,23,14,9,60.87
Velkoz,Sion,109,53,56,48.62
Velkoz,Pantheon,170,82,88,48.24
Velkoz,Zoe,44,19,25,43.18
Velkoz,Ziggs,38,17,21,44.74
Velkoz,Veigar,148,83,65,56.08
Velkoz,Darius,205,92,113,44.88
Velkoz,Kindred,41,20,21,48.78
Velkoz,Tristana,120,70,50,58.33
Velkoz,Neeko,50,34,16,68
Velkoz,Teemo,107,58,49,54.21
Velkoz,Leblanc,67,43,24,64.18
Velkoz,Karma,117,53,64,45.3
Velkoz,Ornn,87,47,40,54.02
Velkoz,Warwick,186,75,111,40.32
Velkoz,Yasuo,202,114,88,56.44
Velkoz,Evelynn,24,8,16,33.33
Velkoz,Lux,308,170,138,55.19
Velkoz,Brand,74,48,26,64.86
Velkoz,Jax,104,55,49,52.88
Velkoz,LeeSin,214,124,90,57.94
Velkoz,Malzahar,127,53,74,41.73
Velkoz,Jinx,242,129,113,53.31
Velkoz,Elise,117,47,70,40.17
Velkoz,Riven,34,20,14,58.82
Velkoz,Ashe,166,84,82,50.6
Velkoz,Nautilus,130,57,73,43.85
Velkoz,Mordekaiser,132,63,69,47.73
Velkoz,Sejuani,66,20,46,30.3
Velkoz,Zilean,41,24,17,58.54
Velkoz,Diana,185,111,74,60
Velkoz,Corki,41,19,22,46.34
Velkoz,Soraka,52,28,24,53.85
Velkoz,Vladimir,68,35,33,51.47
Velkoz,Belveth,27,13,14,48.15
Velkoz,Samira,102,50,52,49.02
Velkoz,Alistar,54,28,26,51.85
Velkoz,Gragas,68,46,22,67.65
Velkoz,Varus,93,45,48,48.39
Velkoz,Zac,65,34,31,52.31
Velkoz,Sett,131,74,57,56.49
Velkoz,Viego,106,59,47,55.66
Velkoz,AurelionSol,49,14,35,28.57
Velkoz,MissFortune,246,135,111,54.88
Velkoz,Shen,104,55,49,52.88
Velkoz,Xerath,120,53,67,44.17
Velkoz,Lulu,164,84,80,51.22
Velkoz,MonkeyKing,53,31,22,58.49
Velkoz,Zed,132,52,80,39.39
Velkoz,Jhin,215,118,97,54.88
Velkoz,Gwen,44,19,25,43.18
Velkoz,Milio,45,30,15,66.67
Velkoz,Malphite,116,46,70,39.66
Velkoz,Katarina,57,37,20,64.91
Velkoz,TahmKench,106,50,56,47.17
Velkoz,Nunu,107,62,45,57.94
Velkoz,Jayce,37,22,15,59.46
Velkoz,Zeri,30,19,11,63.33
Velkoz,Kayn,104,51,53,49.04
Velkoz,Fizz,69,31,38,44.93
Velkoz,Kaisa,176,92,84,52.27
Velkoz,Rell,77,31,46,40.26
Velkoz,Zyra,78,53,25,67.95
Velkoz,Sylas,126,74,52,58.73
Velkoz,Thresh,197,100,97,50.76
Velkoz,Mel,232,125,107,53.88
Velkoz,Vi,118,61,57,51.69
Velkoz,Hwei,99,58,41,58.59
Velkoz,Morgana,102,33,69,32.35
Velkoz,Yorick,92,38,54,41.3
Velkoz,Trundle,58,41,17,70.69
Velkoz,Shaco,60,20,40,33.33
Velkoz,Blitzcrank,91,47,44,51.65
Velkoz,Garen,149,44,105,29.53
Velkoz,Bard,34,13,21,38.24
Velkoz,Udyr,51,32,19,62.75
Velkoz,Yone,161,86,75,53.42
Velkoz,Leona,107,52,55,48.6
Velkoz,Chogath,132,55,77,41.67
Velkoz,Aphelios,51,22,29,43.14
Velkoz,Hecarim,21,13,8,61.9
Velkoz,Aurora,80,51,29,63.75
Velkoz,Aatrox,101,50,51,49.5
Velkoz,Sona,11,11,0,100
Velkoz,Kalista,34,14,20,41.18
Velkoz,Rengar,49,31,18,63.27
Velkoz,Maokai,58,30,28,51.72
Velkoz,Irelia,77,48,29,62.34
Velkoz,Poppy,77,34,43,44.16
Velkoz,Orianna,53,27,26,50.94
Velkoz,Vayne,108,44,64,40.74
Velkoz,MasterYi,104,52,52,50
Velkoz,Nasus,92,52,40,56.52
Velkoz,Amumu,163,55,108,33.74
Velkoz,Heimerdinger,61,41,20,67.21
Velkoz,Lissandra,31,12,19,38.71
Velkoz,Kayle,58,28,30,48.28
Velkoz,Nocturne,99,53,46,53.54
Velkoz,Volibear,98,41,57,41.84
Velkoz,Ekko,72,33,39,45.83
Velkoz,Kled,32,23,9,71.88
Velkoz,Illaoi,61,46,15,75.41
Velkoz,JarvanIV,106,50,56,47.17
Velkoz,Naafiri,32,11,21,34.38
Velkoz,Nilah,43,18,25,41.86
Velkoz,Pyke,88,55,33,62.5
Velkoz,Ahri,160,63,97,39.38
Velkoz,Taliyah,29,9,20,31.03
Velkoz,Quinn,32,21,11,65.63
Velkoz,Nami,140,69,71,49.29
Velkoz,Draven,77,21,56,27.27
Velkoz,Fiora,35,22,13,62.86
Velkoz,Galio,131,46,85,35.11
Velkoz,XinZhao,80,44,36,55
Velkoz,Anivia,39,19,20,48.72
Velkoz,Khazix,65,30,35,46.15
Velkoz,Akali,95,39,56,41.05
Velkoz,Gnar,56,24,32,42.86
Velkoz,Smolder,57,21,36,36.84
Velkoz,Twitch,82,35,47,42.68
Velkoz,Vex,40,15,25,37.5
Velkoz,Xayah,39,19,20,48.72
Velkoz,Yuumi,72,28,44,38.89
Velkoz,Renekton,59,31,28,52.54
Velkoz,Seraphine,61,24,37,39.34
Velkoz,Briar,65,45,20,69.23
Velkoz,Talon,56,26,30,46.43
Velkoz,Swain,151,82,69,54.3
Velkoz,Singed,36,14,22,38.89
Velkoz,Kassadin,36,19,17,52.78
Velkoz,Kennen,32,24,8,75
Velkoz,Ryze,42,16,26,38.1
Velkoz,KogMaw,28,17,11,60.71
Velkoz,Lucian,58,22,36,37.93
Velkoz,Senna,60,26,34,43.33
Velkoz,Camille,53,20,33,37.74
Velkoz,Akshan,23,7,16,30.43
Velkoz,FiddleSticks,38,19,19,50
Velkoz,Skarner,40,24,16,60
Velkoz,Azir,51,26,25,50.98
Velkoz,Urgot,71,34,37,47.89
Velkoz,Lillia,35,19,16,54.29
Velkoz,KSante,73,50,23,68.49
Velkoz,Gangplank,42,14,28,33.33
Velkoz,Syndra,69,19,50,27.54
Velkoz,Rumble,44,17,27,38.64
Velkoz,Cassiopeia,23,11,12,47.83
Velkoz,Rakan,58,41,17,70.69
Velkoz,Sivir,47,24,23,51.06
Velkoz,Taric,36,19,17,52.78
Velkoz,Tryndamere,32,19,13,59.38
Velkoz,Shyvana,19,12,7,63.16
Velkoz,Ivern,24,7,17,29.17
Velkoz,TwistedFate,40,27,13,67.5
Velkoz,Karthus,18,6,12,33.33
Velkoz,Janna,40,19,21,47.5
Velkoz,RekSai,15,6,9,40
Velkoz,Olaf,23,14,9,60.87
Velkoz,Qiyana,19,13,6,68.42
Velkoz,Nidalee,15,5,10,33.33
Xayah,Ambessa,119,68,51,57.14
Xayah,Viktor,92,49,43,53.26
Xayah,Graves,76,33,43,43.42
Xayah,Caitlyn,312,138,174,44.23
Xayah,Braum,81,43,38,53.09
Xayah,Sejuani,74,39,35,52.7
Xayah,Pantheon,174,77,97,44.25
Xayah,Neeko,56,31,25,55.36
Xayah,Varus,99,49,50,49.49
Xayah,Pyke,102,58,44,56.86
Xayah,Yasuo,200,106,94,53
Xayah,Shaco,78,34,44,43.59
Xayah,Azir,78,38,40,48.72
Xayah,Jhin,200,131,69,65.5
Xayah,Sylas,168,86,82,51.19
Xayah,Jax,92,40,52,43.48
Xayah,Diana,169,105,64,62.13
Xayah,Akshan,33,20,13,60.61
Xayah,Ashe,186,89,97,47.85
Xayah,Milio,78,40,38,51.28
Xayah,Illaoi,48,29,19,60.42
Xayah,Twitch,80,28,52,35
Xayah,Ahri,209,117,92,55.98
Xayah,Kaisa,258,144,114,55.81
Xayah,Garen,211,110,101,52.13
Xayah,Ezreal,299,160,139,53.51
Xayah,Brand,55,31,24,56.36
Xayah,Warwick,160,64,96,40
Xayah,LeeSin,161,83,78,51.55
Xayah,Lucian,91,67,24,73.63
Xayah,Nami,115,54,61,46.96
Xayah,Vladimir,79,27,52,34.18
Xayah,Akali,144,88,56,61.11
Xayah,Vayne,156,87,69,55.77
Xayah,Malphite,118,49,69,41.53
Xayah,Ekko,102,36,66,35.29
Xayah,Smolder,88,49,39,55.68
Xayah,Soraka,61,37,24,60.66
Xayah,Irelia,92,45,47,48.91
Xayah,Darius,203,90,113,44.33
Xayah,Aurora,98,55,43,56.12
Xayah,Katarina,53,32,21,60.38
Xayah,JarvanIV,82,31,51,37.8
Xayah,Yone,236,140,96,59.32
Xayah,Amumu,159,67,92,42.14
Xayah,KSante,61,34,27,55.74
Xayah,Draven,58,33,25,56.9
Xayah,Zoe,42,26,16,61.9
Xayah,Lulu,124,70,54,56.45
Xayah,Aatrox,142,68,74,47.89
Xayah,Kayn,128,85,43,66.41
Xayah,MissFortune,235,108,127,45.96
Xayah,Nautilus,195,115,80,58.97
Xayah,Heimerdinger,71,50,21,70.42
Xayah,Vi,165,83,82,50.3
Xayah,Blitzcrank,130,56,74,43.08
Xayah,Tryndamere,59,38,21,64.41
Xayah,Gragas,106,63,43,59.43
Xayah,Senna,80,59,21,73.75
Xayah,Nasus,69,36,33,52.17
Xayah,MasterYi,89,54,35,60.67
Xayah,Morgana,120,50,70,41.67
Xayah,Seraphine,56,30,26,53.57
Xayah,Sion,121,54,67,44.63
Xayah,RekSai,34,15,19,44.12
Xayah,Lissandra,43,18,25,41.86
Xayah,Fizz,49,21,28,42.86
Xayah,Yorick,93,54,39,58.06
Xayah,Briar,84,35,49,41.67
Xayah,Mordekaiser,122,70,52,57.38
Xayah,Vex,94,52,42,55.32
Xayah,Hwei,98,50,48,51.02
Xayah,Malzahar,127,65,62,51.18
Xayah,KogMaw,28,9,19,32.14
Xayah,Udyr,39,23,16,58.97
Xayah,Zed,149,66,83,44.3
Xayah,Lillia,80,35,45,43.75
Xayah,Sett,146,57,89,39.04
Xayah,Swain,120,62,58,51.67
Xayah,Jinx,310,110,200,35.48
Xayah,Yuumi,115,62,53,53.91
Xayah,Zilean,24,3,21,12.5
Xayah,Khazix,55,26,29,47.27
Xayah,Syndra,92,46,46,50
Xayah,Rell,89,45,44,50.56
Xayah,TahmKench,109,52,57,47.71
Xayah,TwistedFate,51,13,38,25.49
Xayah,Anivia,39,14,25,35.9
Xayah,FiddleSticks,70,26,44,37.14
Xayah,Poppy,112,58,54,51.79
Xayah,Zac,85,46,39,54.12
Xayah,Renata,29,11,18,37.93
Xayah,Nocturne,126,55,71,43.65
Xayah,Zyra,73,32,41,43.84
Xayah,Mel,260,159,101,61.15
Xayah,Thresh,224,120,104,53.57
Xayah,Singed,29,6,23,20.69
Xayah,AurelionSol,44,23,21,52.27
Xayah,Elise,119,44,75,36.97
Xayah,MonkeyKing,66,41,25,62.12
Xayah,Lux,236,126,110,53.39
Xayah,Karma,143,62,81,43.36
Xayah,DrMundo,64,36,28,56.25
Xayah,Leblanc,62,32,30,51.61
Xayah,Veigar,132,49,83,37.12
Xayah,Leona,116,63,53,54.31
Xayah,Taric,27,6,21,22.22
Xayah,Nidalee,46,25,21,54.35
Xayah,Fiora,41,14,27,34.15
Xayah,Renekton,74,48,26,64.86
Xayah,Jayce,53,27,26,50.94
Xayah,Olaf,32,13,19,40.63
Xayah,Riven,33,11,22,33.33
Xayah,Galio,135,79,56,58.52
Xayah,Viego,150,68,82,45.33
Xayah,Rengar,55,41,14,74.55
Xayah,Janna,51,18,33,35.29
Xayah,Volibear,113,58,55,51.33
Xayah,Evelynn,40,20,20,50
Xayah,Ornn,68,42,26,61.76
Xayah,Gnar,79,38,41,48.1
Xayah,Annie,57,21,36,36.84
Xayah,Talon,50,29,21,58
Xayah,Karthus,30,21,9,70
Xayah,Alistar,66,31,35,46.97
Xayah,Skarner,71,37,34,52.11
Xayah,Tristana,93,41,52,44.09
Xayah,Corki,63,43,20,68.25
Xayah,Bard,61,38,23,62.3
Xayah,Gangplank,51,34,17,66.67
Xayah,Teemo,116,60,56,51.72
Xayah,Quinn,19,8,11,42.11
Xayah,Hecarim,36,28,8,77.78
Xayah,Ziggs,38,16,22,42.11
Xayah,Rakan,85,31,54,36.47
Xayah,Ryze,39,15,24,38.46
Xayah,Kindred,46,29,17,63.04
Xayah,Naafiri,19,13,6,68.42
Xayah,Sona,20,12,8,60
Xayah,Zeri,67,34,33,50.75
Xayah,Trundle,60,39,21,65
Xayah,Nunu,63,30,33,47.62
Xayah,Rumble,31,25,6,80.65
Xayah,Taliyah,37,19,18,51.35
Xayah,Maokai,41,16,25,39.02
Xayah,Aphelios,52,24,28,46.15
Xayah,Gwen,60,28,32,46.67
Xayah,Velkoz,39,20,19,51.28
Xayah,Sivir,40,7,33,17.5
Xayah,Chogath,158,55,103,34.81
Xayah,Shyvana,31,14,17,45.16
Xayah,Nilah,76,42,34,55.26
Xayah,Rammus,44,20,24,45.45
Xayah,Samira,100,49,51,49
Xayah,Urgot,46,23,23,50
Xayah,XinZhao,62,31,31,50
Xayah,Belveth,26,11,15,42.31
Xayah,Orianna,56,21,35,37.5
Xayah,Shen,120,57,63,47.5
Xayah,Cassiopeia,39,23,16,58.97
Xayah,Kayle,50,17,33,34
Xayah,Kennen,28,12,16,42.86
Xayah,Camille,53,34,19,64.15
Xayah,Xerath,77,31,46,40.26
Xayah,Qiyana,18,11,7,61.11
Xayah,Kalista,29,17,12,58.62
Xayah,Kassadin,28,15,13,53.57
Xayah,Ivern,23,17,6,73.91
Xayah,Kled,8,5,3,62.5
Leblanc,Ambessa,100,45,55,45
Leblanc,Viktor,118,50,68,42.37
Leblanc,Graves,101,49,52,48.51
Leblanc,Caitlyn,298,129,169,43.29
Leblanc,Braum,80,33,47,41.25
Leblanc,Teemo,101,50,51,49.5
Leblanc,FiddleSticks,44,22,22,50
Leblanc,Hwei,63,28,35,44.44
Leblanc,Twitch,93,50,43,53.76
Leblanc,Seraphine,61,28,33,45.9
Leblanc,Garen,167,83,84,49.7
Leblanc,MonkeyKing,112,64,48,57.14
Leblanc,Lux,256,103,153,40.23
Leblanc,Nilah,13,5,8,38.46
Leblanc,Lulu,198,66,132,33.33
Leblanc,Trundle,56,26,30,46.43
Leblanc,Ahri,248,110,138,44.35
Leblanc,Zed,123,50,73,40.65
Leblanc,Skarner,81,37,44,45.68
Leblanc,Aurora,130,67,63,51.54
Leblanc,Ezreal,288,130,158,45.14
Leblanc,Yuumi,92,31,61,33.7
Leblanc,Darius,163,78,85,47.85
Leblanc,Shaco,95,56,39,58.95
Leblanc,Ekko,124,48,76,38.71
Leblanc,Kaisa,182,102,80,56.04
Leblanc,Neeko,72,43,29,59.72
Leblanc,Camille,42,16,26,38.1
Leblanc,Kindred,39,14,25,35.9
Leblanc,Jinx,273,99,174,36.26
Leblanc,Riven,35,19,16,54.29
Leblanc,Shyvana,29,18,11,62.07
Leblanc,Ryze,27,10,17,37.04
Leblanc,Velkoz,67,24,43,35.82
Leblanc,Jhin,231,122,109,52.81
Leblanc,Gnar,59,35,24,59.32
Leblanc,Syndra,88,39,49,44.32
Leblanc,Diana,154,91,63,59.09
Leblanc,Tristana,91,42,49,46.15
Leblanc,Janna,34,6,28,17.65
Leblanc,Sett,168,96,72,57.14
Leblanc,Nautilus,152,88,64,57.89
Leblanc,Shen,72,39,33,54.17
Leblanc,Mel,203,91,112,44.83
Leblanc,Galio,177,73,104,41.24
Leblanc,Thresh,257,123,134,47.86
Leblanc,Lillia,85,47,38,55.29
Leblanc,Yone,250,113,137,45.2
Leblanc,MissFortune,227,85,142,37.44
Leblanc,Karma,154,87,67,56.49
Leblanc,Jax,105,54,51,51.43
Leblanc,Chogath,157,62,95,39.49
Leblanc,Kennen,50,25,25,50
Leblanc,Varus,136,61,75,44.85
Leblanc,Volibear,113,34,79,30.09
Leblanc,Evelynn,27,8,19,29.63
Leblanc,KogMaw,60,32,28,53.33
Leblanc,AurelionSol,21,12,9,57.14
Leblanc,Ashe,297,168,129,56.57
Leblanc,Poppy,94,37,57,39.36
Leblanc,Mordekaiser,185,78,107,42.16
Leblanc,Senna,84,50,34,59.52
Leblanc,Nocturne,149,55,94,36.91
Leblanc,Naafiri,28,17,11,60.71
Leblanc,Gragas,134,66,68,49.25
Leblanc,Malzahar,110,39,71,35.45
Leblanc,Kayn,135,63,72,46.67
Leblanc,Rengar,62,30,32,48.39
Leblanc,Brand,52,26,26,50
Leblanc,LeeSin,264,130,134,49.24
Leblanc,Vex,93,39,54,41.94
Leblanc,Samira,90,38,52,42.22
Leblanc,Blitzcrank,147,66,81,44.9
Leblanc,DrMundo,53,30,23,56.6
Leblanc,Briar,68,27,41,39.71
Leblanc,Lucian,88,43,45,48.86
Leblanc,Nunu,70,34,36,48.57
Leblanc,Renekton,68,24,44,35.29
Leblanc,Zyra,117,70,47,59.83
Leblanc,Vi,138,57,81,41.3
Leblanc,Amumu,119,54,65,45.38
Leblanc,Draven,65,32,33,49.23
Leblanc,Talon,94,49,45,52.13
Leblanc,Corki,56,34,22,60.71
Leblanc,Swain,92,32,60,34.78
Leblanc,Singed,24,6,18,25
Leblanc,Katarina,69,40,29,57.97
Leblanc,Kled,20,9,11,45
Leblanc,Orianna,67,31,36,46.27
Leblanc,Malphite,126,65,61,51.59
Leblanc,Vladimir,61,33,28,54.1
Leblanc,Rammus,47,30,17,63.83
Leblanc,Vayne,105,43,62,40.95
Leblanc,Nami,123,66,57,53.66
Leblanc,Viego,151,69,82,45.7
Leblanc,Yorick,86,36,50,41.86
Leblanc,Elise,91,43,48,47.25
Leblanc,Pyke,107,68,39,63.55
Leblanc,Xayah,62,30,32,48.39
Leblanc,Sivir,50,23,27,46
Leblanc,KSante,80,48,32,60
Leblanc,Kassadin,41,23,18,56.1
Leblanc,Veigar,111,56,55,50.45
Leblanc,Yasuo,213,105,108,49.3
Leblanc,Khazix,60,25,35,41.67
Leblanc,Rakan,77,37,40,48.05
Leblanc,Gangplank,60,26,34,43.33
Leblanc,Azir,49,35,14,71.43
Leblanc,Aatrox,104,49,55,47.12
Leblanc,Zac,56,33,23,58.93
Leblanc,Irelia,93,50,43,53.76
Leblanc,Milio,44,20,24,45.45
Leblanc,Zeri,70,35,35,50
Leblanc,Nidalee,23,13,10,56.52
Leblanc,Alistar,80,43,37,53.75
Leblanc,Hecarim,30,18,12,60
Leblanc,Sion,65,29,36,44.62
Leblanc,Zilean,33,21,12,63.64
Leblanc,Smolder,83,35,48,42.17
Leblanc,Ornn,68,33,35,48.53
Leblanc,Karthus,25,11,14,44
Leblanc,Nasus,66,26,40,39.39
Leblanc,Sylas,180,68,112,37.78
Leblanc,TahmKench,87,45,42,51.72
Leblanc,Ivern,39,15,24,38.46
Leblanc,Maokai,73,26,47,35.62
Leblanc,Sona,14,6,8,42.86
Leblanc,Warwick,168,85,83,50.6
Leblanc,Annie,40,26,14,65
Leblanc,Urgot,62,34,28,54.84
Leblanc,Zoe,58,36,22,62.07
Leblanc,Aphelios,53,24,29,45.28
Leblanc,Lissandra,65,25,40,38.46
Leblanc,Tryndamere,31,22,9,70.97
Leblanc,Fizz,55,39,16,70.91
Leblanc,JarvanIV,83,31,52,37.35
Leblanc,MasterYi,115,45,70,39.13
Leblanc,Akali,119,48,71,40.34
Leblanc,Fiora,35,4,31,11.43
Leblanc,Belveth,12,5,7,41.67
Leblanc,Morgana,117,65,52,55.56
Leblanc,Kalista,63,38,25,60.32
Leblanc,Akshan,34,10,24,29.41
Leblanc,Soraka,71,37,34,52.11
Leblanc,Pantheon,154,80,74,51.95
Leblanc,Leona,82,48,34,58.54
Leblanc,Jayce,68,29,39,42.65
Leblanc,XinZhao,82,56,26,68.29
Leblanc,Quinn,36,12,24,33.33
Leblanc,Rumble,34,14,20,41.18
Leblanc,Rell,67,32,35,47.76
Leblanc,Xerath,131,65,66,49.62
Leblanc,Udyr,34,19,15,55.88
Leblanc,Anivia,26,11,15,42.31
Leblanc,Ziggs,31,14,17,45.16
Leblanc,Kayle,62,29,33,46.77
Leblanc,Illaoi,56,27,29,48.21
Leblanc,Olaf,17,3,14,17.65
Leblanc,Renata,26,9,17,34.62
Leblanc,Taliyah,12,9,3,75
Leblanc,RekSai,11,3,8,27.27
Leblanc,Gwen,49,27,22,55.1
Leblanc,Sejuani,64,28,36,43.75
Leblanc,TwistedFate,41,24,17,58.54
Leblanc,Taric,14,5,9,35.71
Leblanc,Cassiopeia,22,14,8,63.64
Leblanc,Heimerdinger,12,4,8,33.33
Leblanc,Qiyana,17,8,9,47.06
Leblanc,Bard,34,17,17,50
Viktor,Vladimir,102,58,44,56.86
Viktor,Kayn,174,89,85,51.15
Viktor,Velkoz,116,64,52,55.17
Viktor,Xayah,92,43,49,46.74
Viktor,Leblanc,118,68,50,57.63
Viktor,Sejuani,127,57,70,44.88
Viktor,Pantheon,293,155,138,52.9
Viktor,Neeko,85,39,46,45.88
Viktor,Varus,167,80,87,47.9
Viktor,Pyke,169,92,77,54.44
Viktor,Yone,340,186,154,54.71
Viktor,Nocturne,274,133,141,48.54
Viktor,Akali,220,119,101,54.09
Viktor,Ezreal,561,308,253,54.9
Viktor,Renata,51,22,29,43.14
Viktor,JarvanIV,184,92,92,50
Viktor,Ryze,105,50,55,47.62
Viktor,Draven,76,41,35,53.95
Viktor,Blitzcrank,154,79,75,51.3
Viktor,Teemo,181,102,79,56.35
Viktor,Viego,261,133,128,50.96
Viktor,Anivia,79,29,50,36.71
Viktor,MissFortune,314,150,164,47.77
Viktor,TahmKench,199,101,98,50.75
Viktor,Kennen,68,27,41,39.71
Viktor,Vi,226,118,108,52.21
Viktor,Ashe,322,166,156,51.55
Viktor,Lux,415,230,185,55.42
Viktor,Leona,158,99,59,62.66
Viktor,LeeSin,347,177,170,51.01
Viktor,Orianna,138,73,65,52.9
Viktor,Twitch,141,53,88,37.59
Viktor,Morgana,187,65,122,34.76
Viktor,Poppy,144,64,80,44.44
Viktor,Shaco,148,80,68,54.05
Viktor,Ahri,269,145,124,53.9
Viktor,Nami,187,92,95,49.2
Viktor,Gragas,140,83,57,59.29
Viktor,MasterYi,185,109,76,58.92
Viktor,TwistedFate,69,35,34,50.72
Viktor,Rakan,109,42,67,38.53
Viktor,Shen,159,78,81,49.06
Viktor,AurelionSol,92,45,47,48.91
Viktor,Caitlyn,477,248,229,51.99
Viktor,Brand,133,76,57,57.14
Viktor,Chogath,254,120,134,47.24
Viktor,Yasuo,316,161,155,50.95
Viktor,Sivir,129,55,74,42.64
Viktor,Sett,268,150,118,55.97
Viktor,Ekko,179,90,89,50.28
Viktor,Azir,110,47,63,42.73
Viktor,Jinx,500,227,273,45.4
Viktor,Olaf,46,26,20,56.52
Viktor,Katarina,134,76,58,56.72
Viktor,Veigar,240,122,118,50.83
Viktor,Bard,62,39,23,62.9
Viktor,Zed,166,104,62,62.65
Viktor,Ziggs,74,34,40,45.95
Viktor,Graves,151,77,74,50.99
Viktor,Hwei,163,84,79,51.53
Viktor,Mel,502,245,257,48.8
Viktor,Sion,126,55,71,43.65
Viktor,Warwick,204,103,101,50.49
Viktor,Samira,149,87,62,58.39
Viktor,Swain,208,80,128,38.46
Viktor,Garen,318,149,169,46.86
Viktor,Corki,122,69,53,56.56
Viktor,Lillia,93,47,46,50.54
Viktor,Galio,223,117,106,52.47
Viktor,Kaisa,289,131,158,45.33
Viktor,Amumu,181,88,93,48.62
Viktor,KSante,132,78,54,59.09
Viktor,Zoe,60,34,26,56.67
Viktor,Lulu,284,138,146,48.59
Viktor,Ornn,99,55,44,55.56
Viktor,Jayce,113,50,63,44.25
Viktor,Seraphine,97,33,64,34.02
Viktor,Zyra,173,88,85,50.87
Viktor,Trundle,62,39,23,62.9
Viktor,Lissandra,86,49,37,56.98
Viktor,DrMundo,114,69,45,60.53
Viktor,Vex,106,44,62,41.51
Viktor,Jhin,329,182,147,55.32
Viktor,Camille,54,33,21,61.11
Viktor,Xerath,192,98,94,51.04
Viktor,Smolder,126,57,69,45.24
Viktor,Rell,149,76,73,51.01
Viktor,Zac,108,42,66,38.89
Viktor,Lucian,174,101,73,58.05
Viktor,Darius,305,171,134,56.07
Viktor,Mordekaiser,206,112,94,54.37
Viktor,Maokai,95,56,39,58.95
Viktor,Soraka,106,54,52,50.94
Viktor,Rengar,54,37,17,68.52
Viktor,Nautilus,285,150,135,52.63
Viktor,Hecarim,71,41,30,57.75
Viktor,Kindred,78,53,25,67.95
Viktor,Tristana,171,97,74,56.73
Viktor,Karma,234,124,110,52.99
Viktor,Malphite,225,110,115,48.89
Viktor,Jax,161,82,79,50.93
Viktor,Gangplank,102,47,55,46.08
Viktor,Alistar,111,49,62,44.14
Viktor,XinZhao,134,45,89,33.58
Viktor,Renekton,87,47,40,54.02
Viktor,Thresh,373,187,186,50.13
Viktor,Irelia,139,77,62,55.4
Viktor,Milio,135,79,56,58.52
Viktor,Zeri,85,45,40,52.94
Viktor,Yorick,126,55,71,43.65
Viktor,Cassiopeia,65,26,39,40
Viktor,Janna,49,31,18,63.27
Viktor,Diana,246,120,126,48.78
Viktor,Syndra,177,100,77,56.5
Viktor,Vayne,245,136,109,55.51
Viktor,Zilean,52,28,24,53.85
Viktor,Ambessa,145,69,76,47.59
Viktor,Kalista,75,49,26,65.33
Viktor,Illaoi,57,25,32,43.86
Viktor,FiddleSticks,103,41,62,39.81
Viktor,Aurora,193,92,101,47.67
Viktor,Gnar,118,78,40,66.1
Viktor,MonkeyKing,163,78,85,47.85
Viktor,Sona,31,13,18,41.94
Viktor,Aatrox,171,95,76,55.56
Viktor,Shyvana,28,11,17,39.29
Viktor,Urgot,92,36,56,39.13
Viktor,Yuumi,140,70,70,50
Viktor,Volibear,210,89,121,42.38
Viktor,Ivern,41,19,22,46.34
Viktor,RekSai,19,12,7,63.16
Viktor,Talon,90,58,32,64.44
Viktor,Senna,87,38,49,43.68
Viktor,Heimerdinger,88,46,42,52.27
Viktor,Gwen,97,47,50,48.45
Viktor,Udyr,70,36,34,51.43
Viktor,Riven,82,44,38,53.66
Viktor,Sylas,250,149,101,59.6
Viktor,Kayle,102,63,39,61.76
Viktor,Taric,49,20,29,40.82
Viktor,Rumble,53,26,27,49.06
Viktor,KogMaw,51,30,21,58.82
Viktor,Quinn,38,17,21,44.74
Viktor,Evelynn,56,25,31,44.64
Viktor,Malzahar,185,107,78,57.84
Viktor,Briar,100,41,59,41
Viktor,Rammus,59,35,24,59.32
Viktor,Aphelios,97,58,39,59.79
Viktor,Nasus,126,76,50,60.32
Viktor,Akshan,63,36,27,57.14
Viktor,Fizz,106,50,56,47.17
Viktor,Elise,165,86,79,52.12
Viktor,Fiora,63,22,41,34.92
Viktor,Kassadin,40,18,22,45
Viktor,Karthus,42,12,30,28.57
Viktor,Nunu,115,62,53,53.91
Viktor,Annie,35,16,19,45.71
Viktor,Nidalee,53,40,13,75.47
Viktor,Khazix,125,68,57,54.4
Viktor,Naafiri,39,22,17,56.41
Viktor,Singed,44,26,18,59.09
Viktor,Taliyah,35,22,13,62.86
Viktor,Tryndamere,66,33,33,50
Viktor,Skarner,117,70,47,59.83
Viktor,Braum,143,65,78,45.45
Viktor,Belveth,51,27,24,52.94
Viktor,Nilah,61,23,38,37.7
Viktor,Kled,39,23,16,58.97
Viktor,Qiyana,29,3,26,10.34
Graves,Vladimir,75,36,39,48
Graves,Kayn,152,78,74,51.32
Graves,Velkoz,83,44,39,53.01
Graves,Xayah,76,43,33,56.58
Graves,Leblanc,101,52,49,51.49
Graves,Thresh,290,136,154,46.9
Graves,Annie,56,25,31,44.64
Graves,Nasus,79,38,41,48.1
Graves,Tristana,116,66,50,56.9
Graves,Poppy,92,34,58,36.96
Graves,Tryndamere,49,27,22,55.1
Graves,Shaco,106,45,61,42.45
Graves,Caitlyn,284,138,146,48.59
Graves,Morgana,113,72,41,63.72
Graves,Jax,117,55,62,47.01
Graves,Pantheon,183,91,92,49.73
Graves,TwistedFate,67,32,35,47.76
Graves,Sivir,54,33,21,61.11
Graves,Milio,94,48,46,51.06
Graves,Teemo,86,53,33,61.63
Graves,MasterYi,125,70,55,56
Graves,Katarina,67,31,36,46.27
Graves,Samira,115,48,67,41.74
Graves,Singed,42,18,24,42.86
Graves,Aatrox,162,84,78,51.85
Graves,Mel,217,103,114,47.47
Graves,Sona,22,13,9,59.09
Graves,Alistar,54,32,22,59.26
Graves,Nocturne,176,97,79,55.11
Graves,Galio,160,97,63,60.63
Graves,Urgot,43,20,23,46.51
Graves,FiddleSticks,55,22,33,40
Graves,Lux,260,139,121,53.46
Graves,Ashe,248,146,102,58.87
Graves,Braum,87,31,56,35.63
Graves,Yorick,65,34,31,52.31
Graves,Nunu,104,77,27,74.04
Graves,Varus,148,87,61,58.78
Graves,Bard,48,24,24,50
Graves,Hwei,71,30,41,42.25
Graves,Zyra,99,50,49,50.51
Graves,Sett,203,117,86,57.64
Graves,JarvanIV,97,41,56,42.27
Graves,Veigar,93,58,35,62.37
Graves,Renekton,70,42,28,60
Graves,Elise,111,61,50,54.95
Graves,Sylas,257,151,106,58.75
Graves,Jinx,298,148,150,49.66
Graves,Jayce,99,46,53,46.46
Graves,Ekko,55,26,29,47.27
Graves,Viktor,151,74,77,49.01
Graves,Leona,113,64,49,56.64
Graves,Mordekaiser,129,86,43,66.67
Graves,XinZhao,54,31,23,57.41
Graves,Diana,201,111,90,55.22
Graves,Riven,71,41,30,57.75
Graves,Lillia,66,49,17,74.24
Graves,Yasuo,255,157,98,61.57
Graves,Nautilus,228,117,111,51.32
Graves,Qiyana,28,19,9,67.86
Graves,Kalista,60,28,32,46.67
Graves,Irelia,87,54,33,62.07
Graves,Zed,112,49,63,43.75
Graves,Kaisa,256,143,113,55.86
Graves,Brand,45,19,26,42.22
Graves,Volibear,88,50,38,56.82
Graves,Ahri,190,97,93,51.05
Graves,Vayne,143,79,64,55.24
Graves,Rakan,71,47,24,66.2
Graves,TahmKench,128,72,56,56.25
Graves,Jhin,227,124,103,54.63
Graves,MonkeyKing,94,48,46,51.06
Graves,Seraphine,78,44,34,56.41
Graves,Nami,93,39,54,41.94
Graves,Karma,161,91,70,56.52
Graves,LeeSin,372,200,172,53.76
Graves,KogMaw,55,38,17,69.09
Graves,Heimerdinger,52,39,13,75
Graves,Darius,231,120,111,51.95
Graves,Sejuani,111,60,51,54.05
Graves,Quinn,35,15,20,42.86
Graves,Ezreal,319,155,164,48.59
Graves,Senna,81,54,27,66.67
Graves,Soraka,62,27,35,43.55
Graves,Gwen,100,60,40,60
Graves,Lulu,190,108,82,56.84
Graves,Viego,174,101,73,58.05
Graves,Draven,77,47,30,61.04
Graves,MissFortune,250,137,113,54.8
Graves,Ornn,99,43,56,43.43
Graves,Aurora,90,54,36,60
Graves,Ziggs,44,31,13,70.45
Graves,Olaf,35,15,20,42.86
Graves,Syndra,81,50,31,61.73
Graves,Sion,104,55,49,52.88
Graves,Ambessa,91,50,41,54.95
Graves,Talon,46,19,27,41.3
Graves,Khazix,56,28,28,50
Graves,Pyke,135,68,67,50.37
Graves,Akali,141,73,68,51.77
Graves,Malphite,157,64,93,40.76
Graves,Evelynn,26,5,21,19.23
Graves,Vi,140,80,60,57.14
Graves,Gangplank,62,34,28,54.84
Graves,Renata,40,26,14,65
Graves,Trundle,43,30,13,69.77
Graves,Ivern,25,14,11,56
Graves,Blitzcrank,121,68,53,56.2
Graves,Lissandra,49,17,32,34.69
Graves,Aphelios,72,41,31,56.94
Graves,Ryze,55,44,11,80
Graves,Smolder,100,52,48,52
Graves,Zac,74,41,33,55.41
Graves,Rell,74,51,23,68.92
Graves,Hecarim,56,36,20,64.29
Graves,Xerath,120,47,73,39.17
Graves,Orianna,77,33,44,42.86
Graves,Swain,102,47,55,46.08
Graves,Akshan,46,32,14,69.57
Graves,Zilean,20,10,10,50
Graves,KSante,59,28,31,47.46
Graves,Rammus,43,16,27,37.21
Graves,Illaoi,65,32,33,49.23
Graves,Yone,238,148,90,62.18
Graves,Warwick,141,84,57,59.57
Graves,AurelionSol,33,22,11,66.67
Graves,Skarner,48,20,28,41.67
Graves,Gragas,74,56,18,75.68
Graves,Karthus,29,13,16,44.83
Graves,Anivia,35,15,20,42.86
Graves,Maokai,47,17,30,36.17
Graves,Camille,62,29,33,46.77
Graves,Kennen,47,21,26,44.68
Graves,Janna,28,19,9,67.86
Graves,Amumu,155,86,69,55.48
Graves,Corki,65,35,30,53.85
Graves,Cassiopeia,36,25,11,69.44
Graves,Udyr,56,24,32,42.86
Graves,DrMundo,53,21,32,39.62
Graves,Chogath,161,57,104,35.4
Graves,Twitch,74,34,40,45.95
Graves,Garen,194,100,94,51.55
Graves,Naafiri,28,17,11,60.71
Graves,Shen,71,39,32,54.93
Graves,Lucian,88,57,31,64.77
Graves,Malzahar,121,54,67,44.63
Graves,Azir,67,28,39,41.79
Graves,Shyvana,32,15,17,46.88
Graves,Briar,47,27,20,57.45
Graves,Taric,22,6,16,27.27
Graves,Fizz,55,38,17,69.09
Graves,Kayle,60,36,24,60
Graves,Rengar,32,10,22,31.25
Graves,Rumble,42,29,13,69.05
Graves,Yuumi,99,66,33,66.67
Graves,RekSai,9,7,2,77.78
Graves,Nilah,44,16,28,36.36
Graves,Zoe,42,17,25,40.48
Graves,Belveth,18,12,6,66.67
Graves,Gnar,53,28,25,52.83
Graves,Neeko,67,33,34,49.25
Graves,Zeri,76,37,39,48.68
Graves,Vex,54,24,30,44.44
Graves,Fiora,24,14,10,58.33
Graves,Taliyah,36,25,11,69.44
Graves,Nidalee,70,46,24,65.71
Graves,Kindred,58,32,26,55.17
Graves,Kled,26,6,20,23.08
Graves,Kassadin,13,8,5,61.54
XinZhao,Sion,107,48,59,44.86
XinZhao,Nocturne,171,109,62,63.74
XinZhao,Hwei,100,37,63,37
XinZhao,Jhin,229,142,87,62.01
XinZhao,Soraka,62,23,39,37.1
XinZhao,Malphite,106,48,58,45.28
XinZhao,Ivern,32,8,24,25
XinZhao,Ahri,188,90,98,47.87
XinZhao,Ashe,268,159,109,59.33
XinZhao,Lulu,207,118,89,57
XinZhao,Kayle,68,26,42,38.24
XinZhao,Evelynn,32,22,10,68.75
XinZhao,Vladimir,83,46,37,55.42
XinZhao,Kaisa,194,101,93,52.06
XinZhao,Maokai,39,19,20,48.72
XinZhao,TahmKench,109,39,70,35.78
XinZhao,JarvanIV,126,56,70,44.44
XinZhao,Veigar,100,62,38,62
XinZhao,Yasuo,254,123,131,48.43
XinZhao,Irelia,68,48,20,70.59
XinZhao,Karma,145,68,77,46.9
XinZhao,MonkeyKing,111,32,79,28.83
XinZhao,Mel,263,165,98,62.74
XinZhao,Cassiopeia,41,31,10,75.61
XinZhao,Thresh,221,127,94,57.47
XinZhao,Nasus,68,29,39,42.65
XinZhao,MasterYi,119,70,49,58.82
XinZhao,Chogath,140,51,89,36.43
XinZhao,Ezreal,364,169,195,46.43
XinZhao,Amumu,144,61,83,42.36
XinZhao,Warwick,188,91,97,48.4
XinZhao,Nunu,43,32,11,74.42
XinZhao,Malzahar,148,76,72,51.35
XinZhao,Samira,114,43,71,37.72
XinZhao,Pyke,101,54,47,53.47
XinZhao,Gwen,82,50,32,60.98
XinZhao,Graves,54,23,31,42.59
XinZhao,Ziggs,51,20,31,39.22
XinZhao,Zoe,74,21,53,28.38
XinZhao,Talon,90,61,29,67.78
XinZhao,Lissandra,52,23,29,44.23
XinZhao,Corki,61,18,43,29.51
XinZhao,Udyr,34,16,18,47.06
XinZhao,Ornn,97,49,48,50.52
XinZhao,Kayn,136,80,56,58.82
XinZhao,Sylas,189,106,83,56.08
XinZhao,Jinx,323,140,183,43.34
XinZhao,Azir,67,28,39,41.79
XinZhao,Nami,157,72,85,45.86
XinZhao,Shaco,87,63,24,72.41
XinZhao,Rammus,51,19,32,37.25
XinZhao,Zyra,100,54,46,54
XinZhao,Elise,142,72,70,50.7
XinZhao,Khazix,60,33,27,55
XinZhao,Brand,61,42,19,68.85
XinZhao,Leona,117,64,53,54.7
XinZhao,Vayne,180,87,93,48.33
XinZhao,KSante,94,46,48,48.94
XinZhao,Skarner,77,38,39,49.35
XinZhao,Smolder,103,46,57,44.66
XinZhao,Rell,95,54,41,56.84
XinZhao,Garen,200,88,112,44
XinZhao,Darius,168,92,76,54.76
XinZhao,Lux,267,129,138,48.31
XinZhao,Nautilus,211,115,96,54.5
XinZhao,Renekton,98,44,54,44.9
XinZhao,LeeSin,296,147,149,49.66
XinZhao,Galio,107,47,60,43.93
XinZhao,Varus,182,99,83,54.4
XinZhao,Illaoi,49,29,20,59.18
XinZhao,Zac,118,76,42,64.41
XinZhao,Katarina,76,45,31,59.21
XinZhao,Gangplank,66,32,34,48.48
XinZhao,Poppy,112,51,61,45.54
XinZhao,Aphelios,44,25,19,56.82
XinZhao,Vex,67,18,49,26.87
XinZhao,Singed,45,22,23,48.89
XinZhao,AurelionSol,41,22,19,53.66
XinZhao,Swain,119,43,76,36.13
XinZhao,Heimerdinger,78,32,46,41.03
XinZhao,Pantheon,188,95,93,50.53
XinZhao,Blitzcrank,127,55,72,43.31
XinZhao,Caitlyn,279,162,117,58.06
XinZhao,Taric,57,24,33,42.11
XinZhao,Aatrox,100,50,50,50
XinZhao,Viktor,134,89,45,66.42
XinZhao,Fiora,51,18,33,35.29
XinZhao,Aurora,142,71,71,50
XinZhao,Jax,116,58,58,50
XinZhao,Alistar,81,36,45,44.44
XinZhao,Akali,145,79,66,54.48
XinZhao,Nilah,45,22,23,48.89
XinZhao,Milio,61,26,35,42.62
XinZhao,Ekko,95,39,56,41.05
XinZhao,Yone,233,123,110,52.79
XinZhao,Bard,44,21,23,47.73
XinZhao,FiddleSticks,105,54,51,51.43
XinZhao,Teemo,82,54,28,65.85
XinZhao,Kalista,24,18,6,75
XinZhao,Twitch,86,48,38,55.81
XinZhao,Braum,98,54,44,55.1
XinZhao,Lucian,118,68,50,57.63
XinZhao,DrMundo,56,28,28,50
XinZhao,Anivia,46,22,24,47.83
XinZhao,Tryndamere,49,20,29,40.82
XinZhao,Shen,126,65,61,51.59
XinZhao,Zed,131,66,65,50.38
XinZhao,Rengar,28,8,20,28.57
XinZhao,Tristana,115,66,49,57.39
XinZhao,Sett,180,98,82,54.44
XinZhao,Akshan,49,27,22,55.1
XinZhao,Shyvana,33,13,20,39.39
XinZhao,Taliyah,48,24,24,50
XinZhao,MissFortune,264,136,128,51.52
XinZhao,Kassadin,29,12,17,41.38
XinZhao,Senna,69,26,43,37.68
XinZhao,Mordekaiser,183,99,84,54.1
XinZhao,Volibear,136,64,72,47.06
XinZhao,Naafiri,32,19,13,59.38
XinZhao,Yuumi,119,62,57,52.1
XinZhao,Lillia,56,30,26,53.57
XinZhao,Camille,46,32,14,69.57
XinZhao,Urgot,69,33,36,47.83
XinZhao,Vi,152,68,84,44.74
XinZhao,Zeri,42,12,30,28.57
XinZhao,Viego,191,79,112,41.36
XinZhao,Jayce,87,60,27,68.97
XinZhao,Briar,76,36,40,47.37
XinZhao,Morgana,100,56,44,56
XinZhao,Yorick,81,37,44,45.68
XinZhao,Belveth,35,18,17,51.43
XinZhao,Sona,31,11,20,35.48
XinZhao,Fizz,62,32,30,51.61
XinZhao,Janna,47,11,36,23.4
XinZhao,Ambessa,121,56,65,46.28
XinZhao,Karthus,31,18,13,58.06
XinZhao,Qiyana,29,18,11,62.07
XinZhao,Syndra,73,30,43,41.1
XinZhao,Leblanc,82,26,56,31.71
XinZhao,Seraphine,80,34,46,42.5
XinZhao,Gnar,69,36,33,52.17
XinZhao,Velkoz,80,36,44,45
XinZhao,Neeko,65,37,28,56.92
XinZhao,Trundle,63,34,29,53.97
XinZhao,Xerath,135,77,58,57.04
XinZhao,Kindred,54,27,27,50
XinZhao,Olaf,16,3,13,18.75
XinZhao,KogMaw,21,13,8,61.9
XinZhao,Rakan,67,43,24,64.18
XinZhao,Renata,24,8,16,33.33
XinZhao,Nidalee,37,21,16,56.76
XinZhao,Riven,65,35,30,53.85
XinZhao,Xayah,62,31,31,50
XinZhao,Hecarim,43,28,15,65.12
XinZhao,Draven,62,35,27,56.45
XinZhao,Diana,211,118,93,55.92
XinZhao,TwistedFate,35,21,14,60
XinZhao,Annie,56,26,30,46.43
XinZhao,Sejuani,92,36,56,39.13
XinZhao,Gragas,95,46,49,48.42
XinZhao,Sivir,56,24,32,42.86
XinZhao,Orianna,75,36,39,48
XinZhao,Ryze,56,25,31,44.64
XinZhao,RekSai,22,14,8,63.64
XinZhao,Kennen,34,18,16,52.94
XinZhao,Quinn,37,13,24,35.14
XinZhao,Zilean,15,11,4,73.33
XinZhao,Kled,25,14,11,56
XinZhao,Rumble,27,9,18,33.33
Morgana,Sion,195,100,95,51.28
Morgana,Nocturne,266,121,145,45.49
Morgana,Hwei,100,46,54,46
Morgana,Jhin,393,216,177,54.96
Morgana,Soraka,92,49,43,53.26
Morgana,Jax,166,85,81,51.2
Morgana,Udyr,87,65,22,74.71
Morgana,Yone,324,202,122,62.35
Morgana,Smolder,152,84,68,55.26
Morgana,TahmKench,138,81,57,58.7
Morgana,Yasuo,345,191,154,55.36
Morgana,Shaco,203,121,82,59.61
Morgana,Azir,81,40,41,49.38
Morgana,Sylas,301,158,143,52.49
Morgana,Fiora,57,31,26,54.39
Morgana,Teemo,194,85,109,43.81
Morgana,Diana,271,140,131,51.66
Morgana,Nilah,99,40,59,40.4
Morgana,Leona,260,164,96,63.08
Morgana,Volibear,212,101,111,47.64
Morgana,LeeSin,300,169,131,56.33
Morgana,Veigar,283,127,156,44.88
Morgana,Vayne,240,93,147,38.75
Morgana,Yuumi,130,70,60,53.85
Morgana,Riven,97,45,52,46.39
Morgana,MonkeyKing,149,91,58,61.07
Morgana,Kassadin,28,15,13,53.57
Morgana,Caitlyn,433,236,197,54.5
Morgana,Taliyah,49,27,22,55.1
Morgana,Gangplank,72,39,33,54.17
Morgana,FiddleSticks,110,60,50,54.55
Morgana,Ezreal,489,291,198,59.51
Morgana,Lux,577,295,282,51.13
Morgana,Trundle,146,78,68,53.42
Morgana,Twitch,99,48,51,48.48
Morgana,Ahri,242,114,128,47.11
Morgana,Graves,113,41,72,36.28
Morgana,Lulu,277,146,131,52.71
Morgana,Cassiopeia,55,32,23,58.18
Morgana,Kaisa,311,167,144,53.7
Morgana,Mel,409,196,213,47.92
Morgana,Akali,171,95,76,55.56
Morgana,Nunu,146,89,57,60.96
Morgana,Tristana,158,91,67,57.59
Morgana,Nautilus,311,136,175,43.73
Morgana,Sett,325,188,137,57.85
Morgana,Sejuani,123,58,65,47.15
Morgana,Viktor,187,122,65,65.24
Morgana,Jinx,533,268,265,50.28
Morgana,MasterYi,189,89,100,47.09
Morgana,Warwick,287,138,149,48.08
Morgana,Pyke,173,92,81,53.18
Morgana,JarvanIV,99,35,64,35.35
Morgana,Irelia,144,87,57,60.42
Morgana,Mordekaiser,269,154,115,57.25
Morgana,Khazix,108,64,44,59.26
Morgana,Katarina,165,85,80,51.52
Morgana,Nasus,111,53,58,47.75
Morgana,Chogath,249,145,104,58.23
Morgana,Amumu,236,109,127,46.19
Morgana,AurelionSol,73,34,39,46.58
Morgana,Renekton,116,70,46,60.34
Morgana,Elise,138,77,61,55.8
Morgana,Thresh,344,189,155,54.94
Morgana,Olaf,67,32,35,47.76
Morgana,Vi,219,115,104,52.51
Morgana,Bard,54,24,30,44.44
Morgana,Ornn,116,63,53,54.31
Morgana,Ashe,404,225,179,55.69
Morgana,Garen,288,139,149,48.26
Morgana,Rammus,71,38,33,53.52
Morgana,Kayle,104,56,48,53.85
Morgana,Briar,111,45,66,40.54
Morgana,Akshan,79,38,41,48.1
Morgana,Samira,184,89,95,48.37
Morgana,Pantheon,293,138,155,47.1
Morgana,Lucian,167,99,68,59.28
Morgana,Swain,191,90,101,47.12
Morgana,Darius,310,179,131,57.74
Morgana,Syndra,129,59,70,45.74
Morgana,Xayah,120,70,50,58.33
Morgana,Rakan,139,73,66,52.52
Morgana,Kennen,47,23,24,48.94
Morgana,Vladimir,125,51,74,40.8
Morgana,Corki,79,46,33,58.23
Morgana,Kayn,256,136,120,53.13
Morgana,Neeko,98,54,44,55.1
Morgana,Zed,182,105,77,57.69
Morgana,Viego,306,165,141,53.92
Morgana,Vex,127,72,55,56.69
Morgana,Renata,41,28,13,68.29
Morgana,Illaoi,76,49,27,64.47
Morgana,Brand,119,69,50,57.98
Morgana,Ryze,71,30,41,42.25
Morgana,Jayce,97,54,43,55.67
Morgana,MissFortune,437,233,204,53.32
Morgana,Nami,148,68,80,45.95
Morgana,Ziggs,85,50,35,58.82
Morgana,Sona,48,29,19,60.42
Morgana,Zoe,90,62,28,68.89
Morgana,Zilean,65,25,40,38.46
Morgana,Varus,149,88,61,59.06
Morgana,Braum,120,63,57,52.5
Morgana,Gwen,84,46,38,54.76
Morgana,Ekko,182,80,102,43.96
Morgana,Sivir,145,59,86,40.69
Morgana,Milio,144,69,75,47.92
Morgana,KSante,136,74,62,54.41
Morgana,Skarner,74,46,28,62.16
Morgana,Rell,132,63,69,47.73
Morgana,Gragas,142,78,64,54.93
Morgana,Malzahar,228,113,115,49.56
Morgana,Quinn,83,24,59,28.92
Morgana,Galio,237,117,120,49.37
Morgana,Senna,179,111,68,62.01
Morgana,KogMaw,65,38,27,58.46
Morgana,Aurora,161,84,77,52.17
Morgana,Zac,100,50,50,50
Morgana,Xerath,167,101,66,60.48
Morgana,Yorick,185,101,84,54.59
Morgana,Blitzcrank,257,154,103,59.92
Morgana,Singed,51,27,24,52.94
Morgana,Tryndamere,108,62,46,57.41
Morgana,Karma,269,125,144,46.47
Morgana,Nidalee,53,31,22,58.49
Morgana,Rumble,79,37,42,46.84
Morgana,Zyra,188,78,110,41.49
Morgana,Orianna,78,43,35,55.13
Morgana,Poppy,129,66,63,51.16
Morgana,Draven,103,40,63,38.83
Morgana,Gnar,83,49,34,59.04
Morgana,Qiyana,52,26,26,50
Morgana,Shen,167,70,97,41.92
Morgana,Malphite,193,102,91,52.85
Morgana,Belveth,41,29,12,70.73
Morgana,Alistar,105,63,42,60
Morgana,Heimerdinger,105,51,54,48.57
Morgana,Aatrox,164,88,76,53.66
Morgana,Ambessa,103,49,54,47.57
Morgana,Ivern,41,26,15,63.41
Morgana,Seraphine,141,78,63,55.32
Morgana,Evelynn,60,27,33,45
Morgana,Shyvana,27,13,14,48.15
Morgana,Rengar,42,25,17,59.52
Morgana,Kindred,97,63,34,64.95
Morgana,Janna,70,30,40,42.86
Morgana,Hecarim,57,39,18,68.42
Morgana,Kalista,70,30,40,42.86
Morgana,Maokai,95,59,36,62.11
Morgana,Velkoz,102,69,33,67.65
Morgana,DrMundo,82,29,53,35.37
Morgana,Aphelios,96,62,34,64.58
Morgana,Camille,88,43,45,48.86
Morgana,Lissandra,76,53,23,69.74
Morgana,Kled,39,25,14,64.1
Morgana,Leblanc,117,52,65,44.44
Morgana,TwistedFate,58,30,28,51.72
Morgana,XinZhao,100,44,56,44
Morgana,Naafiri,65,39,26,60
Morgana,Urgot,84,45,39,53.57
Morgana,Zeri,73,37,36,50.68
Morgana,Lillia,127,75,52,59.06
Morgana,Talon,78,33,45,42.31
Morgana,Fizz,88,43,45,48.86
Morgana,RekSai,39,20,19,51.28
Morgana,Taric,33,14,19,42.42
Morgana,Anivia,61,33,28,54.1
Morgana,Annie,57,30,27,52.63
Morgana,Karthus,38,20,18,52.63
Karma,Sion,148,64,84,43.24
Karma,Nocturne,247,137,110,55.47
Karma,Hwei,172,86,86,50
Karma,Jhin,460,249,211,54.13
Karma,Soraka,135,57,78,42.22
Karma,Yorick,164,108,56,65.85
Karma,Teemo,213,110,103,51.64
Karma,Katarina,108,55,53,50.93
Karma,Lux,535,296,239,55.33
Karma,Sett,302,169,133,55.96
Karma,Hecarim,110,71,39,64.55
Karma,Ahri,324,146,178,45.06
Karma,Rakan,162,94,68,58.02
Karma,Draven,119,55,64,46.22
Karma,Gnar,129,72,57,55.81
Karma,Kayn,245,123,122,50.2
Karma,Mel,504,269,235,53.37
Karma,Twitch,180,90,90,50
Karma,Pantheon,395,182,213,46.08
Karma,Fiora,91,45,46,49.45
Karma,Singed,76,40,36,52.63
Karma,Yasuo,487,243,244,49.9
Karma,Caitlyn,624,333,291,53.37
Karma,Milio,190,97,93,51.05
Karma,Amumu,254,122,132,48.03
Karma,Lissandra,79,38,41,48.1
Karma,Lucian,195,114,81,58.46
Karma,Xerath,240,120,120,50
Karma,KSante,174,105,69,60.34
Karma,Viego,343,148,195,43.15
Karma,Kassadin,61,26,35,42.62
Karma,Nasus,115,46,69,40
Karma,Bard,104,52,52,50
Karma,Trundle,117,72,45,61.54
Karma,Diana,282,147,135,52.13
Karma,Veigar,238,106,132,44.54
Karma,Ashe,530,245,285,46.23
Karma,Braum,211,72,139,34.12
Karma,Olaf,58,34,24,58.62
Karma,Nidalee,97,56,41,57.73
Karma,Ryze,112,60,52,53.57
Karma,Brand,91,67,24,73.63
Karma,Darius,427,204,223,47.78
Karma,Aurora,209,116,93,55.5
Karma,Corki,123,75,48,60.98
Karma,Briar,169,74,95,43.79
Karma,Sejuani,140,67,73,47.86
Karma,Shaco,189,107,82,56.61
Karma,Ekko,161,96,65,59.63
Karma,Kaisa,352,179,173,50.85
Karma,Neeko,106,53,53,50
Karma,Gangplank,132,64,68,48.48
Karma,XinZhao,145,77,68,53.1
Karma,Azir,131,57,74,43.51
Karma,Lillia,116,51,65,43.97
Karma,Camille,112,60,52,53.57
Karma,Senna,117,55,62,47.01
Karma,Kindred,85,65,20,76.47
Karma,Elise,212,131,81,61.79
Karma,Quinn,84,46,38,54.76
Karma,Nautilus,292,152,140,52.05
Karma,Riven,135,60,75,44.44
Karma,Shyvana,69,23,46,33.33
Karma,Velkoz,117,64,53,54.7
Karma,Mordekaiser,239,106,133,44.35
Karma,Jinx,508,248,260,48.82
Karma,Blitzcrank,205,110,95,53.66
Karma,Akali,223,119,104,53.36
Karma,Zoe,115,61,54,53.04
Karma,Thresh,462,207,255,44.81
Karma,Kayle,131,50,81,38.17
Karma,MonkeyKing,150,62,88,41.33
Karma,Vex,147,70,77,47.62
Karma,Leblanc,154,67,87,43.51
Karma,JarvanIV,182,77,105,42.31
Karma,Vladimir,147,61,86,41.5
Karma,Ziggs,107,40,67,37.38
Karma,Nami,309,126,183,40.78
Karma,Evelynn,90,47,43,52.22
Karma,Fizz,87,40,47,45.98
Karma,MissFortune,472,205,267,43.43
Karma,Galio,294,159,135,54.08
Karma,Vayne,257,107,150,41.63
Karma,Lulu,435,241,194,55.4
Karma,Rumble,73,37,36,50.68
Karma,Warwick,279,127,152,45.52
Karma,Ezreal,670,316,354,47.16
Karma,Qiyana,56,24,32,42.86
Karma,Kalista,57,28,29,49.12
Karma,Heimerdinger,69,36,33,52.17
Karma,Vi,270,126,144,46.67
Karma,RekSai,64,33,31,51.56
Karma,Yone,371,203,168,54.72
Karma,Malzahar,221,107,114,48.42
Karma,Ivern,79,49,30,62.03
Karma,LeeSin,466,241,225,51.72
Karma,Sylas,369,230,139,62.33
Karma,Volibear,181,101,80,55.8
Karma,Talon,112,47,65,41.96
Karma,Ornn,128,49,79,38.28
Karma,TahmKench,197,103,94,52.28
Karma,Leona,195,97,98,49.74
Karma,Taliyah,58,27,31,46.55
Karma,Seraphine,174,80,94,45.98
Karma,Graves,161,70,91,43.48
Karma,Sona,34,16,18,47.06
Karma,Yuumi,195,100,95,51.28
Karma,Garen,351,158,193,45.01
Karma,Zac,138,58,80,42.03
Karma,Pyke,208,118,90,56.73
Karma,Tristana,178,109,69,61.24
Karma,Gwen,100,46,54,46
Karma,Khazix,117,65,52,55.56
Karma,Malphite,240,114,126,47.5
Karma,Irelia,186,111,75,59.68
Karma,Zeri,116,65,51,56.03
Karma,Swain,207,79,128,38.16
Karma,DrMundo,98,48,50,48.98
Karma,Shen,159,79,80,49.69
Karma,Morgana,269,144,125,53.53
Karma,Ambessa,210,93,117,44.29
Karma,Varus,219,114,105,52.05
Karma,Jayce,150,72,78,48
Karma,Aatrox,230,130,100,56.52
Karma,Viktor,234,110,124,47.01
Karma,Zyra,194,77,117,39.69
Karma,FiddleSticks,105,53,52,50.48
Karma,Urgot,108,50,58,46.3
Karma,Maokai,118,54,64,45.76
Karma,Rell,157,83,74,52.87
Karma,Chogath,308,147,161,47.73
Karma,Karthus,67,28,39,41.79
Karma,Taric,43,18,25,41.86
Karma,TwistedFate,101,57,44,56.44
Karma,Sivir,149,75,74,50.34
Karma,AurelionSol,85,36,49,42.35
Karma,Poppy,172,86,86,50
Karma,Jax,229,117,112,51.09
Karma,MasterYi,206,108,98,52.43
Karma,Zed,272,133,139,48.9
Karma,Udyr,91,57,34,62.64
Karma,Aphelios,125,52,73,41.6
Karma,Xayah,143,81,62,56.64
Karma,Gragas,166,79,87,47.59
Karma,Renekton,135,79,56,58.52
Karma,Illaoi,111,52,59,46.85
Karma,Tryndamere,101,46,55,45.54
Karma,Alistar,120,58,62,48.33
Karma,Orianna,140,70,70,50
Karma,Smolder,152,74,78,48.68
Karma,Syndra,195,122,73,62.56
Karma,Janna,83,42,41,50.6
Karma,Cassiopeia,67,30,37,44.78
Karma,Renata,51,24,27,47.06
Karma,Nilah,68,23,45,33.82
Karma,Belveth,52,14,38,26.92
Karma,KogMaw,60,31,29,51.67
Karma,Rammus,75,27,48,36
Karma,Samira,110,59,51,53.64
Karma,Rengar,58,31,27,53.45
Karma,Naafiri,49,32,17,65.31
Karma,Zilean,96,41,55,42.71
Karma,Nunu,121,58,63,47.93
Karma,Skarner,108,50,58,46.3
Karma,Akshan,74,32,42,43.24
Karma,Kled,32,14,18,43.75
Karma,Kennen,56,27,29,48.21
Karma,Annie,84,46,38,54.76
Karma,Anivia,76,42,34,55.26
Sion,Kayn,215,112,103,52.09
Sion,XinZhao,107,59,48,55.14
Sion,Morgana,195,95,100,48.72
Sion,Jinx,401,187,214,46.63
Sion,Karma,148,84,64,56.76
Sion,Teemo,245,153,92,62.45
Sion,Viego,226,104,122,46.02
Sion,Anivia,66,32,34,48.48
Sion,MissFortune,328,159,169,48.48
Sion,TahmKench,128,72,56,56.25
Sion,Ekko,123,68,55,55.28
Sion,Sivir,80,51,29,63.75
Sion,Velkoz,109,56,53,51.38
Sion,Kayle,99,42,57,42.42
Sion,Yasuo,329,189,140,57.45
Sion,Jhin,352,176,176,50
Sion,Braum,118,69,49,58.47
Sion,Darius,294,148,146,50.34
Sion,LeeSin,307,158,149,51.47
Sion,Katarina,86,38,48,44.19
Sion,Caitlyn,490,259,231,52.86
Sion,Nami,199,115,84,57.79
Sion,Shen,153,79,74,51.63
Sion,Shaco,157,91,66,57.96
Sion,AurelionSol,83,36,47,43.37
Sion,Brand,107,49,58,45.79
Sion,Warwick,196,104,92,53.06
Sion,Ahri,229,128,101,55.9
Sion,Hwei,91,51,40,56.04
Sion,Nasus,129,44,85,34.11
Sion,Pantheon,260,135,125,51.92
Sion,Viktor,126,71,55,56.35
Sion,Ashe,323,171,152,52.94
Sion,Milio,123,62,61,50.41
Sion,Tryndamere,60,38,22,63.33
Sion,Gragas,149,83,66,55.7
Sion,Aurora,109,72,37,66.06
Sion,Vayne,234,94,140,40.17
Sion,Senna,112,60,52,53.57
Sion,Ambessa,136,80,56,58.82
Sion,Udyr,69,27,42,39.13
Sion,Syndra,119,64,55,53.78
Sion,Corki,110,67,43,60.91
Sion,Alistar,71,40,31,56.34
Sion,Yone,324,158,166,48.77
Sion,Vi,234,123,111,52.56
Sion,Mel,386,199,187,51.55
Sion,Garen,240,116,124,48.33
Sion,Yorick,126,72,54,57.14
Sion,Xayah,121,67,54,55.37
Sion,Rakan,93,58,35,62.37
Sion,Rammus,65,29,36,44.62
Sion,Zyra,177,105,72,59.32
Sion,Elise,154,91,63,59.09
Sion,Kaisa,248,162,86,65.32
Sion,Vex,103,53,50,51.46
Sion,Veigar,195,77,118,39.49
Sion,Smolder,149,66,83,44.3
Sion,Nautilus,258,136,122,52.71
Sion,Aatrox,160,75,85,46.88
Sion,DrMundo,83,47,36,56.63
Sion,Qiyana,49,24,25,48.98
Sion,Zeri,80,37,43,46.25
Sion,Gnar,86,51,35,59.3
Sion,Malzahar,210,108,102,51.43
Sion,Maokai,78,54,24,69.23
Sion,Zoe,71,39,32,54.93
Sion,Ezreal,422,221,201,52.37
Sion,Renekton,72,32,40,44.44
Sion,Galio,198,115,83,58.08
Sion,Varus,156,70,86,44.87
Sion,FiddleSticks,63,24,39,38.1
Sion,Poppy,138,62,76,44.93
Sion,Khazix,80,63,17,78.75
Sion,Lulu,231,125,106,54.11
Sion,Riven,64,30,34,46.88
Sion,Gangplank,73,35,38,47.95
Sion,Kassadin,40,23,17,57.5
Sion,Aphelios,87,35,52,40.23
Sion,Chogath,248,127,121,51.21
Sion,TwistedFate,66,47,19,71.21
Sion,Nilah,48,25,23,52.08
Sion,Thresh,379,183,196,48.28
Sion,Talon,103,55,48,53.4
Sion,Diana,224,105,119,46.88
Sion,Mordekaiser,242,100,142,41.32
Sion,Gwen,181,80,101,44.2
Sion,Lucian,139,73,66,52.52
Sion,MonkeyKing,140,75,65,53.57
Sion,Lux,422,218,204,51.66
Sion,Zac,152,70,82,46.05
Sion,Samira,146,83,63,56.85
Sion,Leona,183,83,100,45.36
Sion,Ivern,44,17,27,38.64
Sion,Sett,329,148,181,44.98
Sion,Nocturne,153,96,57,62.75
Sion,Sejuani,117,53,64,45.3
Sion,Blitzcrank,138,78,60,56.52
Sion,Graves,104,49,55,47.12
Sion,Fizz,87,55,32,63.22
Sion,Neeko,67,30,37,44.78
Sion,Yuumi,108,56,52,51.85
Sion,Amumu,218,110,108,50.46
Sion,Xerath,134,65,69,48.51
Sion,Irelia,109,47,62,43.12
Sion,Zilean,60,21,39,35
Sion,Jax,118,60,58,50.85
Sion,Cassiopeia,60,37,23,61.67
Sion,Urgot,87,52,35,59.77
Sion,Kled,31,11,20,35.48
Sion,Kindred,70,36,34,51.43
Sion,Lissandra,51,27,24,52.94
Sion,Akali,121,61,60,50.41
Sion,Evelynn,50,25,25,50
Sion,Leblanc,65,36,29,55.38
Sion,Taric,43,14,29,32.56
Sion,Ornn,95,46,49,48.42
Sion,Karthus,64,32,32,50
Sion,Volibear,201,99,102,49.25
Sion,Swain,146,73,73,50
Sion,Vladimir,82,37,45,45.12
Sion,Singed,52,32,20,61.54
Sion,Ryze,69,32,37,46.38
Sion,Trundle,100,53,47,53
Sion,Skarner,87,54,33,62.07
Sion,Twitch,102,52,50,50.98
Sion,Sylas,240,146,94,60.83
Sion,Taliyah,34,18,16,52.94
Sion,Rell,187,101,86,54.01
Sion,Nidalee,47,24,23,51.06
Sion,Camille,58,27,31,46.55
Sion,Orianna,72,41,31,56.94
Sion,Malphite,212,115,97,54.25
Sion,JarvanIV,115,42,73,36.52
Sion,Kennen,50,26,24,52
Sion,MasterYi,129,60,69,46.51
Sion,Tristana,149,74,75,49.66
Sion,RekSai,34,20,14,58.82
Sion,Quinn,63,33,30,52.38
Sion,Naafiri,51,30,21,58.82
Sion,Akshan,51,19,32,37.25
Sion,Illaoi,80,40,40,50
Sion,Draven,77,41,36,53.25
Sion,Briar,95,52,43,54.74
Sion,Sona,31,20,11,64.52
Sion,Belveth,40,21,19,52.5
Sion,Pyke,149,72,77,48.32
Sion,Zed,173,80,93,46.24
Sion,Hecarim,64,44,20,68.75
Sion,Ziggs,79,40,39,50.63
Sion,Jayce,87,45,42,51.72
Sion,Rengar,50,21,29,42
Sion,Shyvana,28,14,14,50
Sion,KogMaw,53,24,29,45.28
Sion,Nunu,116,74,42,63.79
Sion,Lillia,74,30,44,40.54
Sion,Heimerdinger,76,42,34,55.26
Sion,Fiora,56,26,30,46.43
Sion,Azir,63,32,31,50.79
Sion,Soraka,54,35,19,64.81
Sion,Janna,47,15,32,31.91
Sion,Seraphine,115,45,70,39.13
Sion,Renata,20,18,2,90
Sion,Rumble,54,39,15,72.22
Sion,Kalista,54,26,28,48.15
Sion,Annie,54,23,31,42.59
Sion,KSante,95,39,56,41.05
Sion,Olaf,39,11,28,28.21
Sion,Bard,45,28,17,62.22
Nocturne,Kayn,241,141,100,58.51
Nocturne,XinZhao,171,62,109,36.26
Nocturne,Morgana,266,145,121,54.51
Nocturne,Jinx,558,288,270,51.61
Nocturne,Karma,247,110,137,44.53
Nocturne,Maokai,123,65,58,52.85
Nocturne,Viego,307,165,142,53.75
Nocturne,Viktor,274,141,133,51.46
Nocturne,Smolder,174,97,77,55.75
Nocturne,Nami,267,138,129,51.69
Nocturne,Sett,272,132,140,48.53
Nocturne,Kindred,98,29,69,29.59
Nocturne,Mel,471,273,198,57.96
Nocturne,Twitch,137,65,72,47.45
Nocturne,Lulu,389,211,178,54.24
Nocturne,Aatrox,258,144,114,55.81
Nocturne,Lillia,175,92,83,52.57
Nocturne,Hwei,158,74,84,46.84
Nocturne,Ashe,389,193,196,49.61
Nocturne,Amumu,234,127,107,54.27
Nocturne,Ambessa,171,89,82,52.05
Nocturne,Graves,176,79,97,44.89
Nocturne,Ahri,309,137,172,44.34
Nocturne,AurelionSol,92,43,49,46.74
Nocturne,Rakan,140,72,68,51.43
Nocturne,Malphite,278,133,145,47.84
Nocturne,Briar,183,96,87,52.46
Nocturne,Zed,232,115,117,49.57
Nocturne,Ezreal,618,326,292,52.75
Nocturne,Seraphine,179,96,83,53.63
Nocturne,Heimerdinger,100,48,52,48
Nocturne,LeeSin,461,265,196,57.48
Nocturne,Leona,242,125,117,51.65
Nocturne,Chogath,292,146,146,50
Nocturne,Yasuo,482,264,218,54.77
Nocturne,Sivir,138,66,72,47.83
Nocturne,Brand,133,73,60,54.89
Nocturne,Nasus,116,73,43,62.93
Nocturne,MasterYi,217,89,128,41.01
Nocturne,Anivia,89,32,57,35.96
Nocturne,Vayne,272,117,155,43.01
Nocturne,Yuumi,208,97,111,46.63
Nocturne,Trundle,115,55,60,47.83
Nocturne,Khazix,68,34,34,50
Nocturne,Aurora,187,93,94,49.73
Nocturne,Varus,195,106,89,54.36
Nocturne,Pantheon,389,253,136,65.04
Nocturne,Renekton,93,56,37,60.22
Nocturne,Illaoi,104,42,62,40.38
Nocturne,Nunu,193,98,95,50.78
Nocturne,Lux,487,252,235,51.75
Nocturne,MissFortune,443,191,252,43.12
Nocturne,Rell,153,66,87,43.14
Nocturne,Sejuani,146,69,77,47.26
Nocturne,Ekko,168,90,78,53.57
Nocturne,Shaco,197,111,86,56.35
Nocturne,Kennen,67,26,41,38.81
Nocturne,Vladimir,123,45,78,36.59
Nocturne,Corki,141,68,73,48.23
Nocturne,Bard,85,42,43,49.41
Nocturne,Kayle,115,61,54,53.04
Nocturne,Mordekaiser,314,173,141,55.1
Nocturne,Aphelios,128,65,63,50.78
Nocturne,Gragas,174,106,68,60.92
Nocturne,Vex,131,62,69,47.33
Nocturne,Jhin,424,231,193,54.48
Nocturne,Renata,54,22,32,40.74
Nocturne,Yorick,225,120,105,53.33
Nocturne,Sylas,362,174,188,48.07
Nocturne,Samira,126,73,53,57.94
Nocturne,Karthus,77,47,30,61.04
Nocturne,Zeri,98,39,59,39.8
Nocturne,Ryze,81,46,35,56.79
Nocturne,Braum,167,90,77,53.89
Nocturne,Gwen,122,59,63,48.36
Nocturne,Hecarim,81,38,43,46.91
Nocturne,Garen,422,198,224,46.92
Nocturne,Leblanc,149,94,55,63.09
Nocturne,Darius,389,200,189,51.41
Nocturne,Gangplank,124,69,55,55.65
Nocturne,Zilean,67,34,33,50.75
Nocturne,Akali,203,102,101,50.25
Nocturne,Volibear,276,130,146,47.1
Nocturne,Lissandra,89,45,44,50.56
Nocturne,Veigar,246,118,128,47.97
Nocturne,Soraka,102,66,36,64.71
Nocturne,Warwick,333,168,165,50.45
Nocturne,Yone,390,180,210,46.15
Nocturne,Tristana,204,108,96,52.94
Nocturne,Zyra,161,69,92,42.86
Nocturne,Zac,148,84,64,56.76
Nocturne,Akshan,81,38,43,46.91
Nocturne,DrMundo,143,81,62,56.64
Nocturne,Senna,141,77,64,54.61
Nocturne,Shen,166,79,87,47.59
Nocturne,Annie,68,47,21,69.12
Nocturne,Poppy,159,65,94,40.88
Nocturne,Syndra,182,91,91,50
Nocturne,Caitlyn,594,338,256,56.9
Nocturne,Diana,344,152,192,44.19
Nocturne,Camille,70,42,28,60
Nocturne,Xayah,126,71,55,56.35
Nocturne,Blitzcrank,211,99,112,46.92
Nocturne,Taliyah,51,33,18,64.71
Nocturne,Talon,111,53,58,47.75
Nocturne,Nautilus,303,173,130,57.1
Nocturne,KSante,179,96,83,53.63
Nocturne,Evelynn,72,32,40,44.44
Nocturne,Singed,78,30,48,38.46
Nocturne,Cassiopeia,55,27,28,49.09
Nocturne,Sona,44,23,21,52.27
Nocturne,Olaf,61,30,31,49.18
Nocturne,Malzahar,265,154,111,58.11
Nocturne,Xerath,177,99,78,55.93
Nocturne,Ornn,140,64,76,45.71
Nocturne,Taric,43,24,19,55.81
Nocturne,Swain,231,117,114,50.65
Nocturne,Rengar,73,31,42,42.47
Nocturne,MonkeyKing,212,125,87,58.96
Nocturne,Jax,155,79,76,50.97
Nocturne,Teemo,211,135,76,63.98
Nocturne,Lucian,212,114,98,53.77
Nocturne,TahmKench,196,86,110,43.88
Nocturne,Galio,219,101,118,46.12
Nocturne,Rumble,61,38,23,62.3
Nocturne,Neeko,101,64,37,63.37
Nocturne,Sion,153,57,96,37.25
Nocturne,Orianna,146,69,77,47.26
Nocturne,Urgot,125,55,70,44
Nocturne,Kalista,75,38,37,50.67
Nocturne,Skarner,105,47,58,44.76
Nocturne,Irelia,163,81,82,49.69
Nocturne,Thresh,393,203,190,51.65
Nocturne,Shyvana,42,18,24,42.86
Nocturne,Milio,104,48,56,46.15
Nocturne,Elise,197,97,100,49.24
Nocturne,Pyke,166,68,98,40.96
Nocturne,Alistar,118,59,59,50
Nocturne,Fizz,85,37,48,43.53
Nocturne,Kaisa,379,174,205,45.91
Nocturne,Udyr,90,57,33,63.33
Nocturne,Riven,113,50,63,44.25
Nocturne,Jayce,103,62,41,60.19
Nocturne,Ivern,39,20,19,51.28
Nocturne,KogMaw,56,33,23,58.93
Nocturne,Rammus,96,46,50,47.92
Nocturne,Naafiri,60,43,17,71.67
Nocturne,Ziggs,86,15,71,17.44
Nocturne,Kassadin,50,24,26,48
Nocturne,Fiora,60,33,27,55
Nocturne,TwistedFate,66,37,29,56.06
Nocturne,Janna,49,24,25,48.98
Nocturne,JarvanIV,170,71,99,41.76
Nocturne,Nilah,89,39,50,43.82
Nocturne,Vi,255,120,135,47.06
Nocturne,Tryndamere,73,34,39,46.58
Nocturne,Gnar,107,58,49,54.21
Nocturne,Katarina,129,61,68,47.29
Nocturne,Velkoz,99,46,53,46.46
Nocturne,RekSai,43,21,22,48.84
Nocturne,Draven,116,67,49,57.76
Nocturne,Zoe,72,41,31,56.94
Nocturne,Quinn,94,52,42,55.32
Nocturne,Kled,22,10,12,45.45
Nocturne,FiddleSticks,86,46,40,53.49
Nocturne,Qiyana,41,13,28,31.71
Nocturne,Nidalee,75,36,39,48
Nocturne,Azir,91,50,41,54.95
Nocturne,Belveth,36,16,20,44.44
Jhin,Kayn,484,206,278,42.56
Jhin,XinZhao,229,87,142,37.99
Jhin,Morgana,393,177,216,45.04
Jhin,Jinx,956,450,506,47.07
Jhin,Karma,460,211,249,45.87
Jhin,Chogath,487,252,235,51.75
Jhin,Lillia,247,103,144,41.7
Jhin,Tryndamere,128,59,69,46.09
Jhin,Caitlyn,1240,591,649,47.66
Jhin,Renekton,243,125,118,51.44
Jhin,Udyr,165,93,72,56.36
Jhin,Qiyana,102,72,30,70.59
Jhin,Xayah,200,69,131,34.5
Jhin,Garen,557,244,313,43.81
Jhin,Shaco,346,197,149,56.94
Jhin,Tristana,373,173,200,46.38
Jhin,Ezreal,1006,486,520,48.31
Jhin,Swain,345,144,201,41.74
Jhin,Gnar,217,130,87,59.91
Jhin,Mel,879,428,451,48.69
Jhin,Twitch,288,153,135,53.13
Jhin,Pantheon,657,348,309,52.97
Jhin,Trundle,172,85,87,49.42
Jhin,Sylas,564,273,291,48.4
Jhin,Zac,209,94,115,44.98
Jhin,MissFortune,768,363,405,47.27
Jhin,Seraphine,271,108,163,39.85
Jhin,Aatrox,377,195,182,51.72
Jhin,JarvanIV,245,99,146,40.41
Jhin,Yuumi,245,127,118,51.84
Jhin,Warwick,541,235,306,43.44
Jhin,Ahri,490,266,224,54.29
Jhin,Milio,276,113,163,40.94
Jhin,Fiora,171,92,79,53.8
Jhin,Singed,94,45,49,47.87
Jhin,Yasuo,782,404,378,51.66
Jhin,Teemo,356,166,190,46.63
Jhin,Amumu,450,231,219,51.33
Jhin,Lissandra,141,78,63,55.32
Jhin,Lucian,359,196,163,54.6
Jhin,Xerath,336,153,183,45.54
Jhin,Sion,352,176,176,50
Jhin,TwistedFate,135,74,61,54.81
Jhin,Lux,845,464,381,54.91
Jhin,Lulu,527,270,257,51.23
Jhin,Aphelios,236,129,107,54.66
Jhin,Karthus,101,46,55,45.54
Jhin,TahmKench,352,161,191,45.74
Jhin,Veigar,393,192,201,48.85
Jhin,Irelia,231,138,93,59.74
Jhin,Vladimir,221,100,121,45.25
Jhin,Ashe,748,391,357,52.27
Jhin,Rell,281,147,134,52.31
Jhin,Rammus,146,62,84,42.47
Jhin,Leblanc,231,109,122,47.19
Jhin,Sett,564,290,274,51.42
Jhin,Diana,518,232,286,44.79
Jhin,KogMaw,114,61,53,53.51
Jhin,Ambessa,268,96,172,35.82
Jhin,Ekko,333,146,187,43.84
Jhin,Soraka,162,83,79,51.23
Jhin,Illaoi,174,89,85,51.15
Jhin,Rakan,212,112,100,52.83
Jhin,Elise,297,141,156,47.47
Jhin,Zed,375,187,188,49.87
Jhin,Kaisa,536,246,290,45.9
Jhin,Kindred,152,79,73,51.97
Jhin,Syndra,287,138,149,48.08
Jhin,Braum,271,110,161,40.59
Jhin,Heimerdinger,176,101,75,57.39
Jhin,Nunu,215,96,119,44.65
Jhin,Alistar,177,82,95,46.33
Jhin,MasterYi,342,169,173,49.42
Jhin,Fizz,226,106,120,46.9
Jhin,Thresh,597,295,302,49.41
Jhin,Darius,605,277,328,45.79
Jhin,Vex,218,99,119,45.41
Jhin,Brand,206,115,91,55.83
Jhin,Ornn,221,107,114,48.42
Jhin,Jax,346,177,169,51.16
Jhin,Janna,127,53,74,41.73
Jhin,Evelynn,123,48,75,39.02
Jhin,LeeSin,626,353,273,56.39
Jhin,Nasus,219,83,136,37.9
Jhin,Nami,414,222,192,53.62
Jhin,Gragas,253,134,119,52.96
Jhin,Olaf,71,35,36,49.3
Jhin,Graves,227,103,124,45.37
Jhin,Zoe,155,94,61,60.65
Jhin,Zyra,320,171,149,53.44
Jhin,Vi,384,191,193,49.74
Jhin,Kennen,128,80,48,62.5
Jhin,Varus,385,195,190,50.65
Jhin,Renata,99,47,52,47.47
Jhin,Volibear,454,245,209,53.96
Jhin,Katarina,233,145,88,62.23
Jhin,Gwen,169,85,84,50.3
Jhin,Nocturne,424,193,231,45.52
Jhin,Aurora,286,151,135,52.8
Jhin,Annie,140,69,71,49.29
Jhin,Akali,366,190,176,51.91
Jhin,DrMundo,141,62,79,43.97
Jhin,Orianna,174,67,107,38.51
Jhin,Sivir,236,122,114,51.69
Jhin,Zeri,131,44,87,33.59
Jhin,Skarner,167,86,81,51.5
Jhin,Viktor,329,147,182,44.68
Jhin,AurelionSol,139,62,77,44.6
Jhin,Rumble,142,88,54,61.97
Jhin,Maokai,166,71,95,42.77
Jhin,Mordekaiser,442,227,215,51.36
Jhin,Yone,661,315,346,47.66
Jhin,Senna,252,129,123,51.19
Jhin,Yorick,328,174,154,53.05
Jhin,Corki,209,103,106,49.28
Jhin,Sona,78,33,45,42.31
Jhin,Urgot,196,81,115,41.33
Jhin,Blitzcrank,349,163,186,46.7
Jhin,Briar,234,100,134,42.74
Jhin,Rengar,115,48,67,41.74
Jhin,Gangplank,167,100,67,59.88
Jhin,Hwei,272,145,127,53.31
Jhin,Zilean,125,72,53,57.6
Jhin,Malzahar,385,187,198,48.57
Jhin,Camille,147,75,72,51.02
Jhin,Smolder,314,171,143,54.46
Jhin,Riven,147,57,90,38.78
Jhin,Malphite,415,222,193,53.49
Jhin,MonkeyKing,210,103,107,49.05
Jhin,Talon,154,97,57,62.99
Jhin,Ivern,104,57,47,54.81
Jhin,Viego,509,269,240,52.85
Jhin,Neeko,211,117,94,55.45
Jhin,Nautilus,504,245,259,48.61
Jhin,Kayle,212,117,95,55.19
Jhin,Samira,340,192,148,56.47
Jhin,FiddleSticks,177,82,95,46.33
Jhin,Taric,94,43,51,45.74
Jhin,Poppy,291,131,160,45.02
Jhin,Cassiopeia,109,46,63,42.2
Jhin,Vayne,559,268,291,47.94
Jhin,Velkoz,215,97,118,45.12
Jhin,Naafiri,86,52,34,60.47
Jhin,Kled,72,29,43,40.28
Jhin,RekSai,49,23,26,46.94
Jhin,Galio,381,146,235,38.32
Jhin,Nidalee,176,103,73,58.52
Jhin,Shen,260,129,131,49.62
Jhin,Khazix,182,89,93,48.9
Jhin,Kassadin,40,18,22,45
Jhin,Anivia,122,48,74,39.34
Jhin,Pyke,308,184,124,59.74
Jhin,Ryze,138,67,71,48.55
Jhin,Azir,137,77,60,56.2
Jhin,KSante,289,139,150,48.1
Jhin,Bard,108,51,57,47.22
Jhin,Quinn,113,56,57,49.56
Jhin,Taliyah,93,46,47,49.46
Jhin,Leona,359,170,189,47.35
Jhin,Ziggs,128,68,60,53.13
Jhin,Kalista,122,64,58,52.46
Jhin,Draven,174,102,72,58.62
Jhin,Sejuani,208,93,115,44.71
Jhin,Shyvana,74,36,38,48.65
Jhin,Belveth,66,30,36,45.45
Jhin,Hecarim,152,79,73,51.97
Jhin,Akshan,114,57,57,50
Jhin,Nilah,138,67,71,48.55
Jhin,Jayce,198,81,117,40.91
Soraka,Kayn,136,88,48,64.71
Soraka,XinZhao,62,39,23,62.9
Soraka,Morgana,92,43,49,46.74
Soraka,Jinx,244,88,156,36.07
Soraka,Karma,135,78,57,57.78
Soraka,Gnar,61,28,33,45.9
Soraka,Evelynn,26,14,12,53.85
Soraka,Malphite,113,38,75,33.63
Soraka,Lucian,64,40,24,62.5
Soraka,Mel,185,93,92,50.27
Soraka,Garen,127,55,72,43.31
Soraka,Warwick,150,73,77,48.67
Soraka,Ahri,109,61,48,55.96
Soraka,Milio,65,27,38,41.54
Soraka,Riven,57,28,29,49.12
Soraka,Karthus,29,17,12,58.62
Soraka,Nami,107,52,55,48.6
Soraka,KSante,66,38,28,57.58
Soraka,Nunu,64,33,31,51.56
Soraka,Akshan,29,15,14,51.72
Soraka,Ziggs,39,14,25,35.9
Soraka,Seraphine,91,50,41,54.95
Soraka,Gangplank,58,26,32,44.83
Soraka,Shaco,90,45,45,50
Soraka,Veigar,101,64,37,63.37
Soraka,Yuumi,84,26,58,30.95
Soraka,Katarina,45,15,30,33.33
Soraka,Taric,29,18,11,62.07
Soraka,Zed,87,40,47,45.98
Soraka,FiddleSticks,40,15,25,37.5
Soraka,Lillia,58,21,37,36.21
Soraka,Diana,101,49,52,48.51
Soraka,Twitch,75,34,41,45.33
Soraka,Bard,46,24,22,52.17
Soraka,Ryze,40,23,17,57.5
Soraka,Leona,98,46,52,46.94
Soraka,Xayah,61,24,37,39.34
Soraka,Naafiri,41,12,29,29.27
Soraka,Vayne,85,41,44,48.24
Soraka,Lux,288,149,139,51.74
Soraka,Renekton,52,30,22,57.69
Soraka,JarvanIV,87,40,47,45.98
Soraka,Jhin,162,79,83,48.77
Soraka,Janna,24,9,15,37.5
Soraka,Malzahar,89,50,39,56.18
Soraka,Yasuo,196,106,90,54.08
Soraka,Gragas,63,35,28,55.56
Soraka,Ezreal,201,107,94,53.23
Soraka,Lulu,194,75,119,38.66
Soraka,DrMundo,54,26,28,48.15
Soraka,MasterYi,91,47,44,51.65
Soraka,Vladimir,36,16,20,44.44
Soraka,Caitlyn,252,126,126,50
Soraka,Thresh,136,66,70,48.53
Soraka,Sejuani,55,29,26,52.73
Soraka,Akali,82,38,44,46.34
Soraka,Illaoi,39,11,28,28.21
Soraka,MissFortune,148,73,75,49.32
Soraka,Rell,52,18,34,34.62
Soraka,Qiyana,32,13,19,40.63
Soraka,Jax,63,25,38,39.68
Soraka,Mordekaiser,111,49,62,44.14
Soraka,Chogath,159,68,91,42.77
Soraka,Ashe,158,89,69,56.33
Soraka,Ornn,56,18,38,32.14
Soraka,Sylas,91,48,43,52.75
Soraka,Pyke,93,47,46,50.54
Soraka,Yone,162,76,86,46.91
Soraka,Draven,57,24,33,42.11
Soraka,Rammus,48,30,18,62.5
Soraka,Pantheon,116,71,45,61.21
Soraka,Volibear,101,48,53,47.52
Soraka,Rakan,39,10,29,25.64
Soraka,Orianna,48,28,20,58.33
Soraka,Swain,81,39,42,48.15
Soraka,Viego,137,45,92,32.85
Soraka,Sett,145,80,65,55.17
Soraka,Velkoz,52,24,28,46.15
Soraka,Irelia,52,32,20,61.54
Soraka,Nocturne,102,36,66,35.29
Soraka,Galio,75,34,41,45.33
Soraka,Camille,45,27,18,60
Soraka,Darius,129,66,63,51.16
Soraka,Varus,89,33,56,37.08
Soraka,Zac,65,39,26,60
Soraka,Xerath,102,52,50,50.98
Soraka,Brand,56,36,20,64.29
Soraka,Viktor,106,52,54,49.06
Soraka,Khazix,39,26,13,66.67
Soraka,Aurora,79,38,41,48.1
Soraka,Kindred,35,20,15,57.14
Soraka,Graves,62,35,27,56.45
Soraka,Trundle,52,31,21,59.62
Soraka,AurelionSol,44,22,22,50
Soraka,Tristana,75,38,37,50.67
Soraka,LeeSin,115,53,62,46.09
Soraka,Nautilus,101,44,57,43.56
Soraka,Sona,16,12,4,75
Soraka,MonkeyKing,59,30,29,50.85
Soraka,Azir,37,9,28,24.32
Soraka,Jayce,57,25,32,43.86
Soraka,Vex,34,12,22,35.29
Soraka,Heimerdinger,34,17,17,50
Soraka,Amumu,86,32,54,37.21
Soraka,Lissandra,36,21,15,58.33
Soraka,Sivir,50,28,22,56
Soraka,Corki,44,20,24,45.45
Soraka,Vi,103,49,54,47.57
Soraka,Fizz,42,21,21,50
Soraka,Zilean,19,12,7,63.16
Soraka,Olaf,27,11,16,40.74
Soraka,Yorick,64,37,27,57.81
Soraka,Elise,93,51,42,54.84
Soraka,Rengar,20,9,11,45
Soraka,Nidalee,47,25,22,53.19
Soraka,Alistar,27,19,8,70.37
Soraka,TahmKench,101,44,57,43.56
Soraka,Teemo,126,73,53,57.94
Soraka,Neeko,42,26,16,61.9
Soraka,Skarner,31,20,11,64.52
Soraka,Gwen,31,18,13,58.06
Soraka,Kled,11,3,8,27.27
Soraka,Briar,59,31,28,52.54
Soraka,Talon,38,25,13,65.79
Soraka,Zyra,67,43,24,64.18
Soraka,Ambessa,36,19,17,52.78
Soraka,Nasus,82,37,45,45.12
Soraka,Kaisa,143,69,74,48.25
Soraka,Udyr,25,13,12,52
Soraka,Samira,71,30,41,42.25
Soraka,Nilah,21,8,13,38.1
Soraka,Aatrox,90,50,40,55.56
Soraka,Zoe,13,5,8,38.46
Soraka,Braum,74,40,34,54.05
Soraka,Kassadin,26,5,21,19.23
Soraka,Kayle,49,25,24,51.02
Soraka,Hwei,41,14,27,34.15
Soraka,Poppy,51,20,31,39.22
Soraka,Hecarim,37,9,28,24.32
Soraka,Rumble,19,8,11,42.11
Soraka,Urgot,50,28,22,56
Soraka,Leblanc,71,34,37,47.89
Soraka,Singed,30,20,10,66.67
Soraka,Quinn,30,19,11,63.33
Soraka,Ekko,79,41,38,51.9
Soraka,Shen,60,20,40,33.33
Soraka,Tryndamere,37,11,26,29.73
Soraka,Senna,71,37,34,52.11
Soraka,Shyvana,16,0,16,0
Soraka,KogMaw,39,20,19,51.28
Soraka,Aphelios,63,42,21,66.67
Soraka,TwistedFate,38,22,16,57.89
Soraka,Fiora,28,13,15,46.43
Soraka,Cassiopeia,32,13,19,40.63
Soraka,Anivia,22,13,9,59.09
Soraka,Kalista,36,16,20,44.44
Soraka,Maokai,49,26,23,53.06
Soraka,Smolder,56,18,38,32.14
Soraka,Belveth,14,11,3,78.57
Soraka,Sion,54,19,35,35.19
Soraka,Kennen,11,8,3,72.73
Soraka,Blitzcrank,60,36,24,60
Soraka,Syndra,65,31,34,47.69
Soraka,Zeri,38,9,29,23.68
Soraka,Renata,15,12,3,80
Soraka,Taliyah,11,2,9,18.18
Soraka,RekSai,17,7,10,41.18
Soraka,Annie,13,2,11,15.38
Soraka,Ivern,23,9,14,39.13
Pantheon,Ashe,583,272,311,46.66
Pantheon,Twitch,218,129,89,59.17
Pantheon,Viktor,293,138,155,47.1
Pantheon,Xayah,174,97,77,55.75
Pantheon,Xerath,231,118,113,51.08
Pantheon,Galio,304,145,159,47.7
Pantheon,Hecarim,99,49,50,49.49
Pantheon,Shen,215,113,102,52.56
Pantheon,Kaisa,511,271,240,53.03
Pantheon,Nami,301,139,162,46.18
Pantheon,Jhin,657,309,348,47.03
Pantheon,Ekko,283,141,142,49.82
Pantheon,Akali,301,158,143,52.49
Pantheon,Ambessa,282,157,125,55.67
Pantheon,Karma,395,213,182,53.92
Pantheon,Gnar,175,74,101,42.29
Pantheon,Evelynn,97,56,41,57.73
Pantheon,Malphite,380,188,192,49.47
Pantheon,Lucian,309,140,169,45.31
Pantheon,Mel,736,381,355,51.77
Pantheon,Darius,558,252,306,45.16
Pantheon,Graves,183,92,91,50.27
Pantheon,Neeko,153,83,70,54.25
Pantheon,Draven,179,79,100,44.13
Pantheon,Alistar,197,103,94,52.28
Pantheon,Chogath,384,176,208,45.83
Pantheon,MonkeyKing,250,113,137,45.2
Pantheon,Veigar,316,160,156,50.63
Pantheon,Caitlyn,819,415,404,50.67
Pantheon,Kayn,394,212,182,53.81
Pantheon,Teemo,308,151,157,49.03
Pantheon,Sivir,213,104,109,48.83
Pantheon,Velkoz,170,88,82,51.76
Pantheon,Camille,110,52,58,47.27
Pantheon,Diana,484,219,265,45.25
Pantheon,Malzahar,326,150,176,46.01
Pantheon,Zyra,227,110,117,48.46
Pantheon,Kayle,186,111,75,59.68
Pantheon,Irelia,311,139,172,44.69
Pantheon,Corki,137,63,74,45.99
Pantheon,Syndra,221,99,122,44.8
Pantheon,Swain,347,128,219,36.89
Pantheon,Volibear,367,159,208,43.32
Pantheon,Lissandra,115,54,61,46.96
Pantheon,Kalista,132,82,50,62.12
Pantheon,Rell,242,128,114,52.89
Pantheon,Nocturne,389,136,253,34.96
Pantheon,MissFortune,593,293,300,49.41
Pantheon,Rakan,223,111,112,49.78
Pantheon,TahmKench,315,170,145,53.97
Pantheon,Viego,450,248,202,55.11
Pantheon,Zed,395,222,173,56.2
Pantheon,Ziggs,111,52,59,46.85
Pantheon,Heimerdinger,159,74,85,46.54
Pantheon,Nunu,270,136,134,50.37
Pantheon,Yasuo,659,328,331,49.77
Pantheon,Gangplank,137,79,58,57.66
Pantheon,Elise,282,129,153,45.74
Pantheon,Yone,621,325,296,52.33
Pantheon,Warwick,414,194,220,46.86
Pantheon,Nautilus,444,212,232,47.75
Pantheon,Sion,260,125,135,48.08
Pantheon,Samira,252,146,106,57.94
Pantheon,Vayne,449,214,235,47.66
Pantheon,Orianna,195,93,102,47.69
Pantheon,Jinx,817,356,461,43.57
Pantheon,Briar,204,96,108,47.06
Pantheon,Khazix,180,85,95,47.22
Pantheon,Vex,173,73,100,42.2
Pantheon,Aphelios,187,100,87,53.48
Pantheon,Lulu,540,230,310,42.59
Pantheon,Vi,389,199,190,51.16
Pantheon,Pyke,318,178,140,55.97
Pantheon,Lux,781,424,357,54.29
Pantheon,Mordekaiser,418,195,223,46.65
Pantheon,Gragas,260,128,132,49.23
Pantheon,Kled,64,41,23,64.06
Pantheon,Qiyana,70,29,41,41.43
Pantheon,Maokai,153,80,73,52.29
Pantheon,MasterYi,340,157,183,46.18
Pantheon,Lillia,164,85,79,51.83
Pantheon,Katarina,200,95,105,47.5
Pantheon,Varus,313,173,140,55.27
Pantheon,Sett,501,247,254,49.3
Pantheon,Ahri,478,239,239,50
Pantheon,Yuumi,302,145,157,48.01
Pantheon,Olaf,64,35,29,54.69
Pantheon,Morgana,293,155,138,52.9
Pantheon,Illaoi,178,87,91,48.88
Pantheon,Singed,81,44,37,54.32
Pantheon,Fizz,116,71,45,61.21
Pantheon,Soraka,116,45,71,38.79
Pantheon,DrMundo,161,75,86,46.58
Pantheon,Aurora,254,137,117,53.94
Pantheon,KogMaw,100,52,48,52
Pantheon,Leona,301,143,158,47.51
Pantheon,Aatrox,303,133,170,43.89
Pantheon,Nasus,212,108,104,50.94
Pantheon,Belveth,60,25,35,41.67
Pantheon,Blitzcrank,272,131,141,48.16
Pantheon,LeeSin,617,323,294,52.35
Pantheon,Sylas,507,284,223,56.02
Pantheon,Riven,115,49,66,42.61
Pantheon,Poppy,269,125,144,46.47
Pantheon,Taliyah,93,41,52,44.09
Pantheon,Seraphine,257,130,127,50.58
Pantheon,Quinn,129,83,46,64.34
Pantheon,Senna,183,93,90,50.82
Pantheon,JarvanIV,233,125,108,53.65
Pantheon,Ezreal,797,399,398,50.06
Pantheon,Taric,108,55,53,50.93
Pantheon,Zac,204,97,107,47.55
Pantheon,Hwei,210,95,115,45.24
Pantheon,Yorick,280,148,132,52.86
Pantheon,Thresh,633,324,309,51.18
Pantheon,Skarner,149,56,93,37.58
Pantheon,Vladimir,176,96,80,54.55
Pantheon,Brand,165,69,96,41.82
Pantheon,TwistedFate,120,64,56,53.33
Pantheon,Milio,232,117,115,50.43
Pantheon,Renekton,187,84,103,44.92
Pantheon,XinZhao,188,93,95,49.47
Pantheon,Rumble,105,52,53,49.52
Pantheon,AurelionSol,133,52,81,39.1
Pantheon,Amumu,381,159,222,41.73
Pantheon,Urgot,169,90,79,53.25
Pantheon,Kindred,165,84,81,50.91
Pantheon,Cassiopeia,82,36,46,43.9
Pantheon,Talon,142,83,59,58.45
Pantheon,Fiora,113,60,53,53.1
Pantheon,Shaco,221,121,100,54.75
Pantheon,Jayce,178,92,86,51.69
Pantheon,Zoe,152,91,61,59.87
Pantheon,Azir,159,97,62,61.01
Pantheon,Jax,333,178,155,53.45
Pantheon,RekSai,69,37,32,53.62
Pantheon,Garen,443,221,222,49.89
Pantheon,Nilah,114,54,60,47.37
Pantheon,Nidalee,131,75,56,57.25
Pantheon,Braum,237,107,130,45.15
Pantheon,Gwen,207,99,108,47.83
Pantheon,Tryndamere,80,46,34,57.5
Pantheon,Rengar,101,62,39,61.39
Pantheon,Janna,82,28,54,34.15
Pantheon,Udyr,126,73,53,57.94
Pantheon,Shyvana,79,27,52,34.18
Pantheon,Renata,79,39,40,49.37
Pantheon,Ryze,120,41,79,34.17
Pantheon,Tristana,270,121,149,44.81
Pantheon,Sona,43,29,14,67.44
Pantheon,Naafiri,74,31,43,41.89
Pantheon,FiddleSticks,148,84,64,56.76
Pantheon,Karthus,76,35,41,46.05
Pantheon,Bard,98,41,57,41.84
Pantheon,Zeri,142,66,76,46.48
Pantheon,KSante,157,82,75,52.23
Pantheon,Smolder,227,108,119,47.58
Pantheon,Annie,107,52,55,48.6
Pantheon,Ornn,221,107,114,48.42
Pantheon,Trundle,185,79,106,42.7
Pantheon,Leblanc,154,74,80,48.05
Pantheon,Akshan,103,48,55,46.6
Pantheon,Rammus,113,61,52,53.98
Pantheon,Zilean,133,68,65,51.13
Pantheon,Kennen,86,36,50,41.86
Pantheon,Anivia,117,48,69,41.03
Pantheon,Sejuani,176,67,109,38.07
Pantheon,Ivern,66,26,40,39.39
Pantheon,Kassadin,57,30,27,52.63
Neeko,Ashe,194,102,92,52.58
Neeko,Twitch,69,38,31,55.07
Neeko,Viktor,85,46,39,54.12
Neeko,Xayah,56,25,31,44.64
Neeko,Xerath,93,37,56,39.78
Neeko,Sett,162,81,81,50
Neeko,Kindred,38,20,18,52.63
Neeko,Mel,208,106,102,50.96
Neeko,Lulu,107,43,64,40.19
Neeko,Jax,80,31,49,38.75
Neeko,Pantheon,153,70,83,45.75
Neeko,TwistedFate,40,26,14,65
Neeko,Sivir,60,20,40,33.33
Neeko,Milio,50,29,21,58
Neeko,Garen,140,52,88,37.14
Neeko,Kayn,107,54,53,50.47
Neeko,MissFortune,202,93,109,46.04
Neeko,Velkoz,50,16,34,32
Neeko,Volibear,96,46,50,47.92
Neeko,Hwei,74,40,34,54.05
Neeko,Vi,104,48,56,46.15
Neeko,Braum,93,40,53,43.01
Neeko,Yorick,84,46,38,54.76
Neeko,Sejuani,55,19,36,34.55
Neeko,Leblanc,72,29,43,40.28
Neeko,Nilah,40,12,28,30
Neeko,Karma,106,53,53,50
Neeko,JarvanIV,52,20,32,38.46
Neeko,Veigar,93,44,49,47.31
Neeko,Lux,190,99,91,52.11
Neeko,Thresh,183,114,69,62.3
Neeko,Illaoi,41,13,28,31.71
Neeko,Warwick,151,75,76,49.67
Neeko,Ekko,65,25,40,38.46
Neeko,Rakan,66,23,43,34.85
Neeko,Rumble,34,15,19,44.12
Neeko,Yasuo,217,116,101,53.46
Neeko,Ezreal,249,126,123,50.6
Neeko,Draven,59,34,25,57.63
Neeko,Taric,23,8,15,34.78
Neeko,Trundle,47,26,21,55.32
Neeko,Syndra,55,33,22,60
Neeko,Caitlyn,238,118,120,49.58
Neeko,Morgana,98,44,54,44.9
Neeko,Nasus,42,18,24,42.86
Neeko,Jinx,206,113,93,54.85
Neeko,Heimerdinger,39,21,18,53.85
Neeko,Urgot,43,22,21,51.16
Neeko,Udyr,29,14,15,48.28
Neeko,Azir,57,31,26,54.39
Neeko,Gnar,68,33,35,48.53
Neeko,Shaco,85,56,29,65.88
Neeko,Malzahar,98,41,57,41.84
Neeko,Maokai,38,26,12,68.42
Neeko,Riven,37,19,18,51.35
Neeko,Galio,95,41,54,43.16
Neeko,Zyra,121,48,73,39.67
Neeko,Aatrox,129,66,63,51.16
Neeko,Jhin,211,94,117,44.55
Neeko,Shen,59,29,30,49.15
Neeko,Diana,123,66,57,53.66
Neeko,Zed,112,55,57,49.11
Neeko,Nami,92,36,56,39.13
Neeko,Sylas,186,104,82,55.91
Neeko,Irelia,70,31,39,44.29
Neeko,Blitzcrank,104,37,67,35.58
Neeko,Gragas,49,20,29,40.82
Neeko,Kalista,23,9,14,39.13
Neeko,Rell,48,28,20,58.33
Neeko,Teemo,112,62,50,55.36
Neeko,LeeSin,191,101,90,52.88
Neeko,Zeri,49,15,34,30.61
Neeko,Yuumi,60,26,34,43.33
Neeko,Gangplank,57,34,23,59.65
Neeko,Evelynn,33,14,19,42.42
Neeko,Ahri,136,63,73,46.32
Neeko,Seraphine,58,19,39,32.76
Neeko,Darius,202,91,111,45.05
Neeko,Nocturne,101,37,64,36.63
Neeko,Kaisa,106,62,44,58.49
Neeko,TahmKench,110,68,42,61.82
Neeko,Leona,109,58,51,53.21
Neeko,Briar,48,13,35,27.08
Neeko,Yone,178,90,88,50.56
Neeko,Fiora,39,19,20,48.72
Neeko,Sion,67,37,30,55.22
Neeko,Elise,91,54,37,59.34
Neeko,Amumu,154,57,97,37.01
Neeko,Senna,51,18,33,35.29
Neeko,Ornn,62,28,34,45.16
Neeko,Soraka,42,16,26,38.1
Neeko,Mordekaiser,131,77,54,58.78
Neeko,Vayne,125,41,84,32.8
Neeko,Zac,45,22,23,48.89
Neeko,Lissandra,34,11,23,32.35
Neeko,Ivern,34,17,17,50
Neeko,Vladimir,32,8,24,25
Neeko,Aphelios,47,20,27,42.55
Neeko,Corki,53,30,23,56.6
Neeko,Brand,55,25,30,45.45
Neeko,Pyke,103,58,45,56.31
Neeko,Gwen,58,27,31,46.55
Neeko,Samira,78,35,43,44.87
Neeko,Akali,92,54,38,58.7
Neeko,Viego,108,55,53,50.93
Neeko,Swain,87,37,50,42.53
Neeko,Vex,43,16,27,37.21
Neeko,Nautilus,102,46,56,45.1
Neeko,Malphite,96,56,40,58.33
Neeko,MasterYi,122,50,72,40.98
Neeko,Kassadin,19,10,9,52.63
Neeko,Olaf,28,9,19,32.14
Neeko,Ambessa,62,37,25,59.68
Neeko,Taliyah,21,4,17,19.05
Neeko,Tristana,77,39,38,50.65
Neeko,Zilean,37,9,28,24.32
Neeko,Fizz,45,26,19,57.78
Neeko,Skarner,40,14,26,35
Neeko,Lucian,101,54,47,53.47
Neeko,XinZhao,65,28,37,43.08
Neeko,Aurora,99,35,64,35.35
Neeko,Cassiopeia,42,17,25,40.48
Neeko,Khazix,36,21,15,58.33
Neeko,Katarina,53,36,17,67.92
Neeko,Kayle,51,25,26,49.02
Neeko,Shyvana,26,17,9,65.38
Neeko,Lillia,39,25,14,64.1
Neeko,Rengar,35,25,10,71.43
Neeko,Akshan,22,8,14,36.36
Neeko,AurelionSol,28,18,10,64.29
Neeko,Smolder,64,37,27,57.81
Neeko,RekSai,12,5,7,41.67
Neeko,Singed,27,8,19,29.63
Neeko,Karthus,14,3,11,21.43
Neeko,Camille,24,9,15,37.5
Neeko,Nunu,45,22,23,48.89
Neeko,Varus,75,36,39,48
Neeko,Janna,27,14,13,51.85
Neeko,Quinn,37,14,23,37.84
Neeko,Tryndamere,26,15,11,57.69
Neeko,Anivia,24,10,14,41.67
Neeko,DrMundo,28,12,16,42.86
Neeko,Kled,12,6,6,50
Neeko,Orianna,46,14,32,30.43
Neeko,Kennen,28,16,12,57.14
Neeko,Poppy,70,33,37,47.14
Neeko,Naafiri,40,25,15,62.5
Neeko,Chogath,103,37,66,35.92
Neeko,FiddleSticks,23,14,9,60.87
Neeko,Sona,8,4,4,50
Neeko,Belveth,7,4,3,57.14
Neeko,Renekton,51,19,32,37.25
Neeko,Hecarim,37,18,19,48.65
Neeko,Talon,76,50,26,65.79
Neeko,KSante,57,28,29,49.12
Neeko,Renata,32,22,10,68.75
Neeko,Ziggs,35,17,18,48.57
Neeko,Annie,20,8,12,40
Neeko,Jayce,38,25,13,65.79
Neeko,KogMaw,15,8,7,53.33
Neeko,Rammus,24,11,13,45.83
Neeko,MonkeyKing,34,18,16,52.94
Neeko,Zoe,51,20,31,39.22
Neeko,Graves,67,34,33,50.75
Neeko,Ryze,41,18,23,43.9
Neeko,Bard,21,12,9,57.14
Neeko,Qiyana,26,11,15,42.31
Neeko,Nidalee,35,26,9,74.29
Neeko,Alistar,45,10,35,22.22
Varus,Ashe,451,248,203,54.99
Varus,Twitch,156,72,84,46.15
Varus,Viktor,167,87,80,52.1
Varus,Xayah,99,50,49,50.51
Varus,Xerath,203,92,111,45.32
Varus,Shen,118,42,76,35.59
Varus,Vi,220,109,111,49.55
Varus,Swain,166,74,92,44.58
Varus,Nilah,75,39,36,52
Varus,Nami,192,79,113,41.15
Varus,Jayce,102,51,51,50
Varus,Hecarim,67,35,32,52.24
Varus,Milio,111,51,60,45.95
Varus,Caitlyn,541,268,273,49.54
Varus,Zoe,65,25,40,38.46
Varus,Volibear,184,88,96,47.83
Varus,Gragas,148,80,68,54.05
Varus,Lux,387,157,230,40.57
Varus,Trundle,77,36,41,46.75
Varus,Sylas,335,172,163,51.34
Varus,Zac,111,41,70,36.94
Varus,MissFortune,391,193,198,49.36
Varus,Seraphine,147,69,78,46.94
Varus,Chogath,232,108,124,46.55
Varus,MonkeyKing,149,51,98,34.23
Varus,Veigar,180,106,74,58.89
Varus,Mel,422,203,219,48.1
Varus,KSante,127,60,67,47.24
Varus,Viego,219,106,113,48.4
Varus,Kassadin,53,20,33,37.74
Varus,Nasus,88,41,47,46.59
Varus,Bard,88,51,37,57.95
Varus,Diana,243,118,125,48.56
Varus,Braum,165,89,76,53.94
Varus,Skarner,94,53,41,56.38
Varus,Katarina,95,53,42,55.79
Varus,Blitzcrank,183,89,94,48.63
Varus,Lulu,298,163,135,54.7
Varus,Jax,144,77,67,53.47
Varus,Yasuo,406,179,227,44.09
Varus,Teemo,203,105,98,51.72
Varus,Lillia,94,35,59,37.23
Varus,Camille,61,25,36,40.98
Varus,Draven,114,63,51,55.26
Varus,Senna,101,35,66,34.65
Varus,Graves,148,61,87,41.22
Varus,Nocturne,195,89,106,45.64
Varus,Lissandra,69,34,35,49.28
Varus,Rakan,94,37,57,39.36
Varus,DrMundo,69,38,31,55.07
Varus,MasterYi,196,108,88,55.1
Varus,Vladimir,121,62,59,51.24
Varus,Thresh,352,174,178,49.43
Varus,Heimerdinger,87,39,48,44.83
Varus,Nunu,144,94,50,65.28
Varus,Alistar,114,53,61,46.49
Varus,Elise,160,79,81,49.38
Varus,Leona,218,106,112,48.62
Varus,Yorick,133,63,70,47.37
Varus,Briar,124,52,72,41.94
Varus,Ziggs,91,37,54,40.66
Varus,Yone,341,173,168,50.73
Varus,Pantheon,313,140,173,44.73
Varus,Ambessa,167,64,103,38.32
Varus,Hwei,167,86,81,51.5
Varus,Quinn,52,20,32,38.46
Varus,Nidalee,55,25,30,45.45
Varus,Aphelios,121,48,73,39.67
Varus,Malphite,221,117,104,52.94
Varus,Kindred,73,41,32,56.16
Varus,Akshan,48,23,25,47.92
Varus,TahmKench,174,62,112,35.63
Varus,Kled,41,22,19,53.66
Varus,Jhin,385,190,195,49.35
Varus,Pyke,200,103,97,51.5
Varus,Aurora,116,55,61,47.41
Varus,Mordekaiser,267,133,134,49.81
Varus,Shaco,114,54,60,47.37
Varus,Leblanc,136,75,61,55.15
Varus,Amumu,207,75,132,36.23
Varus,AurelionSol,84,43,41,51.19
Varus,LeeSin,379,186,193,49.08
Varus,Ezreal,523,263,260,50.29
Varus,Irelia,158,87,71,55.06
Varus,JarvanIV,159,70,89,44.03
Varus,Taliyah,67,36,31,53.73
Varus,Sivir,128,62,66,48.44
Varus,Zed,169,83,86,49.11
Varus,Samira,144,80,64,55.56
Varus,Morgana,149,61,88,40.94
Varus,Naafiri,55,24,31,43.64
Varus,Akali,186,98,88,52.69
Varus,Poppy,159,78,81,49.06
Varus,Lucian,176,79,97,44.89
Varus,Urgot,109,56,53,51.38
Varus,Udyr,66,35,31,53.03
Varus,Azir,57,34,23,59.65
Varus,Jinx,547,255,292,46.62
Varus,Garen,294,141,153,47.96
Varus,Ahri,282,122,160,43.26
Varus,Smolder,154,87,67,56.49
Varus,Soraka,89,56,33,62.92
Varus,Janna,59,20,39,33.9
Varus,Ornn,130,68,62,52.31
Varus,Tristana,159,77,82,48.43
Varus,Gwen,87,39,48,44.83
Varus,Khazix,120,53,67,44.17
Varus,Darius,340,163,177,47.94
Varus,Qiyana,42,19,23,45.24
Varus,Sion,156,86,70,55.13
Varus,XinZhao,182,83,99,45.6
Varus,Annie,66,29,37,43.94
Varus,Riven,90,50,40,55.56
Varus,Kayn,257,136,121,52.92
Varus,Syndra,142,70,72,49.3
Varus,Karma,219,105,114,47.95
Varus,Malzahar,204,77,127,37.75
Varus,Belveth,34,16,18,47.06
Varus,Kaisa,293,163,130,55.63
Varus,Velkoz,93,48,45,51.61
Varus,Shyvana,56,30,26,53.57
Varus,Anivia,66,34,32,51.52
Varus,Singed,32,13,19,40.63
Varus,Ekko,153,71,82,46.41
Varus,Vex,114,52,62,45.61
Varus,Nautilus,275,149,126,54.18
Varus,Sejuani,136,35,101,25.74
Varus,Maokai,113,38,75,33.63
Varus,Yuumi,137,64,73,46.72
Varus,Olaf,68,20,48,29.41
Varus,Zyra,176,106,70,60.23
Varus,FiddleSticks,92,44,48,47.83
Varus,Kalista,42,29,13,69.05
Varus,Sett,297,142,155,47.81
Varus,Illaoi,105,56,49,53.33
Varus,Rumble,86,42,44,48.84
Varus,Orianna,108,51,57,47.22
Varus,Ryze,81,37,44,45.68
Varus,Rengar,37,11,26,29.73
Varus,Vayne,224,96,128,42.86
Varus,Talon,139,76,63,54.68
Varus,Sona,31,19,12,61.29
Varus,Gnar,61,37,24,60.66
Varus,Tryndamere,54,38,16,70.37
Varus,TwistedFate,68,34,34,50
Varus,Rell,147,75,72,51.02
Varus,Brand,82,37,45,45.12
Varus,Ivern,43,28,15,65.12
Varus,KogMaw,68,31,37,45.59
Varus,Fizz,84,45,39,53.57
Varus,Aatrox,214,108,106,50.47
Varus,Gangplank,122,58,64,47.54
Varus,Warwick,198,86,112,43.43
Varus,Evelynn,80,50,30,62.5
Varus,Zilean,49,28,21,57.14
Varus,Corki,91,39,52,42.86
Varus,Zeri,85,44,41,51.76
Varus,Kayle,123,50,73,40.65
Varus,Cassiopeia,39,18,21,46.15
Varus,Karthus,43,17,26,39.53
Varus,Taric,53,28,25,52.83
Varus,Fiora,65,32,33,49.23
Varus,Galio,192,108,84,56.25
Varus,Renekton,88,42,46,47.73
Varus,Rammus,64,34,30,53.13
Varus,Neeko,75,39,36,52
Varus,Kennen,50,21,29,42
Varus,Renata,42,24,18,57.14
Varus,RekSai,15,11,4,73.33
Twitch,Sejuani,107,62,45,57.94
Twitch,Pantheon,218,89,129,40.83
Twitch,Neeko,69,31,38,44.93
Twitch,Varus,156,84,72,53.85
Twitch,Pyke,67,32,35,47.76
Twitch,Corki,64,39,25,60.94
Twitch,Ekko,121,61,60,50.41
Twitch,Leblanc,93,43,50,46.24
Twitch,Caitlyn,365,168,197,46.03
Twitch,Mel,358,199,159,55.59
Twitch,Garen,223,107,116,47.98
Twitch,MonkeyKing,109,53,56,48.62
Twitch,Lux,327,165,162,50.46
Twitch,Nilah,46,25,21,54.35
Twitch,Lulu,208,88,120,42.31
Twitch,Teemo,182,77,105,42.31
Twitch,Warwick,207,110,97,53.14
Twitch,Nunu,119,52,67,43.7
Twitch,Lucian,117,53,64,45.3
Twitch,Leona,136,51,85,37.5
Twitch,Jhin,288,135,153,46.88
Twitch,Akali,107,48,59,44.86
Twitch,Ambessa,93,49,44,52.69
Twitch,Karma,180,90,90,50
Twitch,Kayn,185,109,76,58.92
Twitch,Shaco,109,60,49,55.05
Twitch,Zoe,26,12,14,46.15
Twitch,KogMaw,58,26,32,44.83
Twitch,TwistedFate,74,39,35,52.7
Twitch,Chogath,178,91,87,51.12
Twitch,Nocturne,137,72,65,52.55
Twitch,Orianna,74,36,38,48.65
Twitch,Tryndamere,58,30,28,51.72
Twitch,Morgana,99,51,48,51.52
Twitch,Cassiopeia,54,18,36,33.33
Twitch,Kaisa,246,98,148,39.84
Twitch,Volibear,148,80,68,54.05
Twitch,Jayce,52,29,23,55.77
Twitch,Elise,113,49,64,43.36
Twitch,Yorick,160,93,67,58.13
Twitch,Zilean,43,19,24,44.19
Twitch,Sett,202,95,107,47.03
Twitch,Viktor,141,88,53,62.41
Twitch,Jinx,419,214,205,51.07
Twitch,Jax,96,48,48,50
Twitch,RekSai,39,28,11,71.79
Twitch,Xayah,80,52,28,65
Twitch,Rakan,110,63,47,57.27
Twitch,Darius,279,126,153,45.16
Twitch,Veigar,156,74,82,47.44
Twitch,Aurora,88,49,39,55.68
Twitch,Briar,103,40,63,38.83
Twitch,Vayne,219,110,109,50.23
Twitch,Fiora,51,26,25,50.98
Twitch,Soraka,75,41,34,54.67
Twitch,Azir,56,34,22,60.71
Twitch,Ornn,92,53,39,57.61
Twitch,Katarina,100,58,42,58
Twitch,Tristana,153,58,95,37.91
Twitch,Gwen,81,46,35,56.79
Twitch,MasterYi,135,64,71,47.41
Twitch,Akshan,52,22,30,42.31
Twitch,Zeri,75,32,43,42.67
Twitch,Yone,170,73,97,42.94
Twitch,Gnar,93,52,41,55.91
Twitch,Kalista,41,17,24,41.46
Twitch,Nautilus,241,133,108,55.19
Twitch,Zed,129,76,53,58.91
Twitch,Thresh,241,114,127,47.3
Twitch,Camille,58,19,39,32.76
Twitch,Lillia,91,55,36,60.44
Twitch,Diana,230,113,117,49.13
Twitch,TahmKench,136,69,67,50.74
Twitch,Udyr,52,38,14,73.08
Twitch,Aatrox,108,50,58,46.3
Twitch,MissFortune,257,124,133,48.25
Twitch,Malphite,198,91,107,45.96
Twitch,Nidalee,26,13,13,50
Twitch,Irelia,105,61,44,58.1
Twitch,Sylas,186,104,82,55.91
Twitch,JarvanIV,100,42,58,42
Twitch,Yasuo,261,133,128,50.96
Twitch,Bard,56,25,31,44.64
Twitch,Ahri,156,66,90,42.31
Twitch,Aphelios,95,57,38,60
Twitch,Renata,32,22,10,68.75
Twitch,Sona,46,24,22,52.17
Twitch,Zac,82,40,42,48.78
Twitch,Hwei,99,50,49,50.51
Twitch,Shen,119,46,73,38.66
Twitch,Draven,56,28,28,50
Twitch,Renekton,91,46,45,50.55
Twitch,Ryze,52,30,22,57.69
Twitch,AurelionSol,67,19,48,28.36
Twitch,Vladimir,87,40,47,45.98
Twitch,Nasus,74,34,40,45.95
Twitch,Vi,159,74,85,46.54
Twitch,Rammus,58,39,19,67.24
Twitch,Zyra,73,46,27,63.01
Twitch,Senna,98,57,41,58.16
Twitch,Ezreal,287,142,145,49.48
Twitch,Xerath,117,61,56,52.14
Twitch,Qiyana,37,25,12,67.57
Twitch,Brand,92,59,33,64.13
Twitch,Taliyah,38,19,19,50
Twitch,DrMundo,78,47,31,60.26
Twitch,Heimerdinger,78,40,38,51.28
Twitch,Ashe,281,133,148,47.33
Twitch,XinZhao,86,38,48,44.19
Twitch,Milio,112,43,69,38.39
Twitch,Singed,49,11,38,22.45
Twitch,Swain,108,58,50,53.7
Twitch,Nami,146,77,69,52.74
Twitch,Illaoi,69,36,33,52.17
Twitch,Belveth,45,21,24,46.67
Twitch,Yuumi,95,34,61,35.79
Twitch,Trundle,80,41,39,51.25
Twitch,Shyvana,60,21,39,35
Twitch,Braum,114,36,78,31.58
Twitch,Mordekaiser,154,73,81,47.4
Twitch,Malzahar,159,79,80,49.69
Twitch,Quinn,55,21,34,38.18
Twitch,Blitzcrank,125,61,64,48.8
Twitch,LeeSin,205,101,104,49.27
Twitch,Syndra,125,53,72,42.4
Twitch,Naafiri,53,26,27,49.06
Twitch,Viego,165,90,75,54.55
Twitch,Smolder,130,55,75,42.31
Twitch,Sion,102,50,52,49.02
Twitch,Galio,142,83,59,58.45
Twitch,Khazix,69,33,36,47.83
Twitch,Urgot,82,41,41,50
Twitch,Amumu,197,81,116,41.12
Twitch,Gangplank,47,20,27,42.55
Twitch,Kayle,86,25,61,29.07
Twitch,Evelynn,51,27,24,52.94
Twitch,Riven,60,23,37,38.33
Twitch,Talon,76,41,35,53.95
Twitch,KSante,85,53,32,62.35
Twitch,Samira,151,93,58,61.59
Twitch,Gragas,87,58,29,66.67
Twitch,FiddleSticks,71,35,36,49.3
Twitch,Ziggs,55,36,19,65.45
Twitch,Seraphine,135,65,70,48.15
Twitch,Rumble,42,27,15,64.29
Twitch,Karthus,41,21,20,51.22
Twitch,Taric,43,19,24,44.19
Twitch,Velkoz,82,47,35,57.32
Twitch,Fizz,84,49,35,58.33
Twitch,Alistar,60,22,38,36.67
Twitch,Vex,62,25,37,40.32
Twitch,Olaf,36,14,22,38.89
Twitch,Anivia,69,34,35,49.28
Twitch,Kindred,80,38,42,47.5
Twitch,Graves,74,40,34,54.05
Twitch,Kennen,23,14,9,60.87
Twitch,Lissandra,44,26,18,59.09
Twitch,Rell,97,56,41,57.73
Twitch,Maokai,79,47,32,59.49
Twitch,Skarner,71,32,39,45.07
Twitch,Kled,36,17,19,47.22
Twitch,Rengar,35,19,16,54.29
Twitch,Poppy,92,51,41,55.43
Twitch,Ivern,37,10,27,27.03
Twitch,Annie,34,12,22,35.29
Twitch,Sivir,74,40,34,54.05
Twitch,Hecarim,64,28,36,43.75
Twitch,Janna,40,11,29,27.5
Twitch,Kassadin,23,2,21,8.7
Galio,Ambessa,195,85,110,43.59
Galio,Gragas,172,107,65,62.21
Galio,Pantheon,304,159,145,52.3
Galio,Samira,153,77,76,50.33
Galio,Hwei,163,84,79,51.53
Galio,DrMundo,119,54,65,45.38
Galio,Rammus,98,55,43,56.12
Galio,Annie,52,31,21,59.62
Galio,Ezreal,601,282,319,46.92
Galio,Renata,55,23,32,41.82
Galio,Graves,160,63,97,39.38
Galio,Ahri,351,174,177,49.57
Galio,AurelionSol,97,42,55,43.3
Galio,Rakan,150,73,77,48.67
Galio,Rengar,72,44,28,61.11
Galio,Warwick,307,161,146,52.44
Galio,Irelia,181,99,82,54.7
Galio,Ashe,427,223,204,52.22
Galio,Nautilus,341,177,164,51.91
Galio,Heimerdinger,121,61,60,50.41
Galio,LeeSin,438,230,208,52.51
Galio,Jinx,522,255,267,48.85
Galio,Leona,272,136,136,50
Galio,Volibear,226,99,127,43.81
Galio,Nunu,193,110,83,56.99
Galio,Katarina,170,79,91,46.47
Galio,Swain,259,126,133,48.65
Galio,Trundle,127,63,64,49.61
Galio,RekSai,42,21,21,50
Galio,Leblanc,177,104,73,58.76
Galio,Caitlyn,556,270,286,48.56
Galio,Lulu,330,146,184,44.24
Galio,Aatrox,246,111,135,45.12
Galio,Briar,116,51,65,43.97
Galio,Elise,245,156,89,63.67
Galio,Viktor,223,106,117,47.53
Galio,Thresh,393,197,196,50.13
Galio,Kindred,105,52,53,49.52
Galio,Yasuo,424,224,200,52.83
Galio,MissFortune,445,254,191,57.08
Galio,Sona,24,8,16,33.33
Galio,Malphite,222,115,107,51.8
Galio,Sejuani,134,41,93,30.6
Galio,Ekko,155,77,78,49.68
Galio,Karma,294,135,159,45.92
Galio,Mordekaiser,289,138,151,47.75
Galio,MonkeyKing,150,70,80,46.67
Galio,Rell,107,62,45,57.94
Galio,Aurora,170,95,75,55.88
Galio,Diana,360,209,151,58.06
Galio,Ryze,93,53,40,56.99
Galio,Maokai,126,54,72,42.86
Galio,Shen,160,76,84,47.5
Galio,Yorick,136,52,84,38.24
Galio,Veigar,192,89,103,46.35
Galio,Nasus,148,85,63,57.43
Galio,Nidalee,102,52,50,50.98
Galio,Jax,195,116,79,59.49
Galio,Evelynn,66,32,34,48.48
Galio,Akali,222,101,121,45.5
Galio,Kaisa,379,202,177,53.3
Galio,Seraphine,170,75,95,44.12
Galio,Morgana,237,120,117,50.63
Galio,Vayne,315,160,155,50.79
Galio,Singed,51,31,20,60.78
Galio,FiddleSticks,113,56,57,49.56
Galio,Teemo,208,84,124,40.38
Galio,Kayn,285,157,128,55.09
Galio,Sylas,424,219,205,51.65
Galio,Poppy,176,81,95,46.02
Galio,Quinn,79,40,39,50.63
Galio,Malzahar,250,131,119,52.4
Galio,Soraka,75,41,34,54.67
Galio,Vi,245,147,98,60
Galio,Xerath,159,56,103,35.22
Galio,TahmKench,183,87,96,47.54
Galio,Yone,456,252,204,55.26
Galio,Ornn,148,58,90,39.19
Galio,Neeko,95,54,41,56.84
Galio,Senna,130,69,61,53.08
Galio,Sion,198,83,115,41.92
Galio,XinZhao,107,60,47,56.07
Galio,Lissandra,84,37,47,44.05
Galio,Braum,135,66,69,48.89
Galio,Darius,367,193,174,52.59
Galio,Sett,364,194,170,53.3
Galio,Milio,118,47,71,39.83
Galio,MasterYi,176,105,71,59.66
Galio,Taliyah,66,28,38,42.42
Galio,Sivir,123,59,64,47.97
Galio,Skarner,123,47,76,38.21
Galio,Mel,498,275,223,55.22
Galio,Khazix,95,34,61,35.79
Galio,Janna,68,28,40,41.18
Galio,Yuumi,191,72,119,37.7
Galio,Lucian,190,89,101,46.84
Galio,Nami,212,120,92,56.6
Galio,Alistar,107,71,36,66.36
Galio,Nocturne,219,118,101,53.88
Galio,Jhin,381,235,146,61.68
Galio,Aphelios,94,43,51,45.74
Galio,Renekton,110,53,57,48.18
Galio,Blitzcrank,179,93,86,51.96
Galio,Amumu,280,147,133,52.5
Galio,Tristana,182,91,91,50
Galio,Kassadin,43,24,19,55.81
Galio,JarvanIV,168,74,94,44.05
Galio,Lux,505,241,264,47.72
Galio,Corki,154,55,99,35.71
Galio,Vladimir,120,65,55,54.17
Galio,Pyke,187,101,86,54.01
Galio,Fizz,89,44,45,49.44
Galio,Gnar,110,60,50,54.55
Galio,Gwen,113,62,51,54.87
Galio,Zed,183,85,98,46.45
Galio,Hecarim,83,37,46,44.58
Galio,Riven,95,46,49,48.42
Galio,Udyr,80,38,42,47.5
Galio,TwistedFate,93,41,52,44.09
Galio,Shaco,149,87,62,58.39
Galio,Xayah,135,56,79,41.48
Galio,Garen,347,179,168,51.59
Galio,Talon,146,69,77,47.26
Galio,Zac,140,59,81,42.14
Galio,Naafiri,60,22,38,36.67
Galio,Kalista,77,35,42,45.45
Galio,Zyra,186,86,100,46.24
Galio,Nilah,95,52,43,54.74
Galio,Syndra,176,96,80,54.55
Galio,Twitch,142,59,83,41.55
Galio,Fiora,88,52,36,59.09
Galio,KogMaw,85,40,45,47.06
Galio,Chogath,245,124,121,50.61
Galio,Rumble,108,46,62,42.59
Galio,Zilean,63,28,35,44.44
Galio,Ziggs,91,36,55,39.56
Galio,Brand,110,62,48,56.36
Galio,Smolder,145,65,80,44.83
Galio,Karthus,64,39,25,60.94
Galio,Jayce,117,79,38,67.52
Galio,Tryndamere,61,26,35,42.62
Galio,Kayle,108,51,57,47.22
Galio,Bard,82,51,31,62.2
Galio,Camille,96,45,51,46.88
Galio,Gangplank,123,72,51,58.54
Galio,Orianna,114,67,47,58.77
Galio,Viego,298,142,156,47.65
Galio,Anivia,96,47,49,48.96
Galio,Varus,192,84,108,43.75
Galio,Velkoz,131,85,46,64.89
Galio,KSante,186,92,94,49.46
Galio,Kennen,82,26,56,31.71
Galio,Vex,105,52,53,49.52
Galio,Olaf,46,39,7,84.78
Galio,Illaoi,111,43,68,38.74
Galio,Urgot,95,45,50,47.37
Galio,Shyvana,59,29,30,49.15
Galio,Lillia,119,48,71,40.34
Galio,Taric,33,8,25,24.24
Galio,Azir,82,43,39,52.44
Galio,Cassiopeia,49,32,17,65.31
Galio,Draven,106,65,41,61.32
Galio,Akshan,42,27,15,64.29
Galio,Kled,43,31,12,72.09
Galio,Belveth,46,10,36,21.74
Galio,Zoe,108,78,30,72.22
Galio,Qiyana,58,42,16,72.41
Galio,Zeri,104,46,58,44.23
Galio,Ivern,40,28,12,70
Hecarim,Ambessa,47,19,28,40.43
Hecarim,Gragas,39,20,19,51.28
Hecarim,Pantheon,99,50,49,50.51
Hecarim,Samira,45,17,28,37.78
Hecarim,Hwei,67,39,28,58.21
Hecarim,Warwick,85,35,50,41.18
Hecarim,Udyr,22,13,9,59.09
Hecarim,Mel,153,62,91,40.52
Hecarim,Sivir,45,23,22,51.11
Hecarim,Karma,110,39,71,35.45
Hecarim,Aatrox,79,41,38,51.9
Hecarim,MasterYi,56,33,23,58.93
Hecarim,TwistedFate,19,8,11,42.11
Hecarim,Varus,67,32,35,47.76
Hecarim,Lux,117,74,43,63.25
Hecarim,Kennen,17,6,11,35.29
Hecarim,Vi,80,43,37,53.75
Hecarim,Ashe,136,66,70,48.53
Hecarim,Leona,70,36,34,51.43
Hecarim,Garen,81,41,40,50.62
Hecarim,Diana,91,42,49,46.15
Hecarim,Yasuo,152,87,65,57.24
Hecarim,Ezreal,133,61,72,45.86
Hecarim,Brand,41,22,19,53.66
Hecarim,Yorick,47,20,27,42.55
Hecarim,Briar,53,31,22,58.49
Hecarim,Sylas,155,70,85,45.16
Hecarim,Veigar,69,38,31,55.07
Hecarim,Ziggs,26,3,23,11.54
Hecarim,Ornn,48,19,29,39.58
Hecarim,Kayn,76,30,46,39.47
Hecarim,Jinx,193,70,123,36.27
Hecarim,Pyke,74,42,32,56.76
Hecarim,Nami,69,31,38,44.93
Hecarim,Nocturne,81,43,38,53.09
Hecarim,Malzahar,51,29,22,56.86
Hecarim,Caitlyn,167,68,99,40.72
Hecarim,Lucian,46,35,11,76.09
Hecarim,Blitzcrank,63,38,25,60.32
Hecarim,Gnar,56,20,36,35.71
Hecarim,Elise,70,41,29,58.57
Hecarim,Ahri,119,59,60,49.58
Hecarim,Draven,47,22,25,46.81
Hecarim,Nautilus,84,43,41,51.19
Hecarim,Jayce,45,17,28,37.78
Hecarim,Lulu,141,53,88,37.59
Hecarim,FiddleSticks,27,5,22,18.52
Hecarim,Vayne,99,60,39,60.61
Hecarim,Viktor,71,30,41,42.25
Hecarim,Singed,11,5,6,45.45
Hecarim,Talon,41,30,11,73.17
Hecarim,Katarina,39,23,16,58.97
Hecarim,Thresh,120,56,64,46.67
Hecarim,Akali,57,27,30,47.37
Hecarim,Seraphine,52,17,35,32.69
Hecarim,Mordekaiser,70,38,32,54.29
Hecarim,JarvanIV,39,19,20,48.72
Hecarim,MissFortune,162,89,73,54.94
Hecarim,Teemo,68,49,19,72.06
Hecarim,Shaco,51,26,25,50.98
Hecarim,Zoe,26,14,12,53.85
Hecarim,Nilah,13,10,3,76.92
Hecarim,Braum,56,25,31,44.64
Hecarim,Aurora,70,32,38,45.71
Hecarim,Akshan,27,13,14,48.15
Hecarim,Tristana,67,31,36,46.27
Hecarim,Skarner,63,20,43,31.75
Hecarim,Rell,51,24,27,47.06
Hecarim,Gangplank,36,20,16,55.56
Hecarim,Ivern,16,7,9,43.75
Hecarim,Chogath,88,54,34,61.36
Hecarim,Morgana,57,18,39,31.58
Hecarim,Kaisa,111,48,63,43.24
Hecarim,Galio,83,46,37,55.42
Hecarim,Leblanc,30,12,18,40
Hecarim,Sejuani,41,20,21,48.78
Hecarim,Aphelios,50,34,16,68
Hecarim,Vladimir,40,23,17,57.5
Hecarim,Velkoz,21,8,13,38.1
Hecarim,Kayle,50,30,20,60
Hecarim,Shyvana,28,19,9,67.86
Hecarim,Malphite,80,29,51,36.25
Hecarim,MonkeyKing,41,9,32,21.95
Hecarim,Swain,67,28,39,41.79
Hecarim,Trundle,23,15,8,65.22
Hecarim,Viego,130,45,85,34.62
Hecarim,Smolder,61,36,25,59.02
Hecarim,Poppy,46,27,19,58.7
Hecarim,Graves,56,20,36,35.71
Hecarim,Alistar,53,22,31,41.51
Hecarim,Nunu,52,26,26,50
Hecarim,Illaoi,28,13,15,46.43
Hecarim,Naafiri,24,11,13,45.83
Hecarim,DrMundo,56,36,20,64.29
Hecarim,Nidalee,20,6,14,30
Hecarim,Riven,16,10,6,62.5
Hecarim,Kindred,37,24,13,64.86
Hecarim,Xayah,36,8,28,22.22
Hecarim,Ryze,22,2,20,9.09
Hecarim,LeeSin,147,74,73,50.34
Hecarim,Irelia,48,30,18,62.5
Hecarim,Milio,46,23,23,50
Hecarim,Soraka,37,28,9,75.68
Hecarim,Corki,38,23,15,60.53
Hecarim,Karthus,26,21,5,80.77
Hecarim,Rumble,31,15,16,48.39
Hecarim,Yone,107,48,59,44.86
Hecarim,Jhin,152,73,79,48.03
Hecarim,Syndra,45,32,13,71.11
Hecarim,Kled,16,6,10,37.5
Hecarim,Jax,61,35,26,57.38
Hecarim,Taliyah,18,2,16,11.11
Hecarim,Zilean,25,7,18,28
Hecarim,Taric,11,5,6,45.45
Hecarim,Camille,32,13,19,40.63
Hecarim,Zed,61,20,41,32.79
Hecarim,Renekton,31,10,21,32.26
Hecarim,Fizz,14,8,6,57.14
Hecarim,Sett,89,39,50,43.82
Hecarim,Rammus,15,12,3,80
Hecarim,Darius,126,70,56,55.56
Hecarim,Evelynn,24,5,19,20.83
Hecarim,Orianna,51,31,20,60.78
Hecarim,Lillia,40,26,14,65
Hecarim,Rakan,30,12,18,40
Hecarim,Nasus,37,24,13,64.86
Hecarim,Sion,64,20,44,31.25
Hecarim,Azir,47,24,23,51.06
Hecarim,Volibear,63,21,42,33.33
Hecarim,Belveth,23,12,11,52.17
Hecarim,KSante,68,30,38,44.12
Hecarim,TahmKench,34,10,24,29.41
Hecarim,Zeri,41,24,17,58.54
Hecarim,Vex,27,13,14,48.15
Hecarim,Amumu,96,53,43,55.21
Hecarim,Janna,23,14,9,60.87
Hecarim,Ekko,68,30,38,44.12
Hecarim,Senna,30,18,12,60
Hecarim,Fiora,31,6,25,19.35
Hecarim,Lissandra,28,8,20,28.57
Hecarim,Qiyana,7,5,2,71.43
Hecarim,Quinn,15,6,9,40
Hecarim,Kalista,27,8,19,29.63
Hecarim,Zac,46,28,18,60.87
Hecarim,Yuumi,47,24,23,51.06
Hecarim,Olaf,24,5,19,20.83
Hecarim,XinZhao,43,15,28,34.88
Hecarim,Zyra,50,23,27,46
Hecarim,Maokai,31,16,15,51.61
Hecarim,Urgot,38,5,33,13.16
Hecarim,Twitch,64,36,28,56.25
Hecarim,AurelionSol,25,17,8,68
Hecarim,Khazix,29,19,10,65.52
Hecarim,Heimerdinger,24,16,8,66.67
Hecarim,Shen,49,22,27,44.9
Hecarim,Cassiopeia,11,5,6,45.45
Hecarim,Xerath,48,19,29,39.58
Hecarim,Tryndamere,17,10,7,58.82
Hecarim,Neeko,37,19,18,51.35
Hecarim,Bard,10,4,6,40
Hecarim,Anivia,28,10,18,35.71
Hecarim,Sona,16,6,10,37.5
Hecarim,Annie,10,7,3,70
Hecarim,Gwen,22,11,11,50
Hecarim,KogMaw,14,7,7,50
Hecarim,RekSai,8,3,5,37.5
Hecarim,Rengar,8,8,0,100
Hecarim,Renata,12,5,7,41.67
Hecarim,Kassadin,9,6,3,66.67
Shen,Ambessa,135,82,53,60.74
Shen,Gragas,114,66,48,57.89
Shen,Pantheon,215,102,113,47.44
Shen,Samira,120,69,51,57.5
Shen,Hwei,113,59,54,52.21
Shen,Rell,121,55,66,45.45
Shen,Rengar,51,28,23,54.9
Shen,Sett,230,106,124,46.09
Shen,Mel,328,170,158,51.83
Shen,Varus,118,76,42,64.41
Shen,Fiora,61,28,33,45.9
Shen,Singed,55,28,27,50.91
Shen,Yasuo,330,192,138,58.18
Shen,Caitlyn,379,220,159,58.05
Shen,Milio,118,59,59,50
Shen,Yorick,112,46,66,41.07
Shen,Diana,181,87,94,48.07
Shen,Ashe,310,149,161,48.06
Shen,Lulu,214,93,121,43.46
Shen,Aatrox,118,74,44,62.71
Shen,Lillia,74,28,46,37.84
Shen,Amumu,211,94,117,44.55
Shen,Warwick,191,77,114,40.31
Shen,Katarina,79,51,28,64.56
Shen,Taric,45,23,22,51.11
Shen,Zed,127,74,53,58.27
Shen,FiddleSticks,69,33,36,47.83
Shen,Irelia,97,72,25,74.23
Shen,Ekko,121,51,70,42.15
Shen,Qiyana,18,13,5,72.22
Shen,Thresh,261,156,105,59.77
Shen,Sion,153,74,79,48.37
Shen,Viktor,159,81,78,50.94
Shen,Jinx,397,181,216,45.59
Shen,Vladimir,108,42,66,38.89
Shen,Akali,131,78,53,59.54
Shen,Vayne,258,125,133,48.45
Shen,Nami,168,90,78,53.57
Shen,Chogath,200,102,98,51
Shen,JarvanIV,128,65,63,50.78
Shen,Tristana,120,52,68,43.33
Shen,Alistar,80,50,30,62.5
Shen,Trundle,106,59,47,55.66
Shen,RekSai,24,10,14,41.67
Shen,Leblanc,72,33,39,45.83
Shen,Gangplank,90,54,36,60
Shen,Kayn,170,96,74,56.47
Shen,Taliyah,48,16,32,33.33
Shen,MissFortune,315,139,176,44.13
Shen,Leona,172,84,88,48.84
Shen,Briar,83,39,44,46.99
Shen,Sylas,251,141,110,56.18
Shen,Veigar,143,70,73,48.95
Shen,Ziggs,74,41,33,55.41
Shen,KSante,74,52,22,70.27
Shen,Draven,57,22,35,38.6
Shen,Zoe,66,43,23,65.15
Shen,Kayle,103,64,39,62.14
Shen,Nidalee,48,27,21,56.25
Shen,Braum,137,72,65,52.55
Shen,Urgot,72,29,43,40.28
Shen,Yone,226,121,105,53.54
Shen,Kalista,62,41,21,66.13
Shen,Galio,160,84,76,52.5
Shen,Shaco,136,72,64,52.94
Shen,Azir,69,35,34,50.72
Shen,TahmKench,104,47,57,45.19
Shen,Aurora,119,55,64,46.22
Shen,Sona,21,6,15,28.57
Shen,Garen,235,117,118,49.79
Shen,Orianna,87,49,38,56.32
Shen,Brand,107,52,55,48.6
Shen,Camille,80,41,39,51.25
Shen,Darius,265,122,143,46.04
Shen,Lux,289,151,138,52.25
Shen,Pyke,127,82,45,64.57
Shen,Nautilus,204,114,90,55.88
Shen,Mordekaiser,183,90,93,49.18
Shen,Malzahar,165,91,74,55.15
Shen,KogMaw,38,25,13,65.79
Shen,Twitch,119,73,46,61.34
Shen,Nocturne,166,87,79,52.41
Shen,Karma,159,80,79,50.31
Shen,Renekton,83,48,35,57.83
Shen,Jayce,53,23,30,43.4
Shen,Zyra,105,53,52,50.48
Shen,Corki,60,41,19,68.33
Shen,LeeSin,234,152,82,64.96
Shen,Swain,155,59,96,38.06
Shen,Blitzcrank,150,55,95,36.67
Shen,MasterYi,156,101,55,64.74
Shen,Vex,47,15,32,31.91
Shen,Morgana,167,97,70,58.08
Shen,Teemo,105,65,40,61.9
Shen,Ezreal,332,204,128,61.45
Shen,Neeko,59,30,29,50.85
Shen,Gnar,101,64,37,63.37
Shen,MonkeyKing,126,62,64,49.21
Shen,Poppy,107,52,55,48.6
Shen,Velkoz,104,49,55,47.12
Shen,Riven,61,32,29,52.46
Shen,Zeri,50,29,21,58
Shen,Xerath,156,93,63,59.62
Shen,Fizz,87,40,47,45.98
Shen,Skarner,76,45,31,59.21
Shen,Volibear,149,85,64,57.05
Shen,Janna,56,28,28,50
Shen,DrMundo,62,22,40,35.48
Shen,Vi,139,66,73,47.48
Shen,Nunu,116,51,65,43.97
Shen,Nasus,66,34,32,51.52
Shen,Gwen,107,57,50,53.27
Shen,Malphite,150,75,75,50
Shen,Jax,118,73,45,61.86
Shen,Kaisa,272,138,134,50.74
Shen,Khazix,101,53,48,52.48
Shen,Elise,135,83,52,61.48
Shen,Jhin,260,131,129,50.38
Shen,XinZhao,126,61,65,48.41
Shen,Lucian,120,82,38,68.33
Shen,Viego,210,98,112,46.67
Shen,Ivern,31,17,14,54.84
Shen,Evelynn,47,20,27,42.55
Shen,Belveth,29,12,17,41.38
Shen,Udyr,58,35,23,60.34
Shen,Seraphine,111,70,41,63.06
Shen,Aphelios,95,54,41,56.84
Shen,Kindred,77,44,33,57.14
Shen,Zac,79,40,39,50.63
Shen,Yuumi,91,59,32,64.84
Shen,Rumble,46,22,24,47.83
Shen,Karthus,39,22,17,56.41
Shen,Syndra,132,57,75,43.18
Shen,Kassadin,44,14,30,31.82
Shen,Tryndamere,59,28,31,47.46
Shen,Talon,88,47,41,53.41
Shen,Akshan,56,31,25,55.36
Shen,Ahri,165,84,81,50.91
Shen,Kennen,25,13,12,52
Shen,Naafiri,72,37,35,51.39
Shen,Sivir,83,23,60,27.71
Shen,Soraka,60,40,20,66.67
Shen,Sejuani,103,44,59,42.72
Shen,Nilah,49,17,32,34.69
Shen,Senna,68,34,34,50
Shen,Annie,40,23,17,57.5
Shen,Zilean,28,6,22,21.43
Shen,Smolder,70,34,36,48.57
Shen,Anivia,75,38,37,50.67
Shen,AurelionSol,72,37,35,51.39
Shen,Lissandra,51,20,31,39.22
Shen,TwistedFate,58,30,28,51.72
Shen,Graves,71,32,39,45.07
Shen,Bard,54,25,29,46.3
Shen,Xayah,120,63,57,52.5
Shen,Rakan,108,65,43,60.19
Shen,Olaf,47,26,21,55.32
Shen,Cassiopeia,33,16,17,48.48
Shen,Illaoi,93,45,48,48.39
Shen,Hecarim,49,27,22,55.1
Shen,Ornn,100,50,50,50
Shen,Heimerdinger,55,35,20,63.64
Shen,Rammus,46,29,17,63.04
Shen,Kled,26,13,13,50
Shen,Maokai,45,33,12,73.33
Shen,Ryze,71,31,40,43.66
Shen,Shyvana,25,10,15,40
Shen,Renata,33,11,22,33.33
Shen,Quinn,23,9,14,39.13
Nami,Ambessa,136,82,54,60.29
Nami,Gragas,170,98,72,57.65
Nami,Pantheon,301,162,139,53.82
Nami,Samira,165,77,88,46.67
Nami,Hwei,129,72,57,55.81
Nami,Yone,305,162,143,53.11
Nami,Nocturne,267,129,138,48.31
Nami,Akali,156,51,105,32.69
Nami,Ezreal,374,218,156,58.29
Nami,Renata,72,41,31,56.94
Nami,Volibear,210,109,101,51.9
Nami,Elise,144,87,57,60.42
Nami,Malzahar,214,131,83,61.21
Nami,Caitlyn,532,262,270,49.25
Nami,Milio,227,117,110,51.54
Nami,Rell,135,65,70,48.15
Nami,Rengar,77,51,26,66.23
Nami,Sett,233,108,125,46.35
Nami,Mel,454,254,200,55.95
Nami,Varus,192,113,79,58.85
Nami,Kayn,203,132,71,65.02
Nami,Ahri,306,153,153,50
Nami,MissFortune,434,244,190,56.22
Nami,Amumu,251,134,117,53.39
Nami,Darius,338,166,172,49.11
Nami,Vi,240,133,107,55.42
Nami,Aphelios,101,63,38,62.38
Nami,Soraka,107,55,52,51.4
Nami,Vladimir,106,57,49,53.77
Nami,MasterYi,164,86,78,52.44
Nami,Leona,178,96,82,53.93
Nami,Ashe,349,177,172,50.72
Nami,Mordekaiser,236,106,130,44.92
Nami,Teemo,219,134,85,61.19
Nami,Katarina,204,97,107,47.55
Nami,Singed,59,35,24,59.32
Nami,Poppy,163,78,85,47.85
Nami,FiddleSticks,69,35,34,50.72
Nami,Lux,481,228,253,47.4
Nami,Braum,192,99,93,51.56
Nami,Aurora,157,85,72,54.14
Nami,Rakan,119,74,45,62.18
Nami,Nasus,153,73,80,47.71
Nami,MonkeyKing,150,65,85,43.33
Nami,Viktor,187,95,92,50.8
Nami,Malphite,211,112,99,53.08
Nami,Briar,92,39,53,42.39
Nami,Zed,153,82,71,53.59
Nami,Seraphine,152,66,86,43.42
Nami,TwistedFate,84,32,52,38.1
Nami,Xayah,115,61,54,53.04
Nami,Sion,199,84,115,42.21
Nami,Shen,168,78,90,46.43
Nami,LeeSin,257,144,113,56.03
Nami,Orianna,110,49,61,44.55
Nami,Garen,356,152,204,42.7
Nami,Talon,106,60,46,56.6
Nami,Sivir,114,55,59,48.25
Nami,Lulu,427,241,186,56.44
Nami,Kennen,62,43,19,69.35
Nami,Pyke,134,62,72,46.27
Nami,Kayle,145,70,75,48.28
Nami,Warwick,239,108,131,45.19
Nami,Irelia,114,74,40,64.91
Nami,Yasuo,363,170,193,46.83
Nami,Gangplank,87,45,42,51.72
Nami,Ekko,166,80,86,48.19
Nami,Alistar,92,48,44,52.17
Nami,Draven,131,63,68,48.09
Nami,Renekton,126,72,54,57.14
Nami,Karma,309,183,126,59.22
Nami,KSante,108,67,41,62.04
Nami,Zoe,110,65,45,59.09
Nami,Veigar,183,101,82,55.19
Nami,Lillia,79,37,42,46.84
Nami,Jayce,75,42,33,56
Nami,Smolder,159,79,80,49.69
Nami,Nunu,152,95,57,62.5
Nami,Thresh,308,158,150,51.3
Nami,Jhin,414,192,222,46.38
Nami,TahmKench,224,86,138,38.39
Nami,XinZhao,157,85,72,54.14
Nami,Kaisa,291,153,138,52.58
Nami,Brand,86,47,39,54.65
Nami,Azir,79,44,35,55.7
Nami,Jax,153,87,66,56.86
Nami,Diana,274,138,136,50.36
Nami,Tryndamere,82,37,45,45.12
Nami,Morgana,148,80,68,54.05
Nami,Khazix,127,70,57,55.12
Nami,Camille,91,37,54,40.66
Nami,Udyr,57,27,30,47.37
Nami,Nidalee,59,38,21,64.41
Nami,Zac,143,63,80,44.06
Nami,Swain,197,122,75,61.93
Nami,Yuumi,149,93,56,62.42
Nami,Viego,247,121,126,48.99
Nami,Senna,99,57,42,57.58
Nami,Gwen,83,46,37,55.42
Nami,Hecarim,69,38,31,55.07
Nami,Ryze,95,57,38,60
Nami,Graves,93,54,39,58.06
Nami,Xerath,168,62,106,36.9
Nami,Zyra,164,74,90,45.12
Nami,Heimerdinger,68,26,42,38.24
Nami,Urgot,131,73,58,55.73
Nami,Sejuani,158,68,90,43.04
Nami,Vayne,235,136,99,57.87
Nami,Vex,93,53,40,56.99
Nami,Blitzcrank,169,92,77,54.44
Nami,Yorick,190,88,102,46.32
Nami,Aatrox,170,92,78,54.12
Nami,Shaco,137,65,72,47.45
Nami,Jinx,548,283,265,51.64
Nami,Ivern,48,21,27,43.75
Nami,Rammus,54,33,21,61.11
Nami,Nautilus,245,162,83,66.12
Nami,DrMundo,110,57,53,51.82
Nami,Zilean,77,57,20,74.03
Nami,Neeko,92,56,36,60.87
Nami,Fiora,71,40,31,56.34
Nami,Qiyana,38,19,19,50
Nami,Leblanc,123,57,66,46.34
Nami,Karthus,81,54,27,66.67
Nami,Evelynn,90,50,40,55.56
Nami,Janna,80,21,59,26.25
Nami,Chogath,264,140,124,53.03
Nami,Corki,99,65,34,65.66
Nami,Galio,212,92,120,43.4
Nami,Cassiopeia,66,32,34,48.48
Nami,Zeri,66,38,28,57.58
Nami,AurelionSol,75,30,45,40
Nami,Fizz,81,42,39,51.85
Nami,Twitch,146,69,77,47.26
Nami,Taliyah,42,26,16,61.9
Nami,Lissandra,94,46,48,48.94
Nami,Sona,58,20,38,34.48
Nami,Illaoi,75,51,24,68
Nami,Belveth,55,31,24,56.36
Nami,Kassadin,40,26,14,65
Nami,Rumble,46,26,20,56.52
Nami,Tristana,153,81,72,52.94
Nami,Lucian,186,102,84,54.84
Nami,Sylas,190,106,84,55.79
Nami,Taric,36,16,20,44.44
Nami,Naafiri,58,24,34,41.38
Nami,Anivia,74,40,34,54.05
Nami,Ziggs,57,35,22,61.4
Nami,Kled,60,32,28,53.33
Nami,Bard,76,36,40,47.37
Nami,Syndra,166,97,69,58.43
Nami,Shyvana,60,24,36,40
Nami,RekSai,38,22,16,57.89
Nami,Olaf,34,14,20,41.18
Nami,Quinn,87,52,35,59.77
Nami,Skarner,118,57,61,48.31
Nami,Kalista,52,33,19,63.46
Nami,Kindred,102,52,50,50.98
Nami,Riven,87,34,53,39.08
Nami,KogMaw,93,39,54,41.94
Nami,Trundle,122,53,69,43.44
Nami,Maokai,119,60,59,50.42
Nami,Akshan,93,40,53,43.01
Nami,Gnar,94,68,26,72.34
Nami,Nilah,78,26,52,33.33
Nami,Velkoz,140,71,69,50.71
Nami,JarvanIV,145,67,78,46.21
Nami,Ornn,105,71,34,67.62
Nami,Annie,81,32,49,39.51
Gragas,Galio,172,65,107,37.79
Gragas,Hecarim,39,19,20,48.72
Gragas,Shen,114,48,66,42.11
Gragas,Kaisa,196,118,78,60.2
Gragas,Nami,170,72,98,42.35
Gragas,Yone,264,118,146,44.7
Gragas,JarvanIV,158,65,93,41.14
Gragas,Ryze,57,33,24,57.89
Gragas,Draven,72,36,36,50
Gragas,Blitzcrank,161,67,94,41.61
Gragas,Poppy,103,49,54,47.57
Gragas,Zac,71,33,38,46.48
Gragas,Malzahar,164,62,102,37.8
Gragas,MissFortune,255,122,133,47.84
Gragas,TahmKench,158,66,92,41.77
Gragas,Mordekaiser,181,90,91,49.72
Gragas,Zed,168,73,95,43.45
Gragas,Varus,148,68,80,45.95
Gragas,Pyke,109,52,57,47.71
Gragas,Vladimir,87,41,46,47.13
Gragas,MasterYi,163,84,79,51.53
Gragas,Leona,147,79,68,53.74
Gragas,Ashe,301,137,164,45.51
Gragas,Jax,150,68,82,45.33
Gragas,Diana,241,103,138,42.74
Gragas,Akshan,32,28,4,87.5
Gragas,Milio,115,56,59,48.7
Gragas,Urgot,46,22,24,47.83
Gragas,Ezreal,438,184,254,42.01
Gragas,Mel,295,157,138,53.22
Gragas,Warwick,189,95,94,50.26
Gragas,LeeSin,374,194,180,51.87
Gragas,Viktor,140,57,83,40.71
Gragas,Lucian,168,90,78,53.57
Gragas,Sett,203,90,113,44.33
Gragas,Veigar,132,57,75,43.18
Gragas,Lux,387,172,215,44.44
Gragas,Thresh,285,119,166,41.75
Gragas,Lissandra,55,34,21,61.82
Gragas,Irelia,141,74,67,52.48
Gragas,Lulu,216,115,101,53.24
Gragas,Vayne,183,84,99,45.9
Gragas,Ivern,25,16,9,64
Gragas,Qiyana,42,27,15,64.29
Gragas,Ahri,190,83,107,43.68
Gragas,Seraphine,100,40,60,40
Gragas,Shaco,108,44,64,40.74
Gragas,Fizz,67,31,36,46.27
Gragas,Aphelios,107,51,56,47.66
Gragas,Soraka,63,28,35,44.44
Gragas,DrMundo,60,39,21,65
Gragas,Zeri,52,35,17,67.31
Gragas,Rumble,65,51,14,78.46
Gragas,Yasuo,251,135,116,53.78
Gragas,Pantheon,260,132,128,50.77
Gragas,Ornn,119,61,58,51.26
Gragas,Vi,192,67,125,34.9
Gragas,Jhin,253,119,134,47.04
Gragas,Sion,149,66,83,44.3
Gragas,Xayah,106,43,63,40.57
Gragas,Aatrox,139,68,71,48.92
Gragas,Nocturne,174,68,106,39.08
Gragas,Caitlyn,354,190,164,53.67
Gragas,Xerath,144,51,93,35.42
Gragas,Kindred,103,37,66,35.92
Gragas,Riven,50,21,29,42
Gragas,Viego,174,75,99,43.1
Gragas,Naafiri,44,24,20,54.55
Gragas,Sejuani,107,52,55,48.6
Gragas,Heimerdinger,57,34,23,59.65
Gragas,Rell,106,39,67,36.79
Gragas,Azir,68,35,33,51.47
Gragas,Ekko,123,35,88,28.46
Gragas,Chogath,197,89,108,45.18
Gragas,Amumu,144,68,76,47.22
Gragas,Leblanc,134,68,66,50.75
Gragas,Morgana,142,64,78,45.07
Gragas,Talon,61,39,22,63.93
Gragas,Renata,29,14,15,48.28
Gragas,Taliyah,45,23,22,51.11
Gragas,Braum,111,48,63,43.24
Gragas,Swain,119,47,72,39.5
Gragas,MonkeyKing,88,51,37,57.95
Gragas,Rammus,52,20,32,38.46
Gragas,Zilean,72,41,31,56.94
Gragas,Kayn,177,70,107,39.55
Gragas,Rengar,29,13,16,44.83
Gragas,Smolder,90,38,52,42.22
Gragas,Janna,71,26,45,36.62
Gragas,Samira,110,60,50,54.55
Gragas,Aurora,119,69,50,57.98
Gragas,Jinx,410,174,236,42.44
Gragas,Khazix,105,48,57,45.71
Gragas,Malphite,106,49,57,46.23
Gragas,Belveth,33,12,21,36.36
Gragas,Velkoz,68,22,46,32.35
Gragas,Katarina,106,31,75,29.25
Gragas,Tristana,122,56,66,45.9
Gragas,Illaoi,85,35,50,41.18
Gragas,Volibear,141,70,71,49.65
Gragas,Quinn,50,33,17,66
Gragas,Zoe,75,28,47,37.33
Gragas,Nilah,59,19,40,32.2
Gragas,Evelynn,59,22,37,37.29
Gragas,Garen,229,99,130,43.23
Gragas,Rakan,73,47,26,64.38
Gragas,Darius,273,115,158,42.12
Gragas,Kled,22,11,11,50
Gragas,Orianna,88,39,49,44.32
Gragas,Briar,88,31,57,35.23
Gragas,Akali,112,48,64,42.86
Gragas,Hwei,106,47,59,44.34
Gragas,Neeko,49,29,20,59.18
Gragas,Karma,166,87,79,52.41
Gragas,Gnar,96,41,55,42.71
Gragas,Zyra,107,68,39,63.55
Gragas,Ambessa,111,44,67,39.64
Gragas,Alistar,90,53,37,58.89
Gragas,Annie,52,25,27,48.08
Gragas,Nasus,83,27,56,32.53
Gragas,RekSai,19,11,8,57.89
Gragas,Yuumi,112,29,83,25.89
Gragas,Elise,123,63,60,51.22
Gragas,TwistedFate,62,33,29,53.23
Gragas,Yorick,83,34,49,40.96
Gragas,Sylas,255,135,120,52.94
Gragas,Corki,95,42,53,44.21
Gragas,Cassiopeia,48,20,28,41.67
Gragas,Trundle,70,47,23,67.14
Gragas,Teemo,127,58,69,45.67
Gragas,KSante,142,74,68,52.11
Gragas,Kennen,33,14,19,42.42
Gragas,Nidalee,62,29,33,46.77
Gragas,Maokai,61,39,22,63.93
Gragas,Brand,84,45,39,53.57
Gragas,Gangplank,85,45,40,52.94
Gragas,Renekton,74,38,36,51.35
Gragas,AurelionSol,45,23,22,51.11
Gragas,Kayle,63,31,32,49.21
Gragas,Senna,96,49,47,51.04
Gragas,Nautilus,200,94,106,47
Gragas,Shyvana,27,11,16,40.74
Gragas,Singed,32,9,23,28.13
Gragas,Jayce,97,63,34,64.95
Gragas,Fiora,51,20,31,39.22
Gragas,Vex,73,26,47,35.62
Gragas,Gwen,50,26,24,52
Gragas,Syndra,88,50,38,56.82
Gragas,Anivia,68,39,29,57.35
Gragas,KogMaw,35,22,13,62.86
Gragas,Bard,56,39,17,69.64
Gragas,Lillia,98,44,54,44.9
Gragas,Skarner,80,43,37,53.75
Gragas,Kassadin,34,12,22,35.29
Gragas,Kalista,58,32,26,55.17
Gragas,Olaf,48,12,36,25
Gragas,Ziggs,68,39,29,57.35
Gragas,Nunu,85,40,45,47.06
Gragas,Twitch,87,29,58,33.33
Gragas,Graves,74,18,56,24.32
Gragas,Tryndamere,50,25,25,50
Gragas,Karthus,26,13,13,50
Gragas,Sivir,61,22,39,36.07
Gragas,Camille,62,32,30,51.61
Gragas,Sona,18,8,10,44.44
Gragas,Taric,44,16,28,36.36
Gragas,Udyr,52,26,26,50
Gragas,XinZhao,95,49,46,51.58
Gragas,FiddleSticks,45,26,19,57.78
Samira,Galio,153,76,77,49.67
Samira,Hecarim,45,28,17,62.22
Samira,Shen,120,51,69,42.5
Samira,Kaisa,233,110,123,47.21
Samira,Nami,165,88,77,53.33
Samira,Quinn,40,21,19,52.5
Samira,MasterYi,157,81,76,51.59
Samira,Garen,208,92,116,44.23
Samira,Smolder,111,51,60,45.95
Samira,Nautilus,219,91,128,41.55
Samira,Jax,117,58,59,49.57
Samira,Graves,115,67,48,58.26
Samira,Kassadin,40,23,17,57.5
Samira,Tristana,119,70,49,58.82
Samira,Ambessa,120,56,64,46.67
Samira,Ahri,236,102,134,43.22
Samira,AurelionSol,68,25,43,36.76
Samira,Rakan,117,58,59,49.57
Samira,Yorick,154,90,64,58.44
Samira,Skarner,98,35,63,35.71
Samira,Mel,334,181,153,54.19
Samira,Senna,99,48,51,48.48
Samira,Sylas,223,118,105,52.91
Samira,Blitzcrank,163,93,70,57.06
Samira,Nasus,83,53,30,63.86
Samira,Anivia,68,40,28,58.82
Samira,Vayne,245,124,121,50.61
Samira,Yuumi,145,79,66,54.48
Samira,XinZhao,114,71,43,62.28
Samira,Azir,83,47,36,56.63
Samira,Jinx,378,195,183,51.59
Samira,Rell,103,52,51,50.49
Samira,Vladimir,95,53,42,55.79
Samira,LeeSin,260,123,137,47.31
Samira,Yasuo,298,126,172,42.28
Samira,MissFortune,319,132,187,41.38
Samira,Sett,268,136,132,50.75
Samira,Hwei,103,49,54,47.57
Samira,TahmKench,121,70,51,57.85
Samira,Heimerdinger,74,35,39,47.3
Samira,Ashe,234,129,105,55.13
Samira,Orianna,70,40,30,57.14
Samira,Seraphine,138,74,64,53.62
Samira,Pantheon,252,106,146,42.06
Samira,Viktor,149,62,87,41.61
Samira,Milio,120,61,59,50.83
Samira,Malphite,167,73,94,43.71
Samira,Kayn,227,117,110,51.54
Samira,Lucian,122,77,45,63.11
Samira,TwistedFate,67,33,34,49.25
Samira,JarvanIV,100,53,47,53
Samira,Vex,52,17,35,32.69
Samira,Morgana,184,95,89,51.63
Samira,Darius,320,160,160,50
Samira,Viego,221,100,121,45.25
Samira,Draven,109,64,45,58.72
Samira,Riven,52,22,30,42.31
Samira,Diana,185,107,78,57.84
Samira,Zoe,33,11,22,33.33
Samira,Ezreal,358,196,162,54.75
Samira,Urgot,51,19,32,37.25
Samira,Vi,119,68,51,57.14
Samira,Syndra,104,57,47,54.81
Samira,Caitlyn,356,154,202,43.26
Samira,Nocturne,126,53,73,42.06
Samira,Taliyah,42,22,20,52.38
Samira,Lux,344,161,183,46.8
Samira,Volibear,201,80,121,39.8
Samira,Varus,144,64,80,44.44
Samira,Braum,108,38,70,35.19
Samira,Sejuani,93,43,50,46.24
Samira,Leblanc,90,52,38,57.78
Samira,Irelia,96,48,48,50
Samira,Malzahar,172,84,88,48.84
Samira,Amumu,183,79,104,43.17
Samira,Ekko,122,59,63,48.36
Samira,Mordekaiser,205,116,89,56.59
Samira,Akali,146,75,71,51.37
Samira,Taric,39,10,29,25.64
Samira,Teemo,142,72,70,50.7
Samira,Zed,147,75,72,51.02
Samira,Singed,40,30,10,75
Samira,Akshan,38,24,14,63.16
Samira,Velkoz,102,52,50,50.98
Samira,Veigar,153,69,84,45.1
Samira,Gragas,110,50,60,45.45
Samira,Swain,148,63,85,42.57
Samira,RekSai,13,6,7,46.15
Samira,Rumble,38,19,19,50
Samira,Jhin,340,148,192,43.53
Samira,Zyra,98,46,52,46.94
Samira,Chogath,150,59,91,39.33
Samira,Corki,68,39,29,57.35
Samira,Nilah,110,48,62,43.64
Samira,Thresh,229,138,91,60.26
Samira,Kayle,99,46,53,46.46
Samira,Cassiopeia,45,18,27,40
Samira,Gwen,73,23,50,31.51
Samira,FiddleSticks,50,17,33,34
Samira,Aphelios,93,53,40,56.99
Samira,Leona,156,87,69,55.77
Samira,Ryze,75,33,42,44
Samira,Belveth,31,19,12,61.29
Samira,Fizz,88,37,51,42.05
Samira,Ornn,110,61,49,55.45
Samira,Elise,94,41,53,43.62
Samira,Katarina,109,70,39,64.22
Samira,Lulu,167,90,77,53.89
Samira,Sion,146,63,83,43.15
Samira,Zac,78,39,39,50
Samira,Tryndamere,44,18,26,40.91
Samira,Naafiri,63,38,25,60.32
Samira,Aurora,117,50,67,42.74
Samira,Aatrox,162,79,83,48.77
Samira,Poppy,79,32,47,40.51
Samira,Nunu,111,51,60,45.95
Samira,Gangplank,72,28,44,38.89
Samira,Kindred,63,40,23,63.49
Samira,Olaf,37,9,28,24.32
Samira,KSante,105,45,60,42.86
Samira,Rengar,52,22,30,42.31
Samira,Khazix,79,42,37,53.16
Samira,Trundle,78,31,47,39.74
Samira,Xerath,138,77,61,55.8
Samira,Camille,54,23,31,42.59
Samira,Brand,79,42,37,53.16
Samira,Ziggs,55,22,33,40
Samira,Shaco,112,67,45,59.82
Samira,Rammus,54,23,31,42.59
Samira,Alistar,78,28,50,35.9
Samira,Yone,287,158,129,55.05
Samira,Soraka,71,41,30,57.75
Samira,Neeko,78,43,35,55.13
Samira,Karma,110,51,59,46.36
Samira,Pyke,148,93,55,62.84
Samira,Janna,63,39,24,61.9
Samira,Nidalee,58,38,20,65.52
Samira,Illaoi,70,33,37,47.14
Samira,Briar,112,69,43,61.61
Samira,Zeri,77,32,45,41.56
Samira,Lissandra,71,43,28,60.56
Samira,Shyvana,33,12,21,36.36
Samira,Twitch,151,58,93,38.41
Samira,Annie,46,22,24,47.83
Samira,Warwick,157,72,85,45.86
Samira,Udyr,60,36,24,60
Samira,Jayce,70,54,16,77.14
Samira,Kalista,59,37,22,62.71
Samira,Sona,22,14,8,63.64
Samira,Talon,62,35,27,56.45
Samira,Maokai,63,29,34,46.03
Samira,KogMaw,45,24,21,53.33
Samira,Lillia,87,50,37,57.47
Samira,Sivir,79,39,40,49.37
Samira,MonkeyKing,138,59,79,42.75
Samira,Bard,44,23,21,52.27
Samira,Gnar,49,35,14,71.43
Samira,Fiora,65,30,35,46.15
Samira,Karthus,43,20,23,46.51
Samira,Zilean,41,12,29,29.27
Samira,Renekton,108,57,51,52.78
Samira,Xayah,100,51,49,51
Samira,DrMundo,58,28,30,48.28
Samira,Evelynn,32,9,23,28.13
Samira,Ivern,26,18,8,69.23
Samira,Renata,42,16,26,38.1
Samira,Qiyana,37,10,27,27.03
Samira,Kennen,37,14,23,37.84
Samira,Kled,17,12,5,70.59
Lillia,Yorick,101,55,46,54.46
Lillia,Teemo,127,77,50,60.63
Lillia,Katarina,70,37,33,52.86
Lillia,Jhin,247,144,103,58.3
Lillia,Lux,236,104,132,44.07
Lillia,Volibear,129,69,60,53.49
Lillia,Elise,113,70,43,61.95
Lillia,Malzahar,116,65,51,56.03
Lillia,Caitlyn,253,132,121,52.17
Lillia,Milio,78,45,33,57.69
Lillia,Jayce,42,20,22,47.62
Lillia,Zilean,47,26,21,55.32
Lillia,Briar,66,44,22,66.67
Lillia,Nocturne,175,83,92,47.43
Lillia,Lissandra,37,14,23,37.84
Lillia,Shen,74,46,28,62.16
Lillia,Renekton,77,43,34,55.84
Lillia,Diana,151,79,72,52.32
Lillia,Varus,94,59,35,62.77
Lillia,Karma,116,65,51,56.03
Lillia,MonkeyKing,94,44,50,46.81
Lillia,Vayne,119,55,64,46.22
Lillia,Fiora,34,11,23,32.35
Lillia,Soraka,58,37,21,63.79
Lillia,Azir,45,22,23,48.89
Lillia,Ambessa,86,47,39,54.65
Lillia,LeeSin,205,110,95,53.66
Lillia,Viktor,93,46,47,49.46
Lillia,Thresh,271,116,155,42.8
Lillia,Singed,44,18,26,40.91
Lillia,Yasuo,230,127,103,55.22
Lillia,Leblanc,85,38,47,44.71
Lillia,Gnar,63,51,12,80.95
Lillia,Akali,135,75,60,55.56
Lillia,Lucian,101,57,44,56.44
Lillia,DrMundo,77,42,35,54.55
Lillia,Xerath,89,45,44,50.56
Lillia,Nami,79,42,37,53.16
Lillia,Warwick,132,67,65,50.76
Lillia,Graves,66,17,49,25.76
Lillia,Draven,56,31,25,55.36
Lillia,Yone,241,121,120,50.21
Lillia,Pantheon,164,79,85,48.17
Lillia,Twitch,91,36,55,39.56
Lillia,Hwei,57,28,29,49.12
Lillia,Heimerdinger,59,42,17,71.19
Lillia,JarvanIV,51,35,16,68.63
Lillia,Naafiri,39,22,17,56.41
Lillia,Jinx,271,110,161,40.59
Lillia,Nasus,75,49,26,65.33
Lillia,Ashe,191,119,72,62.3
Lillia,Mel,248,141,107,56.85
Lillia,Zac,81,39,42,48.15
Lillia,Swain,135,76,59,56.3
Lillia,Yuumi,85,26,59,30.59
Lillia,Viego,116,68,48,58.62
Lillia,Aatrox,90,39,51,43.33
Lillia,Ekko,116,65,51,56.03
Lillia,Xayah,80,45,35,56.25
Lillia,Shaco,84,49,35,58.33
Lillia,Sett,166,105,61,63.25
Lillia,Fizz,60,25,35,41.67
Lillia,Garen,151,65,86,43.05
Lillia,Kayn,129,61,68,47.29
Lillia,Ahri,152,83,69,54.61
Lillia,Ezreal,261,112,149,42.91
Lillia,Corki,36,20,16,55.56
Lillia,Nilah,39,23,16,58.97
Lillia,Gangplank,53,24,29,45.28
Lillia,Poppy,103,53,50,51.46
Lillia,Aphelios,61,31,30,50.82
Lillia,Vex,85,44,41,51.76
Lillia,Lulu,145,74,71,51.03
Lillia,TahmKench,94,40,54,42.55
Lillia,MasterYi,86,51,35,59.3
Lillia,Blitzcrank,109,69,40,63.3
Lillia,Darius,199,92,107,46.23
Lillia,FiddleSticks,42,22,20,52.38
Lillia,KogMaw,37,15,22,40.54
Lillia,Malphite,116,52,64,44.83
Lillia,Rammus,55,41,14,74.55
Lillia,Zyra,94,49,45,52.13
Lillia,Ornn,59,30,29,50.85
Lillia,Irelia,80,29,51,36.25
Lillia,Kaisa,156,88,68,56.41
Lillia,Mordekaiser,114,63,51,55.26
Lillia,Alistar,58,32,26,55.17
Lillia,KSante,108,71,37,65.74
Lillia,Sejuani,107,54,53,50.47
Lillia,MissFortune,241,131,110,54.36
Lillia,Rell,61,29,32,47.54
Lillia,Karthus,44,11,33,25
Lillia,Pyke,69,37,32,53.62
Lillia,Trundle,66,26,40,39.39
Lillia,Nautilus,181,90,91,49.72
Lillia,Kayle,64,27,37,42.19
Lillia,Vladimir,57,30,27,52.63
Lillia,Tryndamere,44,24,20,54.55
Lillia,Kassadin,25,22,3,88
Lillia,Jax,117,73,44,62.39
Lillia,Riven,39,20,19,51.28
Lillia,Orianna,76,31,45,40.79
Lillia,Rumble,39,30,9,76.92
Lillia,Braum,116,58,58,50
Lillia,Seraphine,65,31,34,47.69
Lillia,Udyr,67,49,18,73.13
Lillia,Kalista,34,16,18,47.06
Lillia,Kennen,30,19,11,63.33
Lillia,Rakan,60,31,29,51.67
Lillia,Quinn,44,15,29,34.09
Lillia,Shyvana,23,9,14,39.13
Lillia,AurelionSol,65,30,35,46.15
Lillia,Vi,118,57,61,48.31
Lillia,Aurora,97,58,39,59.79
Lillia,Talon,66,30,36,45.45
Lillia,Syndra,60,35,25,58.33
Lillia,Rengar,17,8,9,47.06
Lillia,Skarner,72,46,26,63.89
Lillia,Gragas,98,54,44,55.1
Lillia,XinZhao,56,26,30,46.43
Lillia,Ryze,30,13,17,43.33
Lillia,Cassiopeia,34,12,22,35.29
Lillia,Veigar,150,79,71,52.67
Lillia,Amumu,110,41,69,37.27
Lillia,Ivern,22,12,10,54.55
Lillia,Nunu,61,32,29,52.46
Lillia,Khazix,82,42,40,51.22
Lillia,Annie,37,14,23,37.84
Lillia,Akshan,32,12,20,37.5
Lillia,Zeri,59,20,39,33.9
Lillia,Brand,73,30,43,41.1
Lillia,Zed,72,48,24,66.67
Lillia,Chogath,153,74,79,48.37
Lillia,Taliyah,24,11,13,45.83
Lillia,Taric,31,18,13,58.06
Lillia,Morgana,127,52,75,40.94
Lillia,Hecarim,40,14,26,35
Lillia,Samira,87,37,50,42.53
Lillia,Sylas,159,75,84,47.17
Lillia,Neeko,39,14,25,35.9
Lillia,Sion,74,44,30,59.46
Lillia,Renata,40,25,15,62.5
Lillia,Maokai,54,25,29,46.3
Lillia,Gwen,41,15,26,36.59
Lillia,Galio,119,71,48,59.66
Lillia,Urgot,60,29,31,48.33
Lillia,Anivia,34,5,29,14.71
Lillia,Velkoz,35,16,19,45.71
Lillia,TwistedFate,59,33,26,55.93
Lillia,Kindred,68,37,31,54.41
Lillia,Senna,66,22,44,33.33
Lillia,Ziggs,25,14,11,56
Lillia,Sona,11,6,5,54.55
Lillia,Illaoi,62,36,26,58.06
Lillia,Tristana,103,54,49,52.43
Lillia,Leona,101,53,48,52.48
Lillia,Janna,28,18,10,64.29
Lillia,Smolder,66,38,28,57.58
Lillia,Nidalee,35,24,11,68.57
Lillia,Kled,20,0,20,0
Lillia,Qiyana,12,8,4,66.67
Lillia,Sivir,61,26,35,42.62
Lillia,Bard,31,15,16,48.39
Lillia,Evelynn,35,11,24,31.43
Lillia,Camille,38,12,26,31.58
Lillia,RekSai,8,5,3,62.5
Lillia,Olaf,27,12,15,44.44
Lillia,Belveth,9,3,6,33.33
Lillia,Zoe,20,8,12,40
Tryndamere,Yorick,90,64,26,71.11
Tryndamere,Teemo,71,28,43,39.44
Tryndamere,Katarina,62,28,34,45.16
Tryndamere,Jhin,128,69,59,53.91
Tryndamere,Lux,183,97,86,53.01
Tryndamere,Trundle,44,27,17,61.36
Tryndamere,Twitch,58,28,30,48.28
Tryndamere,Ahri,138,69,69,50
Tryndamere,Graves,49,22,27,44.9
Tryndamere,Lulu,93,41,52,44.09
Tryndamere,Skarner,26,11,15,42.31
Tryndamere,Mel,144,64,80,44.44
Tryndamere,Smolder,49,40,9,81.63
Tryndamere,Senna,47,27,20,57.45
Tryndamere,Jayce,33,14,19,42.42
Tryndamere,Sejuani,47,23,24,48.94
Tryndamere,Fizz,40,19,21,47.5
Tryndamere,Caitlyn,179,81,98,45.25
Tryndamere,Alistar,25,7,18,28
Tryndamere,Sion,60,22,38,36.67
Tryndamere,MasterYi,77,46,31,59.74
Tryndamere,Xayah,59,21,38,35.59
Tryndamere,Seraphine,43,32,11,74.42
Tryndamere,Riven,20,13,7,65
Tryndamere,Viego,84,42,42,50
Tryndamere,Naafiri,27,18,9,66.67
Tryndamere,Ashe,105,53,52,50.48
Tryndamere,Nami,82,45,37,54.88
Tryndamere,Garen,153,82,71,53.59
Tryndamere,FiddleSticks,36,12,24,33.33
Tryndamere,Xerath,71,26,45,36.62
Tryndamere,Swain,64,34,30,53.13
Tryndamere,Jax,85,43,42,50.59
Tryndamere,Amumu,91,51,40,56.04
Tryndamere,KSante,41,20,21,48.78
Tryndamere,Malzahar,68,28,40,41.18
Tryndamere,Tristana,96,52,44,54.17
Tryndamere,Leona,71,36,35,50.7
Tryndamere,Darius,142,79,63,55.63
Tryndamere,Khazix,38,20,18,52.63
Tryndamere,Qiyana,16,7,9,43.75
Tryndamere,Morgana,108,46,62,42.59
Tryndamere,Singed,25,11,14,44
Tryndamere,Talon,29,12,17,41.38
Tryndamere,Draven,22,6,16,27.27
Tryndamere,Thresh,111,66,45,59.46
Tryndamere,Mordekaiser,129,63,66,48.84
Tryndamere,LeeSin,141,77,64,54.61
Tryndamere,Jinx,193,76,117,39.38
Tryndamere,Belveth,18,10,8,55.56
Tryndamere,Hwei,54,30,24,55.56
Tryndamere,Yasuo,122,69,53,56.56
Tryndamere,Rakan,47,27,20,57.45
Tryndamere,Sylas,68,29,39,42.65
Tryndamere,Shaco,51,18,33,35.29
Tryndamere,Vladimir,53,28,25,52.83
Tryndamere,Ornn,25,12,13,48
Tryndamere,Rell,40,18,22,45
Tryndamere,TahmKench,74,39,35,52.7
Tryndamere,Cassiopeia,14,9,5,64.29
Tryndamere,Zeri,17,5,12,29.41
Tryndamere,Janna,20,8,12,40
Tryndamere,Urgot,36,18,18,50
Tryndamere,Kayn,100,46,54,46
Tryndamere,MissFortune,176,97,79,55.11
Tryndamere,Karma,101,55,46,54.46
Tryndamere,JarvanIV,46,22,24,47.83
Tryndamere,Nasus,42,17,25,40.48
Tryndamere,Malphite,114,55,59,48.25
Tryndamere,Samira,44,26,18,59.09
Tryndamere,Orianna,38,24,14,63.16
Tryndamere,Yuumi,50,28,22,56
Tryndamere,Yone,125,60,65,48
Tryndamere,Milio,76,25,51,32.89
Tryndamere,XinZhao,49,29,20,59.18
Tryndamere,Lillia,44,20,24,45.45
Tryndamere,Aatrox,57,32,25,56.14
Tryndamere,Pantheon,80,34,46,42.5
Tryndamere,Veigar,76,43,33,56.58
Tryndamere,Ivern,30,22,8,73.33
Tryndamere,Ekko,71,25,46,35.21
Tryndamere,Varus,54,16,38,29.63
Tryndamere,Renata,19,15,4,78.95
Tryndamere,Gnar,33,17,16,51.52
Tryndamere,AurelionSol,33,15,18,45.45
Tryndamere,Ezreal,160,73,87,45.63
Tryndamere,Gwen,32,20,12,62.5
Tryndamere,MonkeyKing,66,29,37,43.94
Tryndamere,Azir,18,10,8,55.56
Tryndamere,Shyvana,20,8,12,40
Tryndamere,Ambessa,73,33,40,45.21
Tryndamere,Vi,70,44,26,62.86
Tryndamere,Brand,56,30,26,53.57
Tryndamere,Gangplank,26,16,10,61.54
Tryndamere,Ziggs,31,23,8,74.19
Tryndamere,Rengar,39,13,26,33.33
Tryndamere,Quinn,35,20,15,57.14
Tryndamere,Udyr,20,3,17,15
Tryndamere,Kaisa,124,68,56,54.84
Tryndamere,Rammus,48,32,16,66.67
Tryndamere,Leblanc,31,9,22,29.03
Tryndamere,Nidalee,17,9,8,52.94
Tryndamere,Warwick,86,32,54,37.21
Tryndamere,Vayne,85,31,54,36.47
Tryndamere,KogMaw,30,6,24,20
Tryndamere,Nocturne,73,39,34,53.42
Tryndamere,Taliyah,21,13,8,61.9
Tryndamere,Galio,61,35,26,57.38
Tryndamere,Zed,40,22,18,55
Tryndamere,Shen,59,31,28,52.54
Tryndamere,Nunu,51,22,29,43.14
Tryndamere,Aurora,66,26,40,39.39
Tryndamere,Heimerdinger,47,29,18,61.7
Tryndamere,Akali,87,59,28,67.82
Tryndamere,Volibear,71,32,39,45.07
Tryndamere,Pyke,78,38,40,48.72
Tryndamere,Zac,38,11,27,28.95
Tryndamere,Soraka,37,26,11,70.27
Tryndamere,Chogath,107,51,56,47.66
Tryndamere,Kennen,19,11,8,57.89
Tryndamere,Zyra,75,31,44,41.33
Tryndamere,Sett,74,26,48,35.14
Tryndamere,Gragas,50,25,25,50
Tryndamere,DrMundo,33,13,20,39.39
Tryndamere,Blitzcrank,62,30,32,48.39
Tryndamere,Kindred,27,20,7,74.07
Tryndamere,Lissandra,23,14,9,60.87
Tryndamere,Karthus,19,12,7,63.16
Tryndamere,Kassadin,14,7,7,50
Tryndamere,Bard,25,11,14,44
Tryndamere,Olaf,11,5,6,45.45
Tryndamere,Elise,32,9,23,28.13
Tryndamere,Braum,52,16,36,30.77
Tryndamere,Poppy,38,17,21,44.74
Tryndamere,Zoe,30,22,8,73.33
Tryndamere,Kled,13,6,7,46.15
Tryndamere,Lucian,42,26,16,61.9
Tryndamere,Vex,41,29,12,70.73
Tryndamere,Kayle,47,22,25,46.81
Tryndamere,Neeko,26,11,15,42.31
Tryndamere,Fiora,26,13,13,50
Tryndamere,Rumble,12,9,3,75
Tryndamere,Nautilus,82,38,44,46.34
Tryndamere,RekSai,19,7,12,36.84
Tryndamere,Viktor,66,33,33,50
Tryndamere,Akshan,25,8,17,32
Tryndamere,Anivia,22,6,16,27.27
Tryndamere,Annie,19,10,9,52.63
Tryndamere,Aphelios,33,24,9,72.73
Tryndamere,Velkoz,32,13,19,40.63
Tryndamere,Briar,26,18,8,69.23
Tryndamere,Syndra,53,28,25,52.83
Tryndamere,Hecarim,17,7,10,41.18
Tryndamere,Diana,103,51,52,49.51
Tryndamere,Sivir,26,17,9,65.38
Tryndamere,Irelia,55,23,32,41.82
Tryndamere,Corki,34,19,15,55.88
Tryndamere,Maokai,32,18,14,56.25
Tryndamere,Illaoi,39,13,26,33.33
Tryndamere,Evelynn,31,20,11,64.52
Tryndamere,Renekton,26,13,13,50
Tryndamere,Camille,19,3,16,15.79
Tryndamere,TwistedFate,21,9,12,42.86
Tryndamere,Kalista,31,17,14,54.84
Tryndamere,Ryze,13,5,8,38.46
Tryndamere,Taric,21,10,11,47.62
Tryndamere,Nilah,32,18,14,56.25
Tryndamere,Zilean,9,3,6,33.33
Yorick,Chogath,247,99,148,40.08
Yorick,Lillia,101,46,55,45.54
Yorick,Tryndamere,90,26,64,28.89
Yorick,Caitlyn,466,226,240,48.5
Yorick,Karma,164,56,108,34.15
Yorick,Garen,249,137,112,55.02
Yorick,Shaco,117,56,61,47.86
Yorick,Tristana,141,72,69,51.06
Yorick,Ezreal,343,173,170,50.44
Yorick,Swain,158,64,94,40.51
Yorick,Urgot,94,53,41,56.38
Yorick,Kayn,179,98,81,54.75
Yorick,Vladimir,103,63,40,61.17
Yorick,Kaisa,244,157,87,64.34
Yorick,Taric,51,38,13,74.51
Yorick,Shen,112,66,46,58.93
Yorick,Heimerdinger,83,46,37,55.42
Yorick,Thresh,279,139,140,49.82
Yorick,Twitch,160,67,93,41.88
Yorick,Katarina,94,76,18,80.85
Yorick,Vayne,223,119,104,53.36
Yorick,Blitzcrank,166,94,72,56.63
Yorick,Volibear,168,61,107,36.31
Yorick,Hwei,91,48,43,52.75
Yorick,Vi,169,93,76,55.03
Yorick,Xerath,117,58,59,49.57
Yorick,Braum,148,70,78,47.3
Yorick,Naafiri,52,26,26,50
Yorick,Warwick,240,112,128,46.67
Yorick,Mel,322,191,131,59.32
Yorick,Ashe,323,184,139,56.97
Yorick,Janna,34,23,11,67.65
Yorick,TahmKench,133,45,88,33.83
Yorick,Rengar,45,22,23,48.89
Yorick,Yone,294,145,149,49.32
Yorick,Zyra,143,70,73,48.95
Yorick,Darius,286,166,120,58.04
Yorick,Ekko,166,94,72,56.63
Yorick,Neeko,84,38,46,45.24
Yorick,KSante,86,65,21,75.58
Yorick,Zilean,57,29,28,50.88
Yorick,Nunu,167,94,73,56.29
Yorick,Kennen,50,19,31,38
Yorick,Samira,154,64,90,41.56
Yorick,Rell,109,62,47,56.88
Yorick,Jayce,87,44,43,50.57
Yorick,Graves,65,31,34,47.69
Yorick,Lux,406,210,196,51.72
Yorick,Seraphine,117,66,51,56.41
Yorick,Trundle,128,64,64,50
Yorick,Khazix,79,26,53,32.91
Yorick,Veigar,196,105,91,53.57
Yorick,Smolder,137,100,37,72.99
Yorick,Sylas,189,99,90,52.38
Yorick,Ahri,202,100,102,49.5
Yorick,Renekton,103,67,36,65.05
Yorick,Elise,101,53,48,52.48
Yorick,Jinx,321,170,151,52.96
Yorick,MissFortune,342,175,167,51.17
Yorick,MasterYi,170,114,56,67.06
Yorick,Fizz,83,60,23,72.29
Yorick,Hecarim,47,27,20,57.45
Yorick,Kassadin,38,11,27,28.95
Yorick,Varus,133,70,63,52.63
Yorick,Alistar,79,45,34,56.96
Yorick,Kayle,102,60,42,58.82
Yorick,Nidalee,52,44,8,84.62
Yorick,Gnar,88,43,45,48.86
Yorick,Udyr,74,42,32,56.76
Yorick,Aatrox,138,78,60,56.52
Yorick,Nautilus,215,112,103,52.09
Yorick,Sion,126,54,72,42.86
Yorick,RekSai,21,16,5,76.19
Yorick,Lissandra,78,53,25,67.95
Yorick,Senna,101,58,43,57.43
Yorick,Irelia,137,73,64,53.28
Yorick,Amumu,264,128,136,48.48
Yorick,Xayah,93,39,54,41.94
Yorick,Gangplank,62,29,33,46.77
Yorick,Zoe,57,26,31,45.61
Yorick,FiddleSticks,56,35,21,62.5
Yorick,Kalista,56,26,30,46.43
Yorick,Galio,136,84,52,61.76
Yorick,Zed,178,87,91,48.88
Yorick,Draven,80,65,15,81.25
Yorick,Rakan,72,32,40,44.44
Yorick,Nocturne,225,105,120,46.67
Yorick,Taliyah,44,25,19,56.82
Yorick,Sejuani,102,59,43,57.84
Yorick,Mordekaiser,219,126,93,57.53
Yorick,Gwen,84,39,45,46.43
Yorick,Yasuo,318,161,157,50.63
Yorick,Leona,202,122,80,60.4
Yorick,Jhin,328,154,174,46.95
Yorick,Poppy,87,56,31,64.37
Yorick,Rumble,40,22,18,55
Yorick,Briar,136,76,60,55.88
Yorick,Nasus,133,61,72,45.86
Yorick,Malzahar,177,91,86,51.41
Yorick,Vex,94,41,53,43.62
Yorick,Azir,108,64,44,59.26
Yorick,Zac,81,44,37,54.32
Yorick,Corki,73,40,33,54.79
Yorick,Akali,161,75,86,46.58
Yorick,Nami,190,102,88,53.68
Yorick,Pyke,175,93,82,53.14
Yorick,Rammus,60,27,33,45
Yorick,Morgana,185,84,101,45.41
Yorick,Viego,236,126,110,53.39
Yorick,Milio,107,53,54,49.53
Yorick,Teemo,180,87,93,48.33
Yorick,Pantheon,280,132,148,47.14
Yorick,Ambessa,113,57,56,50.44
Yorick,Skarner,79,36,43,45.57
Yorick,Malphite,188,100,88,53.19
Yorick,Lucian,134,67,67,50
Yorick,Renata,37,18,19,48.65
Yorick,Shyvana,69,25,44,36.23
Yorick,Belveth,39,20,19,51.28
Yorick,Ryze,56,25,31,44.64
Yorick,Ziggs,38,20,18,52.63
Yorick,Riven,63,32,31,50.79
Yorick,Zeri,89,42,47,47.19
Yorick,Maokai,68,42,26,61.76
Yorick,Qiyana,42,29,13,69.05
Yorick,Viktor,126,71,55,56.35
Yorick,Orianna,88,34,54,38.64
Yorick,Singed,64,27,37,42.19
Yorick,LeeSin,174,85,89,48.85
Yorick,Yuumi,119,55,64,46.22
Yorick,Illaoi,95,50,45,52.63
Yorick,Kindred,81,48,33,59.26
Yorick,Leblanc,86,50,36,58.14
Yorick,Soraka,64,27,37,42.19
Yorick,Jax,126,59,67,46.83
Yorick,Ivern,49,22,27,44.9
Yorick,Syndra,116,58,58,50
Yorick,Gragas,83,49,34,59.04
Yorick,JarvanIV,124,66,58,53.23
Yorick,Nilah,47,17,30,36.17
Yorick,Ornn,90,56,34,62.22
Yorick,Aphelios,115,54,61,46.96
Yorick,Evelynn,37,18,19,48.65
Yorick,Aurora,125,63,62,50.4
Yorick,Fiora,53,24,29,45.28
Yorick,Camille,34,13,21,38.24
Yorick,Brand,107,66,41,61.68
Yorick,KogMaw,86,59,27,68.6
Yorick,MonkeyKing,104,57,47,54.81
Yorick,Kled,17,11,6,64.71
Yorick,Velkoz,92,54,38,58.7
Yorick,DrMundo,91,58,33,63.74
Yorick,Annie,43,14,29,32.56
Yorick,Quinn,58,27,31,46.55
Yorick,Lulu,191,110,81,57.59
Yorick,Sona,31,17,14,54.84
Yorick,Karthus,45,24,21,53.33
Yorick,Diana,222,105,117,47.3
Yorick,XinZhao,81,44,37,54.32
Yorick,Sett,237,121,116,51.05
Yorick,Akshan,48,33,15,68.75
Yorick,Talon,70,36,34,51.43
Yorick,TwistedFate,67,30,37,44.78
Yorick,Sivir,81,33,48,40.74
Yorick,AurelionSol,68,18,50,26.47
Yorick,Olaf,33,20,13,60.61
Yorick,Cassiopeia,27,16,11,59.26
Yorick,Anivia,60,27,33,45
Yorick,Bard,64,40,24,62.5
DrMundo,Malphite,91,44,47,48.35
DrMundo,Vi,97,42,55,43.3
DrMundo,Veigar,132,60,72,45.45
DrMundo,Sivir,77,35,42,45.45
DrMundo,Senna,81,47,34,58.02
DrMundo,Olaf,33,15,18,45.45
DrMundo,Kayn,165,106,59,64.24
DrMundo,Yasuo,139,69,70,49.64
DrMundo,Galio,119,65,54,54.62
DrMundo,Velkoz,64,41,23,64.06
DrMundo,Malzahar,129,60,69,46.51
DrMundo,Ahri,149,66,83,44.3
DrMundo,MissFortune,271,123,148,45.39
DrMundo,Amumu,143,62,81,43.36
DrMundo,Yone,175,111,64,63.43
DrMundo,Talon,44,30,14,68.18
DrMundo,Vladimir,65,24,41,36.92
DrMundo,Swain,106,61,45,57.55
DrMundo,Thresh,228,110,118,48.25
DrMundo,Ornn,90,40,50,44.44
DrMundo,Zac,79,41,38,51.9
DrMundo,Zed,118,71,47,60.17
DrMundo,Varus,69,31,38,44.93
DrMundo,Soraka,54,28,26,51.85
DrMundo,KSante,57,43,14,75.44
DrMundo,Gragas,60,21,39,35
DrMundo,Irelia,92,40,52,43.48
DrMundo,Caitlyn,250,125,125,50
DrMundo,Rell,64,22,42,34.38
DrMundo,Lillia,77,35,42,45.45
DrMundo,Jayce,43,26,17,60.47
DrMundo,Smolder,48,24,24,50
DrMundo,Milio,89,29,60,32.58
DrMundo,Aatrox,89,41,48,46.07
DrMundo,Pantheon,161,86,75,53.42
DrMundo,AurelionSol,58,27,31,46.55
DrMundo,Lux,265,164,101,61.89
DrMundo,Quinn,35,24,11,68.57
DrMundo,Nidalee,38,17,21,44.74
DrMundo,Mel,236,109,127,46.19
DrMundo,Aphelios,56,28,28,50
DrMundo,Jax,113,66,47,58.41
DrMundo,LeeSin,161,95,66,59.01
DrMundo,Jinx,256,122,134,47.66
DrMundo,Camille,32,8,24,25
DrMundo,Udyr,45,19,26,42.22
DrMundo,Viktor,114,45,69,39.47
DrMundo,Jhin,141,79,62,56.03
DrMundo,TahmKench,111,53,58,47.75
DrMundo,Mordekaiser,158,99,59,62.66
DrMundo,Hwei,61,41,20,67.21
DrMundo,Ashe,202,92,110,45.54
DrMundo,Trundle,89,51,38,57.3
DrMundo,Singed,45,28,17,62.22
DrMundo,Leblanc,53,23,30,43.4
DrMundo,Ezreal,234,115,119,49.15
DrMundo,FiddleSticks,77,44,33,57.14
DrMundo,Sion,83,36,47,43.37
DrMundo,MasterYi,117,77,40,65.81
DrMundo,Darius,162,76,86,46.91
DrMundo,Nunu,73,33,40,45.21
DrMundo,Katarina,77,39,38,50.65
DrMundo,Lucian,118,70,48,59.32
DrMundo,Karma,98,50,48,51.02
DrMundo,Riven,18,5,13,27.78
DrMundo,Nocturne,143,62,81,43.36
DrMundo,Sett,163,69,94,42.33
DrMundo,Lulu,166,82,84,49.4
DrMundo,Aurora,91,61,30,67.03
DrMundo,Warwick,160,57,103,35.63
DrMundo,Diana,128,62,66,48.44
DrMundo,Anivia,44,14,30,31.82
DrMundo,Kaisa,180,90,90,50
DrMundo,Nautilus,141,81,60,57.45
DrMundo,Briar,56,24,32,42.86
DrMundo,Vex,43,21,22,48.84
DrMundo,Poppy,78,44,34,56.41
DrMundo,Akali,79,43,36,54.43
DrMundo,Draven,51,32,19,62.75
DrMundo,Nami,110,53,57,48.18
DrMundo,Seraphine,59,17,42,28.81
DrMundo,Maokai,48,17,31,35.42
DrMundo,Twitch,78,31,47,39.74
DrMundo,Shen,62,40,22,64.52
DrMundo,Skarner,56,24,32,42.86
DrMundo,Kayle,60,27,33,45
DrMundo,Brand,69,29,40,42.03
DrMundo,Braum,98,54,44,55.1
DrMundo,Xayah,64,28,36,43.75
DrMundo,Chogath,194,79,115,40.72
DrMundo,Ambessa,44,28,16,63.64
DrMundo,Zoe,51,37,14,72.55
DrMundo,Garen,190,97,93,51.05
DrMundo,Volibear,138,69,69,50
DrMundo,Ekko,87,43,44,49.43
DrMundo,Fiora,43,30,13,69.77
DrMundo,XinZhao,56,28,28,50
DrMundo,Fizz,66,21,45,31.82
DrMundo,Evelynn,36,17,19,47.22
DrMundo,Alistar,57,21,36,36.84
DrMundo,Sejuani,76,31,45,40.79
DrMundo,Kindred,36,19,17,52.78
DrMundo,Lissandra,39,11,28,28.21
DrMundo,Heimerdinger,72,32,40,44.44
DrMundo,Yuumi,74,45,29,60.81
DrMundo,Ivern,22,13,9,59.09
DrMundo,Kassadin,37,16,21,43.24
DrMundo,Vayne,158,58,100,36.71
DrMundo,Orianna,49,27,22,55.1
DrMundo,Janna,20,9,11,45
DrMundo,Ziggs,54,41,13,75.93
DrMundo,Blitzcrank,92,57,35,61.96
DrMundo,Ryze,52,30,22,57.69
DrMundo,Elise,89,35,54,39.33
DrMundo,Shyvana,46,20,26,43.48
DrMundo,TwistedFate,37,22,15,59.46
DrMundo,Yorick,91,33,58,36.26
DrMundo,Rammus,22,11,11,50
DrMundo,Gnar,51,38,13,74.51
DrMundo,Nasus,60,29,31,48.33
DrMundo,KogMaw,29,14,15,48.28
DrMundo,Morgana,82,53,29,64.63
DrMundo,Akshan,36,20,16,55.56
DrMundo,Hecarim,56,20,36,35.71
DrMundo,Taliyah,16,9,7,56.25
DrMundo,Zyra,82,51,31,62.2
DrMundo,Renekton,36,12,24,33.33
DrMundo,Gwen,48,24,24,50
DrMundo,Sylas,107,63,44,58.88
DrMundo,JarvanIV,64,20,44,31.25
DrMundo,Bard,29,16,13,55.17
DrMundo,Gangplank,32,23,9,71.88
DrMundo,Pyke,75,33,42,44
DrMundo,Illaoi,46,14,32,30.43
DrMundo,Tristana,91,44,47,48.35
DrMundo,Rumble,34,5,29,14.71
DrMundo,Xerath,73,21,52,28.77
DrMundo,Teemo,82,62,20,75.61
DrMundo,Rakan,56,16,40,28.57
DrMundo,Taric,17,12,5,70.59
DrMundo,Annie,27,5,22,18.52
DrMundo,Tryndamere,33,20,13,60.61
DrMundo,Shaco,59,33,26,55.93
DrMundo,Belveth,25,9,16,36
DrMundo,MonkeyKing,77,40,37,51.95
DrMundo,Viego,121,61,60,50.41
DrMundo,Nilah,33,15,18,45.45
DrMundo,Graves,53,32,21,60.38
DrMundo,Urgot,55,27,28,49.09
DrMundo,RekSai,14,3,11,21.43
DrMundo,Samira,58,30,28,51.72
DrMundo,Renata,26,5,21,19.23
DrMundo,Corki,56,25,31,44.64
DrMundo,Naafiri,15,5,10,33.33
DrMundo,Kalista,30,23,7,76.67
DrMundo,Zeri,50,34,16,68
DrMundo,Syndra,63,37,26,58.73
DrMundo,Rengar,38,27,11,71.05
DrMundo,Qiyana,24,15,9,62.5
DrMundo,Zilean,31,11,20,35.48
DrMundo,Khazix,46,30,16,65.22
DrMundo,Leona,93,47,46,50.54
DrMundo,Neeko,28,16,12,57.14
DrMundo,Kled,28,10,18,35.71
DrMundo,Sona,39,22,17,56.41
DrMundo,Cassiopeia,28,12,16,42.86
DrMundo,Azir,28,10,18,35.71
DrMundo,Kennen,35,18,17,51.43
DrMundo,Karthus,21,13,8,61.9
TwistedFate,Malphite,53,31,22,58.49
TwistedFate,Vi,117,63,54,53.85
TwistedFate,Veigar,65,34,31,52.31
TwistedFate,Sivir,48,13,35,27.08
TwistedFate,Senna,52,26,26,50
TwistedFate,Jayce,43,15,28,34.88
TwistedFate,Hecarim,19,11,8,57.89
TwistedFate,Milio,40,18,22,45
TwistedFate,Caitlyn,152,77,75,50.66
TwistedFate,Zoe,36,19,17,52.78
TwistedFate,Garen,97,34,63,35.05
TwistedFate,Shyvana,14,9,5,64.29
TwistedFate,Lissandra,36,20,16,55.56
TwistedFate,Lux,146,76,70,52.05
TwistedFate,Nasus,46,13,33,28.26
TwistedFate,Amumu,89,34,55,38.2
TwistedFate,Sylas,128,50,78,39.06
TwistedFate,Twitch,74,35,39,47.3
TwistedFate,Lulu,85,50,35,58.82
TwistedFate,Darius,137,87,50,63.5
TwistedFate,Graves,67,35,32,52.24
TwistedFate,Neeko,40,14,26,35
TwistedFate,Draven,49,22,27,44.9
TwistedFate,Alistar,53,21,32,39.62
TwistedFate,Kayle,38,21,17,55.26
TwistedFate,Viego,91,49,42,53.85
TwistedFate,Yasuo,95,41,54,43.16
TwistedFate,Jhin,135,61,74,45.19
TwistedFate,Braum,61,18,43,29.51
TwistedFate,Swain,86,34,52,39.53
TwistedFate,Volibear,43,22,21,51.16
TwistedFate,Kalista,36,16,20,44.44
TwistedFate,Rell,44,19,25,43.18
TwistedFate,Warwick,82,41,41,50
TwistedFate,LeeSin,143,76,67,53.15
TwistedFate,Viktor,69,34,35,49.28
TwistedFate,Lucian,92,53,39,57.61
TwistedFate,Nami,84,52,32,61.9
TwistedFate,Seraphine,45,23,22,51.11
TwistedFate,Ezreal,172,92,80,53.49
TwistedFate,MasterYi,87,32,55,36.78
TwistedFate,Ekko,34,23,11,67.65
TwistedFate,Shaco,68,36,32,52.94
TwistedFate,Briar,46,15,31,32.61
TwistedFate,Akshan,18,13,5,72.22
TwistedFate,Samira,67,34,33,50.75
TwistedFate,Quinn,31,14,17,45.16
TwistedFate,Ambessa,71,37,34,52.11
TwistedFate,Brand,53,24,29,45.28
TwistedFate,Chogath,61,23,38,37.7
TwistedFate,Khazix,30,9,21,30
TwistedFate,Hwei,46,18,28,39.13
TwistedFate,Jinx,166,67,99,40.36
TwistedFate,Thresh,138,62,76,44.93
TwistedFate,Heimerdinger,24,10,14,41.67
TwistedFate,Xayah,51,38,13,74.51
TwistedFate,Rakan,73,33,40,45.21
TwistedFate,Kayn,70,37,33,52.86
TwistedFate,Malzahar,74,41,33,55.41
TwistedFate,Kaisa,105,57,48,54.29
TwistedFate,Sion,66,19,47,28.79
TwistedFate,JarvanIV,62,37,25,59.68
TwistedFate,Nunu,44,24,20,54.55
TwistedFate,Pantheon,120,56,64,46.67
TwistedFate,Azir,24,15,9,62.5
TwistedFate,Elise,47,22,25,46.81
TwistedFate,Aurora,48,23,25,47.92
TwistedFate,Nilah,32,16,16,50
TwistedFate,Mel,93,57,36,61.29
TwistedFate,Karma,101,44,57,43.56
TwistedFate,Maokai,19,12,7,63.16
TwistedFate,Ahri,96,55,41,57.29
TwistedFate,Nautilus,87,52,35,59.77
TwistedFate,Zed,68,41,27,60.29
TwistedFate,Jax,61,36,25,59.02
TwistedFate,Blitzcrank,68,35,33,51.47
TwistedFate,Katarina,51,23,28,45.1
TwistedFate,TahmKench,47,25,22,53.19
TwistedFate,Poppy,44,20,24,45.45
TwistedFate,Yone,108,46,62,42.59
TwistedFate,MissFortune,144,75,69,52.08
TwistedFate,Taric,18,10,8,55.56
TwistedFate,Urgot,30,16,14,53.33
TwistedFate,Gragas,62,29,33,46.77
TwistedFate,Olaf,20,6,14,30
TwistedFate,Irelia,45,13,32,28.89
TwistedFate,Ashe,115,65,50,56.52
TwistedFate,Varus,68,34,34,50
TwistedFate,Galio,93,52,41,55.91
TwistedFate,Singed,15,2,13,13.33
TwistedFate,Tristana,49,13,36,26.53
TwistedFate,DrMundo,37,15,22,40.54
TwistedFate,Trundle,30,9,21,30
TwistedFate,Nocturne,66,29,37,43.94
TwistedFate,Riven,17,5,12,29.41
TwistedFate,Kindred,25,11,14,44
TwistedFate,Rumble,23,13,10,56.52
TwistedFate,Karthus,11,0,11,0
TwistedFate,AurelionSol,44,22,22,50
TwistedFate,Diana,94,51,43,54.26
TwistedFate,Smolder,55,36,19,65.45
TwistedFate,KogMaw,25,17,8,68
TwistedFate,Xerath,84,35,49,41.67
TwistedFate,Mordekaiser,81,30,51,37.04
TwistedFate,Rammus,27,13,14,48.15
TwistedFate,Morgana,58,28,30,48.28
TwistedFate,Sett,110,64,46,58.18
TwistedFate,Orianna,27,13,14,48.15
TwistedFate,Belveth,15,9,6,60
TwistedFate,Naafiri,17,3,14,17.65
TwistedFate,Yorick,67,37,30,55.22
TwistedFate,Camille,24,9,15,37.5
TwistedFate,MonkeyKing,40,21,19,52.5
TwistedFate,Aatrox,76,44,32,57.89
TwistedFate,Taliyah,23,14,9,60.87
TwistedFate,Ryze,41,17,24,41.46
TwistedFate,Soraka,38,16,22,42.11
TwistedFate,Nidalee,30,15,15,50
TwistedFate,Rengar,16,9,7,56.25
TwistedFate,Bard,19,6,13,31.58
TwistedFate,Vayne,81,48,33,59.26
TwistedFate,Teemo,70,29,41,41.43
TwistedFate,Renekton,39,19,20,48.72
TwistedFate,Cassiopeia,24,4,20,16.67
TwistedFate,Sona,15,6,9,40
TwistedFate,Ziggs,19,11,8,57.89
TwistedFate,Zac,46,12,34,26.09
TwistedFate,Zilean,30,15,15,50
TwistedFate,Shen,58,28,30,48.28
TwistedFate,Udyr,27,18,9,66.67
TwistedFate,Yuumi,58,26,32,44.83
TwistedFate,Lillia,59,26,33,44.07
TwistedFate,Vex,43,19,24,44.19
TwistedFate,Gwen,44,24,20,54.55
TwistedFate,XinZhao,35,14,21,40
TwistedFate,Gnar,35,24,11,68.57
TwistedFate,Talon,45,28,17,62.22
TwistedFate,Zeri,31,14,17,45.16
TwistedFate,KSante,49,24,25,48.98
TwistedFate,Leona,74,47,27,63.51
TwistedFate,Skarner,24,7,17,29.17
TwistedFate,Kled,7,2,5,28.57
TwistedFate,Corki,28,12,16,42.86
TwistedFate,Sejuani,36,20,16,55.56
TwistedFate,Akali,59,27,32,45.76
TwistedFate,Syndra,49,19,30,38.78
TwistedFate,Illaoi,38,23,15,60.53
TwistedFate,FiddleSticks,27,18,9,66.67
TwistedFate,Leblanc,41,17,24,41.46
TwistedFate,Fiora,23,13,10,56.52
TwistedFate,Evelynn,23,11,12,47.83
TwistedFate,Vladimir,27,18,9,66.67
TwistedFate,Velkoz,40,13,27,32.5
TwistedFate,Anivia,21,11,10,52.38
TwistedFate,Janna,14,4,10,28.57
TwistedFate,Zyra,39,18,21,46.15
TwistedFate,Gangplank,24,12,12,50
TwistedFate,Renata,16,4,12,25
TwistedFate,Pyke,41,27,14,65.85
TwistedFate,Fizz,36,7,29,19.44
TwistedFate,Tryndamere,21,12,9,57.14
TwistedFate,Ornn,44,25,19,56.82
TwistedFate,Kennen,24,13,11,54.17
TwistedFate,Kassadin,7,5,2,71.43
TwistedFate,Aphelios,32,15,17,46.88
TwistedFate,Qiyana,16,8,8,50
TwistedFate,Annie,32,21,11,65.63
TwistedFate,Ivern,9,6,3,66.67
TwistedFate,RekSai,5,5,0,100
Vi,DrMundo,97,55,42,56.7
Vi,Sejuani,139,68,71,48.92
Vi,Lux,470,251,219,53.4
Vi,Ashe,415,232,183,55.9
Vi,TwistedFate,117,54,63,46.15
Vi,Rell,177,90,87,50.85
Vi,Rengar,71,48,23,67.61
Vi,Sett,310,153,157,49.35
Vi,Mel,422,220,202,52.13
Vi,Varus,220,111,109,50.45
Vi,Gnar,86,51,35,59.3
Vi,Hecarim,80,37,43,46.25
Vi,Viktor,226,108,118,47.79
Vi,MissFortune,404,184,220,45.54
Vi,Mordekaiser,295,155,140,52.54
Vi,Poppy,174,90,84,51.72
Vi,Zed,224,97,127,43.3
Vi,Pyke,224,127,97,56.7
Vi,Riven,113,61,52,53.98
Vi,Karthus,62,35,27,56.45
Vi,Lucian,188,95,93,50.53
Vi,Nami,240,107,133,44.58
Vi,Teemo,188,86,102,45.74
Vi,Khazix,108,71,37,65.74
Vi,Zoe,102,59,43,57.84
Vi,Jinx,552,281,271,50.91
Vi,Yorick,169,76,93,44.97
Vi,Kindred,101,71,30,70.3
Vi,Katarina,153,94,59,61.44
Vi,Caitlyn,692,382,310,55.2
Vi,Neeko,104,56,48,53.85
Vi,Ezreal,590,307,283,52.03
Vi,Aatrox,230,145,85,63.04
Vi,Amumu,278,116,162,41.73
Vi,Taliyah,65,32,33,49.23
Vi,Milio,122,54,68,44.26
Vi,TahmKench,258,135,123,52.33
Vi,JarvanIV,231,108,123,46.75
Vi,Kaisa,390,192,198,49.23
Vi,Morgana,219,104,115,47.49
Vi,Volibear,255,122,133,47.84
Vi,Nunu,134,54,80,40.3
Vi,Swain,207,84,123,40.58
Vi,Rakan,162,78,84,48.15
Vi,Warwick,279,153,126,54.84
Vi,Viego,350,144,206,41.14
Vi,Ahri,336,143,193,42.56
Vi,Hwei,160,87,73,54.38
Vi,Kayn,289,158,131,54.67
Vi,FiddleSticks,77,25,52,32.47
Vi,Qiyana,58,26,32,44.83
Vi,Zac,186,84,102,45.16
Vi,Janna,60,20,40,33.33
Vi,Pantheon,389,190,199,48.84
Vi,Xerath,237,119,118,50.21
Vi,Lulu,328,154,174,46.95
Vi,Yasuo,430,213,217,49.53
Vi,Nautilus,284,128,156,45.07
Vi,Malphite,213,111,102,52.11
Vi,Skarner,103,64,39,62.14
Vi,KogMaw,79,51,28,64.56
Vi,Gragas,192,125,67,65.1
Vi,Darius,366,162,204,44.26
Vi,Xayah,165,82,83,49.7
Vi,Karma,270,144,126,53.33
Vi,Sion,234,111,123,47.44
Vi,Kassadin,51,25,26,49.02
Vi,LeeSin,536,275,261,51.31
Vi,Leona,248,152,96,61.29
Vi,Ornn,152,76,76,50
Vi,Jayce,163,80,83,49.08
Vi,Seraphine,187,108,79,57.75
Vi,Kled,41,25,16,60.98
Vi,MasterYi,209,127,82,60.77
Vi,Vladimir,137,75,62,54.74
Vi,Jhin,384,193,191,50.26
Vi,Diana,399,210,189,52.63
Vi,Samira,119,51,68,42.86
Vi,Irelia,179,108,71,60.34
Vi,Alistar,148,58,90,39.19
Vi,Braum,177,95,82,53.67
Vi,Garen,346,154,192,44.51
Vi,Kennen,70,30,40,42.86
Vi,Talon,150,90,60,60
Vi,Yone,337,187,150,55.49
Vi,Galio,245,98,147,40
Vi,Gwen,116,58,58,50
Vi,Fizz,126,76,50,60.32
Vi,Urgot,95,66,29,69.47
Vi,Rammus,83,45,38,54.22
Vi,Vex,127,62,65,48.82
Vi,Veigar,234,101,133,43.16
Vi,Vayne,319,150,169,47.02
Vi,Yuumi,190,114,76,60
Vi,Tristana,229,117,112,51.09
Vi,Fiora,101,35,66,34.65
Vi,Leblanc,138,81,57,58.7
Vi,Illaoi,121,54,67,44.63
Vi,Ekko,175,86,89,49.14
Vi,Shaco,144,86,58,59.72
Vi,AurelionSol,81,38,43,46.91
Vi,Thresh,416,247,169,59.38
Vi,Briar,115,51,64,44.35
Vi,Smolder,139,71,68,51.08
Vi,Brand,123,61,62,49.59
Vi,Olaf,73,36,37,49.32
Vi,Twitch,159,85,74,53.46
Vi,Ivern,52,32,20,61.54
Vi,Nasus,164,89,75,54.27
Vi,Ziggs,99,43,56,43.43
Vi,Sivir,139,67,72,48.2
Vi,Draven,83,39,44,46.99
Vi,Soraka,103,54,49,52.43
Vi,Maokai,141,85,56,60.28
Vi,Shen,139,73,66,52.52
Vi,Jax,194,99,95,51.03
Vi,Aurora,172,96,76,55.81
Vi,Akali,190,102,88,53.68
Vi,Sona,27,13,14,48.15
Vi,Malzahar,198,98,100,49.49
Vi,Zyra,188,78,110,41.49
Vi,Udyr,75,49,26,65.33
Vi,Renekton,131,54,77,41.22
Vi,Elise,163,77,86,47.24
Vi,Quinn,89,49,40,55.06
Vi,Gangplank,84,57,27,67.86
Vi,Ryze,76,41,35,53.95
Vi,Ambessa,147,100,47,68.03
Vi,Velkoz,118,57,61,48.31
Vi,Renata,55,29,26,52.73
Vi,Nilah,54,26,28,48.15
Vi,Evelynn,51,35,16,68.63
Vi,Sylas,353,180,173,50.99
Vi,Zilean,65,28,37,43.08
Vi,Graves,140,60,80,42.86
Vi,Lillia,118,61,57,51.69
Vi,Tryndamere,70,26,44,37.14
Vi,Orianna,73,34,39,46.58
Vi,Corki,131,79,52,60.31
Vi,Kayle,137,75,62,54.74
Vi,RekSai,32,19,13,59.38
Vi,Blitzcrank,244,116,128,47.54
Vi,XinZhao,152,84,68,55.26
Vi,Bard,79,36,43,45.57
Vi,Nocturne,255,135,120,52.94
Vi,Chogath,313,159,154,50.8
Vi,Azir,93,68,25,73.12
Vi,Cassiopeia,67,27,40,40.3
Vi,MonkeyKing,199,66,133,33.17
Vi,Syndra,149,89,60,59.73
Vi,Naafiri,77,40,37,51.95
Vi,Shyvana,63,32,31,50.79
Vi,Trundle,117,70,47,59.83
Vi,Kalista,63,31,32,49.21
Vi,Anivia,90,49,41,54.44
Vi,Aphelios,134,66,68,49.25
Vi,Senna,109,56,53,51.38
Vi,Zeri,116,70,46,60.34
Vi,KSante,153,87,66,56.86
Vi,Belveth,45,28,17,62.22
Vi,Lissandra,58,36,22,62.07
Vi,Annie,78,40,38,51.28
Vi,Taric,60,39,21,65
Vi,Akshan,75,30,45,40
Vi,Heimerdinger,102,58,44,56.86
Vi,Camille,106,42,64,39.62
Vi,Rumble,69,35,34,50.72
Vi,Singed,39,20,19,51.28
Vi,Nidalee,73,40,33,54.79
Senna,DrMundo,81,34,47,41.98
Senna,Sejuani,66,36,30,54.55
Senna,Lux,295,151,144,51.19
Senna,Ashe,243,130,113,53.5
Senna,TwistedFate,52,26,26,50
Senna,Ivern,28,7,21,25
Senna,Renekton,52,30,22,57.69
Senna,Vladimir,52,26,26,50
Senna,Lucian,76,37,39,48.68
Senna,Blitzcrank,103,55,48,53.4
Senna,Tryndamere,47,20,27,42.55
Senna,Nunu,91,47,44,51.65
Senna,Kennen,43,7,36,16.28
Senna,Samira,99,51,48,51.52
Senna,Rell,90,49,41,54.44
Senna,Diana,171,82,89,47.95
Senna,Katarina,68,38,30,55.88
Senna,Varus,101,66,35,65.35
Senna,Karma,117,62,55,52.99
Senna,Heimerdinger,61,33,28,54.1
Senna,LeeSin,210,105,105,50
Senna,AurelionSol,83,28,55,33.73
Senna,Jinx,308,132,176,42.86
Senna,Leona,114,41,73,35.96
Senna,KSante,75,29,46,38.67
Senna,Rammus,48,30,18,62.5
Senna,Aurora,97,65,32,67.01
Senna,Kaisa,184,96,88,52.17
Senna,Zilean,35,15,20,42.86
Senna,Sion,112,52,60,46.43
Senna,MasterYi,118,45,73,38.14
Senna,Xayah,80,21,59,26.25
Senna,Seraphine,111,51,60,45.95
Senna,Yorick,101,43,58,42.57
Senna,Viego,106,37,69,34.91
Senna,Rakan,92,40,52,43.48
Senna,Aatrox,106,48,58,45.28
Senna,Ekko,118,40,78,33.9
Senna,Chogath,180,86,94,47.78
Senna,Nilah,44,23,21,52.27
Senna,Zyra,74,41,33,55.41
Senna,TahmKench,121,63,58,52.07
Senna,Khazix,45,10,35,22.22
Senna,Jhin,252,123,129,48.81
Senna,Nami,99,42,57,42.42
Senna,Mordekaiser,180,74,106,41.11
Senna,Udyr,53,27,26,50.94
Senna,Smolder,86,57,29,66.28
Senna,Garen,164,93,71,56.71
Senna,Zed,103,61,42,59.22
Senna,Leblanc,84,34,50,40.48
Senna,Mel,270,142,128,52.59
Senna,Morgana,179,68,111,37.99
Senna,Pantheon,183,90,93,49.18
Senna,Vayne,166,72,94,43.37
Senna,Yasuo,204,96,108,47.06
Senna,Milio,115,52,63,45.22
Senna,Veigar,170,89,81,52.35
Senna,Darius,200,76,124,38
Senna,Qiyana,41,20,21,48.78
Senna,Caitlyn,294,136,158,46.26
Senna,Riven,44,24,20,54.55
Senna,Galio,130,61,69,46.92
Senna,Nocturne,141,64,77,45.39
Senna,Sett,155,66,89,42.58
Senna,Lulu,198,94,104,47.47
Senna,Annie,31,16,15,51.61
Senna,Poppy,96,43,53,44.79
Senna,Malphite,160,83,77,51.88
Senna,Graves,81,27,54,33.33
Senna,Braum,128,69,59,53.91
Senna,Jax,114,60,54,52.63
Senna,Jayce,67,29,38,43.28
Senna,Skarner,84,45,39,53.57
Senna,Ahri,136,55,81,40.44
Senna,FiddleSticks,54,21,33,38.89
Senna,Hwei,81,38,43,46.91
Senna,KogMaw,43,24,19,55.81
Senna,Akali,86,45,41,52.33
Senna,Cassiopeia,34,11,23,32.35
Senna,Irelia,79,48,31,60.76
Senna,Twitch,98,41,57,41.84
Senna,Briar,66,19,47,28.79
Senna,Naafiri,43,16,27,37.21
Senna,MissFortune,230,111,119,48.26
Senna,Thresh,190,64,126,33.68
Senna,Belveth,32,13,19,40.63
Senna,Brand,56,32,24,57.14
Senna,Taliyah,32,15,17,46.88
Senna,Zac,75,44,31,58.67
Senna,JarvanIV,85,39,46,45.88
Senna,Swain,110,54,56,49.09
Senna,Tristana,95,49,46,51.58
Senna,Kayn,164,68,96,41.46
Senna,Sylas,182,77,105,42.31
Senna,Syndra,64,44,20,68.75
Senna,Warwick,156,70,86,44.87
Senna,Nidalee,20,5,15,25
Senna,Nautilus,129,69,60,53.49
Senna,Sona,41,20,21,48.78
Senna,Neeko,51,33,18,64.71
Senna,Trundle,74,40,34,54.05
Senna,MonkeyKing,86,34,52,39.53
Senna,Orianna,62,22,40,35.48
Senna,Volibear,113,52,61,46.02
Senna,Pyke,74,47,27,63.51
Senna,Viktor,87,49,38,56.32
Senna,Shyvana,35,12,23,34.29
Senna,Aphelios,54,22,32,40.74
Senna,Renata,27,6,21,22.22
Senna,Evelynn,39,25,14,64.1
Senna,Yuumi,60,42,18,70
Senna,Teemo,78,45,33,57.69
Senna,Yone,214,83,131,38.79
Senna,Gwen,65,31,34,47.69
Senna,Xerath,102,56,46,54.9
Senna,XinZhao,69,43,26,62.32
Senna,Gragas,96,47,49,48.96
Senna,Ezreal,280,137,143,48.93
Senna,Sivir,56,13,43,23.21
Senna,Kassadin,17,5,12,29.41
Senna,Anivia,47,26,21,55.32
Senna,Rumble,42,25,17,59.52
Senna,Azir,58,30,28,51.72
Senna,Gangplank,51,22,29,43.14
Senna,Quinn,42,22,20,52.38
Senna,Akshan,53,30,23,56.6
Senna,Maokai,49,35,14,71.43
Senna,Lissandra,44,21,23,47.73
Senna,Ambessa,86,36,50,41.86
Senna,Camille,41,17,24,41.46
Senna,Malzahar,123,47,76,38.21
Senna,Soraka,71,34,37,47.89
Senna,Kalista,37,20,17,54.05
Senna,Fizz,52,36,16,69.23
Senna,Rengar,35,22,13,62.86
Senna,Gnar,52,28,24,53.85
Senna,Corki,71,44,27,61.97
Senna,Nasus,84,55,29,65.48
Senna,Alistar,53,19,34,35.85
Senna,Kayle,69,26,43,37.68
Senna,Vi,109,53,56,48.62
Senna,Shen,68,34,34,50
Senna,Talon,70,45,25,64.29
Senna,Olaf,38,18,20,47.37
Senna,Urgot,48,16,32,33.33
Senna,Bard,45,22,23,48.89
Senna,Hecarim,30,12,18,40
Senna,Shaco,69,44,25,63.77
Senna,Vex,61,36,25,59.02
Senna,Velkoz,60,34,26,56.67
Senna,Ornn,92,64,28,69.57
Senna,Karthus,24,14,10,58.33
Senna,Zeri,27,20,7,74.07
Senna,RekSai,18,15,3,83.33
Senna,Ryze,56,26,30,46.43
Senna,Lillia,66,44,22,66.67
Senna,Janna,48,21,27,43.75
Senna,Singed,23,12,11,52.17
Senna,Taric,15,2,13,13.33
Senna,Kled,22,11,11,50
Senna,Amumu,108,67,41,62.04
Senna,Elise,76,38,38,50
Senna,Zoe,31,10,21,32.26
Senna,Ziggs,46,21,25,45.65
Senna,Kindred,45,22,23,48.89
Senna,Draven,47,22,25,46.81
Senna,Illaoi,55,39,16,70.91
Senna,Fiora,48,21,27,43.75
Udyr,Mordekaiser,66,30,36,45.45
Udyr,Kayn,87,40,47,45.98
Udyr,Katarina,57,31,26,54.39
Udyr,Caitlyn,199,87,112,43.72
Udyr,Morgana,87,22,65,25.29
Udyr,Yasuo,191,91,100,47.64
Udyr,Shaco,77,26,51,33.77
Udyr,Azir,26,9,17,34.62
Udyr,Jhin,165,72,93,43.64
Udyr,Sylas,113,69,44,61.06
Udyr,Sett,111,52,59,46.85
Udyr,Hecarim,22,9,13,40.91
Udyr,Ahri,89,37,52,41.57
Udyr,Rakan,44,17,27,38.64
Udyr,Draven,31,13,18,41.94
Udyr,Malphite,84,32,52,38.1
Udyr,Chogath,131,57,74,43.51
Udyr,MissFortune,139,65,74,46.76
Udyr,Yuumi,49,5,44,10.2
Udyr,FiddleSticks,39,20,19,51.28
Udyr,Hwei,58,26,32,44.83
Udyr,Teemo,73,39,34,53.42
Udyr,Janna,19,3,16,15.79
Udyr,XinZhao,34,18,16,52.94
Udyr,Gwen,48,17,31,35.42
Udyr,Ashe,154,68,86,44.16
Udyr,Rell,33,19,14,57.58
Udyr,Vladimir,58,20,38,34.48
Udyr,Volibear,111,48,63,43.24
Udyr,Malzahar,71,31,40,43.66
Udyr,Jayce,28,20,8,71.43
Udyr,Sion,69,42,27,60.87
Udyr,Yorick,74,32,42,43.24
Udyr,Nidalee,36,23,13,63.89
Udyr,Yone,146,69,77,47.26
Udyr,Twitch,52,14,38,26.92
Udyr,DrMundo,45,26,19,57.78
Udyr,Zed,68,17,51,25
Udyr,Orianna,41,19,22,46.34
Udyr,Sivir,41,18,23,43.9
Udyr,Nami,57,30,27,52.63
Udyr,Urgot,36,14,22,38.89
Udyr,LeeSin,121,68,53,56.2
Udyr,Xayah,39,16,23,41.03
Udyr,Senna,53,26,27,49.06
Udyr,Viego,69,30,39,43.48
Udyr,Kayle,36,14,22,38.89
Udyr,Skarner,27,9,18,33.33
Udyr,Varus,66,31,35,46.97
Udyr,Ezreal,180,85,95,47.22
Udyr,Neeko,29,15,14,51.72
Udyr,Jinx,165,66,99,40
Udyr,Milio,64,21,43,32.81
Udyr,Zac,66,31,35,46.97
Udyr,Karma,91,34,57,37.36
Udyr,Corki,54,26,28,48.15
Udyr,Ambessa,66,22,44,33.33
Udyr,Amumu,59,25,34,42.37
Udyr,Mel,148,82,66,55.41
Udyr,Warwick,101,49,52,48.51
Udyr,AurelionSol,22,5,17,22.73
Udyr,Lucian,48,30,18,62.5
Udyr,Zyra,71,39,32,54.93
Udyr,Illaoi,37,18,19,48.65
Udyr,Ekko,36,18,18,50
Udyr,Irelia,50,30,20,60
Udyr,Seraphine,48,24,24,50
Udyr,Jax,43,14,29,32.56
Udyr,JarvanIV,55,18,37,32.73
Udyr,Syndra,56,27,29,48.21
Udyr,Brand,48,8,40,16.67
Udyr,KSante,62,27,35,43.55
Udyr,Talon,27,13,14,48.15
Udyr,Kassadin,8,5,3,62.5
Udyr,Vi,75,26,49,34.67
Udyr,Tristana,60,37,23,61.67
Udyr,Rumble,36,15,21,41.67
Udyr,Aurora,56,19,37,33.93
Udyr,Lulu,108,61,47,56.48
Udyr,Kindred,27,8,19,29.63
Udyr,Anivia,42,34,8,80.95
Udyr,Smolder,44,9,35,20.45
Udyr,Diana,117,78,39,66.67
Udyr,Nocturne,90,33,57,36.67
Udyr,Lillia,67,18,49,26.87
Udyr,Lux,120,47,73,39.17
Udyr,Galio,80,42,38,52.5
Udyr,Pantheon,126,53,73,42.06
Udyr,Ziggs,29,12,17,41.38
Udyr,Blitzcrank,66,29,37,43.94
Udyr,Darius,144,55,89,38.19
Udyr,Viktor,70,34,36,48.57
Udyr,Kaisa,119,65,54,54.62
Udyr,Velkoz,51,19,32,37.25
Udyr,Garen,106,44,62,41.51
Udyr,Vayne,105,37,68,35.24
Udyr,Soraka,25,12,13,48
Udyr,Shen,58,23,35,39.66
Udyr,Ryze,23,11,12,47.83
Udyr,Kalista,24,14,10,58.33
Udyr,Sona,17,6,11,35.29
Udyr,Tryndamere,20,17,3,85
Udyr,Maokai,37,16,21,43.24
Udyr,Evelynn,32,13,19,40.63
Udyr,Poppy,61,32,29,52.46
Udyr,Qiyana,16,5,11,31.25
Udyr,Zeri,31,11,20,35.48
Udyr,Camille,30,10,20,33.33
Udyr,Rengar,22,16,6,72.73
Udyr,Quinn,24,12,12,50
Udyr,Nunu,43,25,18,58.14
Udyr,Briar,55,20,35,36.36
Udyr,Lissandra,17,7,10,41.18
Udyr,Vex,58,21,37,36.21
Udyr,Ornn,47,11,36,23.4
Udyr,Zoe,38,17,21,44.74
Udyr,Karthus,26,18,8,69.23
Udyr,Heimerdinger,36,19,17,52.78
Udyr,Swain,52,26,26,50
Udyr,Bard,46,32,14,69.57
Udyr,Thresh,139,52,87,37.41
Udyr,Nasus,16,2,14,12.5
Udyr,Singed,28,14,14,50
Udyr,Samira,60,24,36,40
Udyr,Veigar,63,18,45,28.57
Udyr,Aatrox,90,43,47,47.78
Udyr,Kled,21,10,11,47.62
Udyr,Elise,69,31,38,44.93
Udyr,Zilean,28,14,14,50
Udyr,Gnar,44,14,30,31.82
Udyr,Annie,25,8,17,32
Udyr,Akali,74,33,41,44.59
Udyr,Pyke,65,27,38,41.54
Udyr,Leblanc,34,15,19,44.12
Udyr,Graves,56,32,24,57.14
Udyr,Gangplank,46,19,27,41.3
Udyr,Shyvana,23,9,14,39.13
Udyr,Leona,57,32,25,56.14
Udyr,Olaf,8,3,5,37.5
Udyr,Nautilus,97,45,52,46.39
Udyr,TwistedFate,27,9,18,33.33
Udyr,Alistar,45,23,22,51.11
Udyr,Braum,34,13,21,38.24
Udyr,Taric,20,5,15,25
Udyr,Gragas,52,26,26,50
Udyr,MasterYi,49,25,24,51.02
Udyr,Fiora,28,14,14,50
Udyr,Naafiri,20,9,11,45
Udyr,MonkeyKing,64,36,28,56.25
Udyr,Aphelios,43,25,18,58.14
Udyr,Trundle,47,14,33,29.79
Udyr,Khazix,50,14,36,28
Udyr,TahmKench,79,33,46,41.77
Udyr,Xerath,73,24,49,32.88
Udyr,Riven,19,7,12,36.84
Udyr,Sejuani,27,9,18,33.33
Udyr,Cassiopeia,19,2,17,10.53
Udyr,Belveth,11,6,5,54.55
Udyr,Akshan,34,12,22,35.29
Udyr,Renekton,22,12,10,54.55
Udyr,KogMaw,10,0,10,0
Udyr,Kennen,28,9,19,32.14
Udyr,Fizz,23,11,12,47.83
Udyr,RekSai,13,6,7,46.15
Udyr,Taliyah,21,10,11,47.62
Udyr,Renata,23,6,17,26.09
Udyr,Rammus,15,6,9,40
Udyr,Nilah,14,3,11,21.43
Udyr,Ivern,17,14,3,82.35
Smolder,Mordekaiser,172,72,100,41.86
Smolder,Kayn,172,86,86,50
Smolder,Katarina,90,35,55,38.89
Smolder,Caitlyn,410,225,185,54.88
Smolder,Morgana,152,68,84,44.74
Smolder,Yone,274,142,132,51.82
Smolder,Nocturne,174,77,97,44.25
Smolder,Akali,119,62,57,52.1
Smolder,Ezreal,364,185,179,50.82
Smolder,Renata,46,21,25,45.65
Smolder,Ornn,80,36,44,45
Smolder,Kindred,85,38,47,44.71
Smolder,Talon,70,32,38,45.71
Smolder,Samira,111,60,51,54.05
Smolder,Ashe,212,113,99,53.3
Smolder,Rengar,55,32,23,58.18
Smolder,Warwick,189,87,102,46.03
Smolder,Irelia,96,36,60,37.5
Smolder,Nautilus,217,110,107,50.69
Smolder,Kayle,85,37,48,43.53
Smolder,Evelynn,54,31,23,57.41
Smolder,Corki,69,35,34,50.72
Smolder,Syndra,104,63,41,60.58
Smolder,Tryndamere,49,9,40,18.37
Smolder,Nunu,88,52,36,59.09
Smolder,Kennen,41,17,24,41.46
Smolder,Rell,115,88,27,76.52
Smolder,Yorick,137,37,100,27.01
Smolder,Ahri,217,104,113,47.93
Smolder,Lux,356,193,163,54.21
Smolder,Xayah,88,39,49,44.32
Smolder,Karthus,25,13,12,52
Smolder,Naafiri,77,37,40,48.05
Smolder,Vayne,183,83,100,45.36
Smolder,Volibear,182,87,95,47.8
Smolder,Swain,157,70,87,44.59
Smolder,Rakan,75,37,38,49.33
Smolder,Teemo,152,76,76,50
Smolder,Yasuo,314,173,141,55.1
Smolder,DrMundo,48,24,24,50
Smolder,Xerath,133,60,73,45.11
Smolder,Lucian,132,80,52,60.61
Smolder,Nami,159,80,79,50.31
Smolder,Malphite,193,94,99,48.7
Smolder,Skarner,86,39,47,45.35
Smolder,Hwei,83,55,28,66.27
Smolder,KogMaw,42,14,28,33.33
Smolder,Urgot,89,50,39,56.18
Smolder,Mel,345,180,165,52.17
Smolder,Amumu,157,78,79,49.68
Smolder,Zac,99,53,46,53.54
Smolder,Sion,149,83,66,55.7
Smolder,MonkeyKing,101,47,54,46.53
Smolder,Malzahar,187,86,101,45.99
Smolder,MissFortune,295,152,143,51.53
Smolder,Renekton,61,36,25,59.02
Smolder,Viktor,126,69,57,54.76
Smolder,Seraphine,104,41,63,39.42
Smolder,LeeSin,239,129,110,53.97
Smolder,Senna,86,29,57,33.72
Smolder,MasterYi,149,72,77,48.32
Smolder,Aatrox,141,63,78,44.68
Smolder,XinZhao,103,57,46,55.34
Smolder,Vladimir,69,24,45,34.78
Smolder,Garen,217,108,109,49.77
Smolder,Diana,236,128,108,54.24
Smolder,Zyra,120,59,61,49.17
Smolder,Ekko,146,63,83,43.15
Smolder,Milio,90,52,38,57.78
Smolder,Chogath,194,116,78,59.79
Smolder,Taliyah,48,22,26,45.83
Smolder,Sejuani,84,37,47,44.05
Smolder,Camille,53,32,21,60.38
Smolder,Darius,262,122,140,46.56
Smolder,Varus,154,67,87,43.51
Smolder,Pyke,113,61,52,53.98
Smolder,Ambessa,131,77,54,58.78
Smolder,Khazix,88,47,41,53.41
Smolder,Jhin,314,143,171,45.54
Smolder,Gragas,90,52,38,57.78
Smolder,Tristana,128,82,46,64.06
Smolder,Bard,57,27,30,47.37
Smolder,Gnar,82,46,36,56.1
Smolder,Braum,95,51,44,53.68
Smolder,Nidalee,50,27,23,54
Smolder,Kaisa,228,116,112,50.88
Smolder,Lulu,207,88,119,42.51
Smolder,Vi,139,68,71,48.92
Smolder,Zilean,52,27,25,51.92
Smolder,JarvanIV,126,71,55,56.35
Smolder,Aphelios,114,72,42,63.16
Smolder,Leona,137,62,75,45.26
Smolder,Poppy,121,76,45,62.81
Smolder,Heimerdinger,79,31,48,39.24
Smolder,Ivern,24,10,14,41.67
Smolder,Veigar,138,55,83,39.86
Smolder,Riven,38,25,13,65.79
Smolder,Blitzcrank,80,36,44,45
Smolder,Singed,51,22,29,43.14
Smolder,Shaco,106,64,42,60.38
Smolder,Ryze,44,20,24,45.45
Smolder,Jinx,357,160,197,44.82
Smolder,Yuumi,131,52,79,39.69
Smolder,Udyr,44,35,9,79.55
Smolder,Aurora,96,52,44,54.17
Smolder,Viego,196,91,105,46.43
Smolder,Karma,152,78,74,51.32
Smolder,Sett,224,110,114,49.11
Smolder,Illaoi,50,27,23,54
Smolder,Fizz,69,38,31,55.07
Smolder,Sylas,212,82,130,38.68
Smolder,Gangplank,69,35,34,50.72
Smolder,Azir,62,27,35,43.55
Smolder,Leblanc,83,48,35,57.83
Smolder,Shyvana,41,22,19,53.66
Smolder,AurelionSol,44,14,30,31.82
Smolder,Jayce,71,29,42,40.85
Smolder,Orianna,84,47,37,55.95
Smolder,Olaf,37,10,27,27.03
Smolder,TahmKench,151,79,72,52.32
Smolder,Lissandra,49,32,17,65.31
Smolder,Brand,91,52,39,57.14
Smolder,Gwen,67,28,39,41.79
Smolder,Graves,100,48,52,48
Smolder,Zed,151,72,79,47.68
Smolder,Zeri,79,28,51,35.44
Smolder,Kalista,51,30,21,58.82
Smolder,Hecarim,61,25,36,40.98
Smolder,Twitch,130,75,55,57.69
Smolder,Nasus,105,57,48,54.29
Smolder,Sona,19,14,5,73.68
Smolder,Galio,145,80,65,55.17
Smolder,Jax,107,51,56,47.66
Smolder,Briar,72,22,50,30.56
Smolder,Elise,83,31,52,37.35
Smolder,TwistedFate,55,19,36,34.55
Smolder,Ziggs,25,15,10,60
Smolder,Janna,48,31,17,64.58
Smolder,Pantheon,227,119,108,52.42
Smolder,FiddleSticks,56,26,30,46.43
Smolder,Thresh,252,143,109,56.75
Smolder,Cassiopeia,50,32,18,64
Smolder,Kled,32,14,18,43.75
Smolder,Kassadin,15,7,8,46.67
Smolder,Draven,72,32,40,44.44
Smolder,Nilah,53,24,29,45.28
Smolder,Velkoz,57,36,21,63.16
Smolder,Rammus,45,22,23,48.89
Smolder,Akshan,46,21,25,45.65
Smolder,Neeko,64,27,37,42.19
Smolder,Sivir,58,26,32,44.83
Smolder,Shen,70,36,34,51.43
Smolder,Zoe,49,19,30,38.78
Smolder,Taric,42,12,30,28.57
Smolder,Fiora,49,39,10,79.59
Smolder,Soraka,56,38,18,67.86
Smolder,Vex,59,25,34,42.37
Smolder,Trundle,70,28,42,40
Smolder,KSante,99,50,49,50.51
Smolder,Alistar,87,55,32,63.22
Smolder,Lillia,66,28,38,42.42
Smolder,Anivia,43,23,20,53.49
Smolder,Qiyana,24,13,11,54.17
Smolder,Maokai,86,54,32,62.79
Smolder,Quinn,42,20,22,47.62
Smolder,Belveth,15,10,5,66.67
Smolder,Annie,28,10,18,35.71
Smolder,RekSai,14,5,9,35.71
Smolder,Rumble,25,15,10,60
TahmKench,Mordekaiser,262,115,147,43.89
TahmKench,Kayn,243,103,140,42.39
TahmKench,Katarina,130,61,69,46.92
TahmKench,Caitlyn,433,207,226,47.81
TahmKench,Morgana,138,57,81,41.3
TahmKench,Sion,128,56,72,43.75
TahmKench,RekSai,21,14,7,66.67
TahmKench,Viktor,199,98,101,49.25
TahmKench,KogMaw,73,39,34,53.42
TahmKench,Ashe,378,185,193,48.94
TahmKench,Gragas,158,92,66,58.23
TahmKench,Elise,148,67,81,45.27
TahmKench,Mel,425,210,215,49.41
TahmKench,Vayne,303,137,166,45.21
TahmKench,Zyra,142,70,72,49.3
TahmKench,Sett,300,134,166,44.67
TahmKench,Sejuani,127,68,59,53.54
TahmKench,Jinx,382,217,165,56.81
TahmKench,Lux,473,276,197,58.35
TahmKench,Yorick,133,88,45,66.17
TahmKench,Diana,267,132,135,49.44
TahmKench,Akali,138,71,67,51.45
TahmKench,Milio,120,45,75,37.5
TahmKench,XinZhao,109,70,39,64.22
TahmKench,Thresh,370,193,177,52.16
TahmKench,Kaisa,265,147,118,55.47
TahmKench,Jhin,352,191,161,54.26
TahmKench,Urgot,126,64,62,50.79
TahmKench,Malzahar,241,128,113,53.11
TahmKench,Ezreal,459,263,196,57.3
TahmKench,Irelia,117,59,58,50.43
TahmKench,Ekko,155,76,79,49.03
TahmKench,Qiyana,34,16,18,47.06
TahmKench,Quinn,76,54,22,71.05
TahmKench,LeeSin,262,125,137,47.71
TahmKench,Malphite,173,107,66,61.85
TahmKench,Khazix,85,41,44,48.24
TahmKench,Olaf,50,31,19,62
TahmKench,Vi,258,123,135,47.67
TahmKench,Veigar,220,103,117,46.82
TahmKench,Bard,58,21,37,36.21
TahmKench,Volibear,213,116,97,54.46
TahmKench,Amumu,254,118,136,46.46
TahmKench,Zeri,70,36,34,51.43
TahmKench,Pantheon,315,145,170,46.03
TahmKench,Jayce,76,40,36,52.63
TahmKench,Samira,121,51,70,42.15
TahmKench,Leona,210,108,102,51.43
TahmKench,Heimerdinger,81,41,40,50.62
TahmKench,Orianna,100,38,62,38
TahmKench,Seraphine,144,84,60,58.33
TahmKench,Chogath,252,136,116,53.97
TahmKench,Gwen,103,60,43,58.25
TahmKench,Rell,142,82,60,57.75
TahmKench,Aatrox,178,71,107,39.89
TahmKench,Yasuo,330,142,188,43.03
TahmKench,Nami,224,138,86,61.61
TahmKench,Jax,119,46,73,38.66
TahmKench,MissFortune,325,160,165,49.23
TahmKench,Twitch,136,67,69,49.26
TahmKench,Varus,174,112,62,64.37
TahmKench,Graves,128,56,72,43.75
TahmKench,Zoe,69,34,35,49.28
TahmKench,Zac,117,88,29,75.21
TahmKench,Poppy,149,91,58,61.07
TahmKench,Ziggs,68,26,42,38.24
TahmKench,Warwick,275,152,123,55.27
TahmKench,DrMundo,111,58,53,52.25
TahmKench,Zed,180,115,65,63.89
TahmKench,Sivir,112,61,51,54.46
TahmKench,MasterYi,209,98,111,46.89
TahmKench,Draven,109,70,39,64.22
TahmKench,Rakan,104,46,58,44.23
TahmKench,Trundle,145,51,94,35.17
TahmKench,Tristana,167,84,83,50.3
TahmKench,Blitzcrank,162,86,76,53.09
TahmKench,Gangplank,72,33,39,45.83
TahmKench,Lulu,257,142,115,55.25
TahmKench,Skarner,98,51,47,52.04
TahmKench,AurelionSol,87,43,44,49.43
TahmKench,Karma,197,94,103,47.72
TahmKench,Yone,295,148,147,50.17
TahmKench,Senna,121,58,63,47.93
TahmKench,Shen,104,57,47,54.81
TahmKench,Aurora,139,79,60,56.83
TahmKench,Brand,163,88,75,53.99
TahmKench,Lucian,158,102,56,64.56
TahmKench,Swain,184,70,114,38.04
TahmKench,Rumble,47,28,19,59.57
TahmKench,Fizz,91,53,38,58.24
TahmKench,Zilean,44,28,16,63.64
TahmKench,Renekton,100,50,50,50
TahmKench,Nidalee,56,34,22,60.71
TahmKench,Viego,190,107,83,56.32
TahmKench,Alistar,92,40,52,43.48
TahmKench,Nunu,110,66,44,60
TahmKench,Talon,107,60,47,56.07
TahmKench,Galio,183,96,87,52.46
TahmKench,Darius,337,178,159,52.82
TahmKench,Xayah,109,57,52,52.29
TahmKench,Ambessa,136,65,71,47.79
TahmKench,Pyke,161,117,44,72.67
TahmKench,Syndra,138,81,57,58.7
TahmKench,JarvanIV,109,51,58,46.79
TahmKench,Yuumi,106,56,50,52.83
TahmKench,Annie,75,44,31,58.67
TahmKench,Janna,56,30,26,53.57
TahmKench,Illaoi,113,53,60,46.9
TahmKench,Teemo,177,101,76,57.06
TahmKench,Gnar,95,60,35,63.16
TahmKench,Kayle,104,47,57,45.19
TahmKench,Briar,132,57,75,43.18
TahmKench,Vex,96,34,62,35.42
TahmKench,Kled,22,2,20,9.09
TahmKench,Lillia,94,54,40,57.45
TahmKench,Riven,65,42,23,64.62
TahmKench,Shaco,126,56,70,44.44
TahmKench,Kassadin,39,22,17,56.41
TahmKench,Rengar,51,22,29,43.14
TahmKench,Corki,84,44,40,52.38
TahmKench,Sylas,260,130,130,50
TahmKench,Tryndamere,74,35,39,47.3
TahmKench,Nasus,78,32,46,41.03
TahmKench,Nocturne,196,110,86,56.12
TahmKench,Braum,147,56,91,38.1
TahmKench,TwistedFate,47,22,25,46.81
TahmKench,Velkoz,106,56,50,52.83
TahmKench,Nautilus,258,127,131,49.22
TahmKench,Neeko,110,42,68,38.18
TahmKench,Ornn,102,54,48,52.94
TahmKench,FiddleSticks,88,31,57,35.23
TahmKench,Renata,37,23,14,62.16
TahmKench,Fiora,89,48,41,53.93
TahmKench,Shyvana,53,29,24,54.72
TahmKench,Cassiopeia,47,18,29,38.3
TahmKench,Soraka,101,57,44,56.44
TahmKench,Ryze,70,44,26,62.86
TahmKench,MonkeyKing,136,77,59,56.62
TahmKench,Kindred,66,42,24,63.64
TahmKench,Ahri,204,113,91,55.39
TahmKench,Kalista,56,24,32,42.86
TahmKench,Hwei,139,76,63,54.68
TahmKench,Lissandra,96,38,58,39.58
TahmKench,Vladimir,93,60,33,64.52
TahmKench,KSante,86,53,33,61.63
TahmKench,Azir,91,53,38,58.24
TahmKench,Nilah,62,23,39,37.1
TahmKench,Smolder,151,72,79,47.68
TahmKench,Naafiri,48,25,23,52.08
TahmKench,Leblanc,87,42,45,48.28
TahmKench,Singed,32,14,18,43.75
TahmKench,Camille,75,44,31,58.67
TahmKench,Aphelios,86,49,37,56.98
TahmKench,Ivern,39,14,25,35.9
TahmKench,Garen,288,118,170,40.97
TahmKench,Akshan,72,37,35,51.39
TahmKench,Maokai,111,61,50,54.95
TahmKench,Xerath,145,90,55,62.07
TahmKench,Taliyah,57,27,30,47.37
TahmKench,Taric,48,20,28,41.67
TahmKench,Karthus,35,18,17,51.43
TahmKench,Rammus,74,47,27,63.51
TahmKench,Hecarim,34,24,10,70.59
TahmKench,Evelynn,44,18,26,40.91
TahmKench,Belveth,31,16,15,51.61
TahmKench,Anivia,62,32,30,51.61
TahmKench,Udyr,79,46,33,58.23
TahmKench,Sona,31,14,17,45.16
TahmKench,Kennen,46,33,13,71.74
Shaco,Renekton,97,48,49,49.48
Shaco,Udyr,77,51,26,66.23
Shaco,Qiyana,35,15,20,42.86
Shaco,Xayah,78,44,34,56.41
Shaco,Morgana,203,82,121,40.39
Shaco,Yorick,117,61,56,52.14
Shaco,Warwick,214,101,113,47.2
Shaco,Akali,158,94,64,59.49
Shaco,Jhin,346,149,197,43.06
Shaco,Braum,114,55,59,48.25
Shaco,Nasus,94,43,51,45.74
Shaco,Amumu,179,67,112,37.43
Shaco,Sylas,180,81,99,45
Shaco,Twitch,109,49,60,44.95
Shaco,Lulu,216,95,121,43.98
Shaco,Trundle,65,32,33,49.23
Shaco,Ahri,218,116,102,53.21
Shaco,Graves,106,61,45,57.55
Shaco,Volibear,177,72,105,40.68
Shaco,MasterYi,164,70,94,42.68
Shaco,Mel,316,137,179,43.35
Shaco,Ezreal,394,170,224,43.15
Shaco,Blitzcrank,134,67,67,50
Shaco,Diana,235,108,127,45.96
Shaco,Yasuo,359,176,183,49.03
Shaco,Ashe,283,136,147,48.06
Shaco,Darius,281,131,150,46.62
Shaco,Kayn,207,83,124,40.1
Shaco,Lux,400,198,202,49.5
Shaco,Riven,47,26,21,55.32
Shaco,Soraka,90,45,45,50
Shaco,MonkeyKing,111,57,54,51.35
Shaco,Viktor,148,68,80,45.95
Shaco,Rakan,87,50,37,57.47
Shaco,Sejuani,96,42,54,43.75
Shaco,Leblanc,95,39,56,41.05
Shaco,Nilah,63,28,35,44.44
Shaco,Karma,189,82,107,43.39
Shaco,Jax,148,77,71,52.03
Shaco,Tristana,128,55,73,42.97
Shaco,Sion,157,66,91,42.04
Shaco,Ambessa,106,55,51,51.89
Shaco,Jinx,398,175,223,43.97
Shaco,Kaisa,218,112,106,51.38
Shaco,Malzahar,156,63,93,40.38
Shaco,Gragas,108,64,44,59.26
Shaco,Gnar,68,29,39,42.65
Shaco,MissFortune,305,153,152,50.16
Shaco,Vex,84,47,37,55.95
Shaco,Caitlyn,384,195,189,50.78
Shaco,Brand,95,37,58,38.95
Shaco,Ekko,140,74,66,52.86
Shaco,Alistar,102,42,60,41.18
Shaco,TwistedFate,68,32,36,47.06
Shaco,JarvanIV,107,45,62,42.06
Shaco,Maokai,89,44,45,49.44
Shaco,Zeri,72,37,35,51.39
Shaco,Vayne,181,91,90,50.28
Shaco,Chogath,192,70,122,36.46
Shaco,Olaf,39,19,20,48.72
Shaco,Draven,81,39,42,48.15
Shaco,Teemo,119,48,71,40.34
Shaco,Irelia,128,66,62,51.56
Shaco,Zac,72,40,32,55.56
Shaco,Nocturne,197,86,111,43.65
Shaco,Veigar,153,62,91,40.52
Shaco,KogMaw,58,31,27,53.45
Shaco,Gwen,68,21,47,30.88
Shaco,XinZhao,87,24,63,27.59
Shaco,Zed,160,92,68,57.5
Shaco,Nidalee,68,42,26,61.76
Shaco,Vladimir,77,32,45,41.56
Shaco,Kennen,47,19,28,40.43
Shaco,Varus,114,60,54,52.63
Shaco,Mordekaiser,195,81,114,41.54
Shaco,Kindred,59,33,26,55.93
Shaco,Milio,127,65,62,51.18
Shaco,Taliyah,38,16,22,42.11
Shaco,Hwei,83,46,37,55.42
Shaco,Zoe,68,45,23,66.18
Shaco,Rumble,36,23,13,63.89
Shaco,Corki,65,45,20,69.23
Shaco,Sona,43,20,23,46.51
Shaco,Urgot,58,37,21,63.79
Shaco,Sett,219,108,111,49.32
Shaco,Elise,145,81,64,55.86
Shaco,Yone,275,129,146,46.91
Shaco,Shen,136,64,72,47.06
Shaco,Aurora,124,56,68,45.16
Shaco,Rengar,52,39,13,75
Shaco,Lillia,84,35,49,41.67
Shaco,Nami,137,72,65,52.55
Shaco,Malphite,167,69,98,41.32
Shaco,Viego,179,74,105,41.34
Shaco,Leona,162,87,75,53.7
Shaco,Camille,50,24,26,48
Shaco,LeeSin,278,176,102,63.31
Shaco,Orianna,47,29,18,61.7
Shaco,Annie,21,6,15,28.57
Shaco,Neeko,85,29,56,34.12
Shaco,Gangplank,78,29,49,37.18
Shaco,Lucian,117,73,44,62.39
Shaco,Pyke,143,73,70,51.05
Shaco,Garen,202,113,89,55.94
Shaco,Nautilus,183,96,87,52.46
Shaco,FiddleSticks,75,32,43,42.67
Shaco,Xerath,105,43,62,40.95
Shaco,Singed,33,13,20,39.39
Shaco,Swain,136,60,76,44.12
Shaco,Seraphine,119,60,59,50.42
Shaco,Vi,144,58,86,40.28
Shaco,Zilean,54,26,28,48.15
Shaco,Shyvana,48,31,17,64.58
Shaco,Aphelios,79,33,46,41.77
Shaco,Khazix,90,46,44,51.11
Shaco,TahmKench,126,70,56,55.56
Shaco,KSante,92,41,51,44.57
Shaco,Karthus,50,24,26,48
Shaco,Talon,77,27,50,35.06
Shaco,Fizz,89,43,46,48.31
Shaco,Azir,70,40,30,57.14
Shaco,Heimerdinger,74,36,38,48.65
Shaco,AurelionSol,78,27,51,34.62
Shaco,Cassiopeia,49,32,17,65.31
Shaco,Thresh,253,119,134,47.04
Shaco,Tryndamere,51,33,18,64.71
Shaco,Zyra,133,73,60,54.89
Shaco,Pantheon,221,100,121,45.25
Shaco,Ryze,41,19,22,46.34
Shaco,Hecarim,51,25,26,49.02
Shaco,Lissandra,67,22,45,32.84
Shaco,Jayce,69,34,35,49.28
Shaco,Rammus,33,9,24,27.27
Shaco,Ivern,20,17,3,85
Shaco,Smolder,106,42,64,39.62
Shaco,Poppy,106,50,56,47.17
Shaco,Skarner,54,24,30,44.44
Shaco,Sivir,82,18,64,21.95
Shaco,Kayle,92,41,51,44.57
Shaco,Janna,50,14,36,28
Shaco,Nunu,116,47,69,40.52
Shaco,Samira,112,45,67,40.18
Shaco,Galio,149,62,87,41.61
Shaco,Velkoz,60,40,20,66.67
Shaco,Renata,26,18,8,69.23
Shaco,Ziggs,45,23,22,51.11
Shaco,Aatrox,122,59,63,48.36
Shaco,Katarina,83,38,45,45.78
Shaco,Fiora,59,29,30,49.15
Shaco,Rell,85,35,50,41.18
Shaco,Ornn,84,41,43,48.81
Shaco,Akshan,35,12,23,34.29
Shaco,Briar,91,39,52,42.86
Shaco,Evelynn,54,28,26,51.85
Shaco,RekSai,28,16,12,57.14
Shaco,Taric,25,6,19,24
Shaco,Yuumi,112,55,57,49.11
Shaco,Syndra,70,34,36,48.57
Shaco,Anivia,65,26,39,40
Shaco,DrMundo,59,26,33,44.07
Shaco,Senna,69,25,44,36.23
Shaco,Kled,26,8,18,30.77
Shaco,Kassadin,29,9,20,31.03
Shaco,Bard,46,22,24,47.83
Shaco,Illaoi,66,21,45,31.82
Shaco,Belveth,18,2,16,11.11
Shaco,Quinn,28,14,14,50
Shaco,Kalista,25,19,6,76
Shaco,Naafiri,34,18,16,52.94
Azir,Renekton,56,29,27,51.79
Azir,Udyr,26,17,9,65.38
Azir,Qiyana,10,5,5,50
Azir,Xayah,78,40,38,51.28
Azir,Morgana,81,41,40,50.62
Azir,Akali,74,35,39,47.3
Azir,Amumu,90,38,52,42.22
Azir,Riven,36,20,16,55.56
Azir,Caitlyn,215,102,113,47.44
Azir,Lux,202,99,103,49.01
Azir,Teemo,71,37,34,52.11
Azir,Khazix,38,12,26,31.58
Azir,Zoe,29,11,18,37.93
Azir,Jinx,201,100,101,49.75
Azir,Poppy,68,23,45,33.82
Azir,Karma,131,74,57,56.49
Azir,MonkeyKing,74,31,43,41.89
Azir,Mel,233,140,93,60.09
Azir,Cassiopeia,17,14,3,82.35
Azir,Thresh,118,46,72,38.98
Azir,KSante,33,12,21,36.36
Azir,Lillia,45,23,22,51.11
Azir,Diana,144,62,82,43.06
Azir,Twitch,56,22,34,39.29
Azir,Bard,24,12,12,50
Azir,Garen,108,59,49,54.63
Azir,Viktor,110,63,47,57.27
Azir,Talon,44,26,18,59.09
Azir,Sivir,73,34,39,46.58
Azir,Lulu,118,51,67,43.22
Azir,Warwick,73,24,49,32.88
Azir,Nunu,54,35,19,64.81
Azir,Malzahar,118,75,43,63.56
Azir,Samira,83,36,47,43.37
Azir,Pyke,92,58,34,63.04
Azir,Irelia,68,29,39,42.65
Azir,XinZhao,67,39,28,58.21
Azir,Zed,96,34,62,35.42
Azir,Kaisa,162,64,98,39.51
Azir,Brand,35,12,23,34.29
Azir,Illaoi,33,16,17,48.48
Azir,MasterYi,84,38,46,45.24
Azir,Yone,157,92,65,58.6
Azir,Lucian,90,57,33,63.33
Azir,Nami,79,35,44,44.3
Azir,Vladimir,53,23,30,43.4
Azir,Karthus,23,9,14,39.13
Azir,Ekko,73,36,37,49.32
Azir,Zeri,58,18,40,31.03
Azir,Seraphine,68,31,37,45.59
Azir,Shen,69,34,35,49.28
Azir,Gragas,68,33,35,48.53
Azir,Aurora,90,47,43,52.22
Azir,Ashe,173,88,85,50.87
Azir,Aatrox,121,65,56,53.72
Azir,Yorick,108,44,64,40.74
Azir,Ezreal,232,111,121,47.84
Azir,Maokai,62,22,40,35.48
Azir,Blitzcrank,84,54,30,64.29
Azir,Mordekaiser,110,51,59,46.36
Azir,Skarner,63,39,24,61.9
Azir,Varus,57,23,34,40.35
Azir,Neeko,57,26,31,45.61
Azir,Briar,41,20,21,48.78
Azir,Nautilus,120,58,62,48.33
Azir,Rammus,33,9,24,27.27
Azir,Zilean,23,8,15,34.78
Azir,Draven,49,23,26,46.94
Azir,Darius,196,103,93,52.55
Azir,JarvanIV,70,36,34,51.43
Azir,Yuumi,78,40,38,51.28
Azir,Orianna,59,42,17,71.19
Azir,Ivern,14,5,9,35.71
Azir,Kayn,133,70,63,52.63
Azir,TwistedFate,24,9,15,37.5
Azir,Chogath,95,50,45,52.63
Azir,Zac,59,30,29,50.85
Azir,Soraka,37,28,9,75.68
Azir,Yasuo,166,91,75,54.82
Azir,Sett,158,84,74,53.16
Azir,Fiora,25,10,15,40
Azir,Shaco,70,30,40,42.86
Azir,Veigar,67,32,35,47.76
Azir,Tristana,86,33,53,38.37
Azir,Jax,61,40,21,65.57
Azir,Aphelios,58,20,38,34.48
Azir,Leona,86,39,47,45.35
Azir,Pantheon,159,62,97,38.99
Azir,Katarina,49,22,27,44.9
Azir,Milio,55,38,17,69.09
Azir,Evelynn,36,17,19,47.22
Azir,Jhin,137,60,77,43.8
Azir,Zyra,72,29,43,40.28
Azir,Ryze,56,34,22,60.71
Azir,Leblanc,49,14,35,28.57
Azir,MissFortune,130,64,66,49.23
Azir,Tryndamere,18,8,10,44.44
Azir,Sona,14,6,8,42.86
Azir,Malphite,87,33,54,37.93
Azir,Sylas,128,52,76,40.63
Azir,Smolder,62,35,27,56.45
Azir,TahmKench,91,38,53,41.76
Azir,Shyvana,23,2,21,8.7
Azir,Quinn,30,14,16,46.67
Azir,LeeSin,161,82,79,50.93
Azir,Alistar,67,22,45,32.84
Azir,Jayce,66,33,33,50
Azir,Ahri,107,45,62,42.06
Azir,Senna,58,28,30,48.28
Azir,Kassadin,9,6,3,66.67
Azir,Rakan,52,20,32,38.46
Azir,Heimerdinger,26,12,14,46.15
Azir,Swain,84,35,49,41.67
Azir,Nidalee,40,20,20,50
Azir,Ziggs,27,13,14,48.15
Azir,Viego,124,75,49,60.48
Azir,Kindred,27,11,16,40.74
Azir,Kennen,17,6,11,35.29
Azir,Urgot,38,20,18,52.63
Azir,KogMaw,20,11,9,55
Azir,Vi,93,25,68,26.88
Azir,Nasus,46,19,27,41.3
Azir,Syndra,84,36,48,42.86
Azir,Lissandra,21,11,10,52.38
Azir,Braum,66,21,45,31.82
Azir,Vex,43,5,38,11.63
Azir,Kayle,38,17,21,44.74
Azir,Hecarim,47,23,24,48.94
Azir,Rell,60,31,29,51.67
Azir,Trundle,42,14,28,33.33
Azir,RekSai,16,5,11,31.25
Azir,Ambessa,90,50,40,55.56
Azir,Akshan,27,16,11,59.26
Azir,Gwen,34,9,25,26.47
Azir,Sejuani,47,21,26,44.68
Azir,Fizz,14,3,11,21.43
Azir,Volibear,83,31,52,37.35
Azir,Vayne,85,40,45,47.06
Azir,Taric,20,12,8,60
Azir,Sion,63,31,32,49.21
Azir,Ornn,60,26,34,43.33
Azir,Velkoz,51,25,26,49.02
Azir,Gnar,36,16,20,44.44
Azir,Hwei,71,44,27,61.97
Azir,Graves,67,39,28,58.21
Azir,Nilah,31,18,13,58.06
Azir,Taliyah,20,5,15,25
Azir,Galio,82,39,43,47.56
Azir,Rumble,38,16,22,42.11
Azir,Naafiri,32,16,16,50
Azir,Camille,34,13,21,38.24
Azir,Corki,43,27,16,62.79
Azir,Kalista,29,9,20,31.03
Azir,Anivia,20,5,15,25
Azir,Xerath,53,30,23,56.6
Azir,Renata,25,18,7,72
Azir,Nocturne,91,41,50,45.05
Azir,Singed,25,5,20,20
Azir,FiddleSticks,47,26,21,55.32
Azir,Annie,29,15,14,51.72
Azir,DrMundo,28,18,10,64.29
Azir,Elise,78,36,42,46.15
Azir,Olaf,19,3,16,15.79
Azir,Janna,35,13,22,37.14
Azir,Rengar,24,14,10,58.33
Azir,Belveth,17,9,8,52.94
Azir,AurelionSol,17,2,15,11.76
Azir,Kled,17,6,11,35.29
Azir,Gangplank,27,18,9,66.67
Sylas,Renekton,153,56,97,36.6
Sylas,Udyr,113,44,69,38.94
Sylas,Qiyana,89,49,40,55.06
Sylas,Xayah,168,82,86,48.81
Sylas,Morgana,301,143,158,47.51
Sylas,Akali,420,217,203,51.67
Sylas,Belveth,69,36,33,52.17
Sylas,Varus,335,163,172,48.66
Sylas,Jhin,564,291,273,51.6
Sylas,Lulu,391,190,201,48.59
Sylas,Kayn,360,170,190,47.22
Sylas,Shaco,180,99,81,55
Sylas,Zoe,153,66,87,43.14
Sylas,KogMaw,65,38,27,58.46
Sylas,TwistedFate,128,78,50,60.94
Sylas,KSante,192,95,97,49.48
Sylas,Viego,416,215,201,51.68
Sylas,Kassadin,71,33,38,46.48
Sylas,Nasus,188,93,95,49.47
Sylas,Bard,85,47,38,55.29
Sylas,Naafiri,81,36,45,44.44
Sylas,Warwick,379,190,189,50.13
Sylas,Mel,699,291,408,41.63
Sylas,Ashe,690,347,343,50.29
Sylas,Janna,75,31,44,41.33
Sylas,Yorick,189,90,99,47.62
Sylas,Hwei,189,93,96,49.21
Sylas,Samira,223,105,118,47.09
Sylas,Zyra,275,145,130,52.73
Sylas,Graves,257,106,151,41.25
Sylas,Caitlyn,751,357,394,47.54
Sylas,Teemo,244,123,121,50.41
Sylas,Briar,153,64,89,41.83
Sylas,Heimerdinger,113,53,60,46.9
Sylas,Nautilus,417,208,209,49.88
Sylas,Shen,251,110,141,43.82
Sylas,Hecarim,155,85,70,54.84
Sylas,Alistar,272,146,126,53.68
Sylas,FiddleSticks,138,46,92,33.33
Sylas,Lucian,251,125,126,49.8
Sylas,Rell,175,75,100,42.86
Sylas,XinZhao,189,83,106,43.92
Sylas,Aurora,265,152,113,57.36
Sylas,Sivir,171,73,98,42.69
Sylas,Soraka,91,43,48,47.25
Sylas,Rumble,87,34,53,39.08
Sylas,Kindred,87,38,49,43.68
Sylas,Yasuo,656,285,371,43.45
Sylas,Draven,100,47,53,47
Sylas,Taric,65,22,43,33.85
Sylas,Volibear,253,95,158,37.55
Sylas,Ahri,518,268,250,51.74
Sylas,Vayne,349,148,201,42.41
Sylas,Rakan,144,74,70,51.39
Sylas,Riven,125,58,67,46.4
Sylas,LeeSin,671,353,318,52.61
Sylas,MissFortune,568,302,266,53.17
Sylas,Leona,354,186,168,52.54
Sylas,Olaf,71,34,37,47.89
Sylas,Ezreal,842,426,416,50.59
Sylas,Diana,511,261,250,51.08
Sylas,Irelia,252,144,108,57.14
Sylas,Amumu,410,189,221,46.1
Sylas,Katarina,190,100,90,52.63
Sylas,Rammus,98,44,54,44.9
Sylas,MasterYi,280,139,141,49.64
Sylas,Chogath,373,165,208,44.24
Sylas,Karma,369,139,230,37.67
Sylas,Garen,515,247,268,47.96
Sylas,Pantheon,507,223,284,43.98
Sylas,Malzahar,241,116,125,48.13
Sylas,Malphite,486,290,196,59.67
Sylas,Lux,637,367,270,57.61
Sylas,Nocturne,362,188,174,51.93
Sylas,Taliyah,95,44,51,46.32
Sylas,Jinx,758,337,421,44.46
Sylas,Twitch,186,82,104,44.09
Sylas,Zed,275,134,141,48.73
Sylas,Darius,519,254,265,48.94
Sylas,JarvanIV,242,104,138,42.98
Sylas,Elise,255,111,144,43.53
Sylas,Aatrox,364,206,158,56.59
Sylas,Ekko,259,137,122,52.9
Sylas,Yone,613,297,316,48.45
Sylas,Talon,196,106,90,54.08
Sylas,Fizz,137,72,65,52.55
Sylas,Zilean,86,32,54,37.21
Sylas,Galio,424,205,219,48.35
Sylas,Illaoi,124,57,67,45.97
Sylas,Evelynn,72,37,35,51.39
Sylas,Khazix,140,69,71,49.29
Sylas,Gnar,156,72,84,46.15
Sylas,Braum,238,92,146,38.66
Sylas,Vladimir,173,82,91,47.4
Sylas,Lissandra,125,63,62,50.4
Sylas,Nidalee,105,53,52,50.48
Sylas,Kaisa,524,270,254,51.53
Sylas,Mordekaiser,329,167,162,50.76
Sylas,Milio,162,67,95,41.36
Sylas,Thresh,534,240,294,44.94
Sylas,Urgot,92,55,37,59.78
Sylas,Seraphine,197,60,137,30.46
Sylas,Jax,263,133,130,50.57
Sylas,Neeko,186,82,104,44.09
Sylas,Rengar,85,33,52,38.82
Sylas,Ziggs,102,42,60,41.18
Sylas,TahmKench,260,130,130,50
Sylas,Brand,115,51,64,44.35
Sylas,Tryndamere,68,39,29,57.35
Sylas,Maokai,144,82,62,56.94
Sylas,Vex,207,87,120,42.03
Sylas,Ornn,218,89,129,40.83
Sylas,Ivern,51,31,20,60.78
Sylas,Nunu,160,86,74,53.75
Sylas,Blitzcrank,403,230,173,57.07
Sylas,Senna,182,105,77,57.69
Sylas,Poppy,215,97,118,45.12
Sylas,Sett,460,209,251,45.43
Sylas,Tristana,230,122,108,53.04
Sylas,Gragas,255,120,135,47.06
Sylas,Sejuani,191,77,114,40.31
Sylas,Gangplank,156,94,62,60.26
Sylas,Veigar,199,98,101,49.25
Sylas,Swain,272,121,151,44.49
Sylas,Pyke,299,145,154,48.49
Sylas,Fiora,92,37,55,40.22
Sylas,Velkoz,126,52,74,41.27
Sylas,Smolder,212,130,82,61.32
Sylas,Akshan,55,16,39,29.09
Sylas,Nilah,98,28,70,28.57
Sylas,Renata,64,38,26,59.38
Sylas,Nami,190,84,106,44.21
Sylas,Viktor,250,101,149,40.4
Sylas,Sona,55,32,23,58.18
Sylas,Vi,353,173,180,49.01
Sylas,MonkeyKing,224,82,142,36.61
Sylas,Azir,128,76,52,59.38
Sylas,Annie,91,37,54,40.66
Sylas,Yuumi,177,81,96,45.76
Sylas,Kalista,112,62,50,55.36
Sylas,Camille,146,68,78,46.58
Sylas,Zac,168,91,77,54.17
Sylas,Leblanc,180,112,68,62.22
Sylas,Orianna,143,80,63,55.94
Sylas,Sion,240,94,146,39.17
Sylas,Singed,63,32,31,50.79
Sylas,DrMundo,107,44,63,41.12
Sylas,Zeri,131,53,78,40.46
Sylas,Kayle,138,53,85,38.41
Sylas,Shyvana,51,18,33,35.29
Sylas,Gwen,150,57,93,38
Sylas,Aphelios,171,78,93,45.61
Sylas,Corki,157,72,85,45.86
Sylas,Ambessa,212,100,112,47.17
Sylas,Kled,41,23,18,56.1
Sylas,Xerath,266,133,133,50
Sylas,Trundle,122,48,74,39.34
Sylas,Quinn,96,52,44,54.17
Sylas,Anivia,109,64,45,58.72
Sylas,Syndra,140,83,57,59.29
Sylas,Jayce,149,63,86,42.28
Sylas,Lillia,159,84,75,52.83
Sylas,Kennen,92,47,45,51.09
Sylas,Ryze,127,54,73,42.52
Sylas,Karthus,87,52,35,59.77
Sylas,Skarner,128,69,59,53.91
Sylas,Cassiopeia,79,21,58,26.58
Sylas,AurelionSol,91,54,37,59.34
Sylas,RekSai,29,10,19,34.48
Renekton,Yasuo,287,160,127,55.75
Renekton,Shaco,97,49,48,50.52
Renekton,Azir,56,27,29,48.21
Renekton,Jhin,243,118,125,48.56
Renekton,Sylas,153,97,56,63.4
Renekton,Yone,298,168,130,56.38
Renekton,FiddleSticks,38,15,23,39.47
Renekton,Aurora,105,39,66,37.14
Renekton,Vayne,148,77,71,52.03
Renekton,Senna,52,22,30,42.31
Renekton,KSante,102,66,36,64.71
Renekton,Nunu,65,34,31,52.31
Renekton,Akshan,35,20,15,57.14
Renekton,Ziggs,48,16,32,33.33
Renekton,Seraphine,65,35,30,53.85
Renekton,Teemo,86,24,62,27.91
Renekton,Lillia,77,34,43,44.16
Renekton,Camille,51,24,27,47.06
Renekton,Draven,62,23,39,37.1
Renekton,Ambessa,168,104,64,61.9
Renekton,Ekko,101,39,62,38.61
Renekton,Lux,217,117,100,53.92
Renekton,Caitlyn,296,140,156,47.3
Renekton,Soraka,52,22,30,42.31
Renekton,Yorick,103,36,67,34.95
Renekton,Graves,70,28,42,40
Renekton,Naafiri,30,12,18,40
Renekton,Morgana,116,46,70,39.66
Renekton,Sett,201,87,114,43.28
Renekton,Jax,102,47,55,46.08
Renekton,Irelia,87,55,32,63.22
Renekton,Yuumi,94,51,43,54.26
Renekton,Trundle,51,19,32,37.25
Renekton,Diana,162,73,89,45.06
Renekton,Ahri,147,76,71,51.7
Renekton,Tristana,96,54,42,56.25
Renekton,Janna,23,15,8,65.22
Renekton,Garen,192,102,90,53.13
Renekton,Nocturne,93,37,56,39.78
Renekton,Akali,92,60,32,65.22
Renekton,Corki,46,29,17,63.04
Renekton,Riven,53,29,24,54.72
Renekton,JarvanIV,95,68,27,71.58
Renekton,Vladimir,57,27,30,47.37
Renekton,Nami,126,54,72,42.86
Renekton,Ezreal,304,150,154,49.34
Renekton,MasterYi,88,40,48,45.45
Renekton,Nasus,66,39,27,59.09
Renekton,Alistar,57,24,33,42.11
Renekton,Malzahar,129,51,78,39.53
Renekton,Ashe,160,88,72,55
Renekton,Lulu,155,66,89,42.58
Renekton,Aatrox,126,70,56,55.56
Renekton,LeeSin,201,116,85,57.71
Renekton,Malphite,114,68,46,59.65
Renekton,Zoe,66,31,35,46.97
Renekton,Xerath,96,43,53,44.79
Renekton,Smolder,61,25,36,40.98
Renekton,Leona,107,58,49,54.21
Renekton,Talon,67,38,29,56.72
Renekton,Zyra,84,34,50,40.48
Renekton,Chogath,112,51,61,45.54
Renekton,Braum,88,47,41,53.41
Renekton,TahmKench,100,50,50,50
Renekton,Blitzcrank,123,54,69,43.9
Renekton,Darius,205,101,104,49.27
Renekton,Warwick,149,75,74,50.34
Renekton,Jinx,246,125,121,50.81
Renekton,Gangplank,30,20,10,66.67
Renekton,Qiyana,15,6,9,40
Renekton,Leblanc,68,44,24,64.71
Renekton,Lucian,97,58,39,59.79
Renekton,Twitch,91,45,46,49.45
Renekton,Swain,106,48,58,45.28
Renekton,Sion,72,40,32,55.56
Renekton,XinZhao,98,54,44,55.1
Renekton,Annie,26,11,15,42.31
Renekton,MonkeyKing,85,32,53,37.65
Renekton,Sivir,53,31,22,58.49
Renekton,Shen,83,35,48,42.17
Renekton,RekSai,36,14,22,38.89
Renekton,Veigar,94,51,43,54.26
Renekton,Milio,70,38,32,54.29
Renekton,Kayn,131,69,62,52.67
Renekton,Kaisa,181,100,81,55.25
Renekton,Heimerdinger,24,11,13,45.83
Renekton,Pantheon,187,103,84,55.08
Renekton,Cassiopeia,30,10,20,33.33
Renekton,MissFortune,208,88,120,42.31
Renekton,Amumu,109,48,61,44.04
Renekton,Sejuani,61,40,21,65.57
Renekton,Viktor,87,40,47,45.98
Renekton,Rell,69,30,39,43.48
Renekton,Belveth,25,19,6,76
Renekton,Mel,237,117,120,49.37
Renekton,Gnar,44,29,15,65.91
Renekton,Karma,135,56,79,41.48
Renekton,Poppy,93,35,58,37.63
Renekton,Viego,148,73,75,49.32
Renekton,Hwei,66,26,40,39.39
Renekton,Pyke,98,56,42,57.14
Renekton,Nilah,43,26,17,60.47
Renekton,Thresh,168,94,74,55.95
Renekton,Kennen,41,31,10,75.61
Renekton,Galio,110,57,53,51.82
Renekton,Illaoi,62,19,43,30.65
Renekton,Vi,131,77,54,58.78
Renekton,Xayah,74,26,48,35.14
Renekton,Rakan,69,24,45,34.78
Renekton,Quinn,68,15,53,22.06
Renekton,Urgot,47,14,33,29.79
Renekton,Zeri,52,27,25,51.92
Renekton,Fizz,59,28,31,47.46
Renekton,Volibear,132,51,81,38.64
Renekton,Elise,105,50,55,47.62
Renekton,Lissandra,45,19,26,42.22
Renekton,Evelynn,17,9,8,52.94
Renekton,Bard,48,27,21,56.25
Renekton,Zac,83,36,47,43.37
Renekton,Kalista,33,18,15,54.55
Renekton,Renata,22,13,9,59.09
Renekton,Gragas,74,36,38,48.65
Renekton,Olaf,14,11,3,78.57
Renekton,Syndra,69,33,36,47.83
Renekton,Katarina,77,35,42,45.45
Renekton,Ornn,61,28,33,45.9
Renekton,Briar,61,30,31,49.18
Renekton,Zed,100,46,54,46
Renekton,Khazix,55,17,38,30.91
Renekton,Nidalee,63,29,34,46.03
Renekton,Skarner,57,23,34,40.35
Renekton,DrMundo,36,24,12,66.67
Renekton,Kindred,47,29,18,61.7
Renekton,Ryze,37,20,17,54.05
Renekton,Karthus,27,13,14,48.15
Renekton,Hecarim,31,21,10,67.74
Renekton,Mordekaiser,99,55,44,55.56
Renekton,Rumble,34,12,22,35.29
Renekton,Varus,88,46,42,52.27
Renekton,TwistedFate,39,20,19,51.28
Renekton,Shyvana,20,8,12,40
Renekton,Velkoz,59,28,31,47.46
Renekton,Rengar,28,18,10,64.29
Renekton,Samira,108,51,57,47.22
Renekton,Maokai,46,19,27,41.3
Renekton,Taliyah,26,8,18,30.77
Renekton,Gwen,53,12,41,22.64
Renekton,Vex,44,17,27,38.64
Renekton,Nautilus,146,76,70,52.05
Renekton,Anivia,38,11,27,28.95
Renekton,Kassadin,31,21,10,67.74
Renekton,Kayle,59,23,36,38.98
Renekton,Fiora,31,18,13,58.06
Renekton,Jayce,47,23,24,48.94
Renekton,Orianna,32,11,21,34.38
Renekton,Rammus,42,20,22,47.62
Renekton,Ivern,30,14,16,46.67
Renekton,Brand,42,13,29,30.95
Renekton,Kled,31,13,18,41.94
Renekton,Taric,21,8,13,38.1
Renekton,AurelionSol,41,23,18,56.1
Renekton,Neeko,51,32,19,62.75
Renekton,Zilean,31,10,21,32.26
Renekton,Aphelios,57,25,32,43.86
Renekton,Singed,5,2,3,40
Renekton,Udyr,22,10,12,45.45
Renekton,KogMaw,25,7,18,28
Renekton,Tryndamere,26,13,13,50
Renekton,Sona,6,6,0,100
Qiyana,Yasuo,78,31,47,39.74
Qiyana,Shaco,35,20,15,57.14
Qiyana,Azir,10,5,5,50
Qiyana,Jhin,102,30,72,29.41
Qiyana,Sylas,89,40,49,44.94
Qiyana,Shen,18,5,13,27.78
Qiyana,Viego,80,38,42,47.5
Qiyana,Diana,68,30,38,44.12
Qiyana,Corki,43,29,14,67.44
Qiyana,TahmKench,34,18,16,52.94
Qiyana,Sett,79,22,57,27.85
Qiyana,JarvanIV,25,13,12,52
Qiyana,Veigar,34,15,19,44.12
Qiyana,Lux,104,51,53,49.04
Qiyana,Thresh,85,35,50,41.18
Qiyana,Kled,6,0,6,0
Qiyana,Gragas,42,15,27,35.71
Qiyana,Anivia,20,5,15,25
Qiyana,Jinx,122,62,60,50.82
Qiyana,Rell,27,14,13,51.85
Qiyana,Darius,80,28,52,35
Qiyana,Vi,58,32,26,55.17
Qiyana,Soraka,32,19,13,59.38
Qiyana,Pantheon,70,41,29,58.57
Qiyana,Kaisa,93,43,50,46.24
Qiyana,Pyke,31,17,14,54.84
Qiyana,Gnar,26,3,23,11.54
Qiyana,Graves,28,9,19,32.14
Qiyana,Aurora,43,20,23,46.51
Qiyana,Ezreal,146,73,73,50
Qiyana,Karma,56,32,24,57.14
Qiyana,Gangplank,22,12,10,54.55
Qiyana,Warwick,66,34,32,51.52
Qiyana,Zed,60,27,33,45
Qiyana,Zeri,29,11,18,37.93
Qiyana,Lulu,56,31,25,55.36
Qiyana,Chogath,78,33,45,42.31
Qiyana,Sejuani,44,20,24,45.45
Qiyana,Vex,51,17,34,33.33
Qiyana,Mel,93,36,57,38.71
Qiyana,Seraphine,40,11,29,27.5
Qiyana,Ornn,24,11,13,45.83
Qiyana,Sion,49,25,24,51.02
Qiyana,MasterYi,58,22,36,37.93
Qiyana,Ahri,57,27,30,47.37
Qiyana,Renekton,15,9,6,60
Qiyana,KogMaw,11,6,5,54.55
Qiyana,Yuumi,41,18,23,43.9
Qiyana,Tryndamere,16,9,7,56.25
Qiyana,Varus,42,23,19,54.76
Qiyana,Senna,41,21,20,51.22
Qiyana,Rumble,9,0,9,0
Qiyana,Kayn,48,27,21,56.25
Qiyana,Zyra,25,8,17,32
Qiyana,Urgot,32,12,20,37.5
Qiyana,Morgana,52,26,26,50
Qiyana,Caitlyn,96,60,36,62.5
Qiyana,Malzahar,41,20,21,48.78
Qiyana,Ivern,17,15,2,88.24
Qiyana,AurelionSol,18,11,7,61.11
Qiyana,Mordekaiser,45,14,31,31.11
Qiyana,Akali,43,25,18,58.14
Qiyana,Hwei,21,6,15,28.57
Qiyana,Nami,38,19,19,50
Qiyana,Yorick,42,13,29,30.95
Qiyana,Kindred,20,4,16,20
Qiyana,Ekko,41,21,20,51.22
Qiyana,Vayne,46,23,23,50
Qiyana,Milio,35,16,19,45.71
Qiyana,Malphite,61,24,37,39.34
Qiyana,Twitch,37,12,25,32.43
Qiyana,Poppy,21,18,3,85.71
Qiyana,Nidalee,27,11,16,40.74
Qiyana,Volibear,52,31,21,59.62
Qiyana,Ryze,29,20,9,68.97
Qiyana,Ashe,60,35,25,58.33
Qiyana,Leona,50,18,32,36
Qiyana,Briar,22,7,15,31.82
Qiyana,Yone,94,48,46,51.06
Qiyana,Fiora,29,5,24,17.24
Qiyana,Khazix,16,7,9,43.75
Qiyana,Katarina,34,21,13,61.76
Qiyana,Draven,28,11,17,39.29
Qiyana,MonkeyKing,22,4,18,18.18
Qiyana,Lissandra,30,17,13,56.67
Qiyana,Bard,14,5,9,35.71
Qiyana,LeeSin,75,43,32,57.33
Qiyana,Nautilus,58,22,36,37.93
Qiyana,Orianna,26,12,14,46.15
Qiyana,Jax,32,24,8,75
Qiyana,Maokai,30,14,16,46.67
Qiyana,Heimerdinger,22,11,11,50
Qiyana,Janna,8,3,5,37.5
Qiyana,Aatrox,55,19,36,34.55
Qiyana,Syndra,35,15,20,42.86
Qiyana,MissFortune,84,27,57,32.14
Qiyana,Riven,16,8,8,50
Qiyana,Udyr,16,11,5,68.75
Qiyana,Nilah,9,6,3,66.67
Qiyana,Taric,7,5,2,71.43
Qiyana,Camille,23,23,0,100
Qiyana,Amumu,57,31,26,54.39
Qiyana,FiddleSticks,24,8,16,33.33
Qiyana,Fizz,23,11,12,47.83
Qiyana,Blitzcrank,46,23,23,50
Qiyana,Swain,41,18,23,43.9
Qiyana,Trundle,16,4,12,25
Qiyana,Brand,36,15,21,41.67
Qiyana,Rammus,19,11,8,57.89
Qiyana,XinZhao,29,11,18,37.93
Qiyana,Vladimir,23,10,13,43.48
Qiyana,Rakan,31,12,19,38.71
Qiyana,Lucian,37,22,15,59.46
Qiyana,Braum,27,10,17,37.04
Qiyana,Kennen,16,11,5,68.75
Qiyana,Kassadin,6,3,3,50
Qiyana,Tristana,27,15,12,55.56
Qiyana,Alistar,17,8,9,47.06
Qiyana,Aphelios,23,3,20,13.04
Qiyana,Shyvana,10,3,7,30
Qiyana,Hecarim,7,2,5,28.57
Qiyana,Teemo,56,31,25,55.36
Qiyana,Nunu,27,11,16,40.74
Qiyana,Karthus,9,5,4,55.56
Qiyana,Nocturne,41,28,13,68.29
Qiyana,DrMundo,24,9,15,37.5
Qiyana,Sivir,14,9,5,64.29
Qiyana,Samira,37,27,10,72.97
Qiyana,Elise,26,9,17,34.62
Qiyana,Ambessa,27,8,19,29.63
Qiyana,Belveth,5,0,5,0
Qiyana,Zoe,20,6,14,30
Qiyana,Nasus,15,8,7,53.33
Qiyana,Skarner,15,8,7,53.33
Qiyana,Garen,44,31,13,70.45
Qiyana,Renata,13,8,5,61.54
Qiyana,Naafiri,10,5,5,50
Qiyana,Lillia,12,4,8,33.33
Qiyana,Cassiopeia,8,3,5,37.5
Qiyana,Galio,58,16,42,27.59
Qiyana,Rengar,13,2,11,15.38
Qiyana,Smolder,24,11,13,45.83
Qiyana,Kayle,22,7,15,31.82
Qiyana,Kalista,12,5,7,41.67
Qiyana,Evelynn,9,5,4,55.56
Qiyana,Xayah,18,7,11,38.89
Qiyana,Xerath,41,25,16,60.98
Qiyana,Zac,25,11,14,44
Qiyana,Quinn,11,5,6,45.45
Qiyana,Irelia,14,6,8,42.86
Qiyana,Ziggs,22,10,12,45.45
Qiyana,Velkoz,19,6,13,31.58
Qiyana,Neeko,26,15,11,57.69
Qiyana,Gwen,14,14,0,100
Qiyana,Viktor,29,26,3,89.66
Qiyana,Olaf,10,2,8,20
Qiyana,Leblanc,17,9,8,52.94
Qiyana,Taliyah,11,8,3,72.73
Qiyana,KSante,18,5,13,27.78
Qiyana,Akshan,13,6,7,46.15
Qiyana,TwistedFate,16,8,8,50
Qiyana,Talon,14,8,6,57.14
Qiyana,Illaoi,12,12,0,100
Qiyana,Jayce,11,5,6,45.45
Qiyana,Zilean,9,6,3,66.67
Qiyana,Annie,6,0,6,0
Qiyana,RekSai,6,3,3,50
Qiyana,Sona,3,3,0,100
Qiyana,Singed,6,3,3,50
Fiora,Garen,99,45,54,45.45
Fiora,Zed,62,43,19,69.35
Fiora,Mel,159,70,89,44.03
Fiora,Caitlyn,180,98,82,54.44
Fiora,Morgana,57,26,31,45.61
Fiora,Shen,61,33,28,54.1
Fiora,MasterYi,47,28,19,59.57
Fiora,Katarina,59,29,30,49.15
Fiora,Jhin,171,79,92,46.2
Fiora,Karma,91,46,45,50.55
Fiora,KSante,88,37,51,42.05
Fiora,Lillia,34,23,11,67.65
Fiora,Diana,100,51,49,51
Fiora,Twitch,51,25,26,49.02
Fiora,Bard,11,9,2,81.82
Fiora,Riven,53,16,37,30.19
Fiora,Zoe,29,21,8,72.41
Fiora,Ezreal,171,107,64,62.57
Fiora,Nautilus,108,44,64,40.74
Fiora,Irelia,53,21,32,39.62
Fiora,Rammus,38,21,17,55.26
Fiora,Mordekaiser,127,56,71,44.09
Fiora,KogMaw,29,14,15,48.28
Fiora,Lux,174,97,77,55.75
Fiora,Ornn,66,33,33,50
Fiora,Sejuani,42,12,30,28.57
Fiora,Lissandra,32,10,22,31.25
Fiora,Ashe,126,53,73,42.06
Fiora,Braum,57,25,32,43.86
Fiora,Poppy,68,37,31,54.41
Fiora,Rengar,29,19,10,65.52
Fiora,Heimerdinger,32,24,8,75
Fiora,Vi,101,66,35,65.35
Fiora,Amumu,80,40,40,50
Fiora,Aurora,53,33,20,62.26
Fiora,Draven,52,33,19,63.46
Fiora,Thresh,89,42,47,47.19
Fiora,Gnar,31,20,11,64.52
Fiora,Talon,48,24,24,50
Fiora,Veigar,48,26,22,54.17
Fiora,Brand,18,10,8,55.56
Fiora,Darius,114,59,55,51.75
Fiora,Volibear,66,30,36,45.45
Fiora,Yasuo,145,63,82,43.45
Fiora,Warwick,63,33,30,52.38
Fiora,AurelionSol,31,16,15,51.61
Fiora,Sett,89,39,50,43.82
Fiora,Jax,82,33,49,40.24
Fiora,Swain,89,31,58,34.83
Fiora,Zyra,58,37,21,63.79
Fiora,LeeSin,127,59,68,46.46
Fiora,Azir,25,15,10,60
Fiora,XinZhao,51,33,18,64.71
Fiora,Kayn,81,34,47,41.98
Fiora,MissFortune,124,70,54,56.45
Fiora,Nami,71,31,40,43.66
Fiora,Kayle,46,20,26,43.48
Fiora,Karthus,14,3,11,21.43
Fiora,Pantheon,113,53,60,46.9
Fiora,Khazix,41,17,24,41.46
Fiora,Qiyana,29,24,5,82.76
Fiora,Xayah,41,27,14,65.85
Fiora,Neeko,39,20,19,51.28
Fiora,TahmKench,89,41,48,46.07
Fiora,DrMundo,43,13,30,30.23
Fiora,Anivia,16,5,11,31.25
Fiora,Vayne,63,26,37,41.27
Fiora,Aatrox,72,29,43,40.28
Fiora,Shyvana,8,6,2,75
Fiora,Syndra,52,29,23,55.77
Fiora,Milio,42,17,25,40.48
Fiora,Chogath,153,93,60,60.78
Fiora,Taric,28,14,14,50
Fiora,Teemo,37,12,25,32.43
Fiora,Sylas,92,55,37,59.78
Fiora,Jinx,207,105,102,50.72
Fiora,Yorick,53,29,24,54.72
Fiora,Orianna,30,9,21,30
Fiora,Blitzcrank,61,31,30,50.82
Fiora,Jayce,62,23,39,37.1
Fiora,Kaisa,121,55,66,45.45
Fiora,Briar,32,16,16,50
Fiora,Malphite,72,26,46,36.11
Fiora,Pyke,59,24,35,40.68
Fiora,Nasus,50,27,23,54
Fiora,Ekko,89,56,33,62.92
Fiora,Quinn,20,5,15,25
Fiora,Evelynn,35,10,25,28.57
Fiora,Malzahar,68,31,37,45.59
Fiora,Janna,10,5,5,50
Fiora,Gwen,55,24,31,43.64
Fiora,Skarner,46,30,16,65.22
Fiora,Ziggs,17,14,3,82.35
Fiora,Elise,102,67,35,65.69
Fiora,Ahri,90,42,48,46.67
Fiora,Sivir,41,25,16,60.98
Fiora,Gragas,51,31,20,60.78
Fiora,Lucian,55,26,29,47.27
Fiora,Seraphine,69,37,32,53.62
Fiora,Viego,84,41,43,48.81
Fiora,MonkeyKing,37,23,14,62.16
Fiora,Aphelios,40,24,16,60
Fiora,Lulu,117,59,58,50.43
Fiora,Shaco,59,30,29,50.85
Fiora,Viktor,63,41,22,65.08
Fiora,Leona,72,47,25,65.28
Fiora,Hwei,46,26,20,56.52
Fiora,Kalista,29,11,18,37.93
Fiora,Vladimir,42,17,25,40.48
Fiora,Galio,88,36,52,40.91
Fiora,Nocturne,60,27,33,45
Fiora,Yuumi,42,16,26,38.1
Fiora,Kassadin,11,6,5,54.55
Fiora,Nunu,42,22,20,52.38
Fiora,Zeri,56,19,37,33.93
Fiora,Yone,121,74,47,61.16
Fiora,Leblanc,35,31,4,88.57
Fiora,Zac,51,18,33,35.29
Fiora,Xerath,69,28,41,40.58
Fiora,Akshan,32,10,22,31.25
Fiora,Rell,43,28,15,65.12
Fiora,JarvanIV,61,25,36,40.98
Fiora,Vex,36,16,20,44.44
Fiora,Kled,7,7,0,100
Fiora,Varus,65,33,32,50.77
Fiora,Velkoz,35,13,22,37.14
Fiora,Rumble,31,21,10,67.74
Fiora,RekSai,13,11,2,84.62
Fiora,Samira,65,35,30,53.85
Fiora,Ivern,12,2,10,16.67
Fiora,Soraka,28,15,13,53.57
Fiora,Singed,16,5,11,31.25
Fiora,Cassiopeia,10,2,8,20
Fiora,Illaoi,34,26,8,76.47
Fiora,Naafiri,28,23,5,82.14
Fiora,Rakan,42,29,13,69.05
Fiora,Hecarim,31,25,6,80.65
Fiora,Smolder,49,10,39,20.41
Fiora,Nilah,37,27,10,72.97
Fiora,Urgot,25,2,23,8
Fiora,Corki,31,9,22,29.03
Fiora,Sion,56,30,26,53.57
Fiora,Sona,14,11,3,78.57
Fiora,Ambessa,60,32,28,53.33
Fiora,Annie,15,8,7,53.33
Fiora,Tryndamere,26,13,13,50
Fiora,Taliyah,33,12,21,36.36
Fiora,Tristana,63,34,29,53.97
Fiora,Zilean,22,9,13,40.91
Fiora,Fizz,39,26,13,66.67
Fiora,Udyr,28,14,14,50
Fiora,Alistar,43,23,20,53.49
Fiora,Renekton,31,13,18,41.94
Fiora,Ryze,37,21,16,56.76
Fiora,Nidalee,24,14,10,58.33
Fiora,FiddleSticks,39,11,28,28.21
Fiora,Camille,56,27,29,48.21
Fiora,Kindred,44,18,26,40.91
Fiora,TwistedFate,23,10,13,43.48
Fiora,Akali,54,15,39,27.78
Fiora,Senna,48,27,21,56.25
Fiora,Olaf,16,6,10,37.5
Fiora,Kennen,17,12,5,70.59
Fiora,Trundle,27,7,20,25.93
Fiora,Graves,24,10,14,41.67
Fiora,Maokai,38,24,14,63.16
Fiora,Renata,11,5,6,45.45
Fiora,Belveth,16,6,10,37.5
Fiora,Gangplank,28,16,12,57.14
Nilah,Garen,113,55,58,48.67
Nilah,Zed,71,46,25,64.79
Nilah,Mel,115,84,31,73.04
Nilah,Caitlyn,159,100,59,62.89
Nilah,Morgana,99,59,40,59.6
Nilah,Quinn,22,15,7,68.18
Nilah,Sejuani,44,25,19,56.82
Nilah,Leblanc,13,8,5,61.54
Nilah,Twitch,46,21,25,45.65
Nilah,Nautilus,104,48,56,46.15
Nilah,Rell,59,27,32,45.76
Nilah,Rengar,35,24,11,68.57
Nilah,Sett,109,68,41,62.39
Nilah,Varus,75,36,39,48
Nilah,Mordekaiser,100,46,54,46
Nilah,Diana,84,42,42,50
Nilah,Yone,96,45,51,46.88
Nilah,Xerath,42,14,28,33.33
Nilah,Poppy,53,20,33,37.74
Nilah,FiddleSticks,12,3,9,25
Nilah,Lux,179,95,84,53.07
Nilah,Ashe,131,72,59,54.96
Nilah,Braum,43,28,15,65.12
Nilah,Darius,127,74,53,58.27
Nilah,Shaco,63,35,28,55.56
Nilah,Ekko,48,31,17,64.58
Nilah,Kaisa,136,86,50,63.24
Nilah,Neeko,40,28,12,70
Nilah,Warwick,102,52,50,50.98
Nilah,Viego,100,53,47,53
Nilah,Ahri,74,42,32,56.76
Nilah,Jinx,167,90,77,53.89
Nilah,Hwei,40,23,17,57.5
Nilah,Ziggs,31,9,22,29.03
Nilah,KSante,60,24,36,40
Nilah,Malzahar,92,47,45,51.09
Nilah,Senna,44,21,23,47.73
Nilah,Kennen,16,11,5,68.75
Nilah,Volibear,87,45,42,51.72
Nilah,Lulu,83,28,55,33.73
Nilah,Irelia,41,21,20,51.22
Nilah,Rammus,21,12,9,57.14
Nilah,KogMaw,24,12,12,50
Nilah,Nasus,51,34,17,66.67
Nilah,Amumu,84,44,40,52.38
Nilah,MissFortune,149,70,79,46.98
Nilah,Vex,43,18,25,41.86
Nilah,Sion,48,23,25,47.92
Nilah,JarvanIV,60,26,34,43.33
Nilah,Nunu,47,22,25,46.81
Nilah,Brand,55,19,36,34.55
Nilah,Gragas,59,40,19,67.8
Nilah,LeeSin,108,61,47,56.48
Nilah,TwistedFate,32,16,16,50
Nilah,Tristana,60,30,30,50
Nilah,Pyke,78,35,43,44.87
Nilah,Lillia,39,16,23,41.03
Nilah,Katarina,54,36,18,66.67
Nilah,Samira,110,62,48,56.36
Nilah,Zilean,20,7,13,35
Nilah,Kled,16,5,11,31.25
Nilah,Kayn,87,35,52,40.23
Nilah,Veigar,57,26,31,45.61
Nilah,Vayne,75,31,44,41.33
Nilah,Olaf,20,6,14,30
Nilah,Malphite,82,34,48,41.46
Nilah,MasterYi,49,34,15,69.39
Nilah,Chogath,103,49,54,47.57
Nilah,Cassiopeia,48,24,24,50
Nilah,XinZhao,45,23,22,51.11
Nilah,Hecarim,13,3,10,23.08
Nilah,Lissandra,39,15,24,38.46
Nilah,Vladimir,37,21,16,56.76
Nilah,Zeri,38,17,21,44.74
Nilah,Renekton,43,17,26,39.53
Nilah,Skarner,40,29,11,72.5
Nilah,Jayce,36,19,17,52.78
Nilah,Aatrox,50,36,14,72
Nilah,Yasuo,155,93,62,60
Nilah,Aphelios,52,33,19,63.46
Nilah,Rakan,29,7,22,24.14
Nilah,Elise,75,40,35,53.33
Nilah,Sona,17,11,6,64.71
Nilah,Trundle,49,23,26,46.94
Nilah,Akshan,26,15,11,57.69
Nilah,Alistar,36,19,17,52.78
Nilah,Nidalee,22,11,11,50
Nilah,Syndra,52,32,20,61.54
Nilah,Pantheon,114,60,54,52.63
Nilah,Ezreal,128,66,62,51.56
Nilah,Leona,93,68,25,73.12
Nilah,Yorick,47,30,17,63.83
Nilah,Gnar,37,26,11,70.27
Nilah,Ambessa,55,33,22,60
Nilah,Akali,83,38,45,45.78
Nilah,Gwen,26,10,16,38.46
Nilah,Sylas,98,70,28,71.43
Nilah,Ryze,21,9,12,42.86
Nilah,Yuumi,55,37,18,67.27
Nilah,Vi,54,28,26,51.85
Nilah,Karma,68,45,23,66.18
Nilah,Jax,51,21,30,41.18
Nilah,Karthus,26,16,10,61.54
Nilah,Evelynn,17,9,8,52.94
Nilah,Kindred,33,15,18,45.45
Nilah,TahmKench,62,39,23,62.9
Nilah,Soraka,21,13,8,61.9
Nilah,MonkeyKing,57,31,26,54.39
Nilah,Galio,95,43,52,45.26
Nilah,Taliyah,28,9,19,32.14
Nilah,Qiyana,9,3,6,33.33
Nilah,Lucian,45,29,16,64.44
Nilah,Sivir,13,7,6,53.85
Nilah,Nocturne,89,50,39,56.18
Nilah,Zyra,46,15,31,32.61
Nilah,Briar,39,5,34,12.82
Nilah,Swain,72,30,42,41.67
Nilah,Zac,43,20,23,46.51
Nilah,Annie,23,7,16,30.43
Nilah,Velkoz,43,25,18,58.14
Nilah,Orianna,32,18,14,56.25
Nilah,Nami,78,52,26,66.67
Nilah,Draven,31,12,19,38.71
Nilah,Jhin,138,71,67,51.45
Nilah,Smolder,53,29,24,54.72
Nilah,Talon,51,28,23,54.9
Nilah,Singed,21,4,17,19.05
Nilah,Xayah,76,34,42,44.74
Nilah,Shen,49,32,17,65.31
Nilah,DrMundo,33,18,15,54.55
Nilah,Zoe,25,15,10,60
Nilah,Blitzcrank,51,32,19,62.75
Nilah,Gangplank,19,8,11,42.11
Nilah,Teemo,65,25,40,38.46
Nilah,Renata,28,14,14,50
Nilah,Fiora,37,10,27,27.03
Nilah,Heimerdinger,20,10,10,50
Nilah,Thresh,105,41,64,39.05
Nilah,Bard,26,11,15,42.31
Nilah,Camille,43,28,15,65.12
Nilah,Aurora,55,22,33,40
Nilah,Khazix,38,19,19,50
Nilah,Urgot,40,19,21,47.5
Nilah,Ornn,29,12,17,41.38
Nilah,Milio,31,15,16,48.39
Nilah,Azir,31,13,18,41.94
Nilah,Seraphine,59,28,31,47.46
Nilah,Maokai,33,25,8,75.76
Nilah,Fizz,15,9,6,60
Nilah,Shyvana,7,0,7,0
Nilah,Janna,21,12,9,57.14
Nilah,Kassadin,11,3,8,27.27
Nilah,Kalista,19,15,4,78.95
Nilah,Graves,44,28,16,63.64
Nilah,Viktor,61,38,23,62.3
Nilah,Naafiri,24,11,13,45.83
Nilah,Illaoi,31,13,18,41.94
Nilah,Anivia,20,11,9,55
Nilah,AurelionSol,34,20,14,58.82
Nilah,Kayle,32,19,13,59.38
Nilah,Belveth,14,6,8,42.86
Nilah,RekSai,16,5,11,31.25
Nilah,Riven,18,11,7,61.11
Nilah,Corki,15,10,5,66.67
Nilah,Tryndamere,32,14,18,43.75
Nilah,Udyr,14,11,3,78.57
Nilah,Rumble,6,3,3,50
Nilah,Ivern,8,6,2,75
Nilah,Taric,12,6,6,50
Leona,Garen,306,153,153,50
Leona,Zed,210,115,95,54.76
Leona,Mel,476,269,207,56.51
Leona,Caitlyn,495,237,258,47.88
Leona,Morgana,260,96,164,36.92
Leona,Kled,40,20,20,50
Leona,Kayn,259,126,133,48.65
Leona,Katarina,103,51,52,49.51
Leona,Twitch,136,85,51,62.5
Leona,Thresh,468,221,247,47.22
Leona,Gnar,142,76,66,53.52
Leona,Hecarim,70,34,36,48.57
Leona,Viktor,158,59,99,37.34
Leona,MissFortune,396,209,187,52.78
Leona,Rell,178,96,82,53.93
Leona,Illaoi,96,52,44,54.17
Leona,Briar,130,68,62,52.31
Leona,Taliyah,66,31,35,46.97
Leona,Yone,399,223,176,55.89
Leona,Diana,275,111,164,40.36
Leona,Gragas,147,68,79,46.26
Leona,Yasuo,391,215,176,54.99
Leona,Nami,178,82,96,46.07
Leona,Vladimir,107,49,58,45.79
Leona,Ashe,412,220,192,53.4
Leona,Lux,460,213,247,46.3
Leona,Amumu,241,121,120,50.21
Leona,Nocturne,242,117,125,48.35
Leona,Galio,272,136,136,50
Leona,Senna,114,73,41,64.04
Leona,Gwen,115,51,64,44.35
Leona,Aurora,166,93,73,56.02
Leona,Jinx,490,195,295,39.8
Leona,Soraka,98,52,46,53.06
Leona,Tristana,203,100,103,49.26
Leona,MasterYi,221,123,98,55.66
Leona,Akshan,65,30,35,46.15
Leona,Zeri,116,54,62,46.55
Leona,Rakan,102,52,50,50.98
Leona,Sett,311,138,173,44.37
Leona,Graves,113,49,64,43.36
Leona,Hwei,147,74,73,50.34
Leona,TahmKench,210,102,108,48.57
Leona,Warwick,320,157,163,49.06
Leona,Viego,244,124,120,50.82
Leona,Ahri,302,147,155,48.68
Leona,Shen,172,88,84,51.16
Leona,Sejuani,138,73,65,52.9
Leona,Varus,218,112,106,51.38
Leona,Anivia,67,30,37,44.78
Leona,Nunu,168,101,67,60.12
Leona,Darius,364,182,182,50
Leona,Malphite,254,128,126,50.39
Leona,Kindred,106,68,38,64.15
Leona,Gangplank,93,45,48,48.39
Leona,Vi,248,96,152,38.71
Leona,Sylas,354,168,186,47.46
Leona,Ezreal,526,275,251,52.28
Leona,Braum,196,95,101,48.47
Leona,Trundle,103,44,59,42.72
Leona,Pantheon,301,158,143,52.49
Leona,Kaisa,320,170,150,53.13
Leona,Janna,92,49,43,53.26
Leona,LeeSin,435,235,200,54.02
Leona,Quinn,45,27,18,60
Leona,Naafiri,64,41,23,64.06
Leona,Lulu,253,126,127,49.8
Leona,Blitzcrank,254,121,133,47.64
Leona,Vayne,285,122,163,42.81
Leona,Karma,195,98,97,50.26
Leona,Irelia,135,59,76,43.7
Leona,Alistar,129,63,66,48.84
Leona,Yorick,202,80,122,39.6
Leona,XinZhao,117,53,64,45.3
Leona,Renekton,107,49,58,45.79
Leona,MonkeyKing,172,82,90,47.67
Leona,Seraphine,138,72,66,52.17
Leona,Yuumi,142,84,58,59.15
Leona,Brand,119,51,68,42.86
Leona,Akali,176,99,77,56.25
Leona,Volibear,213,89,124,41.78
Leona,Ekko,206,116,90,56.31
Leona,Lucian,154,92,62,59.74
Leona,Jax,164,68,96,41.46
Leona,Olaf,63,24,39,38.1
Leona,Shaco,162,75,87,46.3
Leona,Ambessa,170,74,96,43.53
Leona,Tryndamere,71,35,36,49.3
Leona,Nidalee,53,30,23,56.6
Leona,Vex,103,61,42,59.22
Leona,Sivir,123,45,78,36.59
Leona,RekSai,31,16,15,51.61
Leona,Veigar,204,103,101,50.49
Leona,Milio,104,40,64,38.46
Leona,Camille,59,30,29,50.85
Leona,Heimerdinger,113,46,67,40.71
Leona,Swain,211,78,133,36.97
Leona,Samira,156,69,87,44.23
Leona,Zyra,129,58,71,44.96
Leona,Malzahar,207,102,105,49.28
Leona,Smolder,137,75,62,54.74
Leona,Zac,126,66,60,52.38
Leona,Azir,86,47,39,54.65
Leona,Rammus,70,39,31,55.71
Leona,Xerath,151,78,73,51.66
Leona,Poppy,176,101,75,57.39
Leona,Mordekaiser,223,117,106,52.47
Leona,Sion,183,100,83,54.64
Leona,Teemo,187,90,97,48.13
Leona,Lissandra,88,36,52,40.91
Leona,Nasus,125,49,76,39.2
Leona,Zoe,88,40,48,45.45
Leona,Xayah,116,53,63,45.69
Leona,Talon,82,39,43,47.56
Leona,Taric,63,31,32,49.21
Leona,Chogath,261,129,132,49.43
Leona,Khazix,90,48,42,53.33
Leona,Qiyana,50,32,18,64
Leona,Neeko,109,51,58,46.79
Leona,Syndra,120,71,49,59.17
Leona,Aatrox,219,124,95,56.62
Leona,JarvanIV,155,82,73,52.9
Leona,Corki,88,54,34,61.36
Leona,Nilah,93,25,68,26.88
Leona,Pyke,172,97,75,56.4
Leona,Kayle,103,48,55,46.6
Leona,Draven,107,53,54,49.53
Leona,Elise,158,64,94,40.51
Leona,Velkoz,107,55,52,51.4
Leona,Nautilus,355,170,185,47.89
Leona,Jhin,359,189,170,52.65
Leona,Ornn,115,59,56,51.3
Leona,Kalista,71,39,32,54.93
Leona,KogMaw,70,38,32,54.29
Leona,Ziggs,81,53,28,65.43
Leona,Orianna,113,53,60,46.9
Leona,Zilean,65,32,33,49.23
Leona,Karthus,58,33,25,56.9
Leona,Fiora,72,25,47,34.72
Leona,FiddleSticks,70,36,34,51.43
Leona,Fizz,100,47,53,47
Leona,Skarner,76,43,33,56.58
Leona,Bard,51,38,13,74.51
Leona,Sona,31,18,13,58.06
Leona,Riven,65,30,35,46.15
Leona,Annie,71,30,41,42.25
Leona,AurelionSol,85,40,45,47.06
Leona,Leblanc,82,34,48,41.46
Leona,Jayce,71,35,36,49.3
Leona,Rengar,48,29,19,60.42
Leona,Ryze,78,31,47,39.74
Leona,Belveth,56,27,29,48.21
Leona,Urgot,102,52,50,50.98
Leona,Singed,40,16,24,40
Leona,Shyvana,53,30,23,56.6
Leona,Aphelios,125,49,76,39.2
Leona,Renata,52,16,36,30.77
Leona,Udyr,57,25,32,43.86
Leona,KSante,145,77,68,53.1
Leona,Kennen,63,29,34,46.03
Leona,Ivern,44,25,19,56.82
Leona,Maokai,116,73,43,62.93
Leona,DrMundo,93,46,47,49.46
Leona,Lillia,101,48,53,47.52
Leona,Evelynn,37,23,14,62.16
Leona,TwistedFate,74,27,47,36.49
Leona,Kassadin,51,25,26,49.02
Leona,Rumble,53,28,25,52.83
Leona,Cassiopeia,54,31,23,57.41
Garen,Fiora,99,54,45,54.55
Garen,Teemo,318,157,161,49.37
Garen,Diana,409,205,204,50.12
Garen,Nilah,113,58,55,51.33
Garen,Leona,306,153,153,50
Garen,Riven,154,90,64,58.44
Garen,Poppy,180,95,85,52.78
Garen,Veigar,375,179,196,47.73
Garen,Ziggs,102,65,37,63.73
Garen,Yuumi,242,112,130,46.28
Garen,Yorick,249,112,137,44.98
Garen,Warwick,424,219,205,51.65
Garen,Akali,300,170,130,56.67
Garen,Jhin,557,313,244,56.19
Garen,Braum,273,157,116,57.51
Garen,Quinn,104,47,57,45.19
Garen,Sejuani,207,105,102,50.72
Garen,Leblanc,167,84,83,50.3
Garen,Twitch,223,116,107,52.02
Garen,Nautilus,423,186,237,43.97
Garen,Nasus,263,141,122,53.61
Garen,Malzahar,338,189,149,55.92
Garen,TwistedFate,97,63,34,64.95
Garen,Seraphine,232,128,104,55.17
Garen,Olaf,68,39,29,57.35
Garen,Viego,368,197,171,53.53
Garen,Ryze,106,58,48,54.72
Garen,Soraka,127,72,55,56.69
Garen,Ornn,182,75,107,41.21
Garen,Kindred,145,71,74,48.97
Garen,Talon,144,91,53,63.19
Garen,Samira,208,116,92,55.77
Garen,Ashe,569,309,260,54.31
Garen,Darius,581,283,298,48.71
Garen,Tristana,315,156,159,49.52
Garen,Neeko,140,88,52,62.86
Garen,Aurora,244,130,114,53.28
Garen,Amumu,342,166,176,48.54
Garen,MissFortune,566,291,275,51.41
Garen,Rakan,213,118,95,55.4
Garen,Mordekaiser,449,228,221,50.78
Garen,Hecarim,81,40,41,49.38
Garen,Sett,509,259,250,50.88
Garen,Xayah,211,101,110,47.87
Garen,Lulu,384,198,186,51.56
Garen,Corki,151,77,74,50.99
Garen,Briar,159,90,69,56.6
Garen,Mel,595,316,279,53.11
Garen,Jax,370,225,145,60.81
Garen,Yasuo,628,343,285,54.62
Garen,Chogath,452,228,224,50.44
Garen,Ekko,273,164,109,60.07
Garen,Azir,108,49,59,45.37
Garen,Jinx,742,357,385,48.11
Garen,Nami,356,204,152,57.3
Garen,Aatrox,307,175,132,57
Garen,Annie,78,45,33,57.69
Garen,Illaoi,186,98,88,52.69
Garen,Renekton,192,90,102,46.88
Garen,LeeSin,486,259,227,53.29
Garen,Viktor,318,169,149,53.14
Garen,Hwei,203,111,92,54.68
Garen,Kayle,238,77,161,32.35
Garen,MonkeyKing,231,125,106,54.11
Garen,Vex,198,93,105,46.97
Garen,Caitlyn,703,389,314,55.33
Garen,Irelia,175,111,64,63.43
Garen,Morgana,288,149,139,51.74
Garen,Lux,672,372,300,55.36
Garen,Kennen,67,37,30,55.22
Garen,Vayne,412,212,200,51.46
Garen,Milio,223,117,106,52.47
Garen,Jayce,126,86,40,68.25
Garen,Zed,282,155,127,54.96
Garen,Thresh,586,319,267,54.44
Garen,Sion,240,124,116,51.67
Garen,Kassadin,58,20,38,34.48
Garen,Lucian,261,139,122,53.26
Garen,Vladimir,160,87,73,54.38
Garen,Naafiri,118,61,57,51.69
Garen,Sylas,515,268,247,52.04
Garen,Evelynn,78,42,36,53.85
Garen,KogMaw,85,54,31,63.53
Garen,Tryndamere,153,71,82,46.41
Garen,Vi,346,192,154,55.49
Garen,Renata,81,37,44,45.68
Garen,Senna,164,71,93,43.29
Garen,Nocturne,422,224,198,53.08
Garen,Smolder,217,109,108,50.23
Garen,Kayn,375,192,183,51.2
Garen,Rengar,91,56,35,61.54
Garen,Brand,213,134,79,62.91
Garen,Karma,351,193,158,54.99
Garen,Shen,235,118,117,50.21
Garen,Swain,298,144,154,48.32
Garen,Katarina,219,135,84,61.64
Garen,Varus,294,153,141,52.04
Garen,Fizz,163,93,70,57.06
Garen,Shaco,202,89,113,44.06
Garen,Orianna,183,102,81,55.74
Garen,Ezreal,750,403,347,53.73
Garen,XinZhao,200,112,88,56
Garen,Pyke,228,116,112,50.88
Garen,Ahri,401,165,236,41.15
Garen,Kaisa,479,284,195,59.29
Garen,Malphite,300,168,132,56
Garen,Zyra,225,108,117,48
Garen,Blitzcrank,298,152,146,51.01
Garen,Nunu,183,109,74,59.56
Garen,MasterYi,341,181,160,53.08
Garen,Sivir,179,79,100,44.13
Garen,Trundle,168,91,77,54.17
Garen,Lillia,151,86,65,56.95
Garen,AurelionSol,119,68,51,57.14
Garen,Taliyah,77,48,29,62.34
Garen,Gragas,229,130,99,56.77
Garen,Kled,70,40,30,57.14
Garen,Urgot,164,105,59,64.02
Garen,Syndra,237,127,110,53.59
Garen,Volibear,346,171,175,49.42
Garen,RekSai,33,16,17,48.48
Garen,Alistar,186,94,92,50.54
Garen,Zeri,144,74,70,51.39
Garen,Yone,482,277,205,57.47
Garen,Belveth,48,34,14,70.83
Garen,Zac,177,92,85,51.98
Garen,Ivern,76,38,38,50
Garen,DrMundo,190,93,97,48.95
Garen,FiddleSticks,131,76,55,58.02
Garen,Draven,150,93,57,62
Garen,Pantheon,443,222,221,50.11
Garen,Ambessa,190,96,94,50.53
Garen,Gnar,166,100,66,60.24
Garen,Nidalee,114,60,54,52.63
Garen,Taric,60,29,31,48.33
Garen,Elise,225,136,89,60.44
Garen,Kalista,124,72,52,58.06
Garen,Cassiopeia,101,50,51,49.5
Garen,Xerath,237,139,98,58.65
Garen,Galio,347,168,179,48.41
Garen,JarvanIV,229,124,105,54.15
Garen,Velkoz,149,105,44,70.47
Garen,Udyr,106,62,44,58.49
Garen,Khazix,140,77,63,55
Garen,Rammus,103,50,53,48.54
Garen,Lissandra,103,48,55,46.6
Garen,Zilean,114,64,50,56.14
Garen,Sona,45,17,28,37.78
Garen,KSante,250,132,118,52.8
Garen,Zoe,95,58,37,61.05
Garen,Skarner,142,75,67,52.82
Garen,TahmKench,288,170,118,59.03
Garen,Rell,146,76,70,52.05
Garen,Singed,78,48,30,61.54
Garen,Aphelios,193,75,118,38.86
Garen,Camille,162,71,91,43.83
Garen,Shyvana,72,34,38,47.22
Garen,Heimerdinger,114,78,36,68.42
Garen,Janna,94,44,50,46.81
Garen,Gwen,144,77,67,53.47
Garen,Gangplank,136,83,53,61.03
Garen,Karthus,72,30,42,41.67
Garen,Graves,194,94,100,48.45
Garen,Maokai,135,66,69,48.89
Garen,Akshan,60,29,31,48.33
Garen,Anivia,90,41,49,45.56
Garen,Qiyana,44,13,31,29.55
Garen,Bard,112,59,53,52.68
Garen,Rumble,72,34,38,47.22
Zed,Fiora,62,19,43,30.65
Zed,Teemo,228,113,115,49.56
Zed,Diana,272,125,147,45.96
Zed,Nilah,71,25,46,35.21
Zed,Leona,210,95,115,45.24
Zed,Volibear,225,117,108,52
Zed,Elise,183,78,105,42.62
Zed,Malzahar,226,116,110,51.33
Zed,Caitlyn,515,266,249,51.65
Zed,Milio,160,69,91,43.13
Zed,Vi,224,127,97,56.7
Zed,Gragas,168,95,73,56.55
Zed,Lux,551,338,213,61.34
Zed,Akali,259,110,149,42.47
Zed,Nunu,131,67,64,51.15
Zed,Tristana,190,113,77,59.47
Zed,Nautilus,244,100,144,40.98
Zed,Leblanc,123,73,50,59.35
Zed,Kayn,276,131,145,47.46
Zed,Ashe,396,216,180,54.55
Zed,Shen,127,53,74,41.73
Zed,Karthus,43,26,17,60.47
Zed,Ekko,186,90,96,48.39
Zed,Ezreal,547,277,270,50.64
Zed,Soraka,87,47,40,54.02
Zed,Darius,348,162,186,46.55
Zed,Nocturne,232,117,115,50.43
Zed,Katarina,122,61,61,50
Zed,Lucian,176,107,69,60.8
Zed,Nami,153,71,82,46.41
Zed,Sett,304,158,146,51.97
Zed,MissFortune,378,177,201,46.83
Zed,Mordekaiser,236,121,115,51.27
Zed,Chogath,211,106,105,50.24
Zed,Naafiri,74,44,30,59.46
Zed,Yasuo,525,278,247,52.95
Zed,Yone,349,182,167,52.15
Zed,Jax,167,94,73,56.29
Zed,Irelia,156,78,78,50
Zed,Jhin,375,188,187,50.13
Zed,Yuumi,118,64,54,54.24
Zed,Amumu,241,112,129,46.47
Zed,Viktor,166,62,104,37.35
Zed,Zeri,76,43,33,56.58
Zed,Pantheon,395,173,222,43.8
Zed,DrMundo,118,47,71,39.83
Zed,MasterYi,200,97,103,48.5
Zed,Vladimir,122,49,73,40.16
Zed,Thresh,353,189,164,53.54
Zed,Jinx,442,188,254,42.53
Zed,KSante,93,44,49,47.31
Zed,Rell,138,70,68,50.72
Zed,Jayce,116,61,55,52.59
Zed,Twitch,129,53,76,41.09
Zed,Orianna,93,45,48,48.39
Zed,Lulu,311,148,163,47.59
Zed,Warwick,234,98,136,41.88
Zed,Graves,112,63,49,56.25
Zed,Azir,96,62,34,64.58
Zed,Mel,429,228,201,53.15
Zed,Garen,282,127,155,45.04
Zed,Ahri,260,141,119,54.23
Zed,Kaisa,344,158,186,45.93
Zed,Shaco,160,68,92,42.5
Zed,Rammus,87,58,29,66.67
Zed,Zyra,160,77,83,48.13
Zed,Zac,93,51,42,54.84
Zed,Morgana,182,77,105,42.31
Zed,Camille,84,36,48,42.86
Zed,Udyr,68,51,17,75
Zed,TahmKench,180,65,115,36.11
Zed,Gnar,131,62,69,47.33
Zed,Yorick,178,91,87,51.12
Zed,Aurora,172,107,65,62.21
Zed,Riven,98,43,55,43.88
Zed,Qiyana,60,33,27,55
Zed,Briar,148,78,70,52.7
Zed,Hwei,147,92,55,62.59
Zed,Kassadin,20,12,8,60
Zed,Blitzcrank,221,135,86,61.09
Zed,Varus,169,86,83,50.89
Zed,Braum,134,53,81,39.55
Zed,Sylas,275,141,134,51.27
Zed,KogMaw,69,35,34,50.72
Zed,Senna,103,42,61,40.78
Zed,Rumble,70,39,31,55.71
Zed,Xerath,176,87,89,49.43
Zed,Malphite,272,139,133,51.1
Zed,Talon,117,58,59,49.57
Zed,Renata,54,19,35,35.19
Zed,Lissandra,119,40,79,33.61
Zed,Aatrox,206,114,92,55.34
Zed,Xayah,149,83,66,55.7
Zed,Pyke,176,110,66,62.5
Zed,Vayne,218,97,121,44.5
Zed,Gangplank,90,59,31,65.56
Zed,Samira,147,72,75,48.98
Zed,Ambessa,153,78,75,50.98
Zed,Illaoi,126,84,42,66.67
Zed,Heimerdinger,81,48,33,59.26
Zed,MonkeyKing,142,57,85,40.14
Zed,Rakan,113,56,57,49.56
Zed,Aphelios,121,63,58,52.07
Zed,Nasus,145,53,92,36.55
Zed,FiddleSticks,79,30,49,37.97
Zed,Seraphine,160,78,82,48.75
Zed,Brand,122,82,40,67.21
Zed,Veigar,202,106,96,52.48
Zed,Taric,43,21,22,48.84
Zed,Ornn,133,68,65,51.13
Zed,Cassiopeia,55,17,38,30.91
Zed,Nidalee,68,19,49,27.94
Zed,Neeko,112,57,55,50.89
Zed,Ryze,70,49,21,70
Zed,Ziggs,76,31,45,40.79
Zed,JarvanIV,137,66,71,48.18
Zed,Karma,272,139,133,51.1
Zed,Evelynn,49,25,24,51.02
Zed,TwistedFate,68,27,41,39.71
Zed,Poppy,106,51,55,48.11
Zed,Velkoz,132,80,52,60.61
Zed,Zilean,66,36,30,54.55
Zed,RekSai,36,28,8,77.78
Zed,LeeSin,341,171,170,50.15
Zed,Taliyah,40,20,20,50
Zed,Annie,70,18,52,25.71
Zed,Trundle,100,49,51,49
Zed,Sona,46,21,25,45.65
Zed,AurelionSol,74,37,37,50
Zed,Skarner,120,65,55,54.17
Zed,Sivir,86,33,53,38.37
Zed,XinZhao,131,65,66,49.62
Zed,Akshan,73,45,28,61.64
Zed,Kindred,87,69,18,79.31
Zed,Viego,317,170,147,53.63
Zed,Draven,86,40,46,46.51
Zed,Quinn,81,40,41,49.38
Zed,Ivern,43,23,20,53.49
Zed,Galio,183,98,85,53.55
Zed,Kled,44,28,16,63.64
Zed,Shyvana,42,22,20,52.38
Zed,Belveth,44,8,36,18.18
Zed,Renekton,100,54,46,54
Zed,Vex,111,49,62,44.14
Zed,Smolder,151,79,72,52.32
Zed,Maokai,116,63,53,54.31
Zed,Anivia,85,43,42,50.59
Zed,Rengar,60,28,32,46.67
Zed,Singed,47,18,29,38.3
Zed,Zoe,77,44,33,57.14
Zed,Alistar,112,34,78,30.36
Zed,Fizz,96,60,36,62.5
Zed,Khazix,128,70,58,54.69
Zed,Sejuani,135,61,74,45.19
Zed,Urgot,84,21,63,25
Zed,Swain,155,71,84,45.81
Zed,Tryndamere,40,18,22,45
Zed,Lillia,72,24,48,33.33
Zed,Kalista,48,19,29,39.58
Zed,Bard,60,37,23,61.67
Zed,Kayle,114,46,68,40.35
Zed,Hecarim,61,41,20,67.21
Zed,Kennen,65,34,31,52.31
Zed,Janna,63,30,33,47.62
Zed,Corki,87,54,33,62.07
Zed,Olaf,42,24,18,57.14
Zed,Sion,173,93,80,53.76
Zed,Gwen,78,28,50,35.9
Zed,Syndra,109,59,50,54.13
Akali,Maokai,104,45,59,43.27
Akali,Viego,258,117,141,45.35
Akali,Viktor,220,101,119,45.91
Akali,Smolder,119,57,62,47.9
Akali,Nami,156,105,51,67.31
Akali,Ambessa,158,78,80,49.37
Akali,Diana,296,152,144,51.35
Akali,Ekko,148,78,70,52.7
Akali,Jinx,500,241,259,48.2
Akali,Lulu,276,139,137,50.36
Akali,Garen,300,130,170,43.33
Akali,Shaco,158,64,94,40.51
Akali,Tristana,151,80,71,52.98
Akali,Ezreal,438,202,236,46.12
Akali,Swain,190,86,104,45.26
Akali,Gnar,121,67,54,55.37
Akali,Kayn,216,87,129,40.28
Akali,Mel,443,212,231,47.86
Akali,Twitch,107,59,48,55.14
Akali,Pantheon,301,143,158,47.51
Akali,Trundle,83,46,37,55.42
Akali,Sylas,420,203,217,48.33
Akali,Zac,127,62,65,48.82
Akali,MissFortune,405,190,215,46.91
Akali,Seraphine,158,68,90,43.04
Akali,Yasuo,492,222,270,45.12
Akali,Naafiri,57,26,31,45.61
Akali,Azir,74,39,35,52.7
Akali,Irelia,193,85,108,44.04
Akali,LeeSin,422,201,221,47.63
Akali,Zed,259,149,110,57.53
Akali,Caitlyn,463,240,223,51.84
Akali,Morgana,171,76,95,44.44
Akali,TahmKench,138,67,71,48.55
Akali,Rengar,48,34,14,70.83
Akali,Yone,478,252,226,52.72
Akali,Chogath,210,92,118,43.81
Akali,Zyra,162,63,99,38.89
Akali,Jayce,129,45,84,34.88
Akali,Sejuani,126,52,74,41.27
Akali,Fizz,91,43,48,47.25
Akali,Alistar,102,49,53,48.04
Akali,Shen,131,53,78,40.46
Akali,Orianna,107,29,78,27.1
Akali,Xayah,144,56,88,38.89
Akali,Rakan,132,44,88,33.33
Akali,Warwick,228,86,142,37.72
Akali,Xerath,146,63,83,43.15
Akali,Mordekaiser,223,95,128,42.6
Akali,AurelionSol,65,27,38,41.54
Akali,Lux,465,262,203,56.34
Akali,Vayne,220,91,129,41.36
Akali,Malzahar,149,67,82,44.97
Akali,Ashe,348,171,177,49.14
Akali,Sett,375,168,207,44.8
Akali,MasterYi,174,90,84,51.72
Akali,Lucian,157,103,54,65.61
Akali,Blitzcrank,187,99,88,52.94
Akali,Katarina,124,77,47,62.1
Akali,JarvanIV,105,51,54,48.57
Akali,Milio,109,49,60,44.95
Akali,Ahri,234,101,133,43.16
Akali,Karma,223,104,119,46.64
Akali,Renekton,92,32,60,34.78
Akali,Hwei,93,38,55,40.86
Akali,Kayle,108,46,62,42.59
Akali,MonkeyKing,181,84,97,46.41
Akali,Vex,145,60,85,41.38
Akali,Soraka,82,44,38,53.66
Akali,Illaoi,88,45,43,51.14
Akali,Nunu,136,59,77,43.38
Akali,Rell,147,66,81,44.9
Akali,Lillia,135,60,75,44.44
Akali,Kaisa,334,138,196,41.32
Akali,Yuumi,147,65,82,44.22
Akali,Volibear,207,99,108,47.83
Akali,Amumu,214,81,133,37.85
Akali,Poppy,140,64,76,45.71
Akali,Darius,335,165,170,49.25
Akali,Brand,129,61,68,47.29
Akali,Ornn,131,61,70,46.56
Akali,Olaf,34,12,22,35.29
Akali,Jhin,366,176,190,48.09
Akali,Briar,102,46,56,45.1
Akali,Riven,76,36,40,47.37
Akali,Rammus,69,34,35,49.28
Akali,Zeri,103,46,57,44.66
Akali,Teemo,223,101,122,45.29
Akali,Gwen,66,39,27,59.09
Akali,Galio,222,121,101,54.5
Akali,Varus,186,88,98,47.31
Akali,Leona,176,77,99,43.75
Akali,Lissandra,92,56,36,60.87
Akali,Braum,145,49,96,33.79
Akali,Yorick,161,86,75,53.42
Akali,Draven,90,35,55,38.89
Akali,Jax,179,95,84,53.07
Akali,Pyke,151,83,68,54.97
Akali,Nocturne,203,101,102,49.75
Akali,Veigar,183,93,90,50.82
Akali,Samira,146,71,75,48.63
Akali,Talon,124,72,52,58.06
Akali,Nautilus,267,137,130,51.31
Akali,Heimerdinger,98,41,57,41.84
Akali,Vladimir,79,24,55,30.38
Akali,Urgot,89,56,33,62.92
Akali,Skarner,92,43,49,46.74
Akali,DrMundo,79,36,43,45.57
Akali,Kled,50,22,28,44
Akali,Cassiopeia,64,22,42,34.38
Akali,Hecarim,57,30,27,52.63
Akali,Sona,17,8,9,47.06
Akali,Aatrox,198,116,82,58.59
Akali,Senna,86,41,45,47.67
Akali,Malphite,165,89,76,53.94
Akali,FiddleSticks,78,28,50,35.9
Akali,Ziggs,47,13,34,27.66
Akali,Belveth,37,24,13,64.86
Akali,Aphelios,108,61,47,56.48
Akali,Ryze,88,39,49,44.32
Akali,Gragas,112,64,48,57.14
Akali,Thresh,300,146,154,48.67
Akali,Qiyana,43,18,25,41.86
Akali,Sivir,132,66,66,50
Akali,XinZhao,145,66,79,45.52
Akali,Singed,46,8,38,17.39
Akali,Elise,166,87,79,52.41
Akali,Vi,190,88,102,46.32
Akali,Zilean,55,33,22,60
Akali,Evelynn,49,26,23,53.06
Akali,Kennen,64,34,30,53.13
Akali,Aurora,138,65,73,47.1
Akali,Akshan,51,23,28,45.1
Akali,Nidalee,88,55,33,62.5
Akali,Shyvana,46,21,25,45.65
Akali,Quinn,58,35,23,60.34
Akali,Graves,141,68,73,48.23
Akali,Sion,121,60,61,49.59
Akali,Nilah,83,45,38,54.22
Akali,Kindred,83,59,24,71.08
Akali,Syndra,115,44,71,38.26
Akali,KSante,137,61,76,44.53
Akali,Neeko,92,38,54,41.3
Akali,Khazix,81,37,44,45.68
Akali,Anivia,45,28,17,62.22
Akali,KogMaw,47,26,21,55.32
Akali,Gangplank,60,30,30,50
Akali,Taric,30,8,22,26.67
Akali,Karthus,55,27,28,49.09
Akali,Renata,40,23,17,57.5
Akali,Leblanc,119,71,48,59.66
Akali,Tryndamere,87,28,59,32.18
Akali,Corki,77,40,37,51.95
Akali,Ivern,57,34,23,59.65
Akali,Zoe,91,40,51,43.96
Akali,RekSai,23,8,15,34.78
Akali,Velkoz,95,56,39,58.95
Akali,Rumble,52,32,20,61.54
Akali,Bard,71,24,47,33.8
Akali,Udyr,74,41,33,55.41
Akali,Nasus,93,41,52,44.09
Akali,Camille,63,38,25,60.32
Akali,Kassadin,19,11,8,57.89
Akali,Kalista,58,21,37,36.21
Akali,TwistedFate,59,32,27,54.24
Akali,Fiora,54,39,15,72.22
Akali,Janna,73,41,32,56.16
Akali,Annie,46,20,26,43.48
Akali,Taliyah,27,11,16,40.74
Maokai,Yone,130,52,78,40
Maokai,Nocturne,123,58,65,47.15
Maokai,Akali,104,59,45,56.73
Maokai,Ezreal,232,113,119,48.71
Maokai,Renata,17,3,14,17.65
Maokai,Darius,165,64,101,38.79
Maokai,XinZhao,39,20,19,51.28
Maokai,Malzahar,120,74,46,61.67
Maokai,Vayne,124,61,63,49.19
Maokai,Rell,66,29,37,43.94
Maokai,Pantheon,153,73,80,47.71
Maokai,Lux,230,87,143,37.83
Maokai,Kaisa,154,77,77,50
Maokai,Pyke,97,46,51,47.42
Maokai,Aatrox,126,62,64,49.21
Maokai,Kayn,133,76,57,57.14
Maokai,Yasuo,171,90,81,52.63
Maokai,MissFortune,178,115,63,64.61
Maokai,Nautilus,133,63,70,47.37
Maokai,Riven,39,14,25,35.9
Maokai,Shaco,89,45,44,50.56
Maokai,Katarina,69,35,34,50.72
Maokai,Tristana,91,45,46,49.45
Maokai,Milio,47,14,33,29.79
Maokai,AurelionSol,46,28,18,60.87
Maokai,Caitlyn,230,113,117,49.13
Maokai,Gnar,54,30,24,55.56
Maokai,Shyvana,22,0,22,0
Maokai,Galio,126,72,54,57.14
Maokai,Xerath,70,12,58,17.14
Maokai,Camille,35,18,17,51.43
Maokai,Kassadin,26,8,18,30.77
Maokai,Jhin,166,95,71,57.23
Maokai,Blitzcrank,74,42,32,56.76
Maokai,Azir,62,40,22,64.52
Maokai,MasterYi,91,45,46,49.45
Maokai,Gangplank,33,21,12,63.64
Maokai,Sion,78,24,54,30.77
Maokai,Diana,161,95,66,59.01
Maokai,Annie,24,11,13,45.83
Maokai,Neeko,38,12,26,31.58
Maokai,RekSai,15,6,9,40
Maokai,Nunu,84,28,56,33.33
Maokai,Viktor,95,39,56,41.05
Maokai,Belveth,16,8,8,50
Maokai,Malphite,87,42,45,48.28
Maokai,Volibear,104,57,47,54.81
Maokai,Amumu,110,47,63,42.73
Maokai,Cassiopeia,32,12,20,37.5
Maokai,Poppy,100,69,31,69
Maokai,Warwick,108,55,53,50.93
Maokai,Anivia,37,15,22,40.54
Maokai,Ahri,98,55,43,56.12
Maokai,Karma,118,64,54,54.24
Maokai,Varus,113,75,38,66.37
Maokai,Yorick,68,26,42,38.24
Maokai,Sylas,144,62,82,43.06
Maokai,Braum,76,32,44,42.11
Maokai,DrMundo,48,31,17,64.58
Maokai,TwistedFate,19,7,12,36.84
Maokai,Thresh,181,111,70,61.33
Maokai,Vi,141,56,85,39.72
Maokai,Mel,195,91,104,46.67
Maokai,Singed,23,10,13,43.48
Maokai,FiddleSticks,64,35,29,54.69
Maokai,Teemo,81,40,41,49.38
Maokai,Kalista,30,8,22,26.67
Maokai,Veigar,80,44,36,55
Maokai,Ornn,81,46,35,56.79
Maokai,Viego,133,57,76,42.86
Maokai,Aphelios,48,31,17,64.58
Maokai,Nasus,56,27,29,48.21
Maokai,Ashe,162,91,71,56.17
Maokai,Ambessa,71,31,40,43.66
Maokai,LeeSin,143,70,73,48.95
Maokai,Hwei,57,29,28,50.88
Maokai,Trundle,56,24,32,42.86
Maokai,Kindred,35,26,9,74.29
Maokai,KSante,52,21,31,40.38
Maokai,Morgana,95,36,59,37.89
Maokai,Gragas,61,22,39,36.07
Maokai,Qiyana,30,16,14,53.33
Maokai,Quinn,52,25,27,48.08
Maokai,Udyr,37,21,16,56.76
Maokai,Vladimir,48,26,22,54.17
Maokai,Leblanc,73,47,26,64.38
Maokai,Lulu,153,80,73,52.29
Maokai,Zed,116,53,63,45.69
Maokai,Mordekaiser,134,60,74,44.78
Maokai,Skarner,44,23,21,52.27
Maokai,Alistar,62,36,26,58.06
Maokai,Velkoz,58,28,30,48.28
Maokai,Rammus,35,13,22,37.14
Maokai,Gwen,62,28,34,45.16
Maokai,Karthus,36,22,14,61.11
Maokai,Swain,107,44,63,41.12
Maokai,Jinx,263,117,146,44.49
Maokai,Senna,49,14,35,28.57
Maokai,Seraphine,90,54,36,60
Maokai,Nami,119,59,60,49.58
Maokai,Syndra,83,33,50,39.76
Maokai,Lucian,67,33,34,49.25
Maokai,Illaoi,50,29,21,58
Maokai,Elise,97,58,39,59.79
Maokai,Chogath,124,69,55,55.65
Maokai,Briar,62,28,34,45.16
Maokai,Orianna,64,29,35,45.31
Maokai,TahmKench,111,50,61,45.05
Maokai,Ryze,39,18,21,46.15
Maokai,Ekko,59,25,34,42.37
Maokai,Samira,63,34,29,53.97
Maokai,Sejuani,71,39,32,54.93
Maokai,Graves,47,30,17,63.83
Maokai,Xayah,41,25,16,60.98
Maokai,Kayle,60,27,33,45
Maokai,Renekton,46,27,19,58.7
Maokai,Fizz,37,20,17,54.05
Maokai,Sivir,54,13,41,24.07
Maokai,Lillia,54,29,25,53.7
Maokai,Soraka,49,23,26,46.94
Maokai,Jayce,35,8,27,22.86
Maokai,Jax,61,39,22,63.93
Maokai,Yuumi,56,28,28,50
Maokai,Heimerdinger,33,20,13,60.61
Maokai,Twitch,79,32,47,40.51
Maokai,Irelia,62,25,37,40.32
Maokai,Zeri,54,26,28,48.15
Maokai,Garen,135,69,66,51.11
Maokai,Hecarim,31,15,16,48.39
Maokai,Draven,41,20,21,48.78
Maokai,Leona,116,43,73,37.07
Maokai,Naafiri,43,11,32,25.58
Maokai,Khazix,41,15,26,36.59
Maokai,Sett,126,71,55,56.35
Maokai,Talon,37,23,14,62.16
Maokai,Nilah,33,8,25,24.24
Maokai,Sona,13,8,5,61.54
Maokai,Ivern,17,8,9,47.06
Maokai,Evelynn,34,16,18,47.06
Maokai,Aurora,80,50,30,62.5
Maokai,MonkeyKing,61,33,28,54.1
Maokai,Nidalee,46,24,22,52.17
Maokai,Zyra,61,40,21,65.57
Maokai,Zoe,53,26,27,49.06
Maokai,Urgot,46,26,20,56.52
Maokai,Zilean,35,8,27,22.86
Maokai,Zac,82,56,26,68.29
Maokai,Akshan,32,15,17,46.88
Maokai,JarvanIV,55,32,23,58.18
Maokai,Taliyah,31,18,13,58.06
Maokai,KogMaw,33,8,25,24.24
Maokai,Brand,42,23,19,54.76
Maokai,Shen,45,12,33,26.67
Maokai,Bard,22,8,14,36.36
Maokai,Smolder,86,32,54,37.21
Maokai,Vex,50,23,27,46
Maokai,Olaf,35,15,20,42.86
Maokai,Tryndamere,32,14,18,43.75
Maokai,Kled,19,8,11,42.11
Maokai,Janna,25,20,5,80
Maokai,Ziggs,40,24,16,60
Maokai,Corki,49,24,25,48.98
Maokai,Rakan,39,21,18,53.85
Maokai,Rumble,23,8,15,34.78
Maokai,Kennen,39,27,12,69.23
Maokai,Lissandra,39,22,17,56.41
Maokai,Taric,10,5,5,50
Maokai,Fiora,38,14,24,36.84
Maokai,Rengar,36,27,9,75
Rakan,Warwick,140,72,68,51.43
Rakan,Udyr,44,27,17,61.36
Rakan,Mel,286,158,128,55.24
Rakan,Sivir,57,22,35,38.6
Rakan,Karma,162,68,94,41.98
Rakan,Nasus,76,46,30,60.53
Rakan,FiddleSticks,63,22,41,34.92
Rakan,Syndra,72,32,40,44.44
Rakan,Seraphine,80,32,48,40
Rakan,Alistar,60,33,27,55
Rakan,Nocturne,140,68,72,48.57
Rakan,Galio,150,77,73,51.33
Rakan,Urgot,56,29,27,51.79
Rakan,Samira,117,59,58,50.43
Rakan,Illaoi,64,27,37,42.19
Rakan,Twitch,110,47,63,42.73
Rakan,Ahri,168,67,101,39.88
Rakan,Kaisa,202,116,86,57.43
Rakan,Ashe,198,100,98,50.51
Rakan,Malzahar,133,64,69,48.12
Rakan,Garen,213,95,118,44.6
Rakan,Caitlyn,260,123,137,47.31
Rakan,Lucian,90,52,38,57.78
Rakan,Nami,119,45,74,37.82
Rakan,Poppy,132,62,70,46.97
Rakan,Shaco,87,37,50,42.53
Rakan,Ezreal,320,148,172,46.25
Rakan,LeeSin,227,94,133,41.41
Rakan,Viktor,109,67,42,61.47
Rakan,Vladimir,71,53,18,74.65
Rakan,Akali,132,88,44,66.67
Rakan,Vayne,164,62,102,37.8
Rakan,Briar,41,24,17,58.54
Rakan,Neeko,66,43,23,65.15
Rakan,Jhin,212,100,112,47.17
Rakan,Lulu,148,62,86,41.89
Rakan,Trundle,75,34,41,45.33
Rakan,Khazix,69,29,40,42.03
Rakan,Aurora,85,41,44,48.24
Rakan,Varus,94,57,37,60.64
Rakan,Pantheon,223,112,111,50.22
Rakan,Leona,102,50,52,49.02
Rakan,Rammus,65,26,39,40
Rakan,Lux,241,126,115,52.28
Rakan,Aatrox,89,42,47,47.19
Rakan,Vi,162,84,78,51.85
Rakan,Smolder,75,38,37,50.67
Rakan,Kayle,57,30,27,52.63
Rakan,Teemo,117,60,57,51.28
Rakan,Graves,71,24,47,33.8
Rakan,Sylas,144,70,74,48.61
Rakan,Irelia,81,38,43,46.91
Rakan,Soraka,39,29,10,74.36
Rakan,MasterYi,114,63,51,55.26
Rakan,Morgana,139,66,73,47.48
Rakan,Quinn,43,31,12,72.09
Rakan,Nidalee,36,19,17,52.78
Rakan,Aphelios,64,32,32,50
Rakan,Sion,93,35,58,37.63
Rakan,RekSai,23,15,8,65.22
Rakan,Lissandra,36,27,9,75
Rakan,Senna,92,52,40,56.52
Rakan,MonkeyKing,72,36,36,50
Rakan,Kayn,185,113,72,61.08
Rakan,Kassadin,33,20,13,60.61
Rakan,Chogath,204,104,100,50.98
Rakan,Darius,198,101,97,51.01
Rakan,Veigar,101,51,50,50.5
Rakan,Nautilus,164,92,72,56.1
Rakan,Gnar,80,48,32,60
Rakan,Yorick,72,40,32,55.56
Rakan,Riven,39,21,18,53.85
Rakan,TahmKench,104,58,46,55.77
Rakan,Mordekaiser,149,76,73,51.01
Rakan,Talon,49,25,24,51.02
Rakan,Renata,36,17,19,47.22
Rakan,TwistedFate,73,40,33,54.79
Rakan,Anivia,46,19,27,41.3
Rakan,AurelionSol,38,18,20,47.37
Rakan,Viego,156,71,85,45.51
Rakan,Milio,73,33,40,45.21
Rakan,Camille,58,38,20,65.52
Rakan,Yone,207,103,104,49.76
Rakan,Tristana,79,38,41,48.1
Rakan,Amumu,122,71,51,58.2
Rakan,Draven,65,45,20,69.23
Rakan,Thresh,222,133,89,59.91
Rakan,Zac,67,38,29,56.72
Rakan,Zed,113,57,56,50.44
Rakan,Yasuo,196,96,100,48.98
Rakan,Rell,80,45,35,56.25
Rakan,Katarina,59,36,23,61.02
Rakan,Orianna,81,30,51,37.04
Rakan,Gragas,73,26,47,35.62
Rakan,Diana,170,85,85,50
Rakan,Blitzcrank,123,72,51,58.54
Rakan,Ivern,15,7,8,46.67
Rakan,Tryndamere,47,20,27,42.55
Rakan,KSante,75,44,31,58.67
Rakan,Malphite,130,64,66,49.23
Rakan,MissFortune,191,101,90,52.88
Rakan,Taric,32,9,23,28.13
Rakan,Ekko,85,43,42,50.59
Rakan,Nilah,29,22,7,75.86
Rakan,Yuumi,102,52,50,50.98
Rakan,Elise,108,60,48,55.56
Rakan,Leblanc,77,40,37,51.95
Rakan,Nunu,57,27,30,47.37
Rakan,Renekton,69,45,24,65.22
Rakan,Braum,70,40,30,57.14
Rakan,Brand,64,31,33,48.44
Rakan,KogMaw,18,11,7,61.11
Rakan,Hwei,73,43,30,58.9
Rakan,Lillia,60,29,31,48.33
Rakan,Gwen,48,34,14,70.83
Rakan,Ornn,105,62,43,59.05
Rakan,Naafiri,37,29,8,78.38
Rakan,Ambessa,96,41,55,42.71
Rakan,Xerath,89,51,38,57.3
Rakan,Kalista,37,31,6,83.78
Rakan,Rengar,47,26,21,55.32
Rakan,Janna,61,30,31,49.18
Rakan,Evelynn,24,9,15,37.5
Rakan,Jinx,280,115,165,41.07
Rakan,Annie,43,20,23,46.51
Rakan,Jax,93,43,50,46.24
Rakan,Jayce,55,26,29,47.27
Rakan,Karthus,42,23,19,54.76
Rakan,Vex,92,39,53,42.39
Rakan,JarvanIV,91,50,41,54.95
Rakan,Skarner,57,26,31,45.61
Rakan,Sett,142,67,75,47.18
Rakan,Heimerdinger,55,22,33,40
Rakan,Gangplank,51,38,13,74.51
Rakan,Singed,15,7,8,46.67
Rakan,Pyke,118,67,51,56.78
Rakan,Shyvana,21,12,9,57.14
Rakan,Sejuani,45,27,18,60
Rakan,Azir,52,32,20,61.54
Rakan,Xayah,85,54,31,63.53
Rakan,Bard,58,29,29,50
Rakan,Taliyah,42,29,13,69.05
Rakan,Ziggs,39,26,13,66.67
Rakan,Sona,35,23,12,65.71
Rakan,Zeri,53,36,17,67.92
Rakan,Qiyana,31,19,12,61.29
Rakan,Hecarim,30,18,12,60
Rakan,DrMundo,56,40,16,71.43
Rakan,Rumble,42,23,19,54.76
Rakan,Zyra,80,29,51,36.25
Rakan,Corki,41,22,19,53.66
Rakan,Cassiopeia,35,11,24,31.43
Rakan,Akshan,21,15,6,71.43
Rakan,Swain,100,45,55,45
Rakan,Fiora,42,13,29,30.95
Rakan,Volibear,87,34,53,39.08
Rakan,XinZhao,67,24,43,35.82
Rakan,Olaf,42,21,21,50
Rakan,Shen,108,43,65,39.81
Rakan,Belveth,15,7,8,46.67
Rakan,Fizz,51,22,29,43.14
Rakan,Kindred,61,27,34,44.26
Rakan,Ryze,43,15,28,34.88
Rakan,Velkoz,58,17,41,29.31
Rakan,Zilean,27,9,18,33.33
Rakan,Kled,9,7,2,77.78
Rakan,Kennen,33,5,28,15.15
Rakan,Zoe,42,27,15,64.29
Rakan,Maokai,39,18,21,46.15
Draven,Warwick,116,55,61,47.41
Draven,Udyr,31,18,13,58.06
Draven,Mel,233,122,111,52.36
Draven,Sivir,55,18,37,32.73
Draven,Karma,119,64,55,53.78
Draven,Heimerdinger,64,46,18,71.88
Draven,Gragas,72,36,36,50
Draven,Viktor,76,35,41,46.05
Draven,Jinx,253,110,143,43.48
Draven,Pyke,59,31,28,52.54
Draven,Thresh,181,73,108,40.33
Draven,Annie,32,14,18,43.75
Draven,Nasus,51,18,33,35.29
Draven,Tristana,98,59,39,60.2
Draven,Poppy,67,26,41,38.81
Draven,Jax,85,30,55,35.29
Draven,Pantheon,179,100,79,55.87
Draven,TwistedFate,49,27,22,55.1
Draven,Milio,63,12,51,19.05
Draven,Renekton,62,39,23,62.9
Draven,Diana,175,91,84,52
Draven,Katarina,71,40,31,56.34
Draven,Varus,114,51,63,44.74
Draven,Kayn,144,74,70,51.39
Draven,Ahri,139,71,68,51.08
Draven,Brand,65,24,41,36.92
Draven,Nami,131,68,63,51.91
Draven,Shen,57,35,22,61.4
Draven,Xayah,58,25,33,43.1
Draven,Sejuani,61,29,32,47.54
Draven,Riven,50,20,30,40
Draven,Lillia,56,25,31,44.64
Draven,Yasuo,203,104,99,51.23
Draven,Nautilus,174,74,100,42.53
Draven,Shaco,81,42,39,51.85
Draven,Lucian,112,67,45,59.82
Draven,Swain,76,32,44,42.11
Draven,JarvanIV,85,51,34,60
Draven,Naafiri,30,18,12,60
Draven,Soraka,57,33,24,57.89
Draven,Sylas,100,53,47,53
Draven,Briar,83,43,40,51.81
Draven,Lux,196,99,97,50.51
Draven,Ezreal,240,107,133,44.58
Draven,Neeko,59,25,34,42.37
Draven,Mordekaiser,126,60,66,47.62
Draven,MonkeyKing,95,54,41,56.84
Draven,Irelia,100,51,49,51
Draven,Samira,109,45,64,41.28
Draven,Rell,80,29,51,36.25
Draven,Amumu,126,56,70,44.44
Draven,Kayle,54,26,28,48.15
Draven,Khazix,52,24,28,46.15
Draven,Lulu,130,69,61,53.08
Draven,Gnar,53,25,28,47.17
Draven,Yorick,80,15,65,18.75
Draven,Aurora,93,46,47,49.46
Draven,TahmKench,109,39,70,35.78
Draven,Rammus,48,22,26,45.83
Draven,Yone,174,81,93,46.55
Draven,Zeri,65,27,38,41.54
Draven,Xerath,93,36,57,38.71
Draven,Viego,116,47,69,40.52
Draven,Kennen,58,35,23,60.34
Draven,Zyra,71,21,50,29.58
Draven,Blitzcrank,100,56,44,56
Draven,Nidalee,48,32,16,66.67
Draven,Akali,90,55,35,61.11
Draven,Ashe,189,102,87,53.97
Draven,Volibear,96,46,50,47.92
Draven,Ekko,77,39,38,50.65
Draven,Azir,49,26,23,53.06
Draven,MissFortune,214,110,104,51.4
Draven,Yuumi,95,43,52,45.26
Draven,Malzahar,84,47,37,55.95
Draven,KogMaw,38,25,13,65.79
Draven,Twitch,56,28,28,50
Draven,Sett,135,57,78,42.22
Draven,Hecarim,47,25,22,53.19
Draven,Trundle,58,40,18,68.97
Draven,Fiora,52,19,33,36.54
Draven,Leblanc,65,33,32,50.77
Draven,Caitlyn,255,120,135,47.06
Draven,Rakan,65,20,45,30.77
Draven,Camille,35,24,11,68.57
Draven,Kaisa,135,68,67,50.37
Draven,DrMundo,51,19,32,37.25
Draven,Talon,20,8,12,40
Draven,Morgana,103,63,40,61.17
Draven,KSante,65,38,27,58.46
Draven,Graves,77,30,47,38.96
Draven,Taric,22,13,9,59.09
Draven,Tryndamere,22,16,6,72.73
Draven,Veigar,132,62,70,46.97
Draven,Teemo,105,51,54,48.57
Draven,Skarner,67,35,32,52.24
Draven,Cassiopeia,30,14,16,46.67
Draven,Chogath,119,68,51,57.14
Draven,Vi,83,44,39,53.01
Draven,Fizz,47,18,29,38.3
Draven,Zilean,33,18,15,54.55
Draven,Braum,93,45,48,48.39
Draven,Urgot,46,27,19,58.7
Draven,Evelynn,30,11,19,36.67
Draven,Kalista,39,15,24,38.46
Draven,Orianna,58,35,23,60.34
Draven,Ambessa,93,49,44,52.69
Draven,Zoe,41,28,13,68.29
Draven,Darius,171,72,99,42.11
Draven,Garen,150,57,93,38
Draven,AurelionSol,36,10,26,27.78
Draven,Anivia,47,16,31,34.04
Draven,Vayne,149,72,77,48.32
Draven,Vladimir,70,30,40,42.86
Draven,Aatrox,100,56,44,56
Draven,Elise,58,31,27,53.45
Draven,Qiyana,28,17,11,60.71
Draven,Zed,86,46,40,53.49
Draven,Aphelios,53,33,20,62.26
Draven,Nunu,85,56,29,65.88
Draven,Bard,27,9,18,33.33
Draven,Zac,48,26,22,54.17
Draven,Renata,25,10,15,40
Draven,Ryze,36,19,17,52.78
Draven,Seraphine,59,36,23,61.02
Draven,Leona,107,54,53,50.47
Draven,Kled,25,11,14,44
Draven,Kindred,82,53,29,64.63
Draven,Syndra,70,35,35,50
Draven,Illaoi,48,21,27,43.75
Draven,Taliyah,25,10,15,40
Draven,Jhin,174,72,102,41.38
Draven,Jayce,32,12,20,37.5
Draven,Akshan,30,17,13,56.67
Draven,Hwei,64,24,40,37.5
Draven,Corki,37,13,24,35.14
Draven,Alistar,70,45,25,64.29
Draven,Gangplank,45,20,25,44.44
Draven,Malphite,99,31,68,31.31
Draven,FiddleSticks,39,22,17,56.41
Draven,Janna,35,24,11,68.57
Draven,LeeSin,156,80,76,51.28
Draven,MasterYi,84,40,44,47.62
Draven,Shyvana,26,9,17,34.62
Draven,Karthus,24,5,19,20.83
Draven,Vex,52,21,31,40.38
Draven,Kassadin,29,15,14,51.72
Draven,Rumble,26,14,12,53.85
Draven,Ornn,50,17,33,34
Draven,Ivern,21,12,9,57.14
Draven,Nocturne,116,49,67,42.24
Draven,Sion,77,36,41,46.75
Draven,Olaf,24,12,12,50
Draven,Velkoz,77,56,21,72.73
Draven,Nilah,31,19,12,61.29
Draven,Smolder,72,40,32,55.56
Draven,Sona,12,5,7,41.67
Draven,Lissandra,38,17,21,44.74
Draven,Quinn,47,29,18,61.7
Draven,Maokai,41,21,20,51.22
Draven,Ziggs,41,20,21,48.78
Draven,XinZhao,62,27,35,43.55
Draven,Galio,106,41,65,38.68
Draven,Rengar,25,10,15,40
Draven,Senna,47,25,22,53.19
Draven,Gwen,45,20,25,44.44
Draven,Belveth,36,26,10,72.22
Draven,Singed,13,9,4,69.23
Draven,RekSai,9,6,3,66.67
Warwick,Sett,421,212,209,50.36
Warwick,Hecarim,85,50,35,58.82
Warwick,Ahri,387,204,183,52.71
Warwick,Rakan,140,68,72,48.57
Warwick,Draven,116,61,55,52.59
Warwick,Riven,96,42,54,43.75
Warwick,Poppy,152,90,62,59.21
Warwick,Veigar,354,192,162,54.24
Warwick,Ziggs,98,55,43,56.12
Warwick,Yuumi,215,112,103,52.09
Warwick,Garen,424,205,219,48.35
Warwick,Shaco,214,113,101,52.8
Warwick,Tristana,234,132,102,56.41
Warwick,Ezreal,602,309,293,51.33
Warwick,Swain,269,127,142,47.21
Warwick,Kled,56,35,21,62.5
Warwick,Kayn,389,219,170,56.3
Warwick,Katarina,168,97,71,57.74
Warwick,Twitch,207,97,110,46.86
Warwick,Thresh,456,210,246,46.05
Warwick,Olaf,92,50,42,54.35
Warwick,Viego,359,196,163,54.6
Warwick,Ryze,125,75,50,60
Warwick,Jhin,541,306,235,56.56
Warwick,Soraka,150,77,73,51.33
Warwick,Malphite,292,155,137,53.08
Warwick,Khazix,139,72,67,51.8
Warwick,Galio,307,146,161,47.56
Warwick,Smolder,189,102,87,53.97
Warwick,Yorick,240,128,112,53.33
Warwick,Sylas,379,189,190,49.87
Warwick,MissFortune,546,308,238,56.41
Warwick,Renata,49,25,24,51.02
Warwick,RekSai,38,29,9,76.32
Warwick,Nunu,227,115,112,50.66
Warwick,Hwei,123,84,39,68.29
Warwick,Morgana,287,149,138,51.92
Warwick,Nautilus,378,213,165,56.35
Warwick,Shen,191,114,77,59.69
Warwick,Karthus,52,31,21,59.62
Warwick,Ekko,239,128,111,53.56
Warwick,Gragas,189,94,95,49.74
Warwick,MasterYi,296,172,124,58.11
Warwick,TwistedFate,82,41,41,50
Warwick,Xayah,160,96,64,60
Warwick,Trundle,164,91,73,55.49
Warwick,Zilean,83,32,51,38.55
Warwick,LeeSin,464,262,202,56.47
Warwick,Orianna,140,72,68,51.43
Warwick,Quinn,95,48,47,50.53
Warwick,Akali,228,142,86,62.28
Warwick,Caitlyn,653,294,359,45.02
Warwick,Milio,190,101,89,53.16
Warwick,AurelionSol,98,44,54,44.9
Warwick,Lux,569,342,227,60.11
Warwick,Vayne,350,175,175,50
Warwick,Lulu,335,181,154,54.03
Warwick,Ambessa,192,93,99,48.44
Warwick,Gwen,137,93,44,67.88
Warwick,Vladimir,141,48,93,34.04
Warwick,Briar,158,83,75,52.53
Warwick,Neeko,151,76,75,50.33
Warwick,Mordekaiser,466,227,239,48.71
Warwick,Darius,477,239,238,50.1
Warwick,Teemo,260,122,138,46.92
Warwick,Jinx,667,319,348,47.83
Warwick,Blitzcrank,296,156,140,52.7
Warwick,Nami,239,131,108,54.81
Warwick,Jax,241,135,106,56.02
Warwick,XinZhao,188,97,91,51.6
Warwick,Azir,73,49,24,67.12
Warwick,Rell,172,100,72,58.14
Warwick,Sion,196,92,104,46.94
Warwick,Vi,279,126,153,45.16
Warwick,Nilah,102,50,52,49.02
Warwick,Leona,320,163,157,50.94
Warwick,Aatrox,274,122,152,44.53
Warwick,Ivern,59,43,16,72.88
Warwick,Pantheon,414,220,194,53.14
Warwick,Nasus,172,103,69,59.88
Warwick,Viktor,204,101,103,49.51
Warwick,Ashe,552,273,279,49.46
Warwick,Zyra,214,132,82,61.68
Warwick,Velkoz,186,111,75,59.68
Warwick,Fizz,169,95,74,56.21
Warwick,Karma,279,152,127,54.48
Warwick,Lillia,132,65,67,49.24
Warwick,Yasuo,548,277,271,50.55
Warwick,Heimerdinger,175,96,79,54.86
Warwick,Irelia,199,89,110,44.72
Warwick,Zed,234,136,98,58.12
Warwick,Kaisa,350,194,156,55.43
Warwick,Brand,158,93,65,58.86
Warwick,Singed,77,40,37,51.95
Warwick,Sejuani,188,81,107,43.09
Warwick,Braum,228,88,140,38.6
Warwick,Kayle,142,66,76,46.48
Warwick,Kindred,121,65,56,53.72
Warwick,TahmKench,275,123,152,44.73
Warwick,Vex,138,79,59,57.25
Warwick,Qiyana,66,32,34,48.48
Warwick,Lucian,204,131,73,64.22
Warwick,Urgot,139,61,78,43.88
Warwick,Zoe,94,63,31,67.02
Warwick,Amumu,374,174,200,46.52
Warwick,Mel,517,280,237,54.16
Warwick,Renekton,149,74,75,49.66
Warwick,Diana,349,163,186,46.7
Warwick,Xerath,211,111,100,52.61
Warwick,Alistar,121,71,50,58.68
Warwick,Chogath,356,173,183,48.6
Warwick,Sona,47,30,17,63.83
Warwick,Rammus,123,70,53,56.91
Warwick,Talon,134,68,66,50.75
Warwick,Gangplank,94,34,60,36.17
Warwick,Nocturne,333,165,168,49.55
Warwick,Taric,48,29,19,60.42
Warwick,Aurora,191,97,94,50.79
Warwick,Pyke,238,128,110,53.78
Warwick,Syndra,195,95,100,48.72
Warwick,Yone,456,260,196,57.02
Warwick,FiddleSticks,77,50,27,64.94
Warwick,Seraphine,184,86,98,46.74
Warwick,Jayce,72,42,30,58.33
Warwick,MonkeyKing,204,90,114,44.12
Warwick,Gnar,103,66,37,64.08
Warwick,Camille,89,54,35,60.67
Warwick,Rengar,89,46,43,51.69
Warwick,Sivir,202,109,93,53.96
Warwick,DrMundo,160,103,57,64.38
Warwick,Maokai,108,53,55,49.07
Warwick,Aphelios,148,86,62,58.11
Warwick,Fiora,63,30,33,47.62
Warwick,Udyr,101,52,49,51.49
Warwick,Malzahar,273,142,131,52.01
Warwick,Evelynn,55,34,21,61.82
Warwick,Kalista,95,50,45,52.63
Warwick,Taliyah,44,29,15,65.91
Warwick,Kennen,58,38,20,65.52
Warwick,Volibear,379,180,199,47.49
Warwick,Elise,167,79,88,47.31
Warwick,Skarner,120,46,74,38.33
Warwick,Senna,156,86,70,55.13
Warwick,Ornn,124,79,45,63.71
Warwick,Shyvana,72,29,43,40.28
Warwick,Cassiopeia,85,36,49,42.35
Warwick,Anivia,89,49,40,55.06
Warwick,Akshan,132,66,66,50
Warwick,Nidalee,64,53,11,82.81
Warwick,Corki,133,68,65,51.13
Warwick,Zac,134,60,74,44.78
Warwick,Janna,71,33,38,46.48
Warwick,Varus,198,112,86,56.57
Warwick,Lissandra,109,77,32,70.64
Warwick,Leblanc,168,83,85,49.4
Warwick,Rumble,79,42,37,53.16
Warwick,Tryndamere,86,54,32,62.79
Warwick,Illaoi,133,59,74,44.36
Warwick,Kassadin,62,18,44,29.03
Warwick,Graves,141,57,84,40.43
Warwick,Samira,157,85,72,54.14
Warwick,Bard,63,32,31,50.79
Warwick,Zeri,95,47,48,49.47
Warwick,Annie,94,45,49,47.87
Warwick,Belveth,41,14,27,34.15
Warwick,JarvanIV,178,86,92,48.31
Warwick,Naafiri,51,25,26,49.02
Warwick,KogMaw,96,47,49,48.96
Warwick,KSante,139,62,77,44.6
Kayle,Volibear,133,81,52,60.9
Kayle,LeeSin,146,90,56,61.64
Kayle,Veigar,92,42,50,45.65
Kayle,Vayne,139,62,77,44.6
Kayle,Yuumi,91,57,34,62.64
Kayle,Sion,99,57,42,57.58
Kayle,Aatrox,82,51,31,62.2
Kayle,TwistedFate,38,17,21,44.74
Kayle,Lux,277,142,135,51.26
Kayle,Lulu,165,94,71,56.97
Kayle,Singed,38,11,27,28.95
Kayle,Darius,232,108,124,46.55
Kayle,Smolder,85,48,37,56.47
Kayle,Mel,231,134,97,58.01
Kayle,Pantheon,186,75,111,40.32
Kayle,XinZhao,68,42,26,61.76
Kayle,Malzahar,125,72,53,57.6
Kayle,Rell,78,59,19,75.64
Kayle,Chogath,138,91,47,65.94
Kayle,JarvanIV,66,28,38,42.42
Kayle,Yasuo,213,111,102,52.11
Kayle,Tristana,147,70,77,47.62
Kayle,Alistar,67,41,26,61.19
Kayle,Mordekaiser,131,69,62,52.67
Kayle,Kayn,141,71,70,50.35
Kayle,Ekko,99,49,50,49.49
Kayle,Nami,145,75,70,51.72
Kayle,Caitlyn,301,147,154,48.84
Kayle,Nunu,71,49,22,69.01
Kayle,Katarina,78,45,33,57.69
Kayle,Swain,88,52,36,59.09
Kayle,Rakan,57,27,30,47.37
Kayle,Garen,238,161,77,67.65
Kayle,Sejuani,68,43,25,63.24
Kayle,Akali,108,62,46,57.41
Kayle,Ezreal,249,134,115,53.82
Kayle,Karma,131,81,50,61.83
Kayle,Irelia,111,57,54,51.35
Kayle,Diana,143,84,59,58.74
Kayle,Morgana,104,48,56,46.15
Kayle,Yorick,102,42,60,41.18
Kayle,Shen,103,39,64,37.86
Kayle,Nocturne,115,54,61,46.96
Kayle,Lucian,100,46,54,46
Kayle,Xerath,99,46,53,46.46
Kayle,Olaf,10,5,5,50
Kayle,Warwick,142,76,66,53.52
Kayle,Urgot,46,26,20,56.52
Kayle,Draven,54,28,26,51.85
Kayle,Udyr,36,22,14,61.11
Kayle,Ahri,159,92,67,57.86
Kayle,MissFortune,212,119,93,56.13
Kayle,Blitzcrank,100,61,39,61
Kayle,Sett,146,75,71,51.37
Kayle,Yone,180,81,99,45
Kayle,Nautilus,147,67,80,45.58
Kayle,Rumble,46,24,22,52.17
Kayle,Jhin,212,95,117,44.81
Kayle,Zyra,87,51,36,58.62
Kayle,Kaisa,158,93,65,58.86
Kayle,TahmKench,104,57,47,54.81
Kayle,Samira,99,53,46,53.54
Kayle,Thresh,142,68,74,47.89
Kayle,MasterYi,99,46,53,46.46
Kayle,Ornn,79,45,34,56.96
Kayle,Aurora,105,41,64,39.05
Kayle,Jinx,228,90,138,39.47
Kayle,Renata,21,4,17,19.05
Kayle,Riven,40,18,22,45
Kayle,Zeri,32,20,12,62.5
Kayle,Fiora,46,26,20,56.52
Kayle,Cassiopeia,35,15,20,42.86
Kayle,Ashe,188,95,93,50.53
Kayle,Skarner,45,29,16,64.44
Kayle,Seraphine,83,48,35,57.83
Kayle,DrMundo,60,33,27,55
Kayle,Ziggs,26,12,14,46.15
Kayle,Nasus,67,26,41,38.81
Kayle,Lillia,64,37,27,57.81
Kayle,Nidalee,43,26,17,60.47
Kayle,Annie,36,10,26,27.78
Kayle,KogMaw,29,13,16,44.83
Kayle,MonkeyKing,90,43,47,47.78
Kayle,Vladimir,67,34,33,50.75
Kayle,Shaco,92,51,41,55.43
Kayle,Kassadin,23,11,12,47.83
Kayle,Teemo,128,58,70,45.31
Kayle,Jax,128,50,78,39.06
Kayle,Pyke,83,46,37,55.42
Kayle,Amumu,140,56,84,40
Kayle,Gwen,45,30,15,66.67
Kayle,Leona,103,55,48,53.4
Kayle,Ambessa,75,46,29,61.33
Kayle,Evelynn,14,3,11,21.43
Kayle,Syndra,105,61,44,58.1
Kayle,Viktor,102,39,63,38.24
Kayle,Braum,71,37,34,52.11
Kayle,Zilean,32,11,21,34.38
Kayle,Malphite,112,58,54,51.79
Kayle,Gragas,63,32,31,50.79
Kayle,Jayce,49,22,27,44.9
Kayle,Shyvana,23,11,12,47.83
Kayle,Aphelios,58,40,18,68.97
Kayle,Lissandra,54,28,26,51.85
Kayle,Naafiri,32,10,22,31.25
Kayle,Kindred,32,19,13,59.38
Kayle,Hecarim,50,20,30,40
Kayle,Zac,57,37,20,64.91
Kayle,Milio,86,43,43,50
Kayle,Vi,137,62,75,45.26
Kayle,Gangplank,52,28,24,53.85
Kayle,Janna,46,27,19,58.7
Kayle,Karthus,24,13,11,54.17
Kayle,Corki,56,40,16,71.43
Kayle,Twitch,86,61,25,70.93
Kayle,Talon,57,33,24,57.89
Kayle,Varus,123,73,50,59.35
Kayle,Soraka,49,24,25,48.98
Kayle,Hwei,82,46,36,56.1
Kayle,Sylas,138,85,53,61.59
Kayle,Illaoi,45,32,13,71.11
Kayle,Gnar,48,19,29,39.58
Kayle,Briar,75,32,43,42.67
Kayle,Galio,108,57,51,52.78
Kayle,KSante,54,33,21,61.11
Kayle,Trundle,51,30,21,58.82
Kayle,Kennen,20,14,6,70
Kayle,Velkoz,58,30,28,51.72
Kayle,Zed,114,68,46,59.65
Kayle,Viego,160,88,72,55
Kayle,Azir,38,21,17,55.26
Kayle,Maokai,60,33,27,55
Kayle,Brand,44,27,17,61.36
Kayle,Quinn,43,17,26,39.53
Kayle,FiddleSticks,37,24,13,64.86
Kayle,Neeko,51,26,25,50.98
Kayle,Heimerdinger,52,31,21,59.62
Kayle,Poppy,87,46,41,52.87
Kayle,Elise,68,41,27,60.29
Kayle,AurelionSol,42,18,24,42.86
Kayle,Anivia,28,19,9,67.86
Kayle,Orianna,44,29,15,65.91
Kayle,Senna,69,43,26,62.32
Kayle,Vex,54,25,29,46.3
Kayle,Rengar,39,13,26,33.33
Kayle,Camille,33,11,22,33.33
Kayle,Ryze,30,15,15,50
Kayle,Kalista,29,16,13,55.17
Kayle,Zoe,27,19,8,70.37
Kayle,Rammus,33,16,17,48.48
Kayle,Leblanc,62,33,29,53.23
Kayle,Sona,29,17,12,58.62
Kayle,Ivern,19,10,9,52.63
Kayle,Tryndamere,47,25,22,53.19
Kayle,Taliyah,14,9,5,64.29
Kayle,Graves,60,24,36,40
Kayle,Renekton,59,36,23,61.02
Kayle,Bard,25,16,9,64
Kayle,Sivir,74,48,26,64.86
Kayle,Xayah,50,33,17,66
Kayle,Akshan,29,16,13,55.17
Kayle,Khazix,64,34,30,53.13
Kayle,Fizz,43,22,21,51.16
Kayle,RekSai,17,14,3,82.35
Kayle,Taric,20,13,7,65
Kayle,Qiyana,22,15,7,68.18
Kayle,Belveth,25,8,17,32
Kayle,Nilah,32,13,19,40.63
Kayle,Kled,15,12,3,80
Kindred,Volibear,71,34,37,47.89
Kindred,LeeSin,152,67,85,44.08
Kindred,Veigar,92,45,47,48.91
Kindred,Vayne,100,42,58,42
Kindred,Yuumi,69,35,34,50.72
Kindred,Chogath,116,49,67,42.24
Kindred,Nocturne,98,69,29,70.41
Kindred,Orianna,27,13,14,48.15
Kindred,Caitlyn,240,101,139,42.08
Kindred,Neeko,38,18,20,47.37
Kindred,Quinn,24,10,14,41.67
Kindred,MasterYi,71,19,52,26.76
Kindred,Garen,145,74,71,51.03
Kindred,Smolder,85,47,38,55.29
Kindred,Nautilus,110,33,77,30
Kindred,Kayn,108,38,70,35.19
Kindred,Mel,161,90,71,55.9
Kindred,MissFortune,177,82,95,46.33
Kindred,Velkoz,41,21,20,51.22
Kindred,Hwei,66,20,46,30.3
Kindred,Vi,101,30,71,29.7
Kindred,Xerath,91,45,46,49.45
Kindred,Braum,65,26,39,40
Kindred,Sett,143,49,94,34.27
Kindred,Darius,140,60,80,42.86
Kindred,Leblanc,39,25,14,64.1
Kindred,Lux,201,82,119,40.8
Kindred,Karma,85,20,65,23.53
Kindred,Ashe,164,95,69,57.93
Kindred,Malzahar,99,44,55,44.44
Kindred,Jayce,36,15,21,41.67
Kindred,Jhin,152,73,79,48.03
Kindred,Singed,21,16,5,76.19
Kindred,JarvanIV,43,18,25,41.86
Kindred,Malphite,94,35,59,37.23
Kindred,FiddleSticks,44,20,24,45.45
Kindred,Galio,105,53,52,50.48
Kindred,Ezreal,202,92,110,45.54
Kindred,Lulu,82,38,44,46.34
Kindred,Heimerdinger,41,24,17,58.54
Kindred,Teemo,78,27,51,34.62
Kindred,Sona,25,10,15,40
Kindred,Sylas,87,49,38,56.32
Kindred,Briar,36,10,26,27.78
Kindred,Elise,64,31,33,48.44
Kindred,Zyra,82,38,44,46.34
Kindred,Varus,73,32,41,43.84
Kindred,Leona,106,38,68,35.85
Kindred,Gragas,103,66,37,64.08
Kindred,Shaco,59,26,33,44.07
Kindred,Fizz,38,20,18,52.63
Kindred,Olaf,19,6,13,31.58
Kindred,Warwick,121,56,65,46.28
Kindred,Irelia,65,33,32,50.77
Kindred,Rell,53,30,23,56.6
Kindred,Ahri,129,52,77,40.31
Kindred,Zoe,39,20,19,51.28
Kindred,Vladimir,43,21,22,48.84
Kindred,Blitzcrank,71,20,51,28.17
Kindred,Alistar,53,19,34,35.85
Kindred,Mordekaiser,101,55,46,54.46
Kindred,Brand,33,16,17,48.48
Kindred,Jinx,225,90,135,40
Kindred,Skarner,36,24,12,66.67
Kindred,Soraka,35,15,20,42.86
Kindred,Lucian,67,28,39,41.79
Kindred,Nunu,64,29,35,45.31
Kindred,Thresh,156,49,107,31.41
Kindred,Aatrox,104,32,72,30.77
Kindred,Amumu,125,37,88,29.6
Kindred,Viktor,78,25,53,32.05
Kindred,Yasuo,153,64,89,41.83
Kindred,Gwen,53,23,30,43.4
Kindred,Taliyah,18,8,10,44.44
Kindred,Pantheon,165,81,84,49.09
Kindred,AurelionSol,50,29,21,58
Kindred,Corki,44,23,21,52.27
Kindred,Qiyana,20,16,4,80
Kindred,Kaisa,125,56,69,44.8
Kindred,Yorick,81,33,48,40.74
Kindred,Tristana,67,21,46,31.34
Kindred,Ekko,83,49,34,59.04
Kindred,Nidalee,12,12,0,100
Kindred,Udyr,27,19,8,70.37
Kindred,Aurora,66,27,39,40.91
Kindred,TahmKench,66,24,42,36.36
Kindred,Zed,87,18,69,20.69
Kindred,Samira,63,23,40,36.51
Kindred,Illaoi,28,12,16,42.86
Kindred,Maokai,35,9,26,25.71
Kindred,Morgana,97,34,63,35.05
Kindred,DrMundo,36,17,19,47.22
Kindred,Poppy,57,28,29,49.12
Kindred,Rengar,21,11,10,52.38
Kindred,Viego,97,32,65,32.99
Kindred,Sion,70,34,36,48.57
Kindred,Trundle,43,29,14,67.44
Kindred,Zac,31,26,5,83.87
Kindred,Kalista,37,16,21,43.24
Kindred,Renata,25,13,12,52
Kindred,Nasus,68,25,43,36.76
Kindred,Diana,144,66,78,45.83
Kindred,Akali,83,24,59,28.92
Kindred,Zilean,25,19,6,76
Kindred,MonkeyKing,42,19,23,45.24
Kindred,Naafiri,16,8,8,50
Kindred,Draven,82,29,53,35.37
Kindred,Cassiopeia,34,8,26,23.53
Kindred,Ornn,62,24,38,38.71
Kindred,Seraphine,46,23,23,50
Kindred,Nilah,33,18,15,54.55
Kindred,Katarina,57,39,18,68.42
Kindred,Janna,29,10,19,34.48
Kindred,Kayle,32,13,19,40.63
Kindred,Vex,61,26,35,42.62
Kindred,Riven,31,16,15,51.61
Kindred,Milio,48,21,27,43.75
Kindred,Jax,50,17,33,34
Kindred,Sivir,46,19,27,41.3
Kindred,Gnar,43,14,29,32.56
Kindred,Shen,77,33,44,42.86
Kindred,Ambessa,70,25,45,35.71
Kindred,Nami,102,50,52,49.02
Kindred,Ziggs,39,17,22,43.59
Kindred,Ivern,20,6,14,30
Kindred,Hecarim,37,13,24,35.14
Kindred,TwistedFate,25,14,11,56
Kindred,Pyke,90,53,37,58.89
Kindred,Renekton,47,18,29,38.3
Kindred,Sejuani,73,29,44,39.73
Kindred,Camille,31,11,20,35.48
Kindred,Azir,27,16,11,59.26
Kindred,Xayah,46,17,29,36.96
Kindred,Karthus,21,6,15,28.57
Kindred,Taric,11,8,3,72.73
Kindred,Syndra,37,14,23,37.84
Kindred,Belveth,17,2,15,11.76
Kindred,KSante,47,32,15,68.09
Kindred,Lissandra,33,23,10,69.7
Kindred,Tryndamere,27,7,20,25.93
Kindred,Swain,70,42,28,60
Kindred,XinZhao,54,27,27,50
Kindred,Twitch,80,42,38,52.5
Kindred,Yone,144,80,64,55.56
Kindred,Lillia,68,31,37,45.59
Kindred,Rakan,61,34,27,55.74
Kindred,Evelynn,20,14,6,70
Kindred,Kassadin,18,6,12,33.33
Kindred,Anivia,17,6,11,35.29
Kindred,Rammus,22,8,14,36.36
Kindred,Ryze,25,7,18,28
Kindred,Aphelios,35,17,18,48.57
Kindred,Talon,47,16,31,34.04
Kindred,Kled,21,13,8,61.9
Kindred,Rumble,39,10,29,25.64
Kindred,Shyvana,26,14,12,53.85
Kindred,Fiora,44,26,18,59.09
Kindred,KogMaw,9,0,9,0
Kindred,Gangplank,26,9,17,34.62
Kindred,Senna,45,23,22,51.11
Kindred,Bard,30,2,28,6.67
Kindred,Khazix,35,14,21,40
Kindred,Annie,14,7,7,50
Kindred,Kennen,22,3,19,13.64
Kindred,Zeri,29,7,22,24.14
Kindred,Urgot,49,20,29,40.82
Kindred,Akshan,14,4,10,28.57
Kindred,Graves,58,26,32,44.83
Kindred,RekSai,5,2,3,40
AurelionSol,Volibear,107,58,49,54.21
AurelionSol,LeeSin,121,55,66,45.45
AurelionSol,Veigar,107,48,59,44.86
AurelionSol,Vayne,98,40,58,40.82
AurelionSol,Yuumi,94,37,57,39.36
AurelionSol,Urgot,39,21,18,53.85
AurelionSol,Kayn,104,42,62,40.38
AurelionSol,Vladimir,39,22,17,56.41
AurelionSol,Kaisa,123,73,50,59.35
AurelionSol,Taric,35,17,18,48.57
AurelionSol,Alistar,33,15,18,45.45
AurelionSol,Nocturne,92,49,43,53.26
AurelionSol,Galio,97,55,42,56.7
AurelionSol,Samira,68,43,25,63.24
AurelionSol,Sion,83,47,36,56.63
AurelionSol,Ambessa,66,28,38,42.42
AurelionSol,Viktor,92,47,45,51.09
AurelionSol,Jinx,227,104,123,45.81
AurelionSol,Mel,248,141,107,56.85
AurelionSol,Illaoi,36,26,10,72.22
AurelionSol,Senna,83,55,28,66.27
AurelionSol,Darius,143,67,76,46.85
AurelionSol,Warwick,98,54,44,55.1
AurelionSol,Akali,65,38,27,58.46
AurelionSol,Morgana,73,39,34,53.42
AurelionSol,Gnar,41,28,13,68.29
AurelionSol,Amumu,108,50,58,46.3
AurelionSol,Aurora,40,31,9,77.5
AurelionSol,Tristana,66,22,44,33.33
AurelionSol,Thresh,143,69,74,48.25
AurelionSol,Teemo,77,49,28,63.64
AurelionSol,DrMundo,58,31,27,53.45
AurelionSol,KogMaw,40,17,23,42.5
AurelionSol,Maokai,46,18,28,39.13
AurelionSol,Quinn,44,36,8,81.82
AurelionSol,Naafiri,38,26,12,68.42
AurelionSol,Lux,217,119,98,54.84
AurelionSol,Varus,84,41,43,48.81
AurelionSol,Lulu,86,49,37,56.98
AurelionSol,Trundle,28,22,6,78.57
AurelionSol,Leblanc,21,9,12,42.86
AurelionSol,Nidalee,19,11,8,57.89
AurelionSol,Blitzcrank,65,42,23,64.62
AurelionSol,Ornn,61,33,28,54.1
AurelionSol,Hwei,56,41,15,73.21
AurelionSol,Jhin,139,77,62,55.4
AurelionSol,TahmKench,87,44,43,50.57
AurelionSol,JarvanIV,69,29,40,42.03
AurelionSol,Chogath,132,62,70,46.97
AurelionSol,Ezreal,165,92,73,55.76
AurelionSol,Braum,60,43,17,71.67
AurelionSol,Yone,136,68,68,50
AurelionSol,Shyvana,24,14,10,58.33
AurelionSol,Fizz,60,31,29,51.67
AurelionSol,Ekko,65,37,28,56.92
AurelionSol,Milio,62,25,37,40.32
AurelionSol,Jax,66,39,27,59.09
AurelionSol,FiddleSticks,17,12,5,70.59
AurelionSol,Yasuo,131,80,51,61.07
AurelionSol,Rakan,38,20,18,52.63
AurelionSol,Rammus,36,22,14,61.11
AurelionSol,Diana,103,43,60,41.75
AurelionSol,Caitlyn,200,106,94,53
AurelionSol,Nautilus,81,47,34,58.02
AurelionSol,Garen,119,51,68,42.86
AurelionSol,Ahri,90,45,45,50
AurelionSol,Soraka,44,22,22,50
AurelionSol,Aatrox,78,44,34,56.41
AurelionSol,Velkoz,49,35,14,71.43
AurelionSol,Vi,81,43,38,53.09
AurelionSol,Twitch,67,48,19,71.64
AurelionSol,Zilean,23,10,13,43.48
AurelionSol,XinZhao,41,19,22,46.34
AurelionSol,Kassadin,21,11,10,52.38
AurelionSol,Xayah,44,21,23,47.73
AurelionSol,Fiora,31,15,16,48.39
AurelionSol,Heimerdinger,32,16,16,50
AurelionSol,Zoe,37,19,18,51.35
AurelionSol,KSante,48,29,19,60.42
AurelionSol,Gwen,46,23,23,50
AurelionSol,Qiyana,18,7,11,38.89
AurelionSol,Karma,85,49,36,57.65
AurelionSol,Sivir,43,24,19,55.81
AurelionSol,Shaco,78,51,27,65.38
AurelionSol,Pantheon,133,81,52,60.9
AurelionSol,Kindred,50,21,29,42
AurelionSol,Katarina,61,26,35,42.62
AurelionSol,MissFortune,156,66,90,42.31
AurelionSol,Ziggs,32,14,18,43.75
AurelionSol,Talon,41,29,12,70.73
AurelionSol,Nasus,74,26,48,35.14
AurelionSol,Brand,57,28,29,49.12
AurelionSol,Olaf,22,13,9,59.09
AurelionSol,Udyr,22,17,5,77.27
AurelionSol,Khazix,43,32,11,74.42
AurelionSol,Zed,74,37,37,50
AurelionSol,Draven,36,26,10,72.22
AurelionSol,Nami,75,45,30,60
AurelionSol,Irelia,42,30,12,71.43
AurelionSol,Evelynn,28,21,7,75
AurelionSol,Riven,26,14,12,53.85
AurelionSol,Swain,85,47,38,55.29
AurelionSol,Tryndamere,33,18,15,54.55
AurelionSol,Kalista,17,8,9,47.06
AurelionSol,Ashe,148,72,76,48.65
AurelionSol,Rengar,23,12,11,52.17
AurelionSol,Syndra,52,31,21,59.62
AurelionSol,Xerath,60,24,36,40
AurelionSol,Zyra,51,27,24,52.94
AurelionSol,Sejuani,47,29,18,61.7
AurelionSol,Gragas,45,22,23,48.89
AurelionSol,Karthus,25,16,9,64
AurelionSol,Lillia,65,35,30,53.85
AurelionSol,Smolder,44,30,14,68.18
AurelionSol,Sett,116,61,55,52.59
AurelionSol,Skarner,49,24,25,48.98
AurelionSol,Seraphine,67,36,31,53.73
AurelionSol,Renata,15,9,6,60
AurelionSol,Nunu,68,41,27,60.29
AurelionSol,Briar,50,19,31,38
AurelionSol,Rell,69,38,31,55.07
AurelionSol,MasterYi,77,43,34,55.84
AurelionSol,Malphite,80,48,32,60
AurelionSol,RekSai,16,12,4,75
AurelionSol,MonkeyKing,50,32,18,64
AurelionSol,Corki,39,19,20,48.72
AurelionSol,Sona,18,5,13,27.78
AurelionSol,Malzahar,76,39,37,51.32
AurelionSol,Orianna,38,19,19,50
AurelionSol,Bard,36,17,19,47.22
AurelionSol,TwistedFate,44,22,22,50
AurelionSol,Taliyah,43,26,17,60.47
AurelionSol,Lucian,51,33,18,64.71
AurelionSol,Viego,86,41,45,47.67
AurelionSol,Lissandra,38,24,14,63.16
AurelionSol,Graves,33,11,22,33.33
AurelionSol,Leona,85,45,40,52.94
AurelionSol,Pyke,61,29,32,47.54
AurelionSol,Mordekaiser,115,54,61,46.96
AurelionSol,Camille,38,22,16,57.89
AurelionSol,Kled,19,8,11,42.11
AurelionSol,Singed,23,15,8,65.22
AurelionSol,Kayle,42,24,18,57.14
AurelionSol,Neeko,28,10,18,35.71
AurelionSol,Yorick,68,50,18,73.53
AurelionSol,Aphelios,52,31,21,59.62
AurelionSol,Shen,72,35,37,48.61
AurelionSol,Vex,15,15,0,100
AurelionSol,Annie,18,7,11,38.89
AurelionSol,Ryze,30,18,12,60
AurelionSol,Elise,66,39,27,59.09
AurelionSol,Poppy,45,24,21,53.33
AurelionSol,Janna,28,13,15,46.43
AurelionSol,Hecarim,25,8,17,32
AurelionSol,Cassiopeia,27,5,22,18.52
AurelionSol,Rumble,15,5,10,33.33
AurelionSol,Akshan,22,12,10,54.55
AurelionSol,Renekton,41,18,23,43.9
AurelionSol,Anivia,34,10,24,29.41
AurelionSol,Zeri,26,12,14,46.15
AurelionSol,Sylas,91,37,54,40.66
AurelionSol,Zac,42,23,19,54.76
AurelionSol,Nilah,34,14,20,41.18
AurelionSol,Gangplank,34,16,18,47.06
AurelionSol,Ivern,18,10,8,55.56
AurelionSol,Belveth,13,5,8,38.46
AurelionSol,Kennen,15,13,2,86.67
AurelionSol,Azir,17,15,2,88.24
AurelionSol,Jayce,45,24,21,53.33
LeeSin,Kayle,146,56,90,38.36
LeeSin,Kindred,152,85,67,55.92
LeeSin,AurelionSol,121,66,55,54.55
LeeSin,Caitlyn,922,424,498,45.99
LeeSin,Morgana,300,131,169,43.67
LeeSin,Ambessa,328,139,189,42.38
LeeSin,Diana,546,273,273,50
LeeSin,Ekko,256,119,137,46.48
LeeSin,Jinx,821,365,456,44.46
LeeSin,Lulu,514,262,252,50.97
LeeSin,Riven,145,60,85,41.38
LeeSin,MonkeyKing,278,116,162,41.73
LeeSin,Kassadin,55,26,29,47.27
LeeSin,Taliyah,97,44,53,45.36
LeeSin,Aatrox,488,275,213,56.35
LeeSin,JarvanIV,299,141,158,47.16
LeeSin,Chogath,375,158,217,42.13
LeeSin,MissFortune,617,281,336,45.54
LeeSin,Yuumi,269,132,137,49.07
LeeSin,Akali,422,221,201,52.37
LeeSin,Nunu,208,109,99,52.4
LeeSin,Lux,683,321,362,47
LeeSin,Tristana,250,118,132,47.2
LeeSin,Nautilus,434,213,221,49.08
LeeSin,Sett,523,222,301,42.45
LeeSin,Sejuani,206,72,134,34.95
LeeSin,Viktor,347,170,177,48.99
LeeSin,Gragas,374,180,194,48.13
LeeSin,MasterYi,334,145,189,43.41
LeeSin,TwistedFate,143,67,76,46.85
LeeSin,Xayah,161,78,83,48.45
LeeSin,Rakan,227,133,94,58.59
LeeSin,Sion,307,149,158,48.53
LeeSin,Rengar,105,71,34,67.62
LeeSin,Hwei,201,74,127,36.82
LeeSin,Ashe,839,392,447,46.72
LeeSin,Braum,237,78,159,32.91
LeeSin,Warwick,464,202,262,43.53
LeeSin,Vladimir,204,87,117,42.65
LeeSin,Vayne,324,156,168,48.15
LeeSin,Nami,257,113,144,43.97
LeeSin,Ezreal,1067,509,558,47.7
LeeSin,Xerath,395,168,227,42.53
LeeSin,Mordekaiser,390,194,196,49.74
LeeSin,TahmKench,262,137,125,52.29
LeeSin,Mel,649,309,340,47.61
LeeSin,Nocturne,461,196,265,42.52
LeeSin,Galio,438,208,230,47.49
LeeSin,Illaoi,152,66,86,43.42
LeeSin,Senna,210,105,105,50
LeeSin,Poppy,306,144,162,47.06
LeeSin,Khazix,198,90,108,45.45
LeeSin,Yone,653,328,325,50.23
LeeSin,Yasuo,723,336,387,46.47
LeeSin,KogMaw,81,41,40,50.62
LeeSin,Ahri,471,220,251,46.71
LeeSin,Irelia,268,129,139,48.13
LeeSin,Darius,561,229,332,40.82
LeeSin,Samira,260,137,123,52.69
LeeSin,Gnar,194,105,89,54.12
LeeSin,Belveth,68,31,37,45.59
LeeSin,KSante,248,118,130,47.58
LeeSin,Rell,223,111,112,49.78
LeeSin,Garen,486,227,259,46.71
LeeSin,Corki,140,71,69,50.71
LeeSin,Lillia,205,95,110,46.34
LeeSin,Kaisa,610,293,317,48.03
LeeSin,Pyke,312,149,163,47.76
LeeSin,Katarina,239,140,99,58.58
LeeSin,Amumu,314,116,198,36.94
LeeSin,Jhin,626,273,353,43.61
LeeSin,Nasus,163,86,77,52.76
LeeSin,Gangplank,192,106,86,55.21
LeeSin,Vi,536,261,275,48.69
LeeSin,Sylas,671,318,353,47.39
LeeSin,Karthus,96,44,52,45.83
LeeSin,Annie,119,58,61,48.74
LeeSin,Zoe,161,85,76,52.8
LeeSin,Aurora,311,159,152,51.13
LeeSin,Viego,561,275,286,49.02
LeeSin,Leona,435,200,235,45.98
LeeSin,DrMundo,161,66,95,40.99
LeeSin,Kayn,370,186,184,50.27
LeeSin,Zeri,185,89,96,48.11
LeeSin,Velkoz,214,90,124,42.06
LeeSin,Urgot,128,44,84,34.38
LeeSin,Zac,213,112,101,52.58
LeeSin,Varus,379,193,186,50.92
LeeSin,Rammus,139,73,66,52.52
LeeSin,Karma,466,225,241,48.28
LeeSin,Pantheon,617,294,323,47.65
LeeSin,Malzahar,319,146,173,45.77
LeeSin,Ivern,65,41,24,63.08
LeeSin,Anivia,137,69,68,50.36
LeeSin,Thresh,685,346,339,50.51
LeeSin,Malphite,333,194,139,58.26
LeeSin,Nidalee,214,115,99,53.74
LeeSin,Veigar,268,142,126,52.99
LeeSin,Skarner,213,117,96,54.93
LeeSin,Renekton,201,85,116,42.29
LeeSin,Udyr,121,53,68,43.8
LeeSin,Smolder,239,110,129,46.03
LeeSin,Heimerdinger,121,42,79,34.71
LeeSin,Jax,279,149,130,53.41
LeeSin,Evelynn,87,49,38,56.32
LeeSin,Seraphine,269,123,146,45.72
LeeSin,Teemo,292,148,144,50.68
LeeSin,Lucian,321,147,174,45.79
LeeSin,Ornn,252,116,136,46.03
LeeSin,Graves,372,172,200,46.24
LeeSin,Leblanc,264,134,130,50.76
LeeSin,Syndra,243,86,157,35.39
LeeSin,Swain,246,83,163,33.74
LeeSin,Shaco,278,102,176,36.69
LeeSin,Milio,183,79,104,43.17
LeeSin,Orianna,195,81,114,41.54
LeeSin,Naafiri,116,54,62,46.55
LeeSin,Zyra,301,138,163,45.85
LeeSin,XinZhao,296,149,147,50.34
LeeSin,Sivir,194,96,98,49.48
LeeSin,Lissandra,132,73,59,55.3
LeeSin,Soraka,115,62,53,53.91
LeeSin,Rumble,158,72,86,45.57
LeeSin,Quinn,119,61,58,51.26
LeeSin,Nilah,108,47,61,43.52
LeeSin,Jayce,253,114,139,45.06
LeeSin,Kled,82,36,46,43.9
LeeSin,Shen,234,82,152,35.04
LeeSin,Tryndamere,141,64,77,45.39
LeeSin,Alistar,229,100,129,43.67
LeeSin,Fiora,127,68,59,53.54
LeeSin,Vex,212,100,112,47.17
LeeSin,Singed,86,46,40,53.49
LeeSin,Fizz,134,84,50,62.69
LeeSin,Kalista,130,71,59,54.62
LeeSin,Yorick,174,89,85,51.15
LeeSin,RekSai,50,21,29,42
LeeSin,Neeko,191,90,101,47.12
LeeSin,Zed,341,170,171,49.85
LeeSin,Gwen,154,84,70,54.55
LeeSin,Blitzcrank,364,181,183,49.73
LeeSin,Talon,271,110,161,40.59
LeeSin,Maokai,143,73,70,51.05
LeeSin,Kennen,127,62,65,48.82
LeeSin,Ryze,162,88,74,54.32
LeeSin,Elise,328,152,176,46.34
LeeSin,Volibear,298,131,167,43.96
LeeSin,Bard,95,53,42,55.79
LeeSin,Renata,98,49,49,50
LeeSin,Qiyana,75,32,43,42.67
LeeSin,Sona,47,22,25,46.81
LeeSin,Trundle,131,73,58,55.73
LeeSin,Zilean,68,32,36,47.06
LeeSin,Twitch,205,104,101,50.73
LeeSin,Taric,49,10,39,20.41
LeeSin,Janna,88,31,57,35.23
LeeSin,Ziggs,141,85,56,60.28
LeeSin,Azir,161,79,82,49.07
LeeSin,FiddleSticks,126,60,66,47.62
LeeSin,Draven,156,76,80,48.72
LeeSin,Brand,130,66,64,50.77
LeeSin,Hecarim,147,73,74,49.66
LeeSin,Olaf,84,38,46,45.24
LeeSin,Briar,195,69,126,35.38
LeeSin,Camille,154,67,87,43.51
LeeSin,Akshan,65,36,29,55.38
LeeSin,Cassiopeia,100,41,59,41
LeeSin,Aphelios,180,63,117,35
LeeSin,Shyvana,62,36,26,58.06
Elise,Ornn,88,51,37,57.95
Elise,Lillia,113,43,70,38.05
Elise,Zed,183,105,78,57.38
Elise,Tristana,138,71,67,51.45
Elise,Nami,144,57,87,39.58
Elise,Poppy,124,62,62,50
Elise,Zac,128,66,62,51.56
Elise,Malzahar,118,40,78,33.9
Elise,MissFortune,324,144,180,44.44
Elise,TahmKench,148,81,67,54.73
Elise,Twitch,113,64,49,56.64
Elise,Katarina,93,54,39,58.06
Elise,Vayne,191,80,111,41.88
Elise,Blitzcrank,183,89,94,48.63
Elise,Braum,137,55,82,40.15
Elise,MasterYi,141,77,64,54.61
Elise,Karma,212,81,131,38.21
Elise,Ashe,317,149,168,47
Elise,Yorick,101,48,53,47.52
Elise,Graves,111,50,61,45.05
Elise,Naafiri,26,12,14,46.15
Elise,Caitlyn,367,201,166,54.77
Elise,Morgana,138,61,77,44.2
Elise,Sett,260,109,151,41.92
Elise,Jax,141,66,75,46.81
Elise,Irelia,91,48,43,52.75
Elise,Jhin,297,156,141,52.53
Elise,Yuumi,104,50,54,48.08
Elise,Pantheon,282,153,129,54.26
Elise,Kayn,200,95,105,47.5
Elise,Ahri,206,93,113,45.15
Elise,Brand,92,66,26,71.74
Elise,Gnar,126,76,50,60.32
Elise,Sejuani,96,46,50,47.92
Elise,Varus,160,81,79,50.63
Elise,Thresh,270,134,136,49.63
Elise,JarvanIV,115,70,45,60.87
Elise,Rumble,69,44,25,63.77
Elise,Galio,245,89,156,36.33
Elise,Lulu,274,136,138,49.64
Elise,Riven,88,51,37,57.95
Elise,Vladimir,113,67,46,59.29
Elise,Ziggs,88,40,48,45.45
Elise,Aurora,146,60,86,41.1
Elise,Ezreal,465,253,212,54.41
Elise,Anivia,75,27,48,36
Elise,Nunu,83,48,35,57.83
Elise,Darius,264,123,141,46.59
Elise,Lux,316,203,113,64.24
Elise,Malphite,170,103,67,60.59
Elise,Kindred,64,33,31,51.56
Elise,Akshan,52,16,36,30.77
Elise,Gwen,46,15,31,32.61
Elise,XinZhao,142,70,72,49.3
Elise,Sion,154,63,91,40.91
Elise,Trundle,58,35,23,60.34
Elise,Mel,310,167,143,53.87
Elise,Kaisa,265,143,122,53.96
Elise,Janna,61,27,34,44.26
Elise,Kled,25,8,17,32
Elise,Briar,82,46,36,56.1
Elise,Velkoz,117,70,47,59.83
Elise,Rammus,48,24,24,50
Elise,Yone,316,150,166,47.47
Elise,Zeri,62,16,46,25.81
Elise,Xerath,172,83,89,48.26
Elise,Shaco,145,64,81,44.14
Elise,Gangplank,91,56,35,61.54
Elise,Nautilus,176,88,88,50
Elise,Volibear,160,69,91,43.13
Elise,Sylas,255,144,111,56.47
Elise,Amumu,176,85,91,48.3
Elise,Teemo,132,59,73,44.7
Elise,Milio,111,49,62,44.14
Elise,Hecarim,70,29,41,41.43
Elise,Ambessa,154,80,74,51.95
Elise,Skarner,93,53,40,56.99
Elise,Fizz,79,47,32,59.49
Elise,Chogath,218,103,115,47.25
Elise,MonkeyKing,119,50,69,42.02
Elise,Syndra,134,90,44,67.16
Elise,TwistedFate,47,25,22,53.19
Elise,Ryze,93,35,58,37.63
Elise,Jinx,389,159,230,40.87
Elise,Urgot,96,52,44,54.17
Elise,Xayah,119,75,44,63.03
Elise,Alistar,75,25,50,33.33
Elise,Ekko,141,70,71,49.65
Elise,Swain,161,87,74,54.04
Elise,Rengar,39,19,20,48.72
Elise,KSante,118,66,52,55.93
Elise,Kassadin,47,21,26,44.68
Elise,Samira,94,53,41,56.38
Elise,Viego,264,135,129,51.14
Elise,Akali,166,79,87,47.59
Elise,Illaoi,83,43,40,51.81
Elise,Leblanc,91,48,43,52.75
Elise,Soraka,93,42,51,45.16
Elise,Warwick,167,88,79,52.69
Elise,Taric,22,13,9,59.09
Elise,Gragas,123,60,63,48.78
Elise,Kalista,58,25,33,43.1
Elise,Rakan,108,48,60,44.44
Elise,Nilah,75,35,40,46.67
Elise,Shen,135,52,83,38.52
Elise,Neeko,91,37,54,40.66
Elise,Lucian,133,87,46,65.41
Elise,LeeSin,328,176,152,53.66
Elise,Sona,35,15,20,42.86
Elise,Aatrox,142,75,67,52.82
Elise,Draven,58,27,31,46.55
Elise,Nocturne,197,100,97,50.76
Elise,Vi,163,86,77,52.76
Elise,Diana,235,120,115,51.06
Elise,Orianna,73,28,45,38.36
Elise,Rell,99,49,50,49.49
Elise,Renekton,105,55,50,52.38
Elise,Talon,119,74,45,62.18
Elise,Garen,225,89,136,39.56
Elise,Nidalee,64,30,34,46.88
Elise,DrMundo,89,54,35,60.67
Elise,Seraphine,106,55,51,51.89
Elise,Olaf,39,21,18,53.85
Elise,Yasuo,290,146,144,50.34
Elise,Cassiopeia,57,39,18,68.42
Elise,Leona,158,94,64,59.49
Elise,Fiora,102,35,67,34.31
Elise,Veigar,118,55,63,46.61
Elise,Taliyah,55,33,22,60
Elise,Mordekaiser,180,106,74,58.89
Elise,Ivern,26,12,14,46.15
Elise,Jayce,95,50,45,52.63
Elise,Annie,50,26,24,52
Elise,Viktor,165,79,86,47.88
Elise,Zilean,53,22,31,41.51
Elise,Smolder,83,52,31,62.65
Elise,Zyra,126,50,76,39.68
Elise,Corki,105,55,50,52.38
Elise,Maokai,97,39,58,40.21
Elise,FiddleSticks,66,21,45,31.82
Elise,Pyke,165,86,79,52.12
Elise,Nasus,87,55,32,63.22
Elise,Lissandra,88,43,45,48.86
Elise,Udyr,69,38,31,55.07
Elise,KogMaw,55,33,22,60
Elise,Evelynn,45,11,34,24.44
Elise,Bard,58,32,26,55.17
Elise,Vex,90,43,47,47.78
Elise,Belveth,33,18,15,54.55
Elise,Quinn,44,7,37,15.91
Elise,Heimerdinger,64,14,50,21.88
Elise,Aphelios,88,36,52,40.91
Elise,Kayle,68,27,41,39.71
Elise,Hwei,97,56,41,57.73
Elise,Renata,43,19,24,44.19
Elise,Khazix,72,35,37,48.61
Elise,Tryndamere,32,23,9,71.88
Elise,Zoe,96,49,47,51.04
Elise,Sivir,107,40,67,37.38
Elise,AurelionSol,66,27,39,40.91
Elise,Karthus,35,14,21,40
Elise,Shyvana,37,17,20,45.95
Elise,Qiyana,26,17,9,65.38
Elise,Senna,76,38,38,50
Elise,Azir,78,42,36,53.85
Elise,Singed,32,13,19,40.63
Elise,Kennen,43,26,17,60.47
Elise,RekSai,18,3,15,16.67
Elise,Camille,36,11,25,30.56
Malzahar,Ornn,98,40,58,40.82
Malzahar,Lillia,116,51,65,43.97
Malzahar,Zed,226,110,116,48.67
Malzahar,Tristana,218,128,90,58.72
Malzahar,Nami,214,83,131,38.79
Malzahar,DrMundo,129,69,60,53.49
Malzahar,Sejuani,137,93,44,67.88
Malzahar,Veigar,269,144,125,53.53
Malzahar,Jinx,539,244,295,45.27
Malzahar,Garen,338,149,189,44.08
Malzahar,Shyvana,57,26,31,45.61
Malzahar,Lissandra,54,25,29,46.3
Malzahar,Lux,510,313,197,61.37
Malzahar,Gragas,164,102,62,62.2
Malzahar,Elise,118,78,40,66.1
Malzahar,Mel,428,245,183,57.24
Malzahar,Vayne,263,151,112,57.41
Malzahar,Zyra,160,97,63,60.63
Malzahar,Gangplank,76,43,33,56.58
Malzahar,FiddleSticks,86,46,40,53.49
Malzahar,Ezreal,468,244,224,52.14
Malzahar,Riven,100,37,63,37
Malzahar,Karthus,58,33,25,56.9
Malzahar,Lucian,125,52,73,41.6
Malzahar,Illaoi,84,41,43,48.81
Malzahar,Pantheon,326,176,150,53.99
Malzahar,Vex,143,79,64,55.24
Malzahar,Braum,209,94,115,44.98
Malzahar,Teemo,177,79,98,44.63
Malzahar,Aurora,156,78,78,50
Malzahar,Amumu,229,113,116,49.34
Malzahar,MissFortune,440,218,222,49.55
Malzahar,Rakan,133,69,64,51.88
Malzahar,Kayle,125,53,72,42.4
Malzahar,Evelynn,67,35,32,52.24
Malzahar,Vladimir,136,75,61,55.15
Malzahar,Kaisa,305,163,142,53.44
Malzahar,Maokai,120,46,74,38.33
Malzahar,Cassiopeia,53,26,27,49.06
Malzahar,Yone,297,149,148,50.17
Malzahar,Ashe,409,208,201,50.86
Malzahar,TahmKench,241,113,128,46.89
Malzahar,Lulu,268,140,128,52.24
Malzahar,Jax,168,91,77,54.17
Malzahar,Yasuo,390,182,208,46.67
Malzahar,Chogath,284,137,147,48.24
Malzahar,KSante,115,69,46,60
Malzahar,Zac,141,61,80,43.26
Malzahar,Annie,65,37,28,56.92
Malzahar,Malphite,242,99,143,40.91
Malzahar,Kindred,99,55,44,55.56
Malzahar,Quinn,77,28,49,36.36
Malzahar,Nautilus,309,181,128,58.58
Malzahar,Khazix,93,50,43,53.76
Malzahar,Akali,149,82,67,55.03
Malzahar,Milio,128,51,77,39.84
Malzahar,Nasus,119,61,58,51.26
Malzahar,MasterYi,196,108,88,55.1
Malzahar,Anivia,56,34,22,60.71
Malzahar,Yuumi,104,55,49,52.88
Malzahar,Shaco,156,93,63,59.62
Malzahar,Fizz,113,71,42,62.83
Malzahar,Aphelios,137,54,83,39.42
Malzahar,Soraka,89,39,50,43.82
Malzahar,Mordekaiser,259,110,149,42.47
Malzahar,Kayn,253,140,113,55.34
Malzahar,Ziggs,86,42,44,48.84
Malzahar,XinZhao,148,72,76,48.65
Malzahar,Azir,118,43,75,36.44
Malzahar,Rell,163,81,82,49.69
Malzahar,Trundle,136,79,57,58.09
Malzahar,Katarina,120,64,56,53.33
Malzahar,Zoe,100,53,47,53
Malzahar,Ambessa,150,73,77,48.67
Malzahar,Udyr,71,40,31,56.34
Malzahar,Syndra,158,77,81,48.73
Malzahar,Corki,95,46,49,48.42
Malzahar,Alistar,105,61,44,58.1
Malzahar,Akshan,81,46,35,56.79
Malzahar,MonkeyKing,153,83,70,54.25
Malzahar,Kassadin,32,12,20,37.5
Malzahar,Karma,221,114,107,51.58
Malzahar,Aatrox,211,106,105,50.24
Malzahar,Ekko,171,83,88,48.54
Malzahar,Nilah,92,45,47,48.91
Malzahar,Ahri,247,120,127,48.58
Malzahar,Zeri,94,48,46,51.06
Malzahar,Velkoz,127,74,53,58.27
Malzahar,Renekton,129,78,51,60.47
Malzahar,Darius,366,180,186,49.18
Malzahar,Poppy,127,66,61,51.97
Malzahar,Xayah,127,62,65,48.82
Malzahar,LeeSin,319,173,146,54.23
Malzahar,Sylas,241,125,116,51.87
Malzahar,Xerath,179,88,91,49.16
Malzahar,Smolder,187,101,86,54.01
Malzahar,Swain,211,93,118,44.08
Malzahar,Gwen,119,67,52,56.3
Malzahar,Hecarim,51,22,29,43.14
Malzahar,Ryze,87,49,38,56.32
Malzahar,Sett,292,159,133,54.45
Malzahar,Leblanc,110,71,39,64.55
Malzahar,Caitlyn,546,289,257,52.93
Malzahar,Morgana,228,115,113,50.44
Malzahar,Diana,305,137,168,44.92
Malzahar,Yorick,177,86,91,48.59
Malzahar,Orianna,83,39,44,46.99
Malzahar,Talon,98,56,42,57.14
Malzahar,Nidalee,67,42,25,62.69
Malzahar,Samira,172,88,84,51.16
Malzahar,Jhin,385,198,187,51.43
Malzahar,Thresh,376,181,195,48.14
Malzahar,Gnar,80,45,35,56.25
Malzahar,Sion,210,102,108,48.57
Malzahar,Neeko,98,57,41,58.16
Malzahar,Galio,250,119,131,47.6
Malzahar,Shen,165,74,91,44.85
Malzahar,Draven,84,37,47,44.05
Malzahar,Tryndamere,68,40,28,58.82
Malzahar,Sivir,110,60,50,54.55
Malzahar,Janna,60,30,30,50
Malzahar,Varus,204,127,77,62.25
Malzahar,Brand,128,54,74,42.19
Malzahar,Camille,65,24,41,36.92
Malzahar,Rengar,56,16,40,28.57
Malzahar,TwistedFate,74,33,41,44.59
Malzahar,Qiyana,41,21,20,51.22
Malzahar,KogMaw,86,39,47,45.35
Malzahar,Rammus,73,43,30,58.9
Malzahar,Kled,38,15,23,39.47
Malzahar,Nocturne,265,111,154,41.89
Malzahar,Volibear,225,98,127,43.56
Malzahar,Viego,224,126,98,56.25
Malzahar,Irelia,160,87,73,54.38
Malzahar,Hwei,160,90,70,56.25
Malzahar,Leona,207,105,102,50.72
Malzahar,Sona,26,11,15,42.31
Malzahar,Briar,99,37,62,37.37
Malzahar,Naafiri,74,30,44,40.54
Malzahar,Warwick,273,131,142,47.99
Malzahar,Singed,51,21,30,41.18
Malzahar,Kalista,63,40,23,63.49
Malzahar,JarvanIV,151,74,77,49.01
Malzahar,Nunu,126,69,57,54.76
Malzahar,Jayce,80,47,33,58.75
Malzahar,Rumble,60,30,30,50
Malzahar,Ivern,62,37,25,59.68
Malzahar,Vi,198,100,98,50.51
Malzahar,Belveth,38,27,11,71.05
Malzahar,Seraphine,139,77,62,55.4
Malzahar,Urgot,117,63,54,53.85
Malzahar,Blitzcrank,154,87,67,56.49
Malzahar,Twitch,159,80,79,50.31
Malzahar,Renata,46,22,24,47.83
Malzahar,Fiora,68,37,31,54.41
Malzahar,Viktor,185,78,107,42.16
Malzahar,Pyke,165,100,65,60.61
Malzahar,Skarner,86,47,39,54.65
Malzahar,Taliyah,59,23,36,38.98
Malzahar,AurelionSol,76,37,39,48.68
Malzahar,Senna,123,76,47,61.79
Malzahar,Heimerdinger,90,47,43,52.22
Malzahar,Zilean,65,16,49,24.62
Malzahar,Bard,76,44,32,57.89
Malzahar,Graves,121,67,54,55.37
Malzahar,Kennen,51,27,24,52.94
Malzahar,Olaf,64,35,29,54.69
Malzahar,Taric,33,19,14,57.58
Malzahar,RekSai,39,13,26,33.33
Milio,Ornn,95,44,51,46.32
Milio,Lillia,78,33,45,42.31
Milio,Zed,160,91,69,56.88
Milio,Tristana,126,77,49,61.11
Milio,Nami,227,110,117,48.46
Milio,Aatrox,130,68,62,52.31
Milio,MasterYi,126,79,47,62.7
Milio,TwistedFate,40,22,18,55
Milio,Varus,111,60,51,54.05
Milio,Lux,282,153,129,54.26
Milio,Urgot,57,32,25,56.14
Milio,Kayn,182,109,73,59.89
Milio,Vladimir,87,62,25,71.26
Milio,Kaisa,172,96,76,55.81
Milio,Taric,32,14,18,43.75
Milio,Olaf,40,23,17,57.5
Milio,Viego,161,91,70,56.52
Milio,Ryze,65,41,24,63.08
Milio,Jhin,276,163,113,59.06
Milio,Soraka,65,38,27,58.46
Milio,Shen,118,59,59,50
Milio,Katarina,96,52,44,54.17
Milio,Karma,190,93,97,48.95
Milio,Gragas,115,59,56,51.3
Milio,Xayah,78,38,40,48.72
Milio,Lucian,117,63,54,53.85
Milio,Rell,107,60,47,56.07
Milio,Darius,210,129,81,61.43
Milio,Graves,94,46,48,48.94
Milio,Neeko,50,21,29,42
Milio,Draven,63,51,12,80.95
Milio,Alistar,66,29,37,43.94
Milio,TahmKench,120,75,45,62.5
Milio,Rengar,40,19,21,47.5
Milio,Yone,183,87,96,47.54
Milio,Chogath,152,60,92,39.47
Milio,Zyra,96,53,43,55.21
Milio,Teemo,136,60,76,44.12
Milio,Aurora,95,50,45,52.63
Milio,Sivir,67,38,29,56.72
Milio,Blitzcrank,129,47,82,36.43
Milio,Ezreal,291,139,152,47.77
Milio,Warwick,190,89,101,46.84
Milio,Xerath,120,69,51,57.5
Milio,Mordekaiser,140,57,83,40.71
Milio,Vi,122,68,54,55.74
Milio,Vayne,178,64,114,35.96
Milio,Yuumi,142,68,74,47.89
Milio,Malzahar,128,77,51,60.16
Milio,Ashe,270,162,108,60
Milio,Gwen,61,45,16,73.77
Milio,Sett,150,86,64,57.33
Milio,Jax,112,72,40,64.29
Milio,Irelia,87,39,48,44.83
Milio,Akali,109,60,49,55.05
Milio,Sion,123,61,62,49.59
Milio,Veigar,102,56,46,54.9
Milio,Samira,120,59,61,49.17
Milio,Swain,153,70,83,45.75
Milio,Amumu,167,68,99,40.72
Milio,Vex,53,27,26,50.94
Milio,Caitlyn,337,180,157,53.41
Milio,Brand,71,43,28,60.56
Milio,DrMundo,89,60,29,67.42
Milio,Yasuo,251,137,114,54.58
Milio,Garen,223,106,117,47.53
Milio,Trundle,76,37,39,48.68
Milio,Zoe,75,46,29,61.33
Milio,Maokai,47,33,14,70.21
Milio,Zeri,87,45,42,51.72
Milio,Singed,38,16,22,42.11
Milio,Lissandra,64,40,24,62.5
Milio,MonkeyKing,85,45,40,52.94
Milio,Gangplank,61,42,19,68.85
Milio,Riven,73,32,41,43.84
Milio,Seraphine,123,73,50,59.35
Milio,Hwei,97,47,50,48.45
Milio,Shaco,127,62,65,48.82
Milio,Nasus,81,44,37,54.32
Milio,Nunu,74,34,40,45.95
Milio,Jinx,323,149,174,46.13
Milio,Morgana,144,75,69,52.08
Milio,Poppy,81,40,41,49.38
Milio,Lulu,271,149,122,54.98
Milio,Diana,171,90,81,52.63
Milio,FiddleSticks,53,23,30,43.4
Milio,Smolder,90,38,52,42.22
Milio,Senna,115,63,52,54.78
Milio,Yorick,107,54,53,50.47
Milio,Briar,68,29,39,42.65
Milio,Mel,281,147,134,52.31
Milio,Nautilus,183,90,93,49.18
Milio,LeeSin,183,104,79,56.83
Milio,Quinn,62,34,28,54.84
Milio,Elise,111,62,49,55.86
Milio,AurelionSol,62,37,25,59.68
Milio,Khazix,70,29,41,41.43
Milio,Sona,35,15,20,42.86
Milio,Rakan,73,40,33,54.79
Milio,Thresh,229,131,98,57.21
Milio,MissFortune,260,143,117,55
Milio,Volibear,127,64,63,50.39
Milio,Ekko,119,70,49,58.82
Milio,Ahri,176,70,106,39.77
Milio,Janna,42,15,27,35.71
Milio,Renekton,70,32,38,45.71
Milio,Leona,104,64,40,61.54
Milio,Jayce,67,41,26,61.19
Milio,Sylas,162,95,67,58.64
Milio,Galio,118,71,47,60.17
Milio,Udyr,64,43,21,67.19
Milio,Pantheon,232,115,117,49.57
Milio,Naafiri,43,21,22,48.84
Milio,Gnar,69,45,24,65.22
Milio,KogMaw,48,20,28,41.67
Milio,Orianna,53,22,31,41.51
Milio,Rumble,36,14,22,38.89
Milio,Kassadin,35,17,18,48.57
Milio,Zilean,40,20,20,50
Milio,Fizz,69,43,26,62.32
Milio,Illaoi,55,21,34,38.18
Milio,Talon,64,33,31,51.56
Milio,Qiyana,35,19,16,54.29
Milio,Viktor,135,56,79,41.48
Milio,Camille,61,25,36,40.98
Milio,Cassiopeia,43,20,23,46.51
Milio,XinZhao,61,35,26,57.38
Milio,Velkoz,45,15,30,33.33
Milio,JarvanIV,132,86,46,65.15
Milio,Twitch,112,69,43,61.61
Milio,Braum,90,41,49,45.56
Milio,Corki,83,40,43,48.19
Milio,Azir,55,17,38,30.91
Milio,Evelynn,42,18,24,42.86
Milio,Malphite,133,64,69,48.12
Milio,Tryndamere,76,51,25,67.11
Milio,Syndra,129,55,74,42.64
Milio,Fiora,42,25,17,59.52
Milio,Nocturne,104,56,48,53.85
Milio,Aphelios,59,21,38,35.59
Milio,Ambessa,109,73,36,66.97
Milio,Belveth,36,19,17,52.78
Milio,Heimerdinger,32,13,19,40.63
Milio,Shyvana,26,9,17,34.62
Milio,Skarner,79,43,36,54.43
Milio,Ziggs,40,20,20,50
Milio,Sejuani,93,56,37,60.22
Milio,Renata,33,19,14,57.58
Milio,Bard,62,35,27,56.45
Milio,Leblanc,44,24,20,54.55
Milio,Kalista,55,29,26,52.73
Milio,Karthus,36,17,19,47.22
Milio,Taliyah,50,23,27,46
Milio,Pyke,80,53,27,66.25
Milio,Kindred,48,27,21,56.25
Milio,Kayle,86,43,43,50
Milio,RekSai,27,10,17,37.04
Milio,Rammus,34,15,19,44.12
Milio,Hecarim,46,23,23,50
Milio,KSante,59,23,36,38.98
Milio,Zac,80,32,48,40
Milio,Annie,27,11,16,40.74
Milio,Kled,17,6,11,35.29
Milio,Nidalee,44,22,22,50
Milio,Akshan,37,22,15,59.46
Milio,Kennen,50,31,19,62
Milio,Nilah,31,16,15,51.61
Milio,Ivern,33,25,8,75.76
Milio,Anivia,38,22,16,57.89
Ornn,Volibear,136,48,88,35.29
Ornn,Elise,88,37,51,42.05
Ornn,Malzahar,98,58,40,59.18
Ornn,Caitlyn,283,124,159,43.82
Ornn,Milio,95,51,44,53.68
Ornn,Quinn,32,8,24,25
Ornn,MasterYi,128,61,67,47.66
Ornn,Garen,182,107,75,58.79
Ornn,Smolder,80,44,36,55
Ornn,Nautilus,157,84,73,53.5
Ornn,Ambessa,112,56,56,50
Ornn,Gwen,99,56,43,56.57
Ornn,Vladimir,92,54,38,58.7
Ornn,Twitch,92,39,53,42.39
Ornn,Lulu,154,86,68,55.84
Ornn,DrMundo,90,50,40,55.56
Ornn,Thresh,171,101,70,59.06
Ornn,Vayne,177,87,90,49.15
Ornn,Zyra,97,48,49,49.48
Ornn,Orianna,57,36,21,63.16
Ornn,Jinx,289,134,155,46.37
Ornn,Velkoz,87,40,47,45.98
Ornn,Teemo,98,47,51,47.96
Ornn,Rumble,47,23,24,48.94
Ornn,Zoe,52,34,18,65.38
Ornn,Jhin,221,114,107,51.58
Ornn,Morgana,116,53,63,45.69
Ornn,XinZhao,97,48,49,49.48
Ornn,Hecarim,48,29,19,60.42
Ornn,Aurora,105,40,65,38.1
Ornn,Sivir,54,25,29,46.3
Ornn,Soraka,56,38,18,67.86
Ornn,Aatrox,118,61,57,51.69
Ornn,Gragas,119,58,61,48.74
Ornn,Yasuo,242,134,108,55.37
Ornn,Ashe,263,151,112,57.41
Ornn,Rell,101,49,52,48.51
Ornn,Viktor,99,44,55,44.44
Ornn,Vi,152,76,76,50
Ornn,Akali,131,70,61,53.44
Ornn,Kled,39,17,22,43.59
Ornn,Pyke,114,62,52,54.39
Ornn,Riven,43,13,30,30.23
Ornn,Rammus,36,14,22,38.89
Ornn,Yone,209,94,115,44.98
Ornn,Zeri,54,29,25,53.7
Ornn,Xerath,98,50,48,51.02
Ornn,Sett,149,61,88,40.94
Ornn,Skarner,61,39,22,63.93
Ornn,AurelionSol,61,28,33,45.9
Ornn,Karma,128,79,49,61.72
Ornn,Fiora,66,33,33,50
Ornn,Diana,158,78,80,49.37
Ornn,Kaisa,202,114,88,56.44
Ornn,Yuumi,96,52,44,54.17
Ornn,Tristana,119,72,47,60.5
Ornn,LeeSin,252,136,116,53.97
Ornn,Ahri,164,88,76,53.66
Ornn,KogMaw,49,31,18,63.27
Ornn,Swain,106,39,67,36.79
Ornn,Viego,169,105,64,62.13
Ornn,Qiyana,24,13,11,54.17
Ornn,Lux,315,175,140,55.56
Ornn,Hwei,59,34,25,57.63
Ornn,Blitzcrank,126,62,64,49.21
Ornn,Kayn,161,70,91,43.48
Ornn,Rengar,39,22,17,56.41
Ornn,Varus,130,62,68,47.69
Ornn,Janna,45,21,24,46.67
Ornn,Sejuani,69,34,35,49.28
Ornn,Galio,148,90,58,60.81
Ornn,Urgot,59,35,24,59.32
Ornn,Lillia,59,29,30,49.15
Ornn,Zed,133,65,68,48.87
Ornn,MissFortune,239,106,133,44.35
Ornn,Kayle,79,34,45,43.04
Ornn,Nocturne,140,76,64,54.29
Ornn,Mel,231,102,129,44.16
Ornn,Chogath,168,69,99,41.07
Ornn,Amumu,140,62,78,44.29
Ornn,Tryndamere,25,13,12,52
Ornn,Ekko,86,46,40,53.49
Ornn,KSante,67,37,30,55.22
Ornn,Graves,99,56,43,56.57
Ornn,Kassadin,32,7,25,21.88
Ornn,Samira,110,49,61,44.55
Ornn,Darius,185,83,102,44.86
Ornn,Sylas,218,129,89,59.17
Ornn,Camille,53,33,20,62.26
Ornn,Mordekaiser,193,110,83,56.99
Ornn,Ryze,55,27,28,49.09
Ornn,JarvanIV,99,41,58,41.41
Ornn,Jax,77,38,39,49.35
Ornn,Maokai,81,35,46,43.21
Ornn,Taric,29,19,10,65.52
Ornn,Ezreal,262,140,122,53.44
Ornn,TahmKench,102,48,54,47.06
Ornn,Malphite,160,95,65,59.38
Ornn,Katarina,108,57,51,52.78
Ornn,Sona,30,13,17,43.33
Ornn,Warwick,124,45,79,36.29
Ornn,Irelia,70,32,38,45.71
Ornn,Yorick,90,34,56,37.78
Ornn,Neeko,62,34,28,54.84
Ornn,MonkeyKing,103,45,58,43.69
Ornn,Lissandra,29,15,14,51.72
Ornn,Bard,57,29,28,50.88
Ornn,Brand,58,35,23,60.34
Ornn,Ziggs,43,13,30,30.23
Ornn,Aphelios,77,27,50,35.06
Ornn,Shyvana,28,13,15,46.43
Ornn,Briar,49,12,37,24.49
Ornn,Alistar,48,30,18,62.5
Ornn,Corki,75,34,41,45.33
Ornn,Rakan,105,43,62,40.95
Ornn,Anivia,68,24,44,35.29
Ornn,Lucian,105,57,48,54.29
Ornn,Braum,119,51,68,42.86
Ornn,Sion,95,49,46,51.58
Ornn,Leblanc,68,35,33,51.47
Ornn,Xayah,68,26,42,38.24
Ornn,Kindred,62,38,24,61.29
Ornn,Renekton,61,33,28,54.1
Ornn,Cassiopeia,34,17,17,50
Ornn,Leona,115,56,59,48.7
Ornn,Nunu,76,46,30,60.53
Ornn,Seraphine,75,30,45,40
Ornn,Illaoi,86,39,47,45.35
Ornn,Shaco,84,43,41,51.19
Ornn,Udyr,47,36,11,76.6
Ornn,Heimerdinger,45,24,21,53.33
Ornn,Pantheon,221,114,107,51.58
Ornn,Veigar,97,47,50,48.45
Ornn,Draven,50,33,17,66
Ornn,Trundle,59,35,24,59.32
Ornn,Fizz,46,18,28,39.13
Ornn,Belveth,28,11,17,39.29
Ornn,Gangplank,48,30,18,62.5
Ornn,Nami,105,34,71,32.38
Ornn,Talon,66,35,31,53.03
Ornn,Syndra,80,33,47,41.25
Ornn,Senna,92,28,64,30.43
Ornn,Ivern,17,8,9,47.06
Ornn,Zac,68,41,27,60.29
Ornn,FiddleSticks,52,34,18,65.38
Ornn,Azir,60,34,26,56.67
Ornn,Vex,57,24,33,42.11
Ornn,Nilah,29,17,12,58.62
Ornn,Poppy,74,37,37,50
Ornn,Singed,34,12,22,35.29
Ornn,Shen,100,50,50,50
Ornn,Renata,35,23,12,65.71
Ornn,Naafiri,17,10,7,58.82
Ornn,Gnar,60,36,24,60
Ornn,Nidalee,44,26,18,59.09
Ornn,Evelynn,39,19,20,48.72
Ornn,Nasus,69,34,35,49.28
Ornn,Jayce,56,32,24,57.14
Ornn,Akshan,39,18,21,46.15
Ornn,Taliyah,30,14,16,46.67
Ornn,Zilean,24,13,11,54.17
Ornn,Khazix,40,14,26,35
Ornn,Kalista,55,37,18,67.27
Ornn,Kennen,45,33,12,73.33
Ornn,Annie,54,27,27,50
Ornn,Olaf,31,5,26,16.13
Ornn,TwistedFate,44,19,25,43.18
Ornn,Karthus,24,13,11,54.17
Ornn,RekSai,17,8,9,47.06
Tristana,Volibear,210,109,101,51.9
Tristana,Elise,138,67,71,48.55
Tristana,Malzahar,218,90,128,41.28
Tristana,Caitlyn,482,239,243,49.59
Tristana,Milio,126,49,77,38.89
Tristana,Yorick,141,69,72,48.94
Tristana,Warwick,234,102,132,43.59
Tristana,Akali,151,71,80,47.02
Tristana,Jhin,373,200,173,53.62
Tristana,Braum,116,74,42,63.79
Tristana,Ashe,361,214,147,59.28
Tristana,Graves,116,50,66,43.1
Tristana,Lucian,177,94,83,53.11
Tristana,Vayne,223,108,115,48.43
Tristana,Draven,98,39,59,39.8
Tristana,Irelia,109,62,47,56.88
Tristana,LeeSin,250,132,118,52.8
Tristana,Zed,190,77,113,40.53
Tristana,Morgana,158,67,91,42.41
Tristana,Teemo,141,76,65,53.9
Tristana,MasterYi,174,98,76,56.32
Tristana,Katarina,132,56,76,42.42
Tristana,Samira,119,49,70,41.18
Tristana,Singed,56,26,30,46.43
Tristana,Garen,315,159,156,50.48
Tristana,Kayn,240,94,146,39.17
Tristana,Mel,384,222,162,57.81
Tristana,MissFortune,424,211,213,49.76
Tristana,Velkoz,120,50,70,41.67
Tristana,Malphite,195,108,87,55.38
Tristana,Vladimir,117,35,82,29.91
Tristana,Ezreal,359,151,208,42.06
Tristana,Camille,57,28,29,49.12
Tristana,KSante,97,52,45,53.61
Tristana,Shaco,128,73,55,57.03
Tristana,Yone,238,103,135,43.28
Tristana,Zilean,46,21,25,45.65
Tristana,Hwei,135,73,62,54.07
Tristana,Zyra,101,61,40,60.4
Tristana,Talon,87,49,38,56.32
Tristana,Swain,183,79,104,43.17
Tristana,Thresh,356,151,205,42.42
Tristana,Chogath,211,73,138,34.6
Tristana,Gangplank,84,43,41,51.19
Tristana,AurelionSol,66,44,22,66.67
Tristana,Leona,203,103,100,50.74
Tristana,Ambessa,105,36,69,34.29
Tristana,Gwen,77,47,30,61.04
Tristana,Twitch,153,95,58,62.09
Tristana,Lulu,242,118,124,48.76
Tristana,Mordekaiser,209,102,107,48.8
Tristana,Kayle,147,77,70,52.38
Tristana,Shen,120,68,52,56.67
Tristana,Naafiri,62,30,32,48.39
Tristana,Yasuo,329,162,167,49.24
Tristana,Rell,110,59,51,53.64
Tristana,Zac,94,49,45,52.13
Tristana,Ryze,52,20,32,38.46
Tristana,Jax,156,74,82,47.44
Tristana,Janna,67,23,44,34.33
Tristana,Renekton,96,42,54,43.75
Tristana,Leblanc,91,49,42,53.85
Tristana,Ziggs,75,47,28,62.67
Tristana,Zoe,103,62,41,60.19
Tristana,Jinx,494,218,276,44.13
Tristana,Lux,402,194,208,48.26
Tristana,Aatrox,183,92,91,50.27
Tristana,Seraphine,160,72,88,45
Tristana,Xerath,132,68,64,51.52
Tristana,Maokai,91,46,45,50.55
Tristana,Zeri,66,32,34,48.48
Tristana,Darius,327,182,145,55.66
Tristana,Olaf,33,19,14,57.58
Tristana,TahmKench,167,83,84,49.7
Tristana,Diana,230,114,116,49.57
Tristana,JarvanIV,164,91,73,55.49
Tristana,Taliyah,43,25,18,58.14
Tristana,Sivir,85,41,44,48.24
Tristana,Evelynn,65,31,34,47.69
Tristana,Kaisa,302,155,147,51.32
Tristana,Rumble,67,41,26,61.19
Tristana,Fizz,109,62,47,56.88
Tristana,Ornn,119,47,72,39.5
Tristana,Karma,178,69,109,38.76
Tristana,Sett,255,102,153,40
Tristana,Nocturne,204,96,108,47.06
Tristana,Ahri,231,117,114,50.65
Tristana,Taric,24,7,17,29.17
Tristana,Rengar,76,25,51,32.89
Tristana,Smolder,128,46,82,35.94
Tristana,Varus,159,82,77,51.57
Tristana,Tryndamere,96,44,52,45.83
Tristana,Nidalee,48,24,24,50
Tristana,Vex,99,61,38,61.62
Tristana,Gnar,92,33,59,35.87
Tristana,Nautilus,236,97,139,41.1
Tristana,Brand,103,54,49,52.43
Tristana,Heimerdinger,66,34,32,51.52
Tristana,Rakan,79,41,38,51.9
Tristana,Vi,229,112,117,48.91
Tristana,Nunu,141,71,70,50.35
Tristana,Alistar,109,73,36,66.97
Tristana,Soraka,75,37,38,49.33
Tristana,Jayce,69,45,24,65.22
Tristana,Gragas,122,66,56,54.1
Tristana,Ekko,115,65,50,56.52
Tristana,Lissandra,79,43,36,54.43
Tristana,Amumu,242,122,120,50.41
Tristana,Cassiopeia,88,46,42,52.27
Tristana,Poppy,132,68,64,51.52
Tristana,Quinn,77,35,42,45.45
Tristana,Nilah,60,30,30,50
Tristana,Viktor,171,74,97,43.27
Tristana,Pyke,149,83,66,55.7
Tristana,Blitzcrank,174,103,71,59.2
Tristana,Ivern,41,17,24,41.46
Tristana,Azir,86,53,33,61.63
Tristana,Senna,95,46,49,48.42
Tristana,Kindred,67,46,21,68.66
Tristana,Sylas,230,108,122,46.96
Tristana,RekSai,28,11,17,39.29
Tristana,Galio,182,91,91,50
Tristana,Syndra,109,50,59,45.87
Tristana,Yuumi,138,69,69,50
Tristana,Trundle,88,50,38,56.82
Tristana,Hecarim,67,36,31,53.73
Tristana,Udyr,60,23,37,38.33
Tristana,Veigar,209,104,105,49.76
Tristana,Bard,75,39,36,52
Tristana,MonkeyKing,117,32,85,27.35
Tristana,Akshan,54,31,23,57.41
Tristana,Nami,153,72,81,47.06
Tristana,XinZhao,115,49,66,42.61
Tristana,Nasus,114,71,43,62.28
Tristana,Aurora,157,76,81,48.41
Tristana,Aphelios,82,35,47,42.68
Tristana,Sejuani,121,57,64,47.11
Tristana,Riven,78,44,34,56.41
Tristana,Skarner,99,34,65,34.34
Tristana,TwistedFate,49,36,13,73.47
Tristana,Rammus,95,37,58,38.95
Tristana,Shyvana,32,17,15,53.13
Tristana,Anivia,78,36,42,46.15
Tristana,Urgot,98,40,58,40.82
Tristana,Briar,66,38,28,57.58
Tristana,KogMaw,40,8,32,20
Tristana,Pantheon,270,149,121,55.19
Tristana,Viego,222,119,103,53.6
Tristana,Xayah,93,52,41,55.91
Tristana,Sona,47,23,24,48.94
Tristana,FiddleSticks,74,33,41,44.59
Tristana,Kennen,47,18,29,38.3
Tristana,Sion,149,75,74,50.34
Tristana,Neeko,77,38,39,49.35
Tristana,Kled,34,11,23,32.35
Tristana,DrMundo,91,47,44,51.65
Tristana,Belveth,34,19,15,55.88
Tristana,Kalista,47,29,18,61.7
Tristana,Karthus,49,26,23,53.06
Tristana,Corki,107,43,64,40.19
Tristana,Qiyana,27,12,15,44.44
Tristana,Renata,55,17,38,30.91
Tristana,Kassadin,28,17,11,60.71
Tristana,Khazix,85,35,50,41.18
Tristana,Illaoi,71,26,45,36.62
Tristana,Fiora,63,29,34,46.03
Tristana,Lillia,103,49,54,47.57
Tristana,Orianna,89,48,41,53.93
Tristana,Annie,48,20,28,41.67
Poppy,Garen,180,85,95,47.22
Poppy,Warwick,152,62,90,40.79
Poppy,Yasuo,316,146,170,46.2
Poppy,MissFortune,270,120,150,44.44
Poppy,Lux,304,166,138,54.61
Poppy,Ashe,281,164,117,58.36
Poppy,Graves,92,58,34,63.04
Poppy,Lucian,123,69,54,56.1
Poppy,Vayne,235,110,125,46.81
Poppy,Draven,67,41,26,61.19
Poppy,Gragas,103,54,49,52.43
Poppy,Elise,124,62,62,50
Poppy,Mel,300,164,136,54.67
Poppy,Zyra,110,63,47,57.27
Poppy,Volibear,166,69,97,41.57
Poppy,Vi,174,84,90,48.28
Poppy,Caitlyn,370,185,185,50
Poppy,Malphite,144,74,70,51.39
Poppy,Azir,68,45,23,66.18
Poppy,Lulu,179,91,88,50.84
Poppy,Camille,70,32,38,45.71
Poppy,Hwei,104,44,60,42.31
Poppy,Nilah,53,33,20,62.26
Poppy,Nami,163,85,78,52.15
Poppy,Nasus,73,44,29,60.27
Poppy,MonkeyKing,62,30,32,48.39
Poppy,Viktor,144,80,64,55.56
Poppy,Rakan,132,70,62,53.03
Poppy,Chogath,163,71,92,43.56
Poppy,LeeSin,306,162,144,52.94
Poppy,Sivir,83,33,50,39.76
Poppy,Brand,73,36,37,49.32
Poppy,Sett,197,100,97,50.76
Poppy,Lissandra,61,27,34,44.26
Poppy,Irelia,146,82,64,56.16
Poppy,Vladimir,102,49,53,48.04
Poppy,Nautilus,264,131,133,49.62
Poppy,RekSai,23,17,6,73.91
Poppy,Akali,140,76,64,54.29
Poppy,Bard,66,24,42,36.36
Poppy,Pyke,141,77,64,54.61
Poppy,Darius,241,115,126,47.72
Poppy,Kayn,139,83,56,59.71
Poppy,Fizz,78,39,39,50
Poppy,Jayce,54,30,24,55.56
Poppy,Diana,249,128,121,51.41
Poppy,TahmKench,149,58,91,38.93
Poppy,Teemo,124,57,67,45.97
Poppy,MasterYi,164,78,86,47.56
Poppy,Malzahar,127,61,66,48.03
Poppy,Trundle,59,40,19,67.8
Poppy,Kaisa,265,138,127,52.08
Poppy,Leblanc,94,57,37,60.64
Poppy,Nidalee,68,37,31,54.41
Poppy,Blitzcrank,139,69,70,49.64
Poppy,KSante,112,74,38,66.07
Poppy,Viego,216,98,118,45.37
Poppy,Pantheon,269,144,125,53.53
Poppy,JarvanIV,167,78,89,46.71
Poppy,Yorick,87,31,56,35.63
Poppy,Ekko,151,64,87,42.38
Poppy,Urgot,71,38,33,53.52
Poppy,Ezreal,256,127,129,49.61
Poppy,Varus,159,81,78,50.94
Poppy,Milio,81,41,40,50.62
Poppy,Yone,279,122,157,43.73
Poppy,Amumu,167,71,96,42.51
Poppy,Galio,176,95,81,53.98
Poppy,Briar,93,48,45,51.61
Poppy,Ambessa,161,90,71,55.9
Poppy,Skarner,67,22,45,32.84
Poppy,Rammus,28,9,19,32.14
Poppy,Fiora,68,31,37,45.59
Poppy,Sion,138,76,62,55.07
Poppy,Xayah,112,54,58,48.21
Poppy,Veigar,127,56,71,44.09
Poppy,Nocturne,159,94,65,59.12
Poppy,Senna,96,53,43,55.21
Poppy,Seraphine,97,51,46,52.58
Poppy,Mordekaiser,166,81,85,48.8
Poppy,Maokai,100,31,69,31
Poppy,Orianna,99,44,55,44.44
Poppy,Tristana,132,64,68,48.48
Poppy,Aurora,113,59,54,52.21
Poppy,XinZhao,112,61,51,54.46
Poppy,Lillia,103,50,53,48.54
Poppy,Katarina,91,60,31,65.93
Poppy,Yuumi,126,73,53,57.94
Poppy,DrMundo,78,34,44,43.59
Poppy,Talon,71,52,19,73.24
Poppy,Morgana,129,63,66,48.84
Poppy,Singed,38,20,18,52.63
Poppy,Thresh,225,123,102,54.67
Poppy,Jhin,291,160,131,54.98
Poppy,Gangplank,53,29,24,54.72
Poppy,Ahri,257,152,105,59.14
Poppy,Karma,172,86,86,50
Poppy,Shen,107,55,52,51.4
Poppy,Sejuani,93,46,47,49.46
Poppy,Xerath,108,43,65,39.81
Poppy,Jinx,324,164,160,50.62
Poppy,Evelynn,32,16,16,50
Poppy,Smolder,121,45,76,37.19
Poppy,Aatrox,167,67,100,40.12
Poppy,Qiyana,21,3,18,14.29
Poppy,Karthus,51,22,29,43.14
Poppy,Leona,176,75,101,42.61
Poppy,Zed,106,55,51,51.89
Poppy,Jax,155,89,66,57.42
Poppy,Zeri,88,38,50,43.18
Poppy,Renekton,93,58,35,62.37
Poppy,Swain,141,56,85,39.72
Poppy,TwistedFate,44,24,20,54.55
Poppy,Corki,77,36,41,46.75
Poppy,Samira,79,47,32,59.49
Poppy,Sylas,215,118,97,54.88
Poppy,Riven,68,33,35,48.53
Poppy,Rell,119,58,61,48.74
Poppy,Ryze,65,34,31,52.31
Poppy,FiddleSticks,57,27,30,47.37
Poppy,Shaco,106,56,50,52.83
Poppy,Nunu,76,38,38,50
Poppy,Zilean,44,13,31,29.55
Poppy,Naafiri,36,18,18,50
Poppy,Aphelios,91,49,42,53.85
Poppy,Kindred,57,29,28,50.88
Poppy,Zac,126,72,54,57.14
Poppy,Taric,30,17,13,56.67
Poppy,Gnar,71,25,46,35.21
Poppy,Braum,130,67,63,51.54
Poppy,Belveth,30,26,4,86.67
Poppy,Olaf,49,22,27,44.9
Poppy,KogMaw,54,14,40,25.93
Poppy,Zoe,50,25,25,50
Poppy,Taliyah,48,23,25,47.92
Poppy,Hecarim,46,19,27,41.3
Poppy,Udyr,61,29,32,47.54
Poppy,Sona,30,23,7,76.67
Poppy,Kassadin,33,14,19,42.42
Poppy,Janna,46,6,40,13.04
Poppy,Ziggs,66,37,29,56.06
Poppy,Quinn,35,14,21,40
Poppy,Akshan,37,17,20,45.95
Poppy,Alistar,118,70,48,59.32
Poppy,Gwen,79,55,24,69.62
Poppy,Velkoz,77,43,34,55.84
Poppy,Soraka,51,31,20,60.78
Poppy,Rengar,42,20,22,47.62
Poppy,Vex,94,44,50,46.81
Poppy,Kled,28,12,16,42.86
Poppy,Khazix,67,39,28,58.21
Poppy,Heimerdinger,48,27,21,56.25
Poppy,Kayle,87,41,46,47.13
Poppy,Kalista,81,44,37,54.32
Poppy,Anivia,44,33,11,75
Poppy,Illaoi,65,31,34,47.69
Poppy,Syndra,90,42,48,46.67
Poppy,Shyvana,38,11,27,28.95
Poppy,Renata,35,16,19,45.71
Poppy,Tryndamere,38,21,17,55.26
Poppy,Twitch,92,41,51,44.57
Poppy,Annie,34,8,26,23.53
Poppy,Kennen,36,26,10,72.22
Poppy,AurelionSol,45,21,24,46.67
Poppy,Ornn,74,37,37,50
Poppy,Cassiopeia,25,6,19,24
Poppy,Ivern,31,14,17,45.16
Poppy,Neeko,70,37,33,52.86
Poppy,Rumble,45,18,27,40
Ziggs,Garen,102,37,65,36.27
Ziggs,Warwick,98,43,55,43.88
Ziggs,Yasuo,169,67,102,39.64
Ziggs,MissFortune,148,76,72,51.35
Ziggs,Lux,223,101,122,45.29
Ziggs,Kayn,104,49,55,47.12
Ziggs,Ekko,60,30,30,50
Ziggs,Teemo,78,46,32,58.97
Ziggs,Sivir,42,24,18,57.14
Ziggs,Velkoz,38,21,17,55.26
Ziggs,Renekton,48,32,16,66.67
Ziggs,Kassadin,21,3,18,14.29
Ziggs,Jinx,213,94,119,44.13
Ziggs,Soraka,39,25,14,64.1
Ziggs,Volibear,82,31,51,37.8
Ziggs,Amumu,92,25,67,27.17
Ziggs,Viktor,74,40,34,54.05
Ziggs,Zeri,25,4,21,16
Ziggs,Pantheon,111,59,52,53.15
Ziggs,Aatrox,82,47,35,57.32
Ziggs,Sejuani,54,18,36,33.33
Ziggs,Malzahar,86,44,42,51.16
Ziggs,Ashe,132,69,63,52.27
Ziggs,Blitzcrank,49,25,24,51.02
Ziggs,Mordekaiser,103,72,31,69.9
Ziggs,XinZhao,51,31,20,60.78
Ziggs,Diana,122,50,72,40.98
Ziggs,Tristana,75,28,47,37.33
Ziggs,Thresh,113,61,52,53.98
Ziggs,Elise,88,48,40,54.55
Ziggs,Ahri,71,25,46,35.21
Ziggs,Ezreal,191,110,81,57.59
Ziggs,Karma,107,67,40,62.62
Ziggs,Shen,74,33,41,44.59
Ziggs,Hecarim,26,23,3,88.46
Ziggs,Varus,91,54,37,59.34
Ziggs,Alistar,33,18,15,54.55
Ziggs,Chogath,87,39,48,44.83
Ziggs,Nilah,31,22,9,70.97
Ziggs,Zyra,65,34,31,52.31
Ziggs,Darius,103,39,64,37.86
Ziggs,Ryze,29,23,6,79.31
Ziggs,Jayce,24,9,15,37.5
Ziggs,Hwei,55,31,24,56.36
Ziggs,TahmKench,68,42,26,61.76
Ziggs,Sett,123,50,73,40.65
Ziggs,Irelia,44,26,18,59.09
Ziggs,Morgana,85,35,50,41.18
Ziggs,Zac,32,15,17,46.88
Ziggs,Corki,22,13,9,59.09
Ziggs,Nautilus,116,61,55,52.59
Ziggs,Orianna,39,13,26,33.33
Ziggs,Brand,40,20,20,50
Ziggs,RekSai,13,9,4,69.23
Ziggs,Nunu,61,36,25,59.02
Ziggs,Belveth,11,5,6,45.45
Ziggs,Malphite,78,42,36,53.85
Ziggs,Caitlyn,227,118,109,51.98
Ziggs,Akali,47,34,13,72.34
Ziggs,Briar,34,10,24,29.41
Ziggs,Naafiri,18,10,8,55.56
Ziggs,Zed,76,45,31,59.21
Ziggs,Talon,52,35,17,67.31
Ziggs,Braum,61,33,28,54.1
Ziggs,Yorick,38,18,20,47.37
Ziggs,Khazix,33,20,13,60.61
Ziggs,Vayne,106,27,79,25.47
Ziggs,Sylas,102,60,42,58.82
Ziggs,Janna,37,18,19,48.65
Ziggs,Vi,99,56,43,56.57
Ziggs,AurelionSol,32,18,14,56.25
Ziggs,Mel,165,112,53,67.88
Ziggs,Lucian,70,37,33,52.86
Ziggs,Kayle,26,14,12,53.85
Ziggs,Lissandra,37,23,14,62.16
Ziggs,Yuumi,44,21,23,47.73
Ziggs,Gnar,40,22,18,55
Ziggs,Graves,44,13,31,29.55
Ziggs,Rell,58,25,33,43.1
Ziggs,MonkeyKing,31,9,22,29.03
Ziggs,Urgot,43,25,18,58.14
Ziggs,Aurora,56,25,31,44.64
Ziggs,Sona,15,12,3,80
Ziggs,Pyke,61,22,39,36.07
Ziggs,Nasus,57,23,34,40.35
Ziggs,Katarina,54,31,23,57.41
Ziggs,Lulu,65,31,34,47.69
Ziggs,Ornn,43,30,13,69.77
Ziggs,Samira,55,33,22,60
Ziggs,Riven,29,9,20,31.03
Ziggs,Yone,170,103,67,60.59
Ziggs,DrMundo,54,13,41,24.07
Ziggs,Milio,40,20,20,50
Ziggs,Udyr,29,17,12,58.62
Ziggs,Vladimir,51,32,19,62.75
Ziggs,Kaisa,101,63,38,62.38
Ziggs,Gangplank,43,30,13,69.77
Ziggs,Nami,57,22,35,38.6
Ziggs,Seraphine,57,29,28,50.88
Ziggs,Rammus,29,12,17,41.38
Ziggs,Jhin,128,60,68,46.88
Ziggs,Olaf,16,8,8,50
Ziggs,Fiora,17,3,14,17.65
Ziggs,Shaco,45,22,23,48.89
Ziggs,Swain,64,25,39,39.06
Ziggs,Tryndamere,31,8,23,25.81
Ziggs,LeeSin,141,56,85,39.72
Ziggs,Nocturne,86,71,15,82.56
Ziggs,Leona,81,28,53,34.57
Ziggs,Kindred,39,22,17,56.41
Ziggs,Poppy,66,29,37,43.94
Ziggs,Galio,91,55,36,60.44
Ziggs,Azir,27,14,13,51.85
Ziggs,Xayah,38,22,16,57.89
Ziggs,Anivia,28,8,20,28.57
Ziggs,Heimerdinger,39,25,14,64.1
Ziggs,Bard,23,8,15,34.78
Ziggs,Karthus,12,3,9,25
Ziggs,Gragas,68,29,39,42.65
Ziggs,Smolder,25,10,15,40
Ziggs,KogMaw,21,7,14,33.33
Ziggs,Xerath,82,47,35,57.32
Ziggs,Jax,59,37,22,62.71
Ziggs,Rakan,39,13,26,33.33
Ziggs,Trundle,33,21,12,63.64
Ziggs,Viego,89,42,47,47.19
Ziggs,Taliyah,24,17,7,70.83
Ziggs,Zilean,22,8,14,36.36
Ziggs,Twitch,55,19,36,34.55
Ziggs,Sion,79,39,40,49.37
Ziggs,Zoe,24,14,10,58.33
Ziggs,MasterYi,52,28,24,53.85
Ziggs,Cassiopeia,17,6,11,35.29
Ziggs,Veigar,81,36,45,44.44
Ziggs,Quinn,34,14,20,41.18
Ziggs,TwistedFate,19,8,11,42.11
Ziggs,Leblanc,31,17,14,54.84
Ziggs,Singed,19,7,12,36.84
Ziggs,Aphelios,43,17,26,39.53
Ziggs,Lillia,25,11,14,44
Ziggs,Vex,39,29,10,74.36
Ziggs,Draven,41,21,20,51.22
Ziggs,Gwen,39,18,21,46.15
Ziggs,Skarner,36,21,15,58.33
Ziggs,Syndra,44,26,18,59.09
Ziggs,FiddleSticks,27,24,3,88.89
Ziggs,Kled,14,4,10,28.57
Ziggs,Ambessa,73,23,50,31.51
Ziggs,JarvanIV,57,36,21,63.16
Ziggs,Annie,17,12,5,70.59
Ziggs,Shyvana,17,3,14,17.65
Ziggs,Renata,12,9,3,75
Ziggs,Rengar,16,6,10,37.5
Ziggs,Evelynn,10,7,3,70
Ziggs,Illaoi,37,24,13,64.86
Ziggs,Senna,46,25,21,54.35
Ziggs,Rumble,17,5,12,29.41
Ziggs,Kennen,18,9,9,50
Ziggs,Taric,10,7,3,70
Ziggs,Camille,23,10,13,43.48
Ziggs,Neeko,35,18,17,51.43
Ziggs,Ivern,15,12,3,80
Ziggs,Maokai,40,16,24,40
Ziggs,KSante,32,19,13,59.38
Ziggs,Kalista,15,13,2,86.67
Ziggs,Akshan,15,10,5,66.67
Ziggs,Fizz,29,12,17,41.38
Ziggs,Qiyana,22,12,10,54.55
Ziggs,Nidalee,19,11,8,57.89
Ekko,Akali,148,70,78,47.3
Ekko,LeeSin,256,137,119,53.52
Ekko,Yasuo,304,173,131,56.91
Ekko,Hwei,131,69,62,52.67
Ekko,Pyke,94,51,43,54.26
Ekko,Teemo,163,82,81,50.31
Ekko,FiddleSticks,85,44,41,51.76
Ekko,Twitch,121,60,61,49.59
Ekko,Seraphine,105,53,52,50.48
Ekko,Gnar,71,51,20,71.83
Ekko,Kayn,202,121,81,59.9
Ekko,Mel,404,198,206,49.01
Ekko,Pantheon,283,142,141,50.18
Ekko,Evelynn,50,27,23,54
Ekko,Malphite,148,75,73,50.68
Ekko,Lucian,118,51,67,43.22
Ekko,Sion,123,55,68,44.72
Ekko,Zoe,64,26,38,40.63
Ekko,Ziggs,60,30,30,50
Ekko,Veigar,191,111,80,58.12
Ekko,Warwick,239,111,128,46.44
Ekko,Katarina,120,70,50,58.33
Ekko,Taric,46,24,22,52.17
Ekko,Zed,186,96,90,51.61
Ekko,Yorick,166,72,94,43.37
Ekko,Sejuani,112,49,63,43.75
Ekko,Leblanc,124,76,48,61.29
Ekko,Nilah,48,17,31,35.42
Ekko,Karma,161,65,96,40.37
Ekko,Shen,121,70,51,57.85
Ekko,Viego,234,135,99,57.69
Ekko,Diana,211,116,95,54.98
Ekko,Corki,45,30,15,66.67
Ekko,TahmKench,155,79,76,50.97
Ekko,Garen,273,109,164,39.93
Ekko,Viktor,179,89,90,49.72
Ekko,Talon,77,39,38,50.65
Ekko,Sivir,89,48,41,53.93
Ekko,Lulu,247,127,120,51.42
Ekko,Xayah,102,66,36,64.71
Ekko,Karthus,55,33,22,60
Ekko,Naafiri,74,44,30,59.46
Ekko,Vayne,230,128,102,55.65
Ekko,Lux,354,183,171,51.69
Ekko,Renekton,101,62,39,61.39
Ekko,JarvanIV,126,51,75,40.48
Ekko,Jhin,333,187,146,56.16
Ekko,Janna,57,30,27,52.63
Ekko,Briar,110,64,46,58.18
Ekko,Neeko,65,40,25,61.54
Ekko,Yone,286,156,130,54.55
Ekko,Chogath,236,120,116,50.85
Ekko,Blitzcrank,149,82,67,55.03
Ekko,Kayle,99,50,49,50.51
Ekko,Irelia,81,35,46,43.21
Ekko,MissFortune,408,209,199,51.23
Ekko,Vladimir,106,51,55,48.11
Ekko,Nautilus,192,99,93,51.56
Ekko,Sett,232,110,122,47.41
Ekko,Graves,55,29,26,52.73
Ekko,Ahri,247,123,124,49.8
Ekko,Brand,110,53,57,48.18
Ekko,Nami,166,86,80,51.81
Ekko,Riven,73,42,31,57.53
Ekko,Nocturne,168,78,90,46.43
Ekko,Galio,155,78,77,50.32
Ekko,Shaco,140,66,74,47.14
Ekko,TwistedFate,34,11,23,32.35
Ekko,Thresh,235,133,102,56.6
Ekko,Nunu,128,63,65,49.22
Ekko,Rengar,65,34,31,52.31
Ekko,KSante,111,64,47,57.66
Ekko,Malzahar,171,88,83,51.46
Ekko,Senna,118,78,40,66.1
Ekko,Illaoi,66,28,38,42.42
Ekko,Ashe,301,179,122,59.47
Ekko,Nidalee,55,37,18,67.27
Ekko,Volibear,209,99,110,47.37
Ekko,Darius,292,124,168,42.47
Ekko,Azir,73,37,36,50.68
Ekko,Sona,42,31,11,73.81
Ekko,Nasus,113,55,58,48.67
Ekko,Xerath,147,74,73,50.34
Ekko,Jinx,473,234,239,49.47
Ekko,Morgana,182,102,80,56.04
Ekko,Heimerdinger,69,34,35,49.28
Ekko,Poppy,151,87,64,57.62
Ekko,Caitlyn,425,202,223,47.53
Ekko,Rell,129,71,58,55.04
Ekko,Gragas,123,88,35,71.54
Ekko,Sylas,259,122,137,47.1
Ekko,Orianna,84,41,43,48.81
Ekko,MasterYi,175,84,91,48
Ekko,Smolder,146,83,63,56.85
Ekko,Lillia,116,51,65,43.97
Ekko,Draven,77,38,39,49.35
Ekko,Leona,206,90,116,43.69
Ekko,Taliyah,56,23,33,41.07
Ekko,Samira,122,63,59,51.64
Ekko,Belveth,21,14,7,66.67
Ekko,Kassadin,36,13,23,36.11
Ekko,AurelionSol,65,28,37,43.08
Ekko,Khazix,88,53,35,60.23
Ekko,Ambessa,139,58,81,41.73
Ekko,Aurora,136,77,59,56.62
Ekko,Syndra,141,80,61,56.74
Ekko,Milio,119,49,70,41.18
Ekko,Vi,175,89,86,50.86
Ekko,Tristana,115,50,65,43.48
Ekko,Rumble,55,38,17,69.09
Ekko,Mordekaiser,154,90,64,58.44
Ekko,Varus,153,82,71,53.59
Ekko,Zyra,121,65,56,53.72
Ekko,Jayce,72,47,25,65.28
Ekko,Jax,143,66,77,46.15
Ekko,Kled,39,15,24,38.46
Ekko,Ezreal,378,190,188,50.26
Ekko,Ryze,64,40,24,62.5
Ekko,Elise,141,71,70,50.35
Ekko,Alistar,78,43,35,55.13
Ekko,Amumu,198,104,94,52.53
Ekko,Gwen,69,34,35,49.28
Ekko,Qiyana,41,20,21,48.78
Ekko,Kaisa,212,110,102,51.89
Ekko,Ornn,86,40,46,46.51
Ekko,XinZhao,95,56,39,58.95
Ekko,Aatrox,163,83,80,50.92
Ekko,Udyr,36,18,18,50
Ekko,Aphelios,88,58,30,65.91
Ekko,Rakan,85,42,43,49.41
Ekko,DrMundo,87,44,43,50.57
Ekko,Zeri,61,30,31,49.18
Ekko,Kindred,83,34,49,40.96
Ekko,Swain,171,78,93,45.61
Ekko,Quinn,75,44,31,58.67
Ekko,Rammus,61,41,20,67.21
Ekko,Tryndamere,71,46,25,64.79
Ekko,RekSai,25,19,6,76
Ekko,MonkeyKing,104,40,64,38.46
Ekko,KogMaw,51,20,31,39.22
Ekko,Gangplank,53,27,26,50.94
Ekko,Yuumi,115,50,65,43.48
Ekko,Fiora,89,33,56,37.08
Ekko,Trundle,81,45,36,55.56
Ekko,Vex,86,34,52,39.53
Ekko,Braum,113,56,57,49.56
Ekko,Akshan,50,24,26,48
Ekko,Zilean,44,26,18,59.09
Ekko,Renata,18,6,12,33.33
Ekko,Anivia,57,24,33,42.11
Ekko,Singed,51,28,23,54.9
Ekko,Skarner,78,51,27,65.38
Ekko,Annie,52,20,32,38.46
Ekko,Ivern,35,13,22,37.14
Ekko,Fizz,91,52,39,57.14
Ekko,Urgot,68,29,39,42.65
Ekko,Olaf,39,10,29,25.64
Ekko,Camille,62,42,20,67.74
Ekko,Soraka,79,38,41,48.1
Ekko,Velkoz,72,39,33,54.17
Ekko,Maokai,59,34,25,57.63
Ekko,Kalista,33,26,7,78.79
Ekko,Shyvana,41,22,19,53.66
Ekko,Zac,79,58,21,73.42
Ekko,Hecarim,68,38,30,55.88
Ekko,Bard,52,33,19,63.46
Ekko,Kennen,53,41,12,77.36
Ekko,Cassiopeia,34,15,19,44.12
Ekko,Lissandra,56,31,25,55.36
Ivern,Yone,59,30,29,50.85
Ivern,FiddleSticks,13,5,8,38.46
Ivern,Aurora,29,6,23,20.69
Ivern,Vayne,45,27,18,60
Ivern,Senna,28,21,7,75
Ivern,Darius,61,24,37,39.34
Ivern,XinZhao,32,24,8,75
Ivern,Orianna,52,24,28,46.15
Ivern,Ezreal,98,52,46,53.06
Ivern,Thresh,68,30,38,44.12
Ivern,Kled,13,2,11,15.38
Ivern,Gragas,25,9,16,36
Ivern,Anivia,20,8,12,40
Ivern,Jinx,148,63,85,42.57
Ivern,Rell,25,10,15,40
Ivern,Warwick,59,16,43,27.12
Ivern,Gnar,23,11,12,47.83
Ivern,Kalista,8,3,5,37.5
Ivern,Nautilus,66,31,35,46.97
Ivern,MonkeyKing,37,12,25,32.43
Ivern,Kayn,69,40,29,57.97
Ivern,Kassadin,6,3,3,50
Ivern,Chogath,88,38,50,43.18
Ivern,Karma,79,30,49,37.97
Ivern,LeeSin,65,24,41,36.92
Ivern,Syndra,51,24,27,47.06
Ivern,Caitlyn,103,45,58,43.69
Ivern,Blitzcrank,60,37,23,61.67
Ivern,Rengar,20,12,8,60
Ivern,Mel,87,46,41,52.87
Ivern,Ashe,80,39,41,48.75
Ivern,Brand,29,19,10,65.52
Ivern,Jax,35,27,8,77.14
Ivern,Diana,90,35,55,38.89
Ivern,Vladimir,23,15,8,65.22
Ivern,Lucian,37,18,19,48.65
Ivern,Nami,48,27,21,56.25
Ivern,Jayce,24,10,14,41.67
Ivern,Azir,14,9,5,64.29
Ivern,Jhin,104,47,57,45.19
Ivern,Malphite,31,9,22,29.03
Ivern,Yasuo,89,31,58,34.83
Ivern,Kaisa,79,31,48,39.24
Ivern,Seraphine,13,5,8,38.46
Ivern,Gwen,24,3,21,12.5
Ivern,Vi,52,20,32,38.46
Ivern,Qiyana,17,2,15,11.76
Ivern,Sivir,36,16,20,44.44
Ivern,Briar,26,14,12,53.85
Ivern,Tristana,41,24,17,58.54
Ivern,Rakan,15,8,7,53.33
Ivern,Volibear,46,20,26,43.48
Ivern,Zac,17,14,3,82.35
Ivern,Corki,24,11,13,45.83
Ivern,Kennen,11,8,3,72.73
Ivern,Sylas,51,20,31,39.22
Ivern,Hwei,34,17,17,50
Ivern,Smolder,24,14,10,58.33
Ivern,Renata,18,9,9,50
Ivern,Nasus,31,9,22,29.03
Ivern,Lulu,102,57,45,55.88
Ivern,Sion,44,27,17,61.36
Ivern,Zeri,25,17,8,68
Ivern,Morgana,41,15,26,36.59
Ivern,Skarner,22,7,15,31.82
Ivern,Garen,76,38,38,50
Ivern,MasterYi,49,24,25,48.98
Ivern,Malzahar,62,25,37,40.32
Ivern,Shaco,20,3,17,15
Ivern,Yorick,49,27,22,55.1
Ivern,Evelynn,18,9,9,50
Ivern,Viktor,41,22,19,53.66
Ivern,Zed,43,20,23,46.51
Ivern,Neeko,34,17,17,50
Ivern,Vex,26,14,12,53.85
Ivern,Hecarim,16,9,7,56.25
Ivern,Katarina,26,11,15,42.31
Ivern,Zilean,29,12,17,41.38
Ivern,DrMundo,22,9,13,40.91
Ivern,Ahri,72,45,27,62.5
Ivern,Tryndamere,30,8,22,26.67
Ivern,Nocturne,39,19,20,48.72
Ivern,Xerath,27,11,16,40.74
Ivern,MissFortune,81,26,55,32.1
Ivern,Graves,25,11,14,44
Ivern,Varus,43,15,28,34.88
Ivern,Shen,31,14,17,45.16
Ivern,Amumu,40,12,28,30
Ivern,Fizz,24,12,12,50
Ivern,Olaf,18,11,7,61.11
Ivern,Khazix,20,9,11,45
Ivern,Leblanc,39,24,15,61.54
Ivern,Trundle,36,13,23,36.11
Ivern,Elise,26,14,12,53.85
Ivern,Teemo,42,23,19,54.76
Ivern,Janna,12,6,6,50
Ivern,Mordekaiser,59,23,36,38.98
Ivern,Rammus,16,5,11,31.25
Ivern,Lux,64,34,30,53.13
Ivern,Kindred,20,14,6,70
Ivern,Yuumi,43,12,31,27.91
Ivern,Ekko,35,22,13,62.86
Ivern,Zyra,16,7,9,43.75
Ivern,Lillia,22,10,12,45.45
Ivern,TahmKench,39,25,14,64.1
Ivern,Swain,51,23,28,45.1
Ivern,Sejuani,38,14,24,36.84
Ivern,Draven,21,9,12,42.86
Ivern,Camille,24,11,13,45.83
Ivern,Akali,57,23,34,40.35
Ivern,Fiora,12,10,2,83.33
Ivern,Viego,58,23,35,39.66
Ivern,Ornn,17,9,8,52.94
Ivern,Leona,44,19,25,43.18
Ivern,Kayle,19,9,10,47.37
Ivern,Alistar,19,0,19,0
Ivern,Akshan,24,9,15,37.5
Ivern,Twitch,37,27,10,72.97
Ivern,Samira,26,8,18,30.77
Ivern,Maokai,17,9,8,52.94
Ivern,Veigar,40,23,17,57.5
Ivern,Heimerdinger,20,6,14,30
Ivern,Talon,19,11,8,57.89
Ivern,Milio,33,8,25,24.24
Ivern,Renekton,30,16,14,53.33
Ivern,Pantheon,66,40,26,60.61
Ivern,Poppy,31,17,14,54.84
Ivern,Ambessa,35,17,18,48.57
Ivern,Aphelios,18,7,11,38.89
Ivern,Pyke,26,7,19,26.92
Ivern,Sona,2,2,0,100
Ivern,RekSai,4,4,0,100
Ivern,Irelia,19,9,10,47.37
Ivern,Velkoz,24,17,7,70.83
Ivern,Bard,13,8,5,61.54
Ivern,Rumble,15,4,11,26.67
Ivern,Taric,13,2,11,15.38
Ivern,Nunu,38,23,15,60.53
Ivern,Quinn,22,3,19,13.64
Ivern,Naafiri,13,13,0,100
Ivern,Riven,22,10,12,45.45
Ivern,Sett,45,16,29,35.56
Ivern,Ziggs,15,3,12,20
Ivern,Aatrox,24,11,13,45.83
Ivern,Shyvana,6,4,2,66.67
Ivern,Braum,33,11,22,33.33
Ivern,KSante,26,10,16,38.46
Ivern,Annie,8,8,0,100
Ivern,Zoe,19,8,11,42.11
Ivern,Taliyah,8,6,2,75
Ivern,AurelionSol,18,8,10,44.44
Ivern,JarvanIV,21,6,15,28.57
Ivern,Ryze,19,11,8,57.89
Ivern,KogMaw,11,2,9,18.18
Ivern,Illaoi,11,6,5,54.55
Ivern,Belveth,5,3,2,60
Ivern,Lissandra,5,0,5,0
Ivern,Urgot,14,3,11,21.43
Ivern,Xayah,23,6,17,26.09
Ivern,Nidalee,12,12,0,100
Ivern,Karthus,7,2,5,28.57
Ivern,Galio,40,12,28,30
Ivern,Cassiopeia,14,2,12,14.29
Ivern,Gangplank,22,14,8,63.64
Ivern,Soraka,23,14,9,60.87
Ivern,Udyr,17,3,14,17.65
Ivern,TwistedFate,9,3,6,33.33
Ivern,Nilah,8,2,6,25
Ivern,Singed,6,3,3,50
Lucian,Yone,272,153,119,56.25
Lucian,FiddleSticks,97,48,49,49.48
Lucian,Aurora,128,45,83,35.16
Lucian,Vayne,177,87,90,49.15
Lucian,Senna,76,39,37,51.32
Lucian,Nasus,88,35,53,39.77
Lucian,Syndra,134,64,70,47.76
Lucian,Mel,343,170,173,49.56
Lucian,Seraphine,106,40,66,37.74
Lucian,Kled,25,11,14,44
Lucian,Kayn,146,63,83,43.15
Lucian,Katarina,93,36,57,38.71
Lucian,Twitch,117,64,53,54.7
Lucian,Thresh,305,142,163,46.56
Lucian,Annie,67,27,40,40.3
Lucian,Tristana,177,83,94,46.89
Lucian,Poppy,123,54,69,43.9
Lucian,Pantheon,309,169,140,54.69
Lucian,Ekko,118,67,51,56.78
Lucian,Talon,89,43,46,48.31
Lucian,Kaisa,286,146,140,51.05
Lucian,Soraka,64,24,40,37.5
Lucian,Darius,307,149,158,48.53
Lucian,Vi,188,93,95,49.47
Lucian,Malzahar,125,73,52,58.4
Lucian,Aphelios,84,41,43,48.81
Lucian,Jax,156,84,72,53.85
Lucian,Diana,227,108,119,47.58
Lucian,Akshan,53,22,31,41.51
Lucian,Ashe,329,157,172,47.72
Lucian,Milio,117,54,63,46.15
Lucian,Irelia,137,61,76,44.53
Lucian,Sejuani,127,31,96,24.41
Lucian,Malphite,182,87,95,47.8
Lucian,Jhin,359,163,196,45.4
Lucian,Karma,195,81,114,41.54
Lucian,Camille,63,25,38,39.68
Lucian,Sivir,117,67,50,57.26
Lucian,Zyra,151,66,85,43.71
Lucian,Teemo,183,99,84,54.1
Lucian,Amumu,199,86,113,43.22
Lucian,MissFortune,309,150,159,48.54
Lucian,Rakan,90,38,52,42.22
Lucian,Hwei,79,36,43,45.57
Lucian,Janna,57,23,34,40.35
Lucian,Briar,67,19,48,28.36
Lucian,Zed,176,69,107,39.2
Lucian,Ezreal,464,218,246,46.98
Lucian,Gragas,168,78,90,46.43
Lucian,MasterYi,149,67,82,44.97
Lucian,TwistedFate,92,39,53,42.39
Lucian,Xayah,91,24,67,26.37
Lucian,Gwen,80,33,47,41.25
Lucian,Jinx,413,175,238,42.37
Lucian,Akali,157,54,103,34.39
Lucian,Nautilus,215,102,113,47.44
Lucian,Heimerdinger,75,42,33,56
Lucian,Samira,122,45,77,36.89
Lucian,Sett,230,96,134,41.74
Lucian,Lillia,101,44,57,43.56
Lucian,Yuumi,128,52,76,40.63
Lucian,Sylas,251,126,125,50.2
Lucian,Xerath,186,73,113,39.25
Lucian,Caitlyn,517,230,287,44.49
Lucian,Lulu,276,157,119,56.88
Lucian,Veigar,178,79,99,44.38
Lucian,Jayce,108,45,63,41.67
Lucian,Smolder,132,52,80,39.39
Lucian,Chogath,205,105,100,51.22
Lucian,Olaf,40,19,21,47.5
Lucian,Yasuo,322,152,170,47.2
Lucian,Draven,112,45,67,40.18
Lucian,Morgana,167,68,99,40.72
Lucian,Mordekaiser,214,96,118,44.86
Lucian,Volibear,161,68,93,42.24
Lucian,Azir,90,33,57,36.67
Lucian,Garen,261,122,139,46.74
Lucian,Kayle,100,54,46,54
Lucian,Trundle,84,42,42,50
Lucian,Illaoi,77,39,38,50.65
Lucian,Brand,91,48,43,52.75
Lucian,Nidalee,78,41,37,52.56
Lucian,Zoe,79,50,29,63.29
Lucian,Gangplank,110,39,71,35.45
Lucian,Warwick,204,73,131,35.78
Lucian,Zeri,97,45,52,46.39
Lucian,Ambessa,128,53,75,41.41
Lucian,TahmKench,158,56,102,35.44
Lucian,Vladimir,78,49,29,62.82
Lucian,Rell,103,49,54,47.57
Lucian,Corki,90,37,53,41.11
Lucian,Lux,373,171,202,45.84
Lucian,LeeSin,321,174,147,54.21
Lucian,Varus,176,97,79,55.11
Lucian,Vex,102,46,56,45.1
Lucian,Blitzcrank,174,94,80,54.02
Lucian,Hecarim,46,11,35,23.91
Lucian,Leona,154,62,92,40.26
Lucian,Singed,42,22,20,52.38
Lucian,Leblanc,88,45,43,51.14
Lucian,Viktor,174,73,101,41.95
Lucian,Alistar,110,41,69,37.27
Lucian,Braum,115,48,67,41.74
Lucian,Ivern,37,19,18,51.35
Lucian,MonkeyKing,98,43,55,43.88
Lucian,Fizz,89,47,42,52.81
Lucian,Renekton,97,39,58,40.21
Lucian,Shaco,117,44,73,37.61
Lucian,KogMaw,43,14,29,32.56
Lucian,Riven,93,43,50,46.24
Lucian,DrMundo,118,48,70,40.68
Lucian,Urgot,71,38,33,53.52
Lucian,Rammus,51,26,25,50.98
Lucian,Quinn,57,39,18,68.42
Lucian,Kindred,67,39,28,58.21
Lucian,Ahri,251,118,133,47.01
Lucian,Kassadin,36,15,21,41.67
Lucian,Swain,207,108,99,52.17
Lucian,Yorick,134,67,67,50
Lucian,Rumble,72,38,34,52.78
Lucian,Aatrox,192,77,115,40.1
Lucian,Sion,139,66,73,47.48
Lucian,Zac,105,65,40,61.9
Lucian,Ziggs,70,33,37,47.14
Lucian,Udyr,48,18,30,37.5
Lucian,Kalista,71,42,29,59.15
Lucian,JarvanIV,158,52,106,32.91
Lucian,Nocturne,212,98,114,46.23
Lucian,Rengar,41,22,19,53.66
Lucian,Galio,190,101,89,53.16
Lucian,Cassiopeia,54,31,23,57.41
Lucian,Khazix,120,59,61,49.17
Lucian,Sona,32,19,13,59.38
Lucian,XinZhao,118,50,68,42.37
Lucian,Skarner,76,23,53,30.26
Lucian,Elise,133,46,87,34.59
Lucian,Shen,120,38,82,31.67
Lucian,Pyke,142,64,78,45.07
Lucian,Taliyah,54,29,25,53.7
Lucian,Gnar,76,46,30,60.53
Lucian,Evelynn,41,25,16,60.98
Lucian,Shyvana,35,22,13,62.86
Lucian,Nami,186,84,102,45.16
Lucian,Ornn,105,48,57,45.71
Lucian,Naafiri,37,25,12,67.57
Lucian,Karthus,52,18,34,34.62
Lucian,Fiora,55,29,26,52.73
Lucian,Orianna,90,33,57,36.67
Lucian,Viego,202,96,106,47.52
Lucian,Nilah,45,16,29,35.56
Lucian,Taric,33,14,19,42.42
Lucian,Maokai,67,34,33,50.75
Lucian,AurelionSol,51,18,33,35.29
Lucian,Nunu,101,47,54,46.53
Lucian,Qiyana,37,15,22,40.54
Lucian,Neeko,101,47,54,46.53
Lucian,Anivia,60,27,33,45
Lucian,Belveth,46,23,23,50
Lucian,Bard,42,29,13,69.05
Lucian,RekSai,16,9,7,56.25
Lucian,Velkoz,58,36,22,62.07
Lucian,Lissandra,59,25,34,42.37
Lucian,Graves,88,31,57,35.23
Lucian,Tryndamere,42,16,26,38.1
Lucian,Ryze,62,41,21,66.13
Lucian,KSante,79,48,31,60.76
Lucian,Zilean,36,15,21,41.67
Lucian,Renata,45,29,16,64.44
Lucian,Kennen,41,16,25,39.02
Blitzcrank,Yone,391,226,165,57.8
Blitzcrank,FiddleSticks,92,46,46,50
Blitzcrank,Aurora,140,60,80,42.86
Blitzcrank,Vayne,205,83,122,40.49
Blitzcrank,Senna,103,48,55,46.6
Blitzcrank,Heimerdinger,64,38,26,59.38
Blitzcrank,Gragas,161,94,67,58.39
Blitzcrank,Viktor,154,75,79,48.7
Blitzcrank,Jinx,415,191,224,46.02
Blitzcrank,Pyke,216,118,98,54.63
Blitzcrank,Nasus,104,44,60,42.31
Blitzcrank,Shaco,134,67,67,50
Blitzcrank,Xerath,165,74,91,44.85
Blitzcrank,Caitlyn,548,294,254,53.65
Blitzcrank,Lulu,267,126,141,47.19
Blitzcrank,Jayce,120,64,56,53.33
Blitzcrank,Elise,183,94,89,51.37
Blitzcrank,Lux,472,250,222,52.97
Blitzcrank,Yorick,166,72,94,43.37
Blitzcrank,Zilean,70,36,34,51.43
Blitzcrank,Darius,322,157,165,48.76
Blitzcrank,Kayn,258,117,141,45.35
Blitzcrank,Veigar,200,79,121,39.5
Blitzcrank,Varus,183,94,89,51.37
Blitzcrank,Kalista,79,34,45,43.04
Blitzcrank,Amumu,233,92,141,39.48
Blitzcrank,Ashe,386,216,170,55.96
Blitzcrank,Irelia,142,63,79,44.37
Blitzcrank,Milio,129,82,47,63.57
Blitzcrank,Hwei,130,69,61,53.08
Blitzcrank,Samira,163,70,93,42.94
Blitzcrank,Zyra,173,73,100,42.2
Blitzcrank,Yasuo,386,211,175,54.66
Blitzcrank,Sett,337,182,155,54.01
Blitzcrank,Warwick,296,140,156,47.3
Blitzcrank,Karma,205,95,110,46.34
Blitzcrank,Ekko,149,67,82,44.97
Blitzcrank,Katarina,123,74,49,60.16
Blitzcrank,Mordekaiser,242,120,122,49.59
Blitzcrank,Ziggs,49,24,25,48.98
Blitzcrank,Nautilus,316,162,154,51.27
Blitzcrank,Jax,171,70,101,40.94
Blitzcrank,Akali,187,88,99,47.06
Blitzcrank,Taliyah,58,27,31,46.55
Blitzcrank,Xayah,130,74,56,56.92
Blitzcrank,Aatrox,177,105,72,59.32
Blitzcrank,Pantheon,272,141,131,51.84
Blitzcrank,Annie,64,27,37,42.19
Blitzcrank,Chogath,242,86,156,35.54
Blitzcrank,Evelynn,66,24,42,36.36
Blitzcrank,KogMaw,70,29,41,41.43
Blitzcrank,Riven,86,36,50,41.86
Blitzcrank,MonkeyKing,101,52,49,51.49
Blitzcrank,AurelionSol,65,23,42,35.38
Blitzcrank,Poppy,139,70,69,50.36
Blitzcrank,TahmKench,162,76,86,46.91
Blitzcrank,Diana,309,151,158,48.87
Blitzcrank,Leona,254,133,121,52.36
Blitzcrank,MissFortune,393,188,205,47.84
Blitzcrank,Ivern,60,23,37,38.33
Blitzcrank,Anivia,69,33,36,47.83
Blitzcrank,Thresh,329,133,196,40.43
Blitzcrank,Teemo,174,85,89,48.85
Blitzcrank,Ezreal,578,280,298,48.44
Blitzcrank,Rumble,41,21,20,51.22
Blitzcrank,Maokai,74,32,42,43.24
Blitzcrank,Zed,221,86,135,38.91
Blitzcrank,Malphite,208,97,111,46.63
Blitzcrank,Viego,284,143,141,50.35
Blitzcrank,Kayle,100,39,61,39
Blitzcrank,Jhin,349,186,163,53.3
Blitzcrank,Yuumi,150,70,80,46.67
Blitzcrank,Urgot,93,45,48,48.39
Blitzcrank,Karthus,43,21,22,48.84
Blitzcrank,JarvanIV,114,55,59,48.25
Blitzcrank,Leblanc,147,81,66,55.1
Blitzcrank,Lucian,174,80,94,45.98
Blitzcrank,Nami,169,77,92,45.56
Blitzcrank,Mel,342,156,186,45.61
Blitzcrank,Draven,100,44,56,44
Blitzcrank,Renekton,123,69,54,56.1
Blitzcrank,Nidalee,79,52,27,65.82
Blitzcrank,Hecarim,63,25,38,39.68
Blitzcrank,Azir,84,30,54,35.71
Blitzcrank,Ahri,324,165,159,50.93
Blitzcrank,Taric,42,22,20,52.38
Blitzcrank,Ornn,126,64,62,50.79
Blitzcrank,Rengar,55,33,22,60
Blitzcrank,Morgana,257,103,154,40.08
Blitzcrank,Kindred,71,51,20,71.83
Blitzcrank,Gangplank,76,42,34,55.26
Blitzcrank,Zeri,87,50,37,57.47
Blitzcrank,Alistar,159,65,94,40.88
Blitzcrank,Garen,298,146,152,48.99
Blitzcrank,Khazix,73,35,38,47.95
Blitzcrank,Illaoi,84,34,50,40.48
Blitzcrank,Zac,115,62,53,53.91
Blitzcrank,Nocturne,211,112,99,53.08
Blitzcrank,Kaisa,258,134,124,51.94
Blitzcrank,Kled,24,8,16,33.33
Blitzcrank,Gnar,103,55,48,53.4
Blitzcrank,Lillia,109,40,69,36.7
Blitzcrank,XinZhao,127,72,55,56.69
Blitzcrank,Shen,150,95,55,63.33
Blitzcrank,Rakan,123,51,72,41.46
Blitzcrank,Volibear,208,103,105,49.52
Blitzcrank,Tristana,174,71,103,40.8
Blitzcrank,Briar,104,47,57,45.19
Blitzcrank,Gwen,79,34,45,43.04
Blitzcrank,Neeko,104,67,37,64.42
Blitzcrank,Bard,54,22,32,40.74
Blitzcrank,TwistedFate,68,33,35,48.53
Blitzcrank,Sylas,403,173,230,42.93
Blitzcrank,Braum,145,80,65,55.17
Blitzcrank,MasterYi,146,75,71,51.37
Blitzcrank,Ambessa,161,97,64,60.25
Blitzcrank,LeeSin,364,183,181,50.27
Blitzcrank,Sivir,133,64,69,48.12
Blitzcrank,Seraphine,112,60,52,53.57
Blitzcrank,Smolder,80,44,36,55
Blitzcrank,Lissandra,67,24,43,35.82
Blitzcrank,Sion,138,60,78,43.48
Blitzcrank,Galio,179,86,93,48.04
Blitzcrank,Sejuani,112,50,62,44.64
Blitzcrank,Zoe,85,49,36,57.65
Blitzcrank,Orianna,100,43,57,43
Blitzcrank,Olaf,43,25,18,58.14
Blitzcrank,Syndra,130,85,45,65.38
Blitzcrank,Sona,30,11,19,36.67
Blitzcrank,Skarner,78,38,40,48.72
Blitzcrank,Talon,131,70,61,53.44
Blitzcrank,Rammus,90,34,56,37.78
Blitzcrank,Fiora,61,30,31,49.18
Blitzcrank,Camille,62,28,34,45.16
Blitzcrank,Aphelios,120,54,66,45
Blitzcrank,Swain,150,73,77,48.67
Blitzcrank,Rell,154,67,87,43.51
Blitzcrank,DrMundo,92,35,57,38.04
Blitzcrank,Udyr,66,37,29,56.06
Blitzcrank,Vladimir,87,33,54,37.93
Blitzcrank,Malzahar,154,67,87,43.51
Blitzcrank,Velkoz,91,44,47,48.35
Blitzcrank,Trundle,95,43,52,45.26
Blitzcrank,Twitch,125,64,61,51.2
Blitzcrank,Graves,121,53,68,43.8
Blitzcrank,Vex,122,56,66,45.9
Blitzcrank,Brand,83,44,39,53.01
Blitzcrank,Naafiri,57,40,17,70.18
Blitzcrank,KSante,128,65,63,50.78
Blitzcrank,Vi,244,128,116,52.46
Blitzcrank,Shyvana,43,16,27,37.21
Blitzcrank,Belveth,41,13,28,31.71
Blitzcrank,Qiyana,46,23,23,50
Blitzcrank,Janna,41,18,23,43.9
Blitzcrank,Corki,68,36,32,52.94
Blitzcrank,Quinn,84,34,50,40.48
Blitzcrank,Fizz,70,37,33,52.86
Blitzcrank,Cassiopeia,33,20,13,60.61
Blitzcrank,Ryze,65,27,38,41.54
Blitzcrank,Tryndamere,62,32,30,51.61
Blitzcrank,Singed,38,5,33,13.16
Blitzcrank,Nilah,51,19,32,37.25
Blitzcrank,Soraka,60,24,36,40
Blitzcrank,Nunu,97,48,49,49.48
Blitzcrank,Kassadin,29,17,12,58.62
Blitzcrank,Renata,43,14,29,32.56
Blitzcrank,Kennen,18,8,10,44.44
Blitzcrank,Akshan,44,18,26,40.91
Blitzcrank,RekSai,30,14,16,46.67
FiddleSticks,Ivern,13,8,5,61.54
FiddleSticks,Renekton,38,23,15,60.53
FiddleSticks,Vladimir,77,41,36,53.25
FiddleSticks,Lucian,97,49,48,50.52
FiddleSticks,Blitzcrank,92,46,46,50
FiddleSticks,Corki,40,12,28,30
FiddleSticks,Ekko,85,41,44,48.24
FiddleSticks,Leblanc,44,22,22,50
FiddleSticks,Caitlyn,237,109,128,45.99
FiddleSticks,Mel,189,110,79,58.2
FiddleSticks,Mordekaiser,118,42,76,35.59
FiddleSticks,Viego,120,55,65,45.83
FiddleSticks,Yone,148,82,66,55.41
FiddleSticks,Rakan,63,41,22,65.08
FiddleSticks,Jax,77,40,37,51.95
FiddleSticks,MasterYi,116,69,47,59.48
FiddleSticks,Malzahar,86,40,46,46.51
FiddleSticks,Morgana,110,50,60,45.45
FiddleSticks,Camille,43,27,16,62.79
FiddleSticks,Graves,55,33,22,60
FiddleSticks,Hwei,38,22,16,57.89
FiddleSticks,Nilah,12,9,3,75
FiddleSticks,Nami,69,34,35,49.28
FiddleSticks,Shen,69,36,33,52.17
FiddleSticks,Karthus,30,15,15,50
FiddleSticks,Ezreal,203,120,83,59.11
FiddleSticks,Soraka,40,25,15,62.5
FiddleSticks,Aphelios,58,36,22,62.07
FiddleSticks,Udyr,39,19,20,48.72
FiddleSticks,Yasuo,153,82,71,53.59
FiddleSticks,Heimerdinger,34,13,21,38.24
FiddleSticks,Kindred,44,24,20,54.55
FiddleSticks,MissFortune,181,102,79,56.35
FiddleSticks,Sona,30,12,18,40
FiddleSticks,Darius,159,87,72,54.72
FiddleSticks,Vi,77,52,25,67.53
FiddleSticks,Sylas,138,92,46,66.67
FiddleSticks,Jinx,197,95,102,48.22
FiddleSticks,Diana,144,83,61,57.64
FiddleSticks,Yorick,56,21,35,37.5
FiddleSticks,Veigar,94,46,48,48.94
FiddleSticks,Nasus,53,35,18,66.04
FiddleSticks,Tryndamere,36,24,12,66.67
FiddleSticks,MonkeyKing,55,22,33,40
FiddleSticks,Ashe,207,106,101,51.21
FiddleSticks,Milio,53,30,23,56.6
FiddleSticks,DrMundo,77,33,44,42.86
FiddleSticks,Briar,47,17,30,36.17
FiddleSticks,Galio,113,57,56,50.44
FiddleSticks,Nunu,67,46,21,68.66
FiddleSticks,Gwen,61,28,33,45.9
FiddleSticks,Khazix,65,32,33,49.23
FiddleSticks,Seraphine,61,26,35,42.62
FiddleSticks,Nidalee,33,26,7,78.79
FiddleSticks,Vex,61,39,22,63.93
FiddleSticks,Sivir,53,33,20,62.26
FiddleSticks,Rell,51,25,26,49.02
FiddleSticks,Shaco,75,43,32,57.33
FiddleSticks,Irelia,58,38,20,65.52
FiddleSticks,Teemo,71,40,31,56.34
FiddleSticks,AurelionSol,17,5,12,29.41
FiddleSticks,Kaisa,125,63,62,50.4
FiddleSticks,Sion,63,39,24,61.9
FiddleSticks,Lux,165,90,75,54.55
FiddleSticks,Xayah,70,44,26,62.86
FiddleSticks,Nautilus,105,59,46,56.19
FiddleSticks,Malphite,64,35,29,54.69
FiddleSticks,Warwick,77,27,50,35.06
FiddleSticks,Vayne,90,49,41,54.44
FiddleSticks,Yuumi,72,43,29,59.72
FiddleSticks,Rumble,47,34,13,72.34
FiddleSticks,Ambessa,52,40,12,76.92
FiddleSticks,Lulu,109,70,39,64.22
FiddleSticks,Zac,62,33,29,53.23
FiddleSticks,Zed,79,49,30,62.03
FiddleSticks,Jhin,177,95,82,53.67
FiddleSticks,Hecarim,27,22,5,81.48
FiddleSticks,Katarina,40,24,16,60
FiddleSticks,Karma,105,52,53,49.52
FiddleSticks,Gangplank,25,16,9,64
FiddleSticks,Senna,54,33,21,61.11
FiddleSticks,Lillia,42,20,22,47.62
FiddleSticks,Singed,31,7,24,22.58
FiddleSticks,Kayn,110,72,38,65.45
FiddleSticks,Pyke,79,41,38,51.9
FiddleSticks,Samira,50,33,17,66
FiddleSticks,Sett,112,62,50,55.36
FiddleSticks,Swain,87,37,50,42.53
FiddleSticks,Zyra,85,26,59,30.59
FiddleSticks,Akali,78,50,28,64.1
FiddleSticks,Rammus,27,19,8,70.37
FiddleSticks,Cassiopeia,35,20,15,57.14
FiddleSticks,Ahri,138,61,77,44.2
FiddleSticks,XinZhao,105,51,54,48.57
FiddleSticks,Varus,92,48,44,52.17
FiddleSticks,Maokai,64,29,35,45.31
FiddleSticks,Amumu,90,47,43,52.22
FiddleSticks,Zoe,37,22,15,59.46
FiddleSticks,Kled,15,11,4,73.33
FiddleSticks,Viktor,103,62,41,60.19
FiddleSticks,Akshan,28,8,20,28.57
FiddleSticks,Braum,52,33,19,63.46
FiddleSticks,Taric,15,8,7,53.33
FiddleSticks,TahmKench,88,57,31,64.77
FiddleSticks,Poppy,57,30,27,52.63
FiddleSticks,Garen,131,55,76,41.98
FiddleSticks,Lissandra,27,12,15,44.44
FiddleSticks,Skarner,30,11,19,36.67
FiddleSticks,Thresh,184,88,96,47.83
FiddleSticks,Volibear,104,44,60,42.31
FiddleSticks,Xerath,64,24,40,37.5
FiddleSticks,Evelynn,31,17,14,54.84
FiddleSticks,Syndra,64,28,36,43.75
FiddleSticks,Fizz,39,30,9,76.92
FiddleSticks,KSante,47,27,20,57.45
FiddleSticks,Aatrox,79,49,30,62.03
FiddleSticks,Naafiri,28,20,8,71.43
FiddleSticks,Anivia,18,6,12,33.33
FiddleSticks,Pantheon,148,64,84,43.24
FiddleSticks,Kennen,36,22,14,61.11
FiddleSticks,Shyvana,20,6,14,30
FiddleSticks,Tristana,74,41,33,55.41
FiddleSticks,Sejuani,47,28,19,59.57
FiddleSticks,Belveth,16,6,10,37.5
FiddleSticks,Qiyana,24,16,8,66.67
FiddleSticks,Leona,70,34,36,48.57
FiddleSticks,LeeSin,126,66,60,52.38
FiddleSticks,Draven,39,17,22,43.59
FiddleSticks,Alistar,61,33,28,54.1
FiddleSticks,Trundle,58,28,30,48.28
FiddleSticks,Brand,84,46,38,54.76
FiddleSticks,Chogath,114,58,56,50.88
FiddleSticks,Talon,49,29,20,59.18
FiddleSticks,Renata,32,16,16,50
FiddleSticks,Rengar,31,23,8,74.19
FiddleSticks,Ryze,39,20,19,51.28
FiddleSticks,Zeri,42,27,15,64.29
FiddleSticks,Smolder,56,30,26,53.57
FiddleSticks,Twitch,71,36,35,50.7
FiddleSticks,Elise,66,45,21,68.18
FiddleSticks,Riven,45,31,14,68.89
FiddleSticks,Bard,41,25,16,60.98
FiddleSticks,Janna,21,13,8,61.9
FiddleSticks,KogMaw,29,13,16,44.83
FiddleSticks,Orianna,53,31,22,58.49
FiddleSticks,Jayce,61,25,36,40.98
FiddleSticks,Kayle,37,13,24,35.14
FiddleSticks,Olaf,39,26,13,66.67
FiddleSticks,Velkoz,38,19,19,50
FiddleSticks,Aurora,59,23,36,38.98
FiddleSticks,Nocturne,86,40,46,46.51
FiddleSticks,Ornn,52,18,34,34.62
FiddleSticks,Urgot,36,14,22,38.89
FiddleSticks,Kassadin,23,10,13,43.48
FiddleSticks,Zilean,30,13,17,43.33
FiddleSticks,Ziggs,27,3,24,11.11
FiddleSticks,Gnar,40,23,17,57.5
FiddleSticks,Fiora,39,28,11,71.79
FiddleSticks,Gragas,45,19,26,42.22
FiddleSticks,Illaoi,41,26,15,63.41
FiddleSticks,Quinn,36,18,18,50
FiddleSticks,Azir,47,21,26,44.68
FiddleSticks,Kalista,19,9,10,47.37
FiddleSticks,JarvanIV,80,26,54,32.5
FiddleSticks,Neeko,23,9,14,39.13
FiddleSticks,Taliyah,25,15,10,60
FiddleSticks,Annie,20,10,10,50
FiddleSticks,TwistedFate,27,9,18,33.33
FiddleSticks,RekSai,12,12,0,100
Aurora,Ivern,29,23,6,79.31
Aurora,Renekton,105,66,39,62.86
Aurora,Vladimir,112,50,62,44.64
Aurora,Lucian,128,83,45,64.84
Aurora,Blitzcrank,140,80,60,57.14
Aurora,Riven,65,27,38,41.54
Aurora,MonkeyKing,81,42,39,51.85
Aurora,Kassadin,27,13,14,48.15
Aurora,Caitlyn,403,172,231,42.68
Aurora,Taliyah,61,33,28,54.1
Aurora,Leblanc,130,63,67,48.46
Aurora,Kayn,175,87,88,49.71
Aurora,Teemo,171,85,86,49.71
Aurora,Ashe,322,168,154,52.17
Aurora,Nautilus,193,84,109,43.52
Aurora,Malzahar,156,78,78,50
Aurora,Garen,244,114,130,46.72
Aurora,Nami,157,72,85,45.86
Aurora,Twitch,88,39,49,44.32
Aurora,Fizz,67,28,39,41.79
Aurora,Kaisa,253,125,128,49.41
Aurora,Karma,209,93,116,44.5
Aurora,Kalista,67,27,40,40.3
Aurora,Amumu,217,101,116,46.54
Aurora,Irelia,128,65,63,50.78
Aurora,Milio,95,45,50,47.37
Aurora,Aatrox,170,82,88,48.24
Aurora,Malphite,133,60,73,45.11
Aurora,Ryze,69,44,25,63.77
Aurora,Leona,166,73,93,43.98
Aurora,Chogath,197,83,114,42.13
Aurora,MasterYi,105,58,47,55.24
Aurora,Gangplank,94,62,32,65.96
Aurora,AurelionSol,40,9,31,22.5
Aurora,Nocturne,187,94,93,50.27
Aurora,Lissandra,54,24,30,44.44
Aurora,MissFortune,308,139,169,45.13
Aurora,Rakan,85,44,41,51.76
Aurora,Sivir,111,67,44,60.36
Aurora,Senna,97,32,65,32.99
Aurora,Yasuo,290,135,155,46.55
Aurora,Xayah,98,43,55,43.88
Aurora,Mordekaiser,180,112,68,62.22
Aurora,Elise,146,86,60,58.9
Aurora,Qiyana,43,23,20,53.49
Aurora,Ornn,105,65,40,61.9
Aurora,Sylas,265,113,152,42.64
Aurora,Jinx,478,226,252,47.28
Aurora,Pyke,111,56,55,50.45
Aurora,Sion,109,37,72,33.94
Aurora,Lux,355,169,186,47.61
Aurora,Seraphine,118,59,59,50
Aurora,Pantheon,254,117,137,46.06
Aurora,Quinn,51,30,21,58.82
Aurora,Nidalee,58,29,29,50
Aurora,Mel,285,124,161,43.51
Aurora,Aphelios,94,45,49,47.87
Aurora,LeeSin,311,152,159,48.87
Aurora,Varus,116,61,55,52.59
Aurora,Rell,128,61,67,47.66
Aurora,Viego,208,118,90,56.73
Aurora,Vex,108,56,52,51.85
Aurora,Jhin,286,135,151,47.2
Aurora,Renata,36,24,12,66.67
Aurora,Gnar,90,42,48,46.67
Aurora,Shyvana,61,25,36,40.98
Aurora,Galio,170,75,95,44.12
Aurora,Xerath,115,45,70,39.13
Aurora,Darius,282,126,156,44.68
Aurora,Corki,72,48,24,66.67
Aurora,Zed,172,65,107,37.79
Aurora,Draven,93,47,46,50.54
Aurora,Urgot,98,62,36,63.27
Aurora,Shaco,124,68,56,54.84
Aurora,Azir,90,43,47,47.78
Aurora,TahmKench,139,60,79,43.17
Aurora,Shen,119,64,55,53.78
Aurora,Briar,82,36,46,43.9
Aurora,Veigar,160,64,96,40
Aurora,Morgana,161,77,84,47.83
Aurora,Ezreal,397,202,195,50.88
Aurora,Vayne,179,82,97,45.81
Aurora,Rammus,56,30,26,53.57
Aurora,KogMaw,49,19,30,38.78
Aurora,Gwen,92,53,39,57.61
Aurora,Khazix,94,37,57,39.36
Aurora,Yone,224,114,110,50.89
Aurora,Warwick,191,94,97,49.21
Aurora,Swain,197,97,100,49.24
Aurora,Hwei,112,67,45,59.82
Aurora,Ekko,136,59,77,43.38
Aurora,Katarina,89,45,44,50.56
Aurora,Gragas,119,50,69,42.02
Aurora,Skarner,84,42,42,50
Aurora,Soraka,79,41,38,51.9
Aurora,Fiora,53,20,33,37.74
Aurora,Diana,231,122,109,52.81
Aurora,Zac,73,37,36,50.68
Aurora,DrMundo,91,30,61,32.97
Aurora,Thresh,333,171,162,51.35
Aurora,Syndra,150,80,70,53.33
Aurora,TwistedFate,48,25,23,52.08
Aurora,Poppy,113,54,59,47.79
Aurora,Camille,83,32,51,38.55
Aurora,Zyra,127,59,68,46.46
Aurora,Brand,79,38,41,48.1
Aurora,Janna,78,52,26,66.67
Aurora,JarvanIV,104,62,42,59.62
Aurora,Ahri,292,141,151,48.29
Aurora,Yuumi,149,63,86,42.28
Aurora,Kayle,105,64,41,60.95
Aurora,XinZhao,142,71,71,50
Aurora,Illaoi,94,35,59,37.23
Aurora,Trundle,95,49,46,51.58
Aurora,Sejuani,119,41,78,34.45
Aurora,Anivia,57,26,31,45.61
Aurora,Braum,126,58,68,46.03
Aurora,Ambessa,140,66,74,47.14
Aurora,Singed,34,8,26,23.53
Aurora,Naafiri,54,32,22,59.26
Aurora,Zeri,74,32,42,43.24
Aurora,Graves,90,36,54,40
Aurora,Nasus,82,32,50,39.02
Aurora,Vi,172,76,96,44.19
Aurora,Lulu,227,130,97,57.27
Aurora,Kled,41,15,26,36.59
Aurora,Viktor,193,101,92,52.33
Aurora,Akshan,73,34,39,46.58
Aurora,Samira,117,67,50,57.26
Aurora,Jayce,96,59,37,61.46
Aurora,Hecarim,70,38,32,54.29
Aurora,Akali,138,73,65,52.9
Aurora,Udyr,56,37,19,66.07
Aurora,Kindred,66,39,27,59.09
Aurora,Smolder,96,44,52,45.83
Aurora,KSante,111,52,59,46.85
Aurora,Ziggs,56,31,25,55.36
Aurora,Sett,210,96,114,45.71
Aurora,Yorick,125,62,63,49.6
Aurora,Tristana,157,81,76,51.59
Aurora,Heimerdinger,63,31,32,49.21
Aurora,Kennen,51,22,29,43.14
Aurora,Volibear,160,83,77,51.88
Aurora,Bard,58,36,22,62.07
Aurora,Lillia,97,39,58,40.21
Aurora,Velkoz,80,29,51,36.25
Aurora,Rumble,64,22,42,34.38
Aurora,Rengar,48,24,24,50
Aurora,Karthus,38,17,21,44.74
Aurora,Zoe,37,10,27,27.03
Aurora,Evelynn,47,15,32,31.91
Aurora,Jax,109,67,42,61.47
Aurora,Orianna,90,38,52,42.22
Aurora,Sona,26,9,17,34.62
Aurora,Cassiopeia,35,14,21,40
Aurora,Alistar,78,46,32,58.97
Aurora,Talon,91,38,53,41.76
Aurora,Tryndamere,66,40,26,60.61
Aurora,Nunu,77,30,47,38.96
Aurora,Neeko,99,64,35,64.65
Aurora,Zilean,46,27,19,58.7
Aurora,Olaf,40,20,20,50
Aurora,Nilah,55,33,22,60
Aurora,FiddleSticks,59,36,23,61.02
Aurora,Annie,39,22,17,56.41
Aurora,Maokai,80,30,50,37.5
Aurora,RekSai,24,14,10,58.33
Aurora,Taric,26,8,18,30.77
Aurora,Belveth,44,16,28,36.36
Rammus,Olaf,25,16,9,64
Rammus,Kayn,112,47,65,41.96
Rammus,Yasuo,204,115,89,56.37
Rammus,Galio,98,43,55,43.88
Rammus,Velkoz,44,18,26,40.91
Rammus,Riven,31,21,10,67.74
Rammus,Shyvana,11,3,8,27.27
Rammus,Ryze,26,20,6,76.92
Rammus,Jhin,146,84,62,57.53
Rammus,Mordekaiser,75,26,49,34.67
Rammus,Chogath,82,42,40,51.22
Rammus,Naafiri,24,13,11,54.17
Rammus,Yone,156,73,83,46.79
Rammus,Gwen,40,19,21,47.5
Rammus,MasterYi,226,125,101,55.31
Rammus,Akshan,26,17,9,65.38
Rammus,Zeri,34,19,15,55.88
Rammus,Rakan,65,39,26,60
Rammus,Sivir,20,10,10,50
Rammus,Ashe,127,66,61,51.97
Rammus,Senna,48,18,30,37.5
Rammus,Irelia,78,47,31,60.26
Rammus,Diana,111,62,49,55.86
Rammus,Morgana,71,33,38,46.48
Rammus,Lux,142,68,74,47.89
Rammus,Sett,102,52,50,50.98
Rammus,Singed,17,5,12,29.41
Rammus,Fizz,53,34,19,64.15
Rammus,Caitlyn,173,84,89,48.55
Rammus,Soraka,48,18,30,37.5
Rammus,XinZhao,51,32,19,62.75
Rammus,Zed,87,29,58,33.33
Rammus,Ezreal,138,75,63,54.35
Rammus,Sion,65,36,29,55.38
Rammus,Fiora,38,17,21,44.74
Rammus,Rengar,15,12,3,80
Rammus,Syndra,60,27,33,45
Rammus,Nilah,21,9,12,42.86
Rammus,Mel,108,50,58,46.3
Rammus,LeeSin,139,66,73,47.48
Rammus,Kassadin,19,14,5,73.68
Rammus,Sylas,98,54,44,55.1
Rammus,Ornn,36,22,14,61.11
Rammus,Akali,69,35,34,50.72
Rammus,Elise,48,24,24,50
Rammus,Draven,48,26,22,54.17
Rammus,Pyke,82,50,32,60.98
Rammus,Aurora,56,26,30,46.43
Rammus,Zac,46,18,28,39.13
Rammus,Kaisa,94,49,45,52.13
Rammus,Zilean,21,8,13,38.1
Rammus,Yorick,60,33,27,55
Rammus,Warwick,123,53,70,43.09
Rammus,Yuumi,70,27,43,38.57
Rammus,Gragas,52,32,20,61.54
Rammus,Azir,33,24,9,72.73
Rammus,Volibear,84,43,41,51.19
Rammus,MissFortune,126,54,72,42.86
Rammus,Poppy,28,19,9,67.86
Rammus,Heimerdinger,42,20,22,47.62
Rammus,AurelionSol,36,14,22,38.89
Rammus,Viego,94,47,47,50
Rammus,Vi,83,38,45,45.78
Rammus,Lucian,51,25,26,49.02
Rammus,Nami,54,21,33,38.89
Rammus,Aatrox,76,43,33,56.58
Rammus,Vladimir,38,29,9,76.32
Rammus,Kled,15,6,9,40
Rammus,Veigar,75,41,34,54.67
Rammus,Vayne,145,43,102,29.66
Rammus,Nautilus,96,52,44,54.17
Rammus,Illaoi,33,6,27,18.18
Rammus,Lillia,55,14,41,25.45
Rammus,Malzahar,73,30,43,41.1
Rammus,Twitch,58,19,39,32.76
Rammus,Lulu,104,52,52,50
Rammus,FiddleSticks,27,8,19,29.63
Rammus,Thresh,105,54,51,51.43
Rammus,Karthus,12,2,10,16.67
Rammus,Xerath,62,24,38,38.71
Rammus,Teemo,52,34,18,65.38
Rammus,Leblanc,47,17,30,36.17
Rammus,Jax,63,31,32,49.21
Rammus,Amumu,63,28,35,44.44
Rammus,Aphelios,38,22,16,57.89
Rammus,Leona,70,31,39,44.29
Rammus,Shaco,33,24,9,72.73
Rammus,Swain,76,34,42,44.74
Rammus,Darius,131,48,83,36.64
Rammus,Jinx,159,69,90,43.4
Rammus,Ambessa,49,23,26,46.94
Rammus,Blitzcrank,90,56,34,62.22
Rammus,Quinn,32,21,11,65.63
Rammus,Alistar,42,21,21,50
Rammus,Brand,25,11,14,44
Rammus,Ekko,61,20,41,32.79
Rammus,KogMaw,41,23,18,56.1
Rammus,Evelynn,10,2,8,20
Rammus,Samira,54,31,23,57.41
Rammus,Tristana,95,58,37,61.05
Rammus,DrMundo,22,11,11,50
Rammus,Sejuani,30,15,15,50
Rammus,Taliyah,9,6,3,66.67
Rammus,Nunu,36,8,28,22.22
Rammus,Urgot,52,14,38,26.92
Rammus,Khazix,27,7,20,25.93
Rammus,Ziggs,29,17,12,58.62
Rammus,Jayce,26,11,15,42.31
Rammus,Orianna,16,8,8,50
Rammus,Zyra,45,14,31,31.11
Rammus,Nocturne,96,50,46,52.08
Rammus,Hwei,42,17,25,40.48
Rammus,Trundle,50,30,20,60
Rammus,Viktor,59,24,35,40.68
Rammus,Braum,54,24,30,44.44
Rammus,Annie,18,3,15,16.67
Rammus,Karma,75,48,27,64
Rammus,Garen,103,53,50,51.46
Rammus,Maokai,35,22,13,62.86
Rammus,Milio,34,19,15,55.88
Rammus,Tryndamere,48,16,32,33.33
Rammus,Ivern,16,11,5,68.75
Rammus,Talon,29,6,23,20.69
Rammus,Graves,43,27,16,62.79
Rammus,Kennen,21,11,10,52.38
Rammus,Camille,21,9,12,42.86
Rammus,Sona,16,8,8,50
Rammus,Lissandra,42,28,14,66.67
Rammus,TwistedFate,27,14,13,51.85
Rammus,Seraphine,54,21,33,38.89
Rammus,Qiyana,19,8,11,42.11
Rammus,Rumble,26,17,9,65.38
Rammus,Pantheon,113,52,61,46.02
Rammus,Hecarim,15,3,12,20
Rammus,Malphite,106,51,55,48.11
Rammus,Ahri,80,55,25,68.75
Rammus,TahmKench,74,27,47,36.49
Rammus,Smolder,45,23,22,51.11
Rammus,Varus,64,30,34,46.88
Rammus,Briar,74,38,36,51.35
Rammus,Xayah,44,24,20,54.55
Rammus,Janna,10,3,7,30
Rammus,Cassiopeia,16,5,11,31.25
Rammus,Nidalee,18,16,2,88.89
Rammus,JarvanIV,39,28,11,71.79
Rammus,Corki,43,22,21,51.16
Rammus,Kayle,33,17,16,51.52
Rammus,Katarina,26,13,13,50
Rammus,Nasus,34,16,18,47.06
Rammus,Zoe,41,18,23,43.9
Rammus,Kindred,22,14,8,63.64
Rammus,Renekton,42,22,20,52.38
Rammus,Vex,57,33,24,57.89
Rammus,Shen,46,17,29,36.96
Rammus,Kalista,31,15,16,48.39
Rammus,Gnar,33,13,20,39.39
Rammus,Anivia,25,14,11,56
Rammus,Belveth,11,6,5,54.55
Rammus,MonkeyKing,30,23,7,76.67
Rammus,Bard,19,14,5,73.68
Rammus,Renata,20,6,14,30
Rammus,Neeko,24,13,11,54.17
Rammus,KSante,19,8,11,42.11
Rammus,RekSai,12,10,2,83.33
Rammus,Rell,21,9,12,42.86
Rammus,Taric,8,8,0,100
Rammus,Udyr,15,9,6,60
Rammus,Gangplank,14,8,6,57.14
Rammus,Skarner,26,17,9,65.38
Annie,Olaf,31,17,14,54.84
Annie,Kayn,102,58,44,56.86
Annie,Yasuo,177,93,84,52.54
Annie,Galio,52,21,31,40.38
Annie,Velkoz,52,21,31,40.38
Annie,Ashe,149,70,79,46.98
Annie,Graves,56,31,25,55.36
Annie,Lucian,67,40,27,59.7
Annie,Vayne,68,40,28,58.82
Annie,Draven,32,18,14,56.25
Annie,Yone,126,57,69,45.24
Annie,Malzahar,65,28,37,43.08
Annie,KogMaw,23,11,12,47.83
Annie,Veigar,84,42,42,50
Annie,Kennen,20,12,8,60
Annie,Garen,78,33,45,42.31
Annie,Talon,37,14,23,37.84
Annie,Aphelios,26,12,14,46.15
Annie,Pyke,57,29,28,50.88
Annie,Trundle,46,31,15,67.39
Annie,MasterYi,50,35,15,70
Annie,Fizz,41,17,24,41.46
Annie,Jinx,170,82,88,48.24
Annie,Thresh,110,50,60,45.45
Annie,KSante,46,17,29,36.96
Annie,LeeSin,119,61,58,51.26
Annie,Ahri,102,51,51,50
Annie,Seraphine,51,35,16,68.63
Annie,Heimerdinger,32,15,17,46.88
Annie,Jhin,140,71,69,50.71
Annie,Blitzcrank,64,37,27,57.81
Annie,Zac,60,32,28,53.33
Annie,Corki,32,11,21,34.38
Annie,Nautilus,87,38,49,43.68
Annie,Gnar,26,6,20,23.08
Annie,Shaco,21,15,6,71.43
Annie,Caitlyn,138,77,61,55.8
Annie,Maokai,24,13,11,54.17
Annie,Renekton,26,15,11,57.69
Annie,Varus,66,37,29,56.06
Annie,TahmKench,75,31,44,41.33
Annie,Darius,93,38,55,40.86
Annie,Nocturne,68,21,47,30.88
Annie,Senna,31,15,16,48.39
Annie,Nunu,24,9,15,37.5
Annie,MissFortune,105,50,55,47.62
Annie,Jax,65,41,24,63.08
Annie,Zeri,34,17,17,50
Annie,Alistar,26,11,15,42.31
Annie,Singed,13,3,10,23.08
Annie,Gragas,52,27,25,51.92
Annie,Zed,70,52,18,74.29
Annie,Kayle,36,26,10,72.22
Annie,Vladimir,34,23,11,67.65
Annie,Lux,142,74,68,52.11
Annie,Yorick,43,29,14,67.44
Annie,Amumu,56,23,33,41.07
Annie,Mel,138,65,73,47.1
Annie,Riven,19,8,11,42.11
Annie,Sylas,91,54,37,59.34
Annie,Xayah,57,36,21,63.16
Annie,Rakan,43,23,20,53.49
Annie,Rammus,18,15,3,83.33
Annie,Belveth,16,6,10,37.5
Annie,Lissandra,22,18,4,81.82
Annie,Bard,24,14,10,58.33
Annie,Kaisa,92,55,37,59.78
Annie,Elise,50,24,26,48
Annie,Leblanc,40,14,26,35
Annie,Braum,42,26,16,61.9
Annie,Mordekaiser,68,28,40,41.18
Annie,Yuumi,45,15,30,33.33
Annie,Ekko,52,32,20,61.54
Annie,Rell,56,24,32,42.86
Annie,Camille,18,9,9,50
Annie,Diana,110,62,48,56.36
Annie,Samira,46,24,22,52.17
Annie,Hwei,50,25,25,50
Annie,Nilah,23,16,7,69.57
Annie,Milio,27,16,11,59.26
Annie,Aatrox,62,26,36,41.94
Annie,Lillia,37,23,14,62.16
Annie,Janna,11,6,5,54.55
Annie,Nasus,35,16,19,45.71
Annie,Pantheon,107,55,52,51.4
Annie,Irelia,38,13,25,34.21
Annie,Zilean,22,10,12,45.45
Annie,Leona,71,41,30,57.75
Annie,Teemo,80,53,27,66.25
Annie,Viktor,35,19,16,54.29
Annie,Sett,66,29,37,43.94
Annie,Warwick,94,49,45,52.13
Annie,Swain,63,22,41,34.92
Annie,Ambessa,40,17,23,42.5
Annie,Ezreal,158,86,72,54.43
Annie,DrMundo,27,22,5,81.48
Annie,Udyr,25,17,8,68
Annie,Chogath,90,47,43,52.22
Annie,Xerath,58,28,30,48.28
Annie,Shen,40,17,23,42.5
Annie,Gwen,40,22,18,55
Annie,MonkeyKing,42,23,19,54.76
Annie,AurelionSol,18,11,7,61.11
Annie,Volibear,73,43,30,58.9
Annie,JarvanIV,60,25,35,41.67
Annie,Renata,17,10,7,58.82
Annie,Syndra,63,36,27,57.14
Annie,Katarina,16,8,8,50
Annie,Poppy,34,26,8,76.47
Annie,Fiora,15,7,8,46.67
Annie,Naafiri,18,5,13,27.78
Annie,Twitch,34,22,12,64.71
Annie,Karthus,18,11,7,61.11
Annie,Quinn,28,15,13,53.57
Annie,Vi,78,38,40,48.72
Annie,Cassiopeia,20,9,11,45
Annie,Zyra,46,32,14,69.57
Annie,Aurora,39,17,22,43.59
Annie,RekSai,17,5,12,29.41
Annie,Sion,54,31,23,57.41
Annie,Malphite,60,31,29,51.67
Annie,Nami,81,49,32,60.49
Annie,XinZhao,56,30,26,53.57
Annie,Akshan,15,12,3,80
Annie,Karma,84,38,46,45.24
Annie,Brand,49,21,28,42.86
Annie,Anivia,16,2,14,12.5
Annie,Tryndamere,19,9,10,47.37
Annie,Illaoi,30,22,8,73.33
Annie,Tristana,48,28,20,58.33
Annie,Shyvana,14,2,12,14.29
Annie,Ziggs,17,5,12,29.41
Annie,Taric,22,9,13,40.91
Annie,Azir,29,14,15,48.28
Annie,Kalista,17,3,14,17.65
Annie,Urgot,34,26,8,76.47
Annie,Morgana,57,27,30,47.37
Annie,Evelynn,13,6,7,46.15
Annie,Lulu,71,32,39,45.07
Annie,FiddleSticks,20,10,10,50
Annie,Zoe,20,6,14,30
Annie,Viego,55,26,29,47.27
Annie,Sona,16,11,5,68.75
Annie,Ryze,14,7,7,50
Annie,Smolder,28,18,10,64.29
Annie,Neeko,20,12,8,60
Annie,Vex,34,19,15,55.88
Annie,Kindred,14,7,7,50
Annie,Sejuani,53,24,29,45.28
Annie,Hecarim,10,3,7,30
Annie,Ivern,8,0,8,0
Annie,Taliyah,22,17,5,77.27
Annie,Ornn,54,27,27,50
Annie,Sivir,29,5,24,17.24
Annie,Briar,20,14,6,70
Annie,Soraka,13,11,2,84.62
Annie,Akali,46,26,20,56.52
Annie,Rengar,16,6,10,37.5
Annie,Gangplank,32,17,15,53.13
Annie,Nidalee,36,21,15,58.33
Annie,Jayce,18,9,9,50
Annie,Skarner,25,12,13,48
Annie,Orianna,20,9,11,45
Annie,Rumble,12,9,3,75
Annie,TwistedFate,32,11,21,34.38
Annie,Qiyana,6,6,0,100
Annie,Khazix,16,11,5,68.75
Annie,Kled,8,8,0,100
Annie,Kassadin,5,3,2,60
Olaf,DrMundo,33,18,15,54.55
Olaf,Rammus,25,9,16,36
Olaf,Annie,31,14,17,45.16
Olaf,Ezreal,156,81,75,51.92
Olaf,Renata,12,0,12,0
Olaf,Garen,68,29,39,42.65
Olaf,Warwick,92,42,50,45.65
Olaf,Ahri,69,31,38,44.93
Olaf,Jinx,132,62,70,46.97
Olaf,Milio,40,17,23,42.5
Olaf,Nasus,51,29,22,56.86
Olaf,Viego,87,39,48,44.83
Olaf,Cassiopeia,19,8,11,42.11
Olaf,Karma,58,24,34,41.38
Olaf,TahmKench,50,19,31,38
Olaf,JarvanIV,40,19,21,47.5
Olaf,Viktor,46,20,26,43.48
Olaf,Kaisa,66,32,34,48.48
Olaf,Morgana,67,35,32,52.24
Olaf,Pantheon,64,29,35,45.31
Olaf,Shaco,39,20,19,51.28
Olaf,Mel,139,86,53,61.87
Olaf,Lucian,40,21,19,52.5
Olaf,Swain,63,28,35,44.44
Olaf,Sylas,71,37,34,52.11
Olaf,Jhin,71,36,35,50.7
Olaf,Nautilus,88,44,44,50
Olaf,Kayle,10,5,5,50
Olaf,Kindred,19,13,6,68.42
Olaf,Tristana,33,14,19,42.42
Olaf,Volibear,50,26,24,52
Olaf,Kayn,62,35,27,56.45
Olaf,Akali,34,22,12,64.71
Olaf,Ashe,125,58,67,46.4
Olaf,Mordekaiser,114,62,52,54.39
Olaf,Talon,26,15,11,57.69
Olaf,Chogath,100,39,61,39
Olaf,Veigar,52,21,31,40.38
Olaf,MissFortune,111,57,54,51.35
Olaf,Leona,63,39,24,61.9
Olaf,Vi,73,37,36,50.68
Olaf,Nilah,20,14,6,70
Olaf,Kled,25,11,14,44
Olaf,Nocturne,61,31,30,50.82
Olaf,Rell,48,33,15,68.75
Olaf,Orianna,35,24,11,68.57
Olaf,Thresh,94,47,47,50
Olaf,AurelionSol,22,9,13,40.91
Olaf,Zyra,31,22,9,70.97
Olaf,Aatrox,38,27,11,71.05
Olaf,Vayne,67,22,45,32.84
Olaf,Varus,68,48,20,70.59
Olaf,Soraka,27,16,11,59.26
Olaf,Graves,35,20,15,57.14
Olaf,Kassadin,10,4,6,40
Olaf,Aphelios,31,15,16,48.39
Olaf,Blitzcrank,43,18,25,41.86
Olaf,Darius,75,28,47,37.33
Olaf,Nunu,33,15,18,45.45
Olaf,Katarina,26,9,17,34.62
Olaf,Braum,43,21,22,48.84
Olaf,Sett,78,37,41,47.44
Olaf,Khazix,30,14,16,46.67
Olaf,Xerath,41,17,24,41.46
Olaf,Samira,37,28,9,75.68
Olaf,Gangplank,35,17,18,48.57
Olaf,Sivir,39,22,17,56.41
Olaf,Camille,19,15,4,78.95
Olaf,Irelia,23,15,8,65.22
Olaf,Zilean,22,7,15,31.82
Olaf,Lux,117,70,47,59.83
Olaf,TwistedFate,20,14,6,70
Olaf,Jax,44,16,28,36.36
Olaf,Urgot,12,8,4,66.67
Olaf,Brand,29,19,10,65.52
Olaf,Xayah,32,19,13,59.38
Olaf,Seraphine,32,18,14,56.25
Olaf,Heimerdinger,28,10,18,35.71
Olaf,Renekton,14,3,11,21.43
Olaf,Elise,39,18,21,46.15
Olaf,Yasuo,99,57,42,57.58
Olaf,Poppy,49,27,22,55.1
Olaf,Malphite,46,28,18,60.87
Olaf,Ziggs,16,8,8,50
Olaf,Taliyah,27,13,14,48.15
Olaf,Smolder,37,27,10,72.97
Olaf,Rengar,9,4,5,44.44
Olaf,Hwei,50,29,21,58
Olaf,Ivern,18,7,11,38.89
Olaf,Illaoi,45,23,22,51.11
Olaf,Janna,21,7,14,33.33
Olaf,Caitlyn,128,70,58,54.69
Olaf,Nami,34,20,14,58.82
Olaf,LeeSin,84,46,38,54.76
Olaf,Teemo,38,11,27,28.95
Olaf,Gragas,48,36,12,75
Olaf,Neeko,28,19,9,67.86
Olaf,Sejuani,41,17,24,41.46
Olaf,Trundle,44,26,18,59.09
Olaf,Ekko,39,29,10,74.36
Olaf,MasterYi,36,11,25,30.56
Olaf,Yuumi,27,22,5,81.48
Olaf,Rumble,18,12,6,66.67
Olaf,Lulu,72,30,42,41.67
Olaf,Draven,24,12,12,50
Olaf,Briar,30,17,13,56.67
Olaf,Zed,42,18,24,42.86
Olaf,Sona,3,3,0,100
Olaf,Aurora,40,20,20,50
Olaf,Yone,72,52,20,72.22
Olaf,Amumu,54,21,33,38.89
Olaf,Anivia,21,7,14,33.33
Olaf,Senna,38,20,18,52.63
Olaf,XinZhao,16,13,3,81.25
Olaf,Naafiri,12,7,5,58.33
Olaf,Yorick,33,13,20,39.39
Olaf,Galio,46,7,39,15.22
Olaf,Twitch,36,22,14,61.11
Olaf,Tryndamere,11,6,5,54.55
Olaf,FiddleSticks,39,13,26,33.33
Olaf,Akshan,11,3,8,27.27
Olaf,Nidalee,29,16,13,55.17
Olaf,Alistar,24,15,9,62.5
Olaf,Kennen,18,8,10,44.44
Olaf,Rakan,42,21,21,50
Olaf,Udyr,8,5,3,62.5
Olaf,Vex,27,14,13,51.85
Olaf,Hecarim,24,19,5,79.17
Olaf,Leblanc,17,14,3,82.35
Olaf,Shen,47,21,26,44.68
Olaf,Pyke,45,31,14,68.89
Olaf,Kalista,17,17,0,100
Olaf,Fizz,27,14,13,51.85
Olaf,Ambessa,25,13,12,52
Olaf,Gnar,41,30,11,73.17
Olaf,Skarner,34,26,8,76.47
Olaf,MonkeyKing,23,9,14,39.13
Olaf,Diana,53,29,24,54.72
Olaf,Syndra,53,24,29,45.28
Olaf,Zac,40,21,19,52.5
Olaf,Corki,18,5,13,27.78
Olaf,Zeri,28,19,9,67.86
Olaf,KSante,30,26,4,86.67
Olaf,Evelynn,7,2,5,28.57
Olaf,Riven,19,9,10,47.37
Olaf,Lissandra,25,9,16,36
Olaf,Malzahar,64,29,35,45.31
Olaf,Taric,12,7,5,58.33
Olaf,Sion,39,28,11,71.79
Olaf,Azir,19,16,3,84.21
Olaf,Maokai,35,20,15,57.14
Olaf,Vladimir,10,4,6,40
Olaf,Fiora,16,10,6,62.5
Olaf,Belveth,4,4,0,100
Olaf,Singed,20,9,11,45
Olaf,Velkoz,23,9,14,39.13
Olaf,Ryze,20,12,8,60
Olaf,Ornn,31,26,5,83.87
Olaf,Bard,11,9,2,81.82
Olaf,Qiyana,10,8,2,80
Olaf,Gwen,16,11,5,68.75
Olaf,Quinn,13,8,5,61.54
Olaf,Jayce,34,11,23,32.35
Olaf,RekSai,5,5,0,100
Olaf,Lillia,27,15,12,55.56
Olaf,KogMaw,3,0,3,0
Olaf,Karthus,9,3,6,33.33
Olaf,Shyvana,8,0,8,0
Olaf,Zoe,6,3,3,50
Corki,Teemo,64,39,25,60.94
Corki,FiddleSticks,40,28,12,70
Corki,Hwei,62,36,26,58.06
Corki,Twitch,64,25,39,39.06
Corki,Seraphine,68,27,41,39.71
Corki,Singed,21,3,18,14.29
Corki,Darius,135,78,57,57.78
Corki,Smolder,69,34,35,49.28
Corki,Mel,176,112,64,63.64
Corki,Pantheon,137,74,63,54.01
Corki,Garen,151,74,77,49.01
Corki,Fizz,37,23,14,62.16
Corki,Kaisa,171,62,109,36.26
Corki,Karma,123,48,75,39.02
Corki,Irelia,61,33,28,54.1
Corki,Ekko,45,15,30,33.33
Corki,Qiyana,43,14,29,32.56
Corki,Ashe,163,87,76,53.37
Corki,Thresh,182,100,82,54.95
Corki,Renekton,46,17,29,36.96
Corki,LeeSin,140,69,71,49.29
Corki,Viktor,122,53,69,43.44
Corki,XinZhao,61,43,18,70.49
Corki,Chogath,132,59,73,44.7
Corki,Gwen,48,20,28,41.67
Corki,Rell,85,42,43,49.41
Corki,Vladimir,74,35,39,47.3
Corki,Volibear,117,52,65,44.44
Corki,Malzahar,95,49,46,51.58
Corki,Jayce,34,16,18,47.06
Corki,Sion,110,43,67,39.09
Corki,Zac,71,38,33,53.52
Corki,Nocturne,141,73,68,51.77
Corki,Veigar,62,30,32,48.39
Corki,KogMaw,38,16,22,42.11
Corki,Morgana,79,33,46,41.77
Corki,Evelynn,31,5,26,16.13
Corki,Aurora,72,24,48,33.33
Corki,Lulu,133,47,86,35.34
Corki,Ahri,160,77,83,48.13
Corki,Shaco,65,20,45,30.77
Corki,Mordekaiser,112,30,82,26.79
Corki,Jhin,209,106,103,50.72
Corki,Zyra,77,43,34,55.84
Corki,Lucian,90,53,37,58.89
Corki,Sett,124,48,76,38.71
Corki,KSante,54,27,27,50
Corki,Skarner,30,7,23,23.33
Corki,Yasuo,172,63,109,36.63
Corki,Swain,91,44,47,48.35
Corki,Viego,105,38,67,36.19
Corki,Velkoz,41,22,19,53.66
Corki,Yorick,73,33,40,45.21
Corki,Diana,133,63,70,47.37
Corki,Annie,32,21,11,65.63
Corki,Ziggs,22,9,13,40.91
Corki,Lux,220,104,116,47.27
Corki,Zilean,47,21,26,44.68
Corki,Heimerdinger,34,6,28,17.65
Corki,Amumu,115,44,71,38.26
Corki,Braum,93,41,52,44.09
Corki,Jinx,230,104,126,45.22
Corki,Khazix,46,26,20,56.52
Corki,Malphite,95,55,40,57.89
Corki,Lillia,36,16,20,44.44
Corki,Katarina,47,18,29,38.3
Corki,Samira,68,29,39,42.65
Corki,Leblanc,56,22,34,39.29
Corki,MissFortune,214,101,113,47.2
Corki,Shen,60,19,41,31.67
Corki,TahmKench,84,40,44,47.62
Corki,Sejuani,50,17,33,34
Corki,Nautilus,153,71,82,46.41
Corki,Kindred,44,21,23,47.73
Corki,Udyr,54,28,26,51.85
Corki,Ivern,24,13,11,54.17
Corki,Soraka,44,24,20,54.55
Corki,Gnar,51,36,15,70.59
Corki,Vayne,155,55,100,35.48
Corki,Nami,99,34,65,34.34
Corki,Aatrox,68,37,31,54.41
Corki,Caitlyn,232,115,117,49.57
Corki,Alistar,61,18,43,29.51
Corki,Brand,47,12,35,25.53
Corki,Milio,83,43,40,51.81
Corki,Poppy,77,41,36,53.25
Corki,Kennen,30,22,8,73.33
Corki,Gragas,95,53,42,55.79
Corki,Galio,154,99,55,64.29
Corki,Leona,88,34,54,38.64
Corki,JarvanIV,85,38,47,44.71
Corki,Kayn,120,55,65,45.83
Corki,Neeko,53,23,30,43.4
Corki,Zeri,55,42,13,76.36
Corki,Nidalee,30,20,10,66.67
Corki,Ornn,75,41,34,54.67
Corki,Warwick,133,65,68,48.87
Corki,Nasus,46,12,34,26.09
Corki,Akshan,38,17,21,44.74
Corki,MasterYi,61,27,34,44.26
Corki,Draven,37,24,13,64.86
Corki,Rengar,27,19,8,70.37
Corki,Vi,131,52,79,39.69
Corki,Xayah,63,20,43,31.75
Corki,Gangplank,46,25,21,54.35
Corki,AurelionSol,39,20,19,51.28
Corki,Bard,36,14,22,38.89
Corki,Varus,91,52,39,57.14
Corki,Kled,29,12,17,41.38
Corki,Kayle,56,16,40,28.57
Corki,Nunu,67,37,30,55.22
Corki,Yone,159,70,89,44.03
Corki,Kalista,21,7,14,33.33
Corki,Blitzcrank,68,32,36,47.06
Corki,Hecarim,38,15,23,39.47
Corki,Elise,105,50,55,47.62
Corki,Sylas,157,85,72,54.14
Corki,Jax,83,44,39,53.01
Corki,Akali,77,37,40,48.05
Corki,Ezreal,217,102,115,47
Corki,Orianna,72,28,44,38.89
Corki,MonkeyKing,99,40,59,40.4
Corki,Zed,87,33,54,37.93
Corki,Pyke,87,37,50,42.53
Corki,Naafiri,21,13,8,61.9
Corki,Urgot,67,42,25,62.69
Corki,Briar,39,11,28,28.21
Corki,Anivia,19,10,9,52.63
Corki,Cassiopeia,25,11,14,44
Corki,Rakan,41,19,22,46.34
Corki,Lissandra,35,15,20,42.86
Corki,Aphelios,59,25,34,42.37
Corki,Senna,71,27,44,38.03
Corki,Graves,65,30,35,46.15
Corki,Tristana,107,64,43,59.81
Corki,Ambessa,58,24,34,41.38
Corki,Taliyah,40,16,24,40
Corki,Sivir,50,16,34,32
Corki,Ryze,29,13,16,44.83
Corki,DrMundo,56,31,25,55.36
Corki,Yuumi,71,43,28,60.56
Corki,Quinn,52,22,30,42.31
Corki,Rammus,43,21,22,48.84
Corki,Fiora,31,22,9,70.97
Corki,Taric,23,6,17,26.09
Corki,Belveth,16,9,7,56.25
Corki,Trundle,52,31,21,59.62
Corki,Syndra,45,26,19,57.78
Corki,Riven,32,16,16,50
Corki,Xerath,33,20,13,60.61
Corki,Kassadin,14,0,14,0
Corki,Illaoi,33,19,14,57.58
Corki,Vex,47,23,24,48.94
Corki,Azir,43,16,27,37.21
Corki,Camille,49,22,27,44.9
Corki,Talon,35,21,14,60
Corki,Karthus,17,10,7,58.82
Corki,Olaf,18,13,5,72.22
Corki,Rumble,37,9,28,24.32
Corki,TwistedFate,28,16,12,57.14
Corki,Shyvana,27,10,17,37.04
Corki,Tryndamere,34,15,19,44.12
Corki,Renata,17,15,2,88.24
Corki,Sona,13,6,7,46.15
Corki,Maokai,49,25,24,51.02
Corki,Nilah,15,5,10,33.33
Corki,Janna,20,15,5,75
Corki,Zoe,27,9,18,33.33
Corki,RekSai,17,8,9,47.06
MonkeyKing,Quinn,31,8,23,25.81
MonkeyKing,Sejuani,95,41,54,43.16
MonkeyKing,Leblanc,112,48,64,42.86
MonkeyKing,Twitch,109,56,53,51.38
MonkeyKing,Nautilus,196,92,104,46.94
MonkeyKing,Gangplank,102,66,36,64.71
MonkeyKing,LeeSin,278,162,116,58.27
MonkeyKing,Aurora,81,39,42,48.15
MonkeyKing,Ashe,297,151,146,50.84
MonkeyKing,Morgana,149,58,91,38.93
MonkeyKing,Gwen,79,37,42,46.84
MonkeyKing,Pantheon,250,137,113,54.8
MonkeyKing,Irelia,118,54,64,45.76
MonkeyKing,Varus,149,98,51,65.77
MonkeyKing,Lux,289,136,153,47.06
MonkeyKing,Poppy,62,32,30,51.61
MonkeyKing,Shaco,111,54,57,48.65
MonkeyKing,Ahri,214,126,88,58.88
MonkeyKing,Ezreal,375,220,155,58.67
MonkeyKing,Nami,150,85,65,56.67
MonkeyKing,XinZhao,111,79,32,71.17
MonkeyKing,Azir,74,43,31,58.11
MonkeyKing,Kaisa,218,119,99,54.59
MonkeyKing,KSante,96,59,37,61.46
MonkeyKing,Lillia,94,50,44,53.19
MonkeyKing,Diana,184,110,74,59.78
MonkeyKing,Bard,63,39,24,61.9
MonkeyKing,Garen,231,106,125,45.89
MonkeyKing,Akali,181,97,84,53.59
MonkeyKing,Karma,150,88,62,58.67
MonkeyKing,Sett,183,104,79,56.83
MonkeyKing,Khazix,55,38,17,69.09
MonkeyKing,Yasuo,248,132,116,53.23
MonkeyKing,Yuumi,132,43,89,32.58
MonkeyKing,Darius,311,144,167,46.3
MonkeyKing,Viego,262,126,136,48.09
MonkeyKing,Galio,150,80,70,53.33
MonkeyKing,Draven,95,41,54,43.16
MonkeyKing,Milio,85,40,45,47.06
MonkeyKing,Yone,240,153,87,63.75
MonkeyKing,Teemo,103,66,37,64.08
MonkeyKing,Malzahar,153,70,83,45.75
MonkeyKing,Rakan,72,36,36,50
MonkeyKing,Ivern,37,25,12,67.57
MonkeyKing,FiddleSticks,55,33,22,60
MonkeyKing,Xerath,103,56,47,54.37
MonkeyKing,Smolder,101,54,47,53.47
MonkeyKing,Swain,107,64,43,59.81
MonkeyKing,Trundle,79,38,41,48.1
MonkeyKing,Nidalee,64,32,32,50
MonkeyKing,Blitzcrank,101,49,52,48.51
MonkeyKing,Camille,77,52,25,67.53
MonkeyKing,Graves,94,46,48,48.94
MonkeyKing,Leona,172,90,82,52.33
MonkeyKing,Talon,92,57,35,61.96
MonkeyKing,Vayne,179,98,81,54.75
MonkeyKing,Zyra,123,59,64,47.97
MonkeyKing,Caitlyn,306,173,133,56.54
MonkeyKing,Gragas,88,37,51,42.05
MonkeyKing,Volibear,123,68,55,55.28
MonkeyKing,MissFortune,275,112,163,40.73
MonkeyKing,Lucian,98,55,43,56.12
MonkeyKing,Renekton,85,53,32,62.35
MonkeyKing,Jhin,210,107,103,50.95
MonkeyKing,Orianna,63,19,44,30.16
MonkeyKing,Warwick,204,114,90,55.88
MonkeyKing,Mordekaiser,160,93,67,58.13
MonkeyKing,Zac,74,41,33,55.41
MonkeyKing,Zed,142,85,57,59.86
MonkeyKing,Rell,118,69,49,58.47
MonkeyKing,Lulu,208,126,82,60.58
MonkeyKing,Ambessa,107,68,39,63.55
MonkeyKing,Elise,119,69,50,57.98
MonkeyKing,Kalista,29,19,10,65.52
MonkeyKing,Chogath,139,73,66,52.52
MonkeyKing,Seraphine,97,52,45,53.61
MonkeyKing,Sivir,64,39,25,60.94
MonkeyKing,Soraka,59,29,30,49.15
MonkeyKing,Riven,79,38,41,48.1
MonkeyKing,Amumu,182,88,94,48.35
MonkeyKing,Ryze,46,20,26,43.48
MonkeyKing,Jinx,322,152,170,47.2
MonkeyKing,Belveth,39,19,20,48.72
MonkeyKing,Aphelios,78,52,26,66.67
MonkeyKing,Shen,126,64,62,50.79
MonkeyKing,MasterYi,144,81,63,56.25
MonkeyKing,Zilean,45,29,16,64.44
MonkeyKing,JarvanIV,116,53,63,45.69
MonkeyKing,Sion,140,65,75,46.43
MonkeyKing,Evelynn,25,11,14,44
MonkeyKing,Xayah,66,25,41,37.88
MonkeyKing,Karthus,48,32,16,66.67
MonkeyKing,Jax,110,70,40,63.64
MonkeyKing,Taliyah,57,24,33,42.11
MonkeyKing,Syndra,93,57,36,61.29
MonkeyKing,Vladimir,77,34,43,44.16
MonkeyKing,Nocturne,212,87,125,41.04
MonkeyKing,Velkoz,53,22,31,41.51
MonkeyKing,Gnar,87,44,43,50.57
MonkeyKing,RekSai,23,17,6,73.91
MonkeyKing,Kayle,90,47,43,52.22
MonkeyKing,Nunu,94,61,33,64.89
MonkeyKing,Kayn,165,80,85,48.48
MonkeyKing,Ziggs,31,22,9,70.97
MonkeyKing,Veigar,170,84,86,49.41
MonkeyKing,Viktor,163,85,78,52.15
MonkeyKing,Taric,34,19,15,55.88
MonkeyKing,TahmKench,136,59,77,43.38
MonkeyKing,Senna,86,52,34,60.47
MonkeyKing,Mel,284,154,130,54.23
MonkeyKing,Tristana,117,85,32,72.65
MonkeyKing,Ornn,103,58,45,56.31
MonkeyKing,Qiyana,22,18,4,81.82
MonkeyKing,Yorick,104,47,57,45.19
MonkeyKing,Thresh,267,130,137,48.69
MonkeyKing,Ekko,104,64,40,61.54
MonkeyKing,Renata,46,24,22,52.17
MonkeyKing,Tryndamere,66,37,29,56.06
MonkeyKing,Sona,22,11,11,50
MonkeyKing,Sylas,224,142,82,63.39
MonkeyKing,Kindred,42,23,19,54.76
MonkeyKing,Katarina,56,29,27,51.79
MonkeyKing,Aatrox,142,71,71,50
MonkeyKing,Hecarim,41,32,9,78.05
MonkeyKing,Cassiopeia,56,35,21,62.5
MonkeyKing,Briar,64,41,23,64.06
MonkeyKing,Pyke,157,91,66,57.96
MonkeyKing,Kassadin,23,17,6,73.91
MonkeyKing,Zeri,79,39,40,49.37
MonkeyKing,Fiora,37,14,23,37.84
MonkeyKing,Nilah,57,26,31,45.61
MonkeyKing,Naafiri,28,17,11,60.71
MonkeyKing,Janna,38,15,23,39.47
MonkeyKing,AurelionSol,50,18,32,36
MonkeyKing,KogMaw,38,19,19,50
MonkeyKing,Malphite,135,69,66,51.11
MonkeyKing,Lissandra,69,42,27,60.87
MonkeyKing,Hwei,129,71,58,55.04
MonkeyKing,Illaoi,52,23,29,44.23
MonkeyKing,Alistar,82,46,36,56.1
MonkeyKing,Nasus,90,52,38,57.78
MonkeyKing,Vi,199,133,66,66.83
MonkeyKing,Brand,60,33,27,55
MonkeyKing,TwistedFate,40,19,21,47.5
MonkeyKing,Urgot,56,32,24,57.14
MonkeyKing,Corki,99,59,40,59.6
MonkeyKing,Shyvana,28,8,20,28.57
MonkeyKing,Akshan,45,22,23,48.89
MonkeyKing,Samira,138,79,59,57.25
MonkeyKing,Braum,87,49,38,56.32
MonkeyKing,DrMundo,77,37,40,48.05
MonkeyKing,Fizz,66,38,28,57.58
MonkeyKing,Annie,42,19,23,45.24
MonkeyKing,Heimerdinger,51,19,32,37.25
MonkeyKing,Vex,55,29,26,52.73
MonkeyKing,Singed,33,14,19,42.42
MonkeyKing,Rengar,38,27,11,71.05
MonkeyKing,Jayce,63,40,23,63.49
MonkeyKing,Zoe,34,17,17,50
MonkeyKing,Udyr,64,28,36,43.75
MonkeyKing,Olaf,23,14,9,60.87
MonkeyKing,Maokai,61,28,33,45.9
MonkeyKing,Kennen,35,24,11,68.57
MonkeyKing,Anivia,48,21,27,43.75
MonkeyKing,Skarner,35,22,13,62.86
MonkeyKing,Rammus,30,7,23,23.33
MonkeyKing,Neeko,34,16,18,47.06
MonkeyKing,Kled,28,17,11,60.71
MonkeyKing,Rumble,35,24,11,68.57
Quinn,Garen,104,57,47,54.81
Quinn,MonkeyKing,31,23,8,74.19
Quinn,Lux,152,83,69,54.61
Quinn,Nilah,22,7,15,31.82
Quinn,Lulu,102,58,44,56.86
Quinn,Ornn,32,24,8,75
Quinn,Kindred,24,14,10,58.33
Quinn,Talon,39,24,15,61.54
Quinn,Samira,40,19,21,47.5
Quinn,Ashe,129,68,61,52.71
Quinn,Ezreal,148,68,80,45.95
Quinn,Warwick,95,47,48,49.47
Quinn,Xerath,59,30,29,50.85
Quinn,Mordekaiser,70,33,37,47.14
Quinn,TahmKench,76,22,54,28.95
Quinn,Braum,45,21,24,46.67
Quinn,MasterYi,56,26,30,46.43
Quinn,Karma,84,38,46,45.24
Quinn,Malzahar,77,49,28,63.64
Quinn,Varus,52,32,20,61.54
Quinn,DrMundo,35,11,24,31.43
Quinn,MissFortune,102,68,34,66.67
Quinn,Aurora,51,21,30,41.18
Quinn,Rakan,43,12,31,27.91
Quinn,Amumu,91,49,42,53.85
Quinn,Malphite,126,62,64,49.21
Quinn,AurelionSol,44,8,36,18.18
Quinn,Swain,66,27,39,40.91
Quinn,Leona,45,18,27,40
Quinn,Zyra,52,31,21,59.62
Quinn,Briar,50,27,23,54
Quinn,TwistedFate,31,17,14,54.84
Quinn,Sivir,56,27,29,48.21
Quinn,Morgana,83,59,24,71.08
Quinn,Pantheon,129,46,83,35.66
Quinn,Katarina,39,21,18,53.85
Quinn,Vayne,103,61,42,59.22
Quinn,Gangplank,35,14,21,40
Quinn,Diana,84,37,47,44.05
Quinn,Galio,79,39,40,49.37
Quinn,Milio,62,28,34,45.16
Quinn,Fizz,27,3,24,11.11
Quinn,Kaisa,119,57,62,47.9
Quinn,Sejuani,42,17,25,40.48
Quinn,Sett,68,30,38,44.12
Quinn,Graves,35,20,15,57.14
Quinn,Lucian,57,18,39,31.58
Quinn,Gragas,50,17,33,34
Quinn,LeeSin,119,58,61,48.74
Quinn,Tristana,77,42,35,54.55
Quinn,Pyke,50,36,14,72
Quinn,Chogath,95,52,43,54.74
Quinn,Rengar,24,16,8,66.67
Quinn,Mel,156,90,66,57.69
Quinn,Nautilus,76,35,41,46.05
Quinn,Renekton,68,53,15,77.94
Quinn,Vi,89,40,49,44.94
Quinn,Zed,81,41,40,50.62
Quinn,Rammus,32,11,21,34.38
Quinn,Akali,58,23,35,39.66
Quinn,Brand,35,22,13,62.86
Quinn,Ekko,75,31,44,41.33
Quinn,KogMaw,22,14,8,63.64
Quinn,Thresh,138,63,75,45.65
Quinn,Viego,102,53,49,51.96
Quinn,Caitlyn,149,76,73,51.01
Quinn,Yorick,58,31,27,53.45
Quinn,Jhin,113,57,56,50.44
Quinn,Lillia,44,29,15,65.91
Quinn,Ryze,25,11,14,44
Quinn,Nunu,53,32,21,60.38
Quinn,Irelia,55,29,26,52.73
Quinn,Twitch,55,34,21,61.82
Quinn,Janna,33,24,9,72.73
Quinn,Fiora,20,15,5,75
Quinn,Viktor,38,21,17,55.26
Quinn,Tryndamere,35,15,20,42.86
Quinn,JarvanIV,54,30,24,55.56
Quinn,Maokai,52,27,25,51.92
Quinn,Yasuo,105,50,55,47.62
Quinn,Azir,30,16,14,53.33
Quinn,Jayce,43,23,20,53.49
Quinn,Nami,87,35,52,40.23
Quinn,Darius,151,56,95,37.09
Quinn,Kayn,65,37,28,56.92
Quinn,Xayah,19,11,8,57.89
Quinn,Udyr,24,12,12,50
Quinn,Skarner,26,5,21,19.23
Quinn,Ahri,74,41,33,55.41
Quinn,Zeri,30,10,20,33.33
Quinn,Teemo,64,26,38,40.63
Quinn,Nasus,25,10,15,40
Quinn,Poppy,35,21,14,60
Quinn,Jinx,208,90,118,43.27
Quinn,Senna,42,20,22,47.62
Quinn,Kennen,28,18,10,64.29
Quinn,Khazix,36,21,15,58.33
Quinn,Heimerdinger,38,13,25,34.21
Quinn,Karthus,25,8,17,32
Quinn,Lissandra,24,14,10,58.33
Quinn,Soraka,30,11,19,36.67
Quinn,Bard,25,17,8,68
Quinn,Urgot,46,17,29,36.96
Quinn,Blitzcrank,84,50,34,59.52
Quinn,Rumble,23,18,5,78.26
Quinn,Belveth,8,3,5,37.5
Quinn,Yone,95,54,41,56.84
Quinn,Sion,63,30,33,47.62
Quinn,Zoe,31,15,16,48.39
Quinn,Sylas,96,44,52,45.83
Quinn,Kled,8,5,3,62.5
Quinn,Velkoz,32,11,21,34.38
Quinn,Leblanc,36,24,12,66.67
Quinn,Aphelios,46,31,15,67.39
Quinn,RekSai,10,2,8,20
Quinn,Vladimir,37,12,25,32.43
Quinn,Kayle,43,26,17,60.47
Quinn,Elise,44,37,7,84.09
Quinn,Hwei,36,21,15,58.33
Quinn,Aatrox,69,30,39,43.48
Quinn,Rell,52,23,29,44.23
Quinn,Volibear,69,31,38,44.93
Quinn,Singed,15,7,8,46.67
Quinn,Cassiopeia,20,14,6,70
Quinn,Naafiri,18,2,16,11.11
Quinn,Seraphine,49,30,19,61.22
Quinn,Syndra,58,30,28,51.72
Quinn,Akshan,35,21,14,60
Quinn,Nocturne,94,42,52,44.68
Quinn,Ziggs,34,20,14,58.82
Quinn,Anivia,19,9,10,47.37
Quinn,Corki,52,30,22,57.69
Quinn,Hecarim,15,9,6,60
Quinn,Camille,28,12,16,42.86
Quinn,Draven,47,18,29,38.3
Quinn,Trundle,32,17,15,53.13
Quinn,Neeko,37,23,14,62.16
Quinn,Alistar,51,23,28,45.1
Quinn,Annie,28,13,15,46.43
Quinn,KSante,40,25,15,62.5
Quinn,Veigar,75,41,34,54.67
Quinn,Jax,49,23,26,46.94
Quinn,Ambessa,39,23,16,58.97
Quinn,Yuumi,57,18,39,31.58
Quinn,Gnar,39,8,31,20.51
Quinn,Orianna,33,18,15,54.55
Quinn,Kassadin,13,8,5,61.54
Quinn,FiddleSticks,36,18,18,50
Quinn,Sona,8,6,2,75
Quinn,Zilean,23,13,10,56.52
Quinn,Taliyah,24,19,5,79.17
Quinn,Riven,16,12,4,75
Quinn,Illaoi,16,13,3,81.25
Quinn,Shaco,28,14,14,50
Quinn,Gwen,18,6,12,33.33
Quinn,Ivern,22,19,3,86.36
Quinn,Smolder,42,22,20,52.38
Quinn,Nidalee,26,16,10,61.54
Quinn,XinZhao,37,24,13,64.86
Quinn,Evelynn,21,7,14,33.33
Quinn,Shen,23,14,9,60.87
Quinn,Kalista,19,11,8,57.89
Quinn,Vex,38,24,14,63.16
Quinn,Taric,17,14,3,82.35
Quinn,Qiyana,11,6,5,54.55
Quinn,Zac,29,14,15,48.28
Quinn,Shyvana,11,3,8,27.27
Quinn,Olaf,13,5,8,38.46
Quinn,Renata,6,3,3,50
Nasus,Mordekaiser,177,99,78,55.93
Nasus,Viego,161,74,87,45.96
Nasus,Yone,231,113,118,48.92
Nasus,Lucian,88,53,35,60.23
Nasus,Rakan,76,30,46,39.47
Nasus,Ashe,241,126,115,52.28
Nasus,Graves,79,41,38,51.9
Nasus,Vayne,176,66,110,37.5
Nasus,Draven,51,33,18,64.71
Nasus,Garen,263,122,141,46.39
Nasus,Shyvana,32,18,14,56.25
Nasus,Lissandra,32,14,18,43.75
Nasus,Lux,301,165,136,54.82
Nasus,Veigar,139,80,59,57.55
Nasus,Kayn,179,84,95,46.93
Nasus,Shaco,94,51,43,54.26
Nasus,Zoe,58,29,29,50
Nasus,KogMaw,51,25,26,49.02
Nasus,TwistedFate,46,33,13,71.74
Nasus,Volibear,149,84,65,56.38
Nasus,MasterYi,142,63,79,44.37
Nasus,Mel,284,157,127,55.28
Nasus,Ezreal,265,135,130,50.94
Nasus,Blitzcrank,104,60,44,57.69
Nasus,Sylas,188,95,93,50.53
Nasus,Evelynn,46,25,21,54.35
Nasus,Varus,88,47,41,53.41
Nasus,Karma,115,69,46,60
Nasus,Olaf,51,22,29,43.14
Nasus,Nidalee,41,26,15,63.41
Nasus,Ryze,38,14,24,36.84
Nasus,Caitlyn,282,127,155,45.04
Nasus,Brand,110,47,63,42.73
Nasus,Poppy,73,29,44,39.73
Nasus,Ahri,130,66,64,50.77
Nasus,Nami,153,80,73,52.29
Nasus,Kennen,36,13,23,36.11
Nasus,XinZhao,68,39,29,57.35
Nasus,Morgana,111,58,53,52.25
Nasus,Malphite,154,82,72,53.25
Nasus,Nocturne,116,43,73,37.07
Nasus,Malzahar,119,58,61,48.74
Nasus,Samira,83,30,53,36.14
Nasus,Pyke,90,48,42,53.33
Nasus,Nunu,91,44,47,48.35
Nasus,Katarina,72,32,40,44.44
Nasus,Swain,140,68,72,48.57
Nasus,Sion,129,85,44,65.89
Nasus,Warwick,172,69,103,40.12
Nasus,Renekton,66,27,39,40.91
Nasus,Jhin,219,136,83,62.1
Nasus,Thresh,249,134,115,53.82
Nasus,Aatrox,101,65,36,64.36
Nasus,Yasuo,238,102,136,42.86
Nasus,MissFortune,222,130,92,58.56
Nasus,Nautilus,170,97,73,57.06
Nasus,Darius,211,123,88,58.29
Nasus,LeeSin,163,77,86,47.24
Nasus,Syndra,65,40,25,61.54
Nasus,Xayah,69,33,36,47.83
Nasus,Pantheon,212,104,108,49.06
Nasus,Sett,157,62,95,39.49
Nasus,Lillia,75,26,49,34.67
Nasus,Neeko,42,24,18,57.14
Nasus,Urgot,69,28,41,40.58
Nasus,FiddleSticks,53,18,35,33.96
Nasus,Kalista,61,28,33,45.9
Nasus,Galio,148,63,85,42.57
Nasus,JarvanIV,93,45,48,48.39
Nasus,Ekko,113,58,55,51.33
Nasus,Sivir,71,37,34,52.11
Nasus,Milio,81,37,44,45.68
Nasus,Yorick,133,72,61,54.14
Nasus,Orianna,56,25,31,44.64
Nasus,Talon,55,28,27,50.91
Nasus,Nilah,51,17,34,33.33
Nasus,Diana,163,92,71,56.44
Nasus,Janna,42,10,32,23.81
Nasus,Zed,145,92,53,63.45
Nasus,Braum,78,45,33,57.69
Nasus,Twitch,74,40,34,54.05
Nasus,Chogath,122,63,59,51.64
Nasus,Vi,164,75,89,45.73
Nasus,Kaisa,196,101,95,51.53
Nasus,Seraphine,117,51,66,43.59
Nasus,Jax,129,67,62,51.94
Nasus,Alistar,61,36,25,59.02
Nasus,Xerath,97,59,38,60.82
Nasus,Zyra,67,31,36,46.27
Nasus,AurelionSol,74,48,26,64.86
Nasus,Yuumi,93,40,53,43.01
Nasus,Heimerdinger,59,23,36,38.98
Nasus,Ivern,31,22,9,70.97
Nasus,Aurora,82,50,32,60.98
Nasus,TahmKench,78,46,32,58.97
Nasus,Tryndamere,42,25,17,59.52
Nasus,Gragas,83,56,27,67.47
Nasus,Lulu,114,41,73,35.96
Nasus,Shen,66,32,34,48.48
Nasus,Leona,125,76,49,60.8
Nasus,Kayle,67,41,26,61.19
Nasus,Zac,82,44,38,53.66
Nasus,Vladimir,69,30,39,43.48
Nasus,Maokai,56,29,27,51.79
Nasus,Ambessa,72,42,30,58.33
Nasus,Sejuani,69,42,27,60.87
Nasus,Jinx,359,195,164,54.32
Nasus,Trundle,92,54,38,58.7
Nasus,Akshan,53,20,33,37.74
Nasus,Gnar,48,36,12,75
Nasus,Ziggs,57,34,23,59.65
Nasus,Jayce,64,30,34,46.88
Nasus,Tristana,114,43,71,37.72
Nasus,Gangplank,49,13,36,26.53
Nasus,Soraka,82,45,37,54.88
Nasus,DrMundo,60,31,29,51.67
Nasus,Skarner,48,21,27,43.75
Nasus,Kindred,68,43,25,63.24
Nasus,Teemo,102,47,55,46.08
Nasus,Khazix,47,21,26,44.68
Nasus,Aphelios,38,15,23,39.47
Nasus,Fiora,50,23,27,46
Nasus,RekSai,17,8,9,47.06
Nasus,Leblanc,66,40,26,60.61
Nasus,Amumu,152,83,69,54.61
Nasus,Karthus,33,30,3,90.91
Nasus,Illaoi,58,33,25,56.9
Nasus,KSante,58,44,14,75.86
Nasus,Viktor,126,50,76,39.68
Nasus,Bard,33,16,17,48.48
Nasus,Riven,59,32,27,54.24
Nasus,Corki,46,34,12,73.91
Nasus,Zeri,55,19,36,34.55
Nasus,Rengar,28,15,13,53.57
Nasus,Briar,60,34,26,56.67
Nasus,Zilean,42,20,22,47.62
Nasus,Smolder,105,48,57,45.71
Nasus,Quinn,25,15,10,60
Nasus,Belveth,32,22,10,68.75
Nasus,Hwei,86,51,35,59.3
Nasus,Udyr,16,14,2,87.5
Nasus,Annie,35,19,16,54.29
Nasus,Rell,51,24,27,47.06
Nasus,Velkoz,92,40,52,43.48
Nasus,Sona,30,11,19,36.67
Nasus,Gwen,41,27,14,65.85
Nasus,MonkeyKing,90,38,52,42.22
Nasus,Vex,72,34,38,47.22
Nasus,Elise,87,32,55,36.78
Nasus,Azir,46,27,19,58.7
Nasus,Hecarim,37,13,24,35.14
Nasus,Camille,73,40,33,54.79
Nasus,Cassiopeia,21,13,8,61.9
Nasus,Fizz,66,43,23,65.15
Nasus,Senna,84,29,55,34.52
Nasus,Akali,93,52,41,55.91
Nasus,Irelia,40,20,20,50
Nasus,Rammus,34,18,16,52.94
Nasus,Singed,54,26,28,48.15
Nasus,Taliyah,29,15,14,51.72
Nasus,Naafiri,28,17,11,60.71
Nasus,Qiyana,15,7,8,46.67
Nasus,Anivia,25,12,13,48
Nasus,Ornn,69,35,34,50.72
Nasus,Rumble,32,21,11,65.63
Nasus,Renata,28,14,14,50
Nasus,Kassadin,18,13,5,72.22
Nasus,Kled,8,3,5,37.5
Nasus,Taric,14,12,2,85.71
Kled,Teemo,23,2,21,8.7
Kled,Warwick,56,21,35,37.5
Kled,Nunu,20,8,12,40
Kled,Lucian,25,14,11,56
Kled,Leona,40,20,20,50
Kled,Vayne,41,22,19,53.66
Kled,Ivern,13,11,2,84.62
Kled,Qiyana,6,6,0,100
Kled,Ahri,61,29,32,47.54
Kled,Seraphine,34,24,10,70.59
Kled,Darius,67,26,41,38.81
Kled,Pantheon,64,23,41,35.94
Kled,Lux,74,24,50,32.43
Kled,Kaisa,77,26,51,33.77
Kled,Pyke,57,30,27,52.63
Kled,Ornn,39,22,17,56.41
Kled,Vi,41,16,25,39.02
Kled,Kennen,17,12,5,70.59
Kled,Varus,41,19,22,46.34
Kled,Renata,17,11,6,64.71
Kled,Jax,31,16,15,51.61
Kled,Elise,25,17,8,68
Kled,Riven,14,11,3,78.57
Kled,Ashe,88,46,42,52.27
Kled,Nautilus,43,30,13,69.77
Kled,Gangplank,25,8,17,32
Kled,Briar,23,8,15,34.78
Kled,Hwei,24,14,10,58.33
Kled,Jinx,79,28,51,35.44
Kled,Zilean,19,11,8,57.89
Kled,Garen,70,30,40,42.86
Kled,Vladimir,25,5,20,20
Kled,Caitlyn,111,48,63,43.24
Kled,Gnar,16,10,6,62.5
Kled,Akali,50,28,22,56
Kled,LeeSin,82,46,36,56.1
Kled,MissFortune,60,33,27,55
Kled,TahmKench,22,20,2,90.91
Kled,Rammus,15,9,6,60
Kled,Diana,65,31,34,47.69
Kled,Nilah,16,11,5,68.75
Kled,Blitzcrank,24,16,8,66.67
Kled,Olaf,25,14,11,56
Kled,Volibear,58,32,26,55.17
Kled,Malzahar,38,23,15,60.53
Kled,Aatrox,46,24,22,52.17
Kled,Ekko,39,24,15,61.54
Kled,Orianna,37,16,21,43.24
Kled,Aphelios,17,8,9,47.06
Kled,Alistar,25,11,14,44
Kled,Gragas,22,11,11,50
Kled,Yasuo,58,40,18,68.97
Kled,Bard,22,13,9,59.09
Kled,Leblanc,20,11,9,55
Kled,Yone,57,27,30,47.37
Kled,Jhin,72,43,29,59.72
Kled,Lulu,70,38,32,54.29
Kled,Illaoi,16,8,8,50
Kled,FiddleSticks,15,4,11,26.67
Kled,Aurora,41,26,15,63.41
Kled,Zyra,27,17,10,62.96
Kled,Viego,37,22,15,59.46
Kled,Sion,31,20,11,64.52
Kled,Yorick,17,6,11,35.29
Kled,Fizz,19,9,10,47.37
Kled,Soraka,11,8,3,72.73
Kled,Zed,44,16,28,36.36
Kled,Nami,60,28,32,46.67
Kled,Draven,25,14,11,56
Kled,Skarner,19,11,8,57.89
Kled,Vex,18,12,6,66.67
Kled,Sett,60,32,28,53.33
Kled,Ezreal,78,37,41,47.44
Kled,Mordekaiser,65,37,28,56.92
Kled,Corki,29,17,12,58.62
Kled,Morgana,39,14,25,35.9
Kled,Kassadin,11,3,8,27.27
Kled,Trundle,24,16,8,66.67
Kled,Ambessa,25,5,20,20
Kled,Sylas,41,18,23,43.9
Kled,Hecarim,16,10,6,62.5
Kled,Veigar,21,12,9,57.14
Kled,Velkoz,32,9,23,28.13
Kled,Tristana,34,23,11,67.65
Kled,Poppy,28,16,12,57.14
Kled,Udyr,21,11,10,52.38
Kled,Smolder,32,18,14,56.25
Kled,Taliyah,12,9,3,75
Kled,Quinn,8,3,5,37.5
Kled,Milio,17,11,6,64.71
Kled,Shyvana,12,4,8,33.33
Kled,KogMaw,11,8,3,72.73
Kled,Fiora,7,0,7,0
Kled,Mel,76,50,26,65.79
Kled,AurelionSol,19,11,8,57.89
Kled,Kayn,20,10,10,50
Kled,Xerath,27,17,10,62.96
Kled,Chogath,56,25,31,44.64
Kled,Zoe,16,7,9,43.75
Kled,JarvanIV,32,17,15,53.13
Kled,Camille,14,11,3,78.57
Kled,Nocturne,22,12,10,54.55
Kled,Karma,32,18,14,56.25
Kled,Syndra,31,9,22,29.03
Kled,Yuumi,17,2,15,11.76
Kled,Shaco,26,18,8,69.23
Kled,Naafiri,8,3,5,37.5
Kled,Twitch,36,19,17,52.78
Kled,Belveth,6,0,6,0
Kled,Tryndamere,13,7,6,53.85
Kled,Khazix,23,3,20,13.04
Kled,Jayce,13,7,6,53.85
Kled,Sejuani,22,10,12,45.45
Kled,Singed,8,6,2,75
Kled,Amumu,27,6,21,22.22
Kled,Sivir,12,3,9,25
Kled,Taric,5,2,3,40
Kled,Rengar,18,6,12,33.33
Kled,Anivia,8,5,3,62.5
Kled,Ziggs,14,10,4,71.43
Kled,Neeko,12,6,6,50
Kled,Irelia,22,8,14,36.36
Kled,Kindred,21,8,13,38.1
Kled,Galio,43,12,31,27.91
Kled,DrMundo,28,18,10,64.29
Kled,Cassiopeia,16,7,9,43.75
Kled,Senna,22,11,11,50
Kled,Lillia,20,20,0,100
Kled,TwistedFate,7,5,2,71.43
Kled,Renekton,31,18,13,58.06
Kled,Karthus,5,0,5,0
Kled,Katarina,17,9,8,52.94
Kled,Thresh,46,16,30,34.78
Kled,Zeri,19,10,9,52.63
Kled,Rakan,9,2,7,22.22
Kled,Heimerdinger,20,7,13,35
Kled,Braum,24,17,7,70.83
Kled,Urgot,16,12,4,75
Kled,Brand,26,13,13,50
Kled,MasterYi,31,13,18,41.94
Kled,Swain,34,16,18,47.06
Kled,Shen,26,13,13,50
Kled,Kalista,14,5,9,35.71
Kled,Rumble,14,4,10,28.57
Kled,Rell,21,11,10,52.38
Kled,Ryze,17,12,5,70.59
Kled,Maokai,19,11,8,57.89
Kled,Talon,16,3,13,18.75
Kled,Lissandra,15,9,6,60
Kled,Malphite,21,11,10,52.38
Kled,Viktor,39,16,23,41.03
Kled,XinZhao,25,11,14,44
Kled,Gwen,21,13,8,61.9
Kled,Samira,17,5,12,29.41
Kled,MonkeyKing,28,11,17,39.29
Kled,Akshan,11,5,6,45.45
Kled,Kayle,15,3,12,20
Kled,Nasus,8,5,3,62.5
Kled,Nidalee,10,7,3,70
Kled,Sona,8,8,0,100
Kled,KSante,19,8,11,42.11
Kled,RekSai,5,2,3,40
Kled,Graves,26,20,6,76.92
Kled,Xayah,8,3,5,37.5
Kled,Azir,17,11,6,64.71
Kled,Zac,21,12,9,57.14
Kled,Janna,9,0,9,0
Kled,Annie,8,0,8,0
Kled,Evelynn,3,3,0,100
Thresh,Teemo,294,139,155,47.28
Thresh,Warwick,456,246,210,53.95
Thresh,Nunu,256,121,135,47.27
Thresh,Lucian,305,163,142,53.44
Thresh,Leona,468,247,221,52.78
Thresh,Ashe,706,359,347,50.85
Thresh,Graves,290,154,136,53.1
Thresh,Vayne,417,195,222,46.76
Thresh,Draven,181,108,73,59.67
Thresh,Yorick,279,140,139,50.18
Thresh,Diana,454,248,206,54.63
Thresh,Yasuo,684,312,372,45.61
Thresh,Lulu,516,258,258,50
Thresh,Rengar,103,56,47,54.37
Thresh,Irelia,298,142,156,47.65
Thresh,Nautilus,506,212,294,41.9
Thresh,Malphite,409,216,193,52.81
Thresh,Ivern,68,38,30,55.88
Thresh,Ahri,536,273,263,50.93
Thresh,TahmKench,370,177,193,47.84
Thresh,JarvanIV,291,133,158,45.7
Thresh,Veigar,309,135,174,43.69
Thresh,Gangplank,178,101,77,56.74
Thresh,XinZhao,221,94,127,42.53
Thresh,Azir,118,72,46,61.02
Thresh,Kaisa,620,301,319,48.55
Thresh,Lux,872,417,455,47.82
Thresh,Shen,261,105,156,40.23
Thresh,Viego,480,259,221,53.96
Thresh,Corki,182,82,100,45.05
Thresh,Gragas,285,166,119,58.25
Thresh,Qiyana,85,50,35,58.82
Thresh,Kalista,96,65,31,67.71
Thresh,Neeko,183,69,114,37.7
Thresh,Sett,481,262,219,54.47
Thresh,KogMaw,105,54,51,51.43
Thresh,Gwen,198,96,102,48.48
Thresh,Amumu,399,191,208,47.87
Thresh,DrMundo,228,118,110,51.75
Thresh,Tristana,356,205,151,57.58
Thresh,Chogath,483,197,286,40.79
Thresh,MasterYi,317,125,192,39.43
Thresh,AurelionSol,143,74,69,51.75
Thresh,Naafiri,109,30,79,27.52
Thresh,Caitlyn,906,418,488,46.14
Thresh,Morgana,344,155,189,45.06
Thresh,Yuumi,345,175,170,50.72
Thresh,Trundle,165,72,93,43.64
Thresh,Janna,126,52,74,41.27
Thresh,Ornn,171,70,101,40.94
Thresh,Zac,220,117,103,53.18
Thresh,Zed,353,164,189,46.46
Thresh,Varus,352,178,174,50.57
Thresh,Soraka,136,70,66,51.47
Thresh,Ziggs,113,52,61,46.02
Thresh,Hwei,209,116,93,55.5
Thresh,Zoe,106,54,52,50.94
Thresh,Jayce,196,108,88,55.1
Thresh,Elise,270,136,134,50.37
Thresh,Twitch,241,127,114,52.7
Thresh,Gnar,163,83,80,50.92
Thresh,MissFortune,665,317,348,47.67
Thresh,Karma,462,255,207,55.19
Thresh,Vladimir,232,111,121,47.84
Thresh,Lillia,271,155,116,57.2
Thresh,Galio,393,196,197,49.87
Thresh,Pyke,343,161,182,46.94
Thresh,Singed,100,55,45,55
Thresh,Leblanc,257,134,123,52.14
Thresh,Katarina,215,85,130,39.53
Thresh,Annie,110,60,50,54.55
Thresh,Jhin,597,302,295,50.59
Thresh,Ezreal,903,492,411,54.49
Thresh,Ekko,235,102,133,43.4
Thresh,Nasus,249,115,134,46.18
Thresh,Alistar,238,127,111,53.36
Thresh,Riven,135,64,71,47.41
Thresh,Skarner,151,84,67,55.63
Thresh,Mordekaiser,418,200,218,47.85
Thresh,Aphelios,199,112,87,56.28
Thresh,Nami,308,150,158,48.7
Thresh,Khazix,135,74,61,54.81
Thresh,Heimerdinger,132,66,66,50
Thresh,Jinx,813,352,461,43.3
Thresh,Garen,586,267,319,45.56
Thresh,Kennen,118,50,68,42.37
Thresh,Volibear,370,170,200,45.95
Thresh,Kayn,445,237,208,53.26
Thresh,LeeSin,685,339,346,49.49
Thresh,Syndra,264,147,117,55.68
Thresh,Blitzcrank,329,196,133,59.57
Thresh,Mel,701,359,342,51.21
Thresh,Karthus,70,35,35,50
Thresh,Darius,649,322,327,49.61
Thresh,Sejuani,213,96,117,45.07
Thresh,Briar,168,81,87,48.21
Thresh,Zilean,135,70,65,51.85
Thresh,TwistedFate,138,76,62,55.07
Thresh,Malzahar,376,195,181,51.86
Thresh,Braum,368,152,216,41.3
Thresh,Bard,145,66,79,45.52
Thresh,Swain,427,178,249,41.69
Thresh,Renata,98,54,44,55.1
Thresh,Pantheon,633,309,324,48.82
Thresh,Ambessa,241,103,138,42.74
Thresh,Rell,242,131,111,54.13
Thresh,Milio,229,98,131,42.79
Thresh,Kindred,156,107,49,68.59
Thresh,Fiora,89,47,42,52.81
Thresh,Rakan,222,89,133,40.09
Thresh,Aurora,333,162,171,48.65
Thresh,Talon,207,120,87,57.97
Thresh,Vi,416,169,247,40.63
Thresh,Sion,379,196,183,51.72
Thresh,Samira,229,91,138,39.74
Thresh,Evelynn,87,42,45,48.28
Thresh,Xayah,224,104,120,46.43
Thresh,Aatrox,437,242,195,55.38
Thresh,Kassadin,59,34,25,57.63
Thresh,KSante,237,149,88,62.87
Thresh,Taric,107,44,63,41.12
Thresh,Kayle,142,74,68,52.11
Thresh,Cassiopeia,88,45,43,51.14
Thresh,Tryndamere,111,45,66,40.54
Thresh,Hecarim,120,64,56,53.33
Thresh,Poppy,225,102,123,45.33
Thresh,Olaf,94,47,47,50
Thresh,Sylas,534,294,240,55.06
Thresh,RekSai,41,20,21,48.78
Thresh,Senna,190,126,64,66.32
Thresh,Jax,318,170,148,53.46
Thresh,Viktor,373,186,187,49.87
Thresh,Rammus,105,51,54,48.57
Thresh,Shaco,253,134,119,52.96
Thresh,Akali,300,154,146,51.33
Thresh,Maokai,181,70,111,38.67
Thresh,Zeri,190,113,77,59.47
Thresh,Orianna,187,108,79,57.75
Thresh,Zyra,292,123,169,42.12
Thresh,Seraphine,250,105,145,42
Thresh,Ryze,135,66,69,48.89
Thresh,Urgot,138,68,70,49.28
Thresh,Renekton,168,74,94,44.05
Thresh,Yone,594,278,316,46.8
Thresh,Fizz,128,65,63,50.78
Thresh,FiddleSticks,184,96,88,52.17
Thresh,Nocturne,393,190,203,48.35
Thresh,Xerath,337,198,139,58.75
Thresh,Velkoz,197,97,100,49.24
Thresh,Quinn,138,75,63,54.35
Thresh,MonkeyKing,267,137,130,51.31
Thresh,Brand,175,73,102,41.71
Thresh,Illaoi,162,95,67,58.64
Thresh,Sona,51,31,20,60.78
Thresh,Shyvana,60,21,39,35
Thresh,Lissandra,168,98,70,58.33
Thresh,Anivia,148,62,86,41.89
Thresh,Taliyah,74,19,55,25.68
Thresh,Rumble,116,44,72,37.93
Thresh,Camille,118,56,62,47.46
Thresh,Sivir,248,118,130,47.58
Thresh,Udyr,139,87,52,62.59
Thresh,Vex,175,84,91,48
Thresh,Smolder,252,109,143,43.25
Thresh,Nidalee,123,69,54,56.1
Thresh,Belveth,100,42,58,42
Thresh,Akshan,107,60,47,56.07
Thresh,Nilah,105,64,41,60.95
Thresh,Kled,46,30,16,65.22
Nunu,Kled,20,12,8,60
Nunu,Kayn,154,76,78,49.35
Nunu,Katarina,83,52,31,62.65
Nunu,Twitch,119,67,52,56.3
Nunu,Thresh,256,135,121,52.73
Nunu,Irelia,86,43,43,50
Nunu,LeeSin,208,99,109,47.6
Nunu,Zed,131,64,67,48.85
Nunu,Caitlyn,347,172,175,49.57
Nunu,Morgana,146,57,89,39.04
Nunu,Teemo,129,51,78,39.53
Nunu,Renekton,65,31,34,47.69
Nunu,Kassadin,42,19,23,45.24
Nunu,Jinx,323,143,180,44.27
Nunu,Soraka,64,31,33,48.44
Nunu,MasterYi,131,60,71,45.8
Nunu,Warwick,227,112,115,49.34
Nunu,Kaisa,186,96,90,51.61
Nunu,Pyke,114,56,58,49.12
Nunu,Yorick,167,73,94,43.71
Nunu,Skarner,57,34,23,59.65
Nunu,Mel,297,152,145,51.18
Nunu,Smolder,88,36,52,40.91
Nunu,Senna,91,44,47,48.35
Nunu,Jayce,34,19,15,55.88
Nunu,Graves,104,27,77,25.96
Nunu,Lux,301,152,149,50.5
Nunu,Seraphine,64,24,40,37.5
Nunu,Nasus,91,47,44,51.65
Nunu,Vi,134,80,54,59.7
Nunu,Galio,193,83,110,43.01
Nunu,Kayle,71,22,49,30.99
Nunu,Jax,84,47,37,55.95
Nunu,XinZhao,43,11,32,25.58
Nunu,Azir,54,19,35,35.19
Nunu,Rell,83,41,42,49.4
Nunu,Varus,144,50,94,34.72
Nunu,Pantheon,270,134,136,49.63
Nunu,Vex,58,34,24,58.62
Nunu,Jhin,215,119,96,55.35
Nunu,Riven,50,37,13,74
Nunu,Nocturne,193,95,98,49.22
Nunu,Akali,136,77,59,56.62
Nunu,Ashe,215,108,107,50.23
Nunu,Mordekaiser,157,79,78,50.32
Nunu,Yasuo,176,67,109,38.07
Nunu,Aphelios,83,30,53,36.14
Nunu,Nami,152,57,95,37.5
Nunu,Aatrox,119,45,74,37.82
Nunu,Ekko,128,65,63,50.78
Nunu,Ezreal,336,163,173,48.51
Nunu,Singed,23,12,11,52.17
Nunu,Urgot,86,51,35,59.3
Nunu,Lissandra,69,38,31,55.07
Nunu,Brand,88,39,49,44.32
Nunu,Leona,168,67,101,39.88
Nunu,Veigar,148,58,90,39.19
Nunu,Elise,83,35,48,42.17
Nunu,Zac,75,42,33,56
Nunu,JarvanIV,83,47,36,56.63
Nunu,Sivir,62,30,32,48.39
Nunu,Milio,74,40,34,54.05
Nunu,MissFortune,265,113,152,42.64
Nunu,Zyra,94,40,54,42.55
Nunu,Ambessa,114,55,59,48.25
Nunu,Chogath,205,85,120,41.46
Nunu,Braum,107,35,72,32.71
Nunu,Trundle,87,35,52,40.23
Nunu,Leblanc,70,36,34,51.43
Nunu,FiddleSticks,67,21,46,31.34
Nunu,DrMundo,73,40,33,54.79
Nunu,Vladimir,84,49,35,58.33
Nunu,Gangplank,34,19,15,55.88
Nunu,Sett,200,87,113,43.5
Nunu,TahmKench,110,44,66,40
Nunu,Yone,242,103,139,42.56
Nunu,Maokai,84,56,28,66.67
Nunu,Ziggs,61,25,36,40.98
Nunu,Kindred,64,35,29,54.69
Nunu,Garen,183,74,109,40.44
Nunu,Annie,24,15,9,62.5
Nunu,Diana,186,79,107,42.47
Nunu,Tristana,141,70,71,49.65
Nunu,Nautilus,163,50,113,30.67
Nunu,TwistedFate,44,20,24,45.45
Nunu,Nilah,47,25,22,53.19
Nunu,Ryze,56,33,23,58.93
Nunu,Ahri,175,84,91,48
Nunu,Briar,63,27,36,42.86
Nunu,Sylas,160,74,86,46.25
Nunu,Vayne,153,67,86,43.79
Nunu,Yuumi,105,55,50,52.38
Nunu,Shen,116,65,51,56.03
Nunu,Velkoz,107,45,62,42.06
Nunu,Malzahar,126,57,69,45.24
Nunu,Malphite,167,75,92,44.91
Nunu,Hwei,89,60,29,67.42
Nunu,MonkeyKing,94,33,61,35.11
Nunu,Poppy,76,38,38,50
Nunu,Taliyah,22,12,10,54.55
Nunu,Talon,49,26,23,53.06
Nunu,Janna,29,10,19,34.48
Nunu,Cassiopeia,35,20,15,57.14
Nunu,Olaf,33,18,15,54.55
Nunu,Swain,130,60,70,46.15
Nunu,Samira,111,60,51,54.05
Nunu,Rakan,57,30,27,52.63
Nunu,Naafiri,57,14,43,24.56
Nunu,Evelynn,71,39,32,54.93
Nunu,Draven,85,29,56,34.12
Nunu,Shaco,116,69,47,59.48
Nunu,Xerath,135,57,78,42.22
Nunu,Lulu,161,84,77,52.17
Nunu,Orianna,64,32,32,50
Nunu,Kalista,38,15,23,39.47
Nunu,Heimerdinger,67,32,35,47.76
Nunu,Rammus,36,28,8,77.78
Nunu,KogMaw,42,14,28,33.33
Nunu,Quinn,53,21,32,39.62
Nunu,Gwen,65,23,42,35.38
Nunu,Akshan,54,32,22,59.26
Nunu,Darius,258,108,150,41.86
Nunu,AurelionSol,68,27,41,39.71
Nunu,Ornn,76,30,46,39.47
Nunu,Viego,154,72,82,46.75
Nunu,Hecarim,52,26,26,50
Nunu,Bard,54,21,33,38.89
Nunu,Sejuani,71,27,44,38.03
Nunu,Volibear,145,92,53,63.45
Nunu,Udyr,43,18,25,41.86
Nunu,Fiora,42,20,22,47.62
Nunu,Corki,67,30,37,44.78
Nunu,Lillia,61,29,32,47.54
Nunu,Tryndamere,51,29,22,56.86
Nunu,Gragas,85,45,40,52.94
Nunu,Viktor,115,53,62,46.09
Nunu,Lucian,101,54,47,53.47
Nunu,Khazix,61,36,25,59.02
Nunu,Xayah,63,33,30,52.38
Nunu,Aurora,77,47,30,61.04
Nunu,Alistar,63,31,32,49.21
Nunu,Fizz,79,33,46,41.77
Nunu,Zeri,49,26,23,53.06
Nunu,Karma,121,63,58,52.07
Nunu,Rengar,35,22,13,62.86
Nunu,Amumu,204,81,123,39.71
Nunu,Shyvana,39,13,26,33.33
Nunu,Zilean,39,8,31,20.51
Nunu,Sion,116,42,74,36.21
Nunu,Belveth,20,11,9,55
Nunu,Gnar,72,43,29,59.72
Nunu,Karthus,33,10,23,30.3
Nunu,Sona,27,17,10,62.96
Nunu,RekSai,14,5,9,35.71
Nunu,Neeko,45,23,22,51.11
Nunu,Kennen,33,10,23,30.3
Nunu,Taric,36,23,13,63.89
Nunu,Syndra,80,27,53,33.75
Nunu,Anivia,41,13,28,31.71
Nunu,Qiyana,27,16,11,59.26
Nunu,Renata,18,9,9,50
Nunu,Blitzcrank,97,49,48,50.52
Nunu,Rumble,34,17,17,50
Nunu,KSante,66,23,43,34.85
Nunu,Zoe,45,28,17,62.22
Nunu,Nidalee,33,21,12,63.64
Nunu,Camille,46,26,20,56.52
Nunu,Illaoi,87,38,49,43.68
Nunu,Ivern,38,15,23,39.47
Heimerdinger,Yone,147,76,71,51.7
Heimerdinger,JarvanIV,41,18,23,43.9
Heimerdinger,Ryze,46,22,24,47.83
Heimerdinger,Draven,64,18,46,28.13
Heimerdinger,Blitzcrank,64,26,38,40.63
Heimerdinger,Yorick,83,37,46,44.58
Heimerdinger,Diana,119,54,65,45.38
Heimerdinger,Yasuo,180,81,99,45
Heimerdinger,Ashe,186,94,92,50.54
Heimerdinger,Lulu,102,52,50,50.98
Heimerdinger,Vladimir,59,28,31,47.46
Heimerdinger,Lux,223,97,126,43.5
Heimerdinger,Amumu,99,39,60,39.39
Heimerdinger,Rell,88,40,48,45.45
Heimerdinger,Mel,161,65,96,40.37
Heimerdinger,Nocturne,100,52,48,52
Heimerdinger,Galio,121,60,61,49.59
Heimerdinger,Illaoi,41,17,24,41.46
Heimerdinger,Senna,61,28,33,45.9
Heimerdinger,Varus,87,48,39,55.17
Heimerdinger,Pantheon,159,85,74,53.46
Heimerdinger,Vex,60,34,26,56.67
Heimerdinger,Jhin,176,75,101,42.61
Heimerdinger,Gnar,47,15,32,31.91
Heimerdinger,Belveth,24,12,12,50
Heimerdinger,Hwei,65,35,30,53.85
Heimerdinger,Samira,74,39,35,52.7
Heimerdinger,TahmKench,81,40,41,49.38
Heimerdinger,Malphite,104,60,44,57.69
Heimerdinger,Kayn,119,62,57,52.1
Heimerdinger,Sylas,113,60,53,53.1
Heimerdinger,Lucian,75,33,42,44
Heimerdinger,FiddleSticks,34,21,13,61.76
Heimerdinger,Ezreal,186,82,104,44.09
Heimerdinger,Urgot,38,8,30,21.05
Heimerdinger,Kindred,41,17,24,41.46
Heimerdinger,Veigar,132,72,60,54.55
Heimerdinger,MissFortune,194,105,89,54.12
Heimerdinger,Darius,155,64,91,41.29
Heimerdinger,Warwick,175,79,96,45.14
Heimerdinger,Taliyah,19,9,10,47.37
Heimerdinger,Xayah,71,21,50,29.58
Heimerdinger,Karma,69,33,36,47.83
Heimerdinger,Lillia,59,17,42,28.81
Heimerdinger,Thresh,132,66,66,50
Heimerdinger,Fizz,33,17,16,51.52
Heimerdinger,Caitlyn,211,107,104,50.71
Heimerdinger,Nautilus,121,46,75,38.02
Heimerdinger,Sett,127,64,63,50.39
Heimerdinger,Neeko,39,18,21,46.15
Heimerdinger,Swain,113,46,67,40.71
Heimerdinger,Aatrox,62,33,29,53.23
Heimerdinger,Annie,32,17,15,53.13
Heimerdinger,Mordekaiser,108,66,42,61.11
Heimerdinger,Sejuani,42,13,29,30.95
Heimerdinger,Zoe,21,13,8,61.9
Heimerdinger,Zilean,30,11,19,36.67
Heimerdinger,LeeSin,121,79,42,65.29
Heimerdinger,Gragas,57,23,34,40.35
Heimerdinger,Ekko,69,35,34,50.72
Heimerdinger,Kaisa,99,52,47,52.53
Heimerdinger,Nami,68,42,26,61.76
Heimerdinger,Teemo,123,64,59,52.03
Heimerdinger,Vayne,110,54,56,49.09
Heimerdinger,Corki,34,28,6,82.35
Heimerdinger,Graves,52,13,39,25
Heimerdinger,TwistedFate,24,14,10,58.33
Heimerdinger,Anivia,22,5,17,22.73
Heimerdinger,Camille,25,12,13,48
Heimerdinger,Zed,81,33,48,40.74
Heimerdinger,Jinx,232,79,153,34.05
Heimerdinger,Sona,17,6,11,35.29
Heimerdinger,Akali,98,57,41,58.16
Heimerdinger,Rammus,42,22,20,52.38
Heimerdinger,Fiora,32,8,24,25
Heimerdinger,Nidalee,25,11,14,44
Heimerdinger,Tristana,66,32,34,48.48
Heimerdinger,Ambessa,47,28,19,59.57
Heimerdinger,Pyke,59,29,30,49.15
Heimerdinger,Renekton,24,13,11,54.17
Heimerdinger,XinZhao,78,46,32,58.97
Heimerdinger,Leona,113,67,46,59.29
Heimerdinger,AurelionSol,32,16,16,50
Heimerdinger,Shaco,74,38,36,51.35
Heimerdinger,Morgana,105,54,51,51.43
Heimerdinger,Seraphine,74,37,37,50
Heimerdinger,Soraka,34,17,17,50
Heimerdinger,Ahri,99,56,43,56.57
Heimerdinger,Twitch,78,38,40,48.72
Heimerdinger,Nasus,59,36,23,61.02
Heimerdinger,Singed,25,10,15,40
Heimerdinger,Kalista,16,9,7,56.25
Heimerdinger,Kennen,34,23,11,67.65
Heimerdinger,Smolder,79,48,31,60.76
Heimerdinger,Renata,27,7,20,25.93
Heimerdinger,Khazix,49,28,21,57.14
Heimerdinger,Viego,131,48,83,36.64
Heimerdinger,Katarina,56,24,32,42.86
Heimerdinger,Chogath,101,36,65,35.64
Heimerdinger,Taric,14,6,8,42.86
Heimerdinger,Akshan,25,2,23,8
Heimerdinger,Zyra,77,42,35,54.55
Heimerdinger,Milio,32,19,13,59.38
Heimerdinger,DrMundo,72,40,32,55.56
Heimerdinger,Aurora,63,32,31,50.79
Heimerdinger,Viktor,88,42,46,47.73
Heimerdinger,Shyvana,23,8,15,34.78
Heimerdinger,Olaf,28,18,10,64.29
Heimerdinger,Zac,48,23,25,47.92
Heimerdinger,Briar,60,35,25,58.33
Heimerdinger,Nunu,67,35,32,52.24
Heimerdinger,Qiyana,22,11,11,50
Heimerdinger,Aphelios,48,40,8,83.33
Heimerdinger,Jayce,52,26,26,50
Heimerdinger,Rakan,55,33,22,60
Heimerdinger,MasterYi,77,35,42,45.45
Heimerdinger,Xerath,88,36,52,40.91
Heimerdinger,Udyr,36,17,19,47.22
Heimerdinger,Azir,26,14,12,53.85
Heimerdinger,Evelynn,25,14,11,56
Heimerdinger,Ziggs,39,14,25,35.9
Heimerdinger,KSante,33,18,15,54.55
Heimerdinger,Syndra,82,32,50,39.02
Heimerdinger,Quinn,38,25,13,65.79
Heimerdinger,Ornn,45,21,24,46.67
Heimerdinger,Tryndamere,47,18,29,38.3
Heimerdinger,Velkoz,61,20,41,32.79
Heimerdinger,Irelia,78,31,47,39.74
Heimerdinger,Yuumi,83,40,43,48.19
Heimerdinger,Brand,53,32,21,60.38
Heimerdinger,Cassiopeia,20,5,15,25
Heimerdinger,Volibear,77,47,30,61.04
Heimerdinger,Malzahar,90,43,47,47.78
Heimerdinger,Poppy,48,21,27,43.75
Heimerdinger,Garen,114,36,78,31.58
Heimerdinger,Lissandra,22,15,7,68.18
Heimerdinger,Jax,42,19,23,45.24
Heimerdinger,Elise,64,50,14,78.13
Heimerdinger,Kayle,52,21,31,40.38
Heimerdinger,Zeri,35,18,17,51.43
Heimerdinger,Sion,76,34,42,44.74
Heimerdinger,KogMaw,18,8,10,44.44
Heimerdinger,Braum,52,14,38,26.92
Heimerdinger,MonkeyKing,51,32,19,62.75
Heimerdinger,Maokai,33,13,20,39.39
Heimerdinger,Naafiri,24,10,14,41.67
Heimerdinger,Nilah,20,10,10,50
Heimerdinger,Riven,16,9,7,56.25
Heimerdinger,Kassadin,16,2,14,12.5
Heimerdinger,Orianna,76,24,52,31.58
Heimerdinger,Rengar,14,5,9,35.71
Heimerdinger,Ivern,20,14,6,70
Heimerdinger,Hecarim,24,8,16,33.33
Heimerdinger,Trundle,33,15,18,45.45
Heimerdinger,Vi,102,44,58,43.14
Heimerdinger,Shen,55,20,35,36.36
Heimerdinger,Alistar,43,18,25,41.86
Heimerdinger,Skarner,23,9,14,39.13
Heimerdinger,Karthus,8,3,5,37.5
Heimerdinger,Gangplank,31,22,9,70.97
Heimerdinger,Kled,20,13,7,65
Heimerdinger,Bard,20,8,12,40
Heimerdinger,Gwen,38,25,13,65.79
Heimerdinger,Sivir,51,27,24,52.94
Heimerdinger,Rumble,12,10,2,83.33
Heimerdinger,Talon,21,9,12,42.86
Heimerdinger,Leblanc,12,8,4,66.67
Heimerdinger,RekSai,5,2,3,40
Heimerdinger,Janna,8,6,2,75
Rell,Shen,121,66,55,54.55
Rell,Vi,177,87,90,49.15
Rell,Swain,126,72,54,57.14
Rell,Nilah,59,32,27,54.24
Rell,Nami,135,70,65,51.85
Rell,Kennen,46,33,13,71.74
Rell,Ashe,258,158,100,61.24
Rell,Lux,254,127,127,50
Rell,Leona,178,82,96,46.07
Rell,Jax,98,45,53,45.92
Rell,Diana,171,99,72,57.89
Rell,Akshan,42,16,26,38.1
Rell,Milio,107,47,60,43.93
Rell,Gangplank,69,28,41,40.58
Rell,Pantheon,242,114,128,47.11
Rell,TwistedFate,44,25,19,56.82
Rell,Kaisa,198,99,99,50
Rell,Braum,132,75,57,56.82
Rell,Kayle,78,19,59,24.36
Rell,Evelynn,40,19,21,47.5
Rell,Vladimir,112,55,57,49.11
Rell,Maokai,66,37,29,56.06
Rell,Yorick,109,47,62,43.12
Rell,Skarner,72,31,41,43.06
Rell,Mel,297,156,141,52.53
Rell,Smolder,115,27,88,23.48
Rell,Senna,90,41,49,45.56
Rell,Heimerdinger,88,48,40,54.55
Rell,Briar,80,43,37,53.75
Rell,Irelia,104,45,59,43.27
Rell,Jhin,281,134,147,47.69
Rell,Vayne,184,90,94,48.91
Rell,Ivern,25,15,10,60
Rell,Qiyana,27,13,14,48.15
Rell,Ahri,215,100,115,46.51
Rell,Seraphine,87,42,45,48.28
Rell,Chogath,185,83,102,44.86
Rell,MasterYi,103,57,46,55.34
Rell,Singed,47,23,24,48.94
Rell,Tristana,110,51,59,46.36
Rell,Zyra,102,50,52,49.02
Rell,Warwick,172,72,100,41.86
Rell,Nunu,83,42,41,50.6
Rell,Malzahar,163,82,81,50.31
Rell,Samira,103,51,52,49.51
Rell,Pyke,80,48,32,60
Rell,DrMundo,64,42,22,65.63
Rell,LeeSin,223,112,111,50.22
Rell,Zed,138,68,70,49.28
Rell,Zeri,81,44,37,54.32
Rell,Lulu,192,100,92,52.08
Rell,Riven,60,30,30,50
Rell,Nocturne,153,87,66,56.86
Rell,Akali,147,81,66,55.1
Rell,Soraka,52,34,18,65.38
Rell,Darius,256,127,129,49.61
Rell,Sylas,175,100,75,57.14
Rell,Jinx,330,147,183,44.55
Rell,TahmKench,142,60,82,42.25
Rell,Talon,79,58,21,73.42
Rell,Lissandra,56,20,36,35.71
Rell,Corki,85,43,42,50.59
Rell,Udyr,33,14,19,42.42
Rell,Ornn,101,52,49,51.49
Rell,Gnar,81,41,40,50.62
Rell,Aatrox,128,62,66,48.44
Rell,MissFortune,239,133,106,55.65
Rell,Nautilus,258,120,138,46.51
Rell,Viego,190,93,97,48.95
Rell,Galio,107,45,62,42.06
Rell,Draven,80,51,29,63.75
Rell,Zoe,64,35,29,54.69
Rell,Ezreal,323,156,167,48.3
Rell,Aurora,128,67,61,52.34
Rell,Kindred,53,23,30,43.4
Rell,Urgot,76,42,34,55.26
Rell,Karthus,35,10,25,28.57
Rell,Caitlyn,360,182,178,50.56
Rell,Gragas,106,67,39,63.21
Rell,Ekko,129,58,71,44.96
Rell,Viktor,149,73,76,48.99
Rell,Lucian,103,54,49,52.43
Rell,Sett,160,79,81,49.38
Rell,XinZhao,95,41,54,43.16
Rell,Morgana,132,69,63,52.27
Rell,Thresh,242,111,131,45.87
Rell,Xayah,89,44,45,49.44
Rell,Trundle,72,31,41,43.06
Rell,Teemo,117,48,69,41.03
Rell,Kassadin,13,8,5,61.54
Rell,KSante,78,32,46,41.03
Rell,FiddleSticks,51,26,25,50.98
Rell,Illaoi,46,29,17,63.04
Rell,MonkeyKing,118,49,69,41.53
Rell,Rakan,80,35,45,43.75
Rell,Kayn,212,101,111,47.64
Rell,Karma,157,74,83,47.13
Rell,Camille,63,31,32,49.21
Rell,Olaf,48,15,33,31.25
Rell,Volibear,197,108,89,54.82
Rell,Xerath,106,38,68,35.85
Rell,Renekton,69,39,30,56.52
Rell,Lillia,61,32,29,52.46
Rell,Amumu,150,56,94,37.33
Rell,Sivir,76,32,44,42.11
Rell,Tryndamere,40,22,18,55
Rell,Yuumi,124,51,73,41.13
Rell,Taliyah,39,21,18,53.85
Rell,Syndra,95,43,52,45.26
Rell,Janna,81,40,41,49.38
Rell,Malphite,155,63,92,40.65
Rell,Neeko,48,20,28,41.67
Rell,Ziggs,58,33,25,56.9
Rell,Veigar,114,47,67,41.23
Rell,Brand,83,42,41,50.6
Rell,Poppy,119,61,58,51.26
Rell,Katarina,91,56,35,61.54
Rell,Elise,99,50,49,50.51
Rell,Velkoz,77,46,31,59.74
Rell,Hecarim,51,27,24,52.94
Rell,Nidalee,57,44,13,77.19
Rell,Yasuo,250,116,134,46.4
Rell,Yone,195,110,85,56.41
Rell,Blitzcrank,154,87,67,56.49
Rell,Aphelios,74,31,43,41.89
Rell,Vex,91,50,41,54.95
Rell,Varus,147,72,75,48.98
Rell,Sejuani,95,39,56,41.05
Rell,Zilean,51,17,34,33.33
Rell,Gwen,69,32,37,46.38
Rell,AurelionSol,69,31,38,44.93
Rell,Mordekaiser,199,118,81,59.3
Rell,Graves,74,23,51,31.08
Rell,Orianna,60,30,30,50
Rell,Hwei,98,62,36,63.27
Rell,Kalista,38,21,17,55.26
Rell,Shaco,85,50,35,58.82
Rell,Alistar,104,47,57,45.19
Rell,Rengar,45,16,29,35.56
Rell,Sion,187,86,101,45.99
Rell,Sona,27,15,12,55.56
Rell,Annie,56,32,24,57.14
Rell,Zac,86,45,41,52.33
Rell,Jayce,53,42,11,79.25
Rell,Ryze,44,19,25,43.18
Rell,JarvanIV,127,46,81,36.22
Rell,Bard,48,19,29,39.58
Rell,Nasus,51,27,24,52.94
Rell,Garen,146,70,76,47.95
Rell,Fiora,43,15,28,34.88
Rell,Fizz,54,26,28,48.15
Rell,Azir,60,29,31,48.33
Rell,Khazix,66,35,31,53.03
Rell,Quinn,52,29,23,55.77
Rell,Leblanc,67,35,32,52.24
Rell,Ambessa,104,67,37,64.42
Rell,Twitch,97,41,56,42.27
Rell,KogMaw,43,18,25,41.86
Rell,RekSai,8,0,8,0
Rell,Cassiopeia,34,19,15,55.88
Rell,Belveth,30,14,16,46.67
Rell,Shyvana,27,9,18,33.33
Rell,Anivia,38,9,29,23.68
Rell,Taric,22,9,13,40.91
Rell,Kled,21,10,11,47.62
Rell,Renata,38,12,26,31.58
Rell,Rammus,21,12,9,57.14
Rell,Rumble,38,11,27,28.95
Rell,Naafiri,30,11,19,36.67
Rengar,Shen,51,23,28,45.1
Rengar,Vi,71,23,48,32.39
Rengar,Swain,57,27,30,47.37
Rengar,Nilah,35,11,24,31.43
Rengar,Nami,77,26,51,33.77
Rengar,Malphite,95,36,59,37.89
Rengar,Khazix,72,33,39,45.83
Rengar,Galio,72,28,44,38.89
Rengar,Smolder,55,23,32,41.82
Rengar,Thresh,103,47,56,45.63
Rengar,Yorick,45,23,22,51.11
Rengar,Diana,77,27,50,35.06
Rengar,Akali,48,14,34,29.17
Rengar,Ashe,119,65,54,54.62
Rengar,Milio,40,21,19,52.5
Rengar,Darius,82,30,52,36.59
Rengar,LeeSin,105,34,71,32.38
Rengar,Katarina,24,13,11,54.17
Rengar,Caitlyn,133,46,87,34.59
Rengar,Jinx,160,73,87,45.63
Rengar,Aatrox,65,28,37,43.08
Rengar,Ekko,65,31,34,47.69
Rengar,Chogath,71,35,36,49.3
Rengar,Zyra,42,11,31,26.19
Rengar,Irelia,44,25,19,56.82
Rengar,Rammus,15,3,12,20
Rengar,Mordekaiser,78,30,48,38.46
Rengar,KogMaw,14,3,11,21.43
Rengar,Lux,166,70,96,42.17
Rengar,Rumble,11,3,8,27.27
Rengar,Fizz,24,9,15,37.5
Rengar,Zilean,24,11,13,45.83
Rengar,Jhin,115,67,48,58.26
Rengar,Garen,91,35,56,38.46
Rengar,Shaco,52,13,39,25
Rengar,Hwei,39,16,23,41.03
Rengar,Leblanc,62,32,30,51.61
Rengar,Ivern,20,8,12,40
Rengar,Skarner,17,5,12,29.41
Rengar,Yuumi,70,27,43,38.57
Rengar,Gwen,34,13,21,38.24
Rengar,Blitzcrank,55,22,33,40
Rengar,Ornn,39,17,22,43.59
Rengar,Gragas,29,16,13,55.17
Rengar,Yasuo,136,50,86,36.76
Rengar,Tristana,76,51,25,67.11
Rengar,Bard,34,19,15,55.88
Rengar,Fiora,29,10,19,34.48
Rengar,MissFortune,134,63,71,47.01
Rengar,Brand,54,14,40,25.93
Rengar,Yone,95,48,47,50.53
Rengar,Janna,14,6,8,42.86
Rengar,Warwick,89,43,46,48.31
Rengar,Kayn,116,65,51,56.03
Rengar,Malzahar,56,40,16,71.43
Rengar,Kaisa,65,26,39,40
Rengar,Viktor,54,17,37,31.48
Rengar,Amumu,97,43,54,44.33
Rengar,TahmKench,51,29,22,56.86
Rengar,Xerath,80,29,51,36.25
Rengar,Mel,126,54,72,42.86
Rengar,Vayne,85,27,58,31.76
Rengar,Sylas,85,52,33,61.18
Rengar,Jax,49,17,32,34.69
Rengar,Viego,75,45,30,60
Rengar,Sona,20,9,11,45
Rengar,Nocturne,73,42,31,57.53
Rengar,Quinn,24,8,16,33.33
Rengar,Elise,39,20,19,51.28
Rengar,Lucian,41,19,22,46.34
Rengar,Zac,54,21,33,38.89
Rengar,Naafiri,36,11,25,30.56
Rengar,Braum,40,18,22,45
Rengar,Belveth,18,9,9,50
Rengar,Vladimir,33,15,18,45.45
Rengar,Soraka,20,11,9,55
Rengar,JarvanIV,52,18,34,34.62
Rengar,Varus,37,26,11,70.27
Rengar,XinZhao,28,20,8,71.43
Rengar,Gnar,37,24,13,64.86
Rengar,Lulu,89,55,34,61.8
Rengar,Samira,52,30,22,57.69
Rengar,Morgana,42,17,25,40.48
Rengar,Trundle,28,17,11,60.71
Rengar,MasterYi,53,29,24,54.72
Rengar,Kindred,21,10,11,47.62
Rengar,Lissandra,29,5,24,17.24
Rengar,Pantheon,101,39,62,38.61
Rengar,Volibear,63,26,37,41.27
Rengar,AurelionSol,23,11,12,47.83
Rengar,Aphelios,38,19,19,50
Rengar,Xayah,55,14,41,25.45
Rengar,Rakan,47,21,26,44.68
Rengar,Jayce,25,11,14,44
Rengar,Veigar,61,26,35,42.62
Rengar,Talon,44,31,13,70.45
Rengar,Olaf,9,5,4,55.56
Rengar,Tryndamere,39,26,13,66.67
Rengar,Lillia,17,9,8,52.94
Rengar,Pyke,48,31,17,64.58
Rengar,Renata,18,13,5,72.22
Rengar,Corki,27,8,19,29.63
Rengar,Aurora,48,24,24,50
Rengar,Rell,45,29,16,64.44
Rengar,Teemo,47,18,29,38.3
Rengar,Riven,25,16,9,64
Rengar,Kassadin,13,6,7,46.15
Rengar,Alistar,32,14,18,43.75
Rengar,Ezreal,143,63,80,44.06
Rengar,Velkoz,49,18,31,36.73
Rengar,Zed,60,32,28,53.33
Rengar,Udyr,22,6,16,27.27
Rengar,Seraphine,47,15,32,31.91
Rengar,Nasus,28,13,15,46.43
Rengar,Karma,58,27,31,46.55
Rengar,Sett,71,26,45,36.62
Rengar,Nautilus,51,21,30,41.18
Rengar,FiddleSticks,31,8,23,25.81
Rengar,Briar,43,25,18,58.14
Rengar,Ambessa,39,25,14,64.1
Rengar,Camille,37,14,23,37.84
Rengar,Poppy,42,22,20,52.38
Rengar,Ryze,31,14,17,45.16
Rengar,Taric,20,17,3,85
Rengar,Leona,48,19,29,39.58
Rengar,Sion,50,29,21,58
Rengar,Senna,35,13,22,37.14
Rengar,Nunu,35,13,22,37.14
Rengar,TwistedFate,16,7,9,43.75
Rengar,Neeko,35,10,25,28.57
Rengar,Sivir,32,14,18,43.75
Rengar,Renekton,28,10,18,35.71
Rengar,Karthus,30,17,13,56.67
Rengar,Kayle,39,26,13,66.67
Rengar,KSante,32,19,13,59.38
Rengar,Kalista,20,6,14,30
Rengar,Sejuani,35,12,23,34.29
Rengar,Zeri,40,14,26,35
Rengar,Twitch,35,16,19,45.71
Rengar,Ahri,80,37,43,46.25
Rengar,MonkeyKing,38,11,27,28.95
Rengar,DrMundo,38,11,27,28.95
Rengar,Syndra,33,12,21,36.36
Rengar,Akshan,15,10,5,66.67
Rengar,Singed,32,25,7,78.13
Rengar,Illaoi,15,0,15,0
Rengar,Taliyah,14,2,12,14.29
Rengar,Urgot,32,15,17,46.88
Rengar,Heimerdinger,14,9,5,64.29
Rengar,Kled,18,12,6,66.67
Rengar,Graves,32,22,10,68.75
Rengar,Vex,22,3,19,13.64
Rengar,Ziggs,16,10,6,62.5
Rengar,Evelynn,21,8,13,38.1
Rengar,Nidalee,28,10,18,35.71
Rengar,Draven,25,15,10,60
Rengar,Qiyana,13,11,2,84.62
Rengar,Cassiopeia,18,5,13,27.78
Rengar,Azir,24,10,14,41.67
Rengar,Orianna,30,13,17,43.33
Rengar,Gangplank,26,10,16,38.46
Rengar,Zoe,21,12,9,57.14
Rengar,Shyvana,8,2,6,25
Rengar,Annie,16,10,6,62.5
Rengar,Kennen,11,6,5,54.55
Rengar,Anivia,30,12,18,40
Rengar,Hecarim,8,0,8,0
Rengar,Maokai,36,9,27,25
Anivia,Sion,66,34,32,51.52
Anivia,RekSai,23,15,8,65.22
Anivia,Viktor,79,50,29,63.29
Anivia,KogMaw,35,14,21,40
Anivia,Ashe,133,71,62,53.38
Anivia,Vayne,94,33,61,35.11
Anivia,Ivern,20,12,8,60
Anivia,Qiyana,20,15,5,75
Anivia,Ahri,122,75,47,61.48
Anivia,Seraphine,37,26,11,70.27
Anivia,Sett,89,46,43,51.69
Anivia,Diana,109,62,47,56.88
Anivia,Yasuo,168,81,87,48.21
Anivia,Lulu,90,38,52,42.22
Anivia,Malphite,74,31,43,41.89
Anivia,Nocturne,89,57,32,64.04
Anivia,Malzahar,56,22,34,39.29
Anivia,Samira,68,28,40,41.18
Anivia,Pyke,74,47,27,63.51
Anivia,Aatrox,62,49,13,79.03
Anivia,Leona,67,37,30,55.22
Anivia,Veigar,78,35,43,44.87
Anivia,Kaisa,131,88,43,67.18
Anivia,Elise,75,48,27,64
Anivia,Chogath,98,48,50,48.98
Anivia,LeeSin,137,68,69,49.64
Anivia,Syndra,85,40,45,47.06
Anivia,Caitlyn,174,81,93,46.55
Anivia,Blitzcrank,69,36,33,52.17
Anivia,Heimerdinger,22,17,5,77.27
Anivia,Darius,111,55,56,49.55
Anivia,Xayah,39,25,14,64.1
Anivia,Rakan,46,27,19,58.7
Anivia,DrMundo,44,30,14,68.18
Anivia,Maokai,37,22,15,59.46
Anivia,Orianna,36,20,16,55.56
Anivia,Mel,139,60,79,43.17
Anivia,Gangplank,44,34,10,77.27
Anivia,Karthus,20,12,8,60
Anivia,Varus,66,32,34,48.48
Anivia,Lux,145,67,78,46.21
Anivia,Evelynn,24,12,12,50
Anivia,Aurora,57,31,26,54.39
Anivia,Jinx,172,90,82,52.33
Anivia,Brand,31,12,19,38.71
Anivia,Mordekaiser,82,45,37,54.88
Anivia,Jax,56,30,26,53.57
Anivia,Jayce,33,13,20,39.39
Anivia,Fiora,16,11,5,68.75
Anivia,XinZhao,46,24,22,52.17
Anivia,Fizz,45,26,19,57.78
Anivia,Draven,47,31,16,65.96
Anivia,Nautilus,100,69,31,69
Anivia,Warwick,89,40,49,44.94
Anivia,Udyr,42,8,34,19.05
Anivia,Jhin,122,74,48,60.66
Anivia,Ezreal,146,75,71,51.37
Anivia,Sejuani,42,20,22,47.62
Anivia,Gwen,30,14,16,46.67
Anivia,Ornn,68,44,24,64.71
Anivia,Zac,60,36,24,60
Anivia,Nami,74,34,40,45.95
Anivia,Ryze,33,24,9,72.73
Anivia,Tristana,78,42,36,53.85
Anivia,Viego,87,52,35,59.77
Anivia,Taliyah,14,11,3,78.57
Anivia,Thresh,148,86,62,58.11
Anivia,Kassadin,22,8,14,36.36
Anivia,Gragas,68,29,39,42.65
Anivia,FiddleSticks,18,12,6,66.67
Anivia,MasterYi,80,48,32,60
Anivia,Akali,45,17,28,37.78
Anivia,Khazix,26,13,13,50
Anivia,Zed,85,42,43,49.41
Anivia,Sivir,38,17,21,44.74
Anivia,Irelia,46,27,19,58.7
Anivia,Skarner,39,13,26,33.33
Anivia,Ekko,57,33,24,57.89
Anivia,Senna,47,21,26,44.68
Anivia,Briar,31,13,18,41.94
Anivia,Ziggs,28,20,8,71.43
Anivia,Janna,34,19,15,55.88
Anivia,Yone,102,60,42,58.82
Anivia,Naafiri,23,11,12,47.83
Anivia,Riven,14,8,6,57.14
Anivia,Zeri,43,17,26,39.53
Anivia,Yuumi,78,37,41,47.44
Anivia,Urgot,32,14,18,43.75
Anivia,Graves,35,20,15,57.14
Anivia,Hwei,40,20,20,50
Anivia,Galio,96,49,47,51.04
Anivia,Shyvana,12,2,10,16.67
Anivia,Sylas,109,45,64,41.28
Anivia,Ambessa,43,22,21,51.16
Anivia,Velkoz,39,20,19,51.28
Anivia,Lucian,60,33,27,55
Anivia,Lissandra,26,21,5,80.77
Anivia,MissFortune,134,62,72,46.27
Anivia,Shaco,65,39,26,60
Anivia,Corki,19,9,10,47.37
Anivia,Vi,90,41,49,45.56
Anivia,Poppy,44,11,33,25
Anivia,Kayle,28,9,19,32.14
Anivia,Olaf,21,14,7,66.67
Anivia,Belveth,20,10,10,50
Anivia,Leblanc,26,15,11,57.69
Anivia,Shen,75,37,38,49.33
Anivia,Kayn,79,37,42,46.84
Anivia,Amumu,69,33,36,47.83
Anivia,Swain,65,28,37,43.08
Anivia,Quinn,19,10,9,52.63
Anivia,Twitch,69,35,34,50.72
Anivia,Soraka,22,9,13,40.91
Anivia,JarvanIV,49,32,17,65.31
Anivia,Lillia,34,29,5,85.29
Anivia,Nunu,41,28,13,68.29
Anivia,Zoe,35,22,13,62.86
Anivia,Zyra,55,21,34,38.18
Anivia,Renekton,38,27,11,71.05
Anivia,Katarina,33,17,16,51.52
Anivia,Alistar,60,36,24,60
Anivia,Rumble,21,15,6,71.43
Anivia,Garen,90,49,41,54.44
Anivia,Pantheon,117,69,48,58.97
Anivia,Neeko,24,14,10,58.33
Anivia,Vladimir,28,16,12,57.14
Anivia,Kindred,17,11,6,64.71
Anivia,Tryndamere,22,16,6,72.73
Anivia,Kled,8,3,5,37.5
Anivia,Annie,16,14,2,87.5
Anivia,Aphelios,34,19,15,55.88
Anivia,TahmKench,62,30,32,48.39
Anivia,Azir,20,15,5,75
Anivia,Gnar,44,27,17,61.36
Anivia,Cassiopeia,33,21,12,63.64
Anivia,Teemo,57,28,29,49.12
Anivia,MonkeyKing,48,27,21,56.25
Anivia,Nasus,25,13,12,52
Anivia,Karma,76,34,42,44.74
Anivia,Xerath,78,48,30,61.54
Anivia,Rell,38,29,9,76.32
Anivia,Morgana,61,28,33,45.9
Anivia,Yorick,60,33,27,55
Anivia,Vex,27,12,15,44.44
Anivia,KSante,42,21,21,50
Anivia,Smolder,43,20,23,46.51
Anivia,AurelionSol,34,24,10,70.59
Anivia,Rammus,25,11,14,44
Anivia,Volibear,51,37,14,72.55
Anivia,Nidalee,24,8,16,33.33
Anivia,Renata,15,10,5,66.67
Anivia,Hecarim,28,18,10,64.29
Anivia,Illaoi,37,22,15,59.46
Anivia,Trundle,27,7,20,25.93
Anivia,Zilean,17,8,9,47.06
Anivia,Taric,8,8,0,100
Anivia,Braum,38,21,17,55.26
Anivia,Bard,24,10,14,41.67
Anivia,TwistedFate,21,10,11,47.62
Anivia,Camille,42,25,17,59.52
Anivia,Nilah,20,9,11,45
Anivia,Sona,14,14,0,100
Anivia,Akshan,13,11,2,84.62
Anivia,Milio,38,16,22,42.11
Anivia,Kalista,15,15,0,100
Anivia,Kennen,13,9,4,69.23
Anivia,Singed,34,21,13,61.76
Anivia,Talon,22,17,5,77.27
Anivia,Rengar,30,18,12,60
RekSai,Teemo,38,13,25,34.21
RekSai,Viego,47,22,25,46.81
RekSai,Anivia,23,8,15,34.78
RekSai,MissFortune,65,38,27,58.46
RekSai,TahmKench,21,7,14,33.33
RekSai,Illaoi,9,0,9,0
RekSai,Twitch,39,11,28,28.21
RekSai,Ahri,36,11,25,30.56
RekSai,Kaisa,29,20,9,68.97
RekSai,Ashe,71,28,43,39.44
RekSai,MasterYi,33,14,19,42.42
RekSai,Warwick,38,9,29,23.68
RekSai,Kassadin,8,3,5,37.5
RekSai,Pyke,34,19,15,55.88
RekSai,Sett,31,5,26,16.13
RekSai,Nautilus,17,9,8,52.94
RekSai,Shen,24,14,10,58.33
RekSai,Mel,69,27,42,39.13
RekSai,Galio,42,21,21,50
RekSai,Volibear,44,21,23,47.73
RekSai,Amumu,33,22,11,66.67
RekSai,Katarina,17,9,8,52.94
RekSai,Vayne,23,4,19,17.39
RekSai,Poppy,23,6,17,26.09
RekSai,Yorick,21,5,16,23.81
RekSai,Karma,64,31,33,48.44
RekSai,Xayah,34,19,15,55.88
RekSai,Rakan,23,8,15,34.78
RekSai,Chogath,16,9,7,56.25
RekSai,Hwei,22,13,9,59.09
RekSai,Caitlyn,89,37,52,41.57
RekSai,Mordekaiser,39,24,15,61.54
RekSai,Yone,52,34,18,65.38
RekSai,Maokai,15,9,6,60
RekSai,Ziggs,13,4,9,30.77
RekSai,Renekton,36,22,14,61.11
RekSai,Kayn,40,18,22,45
RekSai,Samira,13,7,6,53.85
RekSai,Leona,31,15,16,48.39
RekSai,Garen,33,17,16,51.52
RekSai,Briar,17,7,10,41.18
RekSai,Naafiri,11,6,5,54.55
RekSai,Thresh,41,21,20,51.22
RekSai,LeeSin,50,29,21,58
RekSai,Zed,36,8,28,22.22
RekSai,Zeri,14,5,9,35.71
RekSai,Yuumi,25,14,11,56
RekSai,Gragas,19,8,11,42.11
RekSai,Yasuo,60,33,27,55
RekSai,Jhin,49,26,23,53.06
RekSai,Lulu,39,14,25,35.9
RekSai,Malphite,33,12,21,36.36
RekSai,MonkeyKing,23,6,17,26.09
RekSai,Veigar,34,11,23,32.35
RekSai,Pantheon,69,32,37,46.38
RekSai,Vladimir,19,8,11,42.11
RekSai,Tristana,28,17,11,60.71
RekSai,Viktor,19,7,12,36.84
RekSai,Ekko,25,6,19,24
RekSai,Nasus,17,9,8,52.94
RekSai,Ezreal,93,63,30,67.74
RekSai,Nami,38,16,22,42.11
RekSai,Vi,32,13,19,40.63
RekSai,AurelionSol,16,4,12,25
RekSai,Milio,27,17,10,62.96
RekSai,Zac,14,12,2,85.71
RekSai,Sion,34,14,20,41.18
RekSai,Shaco,28,12,16,42.86
RekSai,Xerath,26,11,15,42.31
RekSai,Nocturne,43,22,21,51.16
RekSai,Jinx,52,27,25,51.92
RekSai,Lux,41,21,20,51.22
RekSai,Gangplank,14,9,5,64.29
RekSai,Quinn,10,8,2,80
RekSai,Akali,23,15,8,65.22
RekSai,Fiora,13,2,11,15.38
RekSai,Azir,16,11,5,68.75
RekSai,Zoe,8,0,8,0
RekSai,Lucian,16,7,9,43.75
RekSai,Nunu,14,9,5,64.29
RekSai,Neeko,12,7,5,58.33
RekSai,Darius,49,26,23,53.06
RekSai,Syndra,26,11,15,42.31
RekSai,DrMundo,14,11,3,78.57
RekSai,Kalista,6,3,3,50
RekSai,Senna,18,3,15,16.67
RekSai,Brand,25,9,16,36
RekSai,Trundle,5,2,3,40
RekSai,Kennen,3,3,0,100
RekSai,KSante,17,11,6,64.71
RekSai,Morgana,39,19,20,48.72
RekSai,Tryndamere,19,12,7,63.16
RekSai,Rell,8,8,0,100
RekSai,Annie,17,12,5,70.59
RekSai,Vex,9,3,6,33.33
RekSai,Leblanc,11,8,3,72.73
RekSai,Khazix,17,5,12,29.41
RekSai,Varus,15,4,11,26.67
RekSai,Evelynn,12,12,0,100
RekSai,Orianna,25,14,11,56
RekSai,Camille,9,7,2,77.78
RekSai,XinZhao,22,8,14,36.36
RekSai,Kayle,17,3,14,17.65
RekSai,Gnar,21,10,11,47.62
RekSai,Renata,7,5,2,71.43
RekSai,Graves,9,2,7,22.22
RekSai,Karthus,5,0,5,0
RekSai,Ivern,4,0,4,0
RekSai,Diana,26,15,11,57.69
RekSai,Akshan,9,6,3,66.67
RekSai,Swain,17,14,3,82.35
RekSai,Malzahar,39,26,13,66.67
RekSai,Sylas,29,19,10,65.52
RekSai,Seraphine,10,5,5,50
RekSai,Zyra,5,2,3,40
RekSai,Elise,18,15,3,83.33
RekSai,Urgot,15,5,10,33.33
RekSai,JarvanIV,14,8,6,57.14
RekSai,Riven,8,8,0,100
RekSai,Rumble,11,8,3,72.73
RekSai,Smolder,14,9,5,64.29
RekSai,Blitzcrank,30,16,14,53.33
RekSai,Shyvana,2,2,0,100
RekSai,Aurora,24,10,14,41.67
RekSai,Irelia,12,6,6,50
RekSai,Braum,28,15,13,53.57
RekSai,Sejuani,14,4,10,28.57
RekSai,Belveth,5,2,3,40
RekSai,Soraka,17,10,7,58.82
RekSai,Alistar,5,0,5,0
RekSai,Talon,14,8,6,57.14
RekSai,Velkoz,15,9,6,60
RekSai,Lissandra,21,13,8,61.9
RekSai,Rammus,12,2,10,16.67
RekSai,Nilah,16,11,5,68.75
RekSai,Udyr,13,7,6,53.85
RekSai,Taric,7,2,5,28.57
RekSai,Ambessa,18,13,5,72.22
RekSai,Hecarim,8,5,3,62.5
RekSai,Cassiopeia,5,5,0,100
RekSai,Lillia,8,3,5,37.5
RekSai,Aphelios,31,11,20,35.48
RekSai,Fizz,10,3,7,30
RekSai,Heimerdinger,5,3,2,60
RekSai,Ryze,11,5,6,45.45
RekSai,Ornn,17,9,8,52.94
RekSai,Kled,5,3,2,60
RekSai,Corki,17,9,8,52.94
RekSai,Olaf,5,0,5,0
RekSai,Zilean,11,8,3,72.73
RekSai,Gwen,18,9,9,50
RekSai,Aatrox,14,6,8,42.86
RekSai,Sivir,12,0,12,0
RekSai,Bard,15,9,6,60
RekSai,Jax,15,9,6,60
RekSai,Qiyana,6,3,3,50
RekSai,Janna,9,0,9,0
RekSai,Taliyah,3,0,3,0
RekSai,KogMaw,6,0,6,0
RekSai,Draven,9,3,6,33.33
RekSai,Kindred,5,3,2,60
RekSai,FiddleSticks,12,0,12,0
RekSai,Singed,3,3,0,100
RekSai,TwistedFate,5,0,5,0
RekSai,Nidalee,5,0,5,0
RekSai,Skarner,3,3,0,100
RekSai,Jayce,2,0,2,0
KogMaw,Teemo,72,28,44,38.89
KogMaw,Viego,62,35,27,56.45
KogMaw,Anivia,35,21,14,60
KogMaw,MissFortune,112,48,64,42.86
KogMaw,TahmKench,73,34,39,46.58
KogMaw,Nasus,51,26,25,50.98
KogMaw,Amumu,86,44,42,51.16
KogMaw,Sylas,65,27,38,41.54
KogMaw,Twitch,58,32,26,55.17
KogMaw,Lulu,82,37,45,45.12
KogMaw,Jayce,26,13,13,50
KogMaw,Sejuani,55,38,17,69.09
KogMaw,Fizz,30,14,16,46.67
KogMaw,Caitlyn,168,64,104,38.1
KogMaw,Alistar,52,19,33,36.54
KogMaw,KSante,37,22,15,59.46
KogMaw,Zac,39,16,23,41.03
KogMaw,Yasuo,104,62,42,59.62
KogMaw,Annie,23,12,11,52.17
KogMaw,Malphite,76,41,35,53.95
KogMaw,Gangplank,39,31,8,79.49
KogMaw,LeeSin,81,40,41,49.38
KogMaw,Jhin,114,53,61,46.49
KogMaw,Thresh,105,51,54,48.57
KogMaw,Vi,79,28,51,35.44
KogMaw,Riven,19,8,11,42.11
KogMaw,Yone,110,41,69,37.27
KogMaw,Smolder,42,28,14,66.67
KogMaw,Aatrox,69,25,44,36.23
KogMaw,Pantheon,100,48,52,48
KogMaw,AurelionSol,40,23,17,57.5
KogMaw,Lux,139,76,63,54.68
KogMaw,Shaco,58,27,31,46.55
KogMaw,Kennen,38,20,18,52.63
KogMaw,Vladimir,39,15,24,38.46
KogMaw,Corki,38,22,16,57.89
KogMaw,Bard,15,6,9,40
KogMaw,Fiora,29,15,14,51.72
KogMaw,Rengar,14,11,3,78.57
KogMaw,Syndra,57,27,30,47.37
KogMaw,Nilah,24,12,12,50
KogMaw,Mel,135,73,62,54.07
KogMaw,Garen,85,31,54,36.47
KogMaw,Leblanc,60,28,32,46.67
KogMaw,Blitzcrank,70,41,29,58.57
KogMaw,Gwen,26,16,10,61.54
KogMaw,Diana,90,53,37,58.89
KogMaw,Zed,69,34,35,49.28
KogMaw,Xayah,28,19,9,67.86
KogMaw,Nautilus,69,34,35,49.28
KogMaw,Urgot,44,22,22,50
KogMaw,Kayn,71,32,39,45.07
KogMaw,Zyra,56,32,24,57.14
KogMaw,Ornn,49,18,31,36.73
KogMaw,Graves,55,17,38,30.91
KogMaw,Morgana,65,27,38,41.54
KogMaw,Hwei,30,20,10,66.67
KogMaw,Qiyana,11,5,6,45.45
KogMaw,Lucian,43,29,14,67.44
KogMaw,Shen,38,13,25,34.21
KogMaw,Aurora,49,30,19,61.22
KogMaw,Draven,38,13,25,34.21
KogMaw,Senna,43,19,24,44.19
KogMaw,Lillia,37,22,15,59.46
KogMaw,Jinx,186,91,95,48.92
KogMaw,Milio,48,28,20,58.33
KogMaw,MasterYi,49,36,13,73.47
KogMaw,Malzahar,86,47,39,54.65
KogMaw,Mordekaiser,86,45,41,52.33
KogMaw,Katarina,49,29,20,59.18
KogMaw,Vayne,65,29,36,44.62
KogMaw,Kayle,29,16,13,55.17
KogMaw,Skarner,27,10,17,37.04
KogMaw,Ambessa,50,21,29,42
KogMaw,Talon,22,11,11,50
KogMaw,Ashe,97,35,62,36.08
KogMaw,Quinn,22,8,14,36.36
KogMaw,Rammus,41,18,23,43.9
KogMaw,Rakan,18,7,11,38.89
KogMaw,Yorick,86,27,59,31.4
KogMaw,Jax,82,40,42,48.78
KogMaw,Xerath,57,23,34,40.35
KogMaw,Briar,29,13,16,44.83
KogMaw,Ekko,51,31,20,60.78
KogMaw,Ryze,20,17,3,85
KogMaw,Seraphine,47,29,18,61.7
KogMaw,DrMundo,29,15,14,51.72
KogMaw,Orianna,31,9,22,29.03
KogMaw,Gnar,30,16,14,53.33
KogMaw,Viktor,51,21,30,41.18
KogMaw,Varus,68,37,31,54.41
KogMaw,Nunu,42,28,14,66.67
KogMaw,Shyvana,13,3,10,23.08
KogMaw,Poppy,54,40,14,74.07
KogMaw,Nocturne,56,23,33,41.07
KogMaw,Pyke,57,24,33,42.11
KogMaw,Karma,60,29,31,48.33
KogMaw,Tristana,40,32,8,80
KogMaw,Leona,70,32,38,45.71
KogMaw,Sivir,25,19,6,76
KogMaw,Gragas,35,13,22,37.14
KogMaw,Taliyah,16,10,6,62.5
KogMaw,Akali,47,21,26,44.68
KogMaw,Ezreal,168,87,81,51.79
KogMaw,Ahri,84,47,37,55.95
KogMaw,Volibear,71,31,40,43.66
KogMaw,Galio,85,45,40,52.94
KogMaw,Nami,93,54,39,58.06
KogMaw,Tryndamere,30,24,6,80
KogMaw,MonkeyKing,38,19,19,50
KogMaw,Sett,88,47,41,53.41
KogMaw,Braum,69,49,20,71.01
KogMaw,Irelia,32,21,11,65.63
KogMaw,TwistedFate,25,8,17,32
KogMaw,Ziggs,21,14,7,66.67
KogMaw,Janna,11,5,6,45.45
KogMaw,Azir,20,9,11,45
KogMaw,Chogath,74,46,28,62.16
KogMaw,Kaisa,102,73,29,71.57
KogMaw,Samira,45,21,24,46.67
KogMaw,Elise,55,22,33,40
KogMaw,Vex,52,21,31,40.38
KogMaw,Soraka,39,19,20,48.72
KogMaw,Naafiri,6,6,0,100
KogMaw,FiddleSticks,29,16,13,55.17
KogMaw,Zilean,19,13,6,68.42
KogMaw,Kled,11,3,8,27.27
KogMaw,Warwick,96,49,47,51.04
KogMaw,Swain,63,32,31,50.79
KogMaw,Sion,53,29,24,54.72
KogMaw,Akshan,13,8,5,61.54
KogMaw,Velkoz,28,11,17,39.29
KogMaw,Khazix,22,11,11,50
KogMaw,XinZhao,21,8,13,38.1
KogMaw,Illaoi,34,24,10,70.59
KogMaw,Nidalee,7,5,2,71.43
KogMaw,Heimerdinger,18,10,8,55.56
KogMaw,Camille,15,12,3,80
KogMaw,Rell,43,25,18,58.14
KogMaw,Veigar,55,29,26,52.73
KogMaw,Darius,78,41,37,52.56
KogMaw,Zoe,37,14,23,37.84
KogMaw,Lissandra,28,7,21,25
KogMaw,Zeri,39,17,22,43.59
KogMaw,Brand,32,21,11,65.63
KogMaw,Cassiopeia,23,14,9,60.87
KogMaw,Maokai,33,25,8,75.76
KogMaw,Kindred,9,9,0,100
KogMaw,Trundle,24,12,12,50
KogMaw,JarvanIV,55,32,23,58.18
KogMaw,Taric,6,2,4,33.33
KogMaw,Renata,8,5,3,62.5
KogMaw,Aphelios,28,17,11,60.71
KogMaw,Udyr,10,10,0,100
KogMaw,Neeko,15,7,8,46.67
KogMaw,Renekton,25,18,7,72
KogMaw,Kalista,14,11,3,78.57
KogMaw,Belveth,9,2,7,22.22
KogMaw,Evelynn,14,4,10,28.57
KogMaw,Ivern,11,9,2,81.82
KogMaw,Yuumi,26,10,16,38.46
KogMaw,Rumble,12,5,7,41.67
KogMaw,Karthus,10,10,0,100
KogMaw,Hecarim,14,7,7,50
KogMaw,Olaf,3,3,0,100
KogMaw,Kassadin,9,6,3,66.67
KogMaw,Singed,12,9,3,75
KogMaw,RekSai,6,6,0,100
KogMaw,Sona,3,3,0,100
Aatrox,Jayce,141,83,58,58.87
Aatrox,Hecarim,79,38,41,48.1
Aatrox,Milio,130,62,68,47.69
Aatrox,Caitlyn,469,217,252,46.27
Aatrox,Zoe,80,41,39,51.25
Aatrox,Sett,269,116,153,43.12
Aatrox,LeeSin,488,213,275,43.65
Aatrox,Hwei,148,78,70,52.7
Aatrox,Jhin,377,182,195,48.28
Aatrox,Zilean,57,26,31,45.61
Aatrox,Briar,114,49,65,42.98
Aatrox,Nocturne,258,114,144,44.19
Aatrox,Lissandra,70,19,51,27.14
Aatrox,Shen,118,44,74,37.29
Aatrox,Malphite,196,87,109,44.39
Aatrox,Graves,162,78,84,48.15
Aatrox,Vladimir,117,52,65,44.44
Aatrox,Ezreal,524,242,282,46.18
Aatrox,Camille,112,62,50,55.36
Aatrox,Kayle,82,31,51,37.8
Aatrox,Viego,294,158,136,53.74
Aatrox,Yasuo,396,200,196,50.51
Aatrox,Braum,128,31,97,24.22
Aatrox,Kalista,79,40,39,50.63
Aatrox,Amumu,191,75,116,39.27
Aatrox,Ashe,436,250,186,57.34
Aatrox,Irelia,123,77,46,62.6
Aatrox,Darius,411,203,208,49.39
Aatrox,Vi,230,85,145,36.96
Aatrox,Aurora,170,88,82,51.76
Aatrox,Vayne,227,111,116,48.9
Aatrox,Yuumi,200,96,104,48
Aatrox,Kennen,62,32,30,51.61
Aatrox,Garen,307,132,175,43
Aatrox,Talon,121,72,49,59.5
Aatrox,Aphelios,135,66,69,48.89
Aatrox,Pyke,188,97,91,51.6
Aatrox,Gwen,114,59,55,51.75
Aatrox,MasterYi,169,87,82,51.48
Aatrox,Akshan,44,30,14,68.18
Aatrox,Zeri,114,53,61,46.49
Aatrox,Rakan,89,47,42,52.81
Aatrox,Mordekaiser,264,119,145,45.08
Aatrox,Kayn,228,97,131,42.54
Aatrox,Ziggs,82,35,47,42.68
Aatrox,Nautilus,251,132,119,52.59
Aatrox,Yone,402,181,221,45.02
Aatrox,Warwick,274,152,122,55.47
Aatrox,Gnar,82,48,34,58.54
Aatrox,JarvanIV,129,69,60,53.49
Aatrox,Rumble,62,33,29,53.23
Aatrox,Galio,246,135,111,54.88
Aatrox,Lulu,279,138,141,49.46
Aatrox,Nasus,101,36,65,35.64
Aatrox,Lux,457,243,214,53.17
Aatrox,Xayah,142,74,68,52.11
Aatrox,Maokai,126,64,62,50.79
Aatrox,TahmKench,178,107,71,60.11
Aatrox,Tristana,183,91,92,49.73
Aatrox,Nunu,119,74,45,62.18
Aatrox,Ornn,118,57,61,48.31
Aatrox,Ahri,266,139,127,52.26
Aatrox,Anivia,62,13,49,20.97
Aatrox,MissFortune,354,188,166,53.11
Aatrox,Teemo,215,111,104,51.63
Aatrox,DrMundo,89,48,41,53.93
Aatrox,KogMaw,69,44,25,63.77
Aatrox,Yorick,138,60,78,43.48
Aatrox,Nidalee,99,65,34,65.66
Aatrox,Twitch,108,58,50,53.7
Aatrox,Rell,128,66,62,51.56
Aatrox,KSante,137,70,67,51.09
Aatrox,Seraphine,112,32,80,28.57
Aatrox,Pantheon,303,170,133,56.11
Aatrox,Gragas,139,71,68,51.08
Aatrox,Rengar,65,37,28,56.92
Aatrox,Malzahar,211,105,106,49.76
Aatrox,Senna,106,58,48,54.72
Aatrox,Ryze,82,51,31,62.2
Aatrox,Jinx,425,177,248,41.65
Aatrox,Heimerdinger,62,29,33,46.77
Aatrox,Fizz,49,32,17,65.31
Aatrox,Blitzcrank,177,72,105,40.68
Aatrox,Renekton,126,56,70,44.44
Aatrox,Skarner,106,58,48,54.72
Aatrox,Smolder,141,78,63,55.32
Aatrox,Riven,60,32,28,53.33
Aatrox,Azir,121,56,65,46.28
Aatrox,Sylas,364,158,206,43.41
Aatrox,Zed,206,92,114,44.66
Aatrox,Lillia,90,51,39,56.67
Aatrox,Sion,160,85,75,53.13
Aatrox,Jax,193,92,101,47.67
Aatrox,Nami,170,78,92,45.88
Aatrox,Chogath,228,97,131,42.54
Aatrox,Renata,47,26,21,55.32
Aatrox,Diana,287,146,141,50.87
Aatrox,Illaoi,92,51,41,55.43
Aatrox,Evelynn,46,19,27,41.3
Aatrox,Mel,360,170,190,47.22
Aatrox,Kaisa,325,170,155,52.31
Aatrox,Trundle,87,42,45,48.28
Aatrox,Rammus,76,33,43,43.42
Aatrox,AurelionSol,78,34,44,43.59
Aatrox,Neeko,129,63,66,48.84
Aatrox,Sejuani,113,37,76,32.74
Aatrox,Kindred,104,72,32,69.23
Aatrox,Karma,230,100,130,43.48
Aatrox,Singed,74,29,45,39.19
Aatrox,Swain,202,92,110,45.54
Aatrox,Thresh,437,195,242,44.62
Aatrox,Urgot,118,58,60,49.15
Aatrox,Akali,198,82,116,41.41
Aatrox,Kled,46,22,24,47.83
Aatrox,Kassadin,39,21,18,53.85
Aatrox,XinZhao,100,50,50,50
Aatrox,Katarina,121,63,58,52.07
Aatrox,Lucian,192,115,77,59.9
Aatrox,Cassiopeia,63,44,19,69.84
Aatrox,Olaf,38,11,27,28.95
Aatrox,Morgana,164,76,88,46.34
Aatrox,Poppy,167,100,67,59.88
Aatrox,Ekko,163,80,83,49.08
Aatrox,Ambessa,175,69,106,39.43
Aatrox,Zac,118,63,55,53.39
Aatrox,Corki,68,31,37,45.59
Aatrox,Syndra,136,71,65,52.21
Aatrox,Brand,104,48,56,46.15
Aatrox,Gangplank,126,57,69,45.24
Aatrox,Alistar,116,63,53,54.31
Aatrox,Nilah,50,14,36,28
Aatrox,Samira,162,83,79,51.23
Aatrox,Leona,219,95,124,43.38
Aatrox,Draven,100,44,56,44
Aatrox,Tryndamere,57,25,32,43.86
Aatrox,Fiora,72,43,29,59.72
Aatrox,Viktor,171,76,95,44.44
Aatrox,Elise,142,67,75,47.18
Aatrox,Xerath,185,110,75,59.46
Aatrox,Bard,77,37,40,48.05
Aatrox,Leblanc,104,55,49,52.88
Aatrox,Varus,214,106,108,49.53
Aatrox,Volibear,231,131,100,56.71
Aatrox,MonkeyKing,142,71,71,50
Aatrox,Velkoz,101,51,50,50.5
Aatrox,Shaco,122,63,59,51.64
Aatrox,Sona,45,28,17,62.22
Aatrox,Qiyana,55,36,19,65.45
Aatrox,Veigar,187,93,94,49.73
Aatrox,FiddleSticks,79,30,49,37.97
Aatrox,Orianna,108,41,67,37.96
Aatrox,Soraka,90,40,50,44.44
Aatrox,Sivir,110,44,66,40
Aatrox,Naafiri,70,16,54,22.86
Aatrox,Taliyah,57,29,28,50.88
Aatrox,Karthus,57,41,16,71.93
Aatrox,Khazix,70,32,38,45.71
Aatrox,Annie,62,36,26,58.06
Aatrox,Zyra,135,55,80,40.74
Aatrox,Udyr,90,47,43,52.22
Aatrox,TwistedFate,76,32,44,42.11
Aatrox,Quinn,69,39,30,56.52
Aatrox,Janna,62,30,32,48.39
Aatrox,Shyvana,35,16,19,45.71
Aatrox,Vex,85,44,41,51.76
Aatrox,Taric,31,17,14,54.84
Aatrox,Belveth,28,22,6,78.57
Aatrox,Ivern,24,13,11,54.17
Aatrox,RekSai,14,8,6,57.14
MasterYi,Jayce,104,60,44,57.69
MasterYi,Hecarim,56,23,33,41.07
MasterYi,Milio,126,47,79,37.3
MasterYi,Caitlyn,539,261,278,48.42
MasterYi,Zoe,59,23,36,38.98
MasterYi,Gangplank,80,37,43,46.25
MasterYi,FiddleSticks,116,47,69,40.52
MasterYi,Veigar,164,77,87,46.95
MasterYi,Ezreal,472,244,228,51.69
MasterYi,Lux,431,217,214,50.35
MasterYi,Nasus,142,79,63,55.63
MasterYi,Shaco,164,94,70,57.32
MasterYi,Xerath,190,104,86,54.74
MasterYi,Lulu,235,98,137,41.7
MasterYi,Yone,349,182,167,52.15
MasterYi,Diana,227,115,112,50.66
MasterYi,Gragas,163,79,84,48.47
MasterYi,Yasuo,414,199,215,48.07
MasterYi,Nami,164,78,86,47.56
MasterYi,Fiora,47,19,28,40.43
MasterYi,Singed,67,35,32,52.24
MasterYi,Ornn,128,67,61,52.34
MasterYi,Kindred,71,52,19,73.24
MasterYi,Talon,89,50,39,56.18
MasterYi,Samira,157,76,81,48.41
MasterYi,Ashe,362,191,171,52.76
MasterYi,Jax,238,116,122,48.74
MasterYi,Graves,125,55,70,44
MasterYi,Kassadin,30,17,13,56.67
MasterYi,Tristana,174,76,98,43.68
MasterYi,Malphite,245,137,108,55.92
MasterYi,Vladimir,137,51,86,37.23
MasterYi,Camille,65,36,29,55.38
MasterYi,RekSai,33,19,14,57.58
MasterYi,Nunu,131,71,60,54.2
MasterYi,Hwei,86,41,45,47.67
MasterYi,Morgana,189,100,89,52.91
MasterYi,Nautilus,242,98,144,40.5
MasterYi,Sejuani,121,40,81,33.06
MasterYi,Fizz,79,38,41,48.1
MasterYi,Alistar,85,36,49,42.35
MasterYi,Warwick,296,124,172,41.89
MasterYi,LeeSin,334,189,145,56.59
MasterYi,Viktor,185,76,109,41.08
MasterYi,Lucian,149,82,67,55.03
MasterYi,Kennen,62,35,27,56.45
MasterYi,XinZhao,119,49,70,41.18
MasterYi,Brand,93,67,26,72.04
MasterYi,Elise,141,64,77,45.39
MasterYi,Quinn,56,30,26,53.57
MasterYi,Kaisa,255,138,117,54.12
MasterYi,Nocturne,217,128,89,58.99
MasterYi,Malzahar,196,88,108,44.9
MasterYi,Pyke,176,83,93,47.16
MasterYi,Gnar,83,44,39,53.01
MasterYi,Amumu,239,103,136,43.1
MasterYi,Aurora,105,47,58,44.76
MasterYi,Thresh,317,192,125,60.57
MasterYi,Kayn,277,157,120,56.68
MasterYi,Irelia,133,60,73,45.11
MasterYi,Rell,103,46,57,44.66
MasterYi,Leona,221,98,123,44.34
MasterYi,Rammus,226,101,125,44.69
MasterYi,Twitch,135,71,64,52.59
MasterYi,Aatrox,169,82,87,48.52
MasterYi,Zac,96,46,50,47.92
MasterYi,Zed,200,103,97,51.5
MasterYi,Varus,196,88,108,44.9
MasterYi,Soraka,91,44,47,48.35
MasterYi,Akali,174,84,90,48.28
MasterYi,Jinx,454,214,240,47.14
MasterYi,Yorick,170,56,114,32.94
MasterYi,Annie,50,15,35,30
MasterYi,Jhin,342,173,169,50.58
MasterYi,Renekton,88,48,40,54.55
MasterYi,TwistedFate,87,55,32,63.22
MasterYi,Mel,388,216,172,55.67
MasterYi,Seraphine,114,65,49,57.02
MasterYi,Darius,387,206,181,53.23
MasterYi,Pantheon,340,183,157,53.82
MasterYi,Mordekaiser,219,116,103,52.97
MasterYi,Volibear,224,97,127,43.3
MasterYi,Azir,84,46,38,54.76
MasterYi,Tryndamere,77,31,46,40.26
MasterYi,Vayne,281,88,193,31.32
MasterYi,Senna,118,73,45,61.86
MasterYi,Syndra,119,39,80,32.77
MasterYi,Xayah,89,35,54,39.33
MasterYi,Rakan,114,51,63,44.74
MasterYi,Vi,209,82,127,39.23
MasterYi,Renata,58,34,24,58.62
MasterYi,Sylas,280,141,139,50.36
MasterYi,Vex,87,27,60,31.03
MasterYi,Poppy,164,86,78,52.44
MasterYi,Riven,70,30,40,42.86
MasterYi,TahmKench,209,111,98,53.11
MasterYi,Sett,253,111,142,43.87
MasterYi,MissFortune,417,204,213,48.92
MasterYi,Gwen,114,55,59,48.25
MasterYi,Smolder,149,77,72,51.68
MasterYi,Katarina,137,50,87,36.5
MasterYi,Ekko,175,91,84,52
MasterYi,Teemo,196,98,98,50
MasterYi,Maokai,91,46,45,50.55
MasterYi,Chogath,262,109,153,41.6
MasterYi,Taliyah,57,33,24,57.89
MasterYi,DrMundo,117,40,77,34.19
MasterYi,Qiyana,58,36,22,62.07
MasterYi,Zeri,79,44,35,55.7
MasterYi,Ahri,225,125,100,55.56
MasterYi,Garen,341,160,181,46.92
MasterYi,Galio,176,71,105,40.34
MasterYi,Lillia,86,35,51,40.7
MasterYi,KogMaw,49,13,36,26.53
MasterYi,Karthus,83,42,41,50.6
MasterYi,Taric,52,21,31,40.38
MasterYi,Shen,156,55,101,35.26
MasterYi,Kayle,99,53,46,53.54
MasterYi,Karma,206,98,108,47.57
MasterYi,Braum,144,63,81,43.75
MasterYi,MonkeyKing,144,63,81,43.75
MasterYi,Zyra,130,61,69,46.92
MasterYi,Nilah,49,15,34,30.61
MasterYi,Briar,107,41,66,38.32
MasterYi,Blitzcrank,146,71,75,48.63
MasterYi,Zilean,61,19,42,31.15
MasterYi,Ivern,49,25,24,51.02
MasterYi,Ambessa,134,64,70,47.76
MasterYi,Rengar,53,24,29,45.28
MasterYi,Ryze,53,16,37,30.19
MasterYi,Janna,68,29,39,42.65
MasterYi,Cassiopeia,26,13,13,50
MasterYi,Sivir,118,65,53,55.08
MasterYi,Kalista,74,46,28,62.16
MasterYi,Bard,43,26,17,60.47
MasterYi,Evelynn,60,29,31,48.33
MasterYi,KSante,133,73,60,54.89
MasterYi,Skarner,80,32,48,40
MasterYi,Naafiri,62,40,22,64.52
MasterYi,Trundle,111,56,55,50.45
MasterYi,Viego,202,95,107,47.03
MasterYi,Aphelios,109,61,48,55.96
MasterYi,JarvanIV,173,83,90,47.98
MasterYi,AurelionSol,77,34,43,44.16
MasterYi,Corki,61,34,27,55.74
MasterYi,Orianna,106,38,68,35.85
MasterYi,Khazix,101,50,51,49.5
MasterYi,Anivia,80,32,48,40
MasterYi,Illaoi,119,72,47,60.5
MasterYi,Yuumi,173,82,91,47.4
MasterYi,Leblanc,115,70,45,60.87
MasterYi,Nidalee,42,24,18,57.14
MasterYi,Swain,198,115,83,58.08
MasterYi,Heimerdinger,77,42,35,54.55
MasterYi,Draven,84,44,40,52.38
MasterYi,Neeko,122,72,50,59.02
MasterYi,Sion,129,69,60,53.49
MasterYi,Velkoz,104,52,52,50
MasterYi,Urgot,87,44,43,50.57
MasterYi,Akshan,51,26,25,50.98
MasterYi,Sona,46,17,29,36.96
MasterYi,Olaf,36,25,11,69.44
MasterYi,Shyvana,68,29,39,42.65
MasterYi,Rumble,66,38,28,57.58
MasterYi,Lissandra,75,34,41,45.33
MasterYi,Belveth,32,12,20,37.5
MasterYi,Ziggs,52,24,28,46.15
MasterYi,Udyr,49,24,25,48.98
MasterYi,Kled,31,18,13,58.06
Jayce,Aatrox,141,58,83,41.13
Jayce,MasterYi,104,44,60,42.31
Jayce,TwistedFate,43,28,15,65.12
Jayce,Varus,102,51,51,50
Jayce,Lux,209,113,96,54.07
Jayce,Twitch,52,23,29,44.23
Jayce,Lillia,42,22,20,52.38
Jayce,Katarina,62,32,30,51.61
Jayce,Vayne,127,59,68,46.46
Jayce,Blitzcrank,120,56,64,46.67
Jayce,Tryndamere,33,19,14,57.58
Jayce,Akali,129,84,45,65.12
Jayce,KogMaw,26,13,13,50
Jayce,Swain,93,46,47,49.46
Jayce,Yorick,87,43,44,49.43
Jayce,Nunu,34,15,19,44.12
Jayce,Bard,35,17,18,48.57
Jayce,Gnar,69,35,34,50.72
Jayce,Kindred,36,21,15,58.33
Jayce,Syndra,62,32,30,51.61
Jayce,Jinx,277,138,139,49.82
Jayce,Braum,87,54,33,62.07
Jayce,Yone,155,84,71,54.19
Jayce,Sejuani,72,23,49,31.94
Jayce,Hwei,51,14,37,27.45
Jayce,Chogath,124,43,81,34.68
Jayce,Sett,112,54,58,48.21
Jayce,Graves,99,53,46,53.54
Jayce,Mel,189,94,95,49.74
Jayce,TahmKench,76,36,40,47.37
Jayce,Zed,116,55,61,47.41
Jayce,Thresh,196,88,108,44.9
Jayce,Zac,49,30,19,61.22
Jayce,Kayn,93,57,36,61.29
Jayce,Caitlyn,254,127,127,50
Jayce,Janna,38,13,25,34.21
Jayce,DrMundo,43,17,26,39.53
Jayce,Yasuo,182,82,100,45.05
Jayce,Xerath,121,61,60,50.41
Jayce,Lucian,108,63,45,58.33
Jayce,Nami,75,33,42,44
Jayce,Garen,126,40,86,31.75
Jayce,Mordekaiser,86,46,40,53.49
Jayce,Ahri,143,88,55,61.54
Jayce,Kaisa,167,79,88,47.31
Jayce,Lulu,136,60,76,44.12
Jayce,Ambessa,96,45,51,46.88
Jayce,Udyr,28,8,20,28.57
Jayce,Corki,34,18,16,52.94
Jayce,Alistar,75,43,32,57.33
Jayce,Viktor,113,63,50,55.75
Jayce,Vi,163,83,80,50.92
Jayce,Poppy,54,24,30,44.44
Jayce,Veigar,104,66,38,63.46
Jayce,Ziggs,24,15,9,62.5
Jayce,Morgana,97,43,54,44.33
Jayce,Viego,145,57,88,39.31
Jayce,Irelia,121,61,60,50.41
Jayce,Kennen,43,19,24,44.19
Jayce,Amumu,104,41,63,39.42
Jayce,Ezreal,326,179,147,54.91
Jayce,Warwick,72,30,42,41.67
Jayce,Tristana,69,24,45,34.78
Jayce,Milio,67,26,41,38.81
Jayce,Ashe,205,97,108,47.32
Jayce,Orianna,51,29,22,56.86
Jayce,Ivern,24,14,10,58.33
Jayce,Karma,150,78,72,52
Jayce,Shen,53,30,23,56.6
Jayce,Hecarim,45,28,17,62.22
Jayce,Jax,86,42,44,48.84
Jayce,LeeSin,253,139,114,54.94
Jayce,Senna,67,38,29,56.72
Jayce,Ekko,72,25,47,34.72
Jayce,KSante,73,47,26,64.38
Jayce,Teemo,81,40,41,49.38
Jayce,Skarner,36,16,20,44.44
Jayce,Cassiopeia,33,18,15,54.55
Jayce,Brand,33,13,20,39.39
Jayce,Soraka,57,32,25,56.14
Jayce,Pantheon,178,86,92,48.31
Jayce,Belveth,32,18,14,56.25
Jayce,Anivia,33,20,13,60.61
Jayce,Briar,52,26,26,50
Jayce,Velkoz,37,15,22,40.54
Jayce,Malzahar,80,33,47,41.25
Jayce,Shaco,69,35,34,50.72
Jayce,Nilah,36,17,19,47.22
Jayce,Aurora,96,37,59,38.54
Jayce,Sona,22,9,13,40.91
Jayce,Nasus,64,34,30,53.13
Jayce,Fiora,62,39,23,62.9
Jayce,Xayah,53,26,27,49.06
Jayce,Nocturne,103,41,62,39.81
Jayce,Diana,130,66,64,50.77
Jayce,Vladimir,59,33,26,55.93
Jayce,Yuumi,77,39,38,50.65
Jayce,MissFortune,153,72,81,47.06
Jayce,Nautilus,128,69,59,53.91
Jayce,Gangplank,45,17,28,37.78
Jayce,Rengar,25,14,11,56
Jayce,Taliyah,32,19,13,59.38
Jayce,Rammus,26,15,11,57.69
Jayce,Smolder,71,42,29,59.15
Jayce,Kayle,49,27,22,55.1
Jayce,Karthus,36,19,17,52.78
Jayce,Rakan,55,29,26,52.73
Jayce,Gragas,97,34,63,35.05
Jayce,Lissandra,21,13,8,61.9
Jayce,Azir,66,33,33,50
Jayce,Draven,32,20,12,62.5
Jayce,Trundle,45,23,22,51.11
Jayce,Elise,95,45,50,47.37
Jayce,Quinn,43,20,23,46.51
Jayce,Malphite,126,53,73,42.06
Jayce,Heimerdinger,52,26,26,50
Jayce,Pyke,90,46,44,51.11
Jayce,Darius,196,85,111,43.37
Jayce,Illaoi,43,28,15,65.12
Jayce,Galio,117,38,79,32.48
Jayce,Rell,53,11,42,20.75
Jayce,XinZhao,87,27,60,31.03
Jayce,Kalista,34,17,17,50
Jayce,Rumble,60,38,22,63.33
Jayce,Shyvana,28,9,19,32.14
Jayce,Samira,70,16,54,22.86
Jayce,Riven,33,22,11,66.67
Jayce,Naafiri,22,13,9,59.09
Jayce,Leblanc,68,39,29,57.35
Jayce,Leona,71,36,35,50.7
Jayce,Ryze,24,10,14,41.67
Jayce,Sion,87,42,45,48.28
Jayce,Sylas,149,86,63,57.72
Jayce,FiddleSticks,61,36,25,59.02
Jayce,Jhin,198,117,81,59.09
Jayce,Zilean,19,2,17,10.53
Jayce,Maokai,35,27,8,77.14
Jayce,Volibear,67,43,24,64.18
Jayce,Zoe,34,4,30,11.76
Jayce,Renata,27,19,8,70.37
Jayce,Camille,60,33,27,55
Jayce,Aphelios,50,21,29,42
Jayce,MonkeyKing,63,23,40,36.51
Jayce,Kled,13,6,7,46.15
Jayce,Talon,59,29,30,49.15
Jayce,Renekton,47,24,23,51.06
Jayce,Sivir,43,11,32,25.58
Jayce,Urgot,30,15,15,50
Jayce,Zeri,50,21,29,42
Jayce,Ornn,56,24,32,42.86
Jayce,Seraphine,51,27,24,52.94
Jayce,Taric,19,10,9,52.63
Jayce,JarvanIV,92,59,33,64.13
Jayce,Fizz,41,24,17,58.54
Jayce,Vex,52,26,26,50
Jayce,Neeko,38,13,25,34.21
Jayce,Evelynn,15,7,8,46.67
Jayce,Zyra,98,46,52,46.94
Jayce,Gwen,39,21,18,53.85
Jayce,Annie,18,9,9,50
Jayce,Nidalee,37,26,11,70.27
Jayce,Akshan,20,10,10,50
Jayce,Kassadin,17,8,9,47.06
Jayce,Olaf,34,23,11,67.65
Jayce,AurelionSol,45,21,24,46.67
Jayce,Singed,22,8,14,36.36
Jayce,Khazix,45,18,27,40
Jayce,Qiyana,11,6,5,54.55
Jayce,RekSai,2,2,0,100
Zoe,Aatrox,80,39,41,48.75
Zoe,MasterYi,59,36,23,61.02
Zoe,TwistedFate,36,17,19,47.22
Zoe,Varus,65,40,25,61.54
Zoe,Lux,199,122,77,61.31
Zoe,Nasus,58,29,29,50
Zoe,Amumu,103,53,50,51.46
Zoe,Sylas,153,87,66,56.86
Zoe,Twitch,26,14,12,53.85
Zoe,Lulu,150,81,69,54
Zoe,Malphite,97,30,67,30.93
Zoe,Vi,102,43,59,42.16
Zoe,Azir,29,18,11,62.07
Zoe,MissFortune,186,90,96,48.39
Zoe,Kayn,99,36,63,36.36
Zoe,Ekko,64,38,26,59.38
Zoe,Teemo,80,39,41,48.75
Zoe,Sivir,52,22,30,42.31
Zoe,Velkoz,44,25,19,56.82
Zoe,Mordekaiser,121,65,56,53.72
Zoe,XinZhao,74,53,21,71.62
Zoe,Diana,125,60,65,48
Zoe,Tristana,103,41,62,39.81
Zoe,Thresh,106,52,54,49.06
Zoe,Gnar,39,20,19,51.28
Zoe,Ahri,136,67,69,49.26
Zoe,Karma,115,54,61,46.96
Zoe,Ornn,52,18,34,34.62
Zoe,Jax,48,19,29,39.58
Zoe,Ashe,172,93,79,54.07
Zoe,Yuumi,67,18,49,26.87
Zoe,Shen,66,23,43,34.85
Zoe,Xayah,42,16,26,38.1
Zoe,Viktor,60,26,34,43.33
Zoe,Sejuani,61,40,21,65.57
Zoe,Nami,110,45,65,40.91
Zoe,Kennen,28,15,13,53.57
Zoe,Illaoi,44,22,22,50
Zoe,Malzahar,100,47,53,47
Zoe,Vayne,102,61,41,59.8
Zoe,Milio,75,29,46,38.67
Zoe,Yasuo,148,57,91,38.51
Zoe,Ezreal,184,96,88,52.17
Zoe,TahmKench,69,35,34,50.72
Zoe,Jhin,155,61,94,39.35
Zoe,Nautilus,95,43,52,45.26
Zoe,Fiora,29,8,21,27.59
Zoe,LeeSin,161,76,85,47.2
Zoe,Samira,33,22,11,66.67
Zoe,Rell,64,29,35,45.31
Zoe,Yorick,57,31,26,54.39
Zoe,Hwei,53,27,26,50.94
Zoe,Shaco,68,23,45,33.82
Zoe,Lucian,79,29,50,36.71
Zoe,Heimerdinger,21,8,13,38.1
Zoe,Morgana,90,28,62,31.11
Zoe,Renekton,66,35,31,53.03
Zoe,Jinx,209,81,128,38.76
Zoe,Warwick,94,31,63,32.98
Zoe,Camille,42,10,32,23.81
Zoe,Caitlyn,221,118,103,53.39
Zoe,Zyra,61,33,28,54.1
Zoe,Sion,71,32,39,45.07
Zoe,Kindred,39,19,20,48.72
Zoe,Nidalee,38,22,16,57.89
Zoe,Yone,148,93,55,62.84
Zoe,JarvanIV,34,18,16,52.94
Zoe,Fizz,23,5,18,21.74
Zoe,Mel,152,83,69,54.61
Zoe,Seraphine,41,20,21,48.78
Zoe,Gragas,75,47,28,62.67
Zoe,Pyke,52,25,27,48.08
Zoe,Trundle,27,11,16,40.74
Zoe,AurelionSol,37,18,19,48.65
Zoe,Zeri,37,9,28,24.32
Zoe,Kaisa,173,77,96,44.51
Zoe,KSante,68,39,29,57.35
Zoe,Hecarim,26,12,14,46.15
Zoe,Lissandra,29,6,23,20.69
Zoe,Brand,66,34,32,51.52
Zoe,Singed,24,9,15,37.5
Zoe,FiddleSticks,37,15,22,40.54
Zoe,Pantheon,152,61,91,40.13
Zoe,Leona,88,48,40,54.55
Zoe,DrMundo,51,14,37,27.45
Zoe,Draven,41,13,28,31.71
Zoe,Blitzcrank,85,36,49,42.35
Zoe,Cassiopeia,44,28,16,63.64
Zoe,Vladimir,48,23,25,47.92
Zoe,Riven,29,21,8,72.41
Zoe,Skarner,42,15,27,35.71
Zoe,Orianna,53,21,32,39.62
Zoe,Braum,65,23,42,35.38
Zoe,Naafiri,34,24,10,70.59
Zoe,Sett,129,65,64,50.39
Zoe,Briar,32,17,15,53.13
Zoe,Syndra,64,32,32,50
Zoe,Poppy,50,25,25,50
Zoe,Alistar,50,27,23,54
Zoe,Darius,153,78,75,50.98
Zoe,Leblanc,58,22,36,37.93
Zoe,Soraka,13,8,5,61.54
Zoe,Aurora,37,27,10,72.97
Zoe,Gangplank,54,17,37,31.48
Zoe,Katarina,37,17,20,45.95
Zoe,Udyr,38,21,17,55.26
Zoe,Zed,77,33,44,42.86
Zoe,Garen,95,37,58,38.95
Zoe,Vex,35,14,21,40
Zoe,Bard,11,9,2,81.82
Zoe,Chogath,96,48,48,50
Zoe,Aphelios,41,23,18,56.1
Zoe,Volibear,68,28,40,41.18
Zoe,Rumble,26,8,18,30.77
Zoe,Irelia,50,22,28,44
Zoe,Kassadin,16,13,3,81.25
Zoe,Quinn,31,16,15,51.61
Zoe,Nocturne,72,31,41,43.06
Zoe,Akali,91,51,40,56.04
Zoe,Ambessa,69,30,39,43.48
Zoe,Viego,131,48,83,36.64
Zoe,Janna,29,15,14,51.72
Zoe,Ziggs,24,10,14,41.67
Zoe,Kled,16,9,7,56.25
Zoe,RekSai,8,8,0,100
Zoe,Xerath,61,33,28,54.1
Zoe,Nilah,25,10,15,40
Zoe,Evelynn,23,12,11,52.17
Zoe,Smolder,49,30,19,61.22
Zoe,Sona,11,6,5,54.55
Zoe,Belveth,16,10,6,62.5
Zoe,Zilean,33,11,22,33.33
Zoe,Elise,96,47,49,48.96
Zoe,Jayce,34,30,4,88.24
Zoe,Khazix,81,40,41,49.38
Zoe,Kayle,27,8,19,29.63
Zoe,Swain,62,17,45,27.42
Zoe,Veigar,75,33,42,44
Zoe,Tryndamere,30,8,22,26.67
Zoe,Anivia,35,13,22,37.14
Zoe,Rammus,41,23,18,56.1
Zoe,MonkeyKing,34,17,17,50
Zoe,Nunu,45,17,28,37.78
Zoe,Taric,23,9,14,39.13
Zoe,KogMaw,37,23,14,62.16
Zoe,Qiyana,20,14,6,70
Zoe,Akshan,27,12,15,44.44
Zoe,Maokai,53,27,26,50.94
Zoe,Senna,31,21,10,67.74
Zoe,Galio,108,30,78,27.78
Zoe,Zac,43,34,9,79.07
Zoe,Rakan,42,15,27,35.71
Zoe,Annie,20,14,6,70
Zoe,Taliyah,8,6,2,75
Zoe,Shyvana,14,10,4,71.43
Zoe,Gwen,43,24,19,55.81
Zoe,Karthus,29,15,14,51.72
Zoe,Graves,42,25,17,59.52
Zoe,Ivern,19,11,8,57.89
Zoe,Rengar,21,9,12,42.86
Zoe,Neeko,51,31,20,60.78
Zoe,Ryze,25,15,10,60
Zoe,Urgot,18,11,7,61.11
Zoe,Corki,27,18,9,66.67
Zoe,Talon,62,29,33,46.77
Zoe,Kalista,35,20,15,57.14
Zoe,Lillia,20,12,8,60
Zoe,Renata,11,3,8,27.27
Zoe,Olaf,6,3,3,50
Kennen,Gnar,33,12,21,36.36
Kennen,Hecarim,17,11,6,64.71
Kennen,Viktor,68,41,27,60.29
Kennen,MissFortune,97,54,43,55.67
Kennen,Rell,46,13,33,28.26
Kennen,Yorick,50,31,19,62
Kennen,Skarner,32,16,16,50
Kennen,Mel,142,73,69,51.41
Kennen,Smolder,41,24,17,58.54
Kennen,Senna,43,36,7,83.72
Kennen,Nasus,36,23,13,63.89
Kennen,MasterYi,62,27,35,43.55
Kennen,Chogath,95,35,60,36.84
Kennen,Ezreal,195,106,89,54.36
Kennen,Amumu,71,31,40,43.66
Kennen,Aatrox,62,30,32,48.39
Kennen,Sejuani,34,18,16,52.94
Kennen,Yasuo,107,68,39,63.55
Kennen,Annie,20,8,12,40
Kennen,Nami,62,19,43,30.65
Kennen,Garen,67,30,37,44.78
Kennen,Trundle,40,17,23,42.5
Kennen,Katarina,47,30,17,63.83
Kennen,Zoe,28,13,15,46.43
Kennen,Zac,57,19,38,33.33
Kennen,Nocturne,67,41,26,61.19
Kennen,Veigar,47,35,12,74.47
Kennen,KogMaw,38,18,20,47.37
Kennen,Morgana,47,24,23,51.06
Kennen,Kled,17,5,12,29.41
Kennen,Vladimir,36,7,29,19.44
Kennen,Jhin,128,48,80,37.5
Kennen,Pyke,69,28,41,40.58
Kennen,Mordekaiser,81,38,43,46.91
Kennen,Shaco,47,28,19,59.57
Kennen,Leblanc,50,25,25,50
Kennen,Nilah,16,5,11,31.25
Kennen,Thresh,118,68,50,57.63
Kennen,Jax,48,24,24,50
Kennen,Khazix,21,11,10,52.38
Kennen,Vex,43,24,19,55.81
Kennen,Caitlyn,159,70,89,44.03
Kennen,Ambessa,44,29,15,65.91
Kennen,Jayce,43,24,19,55.81
Kennen,Draven,58,23,35,39.66
Kennen,Vi,70,40,30,57.14
Kennen,Renata,13,0,13,0
Kennen,Heimerdinger,34,11,23,32.35
Kennen,Ivern,11,3,8,27.27
Kennen,Ashe,132,82,50,62.12
Kennen,Warwick,58,20,38,34.48
Kennen,Renekton,41,10,31,24.39
Kennen,Irelia,52,28,24,53.85
Kennen,Alistar,43,20,23,46.51
Kennen,LeeSin,127,65,62,51.18
Kennen,Jinx,131,65,66,49.62
Kennen,Lux,114,44,70,38.6
Kennen,Kayn,67,35,32,52.24
Kennen,Viego,98,47,51,47.96
Kennen,Akali,64,30,34,46.88
Kennen,Corki,30,8,22,26.67
Kennen,Lillia,30,11,19,36.67
Kennen,Aurora,51,29,22,56.86
Kennen,Lulu,99,60,39,60.61
Kennen,Gragas,33,19,14,57.58
Kennen,Kaisa,105,51,54,48.57
Kennen,Nautilus,66,28,38,42.42
Kennen,JarvanIV,57,18,39,31.58
Kennen,Ahri,92,35,57,38.04
Kennen,Briar,36,18,18,50
Kennen,Yone,100,58,42,58
Kennen,FiddleSticks,36,14,22,38.89
Kennen,Janna,31,17,14,54.84
Kennen,Darius,136,73,63,53.68
Kennen,Rammus,21,10,11,47.62
Kennen,Gwen,32,15,17,46.88
Kennen,Karthus,16,9,7,56.25
Kennen,Tristana,47,29,18,61.7
Kennen,Swain,68,23,45,33.82
Kennen,Sion,50,24,26,48
Kennen,Kassadin,8,2,6,25
Kennen,Quinn,28,10,18,35.71
Kennen,Azir,17,11,6,64.71
Kennen,Yuumi,37,16,21,43.24
Kennen,Fizz,32,18,14,56.25
Kennen,Shen,25,12,13,48
Kennen,Ryze,23,14,9,60.87
Kennen,Riven,12,3,9,25
Kennen,Kayle,20,6,14,30
Kennen,Seraphine,33,19,14,57.58
Kennen,Pantheon,86,50,36,58.14
Kennen,Zed,65,31,34,47.69
Kennen,Graves,47,26,21,55.32
Kennen,Tryndamere,19,8,11,42.11
Kennen,Malphite,62,28,34,45.16
Kennen,Zyra,76,34,42,44.74
Kennen,Qiyana,16,5,11,31.25
Kennen,Singed,12,6,6,50
Kennen,Galio,82,56,26,68.29
Kennen,Camille,21,9,12,42.86
Kennen,Diana,72,28,44,38.89
Kennen,Syndra,28,18,10,64.29
Kennen,Aphelios,53,30,23,56.6
Kennen,Gangplank,36,25,11,69.44
Kennen,Sylas,92,45,47,48.91
Kennen,Velkoz,32,8,24,25
Kennen,Illaoi,31,20,11,64.52
Kennen,Leona,63,34,29,53.97
Kennen,Twitch,23,9,14,39.13
Kennen,Milio,50,19,31,38
Kennen,Olaf,18,10,8,55.56
Kennen,Nunu,33,23,10,69.7
Kennen,Soraka,11,3,8,27.27
Kennen,Varus,50,29,21,58
Kennen,Sett,74,46,28,62.16
Kennen,RekSai,3,0,3,0
Kennen,Ekko,53,12,41,22.64
Kennen,Talon,29,9,20,31.03
Kennen,Poppy,36,10,26,27.78
Kennen,Vayne,80,29,51,36.25
Kennen,Malzahar,51,24,27,47.06
Kennen,Karma,56,29,27,51.79
Kennen,Rumble,25,6,19,24
Kennen,Evelynn,21,10,11,47.62
Kennen,Xayah,28,16,12,57.14
Kennen,Teemo,80,49,31,61.25
Kennen,MonkeyKing,35,11,24,31.43
Kennen,Volibear,67,23,44,34.33
Kennen,Neeko,28,12,16,42.86
Kennen,Blitzcrank,18,10,8,55.56
Kennen,Urgot,26,14,12,53.85
Kennen,Braum,52,33,19,63.46
Kennen,Naafiri,12,2,10,16.67
Kennen,Rakan,33,28,5,84.85
Kennen,Samira,37,23,14,62.16
Kennen,Belveth,10,4,6,40
Kennen,Bard,35,23,12,65.71
Kennen,XinZhao,34,16,18,47.06
Kennen,Xerath,78,34,44,43.59
Kennen,Sivir,25,7,18,28
Kennen,Akshan,17,12,5,70.59
Kennen,DrMundo,35,17,18,48.57
Kennen,Elise,43,17,26,39.53
Kennen,Orianna,41,15,26,36.59
Kennen,Ziggs,18,9,9,50
Kennen,Brand,38,13,25,34.21
Kennen,Kindred,22,19,3,86.36
Kennen,Nidalee,21,16,5,76.19
Kennen,Fiora,17,5,12,29.41
Kennen,Taliyah,22,14,8,63.64
Kennen,Kalista,14,0,14,0
Kennen,Lucian,41,25,16,60.98
Kennen,Ornn,45,12,33,26.67
Kennen,TahmKench,46,13,33,28.26
Kennen,Zeri,28,8,20,28.57
Kennen,Hwei,50,15,35,30
Kennen,Udyr,28,19,9,67.86
Kennen,Maokai,39,12,27,30.77
Kennen,AurelionSol,15,2,13,13.33
Kennen,Anivia,13,4,9,30.77
Kennen,Rengar,11,5,6,45.45
Kennen,TwistedFate,24,11,13,45.83
Kennen,KSante,31,19,12,61.29
Kennen,Shyvana,7,0,7,0
Kennen,Cassiopeia,25,14,11,56
Kennen,Zilean,5,5,0,100
Kennen,Taric,11,5,6,45.45
Kennen,Lissandra,23,12,11,52.17
Kennen,Sona,6,3,3,50
Gnar,Kennen,33,21,12,63.64
Gnar,Vi,86,35,51,40.7
Gnar,Ashe,201,111,90,55.22
Gnar,Lux,232,114,118,49.14
Gnar,Leona,142,66,76,46.48
Gnar,Jhin,217,87,130,40.09
Gnar,Ekko,71,20,51,28.17
Gnar,Akali,121,54,67,44.63
Gnar,Ambessa,60,13,47,21.67
Gnar,Karma,129,57,72,44.19
Gnar,Pantheon,175,101,74,57.71
Gnar,Talon,57,26,31,45.61
Gnar,Kaisa,160,92,68,57.5
Gnar,Soraka,61,33,28,54.1
Gnar,Chogath,157,69,88,43.95
Gnar,MasterYi,83,39,44,46.99
Gnar,Gangplank,60,30,30,50
Gnar,AurelionSol,41,13,28,31.71
Gnar,Jayce,69,34,35,49.28
Gnar,Singed,25,13,12,52
Gnar,JarvanIV,87,48,39,55.17
Gnar,Leblanc,59,24,35,40.68
Gnar,Heimerdinger,47,32,15,68.09
Gnar,Orianna,64,26,38,40.63
Gnar,LeeSin,194,89,105,45.88
Gnar,Seraphine,61,22,39,36.07
Gnar,Aatrox,82,34,48,41.46
Gnar,Ivern,23,12,11,52.17
Gnar,Twitch,93,41,52,44.09
Gnar,Elise,126,50,76,39.68
Gnar,Yasuo,214,94,120,43.93
Gnar,Shaco,68,39,29,57.35
Gnar,Zoe,39,19,20,48.72
Gnar,Thresh,163,80,83,49.08
Gnar,Sett,152,82,70,53.95
Gnar,Lillia,63,12,51,19.05
Gnar,Katarina,70,32,38,45.71
Gnar,Yuumi,111,60,51,54.05
Gnar,Illaoi,36,16,20,44.44
Gnar,Amumu,117,48,69,41.03
Gnar,Vladimir,80,21,59,26.25
Gnar,Mordekaiser,129,56,73,43.41
Gnar,Qiyana,26,23,3,88.46
Gnar,Kalista,47,39,8,82.98
Gnar,Nautilus,138,64,74,46.38
Gnar,Naafiri,28,11,17,39.29
Gnar,Jinx,308,123,185,39.94
Gnar,Jax,59,25,34,42.37
Gnar,Diana,164,74,90,45.12
Gnar,Irelia,123,54,69,43.9
Gnar,Malphite,184,74,110,40.22
Gnar,Yorick,88,45,43,51.14
Gnar,Nidalee,39,27,12,69.23
Gnar,Yone,151,82,69,54.3
Gnar,Rell,81,40,41,49.38
Gnar,Aurora,90,48,42,53.33
Gnar,Ryze,37,18,19,48.65
Gnar,Maokai,54,24,30,44.44
Gnar,Kayn,116,55,61,47.41
Gnar,Zed,131,69,62,52.67
Gnar,Draven,53,28,25,52.83
Gnar,Rakan,80,32,48,40
Gnar,Camille,48,13,35,27.08
Gnar,Malzahar,80,35,45,43.75
Gnar,Caitlyn,210,92,118,43.81
Gnar,Zyra,81,36,45,44.44
Gnar,Sion,86,35,51,40.7
Gnar,Annie,26,20,6,76.92
Gnar,Vayne,131,44,87,33.59
Gnar,Neeko,68,35,33,51.47
Gnar,Volibear,98,35,63,35.71
Gnar,Lissandra,55,17,38,30.91
Gnar,Veigar,120,46,74,38.33
Gnar,Hecarim,56,36,20,64.29
Gnar,Tristana,92,59,33,64.13
Gnar,Fiora,31,11,20,35.48
Gnar,Sejuani,64,22,42,34.38
Gnar,Swain,124,52,72,41.94
Gnar,Zac,73,19,54,26.03
Gnar,Sylas,156,84,72,53.85
Gnar,Smolder,82,36,46,43.9
Gnar,Warwick,103,37,66,35.92
Gnar,TahmKench,95,35,60,36.84
Gnar,Kled,16,6,10,37.5
Gnar,Mel,172,93,79,54.07
Gnar,Morgana,83,34,49,40.96
Gnar,Aphelios,73,50,23,68.49
Gnar,Milio,69,24,45,34.78
Gnar,Ahri,173,57,116,32.95
Gnar,Ezreal,241,101,140,41.91
Gnar,Blitzcrank,103,48,55,46.6
Gnar,Briar,46,14,32,30.43
Gnar,Sivir,43,20,23,46.51
Gnar,Shen,101,37,64,36.63
Gnar,Zilean,41,23,18,56.1
Gnar,Lulu,142,60,82,42.25
Gnar,Renekton,44,15,29,34.09
Gnar,Gragas,96,55,41,57.29
Gnar,MissFortune,207,95,112,45.89
Gnar,Corki,51,15,36,29.41
Gnar,Darius,221,94,127,42.53
Gnar,Urgot,44,22,22,50
Gnar,Brand,67,32,35,47.76
Gnar,MonkeyKing,87,43,44,49.43
Gnar,Viktor,118,40,78,33.9
Gnar,Ziggs,40,18,22,45
Gnar,Garen,166,66,100,39.76
Gnar,Rengar,37,13,24,35.14
Gnar,Bard,37,16,21,43.24
Gnar,Teemo,85,33,52,38.82
Gnar,Viego,151,64,87,42.38
Gnar,Nilah,37,11,26,29.73
Gnar,Janna,29,8,21,27.59
Gnar,Pyke,83,37,46,44.58
Gnar,Nasus,48,12,36,25
Gnar,Lucian,76,30,46,39.47
Gnar,Alistar,55,16,39,29.09
Gnar,Varus,61,24,37,39.34
Gnar,KSante,85,56,29,65.88
Gnar,Poppy,71,46,25,64.79
Gnar,Galio,110,50,60,45.45
Gnar,Tryndamere,33,16,17,48.48
Gnar,Zeri,37,18,19,48.65
Gnar,DrMundo,51,13,38,25.49
Gnar,Skarner,49,23,26,46.94
Gnar,Trundle,47,23,24,48.94
Gnar,KogMaw,30,14,16,46.67
Gnar,Braum,84,43,41,51.19
Gnar,Riven,40,17,23,42.5
Gnar,Xayah,79,41,38,51.9
Gnar,Taliyah,41,17,24,41.46
Gnar,Kindred,43,29,14,67.44
Gnar,Karthus,24,16,8,66.67
Gnar,Renata,32,14,18,43.75
Gnar,Kayle,48,29,19,60.42
Gnar,Syndra,79,31,48,39.24
Gnar,Nocturne,107,49,58,45.79
Gnar,Evelynn,24,14,10,58.33
Gnar,Nami,94,26,68,27.66
Gnar,Khazix,48,30,18,62.5
Gnar,XinZhao,69,33,36,47.83
Gnar,Velkoz,56,32,24,57.14
Gnar,Udyr,44,30,14,68.18
Gnar,Akshan,27,11,16,40.74
Gnar,Senna,52,24,28,46.15
Gnar,Samira,49,14,35,28.57
Gnar,Xerath,65,46,19,70.77
Gnar,Nunu,72,29,43,40.28
Gnar,Fizz,40,26,14,65
Gnar,Gwen,41,19,22,46.34
Gnar,Azir,36,20,16,55.56
Gnar,Hwei,64,27,37,42.19
Gnar,TwistedFate,35,11,24,31.43
Gnar,FiddleSticks,40,17,23,42.5
Gnar,Olaf,41,11,30,26.83
Gnar,Quinn,39,31,8,79.49
Gnar,Taric,26,10,16,38.46
Gnar,Rumble,35,17,18,48.57
Gnar,Anivia,44,17,27,38.64
Gnar,Ornn,60,24,36,40
Gnar,Shyvana,28,13,15,46.43
Gnar,RekSai,21,11,10,52.38
Gnar,Rammus,33,20,13,60.61
Gnar,Cassiopeia,20,13,7,65
Gnar,Graves,53,25,28,47.17
Gnar,Vex,34,15,19,44.12
Gnar,Belveth,24,10,14,41.67
Gnar,Kassadin,14,9,5,64.29
Gnar,Sona,5,0,5,0
Amumu,DrMundo,143,81,62,56.64
Amumu,Sejuani,181,96,85,53.04
Amumu,Veigar,292,170,122,58.22
Amumu,Jinx,615,307,308,49.92
Amumu,Nami,251,117,134,46.61
Amumu,Kayn,341,188,153,55.13
Amumu,Shaco,179,112,67,62.57
Amumu,Zoe,103,50,53,48.54
Amumu,KogMaw,86,42,44,48.84
Amumu,TwistedFate,89,55,34,61.8
Amumu,Yasuo,439,247,192,56.26
Amumu,Diana,326,174,152,53.37
Amumu,Naafiri,90,50,40,55.56
Amumu,MissFortune,445,220,225,49.44
Amumu,Azir,90,52,38,57.78
Amumu,Irelia,186,99,87,53.23
Amumu,Malphite,286,169,117,59.09
Amumu,Jhin,450,219,231,48.67
Amumu,Karma,254,132,122,51.97
Amumu,Trundle,137,73,64,53.28
Amumu,Ashe,401,200,201,49.88
Amumu,Braum,203,116,87,57.14
Amumu,Briar,136,70,66,51.47
Amumu,Nocturne,234,107,127,45.73
Amumu,Lissandra,91,37,54,40.66
Amumu,Caitlyn,612,322,290,52.61
Amumu,Shen,211,117,94,55.45
Amumu,Malzahar,229,116,113,50.66
Amumu,Garen,342,176,166,51.46
Amumu,Lucian,199,113,86,56.78
Amumu,Aatrox,191,116,75,60.73
Amumu,Teemo,252,124,128,49.21
Amumu,Aurora,217,116,101,53.46
Amumu,Sivir,144,76,68,52.78
Amumu,Blitzcrank,233,141,92,60.52
Amumu,Heimerdinger,99,60,39,60.61
Amumu,Leona,241,120,121,49.79
Amumu,Kennen,71,40,31,56.34
Amumu,XinZhao,144,83,61,57.64
Amumu,Brand,198,97,101,48.99
Amumu,Morgana,236,127,109,53.81
Amumu,Darius,445,243,202,54.61
Amumu,Vi,278,162,116,58.27
Amumu,Vayne,295,139,156,47.12
Amumu,Yuumi,177,79,98,44.63
Amumu,Yone,396,244,152,61.62
Amumu,Talon,121,68,53,56.2
Amumu,Vladimir,161,65,96,40.37
Amumu,Swain,265,147,118,55.47
Amumu,Thresh,399,208,191,52.13
Amumu,Chogath,345,181,164,52.46
Amumu,MasterYi,239,136,103,56.9
Amumu,Gangplank,123,64,59,52.03
Amumu,AurelionSol,108,58,50,53.7
Amumu,TahmKench,254,136,118,53.54
Amumu,Viego,321,167,154,52.02
Amumu,Zed,241,129,112,53.53
Amumu,Ziggs,92,67,25,72.83
Amumu,RekSai,33,11,22,33.33
Amumu,Akali,214,133,81,62.15
Amumu,Bard,75,44,31,58.67
Amumu,Camille,94,54,40,57.45
Amumu,Milio,167,99,68,59.28
Amumu,Xayah,159,92,67,57.86
Amumu,Viktor,181,93,88,51.38
Amumu,Gnar,117,69,48,58.97
Amumu,LeeSin,314,198,116,63.06
Amumu,Fizz,124,73,51,58.87
Amumu,Seraphine,174,88,86,50.57
Amumu,Mordekaiser,313,161,152,51.44
Amumu,Ambessa,170,101,69,59.41
Amumu,Ryze,100,53,47,53
Amumu,Smolder,157,79,78,50.32
Amumu,Yorick,264,136,128,51.52
Amumu,Sylas,410,221,189,53.9
Amumu,Draven,126,70,56,55.56
Amumu,Quinn,91,42,49,46.15
Amumu,Lux,546,308,238,56.41
Amumu,Varus,207,132,75,63.77
Amumu,Lulu,275,147,128,53.45
Amumu,Illaoi,115,50,65,43.48
Amumu,Ezreal,513,287,226,55.95
Amumu,Sona,46,28,18,60.87
Amumu,Jayce,104,63,41,60.58
Amumu,Mel,554,287,267,51.81
Amumu,Renata,61,32,29,52.46
Amumu,JarvanIV,192,107,85,55.73
Amumu,Elise,176,91,85,51.7
Amumu,Karthus,55,30,25,54.55
Amumu,Gragas,144,76,68,52.78
Amumu,Orianna,132,65,67,49.24
Amumu,Nilah,84,40,44,47.62
Amumu,Samira,183,104,79,56.83
Amumu,Corki,115,71,44,61.74
Amumu,Poppy,167,96,71,57.49
Amumu,Warwick,374,200,174,53.48
Amumu,Tryndamere,91,40,51,43.96
Amumu,Urgot,93,52,41,55.91
Amumu,Janna,69,41,28,59.42
Amumu,Jax,189,104,85,55.03
Amumu,Volibear,231,142,89,61.47
Amumu,Kaisa,340,196,144,57.65
Amumu,Fiora,80,40,40,50
Amumu,Leblanc,119,65,54,54.62
Amumu,Rakan,122,51,71,41.8
Amumu,Rengar,97,54,43,55.67
Amumu,Ahri,313,177,136,56.55
Amumu,Nautilus,369,183,186,49.59
Amumu,Kassadin,48,24,24,50
Amumu,Aphelios,129,72,57,55.81
Amumu,Maokai,110,63,47,57.27
Amumu,Tristana,242,120,122,49.59
Amumu,Kindred,125,88,37,70.4
Amumu,MonkeyKing,182,94,88,51.65
Amumu,Renekton,109,61,48,55.96
Amumu,Belveth,72,27,45,37.5
Amumu,Pantheon,381,222,159,58.27
Amumu,Zeri,95,64,31,67.37
Amumu,Gwen,97,46,51,47.42
Amumu,Rell,150,94,56,62.67
Amumu,Soraka,86,54,32,62.79
Amumu,Ornn,140,78,62,55.71
Amumu,Udyr,59,34,25,57.63
Amumu,Ekko,198,94,104,47.47
Amumu,Rammus,63,35,28,55.56
Amumu,Katarina,153,82,71,53.59
Amumu,Zyra,198,110,88,55.56
Amumu,Hwei,152,93,59,61.18
Amumu,Singed,68,33,35,48.53
Amumu,FiddleSticks,90,43,47,47.78
Amumu,Riven,94,63,31,67.02
Amumu,Galio,280,133,147,47.5
Amumu,Sion,218,108,110,49.54
Amumu,Neeko,154,97,57,62.99
Amumu,Sett,292,153,139,52.4
Amumu,Khazix,109,53,56,48.62
Amumu,Xerath,186,91,95,48.92
Amumu,Nidalee,81,53,28,65.43
Amumu,Alistar,125,70,55,56
Amumu,Kayle,140,84,56,60
Amumu,Shyvana,61,29,32,47.54
Amumu,Annie,56,33,23,58.93
Amumu,Zilean,85,43,42,50.59
Amumu,Ivern,40,28,12,70
Amumu,Evelynn,76,40,36,52.63
Amumu,Nasus,152,69,83,45.39
Amumu,Akshan,78,42,36,53.85
Amumu,Twitch,197,116,81,58.88
Amumu,Taliyah,79,45,34,56.96
Amumu,Lillia,110,69,41,62.73
Amumu,Cassiopeia,48,27,21,56.25
Amumu,Qiyana,57,26,31,45.61
Amumu,Skarner,131,73,58,55.73
Amumu,Taric,41,24,17,58.54
Amumu,Pyke,168,104,64,61.9
Amumu,Zac,157,79,78,50.32
Amumu,Velkoz,163,108,55,66.26
Amumu,Kalista,69,59,10,85.51
Amumu,Vex,145,94,51,64.83
Amumu,Nunu,204,123,81,60.29
Amumu,Syndra,112,66,46,58.93
Amumu,Graves,155,69,86,44.52
Amumu,Rumble,58,35,23,60.34
Amumu,Olaf,54,33,21,61.11
Amumu,Hecarim,96,43,53,44.79
Amumu,Anivia,69,36,33,52.17
Amumu,KSante,147,63,84,42.86
Amumu,Kled,27,21,6,77.78
Amumu,Senna,108,41,67,37.96
Shyvana,Nasus,32,14,18,43.75
Shyvana,Sejuani,28,10,18,35.71
Shyvana,Malzahar,57,31,26,54.39
Shyvana,TwistedFate,14,5,9,35.71
Shyvana,Seraphine,53,18,35,33.96
Shyvana,Teemo,60,29,31,48.33
Shyvana,Rammus,11,8,3,72.73
Shyvana,Leblanc,29,11,18,37.93
Shyvana,Caitlyn,145,75,70,51.72
Shyvana,Karma,69,46,23,66.67
Shyvana,Aurora,61,36,25,59.02
Shyvana,Diana,88,65,23,73.86
Shyvana,Ryze,27,14,13,51.85
Shyvana,Mordekaiser,57,26,31,45.61
Shyvana,Maokai,22,22,0,100
Shyvana,Gwen,34,13,21,38.24
Shyvana,Skarner,35,17,18,48.57
Shyvana,AurelionSol,24,10,14,41.67
Shyvana,Lux,133,65,68,48.87
Shyvana,Volibear,60,26,34,43.33
Shyvana,Shaco,48,17,31,35.42
Shyvana,Yone,68,38,30,55.88
Shyvana,Varus,56,26,30,46.43
Shyvana,Ashe,96,53,43,55.21
Shyvana,Yorick,69,44,25,63.77
Shyvana,Kayn,67,54,13,80.6
Shyvana,Vladimir,26,17,9,65.38
Shyvana,Ezreal,105,56,49,53.33
Shyvana,Xerath,58,31,27,53.45
Shyvana,Urgot,30,15,15,50
Shyvana,Evelynn,9,9,0,100
Shyvana,Briar,45,11,34,24.44
Shyvana,Kalista,26,14,12,53.85
Shyvana,Sett,77,49,28,63.64
Shyvana,TahmKench,53,24,29,45.28
Shyvana,Warwick,72,43,29,59.72
Shyvana,Akali,46,25,21,54.35
Shyvana,Twitch,60,39,21,65
Shyvana,Fiora,8,2,6,25
Shyvana,Nocturne,42,24,18,57.14
Shyvana,Viktor,28,17,11,60.71
Shyvana,Aphelios,41,18,23,43.9
Shyvana,Morgana,27,14,13,51.85
Shyvana,Malphite,56,23,33,41.07
Shyvana,Yasuo,103,52,51,50.49
Shyvana,Lucian,35,13,22,37.14
Shyvana,Milio,26,17,9,65.38
Shyvana,XinZhao,33,20,13,60.61
Shyvana,Jax,33,8,25,24.24
Shyvana,Kaisa,58,33,25,56.9
Shyvana,Senna,35,23,12,65.71
Shyvana,Ornn,28,15,13,53.57
Shyvana,Heimerdinger,23,15,8,65.22
Shyvana,Lulu,65,33,32,50.77
Shyvana,Talon,28,21,7,75
Shyvana,Sivir,27,19,8,70.37
Shyvana,Zyra,35,20,15,57.14
Shyvana,DrMundo,46,26,20,56.52
Shyvana,Amumu,61,32,29,52.46
Shyvana,Mel,113,56,57,49.56
Shyvana,Tristana,32,15,17,46.88
Shyvana,Pantheon,79,52,27,65.82
Shyvana,Veigar,64,36,28,56.25
Shyvana,KogMaw,13,10,3,76.92
Shyvana,Nautilus,44,29,15,65.91
Shyvana,Lillia,23,14,9,60.87
Shyvana,Smolder,41,19,22,46.34
Shyvana,Nami,60,36,24,60
Shyvana,Tryndamere,20,12,8,60
Shyvana,Gragas,27,16,11,59.26
Shyvana,Azir,23,21,2,91.3
Shyvana,Fizz,34,19,15,55.88
Shyvana,Kayle,23,12,11,52.17
Shyvana,Zac,33,21,12,63.64
Shyvana,Zed,42,20,22,47.62
Shyvana,Pyke,39,23,16,58.97
Shyvana,Darius,76,36,40,47.37
Shyvana,Jinx,135,76,59,56.3
Shyvana,Hecarim,28,9,19,32.14
Shyvana,Thresh,60,39,21,65
Shyvana,Orianna,29,14,15,48.28
Shyvana,Zilean,23,15,8,65.22
Shyvana,FiddleSticks,20,14,6,70
Shyvana,Janna,23,18,5,78.26
Shyvana,Chogath,54,37,17,68.52
Shyvana,Jhin,74,38,36,51.35
Shyvana,Rakan,21,9,12,42.86
Shyvana,Naafiri,11,9,2,81.82
Shyvana,Syndra,48,33,15,68.75
Shyvana,Blitzcrank,43,27,16,62.79
Shyvana,Kassadin,3,0,3,0
Shyvana,Draven,26,17,9,65.38
Shyvana,Alistar,33,25,8,75.76
Shyvana,Sylas,51,33,18,64.71
Shyvana,Samira,33,21,12,63.64
Shyvana,Jayce,28,19,9,67.86
Shyvana,Belveth,11,5,6,45.45
Shyvana,Lissandra,14,6,8,42.86
Shyvana,Sona,17,11,6,64.71
Shyvana,Hwei,20,10,10,50
Shyvana,Soraka,16,16,0,100
Shyvana,Braum,35,21,14,60
Shyvana,MasterYi,68,39,29,57.35
Shyvana,Viego,81,61,20,75.31
Shyvana,MissFortune,86,49,37,56.98
Shyvana,Trundle,25,14,11,56
Shyvana,Kled,12,8,4,66.67
Shyvana,Anivia,12,10,2,83.33
Shyvana,Garen,72,38,34,52.78
Shyvana,MonkeyKing,28,20,8,71.43
Shyvana,Ahri,72,41,31,56.94
Shyvana,Akshan,23,18,5,78.26
Shyvana,Vi,63,31,32,49.21
Shyvana,Aatrox,35,19,16,54.29
Shyvana,Nidalee,17,2,15,11.76
Shyvana,Ekko,41,19,22,46.34
Shyvana,Neeko,26,9,17,34.62
Shyvana,Swain,53,23,30,43.4
Shyvana,Leona,53,23,30,43.4
Shyvana,Renekton,20,12,8,60
Shyvana,Nunu,39,26,13,66.67
Shyvana,Xayah,31,17,14,54.84
Shyvana,Sion,28,14,14,50
Shyvana,Khazix,39,26,13,66.67
Shyvana,Irelia,34,20,14,58.82
Shyvana,Udyr,23,14,9,60.87
Shyvana,Vex,32,14,18,43.75
Shyvana,Qiyana,10,7,3,70
Shyvana,Singed,18,15,3,83.33
Shyvana,Galio,59,30,29,50.85
Shyvana,Poppy,38,27,11,71.05
Shyvana,Graves,32,17,15,53.13
Shyvana,Illaoi,24,11,13,45.83
Shyvana,Vayne,53,35,18,66.04
Shyvana,Elise,37,20,17,54.05
Shyvana,LeeSin,62,26,36,41.94
Shyvana,JarvanIV,20,18,2,90
Shyvana,Annie,14,12,2,85.71
Shyvana,Ziggs,17,14,3,82.35
Shyvana,Nilah,7,7,0,100
Shyvana,Rell,27,18,9,66.67
Shyvana,Taliyah,14,5,9,35.71
Shyvana,Kindred,26,12,14,46.15
Shyvana,Velkoz,19,7,12,36.84
Shyvana,Gangplank,17,10,7,58.82
Shyvana,Corki,27,17,10,62.96
Shyvana,Gnar,28,15,13,53.57
Shyvana,Yuumi,27,15,12,55.56
Shyvana,Brand,27,18,9,66.67
Shyvana,Ambessa,32,22,10,68.75
Shyvana,Shen,25,15,10,60
Shyvana,Katarina,14,9,5,64.29
Shyvana,Riven,8,4,4,50
Shyvana,Zoe,14,4,10,28.57
Shyvana,RekSai,2,0,2,0
Shyvana,Ivern,6,2,4,33.33
Shyvana,Bard,13,10,3,76.92
Shyvana,Renata,24,10,14,41.67
Shyvana,Cassiopeia,7,5,2,71.43
Shyvana,Rengar,8,6,2,75
Shyvana,Rumble,14,9,5,64.29
Shyvana,Quinn,11,8,3,72.73
Shyvana,Kennen,7,7,0,100
Shyvana,Karthus,7,5,2,71.43
Shyvana,Zeri,8,6,2,75
Shyvana,KSante,17,11,6,64.71
Shyvana,Taric,3,3,0,100
Shyvana,Olaf,8,8,0,100
Shyvana,Camille,6,3,3,50
Zyra,Poppy,110,47,63,42.73
Zyra,Zac,102,74,28,72.55
Zyra,Malzahar,160,63,97,39.38
Zyra,MissFortune,309,137,172,44.34
Zyra,TahmKench,142,72,70,50.7
Zyra,Illaoi,96,53,43,55.21
Zyra,Pantheon,227,117,110,51.54
Zyra,Vex,94,62,32,65.96
Zyra,Lucian,151,85,66,56.29
Zyra,Braum,125,62,63,49.6
Zyra,Yorick,143,73,70,51.05
Zyra,Diana,249,134,115,53.82
Zyra,Akali,162,99,63,61.11
Zyra,Ashe,319,165,154,51.72
Zyra,Milio,96,43,53,44.79
Zyra,Sylas,275,130,145,47.27
Zyra,Tristana,101,40,61,39.6
Zyra,Ahri,228,119,109,52.19
Zyra,Graves,99,49,50,49.49
Zyra,Blitzcrank,173,100,73,57.8
Zyra,Yasuo,280,138,142,49.29
Zyra,Kayn,207,102,105,49.28
Zyra,Irelia,109,61,48,55.96
Zyra,Caitlyn,458,232,226,50.66
Zyra,Rell,102,52,50,50.98
Zyra,Katarina,82,45,37,54.88
Zyra,JarvanIV,134,61,73,45.52
Zyra,Yone,273,156,117,57.14
Zyra,Ornn,97,49,48,50.52
Zyra,Warwick,214,82,132,38.32
Zyra,Veigar,155,78,77,50.32
Zyra,Malphite,189,82,107,43.39
Zyra,Kindred,82,44,38,53.66
Zyra,Akshan,44,20,24,45.45
Zyra,Viktor,173,85,88,49.13
Zyra,Jhin,320,149,171,46.56
Zyra,Nautilus,212,124,88,58.49
Zyra,Gwen,61,26,35,42.62
Zyra,XinZhao,100,46,54,46
Zyra,Zed,160,83,77,51.88
Zyra,Ezreal,367,189,178,51.5
Zyra,Sion,177,72,105,40.68
Zyra,Rengar,42,31,11,73.81
Zyra,Ziggs,65,31,34,47.69
Zyra,KSante,95,33,62,34.74
Zyra,Senna,74,33,41,44.59
Zyra,Trundle,92,46,46,50
Zyra,Lux,416,180,236,43.27
Zyra,Chogath,178,95,83,53.37
Zyra,Sejuani,103,40,63,38.83
Zyra,Mel,292,149,143,51.03
Zyra,Seraphine,152,65,87,42.76
Zyra,Quinn,52,21,31,40.38
Zyra,Ambessa,107,52,55,48.6
Zyra,Brand,100,49,51,49
Zyra,Draven,71,50,21,70.42
Zyra,Nami,164,90,74,54.88
Zyra,Mordekaiser,215,108,107,50.23
Zyra,Nunu,94,54,40,57.45
Zyra,KogMaw,56,24,32,42.86
Zyra,Vladimir,99,54,45,54.55
Zyra,Teemo,149,84,65,56.38
Zyra,Corki,77,34,43,44.16
Zyra,Renekton,84,50,34,59.52
Zyra,MonkeyKing,123,64,59,52.03
Zyra,Smolder,120,61,59,50.83
Zyra,Gnar,81,45,36,55.56
Zyra,Swain,173,58,115,33.53
Zyra,Zoe,61,28,33,45.9
Zyra,Nocturne,161,92,69,57.14
Zyra,Taric,31,15,16,48.39
Zyra,Urgot,74,37,37,50
Zyra,LeeSin,301,163,138,54.15
Zyra,Janna,37,23,14,62.16
Zyra,Vayne,183,103,80,56.28
Zyra,Neeko,121,73,48,60.33
Zyra,Alistar,69,30,39,43.48
Zyra,Garen,225,117,108,52
Zyra,Sivir,96,42,54,43.75
Zyra,Leblanc,117,47,70,40.17
Zyra,Kayle,87,36,51,41.38
Zyra,Qiyana,25,17,8,68
Zyra,Samira,98,52,46,53.06
Zyra,Morgana,188,110,78,58.51
Zyra,Camille,69,35,34,50.72
Zyra,Xayah,73,41,32,56.16
Zyra,Shen,105,52,53,49.52
Zyra,Karma,194,117,77,60.31
Zyra,Singed,45,20,25,44.44
Zyra,Ekko,121,56,65,46.28
Zyra,Aurora,127,68,59,53.54
Zyra,Sett,224,111,113,49.55
Zyra,Jinx,381,192,189,50.39
Zyra,Lillia,94,45,49,47.87
Zyra,Twitch,73,27,46,36.99
Zyra,Lulu,197,109,88,55.33
Zyra,Fiora,58,21,37,36.21
Zyra,FiddleSticks,85,59,26,69.41
Zyra,Leona,129,71,58,55.04
Zyra,Viego,227,96,131,42.29
Zyra,MasterYi,130,69,61,53.08
Zyra,Nasus,67,36,31,53.73
Zyra,Shaco,133,60,73,45.11
Zyra,Darius,254,138,116,54.33
Zyra,Fizz,68,38,30,55.88
Zyra,Hwei,103,69,34,66.99
Zyra,Amumu,198,88,110,44.44
Zyra,Thresh,292,169,123,57.88
Zyra,Olaf,31,9,22,29.03
Zyra,Udyr,71,32,39,45.07
Zyra,Varus,176,70,106,39.77
Zyra,Khazix,63,30,33,47.62
Zyra,Gragas,107,39,68,36.45
Zyra,Ryze,50,22,28,44
Zyra,Gangplank,68,41,27,60.29
Zyra,Vi,188,110,78,58.51
Zyra,Sona,14,11,3,78.57
Zyra,Volibear,145,83,62,57.24
Zyra,Heimerdinger,77,35,42,45.45
Zyra,Kled,27,10,17,37.04
Zyra,Lissandra,83,53,30,63.86
Zyra,Velkoz,78,25,53,32.05
Zyra,Azir,72,43,29,59.72
Zyra,Shyvana,35,15,20,42.86
Zyra,AurelionSol,51,24,27,47.06
Zyra,Soraka,67,24,43,35.82
Zyra,Bard,36,15,21,41.67
Zyra,Naafiri,58,30,28,51.72
Zyra,Xerath,151,66,85,43.71
Zyra,Taliyah,59,25,34,42.37
Zyra,Rammus,45,31,14,68.89
Zyra,Karthus,44,28,16,63.64
Zyra,Kalista,43,35,8,81.4
Zyra,Aphelios,74,34,40,45.95
Zyra,Galio,186,100,86,53.76
Zyra,Briar,87,47,40,54.02
Zyra,DrMundo,82,31,51,37.8
Zyra,Nidalee,65,43,22,66.15
Zyra,Ivern,16,9,7,56.25
Zyra,Riven,50,25,25,50
Zyra,Nilah,46,31,15,67.39
Zyra,Yuumi,98,32,66,32.65
Zyra,Orianna,92,47,45,51.09
Zyra,Elise,126,76,50,60.32
Zyra,Kaisa,224,114,110,50.89
Zyra,Jax,149,90,59,60.4
Zyra,Aatrox,135,80,55,59.26
Zyra,Pyke,124,72,52,58.06
Zyra,Tryndamere,75,44,31,58.67
Zyra,Syndra,104,55,49,52.88
Zyra,Cassiopeia,38,17,21,44.74
Zyra,Rakan,80,51,29,63.75
Zyra,Kennen,76,42,34,55.26
Zyra,Kassadin,27,14,13,51.85
Zyra,Renata,42,13,29,30.95
Zyra,Belveth,18,8,10,44.44
Zyra,Hecarim,50,27,23,54
Zyra,Anivia,55,34,21,61.82
Zyra,Annie,46,14,32,30.43
Zyra,Evelynn,32,13,19,40.63
Zyra,Maokai,61,21,40,34.43
Zyra,Zeri,88,44,44,50
Zyra,Talon,46,26,20,56.52
Zyra,Rumble,35,14,21,40
Zyra,Zilean,34,4,30,11.76
Zyra,RekSai,5,3,2,60
Zyra,TwistedFate,39,21,18,53.85
Zyra,Jayce,98,52,46,53.06
Zyra,Skarner,56,33,23,58.93
Kassadin,Gangplank,23,18,5,78.26
Kassadin,LeeSin,55,29,26,52.73
Kassadin,Aurora,27,14,13,51.85
Kassadin,Ashe,71,34,37,47.89
Kassadin,Morgana,28,13,15,46.43
Kassadin,Teemo,37,20,17,54.05
Kassadin,MasterYi,30,13,17,43.33
Kassadin,Katarina,31,13,18,41.94
Kassadin,Samira,40,17,23,42.5
Kassadin,Singed,25,11,14,44
Kassadin,Sylas,71,38,33,53.52
Kassadin,Evelynn,18,9,9,50
Kassadin,Mel,163,93,70,57.06
Kassadin,Varus,53,33,20,62.26
Kassadin,Karma,61,35,26,57.38
Kassadin,KSante,21,7,14,33.33
Kassadin,Nunu,42,23,19,54.76
Kassadin,Akshan,24,16,8,66.67
Kassadin,Ziggs,21,18,3,85.71
Kassadin,Seraphine,33,11,22,33.33
Kassadin,RekSai,8,5,3,62.5
Kassadin,Hwei,29,11,18,37.93
Kassadin,Nautilus,34,12,22,35.29
Kassadin,Yorick,38,27,11,71.05
Kassadin,Briar,25,11,14,44
Kassadin,Veigar,41,24,17,58.54
Kassadin,Yone,52,22,30,42.31
Kassadin,Vi,51,26,25,50.98
Kassadin,Caitlyn,95,60,35,63.16
Kassadin,Garen,58,38,20,65.52
Kassadin,Malzahar,32,20,12,62.5
Kassadin,Rakan,33,13,20,39.39
Kassadin,Ivern,6,3,3,50
Kassadin,Rammus,19,5,14,26.32
Kassadin,Chogath,56,19,37,33.93
Kassadin,Rumble,15,12,3,80
Kassadin,Maokai,26,18,8,69.23
Kassadin,Zed,20,8,12,40
Kassadin,Lux,49,30,19,61.22
Kassadin,Ekko,36,23,13,63.89
Kassadin,Riven,25,11,14,44
Kassadin,Rell,13,5,8,38.46
Kassadin,Amumu,48,24,24,50
Kassadin,Sion,40,17,23,42.5
Kassadin,Lucian,36,21,15,58.33
Kassadin,Lulu,43,22,21,51.16
Kassadin,JarvanIV,33,17,16,51.52
Kassadin,AurelionSol,21,10,11,47.62
Kassadin,Swain,41,26,15,63.41
Kassadin,Thresh,59,25,34,42.37
Kassadin,Aatrox,39,18,21,46.15
Kassadin,Orianna,16,9,7,56.25
Kassadin,Aphelios,28,9,19,32.14
Kassadin,Alistar,11,5,6,45.45
Kassadin,TahmKench,39,17,22,43.59
Kassadin,Xerath,36,14,22,38.89
Kassadin,Milio,35,18,17,51.43
Kassadin,Ornn,32,25,7,78.13
Kassadin,Elise,47,26,21,55.32
Kassadin,Mordekaiser,57,27,30,47.37
Kassadin,Zac,25,12,13,48
Kassadin,Yasuo,65,45,20,69.23
Kassadin,Diana,61,28,33,45.9
Kassadin,Udyr,8,3,5,37.5
Kassadin,Leblanc,41,18,23,43.9
Kassadin,Ezreal,113,59,54,52.21
Kassadin,Olaf,10,6,4,60
Kassadin,Syndra,26,12,14,46.15
Kassadin,Sejuani,31,17,14,54.84
Kassadin,Galio,43,19,24,44.19
Kassadin,Jhin,40,22,18,55
Kassadin,Lillia,25,3,22,12
Kassadin,Nami,40,14,26,35
Kassadin,Viego,51,33,18,64.71
Kassadin,Volibear,35,16,19,45.71
Kassadin,Kayle,23,12,11,52.17
Kassadin,Janna,23,18,5,78.26
Kassadin,DrMundo,37,21,16,56.76
Kassadin,XinZhao,29,17,12,58.62
Kassadin,Ahri,58,36,22,62.07
Kassadin,Sivir,23,13,10,56.52
Kassadin,Khazix,25,17,8,68
Kassadin,Darius,50,28,22,56
Kassadin,Belveth,3,0,3,0
Kassadin,Kaisa,60,37,23,61.67
Kassadin,Kayn,59,33,26,55.93
Kassadin,Fizz,21,13,8,61.9
Kassadin,MissFortune,82,34,48,41.46
Kassadin,MonkeyKing,23,6,17,26.09
Kassadin,Anivia,22,14,8,63.64
Kassadin,Vayne,58,32,26,55.17
Kassadin,Taric,3,3,0,100
Kassadin,Urgot,19,5,14,26.32
Kassadin,Bard,17,12,5,70.59
Kassadin,Nocturne,50,26,24,52
Kassadin,Taliyah,20,17,3,85
Kassadin,Braum,36,22,14,61.11
Kassadin,Senna,17,12,5,70.59
Kassadin,Rengar,13,7,6,53.85
Kassadin,Poppy,33,19,14,57.58
Kassadin,Jax,23,11,12,47.83
Kassadin,Pyke,39,13,26,33.33
Kassadin,Fiora,11,5,6,45.45
Kassadin,Viktor,40,22,18,55
Kassadin,Azir,9,3,6,33.33
Kassadin,Soraka,26,21,5,80.77
Kassadin,Shyvana,3,3,0,100
Kassadin,Yuumi,35,9,26,25.71
Kassadin,Shen,44,30,14,68.18
Kassadin,Zeri,21,5,16,23.81
Kassadin,Gragas,34,22,12,64.71
Kassadin,Kennen,8,6,2,75
Kassadin,Neeko,19,9,10,47.37
Kassadin,Warwick,62,44,18,70.97
Kassadin,Kled,11,8,3,72.73
Kassadin,Draven,29,14,15,48.28
Kassadin,Malphite,46,20,26,43.48
Kassadin,Talon,14,8,6,57.14
Kassadin,Skarner,19,14,5,73.68
Kassadin,Illaoi,24,21,3,87.5
Kassadin,Zoe,16,3,13,18.75
Kassadin,Camille,15,8,7,53.33
Kassadin,Smolder,15,8,7,53.33
Kassadin,Jinx,86,34,52,39.53
Kassadin,Zyra,27,13,14,48.15
Kassadin,Ambessa,37,19,18,51.35
Kassadin,Tryndamere,14,7,7,50
Kassadin,Velkoz,36,17,19,47.22
Kassadin,Renata,11,9,2,81.82
Kassadin,Qiyana,6,3,3,50
Kassadin,Kalista,13,10,3,76.92
Kassadin,Lissandra,23,18,5,78.26
Kassadin,Tristana,28,11,17,39.29
Kassadin,Shaco,29,20,9,68.97
Kassadin,Heimerdinger,16,14,2,87.5
Kassadin,Kindred,18,12,6,66.67
Kassadin,FiddleSticks,23,13,10,56.52
Kassadin,Corki,14,14,0,100
Kassadin,Gwen,36,23,13,63.89
Kassadin,Sona,9,0,9,0
Kassadin,Renekton,31,10,21,32.26
Kassadin,Akali,19,8,11,42.11
Kassadin,Vladimir,20,10,10,50
Kassadin,Nidalee,8,5,3,62.5
Kassadin,Leona,51,26,25,50.98
Kassadin,Blitzcrank,29,12,17,41.38
Kassadin,Quinn,13,5,8,38.46
Kassadin,Karthus,5,3,2,60
Kassadin,Nilah,11,8,3,72.73
Kassadin,Pantheon,57,27,30,47.37
Kassadin,Sett,35,18,17,51.43
Kassadin,Brand,21,17,4,80.95
Kassadin,Twitch,23,21,2,91.3
Kassadin,Zilean,7,7,0,100
Kassadin,Vex,25,11,14,44
Kassadin,Xayah,28,13,15,46.43
Kassadin,Nasus,18,5,13,27.78
Kassadin,Cassiopeia,7,5,2,71.43
Kassadin,Irelia,32,19,13,59.38
Kassadin,TwistedFate,7,2,5,28.57
Kassadin,Gnar,14,5,9,35.71
Kassadin,Trundle,13,8,5,61.54
Kassadin,Jayce,17,9,8,52.94
Kassadin,Naafiri,2,2,0,100
Kassadin,Ryze,8,3,5,37.5
Kassadin,Graves,13,5,8,38.46
Kassadin,Hecarim,9,3,6,33.33
Kassadin,KogMaw,9,3,6,33.33
Kassadin,Annie,5,2,3,40
Taliyah,Gangplank,18,10,8,55.56
Taliyah,LeeSin,97,53,44,54.64
Taliyah,Aurora,61,28,33,45.9
Taliyah,Ashe,98,37,61,37.76
Taliyah,Morgana,49,22,27,44.9
Taliyah,Cassiopeia,23,9,14,39.13
Taliyah,Kaisa,79,39,40,49.37
Taliyah,Volibear,71,34,37,47.89
Taliyah,Mel,109,57,52,52.29
Taliyah,Leona,66,35,31,53.03
Taliyah,Darius,102,52,50,50.98
Taliyah,Vi,65,33,32,50.77
Taliyah,Vayne,67,39,28,58.21
Taliyah,Yuumi,65,32,33,49.23
Taliyah,Shen,48,32,16,66.67
Taliyah,Viego,93,43,50,46.24
Taliyah,Yasuo,101,44,57,43.56
Taliyah,Hwei,66,40,26,60.61
Taliyah,Heimerdinger,19,10,9,52.63
Taliyah,Caitlyn,138,63,75,45.65
Taliyah,Blitzcrank,58,31,27,53.45
Taliyah,Yorick,44,19,25,43.18
Taliyah,Shaco,38,22,16,57.89
Taliyah,Sylas,95,51,44,53.68
Taliyah,Samira,42,20,22,47.62
Taliyah,Sett,64,37,27,57.81
Taliyah,Sejuani,46,17,29,36.96
Taliyah,Tristana,43,18,25,41.86
Taliyah,Varus,67,31,36,46.27
Taliyah,Veigar,37,19,18,51.35
Taliyah,KSante,42,21,21,50
Taliyah,Pantheon,93,52,41,55.91
Taliyah,JarvanIV,46,20,26,43.48
Taliyah,Karma,58,31,27,53.45
Taliyah,Irelia,37,16,21,43.24
Taliyah,Alistar,42,16,26,38.1
Taliyah,Teemo,41,15,26,36.59
Taliyah,Gragas,45,22,23,48.89
Taliyah,Lissandra,17,6,11,35.29
Taliyah,Lulu,83,36,47,43.37
Taliyah,MasterYi,57,24,33,42.11
Taliyah,Ekko,56,33,23,58.93
Taliyah,Smolder,48,26,22,54.17
Taliyah,Mordekaiser,65,36,29,55.38
Taliyah,Garen,77,29,48,37.66
Taliyah,Nocturne,51,18,33,35.29
Taliyah,Galio,66,38,28,57.58
Taliyah,Lux,115,42,73,36.52
Taliyah,Urgot,33,16,17,48.48
Taliyah,Kindred,18,10,8,55.56
Taliyah,Malphite,63,29,34,46.03
Taliyah,Twitch,38,19,19,50
Taliyah,Vex,35,14,21,40
Taliyah,Senna,32,17,15,53.13
Taliyah,MonkeyKing,57,33,24,57.89
Taliyah,Xerath,39,27,12,69.23
Taliyah,MissFortune,68,36,32,52.94
Taliyah,Rell,39,18,21,46.15
Taliyah,Evelynn,12,6,6,50
Taliyah,Yone,73,46,27,63.01
Taliyah,Warwick,44,15,29,34.09
Taliyah,Singed,21,9,12,42.86
Taliyah,Zed,40,20,20,50
Taliyah,Ambessa,56,31,25,55.36
Taliyah,Nunu,22,10,12,45.45
Taliyah,Nami,42,16,26,38.1
Taliyah,Katarina,24,11,13,45.83
Taliyah,Lucian,54,25,29,46.3
Taliyah,Braum,36,16,20,44.44
Taliyah,XinZhao,48,24,24,50
Taliyah,Jax,41,18,23,43.9
Taliyah,Rammus,9,3,6,33.33
Taliyah,Vladimir,23,12,11,52.17
Taliyah,Jhin,93,47,46,50.54
Taliyah,Seraphine,27,7,20,25.93
Taliyah,Jayce,32,13,19,40.63
Taliyah,Orianna,39,20,19,51.28
Taliyah,Olaf,27,14,13,51.85
Taliyah,Zyra,59,34,25,57.63
Taliyah,Chogath,64,41,23,64.06
Taliyah,Nautilus,91,34,57,37.36
Taliyah,Ezreal,132,67,65,50.76
Taliyah,Camille,21,11,10,52.38
Taliyah,Jinx,124,50,74,40.32
Taliyah,Milio,50,27,23,54
Taliyah,Gnar,41,24,17,58.54
Taliyah,Elise,55,22,33,40
Taliyah,Draven,25,15,10,60
Taliyah,Pyke,40,23,17,57.5
Taliyah,Anivia,14,3,11,21.43
Taliyah,Poppy,48,25,23,52.08
Taliyah,Thresh,74,55,19,74.32
Taliyah,Diana,69,38,31,55.07
Taliyah,Sion,34,16,18,47.06
Taliyah,KogMaw,16,6,10,37.5
Taliyah,Kassadin,20,3,17,15
Taliyah,Amumu,79,34,45,43.04
Taliyah,Malzahar,59,36,23,61.02
Taliyah,Nilah,28,19,9,67.86
Taliyah,Taric,10,8,2,80
Taliyah,Rumble,15,9,6,60
Taliyah,Ahri,90,45,45,50
Taliyah,DrMundo,16,7,9,43.75
Taliyah,Nidalee,14,8,6,57.14
Taliyah,Brand,32,14,18,43.75
Taliyah,Kalista,15,7,8,46.67
Taliyah,Briar,35,11,24,31.43
Taliyah,Aatrox,57,28,29,49.12
Taliyah,Tryndamere,21,8,13,38.1
Taliyah,AurelionSol,43,17,26,39.53
Taliyah,Rakan,42,13,29,30.95
Taliyah,Aphelios,25,17,8,68
Taliyah,Kayn,67,34,33,50.75
Taliyah,Neeko,21,17,4,80.95
Taliyah,Ziggs,24,7,17,29.17
Taliyah,Hecarim,18,16,2,88.89
Taliyah,Syndra,43,21,22,48.84
Taliyah,Lillia,24,13,11,54.17
Taliyah,Xayah,37,18,19,48.65
Taliyah,TahmKench,57,30,27,52.63
Taliyah,Kled,12,3,9,25
Taliyah,Velkoz,29,20,9,68.97
Taliyah,TwistedFate,23,9,14,39.13
Taliyah,Viktor,35,13,22,37.14
Taliyah,Illaoi,18,10,8,55.56
Taliyah,Corki,40,24,16,60
Taliyah,Renekton,26,18,8,69.23
Taliyah,Talon,14,5,9,35.71
Taliyah,Zeri,41,24,17,58.54
Taliyah,Fiora,33,21,12,63.64
Taliyah,Azir,20,15,5,75
Taliyah,Kayle,14,5,9,35.71
Taliyah,Rengar,14,12,2,85.71
Taliyah,Leblanc,12,3,9,25
Taliyah,Swain,44,19,25,43.18
Taliyah,Nasus,29,14,15,48.28
Taliyah,Janna,22,5,17,22.73
Taliyah,Sivir,31,7,24,22.58
Taliyah,Shyvana,14,9,5,64.29
Taliyah,Karthus,20,9,11,45
Taliyah,Gwen,29,8,21,27.59
Taliyah,Maokai,31,13,18,41.94
Taliyah,Ryze,35,18,17,51.43
Taliyah,Trundle,6,4,2,66.67
Taliyah,Quinn,24,5,19,20.83
Taliyah,Khazix,25,11,14,44
Taliyah,FiddleSticks,25,10,15,40
Taliyah,Ornn,30,16,14,53.33
Taliyah,Zoe,8,2,6,25
Taliyah,Riven,9,5,4,55.56
Taliyah,Akshan,14,7,7,50
Taliyah,Fizz,22,20,2,90.91
Taliyah,Kennen,22,8,14,36.36
Taliyah,Zilean,21,12,9,57.14
Taliyah,Annie,22,5,17,22.73
Taliyah,Ivern,8,2,6,25
Taliyah,Soraka,11,9,2,81.82
Taliyah,Graves,36,11,25,30.56
Taliyah,Udyr,21,11,10,52.38
Taliyah,Bard,18,8,10,44.44
Taliyah,Renata,10,5,5,50
Taliyah,Zac,37,21,16,56.76
Taliyah,Akali,27,16,11,59.26
Taliyah,Qiyana,11,3,8,27.27
Taliyah,Skarner,17,4,13,23.53
Taliyah,RekSai,3,3,0,100
Taliyah,Sona,8,3,5,37.5
Taliyah,Naafiri,8,3,5,37.5
Taliyah,Belveth,9,6,3,66.67
Trundle,Akali,83,37,46,44.58
Trundle,Belveth,30,15,15,50
Trundle,Varus,77,41,36,53.25
Trundle,Jhin,172,87,85,50.58
Trundle,Lulu,116,41,75,35.34
Trundle,Tryndamere,44,17,27,38.64
Trundle,Shaco,65,33,32,50.77
Trundle,Leblanc,56,30,26,53.57
Trundle,Caitlyn,252,122,130,48.41
Trundle,Morgana,146,68,78,46.58
Trundle,Mordekaiser,130,70,60,53.85
Trundle,Amumu,137,64,73,46.72
Trundle,Yone,167,96,71,57.49
Trundle,Karma,117,45,72,38.46
Trundle,Khazix,49,31,18,63.27
Trundle,Katarina,43,22,21,51.16
Trundle,Ezreal,248,132,116,53.23
Trundle,Lux,274,133,141,48.54
Trundle,Yorick,128,64,64,50
Trundle,Warwick,164,73,91,44.51
Trundle,Ahri,174,86,88,49.43
Trundle,Chogath,166,82,84,49.4
Trundle,Nocturne,115,60,55,52.17
Trundle,Lissandra,43,20,23,46.51
Trundle,MissFortune,236,132,104,55.93
Trundle,Rakan,75,41,34,54.67
Trundle,Renekton,51,32,19,62.75
Trundle,Jax,119,57,62,47.9
Trundle,Thresh,165,93,72,56.36
Trundle,Sett,175,90,85,51.43
Trundle,Nautilus,143,70,73,48.95
Trundle,Shen,106,47,59,44.34
Trundle,Mel,231,128,103,55.41
Trundle,Galio,127,64,63,50.39
Trundle,Annie,46,15,31,32.61
Trundle,Kennen,40,23,17,57.5
Trundle,Illaoi,61,33,28,54.1
Trundle,Malzahar,136,57,79,41.91
Trundle,Vayne,145,70,75,48.28
Trundle,Milio,76,39,37,51.32
Trundle,Volibear,113,49,64,43.36
Trundle,Elise,58,23,35,39.66
Trundle,Syndra,77,32,45,41.56
Trundle,Leona,103,59,44,57.28
Trundle,Lucian,84,42,42,50
Trundle,Kayn,173,73,100,42.2
Trundle,Yasuo,178,73,105,41.01
Trundle,Yuumi,54,24,30,44.44
Trundle,Neeko,47,21,26,44.68
Trundle,Sejuani,74,35,39,47.3
Trundle,Viktor,62,23,39,37.1
Trundle,Ashe,236,112,124,47.46
Trundle,Braum,76,36,40,47.37
Trundle,Riven,27,17,10,62.96
Trundle,MonkeyKing,79,41,38,51.9
Trundle,AurelionSol,28,6,22,21.43
Trundle,Poppy,59,19,40,32.2
Trundle,TahmKench,145,94,51,64.83
Trundle,Diana,132,60,72,45.45
Trundle,Zyra,92,46,46,50
Trundle,Urgot,50,30,20,60
Trundle,Karthus,22,12,10,54.55
Trundle,Kaisa,158,87,71,55.06
Trundle,Swain,87,36,51,41.38
Trundle,DrMundo,89,38,51,42.7
Trundle,Briar,63,30,33,47.62
Trundle,Nunu,87,52,35,59.77
Trundle,Ambessa,91,38,53,41.76
Trundle,Rell,72,41,31,56.94
Trundle,Aatrox,87,45,42,51.72
Trundle,Vladimir,58,24,34,41.38
Trundle,Draven,58,18,40,31.03
Trundle,Pyke,82,35,47,42.68
Trundle,Garen,168,77,91,45.83
Trundle,Soraka,52,21,31,40.38
Trundle,Camille,14,9,5,64.29
Trundle,Zeri,31,17,14,54.84
Trundle,Viego,102,40,62,39.22
Trundle,Darius,198,93,105,46.97
Trundle,Jinx,284,125,159,44.01
Trundle,Zoe,27,16,11,59.26
Trundle,KSante,73,51,22,69.86
Trundle,Evelynn,24,14,10,58.33
Trundle,Aurora,95,46,49,48.42
Trundle,Lillia,66,40,26,60.61
Trundle,Zed,100,51,49,51
Trundle,Sivir,54,25,29,46.3
Trundle,Hwei,76,34,42,44.74
Trundle,Nilah,49,26,23,53.06
Trundle,Nasus,92,38,54,41.3
Trundle,Akshan,35,17,18,48.57
Trundle,Tristana,88,38,50,43.18
Trundle,Twitch,80,39,41,48.75
Trundle,Seraphine,75,53,22,70.67
Trundle,Senna,74,34,40,45.95
Trundle,Taric,17,9,8,52.94
Trundle,Maokai,56,32,24,57.14
Trundle,Gragas,70,23,47,32.86
Trundle,Janna,41,13,28,31.71
Trundle,Rengar,28,11,17,39.29
Trundle,Ryze,39,17,22,43.59
Trundle,Samira,78,47,31,60.26
Trundle,Kindred,43,14,29,32.56
Trundle,LeeSin,131,58,73,44.27
Trundle,Velkoz,58,17,41,29.31
Trundle,Gnar,47,24,23,51.06
Trundle,Graves,43,13,30,30.23
Trundle,Blitzcrank,95,52,43,54.74
Trundle,Skarner,47,24,23,51.06
Trundle,TwistedFate,30,21,9,70
Trundle,MasterYi,111,55,56,49.55
Trundle,Ekko,81,36,45,44.44
Trundle,Aphelios,53,21,32,39.62
Trundle,Rammus,50,20,30,40
Trundle,Bard,18,6,12,33.33
Trundle,Sion,100,47,53,47
Trundle,Ivern,36,23,13,63.89
Trundle,Jayce,45,22,23,48.89
Trundle,Hecarim,23,8,15,34.78
Trundle,Malphite,88,34,54,38.64
Trundle,Teemo,109,41,68,37.61
Trundle,FiddleSticks,58,30,28,51.72
Trundle,Qiyana,16,12,4,75
Trundle,JarvanIV,72,38,34,52.78
Trundle,Nami,122,69,53,56.56
Trundle,Kayle,51,21,30,41.18
Trundle,Olaf,44,18,26,40.91
Trundle,Pantheon,185,106,79,57.3
Trundle,Ziggs,33,12,21,36.36
Trundle,Kled,24,8,16,33.33
Trundle,Irelia,66,44,22,66.67
Trundle,Xayah,60,21,39,35
Trundle,Cassiopeia,24,3,21,12.5
Trundle,Fizz,70,46,24,65.71
Trundle,Naafiri,32,11,21,34.38
Trundle,Xerath,91,39,52,42.86
Trundle,Sylas,122,74,48,60.66
Trundle,Zilean,31,19,12,61.29
Trundle,Gangplank,39,25,14,64.1
Trundle,Zac,67,30,37,44.78
Trundle,Renata,26,12,14,46.15
Trundle,Shyvana,25,11,14,44
Trundle,Gwen,63,26,37,41.27
Trundle,Orianna,53,30,23,56.6
Trundle,Veigar,106,51,55,48.11
Trundle,Azir,42,28,14,66.67
Trundle,Ornn,59,24,35,40.68
Trundle,XinZhao,63,29,34,46.03
Trundle,Vi,117,47,70,40.17
Trundle,Alistar,59,28,31,47.46
Trundle,Brand,49,32,17,65.31
Trundle,Corki,52,21,31,40.38
Trundle,Smolder,70,42,28,60
Trundle,Quinn,32,15,17,46.88
Trundle,RekSai,5,3,2,60
Trundle,Talon,49,26,23,53.06
Trundle,Kalista,46,30,16,65.22
Trundle,Udyr,47,33,14,70.21
Trundle,Heimerdinger,33,18,15,54.55
Trundle,Taliyah,6,2,4,33.33
Trundle,KogMaw,24,12,12,50
Trundle,Anivia,27,20,7,74.07
Trundle,Rumble,25,11,14,44
Trundle,Fiora,27,20,7,74.07
Trundle,Nidalee,14,9,5,64.29
Trundle,Vex,40,16,24,40
Trundle,Singed,22,17,5,77.27
Trundle,Kassadin,13,5,8,38.46
Trundle,Sona,6,3,3,50
Belveth,Trundle,30,15,15,50
Belveth,Sylas,69,33,36,47.83
Belveth,Zac,24,14,10,58.33
Belveth,MissFortune,55,29,26,52.73
Belveth,Seraphine,28,6,22,21.43
Belveth,Mel,81,40,41,49.38
Belveth,Lulu,49,29,20,59.18
Belveth,Jax,36,22,14,61.11
Belveth,Yasuo,69,35,34,50.72
Belveth,Chogath,29,12,17,41.38
Belveth,Heimerdinger,24,12,12,50
Belveth,Ashe,75,39,36,52
Belveth,Orianna,36,20,16,55.56
Belveth,LeeSin,68,37,31,54.41
Belveth,Darius,71,41,30,57.75
Belveth,Kayn,28,11,17,39.29
Belveth,Ryze,25,11,14,44
Belveth,Jinx,117,52,65,44.44
Belveth,Pantheon,60,35,25,58.33
Belveth,Vladimir,34,9,25,26.47
Belveth,Ekko,21,7,14,33.33
Belveth,Ambessa,34,17,17,50
Belveth,Braum,44,22,22,50
Belveth,Teemo,48,17,31,35.42
Belveth,Mordekaiser,52,28,24,53.85
Belveth,Yone,77,28,49,36.36
Belveth,Maokai,16,8,8,50
Belveth,Ziggs,11,6,5,54.55
Belveth,Singed,8,3,5,37.5
Belveth,Akshan,19,11,8,57.89
Belveth,Velkoz,27,14,13,51.85
Belveth,Gragas,33,21,12,63.64
Belveth,Varus,34,18,16,52.94
Belveth,Camille,28,10,18,35.71
Belveth,Zeri,18,13,5,72.22
Belveth,Viego,70,27,43,38.57
Belveth,Sett,57,28,29,49.12
Belveth,Akali,37,13,24,35.14
Belveth,MonkeyKing,39,20,19,51.28
Belveth,Volibear,71,34,37,47.89
Belveth,Irelia,36,19,17,52.78
Belveth,Caitlyn,96,49,47,51.04
Belveth,Morgana,41,12,29,29.27
Belveth,Yorick,39,19,20,48.72
Belveth,Amumu,72,45,27,62.5
Belveth,Sivir,25,8,17,32
Belveth,Lux,101,48,53,47.52
Belveth,Tryndamere,18,8,10,44.44
Belveth,Ahri,48,28,20,58.33
Belveth,Samira,31,12,19,38.71
Belveth,Senna,32,19,13,59.38
Belveth,Renekton,25,6,19,24
Belveth,Diana,42,13,29,30.95
Belveth,Brand,24,16,8,66.67
Belveth,Jayce,32,14,18,43.75
Belveth,Rengar,18,9,9,50
Belveth,Nidalee,22,8,14,36.36
Belveth,Garen,48,14,34,29.17
Belveth,Twitch,45,24,21,53.33
Belveth,Nami,55,24,31,43.64
Belveth,Malzahar,38,11,27,28.95
Belveth,Milio,36,17,19,47.22
Belveth,Rumble,22,8,14,36.36
Belveth,Ezreal,94,45,49,47.87
Belveth,Poppy,30,4,26,13.33
Belveth,Shen,29,17,12,58.62
Belveth,Kassadin,3,3,0,100
Belveth,Karma,52,38,14,73.08
Belveth,Zed,44,36,8,81.82
Belveth,Pyke,17,5,12,29.41
Belveth,Annie,16,10,6,62.5
Belveth,Kaisa,53,29,24,54.72
Belveth,FiddleSticks,16,10,6,62.5
Belveth,Fizz,17,14,3,82.35
Belveth,Jhin,66,36,30,54.55
Belveth,Blitzcrank,41,28,13,68.29
Belveth,Nasus,32,10,22,31.25
Belveth,Sejuani,6,3,3,50
Belveth,Leblanc,12,7,5,58.33
Belveth,Skarner,21,13,8,61.9
Belveth,Gwen,24,9,15,37.5
Belveth,Shyvana,11,6,5,54.55
Belveth,XinZhao,35,17,18,48.57
Belveth,TwistedFate,15,6,9,40
Belveth,Quinn,8,5,3,62.5
Belveth,Warwick,41,27,14,65.85
Belveth,Sona,8,5,3,62.5
Belveth,Thresh,100,58,42,58
Belveth,Sion,40,19,21,47.5
Belveth,Yuumi,26,3,23,11.54
Belveth,Talon,23,9,14,39.13
Belveth,Tristana,34,15,19,44.12
Belveth,Elise,33,15,18,45.45
Belveth,Kindred,17,15,2,88.24
Belveth,Syndra,17,12,5,70.59
Belveth,Xerath,28,20,8,71.43
Belveth,Hecarim,23,11,12,47.83
Belveth,Ornn,28,17,11,60.71
Belveth,Lucian,46,23,23,50
Belveth,Kalista,14,9,5,64.29
Belveth,Leona,56,29,27,51.79
Belveth,DrMundo,25,16,9,64
Belveth,Khazix,23,15,8,65.22
Belveth,Vayne,31,16,15,51.61
Belveth,MasterYi,32,20,12,62.5
Belveth,Anivia,20,10,10,50
Belveth,Swain,37,15,22,40.54
Belveth,Nunu,20,9,11,45
Belveth,Lissandra,18,5,13,27.78
Belveth,Malphite,46,21,25,45.65
Belveth,Zoe,16,6,10,37.5
Belveth,Urgot,12,0,12,0
Belveth,Briar,37,11,26,29.73
Belveth,Corki,16,7,9,43.75
Belveth,Soraka,14,3,11,21.43
Belveth,Kled,6,6,0,100
Belveth,Zyra,18,10,8,55.56
Belveth,Xayah,26,15,11,57.69
Belveth,Bard,17,8,9,47.06
Belveth,Riven,10,7,3,70
Belveth,Zilean,14,11,3,78.57
Belveth,Rakan,15,8,7,53.33
Belveth,Katarina,21,16,5,76.19
Belveth,Vi,45,17,28,37.78
Belveth,Cassiopeia,19,13,6,68.42
Belveth,TahmKench,31,15,16,48.39
Belveth,Illaoi,8,6,2,75
Belveth,Veigar,38,9,29,23.68
Belveth,Alistar,22,10,12,45.45
Belveth,Aphelios,28,12,16,42.86
Belveth,Rell,30,16,14,53.33
Belveth,Qiyana,5,5,0,100
Belveth,Naafiri,4,0,4,0
Belveth,Nautilus,44,24,20,54.55
Belveth,Viktor,51,24,27,47.06
Belveth,Gangplank,14,11,3,78.57
Belveth,Karthus,7,7,0,100
Belveth,Renata,7,3,4,42.86
Belveth,Galio,46,36,10,78.26
Belveth,Neeko,7,3,4,42.86
Belveth,Kennen,10,6,4,60
Belveth,JarvanIV,31,9,22,29.03
Belveth,Rammus,11,5,6,45.45
Belveth,Shaco,18,16,2,88.89
Belveth,Nocturne,36,20,16,55.56
Belveth,Janna,20,13,7,65
Belveth,KSante,24,11,13,45.83
Belveth,Hwei,17,11,6,64.71
Belveth,Kayle,25,17,8,68
Belveth,Udyr,11,5,6,45.45
Belveth,Smolder,15,5,10,33.33
Belveth,Aatrox,28,6,22,21.43
Belveth,Graves,18,6,12,33.33
Belveth,RekSai,5,3,2,60
Belveth,Nilah,14,8,6,57.14
Belveth,Olaf,4,0,4,0
Belveth,KogMaw,9,7,2,77.78
Belveth,AurelionSol,13,8,5,61.54
Belveth,Draven,36,10,26,27.78
Belveth,Ivern,5,2,3,40
Belveth,Azir,17,8,9,47.06
Belveth,Gnar,24,14,10,58.33
Belveth,Aurora,44,28,16,63.64
Belveth,Fiora,16,10,6,62.5
Belveth,Evelynn,6,0,6,0
Belveth,Vex,11,6,5,54.55
Belveth,Lillia,9,6,3,66.67
Belveth,Taliyah,9,3,6,33.33
Taric,Yorick,51,13,38,25.49
Taric,Viego,58,20,38,34.48
Taric,AurelionSol,35,18,17,51.43
Taric,Ashe,111,53,58,47.75
Taric,Milio,32,18,14,56.25
Taric,Shen,45,22,23,48.89
Taric,Karthus,13,4,9,30.77
Taric,Ekko,46,22,24,47.83
Taric,Ezreal,99,46,53,46.46
Taric,Soraka,29,11,18,37.93
Taric,Sylas,65,43,22,66.15
Taric,Briar,41,22,19,53.66
Taric,Lux,104,56,48,53.85
Taric,Neeko,23,15,8,65.22
Taric,Blitzcrank,42,20,22,47.62
Taric,Veigar,38,21,17,55.26
Taric,Samira,39,29,10,74.36
Taric,Pantheon,108,53,55,49.07
Taric,Chogath,60,28,32,46.67
Taric,Warwick,48,19,29,39.58
Taric,Yone,59,31,28,52.54
Taric,Tristana,24,17,7,70.83
Taric,Zyra,31,16,15,51.61
Taric,Urgot,28,11,17,39.29
Taric,XinZhao,57,33,24,57.89
Taric,Mel,87,48,39,55.17
Taric,Draven,22,9,13,40.91
Taric,Thresh,107,63,44,58.88
Taric,Teemo,55,35,20,63.64
Taric,MasterYi,52,31,21,59.62
Taric,Zed,43,22,21,51.16
Taric,Jhin,94,51,43,54.26
Taric,Karma,43,25,18,58.14
Taric,Sett,48,33,15,68.75
Taric,Nocturne,43,19,24,44.19
Taric,Jinx,146,67,79,45.89
Taric,Fizz,17,14,3,82.35
Taric,Ornn,29,10,19,34.48
Taric,FiddleSticks,15,7,8,46.67
Taric,Yasuo,78,37,41,47.44
Taric,Irelia,51,26,25,50.98
Taric,Zilean,17,6,11,35.29
Taric,Elise,22,9,13,40.91
Taric,Diana,84,42,42,50
Taric,TwistedFate,18,8,10,44.44
Taric,Xayah,27,21,6,77.78
Taric,Rakan,32,23,9,71.88
Taric,Kayn,55,38,17,69.09
Taric,Ahri,56,27,29,48.21
Taric,Leona,63,32,31,50.79
Taric,Darius,89,46,43,51.69
Taric,MonkeyKing,34,15,19,44.12
Taric,Caitlyn,84,30,54,35.71
Taric,Sona,10,4,6,40
Taric,Trundle,17,8,9,47.06
Taric,Heimerdinger,14,8,6,57.14
Taric,Malphite,50,17,33,34
Taric,Garen,60,31,29,51.67
Taric,Sejuani,33,19,14,57.58
Taric,Alistar,28,15,13,53.57
Taric,Fiora,28,14,14,50
Taric,MissFortune,98,58,40,59.18
Taric,Poppy,30,13,17,43.33
Taric,Yuumi,35,24,11,68.57
Taric,JarvanIV,41,16,25,39.02
Taric,Katarina,48,23,25,47.92
Taric,Nami,36,20,16,55.56
Taric,Sion,43,29,14,67.44
Taric,Viktor,49,29,20,59.18
Taric,Braum,26,13,13,50
Taric,LeeSin,49,39,10,79.59
Taric,Sivir,17,6,11,35.29
Taric,Nautilus,87,40,47,45.98
Taric,Vladimir,23,12,11,52.17
Taric,Kassadin,3,0,3,0
Taric,Lulu,57,30,27,52.63
Taric,Ambessa,38,20,18,52.63
Taric,Taliyah,10,2,8,20
Taric,Qiyana,7,2,5,28.57
Taric,Lucian,33,19,14,57.58
Taric,Amumu,41,17,24,41.46
Taric,Akali,30,22,8,73.33
Taric,Pyke,51,30,21,58.82
Taric,Shaco,25,19,6,76
Taric,Kindred,11,3,8,27.27
Taric,Cassiopeia,24,14,10,58.33
Taric,Lillia,31,13,18,41.94
Taric,TahmKench,48,28,20,58.33
Taric,Hecarim,11,6,5,54.55
Taric,Kaisa,72,42,30,58.33
Taric,Skarner,18,6,12,33.33
Taric,Varus,53,25,28,47.17
Taric,Rengar,20,3,17,15
Taric,Twitch,43,24,19,55.81
Taric,DrMundo,17,5,12,29.41
Taric,Swain,50,21,29,42
Taric,KSante,28,17,11,60.71
Taric,Xerath,21,14,7,66.67
Taric,Volibear,55,35,20,63.64
Taric,Smolder,42,30,12,71.43
Taric,Vex,26,9,17,34.62
Taric,Azir,20,8,12,40
Taric,Gragas,44,28,16,63.64
Taric,Talon,19,16,3,84.21
Taric,Galio,33,25,8,75.76
Taric,Aatrox,31,14,17,45.16
Taric,Nunu,36,13,23,36.11
Taric,Corki,23,17,6,73.91
Taric,Zac,33,21,12,63.64
Taric,Seraphine,30,11,19,36.67
Taric,Orianna,26,10,16,38.46
Taric,Kalista,18,11,7,61.11
Taric,Riven,26,23,3,88.46
Taric,Khazix,16,11,5,68.75
Taric,Lissandra,19,13,6,68.42
Taric,Vayne,59,21,38,35.59
Taric,Graves,22,16,6,72.73
Taric,Gwen,28,18,10,64.29
Taric,Nidalee,15,2,13,13.33
Taric,Kled,5,3,2,60
Taric,Udyr,20,15,5,75
Taric,Vi,60,21,39,35
Taric,Velkoz,36,17,19,47.22
Taric,Brand,15,9,6,60
Taric,Jax,31,14,17,45.16
Taric,Gnar,26,16,10,61.54
Taric,Senna,15,13,2,86.67
Taric,Zoe,23,14,9,60.87
Taric,Hwei,40,25,15,62.5
Taric,Annie,22,13,9,59.09
Taric,Morgana,33,19,14,57.58
Taric,Renekton,21,13,8,61.9
Taric,Naafiri,14,3,11,21.43
Taric,Olaf,12,5,7,41.67
Taric,Renata,18,5,13,27.78
Taric,Gangplank,25,16,9,64
Taric,Malzahar,33,14,19,42.42
Taric,Kayle,20,7,13,35
Taric,Bard,16,8,8,50
Taric,Rell,22,13,9,59.09
Taric,KogMaw,6,4,2,66.67
Taric,Syndra,44,27,17,61.36
Taric,Ivern,13,11,2,84.62
Taric,Zeri,13,8,5,61.54
Taric,Jayce,19,9,10,47.37
Taric,Camille,15,6,9,40
Taric,Anivia,8,0,8,0
Taric,Ziggs,10,3,7,30
Taric,Mordekaiser,35,22,13,62.86
Taric,Evelynn,9,5,4,55.56
Taric,Quinn,17,3,14,17.65
Taric,Rumble,15,10,5,66.67
Taric,Aurora,26,18,8,69.23
Taric,Leblanc,14,9,5,64.29
Taric,Janna,4,0,4,0
Taric,RekSai,7,5,2,71.43
Taric,Nasus,14,2,12,14.29
Taric,Illaoi,25,11,14,44
Taric,Maokai,10,5,5,50
Taric,Rammus,8,0,8,0
Taric,Tryndamere,21,11,10,52.38
Taric,Kennen,11,6,5,54.55
Taric,Akshan,11,8,3,72.73
Taric,Aphelios,16,2,14,12.5
Taric,Shyvana,3,0,3,0
Taric,Singed,3,3,0,100
Taric,Ryze,17,6,11,35.29
Taric,Nilah,12,6,6,50
Zilean,Aatrox,57,31,26,54.39
Zilean,JarvanIV,46,27,19,58.7
Zilean,Chogath,101,50,51,49.5
Zilean,MissFortune,94,44,50,46.81
Zilean,Yuumi,49,23,26,46.94
Zilean,Twitch,43,24,19,55.81
Zilean,Lillia,47,21,26,44.68
Zilean,Katarina,44,29,15,65.91
Zilean,Vayne,85,39,46,45.88
Zilean,Blitzcrank,70,34,36,48.57
Zilean,Jax,63,32,31,50.79
Zilean,Yorick,57,28,29,49.12
Zilean,Yasuo,116,63,53,54.31
Zilean,Tristana,46,25,21,54.35
Zilean,Lux,134,83,51,61.94
Zilean,Warwick,83,51,32,61.45
Zilean,Ahri,86,46,40,53.49
Zilean,Ezreal,131,69,62,52.67
Zilean,Sivir,30,15,15,50
Zilean,Ryze,29,12,17,41.38
Zilean,Ashe,138,59,79,42.75
Zilean,Senna,35,20,15,57.14
Zilean,Darius,89,48,41,53.93
Zilean,Kayn,72,37,35,51.39
Zilean,Fizz,18,6,12,33.33
Zilean,Caitlyn,176,94,82,53.41
Zilean,Nautilus,86,37,49,43.02
Zilean,Heimerdinger,30,19,11,63.33
Zilean,Velkoz,41,17,24,41.46
Zilean,Teemo,83,33,50,39.76
Zilean,Morgana,65,40,25,61.54
Zilean,TahmKench,44,16,28,36.36
Zilean,Rengar,24,13,11,54.17
Zilean,Sylas,86,54,32,62.79
Zilean,Lulu,95,55,40,57.89
Zilean,Kled,19,8,11,42.11
Zilean,Jhin,125,53,72,42.4
Zilean,Veigar,80,39,41,48.75
Zilean,Nocturne,67,33,34,49.25
Zilean,Thresh,135,65,70,48.15
Zilean,Corki,47,26,21,55.32
Zilean,Rammus,21,13,8,61.9
Zilean,Illaoi,35,18,17,51.43
Zilean,Evelynn,28,9,19,32.14
Zilean,Mel,123,73,50,59.35
Zilean,Xayah,24,21,3,87.5
Zilean,Gragas,72,31,41,43.06
Zilean,Azir,23,15,8,65.22
Zilean,Volibear,70,44,26,62.86
Zilean,Irelia,44,25,19,56.82
Zilean,Shaco,54,28,26,51.85
Zilean,AurelionSol,23,13,10,56.52
Zilean,Nilah,20,13,7,65
Zilean,Smolder,52,25,27,48.08
Zilean,Nami,77,20,57,25.97
Zilean,Gnar,41,18,23,43.9
Zilean,MonkeyKing,45,16,29,35.56
Zilean,Milio,40,20,20,50
Zilean,Yone,106,54,52,50.94
Zilean,Braum,55,29,26,52.73
Zilean,Viego,63,42,21,66.67
Zilean,Draven,33,15,18,45.45
Zilean,Soraka,19,7,12,36.84
Zilean,Viktor,52,24,28,46.15
Zilean,Zed,66,30,36,45.45
Zilean,Taric,17,11,6,64.71
Zilean,MasterYi,61,42,19,68.85
Zilean,Riven,19,9,10,47.37
Zilean,Akali,55,22,33,40
Zilean,Sona,17,6,11,35.29
Zilean,Sion,60,39,21,65
Zilean,Poppy,44,31,13,70.45
Zilean,Olaf,22,15,7,68.18
Zilean,Skarner,30,8,22,26.67
Zilean,Aphelios,48,23,25,47.92
Zilean,Gangplank,18,10,8,55.56
Zilean,Ivern,29,17,12,58.62
Zilean,Urgot,28,10,18,35.71
Zilean,Leblanc,33,12,21,36.36
Zilean,Vi,65,37,28,56.92
Zilean,Kayle,32,21,11,65.63
Zilean,Bard,14,7,7,50
Zilean,Kindred,25,6,19,24
Zilean,Syndra,59,27,32,45.76
Zilean,Amumu,85,42,43,49.41
Zilean,Jinx,163,81,82,49.69
Zilean,Rell,51,34,17,66.67
Zilean,LeeSin,68,36,32,52.94
Zilean,Ekko,44,18,26,40.91
Zilean,Varus,49,21,28,42.86
Zilean,Garen,114,50,64,43.86
Zilean,Shyvana,23,8,15,34.78
Zilean,Leona,65,33,32,50.77
Zilean,Kaisa,90,58,32,64.44
Zilean,Singed,11,2,9,18.18
Zilean,Graves,20,10,10,50
Zilean,Sejuani,50,13,37,26
Zilean,Malphite,53,28,25,52.83
Zilean,Nasus,42,22,20,52.38
Zilean,Briar,23,11,12,47.83
Zilean,Galio,63,35,28,55.56
Zilean,Swain,33,8,25,24.24
Zilean,Elise,53,31,22,58.49
Zilean,Karma,96,55,41,57.29
Zilean,Annie,22,12,10,54.55
Zilean,Trundle,31,12,19,38.71
Zilean,Neeko,37,28,9,75.68
Zilean,Ziggs,22,14,8,63.64
Zilean,Pantheon,133,65,68,48.87
Zilean,Hecarim,25,18,7,72
Zilean,Ambessa,31,22,9,70.97
Zilean,Udyr,28,14,14,50
Zilean,KogMaw,19,6,13,31.58
Zilean,Aurora,46,19,27,41.3
Zilean,Janna,22,5,17,22.73
Zilean,Diana,86,46,40,53.49
Zilean,Sett,72,27,45,37.5
Zilean,Jayce,19,17,2,89.47
Zilean,Xerath,32,23,9,71.88
Zilean,Lissandra,25,18,7,72
Zilean,Samira,41,29,12,70.73
Zilean,Shen,28,22,6,78.57
Zilean,Gwen,26,10,16,38.46
Zilean,Malzahar,65,49,16,75.38
Zilean,Nunu,39,31,8,79.49
Zilean,Nidalee,27,19,8,70.37
Zilean,Alistar,43,27,16,62.79
Zilean,Vladimir,51,31,20,60.78
Zilean,Zoe,33,22,11,66.67
Zilean,TwistedFate,30,15,15,50
Zilean,Zeri,21,14,7,66.67
Zilean,Mordekaiser,59,26,33,44.07
Zilean,Belveth,14,3,11,21.43
Zilean,Renata,27,13,14,48.15
Zilean,Seraphine,13,6,7,46.15
Zilean,FiddleSticks,30,17,13,56.67
Zilean,DrMundo,31,20,11,64.52
Zilean,Fiora,22,13,9,59.09
Zilean,Zac,35,22,13,62.86
Zilean,Akshan,25,13,12,52
Zilean,Karthus,25,18,7,72
Zilean,Vex,25,11,14,44
Zilean,Maokai,35,27,8,77.14
Zilean,Pyke,21,16,5,76.19
Zilean,Rakan,27,18,9,66.67
Zilean,Orianna,28,19,9,67.86
Zilean,Quinn,23,10,13,43.48
Zilean,Renekton,31,21,10,67.74
Zilean,Brand,34,17,17,50
Zilean,Kalista,17,15,2,88.24
Zilean,Lucian,36,21,15,58.33
Zilean,Zyra,34,30,4,88.24
Zilean,Anivia,17,9,8,52.94
Zilean,Camille,20,16,4,80
Zilean,Kassadin,7,0,7,0
Zilean,Talon,20,16,4,80
Zilean,Ornn,24,11,13,45.83
Zilean,Rumble,22,16,6,72.73
Zilean,XinZhao,15,4,11,26.67
Zilean,Khazix,28,7,21,25
Zilean,Hwei,40,25,15,62.5
Zilean,KSante,40,24,16,60
Zilean,Taliyah,21,9,12,42.86
Zilean,Naafiri,18,14,4,77.78
Zilean,Kennen,5,0,5,0
Zilean,Cassiopeia,19,6,13,31.58
Zilean,RekSai,11,3,8,27.27
Zilean,Qiyana,9,3,6,33.33
Zilean,Tryndamere,9,6,3,66.67
Orianna,Sett,125,58,67,46.4
Orianna,Kindred,27,14,13,51.85
Orianna,Mel,276,172,104,62.32
Orianna,Twitch,74,38,36,51.35
Orianna,Lulu,165,73,92,44.24
Orianna,Sejuani,79,30,49,37.97
Orianna,Viktor,138,65,73,47.1
Orianna,Jinx,303,149,154,49.17
Orianna,Lux,246,124,122,50.41
Orianna,Malphite,145,77,68,53.1
Orianna,Ivern,52,28,24,53.85
Orianna,Ahri,179,93,86,51.96
Orianna,Ashe,203,96,107,47.29
Orianna,Warwick,140,68,72,48.57
Orianna,Vladimir,98,54,44,55.1
Orianna,Akali,107,78,29,72.9
Orianna,Vayne,139,82,57,58.99
Orianna,Nami,110,61,49,55.45
Orianna,Viego,167,61,106,36.53
Orianna,Hwei,93,58,35,62.37
Orianna,Gnar,64,38,26,59.38
Orianna,Belveth,36,16,20,44.44
Orianna,Samira,70,30,40,42.86
Orianna,TahmKench,100,62,38,62
Orianna,Yone,109,64,45,58.72
Orianna,Kalista,33,21,12,63.64
Orianna,Nautilus,178,99,79,55.62
Orianna,Ornn,57,21,36,36.84
Orianna,Veigar,90,39,51,43.33
Orianna,Yasuo,148,77,71,52.03
Orianna,Pantheon,195,102,93,52.31
Orianna,Zac,60,35,25,58.33
Orianna,Kayn,115,67,48,58.26
Orianna,Zed,93,48,45,51.61
Orianna,Caitlyn,227,122,105,53.74
Orianna,Janna,48,17,31,35.42
Orianna,Camille,56,33,23,58.93
Orianna,Udyr,41,22,19,53.66
Orianna,Jhin,174,107,67,61.49
Orianna,Talon,58,33,25,56.9
Orianna,Xerath,90,42,48,46.67
Orianna,Soraka,48,20,28,41.67
Orianna,Briar,47,28,19,59.57
Orianna,Ekko,84,43,41,51.19
Orianna,Urgot,57,32,25,56.14
Orianna,Nasus,56,31,25,55.36
Orianna,Amumu,132,67,65,50.76
Orianna,Malzahar,83,44,39,53.01
Orianna,MissFortune,238,120,118,50.42
Orianna,Vex,46,14,32,30.43
Orianna,Kaisa,151,58,93,38.41
Orianna,Pyke,87,42,45,48.28
Orianna,KSante,62,33,29,53.23
Orianna,Shaco,47,18,29,38.3
Orianna,Diana,120,48,72,40
Orianna,Yuumi,73,22,51,30.14
Orianna,Shen,87,38,49,43.68
Orianna,Ziggs,39,26,13,66.67
Orianna,Swain,116,47,69,40.52
Orianna,Garen,183,81,102,44.26
Orianna,LeeSin,195,114,81,58.46
Orianna,Jayce,51,22,29,43.14
Orianna,MonkeyKing,63,44,19,69.84
Orianna,Azir,59,17,42,28.81
Orianna,Volibear,102,52,50,50.98
Orianna,Cassiopeia,37,22,15,59.46
Orianna,Poppy,99,55,44,55.56
Orianna,Darius,180,100,80,55.56
Orianna,Rakan,81,51,30,62.96
Orianna,Anivia,36,16,20,44.44
Orianna,Morgana,78,35,43,44.87
Orianna,Milio,53,31,22,58.49
Orianna,Kled,37,21,16,56.76
Orianna,Kassadin,16,7,9,43.75
Orianna,Ezreal,262,107,155,40.84
Orianna,Olaf,35,11,24,31.43
Orianna,Gragas,88,49,39,55.68
Orianna,Bard,46,20,26,43.48
Orianna,Leblanc,67,36,31,53.73
Orianna,Yorick,88,54,34,61.36
Orianna,Thresh,187,79,108,42.25
Orianna,Gangplank,53,29,24,54.72
Orianna,Evelynn,29,4,25,13.79
Orianna,Seraphine,86,46,40,53.49
Orianna,JarvanIV,77,38,39,49.35
Orianna,Draven,58,23,35,39.66
Orianna,Varus,108,57,51,52.78
Orianna,Mordekaiser,133,69,64,51.88
Orianna,Nocturne,146,77,69,52.74
Orianna,Karma,140,70,70,50
Orianna,Tryndamere,38,14,24,36.84
Orianna,Syndra,82,34,48,41.46
Orianna,Blitzcrank,100,57,43,57
Orianna,Lillia,76,45,31,59.21
Orianna,Fizz,34,15,19,44.12
Orianna,Khazix,50,36,14,72
Orianna,Elise,73,45,28,61.64
Orianna,Senna,62,40,22,64.52
Orianna,Fiora,30,21,9,70
Orianna,Aphelios,62,26,36,41.94
Orianna,DrMundo,49,22,27,44.9
Orianna,Renata,27,15,12,55.56
Orianna,Nunu,64,32,32,50
Orianna,Ambessa,76,37,39,48.68
Orianna,Qiyana,26,14,12,53.85
Orianna,Zoe,53,32,21,60.38
Orianna,KogMaw,31,22,9,70.97
Orianna,Taliyah,39,19,20,48.72
Orianna,Rammus,16,8,8,50
Orianna,Smolder,84,37,47,44.05
Orianna,Jax,93,42,51,45.16
Orianna,Katarina,52,24,28,46.15
Orianna,Lucian,90,57,33,63.33
Orianna,Shyvana,29,15,14,51.72
Orianna,Leona,113,60,53,53.1
Orianna,MasterYi,106,68,38,64.15
Orianna,Aatrox,108,67,41,62.04
Orianna,Vi,73,39,34,53.42
Orianna,Sylas,143,63,80,44.06
Orianna,Rell,60,30,30,50
Orianna,Irelia,75,34,41,45.33
Orianna,Graves,77,44,33,57.14
Orianna,Sion,72,31,41,43.06
Orianna,Sivir,48,33,15,68.75
Orianna,Brand,37,21,16,56.76
Orianna,Ryze,37,10,27,27.03
Orianna,Aurora,90,52,38,57.78
Orianna,Alistar,56,26,30,46.43
Orianna,AurelionSol,38,19,19,50
Orianna,Karthus,25,16,9,64
Orianna,Velkoz,53,26,27,49.06
Orianna,Riven,32,13,19,40.63
Orianna,Zyra,92,45,47,48.91
Orianna,Chogath,134,70,64,52.24
Orianna,Zeri,52,25,27,48.08
Orianna,TwistedFate,27,14,13,51.85
Orianna,Rumble,35,24,11,68.57
Orianna,Maokai,64,35,29,54.69
Orianna,Galio,114,47,67,41.23
Orianna,Nilah,32,14,18,43.75
Orianna,Hecarim,51,20,31,39.22
Orianna,Corki,72,44,28,61.11
Orianna,Trundle,53,23,30,43.4
Orianna,FiddleSticks,53,22,31,41.51
Orianna,Braum,66,38,28,57.58
Orianna,Gwen,48,17,31,35.42
Orianna,Kayle,44,15,29,34.09
Orianna,Akshan,37,30,7,81.08
Orianna,Skarner,59,24,35,40.68
Orianna,Teemo,70,36,34,51.43
Orianna,Naafiri,43,23,20,53.49
Orianna,Xayah,56,35,21,62.5
Orianna,Taric,26,16,10,61.54
Orianna,Heimerdinger,76,52,24,68.42
Orianna,Renekton,32,21,11,65.63
Orianna,Tristana,89,41,48,46.07
Orianna,Nidalee,41,31,10,75.61
Orianna,RekSai,25,11,14,44
Orianna,Quinn,33,15,18,45.45
Orianna,XinZhao,75,39,36,52
Orianna,Neeko,46,32,14,69.57
Orianna,Singed,32,10,22,31.25
Orianna,Zilean,28,9,19,32.14
Orianna,Sona,10,5,5,50
Orianna,Lissandra,33,23,10,69.7
Orianna,Kennen,41,26,15,63.41
Orianna,Rengar,30,17,13,56.67
Orianna,Illaoi,38,17,21,44.74
Orianna,Annie,20,11,9,55
Talon,Gnar,57,31,26,54.39
Talon,Evelynn,29,15,14,51.72
Talon,Malphite,89,58,31,65.17
Talon,Lucian,89,46,43,51.69
Talon,Mel,247,133,114,53.85
Talon,Quinn,39,15,24,38.46
Talon,MasterYi,89,39,50,43.82
Talon,Garen,144,53,91,36.81
Talon,Smolder,70,38,32,54.29
Talon,Nautilus,129,59,70,45.74
Talon,Sett,142,53,89,37.32
Talon,Ekko,77,38,39,49.35
Talon,Azir,44,18,26,40.91
Talon,Jinx,249,118,131,47.39
Talon,Nami,106,46,60,43.4
Talon,Aatrox,121,49,72,40.5
Talon,Sejuani,66,26,40,39.39
Talon,Yasuo,241,102,139,42.32
Talon,Annie,37,23,14,62.16
Talon,Gwen,71,34,37,47.89
Talon,Amumu,121,53,68,43.8
Talon,DrMundo,44,14,30,31.82
Talon,Tristana,87,38,49,43.68
Talon,Lulu,130,73,57,56.15
Talon,XinZhao,90,29,61,32.22
Talon,Chogath,112,47,65,41.96
Talon,Ashe,206,102,104,49.51
Talon,Rell,79,21,58,26.58
Talon,Lux,233,110,123,47.21
Talon,Caitlyn,254,130,124,51.18
Talon,Karma,112,65,47,58.04
Talon,Vi,150,60,90,40
Talon,Orianna,58,25,33,43.1
Talon,Swain,82,32,50,39.02
Talon,Renekton,67,29,38,43.28
Talon,MonkeyKing,92,35,57,38.04
Talon,Sylas,196,90,106,45.92
Talon,Seraphine,69,34,35,49.28
Talon,Olaf,26,11,15,42.31
Talon,Gragas,61,22,39,36.07
Talon,Zed,117,59,58,50.43
Talon,Rakan,49,24,25,48.98
Talon,Nasus,55,27,28,49.09
Talon,Malzahar,98,42,56,42.86
Talon,MissFortune,207,81,126,39.13
Talon,Vex,65,33,32,50.77
Talon,Darius,156,65,91,41.67
Talon,JarvanIV,77,31,46,40.26
Talon,Warwick,134,66,68,49.25
Talon,Akali,124,52,72,41.94
Talon,TahmKench,107,47,60,43.93
Talon,Fiora,48,24,24,50
Talon,Jhin,154,57,97,37.01
Talon,Riven,40,14,26,35
Talon,Thresh,207,87,120,42.03
Talon,Kaisa,160,84,76,52.5
Talon,Yone,160,91,69,56.88
Talon,Nocturne,111,58,53,52.25
Talon,Leblanc,94,45,49,47.87
Talon,Sion,103,48,55,46.6
Talon,Poppy,71,19,52,26.76
Talon,Kayn,132,61,71,46.21
Talon,Draven,20,12,8,60
Talon,Tryndamere,29,17,12,58.62
Talon,Hecarim,41,11,30,26.83
Talon,Shaco,77,50,27,64.94
Talon,Ziggs,52,17,35,32.69
Talon,Hwei,68,30,38,44.12
Talon,Jax,58,34,24,58.62
Talon,Vayne,119,44,75,36.97
Talon,Alistar,47,21,26,44.68
Talon,AurelionSol,41,12,29,29.27
Talon,Ezreal,249,108,141,43.37
Talon,Yuumi,69,43,26,62.32
Talon,Teemo,99,40,59,40.4
Talon,Briar,38,25,13,65.79
Talon,Pantheon,142,59,83,41.55
Talon,Milio,64,31,33,48.44
Talon,Nidalee,49,30,19,61.22
Talon,Rumble,30,15,15,50
Talon,Udyr,27,14,13,51.85
Talon,Gangplank,49,29,20,59.18
Talon,LeeSin,271,161,110,59.41
Talon,Leona,82,43,39,52.44
Talon,Mordekaiser,109,53,56,48.62
Talon,Varus,139,63,76,45.32
Talon,Ambessa,70,34,36,48.57
Talon,Nunu,49,23,26,46.94
Talon,Xerath,91,39,52,42.86
Talon,Katarina,67,19,48,28.36
Talon,Aphelios,47,19,28,40.43
Talon,Blitzcrank,131,61,70,46.56
Talon,Graves,46,27,19,58.7
Talon,Veigar,80,32,48,40
Talon,KogMaw,22,11,11,50
Talon,Viktor,90,32,58,35.56
Talon,Elise,119,45,74,37.82
Talon,Vladimir,72,41,31,56.94
Talon,Diana,115,43,72,37.39
Talon,Shyvana,28,7,21,25
Talon,Soraka,38,13,25,34.21
Talon,Galio,146,77,69,52.74
Talon,Cassiopeia,37,20,17,54.05
Talon,Lillia,66,36,30,54.55
Talon,Ryze,41,12,29,29.27
Talon,Xayah,50,21,29,42
Talon,Rengar,44,13,31,29.55
Talon,Janna,26,16,10,61.54
Talon,Illaoi,55,20,35,36.36
Talon,Rammus,29,23,6,79.31
Talon,Renata,21,9,12,42.86
Talon,Kayle,57,24,33,42.11
Talon,Twitch,76,35,41,46.05
Talon,Camille,55,22,33,40
Talon,FiddleSticks,49,20,29,40.82
Talon,Irelia,77,34,43,44.16
Talon,Urgot,49,23,26,46.94
Talon,Kassadin,14,6,8,42.86
Talon,Shen,88,41,47,46.59
Talon,Aurora,91,53,38,58.24
Talon,Khazix,67,30,37,44.78
Talon,Samira,62,27,35,43.55
Talon,Yorick,70,34,36,48.57
Talon,Pyke,79,42,37,53.16
Talon,Sivir,75,49,26,65.33
Talon,Brand,42,22,20,52.38
Talon,Belveth,23,14,9,60.87
Talon,Lissandra,26,9,17,34.62
Talon,Morgana,78,45,33,57.69
Talon,Karthus,27,21,6,77.78
Talon,Ahri,121,54,67,44.63
Talon,Braum,61,28,33,45.9
Talon,Nilah,51,23,28,45.1
Talon,Volibear,76,29,47,38.16
Talon,Zac,48,22,26,45.83
Talon,Velkoz,56,30,26,53.57
Talon,Senna,70,25,45,35.71
Talon,Ornn,66,31,35,46.97
Talon,Taliyah,14,9,5,64.29
Talon,Viego,121,62,59,51.24
Talon,Taric,19,3,16,15.79
Talon,Syndra,40,17,23,42.5
Talon,Trundle,49,23,26,46.94
Talon,Maokai,37,14,23,37.84
Talon,Jayce,59,30,29,50.85
Talon,Kennen,29,20,9,68.97
Talon,Bard,33,19,14,57.58
Talon,TwistedFate,45,17,28,37.78
Talon,Ivern,19,8,11,42.11
Talon,Kindred,47,31,16,65.96
Talon,Corki,35,14,21,40
Talon,Naafiri,44,21,23,47.73
Talon,Zyra,46,20,26,43.48
Talon,Neeko,76,26,50,34.21
Talon,Zilean,20,4,16,20
Talon,Sona,19,3,16,15.79
Talon,Kled,16,13,3,81.25
Talon,Akshan,29,2,27,6.9
Talon,Zeri,46,26,20,56.52
Talon,Fizz,28,15,13,53.57
Talon,Skarner,43,21,22,48.84
Talon,KSante,54,29,25,53.7
Talon,RekSai,14,6,8,42.86
Talon,Anivia,22,5,17,22.73
Talon,Heimerdinger,21,12,9,57.14
Talon,Singed,17,5,12,29.41
Talon,Zoe,62,33,29,53.23
Talon,Qiyana,14,6,8,42.86
Talon,Kalista,30,9,21,30
Cassiopeia,Illaoi,27,15,12,55.56
Cassiopeia,Briar,52,26,26,50
Cassiopeia,Taliyah,23,14,9,60.87
Cassiopeia,Twitch,54,36,18,66.67
Cassiopeia,Morgana,55,23,32,41.82
Cassiopeia,Ahri,81,34,47,41.98
Cassiopeia,Kaisa,75,41,34,54.67
Cassiopeia,Ashe,98,60,38,61.22
Cassiopeia,Olaf,19,11,8,57.89
Cassiopeia,Nidalee,32,27,5,84.38
Cassiopeia,Ryze,32,17,15,53.13
Cassiopeia,Caitlyn,163,97,66,59.51
Cassiopeia,Brand,26,10,16,38.46
Cassiopeia,Urgot,24,14,10,58.33
Cassiopeia,Mordekaiser,73,45,28,61.64
Cassiopeia,Malzahar,53,27,26,50.94
Cassiopeia,Ezreal,104,59,45,56.73
Cassiopeia,Mel,123,70,53,56.91
Cassiopeia,Gangplank,26,12,14,46.15
Cassiopeia,XinZhao,41,10,31,24.39
Cassiopeia,Azir,17,3,14,17.65
Cassiopeia,Lux,101,43,58,42.57
Cassiopeia,Maokai,32,20,12,62.5
Cassiopeia,Orianna,37,15,22,40.54
Cassiopeia,Tristana,88,42,46,47.73
Cassiopeia,Chogath,93,43,50,46.24
Cassiopeia,Nocturne,55,28,27,50.91
Cassiopeia,Akali,64,42,22,65.63
Cassiopeia,Samira,45,27,18,60
Cassiopeia,Thresh,88,43,45,48.86
Cassiopeia,Renekton,30,20,10,66.67
Cassiopeia,Diana,64,37,27,57.81
Cassiopeia,Zed,55,38,17,69.09
Cassiopeia,Jinx,117,62,55,52.99
Cassiopeia,Senna,34,23,11,67.65
Cassiopeia,Jayce,33,15,18,45.45
Cassiopeia,Draven,30,16,14,53.33
Cassiopeia,Syndra,46,29,17,63.04
Cassiopeia,Jhin,109,63,46,57.8
Cassiopeia,Nautilus,97,53,44,54.64
Cassiopeia,Sett,69,41,28,59.42
Cassiopeia,FiddleSticks,35,15,20,42.86
Cassiopeia,Veigar,48,19,29,39.58
Cassiopeia,MissFortune,83,42,41,50.6
Cassiopeia,Shaco,49,17,32,34.69
Cassiopeia,Pantheon,82,46,36,56.1
Cassiopeia,Tryndamere,14,5,9,35.71
Cassiopeia,Kayn,77,47,30,61.04
Cassiopeia,Viktor,65,39,26,60
Cassiopeia,Kayle,35,20,15,57.14
Cassiopeia,Evelynn,13,2,11,15.38
Cassiopeia,Aatrox,63,19,44,30.16
Cassiopeia,Nilah,48,24,24,50
Cassiopeia,Milio,43,23,20,53.49
Cassiopeia,Seraphine,54,16,38,29.63
Cassiopeia,Nami,66,34,32,51.52
Cassiopeia,Teemo,54,27,27,50
Cassiopeia,Lissandra,40,21,19,52.5
Cassiopeia,Lucian,54,23,31,42.59
Cassiopeia,Volibear,59,36,23,61.02
Cassiopeia,Nunu,35,15,20,42.86
Cassiopeia,Zoe,44,16,28,36.36
Cassiopeia,Swain,44,27,17,61.36
Cassiopeia,TahmKench,47,29,18,61.7
Cassiopeia,Warwick,85,49,36,57.65
Cassiopeia,Sion,60,23,37,38.33
Cassiopeia,Gragas,48,28,20,58.33
Cassiopeia,Irelia,32,12,20,37.5
Cassiopeia,MasterYi,26,13,13,50
Cassiopeia,Karma,67,37,30,55.22
Cassiopeia,Garen,101,51,50,50.5
Cassiopeia,Malphite,81,56,25,69.14
Cassiopeia,Pyke,52,26,26,50
Cassiopeia,Alistar,32,24,8,75
Cassiopeia,Elise,57,18,39,31.58
Cassiopeia,Yasuo,90,48,42,53.33
Cassiopeia,Renata,13,7,6,53.85
Cassiopeia,Talon,37,17,20,45.95
Cassiopeia,Singed,20,11,9,55
Cassiopeia,Kindred,34,26,8,76.47
Cassiopeia,Lulu,83,58,25,69.88
Cassiopeia,Ornn,34,17,17,50
Cassiopeia,MonkeyKing,56,21,35,37.5
Cassiopeia,Darius,114,51,63,44.74
Cassiopeia,Viego,37,13,24,35.14
Cassiopeia,Vladimir,47,29,18,61.7
Cassiopeia,Sejuani,31,15,16,48.39
Cassiopeia,Riven,15,6,9,40
Cassiopeia,Sivir,31,25,6,80.65
Cassiopeia,Xerath,52,17,35,32.69
Cassiopeia,Lillia,34,22,12,64.71
Cassiopeia,Amumu,48,21,27,43.75
Cassiopeia,Zac,55,28,27,50.91
Cassiopeia,Yone,93,54,39,58.06
Cassiopeia,Yuumi,55,38,17,69.09
Cassiopeia,Hwei,39,22,17,56.41
Cassiopeia,Aurora,35,21,14,60
Cassiopeia,Varus,39,21,18,53.85
Cassiopeia,Trundle,24,21,3,87.5
Cassiopeia,Vi,67,40,27,59.7
Cassiopeia,Zeri,41,24,17,58.54
Cassiopeia,Gwen,26,10,16,38.46
Cassiopeia,Smolder,50,18,32,36
Cassiopeia,Taric,24,10,14,41.67
Cassiopeia,Katarina,31,21,10,67.74
Cassiopeia,Fizz,31,25,6,80.65
Cassiopeia,Heimerdinger,20,15,5,75
Cassiopeia,Blitzcrank,33,13,20,39.39
Cassiopeia,Karthus,13,8,5,61.54
Cassiopeia,JarvanIV,56,44,12,78.57
Cassiopeia,Neeko,42,25,17,59.52
Cassiopeia,Nasus,21,8,13,38.1
Cassiopeia,Vayne,101,55,46,54.46
Cassiopeia,Quinn,20,6,14,30
Cassiopeia,Zyra,38,21,17,55.26
Cassiopeia,Corki,25,14,11,56
Cassiopeia,Rakan,35,24,11,68.57
Cassiopeia,Kalista,17,11,6,64.71
Cassiopeia,Fiora,10,8,2,80
Cassiopeia,Graves,36,11,25,30.56
Cassiopeia,TwistedFate,24,20,4,83.33
Cassiopeia,Naafiri,21,8,13,38.1
Cassiopeia,KSante,33,21,12,63.64
Cassiopeia,LeeSin,100,59,41,59
Cassiopeia,Ziggs,17,11,6,64.71
Cassiopeia,Rammus,16,11,5,68.75
Cassiopeia,Soraka,32,19,13,59.38
Cassiopeia,Ambessa,46,22,24,47.83
Cassiopeia,Shen,33,17,16,51.52
Cassiopeia,Belveth,19,6,13,31.58
Cassiopeia,Xayah,39,16,23,41.03
Cassiopeia,Sylas,79,58,21,73.42
Cassiopeia,Jax,38,21,17,55.26
Cassiopeia,Aphelios,23,12,11,52.17
Cassiopeia,Annie,20,11,9,55
Cassiopeia,Velkoz,23,12,11,52.17
Cassiopeia,AurelionSol,27,22,5,81.48
Cassiopeia,Rell,34,15,19,44.12
Cassiopeia,Galio,49,17,32,34.69
Cassiopeia,Janna,19,9,10,47.37
Cassiopeia,Kled,16,9,7,56.25
Cassiopeia,Sona,17,11,6,64.71
Cassiopeia,Hecarim,11,6,5,54.55
Cassiopeia,Poppy,25,19,6,76
Cassiopeia,Anivia,33,12,21,36.36
Cassiopeia,DrMundo,28,16,12,57.14
Cassiopeia,KogMaw,23,9,14,39.13
Cassiopeia,Yorick,27,11,16,40.74
Cassiopeia,Leona,54,23,31,42.59
Cassiopeia,Qiyana,8,5,3,62.5
Cassiopeia,Ekko,34,19,15,55.88
Cassiopeia,Gnar,20,7,13,35
Cassiopeia,Udyr,19,17,2,89.47
Cassiopeia,Rengar,18,13,5,72.22
Cassiopeia,Camille,27,17,10,62.96
Cassiopeia,Braum,34,23,11,67.65
Cassiopeia,Skarner,25,14,11,56
Cassiopeia,Bard,12,4,8,33.33
Cassiopeia,Vex,20,11,9,55
Cassiopeia,Shyvana,7,2,5,28.57
Cassiopeia,Rumble,18,10,8,55.56
Cassiopeia,Kassadin,7,2,5,28.57
Cassiopeia,RekSai,5,0,5,0
Cassiopeia,Leblanc,22,8,14,36.36
Cassiopeia,Ivern,14,12,2,85.71
Cassiopeia,Kennen,25,11,14,44
Cassiopeia,Zilean,19,13,6,68.42
Cassiopeia,Khazix,18,6,12,33.33
Cassiopeia,Akshan,6,3,3,50
Illaoi,Cassiopeia,27,12,15,44.44
Illaoi,Kaisa,163,86,77,52.76
Illaoi,Volibear,136,85,51,62.5
Illaoi,Mel,190,89,101,46.84
Illaoi,Leona,96,44,52,45.83
Illaoi,Camille,39,7,32,17.95
Illaoi,Diana,152,84,68,55.26
Illaoi,Malzahar,84,43,41,51.19
Illaoi,Sivir,71,40,31,56.34
Illaoi,Zyra,96,43,53,44.79
Illaoi,Jax,117,72,45,61.54
Illaoi,RekSai,9,9,0,100
Illaoi,Xayah,48,19,29,39.58
Illaoi,Rakan,64,37,27,57.81
Illaoi,Heimerdinger,41,24,17,58.54
Illaoi,LeeSin,152,86,66,56.58
Illaoi,AurelionSol,36,10,26,27.78
Illaoi,Jinx,198,85,113,42.93
Illaoi,Garen,186,88,98,47.31
Illaoi,Briar,55,28,27,50.91
Illaoi,Neeko,41,28,13,68.29
Illaoi,Jhin,174,85,89,48.85
Illaoi,Lulu,117,53,64,45.3
Illaoi,Riven,38,21,17,55.26
Illaoi,Nocturne,104,62,42,59.62
Illaoi,Akali,88,43,45,48.86
Illaoi,Ashe,217,114,103,52.53
Illaoi,Soraka,39,28,11,71.79
Illaoi,Gnar,36,20,16,55.56
Illaoi,Fizz,49,29,20,59.18
Illaoi,Seraphine,73,38,35,52.05
Illaoi,Trundle,61,28,33,45.9
Illaoi,Katarina,57,30,27,52.63
Illaoi,Ezreal,226,105,121,46.46
Illaoi,Zoe,44,22,22,50
Illaoi,Mordekaiser,180,76,104,42.22
Illaoi,Azir,33,17,16,51.52
Illaoi,Caitlyn,293,143,150,48.81
Illaoi,Pantheon,178,91,87,51.12
Illaoi,Ekko,66,38,28,57.58
Illaoi,Vex,74,33,41,44.59
Illaoi,Lucian,77,38,39,49.35
Illaoi,Morgana,76,27,49,35.53
Illaoi,Sett,158,76,82,48.1
Illaoi,Amumu,115,65,50,56.52
Illaoi,Irelia,96,55,41,57.29
Illaoi,MissFortune,215,101,114,46.98
Illaoi,Aatrox,92,41,51,44.57
Illaoi,Sylas,124,67,57,54.03
Illaoi,Zilean,35,17,18,48.57
Illaoi,Darius,187,110,77,58.82
Illaoi,Veigar,99,46,53,46.46
Illaoi,Lux,250,134,116,53.6
Illaoi,Nautilus,138,54,84,39.13
Illaoi,Zed,126,42,84,33.33
Illaoi,Yuumi,83,38,45,45.78
Illaoi,Vi,121,67,54,55.37
Illaoi,TahmKench,113,60,53,53.1
Illaoi,Zac,48,21,27,43.75
Illaoi,Yasuo,187,89,98,47.59
Illaoi,Rell,46,17,29,36.96
Illaoi,Yone,189,93,96,49.21
Illaoi,XinZhao,49,20,29,40.82
Illaoi,Blitzcrank,84,50,34,59.52
Illaoi,Singed,27,9,18,33.33
Illaoi,Gragas,85,50,35,58.82
Illaoi,Hwei,76,48,28,63.16
Illaoi,Swain,95,51,44,53.68
Illaoi,Malphite,101,51,50,50.5
Illaoi,Rammus,33,27,6,81.82
Illaoi,Aurora,94,59,35,62.77
Illaoi,Kayn,146,80,66,54.79
Illaoi,Milio,55,34,21,61.82
Illaoi,Teemo,77,41,36,53.25
Illaoi,Bard,30,21,9,70
Illaoi,JarvanIV,77,22,55,28.57
Illaoi,Karma,111,59,52,53.15
Illaoi,Yorick,95,45,50,47.37
Illaoi,Chogath,123,76,47,61.79
Illaoi,Elise,83,40,43,48.19
Illaoi,Udyr,37,19,18,51.35
Illaoi,Varus,105,49,56,46.67
Illaoi,Lissandra,55,30,25,54.55
Illaoi,Vayne,103,52,51,50.49
Illaoi,Kled,16,8,8,50
Illaoi,Viktor,57,32,25,56.14
Illaoi,Akshan,26,6,20,23.08
Illaoi,Braum,67,36,31,53.73
Illaoi,Renekton,62,43,19,69.35
Illaoi,Twitch,69,33,36,47.83
Illaoi,Nami,75,24,51,32
Illaoi,Rumble,34,18,16,52.94
Illaoi,Sejuani,63,31,32,49.21
Illaoi,Smolder,50,23,27,46
Illaoi,Kindred,28,16,12,57.14
Illaoi,Thresh,162,67,95,41.36
Illaoi,Nidalee,21,12,9,57.14
Illaoi,Kalista,34,20,14,58.82
Illaoi,Alistar,48,25,23,52.08
Illaoi,KSante,50,29,21,58
Illaoi,Draven,48,27,21,56.25
Illaoi,Pyke,78,53,25,67.95
Illaoi,Nasus,58,25,33,43.1
Illaoi,Olaf,45,22,23,48.89
Illaoi,Ornn,86,47,39,54.65
Illaoi,MasterYi,119,47,72,39.5
Illaoi,Samira,70,37,33,52.86
Illaoi,Vladimir,45,29,16,64.44
Illaoi,Viego,100,26,74,26
Illaoi,Talon,55,35,20,63.64
Illaoi,Hecarim,28,15,13,53.57
Illaoi,Ahri,108,49,59,45.37
Illaoi,Graves,65,33,32,50.77
Illaoi,Warwick,133,74,59,55.64
Illaoi,Renata,20,8,12,40
Illaoi,Jayce,43,15,28,34.88
Illaoi,Kayle,45,13,32,28.89
Illaoi,MonkeyKing,52,29,23,55.77
Illaoi,Ambessa,78,43,35,55.13
Illaoi,Syndra,54,28,26,51.85
Illaoi,Urgot,58,30,28,51.72
Illaoi,Maokai,50,21,29,42
Illaoi,Ryze,35,15,20,42.86
Illaoi,Kassadin,24,3,21,12.5
Illaoi,Brand,59,27,32,45.76
Illaoi,Velkoz,61,15,46,24.59
Illaoi,DrMundo,46,32,14,69.57
Illaoi,Khazix,61,34,27,55.74
Illaoi,Sion,80,40,40,50
Illaoi,Taliyah,18,8,10,44.44
Illaoi,Galio,111,68,43,61.26
Illaoi,Kennen,31,11,20,35.48
Illaoi,Fiora,34,8,26,23.53
Illaoi,KogMaw,34,10,24,29.41
Illaoi,Poppy,65,34,31,52.31
Illaoi,Gwen,61,31,30,50.82
Illaoi,Tristana,71,45,26,63.38
Illaoi,Leblanc,56,29,27,51.79
Illaoi,Aphelios,47,28,19,59.57
Illaoi,Skarner,39,14,25,35.9
Illaoi,Gangplank,20,8,12,40
Illaoi,Shen,93,48,45,51.61
Illaoi,Shyvana,24,13,11,54.17
Illaoi,Naafiri,24,15,9,62.5
Illaoi,Belveth,8,2,6,25
Illaoi,Janna,24,5,19,20.83
Illaoi,Rengar,15,15,0,100
Illaoi,Lillia,62,26,36,41.94
Illaoi,Corki,33,14,19,42.42
Illaoi,Annie,30,8,22,26.67
Illaoi,FiddleSticks,41,15,26,36.59
Illaoi,Ziggs,37,13,24,35.14
Illaoi,Shaco,66,45,21,68.18
Illaoi,TwistedFate,38,15,23,39.47
Illaoi,Quinn,16,3,13,18.75
Illaoi,Senna,55,16,39,29.09
Illaoi,Nunu,87,49,38,56.32
Illaoi,Anivia,37,15,22,40.54
Illaoi,Xerath,79,42,37,53.16
Illaoi,Nilah,31,18,13,58.06
Illaoi,Tryndamere,39,26,13,66.67
Illaoi,Zeri,42,30,12,71.43
Illaoi,Sona,19,14,5,73.68
Illaoi,Orianna,38,21,17,55.26
Illaoi,Ivern,11,5,6,45.45
Illaoi,Evelynn,25,6,19,24
Illaoi,Taric,25,14,11,56
Illaoi,Karthus,22,7,15,31.82
Illaoi,Qiyana,12,0,12,0
Briar,Cassiopeia,52,26,26,50
Briar,Kaisa,167,78,89,46.71
Briar,Volibear,141,65,76,46.1
Briar,Mel,224,123,101,54.91
Briar,Leona,130,62,68,47.69
Briar,Aatrox,114,65,49,57.02
Briar,Lillia,66,22,44,33.33
Briar,Hwei,89,33,56,37.08
Briar,Ashe,224,135,89,60.27
Briar,Amumu,136,66,70,48.53
Briar,Darius,231,120,111,51.95
Briar,Nocturne,183,87,96,47.54
Briar,Katarina,75,44,31,58.67
Briar,Lucian,67,48,19,71.64
Briar,Nami,92,53,39,57.61
Briar,Twitch,103,63,40,61.17
Briar,Garen,159,69,90,43.4
Briar,Fizz,75,43,32,57.33
Briar,Karma,169,95,74,56.21
Briar,Vladimir,71,32,39,45.07
Briar,Lux,260,138,122,53.08
Briar,Rell,80,37,43,46.25
Briar,Malphite,142,78,64,54.93
Briar,Kayn,173,107,66,61.85
Briar,Ryze,43,24,19,55.81
Briar,Illaoi,55,27,28,49.09
Briar,Warwick,158,75,83,47.47
Briar,Ekko,110,46,64,41.82
Briar,MissFortune,241,102,139,42.32
Briar,Rakan,41,17,24,41.46
Briar,JarvanIV,66,40,26,60.61
Briar,Rumble,37,20,17,54.05
Briar,Galio,116,65,51,56.03
Briar,Lulu,134,60,74,44.78
Briar,Sylas,153,89,64,58.17
Briar,Pantheon,204,108,96,52.94
Briar,Shen,83,44,39,53.01
Briar,Hecarim,53,22,31,41.51
Briar,Kassadin,25,14,11,56
Briar,Varus,124,72,52,58.06
Briar,Alistar,54,40,14,74.07
Briar,TwistedFate,46,31,15,67.39
Briar,Vex,57,25,32,43.86
Briar,Morgana,111,66,45,59.46
Briar,Kindred,36,26,10,72.22
Briar,Yasuo,203,122,81,60.1
Briar,Draven,83,40,43,48.19
Briar,Taric,41,19,22,46.34
Briar,Irelia,83,41,42,49.4
Briar,Xayah,84,49,35,58.33
Briar,Jax,94,39,55,41.49
Briar,Elise,82,36,46,43.9
Briar,Riven,63,28,35,44.44
Briar,Nautilus,174,83,91,47.7
Briar,Urgot,51,32,19,62.75
Briar,Karthus,30,23,7,76.67
Briar,Akali,102,56,46,54.9
Briar,Swain,123,69,54,56.1
Briar,Gangplank,45,24,21,53.33
Briar,Zed,148,70,78,47.3
Briar,Zeri,46,22,24,47.83
Briar,Quinn,50,23,27,46
Briar,Ambessa,59,33,26,55.93
Briar,Brand,49,32,17,65.31
Briar,KSante,64,38,26,59.38
Briar,Jhin,234,134,100,57.26
Briar,Orianna,47,19,28,40.43
Briar,Kled,23,15,8,65.22
Briar,Veigar,110,57,53,51.82
Briar,Thresh,168,87,81,51.79
Briar,Yorick,136,60,76,44.12
Briar,Aurora,82,46,36,56.1
Briar,Diana,176,114,62,64.77
Briar,Jinx,280,131,149,46.79
Briar,Sona,16,8,8,50
Briar,Trundle,63,33,30,52.38
Briar,Singed,36,14,22,38.89
Briar,Leblanc,68,41,27,60.29
Briar,Ezreal,283,160,123,56.54
Briar,FiddleSticks,47,30,17,63.83
Briar,Yone,200,100,100,50
Briar,Sejuani,83,25,58,30.12
Briar,Azir,41,21,20,51.22
Briar,Milio,68,39,29,57.35
Briar,Poppy,93,45,48,48.39
Briar,Mordekaiser,187,95,92,50.8
Briar,Ahri,196,97,99,49.49
Briar,Chogath,168,97,71,57.74
Briar,DrMundo,56,32,24,57.14
Briar,TahmKench,132,75,57,56.82
Briar,Vayne,132,62,70,46.97
Briar,Vi,115,64,51,55.65
Briar,Caitlyn,311,149,162,47.91
Briar,Gnar,46,32,14,69.57
Briar,RekSai,17,10,7,58.82
Briar,Ziggs,34,24,10,70.59
Briar,Senna,66,47,19,71.21
Briar,Skarner,28,19,9,67.86
Briar,Gragas,88,57,31,64.77
Briar,Blitzcrank,104,57,47,54.81
Briar,Ivern,26,12,14,46.15
Briar,Malzahar,99,62,37,62.63
Briar,Nunu,63,36,27,57.14
Briar,Talon,38,13,25,34.21
Briar,MasterYi,107,66,41,61.68
Briar,Shyvana,45,34,11,75.56
Briar,Jayce,52,26,26,50
Briar,Khazix,43,28,15,65.12
Briar,Qiyana,22,15,7,68.18
Briar,Neeko,48,35,13,72.92
Briar,Pyke,80,54,26,67.5
Briar,Sett,171,94,77,54.97
Briar,Gwen,40,24,16,60
Briar,KogMaw,29,16,13,55.17
Briar,Fiora,32,16,16,50
Briar,Ornn,49,37,12,75.51
Briar,Soraka,59,28,31,47.46
Briar,Heimerdinger,60,25,35,41.67
Briar,Teemo,106,40,66,37.74
Briar,Seraphine,87,45,42,51.72
Briar,Viktor,100,59,41,59
Briar,Renekton,61,31,30,50.82
Briar,Tristana,66,28,38,42.42
Briar,Braum,101,54,47,53.47
Briar,MonkeyKing,64,23,41,35.94
Briar,Zoe,32,15,17,46.88
Briar,AurelionSol,50,31,19,62
Briar,Kennen,36,18,18,50
Briar,Udyr,55,35,20,63.64
Briar,Samira,112,43,69,38.39
Briar,Akshan,38,22,16,57.89
Briar,Nasus,60,26,34,43.33
Briar,Zyra,87,40,47,45.98
Briar,Yuumi,73,39,34,53.42
Briar,Zilean,23,12,11,52.17
Briar,Anivia,31,18,13,58.06
Briar,Janna,26,15,11,57.69
Briar,Shaco,91,52,39,57.14
Briar,Sivir,44,15,29,34.09
Briar,Smolder,72,50,22,69.44
Briar,Taliyah,35,24,11,68.57
Briar,Kalista,40,31,9,77.5
Briar,Xerath,83,31,52,37.35
Briar,Nilah,39,34,5,87.18
Briar,Kayle,75,43,32,57.33
Briar,LeeSin,195,126,69,64.62
Briar,Rengar,43,18,25,41.86
Briar,XinZhao,76,40,36,52.63
Briar,Naafiri,29,24,5,82.76
Briar,Lissandra,31,19,12,61.29
Briar,Bard,42,17,25,40.48
Briar,Camille,32,20,12,62.5
Briar,Evelynn,55,26,29,47.27
Briar,Viego,121,60,61,49.59
Briar,Maokai,62,34,28,54.84
Briar,Aphelios,63,20,43,31.75
Briar,Syndra,65,41,24,63.08
Briar,Olaf,30,13,17,43.33
Briar,Sion,95,43,52,45.26
Briar,Corki,39,28,11,71.79
Briar,Velkoz,65,20,45,30.77
Briar,Rammus,74,36,38,48.65
Briar,Zac,45,21,24,46.67
Briar,Nidalee,30,17,13,56.67
Briar,Belveth,37,26,11,70.27
Briar,Graves,47,20,27,42.55
Briar,Tryndamere,26,8,18,30.77
Briar,Renata,15,10,5,66.67
Briar,Annie,20,6,14,30
Karthus,Darius,88,50,38,56.82
Karthus,Vi,62,27,35,43.55
Karthus,Malzahar,58,25,33,43.1
Karthus,Aphelios,31,16,15,51.61
Karthus,Soraka,29,12,17,41.38
Karthus,Warwick,52,21,31,40.38
Karthus,Katarina,45,26,19,57.78
Karthus,Taric,13,9,4,69.23
Karthus,Zed,43,17,26,39.53
Karthus,FiddleSticks,30,15,15,50
Karthus,Hwei,46,26,20,56.52
Karthus,Teemo,42,26,16,61.9
Karthus,Jhin,101,55,46,54.46
Karthus,Janna,11,8,3,72.73
Karthus,Malphite,48,26,22,54.17
Karthus,Vladimir,28,18,10,64.29
Karthus,Ekko,55,22,33,40
Karthus,Smolder,25,12,13,48
Karthus,KSante,36,20,16,55.56
Karthus,LeeSin,96,52,44,54.17
Karthus,Ahri,55,21,34,38.18
Karthus,Vayne,72,29,43,40.28
Karthus,Seraphine,22,11,11,50
Karthus,Trundle,22,10,12,45.45
Karthus,Briar,30,7,23,23.33
Karthus,Vex,33,12,21,36.36
Karthus,MissFortune,79,42,37,53.16
Karthus,Rell,35,25,10,71.43
Karthus,Nocturne,77,30,47,38.96
Karthus,Azir,23,14,9,60.87
Karthus,Sona,15,6,9,40
Karthus,Amumu,55,25,30,45.45
Karthus,Yone,69,35,34,50.72
Karthus,Kaisa,99,54,45,54.55
Karthus,Renata,8,3,5,37.5
Karthus,Rumble,13,13,0,100
Karthus,Blitzcrank,43,22,21,51.16
Karthus,Xerath,40,13,27,32.5
Karthus,Caitlyn,125,74,51,59.2
Karthus,Thresh,70,35,35,50
Karthus,Anivia,20,8,12,40
Karthus,MasterYi,83,41,42,49.4
Karthus,Karma,67,39,28,58.21
Karthus,Chogath,58,39,19,67.24
Karthus,Shaco,50,26,24,52
Karthus,Nautilus,62,32,30,51.61
Karthus,MonkeyKing,48,16,32,33.33
Karthus,Rammus,12,10,2,83.33
Karthus,Pyke,47,31,16,65.96
Karthus,Lillia,44,33,11,75
Karthus,Lux,94,47,47,50
Karthus,Fiora,14,11,3,78.57
Karthus,Nami,81,27,54,33.33
Karthus,Poppy,51,29,22,56.86
Karthus,Ezreal,129,49,80,37.98
Karthus,Viego,56,28,28,50
Karthus,Mel,106,53,53,50
Karthus,Alistar,26,19,7,73.08
Karthus,Riven,26,18,8,69.23
Karthus,Sejuani,17,9,8,52.94
Karthus,Syndra,54,32,22,59.26
Karthus,Camille,36,20,16,55.56
Karthus,Swain,44,16,28,36.36
Karthus,Irelia,31,11,20,35.48
Karthus,Khazix,32,13,19,40.63
Karthus,AurelionSol,25,9,16,36
Karthus,Nilah,26,10,16,38.46
Karthus,Ashe,93,49,44,52.69
Karthus,Sion,64,32,32,50
Karthus,Leblanc,25,14,11,56
Karthus,Jinx,134,50,84,37.31
Karthus,Milio,36,19,17,52.78
Karthus,Urgot,24,11,13,45.83
Karthus,Lulu,61,30,31,49.18
Karthus,Evelynn,19,11,8,57.89
Karthus,Jax,31,19,12,61.29
Karthus,Lucian,52,34,18,65.38
Karthus,Jayce,36,17,19,47.22
Karthus,Sett,81,42,39,51.85
Karthus,Zyra,44,16,28,36.36
Karthus,Xayah,30,9,21,30
Karthus,Rakan,42,19,23,45.24
Karthus,Nasus,33,3,30,9.09
Karthus,Kayn,76,40,36,52.63
Karthus,Ambessa,46,24,22,52.17
Karthus,Brand,36,17,19,47.22
Karthus,Yorick,45,21,24,46.67
Karthus,Aurora,38,21,17,55.26
Karthus,Leona,58,25,33,43.1
Karthus,Pantheon,76,41,35,53.95
Karthus,Kayle,24,11,13,45.83
Karthus,Volibear,47,27,20,57.45
Karthus,Akali,55,28,27,50.91
Karthus,Skarner,20,9,11,45
Karthus,Shen,39,17,22,43.59
Karthus,Kennen,16,7,9,43.75
Karthus,Maokai,36,14,22,38.89
Karthus,Udyr,26,8,18,30.77
Karthus,Ryze,33,15,18,45.45
Karthus,Draven,24,19,5,79.17
Karthus,Viktor,42,30,12,71.43
Karthus,Yasuo,74,37,37,50
Karthus,Galio,64,25,39,39.06
Karthus,JarvanIV,37,18,19,48.65
Karthus,TwistedFate,11,11,0,100
Karthus,Braum,51,32,19,62.75
Karthus,Gnar,24,8,16,33.33
Karthus,Orianna,25,9,16,36
Karthus,Naafiri,11,9,2,81.82
Karthus,Kindred,21,15,6,71.43
Karthus,Ziggs,12,9,3,75
Karthus,Aatrox,57,16,41,28.07
Karthus,Fizz,32,8,24,25
Karthus,Zeri,24,16,8,66.67
Karthus,Hecarim,26,5,21,19.23
Karthus,Renekton,27,14,13,51.85
Karthus,Quinn,25,17,8,68
Karthus,Diana,61,22,39,36.07
Karthus,Mordekaiser,71,39,32,54.93
Karthus,Varus,43,26,17,60.47
Karthus,XinZhao,31,13,18,41.94
Karthus,Lissandra,23,15,8,65.22
Karthus,TahmKench,35,17,18,48.57
Karthus,Graves,29,16,13,55.17
Karthus,Cassiopeia,13,5,8,38.46
Karthus,Twitch,41,20,21,48.78
Karthus,Talon,27,6,21,22.22
Karthus,Veigar,48,29,19,60.42
Karthus,Gragas,26,13,13,50
Karthus,Tryndamere,19,7,12,36.84
Karthus,Tristana,49,23,26,46.94
Karthus,Samira,43,23,20,53.49
Karthus,Rengar,30,13,17,43.33
Karthus,Nunu,33,23,10,69.7
Karthus,Akshan,14,11,3,78.57
Karthus,Sylas,87,35,52,40.23
Karthus,Garen,72,42,30,58.33
Karthus,Senna,24,10,14,41.67
Karthus,Neeko,14,11,3,78.57
Karthus,Annie,18,7,11,38.89
Karthus,Qiyana,9,4,5,44.44
Karthus,Yuumi,35,11,24,31.43
Karthus,Elise,35,21,14,60
Karthus,Zilean,25,7,18,28
Karthus,Corki,17,7,10,41.18
Karthus,Kled,5,5,0,100
Karthus,Kassadin,5,2,3,40
Karthus,Taliyah,20,11,9,55
Karthus,Bard,23,12,11,52.17
Karthus,Belveth,7,0,7,0
Karthus,Heimerdinger,8,5,3,62.5
Karthus,RekSai,5,5,0,100
Karthus,DrMundo,21,8,13,38.1
Karthus,Singed,6,0,6,0
Karthus,Velkoz,18,12,6,66.67
Karthus,Nidalee,23,17,6,73.91
Karthus,Zoe,29,14,15,48.28
Karthus,Gangplank,19,10,9,52.63
Karthus,Zac,21,9,12,42.86
Karthus,Gwen,22,14,8,63.64
Karthus,Morgana,38,18,20,47.37
Karthus,KogMaw,10,0,10,0
Karthus,Illaoi,22,15,7,68.18
Karthus,Ivern,7,5,2,71.43
Karthus,Shyvana,7,2,5,28.57
Karthus,Kalista,5,5,0,100
Karthus,Ornn,24,11,13,45.83
Karthus,Sivir,8,5,3,62.5
Karthus,Olaf,9,6,3,66.67
Aphelios,Riven,42,22,20,52.38
Aphelios,Karthus,31,15,16,48.39
Aphelios,Mel,238,113,125,47.48
Aphelios,Lucian,84,43,41,51.19
Aphelios,Nami,101,38,63,37.62
Aphelios,FiddleSticks,58,22,36,37.93
Aphelios,Hwei,69,44,25,63.77
Aphelios,Teemo,107,55,52,51.4
Aphelios,Jhin,236,107,129,45.34
Aphelios,Janna,41,24,17,58.54
Aphelios,Aatrox,135,69,66,51.11
Aphelios,Sejuani,62,27,35,43.55
Aphelios,Yasuo,254,122,132,48.03
Aphelios,Annie,26,14,12,53.85
Aphelios,Malzahar,137,83,54,60.58
Aphelios,Gragas,107,56,51,52.34
Aphelios,Ezreal,302,164,138,54.3
Aphelios,Lulu,190,104,86,54.74
Aphelios,Volibear,130,78,52,60
Aphelios,Jax,91,33,58,36.26
Aphelios,Ashe,217,93,124,42.86
Aphelios,Pantheon,187,87,100,46.52
Aphelios,Darius,177,92,85,51.98
Aphelios,Nunu,83,53,30,63.86
Aphelios,Thresh,199,87,112,43.72
Aphelios,Varus,121,73,48,60.33
Aphelios,DrMundo,56,28,28,50
Aphelios,MissFortune,175,99,76,56.57
Aphelios,Aurora,94,49,45,52.13
Aphelios,Rakan,64,32,32,50
Aphelios,Nocturne,128,63,65,49.22
Aphelios,Caitlyn,299,158,141,52.84
Aphelios,Xerath,85,37,48,43.53
Aphelios,Twitch,95,38,57,40
Aphelios,Zac,110,46,64,41.82
Aphelios,Gwen,62,35,27,56.45
Aphelios,Ahri,174,86,88,49.43
Aphelios,Jinx,372,181,191,48.66
Aphelios,Amumu,129,57,72,44.19
Aphelios,Sion,87,52,35,59.77
Aphelios,Zed,121,58,63,47.93
Aphelios,Malphite,122,48,74,39.34
Aphelios,Diana,170,86,84,50.59
Aphelios,Kaisa,203,109,94,53.69
Aphelios,Seraphine,111,40,71,36.04
Aphelios,Shaco,79,46,33,58.23
Aphelios,Yone,179,83,96,46.37
Aphelios,XinZhao,44,19,25,43.18
Aphelios,Lillia,61,30,31,49.18
Aphelios,Katarina,86,51,35,59.3
Aphelios,Yuumi,99,52,47,52.53
Aphelios,Gnar,73,23,50,31.51
Aphelios,Lux,276,160,116,57.97
Aphelios,Kayn,179,82,97,45.81
Aphelios,Warwick,148,62,86,41.89
Aphelios,Veigar,93,43,50,46.24
Aphelios,Samira,93,40,53,43.01
Aphelios,Kled,17,9,8,52.94
Aphelios,Kassadin,28,19,9,67.86
Aphelios,Sett,149,77,72,51.68
Aphelios,Akali,108,47,61,43.52
Aphelios,MonkeyKing,78,26,52,33.33
Aphelios,Vladimir,83,45,38,54.22
Aphelios,Smolder,114,42,72,36.84
Aphelios,Azir,58,38,20,65.52
Aphelios,Ambessa,69,44,25,63.77
Aphelios,Rammus,38,16,22,42.11
Aphelios,Karma,125,73,52,58.4
Aphelios,Maokai,48,17,31,35.42
Aphelios,Swain,115,49,66,42.61
Aphelios,Ekko,88,30,58,34.09
Aphelios,Galio,94,51,43,54.26
Aphelios,Nilah,52,19,33,36.54
Aphelios,Olaf,31,16,15,51.61
Aphelios,Syndra,90,58,32,64.44
Aphelios,Bard,43,20,23,46.51
Aphelios,Shyvana,41,23,18,56.1
Aphelios,Milio,59,38,21,64.41
Aphelios,Yorick,115,61,54,53.04
Aphelios,Khazix,59,31,28,52.54
Aphelios,Talon,47,28,19,59.57
Aphelios,Gangplank,58,30,28,51.72
Aphelios,Poppy,91,42,49,46.15
Aphelios,Fizz,37,11,26,29.73
Aphelios,Draven,53,20,33,37.74
Aphelios,Camille,58,36,22,62.07
Aphelios,Mordekaiser,95,35,60,36.84
Aphelios,Irelia,117,49,68,41.88
Aphelios,Zilean,48,25,23,52.08
Aphelios,Orianna,62,36,26,58.06
Aphelios,Blitzcrank,120,66,54,55
Aphelios,Viego,159,79,80,49.69
Aphelios,Ornn,77,50,27,64.94
Aphelios,Rell,74,43,31,58.11
Aphelios,Evelynn,26,7,19,26.92
Aphelios,Vex,71,36,35,50.7
Aphelios,Tristana,82,47,35,57.32
Aphelios,Neeko,47,27,20,57.45
Aphelios,Rengar,38,19,19,50
Aphelios,Senna,54,32,22,59.26
Aphelios,Nasus,38,23,15,60.53
Aphelios,Velkoz,51,29,22,56.86
Aphelios,Brand,50,30,20,60
Aphelios,Hecarim,50,16,34,32
Aphelios,Kayle,58,18,40,31.03
Aphelios,Pyke,71,36,35,50.7
Aphelios,MasterYi,109,48,61,44.04
Aphelios,Heimerdinger,48,8,40,16.67
Aphelios,Trundle,53,32,21,60.38
Aphelios,Graves,72,31,41,43.06
Aphelios,Zeri,51,33,18,64.71
Aphelios,KSante,69,41,28,59.42
Aphelios,Lissandra,53,23,30,43.4
Aphelios,Viktor,97,39,58,40.21
Aphelios,Braum,77,33,44,42.86
Aphelios,Shen,95,41,54,43.16
Aphelios,Fiora,40,16,24,40
Aphelios,Morgana,96,34,62,35.42
Aphelios,Vayne,120,42,78,35
Aphelios,Zyra,74,40,34,54.05
Aphelios,Sivir,77,42,35,54.55
Aphelios,Singed,24,17,7,70.83
Aphelios,Leblanc,53,29,24,54.72
Aphelios,Sona,17,8,9,47.06
Aphelios,TahmKench,86,37,49,43.02
Aphelios,Sylas,171,93,78,54.39
Aphelios,Skarner,50,23,27,46
Aphelios,Zoe,41,18,23,43.9
Aphelios,Taliyah,25,8,17,32
Aphelios,Briar,63,43,20,68.25
Aphelios,Akshan,47,22,25,46.81
Aphelios,Garen,193,118,75,61.14
Aphelios,Quinn,46,15,31,32.61
Aphelios,Soraka,63,21,42,33.33
Aphelios,Elise,88,52,36,59.09
Aphelios,Xayah,52,28,24,53.85
Aphelios,Chogath,163,63,100,38.65
Aphelios,Corki,59,34,25,57.63
Aphelios,Leona,125,76,49,60.8
Aphelios,Vi,134,68,66,50.75
Aphelios,AurelionSol,52,21,31,40.38
Aphelios,Nautilus,115,62,53,53.91
Aphelios,Kennen,53,23,30,43.4
Aphelios,Naafiri,35,16,19,45.71
Aphelios,Qiyana,23,20,3,86.96
Aphelios,Ryze,61,28,33,45.9
Aphelios,LeeSin,180,117,63,65
Aphelios,Ziggs,43,26,17,60.47
Aphelios,Urgot,57,27,30,47.37
Aphelios,Illaoi,47,19,28,40.43
Aphelios,Jayce,50,29,21,58
Aphelios,Alistar,83,41,42,49.4
Aphelios,Cassiopeia,23,11,12,47.83
Aphelios,JarvanIV,82,36,46,43.9
Aphelios,Belveth,28,16,12,57.14
Aphelios,Kindred,35,18,17,51.43
Aphelios,Udyr,43,18,25,41.86
Aphelios,Anivia,34,15,19,44.12
Aphelios,Tryndamere,33,9,24,27.27
Aphelios,Rumble,20,3,17,15
Aphelios,Ivern,18,11,7,61.11
Aphelios,Renata,29,12,17,41.38
Aphelios,Kalista,32,24,8,75
Aphelios,Renekton,57,32,25,56.14
Aphelios,KogMaw,28,11,17,39.29
Aphelios,Nidalee,23,13,10,56.52
Aphelios,RekSai,31,20,11,64.52
Aphelios,Taric,16,14,2,87.5
Aphelios,TwistedFate,32,17,15,53.13
Naafiri,Akali,57,31,26,54.39
Naafiri,Amumu,90,40,50,44.44
Naafiri,Riven,29,11,18,37.93
Naafiri,Caitlyn,126,62,64,49.21
Naafiri,Lux,130,74,56,56.92
Naafiri,Yorick,52,26,26,50
Naafiri,Kayn,74,42,32,56.76
Naafiri,Sylas,81,45,36,55.56
Naafiri,MissFortune,147,84,63,57.14
Naafiri,Renata,24,8,16,33.33
Naafiri,Malphite,58,14,44,24.14
Naafiri,Vladimir,39,14,25,35.9
Naafiri,Ekko,74,30,44,40.54
Naafiri,Smolder,77,40,37,51.95
Naafiri,Soraka,41,29,12,70.73
Naafiri,Renekton,30,18,12,60
Naafiri,Elise,26,14,12,53.85
Naafiri,Jinx,172,80,92,46.51
Naafiri,Thresh,109,79,30,72.48
Naafiri,Gwen,37,19,18,51.35
Naafiri,Rammus,24,11,13,45.83
Naafiri,Zed,74,30,44,40.54
Naafiri,Tristana,62,32,30,51.61
Naafiri,Mel,112,63,49,56.25
Naafiri,Gnar,28,17,11,60.71
Naafiri,Lillia,39,17,22,43.59
Naafiri,Yone,135,70,65,51.85
Naafiri,Draven,30,12,18,40
Naafiri,AurelionSol,38,12,26,31.58
Naafiri,Swain,43,17,26,39.53
Naafiri,Leona,64,23,41,35.94
Naafiri,Garen,118,57,61,48.31
Naafiri,Gragas,44,20,24,45.45
Naafiri,Tryndamere,27,9,18,33.33
Naafiri,Leblanc,28,11,17,39.29
Naafiri,Varus,55,31,24,56.36
Naafiri,Urgot,37,19,18,51.35
Naafiri,LeeSin,116,62,54,53.45
Naafiri,Diana,91,47,44,51.65
Naafiri,Janna,26,11,15,42.31
Naafiri,Jax,59,34,25,57.63
Naafiri,Volibear,70,41,29,58.57
Naafiri,Kaisa,89,46,43,51.69
Naafiri,Yuumi,37,25,12,67.57
Naafiri,Mordekaiser,94,47,47,50
Naafiri,Sett,78,37,41,47.44
Naafiri,Milio,43,22,21,51.16
Naafiri,RekSai,11,5,6,45.45
Naafiri,Ziggs,18,8,10,44.44
Naafiri,Senna,43,27,16,62.79
Naafiri,Ashe,117,61,56,52.14
Naafiri,Darius,76,33,43,43.42
Naafiri,Malzahar,74,44,30,59.46
Naafiri,Aurora,54,22,32,40.74
Naafiri,Camille,25,21,4,84
Naafiri,Rengar,36,25,11,69.44
Naafiri,Jhin,86,34,52,39.53
Naafiri,Samira,63,25,38,39.68
Naafiri,Akshan,18,15,3,83.33
Naafiri,Nunu,57,43,14,75.44
Naafiri,Gangplank,28,13,15,46.43
Naafiri,Poppy,36,18,18,50
Naafiri,Fizz,32,10,22,31.25
Naafiri,Seraphine,43,9,34,20.93
Naafiri,Veigar,66,29,37,43.94
Naafiri,JarvanIV,51,30,21,58.82
Naafiri,Nami,58,34,24,58.62
Naafiri,Zeri,36,20,16,55.56
Naafiri,Rakan,37,8,29,21.62
Naafiri,Teemo,77,38,39,49.35
Naafiri,Lulu,77,48,29,62.34
Naafiri,MasterYi,62,22,40,35.48
Naafiri,Zoe,34,10,24,29.41
Naafiri,Lucian,37,12,25,32.43
Naafiri,Kindred,16,8,8,50
Naafiri,Syndra,42,14,28,33.33
Naafiri,Zyra,58,28,30,48.28
Naafiri,Khazix,21,4,17,19.05
Naafiri,Irelia,35,11,24,31.43
Naafiri,Brand,26,14,12,53.85
Naafiri,Lissandra,24,12,12,50
Naafiri,Twitch,53,27,26,50.94
Naafiri,Pyke,52,27,25,51.92
Naafiri,Kayle,32,22,10,68.75
Naafiri,TahmKench,48,23,25,47.92
Naafiri,XinZhao,32,13,19,40.63
Naafiri,Hwei,33,15,18,45.45
Naafiri,Nocturne,60,17,43,28.33
Naafiri,Galio,60,38,22,63.33
Naafiri,Ezreal,132,66,66,50
Naafiri,Pantheon,74,43,31,58.11
Naafiri,FiddleSticks,28,8,20,28.57
Naafiri,Vayne,61,31,30,50.82
Naafiri,Ambessa,67,25,42,37.31
Naafiri,MonkeyKing,28,11,17,39.29
Naafiri,Shyvana,11,2,9,18.18
Naafiri,Yasuo,99,62,37,62.63
Naafiri,Blitzcrank,57,17,40,29.82
Naafiri,Hecarim,24,13,11,54.17
Naafiri,Ahri,76,36,40,47.37
Naafiri,Aatrox,70,54,16,77.14
Naafiri,Sejuani,36,20,16,55.56
Naafiri,Karma,49,17,32,34.69
Naafiri,Xayah,19,6,13,31.58
Naafiri,Karthus,11,2,9,18.18
Naafiri,Chogath,74,41,33,55.41
Naafiri,Briar,29,5,24,17.24
Naafiri,Morgana,65,26,39,40
Naafiri,Shen,72,35,37,48.61
Naafiri,TwistedFate,17,14,3,82.35
Naafiri,Trundle,32,21,11,65.63
Naafiri,Anivia,23,12,11,52.17
Naafiri,Velkoz,32,21,11,65.63
Naafiri,Sion,51,21,30,41.18
Naafiri,Vex,61,30,31,49.18
Naafiri,KogMaw,6,0,6,0
Naafiri,Jayce,22,9,13,40.91
Naafiri,Alistar,41,11,30,26.83
Naafiri,Warwick,51,26,25,50.98
Naafiri,Corki,21,8,13,38.1
Naafiri,Vi,77,37,40,48.05
Naafiri,Viktor,39,17,22,43.59
Naafiri,Quinn,18,16,2,88.89
Naafiri,Olaf,12,5,7,41.67
Naafiri,Cassiopeia,21,13,8,61.9
Naafiri,Viego,70,39,31,55.71
Naafiri,Aphelios,35,19,16,54.29
Naafiri,Fiora,28,5,23,17.86
Naafiri,DrMundo,15,10,5,66.67
Naafiri,Heimerdinger,24,14,10,58.33
Naafiri,Graves,28,11,17,39.29
Naafiri,Xerath,69,36,33,52.17
Naafiri,Sivir,18,10,8,55.56
Naafiri,Nautilus,63,27,36,42.86
Naafiri,Kled,8,5,3,62.5
Naafiri,Orianna,43,20,23,46.51
Naafiri,Maokai,43,32,11,74.42
Naafiri,Annie,18,13,5,72.22
Naafiri,Illaoi,24,9,15,37.5
Naafiri,Azir,32,16,16,50
Naafiri,Udyr,20,11,9,55
Naafiri,KSante,27,5,22,18.52
Naafiri,Katarina,32,18,14,56.25
Naafiri,Nasus,28,11,17,39.29
Naafiri,Belveth,4,4,0,100
Naafiri,Ornn,17,7,10,41.18
Naafiri,Skarner,25,22,3,88
Naafiri,Talon,44,23,21,52.27
Naafiri,Kalista,10,3,7,30
Naafiri,Braum,32,19,13,59.38
Naafiri,Neeko,40,15,25,37.5
Naafiri,Kennen,12,10,2,83.33
Naafiri,Qiyana,10,5,5,50
Naafiri,Taric,14,11,3,78.57
Naafiri,Bard,19,16,3,84.21
Naafiri,Singed,10,5,5,50
Naafiri,Nilah,24,13,11,54.17
Naafiri,Ivern,13,0,13,0
Naafiri,Zac,27,16,11,59.26
Naafiri,Evelynn,13,9,4,69.23
Naafiri,Shaco,34,16,18,47.06
Naafiri,Zilean,18,4,14,22.22
Naafiri,Rell,30,19,11,63.33
Naafiri,Ryze,12,8,4,66.67
Naafiri,Rumble,17,9,8,52.94
Naafiri,Kassadin,2,0,2,0
Naafiri,Nidalee,14,9,5,64.29
Naafiri,Taliyah,8,5,3,62.5
Naafiri,Sona,2,0,2,0
Singed,Shen,55,27,28,49.09
Singed,MasterYi,67,32,35,47.76
Singed,Katarina,33,27,6,81.82
Singed,Jhin,94,49,45,52.13
Singed,Karma,76,36,40,47.37
Singed,Jax,39,24,15,61.54
Singed,Graves,42,24,18,57.14
Singed,Kassadin,25,14,11,56
Singed,Tristana,56,30,26,53.57
Singed,Nami,59,24,35,40.68
Singed,Kayle,38,27,11,71.05
Singed,Evelynn,19,7,12,36.84
Singed,Irelia,33,10,23,30.3
Singed,Corki,21,18,3,85.71
Singed,Syndra,32,16,16,50
Singed,Yasuo,112,42,70,37.5
Singed,Kayn,74,43,31,58.11
Singed,Caitlyn,140,86,54,61.43
Singed,Rell,47,24,23,51.06
Singed,Gnar,25,12,13,48
Singed,Kindred,21,5,16,23.81
Singed,Jinx,142,65,77,45.77
Singed,Braum,35,12,23,34.29
Singed,Thresh,100,45,55,45
Singed,Lillia,44,26,18,59.09
Singed,Yone,90,32,58,35.56
Singed,MissFortune,102,57,45,55.88
Singed,Sett,42,18,24,42.86
Singed,Nunu,23,11,12,47.83
Singed,Lux,120,64,56,53.33
Singed,Milio,38,22,16,57.89
Singed,Warwick,77,37,40,48.05
Singed,Rammus,17,12,5,70.59
Singed,Mel,116,66,50,56.9
Singed,Pantheon,81,37,44,45.68
Singed,DrMundo,45,17,28,37.78
Singed,Briar,36,22,14,61.11
Singed,Galio,51,20,31,39.22
Singed,Lucian,42,20,22,47.62
Singed,Volibear,59,27,32,45.76
Singed,Veigar,72,35,37,48.61
Singed,Morgana,51,24,27,47.06
Singed,Vladimir,20,11,9,55
Singed,Belveth,8,5,3,62.5
Singed,Samira,40,10,30,25
Singed,Alistar,44,22,22,50
Singed,Illaoi,27,18,9,66.67
Singed,Shaco,33,20,13,60.61
Singed,Aatrox,74,45,29,60.81
Singed,XinZhao,45,23,22,51.11
Singed,Xayah,29,23,6,79.31
Singed,Darius,56,35,21,62.5
Singed,Nocturne,78,48,30,61.54
Singed,Varus,32,19,13,59.38
Singed,Zyra,45,25,20,55.56
Singed,Tryndamere,25,14,11,56
Singed,Hecarim,11,6,5,54.55
Singed,Leblanc,24,18,6,75
Singed,Ashe,94,59,35,62.77
Singed,Poppy,38,18,20,47.37
Singed,FiddleSticks,31,24,7,77.42
Singed,Sivir,41,24,17,58.54
Singed,Vayne,45,23,22,51.11
Singed,LeeSin,86,40,46,46.51
Singed,Fizz,31,13,18,41.94
Singed,Kaisa,77,42,35,54.55
Singed,Aurora,34,26,8,76.47
Singed,Nidalee,9,6,3,66.67
Singed,Gangplank,26,20,6,76.92
Singed,Akali,46,38,8,82.61
Singed,Yorick,64,37,27,57.81
Singed,Hwei,36,13,23,36.11
Singed,Heimerdinger,25,15,10,60
Singed,Malzahar,51,30,21,58.82
Singed,Maokai,23,13,10,56.52
Singed,Taliyah,21,12,9,57.14
Singed,Annie,13,10,3,76.92
Singed,Mordekaiser,56,41,15,73.21
Singed,Amumu,68,35,33,51.47
Singed,Zoe,24,15,9,62.5
Singed,Twitch,49,38,11,77.55
Singed,Smolder,51,29,22,56.86
Singed,Lulu,75,39,36,52
Singed,Ahri,63,28,35,44.44
Singed,Seraphine,45,28,17,62.22
Singed,Riven,23,12,11,52.17
Singed,Skarner,24,18,6,75
Singed,TwistedFate,15,13,2,86.67
Singed,Cassiopeia,20,9,11,45
Singed,Gragas,32,23,9,71.88
Singed,Vex,24,9,15,37.5
Singed,Sion,52,20,32,38.46
Singed,Ezreal,110,45,65,40.91
Singed,Zilean,11,9,2,81.82
Singed,Khazix,24,13,11,54.17
Singed,Aphelios,24,7,17,29.17
Singed,TahmKench,32,18,14,56.25
Singed,Ekko,51,23,28,45.1
Singed,Rakan,15,8,7,53.33
Singed,Zed,47,29,18,61.7
Singed,Janna,24,15,9,62.5
Singed,Viego,61,36,25,59.02
Singed,Sylas,63,31,32,49.21
Singed,Ryze,25,13,12,52
Singed,KSante,26,12,14,46.15
Singed,Swain,52,21,31,40.38
Singed,Malphite,70,47,23,67.14
Singed,Zac,35,27,8,77.14
Singed,Teemo,46,31,15,67.39
Singed,Garen,78,30,48,38.46
Singed,Udyr,28,14,14,50
Singed,Soraka,30,10,20,33.33
Singed,Zeri,18,9,9,50
Singed,Yuumi,46,30,16,65.22
Singed,Camille,21,5,16,23.81
Singed,Xerath,35,22,13,62.86
Singed,Quinn,15,8,7,53.33
Singed,Lissandra,30,10,20,33.33
Singed,Diana,58,33,25,56.9
Singed,Viktor,44,18,26,40.91
Singed,Nautilus,73,32,41,43.84
Singed,Nilah,21,17,4,80.95
Singed,Leona,40,24,16,60
Singed,AurelionSol,23,8,15,34.78
Singed,Kennen,12,6,6,50
Singed,Blitzcrank,38,33,5,86.84
Singed,Gwen,30,18,12,60
Singed,Velkoz,36,22,14,61.11
Singed,Fiora,16,11,5,68.75
Singed,Ambessa,39,22,17,56.41
Singed,Brand,32,21,11,65.63
Singed,Neeko,27,19,8,70.37
Singed,Shyvana,18,3,15,16.67
Singed,MonkeyKing,33,19,14,57.58
Singed,Ziggs,19,12,7,63.16
Singed,Nasus,54,28,26,51.85
Singed,Kled,8,2,6,25
Singed,Sona,10,5,5,50
Singed,Sejuani,33,22,11,66.67
Singed,Rengar,32,7,25,21.88
Singed,Ornn,34,22,12,64.71
Singed,Senna,23,11,12,47.83
Singed,Orianna,32,22,10,68.75
Singed,Azir,25,20,5,80
Singed,Chogath,45,20,25,44.44
Singed,Elise,32,19,13,59.38
Singed,JarvanIV,36,25,11,69.44
Singed,Kalista,21,10,11,47.62
Singed,Naafiri,10,5,5,50
Singed,Urgot,24,10,14,41.67
Singed,Karthus,6,6,0,100
Singed,Vi,39,19,20,48.72
Singed,Renekton,5,3,2,60
Singed,Renata,8,0,8,0
Singed,Pyke,22,15,7,68.18
Singed,Rumble,11,6,5,54.55
Singed,Trundle,22,5,17,22.73
Singed,Olaf,20,11,9,55
Singed,Anivia,34,13,21,38.24
Singed,Talon,17,12,5,70.59
Singed,Draven,13,4,9,30.77
Singed,Akshan,10,7,3,70
Singed,Jayce,22,14,8,63.64
Singed,Bard,17,9,8,52.94
Singed,Taric,3,0,3,0
Singed,KogMaw,12,3,9,25
Singed,Qiyana,6,3,3,50
Singed,Ivern,6,3,3,50
Singed,RekSai,3,0,3,0
Akshan,Gragas,32,4,28,12.5
Akshan,Viego,49,19,30,38.78
Akshan,Xayah,33,13,20,39.39
Akshan,Lucian,53,31,22,58.49
Akshan,Rell,42,26,16,61.9
Akshan,Teemo,71,36,35,50.7
Akshan,Renekton,35,15,20,42.86
Akshan,Kassadin,24,8,16,33.33
Akshan,Jinx,157,68,89,43.31
Akshan,Soraka,29,14,15,48.28
Akshan,Leona,65,35,30,53.85
Akshan,Rammus,26,9,17,34.62
Akshan,Lux,145,61,84,42.07
Akshan,Twitch,52,30,22,57.69
Akshan,Aatrox,44,14,30,31.82
Akshan,TwistedFate,18,5,13,27.78
Akshan,JarvanIV,61,36,25,59.02
Akshan,Vex,43,29,14,67.44
Akshan,MissFortune,126,69,57,54.76
Akshan,Morgana,79,41,38,51.9
Akshan,Malzahar,81,35,46,43.21
Akshan,Elise,52,36,16,69.23
Akshan,Zyra,44,24,20,54.55
Akshan,Varus,48,25,23,52.08
Akshan,Riven,27,8,19,29.63
Akshan,Nocturne,81,43,38,53.09
Akshan,Ahri,90,38,52,42.22
Akshan,Kaisa,93,48,45,51.61
Akshan,Vladimir,44,28,16,63.64
Akshan,Belveth,19,8,11,42.11
Akshan,Veigar,57,28,29,49.12
Akshan,Samira,38,14,24,36.84
Akshan,Alistar,30,18,12,60
Akshan,Ambessa,56,29,27,51.79
Akshan,Darius,119,38,81,31.93
Akshan,Katarina,50,25,25,50
Akshan,Vayne,87,26,61,29.89
Akshan,Yuumi,60,27,33,45
Akshan,Illaoi,26,20,6,76.92
Akshan,FiddleSticks,28,20,8,71.43
Akshan,Aurora,73,39,34,53.42
Akshan,Pyke,43,21,22,48.84
Akshan,Kayn,106,44,62,41.51
Akshan,Nilah,26,11,15,42.31
Akshan,Nasus,53,33,20,62.26
Akshan,Trundle,35,18,17,51.43
Akshan,Hecarim,27,14,13,51.85
Akshan,Akali,51,28,23,54.9
Akshan,Zed,73,28,45,38.36
Akshan,Mordekaiser,90,49,41,54.44
Akshan,Ezreal,158,89,69,56.33
Akshan,Jax,59,20,39,33.9
Akshan,Naafiri,18,3,15,16.67
Akshan,Mel,169,91,78,53.85
Akshan,Gwen,23,11,12,47.83
Akshan,Tristana,54,23,31,42.59
Akshan,Warwick,132,66,66,50
Akshan,Xerath,53,22,31,41.51
Akshan,Heimerdinger,25,23,2,92
Akshan,Volibear,41,23,18,56.1
Akshan,Lissandra,23,14,9,60.87
Akshan,Caitlyn,201,119,82,59.2
Akshan,XinZhao,49,22,27,44.9
Akshan,Sylas,55,39,16,70.91
Akshan,Amumu,78,36,42,46.15
Akshan,Seraphine,36,20,16,55.56
Akshan,KSante,33,17,16,51.52
Akshan,Ekko,50,26,24,52
Akshan,Viktor,63,27,36,42.86
Akshan,Bard,29,14,15,48.28
Akshan,Nunu,54,22,32,40.74
Akshan,Yasuo,114,43,71,37.72
Akshan,Corki,38,21,17,55.26
Akshan,Gangplank,35,10,25,28.57
Akshan,Draven,30,13,17,43.33
Akshan,Zac,30,13,17,43.33
Akshan,Yone,110,41,69,37.27
Akshan,Graves,46,14,32,30.43
Akshan,Ashe,88,34,54,38.64
Akshan,Briar,38,16,22,42.11
Akshan,Shaco,35,23,12,65.71
Akshan,DrMundo,36,16,20,44.44
Akshan,Sejuani,23,10,13,43.48
Akshan,Swain,67,29,38,43.28
Akshan,Poppy,37,20,17,54.05
Akshan,Senna,53,23,30,43.4
Akshan,Sett,88,51,37,57.95
Akshan,Nautilus,86,22,64,25.58
Akshan,Fiora,32,22,10,68.75
Akshan,Lillia,32,20,12,62.5
Akshan,Shen,56,25,31,44.64
Akshan,Evelynn,16,11,5,68.75
Akshan,Lulu,89,48,41,53.93
Akshan,Urgot,46,24,22,52.17
Akshan,Leblanc,34,24,10,70.59
Akshan,Nami,93,53,40,56.99
Akshan,MasterYi,51,25,26,49.02
Akshan,Ryze,27,19,8,70.37
Akshan,Pantheon,103,55,48,53.4
Akshan,Yorick,48,15,33,31.25
Akshan,Jhin,114,57,57,50
Akshan,TahmKench,72,35,37,48.61
Akshan,Sion,51,32,19,62.75
Akshan,Hwei,43,19,24,44.19
Akshan,Aphelios,47,25,22,53.19
Akshan,Syndra,48,23,25,47.92
Akshan,Chogath,109,46,63,42.2
Akshan,Khazix,25,15,10,60
Akshan,Skarner,41,27,14,65.85
Akshan,Thresh,107,47,60,43.93
Akshan,Malphite,88,47,41,53.41
Akshan,MonkeyKing,45,23,22,51.11
Akshan,Diana,86,43,43,50
Akshan,LeeSin,65,29,36,44.62
Akshan,Irelia,30,23,7,76.67
Akshan,Braum,36,19,17,52.78
Akshan,Shyvana,23,5,18,21.74
Akshan,Gnar,27,16,11,59.26
Akshan,Smolder,46,25,21,54.35
Akshan,Azir,27,11,16,40.74
Akshan,Milio,37,15,22,40.54
Akshan,Neeko,22,14,8,63.64
Akshan,Rakan,21,6,15,28.57
Akshan,Orianna,37,7,30,18.92
Akshan,KogMaw,13,5,8,38.46
Akshan,Nidalee,34,15,19,44.12
Akshan,Quinn,35,14,21,40
Akshan,Fizz,29,15,14,51.72
Akshan,Karthus,14,3,11,21.43
Akshan,Camille,34,8,26,23.53
Akshan,Olaf,11,8,3,72.73
Akshan,Velkoz,23,16,7,69.57
Akshan,Brand,19,2,17,10.53
Akshan,Karma,74,42,32,56.76
Akshan,Ivern,24,15,9,62.5
Akshan,Garen,60,31,29,51.67
Akshan,Zeri,17,8,9,47.06
Akshan,Rengar,15,5,10,33.33
Akshan,Tryndamere,25,17,8,68
Akshan,Vi,75,45,30,60
Akshan,Annie,15,3,12,20
Akshan,Rumble,20,5,15,25
Akshan,Kalista,21,8,13,38.1
Akshan,Kayle,29,13,16,44.83
Akshan,Galio,42,15,27,35.71
Akshan,Zilean,25,12,13,48
Akshan,Zoe,27,15,12,55.56
Akshan,Blitzcrank,44,26,18,59.09
Akshan,Maokai,32,17,15,53.13
Akshan,AurelionSol,22,10,12,45.45
Akshan,Janna,26,14,12,53.85
Akshan,Kennen,17,5,12,29.41
Akshan,Ornn,39,21,18,53.85
Akshan,RekSai,9,3,6,33.33
Akshan,Sivir,24,10,14,41.67
Akshan,Taliyah,14,7,7,50
Akshan,Udyr,34,22,12,64.71
Akshan,Renata,23,11,12,47.83
Akshan,Talon,29,27,2,93.1
Akshan,Kindred,14,10,4,71.43
Akshan,Anivia,13,2,11,15.38
Akshan,Ziggs,15,5,10,33.33
Akshan,Kled,11,6,5,54.55
Akshan,Jayce,20,10,10,50
Akshan,Taric,11,3,8,27.27
Akshan,Singed,10,3,7,30
Akshan,Qiyana,13,7,6,53.85
Akshan,Sona,6,6,0,100
Akshan,Cassiopeia,6,3,3,50
Alistar,Jax,86,32,54,37.21
Alistar,Pantheon,197,94,103,47.72
Alistar,TwistedFate,53,32,21,60.38
Alistar,Sivir,93,35,58,37.63
Alistar,Milio,66,37,29,56.06
Alistar,Ambessa,73,25,48,34.25
Alistar,Graves,54,22,32,40.74
Alistar,Ahri,143,73,70,51.05
Alistar,AurelionSol,33,18,15,54.55
Alistar,Rakan,60,27,33,45
Alistar,Tryndamere,25,18,7,72
Alistar,MasterYi,85,49,36,57.65
Alistar,Akali,102,53,49,51.96
Alistar,KogMaw,52,33,19,63.46
Alistar,Swain,120,54,66,45
Alistar,Mordekaiser,167,77,90,46.11
Alistar,Kayn,144,66,78,45.83
Alistar,Kayle,67,26,41,38.81
Alistar,Caitlyn,280,144,136,51.43
Alistar,Shen,80,30,50,37.5
Alistar,Varus,114,61,53,53.51
Alistar,Vex,70,33,37,47.14
Alistar,Jhin,177,95,82,53.67
Alistar,Lux,214,107,107,50
Alistar,Brand,44,13,31,29.55
Alistar,Nami,92,44,48,47.83
Alistar,Yorick,79,34,45,43.04
Alistar,Briar,54,14,40,25.93
Alistar,Sylas,272,126,146,46.32
Alistar,Veigar,98,65,33,66.33
Alistar,Ziggs,33,15,18,45.45
Alistar,Renekton,57,33,24,57.89
Alistar,Shaco,102,60,42,58.82
Alistar,Thresh,238,111,127,46.64
Alistar,Vladimir,81,32,49,39.51
Alistar,Volibear,112,51,61,45.54
Alistar,Malzahar,105,44,61,41.9
Alistar,Jayce,75,32,43,42.67
Alistar,Sion,71,31,40,43.66
Alistar,Darius,208,93,115,44.71
Alistar,Leona,129,66,63,51.16
Alistar,Taliyah,42,26,16,61.9
Alistar,Vi,148,90,58,60.81
Alistar,Seraphine,40,22,18,55
Alistar,Chogath,151,56,95,37.09
Alistar,Khazix,77,44,33,57.14
Alistar,Hwei,69,30,39,43.48
Alistar,Jinx,300,137,163,45.67
Alistar,Warwick,121,50,71,41.32
Alistar,Kaisa,181,110,71,60.77
Alistar,Pyke,88,44,44,50
Alistar,TahmKench,92,52,40,56.52
Alistar,Zac,77,28,49,36.36
Alistar,Yasuo,225,117,108,52
Alistar,Lucian,110,69,41,62.73
Alistar,Kindred,53,34,19,64.15
Alistar,Gangplank,64,33,31,51.56
Alistar,Zeri,65,28,37,43.08
Alistar,Yuumi,75,40,35,53.33
Alistar,Malphite,149,84,65,56.38
Alistar,Zyra,69,39,30,56.52
Alistar,Ezreal,237,126,111,53.16
Alistar,Blitzcrank,159,94,65,59.12
Alistar,Singed,44,22,22,50
Alistar,Akshan,30,12,18,40
Alistar,Ashe,221,100,121,45.25
Alistar,Velkoz,54,26,28,48.15
Alistar,Sett,160,90,70,56.25
Alistar,Diana,182,97,85,53.3
Alistar,Yone,243,124,119,51.03
Alistar,Tristana,109,36,73,33.03
Alistar,Nautilus,196,109,87,55.61
Alistar,KSante,80,46,34,57.5
Alistar,Evelynn,41,13,28,31.71
Alistar,Annie,26,15,11,57.69
Alistar,Kled,25,14,11,56
Alistar,Kassadin,11,6,5,54.55
Alistar,Mel,252,117,135,46.43
Alistar,Lillia,58,26,32,44.83
Alistar,Viktor,111,62,49,55.86
Alistar,LeeSin,229,129,100,56.33
Alistar,Fizz,45,24,21,53.33
Alistar,Morgana,105,42,63,40
Alistar,Nasus,61,25,36,40.98
Alistar,Talon,47,26,21,55.32
Alistar,XinZhao,81,45,36,55.56
Alistar,Elise,75,50,25,66.67
Alistar,Skarner,61,35,26,57.38
Alistar,Garen,186,92,94,49.46
Alistar,Ekko,78,35,43,44.87
Alistar,Gragas,90,37,53,41.11
Alistar,Karthus,26,7,19,26.92
Alistar,Galio,107,36,71,33.64
Alistar,Corki,61,43,18,70.49
Alistar,Braum,87,47,40,54.02
Alistar,Aatrox,116,53,63,45.69
Alistar,Karma,120,62,58,51.67
Alistar,Soraka,27,8,19,29.63
Alistar,Riven,31,17,14,54.84
Alistar,Sejuani,66,41,25,62.12
Alistar,Syndra,96,39,57,40.63
Alistar,Kennen,43,23,20,53.49
Alistar,Vayne,162,85,77,52.47
Alistar,MissFortune,182,86,96,47.25
Alistar,Nilah,36,17,19,47.22
Alistar,Sona,19,11,8,57.89
Alistar,Gnar,55,39,16,70.91
Alistar,Nocturne,118,59,59,50
Alistar,DrMundo,57,36,21,63.16
Alistar,Amumu,125,55,70,44
Alistar,Taric,28,13,15,46.43
Alistar,Rammus,42,21,21,50
Alistar,Ornn,48,18,30,37.5
Alistar,Cassiopeia,32,8,24,25
Alistar,Urgot,75,33,42,44
Alistar,Leblanc,80,37,43,46.25
Alistar,Samira,78,50,28,64.1
Alistar,JarvanIV,70,30,40,42.86
Alistar,Irelia,82,44,38,53.66
Alistar,Viego,152,93,59,61.18
Alistar,Illaoi,48,23,25,47.92
Alistar,Lulu,151,78,73,51.66
Alistar,Lissandra,38,19,19,50
Alistar,Xayah,66,35,31,53.03
Alistar,Azir,67,45,22,67.16
Alistar,Hecarim,53,31,22,58.49
Alistar,Draven,70,25,45,35.71
Alistar,Rell,104,57,47,54.81
Alistar,Zoe,50,23,27,46
Alistar,Maokai,62,26,36,41.94
Alistar,Rengar,32,18,14,56.25
Alistar,Renata,34,18,16,52.94
Alistar,Xerath,88,28,60,31.82
Alistar,Ryze,44,18,26,40.91
Alistar,FiddleSticks,61,28,33,45.9
Alistar,Zed,112,78,34,69.64
Alistar,Shyvana,33,8,25,24.24
Alistar,Poppy,118,48,70,40.68
Alistar,Orianna,56,30,26,53.57
Alistar,MonkeyKing,82,36,46,43.9
Alistar,Aurora,78,32,46,41.03
Alistar,Teemo,130,71,59,54.62
Alistar,Katarina,62,39,23,62.9
Alistar,Nunu,63,32,31,50.79
Alistar,Naafiri,41,30,11,73.17
Alistar,Bard,25,12,13,48
Alistar,Gwen,51,18,33,35.29
Alistar,Twitch,60,38,22,63.33
Alistar,Senna,53,34,19,64.15
Alistar,Trundle,59,31,28,52.54
Alistar,Zilean,43,16,27,37.21
Alistar,Qiyana,17,9,8,52.94
Alistar,Olaf,24,9,15,37.5
Alistar,Rumble,39,30,9,76.92
Alistar,Udyr,45,22,23,48.89
Alistar,Aphelios,83,42,41,50.6
Alistar,Ivern,19,19,0,100
Alistar,Quinn,51,28,23,54.9
Alistar,Anivia,60,24,36,40
Alistar,Smolder,87,32,55,36.78
Alistar,Fiora,43,20,23,46.51
Alistar,Janna,38,21,17,55.26
Alistar,Belveth,22,12,10,54.55
Alistar,Nidalee,33,17,16,51.52
Alistar,Heimerdinger,43,25,18,58.14
Alistar,Camille,50,22,28,44
Alistar,RekSai,5,5,0,100
Alistar,Neeko,45,35,10,77.78
Alistar,Kalista,28,19,9,67.86
Khazix,Malphite,162,58,104,35.8
Khazix,Vi,108,37,71,34.26
Khazix,Azir,38,26,12,68.42
Khazix,MissFortune,186,94,92,50.54
Khazix,Lulu,133,58,75,43.61
Khazix,Rengar,72,39,33,54.17
Khazix,Warwick,139,67,72,48.2
Khazix,Irelia,79,37,42,46.84
Khazix,Ashe,169,96,73,56.8
Khazix,Nautilus,148,60,88,40.54
Khazix,Trundle,49,18,31,36.73
Khazix,Mel,202,98,104,48.51
Khazix,Jinx,226,102,124,45.13
Khazix,Morgana,108,44,64,40.74
Khazix,Yorick,79,53,26,67.09
Khazix,Ahri,142,56,86,39.44
Khazix,Ezreal,262,122,140,46.56
Khazix,Lux,325,187,138,57.54
Khazix,Sett,119,52,67,43.7
Khazix,LeeSin,198,108,90,54.55
Khazix,Lissandra,48,22,26,45.83
Khazix,TahmKench,85,44,41,51.76
Khazix,Malzahar,93,43,50,46.24
Khazix,Chogath,120,44,76,36.67
Khazix,Nocturne,68,34,34,50
Khazix,Rakan,69,40,29,57.97
Khazix,Volibear,93,36,57,38.71
Khazix,Jax,93,41,52,44.09
Khazix,Yasuo,175,80,95,45.71
Khazix,Pantheon,180,95,85,52.78
Khazix,Darius,181,97,84,53.59
Khazix,Evelynn,42,12,30,28.57
Khazix,Fizz,63,31,32,49.21
Khazix,MonkeyKing,55,17,38,30.91
Khazix,Zac,59,20,39,33.9
Khazix,Katarina,84,51,33,60.71
Khazix,Thresh,135,61,74,45.19
Khazix,Diana,126,71,55,56.35
Khazix,Kennen,21,10,11,47.62
Khazix,Kayn,124,66,58,53.23
Khazix,Yuumi,74,22,52,29.73
Khazix,Urgot,35,8,27,22.86
Khazix,XinZhao,60,27,33,45
Khazix,Draven,52,28,24,53.85
Khazix,Nami,127,57,70,44.88
Khazix,Mordekaiser,138,68,70,49.28
Khazix,Yone,183,98,85,53.55
Khazix,Caitlyn,286,125,161,43.71
Khazix,Senna,45,35,10,77.78
Khazix,TwistedFate,30,21,9,70
Khazix,Kaisa,176,94,82,53.41
Khazix,Alistar,77,33,44,42.86
Khazix,Xayah,55,29,26,52.73
Khazix,Smolder,88,41,47,46.59
Khazix,FiddleSticks,65,33,32,50.77
Khazix,Aurora,94,57,37,60.64
Khazix,Varus,120,67,53,55.83
Khazix,Karma,117,52,65,44.44
Khazix,Ambessa,72,33,39,45.83
Khazix,Ekko,88,35,53,39.77
Khazix,Vayne,122,51,71,41.8
Khazix,Milio,70,41,29,58.57
Khazix,Tryndamere,38,18,20,47.37
Khazix,Sylas,140,71,69,50.71
Khazix,Sion,80,17,63,21.25
Khazix,JarvanIV,58,36,22,62.07
Khazix,Soraka,39,13,26,33.33
Khazix,Gragas,105,57,48,54.29
Khazix,Corki,46,20,26,43.48
Khazix,Blitzcrank,73,38,35,52.05
Khazix,Riven,48,19,29,39.58
Khazix,Shaco,90,44,46,48.89
Khazix,Sivir,33,19,14,57.58
Khazix,Viego,139,70,69,50.36
Khazix,Galio,95,61,34,64.21
Khazix,Ziggs,33,13,20,39.39
Khazix,Braum,71,29,42,40.85
Khazix,Nidalee,57,27,30,47.37
Khazix,Heimerdinger,49,21,28,42.86
Khazix,Zyra,63,33,30,52.38
Khazix,Teemo,81,38,43,46.91
Khazix,Lucian,120,61,59,50.83
Khazix,Brand,47,17,30,36.17
Khazix,Shen,101,48,53,47.52
Khazix,AurelionSol,43,11,32,25.58
Khazix,Leona,90,42,48,46.67
Khazix,Briar,43,15,28,34.88
Khazix,Fiora,41,24,17,58.54
Khazix,Jhin,182,93,89,51.1
Khazix,Qiyana,16,9,7,56.25
Khazix,Seraphine,67,19,48,28.36
Khazix,Leblanc,60,35,25,58.33
Khazix,Orianna,50,14,36,28
Khazix,Aphelios,59,28,31,47.46
Khazix,Olaf,30,16,14,53.33
Khazix,Amumu,109,56,53,51.38
Khazix,Swain,103,54,49,52.43
Khazix,Veigar,71,33,38,46.48
Khazix,Sejuani,78,42,36,53.85
Khazix,Samira,79,37,42,46.84
Khazix,Graves,56,28,28,50
Khazix,Sona,27,12,15,44.44
Khazix,Hwei,88,51,37,57.95
Khazix,Karthus,32,19,13,59.38
Khazix,Gangplank,40,26,14,65
Khazix,Kassadin,25,8,17,32
Khazix,Nasus,47,26,21,55.32
Khazix,Vladimir,47,26,21,55.32
Khazix,Rammus,27,20,7,74.07
Khazix,Naafiri,21,17,4,80.95
Khazix,Renekton,55,38,17,69.09
Khazix,Kalista,24,21,3,87.5
Khazix,Ivern,20,11,9,55
Khazix,Garen,140,63,77,45
Khazix,Zeri,55,16,39,29.09
Khazix,Twitch,69,36,33,52.17
Khazix,MasterYi,101,51,50,50.5
Khazix,Akali,81,44,37,54.32
Khazix,Vex,49,30,19,61.22
Khazix,Anivia,26,13,13,50
Khazix,Singed,24,11,13,45.83
Khazix,KSante,63,26,37,41.27
Khazix,Xerath,91,29,62,31.87
Khazix,Zed,128,58,70,45.31
Khazix,Pyke,54,38,16,70.37
Khazix,Quinn,36,15,21,41.67
Khazix,Aatrox,70,38,32,54.29
Khazix,Lillia,82,40,42,48.78
Khazix,Janna,31,16,15,51.61
Khazix,Talon,67,37,30,55.22
Khazix,Nunu,61,25,36,40.98
Khazix,Gwen,50,18,32,36
Khazix,Poppy,67,28,39,41.79
Khazix,Illaoi,61,27,34,44.26
Khazix,Akshan,25,10,15,40
Khazix,Ryze,22,14,8,63.64
Khazix,Gnar,48,18,30,37.5
Khazix,Viktor,125,57,68,45.6
Khazix,Velkoz,65,35,30,53.85
Khazix,Rell,66,31,35,46.97
Khazix,Neeko,36,15,21,41.67
Khazix,Belveth,23,8,15,34.78
Khazix,Shyvana,39,13,26,33.33
Khazix,KogMaw,22,11,11,50
Khazix,Elise,72,37,35,51.39
Khazix,Syndra,81,52,29,64.2
Khazix,Zoe,81,41,40,50.62
Khazix,Tristana,85,50,35,58.82
Khazix,Renata,19,4,15,21.05
Khazix,Skarner,35,9,26,25.71
Khazix,Nilah,38,19,19,50
Khazix,Kled,23,20,3,86.96
Khazix,Taric,16,5,11,31.25
Khazix,Maokai,41,26,15,63.41
Khazix,DrMundo,46,16,30,34.78
Khazix,Hecarim,29,10,19,34.48
Khazix,RekSai,17,12,5,70.59
Khazix,Udyr,50,36,14,72
Khazix,Kayle,64,30,34,46.88
Khazix,Rumble,22,16,6,72.73
Khazix,Taliyah,25,14,11,56
Khazix,Kindred,35,21,14,60
Khazix,Ornn,40,26,14,65
Khazix,Zilean,28,21,7,75
Khazix,Camille,34,10,24,29.41
Khazix,Bard,15,7,8,46.67
Khazix,Jayce,45,27,18,60
Khazix,Cassiopeia,18,12,6,66.67
Khazix,Annie,16,5,11,31.25
Gwen,Chogath,168,96,72,57.14
Gwen,MonkeyKing,79,42,37,53.16
Gwen,Veigar,92,50,42,54.35
Gwen,Caitlyn,246,122,124,49.59
Gwen,Mel,211,107,104,50.71
Gwen,Malphite,135,61,74,45.19
Gwen,Kayn,114,45,69,39.47
Gwen,Ryze,49,18,31,36.73
Gwen,Lucian,80,47,33,58.75
Gwen,Leona,115,64,51,55.65
Gwen,Yone,171,96,75,56.14
Gwen,Talon,71,37,34,52.11
Gwen,Vladimir,62,19,43,30.65
Gwen,Swain,130,58,72,44.62
Gwen,Thresh,198,102,96,51.52
Gwen,Yasuo,161,82,79,50.93
Gwen,Evelynn,30,20,10,66.67
Gwen,Vayne,93,50,43,53.76
Gwen,Milio,61,16,45,26.23
Gwen,Warwick,137,44,93,32.12
Gwen,Ornn,99,43,56,43.43
Gwen,Katarina,56,25,31,44.64
Gwen,Tristana,77,30,47,38.96
Gwen,Lux,227,131,96,57.71
Gwen,Mordekaiser,151,83,68,54.97
Gwen,Naafiri,37,18,19,48.65
Gwen,Rammus,40,21,19,52.5
Gwen,Twitch,81,35,46,43.21
Gwen,Aatrox,114,55,59,48.25
Gwen,XinZhao,82,32,50,39.02
Gwen,Diana,170,91,79,53.53
Gwen,TahmKench,103,43,60,41.75
Gwen,Lissandra,41,25,16,60.98
Gwen,Corki,48,28,20,58.33
Gwen,Udyr,48,31,17,64.58
Gwen,Shaco,68,47,21,69.12
Gwen,Zyra,61,35,26,57.38
Gwen,Elise,46,31,15,67.39
Gwen,Kaisa,173,87,86,50.29
Gwen,Viego,143,59,84,41.26
Gwen,Vex,78,43,35,55.13
Gwen,Jhin,169,84,85,49.7
Gwen,Renata,20,13,7,65
Gwen,Volibear,133,70,63,52.63
Gwen,Ambessa,60,25,35,41.67
Gwen,KogMaw,26,10,16,38.46
Gwen,Zac,79,44,35,55.7
Gwen,Yuumi,66,27,39,40.91
Gwen,Yorick,84,45,39,53.57
Gwen,MissFortune,176,79,97,44.89
Gwen,Morgana,84,38,46,45.24
Gwen,Nami,83,37,46,44.58
Gwen,Nocturne,122,63,59,51.64
Gwen,Malzahar,119,52,67,43.7
Gwen,Urgot,58,40,18,68.97
Gwen,MasterYi,114,59,55,51.75
Gwen,Akali,66,27,39,40.91
Gwen,Ezreal,222,97,125,43.69
Gwen,Shyvana,34,21,13,61.76
Gwen,Fizz,47,30,17,63.83
Gwen,Jinx,266,142,124,53.38
Gwen,Rengar,34,21,13,61.76
Gwen,Sejuani,69,38,31,55.07
Gwen,Ahri,138,71,67,51.45
Gwen,Nautilus,154,79,75,51.3
Gwen,FiddleSticks,61,33,28,54.1
Gwen,Vi,116,58,58,50
Gwen,Aurora,92,39,53,42.39
Gwen,Varus,87,48,39,55.17
Gwen,Karma,100,54,46,54
Gwen,Ashe,208,110,98,52.88
Gwen,Braum,104,53,51,50.96
Gwen,Irelia,64,31,33,48.44
Gwen,Aphelios,62,27,35,43.55
Gwen,Graves,100,40,60,40
Gwen,Samira,73,50,23,68.49
Gwen,Sett,142,63,79,44.37
Gwen,Seraphine,92,41,51,44.57
Gwen,Ivern,24,21,3,87.5
Gwen,AurelionSol,46,23,23,50
Gwen,Lulu,130,71,59,54.62
Gwen,Kindred,53,30,23,56.6
Gwen,Blitzcrank,79,45,34,56.96
Gwen,Sion,181,101,80,55.8
Gwen,Amumu,97,51,46,52.58
Gwen,Ekko,69,35,34,50.72
Gwen,Darius,139,80,59,57.55
Gwen,Velkoz,44,25,19,56.82
Gwen,LeeSin,154,70,84,45.45
Gwen,Pyke,72,35,37,48.61
Gwen,Shen,107,50,57,46.73
Gwen,Sivir,62,33,29,53.23
Gwen,Skarner,40,21,19,52.5
Gwen,KSante,101,51,50,50.5
Gwen,Pantheon,207,108,99,52.17
Gwen,Akshan,23,12,11,52.17
Gwen,Syndra,65,20,45,30.77
Gwen,Hwei,71,40,31,56.34
Gwen,Anivia,30,16,14,53.33
Gwen,Camille,49,25,24,51.02
Gwen,Nilah,26,16,10,61.54
Gwen,Soraka,31,13,18,41.94
Gwen,Galio,113,51,62,45.13
Gwen,Briar,40,16,24,40
Gwen,Kayle,45,15,30,33.33
Gwen,Viktor,97,50,47,51.55
Gwen,Rakan,48,14,34,29.17
Gwen,Senna,65,34,31,52.31
Gwen,Tryndamere,32,12,20,37.5
Gwen,Sona,25,14,11,56
Gwen,Fiora,55,31,24,56.36
Gwen,Rell,69,37,32,53.62
Gwen,Nunu,65,42,23,64.62
Gwen,Brand,58,35,23,60.34
Gwen,Gragas,50,24,26,48
Gwen,Neeko,58,31,27,53.45
Gwen,Gangplank,25,14,11,56
Gwen,Smolder,67,39,28,58.21
Gwen,Rumble,25,17,8,68
Gwen,Jax,79,41,38,51.9
Gwen,Teemo,80,48,32,60
Gwen,Kennen,32,17,15,53.13
Gwen,Maokai,62,34,28,54.84
Gwen,DrMundo,48,24,24,50
Gwen,Bard,40,13,27,32.5
Gwen,Poppy,79,24,55,30.38
Gwen,Sylas,150,93,57,62
Gwen,Nasus,41,14,27,34.15
Gwen,Kalista,33,19,14,57.58
Gwen,Belveth,24,15,9,62.5
Gwen,Khazix,50,32,18,64
Gwen,Cassiopeia,26,16,10,61.54
Gwen,Trundle,63,37,26,58.73
Gwen,Alistar,51,33,18,64.71
Gwen,Xayah,60,32,28,53.33
Gwen,Orianna,48,31,17,64.58
Gwen,Garen,144,67,77,46.53
Gwen,Singed,30,12,18,40
Gwen,Zed,78,50,28,64.1
Gwen,Annie,40,18,22,45
Gwen,Zilean,26,16,10,61.54
Gwen,Azir,34,25,9,73.53
Gwen,JarvanIV,118,58,60,49.15
Gwen,Illaoi,61,30,31,49.18
Gwen,Xerath,54,20,34,37.04
Gwen,Lillia,41,26,15,63.41
Gwen,Janna,39,20,19,51.28
Gwen,Nidalee,27,17,10,62.96
Gwen,Zeri,67,31,36,46.27
Gwen,Renekton,53,41,12,77.36
Gwen,Gnar,41,22,19,53.66
Gwen,Ziggs,39,21,18,53.85
Gwen,Kassadin,36,13,23,36.11
Gwen,Taric,28,10,18,35.71
Gwen,TwistedFate,44,20,24,45.45
Gwen,Riven,48,23,25,47.92
Gwen,Leblanc,49,22,27,44.9
Gwen,Taliyah,29,21,8,72.41
Gwen,Quinn,18,12,6,66.67
Gwen,Draven,45,25,20,55.56
Gwen,Heimerdinger,38,13,25,34.21
Gwen,Zoe,43,19,24,44.19
Gwen,Karthus,22,8,14,36.36
Gwen,Kled,21,8,13,38.1
Gwen,Hecarim,22,11,11,50
Gwen,Qiyana,14,0,14,0
Gwen,Jayce,39,18,21,46.15
Gwen,Olaf,16,5,11,31.25
Gwen,RekSai,18,9,9,50
KSante,Sylas,192,97,95,50.52
KSante,Evelynn,36,23,13,63.89
KSante,Mel,205,77,128,37.56
KSante,Varus,127,67,60,52.76
KSante,Karma,174,69,105,39.66
KSante,Teemo,63,32,31,50.79
KSante,Renekton,102,36,66,35.29
KSante,Kassadin,21,14,7,66.67
KSante,Jinx,301,102,199,33.89
KSante,Soraka,66,28,38,42.42
KSante,Jax,95,47,48,49.47
KSante,Yorick,86,21,65,24.42
KSante,Yasuo,218,101,117,46.33
KSante,Tristana,97,45,52,46.39
KSante,Lux,270,137,133,50.74
KSante,MonkeyKing,96,37,59,38.54
KSante,Vayne,152,60,92,39.47
KSante,Fiora,88,51,37,57.95
KSante,Azir,33,21,12,63.64
KSante,Yone,242,106,136,43.8
KSante,Kayn,135,57,78,42.22
KSante,Malzahar,115,46,69,40
KSante,KogMaw,37,15,22,40.54
KSante,Veigar,111,55,56,49.55
KSante,Chogath,117,66,51,56.41
KSante,Sivir,81,22,59,27.16
KSante,Ryze,57,42,15,73.68
KSante,Ashe,270,118,152,43.7
KSante,Senna,75,46,29,61.33
KSante,DrMundo,57,14,43,24.56
KSante,LeeSin,248,130,118,52.42
KSante,Zed,93,49,44,52.69
KSante,Zeri,101,35,66,34.65
KSante,Lulu,190,112,78,58.95
KSante,Shen,74,22,52,29.73
KSante,Xayah,61,27,34,44.26
KSante,Viktor,132,54,78,40.91
KSante,Sejuani,88,32,56,36.36
KSante,Nami,108,41,67,37.96
KSante,Aatrox,137,67,70,48.91
KSante,Karthus,36,16,20,44.44
KSante,Annie,46,29,17,63.04
KSante,Ekko,111,47,64,42.34
KSante,Nilah,60,36,24,60
KSante,Zyra,95,62,33,65.26
KSante,Poppy,112,38,74,33.93
KSante,Taliyah,42,21,21,50
KSante,Nautilus,184,78,106,42.39
KSante,XinZhao,94,48,46,51.06
KSante,Vladimir,77,32,45,41.56
KSante,Corki,54,27,27,50
KSante,Morgana,136,62,74,45.59
KSante,Briar,64,26,38,40.63
KSante,Caitlyn,317,156,161,49.21
KSante,Urgot,63,26,37,41.27
KSante,Camille,40,21,19,52.5
KSante,Orianna,62,29,33,46.77
KSante,Tryndamere,41,21,20,51.22
KSante,Nidalee,50,23,27,46
KSante,Vex,74,43,31,58.11
KSante,Rell,78,46,32,58.97
KSante,Nocturne,179,83,96,46.37
KSante,Alistar,80,34,46,42.5
KSante,Jayce,73,26,47,35.62
KSante,Viego,163,84,79,51.53
KSante,Katarina,87,40,47,45.98
KSante,Draven,65,27,38,41.54
KSante,Thresh,237,88,149,37.13
KSante,Trundle,73,22,51,30.14
KSante,Shaco,92,51,41,55.43
KSante,AurelionSol,48,19,29,39.58
KSante,Seraphine,69,26,43,37.68
KSante,Lillia,108,37,71,34.26
KSante,Ornn,67,30,37,44.78
KSante,Elise,118,52,66,44.07
KSante,Rakan,75,31,44,41.33
KSante,Zoe,68,29,39,42.65
KSante,Braum,120,43,77,35.83
KSante,Riven,48,31,17,64.58
KSante,Udyr,62,35,27,56.45
KSante,Leblanc,80,32,48,40
KSante,Ezreal,284,158,126,55.63
KSante,Aurora,111,59,52,53.15
KSante,Sona,20,10,10,50
KSante,Gwen,101,50,51,49.5
KSante,Samira,105,60,45,57.14
KSante,Pyke,88,50,38,56.82
KSante,Gnar,85,29,56,34.12
KSante,Gragas,142,68,74,47.89
KSante,Ahri,197,75,122,38.07
KSante,Jhin,289,150,139,51.9
KSante,Maokai,52,31,21,59.62
KSante,JarvanIV,107,34,73,31.78
KSante,Kaisa,197,91,106,46.19
KSante,TahmKench,86,33,53,38.37
KSante,Yuumi,102,51,51,50
KSante,Rumble,33,20,13,60.61
KSante,Mordekaiser,242,119,123,49.17
KSante,MasterYi,133,60,73,45.11
KSante,FiddleSticks,47,20,27,42.55
KSante,Janna,39,8,31,20.51
KSante,Illaoi,50,21,29,42
KSante,Aphelios,69,28,41,40.58
KSante,Ambessa,158,77,81,48.73
KSante,Hwei,66,25,41,37.88
KSante,Brand,36,19,17,52.78
KSante,Nasus,58,14,44,24.14
KSante,Akshan,33,16,17,48.48
KSante,MissFortune,207,101,106,48.79
KSante,Malphite,109,48,61,44.04
KSante,Irelia,100,54,46,54
KSante,Volibear,114,59,55,51.75
KSante,Sett,204,102,102,50
KSante,Akali,137,76,61,55.47
KSante,Renata,41,21,20,51.22
KSante,Garen,250,118,132,47.2
KSante,Singed,26,14,12,53.85
KSante,Graves,59,31,28,52.54
KSante,Khazix,63,37,26,58.73
KSante,Blitzcrank,128,63,65,49.22
KSante,Pantheon,157,75,82,47.77
KSante,Milio,59,36,23,61.02
KSante,Diana,187,89,98,47.59
KSante,Zac,69,40,29,57.97
KSante,Twitch,85,32,53,37.65
KSante,Heimerdinger,33,15,18,45.45
KSante,Swain,145,63,82,43.45
KSante,Lissandra,47,27,20,57.45
KSante,Kalista,28,15,13,53.57
KSante,Kayle,54,21,33,38.89
KSante,Kindred,47,15,32,31.91
KSante,Galio,186,94,92,50.54
KSante,Hecarim,68,38,30,55.88
KSante,Warwick,139,77,62,55.4
KSante,Taric,28,11,17,39.29
KSante,Xerath,113,49,64,43.36
KSante,Fizz,42,12,30,28.57
KSante,Vi,153,66,87,43.14
KSante,Darius,230,93,137,40.43
KSante,Rengar,32,13,19,40.63
KSante,Cassiopeia,33,12,21,36.36
KSante,Leona,145,68,77,46.9
KSante,Amumu,147,84,63,57.14
KSante,Syndra,78,34,44,43.59
KSante,Smolder,99,49,50,49.49
KSante,Velkoz,73,23,50,31.51
KSante,Quinn,40,15,25,37.5
KSante,RekSai,17,6,11,35.29
KSante,Gangplank,36,18,18,50
KSante,Nunu,66,43,23,65.15
KSante,Naafiri,27,22,5,81.48
KSante,Skarner,53,26,27,49.06
KSante,TwistedFate,49,25,24,51.02
KSante,Sion,95,56,39,58.95
KSante,Olaf,30,4,26,13.33
KSante,Anivia,42,21,21,50
KSante,Lucian,79,31,48,39.24
KSante,Neeko,57,29,28,50.88
KSante,Belveth,24,13,11,54.17
KSante,Bard,50,29,21,58
KSante,Ziggs,32,13,19,40.63
KSante,Zilean,40,16,24,40
KSante,Ivern,26,16,10,61.54
KSante,Talon,54,25,29,46.3
KSante,Rammus,19,11,8,57.89
KSante,Kennen,31,12,19,38.71
KSante,Kled,19,11,8,57.89
KSante,Qiyana,18,13,5,72.22
KSante,Shyvana,17,6,11,35.29
Bard,Sylas,85,38,47,44.71
Bard,Evelynn,31,19,12,61.29
Bard,Mel,144,66,78,45.83
Bard,Varus,88,37,51,42.05
Bard,Karma,104,52,52,50
Bard,MonkeyKing,63,24,39,38.1
Bard,Vayne,87,50,37,57.47
Bard,Fiora,11,2,9,18.18
Bard,Soraka,46,22,24,47.83
Bard,Azir,24,12,12,50
Bard,Jayce,35,18,17,51.43
Bard,Graves,48,24,24,50
Bard,Lux,190,113,77,59.47
Bard,Caitlyn,187,96,91,51.34
Bard,Seraphine,43,28,15,65.12
Bard,TahmKench,58,37,21,63.79
Bard,JarvanIV,55,28,27,50.91
Bard,Viktor,62,23,39,37.1
Bard,Kaisa,109,55,54,50.46
Bard,Morgana,54,30,24,55.56
Bard,Volibear,56,33,23,58.93
Bard,Amumu,75,31,44,41.33
Bard,Katarina,46,26,20,56.52
Bard,Poppy,66,42,24,63.64
Bard,Zac,51,32,19,62.75
Bard,Nocturne,85,43,42,50.59
Bard,Veigar,85,43,42,50.59
Bard,KogMaw,15,9,6,60
Bard,Irelia,35,24,11,68.57
Bard,Kayn,69,41,28,59.42
Bard,Ahri,104,64,40,61.54
Bard,Twitch,56,31,25,55.36
Bard,Thresh,145,79,66,54.48
Bard,Rengar,34,15,19,44.12
Bard,Smolder,57,30,27,52.63
Bard,Janna,20,5,15,25
Bard,Malphite,66,36,30,54.55
Bard,Yasuo,94,43,51,45.74
Bard,Kled,22,9,13,40.91
Bard,Orianna,46,26,20,56.52
Bard,Illaoi,30,9,21,30
Bard,XinZhao,44,23,21,52.27
Bard,Jinx,158,66,92,41.77
Bard,Blitzcrank,54,32,22,59.26
Bard,Sett,92,55,37,59.78
Bard,Skarner,30,16,14,53.33
Bard,Chogath,117,65,52,55.56
Bard,Aphelios,43,23,20,53.49
Bard,Gnar,37,21,16,56.76
Bard,Brand,39,16,23,41.03
Bard,Tristana,75,36,39,48
Bard,Lulu,69,51,18,73.91
Bard,Ornn,57,28,29,49.12
Bard,LeeSin,95,42,53,44.21
Bard,Qiyana,14,9,5,64.29
Bard,Diana,96,53,43,55.21
Bard,Renekton,48,21,27,43.75
Bard,Draven,27,18,9,66.67
Bard,Nautilus,78,36,42,46.15
Bard,Aatrox,77,40,37,51.95
Bard,Milio,62,27,35,43.55
Bard,Aurora,58,22,36,37.93
Bard,MasterYi,43,17,26,39.53
Bard,Ambessa,53,31,22,58.49
Bard,Jhin,108,57,51,52.78
Bard,Zilean,14,7,7,50
Bard,Zyra,36,21,15,58.33
Bard,Velkoz,34,21,13,61.76
Bard,Nami,76,40,36,52.63
Bard,Trundle,18,12,6,66.67
Bard,Annie,24,10,14,41.67
Bard,Nasus,33,17,16,51.52
Bard,Akshan,29,15,14,51.72
Bard,MissFortune,111,45,66,40.54
Bard,Gragas,56,17,39,30.36
Bard,Kassadin,17,5,12,29.41
Bard,Yuumi,63,32,31,50.79
Bard,Nunu,54,33,21,61.11
Bard,Gangplank,18,9,9,50
Bard,Yone,87,47,40,54.02
Bard,Xayah,61,23,38,37.7
Bard,Pantheon,98,57,41,58.16
Bard,Corki,36,22,14,61.11
Bard,Vex,30,11,19,36.67
Bard,Udyr,46,14,32,30.43
Bard,Ziggs,23,15,8,65.22
Bard,Vi,79,43,36,54.43
Bard,Mordekaiser,76,40,36,52.63
Bard,AurelionSol,36,19,17,52.78
Bard,Leona,51,13,38,25.49
Bard,Gwen,40,27,13,67.5
Bard,Rakan,58,29,29,50
Bard,DrMundo,29,13,16,44.83
Bard,Zeri,18,13,5,72.22
Bard,Rell,48,29,19,60.42
Bard,Vladimir,38,10,28,26.32
Bard,Hwei,47,27,20,57.45
Bard,Zoe,11,2,9,18.18
Bard,Urgot,27,6,21,22.22
Bard,Briar,42,25,17,59.52
Bard,Warwick,63,31,32,49.21
Bard,Swain,68,41,27,60.29
Bard,Darius,107,57,50,53.27
Bard,Galio,82,31,51,37.8
Bard,Quinn,25,8,17,32
Bard,Zed,60,23,37,38.33
Bard,Ezreal,125,58,67,46.4
Bard,FiddleSticks,41,16,25,39.02
Bard,Xerath,55,27,28,49.09
Bard,Kalista,18,12,6,66.67
Bard,Alistar,25,13,12,52
Bard,Elise,58,26,32,44.83
Bard,Sivir,28,18,10,64.29
Bard,Samira,44,21,23,47.73
Bard,Akali,71,47,24,66.2
Bard,Syndra,46,15,31,32.61
Bard,Lucian,42,13,29,30.95
Bard,TwistedFate,19,13,6,68.42
Bard,Braum,60,38,22,63.33
Bard,Rumble,11,0,11,0
Bard,Tryndamere,25,14,11,56
Bard,Senna,45,23,22,51.11
Bard,Ekko,52,19,33,36.54
Bard,Malzahar,76,32,44,42.11
Bard,Nilah,26,15,11,57.69
Bard,Shen,54,29,25,53.7
Bard,Ashe,93,62,31,66.67
Bard,Belveth,17,9,8,52.94
Bard,Viego,114,49,65,42.98
Bard,Shaco,46,24,22,52.17
Bard,Talon,33,14,19,42.42
Bard,Kayle,25,9,16,36
Bard,Garen,112,53,59,47.32
Bard,Karthus,23,11,12,47.83
Bard,Lissandra,17,9,8,52.94
Bard,Teemo,59,37,22,62.71
Bard,Camille,32,18,14,56.25
Bard,Kennen,35,12,23,34.29
Bard,Taric,16,8,8,50
Bard,Riven,26,13,13,50
Bard,Jax,50,26,24,52
Bard,Heimerdinger,20,12,8,60
Bard,Kindred,30,28,2,93.33
Bard,Fizz,16,11,5,68.75
Bard,Maokai,22,14,8,63.64
Bard,Ivern,13,5,8,38.46
Bard,Naafiri,19,3,16,15.79
Bard,Hecarim,10,6,4,60
Bard,Lillia,31,16,15,51.61
Bard,Pyke,34,14,20,41.18
Bard,Anivia,24,14,10,58.33
Bard,KSante,50,21,29,42
Bard,Ryze,24,19,5,79.17
Bard,Yorick,64,24,40,37.5
Bard,Cassiopeia,12,8,4,66.67
Bard,Rammus,19,5,14,26.32
Bard,Sion,45,17,28,37.78
Bard,Shyvana,13,3,10,23.08
Bard,Nidalee,11,6,5,54.55
Bard,Sona,10,3,7,30
Bard,Taliyah,18,10,8,55.56
Bard,Neeko,21,9,12,42.86
Bard,Sejuani,34,16,18,47.06
Bard,Khazix,15,8,7,53.33
Bard,Renata,5,2,3,40
Bard,Olaf,11,2,9,18.18
Bard,Leblanc,34,17,17,50
Bard,Singed,17,8,9,47.06
Bard,RekSai,15,6,9,40
Skarner,Leblanc,81,44,37,54.32
Skarner,Kayn,119,63,56,52.94
Skarner,Teemo,76,36,40,47.37
Skarner,Ashe,169,71,98,42.01
Skarner,Nautilus,147,97,50,65.99
Skarner,Darius,178,83,95,46.63
Skarner,Veigar,75,32,43,42.67
Skarner,Varus,94,41,53,43.62
Skarner,Pyke,85,33,52,38.82
Skarner,Tryndamere,26,15,11,57.69
Skarner,Nunu,57,23,34,40.35
Skarner,Kennen,32,16,16,50
Skarner,Samira,98,63,35,64.29
Skarner,Rell,72,41,31,56.94
Skarner,Vi,103,39,64,37.86
Skarner,Riven,47,21,26,44.68
Skarner,Yone,204,107,97,52.45
Skarner,Smolder,86,47,39,54.65
Skarner,Thresh,151,67,84,44.37
Skarner,Ornn,61,22,39,36.07
Skarner,LeeSin,213,96,117,45.07
Skarner,Hwei,77,36,41,46.75
Skarner,Jhin,167,81,86,48.5
Skarner,TahmKench,98,47,51,47.96
Skarner,Aatrox,106,48,58,45.28
Skarner,XinZhao,77,39,38,50.65
Skarner,Vladimir,46,20,26,43.48
Skarner,Corki,30,23,7,76.67
Skarner,Morgana,74,28,46,37.84
Skarner,Rengar,17,12,5,70.59
Skarner,Ahri,131,87,44,66.41
Skarner,Lux,196,94,102,47.96
Skarner,Urgot,47,18,29,38.3
Skarner,Udyr,27,18,9,66.67
Skarner,Azir,63,24,39,38.1
Skarner,Jinx,258,114,144,44.19
Skarner,Shyvana,35,18,17,51.43
Skarner,Fizz,41,32,9,78.05
Skarner,Volibear,109,51,58,46.79
Skarner,Pantheon,149,93,56,62.42
Skarner,Yorick,79,43,36,54.43
Skarner,Elise,93,40,53,43.01
Skarner,Poppy,67,45,22,67.16
Skarner,Aurora,84,42,42,50
Skarner,Kindred,36,12,24,33.33
Skarner,Mel,157,66,91,42.04
Skarner,Jax,109,66,43,60.55
Skarner,Akali,92,49,43,53.26
Skarner,Caitlyn,201,88,113,43.78
Skarner,Senna,84,39,45,46.43
Skarner,Briar,28,9,19,32.14
Skarner,Galio,123,76,47,61.79
Skarner,Seraphine,66,27,39,40.91
Skarner,Jayce,36,20,16,55.56
Skarner,Draven,67,32,35,47.76
Skarner,Syndra,71,41,30,57.75
Skarner,Shen,76,31,45,40.79
Skarner,Sejuani,87,32,55,36.78
Skarner,Alistar,61,26,35,42.62
Skarner,Kayle,45,16,29,35.56
Skarner,Bard,30,14,16,46.67
Skarner,DrMundo,56,32,24,57.14
Skarner,Nilah,40,11,29,27.5
Skarner,Warwick,120,74,46,61.67
Skarner,Yasuo,128,60,68,46.88
Skarner,KogMaw,27,17,10,62.96
Skarner,Yuumi,87,46,41,52.87
Skarner,Ivern,22,15,7,68.18
Skarner,Kaisa,180,108,72,60
Skarner,Gwen,40,19,21,47.5
Skarner,Zed,120,55,65,45.83
Skarner,Irelia,87,49,38,56.32
Skarner,Malphite,92,45,47,48.91
Skarner,Zac,81,49,32,60.49
Skarner,Shaco,54,30,24,55.56
Skarner,Lucian,76,53,23,69.74
Skarner,FiddleSticks,30,19,11,63.33
Skarner,Nocturne,105,58,47,55.24
Skarner,Xerath,77,32,45,41.56
Skarner,Blitzcrank,78,40,38,51.28
Skarner,Soraka,31,11,20,35.48
Skarner,Sett,141,71,70,50.35
Skarner,Hecarim,63,43,20,68.25
Skarner,Camille,33,14,19,42.42
Skarner,Mordekaiser,146,75,71,51.37
Skarner,Zilean,30,22,8,73.33
Skarner,Milio,79,36,43,45.57
Skarner,Singed,24,6,18,25
Skarner,Zoe,42,27,15,64.29
Skarner,Tristana,99,65,34,65.66
Skarner,Gnar,49,26,23,53.06
Skarner,Nasus,48,27,21,56.25
Skarner,MasterYi,80,48,32,60
Skarner,Trundle,47,23,24,48.94
Skarner,Sivir,59,31,28,52.54
Skarner,JarvanIV,77,38,39,49.35
Skarner,AurelionSol,49,25,24,51.02
Skarner,MissFortune,153,69,84,45.1
Skarner,Fiora,46,16,30,34.78
Skarner,Ambessa,60,22,38,36.67
Skarner,Lulu,138,93,45,67.39
Skarner,Vayne,117,53,64,45.3
Skarner,Kled,19,8,11,42.11
Skarner,Malzahar,86,39,47,45.35
Skarner,Ezreal,226,124,102,54.87
Skarner,Chogath,69,31,38,44.93
Skarner,Maokai,44,21,23,47.73
Skarner,Xayah,71,34,37,47.89
Skarner,Rakan,57,31,26,54.39
Skarner,Sion,87,33,54,37.93
Skarner,Lillia,72,26,46,36.11
Skarner,Nami,118,61,57,51.69
Skarner,Ryze,31,17,14,54.84
Skarner,Gragas,80,37,43,46.25
Skarner,Anivia,39,26,13,66.67
Skarner,Rumble,37,20,17,54.05
Skarner,Quinn,26,21,5,80.77
Skarner,Amumu,131,58,73,44.27
Skarner,Ekko,78,27,51,34.62
Skarner,Karthus,20,11,9,55
Skarner,Renekton,57,34,23,59.65
Skarner,Leona,76,33,43,43.42
Skarner,Garen,142,67,75,47.18
Skarner,Diana,136,79,57,58.09
Skarner,Brand,50,30,20,60
Skarner,Graves,48,28,20,58.33
Skarner,Kassadin,19,5,14,26.32
Skarner,Katarina,45,22,23,48.89
Skarner,Swain,58,20,38,34.48
Skarner,Kalista,38,5,33,13.16
Skarner,Belveth,21,8,13,38.1
Skarner,Aphelios,50,27,23,54
Skarner,Viego,127,52,75,40.94
Skarner,Akshan,41,14,27,34.15
Skarner,Taric,18,12,6,66.67
Skarner,Neeko,40,26,14,65
Skarner,Karma,108,58,50,53.7
Skarner,Lissandra,20,13,7,65
Skarner,Renata,26,12,14,46.15
Skarner,Khazix,35,26,9,74.29
Skarner,Orianna,59,35,24,59.32
Skarner,Vex,36,14,22,38.89
Skarner,Twitch,71,39,32,54.93
Skarner,Velkoz,40,16,24,40
Skarner,Illaoi,39,25,14,64.1
Skarner,Gangplank,41,26,15,63.41
Skarner,Nidalee,34,27,7,79.41
Skarner,Sylas,128,59,69,46.09
Skarner,Ziggs,36,15,21,41.67
Skarner,Braum,94,39,55,41.49
Skarner,KSante,53,27,26,50.94
Skarner,Olaf,34,8,26,23.53
Skarner,Viktor,117,47,70,40.17
Skarner,Qiyana,15,7,8,46.67
Skarner,Naafiri,25,3,22,12
Skarner,TwistedFate,24,17,7,70.83
Skarner,MonkeyKing,35,13,22,37.14
Skarner,Zeri,48,30,18,62.5
Skarner,Heimerdinger,23,14,9,60.87
Skarner,Janna,12,8,4,66.67
Skarner,Cassiopeia,25,11,14,44
Skarner,Talon,43,22,21,51.16
Skarner,Zyra,56,23,33,41.07
Skarner,Evelynn,14,7,7,50
Skarner,Annie,25,13,12,52
Skarner,Taliyah,17,13,4,76.47
Skarner,Rammus,26,9,17,34.62
Skarner,Sona,11,0,11,0
Skarner,RekSai,3,0,3,0
Sona,Malphite,34,21,13,61.76
Sona,Graves,22,9,13,40.91
Sona,Vladimir,15,3,12,20
Sona,Ezreal,81,32,49,39.51
Sona,Camille,29,15,14,51.72
Sona,Chogath,41,21,20,51.22
Sona,Yasuo,57,30,27,52.63
Sona,MissFortune,58,29,29,50
Sona,Yuumi,28,17,11,60.71
Sona,FiddleSticks,30,18,12,60
Sona,Galio,24,16,8,66.67
Sona,Lulu,44,20,24,45.45
Sona,Urgot,17,5,12,29.41
Sona,Kindred,25,15,10,60
Sona,Veigar,46,14,32,30.43
Sona,Ashe,79,35,44,44.3
Sona,Karthus,15,9,6,60
Sona,Ekko,42,11,31,26.19
Sona,Zeri,18,5,13,27.78
Sona,Seraphine,37,21,16,56.76
Sona,Sett,63,16,47,25.4
Sona,Amumu,46,18,28,39.13
Sona,Irelia,22,16,6,72.73
Sona,Morgana,48,19,29,39.58
Sona,Ahri,63,36,27,57.14
Sona,Shaco,43,23,20,53.49
Sona,Mordekaiser,54,24,30,44.44
Sona,Jhin,78,45,33,57.69
Sona,Karma,34,18,16,52.94
Sona,Shen,21,15,6,71.43
Sona,Briar,16,8,8,50
Sona,Nautilus,32,23,9,71.88
Sona,Warwick,47,17,30,36.17
Sona,Twitch,46,22,24,47.83
Sona,Kalista,20,9,11,45
Sona,Renata,15,3,12,20
Sona,Ambessa,47,29,18,61.7
Sona,Kayn,45,25,20,55.56
Sona,Vayne,42,22,20,52.38
Sona,Milio,35,20,15,57.14
Sona,Heimerdinger,17,11,6,64.71
Sona,Mel,80,44,36,55
Sona,Volibear,45,29,16,64.44
Sona,Caitlyn,84,53,31,63.1
Sona,Soraka,16,4,12,25
Sona,Akali,17,9,8,52.94
Sona,Nocturne,44,21,23,47.73
Sona,Rengar,20,11,9,55
Sona,Malzahar,26,15,11,57.69
Sona,Yone,66,35,31,53.03
Sona,Hwei,27,11,16,40.74
Sona,Zed,46,25,21,54.35
Sona,Lucian,32,13,19,40.63
Sona,Zilean,17,11,6,64.71
Sona,Ornn,30,17,13,56.67
Sona,Brand,21,11,10,52.38
Sona,Ryze,26,15,11,57.69
Sona,Vi,27,14,13,51.85
Sona,Senna,41,21,20,51.22
Sona,Nilah,17,6,11,35.29
Sona,Blitzcrank,30,19,11,63.33
Sona,Jax,20,11,9,55
Sona,Viktor,31,18,13,58.06
Sona,Taric,10,6,4,60
Sona,Nami,58,38,20,65.52
Sona,KSante,20,10,10,50
Sona,Darius,76,33,43,43.42
Sona,Elise,35,20,15,57.14
Sona,Ziggs,15,3,12,20
Sona,Lux,90,53,37,58.89
Sona,Zyra,14,3,11,21.43
Sona,Jayce,22,13,9,59.09
Sona,Khazix,27,15,12,55.56
Sona,Alistar,19,8,11,42.11
Sona,Varus,31,12,19,38.71
Sona,Syndra,48,30,18,62.5
Sona,Riven,21,13,8,61.9
Sona,LeeSin,47,25,22,53.19
Sona,Sylas,55,23,32,41.82
Sona,Kaisa,56,36,20,64.29
Sona,Gwen,25,11,14,44
Sona,MonkeyKing,22,11,11,50
Sona,Azir,14,8,6,57.14
Sona,Diana,44,21,23,47.73
Sona,Thresh,51,20,31,39.22
Sona,Zac,28,19,9,67.86
Sona,Jinx,120,55,65,45.83
Sona,Udyr,17,11,6,64.71
Sona,Janna,21,7,14,33.33
Sona,Sejuani,17,5,12,29.41
Sona,Yorick,31,14,17,45.16
Sona,Pantheon,43,14,29,32.56
Sona,Velkoz,11,0,11,0
Sona,Aatrox,45,17,28,37.78
Sona,Leblanc,14,8,6,57.14
Sona,Teemo,41,28,13,68.29
Sona,Viego,34,14,20,41.18
Sona,Evelynn,6,6,0,100
Sona,Poppy,30,7,23,23.33
Sona,Braum,27,12,15,44.44
Sona,Garen,45,28,17,62.22
Sona,Tristana,47,24,23,51.06
Sona,Pyke,41,18,23,43.9
Sona,Rell,27,12,15,44.44
Sona,Smolder,19,5,14,26.32
Sona,AurelionSol,18,13,5,72.22
Sona,Fizz,13,3,10,23.08
Sona,Aphelios,17,9,8,52.94
Sona,Aurora,26,17,9,65.38
Sona,Rammus,16,8,8,50
Sona,Leona,31,13,18,41.94
Sona,Rakan,35,12,23,34.29
Sona,Xayah,20,8,12,40
Sona,Nasus,30,19,11,63.33
Sona,MasterYi,46,29,17,63.04
Sona,Gangplank,15,15,0,100
Sona,Shyvana,17,6,11,35.29
Sona,XinZhao,31,20,11,64.52
Sona,Samira,22,8,14,36.36
Sona,Belveth,8,3,5,37.5
Sona,Sion,31,11,20,35.48
Sona,Olaf,3,0,3,0
Sona,Katarina,17,6,11,35.29
Sona,Draven,12,7,5,58.33
Sona,Nunu,27,10,17,37.04
Sona,TwistedFate,15,9,6,60
Sona,Zoe,11,5,6,45.45
Sona,Swain,20,6,14,30
Sona,Gragas,18,10,8,55.56
Sona,Kayle,29,12,17,41.38
Sona,Fiora,14,3,11,21.43
Sona,Xerath,30,15,15,50
Sona,Maokai,13,5,8,38.46
Sona,Singed,10,5,5,50
Sona,Kassadin,9,9,0,100
Sona,Lillia,11,5,6,45.45
Sona,DrMundo,39,17,22,43.59
Sona,Cassiopeia,17,6,11,35.29
Sona,Sivir,16,14,2,87.5
Sona,Ivern,2,0,2,0
Sona,Quinn,8,2,6,25
Sona,JarvanIV,22,9,13,40.91
Sona,TahmKench,31,17,14,54.84
Sona,Orianna,10,5,5,50
Sona,Neeko,8,4,4,50
Sona,Annie,16,5,11,31.25
Sona,Hecarim,16,10,6,62.5
Sona,Talon,19,16,3,84.21
Sona,Corki,13,7,6,53.85
Sona,Anivia,14,0,14,0
Sona,Illaoi,19,5,14,26.32
Sona,Vex,23,11,12,47.83
Sona,Bard,10,7,3,70
Sona,Lissandra,13,4,9,30.77
Sona,Kled,8,0,8,0
Sona,Gnar,5,5,0,100
Sona,Akshan,6,0,6,0
Sona,Kennen,6,3,3,50
Sona,Rumble,3,3,0,100
Sona,Qiyana,3,0,3,0
Sona,Skarner,11,11,0,100
Sona,Nidalee,19,14,5,73.68
Sona,Renekton,6,0,6,0
Sona,Trundle,6,3,3,50
Sona,KogMaw,3,0,3,0
Sona,Taliyah,8,5,3,62.5
Sona,Naafiri,2,2,0,100
Camille,Aatrox,112,50,62,44.64
Camille,MasterYi,65,29,36,44.62
Camille,Mel,189,88,101,46.56
Camille,Tristana,57,29,28,50.88
Camille,Sona,29,14,15,48.28
Camille,Illaoi,39,32,7,82.05
Camille,Pantheon,110,58,52,52.73
Camille,Vex,39,21,18,53.85
Camille,Lucian,63,38,25,60.32
Camille,Braum,70,33,37,47.14
Camille,Poppy,70,38,32,54.29
Camille,FiddleSticks,43,16,27,37.21
Camille,Lux,185,91,94,49.19
Camille,Ashe,155,76,79,49.03
Camille,Sett,112,65,47,58.04
Camille,Darius,139,69,70,49.64
Camille,Leblanc,42,26,16,61.9
Camille,MissFortune,156,76,80,48.72
Camille,Renekton,51,27,24,52.94
Camille,Diana,128,75,53,58.59
Camille,Katarina,33,22,11,66.67
Camille,Varus,61,36,25,59.02
Camille,Karma,112,52,60,46.43
Camille,Amumu,94,40,54,42.55
Camille,Caitlyn,177,95,82,53.67
Camille,Brand,32,16,16,50
Camille,Yone,142,74,68,52.11
Camille,Ambessa,110,58,52,52.73
Camille,Twitch,58,39,19,67.24
Camille,Hwei,50,24,26,48
Camille,DrMundo,32,24,8,75
Camille,Zed,84,48,36,57.14
Camille,Orianna,56,23,33,41.07
Camille,Sivir,54,39,15,72.22
Camille,Nami,91,54,37,59.34
Camille,Rumble,16,8,8,50
Camille,Maokai,35,17,18,48.57
Camille,MonkeyKing,77,25,52,32.47
Camille,Viktor,54,21,33,38.89
Camille,Seraphine,58,29,29,50
Camille,Gnar,48,35,13,72.92
Camille,Swain,77,32,45,41.56
Camille,Jhin,147,72,75,48.98
Camille,Zoe,42,32,10,76.19
Camille,KSante,40,19,21,47.5
Camille,Shaco,50,26,24,52
Camille,Jinx,183,85,98,46.45
Camille,Yuumi,66,38,28,57.58
Camille,Shen,80,39,41,48.75
Camille,Smolder,53,21,32,39.62
Camille,Soraka,45,18,27,40
Camille,Heimerdinger,25,13,12,52
Camille,Irelia,30,8,22,26.67
Camille,Ezreal,215,117,98,54.42
Camille,Rakan,58,20,38,34.48
Camille,Volibear,59,34,25,57.63
Camille,Warwick,89,35,54,39.33
Camille,Malzahar,65,41,24,63.08
Camille,Draven,35,11,24,31.43
Camille,Leona,59,29,30,49.15
Camille,Aurora,83,51,32,61.45
Camille,Nocturne,70,28,42,40
Camille,Kaisa,108,58,50,53.7
Camille,Zyra,69,34,35,49.28
Camille,Trundle,14,5,9,35.71
Camille,Belveth,28,18,10,64.29
Camille,Veigar,82,30,52,36.59
Camille,Rell,63,32,31,50.79
Camille,Milio,61,36,25,59.02
Camille,Zeri,41,18,23,43.9
Camille,Lulu,165,76,89,46.06
Camille,Zac,52,35,17,67.31
Camille,Naafiri,25,4,21,16
Camille,Ornn,53,20,33,37.74
Camille,Olaf,19,4,15,21.05
Camille,Skarner,33,19,14,57.58
Camille,Aphelios,58,22,36,37.93
Camille,JarvanIV,69,26,43,37.68
Camille,Nidalee,30,21,9,70
Camille,Yorick,34,21,13,61.76
Camille,Blitzcrank,62,34,28,54.84
Camille,Gwen,49,24,25,48.98
Camille,Karthus,36,16,20,44.44
Camille,Chogath,110,42,68,38.18
Camille,Samira,54,31,23,57.41
Camille,Urgot,36,10,26,27.78
Camille,Syndra,57,25,32,43.86
Camille,Vayne,129,71,58,55.04
Camille,Taliyah,21,10,11,47.62
Camille,Sylas,146,78,68,53.42
Camille,Yasuo,137,57,80,41.61
Camille,Teemo,52,25,27,48.08
Camille,Ahri,102,52,50,50.98
Camille,Viego,84,38,46,45.24
Camille,Morgana,88,45,43,51.14
Camille,Udyr,30,20,10,66.67
Camille,Jax,66,31,35,46.97
Camille,TahmKench,75,31,44,41.33
Camille,Sion,58,31,27,53.45
Camille,Qiyana,23,0,23,0
Camille,XinZhao,46,14,32,30.43
Camille,Thresh,118,62,56,52.54
Camille,Ryze,30,19,11,63.33
Camille,Sejuani,56,24,32,42.86
Camille,Fizz,44,20,24,45.45
Camille,Rammus,21,12,9,57.14
Camille,Kindred,31,20,11,64.52
Camille,Talon,55,33,22,60
Camille,Malphite,67,35,32,52.24
Camille,Annie,18,9,9,50
Camille,Kayn,87,43,44,49.43
Camille,Riven,39,15,24,38.46
Camille,Ekko,62,20,42,32.26
Camille,Senna,41,24,17,58.54
Camille,Briar,32,12,20,37.5
Camille,Xerath,50,21,29,42
Camille,Rengar,37,23,14,62.16
Camille,Galio,96,51,45,53.13
Camille,Ivern,24,13,11,54.17
Camille,LeeSin,154,87,67,56.49
Camille,TwistedFate,24,15,9,62.5
Camille,Hecarim,32,19,13,59.38
Camille,Kassadin,15,7,8,46.67
Camille,Garen,162,91,71,56.17
Camille,Kalista,25,9,16,36
Camille,Pyke,61,25,36,40.98
Camille,Singed,21,16,5,76.19
Camille,Nasus,73,33,40,45.21
Camille,Graves,62,33,29,53.23
Camille,AurelionSol,38,16,22,42.11
Camille,Mordekaiser,69,28,41,40.58
Camille,Evelynn,14,7,7,50
Camille,Janna,30,14,16,46.67
Camille,Kennen,21,12,9,57.14
Camille,Akshan,34,26,8,76.47
Camille,Gangplank,34,12,22,35.29
Camille,Vladimir,65,25,40,38.46
Camille,Nautilus,94,40,54,42.55
Camille,Kayle,33,22,11,66.67
Camille,Kled,14,3,11,21.43
Camille,Velkoz,53,33,20,62.26
Camille,Gragas,62,30,32,48.39
Camille,Neeko,24,15,9,62.5
Camille,Akali,63,25,38,39.68
Camille,Nilah,43,15,28,34.88
Camille,Jayce,60,27,33,45
Camille,KogMaw,15,3,12,20
Camille,Quinn,28,16,12,57.14
Camille,Azir,34,21,13,61.76
Camille,Corki,49,27,22,55.1
Camille,Fiora,56,29,27,51.79
Camille,Xayah,53,19,34,35.85
Camille,Vi,106,64,42,60.38
Camille,RekSai,9,2,7,22.22
Camille,Alistar,50,28,22,56
Camille,Bard,32,14,18,43.75
Camille,Nunu,46,20,26,43.48
Camille,Cassiopeia,27,10,17,37.04
Camille,Taric,15,9,6,60
Camille,Lissandra,28,14,14,50
Camille,Zilean,20,4,16,20
Camille,Ziggs,23,13,10,56.52
Camille,Anivia,42,17,25,40.48
Camille,Elise,36,25,11,69.44
Camille,Tryndamere,19,16,3,84.21
Camille,Lillia,38,26,12,68.42
Camille,Khazix,34,24,10,70.59
Camille,Renata,22,17,5,77.27
Camille,Shyvana,6,3,3,50
Vex,Camille,39,18,21,46.15
Vex,Diana,166,106,60,63.86
Vex,Malzahar,143,64,79,44.76
Vex,Sivir,89,41,48,46.07
Vex,Zyra,94,32,62,34.04
Vex,Malphite,137,51,86,37.23
Vex,Chogath,135,55,80,40.74
Vex,Yasuo,359,177,182,49.3
Vex,MissFortune,241,108,133,44.81
Vex,Yuumi,45,28,17,62.22
Vex,Heimerdinger,60,26,34,43.33
Vex,Nunu,58,24,34,41.38
Vex,Teemo,111,57,54,51.35
Vex,Alistar,70,37,33,52.86
Vex,Garen,198,105,93,53.03
Vex,Sejuani,99,32,67,32.32
Vex,Akali,145,85,60,58.62
Vex,Ezreal,256,126,130,49.22
Vex,Karma,147,77,70,52.38
Vex,Shaco,84,37,47,44.05
Vex,Jhin,218,119,99,54.59
Vex,Milio,53,26,27,49.06
Vex,Volibear,108,61,47,56.48
Vex,Jax,104,65,39,62.5
Vex,Ashe,236,119,117,50.42
Vex,Pantheon,173,100,73,57.8
Vex,Briar,57,32,25,56.14
Vex,Akshan,43,14,29,32.56
Vex,Samira,52,35,17,67.31
Vex,Lulu,108,62,46,57.41
Vex,Sion,103,50,53,48.54
Vex,Katarina,69,44,25,63.77
Vex,Mel,148,66,82,44.59
Vex,Gwen,78,35,43,44.87
Vex,Nocturne,131,69,62,52.67
Vex,Aurora,108,52,56,48.15
Vex,Caitlyn,262,135,127,51.53
Vex,Morgana,127,55,72,43.31
Vex,Kennen,43,19,24,44.19
Vex,Kayn,148,83,65,56.08
Vex,Jinx,281,133,148,47.33
Vex,Illaoi,74,41,33,55.41
Vex,Veigar,129,55,74,42.64
Vex,Xayah,94,42,52,44.68
Vex,Brand,63,35,28,55.56
Vex,MasterYi,87,60,27,68.97
Vex,Urgot,57,24,33,42.11
Vex,Karthus,33,21,12,63.64
Vex,Kaisa,181,119,62,65.75
Vex,Swain,134,63,71,47.01
Vex,Warwick,138,59,79,42.75
Vex,Lux,310,183,127,59.03
Vex,Viktor,106,62,44,58.49
Vex,Qiyana,51,34,17,66.67
Vex,Darius,211,115,96,54.5
Vex,JarvanIV,80,40,40,50
Vex,Leblanc,93,54,39,58.06
Vex,Lucian,102,56,46,54.9
Vex,Nami,93,40,53,43.01
Vex,Yorick,94,53,41,56.38
Vex,Orianna,46,32,14,69.57
Vex,Talon,65,32,33,49.23
Vex,Nilah,43,25,18,58.14
Vex,KSante,74,31,43,41.89
Vex,FiddleSticks,61,22,39,36.07
Vex,Tristana,99,38,61,38.38
Vex,Leona,103,42,61,40.78
Vex,Yone,252,113,139,44.84
Vex,Vi,127,65,62,51.18
Vex,Nautilus,143,90,53,62.94
Vex,XinZhao,67,49,18,73.13
Vex,Lillia,85,41,44,48.24
Vex,DrMundo,43,22,21,51.16
Vex,TahmKench,96,62,34,64.58
Vex,Zeri,34,20,14,58.82
Vex,Varus,114,62,52,54.39
Vex,Seraphine,101,54,47,53.47
Vex,Shen,47,32,15,68.09
Vex,Syndra,91,60,31,65.93
Vex,Mordekaiser,130,82,48,63.08
Vex,Sett,154,76,78,49.35
Vex,LeeSin,212,112,100,52.83
Vex,Vayne,134,61,73,45.52
Vex,Soraka,34,22,12,64.71
Vex,Sylas,207,120,87,57.97
Vex,Braum,87,43,44,49.43
Vex,Taliyah,35,21,14,60
Vex,Gangplank,66,25,41,37.88
Vex,Riven,24,16,8,66.67
Vex,Evelynn,43,22,21,51.16
Vex,Ivern,26,12,14,46.15
Vex,Aphelios,71,35,36,49.3
Vex,Rell,91,41,50,45.05
Vex,Ekko,86,52,34,60.47
Vex,Blitzcrank,122,66,56,54.1
Vex,Ahri,161,86,75,53.42
Vex,Singed,24,15,9,62.5
Vex,Kindred,61,35,26,57.38
Vex,Zed,111,62,49,55.86
Vex,Rakan,92,53,39,57.61
Vex,Gragas,73,47,26,64.38
Vex,Kled,18,6,12,33.33
Vex,Ambessa,79,31,48,39.24
Vex,Viego,153,69,84,45.1
Vex,Irelia,82,41,41,50
Vex,Khazix,49,19,30,38.78
Vex,Udyr,58,37,21,63.79
Vex,Bard,30,19,11,63.33
Vex,Pyke,100,55,45,55
Vex,Neeko,43,27,16,62.79
Vex,Draven,52,31,21,59.62
Vex,Thresh,175,91,84,52
Vex,Zoe,35,21,14,60
Vex,Nasus,72,38,34,52.78
Vex,Zac,78,52,26,66.67
Vex,Poppy,94,50,44,53.19
Vex,Fiora,36,20,16,55.56
Vex,Amumu,145,51,94,35.17
Vex,Naafiri,61,31,30,50.82
Vex,Nidalee,34,20,14,58.82
Vex,KogMaw,52,31,21,59.62
Vex,Lissandra,33,30,3,90.91
Vex,Elise,90,47,43,52.22
Vex,Azir,43,38,5,88.37
Vex,Janna,27,14,13,51.85
Vex,Velkoz,40,25,15,62.5
Vex,Hwei,73,34,39,46.58
Vex,Xerath,104,53,51,50.96
Vex,Fizz,58,32,26,55.17
Vex,Hecarim,27,14,13,51.85
Vex,Twitch,62,37,25,59.68
Vex,Kayle,54,29,25,53.7
Vex,Galio,105,53,52,50.48
Vex,Kalista,35,14,21,40
Vex,AurelionSol,15,0,15,0
Vex,Senna,61,25,36,40.98
Vex,Shyvana,32,18,14,56.25
Vex,Skarner,36,22,14,61.11
Vex,MonkeyKing,55,26,29,47.27
Vex,Taric,26,17,9,65.38
Vex,Smolder,59,34,25,57.63
Vex,Olaf,27,13,14,48.15
Vex,Aatrox,85,41,44,48.24
Vex,Vladimir,59,34,25,57.63
Vex,Ornn,57,33,24,57.89
Vex,Renekton,44,27,17,61.36
Vex,Ziggs,39,10,29,25.64
Vex,Tryndamere,41,12,29,29.27
Vex,Ryze,37,17,20,45.95
Vex,TwistedFate,43,24,19,55.81
Vex,Corki,47,24,23,51.06
Vex,RekSai,9,6,3,66.67
Vex,Rengar,22,19,3,86.36
Vex,Zilean,25,14,11,56
Vex,Rammus,57,24,33,42.11
Vex,Anivia,27,15,12,55.56
Vex,Renata,31,15,16,48.39
Vex,Maokai,50,27,23,54
Vex,Jayce,52,26,26,50
Vex,Annie,34,15,19,44.12
Vex,Rumble,37,23,14,62.16
Vex,Cassiopeia,20,9,11,45
Vex,Kassadin,25,14,11,56
Vex,Quinn,38,14,24,36.84
Vex,Sona,23,12,11,52.17
Vex,Gnar,34,19,15,55.88
Vex,Trundle,40,24,16,60
Vex,Graves,54,30,24,55.56
Vex,Belveth,11,5,6,45.45
Fizz,Malphite,91,47,44,51.65
Fizz,Chogath,147,59,88,40.14
Fizz,Yasuo,189,98,91,51.85
Fizz,MissFortune,204,89,115,43.63
Fizz,Yuumi,72,40,32,55.56
Fizz,Darius,176,78,98,44.32
Fizz,Aurora,67,39,28,58.21
Fizz,Corki,37,14,23,37.84
Fizz,Briar,75,32,43,42.67
Fizz,Sejuani,49,18,31,36.73
Fizz,Tryndamere,40,21,19,52.5
Fizz,MasterYi,79,41,38,51.9
Fizz,Akali,91,48,43,52.75
Fizz,KogMaw,30,16,14,53.33
Fizz,Swain,93,41,52,44.09
Fizz,Malzahar,113,42,71,37.17
Fizz,Gragas,67,36,31,53.73
Fizz,Ezreal,214,125,89,58.41
Fizz,Lulu,142,60,82,42.25
Fizz,Yorick,83,23,60,27.71
Fizz,Warwick,169,74,95,43.79
Fizz,Annie,41,24,17,58.54
Fizz,Jhin,226,120,106,53.1
Fizz,Nautilus,122,69,53,56.56
Fizz,Khazix,63,32,31,50.79
Fizz,Karma,87,47,40,54.02
Fizz,Illaoi,49,20,29,40.82
Fizz,Amumu,124,51,73,41.13
Fizz,Vladimir,46,12,34,26.09
Fizz,Lux,235,116,119,49.36
Fizz,Jax,66,30,36,45.45
Fizz,Mordekaiser,101,39,62,38.61
Fizz,Ashe,147,65,82,44.22
Fizz,Rammus,53,19,34,35.85
Fizz,Mel,282,139,143,49.29
Fizz,Pantheon,116,45,71,38.79
Fizz,Heimerdinger,33,16,17,48.48
Fizz,Poppy,78,39,39,50
Fizz,Zilean,18,12,6,66.67
Fizz,Xayah,49,28,21,57.14
Fizz,Brand,65,25,40,38.46
Fizz,Kindred,38,18,20,47.37
Fizz,Veigar,176,69,107,39.2
Fizz,Aatrox,49,17,32,34.69
Fizz,TahmKench,91,38,53,41.76
Fizz,Rengar,24,15,9,62.5
Fizz,Sylas,137,65,72,47.45
Fizz,Tristana,109,47,62,43.12
Fizz,Viego,86,41,45,47.67
Fizz,Hwei,49,28,21,57.14
Fizz,Caitlyn,212,102,110,48.11
Fizz,Teemo,86,37,49,43.02
Fizz,Gwen,47,17,30,36.17
Fizz,Skarner,41,9,32,21.95
Fizz,AurelionSol,60,29,31,48.33
Fizz,Garen,163,70,93,42.94
Fizz,Lillia,60,35,25,58.33
Fizz,Lucian,89,42,47,47.19
Fizz,Diana,114,55,59,48.25
Fizz,Elise,79,32,47,40.51
Fizz,Jinx,248,92,156,37.1
Fizz,Quinn,27,24,3,88.89
Fizz,Vi,126,50,76,39.68
Fizz,Katarina,51,34,17,66.67
Fizz,Zac,65,50,15,76.92
Fizz,Kaisa,126,67,59,53.17
Fizz,Riven,49,24,25,48.98
Fizz,Zoe,23,18,5,78.26
Fizz,Sett,132,69,63,52.27
Fizz,Shaco,89,46,43,51.69
Fizz,Alistar,45,21,24,46.67
Fizz,Singed,31,18,13,58.06
Fizz,Milio,69,26,43,37.68
Fizz,Shen,87,47,40,54.02
Fizz,Samira,88,51,37,57.95
Fizz,Taric,17,3,14,17.65
Fizz,Irelia,79,34,45,43.04
Fizz,Draven,47,29,18,61.7
Fizz,Soraka,42,21,21,50
Fizz,Zyra,68,30,38,44.12
Fizz,LeeSin,134,50,84,37.31
Fizz,Volibear,121,54,67,44.63
Fizz,Yone,103,60,43,58.25
Fizz,DrMundo,66,45,21,68.18
Fizz,Anivia,45,19,26,42.22
Fizz,Vayne,129,53,76,41.09
Fizz,Nami,81,39,42,48.15
Fizz,Sion,87,32,55,36.78
Fizz,Thresh,128,63,65,49.22
Fizz,Orianna,34,19,15,55.88
Fizz,Nocturne,85,48,37,56.47
Fizz,Velkoz,69,38,31,55.07
Fizz,Evelynn,41,21,20,51.22
Fizz,Naafiri,32,22,10,68.75
Fizz,Aphelios,37,26,11,70.27
Fizz,Xerath,110,48,62,43.64
Fizz,Kayn,128,82,46,64.06
Fizz,Galio,89,45,44,50.56
Fizz,Smolder,69,31,38,44.93
Fizz,Renekton,59,31,28,52.54
Fizz,Kled,19,10,9,52.63
Fizz,FiddleSticks,39,9,30,23.08
Fizz,Ivern,24,12,12,50
Fizz,Varus,84,39,45,46.43
Fizz,Kalista,23,9,14,39.13
Fizz,Gangplank,41,23,18,56.1
Fizz,Shyvana,34,15,19,44.12
Fizz,Kassadin,21,8,13,38.1
Fizz,Viktor,106,56,50,52.83
Fizz,Ambessa,43,23,20,53.49
Fizz,Braum,120,53,67,44.17
Fizz,Leblanc,55,16,39,29.09
Fizz,Belveth,17,3,14,17.65
Fizz,Qiyana,23,12,11,52.17
Fizz,Leona,100,53,47,53
Fizz,Urgot,43,14,29,32.56
Fizz,Ekko,91,39,52,42.86
Fizz,Camille,44,24,20,54.55
Fizz,Sivir,43,31,12,72.09
Fizz,Sona,13,10,3,76.92
Fizz,Zed,96,36,60,37.5
Fizz,Pyke,93,50,43,53.76
Fizz,Syndra,85,40,45,47.06
Fizz,Karthus,32,24,8,75
Fizz,Kennen,32,14,18,43.75
Fizz,Trundle,70,24,46,34.29
Fizz,XinZhao,62,30,32,48.39
Fizz,Blitzcrank,70,33,37,47.14
Fizz,Rumble,27,13,14,48.15
Fizz,Hecarim,14,6,8,42.86
Fizz,Cassiopeia,31,6,25,19.35
Fizz,Rell,54,28,26,51.85
Fizz,Neeko,45,19,26,42.22
Fizz,Ahri,87,38,49,43.68
Fizz,Nasus,66,23,43,34.85
Fizz,Nunu,79,46,33,58.23
Fizz,Ornn,46,28,18,60.87
Fizz,Senna,52,16,36,30.77
Fizz,Twitch,84,35,49,41.67
Fizz,MonkeyKing,66,28,38,42.42
Fizz,KSante,42,30,12,71.43
Fizz,Vex,58,26,32,44.83
Fizz,Morgana,88,45,43,51.14
Fizz,Lissandra,39,11,28,28.21
Fizz,Akshan,29,14,15,48.28
Fizz,Maokai,37,17,20,45.95
Fizz,Gnar,40,14,26,35
Fizz,Azir,14,11,3,78.57
Fizz,Rakan,51,29,22,56.86
Fizz,Seraphine,71,46,25,64.79
Fizz,Graves,55,17,38,30.91
Fizz,Nilah,15,6,9,40
Fizz,JarvanIV,74,41,33,55.41
Fizz,Olaf,27,13,14,48.15
Fizz,Fiora,39,13,26,33.33
Fizz,Renata,16,9,7,56.25
Fizz,Kayle,43,21,22,48.84
Fizz,Ryze,47,21,26,44.68
Fizz,Bard,16,5,11,31.25
Fizz,Jayce,41,17,24,41.46
Fizz,Janna,32,12,20,37.5
Fizz,Taliyah,22,2,20,9.09
Fizz,Talon,28,13,15,46.43
Fizz,TwistedFate,36,29,7,80.56
Fizz,Udyr,23,12,11,52.17
Fizz,Ziggs,29,17,12,58.62
Fizz,Nidalee,19,11,8,57.89
Fizz,Zeri,10,5,5,50
Fizz,RekSai,10,7,3,70
Janna,Yorick,34,11,23,32.35
Janna,Kayn,83,40,43,48.19
Janna,Sylas,75,44,31,58.67
Janna,MissFortune,88,46,42,52.27
Janna,Renata,6,3,3,50
Janna,Aphelios,41,17,24,41.46
Janna,Udyr,19,16,3,84.21
Janna,Yasuo,83,35,48,42.17
Janna,Lucian,57,34,23,59.65
Janna,Karthus,11,3,8,27.27
Janna,Ambessa,63,34,29,53.97
Janna,Ekko,57,27,30,47.37
Janna,Lux,101,39,62,38.61
Janna,Caitlyn,155,96,59,61.94
Janna,Soraka,24,15,9,62.5
Janna,Vladimir,22,14,8,63.64
Janna,Viego,85,34,51,40
Janna,Hwei,41,28,13,68.29
Janna,Tristana,67,44,23,65.67
Janna,Lulu,93,45,48,48.39
Janna,Renekton,23,8,15,34.78
Janna,Jax,66,34,32,51.52
Janna,Leblanc,34,28,6,82.35
Janna,Thresh,126,74,52,58.73
Janna,Jayce,38,25,13,65.79
Janna,Vi,60,40,20,66.67
Janna,Orianna,48,31,17,64.58
Janna,Jhin,127,74,53,58.27
Janna,Volibear,60,31,29,51.67
Janna,Elise,61,34,27,55.74
Janna,Syndra,36,14,22,38.89
Janna,Leona,92,43,49,46.74
Janna,Nasus,42,32,10,76.19
Janna,Amumu,69,28,41,40.58
Janna,Naafiri,26,15,11,57.69
Janna,Varus,59,39,20,66.1
Janna,Zyra,37,14,23,37.84
Janna,Ornn,45,24,21,53.33
Janna,Gragas,71,45,26,63.38
Janna,Bard,20,15,5,75
Janna,Darius,100,48,52,48
Janna,Malzahar,60,30,30,50
Janna,JarvanIV,74,39,35,52.7
Janna,Yuumi,39,27,12,69.23
Janna,TahmKench,56,26,30,46.43
Janna,Rengar,14,8,6,57.14
Janna,Jinx,166,80,86,48.19
Janna,Milio,42,27,15,64.29
Janna,Sejuani,54,17,37,31.48
Janna,Aurora,78,26,52,33.33
Janna,Kaisa,84,55,29,65.48
Janna,Nautilus,86,38,48,44.19
Janna,Yone,91,53,38,58.24
Janna,Galio,68,40,28,58.82
Janna,Ziggs,37,19,18,51.35
Janna,Chogath,86,50,36,58.14
Janna,Tryndamere,20,12,8,60
Janna,Viktor,49,18,31,36.73
Janna,Shen,56,28,28,50
Janna,Diana,78,42,36,53.85
Janna,Rell,81,41,40,50.62
Janna,Irelia,57,25,32,43.86
Janna,Zeri,24,11,13,45.83
Janna,Mordekaiser,79,49,30,62.03
Janna,Mel,120,81,39,67.5
Janna,Nami,80,59,21,73.75
Janna,Nunu,29,19,10,65.52
Janna,Xerath,39,19,20,48.72
Janna,Nidalee,26,13,13,50
Janna,Braum,58,28,30,48.28
Janna,Shaco,50,36,14,72
Janna,Kassadin,23,5,18,21.74
Janna,Ezreal,139,67,72,48.2
Janna,Gnar,29,21,8,72.41
Janna,Trundle,41,28,13,68.29
Janna,Morgana,70,40,30,57.14
Janna,Ashe,107,53,54,49.53
Janna,Veigar,47,26,21,55.32
Janna,Karma,83,41,42,49.4
Janna,MasterYi,68,39,29,57.35
Janna,Swain,52,34,18,65.38
Janna,Brand,40,31,9,77.5
Janna,Urgot,32,23,9,71.88
Janna,DrMundo,20,11,9,55
Janna,Pantheon,82,54,28,65.85
Janna,Xayah,51,33,18,64.71
Janna,Rakan,61,31,30,50.82
Janna,Katarina,30,20,10,66.67
Janna,KSante,39,31,8,79.49
Janna,Quinn,33,9,24,27.27
Janna,Fiora,10,5,5,50
Janna,Riven,21,13,8,61.9
Janna,Qiyana,8,5,3,62.5
Janna,Kindred,29,19,10,65.52
Janna,Lissandra,17,12,5,70.59
Janna,LeeSin,88,57,31,64.77
Janna,Warwick,71,38,33,53.52
Janna,Sona,21,14,7,66.67
Janna,Olaf,21,14,7,66.67
Janna,Vayne,83,53,30,63.86
Janna,Zac,50,22,28,44
Janna,Kennen,31,14,17,45.16
Janna,Shyvana,23,5,18,21.74
Janna,Poppy,46,40,6,86.96
Janna,Samira,63,24,39,38.1
Janna,MonkeyKing,38,23,15,60.53
Janna,Singed,24,9,15,37.5
Janna,Ivern,12,6,6,50
Janna,Talon,26,10,16,38.46
Janna,Kayle,46,19,27,41.3
Janna,Malphite,71,39,32,54.93
Janna,Sett,83,27,56,32.53
Janna,Briar,26,11,15,42.31
Janna,Draven,35,11,24,31.43
Janna,Pyke,49,28,21,57.14
Janna,Teemo,57,35,22,61.4
Janna,Nocturne,49,25,24,51.02
Janna,Anivia,34,15,19,44.12
Janna,Blitzcrank,41,23,18,56.1
Janna,Smolder,48,17,31,35.42
Janna,KogMaw,11,6,5,54.55
Janna,Khazix,31,15,16,48.39
Janna,Annie,11,5,6,45.45
Janna,Ahri,97,51,46,52.58
Janna,XinZhao,47,36,11,76.6
Janna,FiddleSticks,21,8,13,38.1
Janna,Zed,63,33,30,52.38
Janna,Zoe,29,14,15,48.28
Janna,Gangplank,26,18,8,69.23
Janna,Graves,28,9,19,32.14
Janna,Vex,27,13,14,48.15
Janna,Sivir,22,16,6,72.73
Janna,Aatrox,62,32,30,51.61
Janna,Zilean,22,17,5,77.27
Janna,Garen,94,50,44,53.19
Janna,Camille,30,16,14,53.33
Janna,Hecarim,23,9,14,39.13
Janna,Rammus,10,7,3,70
Janna,Seraphine,32,18,14,56.25
Janna,Gwen,39,19,20,48.72
Janna,Sion,47,32,15,68.09
Janna,Neeko,27,13,14,48.15
Janna,Senna,48,27,21,56.25
Janna,Illaoi,24,19,5,79.17
Janna,AurelionSol,28,15,13,53.57
Janna,Evelynn,21,12,9,57.14
Janna,Twitch,40,29,11,72.5
Janna,Alistar,38,17,21,44.74
Janna,Lillia,28,10,18,35.71
Janna,Cassiopeia,19,10,9,52.63
Janna,Taliyah,22,17,5,77.27
Janna,Nilah,21,9,12,42.86
Janna,Akshan,26,12,14,46.15
Janna,Ryze,16,11,5,68.75
Janna,Kalista,17,13,4,76.47
Janna,Skarner,12,4,8,33.33
Janna,Belveth,20,7,13,35
Janna,Azir,35,22,13,62.86
Janna,Akali,73,32,41,43.84
Janna,TwistedFate,14,10,4,71.43
Janna,Fizz,32,20,12,62.5
Janna,Maokai,25,5,20,20
Janna,Velkoz,40,21,19,52.5
Janna,Taric,4,4,0,100
Janna,Corki,20,5,15,25
Janna,Rumble,8,0,8,0
Janna,RekSai,9,9,0,100
Janna,Kled,9,9,0,100
Janna,Heimerdinger,8,2,6,25
Nidalee,Nasus,41,15,26,36.59
Nidalee,Viego,105,34,71,32.38
Nidalee,Cassiopeia,32,5,27,15.63
Nidalee,Ezreal,225,78,147,34.67
Nidalee,Karma,97,41,56,42.27
Nidalee,Yorick,52,8,44,15.38
Nidalee,Kayn,63,25,38,39.68
Nidalee,Swain,60,16,44,26.67
Nidalee,Caitlyn,185,76,109,41.08
Nidalee,Shen,48,21,27,43.75
Nidalee,Gnar,39,12,27,30.77
Nidalee,Udyr,36,13,23,36.11
Nidalee,Aatrox,99,34,65,34.34
Nidalee,MissFortune,114,53,61,46.49
Nidalee,Nautilus,110,33,77,30
Nidalee,Varus,55,30,25,54.55
Nidalee,DrMundo,38,21,17,55.26
Nidalee,Aurora,58,29,29,50
Nidalee,Rakan,36,17,19,47.22
Nidalee,Shaco,68,26,42,38.24
Nidalee,Darius,115,56,59,48.7
Nidalee,Sett,98,46,52,46.94
Nidalee,Lux,176,76,100,43.18
Nidalee,Riven,29,11,18,37.93
Nidalee,MonkeyKing,64,32,32,50
Nidalee,AurelionSol,19,8,11,42.11
Nidalee,Ashe,149,79,70,53.02
Nidalee,Poppy,68,31,37,45.59
Nidalee,Diana,129,58,71,44.96
Nidalee,LeeSin,214,99,115,46.26
Nidalee,Galio,102,50,52,49.02
Nidalee,Twitch,26,13,13,50
Nidalee,Lulu,95,47,48,49.47
Nidalee,Ekko,55,18,37,32.73
Nidalee,Ahri,84,38,46,45.24
Nidalee,Lucian,78,37,41,47.44
Nidalee,Nami,59,21,38,35.59
Nidalee,TahmKench,56,22,34,39.29
Nidalee,Malzahar,67,25,42,37.31
Nidalee,Draven,48,16,32,33.33
Nidalee,Blitzcrank,79,27,52,34.18
Nidalee,KSante,50,27,23,54
Nidalee,FiddleSticks,33,7,26,21.21
Nidalee,Tristana,48,24,24,50
Nidalee,Leona,53,23,30,43.4
Nidalee,Heimerdinger,25,14,11,56
Nidalee,Zoe,38,16,22,42.11
Nidalee,Sylas,105,52,53,49.52
Nidalee,Smolder,50,23,27,46
Nidalee,Morgana,53,22,31,41.51
Nidalee,Zed,68,49,19,72.06
Nidalee,Singed,9,3,6,33.33
Nidalee,Khazix,57,30,27,52.63
Nidalee,Irelia,45,16,29,35.56
Nidalee,Malphite,62,41,21,66.13
Nidalee,Talon,49,19,30,38.78
Nidalee,Qiyana,27,16,11,59.26
Nidalee,Yone,130,66,64,50.77
Nidalee,Belveth,22,14,8,63.64
Nidalee,Vladimir,56,22,34,39.29
Nidalee,Mel,163,83,80,50.92
Nidalee,Soraka,47,22,25,46.81
Nidalee,Kayle,43,17,26,39.53
Nidalee,Zac,64,24,40,37.5
Nidalee,Jhin,176,73,103,41.48
Nidalee,Xerath,67,27,40,40.3
Nidalee,Xayah,46,21,25,45.65
Nidalee,Senna,20,15,5,75
Nidalee,Vayne,77,35,42,45.45
Nidalee,Kindred,12,0,12,0
Nidalee,Yasuo,97,29,68,29.9
Nidalee,Nilah,22,11,11,50
Nidalee,Yuumi,79,36,43,45.57
Nidalee,Pantheon,131,56,75,42.75
Nidalee,JarvanIV,69,38,31,55.07
Nidalee,Akali,88,33,55,37.5
Nidalee,Janna,26,13,13,50
Nidalee,Garen,114,54,60,47.37
Nidalee,Volibear,41,21,20,51.22
Nidalee,Kaisa,144,51,93,35.42
Nidalee,Amumu,81,28,53,34.57
Nidalee,Warwick,64,11,53,17.19
Nidalee,Rell,57,13,44,22.81
Nidalee,Camille,30,9,21,30
Nidalee,Mordekaiser,84,48,36,57.14
Nidalee,Gragas,62,33,29,53.23
Nidalee,Lissandra,29,10,19,34.48
Nidalee,Elise,64,34,30,53.13
Nidalee,Urgot,36,12,24,33.33
Nidalee,Leblanc,23,10,13,43.48
Nidalee,Corki,30,10,20,33.33
Nidalee,Illaoi,21,9,12,42.86
Nidalee,Sivir,30,16,14,53.33
Nidalee,Syndra,46,14,32,30.43
Nidalee,Ambessa,67,25,42,37.31
Nidalee,Veigar,60,19,41,31.67
Nidalee,Seraphine,54,16,38,29.63
Nidalee,Sion,47,23,24,48.94
Nidalee,Samira,58,20,38,34.48
Nidalee,Renekton,63,34,29,53.97
Nidalee,Hwei,70,46,24,65.71
Nidalee,Rumble,32,15,17,46.88
Nidalee,Hecarim,20,14,6,70
Nidalee,Taliyah,14,6,8,42.86
Nidalee,Zyra,65,22,43,33.85
Nidalee,Tryndamere,17,8,9,47.06
Nidalee,MasterYi,42,18,24,42.86
Nidalee,Azir,40,20,20,50
Nidalee,Chogath,81,38,43,46.91
Nidalee,Brand,34,27,7,79.41
Nidalee,Jax,58,33,25,56.9
Nidalee,Sejuani,46,23,23,50
Nidalee,Viktor,53,13,40,24.53
Nidalee,Vex,34,14,20,41.18
Nidalee,Thresh,123,54,69,43.9
Nidalee,Milio,44,22,22,50
Nidalee,TwistedFate,30,15,15,50
Nidalee,Shyvana,17,15,2,88.24
Nidalee,Akshan,34,19,15,55.88
Nidalee,Zilean,27,8,19,29.63
Nidalee,KogMaw,7,2,5,28.57
Nidalee,Braum,40,21,19,52.5
Nidalee,Kalista,28,12,16,42.86
Nidalee,Olaf,29,13,16,44.83
Nidalee,Rammus,18,2,16,11.11
Nidalee,Katarina,37,17,20,45.95
Nidalee,Gwen,27,10,17,37.04
Nidalee,Briar,30,13,17,43.33
Nidalee,XinZhao,37,16,21,43.24
Nidalee,Skarner,34,7,27,20.59
Nidalee,Teemo,80,34,46,42.5
Nidalee,Kassadin,8,3,5,37.5
Nidalee,Taric,15,13,2,86.67
Nidalee,Nocturne,75,39,36,52
Nidalee,Fiora,24,10,14,41.67
Nidalee,Orianna,41,10,31,24.39
Nidalee,Alistar,33,16,17,48.48
Nidalee,Lillia,35,11,24,31.43
Nidalee,Zeri,33,19,14,57.58
Nidalee,Maokai,46,22,24,47.83
Nidalee,Ornn,44,18,26,40.91
Nidalee,Jinx,189,85,104,44.97
Nidalee,Nunu,33,12,21,36.36
Nidalee,Rengar,28,18,10,64.29
Nidalee,Anivia,24,16,8,66.67
Nidalee,Pyke,59,29,30,49.15
Nidalee,Quinn,26,10,16,38.46
Nidalee,Karthus,23,6,17,26.09
Nidalee,Kennen,21,5,16,23.81
Nidalee,Gangplank,30,7,23,23.33
Nidalee,Trundle,14,5,9,35.71
Nidalee,Bard,11,5,6,45.45
Nidalee,Aphelios,23,10,13,43.48
Nidalee,Renata,8,5,3,62.5
Nidalee,Graves,70,24,46,34.29
Nidalee,Fizz,19,8,11,42.11
Nidalee,Kled,10,3,7,30
Nidalee,Velkoz,15,10,5,66.67
Nidalee,Neeko,35,9,26,25.71
Nidalee,Vi,73,33,40,45.21
Nidalee,Ivern,12,0,12,0
Nidalee,Annie,36,15,21,41.67
Nidalee,Jayce,37,11,26,29.73
Nidalee,Evelynn,10,8,2,80
Nidalee,Ryze,27,6,21,22.22
Nidalee,Ziggs,19,8,11,42.11
Nidalee,Naafiri,14,5,9,35.71
Nidalee,Sona,19,5,14,26.32
Nidalee,RekSai,5,5,0,100
Brand,Nasus,110,63,47,57.27
Brand,Viego,138,50,88,36.23
Brand,Cassiopeia,26,16,10,61.54
Brand,Ezreal,276,154,122,55.8
Brand,Karma,91,24,67,26.37
Brand,Mordekaiser,145,67,78,46.21
Brand,Hecarim,41,19,22,46.34
Brand,Sett,134,58,76,43.28
Brand,Xayah,55,24,31,43.64
Brand,Lulu,133,65,68,48.87
Brand,Sion,107,58,49,54.21
Brand,Ambessa,94,46,48,48.94
Brand,Viktor,133,57,76,42.86
Brand,Jinx,312,110,202,35.26
Brand,Mel,258,159,99,61.63
Brand,MasterYi,93,26,67,27.96
Brand,Chogath,100,52,48,52
Brand,Amumu,198,101,97,51.01
Brand,Nocturne,133,60,73,45.11
Brand,Poppy,73,37,36,50.68
Brand,Caitlyn,321,164,157,51.09
Brand,Gangplank,53,31,22,58.49
Brand,Ekko,110,57,53,51.82
Brand,Elise,92,26,66,28.26
Brand,Alistar,44,31,13,70.45
Brand,Draven,65,41,24,63.08
Brand,Camille,32,16,16,50
Brand,Akali,129,68,61,52.71
Brand,Shaco,95,58,37,61.05
Brand,Jhin,206,91,115,44.17
Brand,Milio,71,28,43,39.44
Brand,Nunu,88,49,39,55.68
Brand,Lux,337,148,189,43.92
Brand,Diana,177,87,90,49.15
Brand,Velkoz,74,26,48,35.14
Brand,Ashe,233,98,135,42.06
Brand,MissFortune,258,114,144,44.19
Brand,Warwick,158,65,93,41.14
Brand,Graves,45,26,19,57.78
Brand,Azir,35,23,12,65.71
Brand,Nami,86,39,47,45.35
Brand,Darius,164,70,94,42.68
Brand,Kayn,148,92,56,62.16
Brand,Fizz,65,40,25,61.54
Brand,Nautilus,176,93,83,52.84
Brand,Vex,63,28,35,44.44
Brand,Lucian,91,43,48,47.25
Brand,Morgana,119,50,69,42.02
Brand,Urgot,70,27,43,38.57
Brand,XinZhao,61,19,42,31.15
Brand,Vladimir,75,38,37,50.67
Brand,Ryze,34,18,16,52.94
Brand,Braum,114,50,64,43.86
Brand,Zyra,100,51,49,51
Brand,Briar,49,17,32,34.69
Brand,TwistedFate,53,29,24,54.72
Brand,Sivir,36,16,20,44.44
Brand,Yasuo,172,87,85,50.58
Brand,TahmKench,163,75,88,46.01
Brand,Leona,119,68,51,57.14
Brand,Jax,91,48,43,52.75
Brand,Evelynn,38,13,25,34.21
Brand,Kaisa,160,94,66,58.75
Brand,Seraphine,135,62,73,45.93
Brand,Garen,213,79,134,37.09
Brand,Hwei,61,20,41,32.79
Brand,Leblanc,52,26,26,50
Brand,Ivern,29,10,19,34.48
Brand,Teemo,133,57,76,42.86
Brand,Shen,107,55,52,51.4
Brand,Ziggs,40,20,20,50
Brand,Swain,137,69,68,50.36
Brand,Tristana,103,49,54,47.57
Brand,Kindred,33,17,16,51.52
Brand,Yone,159,68,91,42.77
Brand,Soraka,56,20,36,35.71
Brand,Rengar,54,40,14,74.07
Brand,Malzahar,128,74,54,57.81
Brand,Fiora,18,8,10,44.44
Brand,Sejuani,69,37,32,53.62
Brand,Volibear,146,60,86,41.1
Brand,Nilah,55,36,19,65.45
Brand,Pantheon,165,96,69,58.18
Brand,Vi,123,62,61,50.41
Brand,Zed,122,40,82,32.79
Brand,Aurora,79,41,38,51.9
Brand,JarvanIV,77,50,27,64.94
Brand,Ahri,151,68,83,45.03
Brand,Zeri,59,24,35,40.68
Brand,Jayce,33,20,13,60.61
Brand,AurelionSol,57,29,28,50.88
Brand,Yuumi,90,41,49,45.56
Brand,Sylas,115,64,51,55.65
Brand,Malphite,113,56,57,49.56
Brand,Twitch,92,33,59,35.87
Brand,Senna,56,24,32,42.86
Brand,Zoe,66,32,34,48.48
Brand,Gnar,67,35,32,52.24
Brand,Belveth,24,8,16,33.33
Brand,Irelia,70,32,38,45.71
Brand,Anivia,31,19,12,61.29
Brand,Katarina,86,47,39,54.65
Brand,Vayne,124,65,59,52.42
Brand,DrMundo,69,40,29,57.97
Brand,Rumble,23,10,13,43.48
Brand,Khazix,47,30,17,63.83
Brand,Corki,47,35,12,74.47
Brand,Aatrox,104,56,48,53.85
Brand,Udyr,48,40,8,83.33
Brand,Rell,83,41,42,49.4
Brand,Sona,21,10,11,47.62
Brand,Veigar,129,65,64,50.39
Brand,Bard,39,23,16,58.97
Brand,Yorick,107,41,66,38.32
Brand,Janna,40,9,31,22.5
Brand,Quinn,35,13,22,37.14
Brand,Rammus,25,14,11,56
Brand,Rakan,64,33,31,51.56
Brand,Ornn,58,23,35,39.66
Brand,Samira,79,37,42,46.84
Brand,Lissandra,26,14,12,53.85
Brand,Olaf,29,10,19,34.48
Brand,Thresh,175,102,73,58.29
Brand,Gragas,84,39,45,46.43
Brand,Neeko,55,30,25,54.55
Brand,Varus,82,45,37,54.88
Brand,Aphelios,50,20,30,40
Brand,Naafiri,26,12,14,46.15
Brand,Tryndamere,56,26,30,46.43
Brand,Gwen,58,23,35,39.66
Brand,Smolder,91,39,52,42.86
Brand,KSante,36,17,19,47.22
Brand,Karthus,36,19,17,52.78
Brand,Syndra,77,35,42,45.45
Brand,Blitzcrank,83,39,44,46.99
Brand,Taliyah,32,18,14,56.25
Brand,Orianna,37,16,21,43.24
Brand,Galio,110,48,62,43.64
Brand,LeeSin,130,64,66,49.23
Brand,FiddleSticks,84,38,46,45.24
Brand,Qiyana,36,21,15,58.33
Brand,Riven,42,10,32,23.81
Brand,Pyke,75,39,36,52
Brand,Skarner,50,20,30,40
Brand,Nidalee,34,7,27,20.59
Brand,Lillia,73,43,30,58.9
Brand,MonkeyKing,60,27,33,45
Brand,Illaoi,59,32,27,54.24
Brand,Heimerdinger,53,21,32,39.62
Brand,Talon,42,20,22,47.62
Brand,Zac,59,30,29,50.85
Brand,Xerath,80,41,39,51.25
Brand,Kayle,44,17,27,38.64
Brand,Singed,32,11,21,34.38
Brand,Akshan,19,17,2,89.47
Brand,Trundle,49,17,32,34.69
Brand,RekSai,25,16,9,64
Brand,Renata,21,14,7,66.67
Brand,Taric,15,6,9,40
Brand,Annie,49,28,21,57.14
Brand,Renekton,42,29,13,69.05
Brand,KogMaw,32,11,21,34.38
Brand,Kalista,33,16,17,48.48
Brand,Maokai,42,19,23,45.24
Brand,Kled,26,13,13,50
Brand,Zilean,34,17,17,50
Brand,Kassadin,21,4,17,19.05
Brand,Shyvana,27,9,18,33.33
Brand,Kennen,38,25,13,65.79
Kalista,Gangplank,34,19,15,55.88
Kalista,Pantheon,132,50,82,37.88
Kalista,TwistedFate,36,20,16,55.56
Kalista,Kaisa,95,48,47,50.53
Kalista,Braum,66,35,31,53.03
Kalista,Aatrox,79,39,40,49.37
Kalista,Teemo,71,31,40,43.66
Kalista,Aurora,67,40,27,59.7
Kalista,Sivir,47,13,34,27.66
Kalista,Blitzcrank,79,45,34,56.96
Kalista,Sett,97,42,55,43.3
Kalista,JarvanIV,56,12,44,21.43
Kalista,Veigar,68,19,49,27.94
Kalista,Lux,125,48,77,38.4
Kalista,Thresh,96,31,65,32.29
Kalista,Ivern,8,5,3,62.5
Kalista,Orianna,33,12,21,36.36
Kalista,Twitch,41,24,17,58.54
Kalista,Gnar,47,8,39,17.02
Kalista,Graves,60,32,28,53.33
Kalista,Ezreal,217,109,108,50.23
Kalista,Karma,57,29,28,50.88
Kalista,Shen,62,21,41,33.87
Kalista,Diana,113,70,43,61.95
Kalista,Yorick,56,30,26,53.57
Kalista,Nasus,61,33,28,54.1
Kalista,Darius,109,51,58,46.79
Kalista,Chogath,71,39,32,54.93
Kalista,Jinx,167,79,88,47.31
Kalista,Sona,20,11,9,55
Kalista,MonkeyKing,29,10,19,34.48
Kalista,Syndra,82,39,43,47.56
Kalista,Yasuo,126,62,64,49.21
Kalista,Caitlyn,148,68,80,45.95
Kalista,Heimerdinger,16,7,9,43.75
Kalista,XinZhao,24,6,18,25
Kalista,Malzahar,63,23,40,36.51
Kalista,Varus,42,13,29,30.95
Kalista,Maokai,30,22,8,73.33
Kalista,Warwick,95,45,50,47.37
Kalista,LeeSin,130,59,71,45.38
Kalista,Neeko,23,14,9,60.87
Kalista,Lucian,71,29,42,40.85
Kalista,Yone,116,54,62,46.55
Kalista,Viktor,75,26,49,34.67
Kalista,Vladimir,36,13,23,36.11
Kalista,Shyvana,26,12,14,46.15
Kalista,Katarina,57,19,38,33.33
Kalista,Draven,39,24,15,61.54
Kalista,Malphite,69,31,38,44.93
Kalista,MissFortune,147,75,72,51.02
Kalista,Elise,58,33,25,56.9
Kalista,Nocturne,75,37,38,49.33
Kalista,TahmKench,56,32,24,57.14
Kalista,Lillia,34,18,16,52.94
Kalista,AurelionSol,17,9,8,52.94
Kalista,Garen,124,52,72,41.94
Kalista,Viego,107,45,62,42.06
Kalista,Morgana,70,40,30,57.14
Kalista,Renekton,33,15,18,45.45
Kalista,Kindred,37,21,16,56.76
Kalista,Ahri,102,45,57,44.12
Kalista,Lulu,79,31,48,39.24
Kalista,Mordekaiser,96,51,45,53.13
Kalista,Hwei,58,28,30,48.28
Kalista,MasterYi,74,28,46,37.84
Kalista,Ashe,153,68,85,44.44
Kalista,Milio,55,26,29,47.27
Kalista,Nunu,38,23,15,60.53
Kalista,Vayne,74,28,46,37.84
Kalista,Rakan,37,6,31,16.22
Kalista,Illaoi,34,14,20,41.18
Kalista,Zac,53,20,33,37.74
Kalista,Mel,128,46,82,35.94
Kalista,Fizz,23,14,9,60.87
Kalista,Sejuani,55,23,32,41.82
Kalista,Sylas,112,50,62,44.64
Kalista,Jhin,122,58,64,47.54
Kalista,Nautilus,86,46,40,53.49
Kalista,Ambessa,48,23,25,47.92
Kalista,Udyr,24,10,14,41.67
Kalista,Seraphine,45,17,28,37.78
Kalista,Khazix,24,3,21,12.5
Kalista,Leona,71,32,39,45.07
Kalista,Jax,39,23,16,58.97
Kalista,Galio,77,42,35,54.55
Kalista,Velkoz,34,20,14,58.82
Kalista,Irelia,39,17,22,43.59
Kalista,Kayn,73,46,27,63.01
Kalista,Smolder,51,21,30,41.18
Kalista,Zyra,43,8,35,18.6
Kalista,Fiora,29,18,11,62.07
Kalista,Rell,38,17,21,44.74
Kalista,Nami,52,19,33,36.54
Kalista,Taliyah,15,8,7,53.33
Kalista,Riven,14,6,8,42.86
Kalista,Gragas,58,26,32,44.83
Kalista,Pyke,58,32,26,55.17
Kalista,Briar,40,9,31,22.5
Kalista,Corki,21,14,7,66.67
Kalista,Leblanc,63,25,38,39.68
Kalista,KSante,28,13,15,46.43
Kalista,Jayce,34,17,17,50
Kalista,Skarner,38,33,5,86.84
Kalista,Gwen,33,14,19,42.42
Kalista,Zed,48,29,19,60.42
Kalista,Samira,59,22,37,37.29
Kalista,Amumu,69,10,59,14.49
Kalista,Senna,37,17,20,45.95
Kalista,Swain,67,22,45,32.84
Kalista,Camille,25,16,9,64
Kalista,Ekko,33,7,26,21.21
Kalista,Bard,18,6,12,33.33
Kalista,Belveth,14,5,9,35.71
Kalista,Vi,63,32,31,50.79
Kalista,Tristana,47,18,29,38.3
Kalista,Poppy,81,37,44,45.68
Kalista,Xerath,43,22,21,51.16
Kalista,Cassiopeia,17,6,11,35.29
Kalista,Vex,35,21,14,60
Kalista,Kayle,29,13,16,44.83
Kalista,Rengar,20,14,6,70
Kalista,RekSai,6,3,3,50
Kalista,Kassadin,13,3,10,23.08
Kalista,Soraka,36,20,16,55.56
Kalista,Nidalee,28,16,12,57.14
Kalista,Hecarim,27,19,8,70.37
Kalista,DrMundo,30,7,23,23.33
Kalista,Urgot,26,8,18,30.77
Kalista,Renata,25,11,14,44
Kalista,Taric,18,7,11,38.89
Kalista,Olaf,17,0,17,0
Kalista,Sion,54,28,26,51.85
Kalista,Trundle,46,16,30,34.78
Kalista,Akshan,21,13,8,61.9
Kalista,Azir,29,20,9,68.97
Kalista,Yuumi,54,23,31,42.59
Kalista,Akali,58,37,21,63.79
Kalista,Volibear,40,23,17,57.5
Kalista,Lissandra,35,25,10,71.43
Kalista,Naafiri,10,7,3,70
Kalista,FiddleSticks,19,10,9,52.63
Kalista,Annie,17,14,3,82.35
Kalista,Nilah,19,4,15,21.05
Kalista,Evelynn,15,4,11,26.67
Kalista,Brand,33,17,16,51.52
Kalista,Aphelios,32,8,24,25
Kalista,Rammus,31,16,15,51.61
Kalista,Janna,17,4,13,23.53
Kalista,Qiyana,12,7,5,58.33
Kalista,Zilean,17,2,15,11.76
Kalista,Xayah,29,12,17,41.38
Kalista,Kled,14,9,5,64.29
Kalista,Singed,21,11,10,52.38
Kalista,Shaco,25,6,19,24
Kalista,Ziggs,15,2,13,13.33
Kalista,Kennen,14,14,0,100
Kalista,Ornn,55,18,37,32.73
Kalista,Quinn,19,8,11,42.11
Kalista,Rumble,15,8,7,53.33
Kalista,Zeri,23,10,13,43.48
Kalista,KogMaw,14,3,11,21.43
Kalista,Anivia,15,0,15,0
Kalista,Tryndamere,31,14,17,45.16
Kalista,Karthus,5,0,5,0
Kalista,Talon,30,21,9,70
Kalista,Zoe,35,15,20,42.86
Kalista,Alistar,28,9,19,32.14
Kalista,Ryze,19,10,9,52.63
Zeri,Leona,116,62,54,53.45
Zeri,Rammus,34,15,19,44.12
Zeri,Lux,182,98,84,53.85
Zeri,Twitch,75,43,32,57.33
Zeri,Aatrox,114,61,53,53.51
Zeri,TahmKench,70,34,36,48.57
Zeri,Viego,126,77,49,61.11
Zeri,Zed,76,33,43,43.42
Zeri,Veigar,91,43,48,47.25
Zeri,Ziggs,25,21,4,84
Zeri,KSante,101,66,35,65.35
Zeri,Gragas,52,17,35,32.69
Zeri,Irelia,48,16,32,33.33
Zeri,Caitlyn,183,97,86,53.01
Zeri,Rell,81,37,44,45.68
Zeri,Riven,31,18,13,58.06
Zeri,Shaco,72,35,37,48.61
Zeri,Katarina,53,23,30,43.4
Zeri,Tristana,66,34,32,51.52
Zeri,Milio,87,42,45,48.28
Zeri,Jax,85,45,40,52.94
Zeri,LeeSin,185,96,89,51.89
Zeri,Malzahar,94,46,48,48.94
Zeri,Jinx,254,107,147,42.13
Zeri,Ornn,54,25,29,46.3
Zeri,Akali,103,57,46,55.34
Zeri,Elise,62,46,16,74.19
Zeri,Draven,65,38,27,58.46
Zeri,Pyke,82,54,28,65.85
Zeri,Qiyana,29,18,11,62.07
Zeri,Briar,46,24,22,52.17
Zeri,Hwei,49,31,18,63.27
Zeri,Lucian,97,52,45,53.61
Zeri,Darius,149,58,91,38.93
Zeri,Nocturne,98,59,39,60.2
Zeri,Azir,58,40,18,68.97
Zeri,Jhin,131,87,44,66.41
Zeri,Sona,18,13,5,72.22
Zeri,Sion,80,43,37,53.75
Zeri,MasterYi,79,35,44,44.3
Zeri,Mel,186,104,82,55.91
Zeri,Ahri,116,27,89,23.28
Zeri,Teemo,81,43,38,53.09
Zeri,Karma,116,51,65,43.97
Zeri,Vladimir,71,35,36,49.3
Zeri,Kayn,91,52,39,57.14
Zeri,Volibear,101,51,50,50.5
Zeri,Blitzcrank,87,37,50,42.53
Zeri,Alistar,65,37,28,56.92
Zeri,Evelynn,33,18,15,54.55
Zeri,Vex,34,14,20,41.18
Zeri,Sivir,54,22,32,40.74
Zeri,Annie,34,17,17,50
Zeri,Trundle,31,14,17,45.16
Zeri,Belveth,18,5,13,27.78
Zeri,Yasuo,168,82,86,48.81
Zeri,Zoe,37,28,9,75.68
Zeri,Mordekaiser,95,44,51,46.32
Zeri,Amumu,95,31,64,32.63
Zeri,Brand,59,35,24,59.32
Zeri,Yorick,89,47,42,52.81
Zeri,Kayle,32,12,20,37.5
Zeri,Shen,50,21,29,42
Zeri,Garen,144,70,74,48.61
Zeri,Viktor,85,40,45,47.06
Zeri,Camille,41,23,18,56.1
Zeri,Tryndamere,17,12,5,70.59
Zeri,Thresh,190,77,113,40.53
Zeri,Aurora,74,42,32,56.76
Zeri,Janna,24,13,11,54.17
Zeri,RekSai,14,9,5,64.29
Zeri,Neeko,49,34,15,69.39
Zeri,Poppy,88,50,38,56.82
Zeri,Sejuani,51,23,28,45.1
Zeri,Velkoz,30,11,19,36.67
Zeri,Ivern,25,8,17,32
Zeri,Nilah,38,21,17,55.26
Zeri,Ekko,61,31,30,50.82
Zeri,Ashe,168,85,83,50.6
Zeri,Nami,66,28,38,42.42
Zeri,Sett,128,57,71,44.53
Zeri,Renekton,52,25,27,48.08
Zeri,Ezreal,270,147,123,54.44
Zeri,Gnar,37,19,18,51.35
Zeri,Urgot,27,11,16,40.74
Zeri,Leblanc,70,35,35,50
Zeri,Corki,55,13,42,23.64
Zeri,Naafiri,36,16,20,44.44
Zeri,Seraphine,34,20,14,58.82
Zeri,Diana,131,71,60,54.2
Zeri,Lissandra,39,12,27,30.77
Zeri,Aphelios,51,18,33,35.29
Zeri,Lulu,154,85,69,55.19
Zeri,Khazix,55,39,16,70.91
Zeri,Malphite,93,58,35,62.37
Zeri,Nasus,55,36,19,65.45
Zeri,MonkeyKing,79,40,39,50.63
Zeri,Smolder,79,51,28,64.56
Zeri,Udyr,31,20,11,64.52
Zeri,Yone,200,121,79,60.5
Zeri,Nautilus,115,64,51,55.65
Zeri,Quinn,30,20,10,66.67
Zeri,Samira,77,45,32,58.44
Zeri,Pantheon,142,76,66,53.52
Zeri,Fiora,56,37,19,66.07
Zeri,Kassadin,21,16,5,76.19
Zeri,Varus,85,41,44,48.24
Zeri,XinZhao,42,30,12,71.43
Zeri,Ryze,48,26,22,54.17
Zeri,Sylas,131,78,53,59.54
Zeri,JarvanIV,76,37,39,48.68
Zeri,Bard,18,5,13,27.78
Zeri,Zac,72,42,30,58.33
Zeri,Karthus,24,8,16,33.33
Zeri,Kaisa,172,93,79,54.07
Zeri,Lillia,59,39,20,66.1
Zeri,Orianna,52,27,25,51.92
Zeri,Xayah,67,33,34,49.25
Zeri,Chogath,130,56,74,43.08
Zeri,FiddleSticks,42,15,27,35.71
Zeri,Yuumi,99,41,58,41.41
Zeri,Cassiopeia,41,17,24,41.46
Zeri,Rakan,53,17,36,32.08
Zeri,MissFortune,125,53,72,42.4
Zeri,Warwick,95,48,47,50.53
Zeri,Morgana,73,36,37,49.32
Zeri,Singed,18,9,9,50
Zeri,Anivia,43,26,17,60.47
Zeri,Vayne,140,66,74,47.14
Zeri,Xerath,52,22,30,42.31
Zeri,Nunu,49,23,26,46.94
Zeri,Heimerdinger,35,17,18,48.57
Zeri,Hecarim,41,17,24,41.46
Zeri,Vi,116,46,70,39.66
Zeri,Swain,88,37,51,42.05
Zeri,Rengar,40,26,14,65
Zeri,Senna,27,7,20,25.93
Zeri,Gwen,67,36,31,53.73
Zeri,Maokai,54,28,26,51.85
Zeri,Zilean,21,7,14,33.33
Zeri,DrMundo,50,16,34,32
Zeri,Taliyah,41,17,24,41.46
Zeri,Akshan,17,9,8,52.94
Zeri,TwistedFate,31,17,14,54.84
Zeri,Nidalee,33,14,19,42.42
Zeri,KogMaw,39,22,17,56.41
Zeri,Soraka,38,29,9,76.32
Zeri,Jayce,50,29,21,58
Zeri,Zyra,88,44,44,50
Zeri,Olaf,28,9,19,32.14
Zeri,Kled,19,9,10,47.37
Zeri,Skarner,48,18,30,37.5
Zeri,Gangplank,34,18,16,52.94
Zeri,Syndra,69,41,28,59.42
Zeri,Taric,13,5,8,38.46
Zeri,Rumble,25,13,12,52
Zeri,AurelionSol,26,14,12,53.85
Zeri,Galio,104,58,46,55.77
Zeri,Illaoi,42,12,30,28.57
Zeri,Kindred,29,22,7,75.86
Zeri,Talon,46,20,26,43.48
Zeri,Ambessa,51,26,25,50.98
Zeri,Braum,66,35,31,53.03
Zeri,Graves,76,39,37,51.32
Zeri,Kalista,23,13,10,56.52
Zeri,Kennen,28,20,8,71.43
Zeri,Renata,7,3,4,42.86
Zeri,Fizz,10,5,5,50
Zeri,Shyvana,8,2,6,25
Rumble,Aatrox,62,29,33,46.77
Rumble,Briar,37,17,20,45.95
Rumble,Ahri,67,32,35,47.76
Rumble,Ezreal,160,77,83,48.13
Rumble,Elise,69,25,44,36.23
Rumble,Ornn,47,24,23,51.06
Rumble,Jax,68,46,22,67.65
Rumble,Ashe,107,59,48,55.14
Rumble,Yuumi,58,25,33,43.1
Rumble,Mordekaiser,70,30,40,42.86
Rumble,Gragas,65,14,51,21.54
Rumble,Neeko,34,19,15,55.88
Rumble,Karma,73,36,37,49.32
Rumble,Sylas,87,53,34,60.92
Rumble,Lux,102,45,57,44.12
Rumble,Camille,16,8,8,50
Rumble,Shaco,36,13,23,36.11
Rumble,Kassadin,15,3,12,20
Rumble,Jhin,142,54,88,38.03
Rumble,Blitzcrank,41,20,21,48.78
Rumble,Yorick,40,18,22,45
Rumble,Karthus,13,0,13,0
Rumble,Zed,70,31,39,44.29
Rumble,TahmKench,47,19,28,40.43
Rumble,Rengar,11,8,3,72.73
Rumble,Tristana,67,26,41,38.81
Rumble,Lulu,120,44,76,36.67
Rumble,Darius,95,56,39,58.95
Rumble,FiddleSticks,47,13,34,27.66
Rumble,Ekko,55,17,38,30.91
Rumble,Kayle,46,22,24,47.83
Rumble,LeeSin,158,86,72,54.43
Rumble,Qiyana,9,9,0,100
Rumble,Samira,38,19,19,50
Rumble,Morgana,79,42,37,53.16
Rumble,Kayn,51,27,24,52.94
Rumble,Mel,120,57,63,47.5
Rumble,Seraphine,39,19,20,48.72
Rumble,Vladimir,42,19,23,45.24
Rumble,Zac,53,42,11,79.25
Rumble,Katarina,46,14,32,30.43
Rumble,Lucian,72,34,38,47.22
Rumble,Renata,18,10,8,55.56
Rumble,Pantheon,105,53,52,50.48
Rumble,Irelia,41,16,25,39.02
Rumble,Kaisa,112,47,65,41.96
Rumble,Milio,36,22,14,61.11
Rumble,Pyke,67,13,54,19.4
Rumble,Talon,30,15,15,50
Rumble,Brand,23,13,10,56.52
Rumble,Braum,44,19,25,43.18
Rumble,Malphite,69,30,39,43.48
Rumble,Nocturne,61,23,38,37.7
Rumble,Malzahar,60,30,30,50
Rumble,Varus,86,44,42,51.16
Rumble,Udyr,36,21,15,58.33
Rumble,Viego,84,39,45,46.43
Rumble,Sett,62,27,35,43.55
Rumble,Illaoi,34,16,18,47.06
Rumble,Lillia,39,9,30,23.08
Rumble,Nami,46,20,26,43.48
Rumble,Volibear,40,7,33,17.5
Rumble,Vayne,80,34,46,42.5
Rumble,Yasuo,117,48,69,41.03
Rumble,KSante,33,13,20,39.39
Rumble,Belveth,22,14,8,63.64
Rumble,Viktor,53,27,26,50.94
Rumble,MissFortune,117,60,57,51.28
Rumble,Nautilus,88,45,43,51.14
Rumble,Gwen,25,8,17,32
Rumble,Aurora,64,42,22,65.63
Rumble,Jinx,143,65,78,45.45
Rumble,Thresh,116,72,44,62.07
Rumble,Swain,69,21,48,30.43
Rumble,Gangplank,39,23,16,58.97
Rumble,Skarner,37,17,20,45.95
Rumble,Senna,42,17,25,40.48
Rumble,Hwei,38,18,20,47.37
Rumble,Nidalee,32,17,15,53.13
Rumble,Taliyah,15,6,9,40
Rumble,Warwick,79,37,42,46.84
Rumble,Galio,108,62,46,57.41
Rumble,Urgot,36,16,20,44.44
Rumble,Sejuani,35,15,20,42.86
Rumble,Shen,46,24,22,52.17
Rumble,TwistedFate,23,10,13,43.48
Rumble,Soraka,19,11,8,57.89
Rumble,Hecarim,31,16,15,51.61
Rumble,Draven,26,12,14,46.15
Rumble,Riven,8,5,3,62.5
Rumble,Jayce,60,22,38,36.67
Rumble,Orianna,35,11,24,31.43
Rumble,Zoe,26,18,8,69.23
Rumble,Quinn,23,5,18,21.74
Rumble,Teemo,68,24,44,35.29
Rumble,Rammus,26,9,17,34.62
Rumble,Xayah,31,6,25,19.35
Rumble,Olaf,18,6,12,33.33
Rumble,Yone,118,61,57,51.69
Rumble,DrMundo,34,29,5,85.29
Rumble,Evelynn,10,5,5,50
Rumble,Fizz,27,14,13,51.85
Rumble,Renekton,34,22,12,64.71
Rumble,Twitch,42,15,27,35.71
Rumble,Fiora,31,10,21,32.26
Rumble,Leblanc,34,20,14,58.82
Rumble,Rakan,42,19,23,45.24
Rumble,Akali,52,20,32,38.46
Rumble,MasterYi,66,28,38,42.42
Rumble,Amumu,58,23,35,39.66
Rumble,Chogath,66,32,34,48.48
Rumble,Sivir,35,16,19,45.71
Rumble,Bard,11,11,0,100
Rumble,Diana,102,60,42,58.82
Rumble,Alistar,39,9,30,23.08
Rumble,Sion,54,15,39,27.78
Rumble,Xerath,57,24,33,42.11
Rumble,Kennen,25,19,6,76
Rumble,Velkoz,44,27,17,61.36
Rumble,Tryndamere,12,3,9,25
Rumble,Azir,38,22,16,57.89
Rumble,Caitlyn,134,67,67,50
Rumble,Nunu,34,17,17,50
Rumble,Anivia,21,6,15,28.57
Rumble,Akshan,20,15,5,75
Rumble,Kindred,39,29,10,74.36
Rumble,Gnar,35,18,17,51.43
Rumble,Leona,53,25,28,47.17
Rumble,Aphelios,20,17,3,85
Rumble,Khazix,22,6,16,27.27
Rumble,Corki,37,28,9,75.68
Rumble,Vi,69,34,35,49.28
Rumble,Graves,42,13,29,30.95
Rumble,AurelionSol,15,10,5,66.67
Rumble,Veigar,45,18,27,40
Rumble,Zyra,35,21,14,60
Rumble,Syndra,44,22,22,50
Rumble,Ziggs,17,12,5,70.59
Rumble,Poppy,45,27,18,60
Rumble,Ambessa,49,14,35,28.57
Rumble,Ivern,15,11,4,73.33
Rumble,Nasus,32,11,21,34.38
Rumble,Lissandra,20,7,13,35
Rumble,Zeri,25,12,13,48
Rumble,Kled,14,10,4,71.43
Rumble,Trundle,25,14,11,56
Rumble,Zilean,22,6,16,27.27
Rumble,Garen,72,38,34,52.78
Rumble,RekSai,11,3,8,27.27
Rumble,Heimerdinger,12,2,10,16.67
Rumble,Vex,37,14,23,37.84
Rumble,Kalista,15,7,8,46.67
Rumble,JarvanIV,34,12,22,35.29
Rumble,Singed,11,5,6,45.45
Rumble,Maokai,23,15,8,65.22
Rumble,Smolder,25,10,15,40
Rumble,Taric,15,5,10,33.33
Rumble,XinZhao,27,18,9,66.67
Rumble,KogMaw,12,7,5,58.33
Rumble,Cassiopeia,18,8,10,44.44
Rumble,Shyvana,14,5,9,35.71
Rumble,Rell,38,27,11,71.05
Rumble,MonkeyKing,35,11,24,31.43
Rumble,Janna,8,8,0,100
Rumble,Naafiri,17,8,9,47.06
Rumble,Annie,12,3,9,25
Rumble,Ryze,15,6,9,40
Rumble,Nilah,6,3,3,50
Rumble,Sona,3,0,3,0
