Name,Games,Wins,Losses,Bans,WR
Nocturne,39859,21012,18847,80974,52.72
Blitzcrank,22529,10865,11664,70650,48.23
Mel,61577,29205,32372,287286,47.43
Karma,38515,19547,18968,31684,50.75
Warwick,45583,23749,21834,78703,52.1
Vladimir,20991,10379,10612,17608,49.45
Lulu,41183,20539,20644,71769,49.87
Aphelios,16048,7986,8062,3902,49.76
Darius,57590,28966,28624,106112,50.3
Viktor,27741,13820,13921,29959,49.82
Singed,8513,4376,4137,2041,51.4
LeeSin,48008,23172,24836,51724,48.27
Yasuo,61270,30723,30547,92940,50.14
Caitlyn,85706,43020,42686,109717,50.19
Yuumi,24204,11738,12466,21705,48.5
Chogath,36595,18780,17815,19539,51.32
Viego,45393,22773,22620,41812,50.17
Galio,27253,13936,13317,17958,51.14
Sivir,16499,8330,8169,3404,50.49
Pyke,24845,12061,12784,73079,48.54
Ambessa,19234,9037,10197,44604,46.98
Fizz,18473,9148,9325,29330,49.52
Amumu,32185,16790,15395,32275,52.17
Brand,23165,11678,11487,18643,50.41
Morgana,36979,18646,18333,92279,50.42
Irelia,26626,13305,13321,50860,49.97
Ahri,40044,19727,20317,18003,49.26
Jax,29551,14441,15110,18723,48.87
Syndra,19749,9978,9771,14397,50.52
Smolder,18990,9035,9955,4306,47.58
Zyra,30095,15426,14669,26927,51.26
Gragas,16752,8061,8691,5740,48.12
Kayn,44712,22586,22126,36626,50.51
Jinx,89110,45742,43368,44073,51.33
Thresh,41137,20783,20354,17228,50.52
Neeko,13833,6766,7067,5490,48.91
Teemo,38624,19859,18765,77328,51.42
Malzahar,32573,16839,15734,52983,51.7
Samira,21415,10451,10964,35142,48.8
Garen,49859,25495,24364,38987,51.13
Diana,50467,25704,24763,45485,50.93
Sylas,44369,21538,22831,40257,48.54
Kaisa,51468,24952,26516,6719,48.48
Yorick,30943,16444,14499,54448,53.14
Veigar,30780,15703,15077,14083,51.02
Tristana,30890,15196,15694,8724,49.19
Poppy,18558,9366,9192,12949,50.47
Shaco,29367,14457,14910,127658,49.23
Lux,76773,38705,38068,77059,50.41
Braum,17676,9151,8525,8426,51.77
Mordekaiser,39587,20505,19082,69359,51.8
Alistar,13109,6528,6581,4088,49.8
Riven,14241,7097,7144,5960,49.83
Sejuani,12404,6077,6327,1841,48.99
Lucian,21544,10401,11143,3498,48.28
Soraka,17230,8932,8298,7183,51.84
Malphite,31694,15765,15929,26563,49.74
Elise,21774,10919,10855,31326,50.15
Nautilus,34490,16777,17713,42515,48.64
Sett,46394,23936,22458,21485,51.59
Aatrox,27207,13508,13699,33908,49.65
Velkoz,18771,9652,9119,6249,51.42
Rammus,9719,4924,4795,20294,50.66
Katarina,23728,11732,11996,22307,49.44
Draven,15838,7774,8064,48547,49.08
Senna,22849,11353,11496,5036,49.69
Sion,22863,11644,11219,5677,50.93
MasterYi,38089,19332,18757,78454,50.75
Annie,10439,5299,5140,3656,50.76
Ezreal,76847,37352,39495,33504,48.61
Briar,22091,11607,10484,27932,52.54
Kayle,20901,10730,10171,10370,51.34
Pantheon,48557,24181,24376,17950,49.8
Belveth,7091,3408,3683,7143,48.06
KogMaw,9413,4891,4522,4393,51.96
Leona,26785,13242,13543,31760,49.44
Kassadin,6606,3323,3283,4355,50.3
Qiyana,7683,3596,4087,1320,46.8
Swain,29710,15318,14392,16881,51.56
Vi,29647,14639,15008,7915,49.38
MonkeyKing,21644,10995,10649,11573,50.8
Gangplank,14728,7298,7430,6067,49.55
Jayce,15524,7655,7869,10812,49.31
Azir,10510,5073,5437,1699,48.27
Skarner,7653,3449,4204,13269,45.07
Aurora,21721,10588,11133,25179,48.75
Corki,12643,6000,6643,5624,47.46
Orianna,13471,6696,6775,2602,49.71
Xayah,14234,7147,7087,2143,50.21
Nami,30803,15913,14890,4560,51.66
Hwei,20044,10110,9934,14554,50.44
Vex,16194,8150,8044,19578,50.33
Yone,57436,27269,30167,39421,47.48
Shen,18985,9338,9647,2365,49.19
Akali,34037,16819,17218,44810,49.41
Varus,28165,13628,14537,4893,48.39
Zed,35487,17260,18227,67004,48.64
None,0,0,0,158107,NaN
Renekton,15948,7818,8130,11294,49.02
Janna,10630,5439,5191,2176,51.17
Karthus,9306,4560,4746,7513,49
Zac,15122,7690,7432,6050,50.85
Zilean,10074,5152,4922,2988,51.14
XinZhao,20162,10146,10016,4717,50.32
Khazix,15218,7271,7947,9135,47.78
Vayne,40183,20533,19650,26654,51.1
Nasus,21500,11045,10455,18167,51.37
Jhin,64360,31975,32385,19457,49.68
Seraphine,22759,11313,11446,7194,49.71
Leblanc,19326,9509,9817,55510,49.2
Illaoi,14530,7182,7348,48164,49.43
Milio,17988,9481,8507,7502,52.71
Rakan,12228,6085,6143,1496,49.76
Ekko,29642,14810,14832,6945,49.96
Ashe,63473,31560,31913,27772,49.72
Volibear,35338,17636,17702,20402,49.91
Tryndamere,17647,8765,8882,11322,49.67
Lillia,17198,8513,8685,15309,49.5
FiddleSticks,15229,7587,7642,0,49.82
Nilah,9369,4950,4419,14237,52.83
Rell,14853,7530,7323,6946,50.7
Trundle,18143,9232,8911,7867,50.88
Evelynn,10737,5329,5408,9180,49.63
Gwen,15266,7338,7928,10031,48.07
DrMundo,17383,8847,8536,13470,50.89
Fiora,11031,5501,5530,12130,49.87
Rengar,10146,4693,5453,6244,46.25
Ziggs,11156,5605,5551,3133,50.24
Xerath,28947,14613,14334,35040,50.48
Sona,9816,5146,4670,817,52.42
Gnar,12610,6227,6383,3927,49.38
Hecarim,13057,6320,6737,7656,48.4
MissFortune,72723,36868,35855,59494,50.7
Talon,18249,8841,9408,5983,48.45
Ornn,12611,6344,6267,2315,50.31
Zoe,11569,5735,5834,5631,49.57
Udyr,12265,5990,6275,6653,48.84
Nunu,16363,8187,8176,5145,50.03
KSante,16178,7556,8622,13948,46.71
Urgot,15836,8280,7556,9591,52.29
Bard,9345,4674,4671,1491,50.02
Kindred,13595,6733,6862,7511,49.53
Lissandra,10439,5376,5063,4441,51.5
Twitch,24973,12317,12656,30826,49.32
Ivern,4113,2038,2075,1306,49.55
Anivia,9800,5101,4699,6370,52.05
Cassiopeia,8796,4413,4383,8850,50.17
Kennen,8075,4049,4026,3511,50.14
Rumble,8660,4147,4513,2595,47.89
Akshan,10694,5291,5403,9051,49.48
TwistedFate,10954,5223,5731,617,47.68
Heimerdinger,14034,7376,6658,18151,52.56
TahmKench,22872,11051,11821,33561,48.32
Graves,20080,9959,10121,14464,49.6
Maokai,14128,7122,7006,2941,50.41
JarvanIV,17923,9166,8757,4102,51.14
Zeri,12714,6251,6463,1493,49.17
Renata,5063,2443,2620,1022,48.25
Kalista,7543,3611,3932,2865,47.87
Shyvana,7529,3746,3783,1922,49.75
Camille,10855,5238,5617,5197,48.25
Quinn,11356,5902,5454,5855,51.97
Ryze,10808,5583,5225,1598,51.66
Fiddlesticks,0,0,0,5561,NaN
Taliyah,7614,3940,3674,1188,51.75
AurelionSol,11524,5802,5722,4762,50.35
Olaf,7278,3605,3673,3536,49.53
Naafiri,10010,5041,4969,5680,50.36
Nidalee,9130,4143,4987,3396,45.38
Taric,6675,3401,3274,1511,50.95
Kled,5471,2763,2708,2378,50.5
RekSai,3561,1697,1864,1656,47.66
