Name,Opponent,Games,Wins,Losses,WR
Ambessa,Yone,322,150,172,46.58
Ambessa,Viego,291,184,107,63.23
Ambessa,Yasuo,348,161,187,46.26
Ambessa,Ezreal,461,251,210,54.45
Ambessa,Lux,400,198,202,49.5
Ambessa,Vladimir,84,44,40,52.38
Ambessa,Kayn,217,99,118,45.62
Ambessa,Velkoz,66,26,40,39.39
Ambessa,Xayah,137,63,74,45.99
Ambessa,Leblanc,106,61,45,57.55
Ambessa,Galio,231,119,112,51.52
Ambessa,Hecarim,50,28,22,56
Ambessa,Shen,159,59,100,37.11
Ambessa,Kaisa,353,176,177,49.86
Ambessa,Nami,154,63,91,40.91
Ambessa,Akali,179,89,90,49.72
Ambessa,LeeSin,382,213,169,55.76
Ambessa,Hwei,110,57,53,51.82
Ambessa,Pyke,116,75,41,64.66
Ambessa,Gnar,87,62,25,71.26
Ambessa,Mel,398,217,181,54.52
Ambessa,Twitch,108,53,55,49.07
Ambessa,Pantheon,303,140,163,46.2
Ambessa,Alistar,73,48,25,65.75
Ambessa,Nocturne,231,115,116,49.78
Ambessa,Urgot,50,25,25,50
Ambessa,Samira,129,70,59,54.26
Ambessa,Shaco,124,60,64,48.39
Ambessa,AurelionSol,72,41,31,56.94
Ambessa,Caitlyn,392,190,202,48.47
Ambessa,Brand,106,51,55,48.11
Ambessa,Warwick,213,111,102,52.11
Ambessa,Ornn,121,62,59,51.24
Ambessa,Katarina,119,63,56,52.94
Ambessa,Tristana,111,69,42,62.16
Ambessa,Renekton,183,70,113,38.25
Ambessa,JarvanIV,177,99,78,55.93
Ambessa,Seraphine,148,91,57,61.49
Ambessa,Jhin,313,196,117,62.62
Ambessa,Janna,72,32,40,44.44
Ambessa,Vayne,203,80,123,39.41
Ambessa,Ahri,257,121,136,47.08
Ambessa,Yuumi,118,74,44,62.71
Ambessa,Irelia,119,56,63,47.06
Ambessa,Lillia,92,45,47,48.91
Ambessa,Volibear,170,74,96,43.53
Ambessa,Jax,166,96,70,57.83
Ambessa,Ashe,348,172,176,49.43
Ambessa,Camille,131,67,64,51.15
Ambessa,Varus,182,112,70,61.54
Ambessa,Malzahar,177,98,79,55.37
Ambessa,Jayce,105,57,48,54.29
Ambessa,Sion,157,59,98,37.58
Ambessa,Amumu,185,78,107,42.16
Ambessa,Gwen,66,41,25,62.12
Ambessa,Diana,291,142,149,48.8
Ambessa,Lucian,149,84,65,56.38
Ambessa,Kennen,47,15,32,31.91
Ambessa,Zyra,119,55,64,46.22
Ambessa,Briar,62,29,33,46.77
Ambessa,TwistedFate,80,40,40,50
Ambessa,Sivir,99,46,53,46.46
Ambessa,Mordekaiser,174,74,100,42.53
Ambessa,Nautilus,280,132,148,47.14
Ambessa,Nunu,117,59,58,50.43
Ambessa,Lulu,288,164,124,56.94
Ambessa,Belveth,34,17,17,50
Ambessa,MissFortune,330,180,150,54.55
Ambessa,Leona,179,99,80,55.31
Ambessa,Thresh,289,159,130,55.02
Ambessa,Trundle,97,56,41,57.73
Ambessa,Smolder,143,57,86,39.86
Ambessa,Khazix,78,39,39,50
Ambessa,Zed,174,93,81,53.45
Ambessa,Jinx,438,208,230,47.49
Ambessa,Sona,47,18,29,38.3
Ambessa,Yorick,119,59,60,49.58
Ambessa,Elise,175,80,95,45.71
Ambessa,Veigar,145,76,69,52.41
Ambessa,Poppy,185,86,99,46.49
Ambessa,Swain,156,69,87,44.23
Ambessa,Ekko,154,84,70,54.55
Ambessa,TahmKench,151,80,71,52.98
Ambessa,Heimerdinger,53,22,31,41.51
Ambessa,Syndra,129,55,74,42.64
Ambessa,Karma,261,147,114,56.32
Ambessa,Darius,268,130,138,48.51
Ambessa,FiddleSticks,55,12,43,21.82
Ambessa,Chogath,181,80,101,44.2
Ambessa,MonkeyKing,134,57,77,42.54
Ambessa,Teemo,146,87,59,59.59
Ambessa,Malphite,190,88,102,46.32
Ambessa,Udyr,66,44,22,66.67
Ambessa,Aurora,167,95,72,56.89
Ambessa,Aphelios,81,31,50,38.27
Ambessa,Morgana,118,60,58,50.85
Ambessa,Zac,137,61,76,44.53
Ambessa,Aatrox,229,136,93,59.39
Ambessa,Viktor,175,94,81,53.71
Ambessa,Braum,156,82,74,52.56
Ambessa,Akshan,56,27,29,48.21
Ambessa,Gragas,147,91,56,61.9
Ambessa,Blitzcrank,176,67,109,38.07
Ambessa,Sett,283,142,141,50.18
Ambessa,Maokai,83,49,34,59.04
Ambessa,Nasus,81,33,48,40.74
Ambessa,DrMundo,44,16,28,36.36
Ambessa,Draven,114,56,58,49.12
Ambessa,Taliyah,68,28,40,41.18
Ambessa,Talon,88,45,43,51.14
Ambessa,Garen,220,112,108,50.91
Ambessa,MasterYi,149,76,73,51.01
Ambessa,Graves,103,50,53,48.54
Ambessa,KogMaw,62,41,21,66.13
Ambessa,Milio,127,39,88,30.71
Ambessa,Nilah,58,22,36,37.93
Ambessa,Rammus,58,32,26,55.17
Ambessa,Xerath,182,69,113,37.91
Ambessa,Riven,113,61,52,53.98
Ambessa,Vi,171,56,115,32.75
Ambessa,Renata,46,15,31,32.61
Ambessa,Kayle,75,29,46,38.67
Ambessa,Soraka,54,26,28,48.15
Ambessa,Orianna,85,42,43,49.41
Ambessa,Rakan,111,61,50,54.95
Ambessa,Bard,53,22,31,41.51
Ambessa,Nidalee,73,45,28,61.64
Ambessa,Ryze,92,46,46,50
Ambessa,Kalista,54,28,26,51.85
Ambessa,Skarner,69,41,28,59.42
Ambessa,Tryndamere,79,40,39,50.63
Ambessa,KSante,218,111,107,50.92
Ambessa,Karthus,49,22,27,44.9
Ambessa,Fizz,43,20,23,46.51
Ambessa,Vex,100,60,40,60
Ambessa,Kindred,73,45,28,61.64
Ambessa,Naafiri,73,42,31,57.53
Ambessa,Taric,41,18,23,43.9
Ambessa,Illaoi,87,35,52,40.23
Ambessa,Sylas,242,121,121,50
Ambessa,Evelynn,35,23,12,65.71
Ambessa,Senna,89,53,36,59.55
Ambessa,Gangplank,86,44,42,51.16
Ambessa,Kled,40,23,17,57.5
Ambessa,Rengar,39,14,25,35.9
Ambessa,Neeko,74,28,46,37.84
Ambessa,XinZhao,163,77,86,47.24
Ambessa,Annie,46,26,20,56.52
Ambessa,Zilean,34,9,25,26.47
Ambessa,Anivia,55,24,31,43.64
Ambessa,Zoe,78,48,30,61.54
Ambessa,Azir,90,40,50,44.44
Ambessa,Kassadin,46,21,25,45.65
Ambessa,Singed,42,17,25,40.48
Ambessa,Corki,67,37,30,55.22
Ambessa,Rell,125,49,76,39.2
Ambessa,Cassiopeia,52,24,28,46.15
Ambessa,Lissandra,36,16,20,44.44
Ambessa,Fiora,60,28,32,46.67
Ambessa,Quinn,45,22,23,48.89
Ambessa,Olaf,34,18,16,52.94
Ambessa,Ziggs,85,50,35,58.82
Ambessa,Sejuani,119,66,53,55.46
Ambessa,Qiyana,27,19,8,70.37
Ambessa,Ivern,41,21,20,51.22
Ambessa,Rumble,61,47,14,77.05
Ambessa,Shyvana,32,10,22,31.25
Ambessa,Zeri,54,25,29,46.3
Ambessa,RekSai,27,8,19,29.63
Volibear,Yone,366,191,175,52.19
Volibear,Viego,319,150,169,47.02
Volibear,Yasuo,413,214,199,51.82
Volibear,Ezreal,472,246,226,52.12
Volibear,Lux,595,343,252,57.65
Volibear,Urgot,108,50,58,46.3
Volibear,Diana,372,205,167,55.11
Volibear,Syndra,181,104,77,57.46
Volibear,MissFortune,424,229,195,54.01
Volibear,Braum,173,83,90,47.98
Volibear,Kayle,142,58,84,40.85
Volibear,Kindred,80,40,40,50
Volibear,AurelionSol,128,58,70,45.31
Volibear,Caitlyn,590,316,274,53.56
Volibear,Morgana,236,123,113,52.12
Volibear,Ornn,148,97,51,65.54
Volibear,Lillia,141,66,75,46.81
Volibear,Zed,249,120,129,48.19
Volibear,Tristana,240,107,133,44.58
Volibear,Nami,246,128,118,52.03
Volibear,Mordekaiser,398,208,190,52.26
Volibear,Poppy,187,106,81,56.68
Volibear,Varus,196,102,94,52.04
Volibear,Pyke,230,145,85,63.04
Volibear,Illaoi,145,54,91,37.24
Volibear,Briar,147,76,71,51.7
Volibear,Taliyah,74,40,34,54.05
Volibear,Twitch,157,77,80,49.04
Volibear,Nasus,173,77,96,44.51
Volibear,Shaco,183,111,72,60.66
Volibear,Xerath,224,113,111,50.45
Volibear,Lulu,327,157,170,48.01
Volibear,Yorick,171,107,64,62.57
Volibear,Katarina,149,85,64,57.05
Volibear,Neeko,96,50,46,52.08
Volibear,Darius,515,285,230,55.34
Volibear,Kayn,292,148,144,50.68
Volibear,Veigar,244,138,106,56.56
Volibear,Gangplank,151,91,60,60.26
Volibear,Pantheon,391,223,168,57.03
Volibear,TwistedFate,55,30,25,54.55
Volibear,Kaisa,349,167,182,47.85
Volibear,TahmKench,255,127,128,49.8
Volibear,Ziggs,85,51,34,60
Volibear,Vi,279,142,137,50.9
Volibear,Galio,268,142,126,52.99
Volibear,Smolder,203,101,102,49.75
Volibear,Vladimir,132,77,55,58.33
Volibear,RekSai,44,23,21,52.27
Volibear,Akali,225,114,111,50.67
Volibear,Ashe,447,260,187,58.17
Volibear,Bard,62,26,36,41.94
Volibear,Ambessa,170,96,74,56.47
Volibear,Khazix,105,63,42,60
Volibear,Vex,126,53,73,42.06
Volibear,Aphelios,145,61,84,42.07
Volibear,Jax,211,107,104,50.71
Volibear,Chogath,281,126,155,44.84
Volibear,Malphite,194,90,104,46.39
Volibear,MasterYi,260,148,112,56.92
Volibear,Lucian,191,111,80,58.12
Volibear,Teemo,225,106,119,47.11
Volibear,Graves,130,56,74,43.08
Volibear,Sylas,280,167,113,59.64
Volibear,Irelia,185,95,90,51.35
Volibear,Soraka,116,56,60,48.28
Volibear,Udyr,114,66,48,57.89
Volibear,Corki,132,80,52,60.61
Volibear,Alistar,115,64,51,55.65
Volibear,Trundle,119,64,55,53.78
Volibear,Mel,402,222,180,55.22
Volibear,Janna,63,29,34,46.03
Volibear,Jhin,481,224,257,46.57
Volibear,Leblanc,134,85,49,63.43
Volibear,Nilah,93,45,48,48.39
Volibear,Thresh,433,239,194,55.2
Volibear,Olaf,59,27,32,45.76
Volibear,Karma,223,89,134,39.91
Volibear,Ekko,239,125,114,52.3
Volibear,Ahri,338,177,161,52.37
Volibear,Gwen,142,66,76,46.48
Volibear,Samira,234,133,101,56.84
Volibear,JarvanIV,178,112,66,62.92
Volibear,Elise,163,94,69,57.67
Volibear,Draven,108,59,49,54.63
Volibear,Leona,234,136,98,58.12
Volibear,Gnar,101,66,35,65.35
Volibear,Nocturne,309,170,139,55.02
Volibear,MonkeyKing,147,67,80,45.58
Volibear,Rammus,87,44,43,50.57
Volibear,Zilean,79,26,53,32.91
Volibear,Singed,62,35,27,56.45
Volibear,Skarner,109,58,51,53.21
Volibear,Zeri,116,56,60,48.28
Volibear,Yuumi,169,94,75,55.62
Volibear,Amumu,258,104,154,40.31
Volibear,Naafiri,76,32,44,42.11
Volibear,Nautilus,312,156,156,50
Volibear,Milio,142,75,67,52.82
Volibear,Camille,65,31,34,47.69
Volibear,Brand,152,89,63,58.55
Volibear,Gragas,162,86,76,53.09
Volibear,Seraphine,149,86,63,57.72
Volibear,Sona,48,19,29,39.58
Volibear,Maokai,110,47,63,42.73
Volibear,Orianna,108,50,58,46.3
Volibear,Shyvana,63,34,29,53.97
Volibear,Fiora,72,39,33,54.17
Volibear,Sett,353,157,196,44.48
Volibear,Kled,58,26,32,44.83
Volibear,Jinx,582,294,288,50.52
Volibear,Rell,212,98,114,46.23
Volibear,Belveth,77,43,34,55.84
Volibear,Malzahar,246,139,107,56.5
Volibear,Garen,367,187,180,50.95
Volibear,Blitzcrank,232,111,121,47.84
Volibear,Ivern,52,32,20,61.54
Volibear,Shen,161,70,91,43.48
Volibear,Fizz,130,73,57,56.15
Volibear,Zac,145,53,92,36.55
Volibear,Warwick,403,208,195,51.61
Volibear,Cassiopeia,59,23,36,38.98
Volibear,Riven,69,39,30,56.52
Volibear,Qiyana,52,21,31,40.38
Volibear,DrMundo,144,72,72,50
Volibear,Vayne,303,145,158,47.85
Volibear,Sejuani,160,70,90,43.75
Volibear,Hwei,162,70,92,43.21
Volibear,Kassadin,41,22,19,53.66
Volibear,Nidalee,47,20,27,42.55
Volibear,FiddleSticks,113,66,47,58.41
Volibear,Zyra,163,74,89,45.4
Volibear,LeeSin,355,191,164,53.8
Volibear,Akshan,44,21,23,47.73
Volibear,Senna,119,64,55,53.78
Volibear,Rumble,49,42,7,85.71
Volibear,Sivir,143,73,70,51.05
Volibear,Evelynn,77,33,44,42.86
Volibear,Viktor,246,145,101,58.94
Volibear,Renekton,144,87,57,60.42
Volibear,Rengar,63,37,26,58.73
Volibear,Aurora,187,86,101,45.99
Volibear,Aatrox,264,115,149,43.56
Volibear,Xayah,131,64,67,48.85
Volibear,Sion,213,102,111,47.89
Volibear,XinZhao,160,81,79,50.63
Volibear,Swain,250,95,155,38
Volibear,KSante,174,91,83,52.3
Volibear,Ryze,83,43,40,51.81
Volibear,KogMaw,77,43,34,55.84
Volibear,Nunu,148,53,95,35.81
Volibear,Karthus,53,20,33,37.74
Volibear,Renata,57,25,32,43.86
Volibear,Zoe,86,49,37,56.98
Volibear,Velkoz,107,66,41,61.68
Volibear,Tryndamere,74,42,32,56.76
Volibear,Heimerdinger,92,33,59,35.87
Volibear,Hecarim,66,42,24,63.64
Volibear,Quinn,75,41,34,54.67
Volibear,Talon,85,50,35,58.82
Volibear,Azir,89,58,31,65.17
Volibear,Lissandra,100,47,53,47
Volibear,Taric,55,20,35,36.36
Volibear,Rakan,90,56,34,62.22
Volibear,Jayce,76,27,49,35.53
Volibear,Annie,79,36,43,45.57
Volibear,Kalista,43,17,26,39.53
Volibear,Kennen,70,47,23,67.14
Volibear,Anivia,54,14,40,25.93
Veigar,Yone,375,199,176,53.07
Veigar,Viego,261,123,138,47.13
Veigar,Yasuo,366,176,190,48.09
Veigar,Ezreal,503,247,256,49.11
Veigar,Lux,596,279,317,46.81
Veigar,DrMundo,138,75,63,54.35
Veigar,Sejuani,138,55,83,39.86
Veigar,Ashe,373,188,185,50.4
Veigar,TwistedFate,65,31,34,47.69
Veigar,Kayle,104,56,48,53.85
Veigar,Kindred,104,50,54,48.08
Veigar,AurelionSol,110,62,48,56.36
Veigar,Caitlyn,612,293,319,47.88
Veigar,Morgana,304,159,145,52.3
Veigar,Garen,405,205,200,50.62
Veigar,Warwick,369,171,198,46.34
Veigar,MissFortune,430,214,216,49.77
Veigar,Malzahar,284,128,156,45.07
Veigar,Kayn,283,148,135,52.3
Veigar,Ahri,360,179,181,49.72
Veigar,Amumu,328,146,182,44.51
Veigar,Nasus,154,65,89,42.21
Veigar,Seraphine,152,71,81,46.71
Veigar,Jax,211,112,99,53.08
Veigar,MasterYi,185,99,86,53.51
Veigar,Gwen,101,51,50,50.5
Veigar,Pantheon,343,171,172,49.85
Veigar,Irelia,168,102,66,60.71
Veigar,Varus,210,86,124,40.95
Veigar,Mordekaiser,322,178,144,55.28
Veigar,Karma,268,153,115,57.09
Veigar,Ekko,209,83,126,39.71
Veigar,Teemo,223,134,89,60.09
Veigar,Sivir,127,74,53,58.27
Veigar,Velkoz,157,71,86,45.22
Veigar,Mel,442,240,202,54.3
Veigar,Darius,435,205,230,47.13
Veigar,Riven,103,49,54,47.57
Veigar,Soraka,113,43,70,38.05
Veigar,Skarner,81,46,35,56.79
Veigar,Volibear,244,106,138,43.44
Veigar,Katarina,195,92,103,47.18
Veigar,Twitch,165,85,80,51.52
Veigar,Blitzcrank,224,130,94,58.04
Veigar,XinZhao,127,50,77,39.37
Veigar,Thresh,369,198,171,53.66
Veigar,Kaisa,349,186,163,53.3
Veigar,Jhin,432,222,210,51.39
Veigar,Yorick,196,91,105,46.43
Veigar,Chogath,323,133,190,41.18
Veigar,KSante,144,71,73,49.31
Veigar,Zac,106,70,36,66.04
Veigar,Annie,87,45,42,51.72
Veigar,Malphite,274,127,147,46.35
Veigar,Gragas,153,81,72,52.94
Veigar,Graves,120,47,73,39.17
Veigar,Qiyana,34,19,15,55.88
Veigar,Kalista,74,52,22,70.27
Veigar,Neeko,96,49,47,51.04
Veigar,Vladimir,138,71,67,51.45
Veigar,TahmKench,238,120,118,50.42
Veigar,JarvanIV,169,87,82,51.48
Veigar,Viktor,267,127,140,47.57
Veigar,Jinx,581,263,318,45.27
Veigar,Zeri,97,48,49,49.48
Veigar,Milio,108,49,59,45.37
Veigar,Vayne,280,120,160,42.86
Veigar,Zyra,182,95,87,52.2
Veigar,Orianna,96,51,45,53.13
Veigar,Shen,155,82,73,52.9
Veigar,Hecarim,84,37,47,44.05
Veigar,Kassadin,41,17,24,41.46
Veigar,Alistar,116,42,74,36.21
Veigar,Xerath,232,105,127,45.26
Veigar,Lucian,211,108,103,51.18
Veigar,Nami,198,88,110,44.44
Veigar,Swain,241,110,131,45.64
Veigar,Heimerdinger,135,60,75,44.44
Veigar,Sona,49,35,14,71.43
Veigar,Anivia,93,52,41,55.91
Veigar,Nunu,169,96,73,56.8
Veigar,Shaco,165,103,62,62.42
Veigar,Kennen,47,12,35,25.53
Veigar,Corki,77,32,45,41.56
Veigar,Bard,91,48,43,52.75
Veigar,Vex,147,86,61,58.5
Veigar,Jayce,107,41,66,38.32
Veigar,Diana,296,161,135,54.39
Veigar,Hwei,130,63,67,48.46
Veigar,Urgot,112,61,51,54.46
Veigar,Sion,204,121,83,59.31
Veigar,Rakan,104,53,51,50.96
Veigar,FiddleSticks,112,54,58,48.21
Veigar,Galio,225,124,101,55.11
Veigar,Fizz,191,107,84,56.02
Veigar,Taliyah,37,18,19,48.65
Veigar,LeeSin,313,147,166,46.96
Veigar,Lulu,321,166,155,51.71
Veigar,Sett,315,152,163,48.25
Veigar,Yuumi,206,104,102,50.49
Veigar,Gangplank,103,64,39,62.14
Veigar,Briar,119,59,60,49.58
Veigar,Zilean,95,41,54,43.16
Veigar,Aurora,187,114,73,60.96
Veigar,Senna,173,81,92,46.82
Veigar,Olaf,58,34,24,58.62
Veigar,Akali,210,105,105,50
Veigar,Taric,38,17,21,44.74
Veigar,Gnar,132,77,55,58.33
Veigar,Nocturne,288,146,142,50.69
Veigar,Singed,81,43,38,53.09
Veigar,Illaoi,114,62,52,54.39
Veigar,Pyke,150,79,71,52.67
Veigar,Ambessa,145,69,76,47.59
Veigar,Akshan,60,32,28,53.33
Veigar,Poppy,139,77,62,55.4
Veigar,Samira,162,93,69,57.41
Veigar,Vi,264,145,119,54.92
Veigar,Syndra,154,69,85,44.81
Veigar,Fiora,57,28,29,49.12
Veigar,Renekton,109,52,57,47.71
Veigar,Leona,216,107,109,49.54
Veigar,Evelynn,55,33,22,60
Veigar,Braum,146,97,49,66.44
Veigar,Rammus,84,43,41,51.19
Veigar,Nilah,60,31,29,51.67
Veigar,Zed,223,105,118,47.09
Veigar,Camille,94,64,30,68.09
Veigar,Aphelios,99,50,49,50.51
Veigar,Draven,147,76,71,51.7
Veigar,Azir,76,38,38,50
Veigar,Cassiopeia,57,35,22,61.4
Veigar,Maokai,89,39,50,43.82
Veigar,Smolder,153,89,64,58.17
Veigar,RekSai,43,29,14,67.44
Veigar,Xayah,144,89,55,61.81
Veigar,Leblanc,120,58,62,48.33
Veigar,Rell,126,76,50,60.32
Veigar,MonkeyKing,200,92,108,46
Veigar,Brand,129,64,65,49.61
Veigar,Tristana,230,120,110,52.17
Veigar,Talon,89,54,35,60.67
Veigar,Khazix,71,38,33,53.52
Veigar,Sylas,229,116,113,50.66
Veigar,Nautilus,285,124,161,43.51
Veigar,Tryndamere,76,33,43,43.42
Veigar,Janna,50,21,29,42
Veigar,Naafiri,78,46,32,58.97
Veigar,Shyvana,64,28,36,43.75
Veigar,Nidalee,60,41,19,68.33
Veigar,Ryze,83,42,41,50.6
Veigar,Elise,145,84,61,57.93
Veigar,Rengar,61,35,26,57.38
Veigar,Aatrox,202,100,102,49.5
Veigar,Lillia,153,71,82,46.41
Veigar,Udyr,69,48,21,69.57
Veigar,Kled,24,9,15,37.5
Veigar,Ornn,109,56,53,51.38
Veigar,Lissandra,95,57,38,60
Veigar,Trundle,112,55,57,49.11
Veigar,Karthus,54,22,32,40.74
Veigar,Ziggs,96,51,45,53.13
Veigar,Zoe,90,48,42,53.33
Veigar,Belveth,41,29,12,70.73
Veigar,Quinn,81,34,47,41.98
Veigar,KogMaw,67,38,29,56.72
Veigar,Ivern,43,20,23,46.51
Veigar,Rumble,45,27,18,60
Veigar,Renata,45,34,11,75.56
Vayne,Yone,430,212,218,49.3
Vayne,Viego,372,220,152,59.14
Vayne,Yasuo,509,287,222,56.39
Vayne,Ezreal,825,492,333,59.64
Vayne,Lux,620,323,297,52.1
Vayne,Kayle,157,86,71,54.78
Vayne,Kindred,121,70,51,57.85
Vayne,AurelionSol,116,64,52,55.17
Vayne,Caitlyn,656,325,331,49.54
Vayne,Morgana,258,159,99,61.63
Vayne,Ivern,48,21,27,43.75
Vayne,Renekton,175,80,95,45.71
Vayne,Vladimir,206,114,92,55.34
Vayne,Lucian,222,114,108,51.35
Vayne,Blitzcrank,223,137,86,61.43
Vayne,Thresh,516,279,237,54.07
Vayne,Annie,77,31,46,40.26
Vayne,Nasus,197,128,69,64.97
Vayne,Tristana,238,121,117,50.84
Vayne,Poppy,292,152,140,52.05
Vayne,Zac,230,107,123,46.52
Vayne,Malzahar,305,127,178,41.64
Vayne,MissFortune,596,304,292,51.01
Vayne,TahmKench,348,190,158,54.6
Vayne,Jayce,157,83,74,52.87
Vayne,Elise,218,123,95,56.42
Vayne,Yorick,232,107,125,46.12
Vayne,Zilean,91,49,42,53.85
Vayne,Evelynn,81,33,48,40.74
Vayne,Kaisa,598,315,283,52.68
Vayne,Maokai,145,72,73,49.66
Vayne,KSante,221,131,90,59.28
Vayne,Lillia,137,70,67,51.09
Vayne,Diana,454,250,204,55.07
Vayne,Twitch,231,118,113,51.08
Vayne,Bard,93,40,53,43.01
Vayne,Shen,291,145,146,49.83
Vayne,LeeSin,396,207,189,52.27
Vayne,Orianna,160,69,91,43.13
Vayne,Xayah,168,78,90,46.43
Vayne,Rakan,176,105,71,59.66
Vayne,Aatrox,281,137,144,48.75
Vayne,Amumu,349,183,166,52.44
Vayne,Taliyah,76,31,45,40.79
Vayne,Ashe,573,295,278,51.48
Vayne,Milio,196,126,70,64.29
Vayne,Kled,44,19,25,43.18
Vayne,Gragas,222,123,99,55.41
Vayne,Anivia,97,61,36,62.89
Vayne,Jinx,681,319,362,46.84
Vayne,Rell,211,106,105,50.24
Vayne,Darius,576,303,273,52.6
Vayne,Warwick,377,193,184,51.19
Vayne,Akali,247,138,109,55.87
Vayne,Malphite,377,163,214,43.24
Vayne,Nocturne,338,188,150,55.62
Vayne,Samira,263,124,139,47.15
Vayne,Pyke,207,104,103,50.24
Vayne,Ekko,254,123,131,48.43
Vayne,Smolder,204,121,83,59.31
Vayne,Soraka,109,56,53,51.38
Vayne,Kayn,296,152,144,51.35
Vayne,Gwen,123,58,65,47.15
Vayne,Ambessa,203,123,80,60.59
Vayne,Ryze,130,64,66,49.23
Vayne,Ornn,192,93,99,48.44
Vayne,Veigar,280,160,120,57.14
Vayne,Pantheon,524,274,250,52.29
Vayne,RekSai,29,22,7,75.86
Vayne,Sejuani,208,89,119,42.79
Vayne,Karma,335,201,134,60
Vayne,Garen,463,218,245,47.08
Vayne,Trundle,163,87,76,53.37
Vayne,Katarina,170,93,77,54.71
Vayne,Zoe,111,47,64,42.34
Vayne,Riven,141,76,65,53.9
Vayne,Shaco,220,108,112,49.09
Vayne,Teemo,242,117,125,48.35
Vayne,Graves,185,88,97,47.57
Vayne,Sylas,382,222,160,58.12
Vayne,Irelia,182,74,108,40.66
Vayne,Sion,288,170,118,59.03
Vayne,MasterYi,326,211,115,64.72
Vayne,Seraphine,175,95,80,54.29
Vayne,Karthus,81,52,29,64.2
Vayne,Leona,321,181,140,56.39
Vayne,XinZhao,207,102,105,49.28
Vayne,Mel,568,320,248,56.34
Vayne,MonkeyKing,221,105,116,47.51
Vayne,Heimerdinger,119,59,60,49.58
Vayne,Ahri,398,214,184,53.77
Vayne,Nami,259,120,139,46.33
Vayne,Quinn,115,48,67,41.74
Vayne,Galio,396,197,199,49.75
Vayne,Senna,172,97,75,56.4
Vayne,Aurora,209,121,88,57.89
Vayne,Chogath,479,239,240,49.9
Vayne,Gnar,158,102,56,64.56
Vayne,Zed,245,136,109,55.51
Vayne,Zyra,195,83,112,42.56
Vayne,Khazix,143,80,63,55.94
Vayne,Sona,42,20,22,47.62
Vayne,Lissandra,84,40,44,47.62
Vayne,Braum,200,100,100,50
Vayne,Vi,361,193,168,53.46
Vayne,FiddleSticks,120,65,55,54.17
Vayne,Hecarim,102,42,60,41.18
Vayne,Briar,144,76,68,52.78
Vayne,Gangplank,129,91,38,70.54
Vayne,Rammus,154,108,46,70.13
Vayne,Nilah,87,50,37,57.47
Vayne,Xerath,256,134,122,52.34
Vayne,JarvanIV,215,118,97,54.88
Vayne,Vex,161,82,79,50.93
Vayne,Singed,48,22,26,45.83
Vayne,Rengar,88,58,30,65.91
Vayne,Ziggs,112,79,33,70.54
Vayne,Talon,140,87,53,62.14
Vayne,Jhin,622,315,307,50.64
Vayne,Qiyana,49,23,26,46.94
Vayne,Leblanc,120,71,49,59.17
Vayne,Olaf,85,57,28,67.06
Vayne,Lulu,330,158,172,47.88
Vayne,Hwei,175,86,89,49.14
Vayne,Viktor,287,136,151,47.39
Vayne,Jax,209,117,92,55.98
Vayne,Corki,170,106,64,62.35
Vayne,Akshan,96,67,29,69.79
Vayne,KogMaw,68,39,29,57.35
Vayne,Brand,139,74,65,53.24
Vayne,Illaoi,115,57,58,49.57
Vayne,Nunu,165,95,70,57.58
Vayne,Alistar,189,95,94,50.26
Vayne,Fiora,78,43,35,55.13
Vayne,Fizz,135,82,53,60.74
Vayne,Draven,155,83,72,53.55
Vayne,Nautilus,420,218,202,51.9
Vayne,Mordekaiser,439,243,196,55.35
Vayne,Varus,263,149,114,56.65
Vayne,Nidalee,92,54,38,58.7
Vayne,Volibear,303,158,145,52.15
Vayne,Swain,314,171,143,54.46
Vayne,Syndra,234,123,111,52.56
Vayne,Rumble,92,52,40,56.52
Vayne,Sivir,158,94,64,59.49
Vayne,Neeko,140,96,44,68.57
Vayne,Urgot,158,93,65,58.86
Vayne,DrMundo,170,109,61,64.12
Vayne,Sett,394,200,194,50.76
Vayne,Kalista,89,58,31,65.17
Vayne,Udyr,111,74,37,66.67
Vayne,Camille,159,67,92,42.14
Vayne,Yuumi,247,109,138,44.13
Vayne,Skarner,147,79,68,53.74
Vayne,Janna,86,30,56,34.88
Vayne,Aphelios,138,93,45,67.39
Vayne,Kassadin,58,26,32,44.83
Vayne,Naafiri,79,36,43,45.57
Vayne,Tryndamere,100,57,43,57
Vayne,Velkoz,123,73,50,59.35
Vayne,Zeri,173,92,81,53.18
Vayne,Cassiopeia,107,46,61,42.99
Vayne,TwistedFate,87,39,48,44.83
Vayne,Belveth,34,18,16,52.94
Vayne,Renata,41,24,17,58.54
Vayne,Azir,109,57,52,52.29
Vayne,Taric,74,44,30,59.46
Vayne,Kennen,98,54,44,55.1
Vayne,Shyvana,56,21,35,37.5
Seraphine,Yone,241,128,113,53.11
Seraphine,Viego,217,80,137,36.87
Seraphine,Yasuo,292,148,144,50.68
Seraphine,Ezreal,354,199,155,56.21
Seraphine,Lux,501,267,234,53.29
Seraphine,Corki,92,47,45,51.09
Seraphine,Ekko,120,58,62,48.33
Seraphine,Leblanc,79,45,34,56.96
Seraphine,Caitlyn,421,201,220,47.74
Seraphine,Mel,337,170,167,50.45
Seraphine,Mordekaiser,225,117,108,52
Seraphine,Lucian,136,87,49,63.97
Seraphine,Rakan,89,48,41,53.93
Seraphine,Garen,268,128,140,47.76
Seraphine,Shyvana,56,35,21,62.5
Seraphine,Lissandra,83,37,46,44.58
Seraphine,Veigar,152,81,71,53.29
Seraphine,Akali,179,96,83,53.63
Seraphine,Belveth,34,28,6,82.35
Seraphine,Varus,165,84,81,50.91
Seraphine,Jhin,298,172,126,57.72
Seraphine,Lulu,297,161,136,54.21
Seraphine,Teemo,144,75,69,52.08
Seraphine,Renekton,80,33,47,41.25
Seraphine,Kassadin,36,25,11,69.44
Seraphine,Jinx,419,196,223,46.78
Seraphine,Soraka,94,44,50,46.81
Seraphine,Darius,308,136,172,44.16
Seraphine,Nocturne,221,98,123,44.34
Seraphine,Katarina,82,56,26,68.29
Seraphine,Nami,194,101,93,52.06
Seraphine,Yorick,120,54,66,45
Seraphine,Nunu,88,49,39,55.68
Seraphine,TwistedFate,51,22,29,43.14
Seraphine,Bard,49,18,31,36.73
Seraphine,Kled,34,10,24,29.41
Seraphine,Gragas,106,63,43,59.43
Seraphine,Anivia,52,17,35,32.69
Seraphine,Rell,105,54,51,51.43
Seraphine,Ambessa,148,57,91,38.51
Seraphine,Gnar,67,39,28,58.21
Seraphine,Hwei,109,51,58,46.79
Seraphine,Samira,150,64,86,42.67
Seraphine,TahmKench,165,72,93,43.64
Seraphine,Illaoi,79,38,41,48.1
Seraphine,Amumu,216,104,112,48.15
Seraphine,Vladimir,88,23,65,26.14
Seraphine,MasterYi,132,64,68,48.48
Seraphine,Tristana,178,97,81,54.49
Seraphine,Yuumi,118,58,60,49.15
Seraphine,Tryndamere,46,11,35,23.91
Seraphine,Aurora,145,71,74,48.97
Seraphine,Vayne,175,80,95,45.71
Seraphine,Senna,132,63,69,47.73
Seraphine,Aatrox,142,95,47,66.9
Seraphine,Karthus,31,11,20,35.48
Seraphine,Xayah,59,26,33,44.07
Seraphine,Annie,60,22,38,36.67
Seraphine,Viktor,115,73,42,63.48
Seraphine,Vi,211,88,123,41.71
Seraphine,Irelia,119,69,50,57.98
Seraphine,Urgot,81,35,46,43.21
Seraphine,Syndra,107,48,59,44.86
Seraphine,Milio,132,56,76,42.42
Seraphine,Azir,71,40,31,56.34
Seraphine,Sona,43,22,21,51.16
Seraphine,Zyra,164,96,68,58.54
Seraphine,Ashe,303,158,145,52.15
Seraphine,Qiyana,40,29,11,72.5
Seraphine,Karma,186,103,83,55.38
Seraphine,Pantheon,290,136,154,46.9
Seraphine,Kaisa,267,127,140,47.57
Seraphine,Alistar,52,24,28,46.15
Seraphine,Camille,73,32,41,43.84
Seraphine,Graves,90,40,50,44.44
Seraphine,Xerath,140,83,57,59.29
Seraphine,Smolder,113,66,47,58.41
Seraphine,Leona,165,75,90,45.45
Seraphine,Sett,234,99,135,42.31
Seraphine,LeeSin,308,161,147,52.27
Seraphine,Galio,206,107,99,51.94
Seraphine,Brand,138,76,62,55.07
Seraphine,Diana,266,119,147,44.74
Seraphine,Talon,84,41,43,48.81
Seraphine,Chogath,193,107,86,55.44
Seraphine,FiddleSticks,76,41,35,53.95
Seraphine,Kayn,185,103,82,55.68
Seraphine,Braum,128,56,72,43.75
Seraphine,Malphite,211,111,100,52.61
Seraphine,Warwick,208,107,101,51.44
Seraphine,Poppy,109,52,57,47.71
Seraphine,Riven,108,57,51,52.78
Seraphine,Zoe,50,24,26,48
Seraphine,Jax,115,51,64,44.35
Seraphine,Rumble,45,26,19,57.78
Seraphine,Volibear,149,63,86,42.28
Seraphine,Shaco,146,74,72,50.68
Seraphine,Swain,121,46,75,38.02
Seraphine,Ivern,16,8,8,50
Seraphine,Aphelios,120,77,43,64.17
Seraphine,MissFortune,417,221,196,53
Seraphine,Sejuani,100,51,49,51
Seraphine,Zed,178,94,84,52.81
Seraphine,Sivir,88,45,43,51.14
Seraphine,Gangplank,90,44,46,48.89
Seraphine,Vex,113,50,63,44.25
Seraphine,Hecarim,64,38,26,59.38
Seraphine,Ahri,251,125,126,49.8
Seraphine,MonkeyKing,112,54,58,48.21
Seraphine,Gwen,95,51,44,53.68
Seraphine,KSante,96,49,47,51.04
Seraphine,Skarner,90,48,42,53.33
Seraphine,Sylas,245,155,90,63.27
Seraphine,Heimerdinger,77,37,40,48.05
Seraphine,Nasus,132,69,63,52.27
Seraphine,Pyke,132,74,58,56.06
Seraphine,DrMundo,59,42,17,71.19
Seraphine,JarvanIV,152,85,67,55.92
Seraphine,Thresh,307,163,144,53.09
Seraphine,Kayle,89,38,51,42.7
Seraphine,Udyr,48,24,24,50
Seraphine,Cassiopeia,60,41,19,68.33
Seraphine,Orianna,95,43,52,45.26
Seraphine,Neeko,67,45,22,67.16
Seraphine,Blitzcrank,121,58,63,47.93
Seraphine,Ryze,66,40,26,60.61
Seraphine,Morgana,162,78,84,48.15
Seraphine,Khazix,79,57,22,72.15
Seraphine,Trundle,81,25,56,30.86
Seraphine,Lillia,68,37,31,54.41
Seraphine,Evelynn,48,22,26,45.83
Seraphine,Naafiri,46,34,12,73.91
Seraphine,Malzahar,163,74,89,45.4
Seraphine,Olaf,35,17,18,48.57
Seraphine,Singed,45,17,28,37.78
Seraphine,Draven,74,29,45,39.19
Seraphine,Elise,118,54,64,45.76
Seraphine,Zeri,46,23,23,50
Seraphine,KogMaw,53,18,35,33.96
Seraphine,Taliyah,36,20,16,55.56
Seraphine,Briar,93,48,45,51.61
Seraphine,Ziggs,78,43,35,55.13
Seraphine,Kindred,58,32,26,55.17
Seraphine,AurelionSol,79,31,48,39.24
Seraphine,Shen,138,53,85,38.41
Seraphine,Nidalee,60,44,16,73.33
Seraphine,Kalista,54,34,20,62.96
Seraphine,Akshan,42,16,26,38.1
Seraphine,Fiora,81,38,43,46.91
Seraphine,Rengar,53,35,18,66.04
Seraphine,Ornn,90,51,39,56.67
Seraphine,Zac,81,40,41,49.38
Seraphine,Nautilus,216,90,126,41.67
Seraphine,Maokai,105,39,66,37.14
Seraphine,Rammus,66,45,21,68.18
Seraphine,Kennen,33,14,19,42.42
Seraphine,Twitch,138,70,68,50.72
Seraphine,XinZhao,101,58,43,57.43
Seraphine,Velkoz,67,43,24,64.18
Seraphine,Quinn,52,22,30,42.31
Seraphine,Janna,32,14,18,43.75
Seraphine,Taric,36,19,17,52.78
Seraphine,Sion,148,97,51,65.54
Seraphine,Zilean,16,7,9,43.75
Seraphine,Nilah,62,34,28,54.84
Seraphine,Fizz,86,28,58,32.56
Seraphine,Jayce,69,27,42,39.13
Seraphine,RekSai,22,5,17,22.73
Seraphine,Renata,29,9,20,31.03
Yone,Ambessa,322,172,150,53.42
Yone,Volibear,366,175,191,47.81
Yone,Veigar,375,176,199,46.93
Yone,Vayne,430,218,212,50.7
Yone,Seraphine,241,113,128,46.89
Yone,Jax,406,197,209,48.52
Yone,Sejuani,257,120,137,46.69
Yone,Hwei,212,107,105,50.47
Yone,Ezreal,1093,511,582,46.75
Yone,Zac,227,123,104,54.19
Yone,Mordekaiser,501,272,229,54.29
Yone,Kayn,433,216,217,49.88
Yone,Katarina,230,134,96,58.26
Yone,Caitlyn,998,437,561,43.79
Yone,Morgana,354,140,214,39.55
Yone,Maokai,148,84,64,56.76
Yone,Viego,591,283,308,47.88
Yone,Viktor,385,175,210,45.45
Yone,Smolder,301,147,154,48.84
Yone,Nami,359,173,186,48.19
Yone,Ivern,74,29,45,39.19
Yone,Renekton,328,148,180,45.12
Yone,Vladimir,266,142,124,53.38
Yone,Lucian,317,143,174,45.11
Yone,Blitzcrank,415,186,229,44.82
Yone,Nasus,252,127,125,50.4
Yone,FiddleSticks,178,72,106,40.45
Yone,Syndra,265,156,109,58.87
Yone,Mel,819,438,381,53.48
Yone,Heimerdinger,156,74,82,47.44
Yone,Gragas,294,164,130,55.78
Yone,Jinx,940,427,513,45.43
Yone,Pyke,389,187,202,48.07
Yone,MasterYi,400,197,203,49.25
Yone,Leona,456,200,256,43.86
Yone,Ashe,861,458,403,53.19
Yone,Trundle,191,77,114,40.31
Yone,Diana,666,341,325,51.2
Yone,Braum,318,151,167,47.48
Yone,Gangplank,201,98,103,48.76
Yone,Darius,789,391,398,49.56
Yone,Teemo,362,174,188,48.07
Yone,Nilah,120,69,51,57.5
Yone,Yorick,315,155,160,49.21
Yone,Akali,538,253,285,47.03
Yone,Milio,213,102,111,47.89
Yone,Yasuo,1029,517,512,50.24
Yone,Tristana,280,156,124,55.71
Yone,Lux,889,402,487,45.22
Yone,Urgot,184,98,86,53.26
Yone,Malzahar,345,166,179,48.12
Yone,KSante,281,160,121,56.94
Yone,Annie,135,72,63,53.33
Yone,Malphite,492,213,279,43.29
Yone,Sett,675,312,363,46.22
Yone,LeeSin,722,349,373,48.34
Yone,Lissandra,139,79,60,56.83
Yone,Irelia,338,184,154,54.44
Yone,Lulu,612,282,330,46.08
Yone,Gwen,189,87,102,46.03
Yone,Amumu,441,161,280,36.51
Yone,DrMundo,181,64,117,35.36
Yone,Rammus,165,89,76,53.94
Yone,Zed,379,182,197,48.02
Yone,Jayce,170,80,90,47.06
Yone,Ekko,304,136,168,44.74
Yone,Xayah,260,111,149,42.69
Yone,Zyra,309,141,168,45.63
Yone,Aatrox,513,290,223,56.53
Yone,Orianna,133,57,76,42.86
Yone,Twitch,188,109,79,57.98
Yone,Pantheon,705,332,373,47.09
Yone,Singed,102,64,38,62.75
Yone,Leblanc,271,152,119,56.09
Yone,Skarner,225,109,116,48.44
Yone,KogMaw,116,69,47,59.48
Yone,Nautilus,472,200,272,42.37
Yone,Camille,163,83,80,50.92
Yone,Lillia,262,129,133,49.24
Yone,Varus,380,171,209,45
Yone,JarvanIV,250,119,131,47.6
Yone,Naafiri,150,74,76,49.33
Yone,Soraka,195,110,85,56.41
Yone,Azir,181,77,104,42.54
Yone,Gnar,184,84,100,45.65
Yone,Udyr,146,77,69,52.74
Yone,MissFortune,822,390,432,47.45
Yone,Sion,351,175,176,49.86
Yone,Kassadin,55,33,22,60
Yone,MonkeyKing,282,90,192,31.91
Yone,Chogath,462,211,251,45.67
Yone,Karma,476,213,263,44.75
Yone,Shen,268,132,136,49.25
Yone,Ornn,227,127,100,55.95
Yone,Elise,361,184,177,50.97
Yone,Draven,198,108,90,54.55
Yone,TahmKench,340,177,163,52.06
Yone,Khazix,201,100,101,49.75
Yone,Jhin,724,391,333,54.01
Yone,Kaisa,699,348,351,49.79
Yone,Shaco,314,158,156,50.32
Yone,Karthus,81,43,38,53.09
Yone,Riven,128,48,80,37.5
Yone,Sylas,718,352,366,49.03
Yone,Poppy,309,172,137,55.66
Yone,AurelionSol,166,77,89,46.39
Yone,Briar,224,103,121,45.98
Yone,Nocturne,480,246,234,51.25
Yone,Ahri,563,275,288,48.85
Yone,Taric,68,31,37,45.59
Yone,Vi,364,162,202,44.51
Yone,Xerath,341,192,149,56.3
Yone,Aurora,269,134,135,49.81
Yone,RekSai,67,30,37,44.78
Yone,Nunu,269,151,118,56.13
Yone,Belveth,83,55,28,66.27
Yone,Galio,543,237,306,43.65
Yone,Warwick,510,232,278,45.49
Yone,Brand,174,103,71,59.2
Yone,Vex,303,166,137,54.79
Yone,Zoe,166,67,99,40.36
Yone,Rakan,225,110,115,48.89
Yone,Swain,389,182,207,46.79
Yone,Kayle,198,108,90,54.55
Yone,Alistar,261,125,136,47.89
Yone,Rengar,98,50,48,51.02
Yone,Illaoi,198,96,102,48.48
Yone,Shyvana,74,36,38,48.65
Yone,Aphelios,215,111,104,51.63
Yone,Talon,190,90,100,47.37
Yone,Ryze,155,77,78,49.68
Yone,Janna,103,47,56,45.63
Yone,Sona,72,31,41,43.06
Yone,Zilean,115,58,57,50.43
Yone,XinZhao,314,158,156,50.32
Yone,Taliyah,88,33,55,37.5
Yone,Kalista,128,71,57,55.47
Yone,Nidalee,145,76,69,52.41
Yone,Garen,539,238,301,44.16
Yone,Kled,69,33,36,47.83
Yone,Fizz,124,52,72,41.94
Yone,TwistedFate,135,80,55,59.26
Yone,Tryndamere,140,80,60,57.14
Yone,Thresh,723,379,344,52.42
Yone,Qiyana,94,46,48,48.94
Yone,Neeko,181,91,90,50.28
Yone,Yuumi,294,163,131,55.44
Yone,Rell,237,97,140,40.93
Yone,Ziggs,188,76,112,40.43
Yone,Senna,241,146,95,60.58
Yone,Velkoz,185,84,101,45.41
Yone,Samira,299,132,167,44.15
Yone,Sivir,199,77,122,38.69
Yone,Kennen,127,51,76,40.16
Yone,Zeri,239,100,139,41.84
Yone,Bard,90,40,50,44.44
Yone,Akshan,110,69,41,62.73
Yone,Cassiopeia,105,45,60,42.86
Yone,Corki,183,101,82,55.19
Yone,Fiora,151,59,92,39.07
Yone,Graves,301,129,172,42.86
Yone,Anivia,129,57,72,44.19
Yone,Hecarim,134,77,57,57.46
Yone,Quinn,101,44,57,43.56
Yone,Renata,72,40,32,55.56
Yone,Rumble,133,57,76,42.86
Yone,Evelynn,93,40,53,43.01
Yone,Olaf,87,26,61,29.89
Yone,Kindred,156,70,86,44.87
Viego,Ambessa,291,107,184,36.77
Viego,Volibear,319,169,150,52.98
Viego,Veigar,261,138,123,52.87
Viego,Vayne,372,152,220,40.86
Viego,Seraphine,217,137,80,63.13
Viego,Yone,591,308,283,52.12
Viego,Nocturne,370,169,201,45.68
Viego,Akali,288,153,135,53.13
Viego,Ezreal,834,457,377,54.8
Viego,Renata,77,39,38,50.65
Viego,Nasus,200,108,92,54
Viego,FiddleSticks,141,74,67,52.48
Viego,Syndra,229,109,120,47.6
Viego,Mel,657,339,318,51.6
Viego,Sion,259,140,119,54.05
Viego,RekSai,56,28,28,50
Viego,Viktor,294,143,151,48.64
Viego,KogMaw,74,33,41,44.59
Viego,Ashe,670,387,283,57.76
Viego,Urgot,108,53,55,49.07
Viego,Kayn,409,211,198,51.59
Viego,Vladimir,168,81,87,48.21
Viego,Kaisa,543,273,270,50.28
Viego,Taric,67,47,20,70.15
Viego,Garen,428,198,230,46.26
Viego,Warwick,383,175,208,45.69
Viego,Ahri,432,221,211,51.16
Viego,Jinx,746,322,424,43.16
Viego,Milio,179,82,97,45.81
Viego,Jax,282,150,132,53.19
Viego,Diana,466,219,247,47
Viego,Akshan,52,33,19,63.46
Viego,Sylas,476,246,230,51.68
Viego,Evelynn,108,57,51,52.78
Viego,Varus,261,143,118,54.79
Viego,Karma,433,237,196,54.73
Viego,Aatrox,354,163,191,46.05
Viego,TwistedFate,106,54,52,50.94
Viego,Lux,596,307,289,51.51
Viego,Lulu,395,165,230,41.77
Viego,Olaf,105,57,48,54.29
Viego,Nidalee,129,89,40,68.99
Viego,Ryze,144,68,76,47.22
Viego,Caitlyn,721,345,376,47.85
Viego,Brand,141,88,53,62.41
Viego,Irelia,214,130,84,60.75
Viego,Ekko,264,114,150,43.18
Viego,Qiyana,86,42,44,48.84
Viego,Thresh,582,275,307,47.25
Viego,Amumu,372,181,191,48.66
Viego,Zeri,159,64,95,40.25
Viego,Pantheon,492,223,269,45.33
Viego,Zac,193,95,98,49.22
Viego,Janna,97,57,40,58.76
Viego,Vi,395,230,165,58.23
Viego,Orianna,191,118,73,61.78
Viego,Nilah,103,47,56,45.63
Viego,Leona,283,147,136,51.94
Viego,Gangplank,207,108,99,52.17
Viego,Taliyah,114,56,58,49.12
Viego,MissFortune,528,280,248,53.03
Viego,Mordekaiser,363,164,199,45.18
Viego,MonkeyKing,313,160,153,51.12
Viego,Samira,239,130,109,54.39
Viego,Rell,214,115,99,53.74
Viego,Lissandra,131,62,69,47.33
Viego,Senna,127,81,46,63.78
Viego,LeeSin,699,361,338,51.65
Viego,Yasuo,584,319,265,54.62
Viego,Katarina,200,111,89,55.5
Viego,Gwen,158,93,65,58.86
Viego,Aurora,235,105,130,44.68
Viego,Morgana,351,150,201,42.74
Viego,Gragas,192,108,84,56.25
Viego,Tryndamere,102,48,54,47.06
Viego,Poppy,225,121,104,53.78
Viego,Nautilus,421,226,195,53.68
Viego,Jayce,175,100,75,57.14
Viego,Draven,143,90,53,62.94
Viego,Lillia,146,69,77,47.26
Viego,Nami,295,141,154,47.8
Viego,Udyr,78,48,30,61.54
Viego,Blitzcrank,302,153,149,50.66
Viego,Sett,408,192,216,47.06
Viego,Sejuani,200,92,108,46
Viego,Yuumi,244,124,120,50.82
Viego,Fizz,86,45,41,52.33
Viego,Ornn,196,76,120,38.78
Viego,Corki,126,82,44,65.08
Viego,Soraka,155,101,54,65.16
Viego,Shaco,227,126,101,55.51
Viego,TahmKench,217,95,122,43.78
Viego,Yorick,266,119,147,44.74
Viego,Rakan,171,94,77,54.97
Viego,Rammus,106,50,56,47.17
Viego,Jhin,566,270,296,47.7
Viego,Velkoz,124,53,71,42.74
Viego,Braum,254,118,136,46.46
Viego,Graves,219,100,119,45.66
Viego,KSante,187,88,99,47.06
Viego,Trundle,123,71,52,57.72
Viego,Belveth,82,55,27,67.07
Viego,Malphite,361,182,179,50.42
Viego,Malzahar,260,113,147,43.46
Viego,Darius,523,272,251,52.01
Viego,Zyra,263,149,114,56.65
Viego,Khazix,151,69,82,45.7
Viego,Hwei,238,124,114,52.1
Viego,Rengar,84,36,48,42.86
Viego,Chogath,421,193,228,45.84
Viego,Zilean,78,30,48,38.46
Viego,Elise,309,156,153,50.49
Viego,Karthus,77,40,37,51.95
Viego,Leblanc,163,88,75,53.99
Viego,JarvanIV,236,130,106,55.08
Viego,Renekton,178,93,85,52.25
Viego,Maokai,148,82,66,55.41
Viego,Swain,295,152,143,51.53
Viego,Kennen,110,60,50,54.55
Viego,Heimerdinger,152,95,57,62.5
Viego,Kassadin,54,18,36,33.33
Viego,Rumble,111,57,54,51.35
Viego,Smolder,223,117,106,52.47
Viego,Gnar,175,102,73,58.29
Viego,Zed,347,159,188,45.82
Viego,Teemo,245,123,122,50.2
Viego,Shen,240,121,119,50.42
Viego,Kled,40,15,25,37.5
Viego,Kindred,109,74,35,67.89
Viego,Aphelios,177,86,91,48.59
Viego,Kalista,122,71,51,58.2
Viego,Xayah,189,106,83,56.08
Viego,Xerath,248,121,127,48.79
Viego,Quinn,108,52,56,48.15
Viego,Alistar,179,74,105,41.34
Viego,MasterYi,229,122,107,53.28
Viego,Fiora,99,52,47,52.53
Viego,Anivia,102,38,64,37.25
Viego,Twitch,186,78,108,41.94
Viego,Cassiopeia,40,27,13,67.5
Viego,Tristana,255,118,137,46.27
Viego,Hecarim,139,88,51,63.31
Viego,Camille,105,61,44,58.1
Viego,Nunu,160,85,75,53.13
Viego,Vex,183,96,87,52.46
Viego,Neeko,117,56,61,47.86
Viego,Sona,46,23,23,50
Viego,Lucian,253,133,120,52.57
Viego,Illaoi,121,86,35,71.07
Viego,Singed,67,25,42,37.31
Viego,Azir,157,61,96,38.85
Viego,Pyke,291,173,118,59.45
Viego,XinZhao,242,139,103,57.44
Viego,AurelionSol,98,48,50,48.98
Viego,Skarner,157,87,70,55.41
Viego,Briar,133,67,66,50.38
Viego,Ziggs,95,47,48,49.47
Viego,Galio,352,177,175,50.28
Viego,Shyvana,84,20,64,23.81
Viego,Kayle,169,81,88,47.93
Viego,Zoe,149,95,54,63.76
Viego,DrMundo,133,69,64,51.88
Viego,Naafiri,73,31,42,42.47
Viego,Ivern,73,44,29,60.27
Viego,Riven,99,48,51,48.48
Viego,Talon,145,71,74,48.97
Viego,Sivir,175,104,71,59.43
Viego,Bard,120,68,52,56.67
Viego,Annie,67,35,32,52.24
Yasuo,Ambessa,348,187,161,53.74
Yasuo,Volibear,413,199,214,48.18
Yasuo,Veigar,366,190,176,51.91
Yasuo,Vayne,509,222,287,43.61
Yasuo,Seraphine,292,144,148,49.32
Yasuo,Renekton,341,142,199,41.64
Yasuo,Udyr,215,115,100,53.49
Yasuo,Qiyana,87,50,37,57.47
Yasuo,Xayah,248,124,124,50
Yasuo,Morgana,402,181,221,45.02
Yasuo,Riven,179,86,93,48.04
Yasuo,Poppy,370,194,176,52.43
Yasuo,Ziggs,190,114,76,60
Yasuo,Yuumi,358,181,177,50.56
Yasuo,Diana,633,363,270,57.35
Yasuo,Ekko,349,155,194,44.41
Yasuo,Jinx,1045,483,562,46.22
Yasuo,Lulu,620,301,319,48.55
Yasuo,DrMundo,151,79,72,52.32
Yasuo,Rammus,234,101,133,43.16
Yasuo,Annie,198,96,102,48.48
Yasuo,Ezreal,1086,578,508,53.22
Yasuo,Renata,100,51,49,51
Yasuo,Akali,567,303,264,53.44
Yasuo,Amumu,490,204,286,41.63
Yasuo,Caitlyn,1157,564,593,48.75
Yasuo,Lux,1030,550,480,53.4
Yasuo,Vladimir,332,163,169,49.1
Yasuo,MasterYi,495,263,232,53.13
Yasuo,Leona,430,194,236,45.12
Yasuo,Ashe,902,447,455,49.56
Yasuo,Mordekaiser,572,242,330,42.31
Yasuo,Shen,387,168,219,43.41
Yasuo,Katarina,249,122,127,49
Yasuo,Jhin,869,417,452,47.99
Yasuo,Karma,637,325,312,51.02
Yasuo,Shaco,398,204,194,51.26
Yasuo,Heimerdinger,195,108,87,55.38
Yasuo,Thresh,813,429,384,52.77
Yasuo,Sion,389,164,225,42.16
Yasuo,Aatrox,468,229,239,48.93
Yasuo,TwistedFate,104,57,47,54.81
Yasuo,Fizz,213,100,113,46.95
Yasuo,Vex,404,200,204,49.5
Yasuo,Sona,72,39,33,54.17
Yasuo,FiddleSticks,186,86,100,46.24
Yasuo,Hwei,264,168,96,63.64
Yasuo,Teemo,434,222,212,51.15
Yasuo,Janna,98,54,44,55.1
Yasuo,Hecarim,173,74,99,42.77
Yasuo,Sett,693,355,338,51.23
Yasuo,XinZhao,335,182,153,54.33
Yasuo,Kaisa,782,415,367,53.07
Yasuo,KSante,320,168,152,52.5
Yasuo,Yone,1029,512,517,49.76
Yasuo,Zilean,137,56,81,40.88
Yasuo,Garen,760,351,409,46.18
Yasuo,Belveth,81,40,41,49.38
Yasuo,Malzahar,462,247,215,53.46
Yasuo,Varus,451,254,197,56.32
Yasuo,Kayn,595,281,314,47.23
Yasuo,KogMaw,128,54,74,42.19
Yasuo,Nocturne,593,272,321,45.87
Yasuo,Viktor,379,197,182,51.98
Yasuo,Gangplank,220,121,99,55
Yasuo,LeeSin,855,450,405,52.63
Yasuo,Anivia,201,114,87,56.72
Yasuo,Kennen,122,42,80,34.43
Yasuo,Talon,286,166,120,58.04
Yasuo,Aphelios,284,141,143,49.65
Yasuo,Pyke,308,152,156,49.35
Yasuo,Gwen,206,106,100,51.46
Yasuo,Kayle,234,114,120,48.72
Yasuo,Zed,603,292,311,48.42
Yasuo,Tristana,389,200,189,51.41
Yasuo,Mel,973,491,482,50.46
Yasuo,Soraka,226,105,121,46.46
Yasuo,Chogath,500,255,245,51
Yasuo,Singed,139,76,63,54.68
Yasuo,Zyra,331,163,168,49.24
Yasuo,Darius,877,398,479,45.38
Yasuo,Blitzcrank,446,211,235,47.31
Yasuo,Sejuani,264,142,122,53.79
Yasuo,Irelia,333,197,136,59.16
Yasuo,Aurora,365,197,168,53.97
Yasuo,Smolder,353,162,191,45.89
Yasuo,Nami,429,220,209,51.28
Yasuo,Samira,322,187,135,58.07
Yasuo,Pantheon,761,370,391,48.62
Yasuo,Taliyah,125,60,65,48
Yasuo,MissFortune,819,403,416,49.21
Yasuo,Orianna,184,95,89,51.63
Yasuo,Velkoz,211,94,117,44.55
Yasuo,Gnar,247,144,103,58.3
Yasuo,Lillia,281,115,166,40.93
Yasuo,Malphite,599,303,296,50.58
Yasuo,Galio,499,239,260,47.9
Yasuo,Khazix,184,98,86,53.26
Yasuo,Gragas,338,155,183,45.86
Yasuo,Neeko,235,110,125,46.81
Yasuo,Jayce,224,118,106,52.68
Yasuo,Milio,278,120,158,43.17
Yasuo,Nasus,286,163,123,56.99
Yasuo,Vi,481,259,222,53.85
Yasuo,Maokai,183,81,102,44.26
Yasuo,Warwick,608,295,313,48.52
Yasuo,Graves,291,113,178,38.83
Yasuo,Xerath,381,212,169,55.64
Yasuo,Draven,227,114,113,50.22
Yasuo,Nunu,209,133,76,63.64
Yasuo,Zoe,166,103,63,62.05
Yasuo,TahmKench,390,215,175,55.13
Yasuo,MonkeyKing,290,137,153,47.24
Yasuo,Zac,291,133,158,45.7
Yasuo,Lucian,409,206,203,50.37
Yasuo,Swain,423,211,212,49.88
Yasuo,Ornn,269,120,149,44.61
Yasuo,Ahri,561,271,290,48.31
Yasuo,Sylas,764,425,339,55.63
Yasuo,Briar,224,84,140,37.5
Yasuo,Braum,355,188,167,52.96
Yasuo,Jax,397,191,206,48.11
Yasuo,Trundle,199,108,91,54.27
Yasuo,Syndra,232,108,124,46.55
Yasuo,Viego,584,265,319,45.38
Yasuo,JarvanIV,315,165,150,52.38
Yasuo,Yorick,348,175,173,50.29
Yasuo,Brand,181,94,87,51.93
Yasuo,Corki,187,121,66,64.71
Yasuo,Senna,225,120,105,53.33
Yasuo,Twitch,294,152,142,51.7
Yasuo,Alistar,273,141,132,51.65
Yasuo,Rengar,136,86,50,63.24
Yasuo,AurelionSol,137,51,86,37.23
Yasuo,Nautilus,610,300,310,49.18
Yasuo,Illaoi,220,113,107,51.36
Yasuo,Rakan,220,115,105,52.27
Yasuo,Ivern,101,61,40,60.4
Yasuo,Sivir,231,102,129,44.16
Yasuo,Fiora,163,94,69,57.67
Yasuo,Kindred,165,92,73,55.76
Yasuo,Bard,100,54,46,54
Yasuo,Urgot,168,92,76,54.76
Yasuo,Evelynn,166,93,73,56.02
Yasuo,Kalista,153,73,80,47.71
Yasuo,Azir,190,90,100,47.37
Yasuo,Kled,64,21,43,32.81
Yasuo,Zeri,219,116,103,52.97
Yasuo,Tryndamere,149,62,87,41.61
Yasuo,Kassadin,74,26,48,35.14
Yasuo,Lissandra,214,121,93,56.54
Yasuo,RekSai,78,30,48,38.46
Yasuo,Taric,93,41,52,44.09
Yasuo,Skarner,155,77,78,49.68
Yasuo,Nilah,164,68,96,41.46
Yasuo,Leblanc,240,114,126,47.5
Yasuo,Ryze,164,67,97,40.85
Yasuo,Nidalee,115,80,35,69.57
Yasuo,Rell,277,140,137,50.54
Yasuo,Shyvana,106,54,52,50.94
Yasuo,Rumble,138,84,54,60.87
Yasuo,Elise,344,168,176,48.84
Yasuo,Cassiopeia,108,45,63,41.67
Yasuo,Olaf,111,48,63,43.24
Yasuo,Camille,182,104,78,57.14
Yasuo,Quinn,123,67,56,54.47
Yasuo,Akshan,129,83,46,64.34
Yasuo,Naafiri,129,55,74,42.64
Yasuo,Karthus,83,43,40,51.81
Ezreal,Ambessa,461,210,251,45.55
Ezreal,Volibear,472,226,246,47.88
Ezreal,Veigar,503,256,247,50.89
Ezreal,Vayne,825,333,492,40.36
Ezreal,Seraphine,354,155,199,43.79
Ezreal,Teemo,475,228,247,48
Ezreal,Kayn,599,305,294,50.92
Ezreal,Yone,1093,582,511,53.25
Ezreal,Ryze,253,121,132,47.83
Ezreal,Lux,1226,592,634,48.29
Ezreal,Maokai,250,128,122,51.2
Ezreal,Viego,834,377,457,45.2
Ezreal,Viktor,630,289,341,45.87
Ezreal,Smolder,418,206,212,49.28
Ezreal,Nami,500,204,296,40.8
Ezreal,Olaf,189,90,99,47.62
Ezreal,Yasuo,1086,508,578,46.78
Ezreal,Galio,763,406,357,53.21
Ezreal,Velkoz,286,141,145,49.3
Ezreal,Yorick,412,191,221,46.36
Ezreal,Warwick,680,323,357,47.5
Ezreal,Akali,525,290,235,55.24
Ezreal,Jhin,1183,616,567,52.07
Ezreal,Braum,398,177,221,44.47
Ezreal,Jax,525,280,245,53.33
Ezreal,MasterYi,574,288,286,50.17
Ezreal,Caitlyn,1827,968,859,52.98
Ezreal,Malzahar,594,281,313,47.31
Ezreal,Morgana,579,225,354,38.86
Ezreal,Nasus,322,154,168,47.83
Ezreal,Shaco,445,239,206,53.71
Ezreal,Xerath,541,291,250,53.79
Ezreal,Lulu,1023,458,565,44.77
Ezreal,Diana,1010,507,503,50.2
Ezreal,Ashe,1544,779,765,50.45
Ezreal,Leblanc,351,188,163,53.56
Ezreal,Nautilus,836,435,401,52.03
Ezreal,Aatrox,653,342,311,52.37
Ezreal,Mel,1183,607,576,51.31
Ezreal,Tristana,449,247,202,55.01
Ezreal,Sona,93,58,35,62.37
Ezreal,Nidalee,264,165,99,62.5
Ezreal,Brand,312,125,187,40.06
Ezreal,Malphite,778,394,384,50.64
Ezreal,Ivern,116,58,58,50
Ezreal,Ahri,947,449,498,47.41
Ezreal,MonkeyKing,477,197,280,41.3
Ezreal,Rakan,371,193,178,52.02
Ezreal,Katarina,368,192,176,52.17
Ezreal,Taric,114,62,52,54.39
Ezreal,Zed,649,327,322,50.39
Ezreal,FiddleSticks,260,107,153,41.15
Ezreal,Darius,1163,504,659,43.34
Ezreal,Nocturne,807,349,458,43.25
Ezreal,Lucian,566,294,272,51.94
Ezreal,Mordekaiser,685,342,343,49.93
Ezreal,Hecarim,157,90,67,57.32
Ezreal,Sett,822,417,405,50.73
Ezreal,Xayah,365,163,202,44.66
Ezreal,Cassiopeia,134,54,80,40.3
Ezreal,Gragas,540,311,229,57.59
Ezreal,TahmKench,585,256,329,43.76
Ezreal,Trundle,290,131,159,45.17
Ezreal,Vi,716,355,361,49.58
Ezreal,Jinx,1570,695,875,44.27
Ezreal,Khazix,310,161,149,51.94
Ezreal,Zilean,161,71,90,44.1
Ezreal,Kennen,228,104,124,45.61
Ezreal,XinZhao,481,246,235,51.14
Ezreal,Quinn,166,86,80,51.81
Ezreal,LeeSin,1295,672,623,51.89
Ezreal,Milio,339,176,163,51.92
Ezreal,Evelynn,140,67,73,47.86
Ezreal,Fizz,244,110,134,45.08
Ezreal,Aphelios,362,165,197,45.58
Ezreal,Soraka,231,109,122,47.19
Ezreal,JarvanIV,442,207,235,46.83
Ezreal,Rumble,181,98,83,54.14
Ezreal,Kayle,288,133,155,46.18
Ezreal,Vex,322,154,168,47.83
Ezreal,Riven,228,128,100,56.14
Ezreal,Vladimir,345,159,186,46.09
Ezreal,Ziggs,224,90,134,40.18
Ezreal,Heimerdinger,219,119,100,54.34
Ezreal,Kindred,235,122,113,51.91
Ezreal,MissFortune,1255,581,674,46.29
Ezreal,Neeko,279,138,141,49.46
Ezreal,Karma,868,444,424,51.15
Ezreal,Renekton,352,193,159,54.83
Ezreal,TwistedFate,202,92,110,45.54
Ezreal,Thresh,1143,504,639,44.09
Ezreal,Urgot,229,98,131,42.79
Ezreal,Elise,546,254,292,46.52
Ezreal,Qiyana,155,79,76,50.97
Ezreal,Kalista,244,120,124,49.18
Ezreal,Illaoi,253,139,114,54.94
Ezreal,Nunu,381,197,184,51.71
Ezreal,Zoe,232,106,126,45.69
Ezreal,Draven,306,169,137,55.23
Ezreal,Leona,619,287,332,46.37
Ezreal,Yuumi,459,234,225,50.98
Ezreal,Sylas,1010,470,540,46.53
Ezreal,Rammus,159,72,87,45.28
Ezreal,Zyra,460,223,237,48.48
Ezreal,Kaisa,1320,640,680,48.48
Ezreal,Fiora,189,70,119,37.04
Ezreal,Samira,403,186,217,46.15
Ezreal,Rell,395,194,201,49.11
Ezreal,Zac,328,168,160,51.22
Ezreal,Irelia,430,222,208,51.63
Ezreal,Varus,586,302,284,51.54
Ezreal,Chogath,679,305,374,44.92
Ezreal,Blitzcrank,668,343,325,51.35
Ezreal,Amumu,627,265,362,42.26
Ezreal,Jayce,404,180,224,44.55
Ezreal,Renata,117,50,67,42.74
Ezreal,Gwen,255,146,109,57.25
Ezreal,Poppy,325,162,163,49.85
Ezreal,Hwei,405,168,237,41.48
Ezreal,AurelionSol,201,88,113,43.78
Ezreal,Azir,265,142,123,53.58
Ezreal,Gangplank,320,136,184,42.5
Ezreal,Aurora,514,255,259,49.61
Ezreal,DrMundo,276,140,136,50.72
Ezreal,Briar,337,153,184,45.4
Ezreal,Udyr,201,113,88,56.22
Ezreal,Pantheon,968,476,492,49.17
Ezreal,Garen,894,422,472,47.2
Ezreal,Sion,479,225,254,46.97
Ezreal,Camille,269,110,159,40.89
Ezreal,Alistar,279,129,150,46.24
Ezreal,Graves,406,197,209,48.52
Ezreal,Lillia,312,176,136,56.41
Ezreal,Gnar,301,167,134,55.48
Ezreal,Sivir,423,173,250,40.9
Ezreal,Ekko,465,227,238,48.82
Ezreal,Orianna,316,173,143,54.75
Ezreal,Shen,407,158,249,38.82
Ezreal,Swain,447,202,245,45.19
Ezreal,Shyvana,126,55,71,43.65
Ezreal,Twitch,347,187,160,53.89
Ezreal,Sejuani,379,152,227,40.11
Ezreal,Talon,300,162,138,54
Ezreal,Karthus,165,104,61,63.03
Ezreal,Ornn,316,149,167,47.15
Ezreal,KSante,383,171,212,44.65
Ezreal,Kassadin,119,57,62,47.9
Ezreal,Nilah,155,74,81,47.74
Ezreal,Akshan,170,75,95,44.12
Ezreal,Janna,166,90,76,54.22
Ezreal,Syndra,353,177,176,50.14
Ezreal,Anivia,206,95,111,46.12
Ezreal,Zeri,324,147,177,45.37
Ezreal,Tryndamere,187,102,85,54.55
Ezreal,Belveth,100,52,48,52
Ezreal,RekSai,117,42,75,35.9
Ezreal,Pyke,557,299,258,53.68
Ezreal,Senna,346,170,176,49.13
Ezreal,Taliyah,150,77,73,51.33
Ezreal,Singed,128,71,57,55.47
Ezreal,Naafiri,147,75,72,51.02
Ezreal,Skarner,277,120,157,43.32
Ezreal,KogMaw,189,84,105,44.44
Ezreal,Rengar,152,89,63,58.55
Ezreal,Kled,99,53,46,53.54
Ezreal,Lissandra,227,108,119,47.58
Ezreal,Bard,143,73,70,51.05
Ezreal,Corki,268,133,135,49.63
Ezreal,Annie,170,81,89,47.65
Lux,Ambessa,400,202,198,50.5
Lux,Volibear,595,252,343,42.35
Lux,Veigar,596,317,279,53.19
Lux,Vayne,620,297,323,47.9
Lux,Seraphine,501,234,267,46.71
Lux,Jax,456,245,211,53.73
Lux,Sejuani,379,156,223,41.16
Lux,Hwei,365,182,183,49.86
Lux,Ezreal,1226,634,592,51.71
Lux,Zac,293,128,165,43.69
Lux,Chogath,544,253,291,46.51
Lux,Lillia,260,147,113,56.54
Lux,Tryndamere,198,95,103,47.98
Lux,Caitlyn,1349,684,665,50.7
Lux,Karma,658,308,350,46.81
Lux,Malphite,581,314,267,54.04
Lux,Vi,575,276,299,48
Lux,Sivir,296,128,168,43.24
Lux,Senna,328,165,163,50.3
Lux,Riven,210,110,100,52.38
Lux,Poppy,349,168,181,48.14
Lux,Ziggs,259,137,122,52.9
Lux,Yuumi,438,230,208,52.51
Lux,Quinn,161,75,86,46.58
Lux,Leblanc,322,186,136,57.76
Lux,Twitch,366,180,186,49.18
Lux,Nautilus,748,331,417,44.25
Lux,Jayce,242,114,128,47.11
Lux,Hecarim,126,46,80,36.51
Lux,Milio,303,138,165,45.54
Lux,Zoe,232,104,128,44.83
Lux,Gnar,259,139,120,53.67
Lux,Viktor,469,212,257,45.2
Lux,MissFortune,1095,485,610,44.29
Lux,Rell,278,130,148,46.76
Lux,Nasus,337,142,195,42.14
Lux,Malzahar,567,224,343,39.51
Lux,TwistedFate,167,85,82,50.9
Lux,Mordekaiser,672,348,324,51.79
Lux,Zed,617,240,377,38.9
Lux,Varus,447,272,175,60.85
Lux,Pyke,462,216,246,46.75
Lux,MasterYi,491,241,250,49.08
Lux,Morgana,631,312,319,49.45
Lux,Yasuo,1030,480,550,46.6
Lux,Diana,802,369,433,46.01
Lux,Naafiri,139,62,77,44.6
Lux,Azir,226,109,117,48.23
Lux,MonkeyKing,340,165,175,48.53
Lux,Mel,946,418,528,44.19
Lux,Irelia,331,171,160,51.66
Lux,LeeSin,812,425,387,52.34
Lux,Katarina,346,168,178,48.55
Lux,Blitzcrank,517,240,277,46.42
Lux,Kayle,298,147,151,49.33
Lux,Viego,596,289,307,48.49
Lux,Jhin,944,435,509,46.08
Lux,Braum,319,154,165,48.28
Lux,TahmKench,530,221,309,41.7
Lux,Orianna,294,152,142,51.7
Lux,Camille,227,112,115,49.34
Lux,Graves,329,169,160,51.37
Lux,Nilah,185,84,101,45.41
Lux,Nami,547,280,267,51.19
Lux,Gangplank,328,145,183,44.21
Lux,Shaco,424,208,216,49.06
Lux,KSante,333,169,164,50.75
Lux,Yone,889,487,402,54.78
Lux,Zilean,149,66,83,44.3
Lux,Cassiopeia,119,64,55,53.78
Lux,Thresh,983,515,468,52.39
Lux,Lulu,804,402,402,50
Lux,Kindred,216,128,88,59.26
Lux,Jinx,1267,566,701,44.67
Lux,Trundle,313,159,154,50.8
Lux,Yorick,418,196,222,46.89
Lux,Nunu,313,155,158,49.52
Lux,Bard,217,86,131,39.63
Lux,Khazix,358,153,205,42.74
Lux,Smolder,386,175,211,45.34
Lux,Heimerdinger,238,132,106,55.46
Lux,Briar,293,146,147,49.83
Lux,Leona,502,268,234,53.39
Lux,Gragas,426,245,181,57.51
Lux,Qiyana,110,56,54,50.91
Lux,Kalista,137,80,57,58.39
Lux,Neeko,208,100,108,48.08
Lux,Darius,886,437,449,49.32
Lux,Warwick,599,245,354,40.9
Lux,Akali,546,230,316,42.12
Lux,Kaisa,810,400,410,49.38
Lux,Vladimir,310,138,172,44.52
Lux,Ekko,399,192,207,48.12
Lux,Soraka,315,154,161,48.89
Lux,Evelynn,161,89,72,55.28
Lux,Gwen,239,108,131,45.19
Lux,Renekton,241,118,123,48.96
Lux,JarvanIV,437,204,233,46.68
Lux,Janna,116,74,42,63.79
Lux,Akshan,154,90,64,58.44
Lux,Zeri,218,96,122,44.04
Lux,Rakan,265,127,138,47.92
Lux,Teemo,449,202,247,44.99
Lux,Alistar,226,119,107,52.65
Lux,Nocturne,595,277,318,46.55
Lux,Ashe,1024,488,536,47.66
Lux,Pantheon,865,387,478,44.74
Lux,Xerath,489,218,271,44.58
Lux,Fizz,256,131,125,51.17
Lux,Garen,738,345,393,46.75
Lux,Rammus,151,80,71,52.98
Lux,Kled,74,50,24,67.57
Lux,Kayn,638,300,338,47.02
Lux,Maokai,251,161,90,64.14
Lux,Ryze,183,97,86,53.01
Lux,Tristana,459,244,215,53.16
Lux,Aatrox,565,265,300,46.9
Lux,Singed,123,59,64,47.97
Lux,Urgot,217,109,108,50.23
Lux,Lissandra,190,92,98,48.42
Lux,Brand,370,204,166,55.14
Lux,Velkoz,338,144,194,42.6
Lux,Elise,361,137,224,37.95
Lux,Rumble,126,69,57,54.76
Lux,Draven,223,109,114,48.88
Lux,Taric,113,54,59,47.79
Lux,Aurora,415,225,190,54.22
Lux,DrMundo,286,113,173,39.51
Lux,KogMaw,157,75,82,47.77
Lux,Ahri,792,411,381,51.89
Lux,Nidalee,194,109,85,56.19
Lux,Amumu,591,247,344,41.79
Lux,AurelionSol,229,107,122,46.72
Lux,Swain,468,212,256,45.3
Lux,Fiora,192,86,106,44.79
Lux,Rengar,172,96,76,55.81
Lux,Syndra,410,219,191,53.41
Lux,Sylas,721,306,415,42.44
Lux,Talon,251,132,119,52.59
Lux,Zyra,491,272,219,55.4
Lux,Samira,383,210,173,54.83
Lux,Vex,352,145,207,41.19
Lux,Kassadin,52,22,30,42.31
Lux,Lucian,433,238,195,54.97
Lux,Sett,655,282,373,43.05
Lux,Skarner,217,114,103,52.53
Lux,Corki,247,128,119,51.82
Lux,Shyvana,148,77,71,52.03
Lux,Ornn,354,167,187,47.18
Lux,Shen,352,168,184,47.73
Lux,Illaoi,265,119,146,44.91
Lux,XinZhao,342,156,186,45.61
Lux,FiddleSticks,207,90,117,43.48
Lux,Taliyah,133,82,51,61.65
Lux,Anivia,178,99,79,55.62
Lux,Aphelios,291,119,172,40.89
Lux,Belveth,110,59,51,53.64
Lux,Sion,461,222,239,48.16
Lux,Xayah,260,122,138,46.92
Lux,Karthus,103,53,50,51.46
Lux,Annie,166,86,80,51.81
Lux,Kennen,138,82,56,59.42
Lux,Renata,102,49,53,48.04
Lux,Galio,601,318,283,52.91
Lux,Sona,102,43,59,42.16
Lux,Olaf,153,68,85,44.44
Lux,Udyr,132,79,53,59.85
Lux,Ivern,73,39,34,53.42
Lux,RekSai,59,23,36,38.98
Mordekaiser,Ahri,443,231,212,52.14
Mordekaiser,Kayn,333,178,155,53.45
Mordekaiser,Mel,587,322,265,54.86
Mordekaiser,Caitlyn,695,374,321,53.81
Mordekaiser,Pyke,249,135,114,54.22
Mordekaiser,Darius,505,239,266,47.33
Mordekaiser,JarvanIV,211,114,97,54.03
Mordekaiser,Xerath,254,112,142,44.09
Mordekaiser,Yuumi,273,136,137,49.82
Mordekaiser,Jax,222,112,110,50.45
Mordekaiser,Udyr,75,39,36,52
Mordekaiser,Yone,501,229,272,45.71
Mordekaiser,Smolder,196,106,90,54.08
Mordekaiser,TahmKench,295,168,127,56.95
Mordekaiser,Nasus,210,93,117,44.29
Mordekaiser,FiddleSticks,148,94,54,63.51
Mordekaiser,Syndra,175,102,73,58.29
Mordekaiser,Seraphine,225,108,117,48
Mordekaiser,Volibear,398,190,208,47.74
Mordekaiser,Vi,334,164,170,49.1
Mordekaiser,Gragas,205,103,102,50.24
Mordekaiser,Lux,672,324,348,48.21
Mordekaiser,Diana,454,248,206,54.63
Mordekaiser,Yasuo,572,330,242,57.69
Mordekaiser,Nami,302,166,136,54.97
Mordekaiser,Trundle,151,66,85,43.71
Mordekaiser,Veigar,322,144,178,44.72
Mordekaiser,Ashe,566,306,260,54.06
Mordekaiser,Braum,220,123,97,55.91
Mordekaiser,Gangplank,125,64,61,51.2
Mordekaiser,Teemo,294,163,131,55.44
Mordekaiser,Nilah,109,60,49,55.05
Mordekaiser,Garen,521,263,258,50.48
Mordekaiser,Ezreal,685,343,342,50.07
Mordekaiser,Brand,172,96,76,55.81
Mordekaiser,Cassiopeia,91,37,54,40.66
Mordekaiser,Jinx,685,300,385,43.8
Mordekaiser,Morgana,311,139,172,44.69
Mordekaiser,Quinn,79,43,36,54.43
Mordekaiser,LeeSin,498,259,239,52.01
Mordekaiser,Akali,256,146,110,57.03
Mordekaiser,Milio,173,101,72,58.38
Mordekaiser,Chogath,392,196,196,50
Mordekaiser,Sivir,171,102,69,59.65
Mordekaiser,Tristana,239,122,117,51.05
Mordekaiser,Alistar,185,99,86,53.51
Mordekaiser,Gwen,169,71,98,42.01
Mordekaiser,Rammus,87,52,35,59.77
Mordekaiser,Zed,269,127,142,47.21
Mordekaiser,Sett,468,209,259,44.66
Mordekaiser,Warwick,511,260,251,50.88
Mordekaiser,Karma,323,166,157,51.39
Mordekaiser,Kayle,140,62,78,44.29
Mordekaiser,Irelia,220,106,114,48.18
Mordekaiser,MissFortune,660,311,349,47.12
Mordekaiser,Lulu,409,188,221,45.97
Mordekaiser,Aatrox,333,187,146,56.16
Mordekaiser,Sejuani,188,85,103,45.21
Mordekaiser,Malzahar,298,164,134,55.03
Mordekaiser,Blitzcrank,263,134,129,50.95
Mordekaiser,Graves,165,67,98,40.61
Mordekaiser,Ziggs,115,34,81,29.57
Mordekaiser,Hwei,203,88,115,43.35
Mordekaiser,Zoe,130,59,71,45.38
Mordekaiser,Katarina,179,90,89,50.28
Mordekaiser,Rumble,73,43,30,58.9
Mordekaiser,Pantheon,460,250,210,54.35
Mordekaiser,Nunu,187,87,100,46.52
Mordekaiser,Thresh,496,248,248,50
Mordekaiser,Fizz,131,83,48,63.36
Mordekaiser,Soraka,135,74,61,54.81
Mordekaiser,Gnar,147,82,65,55.78
Mordekaiser,Aurora,219,83,136,37.9
Mordekaiser,Illaoi,198,113,85,57.07
Mordekaiser,MasterYi,276,127,149,46.01
Mordekaiser,Lucian,271,145,126,53.51
Mordekaiser,Jayce,113,52,61,46.02
Mordekaiser,Viego,363,199,164,54.82
Mordekaiser,Galio,373,190,183,50.94
Mordekaiser,Draven,141,72,69,51.06
Mordekaiser,Urgot,142,71,71,50
Mordekaiser,Amumu,367,170,197,46.32
Mordekaiser,Nocturne,359,162,197,45.13
Mordekaiser,Lissandra,98,49,49,50
Mordekaiser,Kennen,93,52,41,55.91
Mordekaiser,Varus,303,158,145,52.15
Mordekaiser,Xayah,164,67,97,40.85
Mordekaiser,Fiora,145,74,71,51.03
Mordekaiser,Rengar,87,54,33,62.07
Mordekaiser,Shyvana,72,40,32,55.56
Mordekaiser,Shaco,216,123,93,56.94
Mordekaiser,Swain,275,129,146,46.91
Mordekaiser,Heimerdinger,135,54,81,40
Mordekaiser,Yorick,240,108,132,45
Mordekaiser,Velkoz,141,72,69,51.06
Mordekaiser,Vladimir,158,86,72,54.43
Mordekaiser,Ryze,97,45,52,46.39
Mordekaiser,Khazix,150,73,77,48.67
Mordekaiser,Jhin,526,263,263,50
Mordekaiser,Ambessa,174,100,74,57.47
Mordekaiser,Senna,210,121,89,57.62
Mordekaiser,Leblanc,209,116,93,55.5
Mordekaiser,Corki,142,109,33,76.76
Mordekaiser,Sona,66,39,27,59.09
Mordekaiser,Zyra,233,116,117,49.79
Mordekaiser,DrMundo,161,62,99,38.51
Mordekaiser,Olaf,150,67,83,44.67
Mordekaiser,Rakan,158,76,82,48.1
Mordekaiser,Taliyah,71,32,39,45.07
Mordekaiser,Samira,214,92,122,42.99
Mordekaiser,Azir,140,89,51,63.57
Mordekaiser,Shen,222,108,114,48.65
Mordekaiser,Briar,211,104,107,49.29
Mordekaiser,RekSai,48,18,30,37.5
Mordekaiser,Viktor,248,121,127,48.79
Mordekaiser,Belveth,52,24,28,46.15
Mordekaiser,Malphite,374,219,155,58.56
Mordekaiser,Kindred,131,58,73,44.27
Mordekaiser,MonkeyKing,202,76,126,37.62
Mordekaiser,Ekko,178,73,105,41.01
Mordekaiser,Riven,126,55,71,43.65
Mordekaiser,Sylas,407,198,209,48.65
Mordekaiser,Kaisa,443,229,214,51.69
Mordekaiser,Poppy,190,94,96,49.47
Mordekaiser,Naafiri,103,50,53,48.54
Mordekaiser,Vex,151,66,85,43.71
Mordekaiser,Tryndamere,147,69,78,46.94
Mordekaiser,Lillia,129,60,69,46.51
Mordekaiser,KogMaw,101,50,51,49.5
Mordekaiser,Sion,254,151,103,59.45
Mordekaiser,Nautilus,411,227,184,55.23
Mordekaiser,Zeri,140,75,65,53.57
Mordekaiser,Qiyana,48,34,14,70.83
Mordekaiser,Zac,192,111,81,57.81
Mordekaiser,Kassadin,63,36,27,57.14
Mordekaiser,Hecarim,88,41,47,46.59
Mordekaiser,Janna,94,39,55,41.49
Mordekaiser,Ornn,226,98,128,43.36
Mordekaiser,Singed,62,18,44,29.03
Mordekaiser,Anivia,109,55,54,50.46
Mordekaiser,Leona,253,118,135,46.64
Mordekaiser,Orianna,163,76,87,46.63
Mordekaiser,Vayne,439,196,243,44.65
Mordekaiser,Talon,115,62,53,53.91
Mordekaiser,Akshan,96,41,55,42.71
Mordekaiser,Twitch,160,84,76,52.5
Mordekaiser,Neeko,146,63,83,43.15
Mordekaiser,Skarner,161,74,87,45.96
Mordekaiser,Aphelios,125,72,53,57.6
Mordekaiser,Nidalee,99,45,54,45.45
Mordekaiser,Kalista,123,51,72,41.46
Mordekaiser,KSante,311,156,155,50.16
Mordekaiser,Renata,68,36,32,52.94
Mordekaiser,XinZhao,237,114,123,48.1
Mordekaiser,Elise,228,101,127,44.3
Mordekaiser,Rell,220,90,130,40.91
Mordekaiser,Maokai,152,89,63,58.55
Mordekaiser,Annie,80,49,31,61.25
Mordekaiser,Ivern,65,39,26,60
Mordekaiser,Kled,71,31,40,43.66
Mordekaiser,Bard,82,36,46,43.9
Mordekaiser,TwistedFate,87,54,33,62.07
Mordekaiser,Karthus,83,41,42,49.4
Mordekaiser,Evelynn,90,64,26,71.11
Mordekaiser,Renekton,123,56,67,45.53
Mordekaiser,AurelionSol,148,70,78,47.3
Mordekaiser,Camille,105,59,46,56.19
Mordekaiser,Zilean,68,39,29,57.35
Mordekaiser,Taric,44,16,28,36.36
Evelynn,Ahri,118,69,49,58.47
Evelynn,Kayn,92,41,51,44.57
Evelynn,Mel,176,100,76,56.82
Evelynn,Caitlyn,196,107,89,54.59
Evelynn,Pyke,45,28,17,62.22
Evelynn,Pantheon,112,50,62,44.64
Evelynn,Ekko,62,32,30,51.61
Evelynn,Talon,29,14,15,48.28
Evelynn,Kaisa,139,58,81,41.73
Evelynn,Soraka,32,12,20,37.5
Evelynn,KSante,54,25,29,46.3
Evelynn,Viego,108,51,57,47.22
Evelynn,Kassadin,18,9,9,50
Evelynn,Nasus,49,21,28,42.86
Evelynn,Bard,31,12,19,38.71
Evelynn,Singed,22,12,10,54.55
Evelynn,Darius,147,66,81,44.9
Evelynn,Smolder,57,26,31,45.61
Evelynn,XinZhao,47,19,28,40.43
Evelynn,Malzahar,79,35,44,44.3
Evelynn,Vayne,81,48,33,59.26
Evelynn,Rell,49,27,22,55.1
Evelynn,Gwen,33,13,20,39.39
Evelynn,Vladimir,38,24,14,63.16
Evelynn,Ezreal,140,73,67,52.14
Evelynn,Lux,161,72,89,44.72
Evelynn,Chogath,94,54,40,57.45
Evelynn,Khazix,57,42,15,73.68
Evelynn,Swain,79,33,46,41.77
Evelynn,Jhin,135,87,48,64.44
Evelynn,Karma,102,46,56,45.1
Evelynn,Diana,143,66,77,46.15
Evelynn,Velkoz,30,19,11,63.33
Evelynn,Ashe,124,50,74,40.32
Evelynn,MissFortune,113,58,55,51.33
Evelynn,Garen,90,45,45,50
Evelynn,Leblanc,33,19,14,57.58
Evelynn,Corki,31,26,5,83.87
Evelynn,Blitzcrank,75,51,24,68
Evelynn,Sett,107,58,49,54.21
Evelynn,LeeSin,108,47,61,43.52
Evelynn,Galio,87,49,38,56.32
Evelynn,Tristana,71,37,34,52.11
Evelynn,Brand,44,31,13,70.45
Evelynn,Aatrox,64,42,22,65.63
Evelynn,Sylas,84,35,49,41.67
Evelynn,Irelia,51,30,21,58.82
Evelynn,Zilean,28,19,9,67.86
Evelynn,Zac,31,14,17,45.16
Evelynn,Veigar,55,22,33,40
Evelynn,Gragas,65,37,28,56.92
Evelynn,Thresh,105,51,54,48.57
Evelynn,Jax,57,32,25,56.14
Evelynn,Nocturne,87,46,41,52.87
Evelynn,Zeri,39,21,18,53.85
Evelynn,Alistar,53,40,13,75.47
Evelynn,Yasuo,166,73,93,43.98
Evelynn,Poppy,44,25,19,56.82
Evelynn,Zed,55,30,25,54.55
Evelynn,Nautilus,86,43,43,50
Evelynn,MonkeyKing,34,14,20,41.18
Evelynn,Hwei,39,20,19,51.28
Evelynn,Trundle,24,10,14,41.67
Evelynn,Sejuani,59,33,26,55.93
Evelynn,Anivia,27,15,12,55.56
Evelynn,Braum,49,18,31,36.73
Evelynn,Cassiopeia,22,17,5,77.27
Evelynn,Warwick,58,24,34,41.38
Evelynn,Taliyah,15,9,6,60
Evelynn,Nami,99,40,59,40.4
Evelynn,Orianna,35,28,7,80
Evelynn,Neeko,33,19,14,57.58
Evelynn,Shyvana,9,0,9,0
Evelynn,Katarina,29,11,18,37.93
Evelynn,Draven,36,22,14,61.11
Evelynn,Malphite,68,45,23,66.18
Evelynn,Jinx,132,66,66,50
Evelynn,Milio,42,24,18,57.14
Evelynn,Akali,64,32,32,50
Evelynn,Vex,46,24,22,52.17
Evelynn,Morgana,66,33,33,50
Evelynn,Yorick,40,22,18,55
Evelynn,Nunu,74,32,42,43.24
Evelynn,AurelionSol,28,7,21,25
Evelynn,Gangplank,41,16,25,39.02
Evelynn,Fizz,44,23,21,52.27
Evelynn,Seraphine,48,26,22,54.17
Evelynn,DrMundo,36,19,17,52.78
Evelynn,Volibear,77,44,33,57.14
Evelynn,Ivern,18,9,9,50
Evelynn,Azir,36,19,17,52.78
Evelynn,FiddleSticks,31,14,17,45.16
Evelynn,Lucian,47,16,31,34.04
Evelynn,Riven,24,11,13,45.83
Evelynn,Aphelios,29,22,7,75.86
Evelynn,Renekton,20,11,9,55
Evelynn,Senna,48,17,31,35.42
Evelynn,Rammus,10,8,2,80
Evelynn,Kayle,14,11,3,78.57
Evelynn,Vi,60,19,41,31.67
Evelynn,Sion,62,28,34,45.16
Evelynn,Graves,35,24,11,68.57
Evelynn,Nilah,20,11,9,55
Evelynn,MasterYi,66,34,32,51.52
Evelynn,Fiora,38,28,10,73.68
Evelynn,Amumu,79,36,43,45.57
Evelynn,Viktor,56,31,25,55.36
Evelynn,Shen,59,30,29,50.85
Evelynn,Xayah,43,20,23,46.51
Evelynn,Rakan,27,15,12,55.56
Evelynn,Karthus,19,8,11,42.11
Evelynn,Varus,89,36,53,40.45
Evelynn,Udyr,38,25,13,65.79
Evelynn,Sona,6,0,6,0
Evelynn,Urgot,56,32,24,57.14
Evelynn,Aurora,59,35,24,59.32
Evelynn,Heimerdinger,25,11,14,44
Evelynn,Twitch,54,24,30,44.44
Evelynn,Lulu,97,43,54,44.33
Evelynn,Akshan,16,5,11,31.25
Evelynn,Shaco,57,26,31,45.61
Evelynn,Ambessa,35,12,23,34.29
Evelynn,Briar,58,29,29,50
Evelynn,Syndra,53,28,25,52.83
Evelynn,Xerath,58,23,35,39.66
Evelynn,Mordekaiser,90,26,64,28.89
Evelynn,Gnar,27,13,14,48.15
Evelynn,Teemo,53,11,42,20.75
Evelynn,Rumble,19,11,8,57.89
Evelynn,Hecarim,27,19,8,70.37
Evelynn,Elise,60,43,17,71.67
Evelynn,Sivir,43,29,14,67.44
Evelynn,Camille,17,10,7,58.82
Evelynn,Yone,93,53,40,56.99
Evelynn,TahmKench,56,32,24,57.14
Evelynn,Yuumi,48,25,23,52.08
Evelynn,Lissandra,41,13,28,31.71
Evelynn,Zoe,26,11,15,42.31
Evelynn,Samira,35,26,9,74.29
Evelynn,Renata,25,11,14,44
Evelynn,Kindred,20,6,14,30
Evelynn,Leona,46,20,26,43.48
Evelynn,Janna,24,9,15,37.5
Evelynn,Kennen,27,11,16,40.74
Evelynn,Zyra,50,25,25,50
Evelynn,Maokai,37,21,16,56.76
Evelynn,RekSai,18,6,12,33.33
Evelynn,Ziggs,19,3,16,15.79
Evelynn,Rengar,21,13,8,61.9
Evelynn,Olaf,7,5,2,71.43
Evelynn,Kalista,15,11,4,73.33
Evelynn,Ornn,45,23,22,51.11
Evelynn,Annie,16,7,9,43.75
Evelynn,Qiyana,9,4,5,44.44
Evelynn,JarvanIV,43,21,22,48.84
Evelynn,TwistedFate,23,12,11,52.17
Evelynn,Naafiri,13,4,9,30.77
Evelynn,Taric,9,4,5,44.44
Evelynn,Ryze,14,8,6,57.14
Evelynn,Quinn,24,17,7,70.83
Evelynn,Jayce,15,8,7,53.33
Evelynn,Tryndamere,40,14,26,35
Evelynn,Lillia,41,30,11,73.17
Evelynn,KogMaw,17,13,4,76.47
Evelynn,Illaoi,25,19,6,76
Evelynn,Skarner,17,10,7,58.82
Evelynn,Nidalee,16,8,8,50
Evelynn,Belveth,9,9,0,100
Evelynn,Kled,6,0,6,0
Riven,Ahri,153,64,89,41.83
Riven,Kayn,101,62,39,61.39
Riven,Mel,268,156,112,58.21
Riven,Caitlyn,263,137,126,52.09
Riven,Pyke,56,21,35,37.5
Riven,Garen,175,73,102,41.71
Riven,Warwick,111,66,45,59.46
Riven,Yasuo,179,93,86,51.96
Riven,MissFortune,174,73,101,41.95
Riven,Lux,210,100,110,47.62
Riven,Gangplank,68,31,37,45.59
Riven,LeeSin,169,97,72,57.4
Riven,Aurora,77,47,30,61.04
Riven,Ashe,204,114,90,55.88
Riven,Morgana,112,58,54,51.79
Riven,Darius,223,109,114,48.88
Riven,Vi,128,55,73,42.97
Riven,Malzahar,115,75,40,65.22
Riven,Aphelios,48,23,25,47.92
Riven,Soraka,63,35,28,55.56
Riven,Diana,149,55,94,36.91
Riven,Naafiri,29,18,11,62.07
Riven,Azir,42,19,23,45.24
Riven,Shaco,62,27,35,43.55
Riven,Veigar,103,54,49,52.43
Riven,Yuumi,91,46,45,50.55
Riven,Teemo,52,25,27,48.08
Riven,Rammus,49,19,30,38.78
Riven,Leblanc,44,22,22,50
Riven,Karma,171,96,75,56.14
Riven,Illaoi,44,20,24,45.45
Riven,Nunu,56,13,43,23.21
Riven,Rell,78,36,42,46.15
Riven,Renekton,65,30,35,46.15
Riven,Elise,91,37,54,40.66
Riven,Ezreal,228,100,128,43.86
Riven,Malphite,93,46,47,49.46
Riven,Sejuani,75,43,32,57.33
Riven,Ekko,79,34,45,43.04
Riven,Graves,86,42,44,48.84
Riven,Xerath,60,43,17,71.67
Riven,Draven,53,30,23,56.6
Riven,Thresh,171,80,91,46.78
Riven,Skarner,53,26,27,49.06
Riven,Hwei,62,44,18,70.97
Riven,KogMaw,25,17,8,68
Riven,Nautilus,136,63,73,46.32
Riven,Maokai,42,25,17,59.52
Riven,Zeri,46,19,27,41.3
Riven,Vayne,141,65,76,46.1
Riven,Sylas,152,76,76,50
Riven,Braum,79,34,45,43.04
Riven,Fiora,56,37,19,66.07
Riven,Samira,58,33,25,56.9
Riven,Gragas,65,35,30,53.85
Riven,Tryndamere,23,10,13,43.48
Riven,Urgot,66,37,29,56.06
Riven,Syndra,67,29,38,43.28
Riven,Milio,73,41,32,56.16
Riven,Pantheon,136,78,58,57.35
Riven,Trundle,36,10,26,27.78
Riven,Kaisa,171,93,78,54.39
Riven,Nidalee,29,18,11,62.07
Riven,Blitzcrank,95,53,42,55.79
Riven,MasterYi,88,55,33,62.5
Riven,Zed,113,61,52,53.98
Riven,Rakan,54,24,30,44.44
Riven,Kled,14,3,11,21.43
Riven,Briar,72,41,31,56.94
Riven,Velkoz,37,17,20,45.95
Riven,Ornn,52,33,19,63.46
Riven,Akali,94,46,48,48.94
Riven,Aatrox,75,34,41,45.33
Riven,Yone,128,80,48,62.5
Riven,Lulu,118,64,54,54.24
Riven,Lucian,108,56,52,51.85
Riven,Kassadin,28,14,14,50
Riven,Neeko,40,18,22,45
Riven,Senna,47,20,27,42.55
Riven,Zac,53,34,19,64.15
Riven,Akshan,30,19,11,63.33
Riven,DrMundo,24,19,5,79.17
Riven,Jhin,156,96,60,61.54
Riven,Sion,73,43,30,58.9
Riven,Varus,102,43,59,42.16
Riven,JarvanIV,91,56,35,61.54
Riven,Fizz,58,31,27,53.45
Riven,Seraphine,108,51,57,47.22
Riven,Mordekaiser,126,71,55,56.35
Riven,Talon,43,26,17,60.47
Riven,Jax,90,49,41,54.44
Riven,Khazix,54,32,22,59.26
Riven,TahmKench,89,32,57,35.96
Riven,MonkeyKing,97,47,50,48.45
Riven,Yorick,69,34,35,49.28
Riven,Kayle,43,22,21,51.16
Riven,Shen,76,38,38,50
Riven,Volibear,69,30,39,43.48
Riven,Zilean,22,13,9,59.09
Riven,KSante,66,32,34,48.48
Riven,Smolder,44,16,28,36.36
Riven,Lissandra,61,33,28,54.1
Riven,Karthus,29,8,21,27.59
Riven,Alistar,37,17,20,45.95
Riven,Amumu,106,37,69,34.91
Riven,Poppy,80,44,36,55
Riven,Ryze,35,17,18,48.57
Riven,Vex,39,17,22,43.59
Riven,Lillia,45,25,20,55.56
Riven,Jinx,252,126,126,50
Riven,AurelionSol,26,12,14,46.15
Riven,Nocturne,146,75,71,51.37
Riven,Katarina,70,37,33,52.86
Riven,Chogath,121,50,71,41.32
Riven,Evelynn,24,13,11,54.17
Riven,Ziggs,38,26,12,68.42
Riven,Ambessa,113,52,61,46.02
Riven,Galio,131,58,73,44.27
Riven,Xayah,45,25,20,55.56
Riven,Renata,34,20,14,58.82
Riven,Singed,26,11,15,42.31
Riven,Zoe,32,11,21,34.38
Riven,Tristana,87,37,50,42.53
Riven,Viktor,94,47,47,50
Riven,Sona,24,11,13,45.83
Riven,Gnar,49,26,23,53.06
Riven,Annie,19,11,8,57.89
Riven,Janna,30,14,16,46.67
Riven,Kindred,34,18,16,52.94
Riven,Nasus,68,33,35,48.53
Riven,Irelia,51,30,21,58.82
Riven,Nami,102,59,43,57.84
Riven,Rengar,25,9,16,36
Riven,Qiyana,19,11,8,57.89
Riven,Cassiopeia,15,9,6,60
Riven,Hecarim,28,12,16,42.86
Riven,TwistedFate,23,15,8,65.22
Riven,Zyra,65,31,34,47.69
Riven,Twitch,78,43,35,55.13
Riven,Kalista,17,11,6,64.71
Riven,Brand,48,38,10,79.17
Riven,Orianna,38,22,16,57.89
Riven,Camille,39,24,15,61.54
Riven,Leona,77,38,39,49.35
Riven,Sett,135,68,67,50.37
Riven,Sivir,51,22,29,43.14
Riven,Rumble,14,9,5,64.29
Riven,Kennen,15,9,6,60
Riven,Jayce,33,11,22,33.33
Riven,FiddleSticks,57,20,37,35.09
Riven,Anivia,20,9,11,45
Riven,Swain,59,28,31,47.46
Riven,Viego,99,51,48,51.52
Riven,XinZhao,74,30,44,40.54
Riven,Belveth,13,6,7,46.15
Riven,Heimerdinger,19,7,12,36.84
Riven,Corki,44,19,25,43.18
Riven,Taric,26,3,23,11.54
Riven,Vladimir,60,36,24,60
Riven,Gwen,63,31,32,49.21
Riven,Udyr,22,12,10,54.55
Riven,Olaf,22,10,12,45.45
Riven,Quinn,16,4,12,25
Riven,Bard,32,16,16,50
Riven,Shyvana,11,7,4,63.64
Riven,Taliyah,12,7,5,58.33
Riven,Ivern,25,12,13,48
Riven,RekSai,14,3,11,21.43
Riven,Nilah,24,10,14,41.67
MissFortune,Ahri,625,258,367,41.28
MissFortune,Kayn,548,295,253,53.83
MissFortune,Mel,897,450,447,50.17
MissFortune,Caitlyn,1294,635,659,49.07
MissFortune,Pyke,340,195,145,57.35
MissFortune,Gangplank,287,135,152,47.04
MissFortune,Volibear,424,195,229,45.99
MissFortune,Irelia,293,152,141,51.88
MissFortune,Kaisa,725,351,374,48.41
MissFortune,Nautilus,568,298,270,52.46
MissFortune,Sett,734,352,382,47.96
MissFortune,Katarina,295,167,128,56.61
MissFortune,Jinx,1408,641,767,45.53
MissFortune,Renata,136,74,62,54.41
MissFortune,Riven,174,101,73,58.05
MissFortune,Poppy,297,165,132,55.56
MissFortune,Veigar,430,216,214,50.23
MissFortune,Ziggs,169,84,85,49.7
MissFortune,Yuumi,359,174,185,48.47
MissFortune,Sion,397,193,204,48.61
MissFortune,RekSai,65,27,38,41.54
MissFortune,Viktor,389,209,180,53.73
MissFortune,KogMaw,124,76,48,61.29
MissFortune,Ashe,992,531,461,53.53
MissFortune,Kennen,121,58,63,47.93
MissFortune,Vi,482,268,214,55.6
MissFortune,Lux,1095,610,485,55.71
MissFortune,Leona,444,211,233,47.52
MissFortune,DrMundo,286,160,126,55.94
MissFortune,Sejuani,285,107,178,37.54
MissFortune,Nami,518,223,295,43.05
MissFortune,Gragas,285,142,143,49.82
MissFortune,Elise,357,201,156,56.3
MissFortune,Vayne,596,292,304,48.99
MissFortune,Zyra,348,181,167,52.01
MissFortune,Akali,459,245,214,53.38
MissFortune,Belveth,64,32,32,50
MissFortune,Varus,430,210,220,48.84
MissFortune,Jhin,870,456,414,52.41
MissFortune,Lulu,664,340,324,51.2
MissFortune,LeeSin,779,423,356,54.3
MissFortune,Hwei,291,147,144,50.52
MissFortune,Zilean,112,59,53,52.68
MissFortune,Amumu,526,264,262,50.19
MissFortune,Teemo,479,252,227,52.61
MissFortune,Khazix,222,116,106,52.25
MissFortune,Zoe,210,114,96,54.29
MissFortune,Darius,857,401,456,46.79
MissFortune,Kindred,207,110,97,53.14
MissFortune,Tristana,484,237,247,48.97
MissFortune,Neeko,238,121,117,50.84
MissFortune,Fizz,237,130,107,54.85
MissFortune,Udyr,154,86,68,55.84
MissFortune,Vex,289,154,135,53.29
MissFortune,Sona,67,35,32,52.24
MissFortune,Naafiri,168,75,93,44.64
MissFortune,Warwick,615,280,335,45.53
MissFortune,Janna,91,45,46,49.45
MissFortune,Malzahar,506,252,254,49.8
MissFortune,Garen,656,320,336,48.78
MissFortune,Lucian,390,201,189,51.54
MissFortune,Camille,195,98,97,50.26
MissFortune,Zed,429,222,207,51.75
MissFortune,Briar,259,145,114,55.98
MissFortune,Trundle,260,110,150,42.31
MissFortune,Aurora,356,196,160,55.06
MissFortune,Pantheon,689,351,338,50.94
MissFortune,Mordekaiser,660,349,311,52.88
MissFortune,Ekko,438,214,224,48.86
MissFortune,Samira,373,205,168,54.96
MissFortune,Shen,372,206,166,55.38
MissFortune,Viego,528,248,280,46.97
MissFortune,Yasuo,819,416,403,50.79
MissFortune,Shaco,347,164,183,47.26
MissFortune,Thresh,776,393,383,50.64
MissFortune,Singed,120,51,69,42.5
MissFortune,Yorick,381,179,202,46.98
MissFortune,Leblanc,257,160,97,62.26
MissFortune,Nocturne,530,294,236,55.47
MissFortune,Soraka,178,90,88,50.56
MissFortune,Malphite,494,245,249,49.6
MissFortune,FiddleSticks,220,94,126,42.73
MissFortune,Galio,541,221,320,40.85
MissFortune,Ezreal,1255,674,581,53.71
MissFortune,Chogath,597,297,300,49.75
MissFortune,Swain,448,194,254,43.3
MissFortune,Karma,604,345,259,57.12
MissFortune,Nasus,270,119,151,44.07
MissFortune,Xayah,268,145,123,54.1
MissFortune,Maokai,202,69,133,34.16
MissFortune,Heimerdinger,215,98,117,45.58
MissFortune,Akshan,129,57,72,44.19
MissFortune,Evelynn,113,55,58,48.67
MissFortune,Brand,276,153,123,55.43
MissFortune,Aatrox,444,217,227,48.87
MissFortune,Diana,736,372,364,50.54
MissFortune,TahmKench,397,210,187,52.9
MissFortune,Nidalee,123,64,59,52.03
MissFortune,Yone,822,432,390,52.55
MissFortune,Twitch,293,154,139,52.56
MissFortune,Rell,269,124,145,46.1
MissFortune,Quinn,102,34,68,33.33
MissFortune,Aphelios,205,88,117,42.93
MissFortune,Sylas,643,314,329,48.83
MissFortune,Braum,442,224,218,50.68
MissFortune,Morgana,476,225,251,47.27
MissFortune,Xerath,391,204,187,52.17
MissFortune,Smolder,310,155,155,50
MissFortune,Blitzcrank,432,232,200,53.7
MissFortune,Urgot,234,122,112,52.14
MissFortune,Karthus,106,52,54,49.06
MissFortune,Illaoi,239,129,110,53.97
MissFortune,MasterYi,480,264,216,55
MissFortune,Gwen,200,112,88,56
MissFortune,Kayle,236,105,131,44.49
MissFortune,Nunu,295,164,131,55.59
MissFortune,Lissandra,184,94,90,51.09
MissFortune,Orianna,286,142,144,49.65
MissFortune,Talon,228,132,96,57.89
MissFortune,Nilah,167,88,79,52.69
MissFortune,Sivir,271,134,137,49.45
MissFortune,Olaf,135,63,72,46.67
MissFortune,Vladimir,216,134,82,62.04
MissFortune,Ambessa,330,150,180,45.45
MissFortune,MonkeyKing,335,184,151,54.93
MissFortune,Rammus,138,81,57,58.7
MissFortune,Draven,250,131,119,52.4
MissFortune,JarvanIV,389,178,211,45.76
MissFortune,Rengar,149,77,72,51.68
MissFortune,Milio,290,129,161,44.48
MissFortune,Annie,126,67,59,53.17
MissFortune,Syndra,274,135,139,49.27
MissFortune,Velkoz,264,117,147,44.32
MissFortune,Seraphine,417,196,221,47
MissFortune,Jax,316,142,174,44.94
MissFortune,Kled,72,36,36,50
MissFortune,Corki,250,128,122,51.2
MissFortune,Ornn,269,151,118,56.13
MissFortune,Senna,257,128,129,49.81
MissFortune,Renekton,250,135,115,54
MissFortune,Graves,316,155,161,49.05
MissFortune,Lillia,265,119,146,44.91
MissFortune,AurelionSol,192,114,78,59.38
MissFortune,Cassiopeia,113,62,51,54.87
MissFortune,Fiora,145,60,85,41.38
MissFortune,Taliyah,89,47,42,52.81
MissFortune,Hecarim,189,91,98,48.15
MissFortune,Gnar,234,136,98,58.12
MissFortune,Zac,233,125,108,53.65
MissFortune,Tryndamere,191,82,109,42.93
MissFortune,Rakan,203,99,104,48.77
MissFortune,TwistedFate,165,78,87,47.27
MissFortune,Alistar,224,117,107,52.23
MissFortune,Ryze,147,73,74,49.66
MissFortune,Kalista,177,78,99,44.07
MissFortune,Taric,113,43,70,38.05
MissFortune,Azir,190,105,85,55.26
MissFortune,XinZhao,375,182,193,48.53
MissFortune,Ivern,87,58,29,66.67
MissFortune,Jayce,195,93,102,47.69
MissFortune,Rumble,141,66,75,46.81
MissFortune,Skarner,174,90,84,51.72
MissFortune,Kassadin,94,54,40,57.45
MissFortune,KSante,282,142,140,50.35
MissFortune,Bard,123,72,51,58.54
MissFortune,Qiyana,87,57,30,65.52
MissFortune,Zeri,167,96,71,57.49
MissFortune,Shyvana,89,37,52,41.57
MissFortune,Anivia,161,81,80,50.31
Swain,Ahri,298,158,140,53.02
Swain,Kayn,271,143,128,52.77
Swain,Mel,479,229,250,47.81
Swain,Caitlyn,554,284,270,51.26
Swain,Pyke,180,98,82,54.44
Swain,Darius,366,158,208,43.17
Swain,JarvanIV,124,77,47,62.1
Swain,Xerath,141,64,77,45.39
Swain,Yuumi,186,91,95,48.92
Swain,Yorick,170,100,70,58.82
Swain,Warwick,305,160,145,52.46
Swain,Akali,208,113,95,54.33
Swain,Jhin,384,228,156,59.38
Swain,Braum,175,95,80,54.29
Swain,Rell,135,57,78,42.22
Swain,Rengar,63,33,30,52.38
Swain,Sett,335,193,142,57.61
Swain,Varus,190,110,80,57.89
Swain,Gangplank,115,69,46,60
Swain,Pantheon,386,240,146,62.18
Swain,TwistedFate,89,55,34,61.8
Swain,Kaisa,318,201,117,63.21
Swain,Jayce,99,50,49,50.51
Swain,Sejuani,113,61,52,53.98
Swain,Fizz,108,55,53,50.93
Swain,Alistar,138,72,66,52.17
Swain,Gwen,148,81,67,54.73
Swain,Amumu,307,148,159,48.21
Swain,DrMundo,118,51,67,43.22
Swain,Tristana,192,104,88,54.17
Swain,Lulu,276,154,122,55.8
Swain,Nasus,149,75,74,50.34
Swain,Vi,246,144,102,58.54
Swain,Galio,304,157,147,51.64
Swain,Smolder,175,93,82,53.14
Swain,Kayle,94,39,55,41.49
Swain,Viktor,226,137,89,60.62
Swain,Ashe,499,278,221,55.71
Swain,Milio,159,86,73,54.09
Swain,Evelynn,79,46,33,58.23
Swain,MissFortune,448,254,194,56.7
Swain,Nidalee,66,47,19,71.21
Swain,Veigar,241,131,110,54.36
Swain,Chogath,267,156,111,58.43
Swain,Olaf,69,38,31,55.07
Swain,Yasuo,423,212,211,50.12
Swain,Draven,82,50,32,60.98
Swain,Morgana,206,113,93,54.85
Swain,Quinn,69,42,27,60.87
Swain,Naafiri,55,38,17,69.09
Swain,Lux,468,256,212,54.7
Swain,Jinx,538,265,273,49.26
Swain,Heimerdinger,119,70,49,58.82
Swain,Tryndamere,73,39,34,53.42
Swain,MonkeyKing,125,55,70,44
Swain,Malzahar,235,130,105,55.32
Swain,Mordekaiser,275,146,129,53.09
Swain,Trundle,111,60,51,54.05
Swain,Briar,138,60,78,43.48
Swain,Vex,146,74,72,50.68
Swain,Lillia,150,65,85,43.33
Swain,Nami,209,78,131,37.32
Swain,TahmKench,214,135,79,63.08
Swain,Talon,100,56,44,56
Swain,Vladimir,151,82,69,54.3
Swain,Ornn,112,70,42,62.5
Swain,Diana,328,173,155,52.74
Swain,Corki,97,50,47,51.55
Swain,Soraka,96,45,51,46.88
Swain,Camille,95,60,35,63.16
Swain,LeeSin,312,199,113,63.78
Swain,Zyra,188,124,64,65.96
Swain,Irelia,165,95,70,57.58
Swain,Gragas,134,81,53,60.45
Swain,Xayah,138,64,74,46.38
Swain,Thresh,496,291,205,58.67
Swain,Garen,355,184,171,51.83
Swain,Orianna,122,75,47,61.48
Swain,Brand,149,74,75,49.66
Swain,Jax,210,116,94,55.24
Swain,Urgot,114,62,52,54.39
Swain,Teemo,207,111,96,53.62
Swain,Renekton,121,64,57,52.89
Swain,Ryze,84,48,36,57.14
Swain,Karma,252,152,100,60.32
Swain,Ambessa,156,87,69,55.77
Swain,Aurora,230,118,112,51.3
Swain,Syndra,137,75,62,54.74
Swain,Nautilus,323,210,113,65.02
Swain,Yone,389,207,182,53.21
Swain,Samira,175,100,75,57.14
Swain,Gnar,136,78,58,57.35
Swain,Illaoi,104,53,51,50.96
Swain,Shaco,139,76,63,54.68
Swain,Lucian,222,105,117,47.3
Swain,Malphite,250,148,102,59.2
Swain,Seraphine,121,75,46,61.98
Swain,Aatrox,238,125,113,52.52
Swain,XinZhao,137,79,58,57.66
Swain,Kassadin,44,18,26,40.91
Swain,Leona,244,151,93,61.89
Swain,Leblanc,104,69,35,66.35
Swain,Shen,167,99,68,59.28
Swain,Fiora,95,61,34,64.21
Swain,FiddleSticks,105,59,46,56.19
Swain,Ezreal,447,245,202,54.81
Swain,Nocturne,258,129,129,50
Swain,Elise,185,83,102,44.86
Swain,Senna,119,62,57,52.1
Swain,Viego,295,143,152,48.47
Swain,Aphelios,124,69,55,55.65
Swain,Poppy,171,97,74,56.73
Swain,Rammus,76,42,34,55.26
Swain,Hwei,144,71,73,49.31
Swain,Twitch,126,65,61,51.59
Swain,Ekko,201,117,84,58.21
Swain,Vayne,314,143,171,45.54
Swain,Cassiopeia,47,20,27,42.55
Swain,Nunu,148,82,66,55.41
Swain,Katarina,124,73,51,58.87
Swain,Khazix,115,49,66,42.61
Swain,Sylas,314,175,139,55.73
Swain,AurelionSol,91,41,50,45.05
Swain,Janna,64,21,43,32.81
Swain,Karthus,53,34,19,64.15
Swain,Blitzcrank,171,86,85,50.29
Swain,Zac,102,59,43,57.84
Swain,Sion,161,79,82,49.07
Swain,Hecarim,76,45,31,59.21
Swain,Ziggs,70,42,28,60
Swain,Volibear,250,155,95,62
Swain,Rumble,72,51,21,70.83
Swain,Neeko,105,56,49,53.33
Swain,Sivir,123,64,59,52.03
Swain,Graves,120,70,50,58.33
Swain,Singed,64,31,33,48.44
Swain,Zilean,36,28,8,77.78
Swain,MasterYi,219,104,115,47.49
Swain,Kennen,74,48,26,64.86
Swain,Maokai,116,66,50,56.9
Swain,Akshan,79,50,29,63.29
Swain,Udyr,58,26,32,44.83
Swain,Azir,96,55,41,57.29
Swain,Qiyana,47,26,21,55.32
Swain,Ivern,54,31,23,57.41
Swain,Zed,179,93,86,51.96
Swain,KSante,166,97,69,58.43
Swain,Nilah,78,45,33,57.69
Swain,Bard,74,30,44,40.54
Swain,Skarner,76,47,29,61.84
Swain,Annie,75,47,28,62.67
Swain,Kalista,70,45,25,64.29
Swain,Taric,53,32,21,60.38
Swain,Shyvana,56,33,23,58.93
Swain,Velkoz,154,72,82,46.75
Swain,Riven,59,31,28,52.54
Swain,Zeri,112,66,46,58.93
Swain,Kindred,79,37,42,46.84
Swain,KogMaw,69,34,35,49.28
Swain,Rakan,112,58,54,51.79
Swain,Belveth,37,22,15,59.46
Swain,Anivia,80,43,37,53.75
Swain,Sona,26,17,9,65.38
Swain,Zoe,74,48,26,64.86
Swain,Lissandra,70,53,17,75.71
Swain,Taliyah,53,28,25,52.83
Swain,Renata,58,28,30,48.28
Swain,Kled,37,18,19,48.65
Swain,RekSai,23,3,20,13.04
Ahri,Mordekaiser,443,212,231,47.86
Ahri,Evelynn,118,49,69,41.53
Ahri,Riven,153,89,64,58.17
Ahri,MissFortune,625,367,258,58.72
Ahri,Swain,298,140,158,46.98
Ahri,Warwick,432,204,228,47.22
Ahri,Udyr,104,61,43,58.65
Ahri,Mel,482,203,279,42.12
Ahri,Sivir,208,79,129,37.98
Ahri,Karma,405,229,176,56.54
Ahri,DrMundo,170,98,72,57.65
Ahri,Sejuani,236,84,152,35.59
Ahri,Veigar,360,181,179,50.28
Ahri,Jinx,803,369,434,45.95
Ahri,Nami,387,177,210,45.74
Ahri,Tryndamere,150,69,81,46
Ahri,Shaco,257,117,140,45.53
Ahri,Leblanc,287,162,125,56.45
Ahri,Caitlyn,745,352,393,47.25
Ahri,Morgana,284,146,138,51.41
Ahri,Olaf,96,44,52,45.83
Ahri,Viego,432,211,221,48.84
Ahri,Ryze,156,85,71,54.49
Ahri,Jhin,577,269,308,46.62
Ahri,Soraka,127,54,73,42.52
Ahri,Alistar,173,85,88,49.13
Ahri,Nocturne,408,220,188,53.92
Ahri,Galio,444,228,216,51.35
Ahri,Urgot,201,94,107,46.77
Ahri,Samira,266,149,117,56.02
Ahri,Jax,273,138,135,50.55
Ahri,RekSai,45,28,17,62.22
Ahri,Xayah,248,107,141,43.15
Ahri,Rakan,189,110,79,58.2
Ahri,Cassiopeia,90,47,43,52.22
Ahri,Darius,548,239,309,43.61
Ahri,XinZhao,272,143,129,52.57
Ahri,Orianna,230,119,111,51.74
Ahri,Ezreal,947,498,449,52.59
Ahri,Thresh,644,308,336,47.83
Ahri,Nasus,154,67,87,43.51
Ahri,MonkeyKing,241,103,138,42.74
Ahri,Viktor,323,139,184,43.03
Ahri,Ashe,703,321,382,45.66
Ahri,Trundle,195,100,95,51.28
Ahri,Khazix,169,101,68,59.76
Ahri,Smolder,244,128,116,52.46
Ahri,Zilean,95,49,46,51.58
Ahri,Yorick,223,108,115,48.43
Ahri,Hwei,229,115,114,50.22
Ahri,Zyra,264,127,137,48.11
Ahri,Kled,67,32,35,47.76
Ahri,Gragas,244,128,116,52.46
Ahri,Anivia,137,53,84,38.69
Ahri,Rell,236,121,115,51.27
Ahri,Ambessa,257,136,121,52.92
Ahri,LeeSin,564,299,265,53.01
Ahri,Renekton,180,83,97,46.11
Ahri,Gangplank,207,102,105,49.28
Ahri,Ekko,271,142,129,52.4
Ahri,Elise,245,131,114,53.47
Ahri,Draven,163,80,83,49.08
Ahri,Sion,268,116,152,43.28
Ahri,Vi,387,226,161,58.4
Ahri,Nilah,86,32,54,37.21
Ahri,Leona,338,176,162,52.07
Ahri,Akali,267,148,119,55.43
Ahri,Zoe,160,78,82,48.75
Ahri,JarvanIV,301,145,156,48.17
Ahri,Rumble,82,41,41,50
Ahri,Lulu,523,276,247,52.77
Ahri,Vladimir,183,98,85,53.55
Ahri,Ziggs,83,52,31,62.65
Ahri,Teemo,271,139,132,51.29
Ahri,Zac,217,96,121,44.24
Ahri,Pantheon,523,257,266,49.14
Ahri,Katarina,253,127,126,50.2
Ahri,Aatrox,335,157,178,46.87
Ahri,Yasuo,561,290,271,51.69
Ahri,Jayce,176,79,97,44.89
Ahri,Zed,317,149,168,47
Ahri,Graves,232,117,115,50.43
Ahri,Sylas,611,286,325,46.81
Ahri,Irelia,217,104,113,47.93
Ahri,Karthus,61,40,21,65.57
Ahri,Lux,792,381,411,48.11
Ahri,Annie,123,69,54,56.1
Ahri,Malzahar,292,148,144,50.68
Ahri,Nidalee,123,64,59,52.03
Ahri,Volibear,338,161,177,47.63
Ahri,Corki,181,86,95,47.51
Ahri,Sona,63,27,36,42.86
Ahri,Malphite,347,168,179,48.41
Ahri,Kayle,162,70,92,43.21
Ahri,Yuumi,323,176,147,54.49
Ahri,Vayne,398,184,214,46.23
Ahri,Ornn,200,100,100,50
Ahri,Skarner,149,56,93,37.58
Ahri,Bard,110,40,70,36.36
Ahri,Qiyana,66,36,30,54.55
Ahri,Zeri,140,98,42,70
Ahri,MasterYi,279,118,161,42.29
Ahri,Blitzcrank,360,177,183,49.17
Ahri,Twitch,186,105,81,56.45
Ahri,Kindred,153,95,58,62.09
Ahri,Varus,315,178,137,56.51
Ahri,Chogath,417,202,215,48.44
Ahri,Yone,563,288,275,51.15
Ahri,Tristana,264,126,138,47.73
Ahri,Gwen,153,79,74,51.63
Ahri,Briar,202,105,97,51.98
Ahri,Sett,425,225,200,52.94
Ahri,Hecarim,125,66,59,52.8
Ahri,Garen,449,254,195,56.57
Ahri,Akshan,90,52,38,57.78
Ahri,Syndra,335,164,171,48.96
Ahri,Lucian,314,151,163,48.09
Ahri,Milio,197,121,76,61.42
Ahri,Lillia,179,81,98,45.25
Ahri,AurelionSol,99,51,48,51.52
Ahri,Aphelios,198,106,92,53.54
Ahri,Kayn,345,201,144,58.26
Ahri,Amumu,379,163,216,43.01
Ahri,Senna,163,84,79,51.53
Ahri,Maokai,116,52,64,44.83
Ahri,Gnar,206,128,78,62.14
Ahri,Kaisa,539,286,253,53.06
Ahri,Seraphine,251,126,125,50.2
Ahri,Poppy,296,129,167,43.58
Ahri,Brand,172,89,83,51.74
Ahri,Aurora,340,175,165,51.47
Ahri,Belveth,54,26,28,48.15
Ahri,Nautilus,447,225,222,50.34
Ahri,Nunu,199,100,99,50.25
Ahri,Xerath,273,139,134,50.92
Ahri,Diana,483,217,266,44.93
Ahri,TwistedFate,114,50,64,43.86
Ahri,FiddleSticks,177,95,82,53.67
Ahri,Heimerdinger,114,49,65,42.98
Ahri,Neeko,148,79,69,53.38
Ahri,Taric,68,29,39,42.65
Ahri,Braum,265,131,134,49.43
Ahri,Singed,72,35,37,48.61
Ahri,TahmKench,246,127,119,51.63
Ahri,KSante,272,155,117,56.99
Ahri,Ivern,75,27,48,36
Ahri,Kassadin,67,25,42,37.31
Ahri,Kalista,117,63,54,53.85
Ahri,Renata,73,53,20,72.6
Ahri,Vex,191,96,95,50.26
Ahri,Camille,129,68,61,52.71
Ahri,Fiora,105,48,57,45.71
Ahri,Kennen,131,75,56,57.25
Ahri,Azir,131,74,57,56.49
Ahri,KogMaw,105,43,62,40.95
Ahri,Lissandra,169,88,81,52.07
Ahri,Illaoi,117,65,52,55.56
Ahri,Naafiri,85,43,42,50.59
Ahri,Quinn,83,39,44,46.99
Ahri,Taliyah,102,54,48,52.94
Ahri,Pyke,232,118,114,50.86
Ahri,Shen,189,90,99,47.62
Ahri,Janna,103,49,54,47.57
Ahri,Velkoz,169,100,69,59.17
Ahri,Rammus,92,28,64,30.43
Ahri,Shyvana,72,31,41,43.06
Ahri,Fizz,102,58,44,56.86
Ahri,Talon,130,73,57,56.15
Ahri,Rengar,86,46,40,53.49
Kayn,Mordekaiser,333,155,178,46.55
Kayn,Evelynn,92,51,41,55.43
Kayn,Riven,101,39,62,38.61
Kayn,MissFortune,548,253,295,46.17
Kayn,Swain,271,128,143,47.23
Kayn,Jax,261,116,145,44.44
Kayn,Sejuani,182,92,90,50.55
Kayn,Hwei,196,105,91,53.57
Kayn,Ezreal,599,294,305,49.08
Kayn,Zac,231,107,124,46.32
Kayn,Malphite,299,140,159,46.82
Kayn,Lissandra,105,43,62,40.95
Kayn,Lulu,405,201,204,49.63
Kayn,Ambessa,217,118,99,54.38
Kayn,Viktor,204,103,101,50.49
Kayn,Graves,164,77,87,46.95
Kayn,Caitlyn,629,301,328,47.85
Kayn,Braum,190,94,96,49.47
Kayn,Sion,224,112,112,50
Kayn,Nocturne,271,118,153,43.54
Kayn,Jhin,499,287,212,57.52
Kayn,Soraka,142,51,91,35.92
Kayn,Udyr,90,50,40,55.56
Kayn,Yone,433,217,216,50.12
Kayn,Smolder,184,98,86,53.26
Kayn,TahmKench,258,149,109,57.75
Kayn,DrMundo,168,62,106,36.9
Kayn,Rammus,115,65,50,56.52
Kayn,Annie,102,44,58,43.14
Kayn,Renata,56,24,32,42.86
Kayn,Teemo,300,132,168,44
Kayn,Warwick,407,176,231,43.24
Kayn,Nunu,166,84,82,50.6
Kayn,Lucian,176,98,78,55.68
Kayn,Leona,283,142,141,50.18
Kayn,Ekko,223,93,130,41.7
Kayn,Akali,231,138,93,59.74
Kayn,Karma,278,140,138,50.36
Kayn,Veigar,283,135,148,47.7
Kayn,Jinx,739,322,417,43.57
Kayn,Nami,227,80,147,35.24
Kayn,Yorick,191,87,104,45.55
Kayn,Viego,409,198,211,48.41
Kayn,AurelionSol,116,71,45,61.21
Kayn,Ashe,546,270,276,49.45
Kayn,Milio,209,85,124,40.67
Kayn,Nasus,191,98,93,51.31
Kayn,Amumu,380,168,212,44.21
Kayn,Sylas,393,205,188,52.16
Kayn,Twitch,194,79,115,40.72
Kayn,Zed,303,160,143,52.81
Kayn,Skarner,128,56,72,43.75
Kayn,Aurora,193,94,99,48.7
Kayn,Yuumi,180,97,83,53.89
Kayn,Pantheon,424,197,227,46.46
Kayn,Zoe,105,69,36,65.71
Kayn,Ziggs,107,55,52,51.4
Kayn,Darius,520,240,280,46.15
Kayn,Kindred,114,73,41,64.04
Kayn,Tristana,252,155,97,61.51
Kayn,Neeko,107,53,54,49.53
Kayn,Naafiri,86,38,48,44.19
Kayn,Mel,585,300,285,51.28
Kayn,Janna,83,43,40,51.81
Kayn,Gangplank,138,86,52,62.32
Kayn,Shaco,225,136,89,60.44
Kayn,Volibear,292,144,148,49.32
Kayn,Katarina,185,89,96,48.11
Kayn,Blitzcrank,276,153,123,55.43
Kayn,KSante,168,102,66,60.71
Kayn,Yasuo,595,314,281,52.77
Kayn,Gwen,123,75,48,60.98
Kayn,Briar,176,66,110,37.5
Kayn,Vayne,296,144,152,48.65
Kayn,Chogath,353,194,159,54.96
Kayn,JarvanIV,233,116,117,49.79
Kayn,Alistar,147,81,66,55.1
Kayn,MasterYi,307,132,175,43
Kayn,Singed,80,37,43,46.25
Kayn,Zyra,228,114,114,50
Kayn,Kayle,147,73,74,49.66
Kayn,Irelia,229,95,134,41.48
Kayn,Aatrox,252,146,106,57.94
Kayn,Malzahar,277,128,149,46.21
Kayn,Elise,224,114,110,50.89
Kayn,Draven,156,76,80,48.72
Kayn,Shen,191,89,102,46.6
Kayn,Heimerdinger,125,60,65,48
Kayn,Samira,245,122,123,49.8
Kayn,Nautilus,362,203,159,56.08
Kayn,Vi,307,140,167,45.6
Kayn,Jayce,99,39,60,39.39
Kayn,Orianna,121,51,70,42.15
Kayn,Lux,638,338,300,52.98
Kayn,Kaisa,455,226,229,49.67
Kayn,Pyke,217,113,104,52.07
Kayn,Diana,443,222,221,50.11
Kayn,Ryze,114,53,61,46.49
Kayn,Xayah,146,52,94,35.62
Kayn,Maokai,139,60,79,43.17
Kayn,Nidalee,63,38,25,60.32
Kayn,XinZhao,151,62,89,41.06
Kayn,Hecarim,85,49,36,57.65
Kayn,Sivir,151,76,75,50.33
Kayn,Poppy,148,62,86,41.89
Kayn,Zilean,81,38,43,46.91
Kayn,Brand,154,59,95,38.31
Kayn,Rakan,188,72,116,38.3
Kayn,Ivern,69,29,40,42.03
Kayn,Trundle,182,103,79,56.59
Kayn,Syndra,184,105,79,57.07
Kayn,Morgana,271,126,145,46.49
Kayn,LeeSin,439,220,219,50.11
Kayn,Khazix,133,64,69,48.12
Kayn,Vex,151,65,86,43.05
Kayn,Thresh,484,235,249,48.55
Kayn,Belveth,31,20,11,64.52
Kayn,Olaf,68,27,41,39.71
Kayn,Gnar,122,64,58,52.46
Kayn,KogMaw,74,39,35,52.7
Kayn,Garen,402,189,213,47.01
Kayn,Leblanc,144,78,66,54.17
Kayn,Bard,72,31,41,43.06
Kayn,Galio,327,140,187,42.81
Kayn,Ornn,182,103,79,56.59
Kayn,Gragas,201,122,79,60.7
Kayn,Sona,51,23,28,45.1
Kayn,Zeri,109,51,58,46.79
Kayn,Seraphine,185,82,103,44.32
Kayn,Varus,263,127,136,48.29
Kayn,RekSai,46,22,24,47.83
Kayn,Lillia,141,74,67,52.48
Kayn,Sett,452,243,209,53.76
Kayn,Renekton,140,62,78,44.29
Kayn,Rengar,119,51,68,42.86
Kayn,TwistedFate,73,36,37,49.32
Kayn,Ahri,345,144,201,41.74
Kayn,Qiyana,48,21,27,43.75
Kayn,Rumble,54,24,30,44.44
Kayn,Azir,142,72,70,50.7
Kayn,Vladimir,135,63,72,46.67
Kayn,Talon,147,80,67,54.42
Kayn,Urgot,126,70,56,55.56
Kayn,Rell,224,120,104,53.57
Kayn,Nilah,102,61,41,59.8
Kayn,FiddleSticks,119,44,75,36.97
Kayn,Aphelios,185,97,88,52.43
Kayn,Shyvana,70,16,54,22.86
Kayn,Xerath,191,115,76,60.21
Kayn,Fiora,90,53,37,58.89
Kayn,Illaoi,164,75,89,45.73
Kayn,Cassiopeia,86,30,56,34.88
Kayn,Tryndamere,103,57,46,55.34
Kayn,Senna,176,102,74,57.95
Kayn,Taric,67,23,44,34.33
Kayn,MonkeyKing,177,94,83,53.11
Kayn,Akshan,106,62,44,58.49
Kayn,Kennen,70,32,38,45.71
Kayn,Corki,135,74,61,54.81
Kayn,Velkoz,107,56,51,52.34
Kayn,Fizz,128,46,82,35.94
Kayn,Kassadin,59,26,33,44.07
Kayn,Karthus,85,39,46,45.88
Kayn,Kalista,73,27,46,36.99
Kayn,Quinn,74,34,40,45.95
Kayn,Camille,93,47,46,50.54
Kayn,Taliyah,73,36,37,49.32
Kayn,Kled,23,10,13,43.48
Kayn,Anivia,85,45,40,52.94
Mel,Mordekaiser,587,265,322,45.14
Mel,Evelynn,176,76,100,43.18
Mel,Riven,268,112,156,41.79
Mel,MissFortune,897,447,450,49.83
Mel,Swain,479,250,229,52.19
Mel,Chogath,606,282,324,46.53
Mel,Sivir,233,120,113,51.5
Mel,Ashe,898,490,408,54.57
Mel,Fiora,177,95,82,53.67
Mel,Teemo,524,279,245,53.24
Mel,Diana,709,321,388,45.28
Mel,Nilah,130,37,93,28.46
Mel,Leona,542,237,305,43.73
Mel,Sett,661,354,307,53.56
Mel,Hecarim,168,100,68,59.52
Mel,Ahri,482,279,203,57.88
Mel,Rakan,307,131,176,42.67
Mel,Draven,266,126,140,47.37
Mel,FiddleSticks,234,100,134,42.74
Mel,Hwei,278,127,151,45.68
Mel,Twitch,376,171,205,45.48
Mel,Seraphine,337,167,170,49.55
Mel,Viego,657,318,339,48.4
Mel,Yone,819,381,438,46.52
Mel,Lucian,382,185,197,48.43
Mel,Shen,385,173,212,44.94
Mel,Vi,479,223,256,46.56
Mel,Nami,511,227,284,44.42
Mel,Jhin,975,505,470,51.79
Mel,Ekko,434,215,219,49.54
Mel,Akali,494,255,239,51.62
Mel,Ambessa,398,181,217,45.48
Mel,Karma,591,283,308,47.88
Mel,Poppy,342,157,185,45.91
Mel,Zac,294,152,142,51.7
Mel,Malzahar,488,204,284,41.8
Mel,TahmKench,479,248,231,51.77
Mel,Nocturne,546,237,309,43.41
Mel,Orianna,327,125,202,38.23
Mel,Caitlyn,1196,636,560,53.18
Mel,Neeko,220,105,115,47.73
Mel,Pantheon,832,400,432,48.08
Mel,Talon,268,129,139,48.13
Mel,Kaisa,797,397,400,49.81
Mel,Soraka,218,107,111,49.08
Mel,Illaoi,199,104,95,52.26
Mel,Briar,245,107,138,43.67
Mel,Taliyah,124,58,66,46.77
Mel,Morgana,457,240,217,52.52
Mel,Nasus,329,148,181,44.98
Mel,Shaco,355,200,155,56.34
Mel,Xerath,573,260,313,45.38
Mel,Lulu,754,328,426,43.5
Mel,Darius,895,395,500,44.13
Mel,Aphelios,262,137,125,52.29
Mel,Gwen,247,119,128,48.18
Mel,Irelia,418,187,231,44.74
Mel,Varus,449,237,212,52.78
Mel,Lux,946,528,418,55.81
Mel,KSante,277,176,101,63.54
Mel,Kassadin,175,73,102,41.71
Mel,Bard,159,84,75,52.83
Mel,Kindred,173,77,96,44.51
Mel,Veigar,442,202,240,45.7
Mel,Tristana,405,171,234,42.22
Mel,Malphite,524,261,263,49.81
Mel,Graves,277,150,127,54.15
Mel,Vladimir,305,121,184,39.67
Mel,Ezreal,1183,576,607,48.69
Mel,Camille,213,110,103,51.64
Mel,Yorick,352,143,209,40.63
Mel,Kayn,585,285,300,48.72
Mel,Sylas,783,435,348,55.56
Mel,Renata,82,41,41,50
Mel,Kayle,252,109,143,43.25
Mel,Corki,209,79,130,37.8
Mel,Syndra,285,132,153,46.32
Mel,Cassiopeia,141,62,79,43.97
Mel,Gragas,346,159,187,45.95
Mel,Gangplank,242,122,120,50.41
Mel,XinZhao,302,113,189,37.42
Mel,Azir,254,99,155,38.98
Mel,Garen,691,336,355,48.63
Mel,Belveth,84,44,40,52.38
Mel,Tryndamere,165,86,79,52.12
Mel,Nunu,327,157,170,48.01
Mel,Kennen,154,81,73,52.6
Mel,Samira,355,162,193,45.63
Mel,Rell,330,162,168,49.09
Mel,Khazix,229,113,116,49.34
Mel,Katarina,291,138,153,47.42
Mel,AurelionSol,287,131,156,45.64
Mel,Brand,267,108,159,40.45
Mel,Heimerdinger,182,108,74,59.34
Mel,LeeSin,760,397,363,52.24
Mel,Jinx,1081,473,608,43.76
Mel,Naafiri,127,61,66,48.03
Mel,Yasuo,973,482,491,49.54
Mel,Trundle,240,106,134,44.17
Mel,RekSai,84,51,33,60.71
Mel,Leblanc,245,139,106,56.73
Mel,Nautilus,648,311,337,47.99
Mel,Jayce,225,110,115,48.89
Mel,Viktor,583,302,281,51.8
Mel,MasterYi,475,217,258,45.68
Mel,Yuumi,395,178,217,45.06
Mel,Olaf,160,62,98,38.75
Mel,Zed,498,228,270,45.78
Mel,Singed,128,53,75,41.41
Mel,Fizz,315,161,154,51.11
Mel,Jax,343,171,172,49.85
Mel,DrMundo,248,133,115,53.63
Mel,Aurora,339,197,142,58.11
Mel,Sion,407,193,214,47.42
Mel,Ryze,134,68,66,50.75
Mel,Smolder,375,174,201,46.4
Mel,Volibear,402,180,222,44.78
Mel,Elise,379,182,197,48.02
Mel,Vex,166,88,78,53.01
Mel,Lillia,272,122,150,44.85
Mel,Rammus,123,64,59,52.03
Mel,KogMaw,156,74,82,47.44
Mel,Urgot,209,113,96,54.07
Mel,Sejuani,302,118,184,39.07
Mel,Thresh,848,408,440,48.11
Mel,Zyra,328,143,185,43.6
Mel,Qiyana,99,60,39,60.61
Mel,Amumu,608,294,314,48.36
Mel,Braum,316,158,158,50
Mel,Vayne,568,248,320,43.66
Mel,Senna,315,149,166,47.3
Mel,Ivern,90,44,46,48.89
Mel,Blitzcrank,375,207,168,55.2
Mel,Zeri,237,100,137,42.19
Mel,Warwick,571,273,298,47.81
Mel,Aatrox,468,250,218,53.42
Mel,Zilean,132,53,79,40.15
Mel,Milio,299,140,159,46.82
Mel,Sona,86,42,44,48.84
Mel,Skarner,190,100,90,52.63
Mel,Zoe,158,69,89,43.67
Mel,Rumble,138,72,66,52.17
Mel,Anivia,178,100,78,56.18
Mel,Xayah,275,110,165,40
Mel,Gnar,196,88,108,44.9
Mel,Taric,102,39,63,38.24
Mel,TwistedFate,102,45,57,44.12
Mel,Alistar,291,153,138,52.58
Mel,Rengar,132,78,54,59.09
Mel,Galio,588,265,323,45.07
Mel,JarvanIV,387,199,188,51.42
Mel,Pyke,412,196,216,47.57
Mel,Ornn,249,141,108,56.63
Mel,Ziggs,192,62,130,32.29
Mel,Lissandra,158,47,111,29.75
Mel,Renekton,258,138,120,53.49
Mel,Quinn,165,66,99,40
Mel,Udyr,166,72,94,43.37
Mel,Maokai,219,119,100,54.34
Mel,Janna,126,45,81,35.71
Mel,Nidalee,184,92,92,50
Mel,Karthus,121,56,65,46.28
Mel,MonkeyKing,326,154,172,47.24
Mel,Akshan,178,84,94,47.19
Mel,Velkoz,259,116,143,44.79
Mel,Shyvana,116,57,59,49.14
Mel,Annie,156,76,80,48.72
Mel,Kalista,149,91,58,61.07
Mel,Kled,94,35,59,37.23
Caitlyn,Mordekaiser,695,321,374,46.19
Caitlyn,Evelynn,196,89,107,45.41
Caitlyn,Riven,263,126,137,47.91
Caitlyn,MissFortune,1294,659,635,50.93
Caitlyn,Swain,554,270,284,48.74
Caitlyn,Vladimir,300,137,163,45.67
Caitlyn,Kayn,629,328,301,52.15
Caitlyn,Velkoz,354,176,178,49.72
Caitlyn,Xayah,351,207,144,58.97
Caitlyn,Leblanc,367,202,165,55.04
Caitlyn,Yorick,499,261,238,52.3
Caitlyn,Teemo,536,254,282,47.39
Caitlyn,Katarina,338,166,172,49.11
Caitlyn,Jhin,1336,694,642,51.95
Caitlyn,Lux,1349,665,684,49.3
Caitlyn,Jax,491,230,261,46.84
Caitlyn,Udyr,214,121,93,56.54
Caitlyn,Yone,998,561,437,56.21
Caitlyn,Smolder,464,209,255,45.04
Caitlyn,TahmKench,472,244,228,51.69
Caitlyn,Fiora,210,106,104,50.48
Caitlyn,Diana,780,383,397,49.1
Caitlyn,Nilah,171,62,109,36.26
Caitlyn,Leona,552,294,258,53.26
Caitlyn,Volibear,590,274,316,46.44
Caitlyn,LeeSin,1057,552,505,52.22
Caitlyn,Veigar,612,319,293,52.12
Caitlyn,Vayne,656,331,325,50.46
Caitlyn,Yuumi,474,231,243,48.73
Caitlyn,Ornn,328,186,142,56.71
Caitlyn,Lillia,286,139,147,48.6
Caitlyn,Zed,572,270,302,47.2
Caitlyn,Tristana,542,270,272,49.82
Caitlyn,Nami,640,315,325,49.22
Caitlyn,FiddleSticks,285,158,127,55.44
Caitlyn,Hwei,419,190,229,45.35
Caitlyn,Twitch,377,203,174,53.85
Caitlyn,Seraphine,421,220,201,52.26
Caitlyn,Aatrox,541,282,259,52.13
Caitlyn,MasterYi,632,320,312,50.63
Caitlyn,TwistedFate,164,84,80,51.22
Caitlyn,Varus,601,312,289,51.91
Caitlyn,Gangplank,328,170,158,51.83
Caitlyn,Aurora,451,255,196,56.54
Caitlyn,Ashe,1415,700,715,49.47
Caitlyn,Morgana,490,230,260,46.94
Caitlyn,Poppy,406,209,197,51.48
Caitlyn,Pyke,477,245,232,51.36
Caitlyn,Sett,738,384,354,52.03
Caitlyn,Kindred,261,145,116,55.56
Caitlyn,Mel,1196,560,636,46.82
Caitlyn,Lulu,793,428,365,53.97
Caitlyn,Ezreal,1827,859,968,47.02
Caitlyn,Trundle,291,142,149,48.8
Caitlyn,Ahri,745,393,352,52.75
Caitlyn,Graves,347,182,165,52.45
Caitlyn,Blitzcrank,602,278,324,46.18
Caitlyn,Yasuo,1157,593,564,51.25
Caitlyn,Naafiri,141,70,71,49.65
Caitlyn,Azir,248,131,117,52.82
Caitlyn,Shen,442,180,262,40.72
Caitlyn,Karma,753,357,396,47.41
Caitlyn,Gwen,276,139,137,50.36
Caitlyn,Pantheon,903,446,457,49.39
Caitlyn,Irelia,409,207,202,50.61
Caitlyn,Akali,532,253,279,47.56
Caitlyn,Nunu,359,181,178,50.42
Caitlyn,Nautilus,746,363,383,48.66
Caitlyn,Amumu,675,317,358,46.96
Caitlyn,Darius,945,468,477,49.52
Caitlyn,Braum,427,176,251,41.22
Caitlyn,Vi,758,340,418,44.85
Caitlyn,Xerath,509,212,297,41.65
Caitlyn,Nasus,336,173,163,51.49
Caitlyn,Viego,721,376,345,52.15
Caitlyn,Cassiopeia,175,66,109,37.71
Caitlyn,Rakan,293,152,141,51.88
Caitlyn,Tryndamere,188,101,87,53.72
Caitlyn,KogMaw,192,110,82,57.29
Caitlyn,Sion,538,258,280,47.96
Caitlyn,Rengar,136,87,49,63.97
Caitlyn,Ambessa,392,202,190,51.53
Caitlyn,Viktor,534,265,269,49.63
Caitlyn,Jinx,1857,851,1006,45.83
Caitlyn,Bard,205,94,111,45.85
Caitlyn,Warwick,713,380,333,53.3
Caitlyn,Chogath,708,347,361,49.01
Caitlyn,Sivir,305,138,167,45.25
Caitlyn,Brand,354,181,173,51.13
Caitlyn,Shyvana,157,82,75,52.23
Caitlyn,Ryze,249,134,115,53.82
Caitlyn,Renekton,335,177,158,52.84
Caitlyn,JarvanIV,424,178,246,41.98
Caitlyn,Janna,167,68,99,40.72
Caitlyn,Elise,418,196,222,46.89
Caitlyn,Sylas,859,433,426,50.41
Caitlyn,Thresh,1017,524,493,51.52
Caitlyn,Alistar,301,148,153,49.17
Caitlyn,Singed,152,63,89,41.45
Caitlyn,Zyra,539,265,274,49.17
Caitlyn,Kayle,325,160,165,49.23
Caitlyn,Zac,367,194,173,52.86
Caitlyn,Soraka,288,141,147,48.96
Caitlyn,Galio,670,349,321,52.09
Caitlyn,DrMundo,265,134,131,50.57
Caitlyn,Zeri,222,113,109,50.9
Caitlyn,Kaisa,829,465,364,56.09
Caitlyn,Garen,823,365,458,44.35
Caitlyn,Sejuani,404,188,216,46.53
Caitlyn,Camille,213,100,113,46.95
Caitlyn,Shaco,432,216,216,50
Caitlyn,Milio,355,166,189,46.76
Caitlyn,Jayce,284,142,142,50
Caitlyn,Orianna,257,129,128,50.19
Caitlyn,Lucian,607,320,287,52.72
Caitlyn,Nidalee,218,133,85,61.01
Caitlyn,Urgot,305,136,169,44.59
Caitlyn,Lissandra,231,109,122,47.19
Caitlyn,Taliyah,165,84,81,50.91
Caitlyn,Illaoi,323,162,161,50.15
Caitlyn,Rammus,191,95,96,49.74
Caitlyn,Maokai,272,135,137,49.63
Caitlyn,Kassadin,104,41,63,39.42
Caitlyn,Heimerdinger,232,110,122,47.41
Caitlyn,Zilean,203,97,106,47.78
Caitlyn,Aphelios,335,159,176,47.46
Caitlyn,Gragas,408,194,214,47.55
Caitlyn,Neeko,262,135,127,51.53
Caitlyn,Vex,283,136,147,48.06
Caitlyn,Renata,134,60,74,44.78
Caitlyn,Kennen,183,110,73,60.11
Caitlyn,Samira,404,238,166,58.91
Caitlyn,Talon,275,139,136,50.55
Caitlyn,Ivern,109,64,45,58.72
Caitlyn,Anivia,216,117,99,54.17
Caitlyn,Khazix,319,176,143,55.17
Caitlyn,Hecarim,179,99,80,55.31
Caitlyn,Rell,411,208,203,50.61
Caitlyn,Ekko,485,247,238,50.93
Caitlyn,Malphite,652,326,326,50
Caitlyn,Karthus,146,66,80,45.21
Caitlyn,KSante,389,194,195,49.87
Caitlyn,RekSai,116,73,43,62.93
Caitlyn,Fizz,233,125,108,53.65
Caitlyn,Malzahar,594,284,310,47.81
Caitlyn,Gnar,258,139,119,53.88
Caitlyn,MonkeyKing,369,175,194,47.43
Caitlyn,Zoe,245,115,130,46.94
Caitlyn,Annie,153,73,80,47.71
Caitlyn,Senna,333,179,154,53.75
Caitlyn,AurelionSol,224,106,118,47.32
Caitlyn,Nocturne,681,304,377,44.64
Caitlyn,Draven,297,159,138,53.54
Caitlyn,Sona,99,37,62,37.37
Caitlyn,Skarner,240,131,109,54.58
Caitlyn,Kled,114,63,51,55.26
Caitlyn,Briar,323,174,149,53.87
Caitlyn,XinZhao,378,168,210,44.44
Caitlyn,Qiyana,111,45,66,40.54
Caitlyn,Syndra,452,225,227,49.78
Caitlyn,Kalista,166,86,80,51.81
Caitlyn,Ziggs,266,130,136,48.87
Caitlyn,Belveth,105,50,55,47.62
Caitlyn,Corki,262,129,133,49.24
Caitlyn,Taric,93,63,30,67.74
Caitlyn,Akshan,207,85,122,41.06
Caitlyn,Quinn,152,76,76,50
Caitlyn,Olaf,158,73,85,46.2
Caitlyn,Rumble,164,88,76,53.66
Pyke,Mordekaiser,249,114,135,45.78
Pyke,Evelynn,45,17,28,37.78
Pyke,Riven,56,35,21,62.5
Pyke,MissFortune,340,145,195,42.65
Pyke,Swain,180,82,98,45.56
Pyke,Ashe,388,180,208,46.39
Pyke,Twitch,67,35,32,52.24
Pyke,Viktor,196,92,104,46.94
Pyke,Xayah,117,56,61,47.86
Pyke,Xerath,205,73,132,35.61
Pyke,Ambessa,116,41,75,35.34
Pyke,Diana,280,139,141,49.64
Pyke,Ekko,112,55,57,49.11
Pyke,Jinx,457,231,226,50.55
Pyke,Lulu,268,110,158,41.04
Pyke,Yone,389,202,187,51.93
Pyke,JarvanIV,113,49,64,43.36
Pyke,Ryze,62,36,26,58.06
Pyke,Draven,65,34,31,52.31
Pyke,Blitzcrank,225,107,118,47.56
Pyke,Volibear,230,85,145,36.96
Pyke,Vi,254,112,142,44.09
Pyke,Gragas,133,63,70,47.37
Pyke,Caitlyn,477,232,245,48.64
Pyke,Lux,462,246,216,53.25
Pyke,Skarner,94,55,39,58.51
Pyke,Katarina,151,82,69,54.3
Pyke,RekSai,34,15,19,44.12
Pyke,Nunu,120,58,62,48.33
Pyke,Hwei,139,73,66,52.52
Pyke,Morgana,188,96,92,51.06
Pyke,Nautilus,288,143,145,49.65
Pyke,Aatrox,206,100,106,48.54
Pyke,Sejuani,149,44,105,29.53
Pyke,Yasuo,308,156,152,50.65
Pyke,Annie,60,31,29,51.67
Pyke,Nami,143,78,65,54.55
Pyke,Nasus,108,45,63,41.67
Pyke,MasterYi,188,93,95,49.47
Pyke,Anivia,83,27,56,32.53
Pyke,Vayne,207,103,104,49.76
Pyke,Yuumi,223,105,118,47.09
Pyke,Jax,174,85,89,48.85
Pyke,XinZhao,125,59,66,47.2
Pyke,Azir,104,37,67,35.58
Pyke,Rell,95,35,60,36.84
Pyke,LeeSin,348,187,161,53.74
Pyke,Thresh,373,197,176,52.82
Pyke,Pantheon,354,149,205,42.09
Pyke,Poppy,159,67,92,42.14
Pyke,Kled,60,30,30,50
Pyke,Kayn,217,104,113,47.93
Pyke,Qiyana,31,14,17,45.16
Pyke,Maokai,109,54,55,49.54
Pyke,Malphite,259,92,167,35.52
Pyke,Hecarim,80,32,48,40
Pyke,Aurora,117,61,56,52.14
Pyke,Sivir,124,50,74,40.32
Pyke,Soraka,102,49,53,48.04
Pyke,Ornn,123,52,71,42.28
Pyke,Kennen,75,44,31,58.67
Pyke,Varus,224,112,112,50
Pyke,Renata,38,16,22,42.11
Pyke,Rammus,88,35,53,39.77
Pyke,Zeri,100,34,66,34
Pyke,Yorick,181,82,99,45.3
Pyke,Orianna,108,54,54,50
Pyke,Alistar,97,50,47,51.55
Pyke,Zed,191,72,119,37.7
Pyke,Akali,172,74,98,43.02
Pyke,Karma,235,108,127,45.96
Pyke,Shen,145,57,88,39.31
Pyke,Shaco,149,70,79,46.98
Pyke,Smolder,131,61,70,46.56
Pyke,Garen,249,121,128,48.59
Pyke,Darius,324,159,165,49.07
Pyke,Veigar,150,71,79,47.33
Pyke,Warwick,259,119,140,45.95
Pyke,TahmKench,185,59,126,31.89
Pyke,Trundle,91,50,41,54.95
Pyke,Heimerdinger,59,30,29,50.85
Pyke,Quinn,50,14,36,28
Pyke,Zoe,61,33,28,54.1
Pyke,Nilah,84,46,38,54.76
Pyke,FiddleSticks,94,47,47,50
Pyke,Tristana,161,72,89,44.72
Pyke,Mel,412,216,196,52.43
Pyke,Kaisa,364,136,228,37.36
Pyke,Seraphine,132,58,74,43.94
Pyke,Karthus,59,22,37,37.29
Pyke,Rumble,70,57,13,81.43
Pyke,Lillia,69,32,37,46.38
Pyke,Renekton,104,48,56,46.15
Pyke,Leblanc,110,39,71,35.45
Pyke,Gwen,78,43,35,55.13
Pyke,Akshan,49,25,24,51.02
Pyke,Braum,138,65,73,47.1
Pyke,Lucian,163,93,70,57.06
Pyke,Galio,214,95,119,44.39
Pyke,Jhin,347,139,208,40.06
Pyke,KSante,121,59,62,48.76
Pyke,Syndra,105,38,67,36.19
Pyke,Graves,171,88,83,51.46
Pyke,Gnar,92,52,40,56.52
Pyke,Nocturne,193,104,89,53.89
Pyke,Ziggs,73,45,28,61.64
Pyke,Kayle,83,37,46,44.58
Pyke,Sylas,344,175,169,50.87
Pyke,Senna,83,33,50,39.76
Pyke,Irelia,145,74,71,51.03
Pyke,Briar,89,29,60,32.58
Pyke,Leona,181,84,97,46.41
Pyke,Fiora,68,35,33,51.47
Pyke,Cassiopeia,55,29,26,52.73
Pyke,Vladimir,83,42,41,50.6
Pyke,Ezreal,557,258,299,46.32
Pyke,KogMaw,63,36,27,57.14
Pyke,Teemo,179,82,97,45.81
Pyke,Shyvana,45,19,26,42.22
Pyke,Aphelios,74,38,36,51.35
Pyke,Belveth,17,12,5,70.59
Pyke,Naafiri,52,25,27,48.08
Pyke,Neeko,115,48,67,41.74
Pyke,Milio,89,33,56,37.08
Pyke,Illaoi,87,31,56,35.63
Pyke,Zac,107,50,57,46.73
Pyke,Taliyah,43,20,23,46.51
Pyke,Rengar,51,20,31,39.22
Pyke,Samira,157,55,102,35.03
Pyke,MonkeyKing,193,87,106,45.08
Pyke,Malzahar,186,74,112,39.78
Pyke,Kassadin,39,26,13,66.67
Pyke,Sona,44,26,18,59.09
Pyke,Rakan,133,57,76,42.86
Pyke,Sett,301,134,167,44.52
Pyke,Taric,54,21,33,38.89
Pyke,Jayce,105,53,52,50.48
Pyke,Vex,112,48,64,42.86
Pyke,Janna,52,21,31,40.38
Pyke,Amumu,180,70,110,38.89
Pyke,Fizz,105,43,62,40.95
Pyke,Urgot,89,37,52,41.57
Pyke,Kindred,99,46,53,46.46
Pyke,Ahri,232,114,118,49.14
Pyke,Gangplank,91,43,48,47.25
Pyke,Khazix,63,22,41,34.92
Pyke,Kalista,67,29,38,43.28
Pyke,Brand,81,39,42,48.15
Pyke,Viego,291,118,173,40.55
Pyke,Chogath,220,82,138,37.27
Pyke,Elise,180,82,98,45.56
Pyke,DrMundo,84,48,36,57.14
Pyke,AurelionSol,70,38,32,54.29
Pyke,Zyra,148,58,90,39.19
Pyke,Tryndamere,81,43,38,53.09
Pyke,Talon,85,40,45,47.06
Pyke,Velkoz,97,36,61,37.11
Pyke,Camille,70,39,31,55.71
Pyke,Lissandra,48,23,25,47.92
Pyke,Sion,167,80,87,47.9
Pyke,Corki,99,56,43,56.57
Pyke,Udyr,68,41,27,60.29
Pyke,Olaf,48,14,34,29.17
Pyke,Ivern,32,25,7,78.13
Pyke,Zilean,27,8,19,29.63
Pyke,Nidalee,71,42,29,59.15
Pyke,Bard,34,20,14,58.82
Pyke,Singed,25,7,18,28
Pyke,TwistedFate,53,17,36,32.08
Gangplank,Urgot,59,29,30,49.15
Gangplank,Diana,192,112,80,58.33
Gangplank,Syndra,78,40,38,51.28
Gangplank,MissFortune,287,152,135,52.96
Gangplank,Braum,92,40,52,43.48
Gangplank,Riven,68,37,31,54.41
Gangplank,MonkeyKing,132,57,75,43.18
Gangplank,Kassadin,26,8,18,30.77
Gangplank,Caitlyn,328,158,170,48.17
Gangplank,Taliyah,30,14,16,46.67
Gangplank,Jax,81,51,30,62.96
Gangplank,MasterYi,128,67,61,52.34
Gangplank,Malzahar,121,66,55,54.55
Gangplank,Morgana,96,39,57,40.63
Gangplank,Mordekaiser,125,61,64,48.8
Gangplank,Yone,201,103,98,51.24
Gangplank,Xerath,137,64,73,46.72
Gangplank,Darius,248,134,114,54.03
Gangplank,Kayn,138,52,86,37.68
Gangplank,Lux,328,183,145,55.79
Gangplank,Soraka,76,44,32,57.89
Gangplank,Swain,115,46,69,40
Gangplank,Volibear,151,60,91,39.74
Gangplank,Lissandra,59,34,25,57.63
Gangplank,Kalista,49,18,31,36.73
Gangplank,Rell,108,74,34,68.52
Gangplank,Karma,210,113,97,53.81
Gangplank,Mel,242,120,122,49.59
Gangplank,Cassiopeia,29,17,12,58.62
Gangplank,Thresh,271,104,167,38.38
Gangplank,Sett,149,57,92,38.26
Gangplank,Yasuo,220,99,121,45
Gangplank,KogMaw,42,8,34,19.05
Gangplank,Lulu,225,95,130,42.22
Gangplank,Gnar,81,42,39,51.85
Gangplank,Amumu,171,77,94,45.03
Gangplank,Aurora,127,47,80,37.01
Gangplank,Tristana,117,56,61,47.86
Gangplank,Pantheon,194,79,115,40.72
Gangplank,Ahri,207,105,102,50.72
Gangplank,Brand,74,31,43,41.89
Gangplank,Nami,135,63,72,46.67
Gangplank,Shen,120,51,69,42.5
Gangplank,Viego,207,99,108,47.83
Gangplank,Hwei,108,48,60,44.44
Gangplank,LeeSin,258,119,139,46.12
Gangplank,Leona,138,78,60,56.52
Gangplank,Yorick,83,45,38,54.22
Gangplank,Milio,79,34,45,43.04
Gangplank,Qiyana,25,13,12,52
Gangplank,Briar,75,33,42,44
Gangplank,Lucian,140,83,57,59.29
Gangplank,TahmKench,96,45,51,46.88
Gangplank,Elise,115,44,71,38.26
Gangplank,Jinx,306,118,188,38.56
Gangplank,Kled,28,20,8,71.43
Gangplank,Jhin,236,91,145,38.56
Gangplank,Veigar,103,39,64,37.86
Gangplank,Nocturne,178,79,99,44.38
Gangplank,Teemo,123,50,73,40.65
Gangplank,Ezreal,320,184,136,57.5
Gangplank,Maokai,48,12,36,25
Gangplank,Malphite,154,81,73,52.6
Gangplank,Vladimir,75,34,41,45.33
Gangplank,Nunu,46,18,28,39.13
Gangplank,Quinn,41,24,17,58.54
Gangplank,Warwick,136,90,46,66.18
Gangplank,Renekton,60,34,26,56.67
Gangplank,Shaco,117,79,38,67.52
Gangplank,Zed,135,52,83,38.52
Gangplank,Yuumi,126,57,69,45.24
Gangplank,Blitzcrank,109,49,60,44.95
Gangplank,Alistar,82,37,45,45.12
Gangplank,Nautilus,160,68,92,42.5
Gangplank,Sion,124,68,56,54.84
Gangplank,XinZhao,138,64,74,46.38
Gangplank,Lillia,71,41,30,57.75
Gangplank,Katarina,99,51,48,51.52
Gangplank,Kaisa,188,87,101,46.28
Gangplank,Anivia,62,25,37,40.32
Gangplank,Seraphine,90,46,44,51.11
Gangplank,FiddleSticks,52,21,31,40.38
Gangplank,Vayne,129,38,91,29.46
Gangplank,Ashe,336,164,172,48.81
Gangplank,Poppy,83,33,50,39.76
Gangplank,JarvanIV,92,44,48,47.83
Gangplank,Viktor,126,61,65,48.41
Gangplank,Singed,32,12,20,37.5
Gangplank,Vex,90,53,37,58.89
Gangplank,Orianna,68,27,41,39.71
Gangplank,Neeko,75,29,46,38.67
Gangplank,Chogath,147,66,81,44.9
Gangplank,Aatrox,228,117,111,51.32
Gangplank,Talon,70,35,35,50
Gangplank,Zyra,89,39,50,43.82
Gangplank,Sylas,234,101,133,43.16
Gangplank,Samira,90,56,34,62.22
Gangplank,Olaf,44,18,26,40.91
Gangplank,Vi,135,54,81,40
Gangplank,Evelynn,41,25,16,60.98
Gangplank,Naafiri,31,15,16,48.39
Gangplank,Aphelios,79,43,36,54.43
Gangplank,Hecarim,51,25,26,49.02
Gangplank,Zilean,39,17,22,43.59
Gangplank,Leblanc,81,43,38,53.09
Gangplank,Nasus,76,54,22,71.05
Gangplank,Irelia,116,64,52,55.17
Gangplank,Gragas,136,67,69,49.26
Gangplank,Ziggs,76,28,48,36.84
Gangplank,Smolder,93,52,41,55.91
Gangplank,Graves,107,58,49,54.21
Gangplank,Ekko,68,35,33,51.47
Gangplank,Khazix,76,38,38,50
Gangplank,Varus,152,82,70,53.95
Gangplank,Fizz,53,27,26,50.94
Gangplank,Jayce,84,43,41,51.19
Gangplank,Sejuani,90,31,59,34.44
Gangplank,Tryndamere,35,13,22,37.14
Gangplank,Gwen,40,20,20,50
Gangplank,Akshan,38,28,10,73.68
Gangplank,Sivir,61,29,32,47.54
Gangplank,Rumble,45,19,26,42.22
Gangplank,Corki,61,24,37,39.34
Gangplank,Bard,24,15,9,62.5
Gangplank,Akali,90,45,45,50
Gangplank,Xayah,72,26,46,36.11
Gangplank,Rakan,57,19,38,33.33
Gangplank,Kayle,58,24,34,41.38
Gangplank,Draven,75,40,35,53.33
Gangplank,Senna,84,41,43,48.81
Gangplank,Ryze,57,23,34,40.35
Gangplank,Twitch,74,42,32,56.76
Gangplank,Zac,70,40,30,57.14
Gangplank,Zoe,63,43,20,68.25
Gangplank,Pyke,91,48,43,52.75
Gangplank,Sona,21,3,18,14.29
Gangplank,Ambessa,86,42,44,48.84
Gangplank,DrMundo,44,12,32,27.27
Gangplank,Galio,210,81,129,38.57
Gangplank,Trundle,48,20,28,41.67
Gangplank,RekSai,32,17,15,53.13
Gangplank,Janna,41,14,27,34.15
Gangplank,Ornn,72,24,48,33.33
Gangplank,Garen,178,71,107,39.89
Gangplank,Nilah,28,17,11,60.71
Gangplank,Kennen,54,23,31,42.59
Gangplank,Udyr,52,33,19,63.46
Gangplank,Camille,52,34,18,65.38
Gangplank,Skarner,83,33,50,39.76
Gangplank,Illaoi,38,24,14,63.16
Gangplank,Velkoz,60,37,23,61.67
Gangplank,KSante,66,33,33,50
Gangplank,Belveth,23,6,17,26.09
Gangplank,Shyvana,26,10,16,38.46
Gangplank,Taric,31,9,22,29.03
Gangplank,Zeri,55,31,24,56.36
Gangplank,Heimerdinger,49,12,37,24.49
Gangplank,Kindred,44,23,21,52.27
Gangplank,Nidalee,42,29,13,69.05
Gangplank,Karthus,28,12,16,42.86
Gangplank,AurelionSol,43,21,22,48.84
Gangplank,TwistedFate,39,24,15,61.54
Gangplank,Rengar,29,19,10,65.52
Gangplank,Renata,27,15,12,55.56
Gangplank,Annie,50,24,26,48
Gangplank,Ivern,25,8,17,32
Gangplank,Fiora,52,24,28,46.15
Gangplank,Azir,57,21,36,36.84
Gangplank,Rammus,20,9,11,45
Irelia,Urgot,96,53,43,55.21
Irelia,Diana,278,137,141,49.28
Irelia,Syndra,99,48,51,48.48
Irelia,MissFortune,293,141,152,48.12
Irelia,Braum,154,70,84,45.45
Irelia,Chogath,167,68,99,40.72
Irelia,MonkeyKing,127,67,60,52.76
Irelia,Veigar,168,66,102,39.29
Irelia,Caitlyn,409,202,207,49.39
Irelia,Mel,418,231,187,55.26
Irelia,Akali,220,123,97,55.91
Irelia,Nunu,98,46,52,46.94
Irelia,Lux,331,160,171,48.34
Irelia,Tristana,127,50,77,39.37
Irelia,Nautilus,196,97,99,49.49
Irelia,Teemo,161,76,85,47.2
Irelia,Amumu,210,96,114,45.71
Irelia,Lissandra,58,27,31,46.55
Irelia,Lucian,149,85,64,57.05
Irelia,Xerath,156,94,62,60.26
Irelia,Malphite,212,87,125,41.04
Irelia,Khazix,88,42,46,47.73
Irelia,Galio,199,85,114,42.71
Irelia,Smolder,105,63,42,60
Irelia,Thresh,340,174,166,51.18
Irelia,Singed,42,23,19,54.76
Irelia,Darius,301,138,163,45.85
Irelia,Pantheon,344,187,157,54.36
Irelia,XinZhao,95,29,66,30.53
Irelia,Kaisa,324,167,157,51.54
Irelia,Jhin,258,111,147,43.02
Irelia,Morgana,153,57,96,37.25
Irelia,Shen,103,25,78,24.27
Irelia,Viego,214,84,130,39.25
Irelia,Corki,64,28,36,43.75
Irelia,TahmKench,120,58,62,48.33
Irelia,Aatrox,135,52,83,38.52
Irelia,Aurora,140,72,68,51.43
Irelia,Sivir,84,32,52,38.1
Irelia,Blitzcrank,154,85,69,55.19
Irelia,Vladimir,125,74,51,59.2
Irelia,Ashe,391,186,205,47.57
Irelia,Rell,107,59,48,55.14
Irelia,Poppy,155,64,91,41.29
Irelia,Yone,338,154,184,45.56
Irelia,Jinx,419,169,250,40.33
Irelia,Gragas,156,73,83,46.79
Irelia,MasterYi,160,91,69,56.88
Irelia,Zyra,115,51,64,44.35
Irelia,Ambessa,119,63,56,52.94
Irelia,Ryze,92,37,55,40.22
Irelia,LeeSin,295,151,144,51.19
Irelia,Renekton,93,35,58,37.63
Irelia,Elise,103,49,54,47.57
Irelia,Zed,165,78,87,47.27
Irelia,Milio,96,54,42,56.25
Irelia,Mordekaiser,220,114,106,51.82
Irelia,Kayn,229,134,95,58.52
Irelia,Ekko,102,55,47,53.92
Irelia,Nami,147,55,92,37.41
Irelia,Yasuo,333,136,197,40.84
Irelia,Xayah,119,65,54,54.62
Irelia,DrMundo,101,55,46,54.46
Irelia,Zeri,66,41,25,62.12
Irelia,Lulu,275,144,131,52.36
Irelia,Garen,208,76,132,36.54
Irelia,Rammus,90,34,56,37.78
Irelia,Kayle,114,54,60,47.37
Irelia,Jax,174,82,92,47.13
Irelia,Warwick,223,116,107,52.02
Irelia,Graves,105,39,66,37.14
Irelia,Azir,74,42,32,56.76
Irelia,Gnar,147,78,69,53.06
Irelia,Volibear,185,90,95,48.65
Irelia,Shaco,146,71,75,48.63
Irelia,Ahri,217,113,104,52.07
Irelia,Vayne,182,108,74,59.34
Irelia,Rakan,84,43,41,51.19
Irelia,Draven,106,52,54,49.06
Irelia,Sett,199,79,120,39.7
Irelia,Ezreal,430,208,222,48.37
Irelia,Yorick,146,70,76,47.95
Irelia,Briar,86,45,41,52.33
Irelia,Sylas,288,123,165,42.71
Irelia,Seraphine,119,50,69,42.02
Irelia,Fiora,71,38,33,53.52
Irelia,Rengar,47,22,25,46.81
Irelia,Nilah,44,20,24,45.45
Irelia,Kindred,74,38,36,51.35
Irelia,Sejuani,120,34,86,28.33
Irelia,Varus,182,80,102,43.96
Irelia,Illaoi,99,44,55,44.44
Irelia,Ziggs,53,24,29,45.28
Irelia,Sona,34,15,19,44.12
Irelia,Jayce,130,60,70,46.15
Irelia,Leona,147,85,62,57.82
Irelia,Taliyah,40,24,16,60
Irelia,Vi,209,83,126,39.71
Irelia,Twitch,108,44,64,40.74
Irelia,Renata,74,42,32,56.76
Irelia,Samira,102,48,54,47.06
Irelia,Bard,38,11,27,28.95
Irelia,JarvanIV,117,54,63,46.15
Irelia,Soraka,64,26,38,40.63
Irelia,Swain,165,70,95,42.42
Irelia,Evelynn,51,21,30,41.18
Irelia,Karma,225,84,141,37.33
Irelia,Camille,36,22,14,61.11
Irelia,FiddleSticks,67,23,44,34.33
Irelia,Zilean,47,19,28,40.43
Irelia,Gwen,67,33,34,49.25
Irelia,Rumble,47,31,16,65.96
Irelia,Lillia,89,54,35,60.67
Irelia,Senna,88,34,54,38.64
Irelia,Belveth,39,17,22,43.59
Irelia,Malzahar,187,94,93,50.27
Irelia,Neeko,79,42,37,53.16
Irelia,Zac,70,28,42,40
Irelia,Fizz,82,45,37,54.88
Irelia,Viktor,148,65,83,43.92
Irelia,Nidalee,57,38,19,66.67
Irelia,Janna,63,35,28,55.56
Irelia,Udyr,53,23,30,43.4
Irelia,Brand,73,38,35,52.05
Irelia,Taric,54,25,29,46.3
Irelia,Kennen,64,27,37,42.19
Irelia,Ornn,91,47,44,51.65
Irelia,Skarner,99,47,52,47.47
Irelia,Nocturne,181,91,90,50.28
Irelia,Sion,112,62,50,55.36
Irelia,AurelionSol,51,18,33,35.29
Irelia,Cassiopeia,35,20,15,57.14
Irelia,Pyke,145,71,74,48.97
Irelia,Olaf,32,14,18,43.75
Irelia,Aphelios,120,68,52,56.67
Irelia,TwistedFate,48,35,13,72.92
Irelia,Leblanc,99,43,56,43.43
Irelia,Katarina,95,34,61,35.79
Irelia,Gangplank,116,52,64,44.83
Irelia,Karthus,34,23,11,67.65
Irelia,Alistar,91,41,50,45.05
Irelia,Quinn,55,26,29,47.27
Irelia,Naafiri,38,24,14,63.16
Irelia,KSante,112,55,57,49.11
Irelia,Kalista,42,25,17,59.52
Irelia,Riven,51,21,30,41.18
Irelia,Vex,97,47,50,48.45
Irelia,Anivia,70,40,30,57.14
Irelia,Orianna,84,47,37,55.95
Irelia,Yuumi,132,51,81,38.64
Irelia,Hecarim,48,18,30,37.5
Irelia,Velkoz,86,29,57,33.72
Irelia,Talon,83,43,40,51.81
Irelia,KogMaw,38,14,24,36.84
Irelia,Hwei,106,51,55,48.11
Irelia,Annie,41,25,16,60.98
Irelia,Zoe,53,31,22,58.49
Irelia,Trundle,78,28,50,35.9
Irelia,Heimerdinger,87,50,37,57.47
Irelia,Akshan,30,7,23,23.33
Irelia,Shyvana,34,14,20,41.18
Irelia,Nasus,49,23,26,46.94
Irelia,Maokai,65,37,28,56.92
Irelia,Kled,22,14,8,63.64
Irelia,Ivern,22,13,9,59.09
Irelia,Tryndamere,64,38,26,59.38
Irelia,RekSai,12,6,6,50
Irelia,Qiyana,17,8,9,47.06
Irelia,Kassadin,32,13,19,40.63
Kaisa,Urgot,203,103,100,50.74
Kaisa,Diana,642,287,355,44.7
Kaisa,Syndra,262,135,127,51.53
Kaisa,MissFortune,725,374,351,51.59
Kaisa,Braum,352,159,193,45.17
Kaisa,Ambessa,353,177,176,50.14
Kaisa,Gragas,247,99,148,40.08
Kaisa,Pantheon,613,303,310,49.43
Kaisa,Samira,260,132,128,50.77
Kaisa,Hwei,277,143,134,51.62
Kaisa,Yorick,253,90,163,35.57
Kaisa,Viego,543,270,273,49.72
Kaisa,AurelionSol,144,56,88,38.89
Kaisa,Ashe,836,393,443,47.01
Kaisa,Milio,226,100,126,44.25
Kaisa,Gnar,199,83,116,41.71
Kaisa,Evelynn,139,81,58,58.27
Kaisa,Malphite,422,178,244,42.18
Kaisa,Lucian,361,188,173,52.08
Kaisa,Mel,797,400,397,50.19
Kaisa,Illaoi,193,89,104,46.11
Kaisa,Briar,191,95,96,49.74
Kaisa,Taliyah,103,52,51,50.49
Kaisa,Twitch,267,160,107,59.93
Kaisa,Morgana,344,156,188,45.35
Kaisa,Jax,315,164,151,52.06
Kaisa,RekSai,41,12,29,29.27
Kaisa,Xayah,381,168,213,44.09
Kaisa,Rakan,250,107,143,42.8
Kaisa,Cassiopeia,99,52,47,52.53
Kaisa,Swain,318,117,201,36.79
Kaisa,Volibear,349,182,167,52.15
Kaisa,Lissandra,170,59,111,34.71
Kaisa,Kalista,113,59,54,52.21
Kaisa,Rell,237,120,117,50.63
Kaisa,Nunu,213,93,120,43.66
Kaisa,Nautilus,421,169,252,40.14
Kaisa,Darius,746,386,360,51.74
Kaisa,XinZhao,302,165,137,54.64
Kaisa,Malzahar,377,178,199,47.21
Kaisa,Vayne,598,283,315,47.32
Kaisa,Aurora,316,161,155,50.95
Kaisa,Corki,225,139,86,61.78
Kaisa,Sejuani,265,126,139,47.55
Kaisa,Leblanc,236,101,135,42.8
Kaisa,Nilah,148,56,92,37.84
Kaisa,Karma,481,236,245,49.06
Kaisa,TahmKench,319,160,159,50.16
Kaisa,JarvanIV,328,145,183,44.21
Kaisa,Veigar,349,163,186,46.7
Kaisa,Yasuo,782,367,415,46.93
Kaisa,Irelia,324,157,167,48.46
Kaisa,MonkeyKing,275,123,152,44.73
Kaisa,Thresh,788,406,382,51.52
Kaisa,MasterYi,354,156,198,44.07
Kaisa,Shaco,272,136,136,50
Kaisa,Lux,810,410,400,50.62
Kaisa,Lulu,704,344,360,48.86
Kaisa,Olaf,93,49,44,52.69
Kaisa,Vi,447,231,216,51.68
Kaisa,Katarina,220,111,109,50.45
Kaisa,Bard,118,63,55,53.39
Kaisa,Sett,496,254,242,51.21
Kaisa,Jhin,647,353,294,54.56
Kaisa,Yuumi,398,197,201,49.5
Kaisa,Chogath,475,221,254,46.53
Kaisa,Sivir,237,102,135,43.04
Kaisa,Ryze,127,69,58,54.33
Kaisa,Senna,214,103,111,48.13
Kaisa,LeeSin,775,398,377,51.35
Kaisa,Viktor,349,188,161,53.87
Kaisa,Caitlyn,829,364,465,43.91
Kaisa,Akali,391,226,165,57.8
Kaisa,Kled,83,54,29,65.06
Kaisa,Kayn,455,229,226,50.33
Kaisa,Qiyana,99,53,46,53.54
Kaisa,Maokai,178,89,89,50
Kaisa,Anivia,176,64,112,36.36
Kaisa,Warwick,404,177,227,43.81
Kaisa,Graves,325,164,161,50.46
Kaisa,Azir,192,113,79,58.85
Kaisa,Nami,372,186,186,50
Kaisa,Jayce,191,94,97,49.21
Kaisa,Zed,425,234,191,55.06
Kaisa,Jinx,1131,506,625,44.74
Kaisa,Gwen,194,98,96,50.52
Kaisa,Ezreal,1320,680,640,51.52
Kaisa,Sion,287,95,192,33.1
Kaisa,Elise,346,155,191,44.8
Kaisa,Leona,383,168,215,43.86
Kaisa,Riven,171,78,93,45.61
Kaisa,Poppy,316,148,168,46.84
Kaisa,Trundle,170,80,90,47.06
Kaisa,Vex,247,92,155,37.25
Kaisa,Seraphine,267,140,127,52.43
Kaisa,Heimerdinger,123,50,73,40.65
Kaisa,Yone,699,351,348,50.21
Kaisa,Karthus,111,48,63,43.24
Kaisa,Galio,517,249,268,48.16
Kaisa,Tristana,377,186,191,49.34
Kaisa,Brand,178,78,100,43.82
Kaisa,Ornn,229,106,123,46.29
Kaisa,Khazix,203,88,115,43.35
Kaisa,Rammus,130,57,73,43.85
Kaisa,Orianna,205,108,97,52.68
Kaisa,Alistar,232,101,131,43.53
Kaisa,Amumu,385,162,223,42.08
Kaisa,Naafiri,104,52,52,50
Kaisa,FiddleSticks,158,74,84,46.84
Kaisa,Quinn,143,68,75,47.55
Kaisa,Garen,587,243,344,41.4
Kaisa,Zac,321,153,168,47.66
Kaisa,Akshan,105,45,60,42.86
Kaisa,Aatrox,475,230,245,48.42
Kaisa,Teemo,318,126,192,39.62
Kaisa,Fizz,150,71,79,47.33
Kaisa,Vladimir,214,87,127,40.65
Kaisa,Varus,374,166,208,44.39
Kaisa,Sylas,632,299,333,47.31
Kaisa,Smolder,255,124,131,48.63
Kaisa,Draven,156,82,74,52.56
Kaisa,Renekton,217,90,127,41.47
Kaisa,Rengar,74,45,29,60.81
Kaisa,TwistedFate,123,54,69,43.9
Kaisa,Ivern,85,51,34,60
Kaisa,Aphelios,233,118,115,50.64
Kaisa,Mordekaiser,443,214,229,48.31
Kaisa,Talon,175,82,93,46.86
Kaisa,Kayle,173,77,96,44.51
Kaisa,Camille,144,62,82,43.06
Kaisa,Blitzcrank,333,169,164,50.75
Kaisa,DrMundo,201,105,96,52.24
Kaisa,Gangplank,188,101,87,53.72
Kaisa,Ahri,539,253,286,46.94
Kaisa,Rumble,124,68,56,54.84
Kaisa,Lillia,198,92,106,46.46
Kaisa,Nasus,229,113,116,49.34
Kaisa,Zoe,194,108,86,55.67
Kaisa,Pyke,364,228,136,62.64
Kaisa,Janna,96,38,58,39.58
Kaisa,Singed,101,44,57,43.56
Kaisa,Kindred,146,78,68,53.42
Kaisa,Ekko,248,126,122,50.81
Kaisa,Neeko,142,56,86,39.44
Kaisa,Skarner,213,84,129,39.44
Kaisa,Shen,335,158,177,47.16
Kaisa,Nocturne,505,256,249,50.69
Kaisa,Velkoz,194,93,101,47.94
Kaisa,Nidalee,171,111,60,64.91
Kaisa,Fiora,142,78,64,54.93
Kaisa,KSante,278,160,118,57.55
Kaisa,Shyvana,79,37,42,46.84
Kaisa,Hecarim,126,72,54,57.14
Kaisa,Ziggs,125,50,75,40
Kaisa,Kennen,126,63,63,50
Kaisa,Renata,96,50,46,52.08
Kaisa,Udyr,140,66,74,47.14
Kaisa,Xerath,340,162,178,47.65
Kaisa,Sona,68,26,42,38.24
Kaisa,Soraka,179,89,90,49.72
Kaisa,Kassadin,66,26,40,39.39
Kaisa,Belveth,68,33,35,48.53
Kaisa,Tryndamere,154,74,80,48.05
Kaisa,Annie,113,46,67,40.71
Kaisa,Zilean,99,38,61,38.38
Kaisa,Zeri,235,112,123,47.66
Kaisa,Zyra,272,140,132,51.47
Kaisa,KogMaw,147,50,97,34.01
Kaisa,Taric,87,36,51,41.38
Nautilus,Urgot,173,79,94,45.66
Nautilus,Diana,508,276,232,54.33
Nautilus,Syndra,213,123,90,57.75
Nautilus,MissFortune,568,270,298,47.54
Nautilus,Braum,352,170,182,48.3
Nautilus,Garen,504,282,222,55.95
Nautilus,MonkeyKing,244,116,128,47.54
Nautilus,Lux,748,417,331,55.75
Nautilus,Nilah,107,56,51,52.34
Nautilus,Lulu,454,216,238,47.58
Nautilus,Irelia,196,99,97,50.51
Nautilus,LeeSin,554,281,273,50.72
Nautilus,Zed,283,159,124,56.18
Nautilus,Caitlyn,746,383,363,51.34
Nautilus,Morgana,347,190,157,54.76
Nautilus,Ornn,181,82,99,45.3
Nautilus,Kindred,137,86,51,62.77
Nautilus,Talon,141,79,62,56.03
Nautilus,Samira,240,137,103,57.08
Nautilus,Ashe,683,377,306,55.2
Nautilus,Skarner,174,68,106,39.08
Nautilus,Aurora,235,139,96,59.15
Nautilus,Ezreal,836,401,435,47.97
Nautilus,Yuumi,294,123,171,41.84
Nautilus,Malphite,350,197,153,56.29
Nautilus,Khazix,169,97,72,57.4
Nautilus,Galio,416,206,210,49.52
Nautilus,Smolder,235,119,116,50.64
Nautilus,Thresh,629,330,299,52.46
Nautilus,MasterYi,296,165,131,55.74
Nautilus,Warwick,417,186,231,44.6
Nautilus,Kassadin,40,25,15,62.5
Nautilus,Kaisa,421,252,169,59.86
Nautilus,Pyke,288,145,143,50.35
Nautilus,Karma,385,185,200,48.05
Nautilus,Malzahar,348,146,202,41.95
Nautilus,Aatrox,293,140,153,47.78
Nautilus,Sejuani,201,118,83,58.71
Nautilus,Blitzcrank,361,184,177,50.97
Nautilus,Trundle,152,76,76,50
Nautilus,RekSai,29,11,18,37.93
Nautilus,Leblanc,179,82,97,45.81
Nautilus,Darius,546,252,294,46.15
Nautilus,Poppy,312,154,158,49.36
Nautilus,Ekko,210,102,108,48.57
Nautilus,Mel,648,337,311,52.01
Nautilus,Sett,449,206,243,45.88
Nautilus,Lucian,239,119,120,49.79
Nautilus,Ivern,75,41,34,54.67
Nautilus,Orianna,202,94,108,46.53
Nautilus,Twitch,250,114,136,45.6
Nautilus,Pantheon,522,271,251,51.92
Nautilus,Kayn,362,159,203,43.92
Nautilus,Sylas,483,236,247,48.86
Nautilus,Fizz,143,59,84,41.26
Nautilus,Jinx,800,328,472,41
Nautilus,Nasus,206,91,115,44.17
Nautilus,Vi,353,186,167,52.69
Nautilus,Xayah,243,104,139,42.8
Nautilus,Maokai,151,76,75,50.33
Nautilus,Graves,264,123,141,46.59
Nautilus,Xerath,282,121,161,42.91
Nautilus,Draven,198,109,89,55.05
Nautilus,Riven,136,73,63,53.68
Nautilus,Yone,472,272,200,57.63
Nautilus,Gnar,156,83,73,53.21
Nautilus,Yorick,251,112,139,44.62
Nautilus,Nidalee,116,80,36,68.97
Nautilus,Rell,300,150,150,50
Nautilus,Olaf,106,47,59,44.34
Nautilus,Zoe,110,64,46,58.18
Nautilus,Zyra,251,109,142,43.43
Nautilus,Heimerdinger,136,81,55,59.56
Nautilus,Zilean,98,52,46,53.06
Nautilus,Brand,179,83,96,46.37
Nautilus,Fiora,126,73,53,57.94
Nautilus,Zac,210,98,112,46.67
Nautilus,Hwei,234,99,135,42.31
Nautilus,Sion,294,137,157,46.6
Nautilus,Rakan,182,90,92,49.45
Nautilus,Kled,43,13,30,30.23
Nautilus,Briar,198,100,98,50.51
Nautilus,Velkoz,139,79,60,56.83
Nautilus,KSante,247,130,117,52.63
Nautilus,Viego,421,195,226,46.32
Nautilus,JarvanIV,284,112,172,39.44
Nautilus,KogMaw,87,41,46,47.13
Nautilus,Elise,221,106,115,47.96
Nautilus,Ambessa,280,148,132,52.86
Nautilus,Chogath,357,168,189,47.06
Nautilus,Sona,38,12,26,31.58
Nautilus,Annie,105,58,47,55.24
Nautilus,Ziggs,128,64,64,50
Nautilus,Azir,150,71,79,47.33
Nautilus,Milio,207,105,102,50.72
Nautilus,Shen,231,105,126,45.45
Nautilus,Shaco,198,96,102,48.48
Nautilus,Gwen,175,81,94,46.29
Nautilus,Illaoi,162,96,66,59.26
Nautilus,XinZhao,265,132,133,49.81
Nautilus,Akali,303,148,155,48.84
Nautilus,Hecarim,108,56,52,51.85
Nautilus,Tristana,266,154,112,57.89
Nautilus,Jax,247,139,108,56.28
Nautilus,Volibear,312,156,156,50
Nautilus,Gangplank,160,92,68,57.5
Nautilus,Swain,323,113,210,34.98
Nautilus,AurelionSol,99,37,62,37.37
Nautilus,Nami,278,101,177,36.33
Nautilus,FiddleSticks,117,49,68,41.88
Nautilus,Vex,182,77,105,42.31
Nautilus,Kayle,171,86,85,50.29
Nautilus,Nunu,190,125,65,65.79
Nautilus,Yasuo,610,310,300,50.82
Nautilus,Alistar,223,105,118,47.09
Nautilus,Vladimir,205,116,89,56.59
Nautilus,Lissandra,115,37,78,32.17
Nautilus,Soraka,125,78,47,62.4
Nautilus,Viktor,333,159,174,47.75
Nautilus,Jhin,561,289,272,51.52
Nautilus,Amumu,396,201,195,50.76
Nautilus,DrMundo,156,69,87,44.23
Nautilus,Nocturne,363,157,206,43.25
Nautilus,Rammus,111,53,58,47.75
Nautilus,Karthus,65,30,35,46.15
Nautilus,Teemo,273,148,125,54.21
Nautilus,Cassiopeia,106,50,56,47.17
Nautilus,Varus,320,147,173,45.94
Nautilus,Mordekaiser,411,184,227,44.77
Nautilus,Katarina,153,77,76,50.33
Nautilus,Corki,186,100,86,53.76
Nautilus,Janna,95,54,41,56.84
Nautilus,Evelynn,86,43,43,50
Nautilus,Ahri,447,222,225,49.66
Nautilus,TwistedFate,117,44,73,37.61
Nautilus,Quinn,85,47,38,55.29
Nautilus,TahmKench,303,152,151,50.17
Nautilus,Lillia,199,103,96,51.76
Nautilus,Sivir,212,89,123,41.98
Nautilus,Senna,153,72,81,47.06
Nautilus,Anivia,133,43,90,32.33
Nautilus,Vayne,420,202,218,48.1
Nautilus,Veigar,285,161,124,56.49
Nautilus,Bard,93,42,51,45.16
Nautilus,Kennen,84,50,34,59.52
Nautilus,Qiyana,67,39,28,58.21
Nautilus,Jayce,143,65,78,45.45
Nautilus,Rumble,112,55,57,49.11
Nautilus,Gragas,230,118,112,51.3
Nautilus,Leona,385,200,185,51.95
Nautilus,Shyvana,56,24,32,42.86
Nautilus,Kalista,98,43,55,43.88
Nautilus,Taric,96,47,49,48.96
Nautilus,Taliyah,124,66,58,53.23
Nautilus,Zeri,139,63,76,45.32
Nautilus,Rengar,60,36,24,60
Nautilus,Seraphine,216,126,90,58.33
Nautilus,Neeko,132,68,64,51.52
Nautilus,Akshan,98,70,28,71.43
Nautilus,Ryze,108,53,55,49.07
Nautilus,Singed,82,44,38,53.66
Nautilus,Aphelios,142,59,83,41.55
Nautilus,Renata,95,44,51,46.32
Nautilus,Camille,127,66,61,51.97
Nautilus,Udyr,121,70,51,57.85
Nautilus,Naafiri,69,36,33,52.17
Nautilus,Renekton,170,82,88,48.24
Nautilus,Tryndamere,91,50,41,54.95
Nautilus,Belveth,56,29,27,51.79
Urgot,Gangplank,59,30,29,50.85
Urgot,Volibear,108,58,50,53.7
Urgot,Irelia,96,43,53,44.79
Urgot,Kaisa,203,100,103,49.26
Urgot,Nautilus,173,94,79,54.34
Urgot,Yorick,109,50,59,45.87
Urgot,Viego,108,55,53,50.93
Urgot,AurelionSol,42,21,21,50
Urgot,Ashe,169,83,86,49.11
Urgot,Milio,63,25,38,39.68
Urgot,Ambessa,50,25,25,50
Urgot,Graves,52,23,29,44.23
Urgot,Ahri,201,107,94,53.23
Urgot,Rakan,62,27,35,43.55
Urgot,Cassiopeia,27,13,14,48.15
Urgot,Gragas,61,27,34,44.26
Urgot,Yone,184,86,98,46.74
Urgot,TahmKench,141,71,70,50.35
Urgot,Heimerdinger,38,30,8,78.95
Urgot,Teemo,111,42,69,37.84
Urgot,Ezreal,229,131,98,57.21
Urgot,Caitlyn,305,169,136,55.41
Urgot,Sona,17,12,5,70.59
Urgot,Sett,169,86,83,50.89
Urgot,Nunu,89,35,54,39.33
Urgot,Lux,217,108,109,49.77
Urgot,Mordekaiser,142,71,71,50
Urgot,Ryze,23,12,11,52.17
Urgot,Smolder,113,57,56,50.44
Urgot,Yuumi,64,14,50,21.88
Urgot,Darius,251,121,130,48.21
Urgot,LeeSin,176,102,74,57.95
Urgot,Veigar,112,51,61,45.54
Urgot,Shen,81,46,35,56.79
Urgot,Diana,164,71,93,43.29
Urgot,Nasus,87,44,43,50.57
Urgot,Riven,66,29,37,43.94
Urgot,Seraphine,81,46,35,56.79
Urgot,Samira,60,35,25,58.33
Urgot,Hwei,79,47,32,59.49
Urgot,Kayle,49,20,29,40.82
Urgot,Khazix,56,42,14,75
Urgot,Mel,209,96,113,45.93
Urgot,Lulu,124,53,71,42.74
Urgot,Brand,73,43,30,58.9
Urgot,Trundle,53,20,33,37.74
Urgot,Briar,51,19,32,37.25
Urgot,Vex,60,33,27,55
Urgot,MissFortune,234,112,122,47.86
Urgot,Rell,88,37,51,42.05
Urgot,Udyr,39,22,17,56.41
Urgot,Aurora,107,45,62,42.06
Urgot,Malphite,139,65,74,46.76
Urgot,Jhin,217,127,90,58.53
Urgot,Gwen,61,21,40,34.43
Urgot,Shaco,58,21,37,36.21
Urgot,Poppy,74,36,38,48.65
Urgot,Katarina,93,63,30,67.74
Urgot,KogMaw,50,25,25,50
Urgot,Blitzcrank,99,51,48,51.52
Urgot,KSante,81,43,38,53.09
Urgot,Warwick,151,87,64,57.62
Urgot,Orianna,63,28,35,44.44
Urgot,Nami,143,58,85,40.56
Urgot,Skarner,47,29,18,61.7
Urgot,Varus,112,56,56,50
Urgot,Neeko,46,21,25,45.65
Urgot,Jinx,269,67,202,24.91
Urgot,Swain,114,52,62,45.61
Urgot,Amumu,108,47,61,43.52
Urgot,Naafiri,40,21,19,52.5
Urgot,Zyra,86,40,46,46.51
Urgot,Vi,119,32,87,26.89
Urgot,Lucian,80,36,44,45
Urgot,Akali,104,36,68,34.62
Urgot,Ornn,74,30,44,40.54
Urgot,Aatrox,133,69,64,51.88
Urgot,Kayn,126,56,70,44.44
Urgot,Karma,150,73,77,48.67
Urgot,Taric,34,20,14,58.82
Urgot,Qiyana,32,20,12,62.5
Urgot,Yasuo,168,76,92,45.24
Urgot,Elise,102,44,58,43.14
Urgot,Garen,182,68,114,37.36
Urgot,Braum,74,24,50,32.43
Urgot,Sylas,110,46,64,41.82
Urgot,Sivir,46,18,28,39.13
Urgot,Taliyah,36,17,19,47.22
Urgot,Pantheon,181,85,96,46.96
Urgot,Chogath,150,65,85,43.33
Urgot,Zac,76,28,48,36.84
Urgot,Tryndamere,45,21,24,46.67
Urgot,Vladimir,41,17,24,41.46
Urgot,Shyvana,30,15,15,50
Urgot,Draven,55,22,33,40
Urgot,Gnar,53,28,25,52.83
Urgot,Thresh,162,82,80,50.62
Urgot,Nocturne,146,82,64,56.16
Urgot,TwistedFate,30,14,16,46.67
Urgot,Ziggs,52,18,34,34.62
Urgot,Renata,34,17,17,50
Urgot,JarvanIV,85,38,47,44.71
Urgot,Viktor,107,62,45,57.94
Urgot,Renekton,53,36,17,67.92
Urgot,Vayne,158,65,93,41.14
Urgot,Sion,96,41,55,42.71
Urgot,Malzahar,129,57,72,44.19
Urgot,Janna,32,9,23,28.13
Urgot,Olaf,18,7,11,38.89
Urgot,Zeri,36,22,14,61.11
Urgot,Nidalee,42,30,12,71.43
Urgot,Alistar,84,48,36,57.14
Urgot,Zilean,37,21,16,56.76
Urgot,Camille,48,35,13,72.92
Urgot,Tristana,104,61,43,58.65
Urgot,Karthus,24,13,11,54.17
Urgot,Rammus,73,44,29,60.27
Urgot,Kassadin,19,14,5,73.68
Urgot,Twitch,94,50,44,53.19
Urgot,Jax,98,55,43,56.12
Urgot,Evelynn,56,24,32,42.86
Urgot,Leblanc,77,40,37,51.95
Urgot,Rumble,36,20,16,55.56
Urgot,XinZhao,75,39,36,52
Urgot,Fizz,49,32,17,65.31
Urgot,Pyke,89,52,37,58.43
Urgot,Zed,102,72,30,70.59
Urgot,Talon,55,26,29,47.27
Urgot,Azir,44,21,23,47.73
Urgot,Ekko,71,39,32,54.93
Urgot,Bard,30,21,9,70
Urgot,MasterYi,126,58,68,46.03
Urgot,Akshan,49,22,27,44.9
Urgot,Soraka,59,28,31,47.46
Urgot,Morgana,108,48,60,44.44
Urgot,Illaoi,67,31,36,46.27
Urgot,Quinn,52,35,17,67.31
Urgot,Xerath,112,57,55,50.89
Urgot,Syndra,103,58,45,56.31
Urgot,MonkeyKing,62,24,38,38.71
Urgot,Anivia,44,21,23,47.73
Urgot,Corki,67,25,42,37.31
Urgot,Leona,111,56,55,50.45
Urgot,Senna,51,32,19,62.75
Urgot,Sejuani,66,39,27,59.09
Urgot,Galio,125,56,69,44.8
Urgot,DrMundo,55,28,27,50.91
Urgot,Fiora,31,26,5,83.87
Urgot,Lillia,72,40,32,55.56
Urgot,Belveth,15,15,0,100
Urgot,Kalista,26,18,8,69.23
Urgot,Xayah,58,23,35,39.66
Urgot,Aphelios,60,30,30,50
Urgot,Velkoz,77,43,34,55.84
Urgot,Nilah,40,21,19,52.5
Urgot,FiddleSticks,42,28,14,66.67
Urgot,Hecarim,50,33,17,66
Urgot,Rengar,32,17,15,53.13
Urgot,Jayce,48,18,30,37.5
Urgot,Maokai,49,20,29,40.82
Urgot,Kennen,26,12,14,46.15
Urgot,Lissandra,27,11,16,40.74
Urgot,Annie,43,11,32,25.58
Urgot,Kled,19,4,15,21.05
Urgot,Singed,27,17,10,62.96
Urgot,RekSai,15,10,5,66.67
Urgot,Kindred,52,29,23,55.77
Urgot,Zoe,33,10,23,30.3
Urgot,Ivern,14,11,3,78.57
Diana,Gangplank,192,80,112,41.67
Diana,Volibear,372,167,205,44.89
Diana,Irelia,278,141,137,50.72
Diana,Kaisa,642,355,287,55.3
Diana,Nautilus,508,232,276,45.67
Diana,Garen,493,249,244,50.51
Diana,Zed,335,186,149,55.52
Diana,Mel,709,388,321,54.72
Diana,Caitlyn,780,397,383,50.9
Diana,Morgana,304,155,149,50.99
Diana,Akali,359,168,191,46.8
Diana,LeeSin,669,333,336,49.78
Diana,Yasuo,633,270,363,42.65
Diana,Hwei,210,114,96,54.29
Diana,Pyke,280,141,139,50.36
Diana,Amumu,395,185,210,46.84
Diana,Riven,149,94,55,63.09
Diana,Lux,802,433,369,53.99
Diana,Vladimir,223,94,129,42.15
Diana,MasterYi,308,157,151,50.97
Diana,Leona,308,179,129,58.12
Diana,Ashe,632,318,314,50.32
Diana,Mordekaiser,454,206,248,45.37
Diana,Gragas,295,174,121,58.98
Diana,Viego,466,247,219,53
Diana,Xayah,214,94,120,43.93
Diana,Lucian,287,140,147,48.78
Diana,Rell,216,99,117,45.83
Diana,Shen,235,124,111,52.77
Diana,Shaco,295,160,135,54.24
Diana,Heimerdinger,149,74,75,49.66
Diana,Ezreal,1010,503,507,49.8
Diana,Thresh,601,287,314,47.75
Diana,Yone,666,325,341,48.8
Diana,Varus,288,158,130,54.86
Diana,Karma,360,174,186,48.33
Diana,Darius,668,334,334,50
Diana,Teemo,326,166,160,50.92
Diana,Nilah,93,48,45,51.61
Diana,Braum,293,114,179,38.91
Diana,Illaoi,170,77,93,45.29
Diana,Pantheon,601,310,291,51.58
Diana,Vex,217,78,139,35.94
Diana,TahmKench,333,171,162,51.35
Diana,Rengar,86,53,33,61.63
Diana,Chogath,422,205,217,48.58
Diana,Zyra,306,151,155,49.35
Diana,Hecarim,106,52,54,49.06
Diana,Sett,475,228,247,48
Diana,Lulu,525,259,266,49.33
Diana,Lillia,190,93,97,48.95
Diana,Camille,164,74,90,45.12
Diana,Draven,202,87,115,43.07
Diana,Senna,195,95,100,48.72
Diana,MonkeyKing,232,101,131,43.53
Diana,Vayne,454,204,250,44.93
Diana,Fiora,130,67,63,51.54
Diana,Soraka,128,73,55,57.03
Diana,Azir,165,100,65,60.61
Diana,Ekko,250,113,137,45.2
Diana,Qiyana,77,44,33,57.14
Diana,Anivia,148,62,86,41.89
Diana,Jhin,602,340,262,56.48
Diana,Renekton,222,119,103,53.6
Diana,Jax,322,167,155,51.86
Diana,Leblanc,208,87,121,41.83
Diana,Gwen,209,100,109,47.85
Diana,Graves,252,120,132,47.62
Diana,Ziggs,131,81,50,61.83
Diana,Zoe,152,86,66,56.58
Diana,Rammus,126,61,65,48.41
Diana,Kayle,149,59,90,39.6
Diana,Kayn,443,221,222,49.89
Diana,Malphite,393,195,198,49.62
Diana,Jinx,791,350,441,44.25
Diana,Evelynn,143,77,66,53.85
Diana,Brand,201,105,96,52.24
Diana,MissFortune,736,364,372,49.46
Diana,Twitch,263,147,116,55.89
Diana,Gnar,179,99,80,55.31
Diana,Khazix,162,73,89,45.06
Diana,Nami,367,163,204,44.41
Diana,Sylas,592,286,306,48.31
Diana,Samira,206,90,116,43.69
Diana,Poppy,297,142,155,47.81
Diana,Vi,453,225,228,49.67
Diana,Veigar,296,135,161,45.61
Diana,Shyvana,97,29,68,29.9
Diana,Galio,468,211,257,45.09
Diana,Xerath,223,98,125,43.95
Diana,Urgot,164,93,71,56.71
Diana,FiddleSticks,180,76,104,42.22
Diana,Kalista,134,58,76,43.28
Diana,Trundle,153,84,69,54.9
Diana,Tristana,287,146,141,50.87
Diana,Blitzcrank,360,191,169,53.06
Diana,Nidalee,153,86,67,56.21
Diana,Ambessa,291,149,142,51.2
Diana,KogMaw,102,46,56,45.1
Diana,Smolder,290,123,167,42.41
Diana,Seraphine,266,147,119,55.26
Diana,Ornn,185,92,93,49.73
Diana,Sejuani,229,100,129,43.67
Diana,Lissandra,144,81,63,56.25
Diana,Malzahar,374,207,167,55.35
Diana,Milio,207,105,102,50.72
Diana,Swain,328,155,173,47.26
Diana,Velkoz,203,83,120,40.89
Diana,Briar,206,74,132,35.92
Diana,Zac,233,111,122,47.64
Diana,Corki,157,82,75,52.23
Diana,Warwick,412,228,184,55.34
Diana,Orianna,168,102,66,60.71
Diana,Aatrox,362,198,164,54.7
Diana,Maokai,167,72,95,43.11
Diana,Ivern,96,58,38,60.42
Diana,Quinn,96,53,43,55.21
Diana,Nasus,202,83,119,41.09
Diana,Naafiri,106,50,56,47.17
Diana,Ryze,104,57,47,54.81
Diana,Fizz,132,71,61,53.79
Diana,AurelionSol,118,69,49,58.47
Diana,Nunu,222,125,97,56.31
Diana,Alistar,206,103,103,50
Diana,Aurora,282,142,140,50.35
Diana,Nocturne,422,237,185,56.16
Diana,Syndra,266,122,144,45.86
Diana,Aphelios,203,102,101,50.25
Diana,DrMundo,137,69,68,50.36
Diana,Sion,260,134,126,51.54
Diana,Kled,71,37,34,52.11
Diana,Cassiopeia,73,30,43,41.1
Diana,Neeko,144,69,75,47.92
Diana,Rakan,182,91,91,50
Diana,Belveth,51,38,13,74.51
Diana,Ahri,483,266,217,55.07
Diana,Viktor,288,153,135,53.13
Diana,Janna,87,42,45,48.28
Diana,Sivir,158,80,78,50.63
Diana,Kassadin,73,42,31,57.53
Diana,Katarina,184,71,113,38.59
Diana,Yuumi,293,165,128,56.31
Diana,JarvanIV,290,141,149,48.62
Diana,Taric,93,42,51,45.16
Diana,Elise,286,139,147,48.6
Diana,Bard,117,55,62,47.01
Diana,Udyr,129,51,78,39.53
Diana,Jayce,169,82,87,48.52
Diana,Talon,136,81,55,59.56
Diana,Kindred,159,87,72,54.72
Diana,Zeri,182,93,89,51.1
Diana,Sona,50,26,24,52
Diana,Taliyah,96,46,50,47.92
Diana,Renata,86,45,41,52.33
Diana,KSante,280,164,116,58.57
Diana,Yorick,246,132,114,53.66
Diana,Skarner,172,75,97,43.6
Diana,TwistedFate,109,58,51,53.21
Diana,Annie,131,66,65,50.38
Diana,Karthus,79,51,28,64.56
Diana,Akshan,92,49,43,53.26
Diana,Singed,64,25,39,39.06
Diana,Zilean,101,49,52,48.51
Diana,Kennen,93,56,37,60.22
Diana,Rumble,120,51,69,42.5
Diana,XinZhao,295,138,157,46.78
Diana,Olaf,62,30,32,48.39
Diana,Tryndamere,124,61,63,49.19
Diana,RekSai,29,14,15,48.28
Syndra,Gangplank,78,38,40,48.72
Syndra,Volibear,181,77,104,42.54
Syndra,Irelia,99,51,48,51.52
Syndra,Kaisa,262,127,135,48.47
Syndra,Nautilus,213,90,123,42.25
Syndra,Mordekaiser,175,73,102,41.71
Syndra,Viego,229,120,109,52.4
Syndra,Yone,265,109,156,41.13
Syndra,Lucian,158,85,73,53.8
Syndra,Rakan,78,40,38,51.28
Syndra,Singed,35,19,16,54.29
Syndra,Darius,315,157,158,49.84
Syndra,Smolder,110,44,66,40
Syndra,Mel,285,153,132,53.68
Syndra,Pantheon,242,125,117,51.65
Syndra,Jayce,77,36,41,46.75
Syndra,Jhin,317,167,150,52.68
Syndra,JarvanIV,145,62,83,42.76
Syndra,Leblanc,103,55,48,53.4
Syndra,Vladimir,73,21,52,28.77
Syndra,Malzahar,182,87,95,47.8
Syndra,Sion,122,55,67,45.08
Syndra,Nasus,83,28,55,33.73
Syndra,MasterYi,131,83,48,63.36
Syndra,Morgana,147,76,71,51.7
Syndra,Trundle,80,48,32,60
Syndra,Janna,42,28,14,66.67
Syndra,Kayn,184,79,105,42.93
Syndra,Yasuo,232,124,108,53.45
Syndra,Yuumi,157,91,66,57.96
Syndra,Neeko,67,34,33,50.75
Syndra,Rammus,69,36,33,52.17
Syndra,KogMaw,57,30,27,52.63
Syndra,Lux,410,191,219,46.59
Syndra,Riven,67,38,29,56.72
Syndra,Seraphine,107,59,48,55.14
Syndra,Samira,110,50,60,45.45
Syndra,Hwei,166,80,86,48.19
Syndra,Sett,184,78,106,42.39
Syndra,Ivern,54,30,24,55.56
Syndra,Anivia,103,57,46,55.34
Syndra,Jinx,397,186,211,46.85
Syndra,Thresh,303,135,168,44.55
Syndra,Chogath,212,90,122,42.45
Syndra,LeeSin,315,178,137,56.51
Syndra,Lulu,268,127,141,47.39
Syndra,Xayah,101,49,52,48.51
Syndra,Warwick,222,115,107,51.8
Syndra,Swain,137,62,75,45.26
Syndra,Ekko,162,64,98,39.51
Syndra,TahmKench,156,63,93,40.38
Syndra,Ahri,335,171,164,51.04
Syndra,MissFortune,274,139,135,50.73
Syndra,Ambessa,129,74,55,57.36
Syndra,Nocturne,221,112,109,50.68
Syndra,Veigar,154,85,69,55.19
Syndra,Varus,160,78,82,48.75
Syndra,Malphite,189,75,114,39.68
Syndra,Diana,266,144,122,54.14
Syndra,Elise,155,53,102,34.19
Syndra,Aurora,162,82,80,50.62
Syndra,Kalista,94,46,48,48.94
Syndra,Vex,109,37,72,33.94
Syndra,Caitlyn,452,227,225,50.22
Syndra,Garen,252,119,133,47.22
Syndra,Braum,119,51,68,42.86
Syndra,Teemo,136,66,70,48.53
Syndra,Skarner,80,33,47,41.25
Syndra,Cassiopeia,52,20,32,38.46
Syndra,Zac,126,50,76,39.68
Syndra,MonkeyKing,102,36,66,35.29
Syndra,Xerath,161,83,78,51.55
Syndra,Rell,101,55,46,54.46
Syndra,Viktor,192,83,109,43.23
Syndra,Aatrox,166,83,83,50
Syndra,Udyr,59,32,27,54.24
Syndra,Lissandra,43,20,23,46.51
Syndra,Karthus,66,31,35,46.97
Syndra,Alistar,105,57,48,54.29
Syndra,Yorick,128,67,61,52.34
Syndra,Orianna,100,60,40,60
Syndra,Senna,82,23,59,28.05
Syndra,Graves,102,37,65,36.27
Syndra,Kassadin,26,14,12,53.85
Syndra,Aphelios,99,32,67,32.32
Syndra,Blitzcrank,145,54,91,37.24
Syndra,Tristana,121,65,56,53.72
Syndra,Leona,129,55,74,42.64
Syndra,Nilah,55,20,35,36.36
Syndra,Katarina,110,44,66,40
Syndra,Milio,144,77,67,53.47
Syndra,Fiora,55,26,29,47.27
Syndra,Karma,231,94,137,40.69
Syndra,Gwen,74,51,23,68.92
Syndra,Pyke,105,67,38,63.81
Syndra,Vayne,234,111,123,47.44
Syndra,Ezreal,353,176,177,49.86
Syndra,Sona,48,18,30,37.5
Syndra,Ashe,297,152,145,51.18
Syndra,Jax,140,69,71,49.29
Syndra,FiddleSticks,73,39,34,53.42
Syndra,AurelionSol,67,27,40,40.3
Syndra,Kayle,120,50,70,41.67
Syndra,Akali,121,71,50,58.68
Syndra,Zilean,59,32,27,54.24
Syndra,Renekton,75,42,33,56
Syndra,Camille,75,41,34,54.67
Syndra,Nami,193,78,115,40.41
Syndra,Twitch,137,78,59,56.93
Syndra,Nidalee,52,32,20,61.54
Syndra,Naafiri,54,31,23,57.41
Syndra,Draven,70,35,35,50
Syndra,Sejuani,100,43,57,43
Syndra,Lillia,75,37,38,49.33
Syndra,Zoe,76,44,32,57.89
Syndra,Gragas,100,44,56,44
Syndra,Sivir,107,58,49,54.21
Syndra,Qiyana,38,20,18,52.63
Syndra,Galio,212,95,117,44.81
Syndra,Brand,83,45,38,54.22
Syndra,Shyvana,48,15,33,31.25
Syndra,Shen,153,81,72,52.94
Syndra,Fizz,91,48,43,52.75
Syndra,Maokai,92,56,36,60.87
Syndra,Illaoi,60,29,31,48.33
Syndra,Heimerdinger,85,50,35,58.82
Syndra,Gnar,103,63,40,61.17
Syndra,Hecarim,48,16,32,33.33
Syndra,Evelynn,53,25,28,47.17
Syndra,Vi,173,66,107,38.15
Syndra,Urgot,103,45,58,43.69
Syndra,Renata,56,29,27,51.79
Syndra,Kindred,43,29,14,67.44
Syndra,Azir,87,48,39,55.17
Syndra,Taliyah,46,22,24,47.83
Syndra,Akshan,51,25,26,49.02
Syndra,Briar,74,30,44,40.54
Syndra,XinZhao,91,49,42,53.85
Syndra,Sylas,167,63,104,37.72
Syndra,Belveth,17,5,12,29.41
Syndra,Shaco,79,39,40,49.37
Syndra,Ryze,58,26,32,44.83
Syndra,Zyra,116,55,61,47.41
Syndra,Bard,52,31,21,59.62
Syndra,Amumu,127,52,75,40.94
Syndra,Kennen,31,13,18,41.94
Syndra,Quinn,67,34,33,50.75
Syndra,Zed,145,68,77,46.9
Syndra,RekSai,29,18,11,62.07
Syndra,Khazix,93,35,58,37.63
Syndra,Ornn,89,53,36,59.55
Syndra,Poppy,105,60,45,57.14
Syndra,KSante,105,59,46,56.19
Syndra,Kled,37,25,12,67.57
Syndra,Annie,63,27,36,42.86
Syndra,Corki,45,19,26,42.22
Syndra,Nunu,92,62,30,67.39
Syndra,Talon,46,26,20,56.52
Syndra,DrMundo,78,32,46,41.03
Syndra,Ziggs,53,21,32,39.62
Syndra,Velkoz,75,56,19,74.67
Syndra,Rengar,33,21,12,63.64
Syndra,Soraka,74,37,37,50
Syndra,Olaf,62,32,30,51.61
Syndra,Tryndamere,59,28,31,47.46
Syndra,TwistedFate,52,30,22,57.69
Syndra,Rumble,47,25,22,53.19
Syndra,Zeri,78,31,47,39.74
Syndra,Taric,47,20,27,42.55
Braum,Gangplank,92,52,40,56.52
Braum,Volibear,173,90,83,52.02
Braum,Irelia,154,84,70,54.55
Braum,Kaisa,352,193,159,54.83
Braum,Nautilus,352,182,170,51.7
Braum,Vladimir,99,54,45,54.55
Braum,Kayn,190,96,94,50.53
Braum,Velkoz,98,37,61,37.76
Braum,Xayah,93,41,52,44.09
Braum,Leblanc,95,56,39,58.95
Braum,Garen,300,134,166,44.67
Braum,Shaco,120,65,55,54.17
Braum,Tristana,143,51,92,35.66
Braum,Ezreal,398,221,177,55.53
Braum,Swain,175,80,95,45.71
Braum,Mordekaiser,220,97,123,44.09
Braum,Amumu,230,96,134,41.74
Braum,Yone,318,167,151,52.52
Braum,Varus,192,85,107,44.27
Braum,Karma,247,160,87,64.78
Braum,Diana,293,179,114,61.09
Braum,Caitlyn,427,251,176,58.78
Braum,Xerath,152,79,73,51.97
Braum,Sion,130,58,72,44.62
Braum,Aatrox,161,115,46,71.43
Braum,TwistedFate,64,46,18,71.88
Braum,Lux,319,165,154,51.72
Braum,Lulu,268,141,127,52.61
Braum,Yorick,154,81,73,52.6
Braum,Kindred,80,48,32,60
Braum,Katarina,87,38,49,43.68
Braum,Neeko,93,53,40,56.99
Braum,Camille,88,49,39,55.68
Braum,Malzahar,218,115,103,52.75
Braum,Sivir,99,53,46,53.54
Braum,Zyra,149,72,77,48.32
Braum,Graves,120,71,49,59.17
Braum,Hwei,133,66,67,49.62
Braum,Nilah,43,15,28,34.88
Braum,Nami,237,105,132,44.3
Braum,Lissandra,77,35,42,45.45
Braum,Kalista,69,34,35,49.28
Braum,Rell,138,60,78,43.48
Braum,Darius,357,185,172,51.82
Braum,LeeSin,282,180,102,63.83
Braum,Elise,173,94,79,54.34
Braum,Quinn,54,27,27,50
Braum,Jayce,99,36,63,36.36
Braum,Jhin,316,194,122,61.39
Braum,Singed,41,29,12,70.73
Braum,JarvanIV,190,96,94,50.53
Braum,Shen,155,77,78,49.68
Braum,Riven,79,45,34,56.96
Braum,Yasuo,355,167,188,47.04
Braum,MissFortune,442,218,224,49.32
Braum,Leona,220,113,107,51.36
Braum,Trundle,97,49,48,50.52
Braum,Warwick,240,143,97,59.58
Braum,Nocturne,197,92,105,46.7
Braum,Brand,129,73,56,56.59
Braum,Vi,186,85,101,45.7
Braum,Zed,158,102,56,64.56
Braum,Samira,114,70,44,61.4
Braum,Morgana,141,66,75,46.81
Braum,Mel,316,158,158,50
Braum,Renata,53,19,34,35.85
Braum,Teemo,127,56,71,44.09
Braum,Fiora,66,35,31,53.03
Braum,Akali,157,102,55,64.97
Braum,Yuumi,142,79,63,55.63
Braum,Renekton,112,50,62,44.64
Braum,AurelionSol,78,29,49,37.18
Braum,Nunu,107,72,35,67.29
Braum,Gragas,126,69,57,54.76
Braum,Corki,114,64,50,56.14
Braum,Thresh,428,255,173,59.58
Braum,Lucian,166,88,78,53.01
Braum,Belveth,44,22,22,50
Braum,Jax,130,81,49,62.31
Braum,Senna,134,62,72,46.27
Braum,Gwen,113,57,56,50.44
Braum,Galio,159,78,81,49.06
Braum,Vayne,200,100,100,50
Braum,Seraphine,128,72,56,56.25
Braum,Zac,144,94,50,65.28
Braum,Sylas,280,167,113,59.64
Braum,Veigar,146,49,97,33.56
Braum,Smolder,119,50,69,42.02
Braum,Nasus,84,39,45,46.43
Braum,Jinx,453,224,229,49.45
Braum,Viego,254,136,118,53.54
Braum,Urgot,74,50,24,67.57
Braum,Syndra,119,68,51,57.14
Braum,MasterYi,165,93,72,56.36
Braum,Ziggs,79,34,45,43.04
Braum,Evelynn,49,31,18,63.27
Braum,Aurora,162,92,70,56.79
Braum,Maokai,85,44,41,51.76
Braum,Vex,93,47,46,50.54
Braum,Zilean,61,26,35,42.62
Braum,Khazix,80,48,32,60
Braum,Draven,102,51,51,50
Braum,Ambessa,156,74,82,47.44
Braum,Rengar,43,25,18,58.14
Braum,Blitzcrank,160,77,83,48.13
Braum,KSante,135,83,52,61.48
Braum,Hecarim,59,34,25,57.63
Braum,TahmKench,186,109,77,58.6
Braum,XinZhao,137,62,75,45.26
Braum,Milio,99,55,44,55.56
Braum,DrMundo,98,44,54,44.9
Braum,Rumble,68,40,28,58.82
Braum,Illaoi,73,37,36,50.68
Braum,FiddleSticks,70,22,48,31.43
Braum,Pyke,138,73,65,52.9
Braum,Alistar,96,46,50,47.92
Braum,Ryze,69,37,32,53.62
Braum,Ashe,333,188,145,56.46
Braum,Pantheon,288,163,125,56.6
Braum,Janna,61,33,28,54.1
Braum,Olaf,55,25,30,45.45
Braum,Taliyah,42,23,19,54.76
Braum,Twitch,123,84,39,68.29
Braum,Lillia,119,58,61,48.74
Braum,Ahri,265,134,131,50.57
Braum,Rakan,73,30,43,41.1
Braum,Sett,281,126,155,44.84
Braum,Poppy,148,78,70,52.7
Braum,Kayle,77,40,37,51.95
Braum,Taric,35,19,16,54.29
Braum,Ornn,134,77,57,57.46
Braum,Zoe,71,45,26,63.38
Braum,Gnar,84,41,43,48.81
Braum,Briar,110,53,57,48.18
Braum,Ekko,134,72,62,53.73
Braum,Rammus,60,33,27,55
Braum,Aphelios,98,56,42,57.14
Braum,Annie,48,19,29,39.58
Braum,Fizz,126,67,59,53.17
Braum,Sejuani,142,60,82,42.25
Braum,Kassadin,39,14,25,35.9
Braum,Sona,33,18,15,54.55
Braum,Soraka,89,37,52,41.57
Braum,Karthus,54,22,32,40.74
Braum,Malphite,181,70,111,38.67
Braum,Chogath,233,123,110,52.79
Braum,KogMaw,81,26,55,32.1
Braum,Azir,99,66,33,66.67
Braum,Shyvana,38,17,21,44.74
Braum,Qiyana,33,20,13,60.61
Braum,Akshan,36,17,19,47.22
Braum,MonkeyKing,111,56,55,50.45
Braum,Orianna,78,34,44,43.59
Braum,Talon,70,39,31,55.71
Braum,Bard,66,28,38,42.42
Braum,Tryndamere,58,39,19,67.24
Braum,Nidalee,46,19,27,41.3
Braum,Heimerdinger,58,41,17,70.69
Braum,Udyr,34,21,13,61.76
Braum,Skarner,112,64,48,57.14
Braum,Viktor,179,87,92,48.6
Braum,Naafiri,38,16,22,42.11
Braum,Kennen,55,19,36,34.55
Braum,Kled,27,10,17,37.04
Braum,Cassiopeia,40,14,26,35
Braum,Anivia,47,26,21,55.32
Braum,Ivern,36,22,14,61.11
Braum,RekSai,34,19,15,55.88
Braum,Zeri,72,37,35,51.39
Teemo,Jax,181,93,88,51.38
Teemo,Sejuani,130,62,68,47.69
Teemo,Hwei,135,81,54,60
Teemo,Ezreal,475,247,228,52
Teemo,Zac,139,67,72,48.2
Teemo,Chogath,285,109,176,38.25
Teemo,Lillia,136,59,77,43.38
Teemo,Tryndamere,77,46,31,59.74
Teemo,Caitlyn,536,282,254,52.61
Teemo,Karma,240,121,119,50.42
Teemo,Garen,342,170,172,49.71
Teemo,Zed,258,136,122,52.71
Teemo,Mel,524,245,279,46.76
Teemo,Morgana,221,118,103,53.39
Teemo,Corki,73,28,45,38.36
Teemo,Ekko,187,99,88,52.94
Teemo,Leblanc,119,57,62,47.9
Teemo,Kled,23,21,2,91.3
Teemo,Kayn,300,168,132,56
Teemo,Katarina,147,69,78,46.94
Teemo,Twitch,194,114,80,58.76
Teemo,Thresh,339,170,169,50.15
Teemo,Sion,278,104,174,37.41
Teemo,RekSai,41,28,13,68.29
Teemo,Viktor,187,85,102,45.45
Teemo,KogMaw,84,50,34,59.52
Teemo,Ashe,401,171,230,42.64
Teemo,Malphite,320,154,166,48.13
Teemo,Vi,209,120,89,57.42
Teemo,Azir,80,43,37,53.75
Teemo,MissFortune,479,227,252,47.39
Teemo,Lulu,268,160,108,59.7
Teemo,Graves,104,39,65,37.5
Teemo,Kassadin,37,17,20,45.95
Teemo,Tristana,150,71,79,47.33
Teemo,Nami,231,91,140,39.39
Teemo,Irelia,161,85,76,52.8
Teemo,Jhin,392,211,181,53.83
Teemo,Skarner,88,46,42,52.27
Teemo,Aurora,177,86,91,48.59
Teemo,Yuumi,188,82,106,43.62
Teemo,Pantheon,344,178,166,51.74
Teemo,Zoe,83,41,42,49.4
Teemo,Ziggs,84,38,46,45.24
Teemo,Veigar,223,89,134,39.91
Teemo,Mordekaiser,294,131,163,44.56
Teemo,Diana,326,160,166,49.08
Teemo,Yone,362,188,174,51.93
Teemo,Xerath,172,88,84,51.16
Teemo,KSante,81,34,47,41.98
Teemo,Nunu,138,84,54,60.87
Teemo,Akshan,74,35,39,47.3
Teemo,Seraphine,144,69,75,47.92
Teemo,Malzahar,192,104,88,54.17
Teemo,Lucian,189,90,99,47.62
Teemo,Aphelios,122,64,58,52.46
Teemo,Udyr,73,34,39,46.58
Teemo,Yasuo,434,212,222,48.85
Teemo,Karthus,48,19,29,39.58
Teemo,Renekton,95,68,27,71.58
Teemo,Varus,227,107,120,47.14
Teemo,Kalista,74,40,34,54.05
Teemo,Amumu,258,131,127,50.78
Teemo,Milio,148,79,69,53.38
Teemo,Riven,52,27,25,51.92
Teemo,Shyvana,66,34,32,51.52
Teemo,Ryze,123,54,69,43.9
Teemo,Velkoz,119,58,61,48.74
Teemo,Sett,241,132,109,54.77
Teemo,Warwick,269,144,125,53.53
Teemo,Darius,441,229,212,51.93
Teemo,Smolder,167,85,82,50.9
Teemo,Vex,117,57,60,48.72
Teemo,Lux,449,247,202,55.01
Teemo,Sylas,286,142,144,49.65
Teemo,Ornn,110,54,56,49.09
Teemo,Ahri,271,132,139,48.71
Teemo,Urgot,111,69,42,62.16
Teemo,Kindred,84,54,30,64.29
Teemo,Volibear,225,119,106,52.89
Teemo,Shaco,137,74,63,54.01
Teemo,Vayne,242,125,117,51.65
Teemo,Rakan,129,60,69,46.51
Teemo,Aatrox,248,122,126,49.19
Teemo,AurelionSol,83,31,52,37.35
Teemo,MonkeyKing,112,43,69,38.39
Teemo,Poppy,142,73,69,51.41
Teemo,Akali,238,125,113,52.52
Teemo,Blitzcrank,189,101,88,53.44
Teemo,Zilean,89,53,36,59.55
Teemo,Braum,127,71,56,55.91
Teemo,Jinx,522,252,270,48.28
Teemo,LeeSin,337,168,169,49.85
Teemo,Zyra,158,65,93,41.14
Teemo,Heimerdinger,129,62,67,48.06
Teemo,Taliyah,53,35,18,66.04
Teemo,MasterYi,217,107,110,49.31
Teemo,Gangplank,123,73,50,59.35
Teemo,Galio,235,136,99,57.87
Teemo,Elise,141,82,59,58.16
Teemo,Fizz,89,52,37,58.43
Teemo,Sivir,102,52,50,50.98
Teemo,Brand,148,91,57,61.49
Teemo,Yorick,192,102,90,53.13
Teemo,Swain,207,96,111,46.38
Teemo,Samira,160,79,81,49.38
Teemo,Rell,126,72,54,57.14
Teemo,Zeri,87,41,46,47.13
Teemo,FiddleSticks,83,31,52,37.35
Teemo,Belveth,48,31,17,64.58
Teemo,Kaisa,318,192,126,60.38
Teemo,TahmKench,192,88,104,45.83
Teemo,Ambessa,146,59,87,40.41
Teemo,Taric,55,20,35,36.36
Teemo,Shen,126,58,68,46.03
Teemo,Jayce,96,44,52,45.83
Teemo,Draven,114,57,57,50
Teemo,Syndra,136,70,66,51.47
Teemo,Nautilus,273,125,148,45.79
Teemo,Talon,105,62,43,59.05
Teemo,Illaoi,80,39,41,48.75
Teemo,Vladimir,155,66,89,42.58
Teemo,Rammus,58,24,34,41.38
Teemo,XinZhao,109,40,69,36.7
Teemo,Maokai,87,44,43,50.57
Teemo,Neeko,118,50,68,42.37
Teemo,JarvanIV,140,64,76,45.71
Teemo,Nocturne,259,97,162,37.45
Teemo,Hecarim,71,22,49,30.99
Teemo,Lissandra,56,34,22,60.71
Teemo,Cassiopeia,72,36,36,50
Teemo,Khazix,96,49,47,51.04
Teemo,Leona,214,115,99,53.74
Teemo,Gnar,88,55,33,62.5
Teemo,Soraka,132,59,73,44.7
Teemo,Kayle,134,76,58,56.72
Teemo,Viego,245,122,123,49.8
Teemo,Fiora,43,31,12,72.09
Teemo,Gragas,145,81,64,55.86
Teemo,Senna,90,36,54,40
Teemo,Naafiri,80,39,41,48.75
Teemo,Renata,47,21,26,44.68
Teemo,Nasus,114,61,53,53.51
Teemo,Briar,115,69,46,60
Teemo,Pyke,179,97,82,54.19
Teemo,Camille,67,39,28,58.21
Teemo,Ivern,45,19,26,42.22
Teemo,Sona,41,13,28,31.71
Teemo,Rengar,47,29,18,61.7
Teemo,Gwen,95,38,57,40
Teemo,Xayah,131,62,69,47.33
Teemo,Trundle,115,71,44,61.74
Teemo,Quinn,64,38,26,59.38
Teemo,Janna,60,22,38,36.67
Teemo,Olaf,44,30,14,68.18
Teemo,Singed,52,18,34,34.62
Teemo,Alistar,139,68,71,48.92
Teemo,Rumble,83,53,30,63.86
Teemo,Annie,83,30,53,36.14
Teemo,Evelynn,53,42,11,79.25
Teemo,DrMundo,88,26,62,29.55
Teemo,TwistedFate,76,44,32,57.89
Teemo,Nilah,68,43,25,63.24
Teemo,Orianna,88,43,45,48.86
Teemo,Qiyana,59,25,34,42.37
Teemo,Nidalee,83,49,34,59.04
Teemo,Kennen,86,37,49,43.02
Teemo,Anivia,63,35,28,55.56
Teemo,Bard,62,22,40,35.48
Jax,Teemo,181,88,93,48.62
Jax,Kayn,261,145,116,55.56
Jax,Yone,406,209,197,51.48
Jax,Ryze,50,25,25,50
Jax,Lux,456,211,245,46.27
Jax,Sett,288,149,139,51.74
Jax,Katarina,125,60,65,48
Jax,Jinx,489,199,290,40.7
Jax,Renata,49,25,24,51.02
Jax,Mordekaiser,222,110,112,49.55
Jax,Caitlyn,491,261,230,53.16
Jax,Morgana,187,90,97,48.13
Jax,Gangplank,81,30,51,37.04
Jax,FiddleSticks,86,43,43,50
Jax,Veigar,211,99,112,46.92
Jax,Ezreal,525,245,280,46.67
Jax,Gragas,177,97,80,54.8
Jax,Viego,282,132,150,46.81
Jax,Xayah,101,55,46,54.46
Jax,Lucian,168,81,87,48.21
Jax,Rell,107,53,54,49.53
Jax,Darius,327,186,141,56.88
Jax,Graves,138,71,67,51.45
Jax,Neeko,83,52,31,62.65
Jax,Draven,106,70,36,66.04
Jax,Alistar,92,54,38,58.7
Jax,MasterYi,280,158,122,56.43
Jax,Samira,126,65,61,51.59
Jax,Singed,45,15,30,33.33
Jax,Illaoi,120,45,75,37.5
Jax,Twitch,108,51,57,47.22
Jax,Ahri,273,135,138,49.45
Jax,Kaisa,315,151,164,47.94
Jax,Ashe,382,170,212,44.5
Jax,KSante,104,57,47,54.81
Jax,Shaco,160,77,83,48.13
Jax,Zilean,66,34,32,51.52
Jax,Garen,409,163,246,39.85
Jax,Belveth,42,17,25,40.48
Jax,Malzahar,186,80,106,43.01
Jax,Varus,177,85,92,48.02
Jax,Renekton,105,55,50,52.38
Jax,Elise,156,84,72,53.85
Jax,Zed,191,88,103,46.07
Jax,Milio,127,46,81,36.22
Jax,Vladimir,125,66,59,52.8
Jax,Hwei,112,60,52,53.57
Jax,Tristana,177,94,83,53.11
Jax,Lulu,305,127,178,41.64
Jax,Trundle,128,62,66,48.44
Jax,Diana,322,155,167,48.14
Jax,Janna,69,32,37,46.38
Jax,Warwick,247,109,138,44.13
Jax,Nunu,96,46,50,47.92
Jax,Pyke,174,89,85,51.15
Jax,Blitzcrank,180,110,70,61.11
Jax,Ambessa,166,70,96,42.17
Jax,Khazix,99,52,47,52.53
Jax,Vex,113,39,74,34.51
Jax,Aphelios,100,61,39,61
Jax,Rumble,77,25,52,32.47
Jax,Zoe,63,41,22,65.08
Jax,Jhin,388,190,198,48.97
Jax,Volibear,211,104,107,49.29
Jax,Fizz,72,39,33,54.17
Jax,Irelia,174,92,82,52.87
Jax,Soraka,66,41,25,62.12
Jax,Leblanc,114,57,57,50
Jax,TahmKench,131,79,52,60.31
Jax,Gnar,71,40,31,56.34
Jax,Mel,343,172,171,50.15
Jax,Nami,174,81,93,46.55
Jax,Yasuo,397,206,191,51.89
Jax,Yuumi,138,62,76,44.93
Jax,DrMundo,122,56,66,45.9
Jax,Zeri,88,43,45,48.86
Jax,Velkoz,119,55,64,46.22
Jax,Kennen,51,24,27,47.06
Jax,Kled,31,15,16,48.39
Jax,Briar,103,61,42,59.22
Jax,LeeSin,315,154,161,48.89
Jax,Galio,231,94,137,40.69
Jax,Brand,91,43,48,47.25
Jax,Aatrox,211,110,101,52.13
Jax,Akali,197,90,107,45.69
Jax,Leona,182,108,74,59.34
Jax,Tryndamere,88,45,43,51.14
Jax,Swain,210,94,116,44.76
Jax,Ivern,38,11,27,28.95
Jax,Braum,130,49,81,37.69
Jax,Amumu,201,88,113,43.78
Jax,Naafiri,62,28,34,45.16
Jax,Nautilus,247,108,139,43.72
Jax,AurelionSol,72,33,39,45.83
Jax,Senna,123,57,66,46.34
Jax,Seraphine,115,64,51,55.65
Jax,Jayce,95,50,45,52.63
Jax,Skarner,112,43,69,38.39
Jax,MissFortune,316,174,142,55.06
Jax,Evelynn,57,25,32,43.86
Jax,Sivir,122,56,66,45.9
Jax,Annie,68,27,41,39.71
Jax,Sejuani,158,70,88,44.3
Jax,Ekko,164,89,75,54.27
Jax,Riven,90,41,49,45.56
Jax,Fiora,94,52,42,55.32
Jax,Viktor,182,97,85,53.3
Jax,Sylas,311,151,160,48.55
Jax,Thresh,363,178,185,49.04
Jax,Chogath,228,101,127,44.3
Jax,Karma,271,133,138,49.08
Jax,Rengar,52,35,17,67.31
Jax,Nasus,141,68,73,48.23
Jax,Talon,61,27,34,44.26
Jax,XinZhao,167,85,82,50.9
Jax,Azir,64,24,40,37.5
Jax,Rammus,69,35,34,50.72
Jax,MonkeyKing,134,49,85,36.57
Jax,Xerath,183,101,82,55.19
Jax,TwistedFate,64,25,39,39.06
Jax,Poppy,176,78,98,44.32
Jax,Nocturne,188,97,91,51.6
Jax,Vayne,209,92,117,44.02
Jax,Vi,203,104,99,51.23
Jax,Ornn,89,39,50,43.82
Jax,Anivia,65,32,33,49.23
Jax,Udyr,46,32,14,69.57
Jax,Yorick,141,73,68,51.77
Jax,Shen,130,54,76,41.54
Jax,Pantheon,351,161,190,45.87
Jax,Sona,26,12,14,46.15
Jax,Lillia,120,44,76,36.67
Jax,Akshan,68,42,26,61.76
Jax,Kayle,143,87,56,60.84
Jax,Sion,124,58,66,46.77
Jax,Syndra,140,71,69,50.71
Jax,Olaf,53,34,19,64.15
Jax,KogMaw,85,42,43,49.41
Jax,Shyvana,36,25,11,69.44
Jax,Taliyah,44,26,18,59.09
Jax,Nilah,51,30,21,58.82
Jax,Qiyana,35,8,27,22.86
Jax,Karthus,34,12,22,35.29
Jax,Rakan,96,53,43,55.21
Jax,Orianna,111,66,45,59.46
Jax,Kalista,42,16,26,38.1
Jax,Kindred,68,39,29,57.35
Jax,Urgot,98,43,55,43.88
Jax,Gwen,82,41,41,50
Jax,Kassadin,23,12,11,52.17
Jax,Camille,90,44,46,48.89
Jax,Aurora,115,42,73,36.52
Jax,Zac,100,51,49,51
Jax,Malphite,157,69,88,43.95
Jax,Smolder,110,56,54,50.91
Jax,Ziggs,62,25,37,40.32
Jax,JarvanIV,127,69,58,54.33
Jax,Zyra,161,65,96,40.37
Jax,Corki,83,39,44,46.99
Jax,Nidalee,64,28,36,43.75
Jax,Hecarim,70,32,38,45.71
Jax,Heimerdinger,51,29,22,56.86
Jax,Lissandra,58,24,34,41.38
Jax,Maokai,70,28,42,40
Jax,Cassiopeia,38,17,21,44.74
Jax,Quinn,49,26,23,53.06
Jax,Taric,31,17,14,54.84
Jax,Bard,50,24,26,48
Jax,RekSai,21,9,12,42.86
Sejuani,Teemo,130,68,62,52.31
Sejuani,Kayn,182,90,92,49.45
Sejuani,Yone,257,137,120,53.31
Sejuani,Ryze,77,45,32,58.44
Sejuani,Lux,379,223,156,58.84
Sejuani,Ashe,371,204,167,54.99
Sejuani,Twitch,125,57,68,45.6
Sejuani,Viktor,175,97,78,55.43
Sejuani,Xayah,101,56,45,55.45
Sejuani,Xerath,135,75,60,55.56
Sejuani,Malphite,188,100,88,53.19
Sejuani,Vi,202,110,92,54.46
Sejuani,Veigar,138,83,55,60.14
Sejuani,Sivir,108,54,54,50
Sejuani,Senna,87,39,48,44.83
Sejuani,Garen,228,117,111,51.32
Sejuani,MonkeyKing,116,63,53,54.31
Sejuani,Nilah,44,19,25,43.18
Sejuani,Lulu,267,129,138,48.31
Sejuani,Malzahar,170,68,102,40
Sejuani,Ahri,236,152,84,64.41
Sejuani,MissFortune,285,178,107,62.46
Sejuani,Amumu,205,94,111,45.85
Sejuani,Shyvana,34,24,10,70.59
Sejuani,Lissandra,88,51,37,57.95
Sejuani,Lucian,151,105,46,69.54
Sejuani,TahmKench,163,77,86,47.24
Sejuani,LeeSin,257,164,93,63.81
Sejuani,Orianna,115,76,39,66.09
Sejuani,Morgana,144,74,70,51.39
Sejuani,Fizz,64,40,24,62.5
Sejuani,Kaisa,265,139,126,52.45
Sejuani,Karma,197,103,94,52.28
Sejuani,Darius,277,141,136,50.9
Sejuani,Shaco,111,57,54,51.35
Sejuani,Ekko,130,72,58,55.38
Sejuani,Neeko,55,36,19,65.45
Sejuani,Tryndamere,53,30,23,56.6
Sejuani,MasterYi,130,87,43,66.92
Sejuani,Akali,144,86,58,59.72
Sejuani,KogMaw,67,17,50,25.37
Sejuani,Swain,113,52,61,46.02
Sejuani,Kennen,40,19,21,47.5
Sejuani,Talon,72,43,29,59.72
Sejuani,Aphelios,65,38,27,58.46
Sejuani,Pyke,149,105,44,70.47
Sejuani,Jayce,87,58,29,66.67
Sejuani,Katarina,95,44,51,46.32
Sejuani,Mordekaiser,188,103,85,54.79
Sejuani,Yasuo,264,122,142,46.21
Sejuani,Ziggs,60,36,24,60
Sejuani,Nautilus,201,83,118,41.29
Sejuani,Elise,105,56,49,53.33
Sejuani,Leona,150,71,79,47.33
Sejuani,Kayle,71,28,43,39.44
Sejuani,Vex,123,79,44,64.23
Sejuani,Caitlyn,404,216,188,53.47
Sejuani,Soraka,64,32,32,50
Sejuani,KSante,109,68,41,62.39
Sejuani,Draven,70,38,32,54.29
Sejuani,Zoe,61,21,40,34.43
Sejuani,Riven,75,32,43,42.67
Sejuani,Nocturne,197,107,90,54.31
Sejuani,Galio,185,129,56,69.73
Sejuani,Vayne,208,119,89,57.21
Sejuani,Trundle,80,45,35,56.25
Sejuani,Warwick,206,119,87,57.77
Sejuani,Irelia,120,86,34,71.67
Sejuani,JarvanIV,170,77,93,45.29
Sejuani,Taliyah,55,32,23,58.18
Sejuani,Mel,302,184,118,60.93
Sejuani,Yorick,111,49,62,44.14
Sejuani,Gragas,134,73,61,54.48
Sejuani,Zyra,127,78,49,61.42
Sejuani,Yuumi,134,68,66,50.75
Sejuani,Qiyana,44,24,20,54.55
Sejuani,Heimerdinger,45,32,13,71.11
Sejuani,Velkoz,78,52,26,66.67
Sejuani,Viego,200,108,92,54
Sejuani,Samira,96,53,43,55.21
Sejuani,Thresh,285,156,129,54.74
Sejuani,Fiora,48,36,12,75
Sejuani,Diana,229,129,100,56.33
Sejuani,Nami,185,99,86,53.51
Sejuani,Smolder,102,53,49,51.96
Sejuani,Briar,92,64,28,69.57
Sejuani,Gwen,78,31,47,39.74
Sejuani,Ornn,81,44,37,54.32
Sejuani,Graves,135,72,63,53.33
Sejuani,Quinn,48,31,17,64.58
Sejuani,Gnar,79,57,22,72.15
Sejuani,Brand,84,44,40,52.38
Sejuani,Aatrox,164,106,58,64.63
Sejuani,Seraphine,100,49,51,49
Sejuani,Jinx,377,180,197,47.75
Sejuani,Jax,158,88,70,55.7
Sejuani,Corki,59,36,23,61.02
Sejuani,Janna,57,40,17,70.18
Sejuani,Renekton,70,27,43,38.57
Sejuani,Lillia,113,56,57,49.56
Sejuani,Poppy,108,56,52,51.85
Sejuani,Varus,157,116,41,73.89
Sejuani,Ezreal,379,227,152,59.89
Sejuani,Skarner,108,70,38,64.81
Sejuani,Evelynn,59,26,33,44.07
Sejuani,Aurora,137,87,50,63.5
Sejuani,Zeri,78,37,41,47.44
Sejuani,Karthus,20,11,9,55
Sejuani,Sion,144,73,71,50.69
Sejuani,Alistar,72,28,44,38.89
Sejuani,Nasus,87,33,54,37.93
Sejuani,Blitzcrank,139,77,62,55.4
Sejuani,Kassadin,31,14,17,45.16
Sejuani,Chogath,188,103,85,54.79
Sejuani,Volibear,160,90,70,56.25
Sejuani,Sylas,239,147,92,61.51
Sejuani,Illaoi,66,35,31,53.03
Sejuani,Khazix,90,45,45,50
Sejuani,Anivia,48,25,23,52.08
Sejuani,DrMundo,79,45,34,56.96
Sejuani,Taric,33,14,19,42.42
Sejuani,Vladimir,122,67,55,54.92
Sejuani,Tristana,136,79,57,58.09
Sejuani,Milio,99,40,59,40.4
Sejuani,AurelionSol,59,27,32,45.76
Sejuani,Sett,241,135,106,56.02
Sejuani,Rammus,33,18,15,54.55
Sejuani,Rell,101,62,39,61.39
Sejuani,Hecarim,56,24,32,42.86
Sejuani,Kalista,55,32,23,58.18
Sejuani,Gangplank,90,59,31,65.56
Sejuani,Syndra,100,57,43,57
Sejuani,Sona,26,21,5,80.77
Sejuani,Jhin,250,139,111,55.6
Sejuani,Braum,142,82,60,57.75
Sejuani,Nunu,80,47,33,58.75
Sejuani,Cassiopeia,46,25,21,54.35
Sejuani,Rakan,63,30,33,47.62
Sejuani,FiddleSticks,62,28,34,45.16
Sejuani,Akshan,29,16,13,55.17
Sejuani,Rumble,47,26,21,55.32
Sejuani,Zilean,53,40,13,75.47
Sejuani,Hwei,84,47,37,55.95
Sejuani,Naafiri,39,19,20,48.72
Sejuani,Camille,92,59,33,64.13
Sejuani,Zac,93,53,40,56.99
Sejuani,Kindred,76,44,32,57.89
Sejuani,Zed,156,86,70,55.13
Sejuani,Belveth,12,6,6,50
Sejuani,Olaf,50,27,23,54
Sejuani,Ivern,41,24,17,58.54
Sejuani,Nidalee,52,29,23,55.77
Sejuani,Shen,115,68,47,59.13
Sejuani,Maokai,80,38,42,47.5
Sejuani,Azir,59,32,27,54.24
Sejuani,Urgot,66,27,39,40.91
Sejuani,Rengar,41,29,12,70.73
Sejuani,Kled,25,12,13,48
Sejuani,Singed,36,14,22,38.89
Sejuani,Pantheon,239,142,97,59.41
Sejuani,XinZhao,140,80,60,57.14
Sejuani,Ambessa,119,53,66,44.54
Sejuani,TwistedFate,36,16,20,44.44
Sejuani,Udyr,30,18,12,60
Sejuani,Leblanc,79,39,40,49.37
Sejuani,Annie,65,38,27,58.46
Sejuani,RekSai,35,28,7,80
Sejuani,Renata,37,9,28,24.32
Sejuani,Bard,43,21,22,48.84
Hwei,Teemo,135,54,81,40
Hwei,Kayn,196,91,105,46.43
Hwei,Yone,212,105,107,49.53
Hwei,Ryze,65,27,38,41.54
Hwei,Lux,365,183,182,50.14
Hwei,XinZhao,127,75,52,59.06
Hwei,Morgana,115,66,49,57.39
Hwei,Jinx,392,170,222,43.37
Hwei,Karma,208,101,107,48.56
Hwei,Galio,223,106,117,47.53
Hwei,Hecarim,76,28,48,36.84
Hwei,Shen,137,63,74,45.99
Hwei,Kaisa,277,134,143,48.38
Hwei,Nami,153,75,78,49.02
Hwei,Ambessa,110,53,57,48.18
Hwei,Diana,210,96,114,45.71
Hwei,Ekko,149,77,72,51.68
Hwei,Lulu,274,140,134,51.09
Hwei,Corki,74,35,39,47.3
Hwei,Leblanc,87,59,28,67.82
Hwei,Caitlyn,419,229,190,54.65
Hwei,Mel,278,151,127,54.32
Hwei,Aatrox,178,91,87,51.12
Hwei,JarvanIV,125,69,56,55.2
Hwei,Chogath,210,97,113,46.19
Hwei,MissFortune,291,144,147,49.48
Hwei,Yuumi,139,58,81,41.73
Hwei,Briar,107,65,42,60.75
Hwei,Nocturne,209,114,95,54.55
Hwei,Lissandra,66,32,34,48.48
Hwei,Yorick,91,43,48,47.25
Hwei,Kindred,72,49,23,68.06
Hwei,Katarina,108,60,48,55.56
Hwei,Neeko,80,37,43,46.25
Hwei,Poppy,137,75,62,54.74
Hwei,FiddleSticks,50,25,25,50
Hwei,Ashe,337,165,172,48.96
Hwei,Braum,133,67,66,50.38
Hwei,MasterYi,110,60,50,54.55
Hwei,Warwick,141,57,84,40.43
Hwei,Kassadin,29,18,11,62.07
Hwei,Pyke,139,66,73,47.48
Hwei,Aphelios,81,31,50,38.27
Hwei,Udyr,61,32,29,52.46
Hwei,Yasuo,264,96,168,36.36
Hwei,Lucian,115,67,48,58.26
Hwei,Karthus,55,23,32,41.82
Hwei,Darius,304,131,173,43.09
Hwei,LeeSin,264,160,104,60.61
Hwei,Sylas,234,120,114,51.28
Hwei,Tristana,150,74,76,49.33
Hwei,Ahri,229,114,115,49.78
Hwei,Graves,98,59,39,60.2
Hwei,Blitzcrank,148,79,69,53.38
Hwei,Jayce,63,43,20,68.25
Hwei,Zac,129,63,66,48.84
Hwei,Jax,112,52,60,46.43
Hwei,Janna,53,16,37,30.19
Hwei,Viktor,202,100,102,49.5
Hwei,Samira,106,54,52,50.94
Hwei,Leona,162,82,80,50.62
Hwei,Mordekaiser,203,115,88,56.65
Hwei,Thresh,260,129,131,49.62
Hwei,Sion,106,46,60,43.4
Hwei,Vi,187,79,108,42.25
Hwei,Orianna,105,41,64,39.05
Hwei,Nilah,43,17,26,39.53
Hwei,Heimerdinger,68,33,35,48.53
Hwei,Seraphine,109,58,51,53.21
Hwei,Gangplank,108,60,48,55.56
Hwei,Taliyah,75,35,40,46.67
Hwei,Garen,239,110,129,46.03
Hwei,Akali,99,58,41,58.59
Hwei,Riven,62,18,44,29.03
Hwei,Smolder,86,31,55,36.05
Hwei,Camille,68,32,36,47.06
Hwei,Lillia,63,32,31,50.79
Hwei,Varus,179,84,95,46.93
Hwei,Zoe,65,35,30,53.85
Hwei,Veigar,130,67,63,51.54
Hwei,Ziggs,58,27,31,46.55
Hwei,Nautilus,234,135,99,57.69
Hwei,Xayah,104,54,50,51.92
Hwei,Urgot,79,32,47,40.51
Hwei,Syndra,166,86,80,51.81
Hwei,Milio,103,50,53,48.54
Hwei,Shaco,95,40,55,42.11
Hwei,Zed,174,64,110,36.78
Hwei,Zeri,64,21,43,32.81
Hwei,Sett,193,104,89,53.89
Hwei,Skarner,89,53,36,59.55
Hwei,AurelionSol,62,18,44,29.03
Hwei,RekSai,22,9,13,40.91
Hwei,Fizz,61,24,37,39.34
Hwei,Ezreal,405,237,168,58.52
Hwei,DrMundo,70,23,47,32.86
Hwei,Kled,30,16,14,53.33
Hwei,Jhin,296,142,154,47.97
Hwei,Rengar,39,23,16,58.97
Hwei,Brand,73,47,26,64.38
Hwei,TwistedFate,58,34,24,58.62
Hwei,Alistar,93,60,33,64.52
Hwei,Pantheon,243,142,101,58.44
Hwei,Twitch,111,55,56,49.55
Hwei,Ornn,74,34,40,45.95
Hwei,KogMaw,39,10,29,25.64
Hwei,Aurora,130,54,76,41.54
Hwei,Illaoi,85,31,54,36.47
Hwei,Vladimir,85,39,46,45.88
Hwei,Senna,93,46,47,49.46
Hwei,Xerath,157,75,82,47.77
Hwei,Talon,77,44,33,57.14
Hwei,Viego,238,114,124,47.9
Hwei,Malzahar,187,91,96,48.66
Hwei,Tryndamere,63,30,33,47.62
Hwei,Gragas,118,65,53,55.08
Hwei,Renata,48,20,28,41.67
Hwei,Malphite,165,77,88,46.67
Hwei,Sona,36,22,14,61.11
Hwei,Evelynn,39,19,20,48.72
Hwei,Qiyana,21,15,6,71.43
Hwei,Sivir,78,27,51,34.62
Hwei,Singed,45,26,19,57.78
Hwei,Zyra,115,40,75,34.78
Hwei,Amumu,179,74,105,41.34
Hwei,Vayne,175,89,86,50.86
Hwei,Ivern,34,17,17,50
Hwei,Renekton,75,46,29,61.33
Hwei,Trundle,85,48,37,56.47
Hwei,Nunu,104,38,66,36.54
Hwei,Swain,144,73,71,50.69
Hwei,Maokai,63,31,32,49.21
Hwei,Volibear,162,92,70,56.79
Hwei,Gwen,80,34,46,42.5
Hwei,Rakan,85,30,55,35.29
Hwei,Velkoz,105,44,61,41.9
Hwei,TahmKench,148,66,82,44.59
Hwei,Khazix,97,43,54,44.33
Hwei,Kalista,61,33,28,54.1
Hwei,Rammus,48,31,17,64.58
Hwei,KSante,108,56,52,51.85
Hwei,Olaf,62,27,35,43.55
Hwei,Naafiri,48,30,18,62.5
Hwei,Draven,73,49,24,67.12
Hwei,Fiora,49,23,26,46.94
Hwei,Rell,110,39,71,35.45
Hwei,Nidalee,82,27,55,32.93
Hwei,Rumble,47,26,21,55.32
Hwei,Sejuani,84,37,47,44.05
Hwei,Nasus,107,47,60,43.93
Hwei,Cassiopeia,48,23,25,47.92
Hwei,Kayle,91,36,55,39.56
Hwei,Soraka,44,30,14,68.18
Hwei,MonkeyKing,147,67,80,45.58
Hwei,Irelia,106,55,51,51.89
Hwei,Annie,59,28,31,47.46
Hwei,Bard,56,23,33,41.07
Hwei,Shyvana,20,10,10,50
Hwei,Akshan,52,24,28,46.15
Hwei,Anivia,52,26,26,50
Hwei,Quinn,39,15,24,38.46
Hwei,Vex,100,51,49,51
Hwei,Elise,124,56,68,45.16
Hwei,Azir,80,33,47,41.25
Hwei,Gnar,79,49,30,62.03
Hwei,Taric,40,15,25,37.5
Hwei,Belveth,17,6,11,35.29
Hwei,Zilean,49,24,25,48.98
Hwei,Kennen,53,38,15,71.7
Zac,Teemo,139,72,67,51.8
Zac,Kayn,231,124,107,53.68
Zac,Yone,227,104,123,45.81
Zac,Ryze,69,48,21,69.57
Zac,Lux,293,165,128,56.31
Zac,Gragas,101,47,54,46.53
Zac,Elise,149,74,75,49.66
Zac,Mel,294,142,152,48.3
Zac,Vayne,230,123,107,53.48
Zac,Zyra,132,43,89,32.58
Zac,Akali,148,83,65,56.08
Zac,Belveth,27,13,14,48.15
Zac,Varus,135,91,44,67.41
Zac,Jhin,245,133,112,54.29
Zac,Lulu,273,155,118,56.78
Zac,Malzahar,159,89,70,55.97
Zac,KogMaw,54,32,22,59.26
Zac,Veigar,106,36,70,33.96
Zac,Vladimir,101,44,57,43.56
Zac,Viego,193,98,95,50.78
Zac,Hwei,129,66,63,51.16
Zac,Tristana,118,57,61,48.31
Zac,DrMundo,82,41,41,50
Zac,MasterYi,120,59,61,49.17
Zac,Caitlyn,367,173,194,47.14
Zac,Thresh,286,124,162,43.36
Zac,Jayce,61,25,36,40.98
Zac,Vi,219,117,102,53.42
Zac,Orianna,84,28,56,33.33
Zac,Sett,219,92,127,42.01
Zac,Khazix,77,51,26,66.23
Zac,Ahri,217,121,96,55.76
Zac,Yasuo,291,158,133,54.3
Zac,Yuumi,96,53,43,55.21
Zac,Shaco,93,35,58,37.63
Zac,Kennen,57,38,19,66.67
Zac,Corki,98,45,53,45.92
Zac,Bard,57,22,35,38.6
Zac,Zed,99,48,51,48.48
Zac,Nunu,81,33,48,40.74
Zac,Ezreal,328,160,168,48.78
Zac,TahmKench,135,29,106,21.48
Zac,Darius,301,127,174,42.19
Zac,LeeSin,243,122,121,50.21
Zac,Smolder,111,49,62,44.14
Zac,Nautilus,210,112,98,53.33
Zac,Gwen,91,35,56,38.46
Zac,Ashe,325,145,180,44.62
Zac,Lillia,90,51,39,56.67
Zac,Nami,182,95,87,52.2
Zac,Yorick,96,52,44,54.17
Zac,Diana,233,122,111,52.36
Zac,Annie,69,34,35,49.28
Zac,Ziggs,41,20,21,48.78
Zac,Karma,195,110,85,56.41
Zac,Morgana,124,62,62,50
Zac,Rammus,49,31,18,63.27
Zac,Chogath,189,95,94,50.26
Zac,Aphelios,119,70,49,58.82
Zac,Renata,35,19,16,54.29
Zac,Pantheon,237,125,112,52.74
Zac,Viktor,144,78,66,54.17
Zac,Twitch,88,45,43,51.14
Zac,Alistar,86,52,34,60.47
Zac,Riven,53,19,34,35.85
Zac,Nocturne,208,91,117,43.75
Zac,Kaisa,321,168,153,52.34
Zac,Soraka,71,29,42,40.85
Zac,Fizz,68,15,53,22.06
Zac,Jinx,334,143,191,42.81
Zac,Velkoz,68,34,34,50
Zac,Gnar,91,60,31,65.93
Zac,Evelynn,31,17,14,54.84
Zac,Braum,144,50,94,34.72
Zac,Illaoi,51,27,24,52.94
Zac,MonkeyKing,86,42,44,48.84
Zac,Aurora,97,51,46,52.58
Zac,Xayah,91,42,49,46.15
Zac,Rakan,76,29,47,38.16
Zac,FiddleSticks,68,35,33,51.47
Zac,XinZhao,148,51,97,34.46
Zac,Blitzcrank,133,65,68,48.87
Zac,Rumble,65,20,45,30.77
Zac,Azir,65,32,33,49.23
Zac,Xerath,125,68,57,54.4
Zac,Syndra,126,76,50,60.32
Zac,Irelia,70,42,28,60
Zac,Leona,144,66,78,45.83
Zac,Mordekaiser,192,81,111,42.19
Zac,Udyr,69,38,31,55.07
Zac,Ivern,20,3,17,15
Zac,Lucian,135,55,80,40.74
Zac,Senna,90,37,53,41.11
Zac,Ambessa,137,76,61,55.47
Zac,JarvanIV,124,61,63,49.19
Zac,Kassadin,25,13,12,52
Zac,Camille,55,20,35,36.36
Zac,Rengar,54,33,21,61.11
Zac,Urgot,76,48,28,63.16
Zac,MissFortune,233,108,125,46.35
Zac,Volibear,145,92,53,63.45
Zac,Sion,173,91,82,52.6
Zac,Aatrox,166,76,90,45.78
Zac,Samira,84,42,42,50
Zac,Nasus,100,41,59,41
Zac,Nidalee,76,49,27,64.47
Zac,Garen,198,97,101,48.99
Zac,Skarner,90,32,58,35.56
Zac,Neeko,48,26,22,54.17
Zac,Poppy,147,66,81,44.9
Zac,Malphite,127,74,53,58.27
Zac,Leblanc,68,32,36,47.06
Zac,Renekton,95,50,45,52.63
Zac,Kindred,46,11,35,23.91
Zac,Draven,72,34,38,47.22
Zac,Heimerdinger,57,25,32,43.86
Zac,Anivia,84,39,45,46.43
Zac,Kalista,65,36,29,55.38
Zac,Swain,102,43,59,42.16
Zac,Katarina,109,57,52,52.29
Zac,Sivir,78,23,55,29.49
Zac,Sona,31,12,19,38.71
Zac,Galio,173,96,77,55.49
Zac,Shyvana,33,12,21,36.36
Zac,Warwick,155,80,75,51.61
Zac,Sylas,207,89,118,43
Zac,Pyke,107,57,50,53.27
Zac,Graves,110,51,59,46.36
Zac,Janna,59,34,25,57.63
Zac,Kayle,66,26,40,39.39
Zac,RekSai,23,11,12,47.83
Zac,Seraphine,81,41,40,50.62
Zac,Jax,100,49,51,49
Zac,Shen,97,45,52,46.39
Zac,Akshan,33,20,13,60.61
Zac,Gangplank,70,30,40,42.86
Zac,Singed,44,14,30,31.82
Zac,Cassiopeia,64,33,31,51.56
Zac,Sejuani,93,40,53,43.01
Zac,Amumu,187,81,106,43.32
Zac,Rell,92,44,48,47.83
Zac,KSante,102,56,46,54.9
Zac,Milio,107,57,50,53.27
Zac,Zeri,87,36,51,41.38
Zac,Nilah,49,23,26,46.94
Zac,Fiora,63,39,24,61.9
Zac,Vex,111,35,76,31.53
Zac,Trundle,85,49,36,57.65
Zac,Tryndamere,41,27,14,65.85
Zac,Brand,65,32,33,49.23
Zac,Talon,54,29,25,53.7
Zac,Ekko,103,36,67,34.95
Zac,Lissandra,53,31,22,58.49
Zac,TwistedFate,52,40,12,76.92
Zac,Hecarim,52,21,31,40.38
Zac,Briar,60,30,30,50
Zac,Ornn,80,33,47,41.25
Zac,Taric,36,12,24,33.33
Zac,Zilean,41,13,28,31.71
Zac,Olaf,49,22,27,44.9
Zac,Maokai,94,29,65,30.85
Zac,Zoe,55,12,43,21.82
Zac,Naafiri,33,14,19,42.42
Zac,AurelionSol,48,19,29,39.58
Zac,Karthus,27,15,12,55.56
Zac,Qiyana,31,17,14,54.84
Zac,Quinn,29,15,14,51.72
Zac,Taliyah,52,28,24,53.85
Zac,Kled,24,12,12,50
Darius,Chogath,544,257,287,47.24
Darius,Mordekaiser,505,266,239,52.67
Darius,Swain,366,208,158,56.83
Darius,Sivir,232,112,120,48.28
Darius,Ashe,856,480,376,56.07
Darius,Riven,223,114,109,51.12
Darius,Karthus,118,56,62,47.46
Darius,Mel,895,500,395,55.87
Darius,Lucian,373,191,182,51.21
Darius,Nami,404,199,205,49.26
Darius,Jax,327,141,186,43.12
Darius,Pantheon,648,351,297,54.17
Darius,TwistedFate,143,50,93,34.97
Darius,Milio,252,105,147,41.67
Darius,Garen,680,352,328,51.76
Darius,Kayn,520,280,240,53.85
Darius,MissFortune,857,456,401,53.21
Darius,Velkoz,223,119,104,53.36
Darius,Diana,668,334,334,50
Darius,Yone,789,398,391,50.44
Darius,Caitlyn,945,477,468,50.48
Darius,Xerath,374,187,187,50
Darius,Kayle,253,133,120,52.57
Darius,Evelynn,147,81,66,55.1
Darius,Irelia,301,163,138,54.15
Darius,Corki,162,60,102,37.04
Darius,Syndra,315,158,157,50.16
Darius,Gangplank,248,114,134,45.97
Darius,Shaco,350,183,167,52.29
Darius,Veigar,435,230,205,52.87
Darius,Yuumi,392,204,188,52.04
Darius,Skarner,229,122,107,53.28
Darius,Volibear,515,230,285,44.66
Darius,Katarina,246,119,127,48.37
Darius,Twitch,303,168,135,55.45
Darius,Blitzcrank,400,213,187,53.25
Darius,Malphite,484,246,238,50.83
Darius,Ivern,73,40,33,54.79
Darius,Ahri,548,309,239,56.39
Darius,Lulu,670,356,314,53.13
Darius,Vladimir,230,118,112,51.3
Darius,Kaisa,746,360,386,48.26
Darius,Maokai,195,119,76,61.03
Darius,Briar,243,114,129,46.91
Darius,Zed,429,246,183,57.34
Darius,Ezreal,1163,659,504,56.66
Darius,Seraphine,308,172,136,55.84
Darius,Fizz,197,107,90,54.31
Darius,Karma,541,292,249,53.97
Darius,Yorick,313,129,184,41.21
Darius,Sejuani,277,136,141,49.1
Darius,Leblanc,196,103,93,52.55
Darius,Nilah,133,59,74,44.36
Darius,Camille,178,91,87,51.12
Darius,Kindred,155,95,60,61.29
Darius,Jinx,1089,489,600,44.9
Darius,Sion,342,176,166,51.46
Darius,Rengar,85,55,30,64.71
Darius,Hwei,304,173,131,56.91
Darius,Braum,357,172,185,48.18
Darius,Aatrox,519,268,251,51.64
Darius,Amumu,532,235,297,44.17
Darius,Taliyah,126,59,67,46.83
Darius,AurelionSol,173,91,82,52.6
Darius,Lux,886,449,437,50.68
Darius,Vayne,576,273,303,47.4
Darius,Yasuo,877,479,398,54.62
Darius,Sett,764,390,374,51.05
Darius,Warwick,537,271,266,50.47
Darius,Teemo,441,212,229,48.07
Darius,Xayah,254,140,114,55.12
Darius,LeeSin,720,428,292,59.44
Darius,Nautilus,546,294,252,53.85
Darius,Akali,392,197,195,50.26
Darius,Jhin,746,397,349,53.22
Darius,FiddleSticks,216,99,117,45.83
Darius,Qiyana,92,58,34,63.04
Darius,Rell,301,144,157,47.84
Darius,Khazix,214,105,109,49.07
Darius,Kled,85,50,35,58.82
Darius,MasterYi,480,238,242,49.58
Darius,Aphelios,213,103,110,48.36
Darius,Tristana,393,193,200,49.11
Darius,Nasus,262,103,159,39.31
Darius,Heimerdinger,176,97,79,55.11
Darius,Vi,447,246,201,55.03
Darius,Leona,436,224,212,51.38
Darius,Elise,369,192,177,52.03
Darius,MonkeyKing,392,215,177,54.85
Darius,Samira,362,187,175,51.66
Darius,Morgana,352,158,194,44.89
Darius,Poppy,325,156,169,48
Darius,Zilean,98,47,51,47.96
Darius,Brand,188,109,79,57.98
Darius,Nidalee,133,71,62,53.38
Darius,Belveth,80,36,44,45
Darius,Ziggs,112,73,39,65.18
Darius,Aurora,351,177,174,50.43
Darius,Ryze,170,105,65,61.76
Darius,Urgot,251,130,121,51.79
Darius,Zac,301,174,127,57.81
Darius,Rakan,219,106,113,48.4
Darius,Malzahar,438,213,225,48.63
Darius,Ekko,358,210,148,58.66
Darius,Zeri,194,118,76,60.82
Darius,Alistar,241,133,108,55.19
Darius,Sylas,633,331,302,52.29
Darius,Renata,111,51,60,45.95
Darius,Nocturne,482,237,245,49.17
Darius,Thresh,814,420,394,51.6
Darius,Vex,259,123,136,47.49
Darius,Renekton,235,116,119,49.36
Darius,Kalista,136,67,69,49.26
Darius,Talon,177,106,71,59.89
Darius,Senna,233,133,100,57.08
Darius,DrMundo,180,98,82,54.44
Darius,Shen,307,164,143,53.42
Darius,Viktor,359,164,195,45.68
Darius,Smolder,301,149,152,49.5
Darius,Soraka,153,75,78,49.02
Darius,Illaoi,220,101,119,45.91
Darius,XinZhao,291,139,152,47.77
Darius,Pyke,324,165,159,50.93
Darius,TahmKench,430,210,220,48.84
Darius,Graves,312,150,162,48.08
Darius,Anivia,153,77,76,50.33
Darius,Tryndamere,166,81,85,48.8
Darius,Varus,394,201,193,51.02
Darius,Azir,235,114,121,48.51
Darius,Janna,106,55,51,51.89
Darius,Annie,108,67,41,62.04
Darius,Rumble,125,57,68,45.6
Darius,Ambessa,268,138,130,51.49
Darius,Galio,484,240,244,49.59
Darius,Orianna,216,101,115,46.76
Darius,Fiora,150,70,80,46.67
Darius,Singed,80,27,53,33.75
Darius,Gragas,345,209,136,60.58
Darius,Lillia,226,119,107,52.65
Darius,Trundle,222,129,93,58.11
Darius,JarvanIV,307,152,155,49.51
Darius,Naafiri,97,55,42,56.7
Darius,Viego,523,251,272,47.99
Darius,Zyra,314,140,174,44.59
Darius,Ornn,230,135,95,58.7
Darius,Gwen,190,92,98,48.42
Darius,Gnar,302,166,136,54.97
Darius,Akshan,134,87,47,64.93
Darius,Neeko,235,132,103,56.17
Darius,Rammus,137,89,48,64.96
Darius,Draven,210,129,81,61.43
Darius,Taric,110,49,61,44.55
Darius,Sona,79,46,33,58.23
Darius,Olaf,93,59,34,63.44
Darius,Udyr,162,101,61,62.35
Darius,Kassadin,53,25,28,47.17
Darius,Shyvana,91,49,42,53.85
Darius,Cassiopeia,129,66,63,51.16
Darius,Nunu,297,180,117,60.61
Darius,Quinn,157,95,62,60.51
Darius,Zoe,192,99,93,51.56
Darius,Kennen,175,78,97,44.57
Darius,Jayce,244,135,109,55.33
Darius,Bard,122,56,66,45.9
Darius,Lissandra,143,94,49,65.73
Darius,Hecarim,132,56,76,42.42
Darius,KSante,308,179,129,58.12
Darius,RekSai,55,29,26,52.73
Darius,KogMaw,102,52,50,50.98
JarvanIV,Chogath,222,99,123,44.59
JarvanIV,Mordekaiser,211,97,114,45.97
JarvanIV,Swain,124,47,77,37.9
JarvanIV,Sivir,72,31,41,43.06
JarvanIV,Ashe,443,205,238,46.28
JarvanIV,Heimerdinger,50,23,27,46
JarvanIV,Gragas,185,102,83,55.14
JarvanIV,Viktor,232,116,116,50
JarvanIV,Jinx,475,206,269,43.37
JarvanIV,Pyke,113,64,49,56.64
JarvanIV,Sett,262,143,119,54.58
JarvanIV,LeeSin,380,191,189,50.26
JarvanIV,Hwei,125,56,69,44.8
JarvanIV,Jhin,335,179,156,53.43
JarvanIV,Zilean,52,19,33,36.54
JarvanIV,XinZhao,189,106,83,56.08
JarvanIV,Thresh,384,209,175,54.43
JarvanIV,Kaisa,328,183,145,55.79
JarvanIV,Morgana,132,79,53,59.85
JarvanIV,Graves,154,80,74,51.95
JarvanIV,Qiyana,31,15,16,48.39
JarvanIV,Kalista,71,47,24,66.2
JarvanIV,Neeko,76,44,32,57.89
JarvanIV,Ambessa,177,78,99,44.07
JarvanIV,Ekko,147,84,63,57.14
JarvanIV,Lux,437,233,204,53.32
JarvanIV,Caitlyn,424,246,178,58.02
JarvanIV,Soraka,96,53,43,55.21
JarvanIV,Kayn,233,117,116,50.21
JarvanIV,Kayle,75,44,31,58.67
JarvanIV,Shen,188,96,92,51.06
JarvanIV,Olaf,55,30,25,54.55
JarvanIV,Vi,270,147,123,54.44
JarvanIV,Katarina,107,58,49,54.21
JarvanIV,Veigar,169,82,87,48.52
JarvanIV,Bard,58,27,31,46.55
JarvanIV,Ryze,64,33,31,51.56
JarvanIV,Gnar,114,45,69,39.47
JarvanIV,Kindred,70,40,30,57.14
JarvanIV,Syndra,145,83,62,57.24
JarvanIV,Braum,190,94,96,49.47
JarvanIV,Akali,141,72,69,51.06
JarvanIV,Xayah,100,54,46,54
JarvanIV,Zyra,176,97,79,55.11
JarvanIV,Aatrox,189,90,99,47.62
JarvanIV,Briar,96,38,58,39.58
JarvanIV,Ahri,301,156,145,51.83
JarvanIV,Ezreal,442,235,207,53.17
JarvanIV,Elise,145,72,73,49.66
JarvanIV,Renekton,107,27,80,25.23
JarvanIV,Karma,233,126,107,54.08
JarvanIV,Shaco,131,71,60,54.2
JarvanIV,Akshan,70,28,42,40
JarvanIV,Samira,118,59,59,50
JarvanIV,Lulu,317,157,160,49.53
JarvanIV,Lillia,69,25,44,36.23
JarvanIV,Yone,250,131,119,52.4
JarvanIV,Draven,109,52,57,47.71
JarvanIV,Sejuani,170,93,77,54.71
JarvanIV,Tristana,197,100,97,50.76
JarvanIV,Varus,198,107,91,54.04
JarvanIV,Poppy,194,95,99,48.97
JarvanIV,Taliyah,49,26,23,53.06
JarvanIV,Yasuo,315,150,165,47.62
JarvanIV,Nautilus,284,172,112,60.56
JarvanIV,Nasus,111,54,57,48.65
JarvanIV,Nunu,98,45,53,45.92
JarvanIV,Xerath,173,99,74,57.23
JarvanIV,Volibear,178,66,112,37.08
JarvanIV,Sylas,311,174,137,55.95
JarvanIV,Twitch,121,76,45,62.81
JarvanIV,Amumu,240,97,143,40.42
JarvanIV,AurelionSol,69,40,29,57.97
JarvanIV,Vex,104,46,58,44.23
JarvanIV,Blitzcrank,141,74,67,52.48
JarvanIV,Irelia,117,63,54,53.85
JarvanIV,Talon,86,46,40,53.49
JarvanIV,Pantheon,284,138,146,48.59
JarvanIV,TahmKench,136,67,69,49.26
JarvanIV,Azir,79,40,39,50.63
JarvanIV,MissFortune,389,211,178,54.24
JarvanIV,Janna,83,38,45,45.78
JarvanIV,Khazix,73,31,42,42.47
JarvanIV,Riven,91,35,56,38.46
JarvanIV,Zoe,43,19,24,44.19
JarvanIV,TwistedFate,77,37,40,48.05
JarvanIV,Nilah,66,37,29,56.06
JarvanIV,Kassadin,42,22,20,52.38
JarvanIV,Darius,307,155,152,50.49
JarvanIV,Vladimir,98,43,55,43.88
JarvanIV,Smolder,144,67,77,46.53
JarvanIV,Gangplank,92,48,44,52.17
JarvanIV,Mel,387,188,199,48.58
JarvanIV,Zed,173,77,96,44.51
JarvanIV,Brand,83,30,53,36.14
JarvanIV,Malphite,240,102,138,42.5
JarvanIV,MonkeyKing,161,84,77,52.17
JarvanIV,Aurora,143,69,74,48.25
JarvanIV,Vayne,215,97,118,45.12
JarvanIV,Zac,124,63,61,50.81
JarvanIV,Seraphine,152,67,85,44.08
JarvanIV,Hecarim,48,29,19,60.42
JarvanIV,Teemo,140,76,64,54.29
JarvanIV,Lucian,197,118,79,59.9
JarvanIV,Senna,97,55,42,56.7
JarvanIV,Illaoi,92,64,28,69.57
JarvanIV,Ornn,111,64,47,57.66
JarvanIV,Viego,236,106,130,44.92
JarvanIV,Malzahar,187,101,86,54.01
JarvanIV,Tryndamere,58,33,25,56.9
JarvanIV,Milio,156,52,104,33.33
JarvanIV,Diana,290,149,141,51.38
JarvanIV,Orianna,119,69,50,57.98
JarvanIV,Udyr,70,46,24,65.71
JarvanIV,Rengar,55,37,18,67.27
JarvanIV,Galio,240,142,98,59.17
JarvanIV,Leona,188,94,94,50
JarvanIV,Yorick,142,67,75,47.18
JarvanIV,Nidalee,81,40,41,49.38
JarvanIV,Urgot,85,47,38,55.29
JarvanIV,Corki,94,47,47,50
JarvanIV,Yuumi,174,90,84,51.72
JarvanIV,Camille,99,52,47,52.53
JarvanIV,KSante,164,100,64,60.98
JarvanIV,Taric,44,28,16,63.64
JarvanIV,Naafiri,66,21,45,31.82
JarvanIV,Garen,277,132,145,47.65
JarvanIV,Alistar,82,43,39,52.44
JarvanIV,Skarner,101,60,41,59.41
JarvanIV,Rakan,109,53,56,48.62
JarvanIV,Quinn,63,27,36,42.86
JarvanIV,Renata,64,39,25,60.94
JarvanIV,Kennen,66,48,18,72.73
JarvanIV,MasterYi,209,111,98,53.11
JarvanIV,Sion,142,82,60,57.75
JarvanIV,Leblanc,107,58,49,54.21
JarvanIV,Trundle,78,40,38,51.28
JarvanIV,Nocturne,260,141,119,54.23
JarvanIV,Karthus,40,19,21,47.5
JarvanIV,DrMundo,76,53,23,69.74
JarvanIV,Zeri,94,42,52,44.68
JarvanIV,Rell,136,87,49,63.97
JarvanIV,Jax,127,58,69,45.67
JarvanIV,Velkoz,124,59,65,47.58
JarvanIV,Fiora,67,42,25,62.69
JarvanIV,Nami,184,96,88,52.17
JarvanIV,Cassiopeia,62,12,50,19.35
JarvanIV,Warwick,217,116,101,53.46
JarvanIV,Lissandra,73,39,34,53.42
JarvanIV,Kled,32,15,17,46.88
JarvanIV,Gwen,130,66,64,50.77
JarvanIV,Anivia,64,20,44,31.25
JarvanIV,Rammus,45,11,34,24.44
JarvanIV,Annie,75,44,31,58.67
JarvanIV,Fizz,86,42,44,48.84
JarvanIV,Aphelios,115,70,45,60.87
JarvanIV,Shyvana,32,8,24,25
JarvanIV,Ziggs,69,21,48,30.43
JarvanIV,FiddleSticks,110,69,41,62.73
JarvanIV,Sona,28,19,9,67.86
JarvanIV,Maokai,70,29,41,41.43
JarvanIV,Belveth,34,22,12,64.71
JarvanIV,KogMaw,67,29,38,43.28
JarvanIV,Singed,39,11,28,28.21
JarvanIV,Jayce,116,51,65,43.97
JarvanIV,Evelynn,43,22,21,51.16
JarvanIV,RekSai,23,12,11,52.17
JarvanIV,Rumble,49,25,24,51.02
JarvanIV,Ivern,30,21,9,70
Xerath,Chogath,202,119,83,58.91
Xerath,Mordekaiser,254,142,112,55.91
Xerath,Swain,141,77,64,54.61
Xerath,Sivir,137,77,60,56.2
Xerath,Ashe,434,198,236,45.62
Xerath,Sejuani,135,60,75,44.44
Xerath,Pantheon,258,131,127,50.78
Xerath,Neeko,99,59,40,59.6
Xerath,Varus,248,144,104,58.06
Xerath,Pyke,205,132,73,64.39
Xerath,Volibear,224,111,113,49.55
Xerath,MasterYi,223,104,119,46.64
Xerath,Mel,573,313,260,54.62
Xerath,Ezreal,541,250,291,46.21
Xerath,Blitzcrank,183,100,83,54.64
Xerath,Irelia,156,62,94,39.74
Xerath,Malphite,175,86,89,49.14
Xerath,Jhin,360,195,165,54.17
Xerath,Karma,303,132,171,43.56
Xerath,Gangplank,137,73,64,53.28
Xerath,Darius,374,187,187,50
Xerath,Teemo,172,84,88,48.84
Xerath,Nilah,42,28,14,66.67
Xerath,Braum,152,73,79,48.03
Xerath,Yorick,135,68,67,50.37
Xerath,Kindred,97,49,48,50.52
Xerath,Katarina,142,72,70,50.7
Xerath,Caitlyn,509,297,212,58.35
Xerath,Quinn,62,32,30,51.61
Xerath,LeeSin,470,269,201,57.23
Xerath,Akali,152,86,66,56.58
Xerath,Milio,135,54,81,40
Xerath,Vi,276,133,143,48.19
Xerath,Lucian,231,143,88,61.9
Xerath,Lux,489,271,218,55.42
Xerath,Veigar,232,127,105,54.74
Xerath,Lillia,101,47,54,46.53
Xerath,Jayce,145,69,76,47.59
Xerath,Smolder,136,73,63,53.68
Xerath,Riven,60,17,43,28.33
Xerath,Yasuo,381,169,212,44.36
Xerath,Tristana,156,76,80,48.72
Xerath,Nautilus,282,161,121,57.09
Xerath,Kayle,105,56,49,53.33
Xerath,Aphelios,91,54,37,59.34
Xerath,Gragas,153,96,57,62.75
Xerath,Aurora,142,82,60,57.75
Xerath,Diana,223,125,98,56.05
Xerath,Ryze,86,51,35,59.3
Xerath,Maokai,82,64,18,78.05
Xerath,Tryndamere,77,51,26,66.23
Xerath,MonkeyKing,118,53,65,44.92
Xerath,Malzahar,218,109,109,50
Xerath,MissFortune,391,187,204,47.83
Xerath,Ornn,122,57,65,46.72
Xerath,Elise,190,104,86,54.74
Xerath,Draven,108,63,45,58.33
Xerath,Renekton,111,56,55,50.45
Xerath,Viktor,216,109,107,50.46
Xerath,Seraphine,140,57,83,40.71
Xerath,Nami,198,118,80,59.6
Xerath,JarvanIV,173,74,99,42.77
Xerath,Ekko,159,73,86,45.91
Xerath,Orianna,117,57,60,48.72
Xerath,Karthus,49,33,16,67.35
Xerath,Zed,206,107,99,51.94
Xerath,Warwick,238,112,126,47.06
Xerath,Vladimir,117,64,53,54.7
Xerath,Jinx,514,248,266,48.25
Xerath,Morgana,182,78,104,42.86
Xerath,Yone,341,149,192,43.7
Xerath,Galio,216,133,83,61.57
Xerath,Shaco,141,71,70,50.35
Xerath,Soraka,117,56,61,47.86
Xerath,Vayne,256,122,134,47.66
Xerath,Kassadin,39,25,14,64.1
Xerath,Rengar,83,51,32,61.45
Xerath,Yuumi,173,83,90,47.98
Xerath,Hwei,157,82,75,52.23
Xerath,Lulu,285,136,149,47.72
Xerath,Zac,125,57,68,45.6
Xerath,Shyvana,64,33,31,51.56
Xerath,Twitch,147,65,82,44.22
Xerath,Rell,124,83,41,66.94
Xerath,Poppy,117,68,49,58.12
Xerath,Nocturne,234,105,129,44.87
Xerath,Velkoz,129,73,56,56.59
Xerath,Kayn,191,76,115,39.79
Xerath,Shen,186,72,114,38.71
Xerath,Ahri,273,134,139,49.08
Xerath,Nasus,112,44,68,39.29
Xerath,Rammus,74,44,30,59.46
Xerath,Jax,183,82,101,44.81
Xerath,Taliyah,54,15,39,27.78
Xerath,Syndra,161,78,83,48.45
Xerath,Leona,172,88,84,51.16
Xerath,Nidalee,85,52,33,61.18
Xerath,Talon,103,55,48,53.4
Xerath,Janna,42,23,19,54.76
Xerath,Skarner,92,51,41,55.43
Xerath,Thresh,403,169,234,41.94
Xerath,Olaf,50,27,23,54
Xerath,Amumu,201,98,103,48.76
Xerath,Sion,161,78,83,48.45
Xerath,Akshan,59,31,28,52.54
Xerath,Aatrox,227,105,122,46.26
Xerath,FiddleSticks,79,49,30,62.03
Xerath,Ambessa,182,113,69,62.09
Xerath,Fizz,128,68,60,53.13
Xerath,Samira,147,67,80,45.58
Xerath,Nunu,141,81,60,57.45
Xerath,KogMaw,69,40,29,57.97
Xerath,Garen,276,110,166,39.86
Xerath,AurelionSol,69,42,27,60.87
Xerath,Viego,248,127,121,51.21
Xerath,Kaisa,340,178,162,52.35
Xerath,Ivern,27,16,11,59.26
Xerath,Rakan,110,50,60,45.45
Xerath,Senna,132,55,77,41.67
Xerath,Zyra,175,106,69,60.57
Xerath,Lissandra,96,55,41,57.29
Xerath,Graves,147,88,59,59.86
Xerath,Cassiopeia,61,38,23,62.3
Xerath,Alistar,100,72,28,72
Xerath,Heimerdinger,88,52,36,59.09
Xerath,Khazix,106,68,38,64.15
Xerath,Briar,89,52,37,58.43
Xerath,TwistedFate,93,55,38,59.14
Xerath,Ziggs,88,38,50,43.18
Xerath,Fiora,75,44,31,58.67
Xerath,Camille,65,38,27,58.46
Xerath,Evelynn,58,35,23,60.34
Xerath,Trundle,103,52,51,50.49
Xerath,Sylas,296,151,145,51.01
Xerath,Urgot,112,55,57,49.11
Xerath,RekSai,32,18,14,56.25
Xerath,TahmKench,172,61,111,35.47
Xerath,Bard,58,28,30,48.28
Xerath,DrMundo,85,58,27,68.24
Xerath,Sett,293,142,151,48.46
Xerath,Zeri,88,48,40,54.55
Xerath,Belveth,31,8,23,25.81
Xerath,Brand,83,42,41,50.6
Xerath,Singed,44,22,22,50
Xerath,XinZhao,183,82,101,44.81
Xerath,Zilean,38,9,29,23.68
Xerath,KSante,143,82,61,57.34
Xerath,Gnar,77,25,52,32.47
Xerath,Vex,116,57,59,49.14
Xerath,Kled,30,13,17,43.33
Xerath,Kalista,46,21,25,45.65
Xerath,Zoe,70,31,39,44.29
Xerath,Leblanc,140,66,74,47.14
Xerath,Annie,64,33,31,51.56
Xerath,Renata,35,10,25,28.57
Xerath,Taric,24,10,14,41.67
Xerath,Gwen,72,46,26,63.89
Xerath,Naafiri,69,33,36,47.83
Xerath,Corki,39,13,26,33.33
Xerath,Sona,36,18,18,50
Xerath,Rumble,72,36,36,50
Xerath,Udyr,76,52,24,68.42
Xerath,Azir,56,26,30,46.43
Xerath,Hecarim,60,38,22,63.33
Xerath,Anivia,87,33,54,37.93
Xerath,Kennen,90,44,46,48.89
Xerath,Xayah,95,52,43,54.74
Xerath,Qiyana,44,16,28,36.36
Xerath,Illaoi,85,40,45,47.06
Yuumi,Chogath,243,128,115,52.67
Yuumi,Mordekaiser,273,137,136,50.18
Yuumi,Swain,186,95,91,51.08
Yuumi,Sivir,60,35,25,58.33
Yuumi,Ashe,443,212,231,47.86
Yuumi,Kayle,106,34,72,32.08
Yuumi,Kindred,96,49,47,51.04
Yuumi,AurelionSol,106,66,40,62.26
Yuumi,Caitlyn,474,243,231,51.27
Yuumi,Morgana,139,63,76,45.32
Yuumi,Garen,308,157,151,50.97
Yuumi,Warwick,254,112,142,44.09
Yuumi,Yasuo,358,177,181,49.44
Yuumi,MissFortune,359,185,174,51.53
Yuumi,Lux,438,208,230,47.49
Yuumi,Sett,264,107,157,40.53
Yuumi,LeeSin,365,188,177,51.51
Yuumi,Hwei,139,81,58,58.27
Yuumi,Jhin,335,169,166,50.45
Yuumi,Zilean,61,32,29,52.46
Yuumi,Leblanc,116,70,46,60.34
Yuumi,Kayn,180,83,97,46.11
Yuumi,Teemo,188,106,82,56.38
Yuumi,Nautilus,294,171,123,58.16
Yuumi,Fizz,78,35,43,44.87
Yuumi,Udyr,61,56,5,91.8
Yuumi,Vex,72,29,43,40.28
Yuumi,Sona,31,14,17,45.16
Yuumi,Darius,392,188,204,47.96
Yuumi,Riven,91,45,46,49.45
Yuumi,Soraka,114,76,38,66.67
Yuumi,Aatrox,272,143,129,52.57
Yuumi,Amumu,210,107,103,50.95
Yuumi,Taliyah,83,42,41,50.6
Yuumi,Milio,169,86,83,50.89
Yuumi,Malphite,196,119,77,60.71
Yuumi,Nocturne,283,147,136,51.94
Yuumi,Malzahar,152,76,76,50
Yuumi,Samira,166,75,91,45.18
Yuumi,Pyke,223,118,105,52.91
Yuumi,Ambessa,118,44,74,37.29
Yuumi,Thresh,438,206,232,47.03
Yuumi,Ryze,92,47,45,51.09
Yuumi,Renekton,97,43,54,44.33
Yuumi,Elise,149,84,65,56.38
Yuumi,Zed,178,84,94,47.19
Yuumi,Kaisa,398,201,197,50.5
Yuumi,Gnar,132,63,69,47.73
Yuumi,Akali,186,94,92,50.54
Yuumi,Lucian,176,94,82,53.41
Yuumi,Rumble,67,36,31,53.73
Yuumi,Zoe,97,61,36,62.89
Yuumi,Mel,395,217,178,54.94
Yuumi,Seraphine,118,60,58,50.85
Yuumi,MonkeyKing,174,110,64,63.22
Yuumi,Zac,96,43,53,44.79
Yuumi,Pantheon,374,184,190,49.2
Yuumi,Katarina,135,55,80,40.74
Yuumi,Urgot,64,50,14,78.13
Yuumi,Ezreal,459,225,234,49.02
Yuumi,Jax,138,76,62,55.07
Yuumi,Trundle,84,42,42,50
Yuumi,Syndra,157,66,91,42.04
Yuumi,Khazix,98,67,31,68.37
Yuumi,Sejuani,134,66,68,49.25
Yuumi,Gwen,90,48,42,53.33
Yuumi,Lillia,103,74,29,71.84
Yuumi,Nami,197,77,120,39.09
Yuumi,Ahri,323,147,176,45.51
Yuumi,Blitzcrank,180,101,79,56.11
Yuumi,Viego,244,120,124,49.18
Yuumi,Veigar,206,102,104,49.51
Yuumi,Leona,175,73,102,41.71
Yuumi,Karma,303,161,142,53.14
Yuumi,Ornn,126,56,70,44.44
Yuumi,Lissandra,81,33,48,40.74
Yuumi,Braum,142,63,79,44.37
Yuumi,Rengar,82,49,33,59.76
Yuumi,Rammus,88,49,39,55.68
Yuumi,Camille,129,64,65,49.61
Yuumi,Orianna,106,72,34,67.92
Yuumi,Xayah,139,68,71,48.92
Yuumi,Draven,140,76,64,54.29
Yuumi,Gangplank,126,69,57,54.76
Yuumi,Qiyana,44,26,18,59.09
Yuumi,Vladimir,133,62,71,46.62
Yuumi,Volibear,169,75,94,44.38
Yuumi,Alistar,105,44,61,41.9
Yuumi,Illaoi,95,54,41,56.84
Yuumi,Naafiri,43,15,28,34.88
Yuumi,TahmKench,151,77,74,50.99
Yuumi,Azir,102,53,49,51.96
Yuumi,Janna,54,18,36,33.33
Yuumi,Vi,238,100,138,42.02
Yuumi,FiddleSticks,117,53,64,45.3
Yuumi,Jinx,492,247,245,50.2
Yuumi,Lulu,405,214,191,52.84
Yuumi,Poppy,156,71,85,45.51
Yuumi,Aphelios,120,53,67,44.17
Yuumi,Xerath,173,90,83,52.02
Yuumi,Aurora,185,104,81,56.22
Yuumi,Varus,197,112,85,56.85
Yuumi,Talon,96,41,55,42.71
Yuumi,Nasus,108,65,43,60.19
Yuumi,Brand,99,55,44,55.56
Yuumi,Rell,169,97,72,57.4
Yuumi,Yorick,140,76,64,54.29
Yuumi,RekSai,28,14,14,50
Yuumi,Neeko,78,43,35,55.13
Yuumi,Diana,293,128,165,43.69
Yuumi,Galio,272,149,123,54.78
Yuumi,Akshan,60,33,27,55
Yuumi,Ziggs,47,23,24,48.94
Yuumi,Nunu,111,50,61,45.05
Yuumi,Skarner,117,59,58,50.43
Yuumi,Gragas,154,107,47,69.48
Yuumi,Rakan,120,59,61,49.17
Yuumi,Tryndamere,74,34,40,45.95
Yuumi,Smolder,164,88,76,53.66
Yuumi,Tristana,189,90,99,47.62
Yuumi,Sion,141,76,65,53.9
Yuumi,Nidalee,100,55,45,55
Yuumi,Twitch,107,64,43,59.81
Yuumi,JarvanIV,174,84,90,48.28
Yuumi,Viktor,176,100,76,56.82
Yuumi,Yone,294,131,163,44.56
Yuumi,Taric,50,14,36,28
Yuumi,DrMundo,86,35,51,40.7
Yuumi,Jayce,98,44,54,44.9
Yuumi,Nilah,64,18,46,28.13
Yuumi,Senna,75,30,45,40
Yuumi,KSante,153,81,72,52.94
Yuumi,Ekko,160,83,77,51.88
Yuumi,Vayne,247,138,109,55.87
Yuumi,Sylas,234,117,117,50
Yuumi,Bard,72,34,38,47.22
Yuumi,Fiora,51,32,19,62.75
Yuumi,Annie,60,39,21,65
Yuumi,XinZhao,155,78,77,50.32
Yuumi,Ivern,46,31,15,67.39
Yuumi,MasterYi,206,103,103,50
Yuumi,Briar,88,40,48,45.45
Yuumi,Shen,136,59,77,43.38
Yuumi,Irelia,132,81,51,61.36
Yuumi,Kassadin,38,29,9,76.32
Yuumi,Zyra,134,87,47,64.93
Yuumi,Cassiopeia,70,29,41,41.43
Yuumi,Kennen,49,24,25,48.98
Yuumi,Zeri,129,76,53,58.91
Yuumi,Olaf,51,17,34,33.33
Yuumi,Singed,64,19,45,29.69
Yuumi,Anivia,93,47,46,50.54
Yuumi,Heimerdinger,101,52,49,51.49
Yuumi,Shaco,145,72,73,49.66
Yuumi,Belveth,35,23,12,65.71
Yuumi,Velkoz,96,53,43,55.21
Yuumi,Evelynn,48,23,25,47.92
Yuumi,Corki,86,37,49,43.02
Yuumi,Maokai,71,31,40,43.66
Yuumi,Hecarim,65,29,36,44.62
Yuumi,Kled,29,24,5,82.76
Yuumi,TwistedFate,67,35,32,52.24
Yuumi,Karthus,41,27,14,65.85
Yuumi,Kalista,78,40,38,51.28
Yuumi,Quinn,63,45,18,71.43
Yuumi,Graves,144,57,87,39.58
Yuumi,Shyvana,36,15,21,41.67
Yuumi,Renata,25,13,12,52
Yuumi,KogMaw,47,31,16,65.96
Chogath,Darius,544,287,257,52.76
Chogath,JarvanIV,222,123,99,55.41
Chogath,Xerath,202,83,119,41.09
Chogath,Mel,606,324,282,53.47
Chogath,Yuumi,243,115,128,47.33
Chogath,Yorick,259,151,108,58.3
Chogath,Teemo,285,176,109,61.75
Chogath,Katarina,227,118,109,51.98
Chogath,Jhin,535,265,270,49.53
Chogath,Lux,544,291,253,53.49
Chogath,Sett,463,225,238,48.6
Chogath,LeeSin,483,265,218,54.87
Chogath,Hwei,210,113,97,53.81
Chogath,Zilean,107,57,50,53.27
Chogath,Kindred,122,73,49,59.84
Chogath,Twitch,199,99,100,49.75
Chogath,Lulu,453,254,199,56.07
Chogath,Gwen,180,81,99,45
Chogath,Pantheon,432,238,194,55.09
Chogath,Irelia,167,99,68,59.28
Chogath,Varus,268,136,132,50.75
Chogath,Fizz,159,94,65,59.12
Chogath,Udyr,140,83,57,59.29
Chogath,Vex,153,92,61,60.13
Chogath,Sona,44,20,24,45.45
Chogath,Diana,422,217,205,51.42
Chogath,Akali,234,130,104,55.56
Chogath,Ashe,522,264,258,50.57
Chogath,Milio,170,101,69,59.41
Chogath,Garen,515,263,252,51.07
Chogath,Belveth,29,17,12,58.62
Chogath,Malzahar,305,165,140,54.1
Chogath,Kennen,110,69,41,62.73
Chogath,XinZhao,164,104,60,63.41
Chogath,Brand,115,60,55,52.17
Chogath,Veigar,323,190,133,58.82
Chogath,Morgana,273,122,151,44.69
Chogath,Mordekaiser,392,196,196,50
Chogath,Nocturne,325,161,164,49.54
Chogath,Viktor,296,155,141,52.36
Chogath,Poppy,193,110,83,56.99
Chogath,Caitlyn,708,361,347,50.99
Chogath,Gnar,181,97,84,53.59
Chogath,Amumu,375,173,202,46.13
Chogath,Aurora,215,126,89,58.6
Chogath,Tristana,220,144,76,65.45
Chogath,Thresh,564,334,230,59.22
Chogath,Kayn,353,159,194,45.04
Chogath,Kayle,153,53,100,34.64
Chogath,Shen,242,116,126,47.93
Chogath,Rammus,88,46,42,52.27
Chogath,Zed,247,126,121,51.01
Chogath,Yasuo,500,245,255,49
Chogath,Rell,203,108,95,53.2
Chogath,Trundle,181,90,91,49.72
Chogath,Khazix,132,79,53,59.85
Chogath,Jayce,151,93,58,61.59
Chogath,Ekko,239,119,120,49.79
Chogath,KSante,150,69,81,46
Chogath,Kaisa,475,254,221,53.47
Chogath,TahmKench,288,128,160,44.44
Chogath,Talon,121,71,50,58.68
Chogath,Lissandra,142,75,67,52.82
Chogath,Corki,150,82,68,54.67
Chogath,Evelynn,94,40,54,42.55
Chogath,MissFortune,597,300,297,50.25
Chogath,Volibear,281,155,126,55.16
Chogath,Soraka,171,97,74,56.73
Chogath,Shaco,204,131,73,64.22
Chogath,Lucian,226,109,117,48.23
Chogath,Swain,267,111,156,41.57
Chogath,Leblanc,172,104,68,60.47
Chogath,Jinx,793,441,352,55.61
Chogath,Yone,462,251,211,54.33
Chogath,Rakan,222,109,113,49.1
Chogath,Ivern,94,53,41,56.38
Chogath,Rengar,83,45,38,54.22
Chogath,Ziggs,96,54,42,56.25
Chogath,Senna,189,97,92,51.32
Chogath,Kassadin,56,37,19,66.07
Chogath,Ezreal,679,374,305,55.08
Chogath,Sylas,430,235,195,54.65
Chogath,Blitzcrank,260,168,92,64.62
Chogath,Anivia,125,68,57,54.4
Chogath,Zyra,211,104,107,49.29
Chogath,Qiyana,78,45,33,57.69
Chogath,RekSai,19,10,9,52.63
Chogath,Gragas,239,132,107,55.23
Chogath,Renekton,133,70,63,52.63
Chogath,Nautilus,357,189,168,52.94
Chogath,AurelionSol,144,79,65,54.86
Chogath,Nunu,214,123,91,57.48
Chogath,Syndra,212,122,90,57.55
Chogath,Seraphine,193,86,107,44.56
Chogath,TwistedFate,73,47,26,64.38
Chogath,Alistar,166,104,62,62.65
Chogath,MasterYi,298,174,124,58.39
Chogath,Smolder,206,81,125,39.32
Chogath,Zac,189,94,95,49.74
Chogath,Aatrox,249,143,106,57.43
Chogath,Warwick,398,204,194,51.26
Chogath,Vladimir,229,137,92,59.83
Chogath,Kalista,77,38,39,49.35
Chogath,Renata,58,26,32,44.83
Chogath,Olaf,112,67,45,59.82
Chogath,Vayne,479,240,239,50.1
Chogath,Ahri,417,215,202,51.56
Chogath,Taric,78,38,40,48.72
Chogath,Sion,278,142,136,51.08
Chogath,Samira,162,94,68,58.02
Chogath,Ambessa,181,101,80,55.8
Chogath,Elise,254,139,115,54.72
Chogath,Quinn,95,43,52,45.26
Chogath,Briar,189,89,100,47.09
Chogath,Karma,389,203,186,52.19
Chogath,Cassiopeia,96,53,43,55.21
Chogath,MonkeyKing,157,75,82,47.77
Chogath,Azir,98,48,50,48.98
Chogath,Nasus,143,65,78,45.45
Chogath,Karthus,61,19,42,31.15
Chogath,Draven,125,57,68,45.6
Chogath,Jax,228,127,101,55.7
Chogath,Urgot,150,85,65,56.67
Chogath,Janna,104,51,53,49.04
Chogath,Ornn,183,108,75,59.02
Chogath,Viego,421,228,193,54.16
Chogath,Nilah,112,57,55,50.89
Chogath,Nami,288,136,152,47.22
Chogath,Illaoi,135,50,85,37.04
Chogath,Malphite,331,183,148,55.29
Chogath,Gangplank,147,81,66,55.1
Chogath,DrMundo,203,124,79,61.08
Chogath,Ryze,138,62,76,44.93
Chogath,Leona,288,144,144,50
Chogath,Sejuani,188,85,103,45.21
Chogath,Bard,123,52,71,42.28
Chogath,Heimerdinger,116,74,42,63.79
Chogath,Fiora,177,75,102,42.37
Chogath,Hecarim,94,37,57,39.36
Chogath,Camille,122,77,45,63.11
Chogath,Sivir,147,78,69,53.06
Chogath,Riven,121,71,50,58.68
Chogath,Velkoz,147,83,64,56.46
Chogath,Taliyah,79,23,56,29.11
Chogath,Skarner,105,62,43,59.05
Chogath,Shyvana,57,17,40,29.82
Chogath,Galio,293,142,151,48.46
Chogath,FiddleSticks,123,59,64,47.97
Chogath,Naafiri,89,39,50,43.82
Chogath,Nidalee,90,46,44,51.11
Chogath,Braum,233,110,123,47.21
Chogath,Vi,349,169,180,48.42
Chogath,Orianna,152,70,82,46.05
Chogath,Zoe,108,51,57,47.22
Chogath,Lillia,174,85,89,48.85
Chogath,Zeri,178,95,83,53.37
Chogath,Pyke,220,138,82,62.73
Chogath,Maokai,136,64,72,47.06
Chogath,KogMaw,95,43,52,45.26
Chogath,Tryndamere,116,62,54,53.45
Chogath,Akshan,112,63,49,56.25
Chogath,Aphelios,166,100,66,60.24
Chogath,Xayah,173,118,55,68.21
Chogath,Rumble,69,37,32,53.62
Chogath,Kled,59,34,25,57.63
Chogath,Annie,96,46,50,47.92
Chogath,Graves,185,116,69,62.7
Chogath,Neeko,109,69,40,63.3
Chogath,Singed,60,25,35,41.67
Sivir,Darius,232,120,112,51.72
Sivir,JarvanIV,72,41,31,56.94
Sivir,Xerath,137,60,77,43.8
Sivir,Mel,233,113,120,48.5
Sivir,Yuumi,60,25,35,41.67
Sivir,DrMundo,86,51,35,59.3
Sivir,Sejuani,108,54,54,50
Sivir,Lux,296,168,128,56.76
Sivir,Ashe,300,161,139,53.67
Sivir,TwistedFate,48,35,13,72.92
Sivir,Sett,167,89,78,53.29
Sivir,Hecarim,51,25,26,49.02
Sivir,Ahri,208,129,79,62.02
Sivir,Rakan,60,35,25,58.33
Sivir,Draven,76,49,27,64.47
Sivir,Graves,72,36,36,50
Sivir,Neeko,63,40,23,63.49
Sivir,Alistar,105,64,41,60.95
Sivir,Sion,107,44,63,41.12
Sivir,Pantheon,246,121,125,49.19
Sivir,Zoe,67,39,28,58.21
Sivir,Ziggs,51,24,27,47.06
Sivir,Veigar,127,53,74,41.73
Sivir,Illaoi,74,31,43,41.89
Sivir,Vex,110,63,47,57.27
Sivir,Lucian,135,56,79,41.48
Sivir,Braum,99,46,53,46.46
Sivir,Kalista,50,37,13,74
Sivir,Amumu,150,71,79,47.33
Sivir,Irelia,84,52,32,61.9
Sivir,Milio,79,32,47,40.51
Sivir,Mordekaiser,171,69,102,40.35
Sivir,Nocturne,198,111,87,56.06
Sivir,Viktor,168,86,82,51.19
Sivir,Poppy,98,53,45,54.08
Sivir,Caitlyn,305,167,138,54.75
Sivir,Ekko,101,47,54,46.53
Sivir,Azir,73,39,34,53.42
Sivir,Jinx,332,159,173,47.89
Sivir,Nami,135,65,70,48.15
Sivir,KSante,117,77,40,65.81
Sivir,Rammus,20,10,10,50
Sivir,Aurora,126,53,73,42.06
Sivir,Kaisa,237,135,102,56.96
Sivir,Zilean,39,21,18,53.85
Sivir,Ornn,63,35,28,55.56
Sivir,Kayn,151,75,76,49.67
Sivir,Sylas,189,101,88,53.44
Sivir,Pyke,124,74,50,59.68
Sivir,Camille,72,33,39,45.83
Sivir,Udyr,41,23,18,56.1
Sivir,Jhin,278,138,140,49.64
Sivir,TahmKench,127,63,64,49.61
Sivir,Tristana,91,47,44,51.65
Sivir,Varus,161,87,74,54.04
Sivir,Quinn,62,32,30,51.61
Sivir,Ambessa,99,53,46,53.54
Sivir,Brand,36,20,16,55.56
Sivir,Nasus,89,43,46,48.31
Sivir,Nunu,62,32,30,51.61
Sivir,Morgana,157,95,62,60.51
Sivir,Teemo,102,50,52,49.02
Sivir,MissFortune,271,137,134,50.55
Sivir,FiddleSticks,74,35,39,47.3
Sivir,Malzahar,140,56,84,40
Sivir,Leona,135,81,54,60
Sivir,Garen,197,115,82,58.38
Sivir,LeeSin,233,116,117,49.79
Sivir,Renekton,65,25,40,38.46
Sivir,Zyra,108,63,45,58.33
Sivir,Warwick,211,93,118,44.08
Sivir,Yasuo,231,129,102,55.84
Sivir,Seraphine,88,43,45,48.86
Sivir,Galio,153,76,77,49.67
Sivir,Jax,122,66,56,54.1
Sivir,Zeri,66,38,28,57.58
Sivir,Singed,47,17,30,36.17
Sivir,Ezreal,423,250,173,59.1
Sivir,Khazix,57,29,28,50.88
Sivir,Gnar,52,29,23,55.77
Sivir,MonkeyKing,85,34,51,40
Sivir,Karma,215,110,105,51.16
Sivir,Urgot,46,28,18,60.87
Sivir,Ivern,39,20,19,51.28
Sivir,AurelionSol,43,19,24,44.19
Sivir,Lulu,189,89,100,47.09
Sivir,Belveth,28,17,11,60.71
Sivir,Ryze,73,43,30,58.9
Sivir,Rell,100,53,47,53
Sivir,Soraka,50,22,28,44
Sivir,Akali,141,66,75,46.81
Sivir,Vi,178,90,88,50.56
Sivir,Hwei,78,51,27,65.38
Sivir,Diana,158,78,80,49.37
Sivir,Trundle,60,29,31,48.33
Sivir,Nautilus,212,123,89,58.02
Sivir,Gwen,77,41,36,53.25
Sivir,Leblanc,59,27,32,45.76
Sivir,Blitzcrank,163,87,76,53.37
Sivir,Shaco,100,67,33,67
Sivir,Zed,119,74,45,62.18
Sivir,Olaf,48,23,25,47.92
Sivir,Volibear,143,70,73,48.95
Sivir,Vayne,158,64,94,40.51
Sivir,Katarina,59,14,45,23.73
Sivir,MasterYi,136,62,74,45.59
Sivir,Chogath,147,69,78,46.94
Sivir,Lissandra,58,35,23,60.34
Sivir,Kassadin,23,10,13,43.48
Sivir,Shyvana,33,11,22,33.33
Sivir,Nidalee,45,26,19,57.78
Sivir,Zac,78,55,23,70.51
Sivir,Skarner,77,43,34,55.84
Sivir,Yone,199,122,77,61.31
Sivir,Taric,17,11,6,64.71
Sivir,Fiora,50,22,28,44
Sivir,Syndra,107,49,58,45.79
Sivir,Kindred,49,27,22,55.1
Sivir,KogMaw,28,9,19,32.14
Sivir,Senna,65,52,13,80
Sivir,Gangplank,61,32,29,52.46
Sivir,Aphelios,86,38,48,44.19
Sivir,Anivia,41,21,20,51.22
Sivir,Swain,123,59,64,47.97
Sivir,Aatrox,152,87,65,57.24
Sivir,Cassiopeia,40,12,28,30
Sivir,Orianna,72,33,39,45.83
Sivir,Nilah,16,6,10,37.5
Sivir,Fizz,52,15,37,28.85
Sivir,Malphite,132,77,55,58.33
Sivir,Briar,56,38,18,67.86
Sivir,Thresh,317,166,151,52.37
Sivir,Riven,51,29,22,56.86
Sivir,Shen,110,78,32,70.91
Sivir,Vladimir,95,48,47,50.53
Sivir,Talon,84,32,52,38.1
Sivir,Samira,103,46,57,44.66
Sivir,Yorick,90,54,36,60
Sivir,Bard,31,13,18,41.94
Sivir,Evelynn,43,14,29,32.56
Sivir,Janna,25,9,16,36
Sivir,Xayah,52,36,16,69.23
Sivir,Smolder,70,38,32,54.29
Sivir,Rengar,35,21,14,60
Sivir,Rumble,47,22,25,46.81
Sivir,Corki,65,43,22,66.15
Sivir,Maokai,60,44,16,73.33
Sivir,Gragas,79,51,28,64.56
Sivir,Elise,125,82,43,65.6
Sivir,Naafiri,21,8,13,38.1
Sivir,Viego,175,71,104,40.57
Sivir,Renata,32,17,15,53.13
Sivir,Kled,15,12,3,80
Sivir,Twitch,92,46,46,50
Sivir,Qiyana,14,5,9,35.71
Sivir,Kayle,77,29,48,37.66
Sivir,Velkoz,56,29,27,51.79
Sivir,Jayce,52,38,14,73.08
Sivir,XinZhao,101,50,51,49.5
Sivir,Sona,22,8,14,36.36
Sivir,Taliyah,37,27,10,72.97
Sivir,Kennen,34,18,16,52.94
Sivir,Tryndamere,35,15,20,42.86
Sivir,Lillia,70,38,32,54.29
Sivir,Akshan,27,17,10,62.96
Sivir,Heimerdinger,57,27,30,47.37
Sivir,Annie,41,33,8,80.49
Sivir,Karthus,11,6,5,54.55
Sivir,RekSai,15,15,0,100
Ashe,Darius,856,376,480,43.93
Ashe,JarvanIV,443,238,205,53.72
Ashe,Xerath,434,236,198,54.38
Ashe,Mel,898,408,490,45.43
Ashe,Yuumi,443,231,212,52.14
Ashe,Sejuani,371,167,204,45.01
Ashe,Pantheon,673,362,311,53.79
Ashe,Neeko,215,107,108,49.77
Ashe,Varus,532,248,284,46.62
Ashe,Pyke,388,208,180,53.61
Ashe,Malphite,495,221,274,44.65
Ashe,Vi,472,216,256,45.76
Ashe,Veigar,373,185,188,49.6
Ashe,Sivir,300,139,161,46.33
Ashe,Senna,300,134,166,44.67
Ashe,Teemo,401,230,171,57.36
Ashe,Viego,670,283,387,42.24
Ashe,Anivia,166,83,83,50
Ashe,MissFortune,992,461,531,46.47
Ashe,TahmKench,462,238,224,51.52
Ashe,Thresh,859,419,440,48.78
Ashe,Annie,173,91,82,52.6
Ashe,Nasus,283,136,147,48.06
Ashe,Tristana,439,189,250,43.05
Ashe,Poppy,350,153,197,43.71
Ashe,Gnar,252,108,144,42.86
Ashe,Hecarim,154,76,78,49.35
Ashe,Viktor,415,189,226,45.54
Ashe,Rell,318,130,188,40.88
Ashe,Riven,204,90,114,44.12
Ashe,MonkeyKing,351,164,187,46.72
Ashe,Kassadin,83,40,43,48.19
Ashe,Caitlyn,1415,715,700,50.53
Ashe,Taliyah,134,67,67,50
Ashe,Urgot,169,86,83,50.89
Ashe,Kayn,546,276,270,50.55
Ashe,Vladimir,264,131,133,49.62
Ashe,Kaisa,836,443,393,52.99
Ashe,Taric,120,61,59,50.83
Ashe,Yone,861,403,458,46.81
Ashe,Diana,632,314,318,49.68
Ashe,Gragas,379,203,176,53.56
Ashe,Yasuo,902,455,447,50.44
Ashe,Nami,469,205,264,43.71
Ashe,Xayah,237,115,122,48.52
Ashe,Lucian,440,229,211,52.05
Ashe,Shen,376,191,185,50.8
Ashe,Shaco,349,177,172,50.72
Ashe,Heimerdinger,213,110,103,51.64
Ashe,Ezreal,1544,765,779,49.55
Ashe,Quinn,147,73,74,49.66
Ashe,MasterYi,449,213,236,47.44
Ashe,Garen,689,320,369,46.44
Ashe,Smolder,266,126,140,47.37
Ashe,Nautilus,683,306,377,44.8
Ashe,Zed,468,219,249,46.79
Ashe,Skarner,226,122,104,53.98
Ashe,Aurora,400,193,207,48.25
Ashe,Mordekaiser,566,260,306,45.94
Ashe,Amumu,482,237,245,49.17
Ashe,Karma,635,324,311,51.02
Ashe,Briar,266,104,162,39.1
Ashe,Nocturne,521,247,274,47.41
Ashe,Lissandra,198,101,97,51.01
Ashe,Khazix,226,115,111,50.88
Ashe,Galio,553,252,301,45.57
Ashe,Yorick,383,181,202,47.26
Ashe,Sylas,855,415,440,48.54
Ashe,Renata,132,49,83,37.12
Ashe,Camille,218,118,100,54.13
Ashe,Graves,335,159,176,47.46
Ashe,Hwei,337,172,165,51.04
Ashe,Nilah,152,68,84,44.74
Ashe,Jax,382,212,170,55.5
Ashe,RekSai,89,49,40,55.06
Ashe,Rakan,231,107,124,46.32
Ashe,Cassiopeia,125,50,75,40
Ashe,XinZhao,397,163,234,41.06
Ashe,Orianna,254,128,126,50.39
Ashe,Ahri,703,382,321,54.34
Ashe,Rengar,122,57,65,46.72
Ashe,Chogath,522,258,264,49.43
Ashe,Zyra,388,181,207,46.65
Ashe,Malzahar,478,243,235,50.84
Ashe,Corki,190,94,96,49.47
Ashe,LeeSin,1016,513,503,50.49
Ashe,Katarina,270,121,149,44.81
Ashe,Aatrox,577,267,310,46.27
Ashe,Blitzcrank,440,191,249,43.41
Ashe,Irelia,391,205,186,52.43
Ashe,Jhin,889,438,451,49.27
Ashe,Leona,472,222,250,47.03
Ashe,Kindred,179,78,101,43.58
Ashe,Elise,401,192,209,47.88
Ashe,Vayne,573,278,295,48.52
Ashe,Akali,411,210,201,51.09
Ashe,Jinx,1451,625,826,43.07
Ashe,Milio,336,135,201,40.18
Ashe,KSante,372,209,163,56.18
Ashe,Rammus,145,70,75,48.28
Ashe,Zilean,150,85,65,56.67
Ashe,Ziggs,168,78,90,46.43
Ashe,Belveth,96,51,45,53.13
Ashe,Samira,267,123,144,46.07
Ashe,Sion,389,185,204,47.56
Ashe,Warwick,609,309,300,50.74
Ashe,Swain,499,221,278,44.29
Ashe,Illaoi,238,112,126,47.06
Ashe,Nunu,245,119,126,48.57
Ashe,Lux,1024,536,488,52.34
Ashe,Volibear,447,187,260,41.83
Ashe,Ambessa,348,176,172,50.57
Ashe,Vex,290,141,149,48.62
Ashe,Aphelios,259,145,114,55.98
Ashe,Lulu,767,380,387,49.54
Ashe,Rumble,128,57,71,44.53
Ashe,Zoe,190,85,105,44.74
Ashe,Morgana,476,218,258,45.8
Ashe,Talon,245,125,120,51.02
Ashe,Udyr,166,92,74,55.42
Ashe,Sona,97,56,41,57.73
Ashe,Fizz,174,97,77,55.75
Ashe,Soraka,197,93,104,47.21
Ashe,Evelynn,124,74,50,59.68
Ashe,Brand,275,162,113,58.91
Ashe,Ornn,311,130,181,41.8
Ashe,Trundle,275,142,133,51.64
Ashe,Sett,657,294,363,44.75
Ashe,Lillia,230,84,146,36.52
Ashe,Renekton,202,87,115,43.07
Ashe,Tryndamere,135,76,59,56.3
Ashe,Ekko,361,149,212,41.27
Ashe,Olaf,158,76,82,48.1
Ashe,Leblanc,336,147,189,43.75
Ashe,Nidalee,194,76,118,39.18
Ashe,Kled,103,45,58,43.69
Ashe,Velkoz,199,97,102,48.74
Ashe,Seraphine,303,145,158,47.85
Ashe,Zac,325,180,145,55.38
Ashe,Azir,215,109,106,50.7
Ashe,Fiora,165,82,83,49.7
Ashe,DrMundo,217,119,98,54.84
Ashe,FiddleSticks,267,128,139,47.94
Ashe,Ivern,95,50,45,52.63
Ashe,Draven,237,117,120,49.37
Ashe,Alistar,254,130,124,51.18
Ashe,Gwen,244,113,131,46.31
Ashe,Jayce,253,135,118,53.36
Ashe,Shyvana,111,46,65,41.44
Ashe,Singed,115,38,77,33.04
Ashe,Naafiri,126,59,67,46.83
Ashe,Gangplank,336,172,164,51.19
Ashe,Twitch,323,172,151,53.25
Ashe,Kayle,212,108,104,50.94
Ashe,Kennen,147,53,94,36.05
Ashe,Maokai,180,80,100,44.44
Ashe,Braum,333,145,188,43.54
Ashe,Zeri,231,101,130,43.72
Ashe,Qiyana,69,31,38,44.93
Ashe,Ryze,166,81,85,48.8
Ashe,KogMaw,136,74,62,54.41
Ashe,Syndra,297,145,152,48.82
Ashe,Janna,140,72,68,51.43
Ashe,TwistedFate,133,65,68,48.87
Ashe,AurelionSol,187,97,90,51.87
Ashe,Kalista,183,100,83,54.64
Ashe,Karthus,108,50,58,46.3
Ashe,Akshan,112,63,49,56.25
Ashe,Bard,99,31,68,31.31
Malphite,Sett,403,211,192,52.36
Malphite,Kayn,299,159,140,53.18
Malphite,Katarina,130,78,52,60
Malphite,Jinx,619,281,338,45.4
Malphite,Renata,61,37,24,60.66
Malphite,DrMundo,103,53,50,51.46
Malphite,Sejuani,188,88,100,46.81
Malphite,Lux,581,267,314,45.96
Malphite,Ashe,495,274,221,55.35
Malphite,TwistedFate,65,25,40,38.46
Malphite,Pantheon,446,237,209,53.14
Malphite,Ekko,172,85,87,49.42
Malphite,Talon,110,46,64,41.82
Malphite,Kaisa,422,244,178,57.82
Malphite,Soraka,143,81,62,56.64
Malphite,Teemo,320,166,154,51.88
Malphite,Khazix,177,110,67,62.15
Malphite,Zoe,106,73,33,68.87
Malphite,Poppy,177,85,92,48.02
Malphite,Amumu,322,132,190,40.99
Malphite,Lissandra,110,63,47,57.27
Malphite,Lucian,230,116,114,50.43
Malphite,Xerath,175,89,86,50.86
Malphite,Aatrox,247,136,111,55.06
Malphite,MasterYi,302,147,155,48.68
Malphite,Mel,524,263,261,50.19
Malphite,Tristana,216,102,114,47.22
Malphite,Sona,40,19,21,47.5
Malphite,Rengar,104,62,42,59.62
Malphite,Warwick,328,155,173,47.26
Malphite,Irelia,212,125,87,58.96
Malphite,Nautilus,350,153,197,43.71
Malphite,Fizz,109,56,53,51.38
Malphite,Udyr,84,52,32,61.9
Malphite,Vex,167,98,69,58.68
Malphite,Darius,484,238,246,49.17
Malphite,XinZhao,178,91,87,51.12
Malphite,Orianna,160,71,89,44.38
Malphite,Ezreal,778,384,394,49.36
Malphite,Thresh,496,229,267,46.17
Malphite,Nocturne,362,187,175,51.66
Malphite,Nami,253,114,139,45.06
Malphite,Yone,492,279,213,56.71
Malphite,Malzahar,263,155,108,58.94
Malphite,KogMaw,79,35,44,44.3
Malphite,Veigar,274,147,127,53.65
Malphite,Gwen,153,86,67,56.21
Malphite,Briar,166,70,96,42.17
Malphite,Aurora,151,82,69,54.3
Malphite,TahmKench,206,78,128,37.86
Malphite,Nasus,196,87,109,44.39
Malphite,Anivia,89,52,37,58.43
Malphite,Vayne,377,214,163,56.76
Malphite,Yuumi,196,77,119,39.29
Malphite,Xayah,160,93,67,58.13
Malphite,Karthus,57,25,32,43.86
Malphite,Naafiri,70,44,26,62.86
Malphite,Heimerdinger,110,47,63,42.73
Malphite,Samira,209,115,94,55.02
Malphite,Kindred,103,65,38,63.11
Malphite,Yasuo,599,296,303,49.42
Malphite,MissFortune,494,249,245,50.4
Malphite,Riven,93,47,46,50.54
Malphite,Galio,297,134,163,45.12
Malphite,Lulu,354,188,166,53.11
Malphite,Diana,393,198,195,50.38
Malphite,Ryze,109,63,46,57.8
Malphite,Pyke,259,167,92,64.48
Malphite,Vi,285,147,138,51.58
Malphite,Smolder,226,114,112,50.44
Malphite,Volibear,194,104,90,53.61
Malphite,Gnar,196,122,74,62.24
Malphite,Elise,191,79,112,41.36
Malphite,Zyra,219,125,94,57.08
Malphite,Varus,257,131,126,50.97
Malphite,Leona,296,144,152,48.65
Malphite,Quinn,135,73,62,54.07
Malphite,Sylas,588,238,350,40.48
Malphite,Vladimir,183,70,113,38.25
Malphite,LeeSin,408,172,236,42.16
Malphite,Twitch,213,116,97,54.46
Malphite,Renekton,141,58,83,41.13
Malphite,Urgot,139,74,65,53.24
Malphite,Ahri,347,179,168,51.59
Malphite,Blitzcrank,226,120,106,53.1
Malphite,Caitlyn,652,326,326,50
Malphite,Zed,326,166,160,50.92
Malphite,Shaco,185,110,75,59.46
Malphite,Gangplank,154,73,81,47.4
Malphite,Karma,300,159,141,53
Malphite,Mordekaiser,374,155,219,41.44
Malphite,Maokai,93,48,45,51.61
Malphite,Ziggs,84,36,48,42.86
Malphite,Yorick,203,97,106,47.78
Malphite,Alistar,167,83,84,49.7
Malphite,Jhin,463,211,252,45.57
Malphite,Garen,354,150,204,42.37
Malphite,Senna,199,95,104,47.74
Malphite,FiddleSticks,91,47,44,51.65
Malphite,Seraphine,211,100,111,47.39
Malphite,Gragas,139,78,61,56.12
Malphite,Corki,107,46,61,42.99
Malphite,Swain,250,102,148,40.8
Malphite,Ivern,31,22,9,70.97
Malphite,Syndra,189,114,75,60.32
Malphite,Aphelios,143,89,54,62.24
Malphite,Viktor,258,127,131,49.22
Malphite,Illaoi,116,56,60,48.28
Malphite,Lillia,131,70,61,53.44
Malphite,Bard,78,39,39,50
Malphite,Akali,204,94,110,46.08
Malphite,Morgana,244,124,120,50.82
Malphite,Viego,361,179,182,49.58
Malphite,Leblanc,150,82,68,54.67
Malphite,JarvanIV,240,138,102,57.5
Malphite,Hwei,165,88,77,53.33
Malphite,Ambessa,190,102,88,53.68
Malphite,Qiyana,70,43,27,61.43
Malphite,Brand,116,60,56,51.72
Malphite,Nilah,85,51,34,60
Malphite,Taliyah,72,40,32,55.56
Malphite,Nidalee,68,24,44,35.29
Malphite,Rell,179,110,69,61.45
Malphite,Chogath,331,148,183,44.71
Malphite,Velkoz,134,79,55,58.96
Malphite,Tryndamere,150,83,67,55.33
Malphite,Rumble,84,45,39,53.57
Malphite,RekSai,48,33,15,68.75
Malphite,Rakan,148,75,73,50.68
Malphite,Shen,174,90,84,51.72
Malphite,Nunu,179,104,75,58.1
Malphite,Evelynn,68,23,45,33.82
Malphite,Ornn,184,74,110,40.22
Malphite,Kalista,93,47,46,50.54
Malphite,Milio,145,75,70,51.72
Malphite,Skarner,98,50,48,51.02
Malphite,Taric,56,33,23,58.93
Malphite,Shyvana,62,36,26,58.06
Malphite,Fiora,87,55,32,63.22
Malphite,Cassiopeia,96,37,59,38.54
Malphite,Zac,127,53,74,41.73
Malphite,Kayle,124,60,64,48.39
Malphite,Graves,193,108,85,55.96
Malphite,Azir,108,66,42,61.11
Malphite,Olaf,67,21,46,31.34
Malphite,Hecarim,89,54,35,60.67
Malphite,KSante,145,79,66,54.48
Malphite,Zeri,111,47,64,42.34
Malphite,AurelionSol,92,41,51,44.57
Malphite,Trundle,127,63,64,49.61
Malphite,Jayce,141,85,56,60.28
Malphite,Sion,233,109,124,46.78
Malphite,Janna,77,38,39,49.35
Malphite,Draven,123,83,40,67.48
Malphite,Zilean,68,28,40,41.18
Malphite,Singed,76,26,50,34.21
Malphite,MonkeyKing,162,72,90,44.44
Malphite,Jax,157,88,69,56.05
Malphite,Neeko,111,55,56,49.55
Malphite,Sivir,132,55,77,41.67
Malphite,Braum,181,111,70,61.33
Malphite,Camille,85,41,44,48.24
Malphite,Kassadin,49,29,20,59.18
Malphite,Rammus,115,55,60,47.83
Malphite,Akshan,100,50,50,50
Malphite,Kennen,80,43,37,53.75
Malphite,Belveth,46,25,21,54.35
Malphite,Annie,69,35,34,50.72
Malphite,Kled,27,13,14,48.15
Lissandra,Sett,154,77,77,50
Lissandra,Kayn,105,62,43,59.05
Lissandra,Katarina,49,26,23,53.06
Lissandra,Jinx,202,52,150,25.74
Lissandra,Renata,11,8,3,72.73
Lissandra,Nasus,35,21,14,60
Lissandra,Sejuani,88,37,51,42.05
Lissandra,Malzahar,60,32,28,53.33
Lissandra,TwistedFate,42,19,23,45.24
Lissandra,Seraphine,83,46,37,55.42
Lissandra,Irelia,58,31,27,53.45
Lissandra,Malphite,110,47,63,42.73
Lissandra,Jhin,153,66,87,43.14
Lissandra,Karma,97,50,47,51.55
Lissandra,Aatrox,88,57,31,64.77
Lissandra,Lillia,46,29,17,63.04
Lissandra,Hwei,66,34,32,51.52
Lissandra,Ashe,198,97,101,48.99
Lissandra,Amumu,106,57,49,53.77
Lissandra,Gangplank,59,25,34,42.37
Lissandra,Pantheon,133,70,63,52.63
Lissandra,Kaisa,170,111,59,65.29
Lissandra,Braum,77,42,35,54.55
Lissandra,Poppy,70,40,30,57.14
Lissandra,Khazix,51,26,25,50.98
Lissandra,Yone,139,60,79,43.17
Lissandra,Gragas,67,30,37,44.78
Lissandra,Trundle,43,23,20,53.49
Lissandra,Aurora,66,36,30,54.55
Lissandra,Varus,78,41,37,52.56
Lissandra,XinZhao,61,29,32,47.54
Lissandra,Chogath,142,67,75,47.18
Lissandra,Gwen,44,16,28,36.36
Lissandra,Rell,71,48,23,67.61
Lissandra,Nunu,72,31,41,43.06
Lissandra,Lux,190,98,92,51.58
Lissandra,Caitlyn,231,122,109,52.81
Lissandra,Milio,76,30,46,39.47
Lissandra,Yorick,87,34,53,39.08
Lissandra,Viego,131,69,62,52.67
Lissandra,Xayah,52,28,24,53.85
Lissandra,Rakan,45,12,33,26.67
Lissandra,Mordekaiser,98,49,49,50
Lissandra,Viktor,107,46,61,42.99
Lissandra,Fiora,32,22,10,68.75
Lissandra,Diana,144,63,81,43.75
Lissandra,Akali,104,39,65,37.5
Lissandra,Yuumi,81,48,33,59.26
Lissandra,Taliyah,20,11,9,55
Lissandra,Zed,137,88,49,64.23
Lissandra,MissFortune,184,90,94,48.91
Lissandra,Gnar,58,41,17,70.69
Lissandra,Nocturne,131,65,66,49.62
Lissandra,Galio,108,62,46,57.41
Lissandra,Vayne,84,44,40,52.38
Lissandra,LeeSin,159,74,85,46.54
Lissandra,Sylas,143,71,72,49.65
Lissandra,Tristana,91,39,52,42.86
Lissandra,Nautilus,115,78,37,67.83
Lissandra,Lulu,147,64,83,43.54
Lissandra,Mel,158,111,47,70.25
Lissandra,Soraka,42,15,27,35.71
Lissandra,Teemo,56,22,34,39.29
Lissandra,Shaco,82,54,28,65.85
Lissandra,Zoe,41,29,12,70.73
Lissandra,Nilah,45,24,21,53.33
Lissandra,Illaoi,58,28,30,48.28
Lissandra,Ziggs,40,14,26,35
Lissandra,Cassiopeia,43,22,21,51.16
Lissandra,Yasuo,214,93,121,43.46
Lissandra,Leona,106,58,48,54.72
Lissandra,Riven,61,28,33,45.9
Lissandra,Syndra,43,23,20,53.49
Lissandra,Blitzcrank,70,43,27,61.43
Lissandra,FiddleSticks,36,18,18,50
Lissandra,Nami,103,57,46,55.34
Lissandra,Akshan,26,12,14,46.15
Lissandra,Ornn,38,20,18,52.63
Lissandra,Qiyana,33,13,20,39.39
Lissandra,Neeko,40,23,17,57.5
Lissandra,DrMundo,39,28,11,71.79
Lissandra,Rengar,29,24,5,82.76
Lissandra,Zyra,92,36,56,39.13
Lissandra,Sion,63,27,36,42.86
Lissandra,Renekton,51,32,19,62.75
Lissandra,Brand,32,18,14,56.25
Lissandra,Sivir,58,23,35,39.66
Lissandra,Nidalee,38,22,16,57.89
Lissandra,TahmKench,111,64,47,57.66
Lissandra,Kayle,66,32,34,48.48
Lissandra,Naafiri,27,15,12,55.56
Lissandra,Alistar,50,28,22,56
Lissandra,Xerath,96,41,55,42.71
Lissandra,Graves,55,35,20,63.64
Lissandra,Zeri,51,33,18,64.71
Lissandra,Smolder,58,23,35,39.66
Lissandra,Janna,20,5,15,25
Lissandra,Jayce,30,11,19,36.67
Lissandra,Aphelios,68,42,26,61.76
Lissandra,Thresh,189,85,104,44.97
Lissandra,Annie,31,7,24,22.58
Lissandra,Garen,145,79,66,54.48
Lissandra,Warwick,124,41,83,33.06
Lissandra,Ahri,169,81,88,47.93
Lissandra,Morgana,82,26,56,31.71
Lissandra,Udyr,17,10,7,58.82
Lissandra,Leblanc,83,49,34,59.04
Lissandra,Vladimir,48,23,25,47.92
Lissandra,MonkeyKing,78,36,42,46.15
Lissandra,Ezreal,227,119,108,52.42
Lissandra,Samira,89,40,49,44.94
Lissandra,Rammus,42,14,28,33.33
Lissandra,KSante,77,32,45,41.56
Lissandra,AurelionSol,53,20,33,37.74
Lissandra,Quinn,24,10,14,41.67
Lissandra,Briar,34,12,22,35.29
Lissandra,Senna,53,26,27,49.06
Lissandra,Shyvana,17,8,9,47.06
Lissandra,Velkoz,37,22,15,59.46
Lissandra,Elise,94,51,43,54.26
Lissandra,Veigar,95,38,57,40
Lissandra,Darius,143,49,94,34.27
Lissandra,Azir,27,10,17,37.04
Lissandra,Karthus,26,11,15,42.31
Lissandra,Vex,45,12,33,26.67
Lissandra,Pyke,48,25,23,52.08
Lissandra,Talon,29,17,12,58.62
Lissandra,Heimerdinger,28,10,18,35.71
Lissandra,Anivia,35,11,24,31.43
Lissandra,MasterYi,102,56,46,54.9
Lissandra,Singed,33,20,13,60.61
Lissandra,Jax,58,34,24,58.62
Lissandra,Corki,41,23,18,56.1
Lissandra,Kindred,36,10,26,27.78
Lissandra,Zilean,25,7,18,28
Lissandra,Tryndamere,35,12,23,34.29
Lissandra,Fizz,42,28,14,66.67
Lissandra,Skarner,23,10,13,43.48
Lissandra,JarvanIV,73,34,39,46.58
Lissandra,Belveth,24,19,5,79.17
Lissandra,Evelynn,41,28,13,68.29
Lissandra,Volibear,100,53,47,53
Lissandra,Zac,53,22,31,41.51
Lissandra,Kassadin,23,5,18,21.74
Lissandra,Hecarim,28,20,8,71.43
Lissandra,Twitch,50,24,26,48
Lissandra,Lucian,62,37,25,59.68
Lissandra,Shen,66,43,23,65.15
Lissandra,Ambessa,36,20,16,55.56
Lissandra,Swain,70,17,53,24.29
Lissandra,Draven,56,30,26,53.57
Lissandra,Taric,22,6,16,27.27
Lissandra,Vi,85,28,57,32.94
Lissandra,Kalista,35,10,25,28.57
Lissandra,KogMaw,34,21,13,61.76
Lissandra,Urgot,27,16,11,59.26
Lissandra,Bard,17,8,9,47.06
Lissandra,Olaf,28,16,12,57.14
Lissandra,Orianna,45,19,26,42.22
Lissandra,Rumble,23,16,7,69.57
Lissandra,Camille,37,23,14,62.16
Lissandra,Ryze,22,14,8,63.64
Lissandra,Ekko,65,31,34,47.69
Lissandra,Kled,15,6,9,40
Lissandra,RekSai,30,17,13,56.67
Lissandra,Sona,13,9,4,69.23
Lissandra,Ivern,5,5,0,100
Lissandra,Maokai,45,17,28,37.78
Lissandra,Kennen,23,11,12,47.83
Lulu,Sett,448,215,233,47.99
Lulu,Kayn,405,204,201,50.37
Lulu,Katarina,249,146,103,58.63
Lulu,Jinx,867,406,461,46.83
Lulu,Renata,102,63,39,61.76
Lulu,Akali,345,173,172,50.14
Lulu,LeeSin,676,339,337,50.15
Lulu,Yasuo,620,319,301,51.45
Lulu,Hwei,274,134,140,48.91
Lulu,Pyke,268,158,110,58.96
Lulu,Quinn,123,53,70,43.09
Lulu,Sejuani,267,138,129,51.69
Lulu,Leblanc,246,147,99,59.76
Lulu,Twitch,262,153,109,58.4
Lulu,Nautilus,454,238,216,52.42
Lulu,Trundle,131,84,47,64.12
Lulu,Sylas,484,252,232,52.07
Lulu,Zac,273,118,155,43.22
Lulu,MissFortune,664,324,340,48.8
Lulu,Seraphine,297,136,161,45.79
Lulu,Shaco,288,157,131,54.51
Lulu,Zoe,198,90,108,45.45
Lulu,KogMaw,109,57,52,52.29
Lulu,TwistedFate,91,38,53,41.76
Lulu,Chogath,453,199,254,43.93
Lulu,Nocturne,527,250,277,47.44
Lulu,Orianna,210,116,94,55.24
Lulu,Caitlyn,793,365,428,46.03
Lulu,Neeko,134,73,61,54.48
Lulu,Tryndamere,120,70,50,58.33
Lulu,Morgana,325,152,173,46.77
Lulu,Volibear,327,170,157,51.99
Lulu,MasterYi,310,182,128,58.71
Lulu,Mel,754,426,328,56.5
Lulu,Ezreal,1023,565,458,55.23
Lulu,Blitzcrank,354,189,165,53.39
Lulu,Teemo,268,108,160,40.3
Lulu,Khazix,187,108,79,57.75
Lulu,Poppy,233,115,118,49.36
Lulu,Shen,286,160,126,55.94
Lulu,Heimerdinger,135,62,73,45.93
Lulu,Thresh,717,357,360,49.79
Lulu,Kayle,180,77,103,42.78
Lulu,Viego,395,230,165,58.23
Lulu,Jhin,677,317,360,46.82
Lulu,Braum,268,127,141,47.39
Lulu,Darius,670,314,356,46.87
Lulu,XinZhao,294,140,154,47.62
Lulu,Garen,510,240,270,47.06
Lulu,Diana,525,266,259,50.67
Lulu,Brand,163,89,74,54.6
Lulu,Belveth,55,26,29,47.27
Lulu,Malzahar,349,176,173,50.43
Lulu,Varus,364,180,184,49.45
Lulu,Lux,804,402,402,50
Lulu,Yone,612,330,282,53.92
Lulu,Gragas,297,137,160,46.13
Lulu,Ekko,307,150,157,48.86
Lulu,Azir,154,94,60,61.04
Lulu,Nami,580,261,319,45
Lulu,Warwick,371,175,196,47.17
Lulu,Kaisa,704,360,344,51.14
Lulu,Gangplank,225,130,95,57.78
Lulu,Anivia,129,79,50,61.24
Lulu,Talon,157,72,85,45.86
Lulu,Vladimir,213,98,115,46.01
Lulu,Swain,276,122,154,44.2
Lulu,Ornn,196,92,104,46.94
Lulu,Tristana,287,157,130,54.7
Lulu,Fizz,169,91,78,53.85
Lulu,Aphelios,229,110,119,48.03
Lulu,Soraka,260,146,114,56.15
Lulu,Illaoi,138,76,62,55.07
Lulu,Rakan,178,98,80,55.06
Lulu,Mordekaiser,409,221,188,54.03
Lulu,Ryze,163,63,100,38.65
Lulu,Jax,305,178,127,58.36
Lulu,Janna,108,60,48,55.56
Lulu,Galio,477,253,224,53.04
Lulu,KSante,307,138,169,44.95
Lulu,Irelia,275,131,144,47.64
Lulu,Rell,237,113,124,47.68
Lulu,Aatrox,405,207,198,51.11
Lulu,Briar,161,80,81,49.69
Lulu,Ahri,523,247,276,47.23
Lulu,Elise,343,171,172,49.85
Lulu,Kindred,103,50,53,48.54
Lulu,Sona,50,24,26,48
Lulu,Ashe,767,387,380,50.46
Lulu,Pantheon,648,379,269,58.49
Lulu,Zed,365,199,166,54.52
Lulu,Vi,442,213,229,48.19
Lulu,Lucian,351,149,202,42.45
Lulu,Xayah,178,75,103,42.13
Lulu,Viktor,383,176,207,45.95
Lulu,Malphite,354,166,188,46.89
Lulu,Karma,615,278,337,45.2
Lulu,JarvanIV,317,160,157,50.47
Lulu,Vex,141,67,74,47.52
Lulu,Jayce,187,109,78,58.29
Lulu,Nilah,107,70,37,65.42
Lulu,Amumu,323,149,174,46.13
Lulu,AurelionSol,122,49,73,40.16
Lulu,Leona,316,160,156,50.63
Lulu,Renekton,212,110,102,51.89
Lulu,Corki,187,122,65,65.24
Lulu,Urgot,124,71,53,57.26
Lulu,Draven,154,82,72,53.25
Lulu,Nidalee,122,63,59,51.64
Lulu,Veigar,321,155,166,48.29
Lulu,Qiyana,65,25,40,38.46
Lulu,TahmKench,311,136,175,43.73
Lulu,Riven,118,54,64,45.76
Lulu,Milio,343,140,203,40.82
Lulu,Rumble,147,91,56,61.9
Lulu,Zilean,113,52,61,46.02
Lulu,Syndra,268,141,127,52.61
Lulu,Taliyah,101,50,51,49.5
Lulu,Ambessa,288,124,164,43.06
Lulu,DrMundo,175,93,82,53.14
Lulu,Senna,228,116,112,50.88
Lulu,Sion,282,115,167,40.78
Lulu,FiddleSticks,157,66,91,42.04
Lulu,Yuumi,405,191,214,47.16
Lulu,MonkeyKing,304,124,180,40.79
Lulu,Smolder,237,134,103,56.54
Lulu,Kassadin,49,24,25,48.98
Lulu,Hecarim,174,97,77,55.75
Lulu,Graves,280,127,153,45.36
Lulu,Lillia,187,89,98,47.59
Lulu,Rammus,122,64,58,52.46
Lulu,Zyra,236,115,121,48.73
Lulu,Xerath,285,149,136,52.28
Lulu,Gwen,160,86,74,53.75
Lulu,Sivir,189,100,89,52.91
Lulu,Gnar,187,118,69,63.1
Lulu,Velkoz,200,95,105,47.5
Lulu,Lissandra,147,83,64,56.46
Lulu,Camille,213,122,91,57.28
Lulu,Vayne,330,172,158,52.12
Lulu,Ivern,111,48,63,43.24
Lulu,Aurora,293,130,163,44.37
Lulu,Samira,194,98,96,50.52
Lulu,Nasus,162,88,74,54.32
Lulu,Kled,91,38,53,41.76
Lulu,RekSai,54,28,26,51.85
Lulu,Singed,102,51,51,50
Lulu,Rengar,92,37,55,40.22
Lulu,Bard,75,21,54,28
Lulu,Udyr,126,65,61,51.59
Lulu,Ziggs,95,52,43,54.74
Lulu,Shyvana,80,35,45,43.75
Lulu,Nunu,182,83,99,45.6
Lulu,Kennen,114,45,69,39.47
Lulu,Kalista,109,63,46,57.8
Lulu,Naafiri,95,32,63,33.68
Lulu,Yorick,227,105,122,46.26
Lulu,Karthus,82,43,39,52.44
Lulu,Alistar,160,79,81,49.38
Lulu,Cassiopeia,98,34,64,34.69
Lulu,Zeri,232,99,133,42.67
Lulu,Skarner,168,57,111,33.93
Lulu,Maokai,174,85,89,48.85
Lulu,Fiora,144,76,68,52.78
Lulu,Taric,87,39,48,44.83
Lulu,Evelynn,97,54,43,55.67
Lulu,Akshan,98,47,51,47.96
Lulu,Olaf,105,51,54,48.57
Lulu,Annie,92,48,44,52.17
Sett,Malphite,403,192,211,47.64
Sett,Jax,288,139,149,48.26
Sett,Lissandra,154,77,77,50
Sett,MissFortune,734,382,352,52.04
Sett,Lulu,448,233,215,52.01
Sett,Warwick,460,230,230,50
Sett,Udyr,114,62,52,54.39
Sett,Mel,661,307,354,46.44
Sett,Sivir,167,78,89,46.71
Sett,Karma,359,160,199,44.57
Sett,Shen,260,139,121,53.46
Sett,Vi,352,175,177,49.72
Sett,Swain,335,142,193,42.39
Sett,Nilah,112,41,71,36.61
Sett,Nami,278,140,138,50.36
Sett,Aatrox,305,168,137,55.08
Sett,JarvanIV,262,119,143,45.42
Sett,Chogath,463,238,225,51.4
Sett,Yuumi,264,157,107,59.47
Sett,Nocturne,329,161,168,48.94
Sett,Orianna,143,79,64,55.24
Sett,Caitlyn,738,354,384,47.97
Sett,Neeko,174,81,93,46.55
Sett,TahmKench,333,184,149,55.26
Sett,LeeSin,589,337,252,57.22
Sett,Twitch,214,116,98,54.21
Sett,Morgana,358,158,200,44.13
Sett,Garen,578,289,289,50
Sett,Diana,475,247,228,52
Sett,Yasuo,693,338,355,48.77
Sett,Ezreal,822,405,417,49.27
Sett,Brand,149,85,64,57.05
Sett,Camille,145,68,77,46.9
Sett,Kindred,155,103,52,66.45
Sett,Zed,337,155,182,45.99
Sett,Jinx,838,388,450,46.3
Sett,Gragas,239,131,108,54.81
Sett,Graves,233,101,132,43.35
Sett,Qiyana,82,57,25,69.51
Sett,Kalista,109,64,45,58.72
Sett,Poppy,227,112,115,49.34
Sett,Khazix,131,76,55,58.02
Sett,Yone,675,363,312,53.78
Sett,Viktor,310,136,174,43.87
Sett,Talon,160,104,56,65
Sett,Gangplank,149,92,57,61.74
Sett,Anivia,107,52,55,48.6
Sett,Jhin,615,307,308,49.92
Sett,Thresh,580,264,316,45.52
Sett,Renekton,237,123,114,51.9
Sett,Elise,302,175,127,57.95
Sett,Kaisa,496,242,254,48.79
Sett,Milio,180,73,107,40.56
Sett,Mordekaiser,468,259,209,55.34
Sett,Darius,764,374,390,48.95
Sett,Teemo,241,109,132,45.23
Sett,Blitzcrank,373,173,200,46.38
Sett,Trundle,193,91,102,47.15
Sett,RekSai,40,32,8,80
Sett,Leblanc,210,81,129,38.57
Sett,Jayce,124,64,60,51.61
Sett,Ekko,262,137,125,52.29
Sett,Samira,289,144,145,49.83
Sett,Leona,341,185,156,54.25
Sett,Akali,414,231,183,55.8
Sett,Nautilus,449,243,206,54.12
Sett,Katarina,201,99,102,49.25
Sett,Gnar,164,76,88,46.34
Sett,Lucian,281,158,123,56.23
Sett,Singed,51,24,27,47.06
Sett,Urgot,169,83,86,49.11
Sett,MonkeyKing,222,106,116,47.75
Sett,Zac,219,127,92,57.99
Sett,Pantheon,567,281,286,49.56
Sett,Rammus,111,59,52,53.15
Sett,Irelia,199,120,79,60.3
Sett,Nidalee,113,61,52,53.98
Sett,Vladimir,193,105,88,54.4
Sett,Nasus,175,101,74,57.71
Sett,Heimerdinger,130,66,64,50.77
Sett,Ashe,657,363,294,55.25
Sett,Taliyah,79,30,49,37.97
Sett,Syndra,184,106,78,57.61
Sett,Illaoi,185,100,85,54.05
Sett,MasterYi,301,175,126,58.14
Sett,Ziggs,144,88,56,61.11
Sett,Sona,78,50,28,64.1
Sett,Ornn,173,100,73,57.8
Sett,Hwei,193,89,104,46.11
Sett,Viego,408,216,192,52.94
Sett,Veigar,315,163,152,51.75
Sett,Shaco,255,123,132,48.24
Sett,Malzahar,334,154,180,46.11
Sett,Evelynn,107,49,58,45.79
Sett,Seraphine,234,135,99,57.69
Sett,Rell,193,105,88,54.4
Sett,Corki,127,79,48,62.2
Sett,Lux,655,373,282,56.95
Sett,Soraka,163,74,89,45.4
Sett,Xayah,170,89,81,52.35
Sett,Renata,42,15,27,35.71
Sett,Nunu,212,116,96,54.72
Sett,Tristana,279,171,108,61.29
Sett,Lillia,172,67,105,38.95
Sett,Ahri,425,200,225,47.06
Sett,Draven,153,87,66,56.86
Sett,DrMundo,169,97,72,57.4
Sett,Senna,173,98,75,56.65
Sett,Quinn,80,47,33,58.75
Sett,Kayle,155,77,78,49.68
Sett,Alistar,190,91,99,47.89
Sett,Kayn,452,209,243,46.24
Sett,Velkoz,140,60,80,42.86
Sett,Galio,427,200,227,46.84
Sett,Volibear,353,196,157,55.52
Sett,Zyra,263,131,132,49.81
Sett,Naafiri,87,47,40,54.02
Sett,Vex,178,87,91,48.88
Sett,Azir,179,86,93,48.04
Sett,Fiora,104,65,39,62.5
Sett,FiddleSticks,121,56,65,46.28
Sett,Gwen,163,91,72,55.83
Sett,Belveth,63,32,31,50.79
Sett,Aphelios,167,78,89,46.71
Sett,Fizz,138,66,72,47.83
Sett,Cassiopeia,69,28,41,40.58
Sett,Taric,54,18,36,33.33
Sett,Varus,327,173,154,52.91
Sett,Bard,107,40,67,37.38
Sett,Shyvana,77,28,49,36.36
Sett,Sion,350,187,163,53.43
Sett,Ambessa,283,141,142,49.82
Sett,Sylas,517,278,239,53.77
Sett,Rumble,77,44,33,57.14
Sett,Smolder,236,114,122,48.31
Sett,Zeri,155,86,69,55.48
Sett,Olaf,90,47,43,52.22
Sett,Amumu,310,145,165,46.77
Sett,Aurora,240,132,108,55
Sett,Skarner,180,91,89,50.56
Sett,Braum,281,155,126,55.16
Sett,XinZhao,222,100,122,45.05
Sett,Briar,189,86,103,45.5
Sett,Vayne,394,194,200,49.24
Sett,Sejuani,241,106,135,43.98
Sett,AurelionSol,131,58,73,44.27
Sett,Karthus,81,39,42,48.15
Sett,Zoe,138,67,71,48.55
Sett,KSante,249,120,129,48.19
Sett,Kled,60,28,32,46.67
Sett,Rakan,163,81,82,49.69
Sett,Rengar,74,48,26,64.86
Sett,Janna,83,56,27,67.47
Sett,Pyke,301,167,134,55.48
Sett,Ryze,102,42,60,41.18
Sett,Akshan,91,37,54,40.66
Sett,KogMaw,91,41,50,45.05
Sett,Riven,135,67,68,49.63
Sett,TwistedFate,122,52,70,42.62
Sett,Yorick,258,134,124,51.94
Sett,Annie,75,37,38,49.33
Sett,Hecarim,104,56,48,53.85
Sett,Xerath,293,151,142,51.54
Sett,Tryndamere,92,60,32,65.22
Sett,Zilean,75,48,27,64
Sett,Maokai,132,55,77,41.67
Sett,Kennen,77,31,46,40.26
Sett,Kassadin,47,26,21,55.32
Sett,Ivern,48,32,16,66.67
Katarina,Malphite,130,52,78,40
Katarina,Jax,125,65,60,52
Katarina,Lissandra,49,23,26,46.94
Katarina,MissFortune,295,128,167,43.39
Katarina,Lulu,249,103,146,41.37
Katarina,Chogath,227,109,118,48.02
Katarina,Lillia,79,36,43,45.57
Katarina,Tryndamere,68,40,28,58.82
Katarina,Caitlyn,338,172,166,50.89
Katarina,Karma,135,68,67,50.37
Katarina,Udyr,60,29,31,48.33
Katarina,Yone,230,96,134,41.74
Katarina,Smolder,93,55,38,59.14
Katarina,TahmKench,142,78,64,54.93
Katarina,Teemo,147,78,69,53.06
Katarina,Warwick,183,80,103,43.72
Katarina,Nunu,92,34,58,36.96
Katarina,Lucian,114,72,42,63.16
Katarina,Leona,112,61,51,54.46
Katarina,Fiora,65,30,35,46.15
Katarina,Singed,36,9,27,25
Katarina,Yasuo,249,127,122,51
Katarina,Milio,105,50,55,47.62
Katarina,Graves,100,54,46,54
Katarina,Kassadin,34,18,16,52.94
Katarina,Tristana,141,82,59,58.16
Katarina,Nami,228,116,112,50.88
Katarina,Jayce,80,39,41,48.75
Katarina,Elise,108,51,57,47.22
Katarina,Lux,346,178,168,51.45
Katarina,Yorick,103,21,82,20.39
Katarina,Zilean,47,18,29,38.3
Katarina,Volibear,149,64,85,42.95
Katarina,Hwei,108,48,60,44.44
Katarina,Vi,165,65,100,39.39
Katarina,Xerath,142,70,72,49.3
Katarina,Braum,87,49,38,56.32
Katarina,Darius,246,127,119,51.63
Katarina,Kayn,185,96,89,51.89
Katarina,Veigar,195,103,92,52.82
Katarina,Varus,113,45,68,39.82
Katarina,Pyke,151,69,82,45.7
Katarina,Shen,91,34,57,37.36
Katarina,Karthus,51,25,26,49.02
Katarina,Ekko,132,56,76,42.42
Katarina,Ezreal,368,176,192,47.83
Katarina,Soraka,60,42,18,70
Katarina,Briar,78,34,44,43.59
Katarina,Zed,143,79,64,55.24
Katarina,Seraphine,82,26,56,31.71
Katarina,Camille,39,14,25,35.9
Katarina,Draven,89,43,46,48.31
Katarina,Senna,80,36,44,45
Katarina,Trundle,46,24,22,52.17
Katarina,Mel,291,153,138,52.58
Katarina,Jinx,332,155,177,46.69
Katarina,Morgana,180,92,88,51.11
Katarina,Sion,107,60,47,56.07
Katarina,Rengar,24,11,13,45.83
Katarina,Ashe,270,149,121,55.19
Katarina,Ambessa,119,56,63,47.06
Katarina,Gwen,77,40,37,51.95
Katarina,Vladimir,74,36,38,48.65
Katarina,Twitch,100,42,58,42
Katarina,JarvanIV,107,49,58,45.79
Katarina,Viktor,152,67,85,44.08
Katarina,Kaisa,220,109,111,49.55
Katarina,Sejuani,95,51,44,53.68
Katarina,Blitzcrank,141,55,86,39.01
Katarina,Nasus,78,43,35,55.13
Katarina,Galio,206,106,100,51.46
Katarina,Kayle,81,36,45,44.44
Katarina,Sett,201,102,99,50.75
Katarina,Mordekaiser,179,89,90,49.72
Katarina,Akali,136,53,83,38.97
Katarina,Xayah,56,24,32,42.86
Katarina,Zyra,97,49,48,50.52
Katarina,Gnar,91,53,38,58.24
Katarina,Thresh,269,160,109,59.48
Katarina,LeeSin,278,126,152,45.32
Katarina,RekSai,20,11,9,55
Katarina,Bard,58,32,26,55.17
Katarina,Pantheon,227,120,107,52.86
Katarina,Kennen,53,23,30,43.4
Katarina,Illaoi,60,27,33,45
Katarina,Malzahar,147,74,73,50.34
Katarina,Vayne,170,77,93,45.29
Katarina,Maokai,78,37,41,47.44
Katarina,Zeri,71,36,35,50.7
Katarina,Khazix,93,39,54,41.94
Katarina,Ahri,253,126,127,49.8
Katarina,Yuumi,135,80,55,59.26
Katarina,Viego,200,89,111,44.5
Katarina,Vex,87,34,53,39.08
Katarina,Jhin,278,100,178,35.97
Katarina,Sylas,217,102,115,47
Katarina,Urgot,93,30,63,32.26
Katarina,Quinn,45,21,24,46.67
Katarina,MasterYi,155,93,62,60
Katarina,Garen,240,93,147,38.75
Katarina,DrMundo,83,44,39,53.01
Katarina,Fizz,51,17,34,33.33
Katarina,Aurora,113,59,54,52.21
Katarina,Gragas,118,78,40,66.1
Katarina,FiddleSticks,46,19,27,41.3
Katarina,XinZhao,97,37,60,38.14
Katarina,Corki,53,32,21,60.38
Katarina,Nilah,57,21,36,36.84
Katarina,Rumble,49,32,17,65.31
Katarina,Rakan,62,23,39,37.1
Katarina,Gangplank,99,48,51,48.48
Katarina,Poppy,112,46,66,41.07
Katarina,Aphelios,89,38,51,42.7
Katarina,KSante,111,59,52,53.15
Katarina,Hecarim,42,19,23,45.24
Katarina,Leblanc,84,38,46,45.24
Katarina,Aatrox,151,82,69,54.3
Katarina,Nautilus,153,76,77,49.67
Katarina,AurelionSol,67,38,29,56.72
Katarina,Samira,118,42,76,35.59
Katarina,Amumu,180,83,97,46.11
Katarina,Diana,184,113,71,61.41
Katarina,Akshan,50,25,25,50
Katarina,Evelynn,29,18,11,62.07
Katarina,Kalista,75,47,28,62.67
Katarina,Azir,52,27,25,51.92
Katarina,TwistedFate,57,31,26,54.39
Katarina,Velkoz,63,23,40,36.51
Katarina,KogMaw,55,26,29,47.27
Katarina,Brand,92,42,50,45.65
Katarina,Ornn,120,54,66,45
Katarina,Heimerdinger,62,32,30,51.61
Katarina,Syndra,110,66,44,60
Katarina,Talon,79,54,25,68.35
Katarina,Olaf,26,17,9,65.38
Katarina,Taliyah,30,19,11,63.33
Katarina,Swain,124,51,73,41.13
Katarina,Qiyana,37,13,24,35.14
Katarina,Rell,103,38,65,36.89
Katarina,Ziggs,57,26,31,45.61
Katarina,Ivern,38,27,11,71.05
Katarina,Riven,70,33,37,47.14
Katarina,Sivir,59,45,14,76.27
Katarina,Irelia,95,61,34,64.21
Katarina,Ryze,45,17,28,37.78
Katarina,Taric,48,25,23,52.08
Katarina,Janna,36,13,23,36.11
Katarina,MonkeyKing,74,36,38,48.65
Katarina,Zac,109,52,57,47.71
Katarina,Renekton,86,48,38,55.81
Katarina,Kindred,75,24,51,32
Katarina,Renata,53,11,42,20.75
Katarina,Orianna,55,31,24,56.36
Katarina,Shaco,98,51,47,52.04
Katarina,Zoe,55,32,23,58.18
Katarina,Alistar,74,32,42,43.24
Katarina,Skarner,57,26,31,45.61
Katarina,Nocturne,168,89,79,52.98
Katarina,Cassiopeia,37,10,27,27.03
Katarina,Sona,17,11,6,64.71
Katarina,Neeko,59,20,39,33.9
Katarina,Nidalee,43,26,17,60.47
Katarina,Rammus,29,13,16,44.83
Katarina,Annie,16,8,8,50
Katarina,Belveth,21,5,16,23.81
Katarina,Anivia,39,22,17,56.41
Katarina,Naafiri,32,14,18,43.75
Katarina,Kled,17,8,9,47.06
Katarina,Shyvana,14,5,9,35.71
Jinx,Malphite,619,338,281,54.6
Jinx,Jax,489,290,199,59.3
Jinx,Lissandra,202,150,52,74.26
Jinx,MissFortune,1408,767,641,54.47
Jinx,Lulu,867,461,406,53.17
Jinx,Sion,458,235,223,51.31
Jinx,Nocturne,699,333,366,47.64
Jinx,Hwei,392,222,170,56.63
Jinx,Jhin,1076,557,519,51.77
Jinx,Soraka,283,174,109,61.48
Jinx,Akali,611,322,289,52.7
Jinx,LeeSin,1010,567,443,56.14
Jinx,Yasuo,1045,562,483,53.78
Jinx,Pyke,457,226,231,49.45
Jinx,Yone,940,513,427,54.57
Jinx,JarvanIV,475,269,206,56.63
Jinx,Ryze,237,129,108,54.43
Jinx,Draven,277,158,119,57.04
Jinx,Blitzcrank,487,263,224,54
Jinx,Malzahar,614,331,283,53.91
Jinx,Kayn,739,417,322,56.43
Jinx,Ahri,803,434,369,54.05
Jinx,Amumu,690,338,352,48.99
Jinx,Olaf,165,76,89,46.06
Jinx,Viego,746,424,322,56.84
Jinx,Vi,630,301,329,47.78
Jinx,Azir,228,119,109,52.19
Jinx,TahmKench,463,198,265,42.76
Jinx,Orianna,360,187,173,51.94
Jinx,Twitch,485,241,244,49.69
Jinx,Morgana,584,298,286,51.03
Jinx,KSante,373,226,147,60.59
Jinx,Nunu,362,207,155,57.18
Jinx,Akshan,166,95,71,57.23
Jinx,Ziggs,255,134,121,52.55
Jinx,Seraphine,419,223,196,53.22
Jinx,Sett,838,450,388,53.7
Jinx,Darius,1089,600,489,55.1
Jinx,Leblanc,315,195,120,61.9
Jinx,Lux,1267,701,566,55.33
Jinx,Mordekaiser,685,385,300,56.2
Jinx,Khazix,304,160,144,52.63
Jinx,Katarina,332,177,155,53.31
Jinx,Ezreal,1570,875,695,55.73
Jinx,Shen,469,258,211,55.01
Jinx,Shaco,482,286,196,59.34
Jinx,AurelionSol,275,153,122,55.64
Jinx,Caitlyn,1857,1006,851,54.17
Jinx,Brand,339,223,116,65.78
Jinx,Mel,1081,608,473,56.24
Jinx,Galio,687,339,348,49.34
Jinx,Illaoi,231,128,103,55.41
Jinx,Senna,350,194,156,55.43
Jinx,Irelia,419,250,169,59.67
Jinx,Garen,880,472,408,53.64
Jinx,Viktor,584,303,281,51.88
Jinx,Talon,300,152,148,50.67
Jinx,Sivir,332,173,159,52.11
Jinx,Lucian,497,265,232,53.32
Jinx,Leona,556,331,225,59.53
Jinx,Vayne,681,362,319,53.16
Jinx,Ivern,169,100,69,59.17
Jinx,Qiyana,131,69,62,52.67
Jinx,Rengar,166,90,76,54.22
Jinx,Ashe,1451,826,625,56.93
Jinx,Yorick,354,178,176,50.28
Jinx,Graves,409,201,208,49.14
Jinx,Naafiri,202,110,92,54.46
Jinx,Jayce,319,160,159,50.16
Jinx,Singed,172,95,77,55.23
Jinx,Veigar,581,318,263,54.73
Jinx,Warwick,742,402,340,54.18
Jinx,Karma,715,356,359,49.79
Jinx,Samira,426,216,210,50.7
Jinx,MasterYi,556,297,259,53.42
Jinx,Zed,556,335,221,60.25
Jinx,Nilah,182,92,90,50.55
Jinx,Ornn,346,185,161,53.47
Jinx,Pantheon,958,551,407,57.52
Jinx,Annie,197,103,94,52.28
Jinx,Nautilus,800,472,328,59
Jinx,FiddleSticks,260,141,119,54.23
Jinx,Rell,381,222,159,58.27
Jinx,Diana,791,441,350,55.75
Jinx,Tristana,557,309,248,55.48
Jinx,XinZhao,416,219,197,52.64
Jinx,Hecarim,223,129,94,57.85
Jinx,Aurora,562,303,259,53.91
Jinx,Gnar,380,224,156,58.95
Jinx,Lillia,307,179,128,58.31
Jinx,Thresh,1026,578,448,56.34
Jinx,Chogath,793,352,441,44.39
Jinx,Kaisa,1131,625,506,55.26
Jinx,DrMundo,274,140,134,51.09
Jinx,Zeri,329,186,143,56.53
Jinx,Velkoz,278,131,147,47.12
Jinx,Vex,296,160,136,54.05
Jinx,Aatrox,575,329,246,57.22
Jinx,Belveth,126,71,55,56.35
Jinx,Neeko,215,96,119,44.65
Jinx,Swain,538,273,265,50.74
Jinx,Syndra,397,211,186,53.15
Jinx,Sylas,902,502,400,55.65
Jinx,Zoe,257,155,102,60.31
Jinx,Ekko,554,287,267,51.81
Jinx,Milio,371,210,161,56.6
Jinx,Gangplank,306,188,118,61.44
Jinx,Teemo,522,270,252,51.72
Jinx,Renata,120,76,44,63.33
Jinx,Kled,94,60,34,63.83
Jinx,Briar,316,170,146,53.8
Jinx,TwistedFate,181,111,70,61.33
Jinx,Alistar,330,184,146,55.76
Jinx,Nami,650,316,334,48.62
Jinx,Skarner,321,180,141,56.07
Jinx,Varus,625,337,288,53.92
Jinx,Renekton,285,148,137,51.93
Jinx,Xerath,514,266,248,51.75
Jinx,Vladimir,363,191,172,52.62
Jinx,Kalista,179,94,85,52.51
Jinx,Camille,237,128,109,54.01
Jinx,Xayah,373,239,134,64.08
Jinx,Gwen,299,148,151,49.5
Jinx,Urgot,269,202,67,75.09
Jinx,Ambessa,438,230,208,52.51
Jinx,Fizz,284,174,110,61.27
Jinx,Heimerdinger,274,171,103,62.41
Jinx,Kindred,264,159,105,60.23
Jinx,Yuumi,492,245,247,49.8
Jinx,Zac,334,191,143,57.19
Jinx,Gragas,479,278,201,58.04
Jinx,Corki,257,147,110,57.2
Jinx,Janna,178,89,89,50
Jinx,Aphelios,405,203,202,50.12
Jinx,Braum,453,229,224,50.55
Jinx,Sejuani,377,197,180,52.25
Jinx,Udyr,186,114,72,61.29
Jinx,Zyra,429,219,210,51.05
Jinx,KogMaw,231,128,103,55.41
Jinx,Volibear,582,288,294,49.48
Jinx,Cassiopeia,132,64,68,48.48
Jinx,Trundle,311,165,146,53.05
Jinx,MonkeyKing,394,209,185,53.05
Jinx,Elise,461,269,192,58.35
Jinx,Tryndamere,241,150,91,62.24
Jinx,Poppy,429,226,203,52.68
Jinx,Kayle,252,153,99,60.71
Jinx,Taric,155,82,73,52.9
Jinx,Anivia,238,124,114,52.1
Jinx,Bard,167,101,66,60.48
Jinx,Evelynn,132,66,66,50
Jinx,Rammus,192,114,78,59.38
Jinx,Nasus,419,197,222,47.02
Jinx,Kennen,137,72,65,52.55
Jinx,Smolder,414,230,184,55.56
Jinx,Riven,252,126,126,50
Jinx,Fiora,243,126,117,51.85
Jinx,Karthus,170,108,62,63.53
Jinx,Zilean,190,94,96,49.47
Jinx,Sona,135,74,61,54.81
Jinx,Rakan,310,183,127,59.03
Jinx,Shyvana,153,65,88,42.48
Jinx,Taliyah,151,89,62,58.94
Jinx,Rumble,182,108,74,59.34
Jinx,Quinn,226,133,93,58.85
Jinx,Maokai,296,161,135,54.39
Jinx,RekSai,79,43,36,54.43
Jinx,Kassadin,95,61,34,64.21
Jinx,Nidalee,222,122,100,54.95
Renata,Malphite,61,24,37,39.34
Renata,Jax,49,24,25,48.98
Renata,Lissandra,11,3,8,27.27
Renata,MissFortune,136,62,74,45.59
Renata,Lulu,102,39,63,38.24
Renata,Maokai,17,14,3,82.35
Renata,Viego,77,38,39,49.35
Renata,Viktor,66,38,28,57.58
Renata,Smolder,52,28,24,53.85
Renata,Nami,87,34,53,39.08
Renata,Olaf,18,12,6,66.67
Renata,Kayn,56,32,24,57.14
Renata,Yasuo,100,49,51,49
Renata,Galio,73,44,29,60.27
Renata,Velkoz,29,9,20,31.03
Renata,Naafiri,24,16,8,66.67
Renata,Warwick,58,30,28,51.72
Renata,Mel,82,41,41,50
Renata,Ashe,132,83,49,62.88
Renata,Janna,9,6,3,66.67
Renata,Kled,23,6,17,26.09
Renata,MasterYi,79,39,40,49.37
Renata,Vladimir,39,8,31,20.51
Renata,Jhin,105,52,53,49.52
Renata,Pyke,38,22,16,57.89
Renata,Gwen,26,13,13,50
Renata,Nocturne,72,47,25,65.28
Renata,Aurora,54,24,30,44.44
Renata,Caitlyn,134,74,60,55.22
Renata,Morgana,50,16,34,32
Renata,Garen,96,50,46,52.08
Renata,Amumu,73,32,41,43.84
Renata,Kennen,13,13,0,100
Renata,Ezreal,117,67,50,57.26
Renata,Braum,53,34,19,64.15
Renata,Darius,111,60,51,54.05
Renata,Karthus,11,5,6,45.45
Renata,Irelia,74,32,42,43.24
Renata,Jinx,120,44,76,36.67
Renata,Gragas,35,15,20,42.86
Renata,Zed,63,41,22,65.08
Renata,Rakan,39,22,17,56.41
Renata,Twitch,44,16,28,36.36
Renata,Zac,35,16,19,45.71
Renata,Aatrox,62,24,38,38.71
Renata,Thresh,113,50,63,44.25
Renata,Sett,42,27,15,64.29
Renata,Chogath,58,32,26,55.17
Renata,Sona,18,15,3,83.33
Renata,Yorick,40,19,21,47.5
Renata,Rumble,18,8,10,44.44
Renata,Xayah,29,18,11,62.07
Renata,Kayle,21,17,4,80.95
Renata,Hwei,48,28,20,58.33
Renata,Heimerdinger,33,20,13,60.61
Renata,Ivern,18,9,9,50
Renata,Lux,102,53,49,51.96
Renata,TahmKench,43,17,26,39.53
Renata,Urgot,34,17,17,50
Renata,Tryndamere,22,7,15,31.82
Renata,LeeSin,104,52,52,50
Renata,Karma,60,33,27,55
Renata,Vi,61,29,32,47.54
Renata,Orianna,36,18,18,50
Renata,Kaisa,96,46,50,47.92
Renata,Riven,34,14,20,41.18
Renata,Senna,45,33,12,73.33
Renata,Ambessa,46,31,15,67.39
Renata,MonkeyKing,52,22,30,42.31
Renata,Sylas,73,29,44,39.73
Renata,Milio,33,14,19,42.42
Renata,Renekton,25,12,13,48
Renata,Kindred,28,15,13,53.57
Renata,Ahri,73,20,53,27.4
Renata,Draven,31,18,13,58.06
Renata,Shaco,32,11,21,34.38
Renata,Cassiopeia,16,6,10,37.5
Renata,Pantheon,100,52,48,52
Renata,Teemo,47,26,21,55.32
Renata,Graves,52,20,32,38.46
Renata,Malzahar,58,27,31,46.55
Renata,Katarina,53,42,11,79.25
Renata,Mordekaiser,68,32,36,47.06
Renata,JarvanIV,64,25,39,39.06
Renata,AurelionSol,18,9,9,50
Renata,Diana,86,41,45,47.67
Renata,Rengar,21,8,13,38.1
Renata,Ekko,24,15,9,62.5
Renata,KSante,47,23,24,48.94
Renata,Alistar,40,16,24,40
Renata,Volibear,57,32,25,56.14
Renata,Akali,55,32,23,58.18
Renata,Talon,24,12,12,50
Renata,Illaoi,26,12,14,46.15
Renata,Gnar,38,18,20,47.37
Renata,FiddleSticks,35,19,16,54.29
Renata,Yone,72,32,40,44.44
Renata,Trundle,32,17,15,53.13
Renata,Syndra,56,27,29,48.21
Renata,Leona,70,54,16,77.14
Renata,Kassadin,14,5,9,35.71
Renata,Nautilus,95,51,44,53.68
Renata,Xerath,35,25,10,71.43
Renata,Elise,46,24,22,52.17
Renata,Vayne,41,17,24,41.46
Renata,Lillia,43,18,25,41.86
Renata,Tristana,70,47,23,67.14
Renata,Nilah,31,14,17,45.16
Renata,Zyra,42,29,13,69.05
Renata,Skarner,29,14,15,48.28
Renata,DrMundo,29,24,5,82.76
Renata,Evelynn,25,14,11,56
Renata,Poppy,50,31,19,62
Renata,Jayce,36,11,25,30.56
Renata,Khazix,25,18,7,72
Renata,XinZhao,30,19,11,63.33
Renata,Annie,20,7,13,35
Renata,Sivir,32,15,17,46.88
Renata,Zilean,27,14,13,51.85
Renata,Brand,24,10,14,41.67
Renata,Kalista,25,14,11,56
Renata,Leblanc,26,17,9,65.38
Renata,Nunu,18,9,9,50
Renata,Sion,20,2,18,10
Renata,Varus,45,21,24,46.67
Renata,Samira,48,32,16,66.67
Renata,Ornn,41,15,26,36.59
Renata,Ziggs,12,3,9,25
Renata,Blitzcrank,49,29,20,59.18
Renata,Azir,28,10,18,35.71
Renata,Swain,58,30,28,51.72
Renata,Fizz,22,10,12,45.45
Renata,Aphelios,32,20,12,62.5
Renata,Qiyana,13,5,8,38.46
Renata,Soraka,21,6,15,28.57
Renata,Belveth,10,4,6,40
Renata,Taric,18,13,5,72.22
Renata,RekSai,13,5,8,38.46
Renata,Veigar,45,11,34,24.44
Renata,KogMaw,14,3,11,21.43
Renata,Nasus,28,14,14,50
Renata,Yuumi,25,12,13,48
Renata,Anivia,15,5,10,33.33
Renata,Vex,37,16,21,43.24
Renata,Neeko,35,13,22,37.14
Renata,Singed,8,8,0,100
Renata,Corki,23,5,18,21.74
Renata,Shen,33,22,11,66.67
Renata,Akshan,23,12,11,52.17
Renata,Lucian,60,25,35,41.67
Renata,Rammus,29,20,9,68.97
Renata,Gangplank,27,12,15,44.44
Renata,Rell,41,26,15,63.41
Renata,Zeri,16,13,3,81.25
Renata,Briar,15,5,10,33.33
Renata,TwistedFate,19,12,7,63.16
Renata,Shyvana,24,14,10,58.33
Renata,Sejuani,37,28,9,75.68
Renata,Seraphine,29,20,9,68.97
Renata,Nidalee,8,3,5,37.5
Renata,Udyr,26,20,6,76.92
Renata,Taliyah,13,8,5,61.54
Renata,Bard,5,3,2,60
Renata,Fiora,17,12,5,70.59
Renata,Ryze,16,8,8,50
Renata,Camille,22,5,17,22.73
Renata,Hecarim,12,7,5,58.33
Renata,Quinn,6,3,3,50
Renata,Zoe,17,14,3,82.35
Vladimir,Ambessa,84,40,44,47.62
Vladimir,Viktor,114,47,67,41.23
Vladimir,Graves,102,57,45,55.88
Vladimir,Caitlyn,300,163,137,54.33
Vladimir,Braum,99,45,54,45.45
Vladimir,Yone,266,124,142,46.62
Vladimir,FiddleSticks,83,39,44,46.99
Vladimir,Aurora,148,80,68,54.05
Vladimir,Vayne,206,92,114,44.66
Vladimir,Senna,58,29,29,50
Vladimir,Yorick,118,46,72,38.98
Vladimir,Viego,168,87,81,51.79
Vladimir,AurelionSol,54,23,31,42.59
Vladimir,Ashe,264,133,131,50.38
Vladimir,Milio,96,34,62,35.42
Vladimir,Diana,223,129,94,57.85
Vladimir,Gragas,102,58,44,56.86
Vladimir,Yasuo,332,169,163,50.9
Vladimir,Nami,124,64,60,51.61
Vladimir,Aatrox,153,86,67,56.21
Vladimir,MasterYi,152,98,54,64.47
Vladimir,Mel,305,184,121,60.33
Vladimir,Tristana,141,97,44,68.79
Vladimir,Sona,15,12,3,80
Vladimir,Darius,230,112,118,48.7
Vladimir,XinZhao,116,52,64,44.83
Vladimir,Malzahar,166,76,90,45.78
Vladimir,Rell,127,60,67,47.24
Vladimir,Heimerdinger,59,31,28,52.54
Vladimir,Briar,77,39,38,50.65
Vladimir,Irelia,125,51,74,40.8
Vladimir,Jhin,251,136,115,54.18
Vladimir,Leona,113,61,52,53.98
Vladimir,Shen,117,69,48,58.97
Vladimir,LeeSin,255,150,105,58.82
Vladimir,Orianna,110,53,57,48.18
Vladimir,Xayah,97,67,30,69.07
Vladimir,Rakan,80,27,53,33.75
Vladimir,Karthus,37,16,21,43.24
Vladimir,Naafiri,39,25,14,64.1
Vladimir,Lux,310,172,138,55.48
Vladimir,Gwen,68,49,19,72.06
Vladimir,Amumu,176,105,71,59.66
Vladimir,DrMundo,68,44,24,64.71
Vladimir,Lulu,213,115,98,53.99
Vladimir,Evelynn,38,14,24,36.84
Vladimir,Veigar,138,67,71,48.55
Vladimir,Warwick,156,102,54,65.38
Vladimir,Ornn,104,44,60,42.31
Vladimir,Katarina,74,38,36,51.35
Vladimir,Zac,101,57,44,56.44
Vladimir,Ryze,69,42,27,60.87
Vladimir,Jax,125,59,66,47.2
Vladimir,Janna,28,14,14,50
Vladimir,Zed,152,97,55,63.82
Vladimir,Varus,145,74,71,51.03
Vladimir,Soraka,39,23,16,58.97
Vladimir,Poppy,120,62,58,51.67
Vladimir,Ekko,109,58,51,53.21
Vladimir,Samira,104,45,59,43.27
Vladimir,Thresh,295,160,135,54.24
Vladimir,Volibear,132,55,77,41.67
Vladimir,Renekton,69,36,33,52.17
Vladimir,Elise,131,52,79,39.69
Vladimir,Ahri,183,85,98,46.45
Vladimir,Ezreal,345,186,159,53.91
Vladimir,Karma,195,122,73,62.56
Vladimir,Gnar,101,74,27,73.27
Vladimir,Fizz,58,43,15,74.14
Vladimir,Seraphine,88,65,23,73.86
Vladimir,Udyr,64,41,23,64.06
Vladimir,Syndra,73,52,21,71.23
Vladimir,Corki,83,45,38,54.22
Vladimir,Alistar,84,52,32,61.9
Vladimir,Nocturne,171,99,72,57.89
Vladimir,KogMaw,45,27,18,60
Vladimir,Morgana,131,77,54,58.78
Vladimir,Vi,152,71,81,46.71
Vladimir,Kennen,42,32,10,76.19
Vladimir,Renata,39,31,8,79.49
Vladimir,Garen,187,88,99,47.06
Vladimir,Shaco,89,51,38,57.3
Vladimir,Sett,193,88,105,45.6
Vladimir,Malphite,183,113,70,61.75
Vladimir,Azir,65,39,26,60
Vladimir,Mordekaiser,158,72,86,45.57
Vladimir,Brand,75,37,38,49.33
Vladimir,Lucian,108,44,64,40.74
Vladimir,Swain,151,69,82,45.7
Vladimir,Zyra,108,48,60,44.44
Vladimir,KSante,104,63,41,60.58
Vladimir,Skarner,61,32,29,52.46
Vladimir,Smolder,78,51,27,65.38
Vladimir,Gangplank,75,41,34,54.67
Vladimir,Xerath,117,53,64,45.3
Vladimir,Chogath,229,92,137,40.17
Vladimir,Jinx,363,172,191,47.38
Vladimir,Belveth,34,25,9,73.53
Vladimir,MissFortune,216,82,134,37.96
Vladimir,Nunu,90,35,55,38.89
Vladimir,Ivern,23,8,15,34.78
Vladimir,Kindred,49,22,27,44.9
Vladimir,Zeri,83,45,38,54.22
Vladimir,Yuumi,133,71,62,53.38
Vladimir,Akali,103,61,42,59.22
Vladimir,Singed,23,12,11,52.17
Vladimir,Akshan,53,22,31,41.51
Vladimir,Velkoz,77,39,38,50.65
Vladimir,Trundle,64,37,27,57.81
Vladimir,Rammus,38,9,29,23.68
Vladimir,Kaisa,214,127,87,59.35
Vladimir,Sylas,212,112,100,52.83
Vladimir,Nautilus,205,89,116,43.41
Vladimir,Pantheon,215,104,111,48.37
Vladimir,Hwei,85,46,39,54.12
Vladimir,Rumble,51,29,22,56.86
Vladimir,Twitch,96,47,49,48.96
Vladimir,Kayn,135,72,63,53.33
Vladimir,Kled,25,20,5,80
Vladimir,JarvanIV,98,55,43,56.12
Vladimir,Aphelios,92,41,51,44.57
Vladimir,Shyvana,32,12,20,37.5
Vladimir,Tryndamere,56,28,28,50
Vladimir,Teemo,155,89,66,57.42
Vladimir,Leblanc,76,34,42,44.74
Vladimir,MonkeyKing,98,52,46,53.06
Vladimir,Urgot,41,24,17,58.54
Vladimir,Kalista,54,35,19,64.81
Vladimir,Rengar,33,18,15,54.55
Vladimir,Nidalee,68,40,28,58.82
Vladimir,Nilah,40,19,21,47.5
Vladimir,Nasus,81,45,36,55.56
Vladimir,Lillia,60,30,30,50
Vladimir,Annie,37,14,23,37.84
Vladimir,Kayle,82,36,46,43.9
Vladimir,RekSai,19,11,8,57.89
Vladimir,Draven,76,46,30,60.53
Vladimir,Galio,147,67,80,45.58
Vladimir,Zoe,60,28,32,46.67
Vladimir,Sejuani,122,55,67,45.08
Vladimir,Talon,72,31,41,43.06
Vladimir,Ziggs,57,25,32,43.86
Vladimir,Blitzcrank,114,66,48,57.89
Vladimir,Neeko,41,24,17,58.54
Vladimir,Jayce,77,35,42,45.45
Vladimir,TahmKench,105,36,69,34.29
Vladimir,Taliyah,29,11,18,37.93
Vladimir,Pyke,83,41,42,49.4
Vladimir,Khazix,65,33,32,50.77
Vladimir,Sion,106,60,46,56.6
Vladimir,Hecarim,46,20,26,43.48
Vladimir,Maokai,54,28,26,51.85
Vladimir,Taric,29,14,15,48.28
Vladimir,Fiora,45,28,17,62.22
Vladimir,Cassiopeia,50,21,29,42
Vladimir,Illaoi,54,22,32,40.74
Vladimir,Lissandra,48,25,23,52.08
Vladimir,Bard,44,28,16,63.64
Vladimir,Qiyana,26,13,13,50
Vladimir,Sivir,95,47,48,49.47
Vladimir,Quinn,40,25,15,62.5
Vladimir,Zilean,54,20,34,37.04
Vladimir,Camille,71,46,25,64.79
Vladimir,Vex,71,25,46,35.21
Vladimir,Kassadin,29,19,10,65.52
Vladimir,Riven,60,24,36,40
Vladimir,Anivia,31,12,19,38.71
Vladimir,Olaf,22,9,13,40.91
Vladimir,TwistedFate,33,9,24,27.27
Velkoz,Ambessa,66,40,26,60.61
Velkoz,Viktor,122,55,67,45.08
Velkoz,Graves,92,45,47,48.91
Velkoz,Caitlyn,354,178,176,50.28
Velkoz,Braum,98,61,37,62.24
Velkoz,DrMundo,64,23,41,35.94
Velkoz,Rammus,47,26,21,55.32
Velkoz,Annie,52,31,21,59.62
Velkoz,Ezreal,286,145,141,50.7
Velkoz,Renata,29,20,9,68.97
Velkoz,Sion,115,56,59,48.7
Velkoz,Pantheon,185,88,97,47.57
Velkoz,Zoe,50,19,31,38
Velkoz,Ziggs,41,20,21,48.78
Velkoz,Veigar,157,86,71,54.78
Velkoz,Darius,223,104,119,46.64
Velkoz,Kindred,44,20,24,45.45
Velkoz,Tristana,132,79,53,59.85
Velkoz,Neeko,56,40,16,71.43
Velkoz,Teemo,119,61,58,51.26
Velkoz,Leblanc,76,49,27,64.47
Velkoz,Karma,129,56,73,43.41
Velkoz,Ornn,99,50,49,50.51
Velkoz,Warwick,195,81,114,41.54
Velkoz,Yasuo,211,117,94,55.45
Velkoz,Evelynn,30,11,19,36.67
Velkoz,Lux,338,194,144,57.4
Velkoz,Brand,80,54,26,67.5
Velkoz,Jax,119,64,55,53.78
Velkoz,LeeSin,238,136,102,57.14
Velkoz,Malzahar,139,59,80,42.45
Velkoz,Jinx,278,147,131,52.88
Velkoz,Elise,120,50,70,41.67
Velkoz,Riven,37,20,17,54.05
Velkoz,Ashe,199,102,97,51.26
Velkoz,Nautilus,139,60,79,43.17
Velkoz,Mordekaiser,141,69,72,48.94
Velkoz,Sejuani,78,26,52,33.33
Velkoz,Zilean,50,27,23,54
Velkoz,Diana,203,120,83,59.11
Velkoz,Corki,41,19,22,46.34
Velkoz,Soraka,52,28,24,53.85
Velkoz,Vladimir,77,38,39,49.35
Velkoz,Belveth,27,13,14,48.15
Velkoz,Samira,105,50,55,47.62
Velkoz,Alistar,57,28,29,49.12
Velkoz,Gragas,74,46,28,62.16
Velkoz,Varus,102,51,51,50
Velkoz,Zac,68,34,34,50
Velkoz,Sett,140,80,60,57.14
Velkoz,Viego,124,71,53,57.26
Velkoz,AurelionSol,58,17,41,29.31
Velkoz,MissFortune,264,147,117,55.68
Velkoz,Shen,113,61,52,53.98
Velkoz,Xerath,129,56,73,43.41
Velkoz,Lulu,200,105,95,52.5
Velkoz,MonkeyKing,65,31,34,47.69
Velkoz,Zed,138,52,86,37.68
Velkoz,Jhin,224,121,103,54.02
Velkoz,Gwen,47,19,28,40.43
Velkoz,Milio,48,30,18,62.5
Velkoz,Malphite,134,55,79,41.04
Velkoz,Katarina,63,40,23,63.49
Velkoz,TahmKench,118,59,59,50
Velkoz,Nunu,113,65,48,57.52
Velkoz,Jayce,40,22,18,55
Velkoz,Zeri,39,22,17,56.41
Velkoz,Kayn,107,51,56,47.66
Velkoz,Fizz,69,31,38,44.93
Velkoz,Kaisa,194,101,93,52.06
Velkoz,Rell,83,31,52,37.35
Velkoz,Zyra,81,53,28,65.43
Velkoz,Sylas,135,77,58,57.04
Velkoz,Thresh,233,112,121,48.07
Velkoz,Mel,259,143,116,55.21
Velkoz,Vi,130,64,66,49.23
Velkoz,Hwei,105,61,44,58.1
Velkoz,Morgana,117,33,84,28.21
Velkoz,Yorick,101,44,57,43.56
Velkoz,Trundle,64,41,23,64.06
Velkoz,Shaco,66,23,43,34.85
Velkoz,Blitzcrank,100,53,47,53
Velkoz,Garen,152,44,108,28.95
Velkoz,Bard,43,16,27,37.21
Velkoz,Udyr,51,32,19,62.75
Velkoz,Yone,185,101,84,54.59
Velkoz,Leona,110,52,58,47.27
Velkoz,Chogath,147,64,83,43.54
Velkoz,Aphelios,57,25,32,43.86
Velkoz,Hecarim,21,13,8,61.9
Velkoz,Aurora,92,60,32,65.22
Velkoz,Aatrox,125,59,66,47.2
Velkoz,Sona,11,11,0,100
Velkoz,Kalista,40,14,26,35
Velkoz,Rengar,52,34,18,65.38
Velkoz,Maokai,64,33,31,51.56
Velkoz,Irelia,86,57,29,66.28
Velkoz,Poppy,83,37,46,44.58
Velkoz,Orianna,56,27,29,48.21
Velkoz,Vayne,123,50,73,40.65
Velkoz,MasterYi,116,55,61,47.41
Velkoz,Nasus,98,52,46,53.06
Velkoz,Amumu,178,61,117,34.27
Velkoz,Heimerdinger,64,41,23,64.06
Velkoz,Lissandra,37,15,22,40.54
Velkoz,Kayle,58,28,30,48.28
Velkoz,Nocturne,108,62,46,57.41
Velkoz,Volibear,107,41,66,38.32
Velkoz,Ekko,84,39,45,46.43
Velkoz,Kled,32,23,9,71.88
Velkoz,Illaoi,64,46,18,71.88
Velkoz,JarvanIV,124,65,59,52.42
Velkoz,Naafiri,38,11,27,28.95
Velkoz,Nilah,52,24,28,46.15
Velkoz,Pyke,97,61,36,62.89
Velkoz,Ahri,169,69,100,40.83
Velkoz,Taliyah,29,9,20,31.03
Velkoz,Quinn,35,24,11,68.57
Velkoz,Nami,146,72,74,49.32
Velkoz,Draven,80,24,56,30
Velkoz,Fiora,35,22,13,62.86
Velkoz,Galio,152,46,106,30.26
Velkoz,XinZhao,92,44,48,47.83
Velkoz,Anivia,42,22,20,52.38
Velkoz,Khazix,71,33,38,46.48
Velkoz,Akali,101,42,59,41.58
Velkoz,Gnar,68,30,38,44.12
Velkoz,Smolder,66,27,39,40.91
Velkoz,Twitch,82,35,47,42.68
Velkoz,Vex,46,15,31,32.61
Velkoz,Xayah,42,19,23,45.24
Velkoz,Yuumi,96,43,53,44.79
Velkoz,Renekton,62,34,28,54.84
Velkoz,Seraphine,67,24,43,35.82
Velkoz,Briar,68,48,20,70.59
Velkoz,Talon,62,26,36,41.94
Velkoz,Swain,154,82,72,53.25
Velkoz,Singed,45,17,28,37.78
Velkoz,Kassadin,42,25,17,59.52
Velkoz,Kennen,35,27,8,77.14
Velkoz,Ryze,42,16,26,38.1
Velkoz,KogMaw,28,17,11,60.71
Velkoz,Lucian,79,34,45,43.04
Velkoz,Senna,63,26,37,41.27
Velkoz,Camille,56,20,36,35.71
Velkoz,Akshan,29,7,22,24.14
Velkoz,FiddleSticks,44,25,19,56.82
Velkoz,Skarner,40,24,16,60
Velkoz,Azir,54,26,28,48.15
Velkoz,Urgot,77,34,43,44.16
Velkoz,Lillia,47,28,19,59.57
Velkoz,KSante,79,53,26,67.09
Velkoz,Gangplank,60,23,37,38.33
Velkoz,Syndra,75,19,56,25.33
Velkoz,Rumble,47,20,27,42.55
Velkoz,Cassiopeia,26,11,15,42.31
Velkoz,Rakan,61,41,20,67.21
Velkoz,Sivir,56,27,29,48.21
Velkoz,Taric,42,22,20,52.38
Velkoz,Tryndamere,35,19,16,54.29
Velkoz,Shyvana,25,18,7,72
Velkoz,Ivern,24,7,17,29.17
Velkoz,TwistedFate,49,30,19,61.22
Velkoz,Karthus,24,9,15,37.5
Velkoz,Janna,40,19,21,47.5
Velkoz,RekSai,15,6,9,40
Velkoz,Olaf,26,14,12,53.85
Velkoz,Qiyana,22,16,6,72.73
Velkoz,Nidalee,18,5,13,27.78
Xayah,Ambessa,137,74,63,54.01
Xayah,Viktor,110,61,49,55.45
Xayah,Graves,91,42,49,46.15
Xayah,Caitlyn,351,144,207,41.03
Xayah,Braum,93,52,41,55.91
Xayah,Sejuani,101,45,56,44.55
Xayah,Pantheon,207,92,115,44.44
Xayah,Neeko,65,37,28,56.92
Xayah,Varus,123,64,59,52.03
Xayah,Pyke,117,61,56,52.14
Xayah,Yasuo,248,124,124,50
Xayah,Shaco,93,37,56,39.78
Xayah,Azir,84,38,46,45.24
Xayah,Jhin,233,152,81,65.24
Xayah,Sylas,210,107,103,50.95
Xayah,Jax,101,46,55,45.54
Xayah,Diana,214,120,94,56.07
Xayah,Akshan,45,23,22,51.11
Xayah,Ashe,237,122,115,51.48
Xayah,Milio,93,46,47,49.46
Xayah,Illaoi,69,41,28,59.42
Xayah,Twitch,89,31,58,34.83
Xayah,Ahri,248,141,107,56.85
Xayah,Kaisa,381,213,168,55.91
Xayah,Garen,250,131,119,52.4
Xayah,Ezreal,365,202,163,55.34
Xayah,Brand,61,34,27,55.74
Xayah,Warwick,178,76,102,42.7
Xayah,LeeSin,197,110,87,55.84
Xayah,Lucian,109,76,33,69.72
Xayah,Nami,136,60,76,44.12
Xayah,Vladimir,97,30,67,30.93
Xayah,Akali,168,94,74,55.95
Xayah,Vayne,168,90,78,53.57
Xayah,Malphite,160,67,93,41.88
Xayah,Ekko,114,42,72,36.84
Xayah,Smolder,103,55,48,53.4
Xayah,Soraka,67,37,30,55.22
Xayah,Irelia,119,54,65,45.38
Xayah,Darius,254,114,140,44.88
Xayah,Aurora,116,64,52,55.17
Xayah,Katarina,56,32,24,57.14
Xayah,JarvanIV,100,46,54,46
Xayah,Yone,260,149,111,57.31
Xayah,Amumu,192,82,110,42.71
Xayah,KSante,97,49,48,50.52
Xayah,Draven,61,36,25,59.02
Xayah,Zoe,42,26,16,61.9
Xayah,Lulu,178,103,75,57.87
Xayah,Aatrox,157,77,80,49.04
Xayah,Kayn,146,94,52,64.38
Xayah,MissFortune,268,123,145,45.9
Xayah,Nautilus,243,139,104,57.2
Xayah,Heimerdinger,74,50,24,67.57
Xayah,Vi,216,119,97,55.09
Xayah,Blitzcrank,142,62,80,43.66
Xayah,Tryndamere,65,41,24,63.08
Xayah,Gragas,139,87,52,62.59
Xayah,Senna,92,65,27,70.65
Xayah,Nasus,84,42,42,50
Xayah,MasterYi,101,66,35,65.35
Xayah,Morgana,141,71,70,50.35
Xayah,Seraphine,59,33,26,55.93
Xayah,Sion,133,60,73,45.11
Xayah,RekSai,40,18,22,45
Xayah,Lissandra,52,24,28,46.15
Xayah,Fizz,49,21,28,42.86
Xayah,Yorick,105,54,51,51.43
Xayah,Briar,93,35,58,37.63
Xayah,Mordekaiser,164,97,67,59.15
Xayah,Vex,115,61,54,53.04
Xayah,Hwei,104,50,54,48.08
Xayah,Malzahar,142,74,68,52.11
Xayah,KogMaw,31,12,19,38.71
Xayah,Udyr,42,26,16,61.9
Xayah,Zed,182,87,95,47.8
Xayah,Lillia,92,44,48,47.83
Xayah,Sett,170,81,89,47.65
Xayah,Swain,138,74,64,53.62
Xayah,Jinx,373,134,239,35.92
Xayah,Yuumi,139,71,68,51.08
Xayah,Zilean,27,6,21,22.22
Xayah,Khazix,67,32,35,47.76
Xayah,Syndra,101,52,49,51.49
Xayah,Rell,98,51,47,52.04
Xayah,TahmKench,118,52,66,44.07
Xayah,TwistedFate,60,19,41,31.67
Xayah,Anivia,48,20,28,41.67
Xayah,FiddleSticks,79,29,50,36.71
Xayah,Poppy,121,64,57,52.89
Xayah,Zac,91,49,42,53.85
Xayah,Renata,29,11,18,37.93
Xayah,Nocturne,168,79,89,47.02
Xayah,Zyra,91,41,50,45.05
Xayah,Mel,275,165,110,60
Xayah,Thresh,278,141,137,50.72
Xayah,Singed,41,12,29,29.27
Xayah,AurelionSol,50,26,24,52
Xayah,Elise,143,59,84,41.26
Xayah,MonkeyKing,81,50,31,61.73
Xayah,Lux,260,138,122,53.08
Xayah,Karma,170,77,93,45.29
Xayah,DrMundo,67,39,28,58.21
Xayah,Leblanc,74,41,33,55.41
Xayah,Veigar,144,55,89,38.19
Xayah,Leona,152,87,65,57.24
Xayah,Taric,33,9,24,27.27
Xayah,Nidalee,61,31,30,50.82
Xayah,Fiora,47,17,30,36.17
Xayah,Renekton,89,57,32,64.04
Xayah,Jayce,53,27,26,50.94
Xayah,Olaf,38,16,22,42.11
Xayah,Riven,45,20,25,44.44
Xayah,Galio,171,88,83,51.46
Xayah,Viego,189,83,106,43.92
Xayah,Rengar,55,41,14,74.55
Xayah,Janna,57,18,39,31.58
Xayah,Volibear,131,67,64,51.15
Xayah,Evelynn,43,23,20,53.49
Xayah,Ornn,89,54,35,60.67
Xayah,Gnar,88,44,44,50
Xayah,Annie,63,21,42,33.33
Xayah,Talon,65,41,24,63.08
Xayah,Karthus,33,24,9,72.73
Xayah,Alistar,72,37,35,51.39
Xayah,Skarner,80,40,40,50
Xayah,Tristana,99,44,55,44.44
Xayah,Corki,75,49,26,65.33
Xayah,Bard,67,41,26,61.19
Xayah,Gangplank,72,46,26,63.89
Xayah,Teemo,131,69,62,52.67
Xayah,Quinn,25,11,14,44
Xayah,Hecarim,48,34,14,70.83
Xayah,Ziggs,41,16,25,39.02
Xayah,Rakan,103,34,69,33.01
Xayah,Ryze,48,24,24,50
Xayah,Kindred,55,32,23,58.18
Xayah,Naafiri,22,13,9,59.09
Xayah,Sona,26,18,8,69.23
Xayah,Zeri,91,46,45,50.55
Xayah,Trundle,72,45,27,62.5
Xayah,Nunu,75,36,39,48
Xayah,Rumble,43,34,9,79.07
Xayah,Taliyah,43,25,18,58.14
Xayah,Maokai,41,16,25,39.02
Xayah,Aphelios,55,27,28,49.09
Xayah,Gwen,69,31,38,44.93
Xayah,Velkoz,42,23,19,54.76
Xayah,Sivir,52,16,36,30.77
Xayah,Chogath,173,55,118,31.79
Xayah,Shyvana,34,17,17,50
Xayah,Nilah,76,42,34,55.26
Xayah,Rammus,53,26,27,49.06
Xayah,Samira,118,61,57,51.69
Xayah,Urgot,58,35,23,60.34
Xayah,XinZhao,83,40,43,48.19
Xayah,Belveth,26,11,15,42.31
Xayah,Orianna,80,33,47,41.25
Xayah,Shen,135,63,72,46.67
Xayah,Cassiopeia,42,26,16,61.9
Xayah,Kayle,62,23,39,37.1
Xayah,Kennen,34,15,19,44.12
Xayah,Camille,68,46,22,67.65
Xayah,Xerath,95,43,52,45.26
Xayah,Qiyana,21,11,10,52.38
Xayah,Kalista,38,23,15,60.53
Xayah,Kassadin,28,15,13,53.57
Xayah,Ivern,23,17,6,73.91
Xayah,Kled,14,11,3,78.57
Leblanc,Ambessa,106,45,61,42.45
Leblanc,Viktor,154,80,74,51.95
Leblanc,Graves,125,64,61,51.2
Leblanc,Caitlyn,367,165,202,44.96
Leblanc,Braum,95,39,56,41.05
Leblanc,Teemo,119,62,57,52.1
Leblanc,FiddleSticks,56,28,28,50
Leblanc,Hwei,87,28,59,32.18
Leblanc,Twitch,111,65,46,58.56
Leblanc,Seraphine,79,34,45,43.04
Leblanc,Garen,206,107,99,51.94
Leblanc,MonkeyKing,139,85,54,61.15
Leblanc,Lux,322,136,186,42.24
Leblanc,Nilah,22,5,17,22.73
Leblanc,Lulu,246,99,147,40.24
Leblanc,Trundle,56,26,30,46.43
Leblanc,Ahri,287,125,162,43.55
Leblanc,Zed,153,65,88,42.48
Leblanc,Skarner,90,43,47,47.78
Leblanc,Aurora,151,82,69,54.3
Leblanc,Ezreal,351,163,188,46.44
Leblanc,Yuumi,116,46,70,39.66
Leblanc,Darius,196,93,103,47.45
Leblanc,Shaco,116,62,54,53.45
Leblanc,Ekko,139,60,79,43.17
Leblanc,Kaisa,236,135,101,57.2
Leblanc,Neeko,78,43,35,55.13
Leblanc,Camille,54,22,32,40.74
Leblanc,Kindred,51,23,28,45.1
Leblanc,Jinx,315,120,195,38.1
Leblanc,Riven,44,22,22,50
Leblanc,Shyvana,32,18,14,56.25
Leblanc,Ryze,36,13,23,36.11
Leblanc,Velkoz,76,27,49,35.53
Leblanc,Jhin,276,155,121,56.16
Leblanc,Gnar,65,38,27,58.46
Leblanc,Syndra,103,48,55,46.6
Leblanc,Diana,208,121,87,58.17
Leblanc,Tristana,109,54,55,49.54
Leblanc,Janna,40,9,31,22.5
Leblanc,Sett,210,129,81,61.43
Leblanc,Nautilus,179,97,82,54.19
Leblanc,Shen,84,45,39,53.57
Leblanc,Mel,245,106,139,43.27
Leblanc,Galio,225,100,125,44.44
Leblanc,Thresh,305,150,155,49.18
Leblanc,Lillia,100,59,41,59
Leblanc,Yone,271,119,152,43.91
Leblanc,MissFortune,257,97,160,37.74
Leblanc,Karma,205,117,88,57.07
Leblanc,Jax,114,57,57,50
Leblanc,Chogath,172,68,104,39.53
Leblanc,Kennen,50,25,25,50
Leblanc,Varus,145,67,78,46.21
Leblanc,Volibear,134,49,85,36.57
Leblanc,Evelynn,33,14,19,42.42
Leblanc,KogMaw,66,35,31,53.03
Leblanc,AurelionSol,27,18,9,66.67
Leblanc,Ashe,336,189,147,56.25
Leblanc,Poppy,109,43,66,39.45
Leblanc,Mordekaiser,209,93,116,44.5
Leblanc,Senna,99,59,40,59.6
Leblanc,Nocturne,191,79,112,41.36
Leblanc,Naafiri,28,17,11,60.71
Leblanc,Gragas,143,66,77,46.15
Leblanc,Malzahar,134,60,74,44.78
Leblanc,Kayn,144,66,78,45.83
Leblanc,Rengar,62,30,32,48.39
Leblanc,Brand,58,26,32,44.83
Leblanc,LeeSin,312,154,158,49.36
Leblanc,Vex,111,48,63,43.24
Leblanc,Samira,99,41,58,41.41
Leblanc,Blitzcrank,168,78,90,46.43
Leblanc,DrMundo,56,33,23,58.93
Leblanc,Briar,74,30,44,40.54
Leblanc,Lucian,109,58,51,53.21
Leblanc,Nunu,73,34,39,46.58
Leblanc,Renekton,86,33,53,38.37
Leblanc,Zyra,126,73,53,57.94
Leblanc,Vi,162,66,96,40.74
Leblanc,Amumu,155,72,83,46.45
Leblanc,Draven,83,47,36,56.63
Leblanc,Talon,106,58,48,54.72
Leblanc,Corki,77,40,37,51.95
Leblanc,Swain,104,35,69,33.65
Leblanc,Singed,30,9,21,30
Leblanc,Katarina,84,46,38,54.76
Leblanc,Kled,23,12,11,52.17
Leblanc,Orianna,76,40,36,52.63
Leblanc,Malphite,150,68,82,45.33
Leblanc,Vladimir,76,42,34,55.26
Leblanc,Rammus,53,36,17,67.92
Leblanc,Vayne,120,49,71,40.83
Leblanc,Nami,150,78,72,52
Leblanc,Viego,163,75,88,46.01
Leblanc,Yorick,101,48,53,47.52
Leblanc,Elise,109,52,57,47.71
Leblanc,Pyke,110,71,39,64.55
Leblanc,Xayah,74,33,41,44.59
Leblanc,Sivir,59,32,27,54.24
Leblanc,KSante,101,66,35,65.35
Leblanc,Kassadin,41,23,18,56.1
Leblanc,Veigar,120,62,58,51.67
Leblanc,Yasuo,240,126,114,52.5
Leblanc,Khazix,60,25,35,41.67
Leblanc,Rakan,89,43,46,48.31
Leblanc,Gangplank,81,38,43,46.91
Leblanc,Azir,64,44,20,68.75
Leblanc,Aatrox,143,70,73,48.95
Leblanc,Zac,68,36,32,52.94
Leblanc,Irelia,99,56,43,56.57
Leblanc,Milio,62,35,27,56.45
Leblanc,Zeri,97,53,44,54.64
Leblanc,Nidalee,35,19,16,54.29
Leblanc,Alistar,86,49,37,56.98
Leblanc,Hecarim,42,21,21,50
Leblanc,Sion,92,41,51,44.57
Leblanc,Zilean,36,24,12,66.67
Leblanc,Smolder,89,38,51,42.7
Leblanc,Ornn,86,42,44,48.84
Leblanc,Karthus,25,11,14,44
Leblanc,Nasus,84,35,49,41.67
Leblanc,Sylas,204,77,127,37.75
Leblanc,TahmKench,102,48,54,47.06
Leblanc,Ivern,45,15,30,33.33
Leblanc,Maokai,82,32,50,39.02
Leblanc,Sona,20,9,11,45
Leblanc,Warwick,189,91,98,48.15
Leblanc,Annie,46,32,14,69.57
Leblanc,Urgot,77,37,40,48.05
Leblanc,Zoe,61,39,22,63.93
Leblanc,Aphelios,62,30,32,48.39
Leblanc,Lissandra,83,34,49,40.96
Leblanc,Tryndamere,40,31,9,77.5
Leblanc,Fizz,64,45,19,70.31
Leblanc,JarvanIV,107,49,58,45.79
Leblanc,MasterYi,130,48,82,36.92
Leblanc,Akali,143,57,86,39.86
Leblanc,Fiora,50,4,46,8
Leblanc,Belveth,18,5,13,27.78
Leblanc,Morgana,132,77,55,58.33
Leblanc,Kalista,78,44,34,56.41
Leblanc,Akshan,34,10,24,29.41
Leblanc,Soraka,86,46,40,53.49
Leblanc,Pantheon,190,101,89,53.16
Leblanc,Leona,94,57,37,60.64
Leblanc,Jayce,74,32,42,43.24
Leblanc,XinZhao,106,59,47,55.66
Leblanc,Quinn,42,15,27,35.71
Leblanc,Rumble,40,20,20,50
Leblanc,Rell,91,50,41,54.95
Leblanc,Xerath,140,74,66,52.86
Leblanc,Udyr,40,25,15,62.5
Leblanc,Anivia,38,11,27,28.95
Leblanc,Ziggs,31,14,17,45.16
Leblanc,Kayle,74,38,36,51.35
Leblanc,Illaoi,59,27,32,45.76
Leblanc,Olaf,26,9,17,34.62
Leblanc,Renata,26,9,17,34.62
Leblanc,Taliyah,21,18,3,85.71
Leblanc,RekSai,29,21,8,72.41
Leblanc,Gwen,55,30,25,54.55
Leblanc,Sejuani,79,40,39,50.63
Leblanc,TwistedFate,44,27,17,61.36
Leblanc,Taric,20,8,12,40
Leblanc,Cassiopeia,28,20,8,71.43
Leblanc,Heimerdinger,15,4,11,26.67
Leblanc,Qiyana,17,8,9,47.06
Leblanc,Bard,37,20,17,54.05
Viktor,Vladimir,114,67,47,58.77
Viktor,Kayn,204,101,103,49.51
Viktor,Velkoz,122,67,55,54.92
Viktor,Xayah,110,49,61,44.55
Viktor,Leblanc,154,74,80,48.05
Viktor,Sejuani,175,78,97,44.57
Viktor,Pantheon,347,182,165,52.45
Viktor,Neeko,100,48,52,48
Viktor,Varus,203,98,105,48.28
Viktor,Pyke,196,104,92,53.06
Viktor,Yone,385,210,175,54.55
Viktor,Nocturne,337,181,156,53.71
Viktor,Akali,265,149,116,56.23
Viktor,Ezreal,630,341,289,54.13
Viktor,Renata,66,28,38,42.42
Viktor,JarvanIV,232,116,116,50
Viktor,Ryze,114,56,58,49.12
Viktor,Draven,91,47,44,51.65
Viktor,Blitzcrank,160,85,75,53.13
Viktor,Teemo,187,102,85,54.55
Viktor,Viego,294,151,143,51.36
Viktor,Anivia,94,32,62,34.04
Viktor,MissFortune,389,180,209,46.27
Viktor,TahmKench,238,125,113,52.52
Viktor,Kennen,77,30,47,38.96
Viktor,Vi,271,157,114,57.93
Viktor,Ashe,415,226,189,54.46
Viktor,Lux,469,257,212,54.8
Viktor,Leona,176,111,65,63.07
Viktor,LeeSin,404,207,197,51.24
Viktor,Orianna,159,85,74,53.46
Viktor,Twitch,150,59,91,39.33
Viktor,Morgana,214,77,137,35.98
Viktor,Poppy,174,82,92,47.13
Viktor,Shaco,157,89,68,56.69
Viktor,Ahri,323,184,139,56.97
Viktor,Nami,232,107,125,46.12
Viktor,Gragas,173,101,72,58.38
Viktor,MasterYi,209,124,85,59.33
Viktor,TwistedFate,75,41,34,54.67
Viktor,Rakan,115,45,70,39.13
Viktor,Shen,195,96,99,49.23
Viktor,AurelionSol,101,54,47,53.47
Viktor,Caitlyn,534,269,265,50.37
Viktor,Brand,148,91,57,61.49
Viktor,Chogath,296,141,155,47.64
Viktor,Yasuo,379,182,197,48.02
Viktor,Sivir,168,82,86,48.81
Viktor,Sett,310,174,136,56.13
Viktor,Ekko,218,120,98,55.05
Viktor,Azir,137,59,78,43.07
Viktor,Jinx,584,281,303,48.12
Viktor,Olaf,64,35,29,54.69
Viktor,Katarina,152,85,67,55.92
Viktor,Veigar,267,140,127,52.43
Viktor,Bard,71,45,26,63.38
Viktor,Zed,187,122,65,65.24
Viktor,Ziggs,83,34,49,40.96
Viktor,Graves,175,92,83,52.57
Viktor,Hwei,202,102,100,50.5
Viktor,Mel,583,281,302,48.2
Viktor,Sion,141,61,80,43.26
Viktor,Warwick,234,121,113,51.71
Viktor,Samira,164,99,65,60.37
Viktor,Swain,226,89,137,39.38
Viktor,Garen,363,179,184,49.31
Viktor,Corki,143,78,65,54.55
Viktor,Lillia,105,59,46,56.19
Viktor,Galio,265,135,130,50.94
Viktor,Kaisa,349,161,188,46.13
Viktor,Amumu,199,94,105,47.24
Viktor,KSante,177,102,75,57.63
Viktor,Zoe,84,52,32,61.9
Viktor,Lulu,383,207,176,54.05
Viktor,Ornn,120,64,56,53.33
Viktor,Jayce,125,59,66,47.2
Viktor,Seraphine,115,42,73,36.52
Viktor,Zyra,188,97,91,51.6
Viktor,Trundle,74,48,26,64.86
Viktor,Lissandra,107,61,46,57.01
Viktor,DrMundo,123,72,51,58.54
Viktor,Vex,130,53,77,40.77
Viktor,Jhin,383,206,177,53.79
Viktor,Camille,63,42,21,66.67
Viktor,Xerath,216,107,109,49.54
Viktor,Smolder,147,69,78,46.94
Viktor,Rell,182,91,91,50
Viktor,Zac,144,66,78,45.83
Viktor,Lucian,216,125,91,57.87
Viktor,Darius,359,195,164,54.32
Viktor,Mordekaiser,248,127,121,51.21
Viktor,Maokai,113,62,51,54.87
Viktor,Soraka,115,60,55,52.17
Viktor,Rengar,57,37,20,64.91
Viktor,Nautilus,333,174,159,52.25
Viktor,Hecarim,86,53,33,61.63
Viktor,Kindred,111,65,46,58.56
Viktor,Tristana,201,112,89,55.72
Viktor,Karma,300,163,137,54.33
Viktor,Malphite,258,131,127,50.78
Viktor,Jax,182,85,97,46.7
Viktor,Gangplank,126,65,61,51.59
Viktor,Alistar,144,67,77,46.53
Viktor,XinZhao,179,63,116,35.2
Viktor,Renekton,99,59,40,59.6
Viktor,Thresh,451,220,231,48.78
Viktor,Irelia,148,83,65,56.08
Viktor,Milio,147,88,59,59.86
Viktor,Zeri,109,57,52,52.29
Viktor,Yorick,153,70,83,45.75
Viktor,Cassiopeia,71,32,39,45.07
Viktor,Janna,61,37,24,60.66
Viktor,Diana,288,135,153,46.88
Viktor,Syndra,192,109,83,56.77
Viktor,Vayne,287,151,136,52.61
Viktor,Zilean,58,31,27,53.45
Viktor,Ambessa,175,81,94,46.29
Viktor,Kalista,96,61,35,63.54
Viktor,Illaoi,66,28,38,42.42
Viktor,FiddleSticks,115,47,68,40.87
Viktor,Aurora,235,119,116,50.64
Viktor,Gnar,142,93,49,65.49
Viktor,MonkeyKing,199,96,103,48.24
Viktor,Sona,37,19,18,51.35
Viktor,Aatrox,207,113,94,54.59
Viktor,Shyvana,34,17,17,50
Viktor,Urgot,107,45,62,42.06
Viktor,Yuumi,176,76,100,43.18
Viktor,Volibear,246,101,145,41.06
Viktor,Ivern,50,22,28,44
Viktor,RekSai,28,15,13,53.57
Viktor,Talon,93,58,35,62.37
Viktor,Senna,102,47,55,46.08
Viktor,Heimerdinger,97,55,42,56.7
Viktor,Gwen,124,62,62,50
Viktor,Udyr,82,42,40,51.22
Viktor,Riven,94,47,47,50
Viktor,Sylas,322,191,131,59.32
Viktor,Kayle,111,72,39,64.86
Viktor,Taric,49,20,29,40.82
Viktor,Rumble,65,32,33,49.23
Viktor,KogMaw,66,42,24,63.64
Viktor,Quinn,47,17,30,36.17
Viktor,Evelynn,56,25,31,44.64
Viktor,Malzahar,218,125,93,57.34
Viktor,Briar,118,44,74,37.29
Viktor,Rammus,62,35,27,56.45
Viktor,Aphelios,106,64,42,60.38
Viktor,Nasus,147,88,59,59.86
Viktor,Akshan,69,39,30,56.52
Viktor,Fizz,121,53,68,43.8
Viktor,Elise,198,95,103,47.98
Viktor,Fiora,84,31,53,36.9
Viktor,Kassadin,49,18,31,36.73
Viktor,Karthus,51,15,36,29.41
Viktor,Nunu,127,68,59,53.54
Viktor,Annie,41,19,22,46.34
Viktor,Nidalee,62,46,16,74.19
Viktor,Khazix,143,80,63,55.94
Viktor,Naafiri,48,25,23,52.08
Viktor,Singed,62,32,30,51.61
Viktor,Taliyah,44,31,13,70.45
Viktor,Tryndamere,69,36,33,52.17
Viktor,Skarner,141,79,62,56.03
Viktor,Braum,179,92,87,51.4
Viktor,Belveth,51,27,24,52.94
Viktor,Nilah,67,23,44,34.33
Viktor,Kled,39,23,16,58.97
Viktor,Qiyana,32,6,26,18.75
Graves,Vladimir,102,45,57,44.12
Graves,Kayn,164,87,77,53.05
Graves,Velkoz,92,47,45,51.09
Graves,Xayah,91,49,42,53.85
Graves,Leblanc,125,61,64,48.8
Graves,Thresh,377,181,196,48.01
Graves,Annie,59,28,31,47.46
Graves,Nasus,94,47,47,50
Graves,Tristana,140,78,62,55.71
Graves,Poppy,119,43,76,36.13
Graves,Tryndamere,67,30,37,44.78
Graves,Shaco,133,54,79,40.6
Graves,Caitlyn,347,165,182,47.55
Graves,Morgana,125,78,47,62.4
Graves,Jax,138,67,71,48.55
Graves,Pantheon,213,103,110,48.36
Graves,TwistedFate,82,38,44,46.34
Graves,Sivir,72,36,36,50
Graves,Milio,103,48,55,46.6
Graves,Teemo,104,65,39,62.5
Graves,MasterYi,140,76,64,54.29
Graves,Katarina,100,46,54,46
Graves,Samira,130,60,70,46.15
Graves,Singed,54,18,36,33.33
Graves,Aatrox,225,123,102,54.67
Graves,Mel,277,127,150,45.85
Graves,Sona,31,19,12,61.29
Graves,Alistar,63,32,31,50.79
Graves,Nocturne,242,124,118,51.24
Graves,Galio,208,112,96,53.85
Graves,Urgot,52,29,23,55.77
Graves,FiddleSticks,73,31,42,42.47
Graves,Lux,329,160,169,48.63
Graves,Ashe,335,176,159,52.54
Graves,Braum,120,49,71,40.83
Graves,Yorick,86,40,46,46.51
Graves,Nunu,116,86,30,74.14
Graves,Varus,193,105,88,54.4
Graves,Bard,54,27,27,50
Graves,Hwei,98,39,59,39.8
Graves,Zyra,117,59,58,50.43
Graves,Sett,233,132,101,56.65
Graves,JarvanIV,154,74,80,48.05
Graves,Veigar,120,73,47,60.83
Graves,Renekton,91,51,40,56.04
Graves,Elise,168,73,95,43.45
Graves,Sylas,314,175,139,55.73
Graves,Jinx,409,208,201,50.86
Graves,Jayce,114,49,65,42.98
Graves,Ekko,82,44,38,53.66
Graves,Viktor,175,83,92,47.43
Graves,Leona,140,82,58,58.57
Graves,Mordekaiser,165,98,67,59.39
Graves,XinZhao,93,40,53,43.01
Graves,Diana,252,132,120,52.38
Graves,Riven,86,44,42,51.16
Graves,Lillia,75,55,20,73.33
Graves,Yasuo,291,178,113,61.17
Graves,Nautilus,264,141,123,53.41
Graves,Qiyana,34,25,9,73.53
Graves,Kalista,72,31,41,43.06
Graves,Irelia,105,66,39,62.86
Graves,Zed,154,70,84,45.45
Graves,Kaisa,325,161,164,49.54
Graves,Brand,51,22,29,43.14
Graves,Volibear,130,74,56,56.92
Graves,Ahri,232,115,117,49.57
Graves,Vayne,185,97,88,52.43
Graves,Rakan,77,50,27,64.94
Graves,TahmKench,146,84,62,57.53
Graves,Jhin,272,151,121,55.51
Graves,MonkeyKing,127,60,67,47.24
Graves,Seraphine,90,50,40,55.56
Graves,Nami,126,51,75,40.48
Graves,Karma,212,127,85,59.91
Graves,LeeSin,444,227,217,51.13
Graves,KogMaw,70,44,26,62.86
Graves,Heimerdinger,58,42,16,72.41
Graves,Darius,312,162,150,51.92
Graves,Sejuani,135,63,72,46.67
Graves,Quinn,50,21,29,42
Graves,Ezreal,406,209,197,51.48
Graves,Senna,102,57,45,55.88
Graves,Soraka,80,30,50,37.5
Graves,Gwen,115,72,43,62.61
Graves,Lulu,280,153,127,54.64
Graves,Viego,219,119,100,54.34
Graves,Draven,77,47,30,61.04
Graves,MissFortune,316,161,155,50.95
Graves,Ornn,108,43,65,39.81
Graves,Aurora,126,69,57,54.76
Graves,Ziggs,53,34,19,64.15
Graves,Olaf,47,18,29,38.3
Graves,Syndra,102,65,37,63.73
Graves,Sion,128,61,67,47.66
Graves,Ambessa,103,53,50,51.46
Graves,Talon,61,25,36,40.98
Graves,Khazix,65,37,28,56.92
Graves,Pyke,171,83,88,48.54
Graves,Akali,177,94,83,53.11
Graves,Malphite,193,85,108,44.04
Graves,Evelynn,35,11,24,31.43
Graves,Vi,173,89,84,51.45
Graves,Gangplank,107,49,58,45.79
Graves,Renata,52,32,20,61.54
Graves,Trundle,55,36,19,65.45
Graves,Ivern,31,17,14,54.84
Graves,Blitzcrank,142,74,68,52.11
Graves,Lissandra,55,20,35,36.36
Graves,Aphelios,87,50,37,57.47
Graves,Ryze,58,47,11,81.03
Graves,Smolder,115,61,54,53.04
Graves,Zac,110,59,51,53.64
Graves,Rell,80,51,29,63.75
Graves,Hecarim,74,45,29,60.81
Graves,Xerath,147,59,88,40.14
Graves,Orianna,116,57,59,49.14
Graves,Swain,120,50,70,41.67
Graves,Akshan,49,35,14,71.43
Graves,Zilean,26,10,16,38.46
Graves,KSante,113,61,52,53.98
Graves,Rammus,55,16,39,29.09
Graves,Illaoi,65,32,33,49.23
Graves,Yone,301,172,129,57.14
Graves,Warwick,165,96,69,58.18
Graves,AurelionSol,54,28,26,51.85
Graves,Skarner,66,26,40,39.39
Graves,Gragas,92,68,24,73.91
Graves,Karthus,38,22,16,57.89
Graves,Anivia,50,21,29,42
Graves,Maokai,62,23,39,37.1
Graves,Camille,86,41,45,47.67
Graves,Kennen,56,24,32,42.86
Graves,Janna,43,28,15,65.12
Graves,Amumu,185,101,84,54.59
Graves,Corki,92,47,45,51.09
Graves,Cassiopeia,48,28,20,58.33
Graves,Udyr,62,27,35,43.55
Graves,DrMundo,62,21,41,33.87
Graves,Chogath,185,69,116,37.3
Graves,Twitch,86,43,43,50
Graves,Garen,254,133,121,52.36
Graves,Naafiri,34,17,17,50
Graves,Shen,86,48,38,55.81
Graves,Lucian,121,69,52,57.02
Graves,Malzahar,142,60,82,42.25
Graves,Azir,88,37,51,42.05
Graves,Shyvana,35,15,20,42.86
Graves,Briar,59,39,20,66.1
Graves,Taric,25,6,19,24
Graves,Fizz,67,44,23,65.67
Graves,Kayle,75,42,33,56
Graves,Rengar,35,10,25,28.57
Graves,Rumble,54,35,19,64.81
Graves,Yuumi,144,87,57,60.42
Graves,RekSai,15,10,5,66.67
Graves,Nilah,62,22,40,35.48
Graves,Zoe,54,23,31,42.59
Graves,Belveth,27,15,12,55.56
Graves,Gnar,65,31,34,47.69
Graves,Neeko,76,33,43,43.42
Graves,Zeri,97,49,48,50.52
Graves,Vex,81,36,45,44.44
Graves,Fiora,30,17,13,56.67
Graves,Taliyah,45,34,11,75.56
Graves,Nidalee,91,55,36,60.44
Graves,Kindred,73,44,29,60.27
Graves,Kled,29,9,20,31.03
Graves,Kassadin,16,11,5,68.75
XinZhao,Sion,146,60,86,41.1
XinZhao,Nocturne,246,151,95,61.38
XinZhao,Hwei,127,52,75,40.94
XinZhao,Jhin,289,166,123,57.44
XinZhao,Soraka,86,35,51,40.7
XinZhao,Malphite,178,87,91,48.88
XinZhao,Ivern,41,11,30,26.83
XinZhao,Ahri,272,129,143,47.43
XinZhao,Ashe,397,234,163,58.94
XinZhao,Lulu,294,154,140,52.38
XinZhao,Kayle,83,32,51,38.55
XinZhao,Evelynn,47,28,19,59.57
XinZhao,Vladimir,116,64,52,55.17
XinZhao,Kaisa,302,137,165,45.36
XinZhao,Maokai,60,25,35,41.67
XinZhao,TahmKench,133,60,73,45.11
XinZhao,JarvanIV,189,83,106,43.92
XinZhao,Veigar,127,77,50,60.63
XinZhao,Yasuo,335,153,182,45.67
XinZhao,Irelia,95,66,29,69.47
XinZhao,Karma,235,119,116,50.64
XinZhao,MonkeyKing,132,41,91,31.06
XinZhao,Mel,302,189,113,62.58
XinZhao,Cassiopeia,62,43,19,69.35
XinZhao,Thresh,290,172,118,59.31
XinZhao,Nasus,92,29,63,31.52
XinZhao,MasterYi,152,88,64,57.89
XinZhao,Chogath,164,60,104,36.59
XinZhao,Ezreal,481,235,246,48.86
XinZhao,Amumu,189,88,101,46.56
XinZhao,Warwick,209,100,109,47.85
XinZhao,Nunu,61,35,26,57.38
XinZhao,Malzahar,178,85,93,47.75
XinZhao,Samira,132,52,80,39.39
XinZhao,Pyke,125,66,59,52.8
XinZhao,Gwen,103,62,41,60.19
XinZhao,Graves,93,53,40,56.99
XinZhao,Ziggs,69,29,40,42.03
XinZhao,Zoe,98,39,59,39.8
XinZhao,Talon,114,70,44,61.4
XinZhao,Lissandra,61,32,29,52.46
XinZhao,Corki,76,33,43,43.42
XinZhao,Udyr,37,16,21,43.24
XinZhao,Ornn,118,61,57,51.69
XinZhao,Kayn,151,89,62,58.94
XinZhao,Sylas,243,121,122,49.79
XinZhao,Jinx,416,197,219,47.36
XinZhao,Azir,85,40,45,47.06
XinZhao,Nami,211,111,100,52.61
XinZhao,Shaco,105,78,27,74.29
XinZhao,Rammus,60,25,35,41.67
XinZhao,Zyra,136,66,70,48.53
XinZhao,Elise,178,81,97,45.51
XinZhao,Khazix,78,42,36,53.85
XinZhao,Brand,79,51,28,64.56
XinZhao,Leona,156,70,86,44.87
XinZhao,Vayne,207,105,102,50.72
XinZhao,KSante,139,67,72,48.2
XinZhao,Skarner,119,53,66,44.54
XinZhao,Smolder,133,61,72,45.86
XinZhao,Rell,119,66,53,55.46
XinZhao,Garen,281,115,166,40.93
XinZhao,Darius,291,152,139,52.23
XinZhao,Lux,342,186,156,54.39
XinZhao,Nautilus,265,133,132,50.19
XinZhao,Renekton,131,50,81,38.17
XinZhao,LeeSin,449,234,215,52.12
XinZhao,Galio,170,80,90,47.06
XinZhao,Varus,221,117,104,52.94
XinZhao,Illaoi,64,35,29,54.69
XinZhao,Zac,148,97,51,65.54
XinZhao,Katarina,97,60,37,61.86
XinZhao,Gangplank,138,74,64,53.62
XinZhao,Poppy,151,78,73,51.66
XinZhao,Aphelios,59,28,31,47.46
XinZhao,Vex,91,27,64,29.67
XinZhao,Singed,54,25,29,46.3
XinZhao,AurelionSol,50,31,19,62
XinZhao,Swain,137,58,79,42.34
XinZhao,Heimerdinger,93,35,58,37.63
XinZhao,Pantheon,260,131,129,50.38
XinZhao,Blitzcrank,163,67,96,41.1
XinZhao,Caitlyn,378,210,168,55.56
XinZhao,Taric,60,24,36,40
XinZhao,Aatrox,136,74,62,54.41
XinZhao,Viktor,179,116,63,64.8
XinZhao,Fiora,60,24,36,40
XinZhao,Aurora,190,95,95,50
XinZhao,Jax,167,82,85,49.1
XinZhao,Alistar,99,42,57,42.42
XinZhao,Akali,187,97,90,51.87
XinZhao,Nilah,51,25,26,49.02
XinZhao,Milio,76,35,41,46.05
XinZhao,Ekko,110,48,62,43.64
XinZhao,Yone,314,156,158,49.68
XinZhao,Bard,59,24,35,40.68
XinZhao,FiddleSticks,120,60,60,50
XinZhao,Teemo,109,69,40,63.3
XinZhao,Kalista,39,27,12,69.23
XinZhao,Twitch,110,63,47,57.27
XinZhao,Braum,137,75,62,54.74
XinZhao,Lucian,172,104,68,60.47
XinZhao,DrMundo,56,28,28,50
XinZhao,Anivia,67,31,36,46.27
XinZhao,Tryndamere,58,26,32,44.83
XinZhao,Shen,153,71,82,46.41
XinZhao,Zed,200,102,98,51
XinZhao,Rengar,28,8,20,28.57
XinZhao,Tristana,139,81,58,58.27
XinZhao,Sett,222,122,100,54.95
XinZhao,Akshan,52,30,22,57.69
XinZhao,Shyvana,36,16,20,44.44
XinZhao,Taliyah,60,30,30,50
XinZhao,MissFortune,375,193,182,51.47
XinZhao,Kassadin,35,18,17,51.43
XinZhao,Senna,99,35,64,35.35
XinZhao,Mordekaiser,237,123,114,51.9
XinZhao,Volibear,160,79,81,49.38
XinZhao,Naafiri,50,28,22,56
XinZhao,Yuumi,155,77,78,49.68
XinZhao,Lillia,86,42,44,48.84
XinZhao,Camille,73,47,26,64.38
XinZhao,Urgot,75,36,39,48
XinZhao,Vi,203,89,114,43.84
XinZhao,Zeri,75,27,48,36
XinZhao,Viego,242,103,139,42.56
XinZhao,Jayce,105,63,42,60
XinZhao,Briar,82,42,40,51.22
XinZhao,Morgana,139,80,59,57.55
XinZhao,Yorick,99,40,59,40.4
XinZhao,Belveth,38,18,20,47.37
XinZhao,Sona,37,17,20,45.95
XinZhao,Fizz,71,38,33,53.52
XinZhao,Janna,50,11,39,22
XinZhao,Ambessa,163,86,77,52.76
XinZhao,Karthus,58,30,28,51.72
XinZhao,Qiyana,35,24,11,68.57
XinZhao,Syndra,91,42,49,46.15
XinZhao,Leblanc,106,47,59,44.34
XinZhao,Seraphine,101,43,58,42.57
XinZhao,Gnar,90,51,39,56.67
XinZhao,Velkoz,92,48,44,52.17
XinZhao,Neeko,83,46,37,55.42
XinZhao,Trundle,84,43,41,51.19
XinZhao,Xerath,183,101,82,55.19
XinZhao,Kindred,75,42,33,56
XinZhao,Olaf,28,9,19,32.14
XinZhao,KogMaw,27,16,11,59.26
XinZhao,Rakan,85,58,27,68.24
XinZhao,Renata,30,11,19,36.67
XinZhao,Nidalee,55,30,25,54.55
XinZhao,Riven,74,44,30,59.46
XinZhao,Xayah,83,43,40,51.81
XinZhao,Hecarim,58,40,18,68.97
XinZhao,Draven,68,41,27,60.29
XinZhao,Diana,295,157,138,53.22
XinZhao,TwistedFate,47,27,20,57.45
XinZhao,Annie,65,26,39,40
XinZhao,Sejuani,140,60,80,42.86
XinZhao,Gragas,113,58,55,51.33
XinZhao,Sivir,101,51,50,50.5
XinZhao,Orianna,99,45,54,45.45
XinZhao,Ryze,74,37,37,50
XinZhao,RekSai,31,20,11,64.52
XinZhao,Kennen,55,27,28,49.09
XinZhao,Quinn,49,13,36,26.53
XinZhao,Zilean,27,17,10,62.96
XinZhao,Kled,31,17,14,54.84
XinZhao,Rumble,33,12,21,36.36
Morgana,Sion,219,112,107,51.14
Morgana,Nocturne,290,127,163,43.79
Morgana,Hwei,115,49,66,42.61
Morgana,Jhin,429,231,198,53.85
Morgana,Soraka,110,58,52,52.73
Morgana,Jax,187,97,90,51.87
Morgana,Udyr,90,65,25,72.22
Morgana,Yone,354,214,140,60.45
Morgana,Smolder,161,90,71,55.9
Morgana,TahmKench,162,93,69,57.41
Morgana,Yasuo,402,221,181,54.98
Morgana,Shaco,215,124,91,57.67
Morgana,Azir,90,43,47,47.78
Morgana,Sylas,346,188,158,54.34
Morgana,Fiora,66,37,29,56.06
Morgana,Teemo,221,103,118,46.61
Morgana,Diana,304,149,155,49.01
Morgana,Nilah,102,40,62,39.22
Morgana,Leona,299,188,111,62.88
Morgana,Volibear,236,113,123,47.88
Morgana,LeeSin,345,178,167,51.59
Morgana,Veigar,304,145,159,47.7
Morgana,Vayne,258,99,159,38.37
Morgana,Yuumi,139,76,63,54.68
Morgana,Riven,112,54,58,48.21
Morgana,MonkeyKing,173,109,64,63.01
Morgana,Kassadin,31,18,13,58.06
Morgana,Caitlyn,490,260,230,53.06
Morgana,Taliyah,55,30,25,54.55
Morgana,Gangplank,96,57,39,59.38
Morgana,FiddleSticks,131,75,56,57.25
Morgana,Ezreal,579,354,225,61.14
Morgana,Lux,631,319,312,50.55
Morgana,Trundle,152,81,71,53.29
Morgana,Twitch,111,57,54,51.35
Morgana,Ahri,284,138,146,48.59
Morgana,Graves,125,47,78,37.6
Morgana,Lulu,325,173,152,53.23
Morgana,Cassiopeia,58,32,26,55.17
Morgana,Kaisa,344,188,156,54.65
Morgana,Mel,457,217,240,47.48
Morgana,Akali,195,116,79,59.49
Morgana,Nunu,158,92,66,58.23
Morgana,Tristana,173,103,70,59.54
Morgana,Nautilus,347,157,190,45.24
Morgana,Sett,358,200,158,55.87
Morgana,Sejuani,144,70,74,48.61
Morgana,Viktor,214,137,77,64.02
Morgana,Jinx,584,286,298,48.97
Morgana,MasterYi,222,110,112,49.55
Morgana,Warwick,308,144,164,46.75
Morgana,Pyke,188,92,96,48.94
Morgana,JarvanIV,132,53,79,40.15
Morgana,Irelia,153,96,57,62.75
Morgana,Mordekaiser,311,172,139,55.31
Morgana,Khazix,123,73,50,59.35
Morgana,Katarina,180,88,92,48.89
Morgana,Nasus,129,62,67,48.06
Morgana,Chogath,273,151,122,55.31
Morgana,Amumu,272,118,154,43.38
Morgana,AurelionSol,76,37,39,48.68
Morgana,Renekton,137,85,52,62.04
Morgana,Elise,171,95,76,55.56
Morgana,Thresh,407,222,185,54.55
Morgana,Olaf,79,32,47,40.51
Morgana,Vi,246,136,110,55.28
Morgana,Bard,60,24,36,40
Morgana,Ornn,131,72,59,54.96
Morgana,Ashe,476,258,218,54.2
Morgana,Garen,333,154,179,46.25
Morgana,Rammus,83,41,42,49.4
Morgana,Kayle,107,59,48,55.14
Morgana,Briar,120,45,75,37.5
Morgana,Akshan,88,44,44,50
Morgana,Samira,211,104,107,49.29
Morgana,Pantheon,317,150,167,47.32
Morgana,Lucian,194,111,83,57.22
Morgana,Swain,206,93,113,45.15
Morgana,Darius,352,194,158,55.11
Morgana,Syndra,147,71,76,48.3
Morgana,Xayah,141,70,71,49.65
Morgana,Rakan,154,79,75,51.3
Morgana,Kennen,59,26,33,44.07
Morgana,Vladimir,131,54,77,41.22
Morgana,Corki,94,55,39,58.51
Morgana,Kayn,271,145,126,53.51
Morgana,Neeko,104,57,47,54.81
Morgana,Zed,206,120,86,58.25
Morgana,Viego,351,201,150,57.26
Morgana,Vex,139,81,58,58.27
Morgana,Renata,50,34,16,68
Morgana,Illaoi,79,49,30,62.03
Morgana,Brand,140,75,65,53.57
Morgana,Ryze,95,39,56,41.05
Morgana,Jayce,112,66,46,58.93
Morgana,MissFortune,476,251,225,52.73
Morgana,Nami,166,74,92,44.58
Morgana,Ziggs,103,65,38,63.11
Morgana,Sona,51,32,19,62.75
Morgana,Zoe,93,65,28,69.89
Morgana,Zilean,77,31,46,40.26
Morgana,Varus,164,100,64,60.98
Morgana,Braum,141,75,66,53.19
Morgana,Gwen,96,52,44,54.17
Morgana,Ekko,191,83,108,43.46
Morgana,Sivir,157,62,95,39.49
Morgana,Milio,162,72,90,44.44
Morgana,KSante,160,83,77,51.88
Morgana,Skarner,86,52,34,60.47
Morgana,Rell,150,72,78,48
Morgana,Gragas,178,108,70,60.67
Morgana,Malzahar,267,125,142,46.82
Morgana,Quinn,89,30,59,33.71
Morgana,Galio,288,144,144,50
Morgana,Senna,185,117,68,63.24
Morgana,KogMaw,80,47,33,58.75
Morgana,Aurora,188,99,89,52.66
Morgana,Zac,124,62,62,50
Morgana,Xerath,182,104,78,57.14
Morgana,Yorick,188,101,87,53.72
Morgana,Blitzcrank,275,163,112,59.27
Morgana,Singed,60,30,30,50
Morgana,Tryndamere,114,68,46,59.65
Morgana,Karma,302,137,165,45.36
Morgana,Nidalee,59,34,25,57.63
Morgana,Rumble,85,40,45,47.06
Morgana,Zyra,221,102,119,46.15
Morgana,Orianna,90,46,44,51.11
Morgana,Poppy,150,81,69,54
Morgana,Draven,124,55,69,44.35
Morgana,Gnar,95,55,40,57.89
Morgana,Qiyana,55,29,26,52.73
Morgana,Shen,185,73,112,39.46
Morgana,Malphite,244,120,124,49.18
Morgana,Belveth,47,32,15,68.09
Morgana,Alistar,123,75,48,60.98
Morgana,Heimerdinger,114,57,57,50
Morgana,Aatrox,194,106,88,54.64
Morgana,Ambessa,118,58,60,49.15
Morgana,Ivern,44,29,15,65.91
Morgana,Seraphine,162,84,78,51.85
Morgana,Evelynn,66,33,33,50
Morgana,Shyvana,33,16,17,48.48
Morgana,Rengar,45,28,17,62.22
Morgana,Kindred,103,66,37,64.08
Morgana,Janna,70,30,40,42.86
Morgana,Hecarim,69,48,21,69.57
Morgana,Kalista,88,39,49,44.32
Morgana,Maokai,110,71,39,64.55
Morgana,Velkoz,117,84,33,71.79
Morgana,DrMundo,94,35,59,37.23
Morgana,Aphelios,99,65,34,65.66
Morgana,Camille,106,55,51,51.89
Morgana,Lissandra,82,56,26,68.29
Morgana,Kled,42,25,17,59.52
Morgana,Leblanc,132,55,77,41.67
Morgana,TwistedFate,70,36,34,51.43
Morgana,XinZhao,139,59,80,42.45
Morgana,Naafiri,65,39,26,60
Morgana,Urgot,108,60,48,55.56
Morgana,Zeri,85,40,45,47.06
Morgana,Lillia,145,87,58,60
Morgana,Talon,84,36,48,42.86
Morgana,Fizz,97,49,48,50.52
Morgana,RekSai,42,20,22,47.62
Morgana,Taric,33,14,19,42.42
Morgana,Anivia,64,33,31,51.56
Morgana,Annie,66,36,30,54.55
Morgana,Karthus,44,23,21,52.27
Karma,Sion,172,76,96,44.19
Karma,Nocturne,343,170,173,49.56
Karma,Hwei,208,107,101,51.44
Karma,Jhin,526,273,253,51.9
Karma,Soraka,171,81,90,47.37
Karma,Yorick,194,120,74,61.86
Karma,Teemo,240,119,121,49.58
Karma,Katarina,135,67,68,49.63
Karma,Lux,658,350,308,53.19
Karma,Sett,359,199,160,55.43
Karma,Hecarim,128,74,54,57.81
Karma,Ahri,405,176,229,43.46
Karma,Rakan,186,103,83,55.38
Karma,Draven,143,61,82,42.66
Karma,Gnar,177,99,78,55.93
Karma,Kayn,278,138,140,49.64
Karma,Mel,591,308,283,52.12
Karma,Twitch,213,108,105,50.7
Karma,Pantheon,488,224,264,45.9
Karma,Fiora,109,48,61,44.04
Karma,Singed,88,52,36,59.09
Karma,Yasuo,637,312,325,48.98
Karma,Caitlyn,753,396,357,52.59
Karma,Milio,244,124,120,50.82
Karma,Amumu,293,137,156,46.76
Karma,Lissandra,97,47,50,48.45
Karma,Lucian,249,129,120,51.81
Karma,Xerath,303,171,132,56.44
Karma,KSante,255,138,117,54.12
Karma,Viego,433,196,237,45.27
Karma,Kassadin,64,26,38,40.63
Karma,Nasus,163,64,99,39.26
Karma,Bard,119,64,55,53.78
Karma,Trundle,144,84,60,58.33
Karma,Diana,360,186,174,51.67
Karma,Veigar,268,115,153,42.91
Karma,Ashe,635,311,324,48.98
Karma,Braum,247,87,160,35.22
Karma,Olaf,85,52,33,61.18
Karma,Nidalee,118,62,56,52.54
Karma,Ryze,139,78,61,56.12
Karma,Brand,115,76,39,66.09
Karma,Darius,541,249,292,46.03
Karma,Aurora,269,152,117,56.51
Karma,Corki,168,87,81,51.79
Karma,Briar,190,83,107,43.68
Karma,Sejuani,197,94,103,47.72
Karma,Shaco,234,140,94,59.83
Karma,Ekko,212,123,89,58.02
Karma,Kaisa,481,245,236,50.94
Karma,Neeko,130,62,68,47.69
Karma,Gangplank,210,97,113,46.19
Karma,XinZhao,235,116,119,49.36
Karma,Azir,149,60,89,40.27
Karma,Lillia,143,63,80,44.06
Karma,Camille,145,75,70,51.72
Karma,Senna,138,55,83,39.86
Karma,Kindred,106,74,32,69.81
Karma,Elise,266,155,111,58.27
Karma,Quinn,99,52,47,52.53
Karma,Nautilus,385,200,185,51.95
Karma,Riven,171,75,96,43.86
Karma,Shyvana,78,26,52,33.33
Karma,Velkoz,129,73,56,56.59
Karma,Mordekaiser,323,157,166,48.61
Karma,Jinx,715,359,356,50.21
Karma,Blitzcrank,265,140,125,52.83
Karma,Akali,277,158,119,57.04
Karma,Zoe,133,73,60,54.89
Karma,Thresh,624,273,351,43.75
Karma,Kayle,140,53,87,37.86
Karma,MonkeyKing,201,86,115,42.79
Karma,Vex,198,100,98,50.51
Karma,Leblanc,205,88,117,42.93
Karma,JarvanIV,233,107,126,45.92
Karma,Vladimir,195,73,122,37.44
Karma,Ziggs,128,49,79,38.28
Karma,Nami,444,174,270,39.19
Karma,Evelynn,102,56,46,54.9
Karma,Fizz,102,43,59,42.16
Karma,MissFortune,604,259,345,42.88
Karma,Galio,429,216,213,50.35
Karma,Vayne,335,134,201,40
Karma,Lulu,615,337,278,54.8
Karma,Rumble,91,46,45,50.55
Karma,Warwick,324,142,182,43.83
Karma,Ezreal,868,424,444,48.85
Karma,Qiyana,62,24,38,38.71
Karma,Kalista,69,34,35,49.28
Karma,Heimerdinger,93,54,39,58.06
Karma,Vi,336,162,174,48.21
Karma,RekSai,85,42,43,49.41
Karma,Yone,476,263,213,55.25
Karma,Malzahar,284,140,144,49.3
Karma,Ivern,91,55,36,60.44
Karma,LeeSin,628,316,312,50.32
Karma,Sylas,456,275,181,60.31
Karma,Volibear,223,134,89,60.09
Karma,Talon,130,56,74,43.08
Karma,Ornn,173,67,106,38.73
Karma,TahmKench,266,133,133,50
Karma,Leona,228,115,113,50.44
Karma,Taliyah,88,45,43,51.14
Karma,Seraphine,186,83,103,44.62
Karma,Graves,212,85,127,40.09
Karma,Sona,43,19,24,44.19
Karma,Yuumi,303,142,161,46.86
Karma,Garen,441,194,247,43.99
Karma,Zac,195,85,110,43.59
Karma,Pyke,235,127,108,54.04
Karma,Tristana,226,139,87,61.5
Karma,Gwen,130,64,66,49.23
Karma,Khazix,153,86,67,56.21
Karma,Malphite,300,141,159,47
Karma,Irelia,225,141,84,62.67
Karma,Zeri,170,89,81,52.35
Karma,Swain,252,100,152,39.68
Karma,DrMundo,116,60,56,51.72
Karma,Shen,192,100,92,52.08
Karma,Morgana,302,165,137,54.64
Karma,Ambessa,261,114,147,43.68
Karma,Varus,270,135,135,50
Karma,Jayce,192,84,108,43.75
Karma,Aatrox,323,166,157,51.39
Karma,Viktor,300,137,163,45.67
Karma,Zyra,242,104,138,42.98
Karma,FiddleSticks,123,59,64,47.97
Karma,Urgot,150,77,73,51.33
Karma,Maokai,127,54,73,42.52
Karma,Rell,202,104,98,51.49
Karma,Chogath,389,186,203,47.81
Karma,Karthus,94,43,51,45.74
Karma,Taric,58,24,34,41.38
Karma,TwistedFate,101,57,44,56.44
Karma,Sivir,215,105,110,48.84
Karma,AurelionSol,112,51,61,45.54
Karma,Poppy,220,110,110,50
Karma,Jax,271,138,133,50.92
Karma,MasterYi,269,138,131,51.3
Karma,Zed,311,145,166,46.62
Karma,Udyr,109,63,46,57.8
Karma,Aphelios,155,67,88,43.23
Karma,Xayah,170,93,77,54.71
Karma,Gragas,214,118,96,55.14
Karma,Renekton,177,100,77,56.5
Karma,Illaoi,120,58,62,48.33
Karma,Tryndamere,116,52,64,44.83
Karma,Alistar,138,67,71,48.55
Karma,Orianna,179,91,88,50.84
Karma,Smolder,182,92,90,50.55
Karma,Syndra,231,137,94,59.31
Karma,Janna,104,57,47,54.81
Karma,Cassiopeia,85,33,52,38.82
Karma,Renata,60,27,33,45
Karma,Nilah,74,26,48,35.14
Karma,Belveth,55,14,41,25.45
Karma,KogMaw,81,40,41,49.38
Karma,Rammus,87,30,57,34.48
Karma,Samira,149,74,75,49.66
Karma,Rengar,64,31,33,48.44
Karma,Naafiri,61,38,23,62.3
Karma,Zilean,102,41,61,40.2
Karma,Nunu,163,79,84,48.47
Karma,Skarner,156,77,79,49.36
Karma,Akshan,83,35,48,42.17
Karma,Kled,32,14,18,43.75
Karma,Kennen,65,36,29,55.38
Karma,Annie,105,58,47,55.24
Karma,Anivia,109,60,49,55.05
Sion,Kayn,224,112,112,50
Sion,XinZhao,146,86,60,58.9
Sion,Morgana,219,107,112,48.86
Sion,Jinx,458,223,235,48.69
Sion,Karma,172,96,76,55.81
Sion,Teemo,278,174,104,62.59
Sion,Viego,259,119,140,45.95
Sion,Anivia,75,41,34,54.67
Sion,MissFortune,397,204,193,51.39
Sion,TahmKench,164,96,68,58.54
Sion,Ekko,132,74,58,56.06
Sion,Sivir,107,63,44,58.88
Sion,Velkoz,115,59,56,51.3
Sion,Kayle,108,48,60,44.44
Sion,Yasuo,389,225,164,57.84
Sion,Jhin,376,191,185,50.8
Sion,Braum,130,72,58,55.38
Sion,Darius,342,166,176,48.54
Sion,LeeSin,361,188,173,52.08
Sion,Katarina,107,47,60,43.93
Sion,Caitlyn,538,280,258,52.04
Sion,Nami,214,121,93,56.54
Sion,Shen,174,94,80,54.02
Sion,Shaco,175,97,78,55.43
Sion,AurelionSol,104,45,59,43.27
Sion,Brand,119,55,64,46.22
Sion,Warwick,211,116,95,54.98
Sion,Ahri,268,152,116,56.72
Sion,Hwei,106,60,46,56.6
Sion,Nasus,147,56,91,38.1
Sion,Pantheon,296,159,137,53.72
Sion,Viktor,141,80,61,56.74
Sion,Ashe,389,204,185,52.44
Sion,Milio,129,65,64,50.39
Sion,Tryndamere,69,41,28,59.42
Sion,Gragas,164,92,72,56.1
Sion,Aurora,142,84,58,59.15
Sion,Vayne,288,118,170,40.97
Sion,Senna,118,63,55,53.39
Sion,Ambessa,157,98,59,62.42
Sion,Udyr,75,33,42,44
Sion,Syndra,122,67,55,54.92
Sion,Corki,128,76,52,59.38
Sion,Alistar,89,52,37,58.43
Sion,Yone,351,176,175,50.14
Sion,Vi,264,135,129,51.14
Sion,Mel,407,214,193,52.58
Sion,Garen,291,137,154,47.08
Sion,Yorick,138,78,60,56.52
Sion,Xayah,133,73,60,54.89
Sion,Rakan,111,61,50,54.95
Sion,Rammus,68,29,39,42.65
Sion,Zyra,201,117,84,58.21
Sion,Elise,175,103,72,58.86
Sion,Kaisa,287,192,95,66.9
Sion,Vex,115,65,50,56.52
Sion,Veigar,204,83,121,40.69
Sion,Smolder,164,72,92,43.9
Sion,Nautilus,294,157,137,53.4
Sion,Aatrox,181,93,88,51.38
Sion,DrMundo,86,50,36,58.14
Sion,Qiyana,49,24,25,48.98
Sion,Zeri,92,46,46,50
Sion,Gnar,98,54,44,55.1
Sion,Malzahar,243,120,123,49.38
Sion,Maokai,81,57,24,70.37
Sion,Zoe,77,45,32,58.44
Sion,Ezreal,479,254,225,53.03
Sion,Renekton,81,32,49,39.51
Sion,Galio,237,142,95,59.92
Sion,Varus,174,82,92,47.13
Sion,FiddleSticks,72,27,45,37.5
Sion,Poppy,156,77,79,49.36
Sion,Khazix,89,66,23,74.16
Sion,Lulu,282,167,115,59.22
Sion,Riven,73,30,43,41.1
Sion,Gangplank,124,56,68,45.16
Sion,Kassadin,40,23,17,57.5
Sion,Aphelios,105,47,58,44.76
Sion,Chogath,278,136,142,48.92
Sion,TwistedFate,72,47,25,65.28
Sion,Nilah,54,31,23,57.41
Sion,Thresh,430,213,217,49.53
Sion,Talon,112,55,57,49.11
Sion,Diana,260,126,134,48.46
Sion,Mordekaiser,254,103,151,40.55
Sion,Gwen,196,89,107,45.41
Sion,Lucian,157,73,84,46.5
Sion,MonkeyKing,164,84,80,51.22
Sion,Lux,461,239,222,51.84
Sion,Zac,173,82,91,47.4
Sion,Samira,155,89,66,57.42
Sion,Leona,195,89,106,45.64
Sion,Ivern,47,20,27,42.55
Sion,Sett,350,163,187,46.57
Sion,Nocturne,183,108,75,59.02
Sion,Sejuani,144,71,73,49.31
Sion,Blitzcrank,159,90,69,56.6
Sion,Graves,128,67,61,52.34
Sion,Fizz,99,64,35,64.65
Sion,Neeko,73,36,37,49.32
Sion,Yuumi,141,65,76,46.1
Sion,Amumu,239,122,117,51.05
Sion,Xerath,161,83,78,51.55
Sion,Irelia,112,50,62,44.64
Sion,Zilean,66,27,39,40.91
Sion,Jax,124,66,58,53.23
Sion,Cassiopeia,63,37,26,58.73
Sion,Urgot,96,55,41,57.29
Sion,Kled,31,11,20,35.48
Sion,Kindred,79,45,34,56.96
Sion,Lissandra,63,36,27,57.14
Sion,Akali,130,64,66,49.23
Sion,Evelynn,62,34,28,54.84
Sion,Leblanc,92,51,41,55.43
Sion,Taric,46,14,32,30.43
Sion,Ornn,98,46,52,46.94
Sion,Karthus,64,32,32,50
Sion,Volibear,213,111,102,52.11
Sion,Swain,161,82,79,50.93
Sion,Vladimir,106,46,60,43.4
Sion,Singed,64,32,32,50
Sion,Ryze,72,32,40,44.44
Sion,Trundle,130,68,62,52.31
Sion,Skarner,102,63,39,61.76
Sion,Twitch,117,58,59,49.57
Sion,Sylas,276,167,109,60.51
Sion,Taliyah,37,21,16,56.76
Sion,Rell,199,110,89,55.28
Sion,Nidalee,53,30,23,56.6
Sion,Camille,73,33,40,45.21
Sion,Orianna,90,50,40,55.56
Sion,Malphite,233,124,109,53.22
Sion,JarvanIV,142,60,82,42.25
Sion,Kennen,53,26,27,49.06
Sion,MasterYi,153,69,84,45.1
Sion,Tristana,167,83,84,49.7
Sion,RekSai,40,23,17,57.5
Sion,Quinn,66,33,33,50
Sion,Naafiri,51,30,21,58.82
Sion,Akshan,54,22,32,40.74
Sion,Illaoi,98,55,43,56.12
Sion,Draven,89,50,39,56.18
Sion,Briar,113,61,52,53.98
Sion,Sona,31,20,11,64.52
Sion,Belveth,46,27,19,58.7
Sion,Pyke,167,87,80,52.1
Sion,Zed,191,86,105,45.03
Sion,Hecarim,70,44,26,62.86
Sion,Ziggs,94,49,45,52.13
Sion,Jayce,111,60,51,54.05
Sion,Rengar,53,24,29,45.28
Sion,Shyvana,31,14,17,45.16
Sion,KogMaw,65,30,35,46.15
Sion,Nunu,128,77,51,60.16
Sion,Lillia,83,36,47,43.37
Sion,Heimerdinger,85,42,43,49.41
Sion,Fiora,65,29,36,44.62
Sion,Azir,75,38,37,50.67
Sion,Soraka,72,44,28,61.11
Sion,Janna,53,18,35,33.96
Sion,Seraphine,148,51,97,34.46
Sion,Renata,20,18,2,90
Sion,Rumble,75,51,24,68
Sion,Kalista,54,26,28,48.15
Sion,Annie,63,32,31,50.79
Sion,KSante,116,54,62,46.55
Sion,Olaf,48,17,31,35.42
Sion,Bard,54,31,23,57.41
Nocturne,Kayn,271,153,118,56.46
Nocturne,XinZhao,246,95,151,38.62
Nocturne,Morgana,290,163,127,56.21
Nocturne,Jinx,699,366,333,52.36
Nocturne,Karma,343,173,170,50.44
Nocturne,Maokai,144,65,79,45.14
Nocturne,Viego,370,201,169,54.32
Nocturne,Viktor,337,156,181,46.29
Nocturne,Smolder,198,106,92,53.54
Nocturne,Nami,351,180,171,51.28
Nocturne,Sett,329,168,161,51.06
Nocturne,Kindred,119,38,81,31.93
Nocturne,Mel,546,309,237,56.59
Nocturne,Twitch,164,74,90,45.12
Nocturne,Lulu,527,277,250,52.56
Nocturne,Aatrox,363,210,153,57.85
Nocturne,Lillia,202,101,101,50
Nocturne,Hwei,209,95,114,45.45
Nocturne,Ashe,521,274,247,52.59
Nocturne,Amumu,276,160,116,57.97
Nocturne,Ambessa,231,116,115,50.22
Nocturne,Graves,242,118,124,48.76
Nocturne,Ahri,408,188,220,46.08
Nocturne,AurelionSol,110,55,55,50
Nocturne,Rakan,158,78,80,49.37
Nocturne,Malphite,362,175,187,48.34
Nocturne,Briar,198,108,90,54.55
Nocturne,Zed,280,148,132,52.86
Nocturne,Ezreal,807,458,349,56.75
Nocturne,Seraphine,221,123,98,55.66
Nocturne,Heimerdinger,124,54,70,43.55
Nocturne,LeeSin,587,343,244,58.43
Nocturne,Leona,302,155,147,51.32
Nocturne,Chogath,325,164,161,50.46
Nocturne,Yasuo,593,321,272,54.13
Nocturne,Sivir,198,87,111,43.94
Nocturne,Brand,148,76,72,51.35
Nocturne,Nasus,170,97,73,57.06
Nocturne,MasterYi,268,119,149,44.4
Nocturne,Anivia,107,41,66,38.32
Nocturne,Vayne,338,150,188,44.38
Nocturne,Yuumi,283,136,147,48.06
Nocturne,Trundle,142,64,78,45.07
Nocturne,Khazix,101,61,40,60.4
Nocturne,Aurora,226,126,100,55.75
Nocturne,Varus,246,130,116,52.85
Nocturne,Pantheon,473,298,175,63
Nocturne,Renekton,126,77,49,61.11
Nocturne,Illaoi,116,51,65,43.97
Nocturne,Nunu,232,104,128,44.83
Nocturne,Lux,595,318,277,53.45
Nocturne,MissFortune,530,236,294,44.53
Nocturne,Rell,189,87,102,46.03
Nocturne,Sejuani,197,90,107,45.69
Nocturne,Ekko,225,123,102,54.67
Nocturne,Shaco,233,132,101,56.65
Nocturne,Kennen,100,44,56,44
Nocturne,Vladimir,171,72,99,42.11
Nocturne,Corki,162,83,79,51.23
Nocturne,Bard,103,54,49,52.43
Nocturne,Kayle,136,73,63,53.68
Nocturne,Mordekaiser,359,197,162,54.87
Nocturne,Aphelios,158,83,75,52.53
Nocturne,Gragas,216,133,83,61.57
Nocturne,Vex,167,89,78,53.29
Nocturne,Jhin,511,255,256,49.9
Nocturne,Renata,72,25,47,34.72
Nocturne,Yorick,264,141,123,53.41
Nocturne,Sylas,464,219,245,47.2
Nocturne,Samira,156,94,62,60.26
Nocturne,Karthus,86,53,33,61.63
Nocturne,Zeri,134,54,80,40.3
Nocturne,Ryze,108,61,47,56.48
Nocturne,Braum,197,105,92,53.3
Nocturne,Gwen,155,74,81,47.74
Nocturne,Hecarim,99,50,49,50.51
Nocturne,Garen,509,252,257,49.51
Nocturne,Leblanc,191,112,79,58.64
Nocturne,Darius,482,245,237,50.83
Nocturne,Gangplank,178,99,79,55.62
Nocturne,Zilean,79,46,33,58.23
Nocturne,Akali,248,126,122,50.81
Nocturne,Volibear,309,139,170,44.98
Nocturne,Lissandra,131,66,65,50.38
Nocturne,Veigar,288,142,146,49.31
Nocturne,Soraka,132,90,42,68.18
Nocturne,Warwick,402,201,201,50
Nocturne,Yone,480,234,246,48.75
Nocturne,Tristana,243,129,114,53.09
Nocturne,Zyra,176,81,95,46.02
Nocturne,Zac,208,117,91,56.25
Nocturne,Akshan,81,38,43,46.91
Nocturne,DrMundo,164,99,65,60.37
Nocturne,Senna,183,98,85,53.55
Nocturne,Shen,205,100,105,48.78
Nocturne,Annie,89,65,24,73.03
Nocturne,Poppy,201,89,112,44.28
Nocturne,Syndra,221,109,112,49.32
Nocturne,Caitlyn,681,377,304,55.36
Nocturne,Diana,422,185,237,43.84
Nocturne,Camille,100,60,40,60
Nocturne,Xayah,168,89,79,52.98
Nocturne,Blitzcrank,250,129,121,51.6
Nocturne,Taliyah,63,39,24,61.9
Nocturne,Talon,132,68,64,51.52
Nocturne,Nautilus,363,206,157,56.75
Nocturne,KSante,245,126,119,51.43
Nocturne,Evelynn,87,41,46,47.13
Nocturne,Singed,87,39,48,44.83
Nocturne,Cassiopeia,58,30,28,51.72
Nocturne,Sona,53,29,24,54.72
Nocturne,Olaf,97,48,49,49.48
Nocturne,Malzahar,310,181,129,58.39
Nocturne,Xerath,234,129,105,55.13
Nocturne,Ornn,167,76,91,45.51
Nocturne,Taric,61,27,34,44.26
Nocturne,Swain,258,129,129,50
Nocturne,Rengar,82,34,48,41.46
Nocturne,MonkeyKing,260,152,108,58.46
Nocturne,Jax,188,91,97,48.4
Nocturne,Teemo,259,162,97,62.55
Nocturne,Lucian,290,153,137,52.76
Nocturne,TahmKench,253,110,143,43.48
Nocturne,Galio,315,146,169,46.35
Nocturne,Rumble,91,47,44,51.65
Nocturne,Neeko,110,70,40,63.64
Nocturne,Sion,183,75,108,40.98
Nocturne,Orianna,170,87,83,51.18
Nocturne,Urgot,146,64,82,43.84
Nocturne,Kalista,84,44,40,52.38
Nocturne,Skarner,129,65,64,50.39
Nocturne,Irelia,181,90,91,49.72
Nocturne,Thresh,495,263,232,53.13
Nocturne,Shyvana,60,27,33,45
Nocturne,Milio,122,54,68,44.26
Nocturne,Elise,239,118,121,49.37
Nocturne,Pyke,193,89,104,46.11
Nocturne,Alistar,169,83,86,49.11
Nocturne,Fizz,97,43,54,44.33
Nocturne,Kaisa,505,249,256,49.31
Nocturne,Udyr,105,63,42,60
Nocturne,Riven,146,71,75,48.63
Nocturne,Jayce,124,65,59,52.42
Nocturne,Ivern,45,20,25,44.44
Nocturne,KogMaw,71,42,29,59.15
Nocturne,Rammus,108,55,53,50.93
Nocturne,Naafiri,69,49,20,71.01
Nocturne,Ziggs,98,21,77,21.43
Nocturne,Kassadin,53,27,26,50.94
Nocturne,Fiora,75,45,30,60
Nocturne,TwistedFate,75,46,29,61.33
Nocturne,Janna,61,36,25,59.02
Nocturne,JarvanIV,260,119,141,45.77
Nocturne,Nilah,92,42,50,45.65
Nocturne,Vi,357,186,171,52.1
Nocturne,Tryndamere,79,34,45,43.04
Nocturne,Gnar,134,73,61,54.48
Nocturne,Katarina,168,79,89,47.02
Nocturne,Velkoz,108,46,62,42.59
Nocturne,RekSai,52,27,25,51.92
Nocturne,Draven,143,79,64,55.24
Nocturne,Zoe,96,47,49,48.96
Nocturne,Quinn,106,58,48,54.72
Nocturne,Kled,34,22,12,64.71
Nocturne,FiddleSticks,125,67,58,53.6
Nocturne,Qiyana,44,16,28,36.36
Nocturne,Nidalee,78,39,39,50
Nocturne,Azir,121,68,53,56.2
Nocturne,Belveth,42,22,20,52.38
Jhin,Kayn,499,212,287,42.48
Jhin,XinZhao,289,123,166,42.56
Jhin,Morgana,429,198,231,46.15
Jhin,Jinx,1076,519,557,48.23
Jhin,Karma,526,253,273,48.1
Jhin,Chogath,535,270,265,50.47
Jhin,Lillia,265,112,153,42.26
Jhin,Tryndamere,167,77,90,46.11
Jhin,Caitlyn,1336,642,694,48.05
Jhin,Renekton,288,140,148,48.61
Jhin,Udyr,168,93,75,55.36
Jhin,Qiyana,105,72,33,68.57
Jhin,Xayah,233,81,152,34.76
Jhin,Garen,635,283,352,44.57
Jhin,Shaco,376,206,170,54.79
Jhin,Tristana,415,191,224,46.02
Jhin,Ezreal,1183,567,616,47.93
Jhin,Swain,384,156,228,40.63
Jhin,Gnar,229,139,90,60.7
Jhin,Mel,975,470,505,48.21
Jhin,Twitch,309,168,141,54.37
Jhin,Pantheon,732,381,351,52.05
Jhin,Trundle,193,100,93,51.81
Jhin,Sylas,675,321,354,47.56
Jhin,Zac,245,112,133,45.71
Jhin,MissFortune,870,414,456,47.59
Jhin,Seraphine,298,126,172,42.28
Jhin,Aatrox,434,231,203,53.23
Jhin,JarvanIV,335,156,179,46.57
Jhin,Yuumi,335,166,169,49.55
Jhin,Warwick,595,268,327,45.04
Jhin,Ahri,577,308,269,53.38
Jhin,Milio,303,116,187,38.28
Jhin,Fiora,192,101,91,52.6
Jhin,Singed,106,51,55,48.11
Jhin,Yasuo,869,452,417,52.01
Jhin,Teemo,392,181,211,46.17
Jhin,Amumu,516,255,261,49.42
Jhin,Lissandra,153,87,66,56.86
Jhin,Lucian,434,232,202,53.46
Jhin,Xerath,360,165,195,45.83
Jhin,Sion,376,185,191,49.2
Jhin,TwistedFate,156,92,64,58.97
Jhin,Lux,944,509,435,53.92
Jhin,Lulu,677,360,317,53.18
Jhin,Aphelios,266,153,113,57.52
Jhin,Karthus,113,46,67,40.71
Jhin,TahmKench,373,176,197,47.18
Jhin,Veigar,432,210,222,48.61
Jhin,Irelia,258,147,111,56.98
Jhin,Vladimir,251,115,136,45.82
Jhin,Ashe,889,451,438,50.73
Jhin,Rell,332,171,161,51.51
Jhin,Rammus,155,65,90,41.94
Jhin,Leblanc,276,121,155,43.84
Jhin,Sett,615,308,307,50.08
Jhin,Diana,602,262,340,43.52
Jhin,KogMaw,135,67,68,49.63
Jhin,Ambessa,313,117,196,37.38
Jhin,Ekko,381,173,208,45.41
Jhin,Soraka,195,98,97,50.26
Jhin,Illaoi,189,95,94,50.26
Jhin,Rakan,227,118,109,51.98
Jhin,Elise,348,165,183,47.41
Jhin,Zed,432,217,215,50.23
Jhin,Kaisa,647,294,353,45.44
Jhin,Kindred,173,91,82,52.6
Jhin,Syndra,317,150,167,47.32
Jhin,Braum,316,122,194,38.61
Jhin,Heimerdinger,188,107,81,56.91
Jhin,Nunu,242,108,134,44.63
Jhin,Alistar,195,91,104,46.67
Jhin,MasterYi,405,199,206,49.14
Jhin,Fizz,235,106,129,45.11
Jhin,Thresh,741,355,386,47.91
Jhin,Darius,746,349,397,46.78
Jhin,Vex,263,120,143,45.63
Jhin,Brand,230,124,106,53.91
Jhin,Ornn,242,113,129,46.69
Jhin,Jax,388,198,190,51.03
Jhin,Janna,136,56,80,41.18
Jhin,Evelynn,135,48,87,35.56
Jhin,LeeSin,713,383,330,53.72
Jhin,Nasus,243,95,148,39.09
Jhin,Nami,507,258,249,50.89
Jhin,Gragas,280,149,131,53.21
Jhin,Olaf,95,38,57,40
Jhin,Graves,272,121,151,44.49
Jhin,Zoe,170,106,64,62.35
Jhin,Zyra,350,189,161,54
Jhin,Vi,456,230,226,50.44
Jhin,Kennen,161,92,69,57.14
Jhin,Varus,448,228,220,50.89
Jhin,Renata,105,53,52,50.48
Jhin,Volibear,481,257,224,53.43
Jhin,Katarina,278,178,100,64.03
Jhin,Gwen,187,94,93,50.27
Jhin,Nocturne,511,256,255,50.1
Jhin,Aurora,352,196,156,55.68
Jhin,Annie,152,75,77,49.34
Jhin,Akali,408,208,200,50.98
Jhin,DrMundo,141,62,79,43.97
Jhin,Orianna,216,88,128,40.74
Jhin,Sivir,278,140,138,50.36
Jhin,Zeri,185,71,114,38.38
Jhin,Skarner,191,104,87,54.45
Jhin,Viktor,383,177,206,46.21
Jhin,AurelionSol,154,71,83,46.1
Jhin,Rumble,175,103,72,58.86
Jhin,Maokai,187,83,104,44.39
Jhin,Mordekaiser,526,263,263,50
Jhin,Yone,724,333,391,45.99
Jhin,Senna,270,138,132,51.11
Jhin,Yorick,361,192,169,53.19
Jhin,Corki,236,118,118,50
Jhin,Sona,84,33,51,39.29
Jhin,Urgot,217,90,127,41.47
Jhin,Blitzcrank,373,172,201,46.11
Jhin,Briar,243,106,137,43.62
Jhin,Rengar,127,57,70,44.88
Jhin,Gangplank,236,145,91,61.44
Jhin,Hwei,296,154,142,52.03
Jhin,Zilean,128,75,53,58.59
Jhin,Malzahar,433,220,213,50.81
Jhin,Camille,174,84,90,48.28
Jhin,Smolder,338,183,155,54.14
Jhin,Riven,156,60,96,38.46
Jhin,Malphite,463,252,211,54.43
Jhin,MonkeyKing,261,121,140,46.36
Jhin,Talon,160,100,60,62.5
Jhin,Ivern,113,57,56,50.44
Jhin,Viego,566,296,270,52.3
Jhin,Neeko,223,126,97,56.5
Jhin,Nautilus,561,272,289,48.48
Jhin,Kayle,224,123,101,54.91
Jhin,Samira,361,204,157,56.51
Jhin,FiddleSticks,195,88,107,45.13
Jhin,Taric,100,43,57,43
Jhin,Poppy,321,143,178,44.55
Jhin,Cassiopeia,115,46,69,40
Jhin,Vayne,622,307,315,49.36
Jhin,Velkoz,224,103,121,45.98
Jhin,Naafiri,92,58,34,63.04
Jhin,Kled,75,32,43,42.67
Jhin,RekSai,61,29,32,47.54
Jhin,Galio,447,188,259,42.06
Jhin,Nidalee,182,109,73,59.89
Jhin,Shen,293,150,143,51.19
Jhin,Khazix,203,98,105,48.28
Jhin,Kassadin,49,24,25,48.98
Jhin,Anivia,146,63,83,43.15
Jhin,Pyke,347,208,139,59.94
Jhin,Ryze,159,73,86,45.91
Jhin,Azir,158,92,66,58.23
Jhin,KSante,364,178,186,48.9
Jhin,Bard,129,57,72,44.19
Jhin,Quinn,122,62,60,50.82
Jhin,Taliyah,111,58,53,52.25
Jhin,Leona,389,188,201,48.33
Jhin,Ziggs,134,71,63,52.99
Jhin,Kalista,140,70,70,50
Jhin,Draven,195,108,87,55.38
Jhin,Sejuani,250,111,139,44.4
Jhin,Shyvana,77,39,38,50.65
Jhin,Belveth,75,36,39,48
Jhin,Hecarim,167,85,82,50.9
Jhin,Akshan,123,63,60,51.22
Jhin,Nilah,150,73,77,48.67
Jhin,Jayce,222,96,126,43.24
Soraka,Kayn,142,91,51,64.08
Soraka,XinZhao,86,51,35,59.3
Soraka,Morgana,110,52,58,47.27
Soraka,Jinx,283,109,174,38.52
Soraka,Karma,171,90,81,52.63
Soraka,Gnar,67,31,36,46.27
Soraka,Evelynn,32,20,12,62.5
Soraka,Malphite,143,62,81,43.36
Soraka,Lucian,76,43,33,56.58
Soraka,Mel,218,111,107,50.92
Soraka,Garen,157,70,87,44.59
Soraka,Warwick,168,82,86,48.81
Soraka,Ahri,127,73,54,57.48
Soraka,Milio,68,27,41,39.71
Soraka,Riven,63,28,35,44.44
Soraka,Karthus,35,20,15,57.14
Soraka,Nami,122,52,70,42.62
Soraka,KSante,90,56,34,62.22
Soraka,Nunu,64,33,31,51.56
Soraka,Akshan,32,18,14,56.25
Soraka,Ziggs,48,20,28,41.67
Soraka,Seraphine,94,50,44,53.19
Soraka,Gangplank,76,32,44,42.11
Soraka,Shaco,108,54,54,50
Soraka,Veigar,113,70,43,61.95
Soraka,Yuumi,114,38,76,33.33
Soraka,Katarina,60,18,42,30
Soraka,Taric,32,18,14,56.25
Soraka,Zed,120,58,62,48.33
Soraka,FiddleSticks,55,21,34,38.18
Soraka,Lillia,67,27,40,40.3
Soraka,Diana,128,55,73,42.97
Soraka,Twitch,78,37,41,47.44
Soraka,Bard,52,30,22,57.69
Soraka,Ryze,43,26,17,60.47
Soraka,Leona,110,55,55,50
Soraka,Xayah,67,30,37,44.78
Soraka,Naafiri,41,12,29,29.27
Soraka,Vayne,109,53,56,48.62
Soraka,Lux,315,161,154,51.11
Soraka,Renekton,61,36,25,59.02
Soraka,JarvanIV,96,43,53,44.79
Soraka,Jhin,195,97,98,49.74
Soraka,Janna,30,15,15,50
Soraka,Malzahar,107,56,51,52.34
Soraka,Yasuo,226,121,105,53.54
Soraka,Gragas,75,44,31,58.67
Soraka,Ezreal,231,122,109,52.81
Soraka,Lulu,260,114,146,43.85
Soraka,DrMundo,54,26,28,48.15
Soraka,MasterYi,97,47,50,48.45
Soraka,Vladimir,39,16,23,41.03
Soraka,Caitlyn,288,147,141,51.04
Soraka,Thresh,151,66,85,43.71
Soraka,Sejuani,64,32,32,50
Soraka,Akali,94,41,53,43.62
Soraka,Illaoi,39,11,28,28.21
Soraka,MissFortune,178,88,90,49.44
Soraka,Rell,61,24,37,39.34
Soraka,Qiyana,38,19,19,50
Soraka,Jax,66,25,41,37.88
Soraka,Mordekaiser,135,61,74,45.19
Soraka,Chogath,171,74,97,43.27
Soraka,Ashe,197,104,93,52.79
Soraka,Ornn,68,24,44,35.29
Soraka,Sylas,115,51,64,44.35
Soraka,Pyke,102,53,49,51.96
Soraka,Yone,195,85,110,43.59
Soraka,Draven,66,27,39,40.91
Soraka,Rammus,60,36,24,60
Soraka,Pantheon,137,83,54,60.58
Soraka,Volibear,116,60,56,51.72
Soraka,Rakan,48,13,35,27.08
Soraka,Orianna,51,31,20,60.78
Soraka,Swain,96,51,45,53.13
Soraka,Viego,155,54,101,34.84
Soraka,Sett,163,89,74,54.6
Soraka,Velkoz,52,24,28,46.15
Soraka,Irelia,64,38,26,59.38
Soraka,Nocturne,132,42,90,31.82
Soraka,Galio,99,52,47,52.53
Soraka,Camille,54,36,18,66.67
Soraka,Darius,153,78,75,50.98
Soraka,Varus,98,36,62,36.73
Soraka,Zac,71,42,29,59.15
Soraka,Xerath,117,61,56,52.14
Soraka,Brand,56,36,20,64.29
Soraka,Viktor,115,55,60,47.83
Soraka,Khazix,42,29,13,69.05
Soraka,Aurora,91,44,47,48.35
Soraka,Kindred,38,20,18,52.63
Soraka,Graves,80,50,30,62.5
Soraka,Trundle,61,37,24,60.66
Soraka,AurelionSol,47,25,22,53.19
Soraka,Tristana,96,47,49,48.96
Soraka,LeeSin,121,59,62,48.76
Soraka,Nautilus,125,47,78,37.6
Soraka,Sona,16,12,4,75
Soraka,MonkeyKing,71,39,32,54.93
Soraka,Azir,40,9,31,22.5
Soraka,Jayce,75,34,41,45.33
Soraka,Vex,34,12,22,35.29
Soraka,Heimerdinger,40,17,23,42.5
Soraka,Amumu,104,38,66,36.54
Soraka,Lissandra,42,27,15,64.29
Soraka,Sivir,50,28,22,56
Soraka,Corki,50,20,30,40
Soraka,Vi,124,64,60,51.61
Soraka,Fizz,42,21,21,50
Soraka,Zilean,22,12,10,54.55
Soraka,Olaf,36,14,22,38.89
Soraka,Yorick,70,40,30,57.14
Soraka,Elise,114,57,57,50
Soraka,Rengar,23,9,14,39.13
Soraka,Nidalee,56,25,31,44.64
Soraka,Alistar,27,19,8,70.37
Soraka,TahmKench,107,47,60,43.93
Soraka,Teemo,132,73,59,55.3
Soraka,Neeko,54,32,22,59.26
Soraka,Skarner,43,26,17,60.47
Soraka,Gwen,40,27,13,67.5
Soraka,Kled,20,9,11,45
Soraka,Briar,68,37,31,54.41
Soraka,Talon,38,25,13,65.79
Soraka,Zyra,79,52,27,65.82
Soraka,Ambessa,54,28,26,51.85
Soraka,Nasus,88,37,51,42.05
Soraka,Kaisa,179,90,89,50.28
Soraka,Udyr,31,16,15,51.61
Soraka,Samira,77,30,47,38.96
Soraka,Nilah,30,11,19,36.67
Soraka,Aatrox,120,71,49,59.17
Soraka,Zoe,13,5,8,38.46
Soraka,Braum,89,52,37,58.43
Soraka,Kassadin,29,5,24,17.24
Soraka,Kayle,52,25,27,48.08
Soraka,Hwei,44,14,30,31.82
Soraka,Poppy,63,23,40,36.51
Soraka,Hecarim,43,9,34,20.93
Soraka,Rumble,25,14,11,56
Soraka,Urgot,59,31,28,52.54
Soraka,Leblanc,86,40,46,46.51
Soraka,Singed,33,20,13,60.61
Soraka,Quinn,30,19,11,63.33
Soraka,Ekko,100,56,44,56
Soraka,Shen,75,32,43,42.67
Soraka,Tryndamere,40,14,26,35
Soraka,Senna,74,40,34,54.05
Soraka,Shyvana,19,3,16,15.79
Soraka,KogMaw,45,26,19,57.78
Soraka,Aphelios,72,48,24,66.67
Soraka,TwistedFate,44,28,16,63.64
Soraka,Fiora,37,19,18,51.35
Soraka,Cassiopeia,38,16,22,42.11
Soraka,Anivia,34,22,12,64.71
Soraka,Kalista,39,16,23,41.03
Soraka,Maokai,52,29,23,55.77
Soraka,Smolder,59,18,41,30.51
Soraka,Belveth,14,11,3,78.57
Soraka,Sion,72,28,44,38.89
Soraka,Kennen,14,8,6,57.14
Soraka,Blitzcrank,69,42,27,60.87
Soraka,Syndra,74,37,37,50
Soraka,Zeri,59,18,41,30.51
Soraka,Renata,21,15,6,71.43
Soraka,Taliyah,14,2,12,14.29
Soraka,RekSai,20,10,10,50
Soraka,Annie,19,5,14,26.32
Soraka,Ivern,23,9,14,39.13
Pantheon,Ashe,673,311,362,46.21
Pantheon,Twitch,236,144,92,61.02
Pantheon,Viktor,347,165,182,47.55
Pantheon,Xayah,207,115,92,55.56
Pantheon,Xerath,258,127,131,49.22
Pantheon,Galio,361,172,189,47.65
Pantheon,Hecarim,129,58,71,44.96
Pantheon,Shen,263,146,117,55.51
Pantheon,Kaisa,613,310,303,50.57
Pantheon,Nami,379,184,195,48.55
Pantheon,Jhin,732,351,381,47.95
Pantheon,Ekko,322,150,172,46.58
Pantheon,Akali,346,176,170,50.87
Pantheon,Ambessa,303,163,140,53.8
Pantheon,Karma,488,264,224,54.1
Pantheon,Gnar,205,86,119,41.95
Pantheon,Evelynn,112,62,50,55.36
Pantheon,Malphite,446,209,237,46.86
Pantheon,Lucian,381,182,199,47.77
Pantheon,Mel,832,432,400,51.92
Pantheon,Darius,648,297,351,45.83
Pantheon,Graves,213,110,103,51.64
Pantheon,Neeko,177,98,79,55.37
Pantheon,Draven,200,91,109,45.5
Pantheon,Alistar,218,112,106,51.38
Pantheon,Chogath,432,194,238,44.91
Pantheon,MonkeyKing,277,128,149,46.21
Pantheon,Veigar,343,172,171,50.15
Pantheon,Caitlyn,903,457,446,50.61
Pantheon,Kayn,424,227,197,53.54
Pantheon,Teemo,344,166,178,48.26
Pantheon,Sivir,246,125,121,50.81
Pantheon,Velkoz,185,97,88,52.43
Pantheon,Camille,128,64,64,50
Pantheon,Diana,601,291,310,48.42
Pantheon,Malzahar,377,174,203,46.15
Pantheon,Zyra,269,128,141,47.58
Pantheon,Kayle,198,117,81,59.09
Pantheon,Irelia,344,157,187,45.64
Pantheon,Corki,152,69,83,45.39
Pantheon,Syndra,242,117,125,48.35
Pantheon,Swain,386,146,240,37.82
Pantheon,Volibear,391,168,223,42.97
Pantheon,Lissandra,133,63,70,47.37
Pantheon,Kalista,141,85,56,60.28
Pantheon,Rell,272,152,120,55.88
Pantheon,Nocturne,473,175,298,37
Pantheon,MissFortune,689,338,351,49.06
Pantheon,Rakan,235,114,121,48.51
Pantheon,TahmKench,354,185,169,52.26
Pantheon,Viego,492,269,223,54.67
Pantheon,Zed,470,264,206,56.17
Pantheon,Ziggs,138,64,74,46.38
Pantheon,Heimerdinger,162,74,88,45.68
Pantheon,Nunu,294,148,146,50.34
Pantheon,Yasuo,761,391,370,51.38
Pantheon,Gangplank,194,115,79,59.28
Pantheon,Elise,321,150,171,46.73
Pantheon,Yone,705,373,332,52.91
Pantheon,Warwick,465,221,244,47.53
Pantheon,Nautilus,522,251,271,48.08
Pantheon,Sion,296,137,159,46.28
Pantheon,Samira,279,161,118,57.71
Pantheon,Vayne,524,250,274,47.71
Pantheon,Orianna,246,114,132,46.34
Pantheon,Jinx,958,407,551,42.48
Pantheon,Briar,219,102,117,46.58
Pantheon,Khazix,204,94,110,46.08
Pantheon,Vex,206,88,118,42.72
Pantheon,Aphelios,205,115,90,56.1
Pantheon,Lulu,648,269,379,41.51
Pantheon,Vi,422,211,211,50
Pantheon,Pyke,354,205,149,57.91
Pantheon,Lux,865,478,387,55.26
Pantheon,Mordekaiser,460,210,250,45.65
Pantheon,Gragas,302,149,153,49.34
Pantheon,Kled,73,47,26,64.38
Pantheon,Qiyana,73,32,41,43.84
Pantheon,Maokai,168,86,82,51.19
Pantheon,MasterYi,391,181,210,46.29
Pantheon,Lillia,185,97,88,52.43
Pantheon,Katarina,227,107,120,47.14
Pantheon,Varus,352,200,152,56.82
Pantheon,Sett,567,286,281,50.44
Pantheon,Ahri,523,266,257,50.86
Pantheon,Yuumi,374,190,184,50.8
Pantheon,Olaf,85,47,38,55.29
Pantheon,Morgana,317,167,150,52.68
Pantheon,Illaoi,202,105,97,51.98
Pantheon,Singed,90,50,40,55.56
Pantheon,Fizz,146,77,69,52.74
Pantheon,Soraka,137,54,83,39.42
Pantheon,DrMundo,182,90,92,49.45
Pantheon,Aurora,281,152,129,54.09
Pantheon,KogMaw,109,58,51,53.21
Pantheon,Leona,325,158,167,48.62
Pantheon,Aatrox,357,166,191,46.5
Pantheon,Nasus,239,120,119,50.21
Pantheon,Belveth,63,25,38,39.68
Pantheon,Blitzcrank,296,146,150,49.32
Pantheon,LeeSin,722,380,342,52.63
Pantheon,Sylas,585,329,256,56.24
Pantheon,Riven,136,58,78,42.65
Pantheon,Poppy,308,137,171,44.48
Pantheon,Taliyah,108,44,64,40.74
Pantheon,Seraphine,290,154,136,53.1
Pantheon,Quinn,138,83,55,60.14
Pantheon,Senna,219,102,117,46.58
Pantheon,JarvanIV,284,146,138,51.41
Pantheon,Ezreal,968,492,476,50.83
Pantheon,Taric,120,55,65,45.83
Pantheon,Zac,237,112,125,47.26
Pantheon,Hwei,243,101,142,41.56
Pantheon,Yorick,310,163,147,52.58
Pantheon,Thresh,762,366,396,48.03
Pantheon,Skarner,176,65,111,36.93
Pantheon,Vladimir,215,111,104,51.63
Pantheon,Brand,192,84,108,43.75
Pantheon,TwistedFate,141,73,68,51.77
Pantheon,Milio,253,126,127,49.8
Pantheon,Renekton,193,90,103,46.63
Pantheon,XinZhao,260,129,131,49.62
Pantheon,Rumble,123,64,59,52.03
Pantheon,AurelionSol,157,55,102,35.03
Pantheon,Amumu,441,183,258,41.5
Pantheon,Urgot,181,96,85,53.04
Pantheon,Kindred,186,96,90,51.61
Pantheon,Cassiopeia,91,39,52,42.86
Pantheon,Talon,157,95,62,60.51
Pantheon,Fiora,131,72,59,54.96
Pantheon,Shaco,272,133,139,48.9
Pantheon,Jayce,205,98,107,47.8
Pantheon,Zoe,173,97,76,56.07
Pantheon,Azir,180,109,71,60.56
Pantheon,Jax,351,190,161,54.13
Pantheon,RekSai,84,46,38,54.76
Pantheon,Garen,533,257,276,48.22
Pantheon,Nilah,120,57,63,47.5
Pantheon,Nidalee,158,90,68,56.96
Pantheon,Braum,288,125,163,43.4
Pantheon,Gwen,225,114,111,50.67
Pantheon,Tryndamere,95,55,40,57.89
Pantheon,Rengar,104,65,39,62.5
Pantheon,Janna,88,31,57,35.23
Pantheon,Udyr,132,73,59,55.3
Pantheon,Shyvana,91,33,58,36.26
Pantheon,Renata,100,48,52,48
Pantheon,Ryze,135,53,82,39.26
Pantheon,Tristana,300,127,173,42.33
Pantheon,Sona,58,35,23,60.34
Pantheon,Naafiri,92,40,52,43.48
Pantheon,FiddleSticks,166,93,73,56.02
Pantheon,Karthus,85,41,44,48.24
Pantheon,Bard,101,41,60,40.59
Pantheon,Zeri,181,87,94,48.07
Pantheon,KSante,223,115,108,51.57
Pantheon,Smolder,248,117,131,47.18
Pantheon,Annie,122,61,61,50
Pantheon,Ornn,254,122,132,48.03
Pantheon,Trundle,206,85,121,41.26
Pantheon,Leblanc,190,89,101,46.84
Pantheon,Akshan,109,54,55,49.54
Pantheon,Rammus,128,73,55,57.03
Pantheon,Zilean,145,77,68,53.1
Pantheon,Kennen,98,42,56,42.86
Pantheon,Anivia,132,57,75,43.18
Pantheon,Sejuani,239,97,142,40.59
Pantheon,Ivern,72,26,46,36.11
Pantheon,Kassadin,63,36,27,57.14
Neeko,Ashe,215,108,107,50.23
Neeko,Twitch,72,41,31,56.94
Neeko,Viktor,100,52,48,52
Neeko,Xayah,65,28,37,43.08
Neeko,Xerath,99,40,59,40.4
Neeko,Sett,174,93,81,53.45
Neeko,Kindred,41,20,21,48.78
Neeko,Mel,220,115,105,52.27
Neeko,Lulu,134,61,73,45.52
Neeko,Jax,83,31,52,37.35
Neeko,Pantheon,177,79,98,44.63
Neeko,TwistedFate,43,26,17,60.47
Neeko,Sivir,63,23,40,36.51
Neeko,Milio,50,29,21,58
Neeko,Garen,155,55,100,35.48
Neeko,Kayn,107,54,53,50.47
Neeko,MissFortune,238,117,121,49.16
Neeko,Velkoz,56,16,40,28.57
Neeko,Volibear,96,46,50,47.92
Neeko,Hwei,80,43,37,53.75
Neeko,Vi,119,63,56,52.94
Neeko,Braum,93,40,53,43.01
Neeko,Yorick,87,49,38,56.32
Neeko,Sejuani,55,19,36,34.55
Neeko,Leblanc,78,35,43,44.87
Neeko,Nilah,46,15,31,32.61
Neeko,Karma,130,68,62,52.31
Neeko,JarvanIV,76,32,44,42.11
Neeko,Veigar,96,47,49,48.96
Neeko,Lux,208,108,100,51.92
Neeko,Thresh,201,123,78,61.19
Neeko,Illaoi,47,16,31,34.04
Neeko,Warwick,166,87,79,52.41
Neeko,Ekko,71,28,43,39.44
Neeko,Rakan,69,23,46,33.33
Neeko,Rumble,34,15,19,44.12
Neeko,Yasuo,235,125,110,53.19
Neeko,Ezreal,279,141,138,50.54
Neeko,Draven,62,37,25,59.68
Neeko,Taric,23,8,15,34.78
Neeko,Trundle,53,32,21,60.38
Neeko,Syndra,67,33,34,49.25
Neeko,Caitlyn,262,127,135,48.47
Neeko,Morgana,104,47,57,45.19
Neeko,Nasus,48,24,24,50
Neeko,Jinx,215,119,96,55.35
Neeko,Heimerdinger,42,21,21,50
Neeko,Urgot,46,25,21,54.35
Neeko,Udyr,29,14,15,48.28
Neeko,Azir,60,31,29,51.67
Neeko,Gnar,71,36,35,50.7
Neeko,Shaco,100,62,38,62
Neeko,Malzahar,98,41,57,41.84
Neeko,Maokai,41,29,12,70.73
Neeko,Riven,40,22,18,55
Neeko,Galio,119,56,63,47.06
Neeko,Zyra,139,48,91,34.53
Neeko,Aatrox,129,66,63,51.16
Neeko,Jhin,223,97,126,43.5
Neeko,Shen,71,32,39,45.07
Neeko,Diana,144,75,69,52.08
Neeko,Zed,130,67,63,51.54
Neeko,Nami,104,48,56,46.15
Neeko,Sylas,204,113,91,55.39
Neeko,Irelia,79,37,42,46.84
Neeko,Blitzcrank,113,46,67,40.71
Neeko,Gragas,58,23,35,39.66
Neeko,Kalista,26,9,17,34.62
Neeko,Rell,54,31,23,57.41
Neeko,Teemo,118,68,50,57.63
Neeko,LeeSin,212,104,108,49.06
Neeko,Zeri,61,24,37,39.34
Neeko,Yuumi,78,35,43,44.87
Neeko,Gangplank,75,46,29,61.33
Neeko,Evelynn,33,14,19,42.42
Neeko,Ahri,148,69,79,46.62
Neeko,Seraphine,67,22,45,32.84
Neeko,Darius,235,103,132,43.83
Neeko,Nocturne,110,40,70,36.36
Neeko,Kaisa,142,86,56,60.56
Neeko,TahmKench,122,74,48,60.66
Neeko,Leona,115,61,54,53.04
Neeko,Briar,48,13,35,27.08
Neeko,Yone,181,90,91,49.72
Neeko,Fiora,42,19,23,45.24
Neeko,Sion,73,37,36,50.68
Neeko,Elise,103,54,49,52.43
Neeko,Amumu,160,57,103,35.63
Neeko,Senna,51,18,33,35.29
Neeko,Ornn,65,31,34,47.69
Neeko,Soraka,54,22,32,40.74
Neeko,Mordekaiser,146,83,63,56.85
Neeko,Vayne,140,44,96,31.43
Neeko,Zac,48,22,26,45.83
Neeko,Lissandra,40,17,23,42.5
Neeko,Ivern,34,17,17,50
Neeko,Vladimir,41,17,24,41.46
Neeko,Aphelios,56,26,30,46.43
Neeko,Corki,59,33,26,55.93
Neeko,Brand,55,25,30,45.45
Neeko,Pyke,115,67,48,58.26
Neeko,Gwen,67,33,34,49.25
Neeko,Samira,84,41,43,48.81
Neeko,Akali,110,69,41,62.73
Neeko,Viego,117,61,56,52.14
Neeko,Swain,105,49,56,46.67
Neeko,Vex,55,19,36,34.55
Neeko,Nautilus,132,64,68,48.48
Neeko,Malphite,111,56,55,50.45
Neeko,MasterYi,140,62,78,44.29
Neeko,Kassadin,19,10,9,52.63
Neeko,Olaf,37,12,25,32.43
Neeko,Ambessa,74,46,28,62.16
Neeko,Taliyah,21,4,17,19.05
Neeko,Tristana,92,51,41,55.43
Neeko,Zilean,40,12,28,30
Neeko,Fizz,45,26,19,57.78
Neeko,Skarner,43,17,26,39.53
Neeko,Lucian,110,60,50,54.55
Neeko,XinZhao,83,37,46,44.58
Neeko,Aurora,111,47,64,42.34
Neeko,Cassiopeia,51,17,34,33.33
Neeko,Khazix,39,24,15,61.54
Neeko,Katarina,59,39,20,66.1
Neeko,Kayle,57,31,26,54.39
Neeko,Shyvana,26,17,9,65.38
Neeko,Lillia,42,28,14,66.67
Neeko,Rengar,35,25,10,71.43
Neeko,Akshan,22,8,14,36.36
Neeko,AurelionSol,28,18,10,64.29
Neeko,Smolder,76,43,33,56.58
Neeko,RekSai,15,8,7,53.33
Neeko,Singed,27,8,19,29.63
Neeko,Karthus,14,3,11,21.43
Neeko,Camille,27,9,18,33.33
Neeko,Nunu,48,25,23,52.08
Neeko,Varus,87,42,45,48.28
Neeko,Janna,27,14,13,51.85
Neeko,Quinn,40,14,26,35
Neeko,Tryndamere,29,18,11,62.07
Neeko,Anivia,42,22,20,52.38
Neeko,DrMundo,31,15,16,48.39
Neeko,Kled,15,6,9,40
Neeko,Orianna,49,17,32,34.69
Neeko,Kennen,37,19,18,51.35
Neeko,Poppy,79,42,37,53.16
Neeko,Naafiri,40,25,15,62.5
Neeko,Chogath,109,40,69,36.7
Neeko,FiddleSticks,32,17,15,53.13
Neeko,Sona,8,4,4,50
Neeko,Belveth,7,4,3,57.14
Neeko,Renekton,60,25,35,41.67
Neeko,Hecarim,37,18,19,48.65
Neeko,Talon,76,50,26,65.79
Neeko,KSante,72,40,32,55.56
Neeko,Renata,35,22,13,62.86
Neeko,Ziggs,35,17,18,48.57
Neeko,Annie,23,8,15,34.78
Neeko,Jayce,41,28,13,68.29
Neeko,KogMaw,15,8,7,53.33
Neeko,Rammus,24,11,13,45.83
Neeko,MonkeyKing,52,30,22,57.69
Neeko,Zoe,60,26,34,43.33
Neeko,Graves,76,43,33,56.58
Neeko,Ryze,50,21,29,42
Neeko,Bard,21,12,9,57.14
Neeko,Qiyana,26,11,15,42.31
Neeko,Nidalee,38,29,9,76.32
Neeko,Alistar,51,13,38,25.49
Varus,Ashe,532,284,248,53.38
Varus,Twitch,171,78,93,45.61
Varus,Viktor,203,105,98,51.72
Varus,Xayah,123,59,64,47.97
Varus,Xerath,248,104,144,41.94
Varus,Shen,139,54,85,38.85
Varus,Vi,253,118,135,46.64
Varus,Swain,190,80,110,42.11
Varus,Nilah,87,48,39,55.17
Varus,Nami,246,103,143,41.87
Varus,Jayce,126,60,66,47.62
Varus,Hecarim,76,41,35,53.95
Varus,Milio,111,51,60,45.95
Varus,Caitlyn,601,289,312,48.09
Varus,Zoe,92,43,49,46.74
Varus,Volibear,196,94,102,47.96
Varus,Gragas,172,89,83,51.74
Varus,Lux,447,175,272,39.15
Varus,Trundle,86,42,44,48.84
Varus,Sylas,380,193,187,50.79
Varus,Zac,135,44,91,32.59
Varus,MissFortune,430,220,210,51.16
Varus,Seraphine,165,81,84,49.09
Varus,Chogath,268,132,136,49.25
Varus,MonkeyKing,170,66,104,38.82
Varus,Veigar,210,124,86,59.05
Varus,Mel,449,212,237,47.22
Varus,KSante,163,75,88,46.01
Varus,Viego,261,118,143,45.21
Varus,Kassadin,62,26,36,41.94
Varus,Nasus,103,50,53,48.54
Varus,Bard,100,54,46,54
Varus,Diana,288,130,158,45.14
Varus,Braum,192,107,85,55.73
Varus,Skarner,112,62,50,55.36
Varus,Katarina,113,68,45,60.18
Varus,Blitzcrank,198,98,100,49.49
Varus,Lulu,364,184,180,50.55
Varus,Jax,177,92,85,51.98
Varus,Yasuo,451,197,254,43.68
Varus,Teemo,227,120,107,52.86
Varus,Lillia,97,38,59,39.18
Varus,Camille,67,31,36,46.27
Varus,Draven,141,84,57,59.57
Varus,Senna,134,50,84,37.31
Varus,Graves,193,88,105,45.6
Varus,Nocturne,246,116,130,47.15
Varus,Lissandra,78,37,41,47.44
Varus,Rakan,103,37,66,35.92
Varus,DrMundo,81,47,34,58.02
Varus,MasterYi,226,117,109,51.77
Varus,Vladimir,145,71,74,48.97
Varus,Thresh,439,225,214,51.25
Varus,Heimerdinger,93,42,51,45.16
Varus,Nunu,159,97,62,61.01
Varus,Alistar,129,62,67,48.06
Varus,Elise,193,91,102,47.15
Varus,Leona,233,115,118,49.36
Varus,Yorick,157,75,82,47.77
Varus,Briar,136,52,84,38.24
Varus,Ziggs,103,40,63,38.83
Varus,Yone,380,209,171,55
Varus,Pantheon,352,152,200,43.18
Varus,Ambessa,182,70,112,38.46
Varus,Hwei,179,95,84,53.07
Varus,Quinn,64,26,38,40.63
Varus,Nidalee,70,31,39,44.29
Varus,Aphelios,124,48,76,38.71
Varus,Malphite,257,126,131,49.03
Varus,Kindred,88,53,35,60.23
Varus,Akshan,54,26,28,48.15
Varus,TahmKench,192,68,124,35.42
Varus,Kled,44,25,19,56.82
Varus,Jhin,448,220,228,49.11
Varus,Pyke,224,112,112,50
Varus,Aurora,128,67,61,52.34
Varus,Mordekaiser,303,145,158,47.85
Varus,Shaco,123,60,63,48.78
Varus,Leblanc,145,78,67,53.79
Varus,Amumu,225,84,141,37.33
Varus,AurelionSol,96,46,50,47.92
Varus,LeeSin,445,216,229,48.54
Varus,Ezreal,586,284,302,48.46
Varus,Irelia,182,102,80,56.04
Varus,JarvanIV,198,91,107,45.96
Varus,Taliyah,76,42,34,55.26
Varus,Sivir,161,74,87,45.96
Varus,Zed,202,92,110,45.54
Varus,Samira,153,86,67,56.21
Varus,Morgana,164,64,100,39.02
Varus,Naafiri,61,24,37,39.34
Varus,Akali,219,107,112,48.86
Varus,Poppy,186,93,93,50
Varus,Lucian,203,88,115,43.35
Varus,Urgot,112,56,56,50
Varus,Udyr,78,47,31,60.26
Varus,Azir,66,37,29,56.06
Varus,Jinx,625,288,337,46.08
Varus,Garen,321,147,174,45.79
Varus,Ahri,315,137,178,43.49
Varus,Smolder,172,93,79,54.07
Varus,Soraka,98,62,36,63.27
Varus,Janna,65,23,42,35.38
Varus,Ornn,166,83,83,50
Varus,Tristana,186,98,88,52.69
Varus,Gwen,93,42,51,45.16
Varus,Khazix,132,65,67,49.24
Varus,Darius,394,193,201,48.98
Varus,Qiyana,42,19,23,45.24
Varus,Sion,174,92,82,52.87
Varus,XinZhao,221,104,117,47.06
Varus,Annie,78,35,43,44.87
Varus,Riven,102,59,43,57.84
Varus,Kayn,263,136,127,51.71
Varus,Syndra,160,82,78,51.25
Varus,Karma,270,135,135,50
Varus,Malzahar,213,77,136,36.15
Varus,Belveth,49,28,21,57.14
Varus,Kaisa,374,208,166,55.61
Varus,Velkoz,102,51,51,50
Varus,Shyvana,62,36,26,58.06
Varus,Anivia,75,37,38,49.33
Varus,Singed,35,13,22,37.14
Varus,Ekko,165,77,88,46.67
Varus,Vex,135,64,71,47.41
Varus,Nautilus,320,173,147,54.06
Varus,Sejuani,157,41,116,26.11
Varus,Maokai,119,41,78,34.45
Varus,Yuumi,197,85,112,43.15
Varus,Olaf,89,26,63,29.21
Varus,Zyra,188,112,76,59.57
Varus,FiddleSticks,110,53,57,48.18
Varus,Kalista,51,29,22,56.86
Varus,Sett,327,154,173,47.09
Varus,Illaoi,111,59,52,53.15
Varus,Rumble,89,42,47,47.19
Varus,Orianna,138,69,69,50
Varus,Ryze,93,43,50,46.24
Varus,Rengar,37,11,26,29.73
Varus,Vayne,263,114,149,43.35
Varus,Talon,148,76,72,51.35
Varus,Sona,34,19,15,55.88
Varus,Gnar,91,49,42,53.85
Varus,Tryndamere,57,38,19,66.67
Varus,TwistedFate,71,37,34,52.11
Varus,Rell,171,84,87,49.12
Varus,Brand,88,43,45,48.86
Varus,Ivern,43,28,15,65.12
Varus,KogMaw,83,43,40,51.81
Varus,Fizz,102,45,57,44.12
Varus,Aatrox,241,123,118,51.04
Varus,Gangplank,152,70,82,46.05
Varus,Warwick,228,101,127,44.3
Varus,Evelynn,89,53,36,59.55
Varus,Zilean,52,28,24,53.85
Varus,Corki,100,39,61,39
Varus,Zeri,97,47,50,48.45
Varus,Kayle,135,59,76,43.7
Varus,Cassiopeia,48,21,27,43.75
Varus,Karthus,52,17,35,32.69
Varus,Taric,53,28,25,52.83
Varus,Fiora,71,32,39,45.07
Varus,Galio,258,132,126,51.16
Varus,Renekton,121,60,61,49.59
Varus,Rammus,79,40,39,50.63
Varus,Neeko,87,45,42,51.72
Varus,Kennen,74,27,47,36.49
Varus,Renata,45,24,21,53.33
Varus,RekSai,24,17,7,70.83
Twitch,Sejuani,125,68,57,54.4
Twitch,Pantheon,236,92,144,38.98
Twitch,Neeko,72,31,41,43.06
Twitch,Varus,171,93,78,54.39
Twitch,Pyke,67,32,35,47.76
Twitch,Corki,67,42,25,62.69
Twitch,Ekko,139,70,69,50.36
Twitch,Leblanc,111,46,65,41.44
Twitch,Caitlyn,377,174,203,46.15
Twitch,Mel,376,205,171,54.52
Twitch,Garen,250,119,131,47.6
Twitch,MonkeyKing,124,56,68,45.16
Twitch,Lux,366,186,180,50.82
Twitch,Nilah,46,25,21,54.35
Twitch,Lulu,262,109,153,41.6
Twitch,Teemo,194,80,114,41.24
Twitch,Warwick,225,119,106,52.89
Twitch,Nunu,125,55,70,44
Twitch,Lucian,132,62,70,46.97
Twitch,Leona,148,60,88,40.54
Twitch,Jhin,309,141,168,45.63
Twitch,Akali,116,51,65,43.97
Twitch,Ambessa,108,55,53,50.93
Twitch,Karma,213,105,108,49.3
Twitch,Kayn,194,115,79,59.28
Twitch,Shaco,124,66,58,53.23
Twitch,Zoe,47,15,32,31.91
Twitch,KogMaw,70,32,38,45.71
Twitch,TwistedFate,77,42,35,54.55
Twitch,Chogath,199,100,99,50.25
Twitch,Nocturne,164,90,74,54.88
Twitch,Orianna,77,39,38,50.65
Twitch,Tryndamere,61,33,28,54.1
Twitch,Morgana,111,54,57,48.65
Twitch,Cassiopeia,60,18,42,30
Twitch,Kaisa,267,107,160,40.07
Twitch,Volibear,157,80,77,50.96
Twitch,Jayce,58,35,23,60.34
Twitch,Elise,122,49,73,40.16
Twitch,Yorick,160,93,67,58.13
Twitch,Zilean,46,22,24,47.83
Twitch,Sett,214,98,116,45.79
Twitch,Viktor,150,91,59,60.67
Twitch,Jinx,485,244,241,50.31
Twitch,Jax,108,57,51,52.78
Twitch,RekSai,39,28,11,71.79
Twitch,Xayah,89,58,31,65.17
Twitch,Rakan,113,66,47,58.41
Twitch,Darius,303,135,168,44.55
Twitch,Veigar,165,80,85,48.48
Twitch,Aurora,94,52,42,55.32
Twitch,Briar,112,43,69,38.39
Twitch,Vayne,231,113,118,48.92
Twitch,Fiora,60,29,31,48.33
Twitch,Soraka,78,41,37,52.56
Twitch,Azir,62,40,22,64.52
Twitch,Ornn,107,56,51,52.34
Twitch,Katarina,100,58,42,58
Twitch,Tristana,165,64,101,38.79
Twitch,Gwen,93,52,41,55.91
Twitch,MasterYi,144,70,74,48.61
Twitch,Akshan,55,25,30,45.45
Twitch,Zeri,81,35,46,43.21
Twitch,Yone,188,79,109,42.02
Twitch,Gnar,96,55,41,57.29
Twitch,Kalista,41,17,24,41.46
Twitch,Nautilus,250,136,114,54.4
Twitch,Zed,141,76,65,53.9
Twitch,Thresh,256,123,133,48.05
Twitch,Camille,61,19,42,31.15
Twitch,Lillia,106,61,45,57.55
Twitch,Diana,263,116,147,44.11
Twitch,TahmKench,142,72,70,50.7
Twitch,Udyr,58,38,20,65.52
Twitch,Aatrox,126,53,73,42.06
Twitch,MissFortune,293,139,154,47.44
Twitch,Malphite,213,97,116,45.54
Twitch,Nidalee,38,19,19,50
Twitch,Irelia,108,64,44,59.26
Twitch,Sylas,204,110,94,53.92
Twitch,JarvanIV,121,45,76,37.19
Twitch,Yasuo,294,142,152,48.3
Twitch,Bard,68,25,43,36.76
Twitch,Ahri,186,81,105,43.55
Twitch,Aphelios,107,60,47,56.07
Twitch,Renata,44,28,16,63.64
Twitch,Sona,49,27,22,55.1
Twitch,Zac,88,43,45,48.86
Twitch,Hwei,111,56,55,50.45
Twitch,Shen,128,49,79,38.28
Twitch,Draven,68,28,40,41.18
Twitch,Renekton,103,49,54,47.57
Twitch,Ryze,55,33,22,60
Twitch,AurelionSol,67,19,48,28.36
Twitch,Vladimir,96,49,47,51.04
Twitch,Nasus,86,37,49,43.02
Twitch,Vi,186,86,100,46.24
Twitch,Rammus,67,42,25,62.69
Twitch,Zyra,103,61,42,59.22
Twitch,Senna,110,57,53,51.82
Twitch,Ezreal,347,160,187,46.11
Twitch,Xerath,147,82,65,55.78
Twitch,Qiyana,43,31,12,72.09
Twitch,Brand,101,59,42,58.42
Twitch,Taliyah,47,19,28,40.43
Twitch,DrMundo,78,47,31,60.26
Twitch,Heimerdinger,90,43,47,47.78
Twitch,Ashe,323,151,172,46.75
Twitch,XinZhao,110,47,63,42.73
Twitch,Milio,124,49,75,39.52
Twitch,Singed,55,11,44,20
Twitch,Swain,126,61,65,48.41
Twitch,Nami,161,83,78,51.55
Twitch,Illaoi,72,39,33,54.17
Twitch,Belveth,48,21,27,43.75
Twitch,Yuumi,107,43,64,40.19
Twitch,Trundle,86,47,39,54.65
Twitch,Shyvana,63,24,39,38.1
Twitch,Braum,123,39,84,31.71
Twitch,Mordekaiser,160,76,84,47.5
Twitch,Malzahar,180,85,95,47.22
Twitch,Quinn,58,21,37,36.21
Twitch,Blitzcrank,134,64,70,47.76
Twitch,LeeSin,220,104,116,47.27
Twitch,Syndra,137,59,78,43.07
Twitch,Naafiri,65,29,36,44.62
Twitch,Viego,186,108,78,58.06
Twitch,Smolder,145,58,87,40
Twitch,Sion,117,59,58,50.43
Twitch,Galio,163,89,74,54.6
Twitch,Khazix,81,36,45,44.44
Twitch,Urgot,94,44,50,46.81
Twitch,Amumu,212,90,122,42.45
Twitch,Gangplank,74,32,42,43.24
Twitch,Kayle,89,25,64,28.09
Twitch,Evelynn,54,30,24,55.56
Twitch,Riven,78,35,43,44.87
Twitch,Talon,76,41,35,53.95
Twitch,KSante,109,68,41,62.39
Twitch,Samira,154,93,61,60.39
Twitch,Gragas,99,61,38,61.62
Twitch,FiddleSticks,83,41,42,49.4
Twitch,Ziggs,64,42,22,65.63
Twitch,Seraphine,138,68,70,49.28
Twitch,Rumble,48,33,15,68.75
Twitch,Karthus,41,21,20,51.22
Twitch,Taric,46,19,27,41.3
Twitch,Velkoz,82,47,35,57.32
Twitch,Fizz,84,49,35,58.33
Twitch,Alistar,75,28,47,37.33
Twitch,Vex,68,31,37,45.59
Twitch,Olaf,45,17,28,37.78
Twitch,Anivia,72,37,35,51.39
Twitch,Kindred,86,44,42,51.16
Twitch,Graves,86,43,43,50
Twitch,Kennen,23,14,9,60.87
Twitch,Lissandra,50,26,24,52
Twitch,Rell,106,59,47,55.66
Twitch,Maokai,82,50,32,60.98
Twitch,Skarner,89,38,51,42.7
Twitch,Kled,36,17,19,47.22
Twitch,Rengar,35,19,16,54.29
Twitch,Poppy,101,57,44,56.44
Twitch,Ivern,37,10,27,27.03
Twitch,Annie,40,15,25,37.5
Twitch,Sivir,92,46,46,50
Twitch,Hecarim,64,28,36,43.75
Twitch,Janna,43,11,32,25.58
Twitch,Kassadin,26,5,21,19.23
Galio,Ambessa,231,112,119,48.48
Galio,Gragas,235,146,89,62.13
Galio,Pantheon,361,189,172,52.35
Galio,Samira,177,83,94,46.89
Galio,Hwei,223,117,106,52.47
Galio,DrMundo,134,63,71,47.01
Galio,Rammus,104,55,49,52.88
Galio,Annie,67,37,30,55.22
Galio,Ezreal,763,357,406,46.79
Galio,Renata,73,29,44,39.73
Galio,Graves,208,96,112,46.15
Galio,Ahri,444,216,228,48.65
Galio,AurelionSol,130,66,64,50.77
Galio,Rakan,177,94,83,53.11
Galio,Rengar,72,44,28,61.11
Galio,Warwick,340,176,164,51.76
Galio,Irelia,199,114,85,57.29
Galio,Ashe,553,301,252,54.43
Galio,Nautilus,416,210,206,50.48
Galio,Heimerdinger,145,70,75,48.28
Galio,LeeSin,564,293,271,51.95
Galio,Jinx,687,348,339,50.66
Galio,Leona,332,166,166,50
Galio,Volibear,268,126,142,47.01
Galio,Nunu,208,116,92,55.77
Galio,Katarina,206,100,106,48.54
Galio,Swain,304,147,157,48.36
Galio,Trundle,145,69,76,47.59
Galio,RekSai,57,27,30,47.37
Galio,Leblanc,225,125,100,55.56
Galio,Caitlyn,670,321,349,47.91
Galio,Lulu,477,224,253,46.96
Galio,Aatrox,351,162,189,46.15
Galio,Briar,137,60,77,43.8
Galio,Elise,302,195,107,64.57
Galio,Viktor,265,130,135,49.06
Galio,Thresh,504,239,265,47.42
Galio,Kindred,111,52,59,46.85
Galio,Yasuo,499,260,239,52.1
Galio,MissFortune,541,320,221,59.15
Galio,Sona,33,17,16,51.52
Galio,Malphite,297,163,134,54.88
Galio,Sejuani,185,56,129,30.27
Galio,Ekko,200,107,93,53.5
Galio,Karma,429,213,216,49.65
Galio,Mordekaiser,373,183,190,49.06
Galio,MonkeyKing,180,85,95,47.22
Galio,Rell,140,83,57,59.29
Galio,Aurora,206,110,96,53.4
Galio,Diana,468,257,211,54.91
Galio,Ryze,120,68,52,56.67
Galio,Maokai,150,66,84,44
Galio,Shen,199,94,105,47.24
Galio,Yorick,160,70,90,43.75
Galio,Veigar,225,101,124,44.89
Galio,Nasus,190,103,87,54.21
Galio,Nidalee,123,67,56,54.47
Galio,Jax,231,137,94,59.31
Galio,Evelynn,87,38,49,43.68
Galio,Akali,306,146,160,47.71
Galio,Kaisa,517,268,249,51.84
Galio,Seraphine,206,99,107,48.06
Galio,Morgana,288,144,144,50
Galio,Vayne,396,199,197,50.25
Galio,Singed,69,40,29,57.97
Galio,FiddleSticks,146,68,78,46.58
Galio,Teemo,235,99,136,42.13
Galio,Kayn,327,187,140,57.19
Galio,Sylas,544,288,256,52.94
Galio,Poppy,209,105,104,50.24
Galio,Quinn,82,43,39,52.44
Galio,Malzahar,286,146,140,51.05
Galio,Soraka,99,47,52,47.47
Galio,Vi,302,180,122,59.6
Galio,Xerath,216,83,133,38.43
Galio,TahmKench,225,114,111,50.67
Galio,Yone,543,306,237,56.35
Galio,Ornn,175,73,102,41.71
Galio,Neeko,119,63,56,52.94
Galio,Senna,163,90,73,55.21
Galio,Sion,237,95,142,40.08
Galio,XinZhao,170,90,80,52.94
Galio,Lissandra,108,46,62,42.59
Galio,Braum,159,81,78,50.94
Galio,Darius,484,244,240,50.41
Galio,Sett,427,227,200,53.16
Galio,Milio,157,62,95,39.49
Galio,MasterYi,230,126,104,54.78
Galio,Taliyah,75,28,47,37.33
Galio,Sivir,153,77,76,50.33
Galio,Skarner,162,65,97,40.12
Galio,Mel,588,323,265,54.93
Galio,Khazix,146,64,82,43.84
Galio,Janna,74,28,46,37.84
Galio,Yuumi,272,123,149,45.22
Galio,Lucian,268,125,143,46.64
Galio,Nami,287,153,134,53.31
Galio,Alistar,128,80,48,62.5
Galio,Nocturne,315,169,146,53.65
Galio,Jhin,447,259,188,57.94
Galio,Aphelios,127,61,66,48.03
Galio,Renekton,128,56,72,43.75
Galio,Blitzcrank,203,102,101,50.25
Galio,Amumu,355,180,175,50.7
Galio,Tristana,233,124,109,53.22
Galio,Kassadin,52,30,22,57.69
Galio,JarvanIV,240,98,142,40.83
Galio,Lux,601,283,318,47.09
Galio,Corki,181,67,114,37.02
Galio,Vladimir,147,80,67,54.42
Galio,Pyke,214,119,95,55.61
Galio,Fizz,104,50,54,48.08
Galio,Gnar,137,72,65,52.55
Galio,Gwen,146,83,63,56.85
Galio,Zed,243,118,125,48.56
Galio,Hecarim,104,43,61,41.35
Galio,Riven,131,73,58,55.73
Galio,Udyr,89,47,42,52.81
Galio,TwistedFate,105,44,61,41.9
Galio,Shaco,191,117,74,61.26
Galio,Xayah,171,83,88,48.54
Galio,Garen,455,239,216,52.53
Galio,Talon,170,75,95,44.12
Galio,Zac,173,77,96,44.51
Galio,Naafiri,75,31,44,41.33
Galio,Kalista,86,38,48,44.19
Galio,Zyra,216,92,124,42.59
Galio,Nilah,119,70,49,58.82
Galio,Syndra,212,117,95,55.19
Galio,Twitch,163,74,89,45.4
Galio,Fiora,106,58,48,54.72
Galio,KogMaw,100,46,54,46
Galio,Chogath,293,151,142,51.54
Galio,Rumble,135,61,74,45.19
Galio,Zilean,81,34,47,41.98
Galio,Ziggs,121,48,73,39.67
Galio,Brand,122,62,60,50.82
Galio,Smolder,184,83,101,45.11
Galio,Karthus,82,48,34,58.54
Galio,Jayce,147,82,65,55.78
Galio,Tryndamere,76,32,44,42.11
Galio,Kayle,120,60,60,50
Galio,Bard,91,51,40,56.04
Galio,Camille,129,72,57,55.81
Galio,Gangplank,210,129,81,61.43
Galio,Orianna,135,79,56,58.52
Galio,Viego,352,175,177,49.72
Galio,Anivia,129,68,61,52.71
Galio,Varus,258,126,132,48.84
Galio,Velkoz,152,106,46,69.74
Galio,KSante,255,122,133,47.84
Galio,Kennen,91,29,62,31.87
Galio,Vex,141,67,74,47.52
Galio,Olaf,52,42,10,80.77
Galio,Illaoi,126,46,80,36.51
Galio,Urgot,125,69,56,55.2
Galio,Shyvana,74,35,39,47.3
Galio,Lillia,146,72,74,49.32
Galio,Taric,39,11,28,28.21
Galio,Azir,106,55,51,51.89
Galio,Cassiopeia,61,38,23,62.3
Galio,Draven,130,77,53,59.23
Galio,Akshan,48,30,18,62.5
Galio,Kled,58,37,21,63.79
Galio,Belveth,46,10,36,21.74
Galio,Zoe,129,90,39,69.77
Galio,Qiyana,70,48,22,68.57
Galio,Zeri,137,61,76,44.53
Galio,Ivern,46,31,15,67.39
Hecarim,Ambessa,50,22,28,44
Hecarim,Gragas,48,26,22,54.17
Hecarim,Pantheon,129,71,58,55.04
Hecarim,Samira,45,17,28,37.78
Hecarim,Hwei,76,48,28,63.16
Hecarim,Warwick,97,44,53,45.36
Hecarim,Udyr,22,13,9,59.09
Hecarim,Mel,168,68,100,40.48
Hecarim,Sivir,51,26,25,50.98
Hecarim,Karma,128,54,74,42.19
Hecarim,Aatrox,94,50,44,53.19
Hecarim,MasterYi,59,33,26,55.93
Hecarim,TwistedFate,19,8,11,42.11
Hecarim,Varus,76,35,41,46.05
Hecarim,Lux,126,80,46,63.49
Hecarim,Kennen,17,6,11,35.29
Hecarim,Vi,89,49,40,55.06
Hecarim,Ashe,154,78,76,50.65
Hecarim,Leona,73,36,37,49.32
Hecarim,Garen,99,50,49,50.51
Hecarim,Diana,106,54,52,50.94
Hecarim,Yasuo,173,99,74,57.23
Hecarim,Ezreal,157,67,90,42.68
Hecarim,Brand,41,22,19,53.66
Hecarim,Yorick,50,23,27,46
Hecarim,Briar,56,34,22,60.71
Hecarim,Sylas,161,73,88,45.34
Hecarim,Veigar,84,47,37,55.95
Hecarim,Ziggs,38,12,26,31.58
Hecarim,Ornn,51,19,32,37.25
Hecarim,Kayn,85,36,49,42.35
Hecarim,Jinx,223,94,129,42.15
Hecarim,Pyke,80,48,32,60
Hecarim,Nami,81,37,44,45.68
Hecarim,Nocturne,99,49,50,49.49
Hecarim,Malzahar,69,44,25,63.77
Hecarim,Caitlyn,179,80,99,44.69
Hecarim,Lucian,58,44,14,75.86
Hecarim,Blitzcrank,72,44,28,61.11
Hecarim,Gnar,59,23,36,38.98
Hecarim,Elise,79,44,35,55.7
Hecarim,Ahri,125,59,66,47.2
Hecarim,Draven,50,22,28,44
Hecarim,Nautilus,108,52,56,48.15
Hecarim,Jayce,45,17,28,37.78
Hecarim,Lulu,174,77,97,44.25
Hecarim,FiddleSticks,36,11,25,30.56
Hecarim,Vayne,102,60,42,58.82
Hecarim,Viktor,86,33,53,38.37
Hecarim,Singed,17,5,12,29.41
Hecarim,Talon,44,33,11,75
Hecarim,Katarina,42,23,19,54.76
Hecarim,Thresh,144,68,76,47.22
Hecarim,Akali,66,27,39,40.91
Hecarim,Seraphine,64,26,38,40.63
Hecarim,Mordekaiser,88,47,41,53.41
Hecarim,JarvanIV,48,19,29,39.58
Hecarim,MissFortune,189,98,91,51.85
Hecarim,Teemo,71,49,22,69.01
Hecarim,Shaco,57,26,31,45.61
Hecarim,Zoe,29,17,12,58.62
Hecarim,Nilah,16,13,3,81.25
Hecarim,Braum,59,25,34,42.37
Hecarim,Aurora,82,41,41,50
Hecarim,Akshan,30,16,14,53.33
Hecarim,Tristana,73,34,39,46.58
Hecarim,Skarner,69,23,46,33.33
Hecarim,Rell,57,24,33,42.11
Hecarim,Gangplank,51,26,25,50.98
Hecarim,Ivern,19,10,9,52.63
Hecarim,Chogath,94,57,37,60.64
Hecarim,Morgana,69,21,48,30.43
Hecarim,Kaisa,126,54,72,42.86
Hecarim,Galio,104,61,43,58.65
Hecarim,Leblanc,42,21,21,50
Hecarim,Sejuani,56,32,24,57.14
Hecarim,Aphelios,53,34,19,64.15
Hecarim,Vladimir,46,26,20,56.52
Hecarim,Velkoz,21,8,13,38.1
Hecarim,Kayle,50,30,20,60
Hecarim,Shyvana,28,19,9,67.86
Hecarim,Malphite,89,35,54,39.33
Hecarim,MonkeyKing,47,15,32,31.91
Hecarim,Swain,76,31,45,40.79
Hecarim,Trundle,26,15,11,57.69
Hecarim,Viego,139,51,88,36.69
Hecarim,Smolder,67,39,28,58.21
Hecarim,Poppy,52,30,22,57.69
Hecarim,Graves,74,29,45,39.19
Hecarim,Alistar,59,28,31,47.46
Hecarim,Nunu,52,26,26,50
Hecarim,Illaoi,28,13,15,46.43
Hecarim,Naafiri,27,11,16,40.74
Hecarim,DrMundo,59,39,20,66.1
Hecarim,Nidalee,23,9,14,39.13
Hecarim,Riven,28,16,12,57.14
Hecarim,Kindred,37,24,13,64.86
Hecarim,Xayah,48,14,34,29.17
Hecarim,Ryze,22,2,20,9.09
Hecarim,LeeSin,165,86,79,52.12
Hecarim,Irelia,48,30,18,62.5
Hecarim,Milio,58,32,26,55.17
Hecarim,Soraka,43,34,9,79.07
Hecarim,Corki,44,26,18,59.09
Hecarim,Karthus,29,24,5,82.76
Hecarim,Rumble,34,15,19,44.12
Hecarim,Yone,134,57,77,42.54
Hecarim,Jhin,167,82,85,49.1
Hecarim,Syndra,48,32,16,66.67
Hecarim,Kled,16,6,10,37.5
Hecarim,Jax,70,38,32,54.29
Hecarim,Taliyah,21,5,16,23.81
Hecarim,Zilean,31,7,24,22.58
Hecarim,Taric,11,5,6,45.45
Hecarim,Camille,38,19,19,50
Hecarim,Zed,79,38,41,48.1
Hecarim,Renekton,43,16,27,37.21
Hecarim,Fizz,23,8,15,34.78
Hecarim,Sett,104,48,56,46.15
Hecarim,Rammus,15,12,3,80
Hecarim,Darius,132,76,56,57.58
Hecarim,Evelynn,27,8,19,29.63
Hecarim,Orianna,54,34,20,62.96
Hecarim,Lillia,46,32,14,69.57
Hecarim,Rakan,33,15,18,45.45
Hecarim,Nasus,40,27,13,67.5
Hecarim,Sion,70,26,44,37.14
Hecarim,Azir,50,27,23,54
Hecarim,Volibear,66,24,42,36.36
Hecarim,Belveth,23,12,11,52.17
Hecarim,KSante,71,30,41,42.25
Hecarim,TahmKench,37,10,27,27.03
Hecarim,Zeri,62,39,23,62.9
Hecarim,Vex,27,13,14,48.15
Hecarim,Amumu,105,56,49,53.33
Hecarim,Janna,29,17,12,58.62
Hecarim,Ekko,92,42,50,45.65
Hecarim,Senna,33,21,12,63.64
Hecarim,Fiora,40,6,34,15
Hecarim,Lissandra,28,8,20,28.57
Hecarim,Qiyana,10,5,5,50
Hecarim,Quinn,18,9,9,50
Hecarim,Kalista,33,8,25,24.24
Hecarim,Zac,52,31,21,59.62
Hecarim,Yuumi,65,36,29,55.38
Hecarim,Olaf,27,5,22,18.52
Hecarim,XinZhao,58,18,40,31.03
Hecarim,Zyra,53,26,27,49.06
Hecarim,Maokai,31,16,15,51.61
Hecarim,Urgot,50,17,33,34
Hecarim,Twitch,64,36,28,56.25
Hecarim,AurelionSol,28,20,8,71.43
Hecarim,Khazix,35,19,16,54.29
Hecarim,Heimerdinger,33,19,14,57.58
Hecarim,Shen,58,25,33,43.1
Hecarim,Cassiopeia,11,5,6,45.45
Hecarim,Xerath,60,22,38,36.67
Hecarim,Tryndamere,26,16,10,61.54
Hecarim,Neeko,37,19,18,51.35
Hecarim,Bard,10,4,6,40
Hecarim,Anivia,28,10,18,35.71
Hecarim,Sona,19,9,10,47.37
Hecarim,Annie,13,7,6,53.85
Hecarim,Gwen,31,17,14,54.84
Hecarim,KogMaw,20,10,10,50
Hecarim,RekSai,8,3,5,37.5
Hecarim,Rengar,8,8,0,100
Hecarim,Renata,12,5,7,41.67
Hecarim,Kassadin,12,9,3,75
Shen,Ambessa,159,100,59,62.89
Shen,Gragas,135,87,48,64.44
Shen,Pantheon,263,117,146,44.49
Shen,Samira,126,72,54,57.14
Shen,Hwei,137,74,63,54.01
Shen,Rell,136,64,72,47.06
Shen,Rengar,54,31,23,57.41
Shen,Sett,260,121,139,46.54
Shen,Mel,385,212,173,55.06
Shen,Varus,139,85,54,61.15
Shen,Fiora,82,34,48,41.46
Shen,Singed,61,34,27,55.74
Shen,Yasuo,387,219,168,56.59
Shen,Caitlyn,442,262,180,59.28
Shen,Milio,133,65,68,48.87
Shen,Yorick,118,52,66,44.07
Shen,Diana,235,111,124,47.23
Shen,Ashe,376,185,191,49.2
Shen,Lulu,286,126,160,44.06
Shen,Aatrox,178,107,71,60.11
Shen,Lillia,86,40,46,46.51
Shen,Amumu,253,112,141,44.27
Shen,Warwick,206,83,123,40.29
Shen,Katarina,91,57,34,62.64
Shen,Taric,48,26,22,54.17
Shen,Zed,154,89,65,57.79
Shen,FiddleSticks,93,48,45,51.61
Shen,Irelia,103,78,25,75.73
Shen,Ekko,139,60,79,43.17
Shen,Qiyana,18,13,5,72.22
Shen,Thresh,324,192,132,59.26
Shen,Sion,174,80,94,45.98
Shen,Viktor,195,99,96,50.77
Shen,Jinx,469,211,258,44.99
Shen,Vladimir,117,48,69,41.03
Shen,Akali,155,90,65,58.06
Shen,Vayne,291,146,145,50.17
Shen,Nami,195,105,90,53.85
Shen,Chogath,242,126,116,52.07
Shen,JarvanIV,188,92,96,48.94
Shen,Tristana,138,70,68,50.72
Shen,Alistar,89,53,36,59.55
Shen,Trundle,109,59,50,54.13
Shen,RekSai,36,16,20,44.44
Shen,Leblanc,84,39,45,46.43
Shen,Gangplank,120,69,51,57.5
Shen,Kayn,191,102,89,53.4
Shen,Taliyah,66,22,44,33.33
Shen,MissFortune,372,166,206,44.62
Shen,Leona,190,93,97,48.95
Shen,Briar,92,42,50,45.65
Shen,Sylas,293,168,125,57.34
Shen,Veigar,155,73,82,47.1
Shen,Ziggs,80,41,39,51.25
Shen,KSante,110,67,43,60.91
Shen,Draven,81,40,41,49.38
Shen,Zoe,75,49,26,65.33
Shen,Kayle,112,70,42,62.5
Shen,Nidalee,57,33,24,57.89
Shen,Braum,155,78,77,50.32
Shen,Urgot,81,35,46,43.21
Shen,Yone,268,136,132,50.75
Shen,Kalista,65,41,24,63.08
Shen,Galio,199,105,94,52.76
Shen,Shaco,154,81,73,52.6
Shen,Azir,87,41,46,47.13
Shen,TahmKench,131,65,66,49.62
Shen,Aurora,146,73,73,50
Shen,Sona,27,12,15,44.44
Shen,Garen,271,138,133,50.92
Shen,Orianna,108,58,50,53.7
Shen,Brand,119,52,67,43.7
Shen,Camille,95,50,45,52.63
Shen,Darius,307,143,164,46.58
Shen,Lux,352,184,168,52.27
Shen,Pyke,145,88,57,60.69
Shen,Nautilus,231,126,105,54.55
Shen,Mordekaiser,222,114,108,51.35
Shen,Malzahar,189,109,80,57.67
Shen,KogMaw,50,31,19,62
Shen,Twitch,128,79,49,61.72
Shen,Nocturne,205,105,100,51.22
Shen,Karma,192,92,100,47.92
Shen,Renekton,92,51,41,55.43
Shen,Jayce,62,29,33,46.77
Shen,Zyra,120,56,64,46.67
Shen,Corki,75,41,34,54.67
Shen,LeeSin,297,185,112,62.29
Shen,Swain,167,68,99,40.72
Shen,Blitzcrank,159,61,98,38.36
Shen,MasterYi,189,122,67,64.55
Shen,Vex,62,24,38,38.71
Shen,Morgana,185,112,73,60.54
Shen,Teemo,126,68,58,53.97
Shen,Ezreal,407,249,158,61.18
Shen,Neeko,71,39,32,54.93
Shen,Gnar,125,79,46,63.2
Shen,MonkeyKing,141,74,67,52.48
Shen,Poppy,128,64,64,50
Shen,Velkoz,113,52,61,46.02
Shen,Riven,76,38,38,50
Shen,Zeri,74,47,27,63.51
Shen,Xerath,186,114,72,61.29
Shen,Fizz,93,43,50,46.24
Shen,Skarner,103,60,43,58.25
Shen,Volibear,161,91,70,56.52
Shen,Janna,65,31,34,47.69
Shen,DrMundo,74,31,43,41.89
Shen,Vi,178,78,100,43.82
Shen,Nunu,137,66,71,48.18
Shen,Nasus,87,43,44,49.43
Shen,Gwen,116,60,56,51.72
Shen,Malphite,174,84,90,48.28
Shen,Jax,130,76,54,58.46
Shen,Kaisa,335,177,158,52.84
Shen,Khazix,107,56,51,52.34
Shen,Elise,141,86,55,60.99
Shen,Jhin,293,143,150,48.81
Shen,XinZhao,153,82,71,53.59
Shen,Lucian,147,91,56,61.9
Shen,Viego,240,119,121,49.58
Shen,Ivern,31,17,14,54.84
Shen,Evelynn,59,29,30,49.15
Shen,Belveth,38,21,17,55.26
Shen,Udyr,58,35,23,60.34
Shen,Seraphine,138,85,53,61.59
Shen,Aphelios,107,57,50,53.27
Shen,Kindred,89,50,39,56.18
Shen,Zac,97,52,45,53.61
Shen,Yuumi,136,77,59,56.62
Shen,Rumble,58,28,30,48.28
Shen,Karthus,48,28,20,58.33
Shen,Syndra,153,72,81,47.06
Shen,Kassadin,53,14,39,26.42
Shen,Tryndamere,77,37,40,48.05
Shen,Talon,109,59,50,54.13
Shen,Akshan,59,31,28,52.54
Shen,Ahri,189,99,90,52.38
Shen,Kennen,34,19,15,55.88
Shen,Naafiri,78,43,35,55.13
Shen,Sivir,110,32,78,29.09
Shen,Soraka,75,43,32,57.33
Shen,Sejuani,115,47,68,40.87
Shen,Nilah,49,17,32,34.69
Shen,Senna,86,46,40,53.49
Shen,Annie,49,29,20,59.18
Shen,Zilean,31,9,22,29.03
Shen,Smolder,88,43,45,48.86
Shen,Anivia,78,38,40,48.72
Shen,AurelionSol,84,43,41,51.19
Shen,Lissandra,66,23,43,34.85
Shen,TwistedFate,64,36,28,56.25
Shen,Graves,86,38,48,44.19
Shen,Bard,54,25,29,46.3
Shen,Xayah,135,72,63,53.33
Shen,Rakan,114,68,46,59.65
Shen,Olaf,50,29,21,58
Shen,Cassiopeia,36,19,17,52.78
Shen,Illaoi,96,48,48,50
Shen,Hecarim,58,33,25,56.9
Shen,Ornn,118,53,65,44.92
Shen,Heimerdinger,61,35,26,57.38
Shen,Rammus,49,32,17,65.31
Shen,Kled,32,19,13,59.38
Shen,Maokai,51,36,15,70.59
Shen,Ryze,80,34,46,42.5
Shen,Shyvana,34,19,15,55.88
Shen,Renata,33,11,22,33.33
Shen,Quinn,23,9,14,39.13
Nami,Ambessa,154,91,63,59.09
Nami,Gragas,218,128,90,58.72
Nami,Pantheon,379,195,184,51.45
Nami,Samira,177,86,91,48.59
Nami,Hwei,153,78,75,50.98
Nami,Yone,359,186,173,51.81
Nami,Nocturne,351,171,180,48.72
Nami,Akali,201,66,135,32.84
Nami,Ezreal,500,296,204,59.2
Nami,Renata,87,53,34,60.92
Nami,Volibear,246,118,128,47.97
Nami,Elise,195,114,81,58.46
Nami,Malzahar,256,158,98,61.72
Nami,Caitlyn,640,325,315,50.78
Nami,Milio,257,132,125,51.36
Nami,Rell,156,77,79,49.36
Nami,Rengar,77,51,26,66.23
Nami,Sett,278,138,140,49.64
Nami,Mel,511,284,227,55.58
Nami,Varus,246,143,103,58.13
Nami,Kayn,227,147,80,64.76
Nami,Ahri,387,210,177,54.26
Nami,MissFortune,518,295,223,56.95
Nami,Amumu,290,149,141,51.38
Nami,Darius,404,205,199,50.74
Nami,Vi,288,157,131,54.51
Nami,Aphelios,122,72,50,59.02
Nami,Soraka,122,70,52,57.38
Nami,Vladimir,124,60,64,48.39
Nami,MasterYi,221,116,105,52.49
Nami,Leona,208,114,94,54.81
Nami,Ashe,469,264,205,56.29
Nami,Mordekaiser,302,136,166,45.03
Nami,Teemo,231,140,91,60.61
Nami,Katarina,228,112,116,49.12
Nami,Singed,77,41,36,53.25
Nami,Poppy,193,99,94,51.3
Nami,FiddleSticks,111,65,46,58.56
Nami,Lux,547,267,280,48.81
Nami,Braum,237,132,105,55.7
Nami,Aurora,184,100,84,54.35
Nami,Rakan,131,77,54,58.78
Nami,Nasus,177,88,89,49.72
Nami,MonkeyKing,192,95,97,49.48
Nami,Viktor,232,125,107,53.88
Nami,Malphite,253,139,114,54.94
Nami,Briar,104,48,56,46.15
Nami,Zed,198,103,95,52.02
Nami,Seraphine,194,93,101,47.94
Nami,TwistedFate,90,38,52,42.22
Nami,Xayah,136,76,60,55.88
Nami,Sion,214,93,121,43.46
Nami,Shen,195,90,105,46.15
Nami,LeeSin,353,186,167,52.69
Nami,Orianna,137,67,70,48.91
Nami,Garen,416,188,228,45.19
Nami,Talon,145,84,61,57.93
Nami,Sivir,135,70,65,51.85
Nami,Lulu,580,319,261,55
Nami,Kennen,71,49,22,69.01
Nami,Pyke,143,65,78,45.45
Nami,Kayle,160,82,78,51.25
Nami,Warwick,263,123,140,46.77
Nami,Irelia,147,92,55,62.59
Nami,Yasuo,429,209,220,48.72
Nami,Gangplank,135,72,63,53.33
Nami,Ekko,193,98,95,50.78
Nami,Alistar,101,48,53,47.52
Nami,Draven,152,81,71,53.29
Nami,Renekton,150,93,57,62
Nami,Karma,444,270,174,60.81
Nami,KSante,153,97,56,63.4
Nami,Zoe,131,86,45,65.65
Nami,Veigar,198,110,88,55.56
Nami,Lillia,112,58,54,51.79
Nami,Jayce,90,51,39,56.67
Nami,Smolder,186,85,101,45.7
Nami,Nunu,170,101,69,59.41
Nami,Thresh,377,200,177,53.05
Nami,Jhin,507,249,258,49.11
Nami,TahmKench,248,98,150,39.52
Nami,XinZhao,211,100,111,47.39
Nami,Kaisa,372,186,186,50
Nami,Brand,104,59,45,56.73
Nami,Azir,88,53,35,60.23
Nami,Jax,174,93,81,53.45
Nami,Diana,367,204,163,55.59
Nami,Tryndamere,97,49,48,50.52
Nami,Morgana,166,92,74,55.42
Nami,Khazix,148,85,63,57.43
Nami,Camille,130,52,78,40
Nami,Udyr,57,27,30,47.37
Nami,Nidalee,77,53,24,68.83
Nami,Zac,182,87,95,47.8
Nami,Swain,209,131,78,62.68
Nami,Yuumi,197,120,77,60.91
Nami,Viego,295,154,141,52.2
Nami,Senna,117,60,57,51.28
Nami,Gwen,101,58,43,57.43
Nami,Hecarim,81,44,37,54.32
Nami,Ryze,107,66,41,61.68
Nami,Graves,126,75,51,59.52
Nami,Xerath,198,80,118,40.4
Nami,Zyra,203,98,105,48.28
Nami,Heimerdinger,80,32,48,40
Nami,Urgot,143,85,58,59.44
Nami,Sejuani,185,86,99,46.49
Nami,Vayne,259,139,120,53.67
Nami,Vex,120,74,46,61.67
Nami,Blitzcrank,196,107,89,54.59
Nami,Yorick,199,88,111,44.22
Nami,Aatrox,254,140,114,55.12
Nami,Shaco,158,77,81,48.73
Nami,Jinx,650,334,316,51.38
Nami,Ivern,57,30,27,52.63
Nami,Rammus,57,36,21,63.16
Nami,Nautilus,278,177,101,63.67
Nami,DrMundo,128,66,62,51.56
Nami,Zilean,89,57,32,64.04
Nami,Neeko,104,56,48,53.85
Nami,Fiora,86,52,34,60.47
Nami,Qiyana,47,22,25,46.81
Nami,Leblanc,150,72,78,48
Nami,Karthus,81,54,27,66.67
Nami,Evelynn,99,59,40,59.6
Nami,Janna,95,30,65,31.58
Nami,Chogath,288,152,136,52.78
Nami,Corki,120,86,34,71.67
Nami,Galio,287,134,153,46.69
Nami,Cassiopeia,90,47,43,52.22
Nami,Zeri,84,50,34,59.52
Nami,AurelionSol,93,36,57,38.71
Nami,Fizz,93,54,39,58.06
Nami,Twitch,161,78,83,48.45
Nami,Taliyah,51,35,16,68.63
Nami,Lissandra,103,46,57,44.66
Nami,Sona,73,32,41,43.84
Nami,Illaoi,93,60,33,64.52
Nami,Belveth,61,37,24,60.66
Nami,Kassadin,40,26,14,65
Nami,Rumble,58,32,26,55.17
Nami,Tristana,183,96,87,52.46
Nami,Lucian,234,135,99,57.69
Nami,Sylas,247,139,108,56.28
Nami,Taric,45,19,26,42.22
Nami,Naafiri,76,33,43,43.42
Nami,Anivia,101,49,52,48.51
Nami,Ziggs,75,35,40,46.67
Nami,Kled,66,38,28,57.58
Nami,Bard,88,48,40,54.55
Nami,Syndra,193,115,78,59.59
Nami,Shyvana,60,24,36,40
Nami,RekSai,41,25,16,60.98
Nami,Olaf,34,14,20,41.18
Nami,Quinn,96,58,38,60.42
Nami,Skarner,145,63,82,43.45
Nami,Kalista,67,45,22,67.16
Nami,Kindred,114,61,53,53.51
Nami,Riven,102,43,59,42.16
Nami,KogMaw,114,42,72,36.84
Nami,Trundle,146,65,81,44.52
Nami,Maokai,134,69,65,51.49
Nami,Akshan,105,46,59,43.81
Nami,Gnar,127,89,38,70.08
Nami,Nilah,84,32,52,38.1
Nami,Velkoz,146,74,72,50.68
Nami,JarvanIV,184,88,96,47.83
Nami,Ornn,135,95,40,70.37
Nami,Annie,93,44,49,47.31
Gragas,Galio,235,89,146,37.87
Gragas,Hecarim,48,22,26,45.83
Gragas,Shen,135,48,87,35.56
Gragas,Kaisa,247,148,99,59.92
Gragas,Nami,218,90,128,41.28
Gragas,Yone,294,130,164,44.22
Gragas,JarvanIV,185,83,102,44.86
Gragas,Ryze,66,33,33,50
Gragas,Draven,96,45,51,46.88
Gragas,Blitzcrank,185,70,115,37.84
Gragas,Poppy,124,58,66,46.77
Gragas,Zac,101,54,47,53.47
Gragas,Malzahar,185,65,120,35.14
Gragas,MissFortune,285,143,142,50.18
Gragas,TahmKench,188,87,101,46.28
Gragas,Mordekaiser,205,102,103,49.76
Gragas,Zed,210,103,107,49.05
Gragas,Varus,172,83,89,48.26
Gragas,Pyke,133,70,63,52.63
Gragas,Vladimir,102,44,58,43.14
Gragas,MasterYi,202,105,97,51.98
Gragas,Leona,159,79,80,49.69
Gragas,Ashe,379,176,203,46.44
Gragas,Jax,177,80,97,45.2
Gragas,Diana,295,121,174,41.02
Gragas,Akshan,38,28,10,73.68
Gragas,Milio,127,62,65,48.82
Gragas,Urgot,61,34,27,55.74
Gragas,Ezreal,540,229,311,42.41
Gragas,Mel,346,187,159,54.05
Gragas,Warwick,204,107,97,52.45
Gragas,LeeSin,455,230,225,50.55
Gragas,Viktor,173,72,101,41.62
Gragas,Lucian,207,102,105,49.28
Gragas,Sett,239,108,131,45.19
Gragas,Veigar,153,72,81,47.06
Gragas,Lux,426,181,245,42.49
Gragas,Thresh,342,152,190,44.44
Gragas,Lissandra,67,37,30,55.22
Gragas,Irelia,156,83,73,53.21
Gragas,Lulu,297,160,137,53.87
Gragas,Vayne,222,99,123,44.59
Gragas,Ivern,25,16,9,64
Gragas,Qiyana,42,27,15,64.29
Gragas,Ahri,244,116,128,47.54
Gragas,Seraphine,106,43,63,40.57
Gragas,Shaco,126,56,70,44.44
Gragas,Fizz,79,34,45,43.04
Gragas,Aphelios,116,54,62,46.55
Gragas,Soraka,75,31,44,41.33
Gragas,DrMundo,63,42,21,66.67
Gragas,Zeri,79,44,35,55.7
Gragas,Rumble,77,57,20,74.03
Gragas,Yasuo,338,183,155,54.14
Gragas,Pantheon,302,153,149,50.66
Gragas,Ornn,122,61,61,50
Gragas,Vi,216,70,146,32.41
Gragas,Jhin,280,131,149,46.79
Gragas,Sion,164,72,92,43.9
Gragas,Xayah,139,52,87,37.41
Gragas,Aatrox,184,83,101,45.11
Gragas,Nocturne,216,83,133,38.43
Gragas,Caitlyn,408,214,194,52.45
Gragas,Xerath,153,57,96,37.25
Gragas,Kindred,112,43,69,38.39
Gragas,Riven,65,30,35,46.15
Gragas,Viego,192,84,108,43.75
Gragas,Naafiri,47,24,23,51.06
Gragas,Sejuani,134,61,73,45.52
Gragas,Heimerdinger,63,34,29,53.97
Gragas,Rell,127,45,82,35.43
Gragas,Azir,86,41,45,47.67
Gragas,Ekko,147,44,103,29.93
Gragas,Chogath,239,107,132,44.77
Gragas,Amumu,165,74,91,44.85
Gragas,Leblanc,143,77,66,53.85
Gragas,Morgana,178,70,108,39.33
Gragas,Talon,76,42,34,55.26
Gragas,Renata,35,20,15,57.14
Gragas,Taliyah,48,23,25,47.92
Gragas,Braum,126,57,69,45.24
Gragas,Swain,134,53,81,39.55
Gragas,MonkeyKing,106,54,52,50.94
Gragas,Rammus,58,26,32,44.83
Gragas,Zilean,84,44,40,52.38
Gragas,Kayn,201,79,122,39.3
Gragas,Rengar,29,13,16,44.83
Gragas,Smolder,99,44,55,44.44
Gragas,Janna,74,29,45,39.19
Gragas,Samira,137,81,56,59.12
Gragas,Aurora,140,78,62,55.71
Gragas,Jinx,479,201,278,41.96
Gragas,Khazix,117,48,69,41.03
Gragas,Malphite,139,61,78,43.88
Gragas,Belveth,33,12,21,36.36
Gragas,Velkoz,74,28,46,37.84
Gragas,Katarina,118,40,78,33.9
Gragas,Tristana,146,68,78,46.58
Gragas,Illaoi,97,41,56,42.27
Gragas,Volibear,162,76,86,46.91
Gragas,Quinn,50,33,17,66
Gragas,Zoe,93,34,59,36.56
Gragas,Nilah,62,19,43,30.65
Gragas,Evelynn,65,28,37,43.08
Gragas,Garen,268,120,148,44.78
Gragas,Rakan,82,47,35,57.32
Gragas,Darius,345,136,209,39.42
Gragas,Kled,28,14,14,50
Gragas,Orianna,100,45,55,45
Gragas,Briar,94,31,63,32.98
Gragas,Akali,139,57,82,41.01
Gragas,Hwei,118,53,65,44.92
Gragas,Neeko,58,35,23,60.34
Gragas,Karma,214,96,118,44.86
Gragas,Gnar,111,47,64,42.34
Gragas,Zyra,122,74,48,60.66
Gragas,Ambessa,147,56,91,38.1
Gragas,Alistar,99,56,43,56.57
Gragas,Annie,64,34,30,53.13
Gragas,Nasus,119,39,80,32.77
Gragas,RekSai,34,20,14,58.82
Gragas,Yuumi,154,47,107,30.52
Gragas,Elise,141,63,78,44.68
Gragas,TwistedFate,68,36,32,52.94
Gragas,Yorick,92,40,52,43.48
Gragas,Sylas,294,153,141,52.04
Gragas,Corki,110,45,65,40.91
Gragas,Cassiopeia,51,23,28,45.1
Gragas,Trundle,76,47,29,61.84
Gragas,Teemo,145,64,81,44.14
Gragas,KSante,169,95,74,56.21
Gragas,Kennen,51,23,28,45.1
Gragas,Nidalee,68,32,36,47.06
Gragas,Maokai,76,45,31,59.21
Gragas,Brand,90,48,42,53.33
Gragas,Gangplank,136,69,67,50.74
Gragas,Renekton,101,56,45,55.45
Gragas,AurelionSol,60,32,28,53.33
Gragas,Kayle,66,34,32,51.52
Gragas,Senna,111,55,56,49.55
Gragas,Nautilus,230,112,118,48.7
Gragas,Shyvana,39,11,28,28.21
Gragas,Singed,44,9,35,20.45
Gragas,Jayce,127,72,55,56.69
Gragas,Fiora,57,23,34,40.35
Gragas,Vex,88,29,59,32.95
Gragas,Gwen,56,32,24,57.14
Gragas,Syndra,100,56,44,56
Gragas,Anivia,83,48,35,57.83
Gragas,KogMaw,53,28,25,52.83
Gragas,Bard,59,39,20,66.1
Gragas,Lillia,119,56,63,47.06
Gragas,Skarner,101,52,49,51.49
Gragas,Kassadin,34,12,22,35.29
Gragas,Kalista,64,35,29,54.69
Gragas,Olaf,51,12,39,23.53
Gragas,Ziggs,77,39,38,50.65
Gragas,Nunu,100,46,54,46
Gragas,Twitch,99,38,61,38.38
Gragas,Graves,92,24,68,26.09
Gragas,Tryndamere,53,28,25,52.83
Gragas,Karthus,32,16,16,50
Gragas,Sivir,79,28,51,35.44
Gragas,Camille,89,47,42,52.81
Gragas,Sona,36,14,22,38.89
Gragas,Taric,56,19,37,33.93
Gragas,Udyr,58,32,26,55.17
Gragas,XinZhao,113,55,58,48.67
Gragas,FiddleSticks,87,50,37,57.47
Samira,Galio,177,94,83,53.11
Samira,Hecarim,45,28,17,62.22
Samira,Shen,126,54,72,42.86
Samira,Kaisa,260,128,132,49.23
Samira,Nami,177,91,86,51.41
Samira,Quinn,40,21,19,52.5
Samira,MasterYi,184,96,88,52.17
Samira,Garen,223,101,122,45.29
Samira,Smolder,123,54,69,43.9
Samira,Nautilus,240,103,137,42.92
Samira,Jax,126,61,65,48.41
Samira,Graves,130,70,60,53.85
Samira,Kassadin,43,23,20,53.49
Samira,Tristana,143,82,61,57.34
Samira,Ambessa,129,59,70,45.74
Samira,Ahri,266,117,149,43.98
Samira,AurelionSol,74,28,46,37.84
Samira,Rakan,120,58,62,48.33
Samira,Yorick,163,96,67,58.9
Samira,Skarner,104,35,69,33.65
Samira,Mel,355,193,162,54.37
Samira,Senna,102,51,51,50
Samira,Sylas,250,130,120,52
Samira,Blitzcrank,181,102,79,56.35
Samira,Nasus,86,53,33,61.63
Samira,Anivia,77,43,34,55.84
Samira,Vayne,263,139,124,52.85
Samira,Yuumi,166,91,75,54.82
Samira,XinZhao,132,80,52,60.61
Samira,Azir,92,50,42,54.35
Samira,Jinx,426,210,216,49.3
Samira,Rell,106,55,51,51.89
Samira,Vladimir,104,59,45,56.73
Samira,LeeSin,299,147,152,49.16
Samira,Yasuo,322,135,187,41.93
Samira,MissFortune,373,168,205,45.04
Samira,Sett,289,145,144,50.17
Samira,Hwei,106,52,54,49.06
Samira,TahmKench,145,82,63,56.55
Samira,Heimerdinger,80,35,45,43.75
Samira,Ashe,267,144,123,53.93
Samira,Orianna,82,49,33,59.76
Samira,Seraphine,150,86,64,57.33
Samira,Pantheon,279,118,161,42.29
Samira,Viktor,164,65,99,39.63
Samira,Milio,123,61,62,49.59
Samira,Malphite,209,94,115,44.98
Samira,Kayn,245,123,122,50.2
Samira,Lucian,125,80,45,64
Samira,TwistedFate,70,33,37,47.14
Samira,JarvanIV,118,59,59,50
Samira,Vex,64,23,41,35.94
Samira,Morgana,211,107,104,50.71
Samira,Darius,362,175,187,48.34
Samira,Viego,239,109,130,45.61
Samira,Draven,112,64,48,57.14
Samira,Riven,58,25,33,43.1
Samira,Diana,206,116,90,56.31
Samira,Zoe,33,11,22,33.33
Samira,Ezreal,403,217,186,53.85
Samira,Urgot,60,25,35,41.67
Samira,Vi,137,77,60,56.2
Samira,Syndra,110,60,50,54.55
Samira,Caitlyn,404,166,238,41.09
Samira,Nocturne,156,62,94,39.74
Samira,Taliyah,48,22,26,45.83
Samira,Lux,383,173,210,45.17
Samira,Volibear,234,101,133,43.16
Samira,Varus,153,67,86,43.79
Samira,Braum,114,44,70,38.6
Samira,Sejuani,96,43,53,44.79
Samira,Leblanc,99,58,41,58.59
Samira,Irelia,102,54,48,52.94
Samira,Malzahar,190,93,97,48.95
Samira,Amumu,195,85,110,43.59
Samira,Ekko,128,62,66,48.44
Samira,Mordekaiser,214,122,92,57.01
Samira,Akali,164,78,86,47.56
Samira,Taric,42,10,32,23.81
Samira,Teemo,160,81,79,50.63
Samira,Zed,180,93,87,51.67
Samira,Singed,43,30,13,69.77
Samira,Akshan,41,24,17,58.54
Samira,Velkoz,105,55,50,52.38
Samira,Veigar,162,69,93,42.59
Samira,Gragas,137,56,81,40.88
Samira,Swain,175,75,100,42.86
Samira,RekSai,19,6,13,31.58
Samira,Rumble,44,22,22,50
Samira,Jhin,361,157,204,43.49
Samira,Zyra,110,55,55,50
Samira,Chogath,162,68,94,41.98
Samira,Corki,80,45,35,56.25
Samira,Nilah,116,51,65,43.97
Samira,Thresh,262,150,112,57.25
Samira,Kayle,102,49,53,48.04
Samira,Cassiopeia,48,21,27,43.75
Samira,Gwen,82,29,53,35.37
Samira,FiddleSticks,56,20,36,35.71
Samira,Aphelios,96,56,40,58.33
Samira,Leona,171,87,84,50.88
Samira,Ryze,81,33,48,40.74
Samira,Belveth,37,22,15,59.46
Samira,Fizz,97,43,54,44.33
Samira,Ornn,122,64,58,52.46
Samira,Elise,112,50,62,44.64
Samira,Katarina,118,76,42,64.41
Samira,Lulu,194,96,98,49.48
Samira,Sion,155,66,89,42.58
Samira,Zac,84,42,42,50
Samira,Tryndamere,44,18,26,40.91
Samira,Naafiri,63,38,25,60.32
Samira,Aurora,126,53,73,42.06
Samira,Aatrox,183,91,92,49.73
Samira,Poppy,82,35,47,42.68
Samira,Nunu,123,54,69,43.9
Samira,Gangplank,90,34,56,37.78
Samira,Kindred,75,46,29,61.33
Samira,Olaf,37,9,28,24.32
Samira,KSante,132,57,75,43.18
Samira,Rengar,55,22,33,40
Samira,Khazix,91,51,40,56.04
Samira,Trundle,87,34,53,39.08
Samira,Xerath,147,80,67,54.42
Samira,Camille,63,29,34,46.03
Samira,Brand,88,48,40,54.55
Samira,Ziggs,67,34,33,50.75
Samira,Shaco,115,67,48,58.26
Samira,Rammus,63,29,34,46.03
Samira,Alistar,84,31,53,36.9
Samira,Yone,299,167,132,55.85
Samira,Soraka,77,47,30,61.04
Samira,Neeko,84,43,41,51.19
Samira,Karma,149,75,74,50.34
Samira,Pyke,157,102,55,64.97
Samira,Janna,75,45,30,60
Samira,Nidalee,58,38,20,65.52
Samira,Illaoi,70,33,37,47.14
Samira,Briar,115,72,43,62.61
Samira,Zeri,92,32,60,34.78
Samira,Lissandra,89,49,40,55.06
Samira,Shyvana,33,12,21,36.36
Samira,Twitch,154,61,93,39.61
Samira,Annie,49,22,27,44.9
Samira,Warwick,169,78,91,46.15
Samira,Udyr,63,39,24,61.9
Samira,Jayce,82,60,22,73.17
Samira,Kalista,65,40,25,61.54
Samira,Sona,22,14,8,63.64
Samira,Talon,89,56,33,62.92
Samira,Maokai,72,35,37,48.61
Samira,KogMaw,51,24,27,47.06
Samira,Lillia,96,53,43,55.21
Samira,Sivir,103,57,46,55.34
Samira,MonkeyKing,168,65,103,38.69
Samira,Bard,44,23,21,52.27
Samira,Gnar,55,38,17,69.09
Samira,Fiora,74,36,38,48.65
Samira,Karthus,46,23,23,50
Samira,Zilean,44,15,29,34.09
Samira,Renekton,114,60,54,52.63
Samira,Xayah,118,57,61,48.31
Samira,DrMundo,61,28,33,45.9
Samira,Evelynn,35,9,26,25.71
Samira,Ivern,29,21,8,72.41
Samira,Renata,48,16,32,33.33
Samira,Qiyana,37,10,27,27.03
Samira,Kennen,43,14,29,32.56
Samira,Kled,23,15,8,65.22
Lillia,Yorick,107,58,49,54.21
Lillia,Teemo,136,77,59,56.62
Lillia,Katarina,79,43,36,54.43
Lillia,Jhin,265,153,112,57.74
Lillia,Lux,260,113,147,43.46
Lillia,Volibear,141,75,66,53.19
Lillia,Elise,134,85,49,63.43
Lillia,Malzahar,128,71,57,55.47
Lillia,Caitlyn,286,147,139,51.4
Lillia,Milio,81,48,33,59.26
Lillia,Jayce,51,23,28,45.1
Lillia,Zilean,50,26,24,52
Lillia,Briar,72,47,25,65.28
Lillia,Nocturne,202,101,101,50
Lillia,Lissandra,46,17,29,36.96
Lillia,Shen,86,46,40,53.49
Lillia,Renekton,83,43,40,51.81
Lillia,Diana,190,97,93,51.05
Lillia,Varus,97,59,38,60.82
Lillia,Karma,143,80,63,55.94
Lillia,MonkeyKing,94,44,50,46.81
Lillia,Vayne,137,67,70,48.91
Lillia,Fiora,40,11,29,27.5
Lillia,Soraka,67,40,27,59.7
Lillia,Azir,54,28,26,51.85
Lillia,Ambessa,92,47,45,51.09
Lillia,LeeSin,223,122,101,54.71
Lillia,Viktor,105,46,59,43.81
Lillia,Thresh,325,146,179,44.92
Lillia,Singed,56,21,35,37.5
Lillia,Yasuo,281,166,115,59.07
Lillia,Leblanc,100,41,59,41
Lillia,Gnar,66,51,15,77.27
Lillia,Akali,153,84,69,54.9
Lillia,Lucian,113,66,47,58.41
Lillia,DrMundo,86,48,38,55.81
Lillia,Xerath,101,54,47,53.47
Lillia,Nami,112,54,58,48.21
Lillia,Warwick,141,70,71,49.65
Lillia,Graves,75,20,55,26.67
Lillia,Draven,68,37,31,54.41
Lillia,Yone,262,133,129,50.76
Lillia,Pantheon,185,88,97,47.57
Lillia,Twitch,106,45,61,42.45
Lillia,Hwei,63,31,32,49.21
Lillia,Heimerdinger,62,45,17,72.58
Lillia,JarvanIV,69,44,25,63.77
Lillia,Naafiri,39,22,17,56.41
Lillia,Jinx,307,128,179,41.69
Lillia,Nasus,81,52,29,64.2
Lillia,Ashe,230,146,84,63.48
Lillia,Mel,272,150,122,55.15
Lillia,Zac,90,39,51,43.33
Lillia,Swain,150,85,65,56.67
Lillia,Yuumi,103,29,74,28.16
Lillia,Viego,146,77,69,52.74
Lillia,Aatrox,117,51,66,43.59
Lillia,Ekko,125,71,54,56.8
Lillia,Xayah,92,48,44,52.17
Lillia,Shaco,93,52,41,55.91
Lillia,Sett,172,105,67,61.05
Lillia,Fizz,60,25,35,41.67
Lillia,Garen,184,77,107,41.85
Lillia,Kayn,141,67,74,47.52
Lillia,Ahri,179,98,81,54.75
Lillia,Ezreal,312,136,176,43.59
Lillia,Corki,45,23,22,51.11
Lillia,Nilah,45,23,22,51.11
Lillia,Gangplank,71,30,41,42.25
Lillia,Poppy,115,59,56,51.3
Lillia,Aphelios,70,34,36,48.57
Lillia,Vex,91,50,41,54.95
Lillia,Lulu,187,98,89,52.41
Lillia,TahmKench,109,43,66,39.45
Lillia,MasterYi,104,63,41,60.58
Lillia,Blitzcrank,115,69,46,60
Lillia,Darius,226,107,119,47.35
Lillia,FiddleSticks,54,31,23,57.41
Lillia,KogMaw,49,15,34,30.61
Lillia,Malphite,131,61,70,46.56
Lillia,Rammus,55,41,14,74.55
Lillia,Zyra,109,58,51,53.21
Lillia,Ornn,68,36,32,52.94
Lillia,Irelia,89,35,54,39.33
Lillia,Kaisa,198,106,92,53.54
Lillia,Mordekaiser,129,69,60,53.49
Lillia,Alistar,64,35,29,54.69
Lillia,KSante,144,89,55,61.81
Lillia,Sejuani,113,57,56,50.44
Lillia,MissFortune,265,146,119,55.09
Lillia,Rell,73,41,32,56.16
Lillia,Karthus,50,14,36,28
Lillia,Pyke,69,37,32,53.62
Lillia,Trundle,72,32,40,44.44
Lillia,Nautilus,199,96,103,48.24
Lillia,Kayle,76,30,46,39.47
Lillia,Vladimir,60,30,30,50
Lillia,Tryndamere,53,30,23,56.6
Lillia,Kassadin,28,25,3,89.29
Lillia,Jax,120,76,44,63.33
Lillia,Riven,45,20,25,44.44
Lillia,Orianna,103,49,54,47.57
Lillia,Rumble,48,33,15,68.75
Lillia,Braum,119,61,58,51.26
Lillia,Seraphine,68,31,37,45.59
Lillia,Udyr,67,49,18,73.13
Lillia,Kalista,37,19,18,51.35
Lillia,Kennen,33,22,11,66.67
Lillia,Rakan,63,34,29,53.97
Lillia,Quinn,47,18,29,38.3
Lillia,Shyvana,23,9,14,39.13
Lillia,AurelionSol,74,33,41,44.59
Lillia,Vi,148,72,76,48.65
Lillia,Aurora,115,70,45,60.87
Lillia,Talon,75,36,39,48
Lillia,Syndra,75,38,37,50.67
Lillia,Rengar,23,11,12,47.83
Lillia,Skarner,81,49,32,60.49
Lillia,Gragas,119,63,56,52.94
Lillia,XinZhao,86,44,42,51.16
Lillia,Ryze,30,13,17,43.33
Lillia,Cassiopeia,37,15,22,40.54
Lillia,Veigar,153,82,71,53.59
Lillia,Amumu,134,53,81,39.55
Lillia,Ivern,22,12,10,54.55
Lillia,Nunu,64,35,29,54.69
Lillia,Khazix,88,42,46,47.73
Lillia,Annie,37,14,23,37.84
Lillia,Akshan,32,12,20,37.5
Lillia,Zeri,68,26,42,38.24
Lillia,Brand,76,33,43,43.42
Lillia,Zed,81,48,33,59.26
Lillia,Chogath,174,89,85,51.15
Lillia,Taliyah,27,14,13,51.85
Lillia,Taric,31,18,13,58.06
Lillia,Morgana,145,58,87,40
Lillia,Hecarim,46,14,32,30.43
Lillia,Samira,96,43,53,44.79
Lillia,Sylas,183,81,102,44.26
Lillia,Neeko,42,14,28,33.33
Lillia,Sion,83,47,36,56.63
Lillia,Renata,43,25,18,58.14
Lillia,Maokai,63,25,38,39.68
Lillia,Gwen,41,15,26,36.59
Lillia,Galio,146,74,72,50.68
Lillia,Urgot,72,32,40,44.44
Lillia,Anivia,40,8,32,20
Lillia,Velkoz,47,19,28,40.43
Lillia,TwistedFate,65,36,29,55.38
Lillia,Kindred,74,40,34,54.05
Lillia,Senna,72,25,47,34.72
Lillia,Ziggs,25,14,11,56
Lillia,Sona,14,6,8,42.86
Lillia,Illaoi,71,42,29,59.15
Lillia,Tristana,115,57,58,49.57
Lillia,Leona,119,68,51,57.14
Lillia,Janna,31,18,13,58.06
Lillia,Smolder,84,41,43,48.81
Lillia,Nidalee,47,27,20,57.45
Lillia,Kled,23,0,23,0
Lillia,Qiyana,12,8,4,66.67
Lillia,Sivir,70,32,38,45.71
Lillia,Bard,31,15,16,48.39
Lillia,Evelynn,41,11,30,26.83
Lillia,Camille,44,18,26,40.91
Lillia,RekSai,17,11,6,64.71
Lillia,Olaf,30,15,15,50
Lillia,Belveth,12,6,6,50
Lillia,Zoe,26,8,18,30.77
Tryndamere,Yorick,90,64,26,71.11
Tryndamere,Teemo,77,31,46,40.26
Tryndamere,Katarina,68,28,40,41.18
Tryndamere,Jhin,167,90,77,53.89
Tryndamere,Lux,198,103,95,52.02
Tryndamere,Trundle,47,30,17,63.83
Tryndamere,Twitch,61,28,33,45.9
Tryndamere,Ahri,150,81,69,54
Tryndamere,Graves,67,37,30,55.22
Tryndamere,Lulu,120,50,70,41.67
Tryndamere,Skarner,32,17,15,53.13
Tryndamere,Mel,165,79,86,47.88
Tryndamere,Smolder,52,40,12,76.92
Tryndamere,Senna,50,30,20,60
Tryndamere,Jayce,36,14,22,38.89
Tryndamere,Sejuani,53,23,30,43.4
Tryndamere,Fizz,43,22,21,51.16
Tryndamere,Caitlyn,188,87,101,46.28
Tryndamere,Alistar,31,10,21,32.26
Tryndamere,Sion,69,28,41,40.58
Tryndamere,MasterYi,92,55,37,59.78
Tryndamere,Xayah,65,24,41,36.92
Tryndamere,Seraphine,46,35,11,76.09
Tryndamere,Riven,23,13,10,56.52
Tryndamere,Viego,102,54,48,52.94
Tryndamere,Naafiri,27,18,9,66.67
Tryndamere,Ashe,135,59,76,43.7
Tryndamere,Nami,97,48,49,49.48
Tryndamere,Garen,168,91,77,54.17
Tryndamere,FiddleSticks,51,21,30,41.18
Tryndamere,Xerath,77,26,51,33.77
Tryndamere,Swain,73,34,39,46.58
Tryndamere,Jax,88,43,45,48.86
Tryndamere,Amumu,97,54,43,55.67
Tryndamere,KSante,47,23,24,48.94
Tryndamere,Malzahar,80,34,46,42.5
Tryndamere,Tristana,102,55,47,53.92
Tryndamere,Leona,74,36,38,48.65
Tryndamere,Darius,166,85,81,51.2
Tryndamere,Khazix,41,20,21,48.78
Tryndamere,Qiyana,16,7,9,43.75
Tryndamere,Morgana,114,46,68,40.35
Tryndamere,Singed,25,11,14,44
Tryndamere,Talon,29,12,17,41.38
Tryndamere,Draven,25,6,19,24
Tryndamere,Thresh,141,87,54,61.7
Tryndamere,Mordekaiser,147,78,69,53.06
Tryndamere,LeeSin,162,83,79,51.23
Tryndamere,Jinx,241,91,150,37.76
Tryndamere,Belveth,18,10,8,55.56
Tryndamere,Hwei,63,33,30,52.38
Tryndamere,Yasuo,149,87,62,58.39
Tryndamere,Rakan,53,30,23,56.6
Tryndamere,Sylas,86,38,48,44.19
Tryndamere,Shaco,60,21,39,35
Tryndamere,Vladimir,56,28,28,50
Tryndamere,Ornn,31,18,13,58.06
Tryndamere,Rell,46,21,25,45.65
Tryndamere,TahmKench,86,45,41,52.33
Tryndamere,Cassiopeia,14,9,5,64.29
Tryndamere,Zeri,20,5,15,25
Tryndamere,Janna,23,8,15,34.78
Tryndamere,Urgot,45,24,21,53.33
Tryndamere,Kayn,103,46,57,44.66
Tryndamere,MissFortune,191,109,82,57.07
Tryndamere,Karma,116,64,52,55.17
Tryndamere,JarvanIV,58,25,33,43.1
Tryndamere,Nasus,48,17,31,35.42
Tryndamere,Malphite,150,67,83,44.67
Tryndamere,Samira,44,26,18,59.09
Tryndamere,Orianna,44,27,17,61.36
Tryndamere,Yuumi,74,40,34,54.05
Tryndamere,Yone,140,60,80,42.86
Tryndamere,Milio,79,28,51,35.44
Tryndamere,XinZhao,58,32,26,55.17
Tryndamere,Lillia,53,23,30,43.4
Tryndamere,Aatrox,69,38,31,55.07
Tryndamere,Pantheon,95,40,55,42.11
Tryndamere,Veigar,76,43,33,56.58
Tryndamere,Ivern,30,22,8,73.33
Tryndamere,Ekko,80,25,55,31.25
Tryndamere,Varus,57,19,38,33.33
Tryndamere,Renata,22,15,7,68.18
Tryndamere,Gnar,39,20,19,51.28
Tryndamere,AurelionSol,33,15,18,45.45
Tryndamere,Ezreal,187,85,102,45.45
Tryndamere,Gwen,44,32,12,72.73
Tryndamere,MonkeyKing,69,29,40,42.03
Tryndamere,Azir,18,10,8,55.56
Tryndamere,Shyvana,20,8,12,40
Tryndamere,Ambessa,79,39,40,49.37
Tryndamere,Vi,73,44,29,60.27
Tryndamere,Brand,65,33,32,50.77
Tryndamere,Gangplank,35,22,13,62.86
Tryndamere,Ziggs,37,26,11,70.27
Tryndamere,Rengar,39,13,26,33.33
Tryndamere,Quinn,35,20,15,57.14
Tryndamere,Udyr,20,3,17,15
Tryndamere,Kaisa,154,80,74,51.95
Tryndamere,Rammus,48,32,16,66.67
Tryndamere,Leblanc,40,9,31,22.5
Tryndamere,Nidalee,26,9,17,34.62
Tryndamere,Warwick,98,35,63,35.71
Tryndamere,Vayne,100,43,57,43
Tryndamere,KogMaw,30,6,24,20
Tryndamere,Nocturne,79,45,34,56.96
Tryndamere,Taliyah,27,16,11,59.26
Tryndamere,Galio,76,44,32,57.89
Tryndamere,Zed,52,22,30,42.31
Tryndamere,Shen,77,40,37,51.95
Tryndamere,Nunu,63,25,38,39.68
Tryndamere,Aurora,69,29,40,42.03
Tryndamere,Heimerdinger,47,29,18,61.7
Tryndamere,Akali,93,62,31,66.67
Tryndamere,Volibear,74,32,42,43.24
Tryndamere,Pyke,81,38,43,46.91
Tryndamere,Zac,41,14,27,34.15
Tryndamere,Soraka,40,26,14,65
Tryndamere,Chogath,116,54,62,46.55
Tryndamere,Kennen,22,11,11,50
Tryndamere,Zyra,81,34,47,41.98
Tryndamere,Sett,92,32,60,34.78
Tryndamere,Gragas,53,25,28,47.17
Tryndamere,DrMundo,39,13,26,33.33
Tryndamere,Blitzcrank,74,33,41,44.59
Tryndamere,Kindred,33,23,10,69.7
Tryndamere,Lissandra,35,23,12,65.71
Tryndamere,Karthus,22,15,7,68.18
Tryndamere,Kassadin,17,10,7,58.82
Tryndamere,Bard,31,14,17,45.16
Tryndamere,Olaf,14,5,9,35.71
Tryndamere,Elise,47,12,35,25.53
Tryndamere,Braum,58,19,39,32.76
Tryndamere,Poppy,41,17,24,41.46
Tryndamere,Zoe,42,28,14,66.67
Tryndamere,Kled,19,9,10,47.37
Tryndamere,Lucian,45,26,19,57.78
Tryndamere,Vex,50,29,21,58
Tryndamere,Kayle,47,22,25,46.81
Tryndamere,Neeko,29,11,18,37.93
Tryndamere,Fiora,26,13,13,50
Tryndamere,Rumble,18,12,6,66.67
Tryndamere,Nautilus,91,41,50,45.05
Tryndamere,RekSai,19,7,12,36.84
Tryndamere,Viktor,69,33,36,47.83
Tryndamere,Akshan,25,8,17,32
Tryndamere,Anivia,25,6,19,24
Tryndamere,Annie,19,10,9,52.63
Tryndamere,Aphelios,36,27,9,75
Tryndamere,Velkoz,35,16,19,45.71
Tryndamere,Briar,38,24,14,63.16
Tryndamere,Syndra,59,31,28,52.54
Tryndamere,Hecarim,26,10,16,38.46
Tryndamere,Diana,124,63,61,50.81
Tryndamere,Sivir,35,20,15,57.14
Tryndamere,Irelia,64,26,38,40.63
Tryndamere,Corki,43,19,24,44.19
Tryndamere,Maokai,38,18,20,47.37
Tryndamere,Illaoi,42,16,26,38.1
Tryndamere,Evelynn,40,26,14,65
Tryndamere,Renekton,32,13,19,40.63
Tryndamere,Camille,28,9,19,32.14
Tryndamere,TwistedFate,21,9,12,42.86
Tryndamere,Kalista,34,17,17,50
Tryndamere,Ryze,16,5,11,31.25
Tryndamere,Taric,21,10,11,47.62
Tryndamere,Nilah,38,21,17,55.26
Tryndamere,Zilean,15,6,9,40
Tryndamere,Sona,6,0,6,0
Yorick,Chogath,259,108,151,41.7
Yorick,Lillia,107,49,58,45.79
Yorick,Tryndamere,90,26,64,28.89
Yorick,Caitlyn,499,238,261,47.7
Yorick,Karma,194,74,120,38.14
Yorick,Garen,276,158,118,57.25
Yorick,Shaco,126,62,64,49.21
Yorick,Tristana,153,84,69,54.9
Yorick,Ezreal,412,221,191,53.64
Yorick,Swain,170,70,100,41.18
Yorick,Urgot,109,59,50,54.13
Yorick,Kayn,191,104,87,54.45
Yorick,Vladimir,118,72,46,61.02
Yorick,Kaisa,253,163,90,64.43
Yorick,Taric,51,38,13,74.51
Yorick,Shen,118,66,52,55.93
Yorick,Heimerdinger,83,46,37,55.42
Yorick,Thresh,321,160,161,49.84
Yorick,Twitch,160,67,93,41.88
Yorick,Katarina,103,82,21,79.61
Yorick,Vayne,232,125,107,53.88
Yorick,Blitzcrank,178,100,78,56.18
Yorick,Volibear,171,64,107,37.43
Yorick,Hwei,91,48,43,52.75
Yorick,Vi,181,96,85,53.04
Yorick,Xerath,135,67,68,49.63
Yorick,Braum,154,73,81,47.4
Yorick,Naafiri,58,29,29,50
Yorick,Warwick,267,124,143,46.44
Yorick,Mel,352,209,143,59.38
Yorick,Ashe,383,202,181,52.74
Yorick,Janna,34,23,11,67.65
Yorick,TahmKench,142,51,91,35.92
Yorick,Rengar,48,25,23,52.08
Yorick,Yone,315,160,155,50.79
Yorick,Zyra,152,73,79,48.03
Yorick,Darius,313,184,129,58.79
Yorick,Ekko,184,100,84,54.35
Yorick,Neeko,87,38,49,43.68
Yorick,KSante,110,83,27,75.45
Yorick,Zilean,57,29,28,50.88
Yorick,Nunu,173,97,76,56.07
Yorick,Kennen,56,22,34,39.29
Yorick,Samira,163,67,96,41.1
Yorick,Rell,121,65,56,53.72
Yorick,Jayce,96,47,49,48.96
Yorick,Graves,86,46,40,53.49
Yorick,Lux,418,222,196,53.11
Yorick,Seraphine,120,66,54,55
Yorick,Trundle,140,70,70,50
Yorick,Khazix,91,32,59,35.16
Yorick,Veigar,196,105,91,53.57
Yorick,Smolder,149,103,46,69.13
Yorick,Sylas,213,111,102,52.11
Yorick,Ahri,223,115,108,51.57
Yorick,Renekton,109,67,42,61.47
Yorick,Elise,125,68,57,54.4
Yorick,Jinx,354,176,178,49.72
Yorick,MissFortune,381,202,179,53.02
Yorick,MasterYi,176,117,59,66.48
Yorick,Fizz,83,60,23,72.29
Yorick,Hecarim,50,27,23,54
Yorick,Kassadin,38,11,27,28.95
Yorick,Varus,157,82,75,52.23
Yorick,Alistar,85,51,34,60
Yorick,Kayle,111,66,45,59.46
Yorick,Nidalee,55,44,11,80
Yorick,Gnar,103,55,48,53.4
Yorick,Udyr,80,48,32,60
Yorick,Aatrox,168,96,72,57.14
Yorick,Nautilus,251,139,112,55.38
Yorick,Sion,138,60,78,43.48
Yorick,RekSai,24,16,8,66.67
Yorick,Lissandra,87,53,34,60.92
Yorick,Senna,113,64,49,56.64
Yorick,Irelia,146,76,70,52.05
Yorick,Amumu,282,137,145,48.58
Yorick,Xayah,105,51,54,48.57
Yorick,Gangplank,83,38,45,45.78
Yorick,Zoe,66,29,37,43.94
Yorick,FiddleSticks,59,38,21,64.41
Yorick,Kalista,59,26,33,44.07
Yorick,Galio,160,90,70,56.25
Yorick,Zed,193,90,103,46.63
Yorick,Draven,86,71,15,82.56
Yorick,Rakan,78,38,40,48.72
Yorick,Nocturne,264,123,141,46.59
Yorick,Taliyah,44,25,19,56.82
Yorick,Sejuani,111,62,49,55.86
Yorick,Mordekaiser,240,132,108,55
Yorick,Gwen,96,42,54,43.75
Yorick,Yasuo,348,173,175,49.71
Yorick,Leona,217,134,83,61.75
Yorick,Jhin,361,169,192,46.81
Yorick,Poppy,102,65,37,63.73
Yorick,Rumble,46,25,21,54.35
Yorick,Briar,148,82,66,55.41
Yorick,Nasus,139,64,75,46.04
Yorick,Malzahar,189,97,92,51.32
Yorick,Vex,118,56,62,47.46
Yorick,Azir,108,64,44,59.26
Yorick,Zac,96,44,52,45.83
Yorick,Corki,88,46,42,52.27
Yorick,Akali,173,75,98,43.35
Yorick,Nami,199,111,88,55.78
Yorick,Pyke,181,99,82,54.7
Yorick,Rammus,66,33,33,50
Yorick,Morgana,188,87,101,46.28
Yorick,Viego,266,147,119,55.26
Yorick,Milio,116,53,63,45.69
Yorick,Teemo,192,90,102,46.88
Yorick,Pantheon,310,147,163,47.42
Yorick,Ambessa,119,60,59,50.42
Yorick,Skarner,85,39,46,45.88
Yorick,Malphite,203,106,97,52.22
Yorick,Lucian,146,76,70,52.05
Yorick,Renata,40,21,19,52.5
Yorick,Shyvana,69,25,44,36.23
Yorick,Belveth,39,20,19,51.28
Yorick,Ryze,62,28,34,45.16
Yorick,Ziggs,41,23,18,56.1
Yorick,Riven,69,35,34,50.72
Yorick,Zeri,101,42,59,41.58
Yorick,Maokai,83,45,38,54.22
Yorick,Qiyana,42,29,13,69.05
Yorick,Viktor,153,83,70,54.25
Yorick,Orianna,97,40,57,41.24
Yorick,Singed,70,30,40,42.86
Yorick,LeeSin,201,94,107,46.77
Yorick,Yuumi,140,64,76,45.71
Yorick,Illaoi,98,53,45,54.08
Yorick,Kindred,81,48,33,59.26
Yorick,Leblanc,101,53,48,52.48
Yorick,Soraka,70,30,40,42.86
Yorick,Jax,141,68,73,48.23
Yorick,Ivern,52,22,30,42.31
Yorick,Syndra,128,61,67,47.66
Yorick,Gragas,92,52,40,56.52
Yorick,JarvanIV,142,75,67,52.82
Yorick,Nilah,50,20,30,40
Yorick,Ornn,99,59,40,59.6
Yorick,Aphelios,118,57,61,48.31
Yorick,Evelynn,40,18,22,45
Yorick,Aurora,140,75,65,53.57
Yorick,Fiora,56,24,32,42.86
Yorick,Camille,37,13,24,35.14
Yorick,Brand,113,69,44,61.06
Yorick,KogMaw,89,59,30,66.29
Yorick,MonkeyKing,116,63,53,54.31
Yorick,Kled,17,11,6,64.71
Yorick,Velkoz,101,57,44,56.44
Yorick,DrMundo,100,61,39,61
Yorick,Annie,52,23,29,44.23
Yorick,Quinn,61,27,34,44.26
Yorick,Lulu,227,122,105,53.74
Yorick,Sona,37,23,14,62.16
Yorick,Karthus,45,24,21,53.33
Yorick,Diana,246,114,132,46.34
Yorick,XinZhao,99,59,40,59.6
Yorick,Sett,258,124,134,48.06
Yorick,Akshan,51,36,15,70.59
Yorick,Talon,76,42,34,55.26
Yorick,TwistedFate,76,39,37,51.32
Yorick,Sivir,90,36,54,40
Yorick,AurelionSol,74,21,53,28.38
Yorick,Olaf,39,20,19,51.28
Yorick,Cassiopeia,33,19,14,57.58
Yorick,Anivia,69,33,36,47.83
Yorick,Bard,73,46,27,63.01
DrMundo,Malphite,103,50,53,48.54
DrMundo,Vi,106,45,61,42.45
DrMundo,Veigar,138,63,75,45.65
DrMundo,Sivir,86,35,51,40.7
DrMundo,Senna,90,47,43,52.22
DrMundo,Olaf,33,15,18,45.45
DrMundo,Kayn,168,106,62,63.1
DrMundo,Yasuo,151,72,79,47.68
DrMundo,Galio,134,71,63,52.99
DrMundo,Velkoz,64,41,23,64.06
DrMundo,Malzahar,141,63,78,44.68
DrMundo,Ahri,170,72,98,42.35
DrMundo,MissFortune,286,126,160,44.06
DrMundo,Amumu,152,65,87,42.76
DrMundo,Yone,181,117,64,64.64
DrMundo,Talon,44,30,14,68.18
DrMundo,Vladimir,68,24,44,35.29
DrMundo,Swain,118,67,51,56.78
DrMundo,Thresh,240,119,121,49.58
DrMundo,Ornn,93,43,50,46.24
DrMundo,Zac,82,41,41,50
DrMundo,Zed,127,71,56,55.91
DrMundo,Varus,81,34,47,41.98
DrMundo,Soraka,54,28,26,51.85
DrMundo,KSante,66,43,23,65.15
DrMundo,Gragas,63,21,42,33.33
DrMundo,Irelia,101,46,55,45.54
DrMundo,Caitlyn,265,131,134,49.43
DrMundo,Rell,70,22,48,31.43
DrMundo,Lillia,86,38,48,44.19
DrMundo,Jayce,46,26,20,56.52
DrMundo,Smolder,51,24,27,47.06
DrMundo,Milio,101,35,66,34.65
DrMundo,Aatrox,107,53,54,49.53
DrMundo,Pantheon,182,92,90,50.55
DrMundo,AurelionSol,61,27,34,44.26
DrMundo,Lux,286,173,113,60.49
DrMundo,Quinn,35,24,11,68.57
DrMundo,Nidalee,38,17,21,44.74
DrMundo,Mel,248,115,133,46.37
DrMundo,Aphelios,56,28,28,50
DrMundo,Jax,122,66,56,54.1
DrMundo,LeeSin,185,104,81,56.22
DrMundo,Jinx,274,134,140,48.91
DrMundo,Camille,38,14,24,36.84
DrMundo,Udyr,48,19,29,39.58
DrMundo,Viktor,123,51,72,41.46
DrMundo,Jhin,141,79,62,56.03
DrMundo,TahmKench,114,56,58,49.12
DrMundo,Mordekaiser,161,99,62,61.49
DrMundo,Hwei,70,47,23,67.14
DrMundo,Ashe,217,98,119,45.16
DrMundo,Trundle,89,51,38,57.3
DrMundo,Singed,45,28,17,62.22
DrMundo,Leblanc,56,23,33,41.07
DrMundo,Ezreal,276,136,140,49.28
DrMundo,FiddleSticks,80,47,33,58.75
DrMundo,Sion,86,36,50,41.86
DrMundo,MasterYi,126,83,43,65.87
DrMundo,Darius,180,82,98,45.56
DrMundo,Nunu,79,36,43,45.57
DrMundo,Katarina,83,39,44,46.99
DrMundo,Lucian,127,76,51,59.84
DrMundo,Karma,116,56,60,48.28
DrMundo,Riven,24,5,19,20.83
DrMundo,Nocturne,164,65,99,39.63
DrMundo,Sett,169,72,97,42.6
DrMundo,Lulu,175,82,93,46.86
DrMundo,Aurora,103,70,33,67.96
DrMundo,Warwick,175,60,115,34.29
DrMundo,Diana,137,68,69,49.64
DrMundo,Anivia,50,14,36,28
DrMundo,Kaisa,201,96,105,47.76
DrMundo,Nautilus,156,87,69,55.77
DrMundo,Briar,59,27,32,45.76
DrMundo,Vex,46,24,22,52.17
DrMundo,Poppy,84,44,40,52.38
DrMundo,Akali,85,46,39,54.12
DrMundo,Draven,57,35,22,61.4
DrMundo,Nami,128,62,66,48.44
DrMundo,Seraphine,59,17,42,28.81
DrMundo,Maokai,48,17,31,35.42
DrMundo,Twitch,78,31,47,39.74
DrMundo,Shen,74,43,31,58.11
DrMundo,Skarner,56,24,32,42.86
DrMundo,Kayle,60,27,33,45
DrMundo,Brand,69,29,40,42.03
DrMundo,Braum,98,54,44,55.1
DrMundo,Xayah,67,28,39,41.79
DrMundo,Chogath,203,79,124,38.92
DrMundo,Ambessa,44,28,16,63.64
DrMundo,Zoe,51,37,14,72.55
DrMundo,Garen,211,106,105,50.24
DrMundo,Volibear,144,72,72,50
DrMundo,Ekko,93,46,47,49.46
DrMundo,Fiora,49,33,16,67.35
DrMundo,XinZhao,56,28,28,50
DrMundo,Fizz,75,24,51,32
DrMundo,Evelynn,36,17,19,47.22
DrMundo,Alistar,57,21,36,36.84
DrMundo,Sejuani,79,34,45,43.04
DrMundo,Kindred,39,22,17,56.41
DrMundo,Lissandra,39,11,28,28.21
DrMundo,Heimerdinger,75,32,43,42.67
DrMundo,Yuumi,86,51,35,59.3
DrMundo,Ivern,22,13,9,59.09
DrMundo,Kassadin,37,16,21,43.24
DrMundo,Vayne,170,61,109,35.88
DrMundo,Orianna,58,30,28,51.72
DrMundo,Janna,20,9,11,45
DrMundo,Ziggs,63,44,19,69.84
DrMundo,Blitzcrank,101,63,38,62.38
DrMundo,Ryze,52,30,22,57.69
DrMundo,Elise,95,35,60,36.84
DrMundo,Shyvana,46,20,26,43.48
DrMundo,TwistedFate,40,25,15,62.5
DrMundo,Yorick,100,39,61,39
DrMundo,Rammus,25,11,14,44
DrMundo,Gnar,54,38,16,70.37
DrMundo,Nasus,66,32,34,48.48
DrMundo,KogMaw,29,14,15,48.28
DrMundo,Morgana,94,59,35,62.77
DrMundo,Akshan,36,20,16,55.56
DrMundo,Hecarim,59,20,39,33.9
DrMundo,Taliyah,25,12,13,48
DrMundo,Zyra,91,54,37,59.34
DrMundo,Renekton,42,12,30,28.57
DrMundo,Gwen,51,24,27,47.06
DrMundo,Sylas,122,69,53,56.56
DrMundo,JarvanIV,76,23,53,30.26
DrMundo,Bard,35,19,16,54.29
DrMundo,Gangplank,44,32,12,72.73
DrMundo,Pyke,84,36,48,42.86
DrMundo,Illaoi,55,17,38,30.91
DrMundo,Tristana,100,44,56,44
DrMundo,Rumble,37,8,29,21.62
DrMundo,Xerath,85,27,58,31.76
DrMundo,Teemo,88,62,26,70.45
DrMundo,Rakan,62,22,40,35.48
DrMundo,Taric,20,12,8,60
DrMundo,Annie,30,8,22,26.67
DrMundo,Tryndamere,39,26,13,66.67
DrMundo,Shaco,59,33,26,55.93
DrMundo,Belveth,28,12,16,42.86
DrMundo,MonkeyKing,89,43,46,48.31
DrMundo,Viego,133,64,69,48.12
DrMundo,Nilah,36,18,18,50
DrMundo,Graves,62,41,21,66.13
DrMundo,Urgot,55,27,28,49.09
DrMundo,RekSai,14,3,11,21.43
DrMundo,Samira,61,33,28,54.1
DrMundo,Renata,29,5,24,17.24
DrMundo,Corki,62,31,31,50
DrMundo,Naafiri,18,8,10,44.44
DrMundo,Kalista,33,26,7,78.79
DrMundo,Zeri,53,34,19,64.15
DrMundo,Syndra,78,46,32,58.97
DrMundo,Rengar,38,27,11,71.05
DrMundo,Qiyana,24,15,9,62.5
DrMundo,Zilean,34,11,23,32.35
DrMundo,Khazix,55,33,22,60
DrMundo,Leona,93,47,46,50.54
DrMundo,Neeko,31,16,15,51.61
DrMundo,Kled,28,10,18,35.71
DrMundo,Sona,39,22,17,56.41
DrMundo,Cassiopeia,31,12,19,38.71
DrMundo,Azir,28,10,18,35.71
DrMundo,Kennen,35,18,17,51.43
DrMundo,Karthus,24,16,8,66.67
TwistedFate,Malphite,65,40,25,61.54
TwistedFate,Vi,132,69,63,52.27
TwistedFate,Veigar,65,34,31,52.31
TwistedFate,Sivir,48,13,35,27.08
TwistedFate,Senna,58,26,32,44.83
TwistedFate,Jayce,46,18,28,39.13
TwistedFate,Hecarim,19,11,8,57.89
TwistedFate,Milio,46,18,28,39.13
TwistedFate,Caitlyn,164,80,84,48.78
TwistedFate,Zoe,51,22,29,43.14
TwistedFate,Garen,103,37,66,35.92
TwistedFate,Shyvana,17,9,8,52.94
TwistedFate,Lissandra,42,23,19,54.76
TwistedFate,Lux,167,82,85,49.1
TwistedFate,Nasus,46,13,33,28.26
TwistedFate,Amumu,110,43,67,39.09
TwistedFate,Sylas,149,59,90,39.6
TwistedFate,Twitch,77,35,42,45.45
TwistedFate,Lulu,91,53,38,58.24
TwistedFate,Darius,143,93,50,65.03
TwistedFate,Graves,82,44,38,53.66
TwistedFate,Neeko,43,17,26,39.53
TwistedFate,Draven,55,25,30,45.45
TwistedFate,Alistar,62,21,41,33.87
TwistedFate,Kayle,41,21,20,51.22
TwistedFate,Viego,106,52,54,49.06
TwistedFate,Yasuo,104,47,57,45.19
TwistedFate,Jhin,156,64,92,41.03
TwistedFate,Braum,64,18,46,28.13
TwistedFate,Swain,89,34,55,38.2
TwistedFate,Volibear,55,25,30,45.45
TwistedFate,Kalista,42,22,20,52.38
TwistedFate,Rell,50,22,28,44
TwistedFate,Warwick,82,41,41,50
TwistedFate,LeeSin,155,88,67,56.77
TwistedFate,Viktor,75,34,41,45.33
TwistedFate,Lucian,107,59,48,55.14
TwistedFate,Nami,90,52,38,57.78
TwistedFate,Seraphine,51,29,22,56.86
TwistedFate,Ezreal,202,110,92,54.46
TwistedFate,MasterYi,87,32,55,36.78
TwistedFate,Ekko,34,23,11,67.65
TwistedFate,Shaco,74,42,32,56.76
TwistedFate,Briar,49,15,34,30.61
TwistedFate,Akshan,18,13,5,72.22
TwistedFate,Samira,70,37,33,52.86
TwistedFate,Quinn,40,14,26,35
TwistedFate,Ambessa,80,40,40,50
TwistedFate,Brand,56,24,32,42.86
TwistedFate,Chogath,73,26,47,35.62
TwistedFate,Khazix,36,9,27,25
TwistedFate,Hwei,58,24,34,41.38
TwistedFate,Jinx,181,70,111,38.67
TwistedFate,Thresh,153,62,91,40.52
TwistedFate,Heimerdinger,24,10,14,41.67
TwistedFate,Xayah,60,41,19,68.33
TwistedFate,Rakan,76,33,43,43.42
TwistedFate,Kayn,73,37,36,50.68
TwistedFate,Malzahar,92,47,45,51.09
TwistedFate,Kaisa,123,69,54,56.1
TwistedFate,Sion,72,25,47,34.72
TwistedFate,JarvanIV,77,40,37,51.95
TwistedFate,Nunu,47,27,20,57.45
TwistedFate,Pantheon,141,68,73,48.23
TwistedFate,Azir,24,15,9,62.5
TwistedFate,Elise,53,22,31,41.51
TwistedFate,Aurora,57,29,28,50.88
TwistedFate,Nilah,32,16,16,50
TwistedFate,Mel,102,57,45,55.88
TwistedFate,Karma,101,44,57,43.56
TwistedFate,Maokai,22,12,10,54.55
TwistedFate,Ahri,114,64,50,56.14
TwistedFate,Nautilus,117,73,44,62.39
TwistedFate,Zed,80,41,39,51.25
TwistedFate,Jax,64,39,25,60.94
TwistedFate,Blitzcrank,80,41,39,51.25
TwistedFate,Katarina,57,26,31,45.61
TwistedFate,TahmKench,50,28,22,56
TwistedFate,Poppy,56,29,27,51.79
TwistedFate,Yone,135,55,80,40.74
TwistedFate,MissFortune,165,87,78,52.73
TwistedFate,Taric,21,10,11,47.62
TwistedFate,Urgot,30,16,14,53.33
TwistedFate,Gragas,68,32,36,47.06
TwistedFate,Olaf,20,6,14,30
TwistedFate,Irelia,48,13,35,27.08
TwistedFate,Ashe,133,68,65,51.13
TwistedFate,Varus,71,34,37,47.89
TwistedFate,Galio,105,61,44,58.1
TwistedFate,Singed,15,2,13,13.33
TwistedFate,Tristana,58,19,39,32.76
TwistedFate,DrMundo,40,15,25,37.5
TwistedFate,Trundle,33,12,21,36.36
TwistedFate,Nocturne,75,29,46,38.67
TwistedFate,Riven,23,8,15,34.78
TwistedFate,Kindred,28,14,14,50
TwistedFate,Rumble,23,13,10,56.52
TwistedFate,Karthus,11,0,11,0
TwistedFate,AurelionSol,50,22,28,44
TwistedFate,Diana,109,51,58,46.79
TwistedFate,Smolder,61,42,19,68.85
TwistedFate,KogMaw,28,17,11,60.71
TwistedFate,Xerath,93,38,55,40.86
TwistedFate,Mordekaiser,87,33,54,37.93
TwistedFate,Rammus,30,16,14,53.33
TwistedFate,Morgana,70,34,36,48.57
TwistedFate,Sett,122,70,52,57.38
TwistedFate,Orianna,30,13,17,43.33
TwistedFate,Belveth,15,9,6,60
TwistedFate,Naafiri,17,3,14,17.65
TwistedFate,Yorick,76,37,39,48.68
TwistedFate,Camille,36,15,21,41.67
TwistedFate,MonkeyKing,49,21,28,42.86
TwistedFate,Aatrox,88,47,41,53.41
TwistedFate,Taliyah,35,20,15,57.14
TwistedFate,Ryze,56,26,30,46.43
TwistedFate,Soraka,44,16,28,36.36
TwistedFate,Nidalee,30,15,15,50
TwistedFate,Rengar,22,12,10,54.55
TwistedFate,Bard,22,9,13,40.91
TwistedFate,Vayne,87,48,39,55.17
TwistedFate,Teemo,76,32,44,42.11
TwistedFate,Renekton,42,19,23,45.24
TwistedFate,Cassiopeia,24,4,20,16.67
TwistedFate,Sona,18,6,12,33.33
TwistedFate,Ziggs,34,17,17,50
TwistedFate,Zac,52,12,40,23.08
TwistedFate,Zilean,30,15,15,50
TwistedFate,Shen,64,28,36,43.75
TwistedFate,Udyr,33,21,12,63.64
TwistedFate,Yuumi,67,32,35,47.76
TwistedFate,Lillia,65,29,36,44.62
TwistedFate,Vex,43,19,24,44.19
TwistedFate,Gwen,47,27,20,57.45
TwistedFate,XinZhao,47,20,27,42.55
TwistedFate,Gnar,35,24,11,68.57
TwistedFate,Talon,48,28,20,58.33
TwistedFate,Zeri,34,14,20,41.18
TwistedFate,KSante,64,36,28,56.25
TwistedFate,Leona,86,53,33,61.63
TwistedFate,Skarner,39,10,29,25.64
TwistedFate,Kled,7,2,5,28.57
TwistedFate,Corki,34,15,19,44.12
TwistedFate,Sejuani,36,20,16,55.56
TwistedFate,Akali,59,27,32,45.76
TwistedFate,Syndra,52,22,30,42.31
TwistedFate,Illaoi,41,26,15,63.41
TwistedFate,FiddleSticks,36,24,12,66.67
TwistedFate,Leblanc,44,17,27,38.64
TwistedFate,Fiora,35,19,16,54.29
TwistedFate,Evelynn,23,11,12,47.83
TwistedFate,Vladimir,33,24,9,72.73
TwistedFate,Velkoz,49,19,30,38.78
TwistedFate,Anivia,30,17,13,56.67
TwistedFate,Janna,17,7,10,41.18
TwistedFate,Zyra,39,18,21,46.15
TwistedFate,Gangplank,39,15,24,38.46
TwistedFate,Renata,19,7,12,36.84
TwistedFate,Pyke,53,36,17,67.92
TwistedFate,Fizz,42,10,32,23.81
TwistedFate,Tryndamere,21,12,9,57.14
TwistedFate,Ornn,47,25,22,53.19
TwistedFate,Kennen,24,13,11,54.17
TwistedFate,Kassadin,7,5,2,71.43
TwistedFate,Aphelios,38,18,20,47.37
TwistedFate,Qiyana,16,8,8,50
TwistedFate,Annie,32,21,11,65.63
TwistedFate,Ivern,9,6,3,66.67
TwistedFate,RekSai,8,5,3,62.5
Vi,DrMundo,106,61,45,57.55
Vi,Sejuani,202,92,110,45.54
Vi,Lux,575,299,276,52
Vi,Ashe,472,256,216,54.24
Vi,TwistedFate,132,63,69,47.73
Vi,Rell,201,93,108,46.27
Vi,Rengar,77,51,26,66.23
Vi,Sett,352,177,175,50.28
Vi,Mel,479,256,223,53.44
Vi,Varus,253,135,118,53.36
Vi,Gnar,104,63,41,60.58
Vi,Hecarim,89,40,49,44.94
Vi,Viktor,271,114,157,42.07
Vi,MissFortune,482,214,268,44.4
Vi,Mordekaiser,334,170,164,50.9
Vi,Poppy,210,123,87,58.57
Vi,Zed,248,115,133,46.37
Vi,Pyke,254,142,112,55.91
Vi,Riven,128,73,55,57.03
Vi,Karthus,68,38,30,55.88
Vi,Lucian,224,122,102,54.46
Vi,Nami,288,131,157,45.49
Vi,Teemo,209,89,120,42.58
Vi,Khazix,135,80,55,59.26
Vi,Zoe,129,80,49,62.02
Vi,Jinx,630,329,301,52.22
Vi,Yorick,181,85,96,46.96
Vi,Kindred,125,83,42,66.4
Vi,Katarina,165,100,65,60.61
Vi,Caitlyn,758,418,340,55.15
Vi,Neeko,119,56,63,47.06
Vi,Ezreal,716,361,355,50.42
Vi,Aatrox,275,166,109,60.36
Vi,Amumu,308,137,171,44.48
Vi,Taliyah,83,41,42,49.4
Vi,Milio,143,69,74,48.25
Vi,TahmKench,303,156,147,51.49
Vi,JarvanIV,270,123,147,45.56
Vi,Kaisa,447,216,231,48.32
Vi,Morgana,246,110,136,44.72
Vi,Volibear,279,137,142,49.1
Vi,Nunu,149,57,92,38.26
Vi,Swain,246,102,144,41.46
Vi,Rakan,186,84,102,45.16
Vi,Warwick,309,174,135,56.31
Vi,Viego,395,165,230,41.77
Vi,Ahri,387,161,226,41.6
Vi,Hwei,187,108,79,57.75
Vi,Kayn,307,167,140,54.4
Vi,FiddleSticks,92,37,55,40.22
Vi,Qiyana,61,29,32,47.54
Vi,Zac,219,102,117,46.58
Vi,Janna,66,20,46,30.3
Vi,Pantheon,422,211,211,50
Vi,Xerath,276,143,133,51.81
Vi,Lulu,442,229,213,51.81
Vi,Yasuo,481,222,259,46.15
Vi,Nautilus,353,167,186,47.31
Vi,Malphite,285,138,147,48.42
Vi,Skarner,124,76,48,61.29
Vi,KogMaw,91,60,31,65.93
Vi,Gragas,216,146,70,67.59
Vi,Darius,447,201,246,44.97
Vi,Xayah,216,97,119,44.91
Vi,Karma,336,174,162,51.79
Vi,Sion,264,129,135,48.86
Vi,Kassadin,57,25,32,43.86
Vi,LeeSin,632,323,309,51.11
Vi,Leona,257,155,102,60.31
Vi,Ornn,164,88,76,53.66
Vi,Jayce,184,92,92,50
Vi,Seraphine,211,123,88,58.29
Vi,Kled,50,31,19,62
Vi,MasterYi,254,142,112,55.91
Vi,Vladimir,152,81,71,53.29
Vi,Jhin,456,226,230,49.56
Vi,Diana,453,228,225,50.33
Vi,Samira,137,60,77,43.8
Vi,Irelia,209,126,83,60.29
Vi,Alistar,157,64,93,40.76
Vi,Braum,186,101,85,54.3
Vi,Garen,400,166,234,41.5
Vi,Kennen,76,36,40,47.37
Vi,Talon,165,102,63,61.82
Vi,Yone,364,202,162,55.49
Vi,Galio,302,122,180,40.4
Vi,Gwen,128,64,64,50
Vi,Fizz,138,79,59,57.25
Vi,Urgot,119,87,32,73.11
Vi,Rammus,92,51,41,55.43
Vi,Vex,163,71,92,43.56
Vi,Veigar,264,119,145,45.08
Vi,Vayne,361,168,193,46.54
Vi,Yuumi,238,138,100,57.98
Vi,Tristana,262,141,121,53.82
Vi,Fiora,122,47,75,38.52
Vi,Leblanc,162,96,66,59.26
Vi,Illaoi,145,60,85,41.38
Vi,Ekko,193,95,98,49.22
Vi,Shaco,165,95,70,57.58
Vi,AurelionSol,93,44,49,47.31
Vi,Thresh,482,274,208,56.85
Vi,Briar,121,57,64,47.11
Vi,Smolder,172,83,89,48.26
Vi,Brand,141,67,74,47.52
Vi,Olaf,91,42,49,46.15
Vi,Twitch,186,100,86,53.76
Vi,Ivern,52,32,20,61.54
Vi,Nasus,185,98,87,52.97
Vi,Ziggs,114,52,62,45.61
Vi,Sivir,178,88,90,49.44
Vi,Draven,92,48,44,52.17
Vi,Soraka,124,60,64,48.39
Vi,Maokai,153,94,59,61.44
Vi,Shen,178,100,78,56.18
Vi,Jax,203,99,104,48.77
Vi,Aurora,205,123,82,60
Vi,Akali,208,108,100,51.92
Vi,Sona,39,19,20,48.72
Vi,Malzahar,234,113,121,48.29
Vi,Zyra,203,84,119,41.38
Vi,Udyr,81,55,26,67.9
Vi,Renekton,158,63,95,39.87
Vi,Elise,196,89,107,45.41
Vi,Quinn,95,52,43,54.74
Vi,Gangplank,135,81,54,60
Vi,Ryze,88,47,41,53.41
Vi,Ambessa,171,115,56,67.25
Vi,Velkoz,130,66,64,50.77
Vi,Renata,61,32,29,52.46
Vi,Nilah,57,26,31,45.61
Vi,Evelynn,60,41,19,68.33
Vi,Sylas,419,219,200,52.27
Vi,Zilean,74,34,40,45.95
Vi,Graves,173,84,89,48.55
Vi,Lillia,148,76,72,51.35
Vi,Tryndamere,73,29,44,39.73
Vi,Orianna,97,43,54,44.33
Vi,Corki,143,82,61,57.34
Vi,Kayle,143,81,62,56.64
Vi,RekSai,44,25,19,56.82
Vi,Blitzcrank,265,125,140,47.17
Vi,XinZhao,203,114,89,56.16
Vi,Bard,88,39,49,44.32
Vi,Nocturne,357,171,186,47.9
Vi,Chogath,349,180,169,51.58
Vi,Azir,117,83,34,70.94
Vi,Cassiopeia,76,30,46,39.47
Vi,MonkeyKing,241,84,157,34.85
Vi,Syndra,173,107,66,61.85
Vi,Naafiri,83,40,43,48.19
Vi,Shyvana,75,35,40,46.67
Vi,Trundle,144,85,59,59.03
Vi,Kalista,75,34,41,45.33
Vi,Anivia,114,64,50,56.14
Vi,Aphelios,143,75,68,52.45
Vi,Senna,121,62,59,51.24
Vi,Zeri,146,85,61,58.22
Vi,KSante,201,108,93,53.73
Vi,Belveth,48,31,17,64.58
Vi,Lissandra,85,57,28,67.06
Vi,Annie,87,40,47,45.98
Vi,Taric,66,42,24,63.64
Vi,Akshan,78,30,48,38.46
Vi,Heimerdinger,135,82,53,60.74
Vi,Camille,127,54,73,42.52
Vi,Rumble,72,38,34,52.78
Vi,Singed,45,23,22,51.11
Vi,Nidalee,76,40,36,52.63
Senna,DrMundo,90,43,47,47.78
Senna,Sejuani,87,48,39,55.17
Senna,Lux,328,163,165,49.7
Senna,Ashe,300,166,134,55.33
Senna,TwistedFate,58,32,26,55.17
Senna,Ivern,37,13,24,35.14
Senna,Renekton,58,33,25,56.9
Senna,Vladimir,58,29,29,50
Senna,Lucian,103,55,48,53.4
Senna,Blitzcrank,109,55,54,50.46
Senna,Tryndamere,50,20,30,40
Senna,Nunu,97,50,47,51.55
Senna,Kennen,49,7,42,14.29
Senna,Samira,102,51,51,50
Senna,Rell,114,64,50,56.14
Senna,Diana,195,100,95,51.28
Senna,Katarina,80,44,36,55
Senna,Varus,134,84,50,62.69
Senna,Karma,138,83,55,60.14
Senna,Heimerdinger,67,36,31,53.73
Senna,LeeSin,237,114,123,48.1
Senna,AurelionSol,98,37,61,37.76
Senna,Jinx,350,156,194,44.57
Senna,Leona,114,41,73,35.96
Senna,KSante,99,38,61,38.38
Senna,Rammus,51,33,18,64.71
Senna,Aurora,112,74,38,66.07
Senna,Kaisa,214,111,103,51.87
Senna,Zilean,35,15,20,42.86
Senna,Sion,118,55,63,46.61
Senna,MasterYi,136,57,79,41.91
Senna,Xayah,92,27,65,29.35
Senna,Seraphine,132,69,63,52.27
Senna,Yorick,113,49,64,43.36
Senna,Viego,127,46,81,36.22
Senna,Rakan,95,40,55,42.11
Senna,Aatrox,133,57,76,42.86
Senna,Ekko,142,55,87,38.73
Senna,Chogath,189,92,97,48.68
Senna,Nilah,50,29,21,58
Senna,Zyra,98,53,45,54.08
Senna,TahmKench,133,69,64,51.88
Senna,Khazix,51,13,38,25.49
Senna,Jhin,270,132,138,48.89
Senna,Nami,117,57,60,48.72
Senna,Mordekaiser,210,89,121,42.38
Senna,Udyr,59,30,29,50.85
Senna,Smolder,95,63,32,66.32
Senna,Garen,194,108,86,55.67
Senna,Zed,139,82,57,58.99
Senna,Leblanc,99,40,59,40.4
Senna,Mel,315,166,149,52.7
Senna,Morgana,185,68,117,36.76
Senna,Pantheon,219,117,102,53.42
Senna,Vayne,172,75,97,43.6
Senna,Yasuo,225,105,120,46.67
Senna,Milio,124,58,66,46.77
Senna,Veigar,173,92,81,53.18
Senna,Darius,233,100,133,42.92
Senna,Qiyana,44,23,21,52.27
Senna,Caitlyn,333,154,179,46.25
Senna,Riven,47,27,20,57.45
Senna,Galio,163,73,90,44.79
Senna,Nocturne,183,85,98,46.45
Senna,Sett,173,75,98,43.35
Senna,Lulu,228,112,116,49.12
Senna,Annie,34,19,15,55.88
Senna,Poppy,105,52,53,49.52
Senna,Malphite,199,104,95,52.26
Senna,Graves,102,45,57,44.12
Senna,Braum,134,72,62,53.73
Senna,Jax,123,66,57,53.66
Senna,Jayce,82,38,44,46.34
Senna,Skarner,90,48,42,53.33
Senna,Ahri,163,79,84,48.47
Senna,FiddleSticks,60,27,33,45
Senna,Hwei,93,47,46,50.54
Senna,KogMaw,46,24,22,52.17
Senna,Akali,101,48,53,47.52
Senna,Cassiopeia,37,11,26,29.73
Senna,Irelia,88,54,34,61.36
Senna,Twitch,110,53,57,48.18
Senna,Briar,78,28,50,35.9
Senna,Naafiri,46,19,27,41.3
Senna,MissFortune,257,129,128,50.19
Senna,Thresh,247,91,156,36.84
Senna,Belveth,35,16,19,45.71
Senna,Brand,68,44,24,64.71
Senna,Taliyah,41,21,20,51.22
Senna,Zac,90,53,37,58.89
Senna,JarvanIV,97,42,55,43.3
Senna,Swain,119,57,62,47.9
Senna,Tristana,107,55,52,51.4
Senna,Kayn,176,74,102,42.05
Senna,Sylas,215,92,123,42.79
Senna,Syndra,82,59,23,71.95
Senna,Warwick,171,82,89,47.95
Senna,Nidalee,29,8,21,27.59
Senna,Nautilus,153,81,72,52.94
Senna,Sona,47,20,27,42.55
Senna,Neeko,51,33,18,64.71
Senna,Trundle,74,40,34,54.05
Senna,MonkeyKing,104,40,64,38.46
Senna,Orianna,65,25,40,38.46
Senna,Volibear,119,55,64,46.22
Senna,Pyke,83,50,33,60.24
Senna,Viktor,102,55,47,53.92
Senna,Shyvana,35,12,23,34.29
Senna,Aphelios,66,31,35,46.97
Senna,Renata,45,12,33,26.67
Senna,Evelynn,48,31,17,64.58
Senna,Yuumi,75,45,30,60
Senna,Teemo,90,54,36,60
Senna,Yone,241,95,146,39.42
Senna,Gwen,77,43,34,55.84
Senna,Xerath,132,77,55,58.33
Senna,XinZhao,99,64,35,64.65
Senna,Gragas,111,56,55,50.45
Senna,Ezreal,346,176,170,50.87
Senna,Sivir,65,13,52,20
Senna,Kassadin,23,5,18,21.74
Senna,Anivia,53,29,24,54.72
Senna,Rumble,42,25,17,59.52
Senna,Azir,58,30,28,51.72
Senna,Gangplank,84,43,41,51.19
Senna,Quinn,42,22,20,52.38
Senna,Akshan,56,30,26,53.57
Senna,Maokai,58,38,20,65.52
Senna,Lissandra,53,27,26,50.94
Senna,Ambessa,89,36,53,40.45
Senna,Camille,56,29,27,51.79
Senna,Malzahar,144,50,94,34.72
Senna,Soraka,74,34,40,45.95
Senna,Kalista,49,29,20,59.18
Senna,Fizz,64,48,16,75
Senna,Rengar,35,22,13,62.86
Senna,Gnar,58,28,30,48.28
Senna,Corki,83,50,33,60.24
Senna,Nasus,102,67,35,65.69
Senna,Alistar,68,34,34,50
Senna,Kayle,72,29,43,40.28
Senna,Vi,121,59,62,48.76
Senna,Shen,86,40,46,46.51
Senna,Talon,79,51,28,64.56
Senna,Olaf,47,24,23,51.06
Senna,Urgot,51,19,32,37.25
Senna,Bard,57,25,32,43.86
Senna,Hecarim,33,12,21,36.36
Senna,Shaco,84,56,28,66.67
Senna,Vex,73,39,34,53.42
Senna,Velkoz,63,37,26,58.73
Senna,Ornn,95,64,31,67.37
Senna,Karthus,24,14,10,58.33
Senna,Zeri,39,23,16,58.97
Senna,RekSai,24,21,3,87.5
Senna,Ryze,68,32,36,47.06
Senna,Lillia,72,47,25,65.28
Senna,Janna,48,21,27,43.75
Senna,Singed,29,15,14,51.72
Senna,Taric,18,5,13,27.78
Senna,Kled,25,14,11,56
Senna,Amumu,126,79,47,62.7
Senna,Elise,109,50,59,45.87
Senna,Zoe,40,19,21,47.5
Senna,Ziggs,49,21,28,42.86
Senna,Kindred,48,25,23,52.08
Senna,Draven,53,25,28,47.17
Senna,Illaoi,58,42,16,72.41
Senna,Fiora,57,24,33,42.11
Udyr,Mordekaiser,75,36,39,48
Udyr,Kayn,90,40,50,44.44
Udyr,Katarina,60,31,29,51.67
Udyr,Caitlyn,214,93,121,43.46
Udyr,Morgana,90,25,65,27.78
Udyr,Yasuo,215,100,115,46.51
Udyr,Shaco,86,29,57,33.72
Udyr,Azir,29,9,20,31.03
Udyr,Jhin,168,75,93,44.64
Udyr,Sylas,119,72,47,60.5
Udyr,Sett,114,52,62,45.61
Udyr,Hecarim,22,9,13,40.91
Udyr,Ahri,104,43,61,41.35
Udyr,Rakan,44,17,27,38.64
Udyr,Draven,34,13,21,38.24
Udyr,Malphite,84,32,52,38.1
Udyr,Chogath,140,57,83,40.71
Udyr,MissFortune,154,68,86,44.16
Udyr,Yuumi,61,5,56,8.2
Udyr,FiddleSticks,48,23,25,47.92
Udyr,Hwei,61,29,32,47.54
Udyr,Teemo,73,39,34,53.42
Udyr,Janna,19,3,16,15.79
Udyr,XinZhao,37,21,16,56.76
Udyr,Gwen,48,17,31,35.42
Udyr,Ashe,166,74,92,44.58
Udyr,Rell,39,19,20,48.72
Udyr,Vladimir,64,23,41,35.94
Udyr,Volibear,114,48,66,42.11
Udyr,Malzahar,77,37,40,48.05
Udyr,Jayce,31,20,11,64.52
Udyr,Sion,75,42,33,56
Udyr,Yorick,80,32,48,40
Udyr,Nidalee,39,23,16,58.97
Udyr,Yone,146,69,77,47.26
Udyr,Twitch,58,20,38,34.48
Udyr,DrMundo,48,29,19,60.42
Udyr,Zed,74,17,57,22.97
Udyr,Orianna,44,19,25,43.18
Udyr,Sivir,41,18,23,43.9
Udyr,Nami,57,30,27,52.63
Udyr,Urgot,39,17,22,43.59
Udyr,LeeSin,139,77,62,55.4
Udyr,Xayah,42,16,26,38.1
Udyr,Senna,59,29,30,49.15
Udyr,Viego,78,30,48,38.46
Udyr,Kayle,36,14,22,38.89
Udyr,Skarner,30,9,21,30
Udyr,Varus,78,31,47,39.74
Udyr,Ezreal,201,88,113,43.78
Udyr,Neeko,29,15,14,51.72
Udyr,Jinx,186,72,114,38.71
Udyr,Milio,64,21,43,32.81
Udyr,Zac,69,31,38,44.93
Udyr,Karma,109,46,63,42.2
Udyr,Corki,54,26,28,48.15
Udyr,Ambessa,66,22,44,33.33
Udyr,Amumu,65,28,37,43.08
Udyr,Mel,166,94,72,56.63
Udyr,Warwick,116,61,55,52.59
Udyr,AurelionSol,22,5,17,22.73
Udyr,Lucian,51,30,21,58.82
Udyr,Zyra,74,39,35,52.7
Udyr,Illaoi,49,21,28,42.86
Udyr,Ekko,39,18,21,46.15
Udyr,Irelia,53,30,23,56.6
Udyr,Seraphine,48,24,24,50
Udyr,Jax,46,14,32,30.43
Udyr,JarvanIV,70,24,46,34.29
Udyr,Syndra,59,27,32,45.76
Udyr,Brand,51,8,43,15.69
Udyr,KSante,74,33,41,44.59
Udyr,Talon,30,13,17,43.33
Udyr,Kassadin,8,5,3,62.5
Udyr,Vi,81,26,55,32.1
Udyr,Tristana,75,46,29,61.33
Udyr,Rumble,36,15,21,41.67
Udyr,Aurora,65,22,43,33.85
Udyr,Lulu,126,61,65,48.41
Udyr,Kindred,27,8,19,29.63
Udyr,Anivia,45,34,11,75.56
Udyr,Smolder,44,9,35,20.45
Udyr,Diana,129,78,51,60.47
Udyr,Nocturne,105,42,63,40
Udyr,Lillia,67,18,49,26.87
Udyr,Lux,132,53,79,40.15
Udyr,Galio,89,42,47,47.19
Udyr,Pantheon,132,59,73,44.7
Udyr,Ziggs,38,15,23,39.47
Udyr,Blitzcrank,66,29,37,43.94
Udyr,Darius,162,61,101,37.65
Udyr,Viktor,82,40,42,48.78
Udyr,Kaisa,140,74,66,52.86
Udyr,Velkoz,51,19,32,37.25
Udyr,Garen,118,44,74,37.29
Udyr,Vayne,111,37,74,33.33
Udyr,Soraka,31,15,16,48.39
Udyr,Shen,58,23,35,39.66
Udyr,Ryze,32,11,21,34.38
Udyr,Kalista,27,17,10,62.96
Udyr,Sona,17,6,11,35.29
Udyr,Tryndamere,20,17,3,85
Udyr,Maokai,37,16,21,43.24
Udyr,Evelynn,38,13,25,34.21
Udyr,Poppy,64,35,29,54.69
Udyr,Qiyana,16,5,11,31.25
Udyr,Zeri,34,11,23,32.35
Udyr,Camille,30,10,20,33.33
Udyr,Rengar,22,16,6,72.73
Udyr,Quinn,24,12,12,50
Udyr,Nunu,49,25,24,51.02
Udyr,Briar,58,20,38,34.48
Udyr,Lissandra,17,7,10,41.18
Udyr,Vex,64,21,43,32.81
Udyr,Ornn,47,11,36,23.4
Udyr,Zoe,38,17,21,44.74
Udyr,Karthus,26,18,8,69.23
Udyr,Heimerdinger,36,19,17,52.78
Udyr,Swain,58,32,26,55.17
Udyr,Bard,46,32,14,69.57
Udyr,Thresh,151,58,93,38.41
Udyr,Nasus,19,2,17,10.53
Udyr,Singed,31,14,17,45.16
Udyr,Samira,63,24,39,38.1
Udyr,Veigar,69,21,48,30.43
Udyr,Aatrox,90,43,47,47.78
Udyr,Kled,21,10,11,47.62
Udyr,Elise,75,34,41,45.33
Udyr,Zilean,31,14,17,45.16
Udyr,Gnar,53,20,33,37.74
Udyr,Annie,31,11,20,35.48
Udyr,Akali,74,33,41,44.59
Udyr,Pyke,68,27,41,39.71
Udyr,Leblanc,40,15,25,37.5
Udyr,Graves,62,35,27,56.45
Udyr,Gangplank,52,19,33,36.54
Udyr,Shyvana,23,9,14,39.13
Udyr,Leona,66,38,28,57.58
Udyr,Olaf,11,6,5,54.55
Udyr,Nautilus,121,51,70,42.15
Udyr,TwistedFate,33,12,21,36.36
Udyr,Alistar,51,26,25,50.98
Udyr,Braum,34,13,21,38.24
Udyr,Taric,23,5,18,21.74
Udyr,Gragas,58,26,32,44.83
Udyr,MasterYi,55,28,27,50.91
Udyr,Fiora,31,14,17,45.16
Udyr,Naafiri,23,9,14,39.13
Udyr,MonkeyKing,70,36,34,51.43
Udyr,Aphelios,43,25,18,58.14
Udyr,Trundle,56,17,39,30.36
Udyr,Khazix,56,17,39,30.36
Udyr,TahmKench,88,36,52,40.91
Udyr,Xerath,76,24,52,31.58
Udyr,Riven,22,10,12,45.45
Udyr,Sejuani,30,12,18,40
Udyr,Cassiopeia,19,2,17,10.53
Udyr,Belveth,11,6,5,54.55
Udyr,Akshan,34,12,22,35.29
Udyr,Renekton,28,18,10,64.29
Udyr,KogMaw,10,0,10,0
Udyr,Kennen,31,9,22,29.03
Udyr,Fizz,23,11,12,47.83
Udyr,RekSai,13,6,7,46.15
Udyr,Taliyah,21,10,11,47.62
Udyr,Renata,26,6,20,23.08
Udyr,Rammus,15,6,9,40
Udyr,Nilah,17,6,11,35.29
Udyr,Ivern,20,17,3,85
Smolder,Mordekaiser,196,90,106,45.92
Smolder,Kayn,184,86,98,46.74
Smolder,Katarina,93,38,55,40.86
Smolder,Caitlyn,464,255,209,54.96
Smolder,Morgana,161,71,90,44.1
Smolder,Yone,301,154,147,51.16
Smolder,Nocturne,198,92,106,46.46
Smolder,Akali,137,74,63,54.01
Smolder,Ezreal,418,212,206,50.72
Smolder,Renata,52,24,28,46.15
Smolder,Ornn,89,39,50,43.82
Smolder,Kindred,85,38,47,44.71
Smolder,Talon,79,41,38,51.9
Smolder,Samira,123,69,54,56.1
Smolder,Ashe,266,140,126,52.63
Smolder,Rengar,58,35,23,60.34
Smolder,Warwick,204,96,108,47.06
Smolder,Irelia,105,42,63,40
Smolder,Nautilus,235,116,119,49.36
Smolder,Kayle,94,40,54,42.55
Smolder,Evelynn,57,31,26,54.39
Smolder,Corki,84,41,43,48.81
Smolder,Syndra,110,66,44,60
Smolder,Tryndamere,52,12,40,23.08
Smolder,Nunu,97,58,39,59.79
Smolder,Kennen,41,17,24,41.46
Smolder,Rell,136,100,36,73.53
Smolder,Yorick,149,46,103,30.87
Smolder,Ahri,244,116,128,47.54
Smolder,Lux,386,211,175,54.66
Smolder,Xayah,103,48,55,46.6
Smolder,Karthus,25,13,12,52
Smolder,Naafiri,86,40,46,46.51
Smolder,Vayne,204,83,121,40.69
Smolder,Volibear,203,102,101,50.25
Smolder,Swain,175,82,93,46.86
Smolder,Rakan,99,55,44,55.56
Smolder,Teemo,167,82,85,49.1
Smolder,Yasuo,353,191,162,54.11
Smolder,DrMundo,51,27,24,52.94
Smolder,Xerath,136,63,73,46.32
Smolder,Lucian,147,89,58,60.54
Smolder,Nami,186,101,85,54.3
Smolder,Malphite,226,112,114,49.56
Smolder,Skarner,98,51,47,52.04
Smolder,Hwei,86,55,31,63.95
Smolder,KogMaw,42,14,28,33.33
Smolder,Urgot,113,56,57,49.56
Smolder,Mel,375,201,174,53.6
Smolder,Amumu,181,84,97,46.41
Smolder,Zac,111,62,49,55.86
Smolder,Sion,164,92,72,56.1
Smolder,MonkeyKing,104,50,54,48.08
Smolder,Malzahar,214,101,113,47.2
Smolder,MissFortune,310,155,155,50
Smolder,Renekton,64,36,28,56.25
Smolder,Viktor,147,78,69,53.06
Smolder,Seraphine,113,47,66,41.59
Smolder,LeeSin,272,147,125,54.04
Smolder,Senna,95,32,63,33.68
Smolder,MasterYi,170,78,92,45.88
Smolder,Aatrox,156,75,81,48.08
Smolder,XinZhao,133,72,61,54.14
Smolder,Vladimir,78,27,51,34.62
Smolder,Garen,238,120,118,50.42
Smolder,Diana,290,167,123,57.59
Smolder,Zyra,135,68,67,50.37
Smolder,Ekko,152,69,83,45.39
Smolder,Milio,96,52,44,54.17
Smolder,Chogath,206,125,81,60.68
Smolder,Taliyah,51,25,26,49.02
Smolder,Sejuani,102,49,53,48.04
Smolder,Camille,68,47,21,69.12
Smolder,Darius,301,152,149,50.5
Smolder,Varus,172,79,93,45.93
Smolder,Pyke,131,70,61,53.44
Smolder,Ambessa,143,86,57,60.14
Smolder,Khazix,91,50,41,54.95
Smolder,Jhin,338,155,183,45.86
Smolder,Gragas,99,55,44,55.56
Smolder,Tristana,155,100,55,64.52
Smolder,Bard,57,27,30,47.37
Smolder,Gnar,103,58,45,56.31
Smolder,Braum,119,69,50,57.98
Smolder,Nidalee,56,27,29,48.21
Smolder,Kaisa,255,131,124,51.37
Smolder,Lulu,237,103,134,43.46
Smolder,Vi,172,89,83,51.74
Smolder,Zilean,64,30,34,46.88
Smolder,JarvanIV,144,77,67,53.47
Smolder,Aphelios,114,72,42,63.16
Smolder,Leona,152,68,84,44.74
Smolder,Poppy,148,85,63,57.43
Smolder,Heimerdinger,82,31,51,37.8
Smolder,Ivern,30,13,17,43.33
Smolder,Veigar,153,64,89,41.83
Smolder,Riven,44,28,16,63.64
Smolder,Blitzcrank,95,45,50,47.37
Smolder,Singed,54,25,29,46.3
Smolder,Shaco,121,76,45,62.81
Smolder,Ryze,50,26,24,52
Smolder,Jinx,414,184,230,44.44
Smolder,Yuumi,164,76,88,46.34
Smolder,Udyr,44,35,9,79.55
Smolder,Aurora,111,58,53,52.25
Smolder,Viego,223,106,117,47.53
Smolder,Karma,182,90,92,49.45
Smolder,Sett,236,122,114,51.69
Smolder,Illaoi,62,33,29,53.23
Smolder,Fizz,75,41,34,54.67
Smolder,Sylas,242,100,142,41.32
Smolder,Gangplank,93,41,52,44.09
Smolder,Azir,71,33,38,46.48
Smolder,Leblanc,89,51,38,57.3
Smolder,Shyvana,41,22,19,53.66
Smolder,AurelionSol,53,20,33,37.74
Smolder,Jayce,80,35,45,43.75
Smolder,Orianna,90,53,37,58.89
Smolder,Olaf,43,13,30,30.23
Smolder,TahmKench,160,82,78,51.25
Smolder,Lissandra,58,35,23,60.34
Smolder,Brand,94,55,39,58.51
Smolder,Gwen,82,31,51,37.8
Smolder,Graves,115,54,61,46.96
Smolder,Zed,163,81,82,49.69
Smolder,Zeri,94,40,54,42.55
Smolder,Kalista,57,33,24,57.89
Smolder,Hecarim,67,28,39,41.79
Smolder,Twitch,145,87,58,60
Smolder,Nasus,132,69,63,52.27
Smolder,Sona,19,14,5,73.68
Smolder,Galio,184,101,83,54.89
Smolder,Jax,110,54,56,49.09
Smolder,Briar,84,25,59,29.76
Smolder,Elise,98,37,61,37.76
Smolder,TwistedFate,61,19,42,31.15
Smolder,Ziggs,28,18,10,64.29
Smolder,Janna,54,34,20,62.96
Smolder,Pantheon,248,131,117,52.82
Smolder,FiddleSticks,65,29,36,44.62
Smolder,Thresh,279,155,124,55.56
Smolder,Cassiopeia,56,35,21,62.5
Smolder,Kled,35,17,18,48.57
Smolder,Kassadin,21,13,8,61.9
Smolder,Draven,72,32,40,44.44
Smolder,Nilah,56,27,29,48.21
Smolder,Velkoz,66,39,27,59.09
Smolder,Rammus,51,28,23,54.9
Smolder,Akshan,49,24,25,48.98
Smolder,Neeko,76,33,43,43.42
Smolder,Sivir,70,32,38,45.71
Smolder,Shen,88,45,43,51.14
Smolder,Zoe,58,22,36,37.93
Smolder,Taric,45,12,33,26.67
Smolder,Fiora,55,42,13,76.36
Smolder,Soraka,59,41,18,69.49
Smolder,Vex,62,28,34,45.16
Smolder,Trundle,73,28,45,38.36
Smolder,KSante,114,59,55,51.75
Smolder,Alistar,102,70,32,68.63
Smolder,Lillia,84,43,41,51.19
Smolder,Anivia,49,26,23,53.06
Smolder,Qiyana,33,22,11,66.67
Smolder,Maokai,92,57,35,61.96
Smolder,Quinn,48,26,22,54.17
Smolder,Belveth,15,10,5,66.67
Smolder,Annie,28,10,18,35.71
Smolder,RekSai,14,5,9,35.71
Smolder,Rumble,31,15,16,48.39
TahmKench,Mordekaiser,295,127,168,43.05
TahmKench,Kayn,258,109,149,42.25
TahmKench,Katarina,142,64,78,45.07
TahmKench,Caitlyn,472,228,244,48.31
TahmKench,Morgana,162,69,93,42.59
TahmKench,Sion,164,68,96,41.46
TahmKench,RekSai,24,17,7,70.83
TahmKench,Viktor,238,113,125,47.48
TahmKench,KogMaw,82,42,40,51.22
TahmKench,Ashe,462,224,238,48.48
TahmKench,Gragas,188,101,87,53.72
TahmKench,Elise,169,70,99,41.42
TahmKench,Mel,479,231,248,48.23
TahmKench,Vayne,348,158,190,45.4
TahmKench,Zyra,175,85,90,48.57
TahmKench,Sett,333,149,184,44.74
TahmKench,Sejuani,163,86,77,52.76
TahmKench,Jinx,463,265,198,57.24
TahmKench,Lux,530,309,221,58.3
TahmKench,Yorick,142,91,51,64.08
TahmKench,Diana,333,162,171,48.65
TahmKench,Akali,150,80,70,53.33
TahmKench,Milio,138,60,78,43.48
TahmKench,XinZhao,133,73,60,54.89
TahmKench,Thresh,442,229,213,51.81
TahmKench,Kaisa,319,159,160,49.84
TahmKench,Jhin,373,197,176,52.82
TahmKench,Urgot,141,70,71,49.65
TahmKench,Malzahar,286,152,134,53.15
TahmKench,Ezreal,585,329,256,56.24
TahmKench,Irelia,120,62,58,51.67
TahmKench,Ekko,167,82,85,49.1
TahmKench,Qiyana,37,19,18,51.35
TahmKench,Quinn,79,54,25,68.35
TahmKench,LeeSin,352,185,167,52.56
TahmKench,Malphite,206,128,78,62.14
TahmKench,Khazix,97,50,47,51.55
TahmKench,Olaf,56,31,25,55.36
TahmKench,Vi,303,147,156,48.51
TahmKench,Veigar,238,118,120,49.58
TahmKench,Bard,67,24,43,35.82
TahmKench,Volibear,255,128,127,50.2
TahmKench,Amumu,293,136,157,46.42
TahmKench,Zeri,88,42,46,47.73
TahmKench,Pantheon,354,169,185,47.74
TahmKench,Jayce,91,52,39,57.14
TahmKench,Samira,145,63,82,43.45
TahmKench,Leona,216,111,105,51.39
TahmKench,Heimerdinger,90,44,46,48.89
TahmKench,Orianna,103,41,62,39.81
TahmKench,Seraphine,165,93,72,56.36
TahmKench,Chogath,288,160,128,55.56
TahmKench,Gwen,118,69,49,58.47
TahmKench,Rell,157,85,72,54.14
TahmKench,Aatrox,220,89,131,40.45
TahmKench,Yasuo,390,175,215,44.87
TahmKench,Nami,248,150,98,60.48
TahmKench,Jax,131,52,79,39.69
TahmKench,MissFortune,397,187,210,47.1
TahmKench,Twitch,142,70,72,49.3
TahmKench,Varus,192,124,68,64.58
TahmKench,Graves,146,62,84,42.47
TahmKench,Zoe,93,43,50,46.24
TahmKench,Zac,135,106,29,78.52
TahmKench,Poppy,176,103,73,58.52
TahmKench,Ziggs,95,38,57,40
TahmKench,Warwick,299,167,132,55.85
TahmKench,DrMundo,114,58,56,50.88
TahmKench,Zed,207,127,80,61.35
TahmKench,Sivir,127,64,63,50.39
TahmKench,MasterYi,242,107,135,44.21
TahmKench,Draven,121,79,42,65.29
TahmKench,Rakan,116,46,70,39.66
TahmKench,Trundle,175,63,112,36
TahmKench,Tristana,191,99,92,51.83
TahmKench,Blitzcrank,171,89,82,52.05
TahmKench,Gangplank,96,51,45,53.13
TahmKench,Lulu,311,175,136,56.27
TahmKench,Skarner,104,54,50,51.92
TahmKench,AurelionSol,99,52,47,52.53
TahmKench,Karma,266,133,133,50
TahmKench,Yone,340,163,177,47.94
TahmKench,Senna,133,64,69,48.12
TahmKench,Shen,131,66,65,50.38
TahmKench,Aurora,163,91,72,55.83
TahmKench,Brand,172,91,81,52.91
TahmKench,Lucian,182,114,68,62.64
TahmKench,Swain,214,79,135,36.92
TahmKench,Rumble,53,28,25,52.83
TahmKench,Fizz,100,56,44,56
TahmKench,Zilean,56,37,19,66.07
TahmKench,Renekton,106,50,56,47.17
TahmKench,Nidalee,77,46,31,59.74
TahmKench,Viego,217,122,95,56.22
TahmKench,Alistar,107,46,61,42.99
TahmKench,Nunu,113,66,47,58.41
TahmKench,Talon,119,63,56,52.94
TahmKench,Galio,225,111,114,49.33
TahmKench,Darius,430,220,210,51.16
TahmKench,Xayah,118,66,52,55.93
TahmKench,Ambessa,151,71,80,47.02
TahmKench,Pyke,185,126,59,68.11
TahmKench,Syndra,156,93,63,59.62
TahmKench,JarvanIV,136,69,67,50.74
TahmKench,Yuumi,151,74,77,49.01
TahmKench,Annie,90,50,40,55.56
TahmKench,Janna,65,36,29,55.38
TahmKench,Illaoi,119,53,66,44.54
TahmKench,Teemo,192,104,88,54.17
TahmKench,Gnar,131,81,50,61.83
TahmKench,Kayle,119,53,66,44.54
TahmKench,Briar,141,57,84,40.43
TahmKench,Vex,120,46,74,38.33
TahmKench,Kled,25,5,20,20
TahmKench,Lillia,109,66,43,60.55
TahmKench,Riven,89,57,32,64.04
TahmKench,Shaco,147,65,82,44.22
TahmKench,Kassadin,42,22,20,52.38
TahmKench,Rengar,54,22,32,40.74
TahmKench,Corki,99,50,49,50.51
TahmKench,Sylas,290,145,145,50
TahmKench,Tryndamere,86,41,45,47.67
TahmKench,Nasus,105,44,61,41.9
TahmKench,Nocturne,253,143,110,56.52
TahmKench,Braum,186,77,109,41.4
TahmKench,TwistedFate,50,22,28,44
TahmKench,Velkoz,118,59,59,50
TahmKench,Nautilus,303,151,152,49.83
TahmKench,Neeko,122,48,74,39.34
TahmKench,Ornn,123,66,57,53.66
TahmKench,FiddleSticks,97,34,63,35.05
TahmKench,Renata,43,26,17,60.47
TahmKench,Fiora,107,57,50,53.27
TahmKench,Shyvana,62,38,24,61.29
TahmKench,Cassiopeia,62,27,35,43.55
TahmKench,Soraka,107,60,47,56.07
TahmKench,Ryze,82,50,32,60.98
TahmKench,MonkeyKing,148,86,62,58.11
TahmKench,Kindred,84,48,36,57.14
TahmKench,Ahri,246,119,127,48.37
TahmKench,Kalista,56,24,32,42.86
TahmKench,Hwei,148,82,66,55.41
TahmKench,Lissandra,111,47,64,42.34
TahmKench,Vladimir,105,69,36,65.71
TahmKench,KSante,104,59,45,56.73
TahmKench,Azir,100,56,44,56
TahmKench,Nilah,65,26,39,40
TahmKench,Smolder,160,78,82,48.75
TahmKench,Naafiri,60,31,29,51.67
TahmKench,Leblanc,102,54,48,52.94
TahmKench,Singed,41,20,21,48.78
TahmKench,Camille,93,59,34,63.44
TahmKench,Aphelios,101,61,40,60.4
TahmKench,Ivern,42,14,28,33.33
TahmKench,Garen,336,142,194,42.26
TahmKench,Akshan,78,43,35,55.13
TahmKench,Maokai,126,61,65,48.41
TahmKench,Xerath,172,111,61,64.53
TahmKench,Taliyah,63,27,36,42.86
TahmKench,Taric,51,20,31,39.22
TahmKench,Karthus,53,27,26,50.94
TahmKench,Rammus,77,47,30,61.04
TahmKench,Hecarim,37,27,10,72.97
TahmKench,Evelynn,56,24,32,42.86
TahmKench,Belveth,37,22,15,59.46
TahmKench,Anivia,86,44,42,51.16
TahmKench,Udyr,88,52,36,59.09
TahmKench,Sona,37,17,20,45.95
TahmKench,Kennen,46,33,13,71.74
Shaco,Renekton,115,57,58,49.57
Shaco,Udyr,86,57,29,66.28
Shaco,Qiyana,44,18,26,40.91
Shaco,Xayah,93,56,37,60.22
Shaco,Morgana,215,91,124,42.33
Shaco,Yorick,126,64,62,50.79
Shaco,Warwick,247,113,134,45.75
Shaco,Akali,188,112,76,59.57
Shaco,Jhin,376,170,206,45.21
Shaco,Braum,120,55,65,45.83
Shaco,Nasus,100,46,54,46
Shaco,Amumu,200,73,127,36.5
Shaco,Sylas,222,99,123,44.59
Shaco,Twitch,124,58,66,46.77
Shaco,Lulu,288,131,157,45.49
Shaco,Trundle,68,32,36,47.06
Shaco,Ahri,257,140,117,54.47
Shaco,Graves,133,79,54,59.4
Shaco,Volibear,183,72,111,39.34
Shaco,MasterYi,179,73,106,40.78
Shaco,Mel,355,155,200,43.66
Shaco,Ezreal,445,206,239,46.29
Shaco,Blitzcrank,143,70,73,48.95
Shaco,Diana,295,135,160,45.76
Shaco,Yasuo,398,194,204,48.74
Shaco,Ashe,349,172,177,49.28
Shaco,Darius,350,167,183,47.71
Shaco,Kayn,225,89,136,39.56
Shaco,Lux,424,216,208,50.94
Shaco,Riven,62,35,27,56.45
Shaco,Soraka,108,54,54,50
Shaco,MonkeyKing,129,66,63,51.16
Shaco,Viktor,157,68,89,43.31
Shaco,Rakan,93,53,40,56.99
Shaco,Sejuani,111,54,57,48.65
Shaco,Leblanc,116,54,62,46.55
Shaco,Nilah,72,34,38,47.22
Shaco,Karma,234,94,140,40.17
Shaco,Jax,160,83,77,51.88
Shaco,Tristana,152,73,79,48.03
Shaco,Sion,175,78,97,44.57
Shaco,Ambessa,124,64,60,51.61
Shaco,Jinx,482,196,286,40.66
Shaco,Kaisa,272,136,136,50
Shaco,Malzahar,189,81,108,42.86
Shaco,Gragas,126,70,56,55.56
Shaco,Gnar,74,35,39,47.3
Shaco,MissFortune,347,183,164,52.74
Shaco,Vex,93,50,43,53.76
Shaco,Caitlyn,432,216,216,50
Shaco,Brand,98,37,61,37.76
Shaco,Ekko,164,83,81,50.61
Shaco,Alistar,123,42,81,34.15
Shaco,TwistedFate,74,32,42,43.24
Shaco,JarvanIV,131,60,71,45.8
Shaco,Maokai,101,50,51,49.5
Shaco,Zeri,84,43,41,51.19
Shaco,Vayne,220,112,108,50.91
Shaco,Chogath,204,73,131,35.78
Shaco,Olaf,42,22,20,52.38
Shaco,Draven,93,45,48,48.39
Shaco,Teemo,137,63,74,45.99
Shaco,Irelia,146,75,71,51.37
Shaco,Zac,93,58,35,62.37
Shaco,Nocturne,233,101,132,43.35
Shaco,Veigar,165,62,103,37.58
Shaco,KogMaw,79,46,33,58.23
Shaco,Gwen,80,30,50,37.5
Shaco,XinZhao,105,27,78,25.71
Shaco,Zed,181,104,77,57.46
Shaco,Nidalee,71,42,29,59.15
Shaco,Vladimir,89,38,51,42.7
Shaco,Kennen,62,28,34,45.16
Shaco,Varus,123,63,60,51.22
Shaco,Mordekaiser,216,93,123,43.06
Shaco,Kindred,68,42,26,61.76
Shaco,Milio,139,65,74,46.76
Shaco,Taliyah,38,16,22,42.11
Shaco,Hwei,95,55,40,57.89
Shaco,Zoe,86,60,26,69.77
Shaco,Rumble,36,23,13,63.89
Shaco,Corki,80,54,26,67.5
Shaco,Sona,46,23,23,50
Shaco,Urgot,58,37,21,63.79
Shaco,Sett,255,132,123,51.76
Shaco,Elise,172,93,79,54.07
Shaco,Yone,314,156,158,49.68
Shaco,Shen,154,73,81,47.4
Shaco,Aurora,154,68,86,44.16
Shaco,Rengar,58,45,13,77.59
Shaco,Lillia,93,41,52,44.09
Shaco,Nami,158,81,77,51.27
Shaco,Malphite,185,75,110,40.54
Shaco,Viego,227,101,126,44.49
Shaco,Leona,183,102,81,55.74
Shaco,Camille,62,33,29,53.23
Shaco,LeeSin,362,224,138,61.88
Shaco,Orianna,62,38,24,61.29
Shaco,Annie,21,6,15,28.57
Shaco,Neeko,100,38,62,38
Shaco,Gangplank,117,38,79,32.48
Shaco,Lucian,135,82,53,60.74
Shaco,Pyke,149,79,70,53.02
Shaco,Garen,238,131,107,55.04
Shaco,Nautilus,198,102,96,51.52
Shaco,FiddleSticks,78,32,46,41.03
Shaco,Xerath,141,70,71,49.65
Shaco,Singed,36,13,23,36.11
Shaco,Swain,139,63,76,45.32
Shaco,Seraphine,146,72,74,49.32
Shaco,Vi,165,70,95,42.42
Shaco,Zilean,63,35,28,55.56
Shaco,Shyvana,51,34,17,66.67
Shaco,Aphelios,85,33,52,38.82
Shaco,Khazix,99,52,47,52.53
Shaco,TahmKench,147,82,65,55.78
Shaco,KSante,128,71,57,55.47
Shaco,Karthus,50,24,26,48
Shaco,Talon,80,27,53,33.75
Shaco,Fizz,101,49,52,48.51
Shaco,Azir,76,46,30,60.53
Shaco,Heimerdinger,86,42,44,48.84
Shaco,AurelionSol,84,30,54,35.71
Shaco,Cassiopeia,55,35,20,63.64
Shaco,Thresh,316,149,167,47.15
Shaco,Tryndamere,60,39,21,65
Shaco,Zyra,151,91,60,60.26
Shaco,Pantheon,272,139,133,51.1
Shaco,Ryze,44,19,25,43.18
Shaco,Hecarim,57,31,26,54.39
Shaco,Lissandra,82,28,54,34.15
Shaco,Jayce,75,40,35,53.33
Shaco,Rammus,42,12,30,28.57
Shaco,Ivern,26,20,6,76.92
Shaco,Smolder,121,45,76,37.19
Shaco,Poppy,118,59,59,50
Shaco,Skarner,60,27,33,45
Shaco,Sivir,100,33,67,33
Shaco,Kayle,107,47,60,43.93
Shaco,Janna,53,17,36,32.08
Shaco,Nunu,125,47,78,37.6
Shaco,Samira,115,48,67,41.74
Shaco,Galio,191,74,117,38.74
Shaco,Velkoz,66,43,23,65.15
Shaco,Renata,32,21,11,65.63
Shaco,Ziggs,54,26,28,48.15
Shaco,Aatrox,158,71,87,44.94
Shaco,Katarina,98,47,51,47.96
Shaco,Fiora,65,35,30,53.85
Shaco,Rell,100,47,53,47
Shaco,Ornn,102,47,55,46.08
Shaco,Akshan,38,15,23,39.47
Shaco,Briar,100,42,58,42
Shaco,Evelynn,57,31,26,54.39
Shaco,RekSai,37,22,15,59.46
Shaco,Taric,31,6,25,19.35
Shaco,Yuumi,145,73,72,50.34
Shaco,Syndra,79,40,39,50.63
Shaco,Anivia,77,35,42,45.45
Shaco,DrMundo,59,26,33,44.07
Shaco,Senna,84,28,56,33.33
Shaco,Kled,29,8,21,27.59
Shaco,Kassadin,32,9,23,28.13
Shaco,Bard,55,28,27,50.91
Shaco,Illaoi,81,30,51,37.04
Shaco,Belveth,24,2,22,8.33
Shaco,Quinn,34,17,17,50
Shaco,Kalista,28,19,9,67.86
Shaco,Naafiri,37,18,19,48.65
Azir,Renekton,59,32,27,54.24
Azir,Udyr,29,20,9,68.97
Azir,Qiyana,13,8,5,61.54
Azir,Xayah,84,46,38,54.76
Azir,Morgana,90,47,43,52.22
Azir,Akali,86,41,45,47.67
Azir,Amumu,105,41,64,39.05
Azir,Riven,42,23,19,54.76
Azir,Caitlyn,248,117,131,47.18
Azir,Lux,226,117,109,51.77
Azir,Teemo,80,37,43,46.25
Azir,Khazix,38,12,26,31.58
Azir,Zoe,35,14,21,40
Azir,Jinx,228,109,119,47.81
Azir,Poppy,83,32,51,38.55
Azir,Karma,149,89,60,59.73
Azir,MonkeyKing,83,34,49,40.96
Azir,Mel,254,155,99,61.02
Azir,Cassiopeia,17,14,3,82.35
Azir,Thresh,148,58,90,39.19
Azir,KSante,45,21,24,46.67
Azir,Lillia,54,26,28,48.15
Azir,Diana,165,65,100,39.39
Azir,Twitch,62,22,40,35.48
Azir,Bard,24,12,12,50
Azir,Garen,138,77,61,55.8
Azir,Viktor,137,78,59,56.93
Azir,Talon,47,29,18,61.7
Azir,Sivir,73,34,39,46.58
Azir,Lulu,154,60,94,38.96
Azir,Warwick,79,27,52,34.18
Azir,Nunu,54,35,19,64.81
Azir,Malzahar,124,78,46,62.9
Azir,Samira,92,42,50,45.65
Azir,Pyke,104,67,37,64.42
Azir,Irelia,74,32,42,43.24
Azir,XinZhao,85,45,40,52.94
Azir,Zed,111,46,65,41.44
Azir,Kaisa,192,79,113,41.15
Azir,Brand,35,12,23,34.29
Azir,Illaoi,33,16,17,48.48
Azir,MasterYi,102,47,55,46.08
Azir,Yone,181,104,77,57.46
Azir,Lucian,99,63,36,63.64
Azir,Nami,88,35,53,39.77
Azir,Vladimir,65,26,39,40
Azir,Karthus,26,9,17,34.62
Azir,Ekko,94,48,46,51.06
Azir,Zeri,73,18,55,24.66
Azir,Seraphine,71,31,40,43.66
Azir,Shen,87,46,41,52.87
Azir,Gragas,86,45,41,52.33
Azir,Aurora,117,59,58,50.43
Azir,Ashe,215,106,109,49.3
Azir,Aatrox,136,71,65,52.21
Azir,Yorick,108,44,64,40.74
Azir,Ezreal,265,123,142,46.42
Azir,Maokai,65,25,40,38.46
Azir,Blitzcrank,105,60,45,57.14
Azir,Mordekaiser,140,51,89,36.43
Azir,Skarner,69,42,27,60.87
Azir,Varus,66,29,37,43.94
Azir,Neeko,60,29,31,48.33
Azir,Briar,47,20,27,42.55
Azir,Nautilus,150,79,71,52.67
Azir,Rammus,42,12,30,28.57
Azir,Zilean,23,8,15,34.78
Azir,Draven,61,32,29,52.46
Azir,Darius,235,121,114,51.49
Azir,JarvanIV,79,39,40,49.37
Azir,Yuumi,102,49,53,48.04
Azir,Orianna,68,45,23,66.18
Azir,Ivern,20,8,12,40
Azir,Kayn,142,70,72,49.3
Azir,TwistedFate,24,9,15,37.5
Azir,Chogath,98,50,48,51.02
Azir,Zac,65,33,32,50.77
Azir,Soraka,40,31,9,77.5
Azir,Yasuo,190,100,90,52.63
Azir,Sett,179,93,86,51.96
Azir,Fiora,28,13,15,46.43
Azir,Shaco,76,30,46,39.47
Azir,Veigar,76,38,38,50
Azir,Tristana,98,39,59,39.8
Azir,Jax,64,40,24,62.5
Azir,Aphelios,64,23,41,35.94
Azir,Leona,104,39,65,37.5
Azir,Pantheon,180,71,109,39.44
Azir,Katarina,52,25,27,48.08
Azir,Milio,61,38,23,62.3
Azir,Evelynn,36,17,19,47.22
Azir,Jhin,158,66,92,41.77
Azir,Zyra,99,47,52,47.47
Azir,Ryze,56,34,22,60.71
Azir,Leblanc,64,20,44,31.25
Azir,MissFortune,190,85,105,44.74
Azir,Tryndamere,18,8,10,44.44
Azir,Sona,14,6,8,42.86
Azir,Malphite,108,42,66,38.89
Azir,Sylas,158,61,97,38.61
Azir,Smolder,71,38,33,53.52
Azir,TahmKench,100,44,56,44
Azir,Shyvana,32,5,27,15.63
Azir,Quinn,36,20,16,55.56
Azir,LeeSin,191,94,97,49.21
Azir,Alistar,67,22,45,32.84
Azir,Jayce,72,33,39,45.83
Azir,Ahri,131,57,74,43.51
Azir,Senna,58,28,30,48.28
Azir,Kassadin,15,6,9,40
Azir,Rakan,55,23,32,41.82
Azir,Heimerdinger,26,12,14,46.15
Azir,Swain,96,41,55,42.71
Azir,Nidalee,43,20,23,46.51
Azir,Ziggs,33,16,17,48.48
Azir,Viego,157,96,61,61.15
Azir,Kindred,30,11,19,36.67
Azir,Kennen,26,9,17,34.62
Azir,Urgot,44,23,21,52.27
Azir,KogMaw,23,14,9,60.87
Azir,Vi,117,34,83,29.06
Azir,Nasus,58,22,36,37.93
Azir,Syndra,87,39,48,44.83
Azir,Lissandra,27,17,10,62.96
Azir,Braum,99,33,66,33.33
Azir,Vex,52,5,47,9.62
Azir,Kayle,38,17,21,44.74
Azir,Hecarim,50,23,27,46
Azir,Rell,69,34,35,49.28
Azir,Trundle,45,14,31,31.11
Azir,RekSai,16,5,11,31.25
Azir,Ambessa,90,50,40,55.56
Azir,Akshan,33,19,14,57.58
Azir,Gwen,43,12,31,27.91
Azir,Sejuani,59,27,32,45.76
Azir,Fizz,17,3,14,17.65
Azir,Volibear,89,31,58,34.83
Azir,Vayne,109,52,57,47.71
Azir,Taric,23,12,11,52.17
Azir,Sion,75,37,38,49.33
Azir,Ornn,75,29,46,38.67
Azir,Velkoz,54,28,26,51.85
Azir,Gnar,42,19,23,45.24
Azir,Hwei,80,47,33,58.75
Azir,Graves,88,51,37,57.95
Azir,Nilah,31,18,13,58.06
Azir,Taliyah,32,8,24,25
Azir,Galio,106,51,55,48.11
Azir,Rumble,41,16,25,39.02
Azir,Naafiri,35,19,16,54.29
Azir,Camille,49,19,30,38.78
Azir,Corki,49,30,19,61.22
Azir,Kalista,35,9,26,25.71
Azir,Anivia,32,8,24,25
Azir,Xerath,56,30,26,53.57
Azir,Renata,28,18,10,64.29
Azir,Nocturne,121,53,68,43.8
Azir,Singed,28,5,23,17.86
Azir,FiddleSticks,59,29,30,49.15
Azir,Annie,32,15,17,46.88
Azir,DrMundo,28,18,10,64.29
Azir,Elise,87,39,48,44.83
Azir,Olaf,22,6,16,27.27
Azir,Janna,35,13,22,37.14
Azir,Rengar,27,17,10,62.96
Azir,Belveth,17,9,8,52.94
Azir,AurelionSol,29,5,24,17.24
Azir,Kled,17,6,11,35.29
Azir,Gangplank,57,36,21,63.16
Sylas,Renekton,171,71,100,41.52
Sylas,Udyr,119,47,72,39.5
Sylas,Qiyana,92,52,40,56.52
Sylas,Xayah,210,103,107,49.05
Sylas,Morgana,346,158,188,45.66
Sylas,Akali,474,244,230,51.48
Sylas,Belveth,78,42,36,53.85
Sylas,Varus,380,187,193,49.21
Sylas,Jhin,675,354,321,52.44
Sylas,Lulu,484,232,252,47.93
Sylas,Kayn,393,188,205,47.84
Sylas,Shaco,222,123,99,55.41
Sylas,Zoe,186,81,105,43.55
Sylas,KogMaw,92,47,45,51.09
Sylas,TwistedFate,149,90,59,60.4
Sylas,KSante,225,113,112,50.22
Sylas,Viego,476,230,246,48.32
Sylas,Kassadin,80,39,41,48.75
Sylas,Nasus,215,105,110,48.84
Sylas,Bard,94,56,38,59.57
Sylas,Naafiri,93,36,57,38.71
Sylas,Warwick,406,214,192,52.71
Sylas,Mel,783,348,435,44.44
Sylas,Ashe,855,440,415,51.46
Sylas,Janna,84,37,47,44.05
Sylas,Yorick,213,102,111,47.89
Sylas,Hwei,234,114,120,48.72
Sylas,Samira,250,120,130,48
Sylas,Zyra,317,172,145,54.26
Sylas,Graves,314,139,175,44.27
Sylas,Caitlyn,859,426,433,49.59
Sylas,Teemo,286,144,142,50.35
Sylas,Briar,171,73,98,42.69
Sylas,Heimerdinger,116,53,63,45.69
Sylas,Nautilus,483,247,236,51.14
Sylas,Shen,293,125,168,42.66
Sylas,Hecarim,161,88,73,54.66
Sylas,Alistar,308,167,141,54.22
Sylas,FiddleSticks,183,70,113,38.25
Sylas,Lucian,296,149,147,50.34
Sylas,Rell,214,93,121,43.46
Sylas,XinZhao,243,122,121,50.21
Sylas,Aurora,313,185,128,59.11
Sylas,Sivir,189,88,101,46.56
Sylas,Soraka,115,64,51,55.65
Sylas,Rumble,123,58,65,47.15
Sylas,Kindred,111,50,61,45.05
Sylas,Yasuo,764,339,425,44.37
Sylas,Draven,121,62,59,51.24
Sylas,Taric,83,34,49,40.96
Sylas,Volibear,280,113,167,40.36
Sylas,Ahri,611,325,286,53.19
Sylas,Vayne,382,160,222,41.88
Sylas,Rakan,162,77,85,47.53
Sylas,Riven,152,76,76,50
Sylas,LeeSin,782,401,381,51.28
Sylas,MissFortune,643,329,314,51.17
Sylas,Leona,399,219,180,54.89
Sylas,Olaf,77,37,40,48.05
Sylas,Ezreal,1010,540,470,53.47
Sylas,Diana,592,306,286,51.69
Sylas,Irelia,288,165,123,57.29
Sylas,Amumu,470,228,242,48.51
Sylas,Katarina,217,115,102,53
Sylas,Rammus,113,53,60,46.9
Sylas,MasterYi,367,184,183,50.14
Sylas,Chogath,430,195,235,45.35
Sylas,Karma,456,181,275,39.69
Sylas,Garen,608,298,310,49.01
Sylas,Pantheon,585,256,329,43.76
Sylas,Malzahar,283,131,152,46.29
Sylas,Malphite,588,350,238,59.52
Sylas,Lux,721,415,306,57.56
Sylas,Nocturne,464,245,219,52.8
Sylas,Taliyah,116,56,60,48.28
Sylas,Jinx,902,400,502,44.35
Sylas,Twitch,204,94,110,46.08
Sylas,Zed,335,173,162,51.64
Sylas,Darius,633,302,331,47.71
Sylas,JarvanIV,311,137,174,44.05
Sylas,Elise,291,132,159,45.36
Sylas,Aatrox,436,236,200,54.13
Sylas,Ekko,295,164,131,55.59
Sylas,Yone,718,366,352,50.97
Sylas,Talon,211,115,96,54.5
Sylas,Fizz,143,75,68,52.45
Sylas,Zilean,95,35,60,36.84
Sylas,Galio,544,256,288,47.06
Sylas,Illaoi,142,69,73,48.59
Sylas,Evelynn,84,49,35,58.33
Sylas,Khazix,149,69,80,46.31
Sylas,Gnar,189,90,99,47.62
Sylas,Braum,280,113,167,40.36
Sylas,Vladimir,212,100,112,47.17
Sylas,Lissandra,143,72,71,50.35
Sylas,Nidalee,120,56,64,46.67
Sylas,Kaisa,632,333,299,52.69
Sylas,Mordekaiser,407,209,198,51.35
Sylas,Milio,174,70,104,40.23
Sylas,Thresh,639,300,339,46.95
Sylas,Urgot,110,64,46,58.18
Sylas,Seraphine,245,90,155,36.73
Sylas,Jax,311,160,151,51.45
Sylas,Neeko,204,91,113,44.61
Sylas,Rengar,94,36,58,38.3
Sylas,Ziggs,129,60,69,46.51
Sylas,TahmKench,290,145,145,50
Sylas,Brand,130,57,73,43.85
Sylas,Tryndamere,86,48,38,55.81
Sylas,Maokai,168,85,83,50.6
Sylas,Vex,255,111,144,43.53
Sylas,Ornn,239,101,138,42.26
Sylas,Ivern,63,37,26,58.73
Sylas,Nunu,184,92,92,50
Sylas,Blitzcrank,436,251,185,57.57
Sylas,Senna,215,123,92,57.21
Sylas,Poppy,251,118,133,47.01
Sylas,Sett,517,239,278,46.23
Sylas,Tristana,275,140,135,50.91
Sylas,Gragas,294,141,153,47.96
Sylas,Sejuani,239,92,147,38.49
Sylas,Gangplank,234,133,101,56.84
Sylas,Veigar,229,113,116,49.34
Sylas,Swain,314,139,175,44.27
Sylas,Pyke,344,169,175,49.13
Sylas,Fiora,98,40,58,40.82
Sylas,Velkoz,135,58,77,42.96
Sylas,Smolder,242,142,100,58.68
Sylas,Akshan,67,22,45,32.84
Sylas,Nilah,98,28,70,28.57
Sylas,Renata,73,44,29,60.27
Sylas,Nami,247,108,139,43.72
Sylas,Viktor,322,131,191,40.68
Sylas,Sona,76,35,41,46.05
Sylas,Vi,419,200,219,47.73
Sylas,MonkeyKing,263,112,151,42.59
Sylas,Azir,158,97,61,61.39
Sylas,Annie,91,37,54,40.66
Sylas,Yuumi,234,117,117,50
Sylas,Kalista,124,68,56,54.84
Sylas,Camille,188,86,102,45.74
Sylas,Zac,207,118,89,57
Sylas,Leblanc,204,127,77,62.25
Sylas,Orianna,188,110,78,58.51
Sylas,Sion,276,109,167,39.49
Sylas,Singed,78,47,31,60.26
Sylas,DrMundo,122,53,69,43.44
Sylas,Zeri,143,59,84,41.26
Sylas,Kayle,150,62,88,41.33
Sylas,Shyvana,60,24,36,40
Sylas,Gwen,168,69,99,41.07
Sylas,Aphelios,201,93,108,46.27
Sylas,Corki,184,78,106,42.39
Sylas,Ambessa,242,121,121,50
Sylas,Kled,56,32,24,57.14
Sylas,Xerath,296,145,151,48.99
Sylas,Trundle,128,54,74,42.19
Sylas,Quinn,102,58,44,56.86
Sylas,Anivia,139,79,60,56.83
Sylas,Syndra,167,104,63,62.28
Sylas,Jayce,176,78,98,44.32
Sylas,Lillia,183,102,81,55.74
Sylas,Kennen,113,56,57,49.56
Sylas,Ryze,154,66,88,42.86
Sylas,Karthus,102,61,41,59.8
Sylas,Skarner,149,87,62,58.39
Sylas,Cassiopeia,91,30,61,32.97
Sylas,AurelionSol,106,63,43,59.43
Sylas,RekSai,47,19,28,40.43
Renekton,Yasuo,341,199,142,58.36
Renekton,Shaco,115,58,57,50.43
Renekton,Azir,59,27,32,45.76
Renekton,Jhin,288,148,140,51.39
Renekton,Sylas,171,100,71,58.48
Renekton,Yone,328,180,148,54.88
Renekton,FiddleSticks,38,15,23,39.47
Renekton,Aurora,120,48,72,40
Renekton,Vayne,175,95,80,54.29
Renekton,Senna,58,25,33,43.1
Renekton,KSante,141,72,69,51.06
Renekton,Nunu,68,34,34,50
Renekton,Akshan,38,23,15,60.53
Renekton,Ziggs,51,19,32,37.25
Renekton,Seraphine,80,47,33,58.75
Renekton,Teemo,95,27,68,28.42
Renekton,Lillia,83,40,43,48.19
Renekton,Camille,60,27,33,45
Renekton,Draven,71,32,39,45.07
Renekton,Ambessa,183,113,70,61.75
Renekton,Ekko,116,48,68,41.38
Renekton,Lux,241,123,118,51.04
Renekton,Caitlyn,335,158,177,47.16
Renekton,Soraka,61,25,36,40.98
Renekton,Yorick,109,42,67,38.53
Renekton,Graves,91,40,51,43.96
Renekton,Naafiri,36,12,24,33.33
Renekton,Morgana,137,52,85,37.96
Renekton,Sett,237,114,123,48.1
Renekton,Jax,105,50,55,47.62
Renekton,Irelia,93,58,35,62.37
Renekton,Yuumi,97,54,43,55.67
Renekton,Trundle,51,19,32,37.25
Renekton,Diana,222,103,119,46.4
Renekton,Ahri,180,97,83,53.89
Renekton,Tristana,102,57,45,55.88
Renekton,Janna,26,18,8,69.23
Renekton,Garen,219,120,99,54.79
Renekton,Nocturne,126,49,77,38.89
Renekton,Akali,107,66,41,61.68
Renekton,Corki,52,32,20,61.54
Renekton,Riven,65,35,30,53.85
Renekton,JarvanIV,107,80,27,74.77
Renekton,Vladimir,69,33,36,47.83
Renekton,Nami,150,57,93,38
Renekton,Ezreal,352,159,193,45.17
Renekton,MasterYi,91,40,51,43.96
Renekton,Nasus,75,48,27,64
Renekton,Alistar,66,27,39,40.91
Renekton,Malzahar,135,54,81,40
Renekton,Ashe,202,115,87,56.93
Renekton,Lulu,212,102,110,48.11
Renekton,Aatrox,168,82,86,48.81
Renekton,LeeSin,225,131,94,58.22
Renekton,Malphite,141,83,58,58.87
Renekton,Zoe,81,37,44,45.68
Renekton,Xerath,111,55,56,49.55
Renekton,Smolder,64,28,36,43.75
Renekton,Leona,119,64,55,53.78
Renekton,Talon,73,38,35,52.05
Renekton,Zyra,93,43,50,46.24
Renekton,Chogath,133,63,70,47.37
Renekton,Braum,112,62,50,55.36
Renekton,TahmKench,106,56,50,52.83
Renekton,Blitzcrank,141,69,72,48.94
Renekton,Darius,235,119,116,50.64
Renekton,Warwick,167,84,83,50.3
Renekton,Jinx,285,137,148,48.07
Renekton,Gangplank,60,26,34,43.33
Renekton,Qiyana,18,6,12,33.33
Renekton,Leblanc,86,53,33,61.63
Renekton,Lucian,103,58,45,56.31
Renekton,Twitch,103,54,49,52.43
Renekton,Swain,121,57,64,47.11
Renekton,Sion,81,49,32,60.49
Renekton,XinZhao,131,81,50,61.83
Renekton,Annie,29,14,15,48.28
Renekton,MonkeyKing,106,38,68,35.85
Renekton,Sivir,65,40,25,61.54
Renekton,Shen,92,41,51,44.57
Renekton,RekSai,39,17,22,43.59
Renekton,Veigar,109,57,52,52.29
Renekton,Milio,76,41,35,53.95
Renekton,Kayn,140,78,62,55.71
Renekton,Kaisa,217,127,90,58.53
Renekton,Heimerdinger,27,11,16,40.74
Renekton,Pantheon,193,103,90,53.37
Renekton,Cassiopeia,39,19,20,48.72
Renekton,MissFortune,250,115,135,46
Renekton,Amumu,118,54,64,45.76
Renekton,Sejuani,70,43,27,61.43
Renekton,Viktor,99,40,59,40.4
Renekton,Rell,81,42,39,51.85
Renekton,Belveth,28,22,6,78.57
Renekton,Mel,258,120,138,46.51
Renekton,Gnar,53,32,21,60.38
Renekton,Karma,177,77,100,43.5
Renekton,Poppy,105,38,67,36.19
Renekton,Viego,178,85,93,47.75
Renekton,Hwei,75,29,46,38.67
Renekton,Pyke,104,56,48,53.85
Renekton,Nilah,52,29,23,55.77
Renekton,Thresh,189,100,89,52.91
Renekton,Kennen,50,37,13,74
Renekton,Galio,128,72,56,56.25
Renekton,Illaoi,74,25,49,33.78
Renekton,Vi,158,95,63,60.13
Renekton,Xayah,89,32,57,35.96
Renekton,Rakan,84,33,51,39.29
Renekton,Quinn,71,15,56,21.13
Renekton,Urgot,53,17,36,32.08
Renekton,Zeri,58,27,31,46.55
Renekton,Fizz,62,31,31,50
Renekton,Volibear,144,57,87,39.58
Renekton,Elise,132,68,64,51.52
Renekton,Lissandra,51,19,32,37.25
Renekton,Evelynn,20,9,11,45
Renekton,Bard,51,27,24,52.94
Renekton,Zac,95,45,50,47.37
Renekton,Kalista,39,24,15,61.54
Renekton,Renata,25,13,12,52
Renekton,Gragas,101,45,56,44.55
Renekton,Olaf,14,11,3,78.57
Renekton,Syndra,75,33,42,44
Renekton,Katarina,86,38,48,44.19
Renekton,Ornn,73,37,36,50.68
Renekton,Briar,67,30,37,44.78
Renekton,Zed,136,76,60,55.88
Renekton,Khazix,64,20,44,31.25
Renekton,Nidalee,72,35,37,48.61
Renekton,Skarner,60,23,37,38.33
Renekton,DrMundo,42,30,12,71.43
Renekton,Kindred,47,29,18,61.7
Renekton,Ryze,43,20,23,46.51
Renekton,Karthus,30,16,14,53.33
Renekton,Hecarim,43,27,16,62.79
Renekton,Mordekaiser,123,67,56,54.47
Renekton,Rumble,40,15,25,37.5
Renekton,Varus,121,61,60,50.41
Renekton,TwistedFate,42,23,19,54.76
Renekton,Shyvana,26,11,15,42.31
Renekton,Velkoz,62,28,34,45.16
Renekton,Rengar,28,18,10,64.29
Renekton,Samira,114,54,60,47.37
Renekton,Maokai,52,25,27,48.08
Renekton,Taliyah,38,14,24,36.84
Renekton,Gwen,59,12,47,20.34
Renekton,Vex,59,23,36,38.98
Renekton,Nautilus,170,88,82,51.76
Renekton,Anivia,38,11,27,28.95
Renekton,Kassadin,31,21,10,67.74
Renekton,Kayle,65,26,39,40
Renekton,Fiora,34,21,13,61.76
Renekton,Jayce,53,29,24,54.72
Renekton,Orianna,41,14,27,34.15
Renekton,Rammus,45,23,22,51.11
Renekton,Ivern,33,14,19,42.42
Renekton,Brand,51,19,32,37.25
Renekton,Kled,31,13,18,41.94
Renekton,Taric,24,8,16,33.33
Renekton,AurelionSol,56,32,24,57.14
Renekton,Neeko,60,35,25,58.33
Renekton,Zilean,31,10,21,32.26
Renekton,Aphelios,69,31,38,44.93
Renekton,Singed,14,11,3,78.57
Renekton,Udyr,28,10,18,35.71
Renekton,KogMaw,31,13,18,41.94
Renekton,Tryndamere,32,19,13,59.38
Renekton,Sona,6,6,0,100
Qiyana,Yasuo,87,37,50,42.53
Qiyana,Shaco,44,26,18,59.09
Qiyana,Azir,13,5,8,38.46
Qiyana,Jhin,105,33,72,31.43
Qiyana,Sylas,92,40,52,43.48
Qiyana,Shen,18,5,13,27.78
Qiyana,Viego,86,44,42,51.16
Qiyana,Diana,77,33,44,42.86
Qiyana,Corki,46,29,17,63.04
Qiyana,TahmKench,37,18,19,48.65
Qiyana,Sett,82,25,57,30.49
Qiyana,JarvanIV,31,16,15,51.61
Qiyana,Veigar,34,15,19,44.12
Qiyana,Lux,110,54,56,49.09
Qiyana,Thresh,91,38,53,41.76
Qiyana,Kled,9,3,6,33.33
Qiyana,Gragas,42,15,27,35.71
Qiyana,Anivia,23,8,15,34.78
Qiyana,Jinx,131,62,69,47.33
Qiyana,Rell,33,17,16,51.52
Qiyana,Darius,92,34,58,36.96
Qiyana,Vi,61,32,29,52.46
Qiyana,Soraka,38,19,19,50
Qiyana,Pantheon,73,41,32,56.16
Qiyana,Kaisa,99,46,53,46.46
Qiyana,Pyke,31,17,14,54.84
Qiyana,Gnar,26,3,23,11.54
Qiyana,Graves,34,9,25,26.47
Qiyana,Aurora,46,23,23,50
Qiyana,Ezreal,155,76,79,49.03
Qiyana,Karma,62,38,24,61.29
Qiyana,Gangplank,25,12,13,48
Qiyana,Warwick,66,34,32,51.52
Qiyana,Zed,63,27,36,42.86
Qiyana,Zeri,35,17,18,48.57
Qiyana,Lulu,65,40,25,61.54
Qiyana,Chogath,78,33,45,42.31
Qiyana,Sejuani,44,20,24,45.45
Qiyana,Vex,54,17,37,31.48
Qiyana,Mel,99,39,60,39.39
Qiyana,Seraphine,40,11,29,27.5
Qiyana,Ornn,30,11,19,36.67
Qiyana,Sion,49,25,24,51.02
Qiyana,MasterYi,58,22,36,37.93
Qiyana,Ahri,66,30,36,45.45
Qiyana,Renekton,18,12,6,66.67
Qiyana,KogMaw,17,12,5,70.59
Qiyana,Yuumi,44,18,26,40.91
Qiyana,Tryndamere,16,9,7,56.25
Qiyana,Varus,42,23,19,54.76
Qiyana,Senna,44,21,23,47.73
Qiyana,Rumble,9,0,9,0
Qiyana,Kayn,48,27,21,56.25
Qiyana,Zyra,34,14,20,41.18
Qiyana,Urgot,32,12,20,37.5
Qiyana,Morgana,55,26,29,47.27
Qiyana,Caitlyn,111,66,45,59.46
Qiyana,Malzahar,44,23,21,52.27
Qiyana,Ivern,17,15,2,88.24
Qiyana,AurelionSol,18,11,7,61.11
Qiyana,Mordekaiser,48,14,34,29.17
Qiyana,Akali,43,25,18,58.14
Qiyana,Hwei,21,6,15,28.57
Qiyana,Nami,47,25,22,53.19
Qiyana,Yorick,42,13,29,30.95
Qiyana,Kindred,23,4,19,17.39
Qiyana,Ekko,41,21,20,51.22
Qiyana,Vayne,49,26,23,53.06
Qiyana,Milio,38,16,22,42.11
Qiyana,Malphite,70,27,43,38.57
Qiyana,Twitch,43,12,31,27.91
Qiyana,Poppy,30,21,9,70
Qiyana,Nidalee,27,11,16,40.74
Qiyana,Volibear,52,31,21,59.62
Qiyana,Ryze,29,20,9,68.97
Qiyana,Ashe,69,38,31,55.07
Qiyana,Leona,50,18,32,36
Qiyana,Briar,22,7,15,31.82
Qiyana,Yone,94,48,46,51.06
Qiyana,Fiora,32,5,27,15.63
Qiyana,Khazix,16,7,9,43.75
Qiyana,Katarina,37,24,13,64.86
Qiyana,Draven,34,17,17,50
Qiyana,MonkeyKing,25,4,21,16
Qiyana,Lissandra,33,20,13,60.61
Qiyana,Bard,14,5,9,35.71
Qiyana,LeeSin,87,49,38,56.32
Qiyana,Nautilus,67,28,39,41.79
Qiyana,Orianna,32,15,17,46.88
Qiyana,Jax,35,27,8,77.14
Qiyana,Maokai,33,14,19,42.42
Qiyana,Heimerdinger,22,11,11,50
Qiyana,Janna,8,3,5,37.5
Qiyana,Aatrox,61,25,36,40.98
Qiyana,Syndra,38,18,20,47.37
Qiyana,MissFortune,87,30,57,34.48
Qiyana,Riven,19,8,11,42.11
Qiyana,Udyr,16,11,5,68.75
Qiyana,Nilah,12,9,3,75
Qiyana,Taric,7,5,2,71.43
Qiyana,Camille,23,23,0,100
Qiyana,Amumu,57,31,26,54.39
Qiyana,FiddleSticks,27,11,16,40.74
Qiyana,Fizz,23,11,12,47.83
Qiyana,Blitzcrank,46,23,23,50
Qiyana,Swain,47,21,26,44.68
Qiyana,Trundle,16,4,12,25
Qiyana,Brand,42,21,21,50
Qiyana,Rammus,19,11,8,57.89
Qiyana,XinZhao,35,11,24,31.43
Qiyana,Vladimir,26,13,13,50
Qiyana,Rakan,31,12,19,38.71
Qiyana,Lucian,40,22,18,55
Qiyana,Braum,33,13,20,39.39
Qiyana,Kennen,16,11,5,68.75
Qiyana,Kassadin,6,3,3,50
Qiyana,Tristana,27,15,12,55.56
Qiyana,Alistar,17,8,9,47.06
Qiyana,Aphelios,23,3,20,13.04
Qiyana,Shyvana,10,3,7,30
Qiyana,Hecarim,10,5,5,50
Qiyana,Teemo,59,34,25,57.63
Qiyana,Nunu,27,11,16,40.74
Qiyana,Karthus,9,5,4,55.56
Qiyana,Nocturne,44,28,16,63.64
Qiyana,DrMundo,24,9,15,37.5
Qiyana,Sivir,14,9,5,64.29
Qiyana,Samira,37,27,10,72.97
Qiyana,Elise,41,15,26,36.59
Qiyana,Ambessa,27,8,19,29.63
Qiyana,Belveth,11,3,8,27.27
Qiyana,Zoe,20,6,14,30
Qiyana,Nasus,24,14,10,58.33
Qiyana,Skarner,18,8,10,44.44
Qiyana,Garen,47,34,13,72.34
Qiyana,Renata,13,8,5,61.54
Qiyana,Naafiri,10,5,5,50
Qiyana,Lillia,12,4,8,33.33
Qiyana,Cassiopeia,17,3,14,17.65
Qiyana,Galio,70,22,48,31.43
Qiyana,Rengar,13,2,11,15.38
Qiyana,Smolder,33,11,22,33.33
Qiyana,Kayle,22,7,15,31.82
Qiyana,Kalista,12,5,7,41.67
Qiyana,Evelynn,9,5,4,55.56
Qiyana,Xayah,21,10,11,47.62
Qiyana,Xerath,44,28,16,63.64
Qiyana,Zac,31,14,17,45.16
Qiyana,Quinn,14,5,9,35.71
Qiyana,Irelia,17,9,8,52.94
Qiyana,Ziggs,22,10,12,45.45
Qiyana,Velkoz,22,6,16,27.27
Qiyana,Neeko,26,15,11,57.69
Qiyana,Gwen,17,14,3,82.35
Qiyana,Viktor,32,26,6,81.25
Qiyana,Olaf,16,2,14,12.5
Qiyana,Leblanc,17,9,8,52.94
Qiyana,Taliyah,11,8,3,72.73
Qiyana,KSante,21,5,16,23.81
Qiyana,Akshan,13,6,7,46.15
Qiyana,TwistedFate,16,8,8,50
Qiyana,Talon,17,11,6,64.71
Qiyana,Illaoi,12,12,0,100
Qiyana,Jayce,11,5,6,45.45
Qiyana,Zilean,9,6,3,66.67
Qiyana,Annie,12,3,9,25
Qiyana,RekSai,6,3,3,50
Qiyana,Sona,3,3,0,100
Qiyana,Singed,6,3,3,50
Fiora,Garen,117,57,60,48.72
Fiora,Zed,89,58,31,65.17
Fiora,Mel,177,82,95,46.33
Fiora,Caitlyn,210,104,106,49.52
Fiora,Morgana,66,29,37,43.94
Fiora,Shen,82,48,34,58.54
Fiora,MasterYi,53,28,25,52.83
Fiora,Katarina,65,35,30,53.85
Fiora,Jhin,192,91,101,47.4
Fiora,Karma,109,61,48,55.96
Fiora,KSante,112,49,63,43.75
Fiora,Lillia,40,29,11,72.5
Fiora,Diana,130,63,67,48.46
Fiora,Twitch,60,31,29,51.67
Fiora,Bard,14,12,2,85.71
Fiora,Riven,56,19,37,33.93
Fiora,Zoe,32,24,8,75
Fiora,Ezreal,189,119,70,62.96
Fiora,Nautilus,126,53,73,42.06
Fiora,Irelia,71,33,38,46.48
Fiora,Rammus,38,21,17,55.26
Fiora,Mordekaiser,145,71,74,48.97
Fiora,KogMaw,35,14,21,40
Fiora,Lux,192,106,86,55.21
Fiora,Ornn,75,39,36,52
Fiora,Sejuani,48,12,36,25
Fiora,Lissandra,32,10,22,31.25
Fiora,Ashe,165,83,82,50.3
Fiora,Braum,66,31,35,46.97
Fiora,Poppy,77,43,34,55.84
Fiora,Rengar,29,19,10,65.52
Fiora,Heimerdinger,35,24,11,68.57
Fiora,Vi,122,75,47,61.48
Fiora,Amumu,101,52,49,51.49
Fiora,Aurora,59,39,20,66.1
Fiora,Draven,55,33,22,60
Fiora,Thresh,110,51,59,46.36
Fiora,Gnar,37,20,17,54.05
Fiora,Talon,57,30,27,52.63
Fiora,Veigar,57,29,28,50.88
Fiora,Brand,21,10,11,47.62
Fiora,Darius,150,80,70,53.33
Fiora,Volibear,72,33,39,45.83
Fiora,Yasuo,163,69,94,42.33
Fiora,Warwick,72,36,36,50
Fiora,AurelionSol,37,19,18,51.35
Fiora,Sett,104,39,65,37.5
Fiora,Jax,94,42,52,44.68
Fiora,Swain,95,34,61,35.79
Fiora,Zyra,61,40,21,65.57
Fiora,LeeSin,154,80,74,51.95
Fiora,Azir,28,15,13,53.57
Fiora,XinZhao,60,36,24,60
Fiora,Kayn,90,37,53,41.11
Fiora,MissFortune,145,85,60,58.62
Fiora,Nami,86,34,52,39.53
Fiora,Kayle,52,20,32,38.46
Fiora,Karthus,20,9,11,45
Fiora,Pantheon,131,59,72,45.04
Fiora,Khazix,50,23,27,46
Fiora,Qiyana,32,27,5,84.38
Fiora,Xayah,47,30,17,63.83
Fiora,Neeko,42,23,19,54.76
Fiora,TahmKench,107,50,57,46.73
Fiora,DrMundo,49,16,33,32.65
Fiora,Anivia,22,5,17,22.73
Fiora,Vayne,78,35,43,44.87
Fiora,Aatrox,96,38,58,39.58
Fiora,Shyvana,8,6,2,75
Fiora,Syndra,55,29,26,52.73
Fiora,Milio,51,17,34,33.33
Fiora,Chogath,177,102,75,57.63
Fiora,Taric,34,14,20,41.18
Fiora,Teemo,43,12,31,27.91
Fiora,Sylas,98,58,40,59.18
Fiora,Jinx,243,117,126,48.15
Fiora,Yorick,56,32,24,57.14
Fiora,Orianna,39,15,24,38.46
Fiora,Blitzcrank,76,40,36,52.63
Fiora,Jayce,65,23,42,35.38
Fiora,Kaisa,142,64,78,45.07
Fiora,Briar,38,19,19,50
Fiora,Malphite,87,32,55,36.78
Fiora,Pyke,68,33,35,48.53
Fiora,Nasus,65,36,29,55.38
Fiora,Ekko,92,59,33,64.13
Fiora,Quinn,20,5,15,25
Fiora,Evelynn,38,10,28,26.32
Fiora,Malzahar,86,46,40,53.49
Fiora,Janna,16,11,5,68.75
Fiora,Gwen,61,27,34,44.26
Fiora,Skarner,49,33,16,67.35
Fiora,Ziggs,20,14,6,70
Fiora,Elise,117,79,38,67.52
Fiora,Ahri,105,57,48,54.29
Fiora,Sivir,50,28,22,56
Fiora,Gragas,57,34,23,59.65
Fiora,Lucian,61,29,32,47.54
Fiora,Seraphine,81,43,38,53.09
Fiora,Viego,99,47,52,47.47
Fiora,MonkeyKing,43,26,17,60.47
Fiora,Aphelios,43,27,16,62.79
Fiora,Lulu,144,68,76,47.22
Fiora,Shaco,65,30,35,46.15
Fiora,Viktor,84,53,31,63.1
Fiora,Leona,84,53,31,63.1
Fiora,Hwei,49,26,23,53.06
Fiora,Kalista,32,14,18,43.75
Fiora,Vladimir,45,17,28,37.78
Fiora,Galio,106,48,58,45.28
Fiora,Nocturne,75,30,45,40
Fiora,Yuumi,51,19,32,37.25
Fiora,Kassadin,11,6,5,54.55
Fiora,Nunu,45,22,23,48.89
Fiora,Zeri,68,22,46,32.35
Fiora,Yone,151,92,59,60.93
Fiora,Leblanc,50,46,4,92
Fiora,Zac,63,24,39,38.1
Fiora,Xerath,75,31,44,41.33
Fiora,Akshan,32,10,22,31.25
Fiora,Rell,55,34,21,61.82
Fiora,JarvanIV,67,25,42,37.31
Fiora,Vex,42,19,23,45.24
Fiora,Kled,7,7,0,100
Fiora,Varus,71,39,32,54.93
Fiora,Velkoz,35,13,22,37.14
Fiora,Rumble,31,21,10,67.74
Fiora,RekSai,16,14,2,87.5
Fiora,Samira,74,38,36,51.35
Fiora,Ivern,15,5,10,33.33
Fiora,Soraka,37,18,19,48.65
Fiora,Singed,19,5,14,26.32
Fiora,Cassiopeia,10,2,8,20
Fiora,Illaoi,43,29,14,67.44
Fiora,Naafiri,31,23,8,74.19
Fiora,Rakan,48,32,16,66.67
Fiora,Hecarim,40,34,6,85
Fiora,Smolder,55,13,42,23.64
Fiora,Nilah,37,27,10,72.97
Fiora,Urgot,31,5,26,16.13
Fiora,Corki,52,21,31,40.38
Fiora,Sion,65,36,29,55.38
Fiora,Sona,17,11,6,64.71
Fiora,Ambessa,60,32,28,53.33
Fiora,Annie,15,8,7,53.33
Fiora,Tryndamere,26,13,13,50
Fiora,Taliyah,36,15,21,41.67
Fiora,Tristana,84,46,38,54.76
Fiora,Zilean,22,9,13,40.91
Fiora,Fizz,39,26,13,66.67
Fiora,Udyr,31,17,14,54.84
Fiora,Alistar,52,29,23,55.77
Fiora,Renekton,34,13,21,38.24
Fiora,Ryze,46,27,19,58.7
Fiora,Nidalee,33,20,13,60.61
Fiora,FiddleSticks,48,17,31,35.42
Fiora,Camille,65,30,35,46.15
Fiora,Kindred,44,18,26,40.91
Fiora,TwistedFate,35,16,19,45.71
Fiora,Akali,60,15,45,25
Fiora,Senna,57,33,24,57.89
Fiora,Olaf,16,6,10,37.5
Fiora,Kennen,20,12,8,60
Fiora,Trundle,36,10,26,27.78
Fiora,Graves,30,13,17,43.33
Fiora,Maokai,47,24,23,51.06
Fiora,Renata,17,5,12,29.41
Fiora,Belveth,16,6,10,37.5
Fiora,Gangplank,52,28,24,53.85
Nilah,Garen,119,61,58,51.26
Nilah,Zed,83,52,31,62.65
Nilah,Mel,130,93,37,71.54
Nilah,Caitlyn,171,109,62,63.74
Nilah,Morgana,102,62,40,60.78
Nilah,Quinn,22,15,7,68.18
Nilah,Sejuani,44,25,19,56.82
Nilah,Leblanc,22,17,5,77.27
Nilah,Twitch,46,21,25,45.65
Nilah,Nautilus,107,51,56,47.66
Nilah,Rell,62,30,32,48.39
Nilah,Rengar,38,27,11,71.05
Nilah,Sett,112,71,41,63.39
Nilah,Varus,87,39,48,44.83
Nilah,Mordekaiser,109,49,60,44.95
Nilah,Diana,93,45,48,48.39
Nilah,Yone,120,51,69,42.5
Nilah,Xerath,42,14,28,33.33
Nilah,Poppy,68,32,36,47.06
Nilah,FiddleSticks,12,3,9,25
Nilah,Lux,185,101,84,54.59
Nilah,Ashe,152,84,68,55.26
Nilah,Braum,43,28,15,65.12
Nilah,Darius,133,74,59,55.64
Nilah,Shaco,72,38,34,52.78
Nilah,Ekko,51,31,20,60.78
Nilah,Kaisa,148,92,56,62.16
Nilah,Neeko,46,31,15,67.39
Nilah,Warwick,105,52,53,49.52
Nilah,Viego,103,56,47,54.37
Nilah,Ahri,86,54,32,62.79
Nilah,Jinx,182,90,92,49.45
Nilah,Hwei,43,26,17,60.47
Nilah,Ziggs,31,9,22,29.03
Nilah,KSante,72,30,42,41.67
Nilah,Malzahar,101,53,48,52.48
Nilah,Senna,50,21,29,42
Nilah,Kennen,16,11,5,68.75
Nilah,Volibear,93,48,45,51.61
Nilah,Lulu,107,37,70,34.58
Nilah,Irelia,44,24,20,54.55
Nilah,Rammus,21,12,9,57.14
Nilah,KogMaw,27,15,12,55.56
Nilah,Nasus,63,37,26,58.73
Nilah,Amumu,96,53,43,55.21
Nilah,MissFortune,167,79,88,47.31
Nilah,Vex,46,18,28,39.13
Nilah,Sion,54,23,31,42.59
Nilah,JarvanIV,66,29,37,43.94
Nilah,Nunu,50,25,25,50
Nilah,Brand,58,19,39,32.76
Nilah,Gragas,62,43,19,69.35
Nilah,LeeSin,132,76,56,57.58
Nilah,TwistedFate,32,16,16,50
Nilah,Tristana,63,30,33,47.62
Nilah,Pyke,84,38,46,45.24
Nilah,Lillia,45,22,23,48.89
Nilah,Katarina,57,36,21,63.16
Nilah,Samira,116,65,51,56.03
Nilah,Zilean,26,7,19,26.92
Nilah,Kled,16,5,11,31.25
Nilah,Kayn,102,41,61,40.2
Nilah,Veigar,60,29,31,48.33
Nilah,Vayne,87,37,50,42.53
Nilah,Olaf,23,9,14,39.13
Nilah,Malphite,85,34,51,40
Nilah,MasterYi,67,46,21,68.66
Nilah,Chogath,112,55,57,49.11
Nilah,Cassiopeia,48,24,24,50
Nilah,XinZhao,51,26,25,50.98
Nilah,Hecarim,16,3,13,18.75
Nilah,Lissandra,45,21,24,46.67
Nilah,Vladimir,40,21,19,52.5
Nilah,Zeri,38,17,21,44.74
Nilah,Renekton,52,23,29,44.23
Nilah,Skarner,43,29,14,67.44
Nilah,Jayce,45,22,23,48.89
Nilah,Aatrox,65,45,20,69.23
Nilah,Yasuo,164,96,68,58.54
Nilah,Aphelios,52,33,19,63.46
Nilah,Rakan,29,7,22,24.14
Nilah,Elise,84,46,38,54.76
Nilah,Sona,17,11,6,64.71
Nilah,Trundle,55,23,32,41.82
Nilah,Akshan,32,15,17,46.88
Nilah,Alistar,42,19,23,45.24
Nilah,Nidalee,25,11,14,44
Nilah,Syndra,55,35,20,63.64
Nilah,Pantheon,120,63,57,52.5
Nilah,Ezreal,155,81,74,52.26
Nilah,Leona,96,71,25,73.96
Nilah,Yorick,50,30,20,60
Nilah,Gnar,37,26,11,70.27
Nilah,Ambessa,58,36,22,62.07
Nilah,Akali,89,41,48,46.07
Nilah,Gwen,41,16,25,39.02
Nilah,Sylas,98,70,28,71.43
Nilah,Ryze,24,9,15,37.5
Nilah,Yuumi,64,46,18,71.88
Nilah,Vi,57,31,26,54.39
Nilah,Karma,74,48,26,64.86
Nilah,Jax,51,21,30,41.18
Nilah,Karthus,29,16,13,55.17
Nilah,Evelynn,20,9,11,45
Nilah,Kindred,33,15,18,45.45
Nilah,TahmKench,65,39,26,60
Nilah,Soraka,30,19,11,63.33
Nilah,MonkeyKing,57,31,26,54.39
Nilah,Galio,119,49,70,41.18
Nilah,Taliyah,31,9,22,29.03
Nilah,Qiyana,12,3,9,25
Nilah,Lucian,57,35,22,61.4
Nilah,Sivir,16,10,6,62.5
Nilah,Nocturne,92,50,42,54.35
Nilah,Zyra,58,18,40,31.03
Nilah,Briar,39,5,34,12.82
Nilah,Swain,78,33,45,42.31
Nilah,Zac,49,26,23,53.06
Nilah,Annie,23,7,16,30.43
Nilah,Velkoz,52,28,24,53.85
Nilah,Orianna,32,18,14,56.25
Nilah,Nami,84,52,32,61.9
Nilah,Draven,34,12,22,35.29
Nilah,Jhin,150,77,73,51.33
Nilah,Smolder,56,29,27,51.79
Nilah,Talon,51,28,23,54.9
Nilah,Singed,21,4,17,19.05
Nilah,Xayah,76,34,42,44.74
Nilah,Shen,49,32,17,65.31
Nilah,DrMundo,36,18,18,50
Nilah,Zoe,25,15,10,60
Nilah,Blitzcrank,51,32,19,62.75
Nilah,Gangplank,28,11,17,39.29
Nilah,Teemo,68,25,43,36.76
Nilah,Renata,31,17,14,54.84
Nilah,Fiora,37,10,27,27.03
Nilah,Heimerdinger,20,10,10,50
Nilah,Thresh,120,47,73,39.17
Nilah,Bard,32,14,18,43.75
Nilah,Camille,46,31,15,67.39
Nilah,Aurora,73,31,42,42.47
Nilah,Khazix,38,19,19,50
Nilah,Urgot,40,19,21,47.5
Nilah,Ornn,32,15,17,46.88
Nilah,Milio,31,15,16,48.39
Nilah,Azir,31,13,18,41.94
Nilah,Seraphine,62,28,34,45.16
Nilah,Maokai,36,25,11,69.44
Nilah,Fizz,15,9,6,60
Nilah,Shyvana,10,0,10,0
Nilah,Janna,27,15,12,55.56
Nilah,Kassadin,11,3,8,27.27
Nilah,Kalista,22,18,4,81.82
Nilah,Graves,62,40,22,64.52
Nilah,Viktor,67,44,23,65.67
Nilah,Naafiri,24,11,13,45.83
Nilah,Illaoi,34,13,21,38.24
Nilah,Anivia,26,17,9,65.38
Nilah,AurelionSol,37,20,17,54.05
Nilah,Kayle,32,19,13,59.38
Nilah,Belveth,14,6,8,42.86
Nilah,RekSai,16,5,11,31.25
Nilah,Riven,24,14,10,58.33
Nilah,Corki,24,13,11,54.17
Nilah,Tryndamere,38,17,21,44.74
Nilah,Udyr,17,11,6,64.71
Nilah,Rumble,6,3,3,50
Nilah,Ivern,8,6,2,75
Nilah,Taric,15,6,9,40
Leona,Garen,360,171,189,47.5
Leona,Zed,243,124,119,51.03
Leona,Mel,542,305,237,56.27
Leona,Caitlyn,552,258,294,46.74
Leona,Morgana,299,111,188,37.12
Leona,Kled,43,20,23,46.51
Leona,Kayn,283,141,142,49.82
Leona,Katarina,112,51,61,45.54
Leona,Twitch,148,88,60,59.46
Leona,Thresh,531,254,277,47.83
Leona,Gnar,151,85,66,56.29
Leona,Hecarim,73,37,36,50.68
Leona,Viktor,176,65,111,36.93
Leona,MissFortune,444,233,211,52.48
Leona,Rell,211,114,97,54.03
Leona,Illaoi,108,61,47,56.48
Leona,Briar,130,68,62,52.31
Leona,Taliyah,66,31,35,46.97
Leona,Yone,456,256,200,56.14
Leona,Diana,308,129,179,41.88
Leona,Gragas,159,80,79,50.31
Leona,Yasuo,430,236,194,54.88
Leona,Nami,208,94,114,45.19
Leona,Vladimir,113,52,61,46.02
Leona,Ashe,472,250,222,52.97
Leona,Lux,502,234,268,46.61
Leona,Amumu,268,142,126,52.99
Leona,Nocturne,302,147,155,48.68
Leona,Galio,332,166,166,50
Leona,Senna,114,73,41,64.04
Leona,Gwen,121,57,64,47.11
Leona,Aurora,184,105,79,57.07
Leona,Jinx,556,225,331,40.47
Leona,Soraka,110,55,55,50
Leona,Tristana,242,118,124,48.76
Leona,MasterYi,248,135,113,54.44
Leona,Akshan,71,36,35,50.7
Leona,Zeri,143,69,74,48.25
Leona,Rakan,114,55,59,48.25
Leona,Sett,341,156,185,45.75
Leona,Graves,140,58,82,41.43
Leona,Hwei,162,80,82,49.38
Leona,TahmKench,216,105,111,48.61
Leona,Warwick,356,178,178,50
Leona,Viego,283,136,147,48.06
Leona,Ahri,338,162,176,47.93
Leona,Shen,190,97,93,51.05
Leona,Sejuani,150,79,71,52.67
Leona,Varus,233,118,115,50.64
Leona,Anivia,82,36,46,43.9
Leona,Nunu,183,107,76,58.47
Leona,Darius,436,212,224,48.62
Leona,Malphite,296,152,144,51.35
Leona,Kindred,109,68,41,62.39
Leona,Gangplank,138,60,78,43.48
Leona,Vi,257,102,155,39.69
Leona,Sylas,399,180,219,45.11
Leona,Ezreal,619,332,287,53.63
Leona,Braum,220,107,113,48.64
Leona,Trundle,115,47,68,40.87
Leona,Pantheon,325,167,158,51.38
Leona,Kaisa,383,215,168,56.14
Leona,Janna,101,55,46,54.46
Leona,LeeSin,501,271,230,54.09
Leona,Quinn,54,30,24,55.56
Leona,Naafiri,67,41,26,61.19
Leona,Lulu,316,156,160,49.37
Leona,Blitzcrank,290,136,154,46.9
Leona,Vayne,321,140,181,43.61
Leona,Karma,228,113,115,49.56
Leona,Irelia,147,62,85,42.18
Leona,Alistar,150,75,75,50
Leona,Yorick,217,83,134,38.25
Leona,XinZhao,156,86,70,55.13
Leona,Renekton,119,55,64,46.22
Leona,MonkeyKing,190,82,108,43.16
Leona,Seraphine,165,90,75,54.55
Leona,Yuumi,175,102,73,58.29
Leona,Brand,137,60,77,43.8
Leona,Akali,191,102,89,53.4
Leona,Volibear,234,98,136,41.88
Leona,Ekko,242,137,105,56.61
Leona,Lucian,166,98,68,59.04
Leona,Jax,182,74,108,40.66
Leona,Olaf,75,27,48,36
Leona,Shaco,183,81,102,44.26
Leona,Ambessa,179,80,99,44.69
Leona,Tryndamere,74,38,36,51.35
Leona,Nidalee,71,36,35,50.7
Leona,Vex,121,73,48,60.33
Leona,Sivir,135,54,81,40
Leona,RekSai,34,16,18,47.06
Leona,Veigar,216,109,107,50.46
Leona,Milio,113,43,70,38.05
Leona,Camille,71,33,38,46.48
Leona,Heimerdinger,113,46,67,40.71
Leona,Swain,244,93,151,38.11
Leona,Samira,171,84,87,49.12
Leona,Zyra,144,67,77,46.53
Leona,Malzahar,240,126,114,52.5
Leona,Smolder,152,84,68,55.26
Leona,Zac,144,78,66,54.17
Leona,Azir,104,65,39,62.5
Leona,Rammus,76,42,34,55.26
Leona,Xerath,172,84,88,48.84
Leona,Poppy,200,107,93,53.5
Leona,Mordekaiser,253,135,118,53.36
Leona,Sion,195,106,89,54.36
Leona,Teemo,214,99,115,46.26
Leona,Lissandra,106,48,58,45.28
Leona,Nasus,137,58,79,42.34
Leona,Zoe,100,49,51,49
Leona,Xayah,152,65,87,42.76
Leona,Talon,97,48,49,49.48
Leona,Taric,66,31,35,46.97
Leona,Chogath,288,144,144,50
Leona,Khazix,96,51,45,53.13
Leona,Qiyana,50,32,18,64
Leona,Neeko,115,54,61,46.96
Leona,Syndra,129,74,55,57.36
Leona,Aatrox,255,145,110,56.86
Leona,JarvanIV,188,94,94,50
Leona,Corki,97,57,40,58.76
Leona,Nilah,96,25,71,26.04
Leona,Pyke,181,97,84,53.59
Leona,Kayle,106,48,58,45.28
Leona,Draven,113,56,57,49.56
Leona,Elise,167,70,97,41.92
Leona,Velkoz,110,58,52,52.73
Leona,Nautilus,385,185,200,48.05
Leona,Jhin,389,201,188,51.67
Leona,Ornn,127,65,62,51.18
Leona,Kalista,77,39,38,50.65
Leona,KogMaw,79,41,38,51.9
Leona,Ziggs,96,59,37,61.46
Leona,Orianna,125,59,66,47.2
Leona,Zilean,74,41,33,55.41
Leona,Karthus,67,36,31,53.73
Leona,Fiora,84,31,53,36.9
Leona,FiddleSticks,82,39,43,47.56
Leona,Fizz,112,56,56,50
Leona,Skarner,76,43,33,56.58
Leona,Bard,54,38,16,70.37
Leona,Sona,31,18,13,58.06
Leona,Riven,77,39,38,50.65
Leona,Annie,77,30,47,38.96
Leona,AurelionSol,94,43,51,45.74
Leona,Leblanc,94,37,57,39.36
Leona,Jayce,92,38,54,41.3
Leona,Rengar,51,29,22,56.86
Leona,Ryze,84,34,50,40.48
Leona,Belveth,65,30,35,46.15
Leona,Urgot,111,55,56,49.55
Leona,Singed,46,16,30,34.78
Leona,Shyvana,53,30,23,56.6
Leona,Aphelios,137,49,88,35.77
Leona,Renata,70,16,54,22.86
Leona,Udyr,66,28,38,42.42
Leona,KSante,175,95,80,54.29
Leona,Kennen,69,32,37,46.38
Leona,Ivern,56,31,25,55.36
Leona,Maokai,125,73,52,58.4
Leona,DrMundo,93,46,47,49.46
Leona,Lillia,119,51,68,42.86
Leona,Evelynn,46,26,20,56.52
Leona,TwistedFate,86,33,53,38.37
Leona,Kassadin,51,25,26,49.02
Leona,Rumble,62,28,34,45.16
Leona,Cassiopeia,60,34,26,56.67
Garen,Fiora,117,60,57,51.28
Garen,Teemo,342,172,170,50.29
Garen,Diana,493,244,249,49.49
Garen,Nilah,119,58,61,48.74
Garen,Leona,360,189,171,52.5
Garen,Riven,175,102,73,58.29
Garen,Poppy,222,113,109,50.9
Garen,Veigar,405,200,205,49.38
Garen,Ziggs,126,74,52,58.73
Garen,Yuumi,308,151,157,49.03
Garen,Yorick,276,118,158,42.75
Garen,Warwick,466,237,229,50.86
Garen,Akali,339,206,133,60.77
Garen,Jhin,635,352,283,55.43
Garen,Braum,300,166,134,55.33
Garen,Quinn,116,47,69,40.52
Garen,Sejuani,228,111,117,48.68
Garen,Leblanc,206,99,107,48.06
Garen,Twitch,250,131,119,52.4
Garen,Nautilus,504,222,282,44.05
Garen,Nasus,299,156,143,52.17
Garen,Malzahar,368,189,179,51.36
Garen,TwistedFate,103,66,37,64.08
Garen,Seraphine,268,140,128,52.24
Garen,Olaf,86,48,38,55.81
Garen,Viego,428,230,198,53.74
Garen,Ryze,115,61,54,53.04
Garen,Soraka,157,87,70,55.41
Garen,Ornn,197,84,113,42.64
Garen,Kindred,175,89,86,50.86
Garen,Talon,159,97,62,61.01
Garen,Samira,223,122,101,54.71
Garen,Ashe,689,369,320,53.56
Garen,Darius,680,328,352,48.24
Garen,Tristana,366,180,186,49.18
Garen,Neeko,155,100,55,64.52
Garen,Aurora,277,148,129,53.43
Garen,Amumu,402,196,206,48.76
Garen,MissFortune,656,336,320,51.22
Garen,Rakan,243,127,116,52.26
Garen,Mordekaiser,521,258,263,49.52
Garen,Hecarim,99,49,50,49.49
Garen,Sett,578,289,289,50
Garen,Xayah,250,119,131,47.6
Garen,Lulu,510,270,240,52.94
Garen,Corki,193,107,86,55.44
Garen,Briar,177,102,75,57.63
Garen,Mel,691,355,336,51.37
Garen,Jax,409,246,163,60.15
Garen,Yasuo,760,409,351,53.82
Garen,Chogath,515,252,263,48.93
Garen,Ekko,303,182,121,60.07
Garen,Azir,138,61,77,44.2
Garen,Jinx,880,408,472,46.36
Garen,Nami,416,228,188,54.81
Garen,Aatrox,391,229,162,58.57
Garen,Annie,84,45,39,53.57
Garen,Illaoi,201,104,97,51.74
Garen,Renekton,219,99,120,45.21
Garen,LeeSin,591,301,290,50.93
Garen,Viktor,363,184,179,50.69
Garen,Hwei,239,129,110,53.97
Garen,Kayle,259,95,164,36.68
Garen,MonkeyKing,267,146,121,54.68
Garen,Vex,228,105,123,46.05
Garen,Caitlyn,823,458,365,55.65
Garen,Irelia,208,132,76,63.46
Garen,Morgana,333,179,154,53.75
Garen,Lux,738,393,345,53.25
Garen,Kennen,85,52,33,61.18
Garen,Vayne,463,245,218,52.92
Garen,Milio,241,123,118,51.04
Garen,Jayce,153,101,52,66.01
Garen,Zed,333,191,142,57.36
Garen,Thresh,679,370,309,54.49
Garen,Sion,291,154,137,52.92
Garen,Kassadin,64,26,38,40.63
Garen,Lucian,297,154,143,51.85
Garen,Vladimir,187,99,88,52.94
Garen,Naafiri,124,61,63,49.19
Garen,Sylas,608,310,298,50.99
Garen,Evelynn,90,45,45,50
Garen,KogMaw,106,72,34,67.92
Garen,Tryndamere,168,77,91,45.83
Garen,Vi,400,234,166,58.5
Garen,Renata,96,46,50,47.92
Garen,Senna,194,86,108,44.33
Garen,Nocturne,509,257,252,50.49
Garen,Smolder,238,118,120,49.58
Garen,Kayn,402,213,189,52.99
Garen,Rengar,94,59,35,62.77
Garen,Brand,231,140,91,60.61
Garen,Karma,441,247,194,56.01
Garen,Shen,271,133,138,49.08
Garen,Swain,355,171,184,48.17
Garen,Katarina,240,147,93,61.25
Garen,Varus,321,174,147,54.21
Garen,Fizz,172,99,73,57.56
Garen,Shaco,238,107,131,44.96
Garen,Orianna,210,117,93,55.71
Garen,Ezreal,894,472,422,52.8
Garen,XinZhao,281,166,115,59.07
Garen,Pyke,249,128,121,51.41
Garen,Ahri,449,195,254,43.43
Garen,Kaisa,587,344,243,58.6
Garen,Malphite,354,204,150,57.63
Garen,Zyra,273,135,138,49.45
Garen,Blitzcrank,331,173,158,52.27
Garen,Nunu,189,112,77,59.26
Garen,MasterYi,383,187,196,48.83
Garen,Sivir,197,82,115,41.62
Garen,Trundle,192,103,89,53.65
Garen,Lillia,184,107,77,58.15
Garen,AurelionSol,131,74,57,56.49
Garen,Taliyah,89,54,35,60.67
Garen,Gragas,268,148,120,55.22
Garen,Kled,82,40,42,48.78
Garen,Urgot,182,114,68,62.64
Garen,Syndra,252,133,119,52.78
Garen,Volibear,367,180,187,49.05
Garen,RekSai,45,25,20,55.56
Garen,Alistar,213,115,98,53.99
Garen,Zeri,171,92,79,53.8
Garen,Yone,539,301,238,55.84
Garen,Belveth,63,37,26,58.73
Garen,Zac,198,101,97,51.01
Garen,Ivern,88,47,41,53.41
Garen,DrMundo,211,105,106,49.76
Garen,FiddleSticks,170,103,67,60.59
Garen,Draven,180,114,66,63.33
Garen,Pantheon,533,276,257,51.78
Garen,Ambessa,220,108,112,49.09
Garen,Gnar,187,112,75,59.89
Garen,Nidalee,126,66,60,52.38
Garen,Taric,63,29,34,46.03
Garen,Elise,264,154,110,58.33
Garen,Kalista,145,81,64,55.86
Garen,Cassiopeia,113,50,63,44.25
Garen,Xerath,276,166,110,60.14
Garen,Galio,455,216,239,47.47
Garen,JarvanIV,277,145,132,52.35
Garen,Velkoz,152,108,44,71.05
Garen,Udyr,118,74,44,62.71
Garen,Khazix,173,86,87,49.71
Garen,Rammus,112,56,56,50
Garen,Lissandra,145,66,79,45.52
Garen,Zilean,135,76,59,56.3
Garen,Sona,45,17,28,37.78
Garen,KSante,328,183,145,55.79
Garen,Zoe,110,70,40,63.64
Garen,Skarner,169,90,79,53.25
Garen,TahmKench,336,194,142,57.74
Garen,Rell,170,85,85,50
Garen,Singed,96,57,39,59.38
Garen,Aphelios,211,84,127,39.81
Garen,Camille,183,77,106,42.08
Garen,Shyvana,75,34,41,45.33
Garen,Heimerdinger,144,90,54,62.5
Garen,Janna,106,50,56,47.17
Garen,Gwen,180,92,88,51.11
Garen,Gangplank,178,107,71,60.11
Garen,Karthus,99,42,57,42.42
Garen,Graves,254,121,133,47.64
Garen,Maokai,144,72,72,50
Garen,Akshan,66,35,31,53.03
Garen,Anivia,129,59,70,45.74
Garen,Qiyana,47,13,34,27.66
Garen,Bard,121,65,56,53.72
Garen,Rumble,90,46,44,51.11
Zed,Fiora,89,31,58,34.83
Zed,Teemo,258,122,136,47.29
Zed,Diana,335,149,186,44.48
Zed,Nilah,83,31,52,37.35
Zed,Leona,243,119,124,48.97
Zed,Volibear,249,129,120,51.81
Zed,Elise,216,102,114,47.22
Zed,Malzahar,247,131,116,53.04
Zed,Caitlyn,572,302,270,52.8
Zed,Milio,184,78,106,42.39
Zed,Vi,248,133,115,53.63
Zed,Gragas,210,107,103,50.95
Zed,Lux,617,377,240,61.1
Zed,Akali,289,128,161,44.29
Zed,Nunu,143,67,76,46.85
Zed,Tristana,211,122,89,57.82
Zed,Nautilus,283,124,159,43.82
Zed,Leblanc,153,88,65,57.52
Zed,Kayn,303,143,160,47.19
Zed,Ashe,468,249,219,53.21
Zed,Shen,154,65,89,42.21
Zed,Karthus,55,26,29,47.27
Zed,Ekko,213,99,114,46.48
Zed,Ezreal,649,322,327,49.61
Zed,Soraka,120,62,58,51.67
Zed,Darius,429,183,246,42.66
Zed,Nocturne,280,132,148,47.14
Zed,Katarina,143,64,79,44.76
Zed,Lucian,215,125,90,58.14
Zed,Nami,198,95,103,47.98
Zed,Sett,337,182,155,54.01
Zed,MissFortune,429,207,222,48.25
Zed,Mordekaiser,269,142,127,52.79
Zed,Chogath,247,121,126,48.99
Zed,Naafiri,80,50,30,62.5
Zed,Yasuo,603,311,292,51.58
Zed,Yone,379,197,182,51.98
Zed,Jax,191,103,88,53.93
Zed,Irelia,165,87,78,52.73
Zed,Jhin,432,215,217,49.77
Zed,Yuumi,178,94,84,52.81
Zed,Amumu,268,127,141,47.39
Zed,Viktor,187,65,122,34.76
Zed,Zeri,97,55,42,56.7
Zed,Pantheon,470,206,264,43.83
Zed,DrMundo,127,56,71,44.09
Zed,MasterYi,239,112,127,46.86
Zed,Vladimir,152,55,97,36.18
Zed,Thresh,416,213,203,51.2
Zed,Jinx,556,221,335,39.75
Zed,KSante,120,50,70,41.67
Zed,Rell,162,82,80,50.62
Zed,Jayce,134,70,64,52.24
Zed,Twitch,141,65,76,46.1
Zed,Orianna,102,51,51,50
Zed,Lulu,365,166,199,45.48
Zed,Warwick,252,110,142,43.65
Zed,Graves,154,84,70,54.55
Zed,Azir,111,65,46,58.56
Zed,Mel,498,270,228,54.22
Zed,Garen,333,142,191,42.64
Zed,Ahri,317,168,149,53
Zed,Kaisa,425,191,234,44.94
Zed,Shaco,181,77,104,42.54
Zed,Rammus,87,58,29,66.67
Zed,Zyra,181,86,95,47.51
Zed,Zac,99,51,48,51.52
Zed,Morgana,206,86,120,41.75
Zed,Camille,102,48,54,47.06
Zed,Udyr,74,57,17,77.03
Zed,TahmKench,207,80,127,38.65
Zed,Gnar,146,68,78,46.58
Zed,Yorick,193,103,90,53.37
Zed,Aurora,190,119,71,62.63
Zed,Riven,113,52,61,46.02
Zed,Qiyana,63,36,27,57.14
Zed,Briar,157,84,73,53.5
Zed,Hwei,174,110,64,63.22
Zed,Kassadin,20,12,8,60
Zed,Blitzcrank,257,153,104,59.53
Zed,Varus,202,110,92,54.46
Zed,Braum,158,56,102,35.44
Zed,Sylas,335,162,173,48.36
Zed,KogMaw,81,41,40,50.62
Zed,Senna,139,57,82,41.01
Zed,Rumble,88,48,40,54.55
Zed,Xerath,206,99,107,48.06
Zed,Malphite,326,160,166,49.08
Zed,Talon,141,70,71,49.65
Zed,Renata,63,22,41,34.92
Zed,Lissandra,137,49,88,35.77
Zed,Aatrox,245,132,113,53.88
Zed,Xayah,182,95,87,52.2
Zed,Pyke,191,119,72,62.3
Zed,Vayne,245,109,136,44.49
Zed,Gangplank,135,83,52,61.48
Zed,Samira,180,87,93,48.33
Zed,Ambessa,174,81,93,46.55
Zed,Illaoi,147,90,57,61.22
Zed,Heimerdinger,99,57,42,57.58
Zed,MonkeyKing,178,81,97,45.51
Zed,Rakan,131,56,75,42.75
Zed,Aphelios,127,66,61,51.97
Zed,Nasus,157,56,101,35.67
Zed,FiddleSticks,94,36,58,38.3
Zed,Seraphine,178,84,94,47.19
Zed,Brand,143,88,55,61.54
Zed,Veigar,223,118,105,52.91
Zed,Taric,58,30,28,51.72
Zed,Ornn,148,74,74,50
Zed,Cassiopeia,70,23,47,32.86
Zed,Nidalee,80,25,55,31.25
Zed,Neeko,130,63,67,48.46
Zed,Ryze,79,52,27,65.82
Zed,Ziggs,85,31,54,36.47
Zed,JarvanIV,173,96,77,55.49
Zed,Karma,311,166,145,53.38
Zed,Evelynn,55,25,30,45.45
Zed,TwistedFate,80,39,41,48.75
Zed,Poppy,130,63,67,48.46
Zed,Velkoz,138,86,52,62.32
Zed,Zilean,66,36,30,54.55
Zed,RekSai,51,34,17,66.67
Zed,LeeSin,401,195,206,48.63
Zed,Taliyah,58,23,35,39.66
Zed,Annie,70,18,52,25.71
Zed,Trundle,124,61,63,49.19
Zed,Sona,49,21,28,42.86
Zed,AurelionSol,77,37,40,48.05
Zed,Skarner,129,71,58,55.04
Zed,Sivir,119,45,74,37.82
Zed,XinZhao,200,98,102,49
Zed,Akshan,79,48,31,60.76
Zed,Kindred,96,75,21,78.13
Zed,Viego,347,188,159,54.18
Zed,Draven,95,46,49,48.42
Zed,Quinn,99,52,47,52.53
Zed,Ivern,49,29,20,59.18
Zed,Galio,243,125,118,51.44
Zed,Kled,47,28,19,59.57
Zed,Shyvana,45,22,23,48.89
Zed,Belveth,53,17,36,32.08
Zed,Renekton,136,60,76,44.12
Zed,Vex,132,55,77,41.67
Zed,Smolder,163,82,81,50.31
Zed,Maokai,131,72,59,54.96
Zed,Anivia,94,46,48,48.94
Zed,Rengar,60,28,32,46.67
Zed,Singed,53,21,32,39.62
Zed,Zoe,92,56,36,60.87
Zed,Alistar,136,40,96,29.41
Zed,Fizz,108,66,42,61.11
Zed,Khazix,161,91,70,56.52
Zed,Sejuani,156,70,86,44.87
Zed,Urgot,102,30,72,29.41
Zed,Swain,179,86,93,48.04
Zed,Tryndamere,52,30,22,57.69
Zed,Lillia,81,33,48,40.74
Zed,Kalista,66,28,38,42.42
Zed,Bard,60,37,23,61.67
Zed,Kayle,120,49,71,40.83
Zed,Hecarim,79,41,38,51.9
Zed,Kennen,77,40,37,51.95
Zed,Janna,69,30,39,43.48
Zed,Corki,99,57,42,57.58
Zed,Olaf,63,30,33,47.62
Zed,Sion,191,105,86,54.97
Zed,Gwen,93,43,50,46.24
Zed,Syndra,145,77,68,53.1
Akali,Maokai,110,45,65,40.91
Akali,Viego,288,135,153,46.88
Akali,Viktor,265,116,149,43.77
Akali,Smolder,137,63,74,45.99
Akali,Nami,201,135,66,67.16
Akali,Ambessa,179,90,89,50.28
Akali,Diana,359,191,168,53.2
Akali,Ekko,175,90,85,51.43
Akali,Jinx,611,289,322,47.3
Akali,Lulu,345,172,173,49.86
Akali,Garen,339,133,206,39.23
Akali,Shaco,188,76,112,40.43
Akali,Tristana,175,95,80,54.29
Akali,Ezreal,525,235,290,44.76
Akali,Swain,208,95,113,45.67
Akali,Gnar,136,76,60,55.88
Akali,Kayn,231,93,138,40.26
Akali,Mel,494,239,255,48.38
Akali,Twitch,116,65,51,56.03
Akali,Pantheon,346,170,176,49.13
Akali,Trundle,95,46,49,48.42
Akali,Sylas,474,230,244,48.52
Akali,Zac,148,65,83,43.92
Akali,MissFortune,459,214,245,46.62
Akali,Seraphine,179,83,96,46.37
Akali,Yasuo,567,264,303,46.56
Akali,Naafiri,57,26,31,45.61
Akali,Azir,86,45,41,52.33
Akali,Irelia,220,97,123,44.09
Akali,LeeSin,500,237,263,47.4
Akali,Zed,289,161,128,55.71
Akali,Caitlyn,532,279,253,52.44
Akali,Morgana,195,79,116,40.51
Akali,TahmKench,150,70,80,46.67
Akali,Rengar,48,34,14,70.83
Akali,Yone,538,285,253,52.97
Akali,Chogath,234,104,130,44.44
Akali,Zyra,180,69,111,38.33
Akali,Jayce,144,54,90,37.5
Akali,Sejuani,144,58,86,40.28
Akali,Fizz,109,58,51,53.21
Akali,Alistar,108,49,59,45.37
Akali,Shen,155,65,90,41.94
Akali,Orianna,137,53,84,38.69
Akali,Xayah,168,74,94,44.05
Akali,Rakan,138,44,94,31.88
Akali,Warwick,255,107,148,41.96
Akali,Xerath,152,66,86,43.42
Akali,Mordekaiser,256,110,146,42.97
Akali,AurelionSol,65,27,38,41.54
Akali,Lux,546,316,230,57.88
Akali,Vayne,247,109,138,44.13
Akali,Malzahar,182,85,97,46.7
Akali,Ashe,411,201,210,48.91
Akali,Sett,414,183,231,44.2
Akali,MasterYi,210,114,96,54.29
Akali,Lucian,178,112,66,62.92
Akali,Blitzcrank,214,111,103,51.87
Akali,Katarina,136,83,53,61.03
Akali,JarvanIV,141,69,72,48.94
Akali,Milio,145,64,81,44.14
Akali,Ahri,267,119,148,44.57
Akali,Karma,277,119,158,42.96
Akali,Renekton,107,41,66,38.32
Akali,Hwei,99,41,58,41.41
Akali,Kayle,117,55,62,47.01
Akali,MonkeyKing,205,93,112,45.37
Akali,Vex,151,60,91,39.74
Akali,Soraka,94,53,41,56.38
Akali,Illaoi,103,54,49,52.43
Akali,Nunu,148,68,80,45.95
Akali,Rell,162,75,87,46.3
Akali,Lillia,153,69,84,45.1
Akali,Kaisa,391,165,226,42.2
Akali,Yuumi,186,92,94,49.46
Akali,Volibear,225,111,114,49.33
Akali,Amumu,235,93,142,39.57
Akali,Poppy,167,76,91,45.51
Akali,Darius,392,195,197,49.74
Akali,Brand,141,70,71,49.65
Akali,Ornn,149,70,79,46.98
Akali,Olaf,43,15,28,34.88
Akali,Jhin,408,200,208,49.02
Akali,Briar,108,46,62,42.59
Akali,Riven,94,48,46,51.06
Akali,Rammus,81,40,41,49.38
Akali,Zeri,130,64,66,49.23
Akali,Teemo,238,113,125,47.48
Akali,Gwen,90,57,33,63.33
Akali,Galio,306,160,146,52.29
Akali,Varus,219,112,107,51.14
Akali,Leona,191,89,102,46.6
Akali,Lissandra,104,65,39,62.5
Akali,Braum,157,55,102,35.03
Akali,Yorick,173,98,75,56.65
Akali,Draven,111,44,67,39.64
Akali,Jax,197,107,90,54.31
Akali,Pyke,172,98,74,56.98
Akali,Nocturne,248,122,126,49.19
Akali,Veigar,210,105,105,50
Akali,Samira,164,86,78,52.44
Akali,Talon,145,81,64,55.86
Akali,Nautilus,303,155,148,51.16
Akali,Heimerdinger,116,44,72,37.93
Akali,Vladimir,103,42,61,40.78
Akali,Urgot,104,68,36,65.38
Akali,Skarner,98,43,55,43.88
Akali,DrMundo,85,39,46,45.88
Akali,Kled,56,28,28,50
Akali,Cassiopeia,73,28,45,38.36
Akali,Hecarim,66,39,27,59.09
Akali,Sona,26,14,12,53.85
Akali,Aatrox,240,146,94,60.83
Akali,Senna,101,53,48,52.48
Akali,Malphite,204,110,94,53.92
Akali,FiddleSticks,90,40,50,44.44
Akali,Ziggs,56,19,37,33.93
Akali,Belveth,46,27,19,58.7
Akali,Aphelios,120,70,50,58.33
Akali,Ryze,106,42,64,39.62
Akali,Gragas,139,82,57,58.99
Akali,Thresh,402,188,214,46.77
Akali,Qiyana,43,18,25,41.86
Akali,Sivir,141,75,66,53.19
Akali,XinZhao,187,90,97,48.13
Akali,Singed,52,14,38,26.92
Akali,Elise,202,105,97,51.98
Akali,Vi,208,100,108,48.08
Akali,Zilean,64,39,25,60.94
Akali,Evelynn,64,32,32,50
Akali,Kennen,79,34,45,43.04
Akali,Aurora,168,83,85,49.4
Akali,Akshan,60,32,28,53.33
Akali,Nidalee,100,61,39,61
Akali,Shyvana,55,30,25,54.55
Akali,Quinn,61,35,26,57.38
Akali,Graves,177,83,94,46.89
Akali,Sion,130,66,64,50.77
Akali,Nilah,89,48,41,53.93
Akali,Kindred,89,65,24,73.03
Akali,Syndra,121,50,71,41.32
Akali,KSante,191,88,103,46.07
Akali,Neeko,110,41,69,37.27
Akali,Khazix,114,58,56,50.88
Akali,Anivia,57,34,23,59.65
Akali,KogMaw,62,38,24,61.29
Akali,Gangplank,90,45,45,50
Akali,Taric,36,11,25,30.56
Akali,Karthus,64,30,34,46.88
Akali,Renata,55,23,32,41.82
Akali,Leblanc,143,86,57,60.14
Akali,Tryndamere,93,31,62,33.33
Akali,Corki,98,49,49,50
Akali,Ivern,57,34,23,59.65
Akali,Zoe,103,43,60,41.75
Akali,RekSai,32,17,15,53.13
Akali,Velkoz,101,59,42,58.42
Akali,Rumble,58,35,23,60.34
Akali,Bard,71,24,47,33.8
Akali,Udyr,74,41,33,55.41
Akali,Nasus,111,44,67,39.64
Akali,Camille,75,41,34,54.67
Akali,Kassadin,22,14,8,63.64
Akali,Kalista,61,24,37,39.34
Akali,TwistedFate,59,32,27,54.24
Akali,Fiora,60,45,15,75
Akali,Janna,79,47,32,59.49
Akali,Annie,55,26,29,47.27
Akali,Taliyah,33,11,22,33.33
Maokai,Yone,148,64,84,43.24
Maokai,Nocturne,144,79,65,54.86
Maokai,Akali,110,65,45,59.09
Maokai,Ezreal,250,122,128,48.8
Maokai,Renata,17,3,14,17.65
Maokai,Darius,195,76,119,38.97
Maokai,XinZhao,60,35,25,58.33
Maokai,Malzahar,126,77,49,61.11
Maokai,Vayne,145,73,72,50.34
Maokai,Rell,78,38,40,48.72
Maokai,Pantheon,168,82,86,48.81
Maokai,Lux,251,90,161,35.86
Maokai,Kaisa,178,89,89,50
Maokai,Pyke,109,55,54,50.46
Maokai,Aatrox,141,65,76,46.1
Maokai,Kayn,139,79,60,56.83
Maokai,Yasuo,183,102,81,55.74
Maokai,MissFortune,202,133,69,65.84
Maokai,Nautilus,151,75,76,49.67
Maokai,Riven,42,17,25,40.48
Maokai,Shaco,101,51,50,50.5
Maokai,Katarina,78,41,37,52.56
Maokai,Tristana,97,51,46,52.58
Maokai,Milio,56,20,36,35.71
Maokai,AurelionSol,49,28,21,57.14
Maokai,Caitlyn,272,137,135,50.37
Maokai,Gnar,60,36,24,60
Maokai,Shyvana,28,3,25,10.71
Maokai,Galio,150,84,66,56
Maokai,Xerath,82,18,64,21.95
Maokai,Camille,47,24,23,51.06
Maokai,Kassadin,29,11,18,37.93
Maokai,Jhin,187,104,83,55.61
Maokai,Blitzcrank,86,45,41,52.33
Maokai,Azir,65,40,25,61.54
Maokai,MasterYi,103,51,52,49.51
Maokai,Gangplank,48,36,12,75
Maokai,Sion,81,24,57,29.63
Maokai,Diana,167,95,72,56.89
Maokai,Annie,33,11,22,33.33
Maokai,Neeko,41,12,29,29.27
Maokai,RekSai,18,9,9,50
Maokai,Nunu,93,34,59,36.56
Maokai,Viktor,113,51,62,45.13
Maokai,Belveth,16,8,8,50
Maokai,Malphite,93,45,48,48.39
Maokai,Volibear,110,63,47,57.27
Maokai,Amumu,122,56,66,45.9
Maokai,Cassiopeia,32,12,20,37.5
Maokai,Poppy,106,75,31,70.75
Maokai,Warwick,108,55,53,50.93
Maokai,Anivia,58,33,25,56.9
Maokai,Ahri,116,64,52,55.17
Maokai,Karma,127,73,54,57.48
Maokai,Varus,119,78,41,65.55
Maokai,Yorick,83,38,45,45.78
Maokai,Sylas,168,83,85,49.4
Maokai,Braum,85,41,44,48.24
Maokai,DrMundo,48,31,17,64.58
Maokai,TwistedFate,22,10,12,45.45
Maokai,Thresh,193,120,73,62.18
Maokai,Vi,153,59,94,38.56
Maokai,Mel,219,100,119,45.66
Maokai,Singed,23,10,13,43.48
Maokai,FiddleSticks,70,38,32,54.29
Maokai,Teemo,87,43,44,49.43
Maokai,Kalista,33,8,25,24.24
Maokai,Veigar,89,50,39,56.18
Maokai,Ornn,90,49,41,54.44
Maokai,Viego,148,66,82,44.59
Maokai,Aphelios,57,37,20,64.91
Maokai,Nasus,62,33,29,53.23
Maokai,Ashe,180,100,80,55.56
Maokai,Ambessa,83,34,49,40.96
Maokai,LeeSin,167,88,79,52.69
Maokai,Hwei,63,32,31,50.79
Maokai,Trundle,59,24,35,40.68
Maokai,Kindred,41,29,12,70.73
Maokai,KSante,61,30,31,49.18
Maokai,Morgana,110,39,71,35.45
Maokai,Gragas,76,31,45,40.79
Maokai,Qiyana,33,19,14,57.58
Maokai,Quinn,52,25,27,48.08
Maokai,Udyr,37,21,16,56.76
Maokai,Vladimir,54,26,28,48.15
Maokai,Leblanc,82,50,32,60.98
Maokai,Lulu,174,89,85,51.15
Maokai,Zed,131,59,72,45.04
Maokai,Mordekaiser,152,63,89,41.45
Maokai,Skarner,56,26,30,46.43
Maokai,Alistar,71,39,32,54.93
Maokai,Velkoz,64,31,33,48.44
Maokai,Rammus,38,16,22,42.11
Maokai,Gwen,62,28,34,45.16
Maokai,Karthus,36,22,14,61.11
Maokai,Swain,116,50,66,43.1
Maokai,Jinx,296,135,161,45.61
Maokai,Senna,58,20,38,34.48
Maokai,Seraphine,105,66,39,62.86
Maokai,Nami,134,65,69,48.51
Maokai,Syndra,92,36,56,39.13
Maokai,Lucian,82,45,37,54.88
Maokai,Illaoi,50,29,21,58
Maokai,Elise,106,67,39,63.21
Maokai,Chogath,136,72,64,52.94
Maokai,Briar,65,28,37,43.08
Maokai,Orianna,70,35,35,50
Maokai,TahmKench,126,65,61,51.59
Maokai,Ryze,42,18,24,42.86
Maokai,Ekko,62,25,37,40.32
Maokai,Samira,72,37,35,51.39
Maokai,Sejuani,80,42,38,52.5
Maokai,Graves,62,39,23,62.9
Maokai,Xayah,41,25,16,60.98
Maokai,Kayle,60,27,33,45
Maokai,Renekton,52,27,25,51.92
Maokai,Fizz,40,23,17,57.5
Maokai,Sivir,60,16,44,26.67
Maokai,Lillia,63,38,25,60.32
Maokai,Soraka,52,23,29,44.23
Maokai,Jayce,35,8,27,22.86
Maokai,Jax,70,42,28,60
Maokai,Yuumi,71,40,31,56.34
Maokai,Heimerdinger,36,23,13,63.89
Maokai,Twitch,82,32,50,39.02
Maokai,Irelia,65,28,37,43.08
Maokai,Zeri,60,32,28,53.33
Maokai,Garen,144,72,72,50
Maokai,Hecarim,31,15,16,48.39
Maokai,Draven,50,29,21,58
Maokai,Leona,125,52,73,41.6
Maokai,Naafiri,46,11,35,23.91
Maokai,Khazix,53,18,35,33.96
Maokai,Sett,132,77,55,58.33
Maokai,Talon,40,23,17,57.5
Maokai,Nilah,36,11,25,30.56
Maokai,Sona,13,8,5,61.54
Maokai,Ivern,17,8,9,47.06
Maokai,Evelynn,37,16,21,43.24
Maokai,Aurora,86,53,33,61.63
Maokai,MonkeyKing,64,36,28,56.25
Maokai,Nidalee,55,27,28,49.09
Maokai,Zyra,61,40,21,65.57
Maokai,Zoe,53,26,27,49.06
Maokai,Urgot,49,29,20,59.18
Maokai,Zilean,38,11,27,28.95
Maokai,Zac,94,65,29,69.15
Maokai,Akshan,32,15,17,46.88
Maokai,JarvanIV,70,41,29,58.57
Maokai,Taliyah,34,21,13,61.76
Maokai,KogMaw,36,11,25,30.56
Maokai,Brand,42,23,19,54.76
Maokai,Shen,51,15,36,29.41
Maokai,Bard,28,8,20,28.57
Maokai,Smolder,92,35,57,38.04
Maokai,Vex,68,32,36,47.06
Maokai,Olaf,44,21,23,47.73
Maokai,Tryndamere,38,20,18,52.63
Maokai,Kled,25,14,11,56
Maokai,Janna,25,20,5,80
Maokai,Ziggs,49,33,16,67.35
Maokai,Corki,61,33,28,54.1
Maokai,Rakan,45,27,18,60
Maokai,Rumble,29,11,18,37.93
Maokai,Kennen,45,30,15,66.67
Maokai,Lissandra,45,28,17,62.22
Maokai,Taric,13,8,5,61.54
Maokai,Fiora,47,23,24,48.94
Maokai,Rengar,36,27,9,75
Rakan,Warwick,158,81,77,51.27
Rakan,Udyr,44,27,17,61.36
Rakan,Mel,307,176,131,57.33
Rakan,Sivir,60,25,35,41.67
Rakan,Karma,186,83,103,44.62
Rakan,Nasus,79,46,33,58.23
Rakan,FiddleSticks,72,28,44,38.89
Rakan,Syndra,78,38,40,48.72
Rakan,Seraphine,89,41,48,46.07
Rakan,Alistar,63,36,27,57.14
Rakan,Nocturne,158,80,78,50.63
Rakan,Galio,177,83,94,46.89
Rakan,Urgot,62,35,27,56.45
Rakan,Samira,120,62,58,51.67
Rakan,Illaoi,70,33,37,47.14
Rakan,Twitch,113,47,66,41.59
Rakan,Ahri,189,79,110,41.8
Rakan,Kaisa,250,143,107,57.2
Rakan,Ashe,231,124,107,53.68
Rakan,Malzahar,145,67,78,46.21
Rakan,Garen,243,116,127,47.74
Rakan,Caitlyn,293,141,152,48.12
Rakan,Lucian,102,55,47,53.92
Rakan,Nami,131,54,77,41.22
Rakan,Poppy,147,68,79,46.26
Rakan,Shaco,93,40,53,43.01
Rakan,Ezreal,371,178,193,47.98
Rakan,LeeSin,269,121,148,44.98
Rakan,Viktor,115,70,45,60.87
Rakan,Vladimir,80,53,27,66.25
Rakan,Akali,138,94,44,68.12
Rakan,Vayne,176,71,105,40.34
Rakan,Briar,41,24,17,58.54
Rakan,Neeko,69,46,23,66.67
Rakan,Jhin,227,109,118,48.02
Rakan,Lulu,178,80,98,44.94
Rakan,Trundle,75,34,41,45.33
Rakan,Khazix,75,29,46,38.67
Rakan,Aurora,94,47,47,50
Rakan,Varus,103,66,37,64.08
Rakan,Pantheon,235,121,114,51.49
Rakan,Leona,114,59,55,51.75
Rakan,Rammus,71,32,39,45.07
Rakan,Lux,265,138,127,52.08
Rakan,Aatrox,110,51,59,46.36
Rakan,Vi,186,102,84,54.84
Rakan,Smolder,99,44,55,44.44
Rakan,Kayle,66,33,33,50
Rakan,Teemo,129,69,60,53.49
Rakan,Graves,77,27,50,35.06
Rakan,Sylas,162,85,77,52.47
Rakan,Irelia,84,41,43,48.81
Rakan,Soraka,48,35,13,72.92
Rakan,MasterYi,135,81,54,60
Rakan,Morgana,154,75,79,48.7
Rakan,Quinn,49,34,15,69.39
Rakan,Nidalee,42,19,23,45.24
Rakan,Aphelios,70,38,32,54.29
Rakan,Sion,111,50,61,45.05
Rakan,RekSai,32,21,11,65.63
Rakan,Lissandra,45,33,12,73.33
Rakan,Senna,95,55,40,57.89
Rakan,MonkeyKing,87,39,48,44.83
Rakan,Kayn,188,116,72,61.7
Rakan,Kassadin,33,20,13,60.61
Rakan,Chogath,222,113,109,50.9
Rakan,Darius,219,113,106,51.6
Rakan,Veigar,104,51,53,49.04
Rakan,Nautilus,182,92,90,50.55
Rakan,Gnar,95,57,38,60
Rakan,Yorick,78,40,38,51.28
Rakan,Riven,54,30,24,55.56
Rakan,TahmKench,116,70,46,60.34
Rakan,Mordekaiser,158,82,76,51.9
Rakan,Talon,52,25,27,48.08
Rakan,Renata,39,17,22,43.59
Rakan,TwistedFate,76,43,33,56.58
Rakan,Anivia,52,25,27,48.08
Rakan,AurelionSol,38,18,20,47.37
Rakan,Viego,171,77,94,45.03
Rakan,Milio,82,36,46,43.9
Rakan,Camille,67,47,20,70.15
Rakan,Yone,225,115,110,51.11
Rakan,Tristana,91,44,47,48.35
Rakan,Amumu,137,77,60,56.2
Rakan,Draven,74,45,29,60.81
Rakan,Thresh,255,136,119,53.33
Rakan,Zac,76,47,29,61.84
Rakan,Zed,131,75,56,57.25
Rakan,Yasuo,220,105,115,47.73
Rakan,Rell,86,51,35,59.3
Rakan,Katarina,62,39,23,62.9
Rakan,Orianna,93,36,57,38.71
Rakan,Gragas,82,35,47,42.68
Rakan,Diana,182,91,91,50
Rakan,Blitzcrank,123,72,51,58.54
Rakan,Ivern,18,7,11,38.89
Rakan,Tryndamere,53,23,30,43.4
Rakan,KSante,96,53,43,55.21
Rakan,Malphite,148,73,75,49.32
Rakan,MissFortune,203,104,99,51.23
Rakan,Taric,32,9,23,28.13
Rakan,Ekko,97,49,48,50.52
Rakan,Nilah,29,22,7,75.86
Rakan,Yuumi,120,61,59,50.83
Rakan,Elise,126,72,54,57.14
Rakan,Leblanc,89,46,43,51.69
Rakan,Nunu,66,36,30,54.55
Rakan,Renekton,84,51,33,60.71
Rakan,Braum,73,43,30,58.9
Rakan,Brand,73,40,33,54.79
Rakan,KogMaw,21,14,7,66.67
Rakan,Hwei,85,55,30,64.71
Rakan,Lillia,63,29,34,46.03
Rakan,Gwen,51,34,17,66.67
Rakan,Ornn,114,65,49,57.02
Rakan,Naafiri,43,32,11,74.42
Rakan,Ambessa,111,50,61,45.05
Rakan,Xerath,110,60,50,54.55
Rakan,Kalista,40,34,6,85
Rakan,Rengar,47,26,21,55.32
Rakan,Janna,61,30,31,49.18
Rakan,Evelynn,27,12,15,44.44
Rakan,Jinx,310,127,183,40.97
Rakan,Annie,43,20,23,46.51
Rakan,Jax,96,43,53,44.79
Rakan,Jayce,61,29,32,47.54
Rakan,Karthus,48,26,22,54.17
Rakan,Vex,107,45,62,42.06
Rakan,JarvanIV,109,56,53,51.38
Rakan,Skarner,60,26,34,43.33
Rakan,Sett,163,82,81,50.31
Rakan,Heimerdinger,64,31,33,48.44
Rakan,Gangplank,57,38,19,66.67
Rakan,Singed,15,7,8,46.67
Rakan,Pyke,133,76,57,57.14
Rakan,Shyvana,21,12,9,57.14
Rakan,Sejuani,63,33,30,52.38
Rakan,Azir,55,32,23,58.18
Rakan,Xayah,103,69,34,66.99
Rakan,Bard,58,29,29,50
Rakan,Taliyah,51,32,19,62.75
Rakan,Ziggs,39,26,13,66.67
Rakan,Sona,41,26,15,63.41
Rakan,Zeri,62,42,20,67.74
Rakan,Qiyana,31,19,12,61.29
Rakan,Hecarim,33,18,15,54.55
Rakan,DrMundo,62,40,22,64.52
Rakan,Rumble,45,26,19,57.78
Rakan,Zyra,92,41,51,44.57
Rakan,Corki,44,22,22,50
Rakan,Cassiopeia,35,11,24,31.43
Rakan,Akshan,27,15,12,55.56
Rakan,Swain,112,54,58,48.21
Rakan,Fiora,48,16,32,33.33
Rakan,Volibear,90,34,56,37.78
Rakan,XinZhao,85,27,58,31.76
Rakan,Olaf,45,24,21,53.33
Rakan,Shen,114,46,68,40.35
Rakan,Belveth,18,10,8,55.56
Rakan,Fizz,60,25,35,41.67
Rakan,Kindred,67,30,37,44.78
Rakan,Ryze,49,18,31,36.73
Rakan,Velkoz,61,20,41,32.79
Rakan,Zilean,27,9,18,33.33
Rakan,Kled,9,7,2,77.78
Rakan,Kennen,39,8,31,20.51
Rakan,Zoe,48,33,15,68.75
Rakan,Maokai,45,18,27,40
Draven,Warwick,134,67,67,50
Draven,Udyr,34,21,13,61.76
Draven,Mel,266,140,126,52.63
Draven,Sivir,76,27,49,35.53
Draven,Karma,143,82,61,57.34
Draven,Heimerdinger,70,52,18,74.29
Draven,Gragas,96,51,45,53.13
Draven,Viktor,91,44,47,48.35
Draven,Jinx,277,119,158,42.96
Draven,Pyke,65,31,34,47.69
Draven,Thresh,196,79,117,40.31
Draven,Annie,38,20,18,52.63
Draven,Nasus,63,24,39,38.1
Draven,Tristana,104,62,42,59.62
Draven,Poppy,70,29,41,41.43
Draven,Jax,106,36,70,33.96
Draven,Pantheon,200,109,91,54.5
Draven,TwistedFate,55,30,25,54.55
Draven,Milio,69,15,54,21.74
Draven,Renekton,71,39,32,54.93
Draven,Diana,202,115,87,56.93
Draven,Katarina,89,46,43,51.69
Draven,Varus,141,57,84,40.43
Draven,Kayn,156,80,76,51.28
Draven,Ahri,163,83,80,50.92
Draven,Brand,71,24,47,33.8
Draven,Nami,152,71,81,46.71
Draven,Shen,81,41,40,50.62
Draven,Xayah,61,25,36,40.98
Draven,Sejuani,70,32,38,45.71
Draven,Riven,53,23,30,43.4
Draven,Lillia,68,31,37,45.59
Draven,Yasuo,227,113,114,49.78
Draven,Nautilus,198,89,109,44.95
Draven,Shaco,93,48,45,51.61
Draven,Lucian,127,73,54,57.48
Draven,Swain,82,32,50,39.02
Draven,JarvanIV,109,57,52,52.29
Draven,Naafiri,36,18,18,50
Draven,Soraka,66,39,27,59.09
Draven,Sylas,121,59,62,48.76
Draven,Briar,83,43,40,51.81
Draven,Lux,223,114,109,51.12
Draven,Ezreal,306,137,169,44.77
Draven,Neeko,62,25,37,40.32
Draven,Mordekaiser,141,69,72,48.94
Draven,MonkeyKing,107,60,47,56.07
Draven,Irelia,106,54,52,50.94
Draven,Samira,112,48,64,42.86
Draven,Rell,95,32,63,33.68
Draven,Amumu,135,62,73,45.93
Draven,Kayle,54,26,28,48.15
Draven,Khazix,58,27,31,46.55
Draven,Lulu,154,72,82,46.75
Draven,Gnar,59,28,31,47.46
Draven,Yorick,86,15,71,17.44
Draven,Aurora,114,61,53,53.51
Draven,TahmKench,121,42,79,34.71
Draven,Rammus,48,22,26,45.83
Draven,Yone,198,90,108,45.45
Draven,Zeri,89,36,53,40.45
Draven,Xerath,108,45,63,41.67
Draven,Viego,143,53,90,37.06
Draven,Kennen,67,38,29,56.72
Draven,Zyra,83,24,59,28.92
Draven,Blitzcrank,115,65,50,56.52
Draven,Nidalee,51,35,16,68.63
Draven,Akali,111,67,44,60.36
Draven,Ashe,237,120,117,50.63
Draven,Volibear,108,49,59,45.37
Draven,Ekko,98,51,47,52.04
Draven,Azir,61,29,32,47.54
Draven,MissFortune,250,119,131,47.6
Draven,Yuumi,140,64,76,45.71
Draven,Malzahar,99,56,43,56.57
Draven,KogMaw,38,25,13,65.79
Draven,Twitch,68,40,28,58.82
Draven,Sett,153,66,87,43.14
Draven,Hecarim,50,28,22,56
Draven,Trundle,58,40,18,68.97
Draven,Fiora,55,22,33,40
Draven,Leblanc,83,36,47,43.37
Draven,Caitlyn,297,138,159,46.46
Draven,Rakan,74,29,45,39.19
Draven,Camille,38,24,14,63.16
Draven,Kaisa,156,74,82,47.44
Draven,DrMundo,57,22,35,38.6
Draven,Talon,23,11,12,47.83
Draven,Morgana,124,69,55,55.65
Draven,KSante,86,44,42,51.16
Draven,Graves,77,30,47,38.96
Draven,Taric,25,13,12,52
Draven,Tryndamere,25,19,6,76
Draven,Veigar,147,71,76,48.3
Draven,Teemo,114,57,57,50
Draven,Skarner,85,41,44,48.24
Draven,Cassiopeia,30,14,16,46.67
Draven,Chogath,125,68,57,54.4
Draven,Vi,92,44,48,47.83
Draven,Fizz,53,21,32,39.62
Draven,Zilean,33,18,15,54.55
Draven,Braum,102,51,51,50
Draven,Urgot,55,33,22,60
Draven,Evelynn,36,14,22,38.89
Draven,Kalista,51,24,27,47.06
Draven,Orianna,61,35,26,57.38
Draven,Ambessa,114,58,56,50.88
Draven,Zoe,53,40,13,75.47
Draven,Darius,210,81,129,38.57
Draven,Garen,180,66,114,36.67
Draven,AurelionSol,48,13,35,27.08
Draven,Anivia,50,19,31,38
Draven,Vayne,155,72,83,46.45
Draven,Vladimir,76,30,46,39.47
Draven,Aatrox,121,68,53,56.2
Draven,Elise,70,34,36,48.57
Draven,Qiyana,34,17,17,50
Draven,Zed,95,49,46,51.58
Draven,Aphelios,56,33,23,58.93
Draven,Nunu,91,59,32,64.84
Draven,Bard,33,9,24,27.27
Draven,Zac,72,38,34,52.78
Draven,Renata,31,13,18,41.94
Draven,Ryze,36,19,17,52.78
Draven,Seraphine,74,45,29,60.81
Draven,Leona,113,57,56,50.44
Draven,Kled,25,11,14,44
Draven,Kindred,88,59,29,67.05
Draven,Syndra,70,35,35,50
Draven,Illaoi,54,21,33,38.89
Draven,Taliyah,37,10,27,27.03
Draven,Jhin,195,87,108,44.62
Draven,Jayce,41,18,23,43.9
Draven,Akshan,30,17,13,56.67
Draven,Hwei,73,24,49,32.88
Draven,Corki,49,19,30,38.78
Draven,Alistar,76,48,28,63.16
Draven,Gangplank,75,35,40,46.67
Draven,Malphite,123,40,83,32.52
Draven,FiddleSticks,57,25,32,43.86
Draven,Janna,35,24,11,68.57
Draven,LeeSin,183,95,88,51.91
Draven,MasterYi,99,49,50,49.49
Draven,Shyvana,26,9,17,34.62
Draven,Karthus,30,5,25,16.67
Draven,Vex,58,24,34,41.38
Draven,Kassadin,29,15,14,51.72
Draven,Rumble,35,17,18,48.57
Draven,Ornn,59,20,39,33.9
Draven,Ivern,24,15,9,62.5
Draven,Nocturne,143,64,79,44.76
Draven,Sion,89,39,50,43.82
Draven,Olaf,27,15,12,55.56
Draven,Velkoz,80,56,24,70
Draven,Nilah,34,22,12,64.71
Draven,Smolder,72,40,32,55.56
Draven,Sona,15,8,7,53.33
Draven,Lissandra,56,26,30,46.43
Draven,Quinn,56,32,24,57.14
Draven,Maokai,50,21,29,42
Draven,Ziggs,44,23,21,52.27
Draven,XinZhao,68,27,41,39.71
Draven,Galio,130,53,77,40.77
Draven,Rengar,28,10,18,35.71
Draven,Senna,53,28,25,52.83
Draven,Gwen,48,23,25,47.92
Draven,Belveth,39,29,10,74.36
Draven,Singed,16,12,4,75
Draven,RekSai,21,18,3,85.71
Warwick,Sett,460,230,230,50
Warwick,Hecarim,97,53,44,54.64
Warwick,Ahri,432,228,204,52.78
Warwick,Rakan,158,77,81,48.73
Warwick,Draven,134,67,67,50
Warwick,Riven,111,45,66,40.54
Warwick,Poppy,164,96,68,58.54
Warwick,Veigar,369,198,171,53.66
Warwick,Ziggs,110,64,46,58.18
Warwick,Yuumi,254,142,112,55.91
Warwick,Garen,466,229,237,49.14
Warwick,Shaco,247,134,113,54.25
Warwick,Tristana,252,141,111,55.95
Warwick,Ezreal,680,357,323,52.5
Warwick,Swain,305,145,160,47.54
Warwick,Kled,59,38,21,64.41
Warwick,Kayn,407,231,176,56.76
Warwick,Katarina,183,103,80,56.28
Warwick,Twitch,225,106,119,47.11
Warwick,Thresh,519,231,288,44.51
Warwick,Olaf,104,50,54,48.08
Warwick,Viego,383,208,175,54.31
Warwick,Ryze,140,78,62,55.71
Warwick,Jhin,595,327,268,54.96
Warwick,Soraka,168,86,82,51.19
Warwick,Malphite,328,173,155,52.74
Warwick,Khazix,154,78,76,50.65
Warwick,Galio,340,164,176,48.24
Warwick,Smolder,204,108,96,52.94
Warwick,Yorick,267,143,124,53.56
Warwick,Sylas,406,192,214,47.29
Warwick,MissFortune,615,335,280,54.47
Warwick,Renata,58,28,30,48.28
Warwick,RekSai,41,29,12,70.73
Warwick,Nunu,242,121,121,50
Warwick,Hwei,141,84,57,59.57
Warwick,Morgana,308,164,144,53.25
Warwick,Nautilus,417,231,186,55.4
Warwick,Shen,206,123,83,59.71
Warwick,Karthus,58,37,21,63.79
Warwick,Ekko,263,140,123,53.23
Warwick,Gragas,204,97,107,47.55
Warwick,MasterYi,335,184,151,54.93
Warwick,TwistedFate,82,41,41,50
Warwick,Xayah,178,102,76,57.3
Warwick,Trundle,170,97,73,57.06
Warwick,Zilean,86,32,54,37.21
Warwick,LeeSin,506,277,229,54.74
Warwick,Orianna,158,84,74,53.16
Warwick,Quinn,107,57,50,53.27
Warwick,Akali,255,148,107,58.04
Warwick,Caitlyn,713,333,380,46.7
Warwick,Milio,205,107,98,52.2
Warwick,AurelionSol,116,56,60,48.28
Warwick,Lux,599,354,245,59.1
Warwick,Vayne,377,184,193,48.81
Warwick,Lulu,371,196,175,52.83
Warwick,Ambessa,213,102,111,47.89
Warwick,Gwen,149,99,50,66.44
Warwick,Vladimir,156,54,102,34.62
Warwick,Briar,167,92,75,55.09
Warwick,Neeko,166,79,87,47.59
Warwick,Mordekaiser,511,251,260,49.12
Warwick,Darius,537,266,271,49.53
Warwick,Teemo,269,125,144,46.47
Warwick,Jinx,742,340,402,45.82
Warwick,Blitzcrank,311,165,146,53.05
Warwick,Nami,263,140,123,53.23
Warwick,Jax,247,138,109,55.87
Warwick,XinZhao,209,109,100,52.15
Warwick,Azir,79,52,27,65.82
Warwick,Rell,187,106,81,56.68
Warwick,Sion,211,95,116,45.02
Warwick,Vi,309,135,174,43.69
Warwick,Nilah,105,53,52,50.48
Warwick,Leona,356,178,178,50
Warwick,Aatrox,310,134,176,43.23
Warwick,Ivern,68,46,22,67.65
Warwick,Pantheon,465,244,221,52.47
Warwick,Nasus,193,115,78,59.59
Warwick,Viktor,234,113,121,48.29
Warwick,Ashe,609,300,309,49.26
Warwick,Zyra,235,135,100,57.45
Warwick,Velkoz,195,114,81,58.46
Warwick,Fizz,187,104,83,55.61
Warwick,Karma,324,182,142,56.17
Warwick,Lillia,141,71,70,50.35
Warwick,Yasuo,608,313,295,51.48
Warwick,Heimerdinger,184,99,85,53.8
Warwick,Irelia,223,107,116,47.98
Warwick,Zed,252,142,110,56.35
Warwick,Kaisa,404,227,177,56.19
Warwick,Brand,164,99,65,60.37
Warwick,Singed,80,43,37,53.75
Warwick,Sejuani,206,87,119,42.23
Warwick,Braum,240,97,143,40.42
Warwick,Kayle,142,66,76,46.48
Warwick,Kindred,127,65,62,51.18
Warwick,TahmKench,299,132,167,44.15
Warwick,Vex,147,79,68,53.74
Warwick,Qiyana,66,32,34,48.48
Warwick,Lucian,234,140,94,59.83
Warwick,Urgot,151,64,87,42.38
Warwick,Zoe,109,75,34,68.81
Warwick,Amumu,398,186,212,46.73
Warwick,Mel,571,298,273,52.19
Warwick,Renekton,167,83,84,49.7
Warwick,Diana,412,184,228,44.66
Warwick,Xerath,238,126,112,52.94
Warwick,Alistar,136,77,59,56.62
Warwick,Chogath,398,194,204,48.74
Warwick,Sona,50,30,20,60
Warwick,Rammus,144,79,65,54.86
Warwick,Talon,143,71,72,49.65
Warwick,Gangplank,136,46,90,33.82
Warwick,Nocturne,402,201,201,50
Warwick,Taric,51,32,19,62.75
Warwick,Aurora,218,115,103,52.75
Warwick,Pyke,259,140,119,54.05
Warwick,Syndra,222,107,115,48.2
Warwick,Yone,510,278,232,54.51
Warwick,FiddleSticks,101,53,48,52.48
Warwick,Seraphine,208,101,107,48.56
Warwick,Jayce,78,48,30,61.54
Warwick,MonkeyKing,237,102,135,43.04
Warwick,Gnar,130,78,52,60
Warwick,Camille,113,66,47,58.41
Warwick,Rengar,92,49,43,53.26
Warwick,Sivir,211,118,93,55.92
Warwick,DrMundo,175,115,60,65.71
Warwick,Maokai,108,53,55,49.07
Warwick,Aphelios,154,92,62,59.74
Warwick,Fiora,72,36,36,50
Warwick,Udyr,116,55,61,47.41
Warwick,Malzahar,318,169,149,53.14
Warwick,Evelynn,58,34,24,58.62
Warwick,Kalista,101,50,51,49.5
Warwick,Taliyah,47,29,18,61.7
Warwick,Kennen,61,38,23,62.3
Warwick,Volibear,403,195,208,48.39
Warwick,Elise,194,97,97,50
Warwick,Skarner,138,58,80,42.03
Warwick,Senna,171,89,82,52.05
Warwick,Ornn,142,85,57,59.86
Warwick,Shyvana,84,38,46,45.24
Warwick,Cassiopeia,94,42,52,44.68
Warwick,Anivia,110,61,49,55.45
Warwick,Akshan,141,66,75,46.81
Warwick,Nidalee,67,53,14,79.1
Warwick,Corki,157,71,86,45.22
Warwick,Zac,155,75,80,48.39
Warwick,Janna,71,33,38,46.48
Warwick,Varus,228,127,101,55.7
Warwick,Lissandra,124,83,41,66.94
Warwick,Leblanc,189,98,91,51.85
Warwick,Rumble,88,45,43,51.14
Warwick,Tryndamere,98,63,35,64.29
Warwick,Illaoi,142,62,80,43.66
Warwick,Kassadin,65,18,47,27.69
Warwick,Graves,165,69,96,41.82
Warwick,Samira,169,91,78,53.85
Warwick,Bard,69,32,37,46.38
Warwick,Zeri,104,50,54,48.08
Warwick,Annie,97,48,49,49.48
Warwick,Belveth,47,20,27,42.55
Warwick,JarvanIV,217,101,116,46.54
Warwick,Naafiri,54,28,26,51.85
Warwick,KogMaw,102,50,52,49.02
Warwick,KSante,169,77,92,45.56
Kayle,Volibear,142,84,58,59.15
Kayle,LeeSin,158,99,59,62.66
Kayle,Veigar,104,48,56,46.15
Kayle,Vayne,157,71,86,45.22
Kayle,Yuumi,106,72,34,67.92
Kayle,Sion,108,60,48,55.56
Kayle,Aatrox,94,60,34,63.83
Kayle,TwistedFate,41,20,21,48.78
Kayle,Lux,298,151,147,50.67
Kayle,Lulu,180,103,77,57.22
Kayle,Singed,41,11,30,26.83
Kayle,Darius,253,120,133,47.43
Kayle,Smolder,94,54,40,57.45
Kayle,Mel,252,143,109,56.75
Kayle,Pantheon,198,81,117,40.91
Kayle,XinZhao,83,51,32,61.45
Kayle,Malzahar,134,75,59,55.97
Kayle,Rell,87,65,22,74.71
Kayle,Chogath,153,100,53,65.36
Kayle,JarvanIV,75,31,44,41.33
Kayle,Yasuo,234,120,114,51.28
Kayle,Tristana,159,79,80,49.69
Kayle,Alistar,70,41,29,58.57
Kayle,Mordekaiser,140,78,62,55.71
Kayle,Kayn,147,74,73,50.34
Kayle,Ekko,105,52,53,49.52
Kayle,Nami,160,78,82,48.75
Kayle,Caitlyn,325,165,160,50.77
Kayle,Nunu,74,49,25,66.22
Kayle,Katarina,81,45,36,55.56
Kayle,Swain,94,55,39,58.51
Kayle,Rakan,66,33,33,50
Kayle,Garen,259,164,95,63.32
Kayle,Sejuani,71,43,28,60.56
Kayle,Akali,117,62,55,52.99
Kayle,Ezreal,288,155,133,53.82
Kayle,Karma,140,87,53,62.14
Kayle,Irelia,114,60,54,52.63
Kayle,Diana,149,90,59,60.4
Kayle,Morgana,107,48,59,44.86
Kayle,Yorick,111,45,66,40.54
Kayle,Shen,112,42,70,37.5
Kayle,Nocturne,136,63,73,46.32
Kayle,Lucian,109,52,57,47.71
Kayle,Xerath,105,49,56,46.67
Kayle,Olaf,22,8,14,36.36
Kayle,Warwick,142,76,66,53.52
Kayle,Urgot,49,29,20,59.18
Kayle,Draven,54,28,26,51.85
Kayle,Udyr,36,22,14,61.11
Kayle,Ahri,162,92,70,56.79
Kayle,MissFortune,236,131,105,55.51
Kayle,Blitzcrank,109,67,42,61.47
Kayle,Sett,155,78,77,50.32
Kayle,Yone,198,90,108,45.45
Kayle,Nautilus,171,85,86,49.71
Kayle,Rumble,52,30,22,57.69
Kayle,Jhin,224,101,123,45.09
Kayle,Zyra,99,57,42,57.58
Kayle,Kaisa,173,96,77,55.49
Kayle,TahmKench,119,66,53,55.46
Kayle,Samira,102,53,49,51.96
Kayle,Thresh,157,77,80,49.04
Kayle,MasterYi,111,52,59,46.85
Kayle,Ornn,88,51,37,57.95
Kayle,Aurora,111,47,64,42.34
Kayle,Jinx,252,99,153,39.29
Kayle,Renata,21,4,17,19.05
Kayle,Riven,43,21,22,48.84
Kayle,Zeri,35,23,12,65.71
Kayle,Fiora,52,32,20,61.54
Kayle,Cassiopeia,35,15,20,42.86
Kayle,Ashe,212,104,108,49.06
Kayle,Skarner,51,29,22,56.86
Kayle,Seraphine,89,51,38,57.3
Kayle,DrMundo,60,33,27,55
Kayle,Ziggs,26,12,14,46.15
Kayle,Nasus,70,29,41,41.43
Kayle,Lillia,76,46,30,60.53
Kayle,Nidalee,43,26,17,60.47
Kayle,Annie,36,10,26,27.78
Kayle,KogMaw,29,13,16,44.83
Kayle,MonkeyKing,102,49,53,48.04
Kayle,Vladimir,82,46,36,56.1
Kayle,Shaco,107,60,47,56.07
Kayle,Kassadin,23,11,12,47.83
Kayle,Teemo,134,58,76,43.28
Kayle,Jax,143,56,87,39.16
Kayle,Pyke,83,46,37,55.42
Kayle,Amumu,146,59,87,40.41
Kayle,Gwen,45,30,15,66.67
Kayle,Leona,106,58,48,54.72
Kayle,Ambessa,75,46,29,61.33
Kayle,Evelynn,14,3,11,21.43
Kayle,Syndra,120,70,50,58.33
Kayle,Viktor,111,39,72,35.14
Kayle,Braum,77,37,40,48.05
Kayle,Zilean,32,11,21,34.38
Kayle,Malphite,124,64,60,51.61
Kayle,Gragas,66,32,34,48.48
Kayle,Jayce,55,25,30,45.45
Kayle,Shyvana,26,11,15,42.31
Kayle,Aphelios,61,43,18,70.49
Kayle,Lissandra,66,34,32,51.52
Kayle,Naafiri,35,10,25,28.57
Kayle,Kindred,38,19,19,50
Kayle,Hecarim,50,20,30,40
Kayle,Zac,66,40,26,60.61
Kayle,Milio,89,46,43,51.69
Kayle,Vi,143,62,81,43.36
Kayle,Gangplank,58,34,24,58.62
Kayle,Janna,46,27,19,58.7
Kayle,Karthus,24,13,11,54.17
Kayle,Corki,56,40,16,71.43
Kayle,Twitch,89,64,25,71.91
Kayle,Talon,57,33,24,57.89
Kayle,Varus,135,76,59,56.3
Kayle,Soraka,52,27,25,51.92
Kayle,Hwei,91,55,36,60.44
Kayle,Sylas,150,88,62,58.67
Kayle,Illaoi,51,35,16,68.63
Kayle,Gnar,57,25,32,43.86
Kayle,Briar,81,35,46,43.21
Kayle,Galio,120,60,60,50
Kayle,KSante,69,42,27,60.87
Kayle,Trundle,51,30,21,58.82
Kayle,Kennen,20,14,6,70
Kayle,Velkoz,58,30,28,51.72
Kayle,Zed,120,71,49,59.17
Kayle,Viego,169,88,81,52.07
Kayle,Azir,38,21,17,55.26
Kayle,Maokai,60,33,27,55
Kayle,Brand,50,30,20,60
Kayle,Quinn,46,17,29,36.96
Kayle,FiddleSticks,43,24,19,55.81
Kayle,Neeko,57,26,31,45.61
Kayle,Heimerdinger,52,31,21,59.62
Kayle,Poppy,96,52,44,54.17
Kayle,Elise,71,44,27,61.97
Kayle,AurelionSol,45,18,27,40
Kayle,Anivia,28,19,9,67.86
Kayle,Orianna,53,32,21,60.38
Kayle,Senna,72,43,29,59.72
Kayle,Vex,63,28,35,44.44
Kayle,Rengar,39,13,26,33.33
Kayle,Camille,42,14,28,33.33
Kayle,Ryze,33,18,15,54.55
Kayle,Kalista,29,16,13,55.17
Kayle,Zoe,33,22,11,66.67
Kayle,Rammus,33,16,17,48.48
Kayle,Leblanc,74,36,38,48.65
Kayle,Sona,32,17,15,53.13
Kayle,Ivern,19,10,9,52.63
Kayle,Tryndamere,47,25,22,53.19
Kayle,Taliyah,26,15,11,57.69
Kayle,Graves,75,33,42,44
Kayle,Renekton,65,39,26,60
Kayle,Bard,28,19,9,67.86
Kayle,Sivir,77,48,29,62.34
Kayle,Xayah,62,39,23,62.9
Kayle,Akshan,29,16,13,55.17
Kayle,Khazix,73,40,33,54.79
Kayle,Fizz,43,22,21,51.16
Kayle,RekSai,23,17,6,73.91
Kayle,Taric,20,13,7,65
Kayle,Qiyana,22,15,7,68.18
Kayle,Belveth,28,11,17,39.29
Kayle,Nilah,32,13,19,40.63
Kayle,Kled,18,12,6,66.67
Kindred,Volibear,80,40,40,50
Kindred,LeeSin,179,85,94,47.49
Kindred,Veigar,104,54,50,51.92
Kindred,Vayne,121,51,70,42.15
Kindred,Yuumi,96,47,49,48.96
Kindred,Chogath,122,49,73,40.16
Kindred,Nocturne,119,81,38,68.07
Kindred,Orianna,36,19,17,52.78
Kindred,Caitlyn,261,116,145,44.44
Kindred,Neeko,41,21,20,51.22
Kindred,Quinn,24,10,14,41.67
Kindred,MasterYi,83,25,58,30.12
Kindred,Garen,175,86,89,49.14
Kindred,Smolder,85,47,38,55.29
Kindred,Nautilus,137,51,86,37.23
Kindred,Kayn,114,41,73,35.96
Kindred,Mel,173,96,77,55.49
Kindred,MissFortune,207,97,110,46.86
Kindred,Velkoz,44,24,20,54.55
Kindred,Hwei,72,23,49,31.94
Kindred,Vi,125,42,83,33.6
Kindred,Xerath,97,48,49,49.48
Kindred,Braum,80,32,48,40
Kindred,Sett,155,52,103,33.55
Kindred,Darius,155,60,95,38.71
Kindred,Leblanc,51,28,23,54.9
Kindred,Lux,216,88,128,40.74
Kindred,Karma,106,32,74,30.19
Kindred,Ashe,179,101,78,56.42
Kindred,Malzahar,108,50,58,46.3
Kindred,Jayce,48,15,33,31.25
Kindred,Jhin,173,82,91,47.4
Kindred,Singed,24,19,5,79.17
Kindred,JarvanIV,70,30,40,42.86
Kindred,Malphite,103,38,65,36.89
Kindred,FiddleSticks,56,29,27,51.79
Kindred,Galio,111,59,52,53.15
Kindred,Ezreal,235,113,122,48.09
Kindred,Lulu,103,53,50,51.46
Kindred,Heimerdinger,50,27,23,54
Kindred,Teemo,84,30,54,35.71
Kindred,Sona,25,10,15,40
Kindred,Sylas,111,61,50,54.95
Kindred,Briar,39,10,29,25.64
Kindred,Elise,79,43,36,54.43
Kindred,Zyra,91,41,50,45.05
Kindred,Varus,88,35,53,39.77
Kindred,Leona,109,41,68,37.61
Kindred,Gragas,112,69,43,61.61
Kindred,Shaco,68,26,42,38.24
Kindred,Fizz,44,20,24,45.45
Kindred,Olaf,22,9,13,40.91
Kindred,Warwick,127,62,65,48.82
Kindred,Irelia,74,36,38,48.65
Kindred,Rell,62,36,26,58.06
Kindred,Ahri,153,58,95,37.91
Kindred,Zoe,45,20,25,44.44
Kindred,Vladimir,49,27,22,55.1
Kindred,Blitzcrank,74,20,54,27.03
Kindred,Alistar,62,25,37,40.32
Kindred,Mordekaiser,131,73,58,55.73
Kindred,Brand,39,19,20,48.72
Kindred,Jinx,264,105,159,39.77
Kindred,Skarner,51,27,24,52.94
Kindred,Soraka,38,18,20,47.37
Kindred,Lucian,79,28,51,35.44
Kindred,Nunu,67,32,35,47.76
Kindred,Thresh,186,61,125,32.8
Kindred,Aatrox,125,38,87,30.4
Kindred,Amumu,140,46,94,32.86
Kindred,Viktor,111,46,65,41.44
Kindred,Yasuo,165,73,92,44.24
Kindred,Gwen,59,26,33,44.07
Kindred,Taliyah,21,11,10,52.38
Kindred,Pantheon,186,90,96,48.39
Kindred,AurelionSol,59,35,24,59.32
Kindred,Corki,47,23,24,48.94
Kindred,Qiyana,23,19,4,82.61
Kindred,Kaisa,146,68,78,46.58
Kindred,Yorick,81,33,48,40.74
Kindred,Tristana,82,27,55,32.93
Kindred,Ekko,89,55,34,61.8
Kindred,Nidalee,12,12,0,100
Kindred,Udyr,27,19,8,70.37
Kindred,Aurora,84,30,54,35.71
Kindred,TahmKench,84,36,48,42.86
Kindred,Zed,96,21,75,21.88
Kindred,Samira,75,29,46,38.67
Kindred,Illaoi,40,21,19,52.5
Kindred,Maokai,41,12,29,29.27
Kindred,Morgana,103,37,66,35.92
Kindred,DrMundo,39,17,22,43.59
Kindred,Poppy,66,34,32,51.52
Kindred,Rengar,21,11,10,52.38
Kindred,Viego,109,35,74,32.11
Kindred,Sion,79,34,45,43.04
Kindred,Trundle,46,29,17,63.04
Kindred,Zac,46,35,11,76.09
Kindred,Kalista,43,19,24,44.19
Kindred,Renata,28,13,15,46.43
Kindred,Nasus,71,28,43,39.44
Kindred,Diana,159,72,87,45.28
Kindred,Akali,89,24,65,26.97
Kindred,Zilean,28,19,9,67.86
Kindred,MonkeyKing,45,19,26,42.22
Kindred,Naafiri,16,8,8,50
Kindred,Draven,88,29,59,32.95
Kindred,Cassiopeia,40,14,26,35
Kindred,Ornn,68,27,41,39.71
Kindred,Seraphine,58,26,32,44.83
Kindred,Nilah,33,18,15,54.55
Kindred,Katarina,75,51,24,68
Kindred,Janna,38,13,25,34.21
Kindred,Kayle,38,19,19,50
Kindred,Vex,73,29,44,39.73
Kindred,Riven,34,16,18,47.06
Kindred,Milio,54,24,30,44.44
Kindred,Jax,68,29,39,42.65
Kindred,Sivir,49,22,27,44.9
Kindred,Gnar,52,14,38,26.92
Kindred,Shen,89,39,50,43.82
Kindred,Ambessa,73,28,45,38.36
Kindred,Nami,114,53,61,46.49
Kindred,Ziggs,48,23,25,47.92
Kindred,Ivern,20,6,14,30
Kindred,Hecarim,37,13,24,35.14
Kindred,TwistedFate,28,14,14,50
Kindred,Pyke,99,53,46,53.54
Kindred,Renekton,47,18,29,38.3
Kindred,Sejuani,76,32,44,42.11
Kindred,Camille,34,14,20,41.18
Kindred,Azir,30,19,11,63.33
Kindred,Xayah,55,23,32,41.82
Kindred,Karthus,27,6,21,22.22
Kindred,Taric,17,8,9,47.06
Kindred,Syndra,43,14,29,32.56
Kindred,Belveth,23,8,15,34.78
Kindred,KSante,62,38,24,61.29
Kindred,Lissandra,36,26,10,72.22
Kindred,Tryndamere,33,10,23,30.3
Kindred,Swain,79,42,37,53.16
Kindred,XinZhao,75,33,42,44
Kindred,Twitch,86,42,44,48.84
Kindred,Yone,156,86,70,55.13
Kindred,Lillia,74,34,40,45.95
Kindred,Rakan,67,37,30,55.22
Kindred,Evelynn,20,14,6,70
Kindred,Kassadin,21,9,12,42.86
Kindred,Anivia,23,6,17,26.09
Kindred,Rammus,25,8,17,32
Kindred,Ryze,28,10,18,35.71
Kindred,Aphelios,44,23,21,52.27
Kindred,Talon,47,16,31,34.04
Kindred,Kled,24,13,11,54.17
Kindred,Rumble,45,13,32,28.89
Kindred,Shyvana,29,17,12,58.62
Kindred,Fiora,44,26,18,59.09
Kindred,KogMaw,15,6,9,40
Kindred,Gangplank,44,21,23,47.73
Kindred,Senna,48,23,25,47.92
Kindred,Bard,36,5,31,13.89
Kindred,Khazix,47,14,33,29.79
Kindred,Annie,14,7,7,50
Kindred,Kennen,25,6,19,24
Kindred,Zeri,35,7,28,20
Kindred,Urgot,52,23,29,44.23
Kindred,Akshan,17,7,10,41.18
Kindred,Graves,73,29,44,39.73
Kindred,RekSai,11,5,6,45.45
AurelionSol,Volibear,128,70,58,54.69
AurelionSol,LeeSin,160,76,84,47.5
AurelionSol,Veigar,110,48,62,43.64
AurelionSol,Vayne,116,52,64,44.83
AurelionSol,Yuumi,106,40,66,37.74
AurelionSol,Urgot,42,21,21,50
AurelionSol,Kayn,116,45,71,38.79
AurelionSol,Vladimir,54,31,23,57.41
AurelionSol,Kaisa,144,88,56,61.11
AurelionSol,Taric,35,17,18,48.57
AurelionSol,Alistar,36,18,18,50
AurelionSol,Nocturne,110,55,55,50
AurelionSol,Galio,130,64,66,49.23
AurelionSol,Samira,74,46,28,62.16
AurelionSol,Sion,104,59,45,56.73
AurelionSol,Ambessa,72,31,41,43.06
AurelionSol,Viktor,101,47,54,46.53
AurelionSol,Jinx,275,122,153,44.36
AurelionSol,Mel,287,156,131,54.36
AurelionSol,Illaoi,45,32,13,71.11
AurelionSol,Senna,98,61,37,62.24
AurelionSol,Darius,173,82,91,47.4
AurelionSol,Warwick,116,60,56,51.72
AurelionSol,Akali,65,38,27,58.46
AurelionSol,Morgana,76,39,37,51.32
AurelionSol,Gnar,41,28,13,68.29
AurelionSol,Amumu,123,59,64,47.97
AurelionSol,Aurora,61,43,18,70.49
AurelionSol,Tristana,75,28,47,37.33
AurelionSol,Thresh,167,84,83,50.3
AurelionSol,Teemo,83,52,31,62.65
AurelionSol,DrMundo,61,34,27,55.74
AurelionSol,KogMaw,43,20,23,46.51
AurelionSol,Maokai,49,21,28,42.86
AurelionSol,Quinn,50,39,11,78
AurelionSol,Naafiri,41,26,15,63.41
AurelionSol,Lux,229,122,107,53.28
AurelionSol,Varus,96,50,46,52.08
AurelionSol,Lulu,122,73,49,59.84
AurelionSol,Trundle,37,22,15,59.46
AurelionSol,Leblanc,27,9,18,33.33
AurelionSol,Nidalee,19,11,8,57.89
AurelionSol,Blitzcrank,68,42,26,61.76
AurelionSol,Ornn,79,42,37,53.16
AurelionSol,Hwei,62,44,18,70.97
AurelionSol,Jhin,154,83,71,53.9
AurelionSol,TahmKench,99,47,52,47.47
AurelionSol,JarvanIV,69,29,40,42.03
AurelionSol,Chogath,144,65,79,45.14
AurelionSol,Ezreal,201,113,88,56.22
AurelionSol,Braum,78,49,29,62.82
AurelionSol,Yone,166,89,77,53.61
AurelionSol,Shyvana,30,17,13,56.67
AurelionSol,Fizz,69,37,32,53.62
AurelionSol,Ekko,77,43,34,55.84
AurelionSol,Milio,68,28,40,41.18
AurelionSol,Jax,72,39,33,54.17
AurelionSol,FiddleSticks,20,15,5,75
AurelionSol,Yasuo,137,86,51,62.77
AurelionSol,Rakan,38,20,18,52.63
AurelionSol,Rammus,48,31,17,64.58
AurelionSol,Diana,118,49,69,41.53
AurelionSol,Caitlyn,224,118,106,52.68
AurelionSol,Nautilus,99,62,37,62.63
AurelionSol,Garen,131,57,74,43.51
AurelionSol,Ahri,99,48,51,48.48
AurelionSol,Soraka,47,22,25,46.81
AurelionSol,Aatrox,99,62,37,62.63
AurelionSol,Velkoz,58,41,17,70.69
AurelionSol,Vi,93,49,44,52.69
AurelionSol,Twitch,67,48,19,71.64
AurelionSol,Zilean,26,13,13,50
AurelionSol,XinZhao,50,19,31,38
AurelionSol,Kassadin,27,14,13,51.85
AurelionSol,Xayah,50,24,26,48
AurelionSol,Fiora,37,18,19,48.65
AurelionSol,Heimerdinger,38,16,22,42.11
AurelionSol,Zoe,43,22,21,51.16
AurelionSol,KSante,63,38,25,60.32
AurelionSol,Gwen,55,26,29,47.27
AurelionSol,Qiyana,18,7,11,38.89
AurelionSol,Karma,112,61,51,54.46
AurelionSol,Sivir,43,24,19,55.81
AurelionSol,Shaco,84,54,30,64.29
AurelionSol,Pantheon,157,102,55,64.97
AurelionSol,Kindred,59,24,35,40.68
AurelionSol,Katarina,67,29,38,43.28
AurelionSol,MissFortune,192,78,114,40.63
AurelionSol,Ziggs,35,17,18,48.57
AurelionSol,Talon,47,35,12,74.47
AurelionSol,Nasus,86,35,51,40.7
AurelionSol,Brand,66,37,29,56.06
AurelionSol,Olaf,22,13,9,59.09
AurelionSol,Udyr,22,17,5,77.27
AurelionSol,Khazix,49,35,14,71.43
AurelionSol,Zed,77,40,37,51.95
AurelionSol,Draven,48,35,13,72.92
AurelionSol,Nami,93,57,36,61.29
AurelionSol,Irelia,51,33,18,64.71
AurelionSol,Evelynn,28,21,7,75
AurelionSol,Riven,26,14,12,53.85
AurelionSol,Swain,91,50,41,54.95
AurelionSol,Tryndamere,33,18,15,54.55
AurelionSol,Kalista,26,11,15,42.31
AurelionSol,Ashe,187,90,97,48.13
AurelionSol,Rengar,26,12,14,46.15
AurelionSol,Syndra,67,40,27,59.7
AurelionSol,Xerath,69,27,42,39.13
AurelionSol,Zyra,69,39,30,56.52
AurelionSol,Sejuani,59,32,27,54.24
AurelionSol,Gragas,60,28,32,46.67
AurelionSol,Karthus,25,16,9,64
AurelionSol,Lillia,74,41,33,55.41
AurelionSol,Smolder,53,33,20,62.26
AurelionSol,Sett,131,73,58,55.73
AurelionSol,Skarner,52,24,28,46.15
AurelionSol,Seraphine,79,48,31,60.76
AurelionSol,Renata,18,9,9,50
AurelionSol,Nunu,71,44,27,61.97
AurelionSol,Briar,53,22,31,41.51
AurelionSol,Rell,78,38,40,48.72
AurelionSol,MasterYi,89,52,37,58.43
AurelionSol,Malphite,92,51,41,55.43
AurelionSol,RekSai,19,12,7,63.16
AurelionSol,MonkeyKing,56,38,18,67.86
AurelionSol,Corki,45,25,20,55.56
AurelionSol,Sona,21,5,16,23.81
AurelionSol,Malzahar,97,54,43,55.67
AurelionSol,Orianna,38,19,19,50
AurelionSol,Bard,36,17,19,47.22
AurelionSol,TwistedFate,50,28,22,56
AurelionSol,Taliyah,52,29,23,55.77
AurelionSol,Lucian,66,42,24,63.64
AurelionSol,Viego,98,50,48,51.02
AurelionSol,Lissandra,53,33,20,62.26
AurelionSol,Graves,54,26,28,48.15
AurelionSol,Leona,94,51,43,54.26
AurelionSol,Pyke,70,32,38,45.71
AurelionSol,Mordekaiser,148,78,70,52.7
AurelionSol,Camille,47,28,19,59.57
AurelionSol,Kled,19,8,11,42.11
AurelionSol,Singed,26,18,8,69.23
AurelionSol,Kayle,45,27,18,60
AurelionSol,Neeko,28,10,18,35.71
AurelionSol,Yorick,74,53,21,71.62
AurelionSol,Aphelios,55,34,21,61.82
AurelionSol,Shen,84,41,43,48.81
AurelionSol,Vex,27,21,6,77.78
AurelionSol,Annie,18,7,11,38.89
AurelionSol,Ryze,36,18,18,50
AurelionSol,Elise,78,45,33,57.69
AurelionSol,Poppy,57,30,27,52.63
AurelionSol,Janna,28,13,15,46.43
AurelionSol,Hecarim,28,8,20,28.57
AurelionSol,Cassiopeia,33,8,25,24.24
AurelionSol,Rumble,15,5,10,33.33
AurelionSol,Akshan,31,18,13,58.06
AurelionSol,Renekton,56,24,32,42.86
AurelionSol,Anivia,43,19,24,44.19
AurelionSol,Zeri,38,18,20,47.37
AurelionSol,Sylas,106,43,63,40.57
AurelionSol,Zac,48,29,19,60.42
AurelionSol,Nilah,37,17,20,45.95
AurelionSol,Gangplank,43,22,21,51.16
AurelionSol,Ivern,21,10,11,47.62
AurelionSol,Belveth,16,8,8,50
AurelionSol,Kennen,15,13,2,86.67
AurelionSol,Azir,29,24,5,82.76
AurelionSol,Jayce,48,27,21,56.25
LeeSin,Kayle,158,59,99,37.34
LeeSin,Kindred,179,94,85,52.51
LeeSin,AurelionSol,160,84,76,52.5
LeeSin,Caitlyn,1057,505,552,47.78
LeeSin,Morgana,345,167,178,48.41
LeeSin,Ambessa,382,169,213,44.24
LeeSin,Diana,669,336,333,50.22
LeeSin,Ekko,292,137,155,46.92
LeeSin,Jinx,1010,443,567,43.86
LeeSin,Lulu,676,337,339,49.85
LeeSin,Riven,169,72,97,42.6
LeeSin,MonkeyKing,347,143,204,41.21
LeeSin,Kassadin,67,32,35,47.76
LeeSin,Taliyah,127,59,68,46.46
LeeSin,Aatrox,608,341,267,56.09
LeeSin,JarvanIV,380,189,191,49.74
LeeSin,Chogath,483,218,265,45.13
LeeSin,MissFortune,779,356,423,45.7
LeeSin,Yuumi,365,177,188,48.49
LeeSin,Akali,500,263,237,52.6
LeeSin,Nunu,220,115,105,52.27
LeeSin,Lux,812,387,425,47.66
LeeSin,Tristana,307,139,168,45.28
LeeSin,Nautilus,554,273,281,49.28
LeeSin,Sett,589,252,337,42.78
LeeSin,Sejuani,257,93,164,36.19
LeeSin,Viktor,404,197,207,48.76
LeeSin,Gragas,455,225,230,49.45
LeeSin,MasterYi,394,178,216,45.18
LeeSin,TwistedFate,155,67,88,43.23
LeeSin,Xayah,197,87,110,44.16
LeeSin,Rakan,269,148,121,55.02
LeeSin,Sion,361,173,188,47.92
LeeSin,Rengar,108,71,37,65.74
LeeSin,Hwei,264,104,160,39.39
LeeSin,Ashe,1016,503,513,49.51
LeeSin,Braum,282,102,180,36.17
LeeSin,Warwick,506,229,277,45.26
LeeSin,Vladimir,255,105,150,41.18
LeeSin,Vayne,396,189,207,47.73
LeeSin,Nami,353,167,186,47.31
LeeSin,Ezreal,1295,623,672,48.11
LeeSin,Xerath,470,201,269,42.77
LeeSin,Mordekaiser,498,239,259,47.99
LeeSin,TahmKench,352,167,185,47.44
LeeSin,Mel,760,363,397,47.76
LeeSin,Nocturne,587,244,343,41.57
LeeSin,Galio,564,271,293,48.05
LeeSin,Illaoi,164,78,86,47.56
LeeSin,Senna,237,123,114,51.9
LeeSin,Poppy,351,177,174,50.43
LeeSin,Khazix,255,132,123,51.76
LeeSin,Yone,722,373,349,51.66
LeeSin,Yasuo,855,405,450,47.37
LeeSin,KogMaw,111,47,64,42.34
LeeSin,Ahri,564,265,299,46.99
LeeSin,Irelia,295,144,151,48.81
LeeSin,Darius,720,292,428,40.56
LeeSin,Samira,299,152,147,50.84
LeeSin,Gnar,224,114,110,50.89
LeeSin,Belveth,68,31,37,45.59
LeeSin,KSante,332,169,163,50.9
LeeSin,Rell,280,132,148,47.14
LeeSin,Garen,591,290,301,49.07
LeeSin,Corki,182,95,87,52.2
LeeSin,Lillia,223,101,122,45.29
LeeSin,Kaisa,775,377,398,48.65
LeeSin,Pyke,348,161,187,46.26
LeeSin,Katarina,278,152,126,54.68
LeeSin,Amumu,377,146,231,38.73
LeeSin,Jhin,713,330,383,46.28
LeeSin,Nasus,211,116,95,54.98
LeeSin,Gangplank,258,139,119,53.88
LeeSin,Vi,632,309,323,48.89
LeeSin,Sylas,782,381,401,48.72
LeeSin,Karthus,129,62,67,48.06
LeeSin,Annie,140,73,67,52.14
LeeSin,Zoe,185,100,85,54.05
LeeSin,Aurora,377,195,182,51.72
LeeSin,Viego,699,338,361,48.35
LeeSin,Leona,501,230,271,45.91
LeeSin,DrMundo,185,81,104,43.78
LeeSin,Kayn,439,219,220,49.89
LeeSin,Zeri,236,113,123,47.88
LeeSin,Velkoz,238,102,136,42.86
LeeSin,Urgot,176,74,102,42.05
LeeSin,Zac,243,121,122,49.79
LeeSin,Varus,445,229,216,51.46
LeeSin,Rammus,154,82,72,53.25
LeeSin,Karma,628,312,316,49.68
LeeSin,Pantheon,722,342,380,47.37
LeeSin,Malzahar,424,191,233,45.05
LeeSin,Ivern,83,56,27,67.47
LeeSin,Anivia,179,90,89,50.28
LeeSin,Thresh,835,409,426,48.98
LeeSin,Malphite,408,236,172,57.84
LeeSin,Nidalee,241,124,117,51.45
LeeSin,Veigar,313,166,147,53.04
LeeSin,Skarner,264,144,120,54.55
LeeSin,Renekton,225,94,131,41.78
LeeSin,Udyr,139,62,77,44.6
LeeSin,Smolder,272,125,147,45.96
LeeSin,Heimerdinger,127,45,82,35.43
LeeSin,Jax,315,161,154,51.11
LeeSin,Evelynn,108,61,47,56.48
LeeSin,Seraphine,308,147,161,47.73
LeeSin,Teemo,337,169,168,50.15
LeeSin,Lucian,417,201,216,48.2
LeeSin,Ornn,303,137,166,45.21
LeeSin,Graves,444,217,227,48.87
LeeSin,Leblanc,312,158,154,50.64
LeeSin,Syndra,315,137,178,43.49
LeeSin,Swain,312,113,199,36.22
LeeSin,Shaco,362,138,224,38.12
LeeSin,Milio,207,88,119,42.51
LeeSin,Orianna,234,99,135,42.31
LeeSin,Naafiri,125,60,65,48
LeeSin,Zyra,343,156,187,45.48
LeeSin,XinZhao,449,215,234,47.88
LeeSin,Sivir,233,117,116,50.21
LeeSin,Lissandra,159,85,74,53.46
LeeSin,Soraka,121,62,59,51.24
LeeSin,Rumble,173,75,98,43.35
LeeSin,Quinn,131,67,64,51.15
LeeSin,Nilah,132,56,76,42.42
LeeSin,Jayce,298,135,163,45.3
LeeSin,Kled,91,39,52,42.86
LeeSin,Shen,297,112,185,37.71
LeeSin,Tryndamere,162,79,83,48.77
LeeSin,Alistar,268,127,141,47.39
LeeSin,Fiora,154,74,80,48.05
LeeSin,Vex,236,115,121,48.73
LeeSin,Singed,92,49,43,53.26
LeeSin,Fizz,152,90,62,59.21
LeeSin,Kalista,148,77,71,52.03
LeeSin,Yorick,201,107,94,53.23
LeeSin,RekSai,68,36,32,52.94
LeeSin,Neeko,212,108,104,50.94
LeeSin,Zed,401,206,195,51.37
LeeSin,Gwen,172,96,76,55.81
LeeSin,Blitzcrank,424,217,207,51.18
LeeSin,Talon,298,125,173,41.95
LeeSin,Maokai,167,79,88,47.31
LeeSin,Kennen,154,68,86,44.16
LeeSin,Ryze,192,106,86,55.21
LeeSin,Elise,388,182,206,46.91
LeeSin,Volibear,355,164,191,46.2
LeeSin,Bard,104,56,48,53.85
LeeSin,Renata,104,52,52,50
LeeSin,Qiyana,87,38,49,43.68
LeeSin,Sona,50,25,25,50
LeeSin,Trundle,146,79,67,54.11
LeeSin,Zilean,95,47,48,49.47
LeeSin,Twitch,220,116,104,52.73
LeeSin,Taric,58,13,45,22.41
LeeSin,Janna,118,58,60,49.15
LeeSin,Ziggs,159,91,68,57.23
LeeSin,Azir,191,97,94,50.79
LeeSin,FiddleSticks,153,72,81,47.06
LeeSin,Draven,183,88,95,48.09
LeeSin,Brand,157,75,82,47.77
LeeSin,Hecarim,165,79,86,47.88
LeeSin,Olaf,96,44,52,45.83
LeeSin,Briar,204,75,129,36.76
LeeSin,Camille,211,91,120,43.13
LeeSin,Akshan,80,45,35,56.25
LeeSin,Cassiopeia,118,50,68,42.37
LeeSin,Aphelios,213,75,138,35.21
LeeSin,Shyvana,71,45,26,63.38
Elise,Ornn,103,60,43,58.25
Elise,Lillia,134,49,85,36.57
Elise,Zed,216,114,102,52.78
Elise,Tristana,165,86,79,52.12
Elise,Nami,195,81,114,41.54
Elise,Poppy,157,83,74,52.87
Elise,Zac,149,75,74,50.34
Elise,Malzahar,142,55,87,38.73
Elise,MissFortune,357,156,201,43.7
Elise,TahmKench,169,99,70,58.58
Elise,Twitch,122,73,49,59.84
Elise,Katarina,108,57,51,52.78
Elise,Vayne,218,95,123,43.58
Elise,Blitzcrank,216,104,112,48.15
Elise,Braum,173,79,94,45.66
Elise,MasterYi,177,101,76,57.06
Elise,Karma,266,111,155,41.73
Elise,Ashe,401,209,192,52.12
Elise,Yorick,125,57,68,45.6
Elise,Graves,168,95,73,56.55
Elise,Naafiri,32,18,14,56.25
Elise,Caitlyn,418,222,196,53.11
Elise,Morgana,171,76,95,44.44
Elise,Sett,302,127,175,42.05
Elise,Jax,156,72,84,46.15
Elise,Irelia,103,54,49,52.43
Elise,Jhin,348,183,165,52.59
Elise,Yuumi,149,65,84,43.62
Elise,Pantheon,321,171,150,53.27
Elise,Kayn,224,110,114,49.11
Elise,Ahri,245,114,131,46.53
Elise,Brand,98,69,29,70.41
Elise,Gnar,153,85,68,55.56
Elise,Sejuani,105,49,56,46.67
Elise,Varus,193,102,91,52.85
Elise,Thresh,327,164,163,50.15
Elise,JarvanIV,145,73,72,50.34
Elise,Rumble,78,47,31,60.26
Elise,Galio,302,107,195,35.43
Elise,Lulu,343,172,171,50.15
Elise,Riven,91,54,37,59.34
Elise,Vladimir,131,79,52,60.31
Elise,Ziggs,100,46,54,46
Elise,Aurora,179,75,104,41.9
Elise,Ezreal,546,292,254,53.48
Elise,Anivia,93,36,57,38.71
Elise,Nunu,95,60,35,63.16
Elise,Darius,369,177,192,47.97
Elise,Lux,361,224,137,62.05
Elise,Malphite,191,112,79,58.64
Elise,Kindred,79,36,43,45.57
Elise,Akshan,55,16,39,29.09
Elise,Gwen,64,27,37,42.19
Elise,XinZhao,178,97,81,54.49
Elise,Sion,175,72,103,41.14
Elise,Trundle,67,38,29,56.72
Elise,Mel,379,197,182,51.98
Elise,Kaisa,346,191,155,55.2
Elise,Janna,67,33,34,49.25
Elise,Kled,37,14,23,37.84
Elise,Briar,85,49,36,57.65
Elise,Velkoz,120,70,50,58.33
Elise,Rammus,57,27,30,47.37
Elise,Yone,361,177,184,49.03
Elise,Zeri,101,37,64,36.63
Elise,Xerath,190,86,104,45.26
Elise,Shaco,172,79,93,45.93
Elise,Gangplank,115,71,44,61.74
Elise,Nautilus,221,115,106,52.04
Elise,Volibear,163,69,94,42.33
Elise,Sylas,291,159,132,54.64
Elise,Amumu,206,94,112,45.63
Elise,Teemo,141,59,82,41.84
Elise,Milio,132,58,74,43.94
Elise,Hecarim,79,35,44,44.3
Elise,Ambessa,175,95,80,54.29
Elise,Skarner,117,65,52,55.56
Elise,Fizz,91,56,35,61.54
Elise,Chogath,254,115,139,45.28
Elise,MonkeyKing,140,62,78,44.29
Elise,Syndra,155,102,53,65.81
Elise,TwistedFate,53,31,22,58.49
Elise,Ryze,111,47,64,42.34
Elise,Jinx,461,192,269,41.65
Elise,Urgot,102,58,44,56.86
Elise,Xayah,143,84,59,58.74
Elise,Alistar,93,40,53,43.01
Elise,Ekko,153,73,80,47.71
Elise,Swain,185,102,83,55.14
Elise,Rengar,42,22,20,52.38
Elise,KSante,154,84,70,54.55
Elise,Kassadin,47,21,26,44.68
Elise,Samira,112,62,50,55.36
Elise,Viego,309,153,156,49.51
Elise,Akali,202,97,105,48.02
Elise,Illaoi,92,49,43,53.26
Elise,Leblanc,109,57,52,52.29
Elise,Soraka,114,57,57,50
Elise,Warwick,194,97,97,50
Elise,Taric,28,13,15,46.43
Elise,Gragas,141,78,63,55.32
Elise,Kalista,79,37,42,46.84
Elise,Rakan,126,54,72,42.86
Elise,Nilah,84,38,46,45.24
Elise,Shen,141,55,86,39.01
Elise,Neeko,103,49,54,47.57
Elise,Lucian,172,99,73,57.56
Elise,LeeSin,388,206,182,53.09
Elise,Sona,35,15,20,42.86
Elise,Aatrox,181,102,79,56.35
Elise,Draven,70,36,34,51.43
Elise,Nocturne,239,121,118,50.63
Elise,Vi,196,107,89,54.59
Elise,Diana,286,147,139,51.4
Elise,Orianna,85,31,54,36.47
Elise,Rell,123,61,62,49.59
Elise,Renekton,132,64,68,48.48
Elise,Talon,125,74,51,59.2
Elise,Garen,264,110,154,41.67
Elise,Nidalee,82,45,37,54.88
Elise,DrMundo,95,60,35,63.16
Elise,Seraphine,118,64,54,54.24
Elise,Olaf,54,27,27,50
Elise,Yasuo,344,176,168,51.16
Elise,Cassiopeia,78,48,30,61.54
Elise,Leona,167,97,70,58.08
Elise,Fiora,117,38,79,32.48
Elise,Veigar,145,61,84,42.07
Elise,Taliyah,64,39,25,60.94
Elise,Mordekaiser,228,127,101,55.7
Elise,Ivern,38,18,20,47.37
Elise,Jayce,101,50,51,49.5
Elise,Annie,56,29,27,51.79
Elise,Viktor,198,103,95,52.02
Elise,Zilean,62,28,34,45.16
Elise,Smolder,98,61,37,62.24
Elise,Zyra,141,56,85,39.72
Elise,Corki,123,64,59,52.03
Elise,Maokai,106,39,67,36.79
Elise,FiddleSticks,81,27,54,33.33
Elise,Pyke,180,98,82,54.44
Elise,Nasus,108,61,47,56.48
Elise,Lissandra,94,43,51,45.74
Elise,Udyr,75,41,34,54.67
Elise,KogMaw,64,39,25,60.94
Elise,Evelynn,60,17,43,28.33
Elise,Bard,61,32,29,52.46
Elise,Vex,111,52,59,46.85
Elise,Belveth,42,24,18,57.14
Elise,Quinn,47,7,40,14.89
Elise,Heimerdinger,73,17,56,23.29
Elise,Aphelios,94,39,55,41.49
Elise,Kayle,71,27,44,38.03
Elise,Hwei,124,68,56,54.84
Elise,Renata,46,22,24,47.83
Elise,Khazix,84,41,43,48.81
Elise,Tryndamere,47,35,12,74.47
Elise,Zoe,102,55,47,53.92
Elise,Sivir,125,43,82,34.4
Elise,AurelionSol,78,33,45,42.31
Elise,Karthus,38,17,21,44.74
Elise,Shyvana,43,20,23,46.51
Elise,Qiyana,41,26,15,63.41
Elise,Senna,109,59,50,54.13
Elise,Azir,87,48,39,55.17
Elise,Singed,44,16,28,36.36
Elise,Kennen,52,29,23,55.77
Elise,RekSai,21,6,15,28.57
Elise,Camille,51,20,31,39.22
Malzahar,Ornn,113,46,67,40.71
Malzahar,Lillia,128,57,71,44.53
Malzahar,Zed,247,116,131,46.96
Malzahar,Tristana,248,146,102,58.87
Malzahar,Nami,256,98,158,38.28
Malzahar,DrMundo,141,78,63,55.32
Malzahar,Sejuani,170,102,68,60
Malzahar,Veigar,284,156,128,54.93
Malzahar,Jinx,614,283,331,46.09
Malzahar,Garen,368,179,189,48.64
Malzahar,Shyvana,60,29,31,48.33
Malzahar,Lissandra,60,28,32,46.67
Malzahar,Lux,567,343,224,60.49
Malzahar,Gragas,185,120,65,64.86
Malzahar,Elise,142,87,55,61.27
Malzahar,Mel,488,284,204,58.2
Malzahar,Vayne,305,178,127,58.36
Malzahar,Zyra,199,118,81,59.3
Malzahar,Gangplank,121,55,66,45.45
Malzahar,FiddleSticks,116,58,58,50
Malzahar,Ezreal,594,313,281,52.69
Malzahar,Riven,115,40,75,34.78
Malzahar,Karthus,70,45,25,64.29
Malzahar,Lucian,173,79,94,45.66
Malzahar,Illaoi,102,50,52,49.02
Malzahar,Pantheon,377,203,174,53.85
Malzahar,Vex,149,82,67,55.03
Malzahar,Braum,218,103,115,47.25
Malzahar,Teemo,192,88,104,45.83
Malzahar,Aurora,189,102,87,53.97
Malzahar,Amumu,262,137,125,52.29
Malzahar,MissFortune,506,254,252,50.2
Malzahar,Rakan,145,78,67,53.79
Malzahar,Kayle,134,59,75,44.03
Malzahar,Evelynn,79,44,35,55.7
Malzahar,Vladimir,166,90,76,54.22
Malzahar,Kaisa,377,199,178,52.79
Malzahar,Maokai,126,49,77,38.89
Malzahar,Cassiopeia,65,29,36,44.62
Malzahar,Yone,345,179,166,51.88
Malzahar,Ashe,478,235,243,49.16
Malzahar,TahmKench,286,134,152,46.85
Malzahar,Lulu,349,173,176,49.57
Malzahar,Jax,186,106,80,56.99
Malzahar,Yasuo,462,215,247,46.54
Malzahar,Chogath,305,140,165,45.9
Malzahar,KSante,148,87,61,58.78
Malzahar,Zac,159,70,89,44.03
Malzahar,Annie,71,40,31,56.34
Malzahar,Malphite,263,108,155,41.06
Malzahar,Kindred,108,58,50,53.7
Malzahar,Quinn,80,28,52,35
Malzahar,Nautilus,348,202,146,58.05
Malzahar,Khazix,99,53,46,53.54
Malzahar,Akali,182,97,85,53.3
Malzahar,Milio,143,60,83,41.96
Malzahar,Nasus,134,67,67,50
Malzahar,MasterYi,247,147,100,59.51
Malzahar,Anivia,68,40,28,58.82
Malzahar,Yuumi,152,76,76,50
Malzahar,Shaco,189,108,81,57.14
Malzahar,Fizz,131,83,48,63.36
Malzahar,Aphelios,143,54,89,37.76
Malzahar,Soraka,107,51,56,47.66
Malzahar,Mordekaiser,298,134,164,44.97
Malzahar,Kayn,277,149,128,53.79
Malzahar,Ziggs,92,42,50,45.65
Malzahar,XinZhao,178,93,85,52.25
Malzahar,Azir,124,46,78,37.1
Malzahar,Rell,190,102,88,53.68
Malzahar,Trundle,145,82,63,56.55
Malzahar,Katarina,147,73,74,49.66
Malzahar,Zoe,112,65,47,58.04
Malzahar,Ambessa,177,79,98,44.63
Malzahar,Udyr,77,40,37,51.95
Malzahar,Syndra,182,95,87,52.2
Malzahar,Corki,116,61,55,52.59
Malzahar,Alistar,117,67,50,57.26
Malzahar,Akshan,84,46,38,54.76
Malzahar,MonkeyKing,171,92,79,53.8
Malzahar,Kassadin,32,12,20,37.5
Malzahar,Karma,284,144,140,50.7
Malzahar,Aatrox,241,118,123,48.96
Malzahar,Ekko,204,110,94,53.92
Malzahar,Nilah,101,48,53,47.52
Malzahar,Ahri,292,144,148,49.32
Malzahar,Zeri,133,66,67,49.62
Malzahar,Velkoz,139,80,59,57.55
Malzahar,Renekton,135,81,54,60
Malzahar,Darius,438,225,213,51.37
Malzahar,Poppy,145,75,70,51.72
Malzahar,Xayah,142,68,74,47.89
Malzahar,LeeSin,424,233,191,54.95
Malzahar,Sylas,283,152,131,53.71
Malzahar,Xerath,218,109,109,50
Malzahar,Smolder,214,113,101,52.8
Malzahar,Swain,235,105,130,44.68
Malzahar,Gwen,119,67,52,56.3
Malzahar,Hecarim,69,25,44,36.23
Malzahar,Ryze,99,61,38,61.62
Malzahar,Sett,334,180,154,53.89
Malzahar,Leblanc,134,74,60,55.22
Malzahar,Caitlyn,594,310,284,52.19
Malzahar,Morgana,267,142,125,53.18
Malzahar,Diana,374,167,207,44.65
Malzahar,Yorick,189,92,97,48.68
Malzahar,Orianna,113,51,62,45.13
Malzahar,Talon,107,59,48,55.14
Malzahar,Nidalee,76,48,28,63.16
Malzahar,Samira,190,97,93,51.05
Malzahar,Jhin,433,213,220,49.19
Malzahar,Thresh,424,217,207,51.18
Malzahar,Gnar,95,57,38,60
Malzahar,Sion,243,123,120,50.62
Malzahar,Neeko,98,57,41,58.16
Malzahar,Galio,286,140,146,48.95
Malzahar,Shen,189,80,109,42.33
Malzahar,Draven,99,43,56,43.43
Malzahar,Tryndamere,80,46,34,57.5
Malzahar,Sivir,140,84,56,60
Malzahar,Janna,63,33,30,52.38
Malzahar,Varus,213,136,77,63.85
Malzahar,Brand,137,54,83,39.42
Malzahar,Camille,74,27,47,36.49
Malzahar,Rengar,62,16,46,25.81
Malzahar,TwistedFate,92,45,47,48.91
Malzahar,Qiyana,44,21,23,47.73
Malzahar,KogMaw,92,42,50,45.65
Malzahar,Rammus,82,49,33,59.76
Malzahar,Kled,47,21,26,44.68
Malzahar,Nocturne,310,129,181,41.61
Malzahar,Volibear,246,107,139,43.5
Malzahar,Viego,260,147,113,56.54
Malzahar,Irelia,187,93,94,49.73
Malzahar,Hwei,187,96,91,51.34
Malzahar,Leona,240,114,126,47.5
Malzahar,Sona,35,11,24,31.43
Malzahar,Briar,105,37,68,35.24
Malzahar,Naafiri,83,36,47,43.37
Malzahar,Warwick,318,149,169,46.86
Malzahar,Singed,54,21,33,38.89
Malzahar,Kalista,66,40,26,60.61
Malzahar,JarvanIV,187,86,101,45.99
Malzahar,Nunu,135,72,63,53.33
Malzahar,Jayce,98,56,42,57.14
Malzahar,Rumble,78,42,36,53.85
Malzahar,Ivern,62,37,25,59.68
Malzahar,Vi,234,121,113,51.71
Malzahar,Belveth,47,30,17,63.83
Malzahar,Seraphine,163,89,74,54.6
Malzahar,Urgot,129,72,57,55.81
Malzahar,Blitzcrank,172,93,79,54.07
Malzahar,Twitch,180,95,85,52.78
Malzahar,Renata,58,31,27,53.45
Malzahar,Fiora,86,40,46,46.51
Malzahar,Viktor,218,93,125,42.66
Malzahar,Pyke,186,112,74,60.22
Malzahar,Skarner,122,68,54,55.74
Malzahar,Taliyah,65,23,42,35.38
Malzahar,AurelionSol,97,43,54,44.33
Malzahar,Senna,144,94,50,65.28
Malzahar,Heimerdinger,111,59,52,53.15
Malzahar,Zilean,74,22,52,29.73
Malzahar,Bard,91,50,41,54.95
Malzahar,Graves,142,82,60,57.75
Malzahar,Kennen,57,30,27,52.63
Malzahar,Olaf,88,41,47,46.59
Malzahar,Taric,42,19,23,45.24
Malzahar,RekSai,39,13,26,33.33
Milio,Ornn,107,50,57,46.73
Milio,Lillia,81,33,48,40.74
Milio,Zed,184,106,78,57.61
Milio,Tristana,141,80,61,56.74
Milio,Nami,257,125,132,48.64
Milio,Aatrox,172,98,74,56.98
Milio,MasterYi,144,88,56,61.11
Milio,TwistedFate,46,28,18,60.87
Milio,Varus,111,60,51,54.05
Milio,Lux,303,165,138,54.46
Milio,Urgot,63,38,25,60.32
Milio,Kayn,209,124,85,59.33
Milio,Vladimir,96,62,34,64.58
Milio,Kaisa,226,126,100,55.75
Milio,Taric,35,14,21,40
Milio,Olaf,49,29,20,59.18
Milio,Viego,179,97,82,54.19
Milio,Ryze,68,41,27,60.29
Milio,Jhin,303,187,116,61.72
Milio,Soraka,68,41,27,60.29
Milio,Shen,133,68,65,51.13
Milio,Katarina,105,55,50,52.38
Milio,Karma,244,120,124,49.18
Milio,Gragas,127,65,62,51.18
Milio,Xayah,93,47,46,50.54
Milio,Lucian,138,66,72,47.83
Milio,Rell,110,63,47,57.27
Milio,Darius,252,147,105,58.33
Milio,Graves,103,55,48,53.4
Milio,Neeko,50,21,29,42
Milio,Draven,69,54,15,78.26
Milio,Alistar,66,29,37,43.94
Milio,TahmKench,138,78,60,56.52
Milio,Rengar,40,19,21,47.5
Milio,Yone,213,111,102,52.11
Milio,Chogath,170,69,101,40.59
Milio,Zyra,96,53,43,55.21
Milio,Teemo,148,69,79,46.62
Milio,Aurora,107,59,48,55.14
Milio,Sivir,79,47,32,59.49
Milio,Blitzcrank,144,50,94,34.72
Milio,Ezreal,339,163,176,48.08
Milio,Warwick,205,98,107,47.8
Milio,Xerath,135,81,54,60
Milio,Mordekaiser,173,72,101,41.62
Milio,Vi,143,74,69,51.75
Milio,Vayne,196,70,126,35.71
Milio,Yuumi,169,83,86,49.11
Milio,Malzahar,143,83,60,58.04
Milio,Ashe,336,201,135,59.82
Milio,Gwen,67,45,22,67.16
Milio,Sett,180,107,73,59.44
Milio,Jax,127,81,46,63.78
Milio,Irelia,96,42,54,43.75
Milio,Akali,145,81,64,55.86
Milio,Sion,129,64,65,49.61
Milio,Veigar,108,59,49,54.63
Milio,Samira,123,62,61,50.41
Milio,Swain,159,73,86,45.91
Milio,Amumu,179,71,108,39.66
Milio,Vex,59,30,29,50.85
Milio,Caitlyn,355,189,166,53.24
Milio,Brand,74,46,28,62.16
Milio,DrMundo,101,66,35,65.35
Milio,Yasuo,278,158,120,56.83
Milio,Garen,241,118,123,48.96
Milio,Trundle,85,46,39,54.12
Milio,Zoe,96,55,41,57.29
Milio,Maokai,56,36,20,64.29
Milio,Zeri,105,54,51,51.43
Milio,Singed,44,22,22,50
Milio,Lissandra,76,46,30,60.53
Milio,MonkeyKing,100,54,46,54
Milio,Gangplank,79,45,34,56.96
Milio,Riven,73,32,41,43.84
Milio,Seraphine,132,76,56,57.58
Milio,Hwei,103,53,50,51.46
Milio,Shaco,139,74,65,53.24
Milio,Nasus,87,47,40,54.02
Milio,Nunu,80,34,46,42.5
Milio,Jinx,371,161,210,43.4
Milio,Morgana,162,90,72,55.56
Milio,Poppy,90,49,41,54.44
Milio,Lulu,343,203,140,59.18
Milio,Diana,207,102,105,49.28
Milio,FiddleSticks,68,32,36,47.06
Milio,Smolder,96,44,52,45.83
Milio,Senna,124,66,58,53.23
Milio,Yorick,116,63,53,54.31
Milio,Briar,68,29,39,42.65
Milio,Mel,299,159,140,53.18
Milio,Nautilus,207,102,105,49.28
Milio,LeeSin,207,119,88,57.49
Milio,Quinn,71,37,34,52.11
Milio,Elise,132,74,58,56.06
Milio,AurelionSol,68,40,28,58.82
Milio,Khazix,76,35,41,46.05
Milio,Sona,35,15,20,42.86
Milio,Rakan,82,46,36,56.1
Milio,Thresh,283,161,122,56.89
Milio,MissFortune,290,161,129,55.52
Milio,Volibear,142,67,75,47.18
Milio,Ekko,134,82,52,61.19
Milio,Ahri,197,76,121,38.58
Milio,Janna,48,18,30,37.5
Milio,Renekton,76,35,41,46.05
Milio,Leona,113,70,43,61.95
Milio,Jayce,70,44,26,62.86
Milio,Sylas,174,104,70,59.77
Milio,Galio,157,95,62,60.51
Milio,Udyr,64,43,21,67.19
Milio,Pantheon,253,127,126,50.2
Milio,Naafiri,46,24,22,52.17
Milio,Gnar,81,48,33,59.26
Milio,KogMaw,54,26,28,48.15
Milio,Orianna,68,31,37,45.59
Milio,Rumble,36,14,22,38.89
Milio,Kassadin,38,20,18,52.63
Milio,Zilean,43,20,23,46.51
Milio,Fizz,69,43,26,62.32
Milio,Illaoi,64,27,37,42.19
Milio,Talon,76,42,34,55.26
Milio,Qiyana,38,22,16,57.89
Milio,Viktor,147,59,88,40.14
Milio,Camille,67,25,42,37.31
Milio,Cassiopeia,46,23,23,50
Milio,XinZhao,76,41,35,53.95
Milio,Velkoz,48,18,30,37.5
Milio,JarvanIV,156,104,52,66.67
Milio,Twitch,124,75,49,60.48
Milio,Braum,99,44,55,44.44
Milio,Corki,107,58,49,54.21
Milio,Azir,61,23,38,37.7
Milio,Evelynn,42,18,24,42.86
Milio,Malphite,145,70,75,48.28
Milio,Tryndamere,79,51,28,64.56
Milio,Syndra,144,67,77,46.53
Milio,Fiora,51,34,17,66.67
Milio,Nocturne,122,68,54,55.74
Milio,Aphelios,62,21,41,33.87
Milio,Ambessa,127,88,39,69.29
Milio,Belveth,39,22,17,56.41
Milio,Heimerdinger,38,13,25,34.21
Milio,Shyvana,29,12,17,41.38
Milio,Skarner,121,67,54,55.37
Milio,Ziggs,40,20,20,50
Milio,Sejuani,99,59,40,59.6
Milio,Renata,33,19,14,57.58
Milio,Bard,62,35,27,56.45
Milio,Leblanc,62,27,35,43.55
Milio,Kalista,55,29,26,52.73
Milio,Karthus,36,17,19,47.22
Milio,Taliyah,53,26,27,49.06
Milio,Pyke,89,56,33,62.92
Milio,Kindred,54,30,24,55.56
Milio,Kayle,89,43,46,48.31
Milio,RekSai,36,19,17,52.78
Milio,Rammus,34,15,19,44.12
Milio,Hecarim,58,26,32,44.83
Milio,KSante,86,35,51,40.7
Milio,Zac,107,50,57,46.73
Milio,Annie,33,14,19,42.42
Milio,Kled,23,6,17,26.09
Milio,Nidalee,53,28,25,52.83
Milio,Akshan,46,28,18,60.87
Milio,Kennen,50,31,19,62
Milio,Nilah,31,16,15,51.61
Milio,Ivern,33,25,8,75.76
Milio,Anivia,50,31,19,62
Ornn,Volibear,148,51,97,34.46
Ornn,Elise,103,43,60,41.75
Ornn,Malzahar,113,67,46,59.29
Ornn,Caitlyn,328,142,186,43.29
Ornn,Milio,107,57,50,53.27
Ornn,Quinn,35,11,24,31.43
Ornn,MasterYi,143,70,73,48.95
Ornn,Garen,197,113,84,57.36
Ornn,Smolder,89,50,39,56.18
Ornn,Nautilus,181,99,82,54.7
Ornn,Ambessa,121,59,62,48.76
Ornn,Gwen,111,65,46,58.56
Ornn,Vladimir,104,60,44,57.69
Ornn,Twitch,107,51,56,47.66
Ornn,Lulu,196,104,92,53.06
Ornn,DrMundo,93,50,43,53.76
Ornn,Thresh,207,128,79,61.84
Ornn,Vayne,192,99,93,51.56
Ornn,Zyra,115,51,64,44.35
Ornn,Orianna,66,45,21,68.18
Ornn,Jinx,346,161,185,46.53
Ornn,Velkoz,99,49,50,49.49
Ornn,Teemo,110,56,54,50.91
Ornn,Rumble,56,32,24,57.14
Ornn,Zoe,58,40,18,68.97
Ornn,Jhin,242,129,113,53.31
Ornn,Morgana,131,59,72,45.04
Ornn,XinZhao,118,57,61,48.31
Ornn,Hecarim,51,32,19,62.75
Ornn,Aurora,129,55,74,42.64
Ornn,Sivir,63,28,35,44.44
Ornn,Soraka,68,44,24,64.71
Ornn,Aatrox,157,82,75,52.23
Ornn,Gragas,122,61,61,50
Ornn,Yasuo,269,149,120,55.39
Ornn,Ashe,311,181,130,58.2
Ornn,Rell,116,58,58,50
Ornn,Viktor,120,56,64,46.67
Ornn,Vi,164,76,88,46.34
Ornn,Akali,149,79,70,53.02
Ornn,Kled,42,17,25,40.48
Ornn,Pyke,123,71,52,57.72
Ornn,Riven,52,19,33,36.54
Ornn,Rammus,42,14,28,33.33
Ornn,Yone,227,100,127,44.05
Ornn,Zeri,75,41,34,54.67
Ornn,Xerath,122,65,57,53.28
Ornn,Sett,173,73,100,42.2
Ornn,Skarner,79,45,34,56.96
Ornn,AurelionSol,79,37,42,46.84
Ornn,Karma,173,106,67,61.27
Ornn,Fiora,75,36,39,48
Ornn,Diana,185,93,92,50.27
Ornn,Kaisa,229,123,106,53.71
Ornn,Yuumi,126,70,56,55.56
Ornn,Tristana,131,81,50,61.83
Ornn,LeeSin,303,166,137,54.79
Ornn,Ahri,200,100,100,50
Ornn,KogMaw,49,31,18,63.27
Ornn,Swain,112,42,70,37.5
Ornn,Viego,196,120,76,61.22
Ornn,Qiyana,30,19,11,63.33
Ornn,Lux,354,187,167,52.82
Ornn,Hwei,74,40,34,54.05
Ornn,Blitzcrank,156,80,76,51.28
Ornn,Kayn,182,79,103,43.41
Ornn,Rengar,42,25,17,59.52
Ornn,Varus,166,83,83,50
Ornn,Janna,48,21,27,43.75
Ornn,Sejuani,81,37,44,45.68
Ornn,Galio,175,102,73,58.29
Ornn,Urgot,74,44,30,59.46
Ornn,Lillia,68,32,36,47.06
Ornn,Zed,148,74,74,50
Ornn,MissFortune,269,118,151,43.87
Ornn,Kayle,88,37,51,42.05
Ornn,Nocturne,167,91,76,54.49
Ornn,Mel,249,108,141,43.37
Ornn,Chogath,183,75,108,40.98
Ornn,Amumu,155,68,87,43.87
Ornn,Tryndamere,31,13,18,41.94
Ornn,Ekko,104,61,43,58.65
Ornn,KSante,97,55,42,56.7
Ornn,Graves,108,65,43,60.19
Ornn,Kassadin,35,7,28,20
Ornn,Samira,122,58,64,47.54
Ornn,Darius,230,95,135,41.3
Ornn,Sylas,239,138,101,57.74
Ornn,Camille,59,36,23,61.02
Ornn,Mordekaiser,226,128,98,56.64
Ornn,Ryze,64,33,31,51.56
Ornn,JarvanIV,111,47,64,42.34
Ornn,Jax,89,50,39,56.18
Ornn,Maokai,90,41,49,45.56
Ornn,Taric,29,19,10,65.52
Ornn,Ezreal,316,167,149,52.85
Ornn,TahmKench,123,57,66,46.34
Ornn,Malphite,184,110,74,59.78
Ornn,Katarina,120,66,54,55
Ornn,Sona,30,13,17,43.33
Ornn,Warwick,142,57,85,40.14
Ornn,Irelia,91,44,47,48.35
Ornn,Yorick,99,40,59,40.4
Ornn,Neeko,65,34,31,52.31
Ornn,MonkeyKing,121,54,67,44.63
Ornn,Lissandra,38,18,20,47.37
Ornn,Bard,57,29,28,50.88
Ornn,Brand,64,35,29,54.69
Ornn,Ziggs,52,13,39,25
Ornn,Aphelios,86,33,53,38.37
Ornn,Shyvana,31,13,18,41.94
Ornn,Briar,61,21,40,34.43
Ornn,Alistar,54,36,18,66.67
Ornn,Corki,81,37,44,45.68
Ornn,Rakan,114,49,65,42.98
Ornn,Anivia,71,27,44,38.03
Ornn,Lucian,132,75,57,56.82
Ornn,Braum,134,57,77,42.54
Ornn,Sion,98,52,46,53.06
Ornn,Leblanc,86,44,42,51.16
Ornn,Xayah,89,35,54,39.33
Ornn,Kindred,68,41,27,60.29
Ornn,Renekton,73,36,37,49.32
Ornn,Cassiopeia,43,20,23,46.51
Ornn,Leona,127,62,65,48.82
Ornn,Nunu,82,46,36,56.1
Ornn,Seraphine,90,39,51,43.33
Ornn,Illaoi,89,42,47,47.19
Ornn,Shaco,102,55,47,53.92
Ornn,Udyr,47,36,11,76.6
Ornn,Heimerdinger,48,27,21,56.25
Ornn,Pantheon,254,132,122,51.97
Ornn,Veigar,109,53,56,48.62
Ornn,Draven,59,39,20,66.1
Ornn,Trundle,65,38,27,58.46
Ornn,Fizz,55,21,34,38.18
Ornn,Belveth,34,17,17,50
Ornn,Gangplank,72,48,24,66.67
Ornn,Nami,135,40,95,29.63
Ornn,Talon,75,38,37,50.67
Ornn,Syndra,89,36,53,40.45
Ornn,Senna,95,31,64,32.63
Ornn,Ivern,20,11,9,55
Ornn,Zac,80,47,33,58.75
Ornn,FiddleSticks,70,46,24,65.71
Ornn,Azir,75,46,29,61.33
Ornn,Vex,57,24,33,42.11
Ornn,Nilah,32,17,15,53.13
Ornn,Poppy,92,43,49,46.74
Ornn,Singed,40,15,25,37.5
Ornn,Shen,118,65,53,55.08
Ornn,Renata,41,26,15,63.41
Ornn,Naafiri,20,10,10,50
Ornn,Gnar,72,39,33,54.17
Ornn,Nidalee,59,38,21,64.41
Ornn,Evelynn,45,22,23,48.89
Ornn,Nasus,81,46,35,56.79
Ornn,Jayce,68,38,30,55.88
Ornn,Akshan,45,18,27,40
Ornn,Taliyah,33,14,19,42.42
Ornn,Zilean,24,13,11,54.17
Ornn,Khazix,46,17,29,36.96
Ornn,Kalista,58,37,21,63.79
Ornn,Kennen,48,33,15,68.75
Ornn,Annie,57,30,27,52.63
Ornn,Olaf,40,5,35,12.5
Ornn,TwistedFate,47,22,25,46.81
Ornn,Karthus,24,13,11,54.17
Ornn,RekSai,32,17,15,53.13
Tristana,Volibear,240,133,107,55.42
Tristana,Elise,165,79,86,47.88
Tristana,Malzahar,248,102,146,41.13
Tristana,Caitlyn,542,272,270,50.18
Tristana,Milio,141,61,80,43.26
Tristana,Yorick,153,69,84,45.1
Tristana,Warwick,252,111,141,44.05
Tristana,Akali,175,80,95,45.71
Tristana,Jhin,415,224,191,53.98
Tristana,Braum,143,92,51,64.34
Tristana,Ashe,439,250,189,56.95
Tristana,Graves,140,62,78,44.29
Tristana,Lucian,216,118,98,54.63
Tristana,Vayne,238,117,121,49.16
Tristana,Draven,104,42,62,40.38
Tristana,Irelia,127,77,50,60.63
Tristana,LeeSin,307,168,139,54.72
Tristana,Zed,211,89,122,42.18
Tristana,Morgana,173,70,103,40.46
Tristana,Teemo,150,79,71,52.67
Tristana,MasterYi,207,110,97,53.14
Tristana,Katarina,141,59,82,41.84
Tristana,Samira,143,61,82,42.66
Tristana,Singed,68,32,36,47.06
Tristana,Garen,366,186,180,50.82
Tristana,Kayn,252,97,155,38.49
Tristana,Mel,405,234,171,57.78
Tristana,MissFortune,484,247,237,51.03
Tristana,Velkoz,132,53,79,40.15
Tristana,Malphite,216,114,102,52.78
Tristana,Vladimir,141,44,97,31.21
Tristana,Ezreal,449,202,247,44.99
Tristana,Camille,81,37,44,45.68
Tristana,KSante,127,70,57,55.12
Tristana,Shaco,152,79,73,51.97
Tristana,Yone,280,124,156,44.29
Tristana,Zilean,49,24,25,48.98
Tristana,Hwei,150,76,74,50.67
Tristana,Zyra,119,67,52,56.3
Tristana,Talon,93,52,41,55.91
Tristana,Swain,192,88,104,45.83
Tristana,Thresh,404,172,232,42.57
Tristana,Chogath,220,76,144,34.55
Tristana,Gangplank,117,61,56,52.14
Tristana,AurelionSol,75,47,28,62.67
Tristana,Leona,242,124,118,51.24
Tristana,Ambessa,111,42,69,37.84
Tristana,Gwen,77,47,30,61.04
Tristana,Twitch,165,101,64,61.21
Tristana,Lulu,287,130,157,45.3
Tristana,Mordekaiser,239,117,122,48.95
Tristana,Kayle,159,80,79,50.31
Tristana,Shen,138,68,70,49.28
Tristana,Naafiri,68,30,38,44.12
Tristana,Yasuo,389,189,200,48.59
Tristana,Rell,119,62,57,52.1
Tristana,Zac,118,61,57,51.69
Tristana,Ryze,55,20,35,36.36
Tristana,Jax,177,83,94,46.89
Tristana,Janna,70,26,44,37.14
Tristana,Renekton,102,45,57,44.12
Tristana,Leblanc,109,55,54,50.46
Tristana,Ziggs,84,50,34,59.52
Tristana,Zoe,112,68,44,60.71
Tristana,Jinx,557,248,309,44.52
Tristana,Lux,459,215,244,46.84
Tristana,Aatrox,225,119,106,52.89
Tristana,Seraphine,178,81,97,45.51
Tristana,Xerath,156,80,76,51.28
Tristana,Maokai,97,46,51,47.42
Tristana,Zeri,84,41,43,48.81
Tristana,Darius,393,200,193,50.89
Tristana,Olaf,45,28,17,62.22
Tristana,TahmKench,191,92,99,48.17
Tristana,Diana,287,141,146,49.13
Tristana,JarvanIV,197,97,100,49.24
Tristana,Taliyah,49,28,21,57.14
Tristana,Sivir,91,44,47,48.35
Tristana,Evelynn,71,34,37,47.89
Tristana,Kaisa,377,191,186,50.66
Tristana,Rumble,79,44,35,55.7
Tristana,Fizz,121,68,53,56.2
Tristana,Ornn,131,50,81,38.17
Tristana,Karma,226,87,139,38.5
Tristana,Sett,279,108,171,38.71
Tristana,Nocturne,243,114,129,46.91
Tristana,Ahri,264,138,126,52.27
Tristana,Taric,36,10,26,27.78
Tristana,Rengar,79,25,54,31.65
Tristana,Smolder,155,55,100,35.48
Tristana,Varus,186,88,98,47.31
Tristana,Tryndamere,102,47,55,46.08
Tristana,Nidalee,63,36,27,57.14
Tristana,Vex,108,64,44,59.26
Tristana,Gnar,101,33,68,32.67
Tristana,Nautilus,266,112,154,42.11
Tristana,Brand,106,54,52,50.94
Tristana,Heimerdinger,69,34,35,49.28
Tristana,Rakan,91,47,44,51.65
Tristana,Vi,262,121,141,46.18
Tristana,Nunu,144,71,73,49.31
Tristana,Alistar,121,82,39,67.77
Tristana,Soraka,96,49,47,51.04
Tristana,Jayce,87,51,36,58.62
Tristana,Gragas,146,78,68,53.42
Tristana,Ekko,130,68,62,52.31
Tristana,Lissandra,91,52,39,57.14
Tristana,Amumu,272,143,129,52.57
Tristana,Cassiopeia,97,49,48,50.52
Tristana,Poppy,147,74,73,50.34
Tristana,Quinn,77,35,42,45.45
Tristana,Nilah,63,33,30,52.38
Tristana,Viktor,201,89,112,44.28
Tristana,Pyke,161,89,72,55.28
Tristana,Blitzcrank,189,109,80,57.67
Tristana,Ivern,47,17,30,36.17
Tristana,Azir,98,59,39,60.2
Tristana,Senna,107,52,55,48.6
Tristana,Kindred,82,55,27,67.07
Tristana,Sylas,275,135,140,49.09
Tristana,RekSai,46,20,26,43.48
Tristana,Galio,233,109,124,46.78
Tristana,Syndra,121,56,65,46.28
Tristana,Yuumi,189,99,90,52.38
Tristana,Trundle,106,65,41,61.32
Tristana,Hecarim,73,39,34,53.42
Tristana,Udyr,75,29,46,38.67
Tristana,Veigar,230,110,120,47.83
Tristana,Bard,87,45,42,51.72
Tristana,MonkeyKing,129,41,88,31.78
Tristana,Akshan,63,37,26,58.73
Tristana,Nami,183,87,96,47.54
Tristana,XinZhao,139,58,81,41.73
Tristana,Nasus,129,80,49,62.02
Tristana,Aurora,178,97,81,54.49
Tristana,Aphelios,91,38,53,41.76
Tristana,Sejuani,136,57,79,41.91
Tristana,Riven,87,50,37,57.47
Tristana,Skarner,111,43,68,38.74
Tristana,TwistedFate,58,39,19,67.24
Tristana,Rammus,95,37,58,38.95
Tristana,Shyvana,35,17,18,48.57
Tristana,Anivia,87,45,42,51.72
Tristana,Urgot,104,43,61,41.35
Tristana,Briar,72,41,31,56.94
Tristana,KogMaw,46,8,38,17.39
Tristana,Pantheon,300,173,127,57.67
Tristana,Viego,255,137,118,53.73
Tristana,Xayah,99,55,44,55.56
Tristana,Sona,53,26,27,49.06
Tristana,FiddleSticks,86,39,47,45.35
Tristana,Kennen,50,21,29,42
Tristana,Sion,167,84,83,50.3
Tristana,Neeko,92,41,51,44.57
Tristana,Kled,34,11,23,32.35
Tristana,DrMundo,100,56,44,56
Tristana,Belveth,37,22,15,59.46
Tristana,Kalista,53,32,21,60.38
Tristana,Karthus,61,32,29,52.46
Tristana,Corki,131,49,82,37.4
Tristana,Qiyana,27,12,15,44.44
Tristana,Renata,70,23,47,32.86
Tristana,Kassadin,31,20,11,64.52
Tristana,Khazix,94,35,59,37.23
Tristana,Illaoi,71,26,45,36.62
Tristana,Fiora,84,38,46,45.24
Tristana,Lillia,115,58,57,50.43
Tristana,Orianna,107,54,53,50.47
Tristana,Annie,57,26,31,45.61
Poppy,Garen,222,109,113,49.1
Poppy,Warwick,164,68,96,41.46
Poppy,Yasuo,370,176,194,47.57
Poppy,MissFortune,297,132,165,44.44
Poppy,Lux,349,181,168,51.86
Poppy,Ashe,350,197,153,56.29
Poppy,Graves,119,76,43,63.87
Poppy,Lucian,153,78,75,50.98
Poppy,Vayne,292,140,152,47.95
Poppy,Draven,70,41,29,58.57
Poppy,Gragas,124,66,58,53.23
Poppy,Elise,157,74,83,47.13
Poppy,Mel,342,185,157,54.09
Poppy,Zyra,119,66,53,55.46
Poppy,Volibear,187,81,106,43.32
Poppy,Vi,210,87,123,41.43
Poppy,Caitlyn,406,197,209,48.52
Poppy,Malphite,177,92,85,51.98
Poppy,Azir,83,51,32,61.45
Poppy,Lulu,233,118,115,50.64
Poppy,Camille,88,47,41,53.41
Poppy,Hwei,137,62,75,45.26
Poppy,Nilah,68,36,32,52.94
Poppy,Nami,193,94,99,48.7
Poppy,Nasus,85,44,41,51.76
Poppy,MonkeyKing,71,30,41,42.25
Poppy,Viktor,174,92,82,52.87
Poppy,Rakan,147,79,68,53.74
Poppy,Chogath,193,83,110,43.01
Poppy,LeeSin,351,174,177,49.57
Poppy,Sivir,98,45,53,45.92
Poppy,Brand,76,39,37,51.32
Poppy,Sett,227,115,112,50.66
Poppy,Lissandra,70,30,40,42.86
Poppy,Irelia,155,91,64,58.71
Poppy,Vladimir,120,58,62,48.33
Poppy,Nautilus,312,158,154,50.64
Poppy,RekSai,23,17,6,73.91
Poppy,Akali,167,91,76,54.49
Poppy,Bard,75,27,48,36
Poppy,Pyke,159,92,67,57.86
Poppy,Darius,325,169,156,52
Poppy,Kayn,148,86,62,58.11
Poppy,Fizz,87,45,42,51.72
Poppy,Jayce,72,36,36,50
Poppy,Diana,297,155,142,52.19
Poppy,TahmKench,176,73,103,41.48
Poppy,Teemo,142,69,73,48.59
Poppy,MasterYi,197,93,104,47.21
Poppy,Malzahar,145,70,75,48.28
Poppy,Trundle,68,46,22,67.65
Poppy,Kaisa,316,168,148,53.16
Poppy,Leblanc,109,66,43,60.55
Poppy,Nidalee,77,43,34,55.84
Poppy,Blitzcrank,154,78,76,50.65
Poppy,KSante,151,92,59,60.93
Poppy,Viego,225,104,121,46.22
Poppy,Pantheon,308,171,137,55.52
Poppy,JarvanIV,194,99,95,51.03
Poppy,Yorick,102,37,65,36.27
Poppy,Ekko,172,85,87,49.42
Poppy,Urgot,74,38,36,51.35
Poppy,Ezreal,325,163,162,50.15
Poppy,Varus,186,93,93,50
Poppy,Milio,90,41,49,45.56
Poppy,Yone,309,137,172,44.34
Poppy,Amumu,194,86,108,44.33
Poppy,Galio,209,104,105,49.76
Poppy,Briar,105,54,51,51.43
Poppy,Ambessa,185,99,86,53.51
Poppy,Skarner,76,22,54,28.95
Poppy,Rammus,34,12,22,35.29
Poppy,Fiora,77,34,43,44.16
Poppy,Sion,156,79,77,50.64
Poppy,Xayah,121,57,64,47.11
Poppy,Veigar,139,62,77,44.6
Poppy,Nocturne,201,112,89,55.72
Poppy,Senna,105,53,52,50.48
Poppy,Seraphine,109,57,52,52.29
Poppy,Mordekaiser,190,96,94,50.53
Poppy,Maokai,106,31,75,29.25
Poppy,Orianna,108,47,61,43.52
Poppy,Tristana,147,73,74,49.66
Poppy,Aurora,140,68,72,48.57
Poppy,XinZhao,151,73,78,48.34
Poppy,Lillia,115,56,59,48.7
Poppy,Katarina,112,66,46,58.93
Poppy,Yuumi,156,85,71,54.49
Poppy,DrMundo,84,40,44,47.62
Poppy,Talon,77,55,22,71.43
Poppy,Morgana,150,69,81,46
Poppy,Singed,44,20,24,45.45
Poppy,Thresh,270,144,126,53.33
Poppy,Jhin,321,178,143,55.45
Poppy,Gangplank,83,50,33,60.24
Poppy,Ahri,296,167,129,56.42
Poppy,Karma,220,110,110,50
Poppy,Shen,128,64,64,50
Poppy,Sejuani,108,52,56,48.15
Poppy,Xerath,117,49,68,41.88
Poppy,Jinx,429,203,226,47.32
Poppy,Evelynn,44,19,25,43.18
Poppy,Smolder,148,63,85,42.57
Poppy,Aatrox,203,88,115,43.35
Poppy,Qiyana,30,9,21,30
Poppy,Karthus,60,28,32,46.67
Poppy,Leona,200,93,107,46.5
Poppy,Zed,130,67,63,51.54
Poppy,Jax,176,98,78,55.68
Poppy,Zeri,97,41,56,42.27
Poppy,Renekton,105,67,38,63.81
Poppy,Swain,171,74,97,43.27
Poppy,TwistedFate,56,27,29,48.21
Poppy,Corki,80,36,44,45
Poppy,Samira,82,47,35,57.32
Poppy,Sylas,251,133,118,52.99
Poppy,Riven,80,36,44,45
Poppy,Rell,146,64,82,43.84
Poppy,Ryze,77,37,40,48.05
Poppy,FiddleSticks,75,33,42,44
Poppy,Shaco,118,59,59,50
Poppy,Nunu,88,41,47,46.59
Poppy,Zilean,47,16,31,34.04
Poppy,Naafiri,42,21,21,50
Poppy,Aphelios,97,52,45,53.61
Poppy,Kindred,66,32,34,48.48
Poppy,Zac,147,81,66,55.1
Poppy,Taric,30,17,13,56.67
Poppy,Gnar,86,31,55,36.05
Poppy,Braum,148,70,78,47.3
Poppy,Belveth,39,32,7,82.05
Poppy,Olaf,64,25,39,39.06
Poppy,KogMaw,60,20,40,33.33
Poppy,Zoe,62,28,34,45.16
Poppy,Taliyah,57,23,34,40.35
Poppy,Hecarim,52,22,30,42.31
Poppy,Udyr,64,29,35,45.31
Poppy,Sona,33,23,10,69.7
Poppy,Kassadin,33,14,19,42.42
Poppy,Janna,52,9,43,17.31
Poppy,Ziggs,75,43,32,57.33
Poppy,Quinn,38,17,21,44.74
Poppy,Akshan,40,17,23,42.5
Poppy,Alistar,127,76,51,59.84
Poppy,Gwen,85,58,27,68.24
Poppy,Velkoz,83,46,37,55.42
Poppy,Soraka,63,40,23,63.49
Poppy,Rengar,45,23,22,51.11
Poppy,Vex,103,50,53,48.54
Poppy,Kled,28,12,16,42.86
Poppy,Khazix,67,39,28,58.21
Poppy,Heimerdinger,51,30,21,58.82
Poppy,Kayle,96,44,52,45.83
Poppy,Kalista,90,47,43,52.22
Poppy,Anivia,47,36,11,76.6
Poppy,Illaoi,80,34,46,42.5
Poppy,Syndra,105,45,60,42.86
Poppy,Shyvana,44,11,33,25
Poppy,Renata,50,19,31,38
Poppy,Tryndamere,41,24,17,58.54
Poppy,Twitch,101,44,57,43.56
Poppy,Annie,43,11,32,25.58
Poppy,Kennen,48,29,19,60.42
Poppy,AurelionSol,57,27,30,47.37
Poppy,Ornn,92,49,43,53.26
Poppy,Cassiopeia,40,15,25,37.5
Poppy,Ivern,40,23,17,57.5
Poppy,Neeko,79,37,42,46.84
Poppy,Rumble,51,21,30,41.18
Ziggs,Garen,126,52,74,41.27
Ziggs,Warwick,110,46,64,41.82
Ziggs,Yasuo,190,76,114,40
Ziggs,MissFortune,169,85,84,50.3
Ziggs,Lux,259,122,137,47.1
Ziggs,Kayn,107,52,55,48.6
Ziggs,Ekko,69,33,36,47.83
Ziggs,Teemo,84,46,38,54.76
Ziggs,Sivir,51,27,24,52.94
Ziggs,Velkoz,41,21,20,51.22
Ziggs,Renekton,51,32,19,62.75
Ziggs,Kassadin,21,3,18,14.29
Ziggs,Jinx,255,121,134,47.45
Ziggs,Soraka,48,28,20,58.33
Ziggs,Volibear,85,34,51,40
Ziggs,Amumu,110,25,85,22.73
Ziggs,Viktor,83,49,34,59.04
Ziggs,Zeri,28,4,24,14.29
Ziggs,Pantheon,138,74,64,53.62
Ziggs,Aatrox,88,50,38,56.82
Ziggs,Sejuani,60,24,36,40
Ziggs,Malzahar,92,50,42,54.35
Ziggs,Ashe,168,90,78,53.57
Ziggs,Blitzcrank,55,28,27,50.91
Ziggs,Mordekaiser,115,81,34,70.43
Ziggs,XinZhao,69,40,29,57.97
Ziggs,Diana,131,50,81,38.17
Ziggs,Tristana,84,34,50,40.48
Ziggs,Thresh,128,67,61,52.34
Ziggs,Elise,100,54,46,54
Ziggs,Ahri,83,31,52,37.35
Ziggs,Ezreal,224,134,90,59.82
Ziggs,Karma,128,79,49,61.72
Ziggs,Shen,80,39,41,48.75
Ziggs,Hecarim,38,26,12,68.42
Ziggs,Varus,103,63,40,61.17
Ziggs,Alistar,36,18,18,50
Ziggs,Chogath,96,42,54,43.75
Ziggs,Nilah,31,22,9,70.97
Ziggs,Zyra,71,37,34,52.11
Ziggs,Darius,112,39,73,34.82
Ziggs,Ryze,29,23,6,79.31
Ziggs,Jayce,24,9,15,37.5
Ziggs,Hwei,58,31,27,53.45
Ziggs,TahmKench,95,57,38,60
Ziggs,Sett,144,56,88,38.89
Ziggs,Irelia,53,29,24,54.72
Ziggs,Morgana,103,38,65,36.89
Ziggs,Zac,41,21,20,51.22
Ziggs,Corki,25,13,12,52
Ziggs,Nautilus,128,64,64,50
Ziggs,Orianna,45,16,29,35.56
Ziggs,Brand,40,20,20,50
Ziggs,RekSai,16,12,4,75
Ziggs,Nunu,64,36,28,56.25
Ziggs,Belveth,11,5,6,45.45
Ziggs,Malphite,84,48,36,57.14
Ziggs,Caitlyn,266,136,130,51.13
Ziggs,Akali,56,37,19,66.07
Ziggs,Briar,37,13,24,35.14
Ziggs,Naafiri,21,13,8,61.9
Ziggs,Zed,85,54,31,63.53
Ziggs,Talon,61,38,23,62.3
Ziggs,Braum,79,45,34,56.96
Ziggs,Yorick,41,18,23,43.9
Ziggs,Khazix,39,26,13,66.67
Ziggs,Vayne,112,33,79,29.46
Ziggs,Sylas,129,69,60,53.49
Ziggs,Janna,37,18,19,48.65
Ziggs,Vi,114,62,52,54.39
Ziggs,AurelionSol,35,18,17,51.43
Ziggs,Mel,192,130,62,67.71
Ziggs,Lucian,76,40,36,52.63
Ziggs,Kayle,26,14,12,53.85
Ziggs,Lissandra,40,26,14,65
Ziggs,Yuumi,47,24,23,51.06
Ziggs,Gnar,46,25,21,54.35
Ziggs,Graves,53,19,34,35.85
Ziggs,Rell,61,25,36,40.98
Ziggs,MonkeyKing,49,24,25,48.98
Ziggs,Urgot,52,34,18,65.38
Ziggs,Aurora,68,28,40,41.18
Ziggs,Sona,18,12,6,66.67
Ziggs,Pyke,73,28,45,38.36
Ziggs,Nasus,69,26,43,37.68
Ziggs,Katarina,57,31,26,54.39
Ziggs,Lulu,95,43,52,45.26
Ziggs,Ornn,52,39,13,75
Ziggs,Samira,67,33,34,49.25
Ziggs,Riven,38,12,26,31.58
Ziggs,Yone,188,112,76,59.57
Ziggs,DrMundo,63,19,44,30.16
Ziggs,Milio,40,20,20,50
Ziggs,Udyr,38,23,15,60.53
Ziggs,Vladimir,57,32,25,56.14
Ziggs,Kaisa,125,75,50,60
Ziggs,Gangplank,76,48,28,63.16
Ziggs,Nami,75,40,35,53.33
Ziggs,Seraphine,78,35,43,44.87
Ziggs,Rammus,29,12,17,41.38
Ziggs,Jhin,134,63,71,47.01
Ziggs,Olaf,22,8,14,36.36
Ziggs,Fiora,20,6,14,30
Ziggs,Shaco,54,28,26,51.85
Ziggs,Swain,70,28,42,40
Ziggs,Tryndamere,37,11,26,29.73
Ziggs,LeeSin,159,68,91,42.77
Ziggs,Nocturne,98,77,21,78.57
Ziggs,Leona,96,37,59,38.54
Ziggs,Kindred,48,25,23,52.08
Ziggs,Poppy,75,32,43,42.67
Ziggs,Galio,121,73,48,60.33
Ziggs,Azir,33,17,16,51.52
Ziggs,Xayah,41,25,16,60.98
Ziggs,Anivia,43,11,32,25.58
Ziggs,Heimerdinger,45,25,20,55.56
Ziggs,Bard,26,11,15,42.31
Ziggs,Karthus,18,3,15,16.67
Ziggs,Gragas,77,38,39,49.35
Ziggs,Smolder,28,10,18,35.71
Ziggs,KogMaw,27,10,17,37.04
Ziggs,Xerath,88,50,38,56.82
Ziggs,Jax,62,37,25,59.68
Ziggs,Rakan,39,13,26,33.33
Ziggs,Trundle,36,21,15,58.33
Ziggs,Viego,95,48,47,50.53
Ziggs,Taliyah,33,23,10,69.7
Ziggs,Zilean,25,11,14,44
Ziggs,Twitch,64,22,42,34.38
Ziggs,Sion,94,45,49,47.87
Ziggs,Zoe,30,17,13,56.67
Ziggs,MasterYi,70,31,39,44.29
Ziggs,Cassiopeia,23,12,11,52.17
Ziggs,Veigar,96,45,51,46.88
Ziggs,Quinn,37,17,20,45.95
Ziggs,TwistedFate,34,17,17,50
Ziggs,Leblanc,31,17,14,54.84
Ziggs,Singed,22,7,15,31.82
Ziggs,Aphelios,49,20,29,40.82
Ziggs,Lillia,25,11,14,44
Ziggs,Vex,48,32,16,66.67
Ziggs,Draven,44,21,23,47.73
Ziggs,Gwen,48,24,24,50
Ziggs,Skarner,42,27,15,64.29
Ziggs,Syndra,53,32,21,60.38
Ziggs,FiddleSticks,33,27,6,81.82
Ziggs,Kled,14,4,10,28.57
Ziggs,Ambessa,85,35,50,41.18
Ziggs,JarvanIV,69,48,21,69.57
Ziggs,Annie,23,15,8,65.22
Ziggs,Shyvana,17,3,14,17.65
Ziggs,Renata,12,9,3,75
Ziggs,Rengar,19,9,10,47.37
Ziggs,Evelynn,19,16,3,84.21
Ziggs,Illaoi,46,30,16,65.22
Ziggs,Senna,49,28,21,57.14
Ziggs,Rumble,20,8,12,40
Ziggs,Kennen,21,12,9,57.14
Ziggs,Taric,10,7,3,70
Ziggs,Camille,35,19,16,54.29
Ziggs,Neeko,35,18,17,51.43
Ziggs,Ivern,15,12,3,80
Ziggs,Maokai,49,16,33,32.65
Ziggs,KSante,38,22,16,57.89
Ziggs,Kalista,21,13,8,61.9
Ziggs,Akshan,15,10,5,66.67
Ziggs,Fizz,32,15,17,46.88
Ziggs,Qiyana,22,12,10,54.55
Ziggs,Nidalee,19,11,8,57.89
Ekko,Akali,175,85,90,48.57
Ekko,LeeSin,292,155,137,53.08
Ekko,Yasuo,349,194,155,55.59
Ekko,Hwei,149,72,77,48.32
Ekko,Pyke,112,57,55,50.89
Ekko,Teemo,187,88,99,47.06
Ekko,FiddleSticks,85,44,41,51.76
Ekko,Twitch,139,69,70,49.64
Ekko,Seraphine,120,62,58,51.67
Ekko,Gnar,95,66,29,69.47
Ekko,Kayn,223,130,93,58.3
Ekko,Mel,434,219,215,50.46
Ekko,Pantheon,322,172,150,53.42
Ekko,Evelynn,62,30,32,48.39
Ekko,Malphite,172,87,85,50.58
Ekko,Lucian,151,63,88,41.72
Ekko,Sion,132,58,74,43.94
Ekko,Zoe,88,41,47,46.59
Ekko,Ziggs,69,36,33,52.17
Ekko,Veigar,209,126,83,60.29
Ekko,Warwick,263,123,140,46.77
Ekko,Katarina,132,76,56,57.58
Ekko,Taric,52,27,25,51.92
Ekko,Zed,213,114,99,53.52
Ekko,Yorick,184,84,100,45.65
Ekko,Sejuani,130,58,72,44.62
Ekko,Leblanc,139,79,60,56.83
Ekko,Nilah,51,20,31,39.22
Ekko,Karma,212,89,123,41.98
Ekko,Shen,139,79,60,56.83
Ekko,Viego,264,150,114,56.82
Ekko,Diana,250,137,113,54.8
Ekko,Corki,54,33,21,61.11
Ekko,TahmKench,167,85,82,50.9
Ekko,Garen,303,121,182,39.93
Ekko,Viktor,218,98,120,44.95
Ekko,Talon,95,48,47,50.53
Ekko,Sivir,101,54,47,53.47
Ekko,Lulu,307,157,150,51.14
Ekko,Xayah,114,72,42,63.16
Ekko,Karthus,55,33,22,60
Ekko,Naafiri,77,47,30,61.04
Ekko,Vayne,254,131,123,51.57
Ekko,Lux,399,207,192,51.88
Ekko,Renekton,116,68,48,58.62
Ekko,JarvanIV,147,63,84,42.86
Ekko,Jhin,381,208,173,54.59
Ekko,Janna,63,33,30,52.38
Ekko,Briar,119,67,52,56.3
Ekko,Neeko,71,43,28,60.56
Ekko,Yone,304,168,136,55.26
Ekko,Chogath,239,120,119,50.21
Ekko,Blitzcrank,155,88,67,56.77
Ekko,Kayle,105,53,52,50.48
Ekko,Irelia,102,47,55,46.08
Ekko,MissFortune,438,224,214,51.14
Ekko,Vladimir,109,51,58,46.79
Ekko,Nautilus,210,108,102,51.43
Ekko,Sett,262,125,137,47.71
Ekko,Graves,82,38,44,46.34
Ekko,Ahri,271,129,142,47.6
Ekko,Brand,116,59,57,50.86
Ekko,Nami,193,95,98,49.22
Ekko,Riven,79,45,34,56.96
Ekko,Nocturne,225,102,123,45.33
Ekko,Galio,200,93,107,46.5
Ekko,Shaco,164,81,83,49.39
Ekko,TwistedFate,34,11,23,32.35
Ekko,Thresh,280,154,126,55
Ekko,Nunu,128,63,65,49.22
Ekko,Rengar,65,34,31,52.31
Ekko,KSante,138,76,62,55.07
Ekko,Malzahar,204,94,110,46.08
Ekko,Senna,142,87,55,61.27
Ekko,Illaoi,72,31,41,43.06
Ekko,Ashe,361,212,149,58.73
Ekko,Nidalee,70,46,24,65.71
Ekko,Volibear,239,114,125,47.7
Ekko,Darius,358,148,210,41.34
Ekko,Azir,94,46,48,48.94
Ekko,Sona,42,31,11,73.81
Ekko,Nasus,131,64,67,48.85
Ekko,Xerath,159,86,73,54.09
Ekko,Jinx,554,267,287,48.19
Ekko,Morgana,191,108,83,56.54
Ekko,Heimerdinger,75,34,41,45.33
Ekko,Poppy,172,87,85,50.58
Ekko,Caitlyn,485,238,247,49.07
Ekko,Rell,135,74,61,54.81
Ekko,Gragas,147,103,44,70.07
Ekko,Sylas,295,131,164,44.41
Ekko,Orianna,102,53,49,51.96
Ekko,MasterYi,199,90,109,45.23
Ekko,Smolder,152,83,69,54.61
Ekko,Lillia,125,54,71,43.2
Ekko,Draven,98,47,51,47.96
Ekko,Leona,242,105,137,43.39
Ekko,Taliyah,59,23,36,38.98
Ekko,Samira,128,66,62,51.56
Ekko,Belveth,21,14,7,66.67
Ekko,Kassadin,42,19,23,45.24
Ekko,AurelionSol,77,34,43,44.16
Ekko,Khazix,97,56,41,57.73
Ekko,Ambessa,154,70,84,45.45
Ekko,Aurora,160,86,74,53.75
Ekko,Syndra,162,98,64,60.49
Ekko,Milio,134,52,82,38.81
Ekko,Vi,193,98,95,50.78
Ekko,Tristana,130,62,68,47.69
Ekko,Rumble,64,44,20,68.75
Ekko,Mordekaiser,178,105,73,58.99
Ekko,Varus,165,88,77,53.33
Ekko,Zyra,136,68,68,50
Ekko,Jayce,84,56,28,66.67
Ekko,Jax,164,75,89,45.73
Ekko,Kled,39,15,24,38.46
Ekko,Ezreal,465,238,227,51.18
Ekko,Ryze,67,40,27,59.7
Ekko,Elise,153,80,73,52.29
Ekko,Alistar,93,49,44,52.69
Ekko,Amumu,219,113,106,51.6
Ekko,Gwen,75,40,35,53.33
Ekko,Qiyana,41,20,21,48.78
Ekko,Kaisa,248,122,126,49.19
Ekko,Ornn,104,43,61,41.35
Ekko,XinZhao,110,62,48,56.36
Ekko,Aatrox,205,98,107,47.8
Ekko,Udyr,39,21,18,53.85
Ekko,Aphelios,94,61,33,64.89
Ekko,Rakan,97,48,49,49.48
Ekko,DrMundo,93,47,46,50.54
Ekko,Zeri,76,39,37,51.32
Ekko,Kindred,89,34,55,38.2
Ekko,Swain,201,84,117,41.79
Ekko,Quinn,87,47,40,54.02
Ekko,Rammus,61,41,20,67.21
Ekko,Tryndamere,80,55,25,68.75
Ekko,RekSai,34,22,12,64.71
Ekko,MonkeyKing,122,46,76,37.7
Ekko,KogMaw,60,23,37,38.33
Ekko,Gangplank,68,33,35,48.53
Ekko,Yuumi,160,77,83,48.13
Ekko,Fiora,92,33,59,35.87
Ekko,Trundle,90,45,45,50
Ekko,Vex,110,49,61,44.55
Ekko,Braum,134,62,72,46.27
Ekko,Akshan,50,24,26,48
Ekko,Zilean,56,35,21,62.5
Ekko,Renata,24,9,15,37.5
Ekko,Anivia,69,30,39,43.48
Ekko,Singed,60,31,29,51.67
Ekko,Skarner,96,66,30,68.75
Ekko,Annie,64,23,41,35.94
Ekko,Ivern,44,19,25,43.18
Ekko,Fizz,97,58,39,59.79
Ekko,Urgot,71,32,39,45.07
Ekko,Olaf,57,22,35,38.6
Ekko,Camille,68,48,20,70.59
Ekko,Soraka,100,44,56,44
Ekko,Velkoz,84,45,39,53.57
Ekko,Maokai,62,37,25,59.68
Ekko,Kalista,39,26,13,66.67
Ekko,Shyvana,44,25,19,56.82
Ekko,Zac,103,67,36,65.05
Ekko,Hecarim,92,50,42,54.35
Ekko,Bard,55,33,22,60
Ekko,Kennen,56,41,15,73.21
Ekko,Cassiopeia,37,15,22,40.54
Ekko,Lissandra,65,34,31,52.31
Ivern,Yone,74,45,29,60.81
Ivern,FiddleSticks,13,5,8,38.46
Ivern,Aurora,35,12,23,34.29
Ivern,Vayne,48,27,21,56.25
Ivern,Senna,37,24,13,64.86
Ivern,Darius,73,33,40,45.21
Ivern,XinZhao,41,30,11,73.17
Ivern,Orianna,55,27,28,49.09
Ivern,Ezreal,116,58,58,50
Ivern,Thresh,74,33,41,44.59
Ivern,Kled,13,2,11,15.38
Ivern,Gragas,25,9,16,36
Ivern,Anivia,20,8,12,40
Ivern,Jinx,169,69,100,40.83
Ivern,Rell,28,13,15,46.43
Ivern,Warwick,68,22,46,32.35
Ivern,Gnar,29,14,15,48.28
Ivern,Kalista,14,6,8,42.86
Ivern,Nautilus,75,34,41,45.33
Ivern,MonkeyKing,37,12,25,32.43
Ivern,Kayn,69,40,29,57.97
Ivern,Kassadin,6,3,3,50
Ivern,Chogath,94,41,53,43.62
Ivern,Karma,91,36,55,39.56
Ivern,LeeSin,83,27,56,32.53
Ivern,Syndra,54,24,30,44.44
Ivern,Caitlyn,109,45,64,41.28
Ivern,Blitzcrank,63,37,26,58.73
Ivern,Rengar,20,12,8,60
Ivern,Mel,90,46,44,51.11
Ivern,Ashe,95,45,50,47.37
Ivern,Brand,29,19,10,65.52
Ivern,Jax,38,27,11,71.05
Ivern,Diana,96,38,58,39.58
Ivern,Vladimir,23,15,8,65.22
Ivern,Lucian,37,18,19,48.65
Ivern,Nami,57,27,30,47.37
Ivern,Jayce,24,10,14,41.67
Ivern,Azir,20,12,8,60
Ivern,Jhin,113,56,57,49.56
Ivern,Malphite,31,9,22,29.03
Ivern,Yasuo,101,40,61,39.6
Ivern,Kaisa,85,34,51,40
Ivern,Seraphine,16,8,8,50
Ivern,Gwen,24,3,21,12.5
Ivern,Vi,52,20,32,38.46
Ivern,Qiyana,17,2,15,11.76
Ivern,Sivir,39,19,20,48.72
Ivern,Briar,26,14,12,53.85
Ivern,Tristana,47,30,17,63.83
Ivern,Rakan,18,11,7,61.11
Ivern,Volibear,52,20,32,38.46
Ivern,Zac,20,17,3,85
Ivern,Corki,24,11,13,45.83
Ivern,Kennen,11,8,3,72.73
Ivern,Sylas,63,26,37,41.27
Ivern,Hwei,34,17,17,50
Ivern,Smolder,30,17,13,56.67
Ivern,Renata,18,9,9,50
Ivern,Nasus,34,9,25,26.47
Ivern,Lulu,111,63,48,56.76
Ivern,Sion,47,27,20,57.45
Ivern,Zeri,28,20,8,71.43
Ivern,Morgana,44,15,29,34.09
Ivern,Skarner,25,10,15,40
Ivern,Garen,88,41,47,46.59
Ivern,MasterYi,49,24,25,48.98
Ivern,Malzahar,62,25,37,40.32
Ivern,Shaco,26,6,20,23.08
Ivern,Yorick,52,30,22,57.69
Ivern,Evelynn,18,9,9,50
Ivern,Viktor,50,28,22,56
Ivern,Zed,49,20,29,40.82
Ivern,Neeko,34,17,17,50
Ivern,Vex,26,14,12,53.85
Ivern,Hecarim,19,9,10,47.37
Ivern,Katarina,38,11,27,28.95
Ivern,Zilean,29,12,17,41.38
Ivern,DrMundo,22,9,13,40.91
Ivern,Ahri,75,48,27,64
Ivern,Tryndamere,30,8,22,26.67
Ivern,Nocturne,45,25,20,55.56
Ivern,Xerath,27,11,16,40.74
Ivern,MissFortune,87,29,58,33.33
Ivern,Graves,31,14,17,45.16
Ivern,Varus,43,15,28,34.88
Ivern,Shen,31,14,17,45.16
Ivern,Amumu,43,15,28,34.88
Ivern,Fizz,24,12,12,50
Ivern,Olaf,18,11,7,61.11
Ivern,Khazix,20,9,11,45
Ivern,Leblanc,45,30,15,66.67
Ivern,Trundle,36,13,23,36.11
Ivern,Elise,38,20,18,52.63
Ivern,Teemo,45,26,19,57.78
Ivern,Janna,12,6,6,50
Ivern,Mordekaiser,65,26,39,40
Ivern,Rammus,16,5,11,31.25
Ivern,Lux,73,34,39,46.58
Ivern,Kindred,20,14,6,70
Ivern,Yuumi,46,15,31,32.61
Ivern,Ekko,44,25,19,56.82
Ivern,Zyra,16,7,9,43.75
Ivern,Lillia,22,10,12,45.45
Ivern,TahmKench,42,28,14,66.67
Ivern,Swain,54,23,31,42.59
Ivern,Sejuani,41,17,24,41.46
Ivern,Draven,24,9,15,37.5
Ivern,Camille,24,11,13,45.83
Ivern,Akali,57,23,34,40.35
Ivern,Fiora,15,10,5,66.67
Ivern,Viego,73,29,44,39.73
Ivern,Ornn,20,9,11,45
Ivern,Leona,56,25,31,44.64
Ivern,Kayle,19,9,10,47.37
Ivern,Alistar,19,0,19,0
Ivern,Akshan,24,9,15,37.5
Ivern,Twitch,37,27,10,72.97
Ivern,Samira,29,8,21,27.59
Ivern,Maokai,17,9,8,52.94
Ivern,Veigar,43,23,20,53.49
Ivern,Heimerdinger,26,6,20,23.08
Ivern,Talon,22,14,8,63.64
Ivern,Milio,33,8,25,24.24
Ivern,Renekton,33,19,14,57.58
Ivern,Pantheon,72,46,26,63.89
Ivern,Poppy,40,17,23,42.5
Ivern,Ambessa,41,20,21,48.78
Ivern,Aphelios,24,13,11,54.17
Ivern,Pyke,32,7,25,21.88
Ivern,Sona,2,2,0,100
Ivern,RekSai,4,4,0,100
Ivern,Irelia,22,9,13,40.91
Ivern,Velkoz,24,17,7,70.83
Ivern,Bard,16,11,5,68.75
Ivern,Rumble,15,4,11,26.67
Ivern,Taric,13,2,11,15.38
Ivern,Nunu,38,23,15,60.53
Ivern,Quinn,22,3,19,13.64
Ivern,Naafiri,13,13,0,100
Ivern,Riven,25,13,12,52
Ivern,Sett,48,16,32,33.33
Ivern,Ziggs,15,3,12,20
Ivern,Aatrox,33,11,22,33.33
Ivern,Shyvana,6,4,2,66.67
Ivern,Braum,36,14,22,38.89
Ivern,KSante,32,16,16,50
Ivern,Annie,8,8,0,100
Ivern,Zoe,22,8,14,36.36
Ivern,Taliyah,8,6,2,75
Ivern,AurelionSol,21,11,10,52.38
Ivern,JarvanIV,30,9,21,30
Ivern,Ryze,19,11,8,57.89
Ivern,KogMaw,14,5,9,35.71
Ivern,Illaoi,11,6,5,54.55
Ivern,Belveth,5,3,2,60
Ivern,Lissandra,5,0,5,0
Ivern,Urgot,14,3,11,21.43
Ivern,Xayah,23,6,17,26.09
Ivern,Nidalee,12,12,0,100
Ivern,Karthus,10,2,8,20
Ivern,Galio,46,15,31,32.61
Ivern,Cassiopeia,14,2,12,14.29
Ivern,Gangplank,25,17,8,68
Ivern,Soraka,23,14,9,60.87
Ivern,Udyr,20,3,17,15
Ivern,TwistedFate,9,3,6,33.33
Ivern,Nilah,8,2,6,25
Ivern,Singed,6,3,3,50
Lucian,Yone,317,174,143,54.89
Lucian,FiddleSticks,115,54,61,46.96
Lucian,Aurora,164,66,98,40.24
Lucian,Vayne,222,108,114,48.65
Lucian,Senna,103,48,55,46.6
Lucian,Nasus,118,47,71,39.83
Lucian,Syndra,158,73,85,46.2
Lucian,Mel,382,197,185,51.57
Lucian,Seraphine,136,49,87,36.03
Lucian,Kled,31,11,20,35.48
Lucian,Kayn,176,78,98,44.32
Lucian,Katarina,114,42,72,36.84
Lucian,Twitch,132,70,62,53.03
Lucian,Thresh,389,181,208,46.53
Lucian,Annie,73,30,43,41.1
Lucian,Tristana,216,98,118,45.37
Lucian,Poppy,153,75,78,49.02
Lucian,Pantheon,381,199,182,52.23
Lucian,Ekko,151,88,63,58.28
Lucian,Talon,110,52,58,47.27
Lucian,Kaisa,361,173,188,47.92
Lucian,Soraka,76,33,43,43.42
Lucian,Darius,373,182,191,48.79
Lucian,Vi,224,102,122,45.54
Lucian,Malzahar,173,94,79,54.34
Lucian,Aphelios,96,41,55,42.71
Lucian,Jax,168,87,81,51.79
Lucian,Diana,287,147,140,51.22
Lucian,Akshan,62,31,31,50
Lucian,Ashe,440,211,229,47.95
Lucian,Milio,138,72,66,52.17
Lucian,Irelia,149,64,85,42.95
Lucian,Sejuani,151,46,105,30.46
Lucian,Malphite,230,114,116,49.57
Lucian,Jhin,434,202,232,46.54
Lucian,Karma,249,120,129,48.19
Lucian,Camille,78,34,44,43.59
Lucian,Sivir,135,79,56,58.52
Lucian,Zyra,184,84,100,45.65
Lucian,Teemo,189,99,90,52.38
Lucian,Amumu,232,104,128,44.83
Lucian,MissFortune,390,189,201,48.46
Lucian,Rakan,102,47,55,46.08
Lucian,Hwei,115,48,67,41.74
Lucian,Janna,69,35,34,50.72
Lucian,Briar,79,28,51,35.44
Lucian,Zed,215,90,125,41.86
Lucian,Ezreal,566,272,294,48.06
Lucian,Gragas,207,105,102,50.72
Lucian,MasterYi,164,73,91,44.51
Lucian,TwistedFate,107,48,59,44.86
Lucian,Xayah,109,33,76,30.28
Lucian,Gwen,83,36,47,43.37
Lucian,Jinx,497,232,265,46.68
Lucian,Akali,178,66,112,37.08
Lucian,Nautilus,239,120,119,50.21
Lucian,Heimerdinger,81,45,36,55.56
Lucian,Samira,125,45,80,36
Lucian,Sett,281,123,158,43.77
Lucian,Lillia,113,47,66,41.59
Lucian,Yuumi,176,82,94,46.59
Lucian,Sylas,296,147,149,49.66
Lucian,Xerath,231,88,143,38.1
Lucian,Caitlyn,607,287,320,47.28
Lucian,Lulu,351,202,149,57.55
Lucian,Veigar,211,103,108,48.82
Lucian,Jayce,138,57,81,41.3
Lucian,Smolder,147,58,89,39.46
Lucian,Chogath,226,117,109,51.77
Lucian,Olaf,49,22,27,44.9
Lucian,Yasuo,409,203,206,49.63
Lucian,Draven,127,54,73,42.52
Lucian,Morgana,194,83,111,42.78
Lucian,Mordekaiser,271,126,145,46.49
Lucian,Volibear,191,80,111,41.88
Lucian,Azir,99,36,63,36.36
Lucian,Garen,297,143,154,48.15
Lucian,Kayle,109,57,52,52.29
Lucian,Trundle,102,51,51,50
Lucian,Illaoi,101,51,50,50.5
Lucian,Brand,103,57,46,55.34
Lucian,Nidalee,93,47,46,50.54
Lucian,Zoe,94,62,32,65.96
Lucian,Gangplank,140,57,83,40.71
Lucian,Warwick,234,94,140,40.17
Lucian,Zeri,112,51,61,45.54
Lucian,Ambessa,149,65,84,43.62
Lucian,TahmKench,182,68,114,37.36
Lucian,Vladimir,108,64,44,59.26
Lucian,Rell,124,61,63,49.19
Lucian,Corki,111,55,56,49.55
Lucian,Lux,433,195,238,45.03
Lucian,LeeSin,417,216,201,51.8
Lucian,Varus,203,115,88,56.65
Lucian,Vex,129,52,77,40.31
Lucian,Blitzcrank,198,100,98,50.51
Lucian,Hecarim,58,14,44,24.14
Lucian,Leona,166,68,98,40.96
Lucian,Singed,54,28,26,51.85
Lucian,Leblanc,109,51,58,46.79
Lucian,Viktor,216,91,125,42.13
Lucian,Alistar,119,44,75,36.97
Lucian,Braum,166,78,88,46.99
Lucian,Ivern,37,19,18,51.35
Lucian,MonkeyKing,131,61,70,46.56
Lucian,Fizz,101,53,48,52.48
Lucian,Renekton,103,45,58,43.69
Lucian,Shaco,135,53,82,39.26
Lucian,KogMaw,55,23,32,41.82
Lucian,Riven,108,52,56,48.15
Lucian,DrMundo,127,51,76,40.16
Lucian,Urgot,80,44,36,55
Lucian,Rammus,57,32,25,56.14
Lucian,Quinn,69,48,21,69.57
Lucian,Kindred,79,51,28,64.56
Lucian,Ahri,314,163,151,51.91
Lucian,Kassadin,39,18,21,46.15
Lucian,Swain,222,117,105,52.7
Lucian,Yorick,146,70,76,47.95
Lucian,Rumble,81,44,37,54.32
Lucian,Aatrox,270,131,139,48.52
Lucian,Sion,157,84,73,53.5
Lucian,Zac,135,80,55,59.26
Lucian,Ziggs,76,36,40,47.37
Lucian,Udyr,51,21,30,41.18
Lucian,Kalista,83,51,32,61.45
Lucian,JarvanIV,197,79,118,40.1
Lucian,Nocturne,290,137,153,47.24
Lucian,Rengar,44,22,22,50
Lucian,Galio,268,143,125,53.36
Lucian,Cassiopeia,60,34,26,56.67
Lucian,Khazix,129,68,61,52.71
Lucian,Sona,44,25,19,56.82
Lucian,XinZhao,172,68,104,39.53
Lucian,Skarner,106,32,74,30.19
Lucian,Elise,172,73,99,42.44
Lucian,Shen,147,56,91,38.1
Lucian,Pyke,163,70,93,42.94
Lucian,Taliyah,66,38,28,57.58
Lucian,Gnar,97,61,36,62.89
Lucian,Evelynn,47,31,16,65.96
Lucian,Shyvana,44,31,13,70.45
Lucian,Nami,234,99,135,42.31
Lucian,Ornn,132,57,75,43.18
Lucian,Naafiri,43,28,15,65.12
Lucian,Karthus,55,21,34,38.18
Lucian,Fiora,61,32,29,52.46
Lucian,Orianna,114,54,60,47.37
Lucian,Viego,253,120,133,47.43
Lucian,Nilah,57,22,35,38.6
Lucian,Taric,42,17,25,40.48
Lucian,Maokai,82,37,45,45.12
Lucian,AurelionSol,66,24,42,36.36
Lucian,Nunu,104,47,57,45.19
Lucian,Qiyana,40,18,22,45
Lucian,Neeko,110,50,60,45.45
Lucian,Anivia,81,36,45,44.44
Lucian,Belveth,46,23,23,50
Lucian,Bard,51,35,16,68.63
Lucian,RekSai,31,18,13,58.06
Lucian,Velkoz,79,45,34,56.96
Lucian,Lissandra,62,25,37,40.32
Lucian,Graves,121,52,69,42.98
Lucian,Tryndamere,45,19,26,42.22
Lucian,Ryze,77,50,27,64.94
Lucian,KSante,130,69,61,53.08
Lucian,Zilean,36,15,21,41.67
Lucian,Renata,60,35,25,58.33
Lucian,Kennen,41,16,25,39.02
Blitzcrank,Yone,415,229,186,55.18
Blitzcrank,FiddleSticks,116,58,58,50
Blitzcrank,Aurora,155,63,92,40.65
Blitzcrank,Vayne,223,86,137,38.57
Blitzcrank,Senna,109,54,55,49.54
Blitzcrank,Heimerdinger,73,44,29,60.27
Blitzcrank,Gragas,185,115,70,62.16
Blitzcrank,Viktor,160,75,85,46.88
Blitzcrank,Jinx,487,224,263,46
Blitzcrank,Pyke,225,118,107,52.44
Blitzcrank,Nasus,122,47,75,38.52
Blitzcrank,Shaco,143,73,70,51.05
Blitzcrank,Xerath,183,83,100,45.36
Blitzcrank,Caitlyn,602,324,278,53.82
Blitzcrank,Lulu,354,165,189,46.61
Blitzcrank,Jayce,138,76,62,55.07
Blitzcrank,Elise,216,112,104,51.85
Blitzcrank,Lux,517,277,240,53.58
Blitzcrank,Yorick,178,78,100,43.82
Blitzcrank,Zilean,73,39,34,53.42
Blitzcrank,Darius,400,187,213,46.75
Blitzcrank,Kayn,276,123,153,44.57
Blitzcrank,Veigar,224,94,130,41.96
Blitzcrank,Varus,198,100,98,50.51
Blitzcrank,Kalista,85,40,45,47.06
Blitzcrank,Amumu,254,104,150,40.94
Blitzcrank,Ashe,440,249,191,56.59
Blitzcrank,Irelia,154,69,85,44.81
Blitzcrank,Milio,144,94,50,65.28
Blitzcrank,Hwei,148,69,79,46.62
Blitzcrank,Samira,181,79,102,43.65
Blitzcrank,Zyra,191,85,106,44.5
Blitzcrank,Yasuo,446,235,211,52.69
Blitzcrank,Sett,373,200,173,53.62
Blitzcrank,Warwick,311,146,165,46.95
Blitzcrank,Karma,265,125,140,47.17
Blitzcrank,Ekko,155,67,88,43.23
Blitzcrank,Katarina,141,86,55,60.99
Blitzcrank,Mordekaiser,263,129,134,49.05
Blitzcrank,Ziggs,55,27,28,49.09
Blitzcrank,Nautilus,361,177,184,49.03
Blitzcrank,Jax,180,70,110,38.89
Blitzcrank,Akali,214,103,111,48.13
Blitzcrank,Taliyah,58,27,31,46.55
Blitzcrank,Xayah,142,80,62,56.34
Blitzcrank,Aatrox,210,129,81,61.43
Blitzcrank,Pantheon,296,150,146,50.68
Blitzcrank,Annie,73,27,46,36.99
Blitzcrank,Chogath,260,92,168,35.38
Blitzcrank,Evelynn,75,24,51,32
Blitzcrank,KogMaw,85,35,50,41.18
Blitzcrank,Riven,95,42,53,44.21
Blitzcrank,MonkeyKing,119,61,58,51.26
Blitzcrank,AurelionSol,68,26,42,38.24
Blitzcrank,Poppy,154,76,78,49.35
Blitzcrank,TahmKench,171,82,89,47.95
Blitzcrank,Diana,360,169,191,46.94
Blitzcrank,Leona,290,154,136,53.1
Blitzcrank,MissFortune,432,200,232,46.3
Blitzcrank,Ivern,63,26,37,41.27
Blitzcrank,Anivia,78,33,45,42.31
Blitzcrank,Thresh,383,166,217,43.34
Blitzcrank,Teemo,189,88,101,46.56
Blitzcrank,Ezreal,668,325,343,48.65
Blitzcrank,Rumble,50,27,23,54
Blitzcrank,Maokai,86,41,45,47.67
Blitzcrank,Zed,257,104,153,40.47
Blitzcrank,Malphite,226,106,120,46.9
Blitzcrank,Viego,302,149,153,49.34
Blitzcrank,Kayle,109,42,67,38.53
Blitzcrank,Jhin,373,201,172,53.89
Blitzcrank,Yuumi,180,79,101,43.89
Blitzcrank,Urgot,99,48,51,48.48
Blitzcrank,Karthus,46,24,22,52.17
Blitzcrank,JarvanIV,141,67,74,47.52
Blitzcrank,Leblanc,168,90,78,53.57
Blitzcrank,Lucian,198,98,100,49.49
Blitzcrank,Nami,196,89,107,45.41
Blitzcrank,Mel,375,168,207,44.8
Blitzcrank,Draven,115,50,65,43.48
Blitzcrank,Renekton,141,72,69,51.06
Blitzcrank,Nidalee,91,61,30,67.03
Blitzcrank,Hecarim,72,28,44,38.89
Blitzcrank,Azir,105,45,60,42.86
Blitzcrank,Ahri,360,183,177,50.83
Blitzcrank,Taric,48,25,23,52.08
Blitzcrank,Ornn,156,76,80,48.72
Blitzcrank,Rengar,55,33,22,60
Blitzcrank,Morgana,275,112,163,40.73
Blitzcrank,Kindred,74,54,20,72.97
Blitzcrank,Gangplank,109,60,49,55.05
Blitzcrank,Zeri,99,50,49,50.51
Blitzcrank,Alistar,174,71,103,40.8
Blitzcrank,Garen,331,158,173,47.73
Blitzcrank,Khazix,79,38,41,48.1
Blitzcrank,Illaoi,96,40,56,41.67
Blitzcrank,Zac,133,68,65,51.13
Blitzcrank,Nocturne,250,121,129,48.4
Blitzcrank,Kaisa,333,164,169,49.25
Blitzcrank,Kled,33,11,22,33.33
Blitzcrank,Gnar,121,61,60,50.41
Blitzcrank,Lillia,115,46,69,40
Blitzcrank,XinZhao,163,96,67,58.9
Blitzcrank,Shen,159,98,61,61.64
Blitzcrank,Rakan,123,51,72,41.46
Blitzcrank,Volibear,232,121,111,52.16
Blitzcrank,Tristana,189,80,109,42.33
Blitzcrank,Briar,107,50,57,46.73
Blitzcrank,Gwen,91,37,54,40.66
Blitzcrank,Neeko,113,67,46,59.29
Blitzcrank,Bard,54,22,32,40.74
Blitzcrank,TwistedFate,80,39,41,48.75
Blitzcrank,Sylas,436,185,251,42.43
Blitzcrank,Braum,160,83,77,51.88
Blitzcrank,MasterYi,167,87,80,52.1
Blitzcrank,Ambessa,176,109,67,61.93
Blitzcrank,LeeSin,424,207,217,48.82
Blitzcrank,Sivir,163,76,87,46.63
Blitzcrank,Seraphine,121,63,58,52.07
Blitzcrank,Smolder,95,50,45,52.63
Blitzcrank,Lissandra,70,27,43,38.57
Blitzcrank,Sion,159,69,90,43.4
Blitzcrank,Galio,203,101,102,49.75
Blitzcrank,Sejuani,139,62,77,44.6
Blitzcrank,Zoe,97,58,39,59.79
Blitzcrank,Orianna,106,46,60,43.4
Blitzcrank,Olaf,58,34,24,58.62
Blitzcrank,Syndra,145,91,54,62.76
Blitzcrank,Sona,33,11,22,33.33
Blitzcrank,Skarner,93,38,55,40.86
Blitzcrank,Talon,140,79,61,56.43
Blitzcrank,Rammus,105,43,62,40.95
Blitzcrank,Fiora,76,36,40,47.37
Blitzcrank,Camille,65,28,37,43.08
Blitzcrank,Aphelios,138,66,72,47.83
Blitzcrank,Swain,171,85,86,49.71
Blitzcrank,Rell,160,70,90,43.75
Blitzcrank,DrMundo,101,38,63,37.62
Blitzcrank,Udyr,66,37,29,56.06
Blitzcrank,Vladimir,114,48,66,42.11
Blitzcrank,Malzahar,172,79,93,45.93
Blitzcrank,Velkoz,100,47,53,47
Blitzcrank,Trundle,101,46,55,45.54
Blitzcrank,Twitch,134,70,64,52.24
Blitzcrank,Graves,142,68,74,47.89
Blitzcrank,Vex,137,68,69,49.64
Blitzcrank,Brand,89,47,42,52.81
Blitzcrank,Naafiri,60,43,17,71.67
Blitzcrank,KSante,146,74,72,50.68
Blitzcrank,Vi,265,140,125,52.83
Blitzcrank,Shyvana,46,19,27,41.3
Blitzcrank,Belveth,47,19,28,40.43
Blitzcrank,Qiyana,46,23,23,50
Blitzcrank,Janna,47,21,26,44.68
Blitzcrank,Corki,74,36,38,48.65
Blitzcrank,Quinn,84,34,50,40.48
Blitzcrank,Fizz,79,43,36,54.43
Blitzcrank,Cassiopeia,36,23,13,63.89
Blitzcrank,Ryze,68,27,41,39.71
Blitzcrank,Tryndamere,74,41,33,55.41
Blitzcrank,Singed,41,8,33,19.51
Blitzcrank,Nilah,51,19,32,37.25
Blitzcrank,Soraka,69,27,42,39.13
Blitzcrank,Nunu,109,54,55,49.54
Blitzcrank,Kassadin,38,20,18,52.63
Blitzcrank,Renata,49,20,29,40.82
Blitzcrank,Kennen,39,14,25,35.9
Blitzcrank,Akshan,47,21,26,44.68
Blitzcrank,RekSai,45,26,19,57.78
FiddleSticks,Ivern,13,8,5,61.54
FiddleSticks,Renekton,38,23,15,60.53
FiddleSticks,Vladimir,83,44,39,53.01
FiddleSticks,Lucian,115,61,54,53.04
FiddleSticks,Blitzcrank,116,58,58,50
FiddleSticks,Corki,40,12,28,30
FiddleSticks,Ekko,85,41,44,48.24
FiddleSticks,Leblanc,56,28,28,50
FiddleSticks,Caitlyn,285,127,158,44.56
FiddleSticks,Mel,234,134,100,57.26
FiddleSticks,Mordekaiser,148,54,94,36.49
FiddleSticks,Viego,141,67,74,47.52
FiddleSticks,Yone,178,106,72,59.55
FiddleSticks,Rakan,72,44,28,61.11
FiddleSticks,Jax,86,43,43,50
FiddleSticks,MasterYi,146,90,56,61.64
FiddleSticks,Malzahar,116,58,58,50
FiddleSticks,Morgana,131,56,75,42.75
FiddleSticks,Camille,70,39,31,55.71
FiddleSticks,Graves,73,42,31,57.53
FiddleSticks,Hwei,50,25,25,50
FiddleSticks,Nilah,12,9,3,75
FiddleSticks,Nami,111,46,65,41.44
FiddleSticks,Shen,93,45,48,48.39
FiddleSticks,Karthus,42,18,24,42.86
FiddleSticks,Ezreal,260,153,107,58.85
FiddleSticks,Soraka,55,34,21,61.82
FiddleSticks,Aphelios,70,45,25,64.29
FiddleSticks,Udyr,48,25,23,52.08
FiddleSticks,Yasuo,186,100,86,53.76
FiddleSticks,Heimerdinger,43,19,24,44.19
FiddleSticks,Kindred,56,27,29,48.21
FiddleSticks,MissFortune,220,126,94,57.27
FiddleSticks,Sona,33,15,18,45.45
FiddleSticks,Darius,216,117,99,54.17
FiddleSticks,Vi,92,55,37,59.78
FiddleSticks,Sylas,183,113,70,61.75
FiddleSticks,Jinx,260,119,141,45.77
FiddleSticks,Diana,180,104,76,57.78
FiddleSticks,Yorick,59,21,38,35.59
FiddleSticks,Veigar,112,58,54,51.79
FiddleSticks,Nasus,65,38,27,58.46
FiddleSticks,Tryndamere,51,30,21,58.82
FiddleSticks,MonkeyKing,73,31,42,42.47
FiddleSticks,Ashe,267,139,128,52.06
FiddleSticks,Milio,68,36,32,52.94
FiddleSticks,DrMundo,80,33,47,41.25
FiddleSticks,Briar,53,20,33,37.74
FiddleSticks,Galio,146,78,68,53.42
FiddleSticks,Nunu,85,61,24,71.76
FiddleSticks,Gwen,73,37,36,50.68
FiddleSticks,Khazix,80,35,45,43.75
FiddleSticks,Seraphine,76,35,41,46.05
FiddleSticks,Nidalee,42,32,10,76.19
FiddleSticks,Vex,88,57,31,64.77
FiddleSticks,Sivir,74,39,35,52.7
FiddleSticks,Rell,78,40,38,51.28
FiddleSticks,Shaco,78,46,32,58.97
FiddleSticks,Irelia,67,44,23,65.67
FiddleSticks,Teemo,83,52,31,62.65
FiddleSticks,AurelionSol,20,5,15,25
FiddleSticks,Kaisa,158,84,74,53.16
FiddleSticks,Sion,72,45,27,62.5
FiddleSticks,Lux,207,117,90,56.52
FiddleSticks,Xayah,79,50,29,63.29
FiddleSticks,Nautilus,117,68,49,58.12
FiddleSticks,Malphite,91,44,47,48.35
FiddleSticks,Warwick,101,48,53,47.52
FiddleSticks,Vayne,120,55,65,45.83
FiddleSticks,Yuumi,117,64,53,54.7
FiddleSticks,Rumble,56,43,13,76.79
FiddleSticks,Ambessa,55,43,12,78.18
FiddleSticks,Lulu,157,91,66,57.96
FiddleSticks,Zac,68,33,35,48.53
FiddleSticks,Zed,94,58,36,61.7
FiddleSticks,Jhin,195,107,88,54.87
FiddleSticks,Hecarim,36,25,11,69.44
FiddleSticks,Katarina,46,27,19,58.7
FiddleSticks,Karma,123,64,59,52.03
FiddleSticks,Gangplank,52,31,21,59.62
FiddleSticks,Senna,60,33,27,55
FiddleSticks,Lillia,54,23,31,42.59
FiddleSticks,Singed,31,7,24,22.58
FiddleSticks,Kayn,119,75,44,63.03
FiddleSticks,Pyke,94,47,47,50
FiddleSticks,Samira,56,36,20,64.29
FiddleSticks,Sett,121,65,56,53.72
FiddleSticks,Swain,105,46,59,43.81
FiddleSticks,Zyra,97,32,65,32.99
FiddleSticks,Akali,90,50,40,55.56
FiddleSticks,Rammus,36,22,14,61.11
FiddleSticks,Cassiopeia,38,23,15,60.53
FiddleSticks,Ahri,177,82,95,46.33
FiddleSticks,XinZhao,120,60,60,50
FiddleSticks,Varus,110,57,53,51.82
FiddleSticks,Maokai,70,32,38,45.71
FiddleSticks,Amumu,111,56,55,50.45
FiddleSticks,Zoe,43,22,21,51.16
FiddleSticks,Kled,21,14,7,66.67
FiddleSticks,Viktor,115,68,47,59.13
FiddleSticks,Akshan,31,8,23,25.81
FiddleSticks,Braum,70,48,22,68.57
FiddleSticks,Taric,18,11,7,61.11
FiddleSticks,TahmKench,97,63,34,64.95
FiddleSticks,Poppy,75,42,33,56
FiddleSticks,Garen,170,67,103,39.41
FiddleSticks,Lissandra,36,18,18,50
FiddleSticks,Skarner,39,11,28,28.21
FiddleSticks,Thresh,229,112,117,48.91
FiddleSticks,Volibear,113,47,66,41.59
FiddleSticks,Xerath,79,30,49,37.97
FiddleSticks,Evelynn,31,17,14,54.84
FiddleSticks,Syndra,73,34,39,46.58
FiddleSticks,Fizz,48,36,12,75
FiddleSticks,KSante,71,42,29,59.15
FiddleSticks,Aatrox,112,67,45,59.82
FiddleSticks,Naafiri,34,23,11,67.65
FiddleSticks,Anivia,21,9,12,42.86
FiddleSticks,Pantheon,166,73,93,43.98
FiddleSticks,Kennen,39,25,14,64.1
FiddleSticks,Shyvana,20,6,14,30
FiddleSticks,Tristana,86,47,39,54.65
FiddleSticks,Sejuani,62,34,28,54.84
FiddleSticks,Belveth,22,12,10,54.55
FiddleSticks,Qiyana,27,16,11,59.26
FiddleSticks,Leona,82,43,39,52.44
FiddleSticks,LeeSin,153,81,72,52.94
FiddleSticks,Draven,57,32,25,56.14
FiddleSticks,Alistar,64,33,31,51.56
FiddleSticks,Trundle,67,28,39,41.79
FiddleSticks,Brand,93,49,44,52.69
FiddleSticks,Chogath,123,64,59,52.03
FiddleSticks,Talon,61,35,26,57.38
FiddleSticks,Renata,35,16,19,45.71
FiddleSticks,Rengar,31,23,8,74.19
FiddleSticks,Ryze,48,26,22,54.17
FiddleSticks,Zeri,72,48,24,66.67
FiddleSticks,Smolder,65,36,29,55.38
FiddleSticks,Twitch,83,42,41,50.6
FiddleSticks,Elise,81,54,27,66.67
FiddleSticks,Riven,57,37,20,64.91
FiddleSticks,Bard,41,25,16,60.98
FiddleSticks,Janna,21,13,8,61.9
FiddleSticks,KogMaw,35,16,19,45.71
FiddleSticks,Orianna,62,34,28,54.84
FiddleSticks,Jayce,70,34,36,48.57
FiddleSticks,Kayle,43,19,24,44.19
FiddleSticks,Olaf,42,26,16,61.9
FiddleSticks,Velkoz,44,19,25,43.18
FiddleSticks,Aurora,83,35,48,42.17
FiddleSticks,Nocturne,125,58,67,46.4
FiddleSticks,Ornn,70,24,46,34.29
FiddleSticks,Urgot,42,14,28,33.33
FiddleSticks,Kassadin,29,13,16,44.83
FiddleSticks,Zilean,30,13,17,43.33
FiddleSticks,Ziggs,33,6,27,18.18
FiddleSticks,Gnar,49,29,20,59.18
FiddleSticks,Fiora,48,31,17,64.58
FiddleSticks,Gragas,87,37,50,42.53
FiddleSticks,Illaoi,41,26,15,63.41
FiddleSticks,Quinn,36,18,18,50
FiddleSticks,Azir,59,30,29,50.85
FiddleSticks,Kalista,22,9,13,40.91
FiddleSticks,JarvanIV,110,41,69,37.27
FiddleSticks,Neeko,32,15,17,46.88
FiddleSticks,Taliyah,37,21,16,56.76
FiddleSticks,Annie,23,13,10,56.52
FiddleSticks,TwistedFate,36,12,24,33.33
FiddleSticks,RekSai,18,15,3,83.33
Aurora,Ivern,35,23,12,65.71
Aurora,Renekton,120,72,48,60
Aurora,Vladimir,148,68,80,45.95
Aurora,Lucian,164,98,66,59.76
Aurora,Blitzcrank,155,92,63,59.35
Aurora,Riven,77,30,47,38.96
Aurora,MonkeyKing,117,42,75,35.9
Aurora,Kassadin,27,13,14,48.15
Aurora,Caitlyn,451,196,255,43.46
Aurora,Taliyah,61,33,28,54.1
Aurora,Leblanc,151,69,82,45.7
Aurora,Kayn,193,99,94,51.3
Aurora,Teemo,177,91,86,51.41
Aurora,Ashe,400,207,193,51.75
Aurora,Nautilus,235,96,139,40.85
Aurora,Malzahar,189,87,102,46.03
Aurora,Garen,277,129,148,46.57
Aurora,Nami,184,84,100,45.65
Aurora,Twitch,94,42,52,44.68
Aurora,Fizz,76,31,45,40.79
Aurora,Kaisa,316,155,161,49.05
Aurora,Karma,269,117,152,43.49
Aurora,Kalista,70,27,43,38.57
Aurora,Amumu,229,104,125,45.41
Aurora,Irelia,140,68,72,48.57
Aurora,Milio,107,48,59,44.86
Aurora,Aatrox,224,109,115,48.66
Aurora,Malphite,151,69,82,45.7
Aurora,Ryze,84,56,28,66.67
Aurora,Leona,184,79,105,42.93
Aurora,Chogath,215,89,126,41.4
Aurora,MasterYi,138,73,65,52.9
Aurora,Gangplank,127,80,47,62.99
Aurora,AurelionSol,61,18,43,29.51
Aurora,Nocturne,226,100,126,44.25
Aurora,Lissandra,66,30,36,45.45
Aurora,MissFortune,356,160,196,44.94
Aurora,Rakan,94,47,47,50
Aurora,Sivir,126,73,53,57.94
Aurora,Senna,112,38,74,33.93
Aurora,Yasuo,365,168,197,46.03
Aurora,Xayah,116,52,64,44.83
Aurora,Mordekaiser,219,136,83,62.1
Aurora,Elise,179,104,75,58.1
Aurora,Qiyana,46,23,23,50
Aurora,Ornn,129,74,55,57.36
Aurora,Sylas,313,128,185,40.89
Aurora,Jinx,562,259,303,46.09
Aurora,Pyke,117,56,61,47.86
Aurora,Sion,142,58,84,40.85
Aurora,Lux,415,190,225,45.78
Aurora,Seraphine,145,74,71,51.03
Aurora,Pantheon,281,129,152,45.91
Aurora,Quinn,51,30,21,58.82
Aurora,Nidalee,64,29,35,45.31
Aurora,Mel,339,142,197,41.89
Aurora,Aphelios,115,57,58,49.57
Aurora,LeeSin,377,182,195,48.28
Aurora,Varus,128,61,67,47.66
Aurora,Rell,143,64,79,44.76
Aurora,Viego,235,130,105,55.32
Aurora,Vex,123,62,61,50.41
Aurora,Jhin,352,156,196,44.32
Aurora,Renata,54,30,24,55.56
Aurora,Gnar,105,48,57,45.71
Aurora,Shyvana,67,28,39,41.79
Aurora,Galio,206,96,110,46.6
Aurora,Xerath,142,60,82,42.25
Aurora,Darius,351,174,177,49.57
Aurora,Corki,75,51,24,68
Aurora,Zed,190,71,119,37.37
Aurora,Draven,114,53,61,46.49
Aurora,Urgot,107,62,45,57.94
Aurora,Shaco,154,86,68,55.84
Aurora,Azir,117,58,59,49.57
Aurora,TahmKench,163,72,91,44.17
Aurora,Shen,146,73,73,50
Aurora,Briar,97,51,46,52.58
Aurora,Veigar,187,73,114,39.04
Aurora,Morgana,188,89,99,47.34
Aurora,Ezreal,514,259,255,50.39
Aurora,Vayne,209,88,121,42.11
Aurora,Rammus,56,30,26,53.57
Aurora,KogMaw,55,19,36,34.55
Aurora,Gwen,113,62,51,54.87
Aurora,Khazix,118,52,66,44.07
Aurora,Yone,269,135,134,50.19
Aurora,Warwick,218,103,115,47.25
Aurora,Swain,230,112,118,48.7
Aurora,Hwei,130,76,54,58.46
Aurora,Ekko,160,74,86,46.25
Aurora,Katarina,113,54,59,47.79
Aurora,Gragas,140,62,78,44.29
Aurora,Skarner,102,48,54,47.06
Aurora,Soraka,91,47,44,51.65
Aurora,Fiora,59,20,39,33.9
Aurora,Diana,282,140,142,49.65
Aurora,Zac,97,46,51,47.42
Aurora,DrMundo,103,33,70,32.04
Aurora,Thresh,411,198,213,48.18
Aurora,Syndra,162,80,82,49.38
Aurora,TwistedFate,57,28,29,49.12
Aurora,Poppy,140,72,68,51.43
Aurora,Camille,107,47,60,43.93
Aurora,Zyra,154,68,86,44.16
Aurora,Brand,82,41,41,50
Aurora,Janna,87,55,32,63.22
Aurora,JarvanIV,143,74,69,51.75
Aurora,Ahri,340,165,175,48.53
Aurora,Yuumi,185,81,104,43.78
Aurora,Kayle,111,64,47,57.66
Aurora,XinZhao,190,95,95,50
Aurora,Illaoi,100,38,62,38
Aurora,Trundle,107,58,49,54.21
Aurora,Sejuani,137,50,87,36.5
Aurora,Anivia,78,41,37,52.56
Aurora,Braum,162,70,92,43.21
Aurora,Ambessa,167,72,95,43.11
Aurora,Singed,40,11,29,27.5
Aurora,Naafiri,63,35,28,55.56
Aurora,Zeri,95,47,48,49.47
Aurora,Graves,126,57,69,45.24
Aurora,Nasus,100,35,65,35
Aurora,Vi,205,82,123,40
Aurora,Lulu,293,163,130,55.63
Aurora,Kled,44,18,26,40.91
Aurora,Viktor,235,116,119,49.36
Aurora,Akshan,73,34,39,46.58
Aurora,Samira,126,73,53,57.94
Aurora,Jayce,117,65,52,55.56
Aurora,Hecarim,82,41,41,50
Aurora,Akali,168,85,83,50.6
Aurora,Udyr,65,43,22,66.15
Aurora,Kindred,84,54,30,64.29
Aurora,Smolder,111,53,58,47.75
Aurora,KSante,147,67,80,45.58
Aurora,Ziggs,68,40,28,58.82
Aurora,Sett,240,108,132,45
Aurora,Yorick,140,65,75,46.43
Aurora,Tristana,178,81,97,45.51
Aurora,Heimerdinger,66,31,35,46.97
Aurora,Kennen,72,28,44,38.89
Aurora,Volibear,187,101,86,54.01
Aurora,Bard,58,36,22,62.07
Aurora,Lillia,115,45,70,39.13
Aurora,Velkoz,92,32,60,34.78
Aurora,Rumble,79,28,51,35.44
Aurora,Rengar,51,24,27,47.06
Aurora,Karthus,44,17,27,38.64
Aurora,Zoe,49,10,39,20.41
Aurora,Evelynn,59,24,35,40.68
Aurora,Jax,115,73,42,63.48
Aurora,Orianna,105,47,58,44.76
Aurora,Sona,29,9,20,31.03
Aurora,Cassiopeia,47,17,30,36.17
Aurora,Alistar,87,52,35,59.77
Aurora,Talon,118,53,65,44.92
Aurora,Tryndamere,69,40,29,57.97
Aurora,Nunu,86,33,53,38.37
Aurora,Neeko,111,64,47,57.66
Aurora,Zilean,52,30,22,57.69
Aurora,Olaf,49,23,26,46.94
Aurora,Nilah,73,42,31,57.53
Aurora,FiddleSticks,83,48,35,57.83
Aurora,Annie,42,22,20,52.38
Aurora,Maokai,86,33,53,38.37
Aurora,RekSai,36,17,19,47.22
Aurora,Taric,26,8,18,30.77
Aurora,Belveth,50,22,28,44
Rammus,Olaf,34,19,15,55.88
Rammus,Kayn,115,50,65,43.48
Rammus,Yasuo,234,133,101,56.84
Rammus,Galio,104,49,55,47.12
Rammus,Velkoz,47,21,26,44.68
Rammus,Riven,49,30,19,61.22
Rammus,Shyvana,11,3,8,27.27
Rammus,Ryze,32,23,9,71.88
Rammus,Jhin,155,90,65,58.06
Rammus,Mordekaiser,87,35,52,40.23
Rammus,Chogath,88,42,46,47.73
Rammus,Naafiri,24,13,11,54.17
Rammus,Yone,165,76,89,46.06
Rammus,Gwen,40,19,21,47.5
Rammus,MasterYi,274,152,122,55.47
Rammus,Akshan,26,17,9,65.38
Rammus,Zeri,40,19,21,47.5
Rammus,Rakan,71,39,32,54.93
Rammus,Sivir,20,10,10,50
Rammus,Ashe,145,75,70,51.72
Rammus,Senna,51,18,33,35.29
Rammus,Irelia,90,56,34,62.22
Rammus,Diana,126,65,61,51.59
Rammus,Morgana,83,42,41,50.6
Rammus,Lux,151,71,80,47.02
Rammus,Sett,111,52,59,46.85
Rammus,Singed,20,5,15,25
Rammus,Fizz,71,43,28,60.56
Rammus,Caitlyn,191,96,95,50.26
Rammus,Soraka,60,24,36,40
Rammus,XinZhao,60,35,25,58.33
Rammus,Zed,87,29,58,33.33
Rammus,Ezreal,159,87,72,54.72
Rammus,Sion,68,39,29,57.35
Rammus,Fiora,38,17,21,44.74
Rammus,Rengar,15,12,3,80
Rammus,Syndra,69,33,36,47.83
Rammus,Nilah,21,9,12,42.86
Rammus,Mel,123,59,64,47.97
Rammus,LeeSin,154,72,82,46.75
Rammus,Kassadin,19,14,5,73.68
Rammus,Sylas,113,60,53,53.1
Rammus,Ornn,42,28,14,66.67
Rammus,Akali,81,41,40,50.62
Rammus,Elise,57,30,27,52.63
Rammus,Draven,48,26,22,54.17
Rammus,Pyke,88,53,35,60.23
Rammus,Aurora,56,26,30,46.43
Rammus,Zac,49,18,31,36.73
Rammus,Kaisa,130,73,57,56.15
Rammus,Zilean,21,8,13,38.1
Rammus,Yorick,66,33,33,50
Rammus,Warwick,144,65,79,45.14
Rammus,Yuumi,88,39,49,44.32
Rammus,Gragas,58,32,26,55.17
Rammus,Azir,42,30,12,71.43
Rammus,Volibear,87,43,44,49.43
Rammus,MissFortune,138,57,81,41.3
Rammus,Poppy,34,22,12,64.71
Rammus,Heimerdinger,42,20,22,47.62
Rammus,AurelionSol,48,17,31,35.42
Rammus,Viego,106,56,50,52.83
Rammus,Vi,92,41,51,44.57
Rammus,Lucian,57,25,32,43.86
Rammus,Nami,57,21,36,36.84
Rammus,Aatrox,88,49,39,55.68
Rammus,Vladimir,38,29,9,76.32
Rammus,Kled,15,6,9,40
Rammus,Veigar,84,41,43,48.81
Rammus,Vayne,154,46,108,29.87
Rammus,Nautilus,111,58,53,52.25
Rammus,Illaoi,33,6,27,18.18
Rammus,Lillia,55,14,41,25.45
Rammus,Malzahar,82,33,49,40.24
Rammus,Twitch,67,25,42,37.31
Rammus,Lulu,122,58,64,47.54
Rammus,FiddleSticks,36,14,22,38.89
Rammus,Thresh,126,63,63,50
Rammus,Karthus,18,2,16,11.11
Rammus,Xerath,74,30,44,40.54
Rammus,Teemo,58,34,24,58.62
Rammus,Leblanc,53,17,36,32.08
Rammus,Jax,69,34,35,49.28
Rammus,Amumu,66,31,35,46.97
Rammus,Aphelios,38,22,16,57.89
Rammus,Leona,76,34,42,44.74
Rammus,Shaco,42,30,12,71.43
Rammus,Swain,76,34,42,44.74
Rammus,Darius,137,48,89,35.04
Rammus,Jinx,192,78,114,40.63
Rammus,Ambessa,58,26,32,44.83
Rammus,Blitzcrank,105,62,43,59.05
Rammus,Quinn,35,21,14,60
Rammus,Alistar,51,21,30,41.18
Rammus,Brand,28,11,17,39.29
Rammus,Ekko,61,20,41,32.79
Rammus,KogMaw,44,26,18,59.09
Rammus,Evelynn,10,2,8,20
Rammus,Samira,63,34,29,53.97
Rammus,Tristana,95,58,37,61.05
Rammus,DrMundo,25,14,11,56
Rammus,Sejuani,33,15,18,45.45
Rammus,Taliyah,12,6,6,50
Rammus,Nunu,36,8,28,22.22
Rammus,Urgot,73,29,44,39.73
Rammus,Khazix,30,10,20,33.33
Rammus,Ziggs,29,17,12,58.62
Rammus,Jayce,41,11,30,26.83
Rammus,Orianna,22,11,11,50
Rammus,Zyra,48,14,34,29.17
Rammus,Nocturne,108,53,55,49.07
Rammus,Hwei,48,17,31,35.42
Rammus,Trundle,53,33,20,62.26
Rammus,Viktor,62,27,35,43.55
Rammus,Braum,60,27,33,45
Rammus,Annie,18,3,15,16.67
Rammus,Karma,87,57,30,65.52
Rammus,Garen,112,56,56,50
Rammus,Maokai,38,22,16,57.89
Rammus,Milio,34,19,15,55.88
Rammus,Tryndamere,48,16,32,33.33
Rammus,Ivern,16,11,5,68.75
Rammus,Talon,29,6,23,20.69
Rammus,Graves,55,39,16,70.91
Rammus,Kennen,21,11,10,52.38
Rammus,Camille,21,9,12,42.86
Rammus,Sona,16,8,8,50
Rammus,Lissandra,42,28,14,66.67
Rammus,TwistedFate,30,14,16,46.67
Rammus,Seraphine,66,21,45,31.82
Rammus,Qiyana,19,8,11,42.11
Rammus,Rumble,29,20,9,68.97
Rammus,Pantheon,128,55,73,42.97
Rammus,Hecarim,15,3,12,20
Rammus,Malphite,115,60,55,52.17
Rammus,Ahri,92,64,28,69.57
Rammus,TahmKench,77,30,47,38.96
Rammus,Smolder,51,23,28,45.1
Rammus,Varus,79,39,40,49.37
Rammus,Briar,77,38,39,49.35
Rammus,Xayah,53,27,26,50.94
Rammus,Janna,10,3,7,30
Rammus,Cassiopeia,16,5,11,31.25
Rammus,Nidalee,21,16,5,76.19
Rammus,JarvanIV,45,34,11,75.56
Rammus,Corki,46,25,21,54.35
Rammus,Kayle,33,17,16,51.52
Rammus,Katarina,29,16,13,55.17
Rammus,Nasus,37,16,21,43.24
Rammus,Zoe,50,18,32,36
Rammus,Kindred,25,17,8,68
Rammus,Renekton,45,22,23,48.89
Rammus,Vex,57,33,24,57.89
Rammus,Shen,49,17,32,34.69
Rammus,Kalista,43,18,25,41.86
Rammus,Gnar,42,19,23,45.24
Rammus,Anivia,28,17,11,60.71
Rammus,Belveth,14,6,8,42.86
Rammus,MonkeyKing,39,29,10,74.36
Rammus,Bard,19,14,5,73.68
Rammus,Renata,29,9,20,31.03
Rammus,Neeko,24,13,11,54.17
Rammus,KSante,28,8,20,28.57
Rammus,RekSai,21,10,11,47.62
Rammus,Rell,33,15,18,45.45
Rammus,Taric,8,8,0,100
Rammus,Udyr,15,9,6,60
Rammus,Gangplank,20,11,9,55
Rammus,Skarner,29,17,12,58.62
Annie,Olaf,34,17,17,50
Annie,Kayn,102,58,44,56.86
Annie,Yasuo,198,102,96,51.52
Annie,Galio,67,30,37,44.78
Annie,Velkoz,52,21,31,40.38
Annie,Ashe,173,82,91,47.4
Annie,Graves,59,31,28,52.54
Annie,Lucian,73,43,30,58.9
Annie,Vayne,77,46,31,59.74
Annie,Draven,38,18,20,47.37
Annie,Yone,135,63,72,46.67
Annie,Malzahar,71,31,40,43.66
Annie,KogMaw,29,11,18,37.93
Annie,Veigar,87,42,45,48.28
Annie,Kennen,23,12,11,52.17
Annie,Garen,84,39,45,46.43
Annie,Talon,43,17,26,39.53
Annie,Aphelios,32,18,14,56.25
Annie,Pyke,60,29,31,48.33
Annie,Trundle,49,34,15,69.39
Annie,MasterYi,56,38,18,67.86
Annie,Fizz,47,17,30,36.17
Annie,Jinx,197,94,103,47.72
Annie,Thresh,125,50,75,40
Annie,KSante,58,26,32,44.83
Annie,LeeSin,140,67,73,47.86
Annie,Ahri,123,54,69,43.9
Annie,Seraphine,60,38,22,63.33
Annie,Heimerdinger,38,18,20,47.37
Annie,Jhin,152,77,75,50.66
Annie,Blitzcrank,73,46,27,63.01
Annie,Zac,69,35,34,50.72
Annie,Corki,38,17,21,44.74
Annie,Nautilus,105,47,58,44.76
Annie,Gnar,35,6,29,17.14
Annie,Shaco,21,15,6,71.43
Annie,Caitlyn,153,80,73,52.29
Annie,Maokai,33,22,11,66.67
Annie,Renekton,29,15,14,51.72
Annie,Varus,78,43,35,55.13
Annie,TahmKench,90,40,50,44.44
Annie,Darius,108,41,67,37.96
Annie,Nocturne,89,24,65,26.97
Annie,Senna,34,15,19,44.12
Annie,Nunu,24,9,15,37.5
Annie,MissFortune,126,59,67,46.83
Annie,Jax,68,41,27,60.29
Annie,Zeri,43,20,23,46.51
Annie,Alistar,29,14,15,48.28
Annie,Singed,13,3,10,23.08
Annie,Gragas,64,30,34,46.88
Annie,Zed,70,52,18,74.29
Annie,Kayle,36,26,10,72.22
Annie,Vladimir,37,23,14,62.16
Annie,Lux,166,80,86,48.19
Annie,Yorick,52,29,23,55.77
Annie,Amumu,62,26,36,41.94
Annie,Mel,156,80,76,51.28
Annie,Riven,19,8,11,42.11
Annie,Sylas,91,54,37,59.34
Annie,Xayah,63,42,21,66.67
Annie,Rakan,43,23,20,53.49
Annie,Rammus,18,15,3,83.33
Annie,Belveth,19,6,13,31.58
Annie,Lissandra,31,24,7,77.42
Annie,Bard,24,14,10,58.33
Annie,Kaisa,113,67,46,59.29
Annie,Elise,56,27,29,48.21
Annie,Leblanc,46,14,32,30.43
Annie,Braum,48,29,19,60.42
Annie,Mordekaiser,80,31,49,38.75
Annie,Yuumi,60,21,39,35
Annie,Ekko,64,41,23,64.06
Annie,Rell,62,27,35,43.55
Annie,Camille,18,9,9,50
Annie,Diana,131,65,66,49.62
Annie,Samira,49,27,22,55.1
Annie,Hwei,59,31,28,52.54
Annie,Nilah,23,16,7,69.57
Annie,Milio,33,19,14,57.58
Annie,Aatrox,74,29,45,39.19
Annie,Lillia,37,23,14,62.16
Annie,Janna,11,6,5,54.55
Annie,Nasus,44,22,22,50
Annie,Pantheon,122,61,61,50
Annie,Irelia,41,16,25,39.02
Annie,Zilean,25,13,12,52
Annie,Leona,77,47,30,61.04
Annie,Teemo,83,53,30,63.86
Annie,Viktor,41,22,19,53.66
Annie,Sett,75,38,37,50.67
Annie,Warwick,97,49,48,50.52
Annie,Swain,75,28,47,37.33
Annie,Ambessa,46,20,26,43.48
Annie,Ezreal,170,89,81,52.35
Annie,DrMundo,30,22,8,73.33
Annie,Udyr,31,20,11,64.52
Annie,Chogath,96,50,46,52.08
Annie,Xerath,64,31,33,48.44
Annie,Shen,49,20,29,40.82
Annie,Gwen,40,22,18,55
Annie,MonkeyKing,60,32,28,53.33
Annie,AurelionSol,18,11,7,61.11
Annie,Volibear,79,43,36,54.43
Annie,JarvanIV,75,31,44,41.33
Annie,Renata,20,13,7,65
Annie,Syndra,63,36,27,57.14
Annie,Katarina,16,8,8,50
Annie,Poppy,43,32,11,74.42
Annie,Fiora,15,7,8,46.67
Annie,Naafiri,18,5,13,27.78
Annie,Twitch,40,25,15,62.5
Annie,Karthus,21,14,7,66.67
Annie,Quinn,34,21,13,61.76
Annie,Vi,87,47,40,54.02
Annie,Cassiopeia,35,15,20,42.86
Annie,Zyra,49,32,17,65.31
Annie,Aurora,42,20,22,47.62
Annie,RekSai,23,8,15,34.78
Annie,Sion,63,31,32,49.21
Annie,Malphite,69,34,35,49.28
Annie,Nami,93,49,44,52.69
Annie,XinZhao,65,39,26,60
Annie,Akshan,15,12,3,80
Annie,Karma,105,47,58,44.76
Annie,Brand,55,24,31,43.64
Annie,Anivia,25,5,20,20
Annie,Tryndamere,19,9,10,47.37
Annie,Illaoi,33,25,8,75.76
Annie,Tristana,57,31,26,54.39
Annie,Shyvana,17,5,12,29.41
Annie,Ziggs,23,8,15,34.78
Annie,Taric,25,12,13,48
Annie,Azir,32,17,15,53.13
Annie,Kalista,17,3,14,17.65
Annie,Urgot,43,32,11,74.42
Annie,Morgana,66,30,36,45.45
Annie,Evelynn,16,9,7,56.25
Annie,Lulu,92,44,48,47.83
Annie,FiddleSticks,23,10,13,43.48
Annie,Zoe,26,9,17,34.62
Annie,Viego,67,32,35,47.76
Annie,Sona,19,14,5,73.68
Annie,Ryze,14,7,7,50
Annie,Smolder,28,18,10,64.29
Annie,Neeko,23,15,8,65.22
Annie,Vex,43,25,18,58.14
Annie,Kindred,14,7,7,50
Annie,Sejuani,65,27,38,41.54
Annie,Hecarim,13,6,7,46.15
Annie,Ivern,8,0,8,0
Annie,Taliyah,22,17,5,77.27
Annie,Ornn,57,27,30,47.37
Annie,Sivir,41,8,33,19.51
Annie,Briar,20,14,6,70
Annie,Soraka,19,14,5,73.68
Annie,Akali,55,29,26,52.73
Annie,Rengar,16,6,10,37.5
Annie,Gangplank,50,26,24,52
Annie,Nidalee,36,21,15,58.33
Annie,Jayce,21,9,12,42.86
Annie,Skarner,37,15,22,40.54
Annie,Orianna,26,9,17,34.62
Annie,Rumble,15,9,6,60
Annie,TwistedFate,32,11,21,34.38
Annie,Qiyana,12,9,3,75
Annie,Khazix,22,11,11,50
Annie,Kled,8,8,0,100
Annie,Kassadin,14,9,5,64.29
Olaf,DrMundo,33,18,15,54.55
Olaf,Rammus,34,15,19,44.12
Olaf,Annie,34,17,17,50
Olaf,Ezreal,189,99,90,52.38
Olaf,Renata,18,6,12,33.33
Olaf,Garen,86,38,48,44.19
Olaf,Warwick,104,54,50,51.92
Olaf,Ahri,96,52,44,54.17
Olaf,Jinx,165,89,76,53.94
Olaf,Milio,49,20,29,40.82
Olaf,Nasus,54,29,25,53.7
Olaf,Viego,105,48,57,45.71
Olaf,Cassiopeia,25,11,14,44
Olaf,Karma,85,33,52,38.82
Olaf,TahmKench,56,25,31,44.64
Olaf,JarvanIV,55,25,30,45.45
Olaf,Viktor,64,29,35,45.31
Olaf,Kaisa,93,44,49,47.31
Olaf,Morgana,79,47,32,59.49
Olaf,Pantheon,85,38,47,44.71
Olaf,Shaco,42,20,22,47.62
Olaf,Mel,160,98,62,61.25
Olaf,Lucian,49,27,22,55.1
Olaf,Swain,69,31,38,44.93
Olaf,Sylas,77,40,37,51.95
Olaf,Jhin,95,57,38,60
Olaf,Nautilus,106,59,47,55.66
Olaf,Kayle,22,14,8,63.64
Olaf,Kindred,22,13,9,59.09
Olaf,Tristana,45,17,28,37.78
Olaf,Volibear,59,32,27,54.24
Olaf,Kayn,68,41,27,60.29
Olaf,Akali,43,28,15,65.12
Olaf,Ashe,158,82,76,51.9
Olaf,Mordekaiser,150,83,67,55.33
Olaf,Talon,29,18,11,62.07
Olaf,Chogath,112,45,67,40.18
Olaf,Veigar,58,24,34,41.38
Olaf,MissFortune,135,72,63,53.33
Olaf,Leona,75,48,27,64
Olaf,Vi,91,49,42,53.85
Olaf,Nilah,23,14,9,60.87
Olaf,Kled,25,11,14,44
Olaf,Nocturne,97,49,48,50.52
Olaf,Rell,57,36,21,63.16
Olaf,Orianna,44,27,17,61.36
Olaf,Thresh,106,59,47,55.66
Olaf,AurelionSol,22,9,13,40.91
Olaf,Zyra,43,28,15,65.12
Olaf,Aatrox,53,39,14,73.58
Olaf,Vayne,85,28,57,32.94
Olaf,Varus,89,63,26,70.79
Olaf,Soraka,36,22,14,61.11
Olaf,Graves,47,29,18,61.7
Olaf,Kassadin,10,4,6,40
Olaf,Aphelios,34,18,16,52.94
Olaf,Blitzcrank,58,24,34,41.38
Olaf,Darius,93,34,59,36.56
Olaf,Nunu,36,15,21,41.67
Olaf,Katarina,26,9,17,34.62
Olaf,Braum,55,30,25,54.55
Olaf,Sett,90,43,47,47.78
Olaf,Khazix,36,20,16,55.56
Olaf,Xerath,50,23,27,46
Olaf,Samira,37,28,9,75.68
Olaf,Gangplank,44,26,18,59.09
Olaf,Sivir,48,25,23,52.08
Olaf,Camille,25,18,7,72
Olaf,Irelia,32,18,14,56.25
Olaf,Zilean,22,7,15,31.82
Olaf,Lux,153,85,68,55.56
Olaf,TwistedFate,20,14,6,70
Olaf,Jax,53,19,34,35.85
Olaf,Urgot,18,11,7,61.11
Olaf,Brand,29,19,10,65.52
Olaf,Xayah,38,22,16,57.89
Olaf,Seraphine,35,18,17,51.43
Olaf,Heimerdinger,34,10,24,29.41
Olaf,Renekton,14,3,11,21.43
Olaf,Elise,54,27,27,50
Olaf,Yasuo,111,63,48,56.76
Olaf,Poppy,64,39,25,60.94
Olaf,Malphite,67,46,21,68.66
Olaf,Ziggs,22,14,8,63.64
Olaf,Taliyah,30,16,14,53.33
Olaf,Smolder,43,30,13,69.77
Olaf,Rengar,9,4,5,44.44
Olaf,Hwei,62,35,27,56.45
Olaf,Ivern,18,7,11,38.89
Olaf,Illaoi,48,23,25,47.92
Olaf,Janna,21,7,14,33.33
Olaf,Caitlyn,158,85,73,53.8
Olaf,Nami,34,20,14,58.82
Olaf,LeeSin,96,52,44,54.17
Olaf,Teemo,44,14,30,31.82
Olaf,Gragas,51,39,12,76.47
Olaf,Neeko,37,25,12,67.57
Olaf,Sejuani,50,23,27,46
Olaf,Trundle,50,26,24,52
Olaf,Ekko,57,35,22,61.4
Olaf,MasterYi,48,17,31,35.42
Olaf,Yuumi,51,34,17,66.67
Olaf,Rumble,27,21,6,77.78
Olaf,Lulu,105,54,51,51.43
Olaf,Draven,27,12,15,44.44
Olaf,Briar,42,23,19,54.76
Olaf,Zed,63,33,30,52.38
Olaf,Sona,6,6,0,100
Olaf,Aurora,49,26,23,53.06
Olaf,Yone,87,61,26,70.11
Olaf,Amumu,66,33,33,50
Olaf,Anivia,30,13,17,43.33
Olaf,Senna,47,23,24,48.94
Olaf,XinZhao,28,19,9,67.86
Olaf,Naafiri,12,7,5,58.33
Olaf,Yorick,39,19,20,48.72
Olaf,Galio,52,10,42,19.23
Olaf,Twitch,45,28,17,62.22
Olaf,Tryndamere,14,9,5,64.29
Olaf,FiddleSticks,42,16,26,38.1
Olaf,Akshan,11,3,8,27.27
Olaf,Nidalee,35,16,19,45.71
Olaf,Alistar,33,21,12,63.64
Olaf,Kennen,18,8,10,44.44
Olaf,Rakan,45,21,24,46.67
Olaf,Udyr,11,5,6,45.45
Olaf,Vex,42,26,16,61.9
Olaf,Hecarim,27,22,5,81.48
Olaf,Leblanc,26,17,9,65.38
Olaf,Shen,50,21,29,42
Olaf,Pyke,48,34,14,70.83
Olaf,Kalista,17,17,0,100
Olaf,Fizz,27,14,13,51.85
Olaf,Ambessa,34,16,18,47.06
Olaf,Gnar,50,36,14,72
Olaf,Skarner,46,35,11,76.09
Olaf,MonkeyKing,32,15,17,46.88
Olaf,Diana,62,32,30,51.61
Olaf,Syndra,62,30,32,48.39
Olaf,Zac,49,27,22,55.1
Olaf,Corki,24,11,13,45.83
Olaf,Zeri,34,25,9,73.53
Olaf,KSante,42,32,10,76.19
Olaf,Evelynn,7,2,5,28.57
Olaf,Riven,22,12,10,54.55
Olaf,Lissandra,28,12,16,42.86
Olaf,Malzahar,88,47,41,53.41
Olaf,Taric,12,7,5,58.33
Olaf,Sion,48,31,17,64.58
Olaf,Azir,22,16,6,72.73
Olaf,Maokai,44,23,21,52.27
Olaf,Vladimir,22,13,9,59.09
Olaf,Fiora,16,10,6,62.5
Olaf,Belveth,7,4,3,57.14
Olaf,Singed,32,15,17,46.88
Olaf,Velkoz,26,12,14,46.15
Olaf,Ryze,20,12,8,60
Olaf,Ornn,40,35,5,87.5
Olaf,Bard,11,9,2,81.82
Olaf,Qiyana,16,14,2,87.5
Olaf,Gwen,16,11,5,68.75
Olaf,Quinn,19,14,5,73.68
Olaf,Jayce,40,17,23,42.5
Olaf,RekSai,8,5,3,62.5
Olaf,Lillia,30,15,15,50
Olaf,KogMaw,3,0,3,0
Olaf,Karthus,9,3,6,33.33
Olaf,Shyvana,14,6,8,42.86
Olaf,Zoe,18,15,3,83.33
Corki,Teemo,73,45,28,61.64
Corki,FiddleSticks,40,28,12,70
Corki,Hwei,74,39,35,52.7
Corki,Twitch,67,25,42,37.31
Corki,Seraphine,92,45,47,48.91
Corki,Singed,24,3,21,12.5
Corki,Darius,162,102,60,62.96
Corki,Smolder,84,43,41,51.19
Corki,Mel,209,130,79,62.2
Corki,Pantheon,152,83,69,54.61
Corki,Garen,193,86,107,44.56
Corki,Fizz,43,29,14,67.44
Corki,Kaisa,225,86,139,38.22
Corki,Karma,168,81,87,48.21
Corki,Irelia,64,36,28,56.25
Corki,Ekko,54,21,33,38.89
Corki,Qiyana,46,17,29,36.96
Corki,Ashe,190,96,94,50.53
Corki,Thresh,206,118,88,57.28
Corki,Renekton,52,20,32,38.46
Corki,LeeSin,182,87,95,47.8
Corki,Viktor,143,65,78,45.45
Corki,XinZhao,76,43,33,56.58
Corki,Chogath,150,68,82,45.33
Corki,Gwen,60,29,31,48.33
Corki,Rell,94,51,43,54.26
Corki,Vladimir,83,38,45,45.78
Corki,Volibear,132,52,80,39.39
Corki,Malzahar,116,55,61,47.41
Corki,Jayce,43,22,21,51.16
Corki,Sion,128,52,76,40.63
Corki,Zac,98,53,45,54.08
Corki,Nocturne,162,79,83,48.77
Corki,Veigar,77,45,32,58.44
Corki,KogMaw,44,19,25,43.18
Corki,Morgana,94,39,55,41.49
Corki,Evelynn,31,5,26,16.13
Corki,Aurora,75,24,51,32
Corki,Lulu,187,65,122,34.76
Corki,Ahri,181,95,86,52.49
Corki,Shaco,80,26,54,32.5
Corki,Mordekaiser,142,33,109,23.24
Corki,Jhin,236,118,118,50
Corki,Zyra,86,46,40,53.49
Corki,Lucian,111,56,55,50.45
Corki,Sett,127,48,79,37.8
Corki,KSante,72,39,33,54.17
Corki,Skarner,45,16,29,35.56
Corki,Yasuo,187,66,121,35.29
Corki,Swain,97,47,50,48.45
Corki,Viego,126,44,82,34.92
Corki,Velkoz,41,22,19,53.66
Corki,Yorick,88,42,46,47.73
Corki,Diana,157,75,82,47.77
Corki,Annie,38,21,17,55.26
Corki,Ziggs,25,12,13,48
Corki,Lux,247,119,128,48.18
Corki,Zilean,47,21,26,44.68
Corki,Heimerdinger,37,9,28,24.32
Corki,Amumu,124,50,74,40.32
Corki,Braum,114,50,64,43.86
Corki,Jinx,257,110,147,42.8
Corki,Khazix,49,26,23,53.06
Corki,Malphite,107,61,46,57.01
Corki,Lillia,45,22,23,48.89
Corki,Katarina,53,21,32,39.62
Corki,Samira,80,35,45,43.75
Corki,Leblanc,77,37,40,48.05
Corki,MissFortune,250,122,128,48.8
Corki,Shen,75,34,41,45.33
Corki,TahmKench,99,49,50,49.49
Corki,Sejuani,59,23,36,38.98
Corki,Nautilus,186,86,100,46.24
Corki,Kindred,47,24,23,51.06
Corki,Udyr,54,28,26,51.85
Corki,Ivern,24,13,11,54.17
Corki,Soraka,50,30,20,60
Corki,Gnar,60,39,21,65
Corki,Vayne,170,64,106,37.65
Corki,Nami,120,34,86,28.33
Corki,Aatrox,98,46,52,46.94
Corki,Caitlyn,262,133,129,50.76
Corki,Alistar,61,18,43,29.51
Corki,Brand,50,15,35,30
Corki,Milio,107,49,58,45.79
Corki,Poppy,80,44,36,55
Corki,Kennen,36,28,8,77.78
Corki,Gragas,110,65,45,59.09
Corki,Galio,181,114,67,62.98
Corki,Leona,97,40,57,41.24
Corki,JarvanIV,94,47,47,50
Corki,Kayn,135,61,74,45.19
Corki,Neeko,59,26,33,44.07
Corki,Zeri,58,42,16,72.41
Corki,Nidalee,33,20,13,60.61
Corki,Ornn,81,44,37,54.32
Corki,Warwick,157,86,71,54.78
Corki,Nasus,52,12,40,23.08
Corki,Akshan,41,20,21,48.78
Corki,MasterYi,79,42,37,53.16
Corki,Draven,49,30,19,61.22
Corki,Rengar,30,19,11,63.33
Corki,Vi,143,61,82,42.66
Corki,Xayah,75,26,49,34.67
Corki,Gangplank,61,37,24,60.66
Corki,AurelionSol,45,20,25,44.44
Corki,Bard,36,14,22,38.89
Corki,Varus,100,61,39,61
Corki,Kled,35,18,17,51.43
Corki,Kayle,56,16,40,28.57
Corki,Nunu,73,40,33,54.79
Corki,Yone,183,82,101,44.81
Corki,Kalista,36,10,26,27.78
Corki,Blitzcrank,74,38,36,51.35
Corki,Hecarim,44,18,26,40.91
Corki,Elise,123,59,64,47.97
Corki,Sylas,184,106,78,57.61
Corki,Jax,83,44,39,53.01
Corki,Akali,98,49,49,50
Corki,Ezreal,268,135,133,50.37
Corki,Orianna,84,34,50,40.48
Corki,MonkeyKing,108,46,62,42.59
Corki,Zed,99,42,57,42.42
Corki,Pyke,99,43,56,43.43
Corki,Naafiri,21,13,8,61.9
Corki,Urgot,67,42,25,62.69
Corki,Briar,48,11,37,22.92
Corki,Anivia,28,16,12,57.14
Corki,Cassiopeia,31,14,17,45.16
Corki,Rakan,44,22,22,50
Corki,Lissandra,41,18,23,43.9
Corki,Aphelios,62,28,34,45.16
Corki,Senna,83,33,50,39.76
Corki,Graves,92,45,47,48.91
Corki,Tristana,131,82,49,62.6
Corki,Ambessa,67,30,37,44.78
Corki,Taliyah,43,16,27,37.21
Corki,Sivir,65,22,43,33.85
Corki,Ryze,38,16,22,42.11
Corki,DrMundo,62,31,31,50
Corki,Yuumi,86,49,37,56.98
Corki,Quinn,52,22,30,42.31
Corki,Rammus,46,21,25,45.65
Corki,Fiora,52,31,21,59.62
Corki,Taric,23,6,17,26.09
Corki,Belveth,16,9,7,56.25
Corki,Trundle,58,31,27,53.45
Corki,Syndra,45,26,19,57.78
Corki,Riven,44,25,19,56.82
Corki,Xerath,39,26,13,66.67
Corki,Kassadin,17,3,14,17.65
Corki,Illaoi,42,25,17,59.52
Corki,Vex,56,29,27,51.79
Corki,Azir,49,19,30,38.78
Corki,Camille,55,25,30,45.45
Corki,Talon,41,27,14,65.85
Corki,Karthus,17,10,7,58.82
Corki,Olaf,24,13,11,54.17
Corki,Rumble,40,12,28,30
Corki,TwistedFate,34,19,15,55.88
Corki,Shyvana,30,10,20,33.33
Corki,Tryndamere,43,24,19,55.81
Corki,Renata,23,18,5,78.26
Corki,Sona,13,6,7,46.15
Corki,Maokai,61,28,33,45.9
Corki,Nilah,24,11,13,45.83
Corki,Janna,20,15,5,75
Corki,Zoe,36,12,24,33.33
Corki,RekSai,26,17,9,65.38
MonkeyKing,Quinn,37,14,23,37.84
MonkeyKing,Sejuani,116,53,63,45.69
MonkeyKing,Leblanc,139,54,85,38.85
MonkeyKing,Twitch,124,68,56,54.84
MonkeyKing,Nautilus,244,128,116,52.46
MonkeyKing,Gangplank,132,75,57,56.82
MonkeyKing,LeeSin,347,204,143,58.79
MonkeyKing,Aurora,117,75,42,64.1
MonkeyKing,Ashe,351,187,164,53.28
MonkeyKing,Morgana,173,64,109,36.99
MonkeyKing,Gwen,82,37,45,45.12
MonkeyKing,Pantheon,277,149,128,53.79
MonkeyKing,Irelia,127,60,67,47.24
MonkeyKing,Varus,170,104,66,61.18
MonkeyKing,Lux,340,175,165,51.47
MonkeyKing,Poppy,71,41,30,57.75
MonkeyKing,Shaco,129,63,66,48.84
MonkeyKing,Ahri,241,138,103,57.26
MonkeyKing,Ezreal,477,280,197,58.7
MonkeyKing,Nami,192,97,95,50.52
MonkeyKing,XinZhao,132,91,41,68.94
MonkeyKing,Azir,83,49,34,59.04
MonkeyKing,Kaisa,275,152,123,55.27
MonkeyKing,KSante,129,74,55,57.36
MonkeyKing,Lillia,94,50,44,53.19
MonkeyKing,Diana,232,131,101,56.47
MonkeyKing,Bard,69,42,27,60.87
MonkeyKing,Garen,267,121,146,45.32
MonkeyKing,Akali,205,112,93,54.63
MonkeyKing,Karma,201,115,86,57.21
MonkeyKing,Sett,222,116,106,52.25
MonkeyKing,Khazix,61,41,20,67.21
MonkeyKing,Yasuo,290,153,137,52.76
MonkeyKing,Yuumi,174,64,110,36.78
MonkeyKing,Darius,392,177,215,45.15
MonkeyKing,Viego,313,153,160,48.88
MonkeyKing,Galio,180,95,85,52.78
MonkeyKing,Draven,107,47,60,43.93
MonkeyKing,Milio,100,46,54,46
MonkeyKing,Yone,282,192,90,68.09
MonkeyKing,Teemo,112,69,43,61.61
MonkeyKing,Malzahar,171,79,92,46.2
MonkeyKing,Rakan,87,48,39,55.17
MonkeyKing,Ivern,37,25,12,67.57
MonkeyKing,FiddleSticks,73,42,31,57.53
MonkeyKing,Xerath,118,65,53,55.08
MonkeyKing,Smolder,104,54,50,51.92
MonkeyKing,Swain,125,70,55,56
MonkeyKing,Trundle,91,44,47,48.35
MonkeyKing,Nidalee,79,38,41,48.1
MonkeyKing,Blitzcrank,119,58,61,48.74
MonkeyKing,Camille,98,58,40,59.18
MonkeyKing,Graves,127,67,60,52.76
MonkeyKing,Leona,190,108,82,56.84
MonkeyKing,Talon,104,63,41,60.58
MonkeyKing,Vayne,221,116,105,52.49
MonkeyKing,Zyra,147,74,73,50.34
MonkeyKing,Caitlyn,369,194,175,52.57
MonkeyKing,Gragas,106,52,54,49.06
MonkeyKing,Volibear,147,80,67,54.42
MonkeyKing,MissFortune,335,151,184,45.07
MonkeyKing,Lucian,131,70,61,53.44
MonkeyKing,Renekton,106,68,38,64.15
MonkeyKing,Jhin,261,140,121,53.64
MonkeyKing,Orianna,84,22,62,26.19
MonkeyKing,Warwick,237,135,102,56.96
MonkeyKing,Mordekaiser,202,126,76,62.38
MonkeyKing,Zac,86,44,42,51.16
MonkeyKing,Zed,178,97,81,54.49
MonkeyKing,Rell,139,87,52,62.59
MonkeyKing,Lulu,304,180,124,59.21
MonkeyKing,Ambessa,134,77,57,57.46
MonkeyKing,Elise,140,78,62,55.71
MonkeyKing,Kalista,38,25,13,65.79
MonkeyKing,Chogath,157,82,75,52.23
MonkeyKing,Seraphine,112,58,54,51.79
MonkeyKing,Sivir,85,51,34,60
MonkeyKing,Soraka,71,32,39,45.07
MonkeyKing,Riven,97,50,47,51.55
MonkeyKing,Amumu,212,97,115,45.75
MonkeyKing,Ryze,58,32,26,55.17
MonkeyKing,Jinx,394,185,209,46.95
MonkeyKing,Belveth,45,25,20,55.56
MonkeyKing,Aphelios,90,58,32,64.44
MonkeyKing,Shen,141,67,74,47.52
MonkeyKing,MasterYi,189,99,90,52.38
MonkeyKing,Zilean,45,29,16,64.44
MonkeyKing,JarvanIV,161,77,84,47.83
MonkeyKing,Sion,164,80,84,48.78
MonkeyKing,Evelynn,34,20,14,58.82
MonkeyKing,Xayah,81,31,50,38.27
MonkeyKing,Karthus,54,35,19,64.81
MonkeyKing,Jax,134,85,49,63.43
MonkeyKing,Taliyah,60,27,33,45
MonkeyKing,Syndra,102,66,36,64.71
MonkeyKing,Vladimir,98,46,52,46.94
MonkeyKing,Nocturne,260,108,152,41.54
MonkeyKing,Velkoz,65,34,31,52.31
MonkeyKing,Gnar,111,56,55,50.45
MonkeyKing,RekSai,32,26,6,81.25
MonkeyKing,Kayle,102,53,49,51.96
MonkeyKing,Nunu,103,61,42,59.22
MonkeyKing,Kayn,177,83,94,46.89
MonkeyKing,Ziggs,49,25,24,51.02
MonkeyKing,Veigar,200,108,92,54
MonkeyKing,Viktor,199,103,96,51.76
MonkeyKing,Taric,37,22,15,59.46
MonkeyKing,TahmKench,148,62,86,41.89
MonkeyKing,Senna,104,64,40,61.54
MonkeyKing,Mel,326,172,154,52.76
MonkeyKing,Tristana,129,88,41,68.22
MonkeyKing,Ornn,121,67,54,55.37
MonkeyKing,Qiyana,25,21,4,84
MonkeyKing,Yorick,116,53,63,45.69
MonkeyKing,Thresh,321,151,170,47.04
MonkeyKing,Ekko,122,76,46,62.3
MonkeyKing,Renata,52,30,22,57.69
MonkeyKing,Tryndamere,69,40,29,57.97
MonkeyKing,Sona,25,11,14,44
MonkeyKing,Sylas,263,151,112,57.41
MonkeyKing,Kindred,45,26,19,57.78
MonkeyKing,Katarina,74,38,36,51.35
MonkeyKing,Aatrox,184,98,86,53.26
MonkeyKing,Hecarim,47,32,15,68.09
MonkeyKing,Cassiopeia,56,35,21,62.5
MonkeyKing,Briar,67,41,26,61.19
MonkeyKing,Pyke,193,106,87,54.92
MonkeyKing,Kassadin,26,20,6,76.92
MonkeyKing,Zeri,112,51,61,45.54
MonkeyKing,Fiora,43,17,26,39.53
MonkeyKing,Nilah,57,26,31,45.61
MonkeyKing,Naafiri,37,17,20,45.95
MonkeyKing,Janna,44,18,26,40.91
MonkeyKing,AurelionSol,56,18,38,32.14
MonkeyKing,KogMaw,53,28,25,52.83
MonkeyKing,Malphite,162,90,72,55.56
MonkeyKing,Lissandra,78,42,36,53.85
MonkeyKing,Hwei,147,80,67,54.42
MonkeyKing,Illaoi,64,29,35,45.31
MonkeyKing,Alistar,94,49,45,52.13
MonkeyKing,Nasus,111,58,53,52.25
MonkeyKing,Vi,241,157,84,65.15
MonkeyKing,Brand,60,33,27,55
MonkeyKing,TwistedFate,49,28,21,57.14
MonkeyKing,Urgot,62,38,24,61.29
MonkeyKing,Corki,108,62,46,57.41
MonkeyKing,Shyvana,31,8,23,25.81
MonkeyKing,Akshan,54,28,26,51.85
MonkeyKing,Samira,168,103,65,61.31
MonkeyKing,Braum,111,55,56,49.55
MonkeyKing,DrMundo,89,46,43,51.69
MonkeyKing,Fizz,81,50,31,61.73
MonkeyKing,Annie,60,28,32,46.67
MonkeyKing,Heimerdinger,60,25,35,41.67
MonkeyKing,Vex,73,41,32,56.16
MonkeyKing,Singed,42,20,22,47.62
MonkeyKing,Rengar,38,27,11,71.05
MonkeyKing,Jayce,78,52,26,66.67
MonkeyKing,Zoe,46,29,17,63.04
MonkeyKing,Udyr,70,34,36,48.57
MonkeyKing,Olaf,32,17,15,53.13
MonkeyKing,Maokai,64,28,36,43.75
MonkeyKing,Kennen,44,30,14,68.18
MonkeyKing,Anivia,72,27,45,37.5
MonkeyKing,Skarner,47,28,19,59.57
MonkeyKing,Rammus,39,10,29,25.64
MonkeyKing,Neeko,52,22,30,42.31
MonkeyKing,Kled,31,17,14,54.84
MonkeyKing,Rumble,44,30,14,68.18
Quinn,Garen,116,69,47,59.48
Quinn,MonkeyKing,37,23,14,62.16
Quinn,Lux,161,86,75,53.42
Quinn,Nilah,22,7,15,31.82
Quinn,Lulu,123,70,53,56.91
Quinn,Ornn,35,24,11,68.57
Quinn,Kindred,24,14,10,58.33
Quinn,Talon,39,24,15,61.54
Quinn,Samira,40,19,21,47.5
Quinn,Ashe,147,74,73,50.34
Quinn,Ezreal,166,80,86,48.19
Quinn,Warwick,107,50,57,46.73
Quinn,Xerath,62,30,32,48.39
Quinn,Mordekaiser,79,36,43,45.57
Quinn,TahmKench,79,25,54,31.65
Quinn,Braum,54,27,27,50
Quinn,MasterYi,62,29,33,46.77
Quinn,Karma,99,47,52,47.47
Quinn,Malzahar,80,52,28,65
Quinn,Varus,64,38,26,59.38
Quinn,DrMundo,35,11,24,31.43
Quinn,MissFortune,102,68,34,66.67
Quinn,Aurora,51,21,30,41.18
Quinn,Rakan,49,15,34,30.61
Quinn,Amumu,94,49,45,52.13
Quinn,Malphite,135,62,73,45.93
Quinn,AurelionSol,50,11,39,22
Quinn,Swain,69,27,42,39.13
Quinn,Leona,54,24,30,44.44
Quinn,Zyra,61,34,27,55.74
Quinn,Briar,50,27,23,54
Quinn,TwistedFate,40,26,14,65
Quinn,Sivir,62,30,32,48.39
Quinn,Morgana,89,59,30,66.29
Quinn,Pantheon,138,55,83,39.86
Quinn,Katarina,45,24,21,53.33
Quinn,Vayne,115,67,48,58.26
Quinn,Gangplank,41,17,24,41.46
Quinn,Diana,96,43,53,44.79
Quinn,Galio,82,39,43,47.56
Quinn,Milio,71,34,37,47.89
Quinn,Fizz,27,3,24,11.11
Quinn,Kaisa,143,75,68,52.45
Quinn,Sejuani,48,17,31,35.42
Quinn,Sett,80,33,47,41.25
Quinn,Graves,50,29,21,58
Quinn,Lucian,69,21,48,30.43
Quinn,Gragas,50,17,33,34
Quinn,LeeSin,131,64,67,48.85
Quinn,Tristana,77,42,35,54.55
Quinn,Pyke,50,36,14,72
Quinn,Chogath,95,52,43,54.74
Quinn,Rengar,24,16,8,66.67
Quinn,Mel,165,99,66,60
Quinn,Nautilus,85,38,47,44.71
Quinn,Renekton,71,56,15,78.87
Quinn,Vi,95,43,52,45.26
Quinn,Zed,99,47,52,47.47
Quinn,Rammus,35,14,21,40
Quinn,Akali,61,26,35,42.62
Quinn,Brand,35,22,13,62.86
Quinn,Ekko,87,40,47,45.98
Quinn,KogMaw,28,17,11,60.71
Quinn,Thresh,150,72,78,48
Quinn,Viego,108,56,52,51.85
Quinn,Caitlyn,152,76,76,50
Quinn,Yorick,61,34,27,55.74
Quinn,Jhin,122,60,62,49.18
Quinn,Lillia,47,29,18,61.7
Quinn,Ryze,28,14,14,50
Quinn,Nunu,59,38,21,64.41
Quinn,Irelia,55,29,26,52.73
Quinn,Twitch,58,37,21,63.79
Quinn,Janna,36,27,9,75
Quinn,Fiora,20,15,5,75
Quinn,Viktor,47,30,17,63.83
Quinn,Tryndamere,35,15,20,42.86
Quinn,JarvanIV,63,36,27,57.14
Quinn,Maokai,52,27,25,51.92
Quinn,Yasuo,123,56,67,45.53
Quinn,Azir,36,16,20,44.44
Quinn,Jayce,55,35,20,63.64
Quinn,Nami,96,38,58,39.58
Quinn,Darius,157,62,95,39.49
Quinn,Kayn,74,40,34,54.05
Quinn,Xayah,25,14,11,56
Quinn,Udyr,24,12,12,50
Quinn,Skarner,29,5,24,17.24
Quinn,Ahri,83,44,39,53.01
Quinn,Zeri,33,13,20,39.39
Quinn,Teemo,64,26,38,40.63
Quinn,Nasus,28,13,15,46.43
Quinn,Poppy,38,21,17,55.26
Quinn,Jinx,226,93,133,41.15
Quinn,Senna,42,20,22,47.62
Quinn,Kennen,34,24,10,70.59
Quinn,Khazix,36,21,15,58.33
Quinn,Heimerdinger,38,13,25,34.21
Quinn,Karthus,25,8,17,32
Quinn,Lissandra,24,14,10,58.33
Quinn,Soraka,30,11,19,36.67
Quinn,Bard,28,17,11,60.71
Quinn,Urgot,52,17,35,32.69
Quinn,Blitzcrank,84,50,34,59.52
Quinn,Rumble,23,18,5,78.26
Quinn,Belveth,8,3,5,37.5
Quinn,Yone,101,57,44,56.44
Quinn,Sion,66,33,33,50
Quinn,Zoe,34,15,19,44.12
Quinn,Sylas,102,44,58,43.14
Quinn,Kled,8,5,3,62.5
Quinn,Velkoz,35,11,24,31.43
Quinn,Leblanc,42,27,15,64.29
Quinn,Aphelios,46,31,15,67.39
Quinn,RekSai,13,2,11,15.38
Quinn,Vladimir,40,15,25,37.5
Quinn,Kayle,46,29,17,63.04
Quinn,Elise,47,40,7,85.11
Quinn,Hwei,39,24,15,61.54
Quinn,Aatrox,81,33,48,40.74
Quinn,Rell,55,26,29,47.27
Quinn,Volibear,75,34,41,45.33
Quinn,Singed,18,10,8,55.56
Quinn,Cassiopeia,20,14,6,70
Quinn,Naafiri,18,2,16,11.11
Quinn,Seraphine,52,30,22,57.69
Quinn,Syndra,67,33,34,49.25
Quinn,Akshan,35,21,14,60
Quinn,Nocturne,106,48,58,45.28
Quinn,Ziggs,37,20,17,54.05
Quinn,Anivia,19,9,10,47.37
Quinn,Corki,52,30,22,57.69
Quinn,Hecarim,18,9,9,50
Quinn,Camille,28,12,16,42.86
Quinn,Draven,56,24,32,42.86
Quinn,Trundle,35,17,18,48.57
Quinn,Neeko,40,26,14,65
Quinn,Alistar,51,23,28,45.1
Quinn,Annie,34,13,21,38.24
Quinn,KSante,43,28,15,65.12
Quinn,Veigar,81,47,34,58.02
Quinn,Jax,49,23,26,46.94
Quinn,Ambessa,45,23,22,51.11
Quinn,Yuumi,63,18,45,28.57
Quinn,Gnar,42,8,34,19.05
Quinn,Orianna,36,18,18,50
Quinn,Kassadin,13,8,5,61.54
Quinn,FiddleSticks,36,18,18,50
Quinn,Sona,8,6,2,75
Quinn,Zilean,23,13,10,56.52
Quinn,Taliyah,24,19,5,79.17
Quinn,Riven,16,12,4,75
Quinn,Illaoi,16,13,3,81.25
Quinn,Shaco,34,17,17,50
Quinn,Gwen,24,9,15,37.5
Quinn,Ivern,22,19,3,86.36
Quinn,Smolder,48,22,26,45.83
Quinn,Nidalee,26,16,10,61.54
Quinn,XinZhao,49,36,13,73.47
Quinn,Evelynn,24,7,17,29.17
Quinn,Shen,23,14,9,60.87
Quinn,Kalista,19,11,8,57.89
Quinn,Vex,41,27,14,65.85
Quinn,Taric,17,14,3,82.35
Quinn,Qiyana,14,9,5,64.29
Quinn,Zac,29,14,15,48.28
Quinn,Shyvana,11,3,8,27.27
Quinn,Olaf,19,5,14,26.32
Quinn,Renata,6,3,3,50
Nasus,Mordekaiser,210,117,93,55.71
Nasus,Viego,200,92,108,46
Nasus,Yone,252,125,127,49.6
Nasus,Lucian,118,71,47,60.17
Nasus,Rakan,79,33,46,41.77
Nasus,Ashe,283,147,136,51.94
Nasus,Graves,94,47,47,50
Nasus,Vayne,197,69,128,35.03
Nasus,Draven,63,39,24,61.9
Nasus,Garen,299,143,156,47.83
Nasus,Shyvana,32,18,14,56.25
Nasus,Lissandra,35,14,21,40
Nasus,Lux,337,195,142,57.86
Nasus,Veigar,154,89,65,57.79
Nasus,Kayn,191,93,98,48.69
Nasus,Shaco,100,54,46,54
Nasus,Zoe,61,29,32,47.54
Nasus,KogMaw,60,31,29,51.67
Nasus,TwistedFate,46,33,13,71.74
Nasus,Volibear,173,96,77,55.49
Nasus,MasterYi,154,69,85,44.81
Nasus,Mel,329,181,148,55.02
Nasus,Ezreal,322,168,154,52.17
Nasus,Blitzcrank,122,75,47,61.48
Nasus,Sylas,215,110,105,51.16
Nasus,Evelynn,49,28,21,57.14
Nasus,Varus,103,53,50,51.46
Nasus,Karma,163,99,64,60.74
Nasus,Olaf,54,25,29,46.3
Nasus,Nidalee,56,32,24,57.14
Nasus,Ryze,41,14,27,34.15
Nasus,Caitlyn,336,163,173,48.51
Nasus,Brand,122,56,66,45.9
Nasus,Poppy,85,41,44,48.24
Nasus,Ahri,154,87,67,56.49
Nasus,Nami,177,89,88,50.28
Nasus,Kennen,36,13,23,36.11
Nasus,XinZhao,92,63,29,68.48
Nasus,Morgana,129,67,62,51.94
Nasus,Malphite,196,109,87,55.61
Nasus,Nocturne,170,73,97,42.94
Nasus,Malzahar,134,67,67,50
Nasus,Samira,86,33,53,38.37
Nasus,Pyke,108,63,45,58.33
Nasus,Nunu,103,47,56,45.63
Nasus,Katarina,78,35,43,44.87
Nasus,Swain,149,74,75,49.66
Nasus,Sion,147,91,56,61.9
Nasus,Warwick,193,78,115,40.41
Nasus,Renekton,75,27,48,36
Nasus,Jhin,243,148,95,60.91
Nasus,Thresh,294,158,136,53.74
Nasus,Aatrox,122,80,42,65.57
Nasus,Yasuo,286,123,163,43.01
Nasus,MissFortune,270,151,119,55.93
Nasus,Nautilus,206,115,91,55.83
Nasus,Darius,262,159,103,60.69
Nasus,LeeSin,211,95,116,45.02
Nasus,Syndra,83,55,28,66.27
Nasus,Xayah,84,42,42,50
Nasus,Pantheon,239,119,120,49.79
Nasus,Sett,175,74,101,42.29
Nasus,Lillia,81,29,52,35.8
Nasus,Neeko,48,24,24,50
Nasus,Urgot,87,43,44,49.43
Nasus,FiddleSticks,65,27,38,41.54
Nasus,Kalista,64,31,33,48.44
Nasus,Galio,190,87,103,45.79
Nasus,JarvanIV,111,57,54,51.35
Nasus,Ekko,131,67,64,51.15
Nasus,Sivir,89,46,43,51.69
Nasus,Milio,87,40,47,45.98
Nasus,Yorick,139,75,64,53.96
Nasus,Orianna,68,34,34,50
Nasus,Talon,67,34,33,50.75
Nasus,Nilah,63,26,37,41.27
Nasus,Diana,202,119,83,58.91
Nasus,Janna,51,13,38,25.49
Nasus,Zed,157,101,56,64.33
Nasus,Braum,84,45,39,53.57
Nasus,Twitch,86,49,37,56.98
Nasus,Chogath,143,78,65,54.55
Nasus,Vi,185,87,98,47.03
Nasus,Kaisa,229,116,113,50.66
Nasus,Seraphine,132,63,69,47.73
Nasus,Jax,141,73,68,51.77
Nasus,Alistar,76,42,34,55.26
Nasus,Xerath,112,68,44,60.71
Nasus,Zyra,88,43,45,48.86
Nasus,AurelionSol,86,51,35,59.3
Nasus,Yuumi,108,43,65,39.81
Nasus,Heimerdinger,83,41,42,49.4
Nasus,Ivern,34,25,9,73.53
Nasus,Aurora,100,65,35,65
Nasus,TahmKench,105,61,44,58.1
Nasus,Tryndamere,48,31,17,64.58
Nasus,Gragas,119,80,39,67.23
Nasus,Lulu,162,74,88,45.68
Nasus,Shen,87,44,43,50.57
Nasus,Leona,137,79,58,57.66
Nasus,Kayle,70,41,29,58.57
Nasus,Zac,100,59,41,59
Nasus,Vladimir,81,36,45,44.44
Nasus,Maokai,62,29,33,46.77
Nasus,Ambessa,81,48,33,59.26
Nasus,Sejuani,87,54,33,62.07
Nasus,Jinx,419,222,197,52.98
Nasus,Trundle,104,60,44,57.69
Nasus,Akshan,56,23,33,41.07
Nasus,Gnar,57,42,15,73.68
Nasus,Ziggs,69,43,26,62.32
Nasus,Jayce,79,42,37,53.16
Nasus,Tristana,129,49,80,37.98
Nasus,Gangplank,76,22,54,28.95
Nasus,Soraka,88,51,37,57.95
Nasus,DrMundo,66,34,32,51.52
Nasus,Skarner,69,33,36,47.83
Nasus,Kindred,71,43,28,60.56
Nasus,Teemo,114,53,61,46.49
Nasus,Khazix,71,33,38,46.48
Nasus,Aphelios,44,21,23,47.73
Nasus,Fiora,65,29,36,44.62
Nasus,RekSai,20,8,12,40
Nasus,Leblanc,84,49,35,58.33
Nasus,Amumu,173,89,84,51.45
Nasus,Karthus,36,33,3,91.67
Nasus,Illaoi,73,39,34,53.42
Nasus,KSante,70,50,20,71.43
Nasus,Viktor,147,59,88,40.14
Nasus,Bard,39,19,20,48.72
Nasus,Riven,68,35,33,51.47
Nasus,Corki,52,40,12,76.92
Nasus,Zeri,79,31,48,39.24
Nasus,Rengar,31,18,13,58.06
Nasus,Briar,72,37,35,51.39
Nasus,Zilean,51,26,25,50.98
Nasus,Smolder,132,63,69,47.73
Nasus,Quinn,28,15,13,53.57
Nasus,Belveth,32,22,10,68.75
Nasus,Hwei,107,60,47,56.07
Nasus,Udyr,19,17,2,89.47
Nasus,Annie,44,22,22,50
Nasus,Rell,60,27,33,45
Nasus,Velkoz,98,46,52,46.94
Nasus,Sona,33,11,22,33.33
Nasus,Gwen,50,36,14,72
Nasus,MonkeyKing,111,53,58,47.75
Nasus,Vex,81,37,44,45.68
Nasus,Elise,108,47,61,43.52
Nasus,Azir,58,36,22,62.07
Nasus,Hecarim,40,13,27,32.5
Nasus,Camille,82,46,36,56.1
Nasus,Cassiopeia,27,19,8,70.37
Nasus,Fizz,87,58,29,66.67
Nasus,Senna,102,35,67,34.31
Nasus,Akali,111,67,44,60.36
Nasus,Irelia,49,26,23,53.06
Nasus,Rammus,37,21,16,56.76
Nasus,Singed,63,26,37,41.27
Nasus,Taliyah,32,15,17,46.88
Nasus,Naafiri,31,20,11,64.52
Nasus,Qiyana,24,10,14,41.67
Nasus,Anivia,25,12,13,48
Nasus,Ornn,81,35,46,43.21
Nasus,Rumble,35,24,11,68.57
Nasus,Renata,28,14,14,50
Nasus,Kassadin,24,16,8,66.67
Nasus,Kled,14,9,5,64.29
Nasus,Taric,17,12,5,70.59
Kled,Teemo,23,2,21,8.7
Kled,Warwick,59,21,38,35.59
Kled,Nunu,20,8,12,40
Kled,Lucian,31,20,11,64.52
Kled,Leona,43,23,20,53.49
Kled,Vayne,44,25,19,56.82
Kled,Ivern,13,11,2,84.62
Kled,Qiyana,9,6,3,66.67
Kled,Ahri,67,35,32,52.24
Kled,Seraphine,34,24,10,70.59
Kled,Darius,85,35,50,41.18
Kled,Pantheon,73,26,47,35.62
Kled,Lux,74,24,50,32.43
Kled,Kaisa,83,29,54,34.94
Kled,Pyke,60,30,30,50
Kled,Ornn,42,25,17,59.52
Kled,Vi,50,19,31,38
Kled,Kennen,23,15,8,65.22
Kled,Varus,44,19,25,43.18
Kled,Renata,23,17,6,73.91
Kled,Jax,31,16,15,51.61
Kled,Elise,37,23,14,62.16
Kled,Riven,14,11,3,78.57
Kled,Ashe,103,58,45,56.31
Kled,Nautilus,43,30,13,69.77
Kled,Gangplank,28,8,20,28.57
Kled,Briar,23,8,15,34.78
Kled,Hwei,30,14,16,46.67
Kled,Jinx,94,34,60,36.17
Kled,Zilean,19,11,8,57.89
Kled,Garen,82,42,40,51.22
Kled,Vladimir,25,5,20,20
Kled,Caitlyn,114,51,63,44.74
Kled,Gnar,19,10,9,52.63
Kled,Akali,56,28,28,50
Kled,LeeSin,91,52,39,57.14
Kled,MissFortune,72,36,36,50
Kled,TahmKench,25,20,5,80
Kled,Rammus,15,9,6,60
Kled,Diana,71,34,37,47.89
Kled,Nilah,16,11,5,68.75
Kled,Blitzcrank,33,22,11,66.67
Kled,Olaf,25,14,11,56
Kled,Volibear,58,32,26,55.17
Kled,Malzahar,47,26,21,55.32
Kled,Aatrox,64,30,34,46.88
Kled,Ekko,39,24,15,61.54
Kled,Orianna,40,19,21,47.5
Kled,Aphelios,17,8,9,47.06
Kled,Alistar,25,11,14,44
Kled,Gragas,28,14,14,50
Kled,Yasuo,64,43,21,67.19
Kled,Bard,22,13,9,59.09
Kled,Leblanc,23,11,12,47.83
Kled,Yone,69,36,33,52.17
Kled,Jhin,75,43,32,57.33
Kled,Lulu,91,53,38,58.24
Kled,Illaoi,16,8,8,50
Kled,FiddleSticks,21,7,14,33.33
Kled,Aurora,44,26,18,59.09
Kled,Zyra,30,20,10,66.67
Kled,Viego,40,25,15,62.5
Kled,Sion,31,20,11,64.52
Kled,Yorick,17,6,11,35.29
Kled,Fizz,25,12,13,48
Kled,Soraka,20,11,9,55
Kled,Zed,47,19,28,40.43
Kled,Nami,66,28,38,42.42
Kled,Draven,25,14,11,56
Kled,Skarner,22,11,11,50
Kled,Vex,18,12,6,66.67
Kled,Sett,60,32,28,53.33
Kled,Ezreal,99,46,53,46.46
Kled,Mordekaiser,71,40,31,56.34
Kled,Corki,35,17,18,48.57
Kled,Morgana,42,17,25,40.48
Kled,Kassadin,11,3,8,27.27
Kled,Trundle,24,16,8,66.67
Kled,Ambessa,40,17,23,42.5
Kled,Sylas,56,24,32,42.86
Kled,Hecarim,16,10,6,62.5
Kled,Veigar,24,15,9,62.5
Kled,Velkoz,32,9,23,28.13
Kled,Tristana,34,23,11,67.65
Kled,Poppy,28,16,12,57.14
Kled,Udyr,21,11,10,52.38
Kled,Smolder,35,18,17,51.43
Kled,Taliyah,18,12,6,66.67
Kled,Quinn,8,3,5,37.5
Kled,Milio,23,17,6,73.91
Kled,Shyvana,15,7,8,46.67
Kled,KogMaw,11,8,3,72.73
Kled,Fiora,7,0,7,0
Kled,Mel,94,59,35,62.77
Kled,AurelionSol,19,11,8,57.89
Kled,Kayn,23,13,10,56.52
Kled,Xerath,30,17,13,56.67
Kled,Chogath,59,25,34,42.37
Kled,Zoe,16,7,9,43.75
Kled,JarvanIV,32,17,15,53.13
Kled,Camille,17,11,6,64.71
Kled,Nocturne,34,12,22,35.29
Kled,Karma,32,18,14,56.25
Kled,Syndra,37,12,25,32.43
Kled,Yuumi,29,5,24,17.24
Kled,Shaco,29,21,8,72.41
Kled,Naafiri,8,3,5,37.5
Kled,Twitch,36,19,17,52.78
Kled,Belveth,6,0,6,0
Kled,Tryndamere,19,10,9,52.63
Kled,Khazix,26,3,23,11.54
Kled,Jayce,16,10,6,62.5
Kled,Sejuani,25,13,12,52
Kled,Singed,8,6,2,75
Kled,Amumu,39,15,24,38.46
Kled,Sivir,15,3,12,20
Kled,Taric,8,5,3,62.5
Kled,Rengar,18,6,12,33.33
Kled,Anivia,17,8,9,47.06
Kled,Ziggs,14,10,4,71.43
Kled,Neeko,15,9,6,60
Kled,Irelia,22,8,14,36.36
Kled,Kindred,24,11,13,45.83
Kled,Galio,58,21,37,36.21
Kled,DrMundo,28,18,10,64.29
Kled,Cassiopeia,16,7,9,43.75
Kled,Senna,25,11,14,44
Kled,Lillia,23,23,0,100
Kled,TwistedFate,7,5,2,71.43
Kled,Renekton,31,18,13,58.06
Kled,Karthus,5,0,5,0
Kled,Katarina,17,9,8,52.94
Kled,Thresh,58,19,39,32.76
Kled,Zeri,28,19,9,67.86
Kled,Rakan,9,2,7,22.22
Kled,Heimerdinger,20,7,13,35
Kled,Braum,27,17,10,62.96
Kled,Urgot,19,15,4,78.95
Kled,Brand,26,13,13,50
Kled,MasterYi,34,13,21,38.24
Kled,Swain,37,19,18,51.35
Kled,Shen,32,13,19,40.63
Kled,Kalista,17,8,9,47.06
Kled,Rumble,20,10,10,50
Kled,Rell,27,14,13,51.85
Kled,Ryze,17,12,5,70.59
Kled,Maokai,25,11,14,44
Kled,Talon,19,6,13,31.58
Kled,Lissandra,15,9,6,60
Kled,Malphite,27,14,13,51.85
Kled,Viktor,39,16,23,41.03
Kled,XinZhao,31,14,17,45.16
Kled,Gwen,21,13,8,61.9
Kled,Samira,23,8,15,34.78
Kled,MonkeyKing,31,14,17,45.16
Kled,Akshan,11,5,6,45.45
Kled,Kayle,18,6,12,33.33
Kled,Nasus,14,5,9,35.71
Kled,Nidalee,10,7,3,70
Kled,Sona,8,8,0,100
Kled,KSante,28,11,17,39.29
Kled,RekSai,5,2,3,40
Kled,Graves,29,20,9,68.97
Kled,Xayah,14,3,11,21.43
Kled,Azir,17,11,6,64.71
Kled,Zac,24,12,12,50
Kled,Janna,9,0,9,0
Kled,Annie,8,0,8,0
Kled,Evelynn,6,6,0,100
Thresh,Teemo,339,169,170,49.85
Thresh,Warwick,519,288,231,55.49
Thresh,Nunu,271,121,150,44.65
Thresh,Lucian,389,208,181,53.47
Thresh,Leona,531,277,254,52.17
Thresh,Ashe,859,440,419,51.22
Thresh,Graves,377,196,181,51.99
Thresh,Vayne,516,237,279,45.93
Thresh,Draven,196,117,79,59.69
Thresh,Yorick,321,161,160,50.16
Thresh,Diana,601,314,287,52.25
Thresh,Yasuo,813,384,429,47.23
Thresh,Lulu,717,360,357,50.21
Thresh,Rengar,115,68,47,59.13
Thresh,Irelia,340,166,174,48.82
Thresh,Nautilus,629,299,330,47.54
Thresh,Malphite,496,267,229,53.83
Thresh,Ivern,74,41,33,55.41
Thresh,Ahri,644,336,308,52.17
Thresh,TahmKench,442,213,229,48.19
Thresh,JarvanIV,384,175,209,45.57
Thresh,Veigar,369,171,198,46.34
Thresh,Gangplank,271,167,104,61.62
Thresh,XinZhao,290,118,172,40.69
Thresh,Azir,148,90,58,60.81
Thresh,Kaisa,788,382,406,48.48
Thresh,Lux,983,468,515,47.61
Thresh,Shen,324,132,192,40.74
Thresh,Viego,582,307,275,52.75
Thresh,Corki,206,88,118,42.72
Thresh,Gragas,342,190,152,55.56
Thresh,Qiyana,91,53,38,58.24
Thresh,Kalista,126,74,52,58.73
Thresh,Neeko,201,78,123,38.81
Thresh,Sett,580,316,264,54.48
Thresh,KogMaw,126,63,63,50
Thresh,Gwen,243,126,117,51.85
Thresh,Amumu,477,245,232,51.36
Thresh,DrMundo,240,121,119,50.42
Thresh,Tristana,404,232,172,57.43
Thresh,Chogath,564,230,334,40.78
Thresh,MasterYi,389,179,210,46.02
Thresh,AurelionSol,167,83,84,49.7
Thresh,Naafiri,130,42,88,32.31
Thresh,Caitlyn,1017,493,524,48.48
Thresh,Morgana,407,185,222,45.45
Thresh,Yuumi,438,232,206,52.97
Thresh,Trundle,186,81,105,43.55
Thresh,Janna,138,55,83,39.86
Thresh,Ornn,207,79,128,38.16
Thresh,Zac,286,162,124,56.64
Thresh,Zed,416,203,213,48.8
Thresh,Varus,439,214,225,48.75
Thresh,Soraka,151,85,66,56.29
Thresh,Ziggs,128,61,67,47.66
Thresh,Hwei,260,131,129,50.38
Thresh,Zoe,142,72,70,50.7
Thresh,Jayce,220,120,100,54.55
Thresh,Elise,327,163,164,49.85
Thresh,Twitch,256,133,123,51.95
Thresh,Gnar,193,104,89,53.89
Thresh,MissFortune,776,383,393,49.36
Thresh,Karma,624,351,273,56.25
Thresh,Vladimir,295,135,160,45.76
Thresh,Lillia,325,179,146,55.08
Thresh,Galio,504,265,239,52.58
Thresh,Pyke,373,176,197,47.18
Thresh,Singed,109,61,48,55.96
Thresh,Leblanc,305,155,150,50.82
Thresh,Katarina,269,109,160,40.52
Thresh,Annie,125,75,50,60
Thresh,Jhin,741,386,355,52.09
Thresh,Ezreal,1143,639,504,55.91
Thresh,Ekko,280,126,154,45
Thresh,Nasus,294,136,158,46.26
Thresh,Alistar,307,160,147,52.12
Thresh,Riven,171,91,80,53.22
Thresh,Skarner,190,105,85,55.26
Thresh,Mordekaiser,496,248,248,50
Thresh,Aphelios,217,124,93,57.14
Thresh,Nami,377,177,200,46.95
Thresh,Khazix,171,92,79,53.8
Thresh,Heimerdinger,162,72,90,44.44
Thresh,Jinx,1026,448,578,43.66
Thresh,Garen,679,309,370,45.51
Thresh,Kennen,145,59,86,40.69
Thresh,Volibear,433,194,239,44.8
Thresh,Kayn,484,249,235,51.45
Thresh,LeeSin,835,426,409,51.02
Thresh,Syndra,303,168,135,55.45
Thresh,Blitzcrank,383,217,166,56.66
Thresh,Mel,848,440,408,51.89
Thresh,Karthus,94,47,47,50
Thresh,Darius,814,394,420,48.4
Thresh,Sejuani,285,129,156,45.26
Thresh,Briar,198,93,105,46.97
Thresh,Zilean,159,82,77,51.57
Thresh,TwistedFate,153,91,62,59.48
Thresh,Malzahar,424,207,217,48.82
Thresh,Braum,428,173,255,40.42
Thresh,Bard,157,75,82,47.77
Thresh,Swain,496,205,291,41.33
Thresh,Renata,113,63,50,55.75
Thresh,Pantheon,762,396,366,51.97
Thresh,Ambessa,289,130,159,44.98
Thresh,Rell,290,149,141,51.38
Thresh,Milio,283,122,161,43.11
Thresh,Kindred,186,125,61,67.2
Thresh,Fiora,110,59,51,53.64
Thresh,Rakan,255,119,136,46.67
Thresh,Aurora,411,213,198,51.82
Thresh,Talon,255,147,108,57.65
Thresh,Vi,482,208,274,43.15
Thresh,Sion,430,217,213,50.47
Thresh,Samira,262,112,150,42.75
Thresh,Evelynn,105,54,51,51.43
Thresh,Xayah,278,137,141,49.28
Thresh,Aatrox,560,323,237,57.68
Thresh,Kassadin,68,43,25,63.24
Thresh,KSante,348,209,139,60.06
Thresh,Taric,116,44,72,37.93
Thresh,Kayle,157,80,77,50.96
Thresh,Cassiopeia,97,45,52,46.39
Thresh,Tryndamere,141,54,87,38.3
Thresh,Hecarim,144,76,68,52.78
Thresh,Poppy,270,126,144,46.67
Thresh,Olaf,106,47,59,44.34
Thresh,Sylas,639,339,300,53.05
Thresh,RekSai,53,32,21,60.38
Thresh,Senna,247,156,91,63.16
Thresh,Jax,363,185,178,50.96
Thresh,Viktor,451,231,220,51.22
Thresh,Rammus,126,63,63,50
Thresh,Shaco,316,167,149,52.85
Thresh,Akali,402,214,188,53.23
Thresh,Maokai,193,73,120,37.82
Thresh,Zeri,232,137,95,59.05
Thresh,Orianna,214,117,97,54.67
Thresh,Zyra,361,141,220,39.06
Thresh,Seraphine,307,144,163,46.91
Thresh,Ryze,153,78,75,50.98
Thresh,Urgot,162,80,82,49.38
Thresh,Renekton,189,89,100,47.09
Thresh,Yone,723,344,379,47.58
Thresh,Fizz,143,80,63,55.94
Thresh,FiddleSticks,229,117,112,51.09
Thresh,Nocturne,495,232,263,46.87
Thresh,Xerath,403,234,169,58.06
Thresh,Velkoz,233,121,112,51.93
Thresh,Quinn,150,78,72,52
Thresh,MonkeyKing,321,170,151,52.96
Thresh,Brand,205,88,117,42.93
Thresh,Illaoi,189,107,82,56.61
Thresh,Sona,60,34,26,56.67
Thresh,Shyvana,63,24,39,38.1
Thresh,Lissandra,189,104,85,55.03
Thresh,Anivia,172,74,98,43.02
Thresh,Taliyah,101,40,61,39.6
Thresh,Rumble,143,56,87,39.16
Thresh,Camille,169,83,86,49.11
Thresh,Sivir,317,151,166,47.63
Thresh,Udyr,151,93,58,61.59
Thresh,Vex,202,93,109,46.04
Thresh,Smolder,279,124,155,44.44
Thresh,Nidalee,159,93,66,58.49
Thresh,Belveth,106,45,61,42.45
Thresh,Akshan,116,63,53,54.31
Thresh,Nilah,120,73,47,60.83
Thresh,Kled,58,39,19,67.24
Nunu,Kled,20,12,8,60
Nunu,Kayn,166,82,84,49.4
Nunu,Katarina,92,58,34,63.04
Nunu,Twitch,125,70,55,56
Nunu,Thresh,271,150,121,55.35
Nunu,Irelia,98,52,46,53.06
Nunu,LeeSin,220,105,115,47.73
Nunu,Zed,143,76,67,53.15
Nunu,Caitlyn,359,178,181,49.58
Nunu,Morgana,158,66,92,41.77
Nunu,Teemo,138,54,84,39.13
Nunu,Renekton,68,34,34,50
Nunu,Kassadin,42,19,23,45.24
Nunu,Jinx,362,155,207,42.82
Nunu,Soraka,64,31,33,48.44
Nunu,MasterYi,140,60,80,42.86
Nunu,Warwick,242,121,121,50
Nunu,Kaisa,213,120,93,56.34
Nunu,Pyke,120,62,58,51.67
Nunu,Yorick,173,76,97,43.93
Nunu,Skarner,63,37,26,58.73
Nunu,Mel,327,170,157,51.99
Nunu,Smolder,97,39,58,40.21
Nunu,Senna,97,47,50,48.45
Nunu,Jayce,40,22,18,55
Nunu,Graves,116,30,86,25.86
Nunu,Lux,313,158,155,50.48
Nunu,Seraphine,88,39,49,44.32
Nunu,Nasus,103,56,47,54.37
Nunu,Vi,149,92,57,61.74
Nunu,Galio,208,92,116,44.23
Nunu,Kayle,74,25,49,33.78
Nunu,Jax,96,50,46,52.08
Nunu,XinZhao,61,26,35,42.62
Nunu,Azir,54,19,35,35.19
Nunu,Rell,95,47,48,49.47
Nunu,Varus,159,62,97,38.99
Nunu,Pantheon,294,146,148,49.66
Nunu,Vex,61,34,27,55.74
Nunu,Jhin,242,134,108,55.37
Nunu,Riven,56,43,13,76.79
Nunu,Nocturne,232,128,104,55.17
Nunu,Akali,148,80,68,54.05
Nunu,Ashe,245,126,119,51.43
Nunu,Mordekaiser,187,100,87,53.48
Nunu,Yasuo,209,76,133,36.36
Nunu,Aphelios,89,33,56,37.08
Nunu,Nami,170,69,101,40.59
Nunu,Aatrox,137,57,80,41.61
Nunu,Ekko,128,65,63,50.78
Nunu,Ezreal,381,184,197,48.29
Nunu,Singed,29,15,14,51.72
Nunu,Urgot,89,54,35,60.67
Nunu,Lissandra,72,41,31,56.94
Nunu,Brand,94,42,52,44.68
Nunu,Leona,183,76,107,41.53
Nunu,Veigar,169,73,96,43.2
Nunu,Elise,95,35,60,36.84
Nunu,Zac,81,48,33,59.26
Nunu,JarvanIV,98,53,45,54.08
Nunu,Sivir,62,30,32,48.39
Nunu,Milio,80,46,34,57.5
Nunu,MissFortune,295,131,164,44.41
Nunu,Zyra,100,40,60,40
Nunu,Ambessa,117,58,59,49.57
Nunu,Chogath,214,91,123,42.52
Nunu,Braum,107,35,72,32.71
Nunu,Trundle,87,35,52,40.23
Nunu,Leblanc,73,39,34,53.42
Nunu,FiddleSticks,85,24,61,28.24
Nunu,DrMundo,79,43,36,54.43
Nunu,Vladimir,90,55,35,61.11
Nunu,Gangplank,46,28,18,60.87
Nunu,Sett,212,96,116,45.28
Nunu,TahmKench,113,47,66,41.59
Nunu,Yone,269,118,151,43.87
Nunu,Maokai,93,59,34,63.44
Nunu,Ziggs,64,28,36,43.75
Nunu,Kindred,67,35,32,52.24
Nunu,Garen,189,77,112,40.74
Nunu,Annie,24,15,9,62.5
Nunu,Diana,222,97,125,43.69
Nunu,Tristana,144,73,71,50.69
Nunu,Nautilus,190,65,125,34.21
Nunu,TwistedFate,47,20,27,42.55
Nunu,Nilah,50,25,25,50
Nunu,Ryze,56,33,23,58.93
Nunu,Ahri,199,99,100,49.75
Nunu,Briar,72,30,42,41.67
Nunu,Sylas,184,92,92,50
Nunu,Vayne,165,70,95,42.42
Nunu,Yuumi,111,61,50,54.95
Nunu,Shen,137,71,66,51.82
Nunu,Velkoz,113,48,65,42.48
Nunu,Malzahar,135,63,72,46.67
Nunu,Malphite,179,75,104,41.9
Nunu,Hwei,104,66,38,63.46
Nunu,MonkeyKing,103,42,61,40.78
Nunu,Poppy,88,47,41,53.41
Nunu,Taliyah,28,15,13,53.57
Nunu,Talon,64,35,29,54.69
Nunu,Janna,35,13,22,37.14
Nunu,Cassiopeia,47,32,15,68.09
Nunu,Olaf,36,21,15,58.33
Nunu,Swain,148,66,82,44.59
Nunu,Samira,123,69,54,56.1
Nunu,Rakan,66,30,36,45.45
Nunu,Naafiri,57,14,43,24.56
Nunu,Evelynn,74,42,32,56.76
Nunu,Draven,91,32,59,35.16
Nunu,Shaco,125,78,47,62.4
Nunu,Xerath,141,60,81,42.55
Nunu,Lulu,182,99,83,54.4
Nunu,Orianna,67,35,32,52.24
Nunu,Kalista,38,15,23,39.47
Nunu,Heimerdinger,67,32,35,47.76
Nunu,Rammus,36,28,8,77.78
Nunu,KogMaw,45,17,28,37.78
Nunu,Quinn,59,21,38,35.59
Nunu,Gwen,68,23,45,33.82
Nunu,Akshan,57,32,25,56.14
Nunu,Darius,297,117,180,39.39
Nunu,AurelionSol,71,27,44,38.03
Nunu,Ornn,82,36,46,43.9
Nunu,Viego,160,75,85,46.88
Nunu,Hecarim,52,26,26,50
Nunu,Bard,60,24,36,40
Nunu,Sejuani,80,33,47,41.25
Nunu,Volibear,148,95,53,64.19
Nunu,Udyr,49,24,25,48.98
Nunu,Fiora,45,23,22,51.11
Nunu,Corki,73,33,40,45.21
Nunu,Lillia,64,29,35,45.31
Nunu,Tryndamere,63,38,25,60.32
Nunu,Gragas,100,54,46,54
Nunu,Viktor,127,59,68,46.46
Nunu,Lucian,104,57,47,54.81
Nunu,Khazix,64,39,25,60.94
Nunu,Xayah,75,39,36,52
Nunu,Aurora,86,53,33,61.63
Nunu,Alistar,63,31,32,49.21
Nunu,Fizz,82,36,46,43.9
Nunu,Zeri,58,29,29,50
Nunu,Karma,163,84,79,51.53
Nunu,Rengar,38,25,13,65.79
Nunu,Amumu,219,90,129,41.1
Nunu,Shyvana,39,13,26,33.33
Nunu,Zilean,39,8,31,20.51
Nunu,Sion,128,51,77,39.84
Nunu,Belveth,20,11,9,55
Nunu,Gnar,75,46,29,61.33
Nunu,Karthus,33,10,23,30.3
Nunu,Sona,33,20,13,60.61
Nunu,RekSai,17,5,12,29.41
Nunu,Neeko,48,23,25,47.92
Nunu,Kennen,39,13,26,33.33
Nunu,Taric,39,23,16,58.97
Nunu,Syndra,92,30,62,32.61
Nunu,Anivia,53,22,31,41.51
Nunu,Qiyana,27,16,11,59.26
Nunu,Renata,18,9,9,50
Nunu,Blitzcrank,109,55,54,50.46
Nunu,Rumble,43,23,20,53.49
Nunu,KSante,81,29,52,35.8
Nunu,Zoe,48,28,20,58.33
Nunu,Nidalee,42,27,15,64.29
Nunu,Camille,49,29,20,59.18
Nunu,Illaoi,90,38,52,42.22
Nunu,Ivern,38,15,23,39.47
Heimerdinger,Yone,156,82,74,52.56
Heimerdinger,JarvanIV,50,27,23,54
Heimerdinger,Ryze,61,31,30,50.82
Heimerdinger,Draven,70,18,52,25.71
Heimerdinger,Blitzcrank,73,29,44,39.73
Heimerdinger,Yorick,83,37,46,44.58
Heimerdinger,Diana,149,75,74,50.34
Heimerdinger,Yasuo,195,87,108,44.62
Heimerdinger,Ashe,213,103,110,48.36
Heimerdinger,Lulu,135,73,62,54.07
Heimerdinger,Vladimir,59,28,31,47.46
Heimerdinger,Lux,238,106,132,44.54
Heimerdinger,Amumu,102,42,60,41.18
Heimerdinger,Rell,97,40,57,41.24
Heimerdinger,Mel,182,74,108,40.66
Heimerdinger,Nocturne,124,70,54,56.45
Heimerdinger,Galio,145,75,70,51.72
Heimerdinger,Illaoi,47,20,27,42.55
Heimerdinger,Senna,67,31,36,46.27
Heimerdinger,Varus,93,51,42,54.84
Heimerdinger,Pantheon,162,88,74,54.32
Heimerdinger,Vex,66,34,32,51.52
Heimerdinger,Jhin,188,81,107,43.09
Heimerdinger,Gnar,56,21,35,37.5
Heimerdinger,Belveth,24,12,12,50
Heimerdinger,Hwei,68,35,33,51.47
Heimerdinger,Samira,80,45,35,56.25
Heimerdinger,TahmKench,90,46,44,51.11
Heimerdinger,Malphite,110,63,47,57.27
Heimerdinger,Kayn,125,65,60,52
Heimerdinger,Sylas,116,63,53,54.31
Heimerdinger,Lucian,81,36,45,44.44
Heimerdinger,FiddleSticks,43,24,19,55.81
Heimerdinger,Ezreal,219,100,119,45.66
Heimerdinger,Urgot,38,8,30,21.05
Heimerdinger,Kindred,50,23,27,46
Heimerdinger,Veigar,135,75,60,55.56
Heimerdinger,MissFortune,215,117,98,54.42
Heimerdinger,Darius,176,79,97,44.89
Heimerdinger,Warwick,184,85,99,46.2
Heimerdinger,Taliyah,22,9,13,40.91
Heimerdinger,Xayah,74,24,50,32.43
Heimerdinger,Karma,93,39,54,41.94
Heimerdinger,Lillia,62,17,45,27.42
Heimerdinger,Thresh,162,90,72,55.56
Heimerdinger,Fizz,45,26,19,57.78
Heimerdinger,Caitlyn,232,122,110,52.59
Heimerdinger,Nautilus,136,55,81,40.44
Heimerdinger,Sett,130,64,66,49.23
Heimerdinger,Neeko,42,21,21,50
Heimerdinger,Swain,119,49,70,41.18
Heimerdinger,Aatrox,71,36,35,50.7
Heimerdinger,Annie,38,20,18,52.63
Heimerdinger,Mordekaiser,135,81,54,60
Heimerdinger,Sejuani,45,13,32,28.89
Heimerdinger,Zoe,27,16,11,59.26
Heimerdinger,Zilean,36,14,22,38.89
Heimerdinger,LeeSin,127,82,45,64.57
Heimerdinger,Gragas,63,29,34,46.03
Heimerdinger,Ekko,75,41,34,54.67
Heimerdinger,Kaisa,123,73,50,59.35
Heimerdinger,Nami,80,48,32,60
Heimerdinger,Teemo,129,67,62,51.94
Heimerdinger,Vayne,119,60,59,50.42
Heimerdinger,Corki,37,28,9,75.68
Heimerdinger,Graves,58,16,42,27.59
Heimerdinger,TwistedFate,24,14,10,58.33
Heimerdinger,Anivia,22,5,17,22.73
Heimerdinger,Camille,25,12,13,48
Heimerdinger,Zed,99,42,57,42.42
Heimerdinger,Jinx,274,103,171,37.59
Heimerdinger,Sona,20,9,11,45
Heimerdinger,Akali,116,72,44,62.07
Heimerdinger,Rammus,42,22,20,52.38
Heimerdinger,Fiora,35,11,24,31.43
Heimerdinger,Nidalee,28,14,14,50
Heimerdinger,Tristana,69,35,34,50.72
Heimerdinger,Ambessa,53,31,22,58.49
Heimerdinger,Pyke,59,29,30,49.15
Heimerdinger,Renekton,27,16,11,59.26
Heimerdinger,XinZhao,93,58,35,62.37
Heimerdinger,Leona,113,67,46,59.29
Heimerdinger,AurelionSol,38,22,16,57.89
Heimerdinger,Shaco,86,44,42,51.16
Heimerdinger,Morgana,114,57,57,50
Heimerdinger,Seraphine,77,40,37,51.95
Heimerdinger,Soraka,40,23,17,57.5
Heimerdinger,Ahri,114,65,49,57.02
Heimerdinger,Twitch,90,47,43,52.22
Heimerdinger,Nasus,83,42,41,50.6
Heimerdinger,Singed,25,10,15,40
Heimerdinger,Kalista,16,9,7,56.25
Heimerdinger,Kennen,34,23,11,67.65
Heimerdinger,Smolder,82,51,31,62.2
Heimerdinger,Renata,33,13,20,39.39
Heimerdinger,Khazix,61,31,30,50.82
Heimerdinger,Viego,152,57,95,37.5
Heimerdinger,Katarina,62,30,32,48.39
Heimerdinger,Chogath,116,42,74,36.21
Heimerdinger,Taric,14,6,8,42.86
Heimerdinger,Akshan,28,5,23,17.86
Heimerdinger,Zyra,86,48,38,55.81
Heimerdinger,Milio,38,25,13,65.79
Heimerdinger,DrMundo,75,43,32,57.33
Heimerdinger,Aurora,66,35,31,53.03
Heimerdinger,Viktor,97,42,55,43.3
Heimerdinger,Shyvana,26,8,18,30.77
Heimerdinger,Olaf,34,24,10,70.59
Heimerdinger,Zac,57,32,25,56.14
Heimerdinger,Briar,63,35,28,55.56
Heimerdinger,Nunu,67,35,32,52.24
Heimerdinger,Qiyana,22,11,11,50
Heimerdinger,Aphelios,51,40,11,78.43
Heimerdinger,Jayce,55,26,29,47.27
Heimerdinger,Rakan,64,33,31,51.56
Heimerdinger,MasterYi,92,47,45,51.09
Heimerdinger,Xerath,88,36,52,40.91
Heimerdinger,Udyr,36,17,19,47.22
Heimerdinger,Azir,26,14,12,53.85
Heimerdinger,Evelynn,25,14,11,56
Heimerdinger,Ziggs,45,20,25,44.44
Heimerdinger,KSante,42,21,21,50
Heimerdinger,Syndra,85,35,50,41.18
Heimerdinger,Quinn,38,25,13,65.79
Heimerdinger,Ornn,48,21,27,43.75
Heimerdinger,Tryndamere,47,18,29,38.3
Heimerdinger,Velkoz,64,23,41,35.94
Heimerdinger,Irelia,87,37,50,42.53
Heimerdinger,Yuumi,101,49,52,48.51
Heimerdinger,Brand,59,38,21,64.41
Heimerdinger,Cassiopeia,26,5,21,19.23
Heimerdinger,Volibear,92,59,33,64.13
Heimerdinger,Malzahar,111,52,59,46.85
Heimerdinger,Poppy,51,21,30,41.18
Heimerdinger,Garen,144,54,90,37.5
Heimerdinger,Lissandra,28,18,10,64.29
Heimerdinger,Jax,51,22,29,43.14
Heimerdinger,Elise,73,56,17,76.71
Heimerdinger,Kayle,52,21,31,40.38
Heimerdinger,Zeri,44,21,23,47.73
Heimerdinger,Sion,85,43,42,50.59
Heimerdinger,KogMaw,27,14,13,51.85
Heimerdinger,Braum,58,17,41,29.31
Heimerdinger,MonkeyKing,60,35,25,58.33
Heimerdinger,Maokai,36,13,23,36.11
Heimerdinger,Naafiri,30,16,14,53.33
Heimerdinger,Nilah,20,10,10,50
Heimerdinger,Riven,19,12,7,63.16
Heimerdinger,Kassadin,22,8,14,36.36
Heimerdinger,Orianna,88,30,58,34.09
Heimerdinger,Rengar,14,5,9,35.71
Heimerdinger,Ivern,26,20,6,76.92
Heimerdinger,Hecarim,33,14,19,42.42
Heimerdinger,Trundle,33,15,18,45.45
Heimerdinger,Vi,135,53,82,39.26
Heimerdinger,Shen,61,26,35,42.62
Heimerdinger,Alistar,46,18,28,39.13
Heimerdinger,Skarner,26,12,14,46.15
Heimerdinger,Karthus,11,6,5,54.55
Heimerdinger,Gangplank,49,37,12,75.51
Heimerdinger,Kled,20,13,7,65
Heimerdinger,Bard,23,11,12,47.83
Heimerdinger,Gwen,41,28,13,68.29
Heimerdinger,Sivir,57,30,27,52.63
Heimerdinger,Rumble,12,10,2,83.33
Heimerdinger,Talon,27,15,12,55.56
Heimerdinger,Leblanc,15,11,4,73.33
Heimerdinger,RekSai,8,5,3,62.5
Heimerdinger,Janna,8,6,2,75
Ryze,Jax,50,25,25,50
Ryze,Sejuani,77,32,45,41.56
Ryze,Hwei,65,38,27,58.46
Ryze,Ezreal,253,132,121,52.17
Ryze,Zac,69,21,48,30.43
Ryze,Heimerdinger,61,30,31,49.18
Ryze,Gragas,66,33,33,50
Ryze,Viktor,114,58,56,50.88
Ryze,Jinx,237,108,129,45.57
Ryze,Pyke,62,26,36,41.94
Ryze,Garen,115,54,61,46.96
Ryze,Warwick,140,62,78,44.29
Ryze,Ahri,156,71,85,45.51
Ryze,Milio,68,27,41,39.71
Ryze,Nasus,41,27,14,65.85
Ryze,Viego,144,76,68,52.78
Ryze,Cassiopeia,38,18,20,47.37
Ryze,Karma,139,61,78,43.88
Ryze,Teemo,123,69,54,56.1
Ryze,Rammus,32,9,23,28.13
Ryze,Leblanc,36,23,13,63.89
Ryze,Caitlyn,249,115,134,46.18
Ryze,Gwen,58,34,24,58.62
Ryze,Briar,49,22,27,44.9
Ryze,Aurora,84,28,56,33.33
Ryze,Soraka,43,17,26,39.53
Ryze,Vayne,130,66,64,50.77
Ryze,Yuumi,92,45,47,48.91
Ryze,JarvanIV,64,31,33,48.44
Ryze,Irelia,92,55,37,59.78
Ryze,KSante,72,21,51,29.17
Ryze,Kaisa,127,58,69,45.67
Ryze,Zilean,32,17,15,53.13
Ryze,Vladimir,69,27,42,39.13
Ryze,Tristana,55,35,20,63.64
Ryze,Lulu,163,100,63,61.35
Ryze,Kayn,114,61,53,53.51
Ryze,Malphite,109,46,63,42.2
Ryze,Lux,183,86,97,46.99
Ryze,Urgot,23,11,12,47.83
Ryze,Mel,134,66,68,49.25
Ryze,Amumu,109,50,59,45.87
Ryze,Aatrox,100,43,57,43
Ryze,Belveth,25,14,11,56
Ryze,Ziggs,29,6,23,20.69
Ryze,Morgana,95,56,39,58.95
Ryze,Gnar,43,19,24,44.19
Ryze,Shyvana,27,13,14,48.15
Ryze,Galio,120,52,68,43.33
Ryze,Xerath,86,35,51,40.7
Ryze,Darius,170,65,105,38.24
Ryze,Mordekaiser,97,52,45,53.61
Ryze,Nocturne,108,47,61,43.52
Ryze,Brand,40,19,21,47.5
Ryze,Nami,107,41,66,38.32
Ryze,Malzahar,99,38,61,38.38
Ryze,Diana,104,47,57,45.19
Ryze,Twitch,55,22,33,40
Ryze,Swain,84,36,48,42.86
Ryze,Nunu,56,23,33,41.07
Ryze,Zed,79,27,52,34.18
Ryze,MonkeyKing,58,26,32,44.83
Ryze,Elise,111,64,47,57.66
Ryze,Yorick,62,34,28,54.84
Ryze,Akali,106,64,42,60.38
Ryze,Sivir,73,30,43,41.1
Ryze,Yone,155,78,77,50.32
Ryze,Ekko,67,27,40,40.3
Ryze,Samira,81,48,33,59.26
Ryze,Ornn,64,31,33,48.44
Ryze,Shaco,44,25,19,56.82
Ryze,Zyra,56,28,28,50
Ryze,Thresh,153,75,78,49.02
Ryze,Braum,69,32,37,46.38
Ryze,Chogath,138,76,62,55.07
Ryze,Poppy,77,40,37,51.95
Ryze,Yasuo,164,97,67,59.15
Ryze,MissFortune,147,74,73,50.34
Ryze,Seraphine,66,26,40,39.39
Ryze,Varus,93,50,43,53.76
Ryze,Riven,35,18,17,51.43
Ryze,Qiyana,29,9,20,31.03
Ryze,Sona,29,14,15,48.28
Ryze,Ashe,166,85,81,51.2
Ryze,LeeSin,192,86,106,44.79
Ryze,Smolder,50,24,26,48
Ryze,TahmKench,82,32,50,39.02
Ryze,Jhin,159,86,73,54.09
Ryze,Trundle,39,22,17,56.41
Ryze,MasterYi,62,43,19,69.35
Ryze,Azir,56,22,34,39.29
Ryze,Nilah,24,15,9,62.5
Ryze,Vi,88,41,47,46.59
Ryze,DrMundo,52,22,30,42.31
Ryze,Katarina,45,28,17,62.22
Ryze,Draven,36,17,19,47.22
Ryze,KogMaw,26,9,17,34.62
Ryze,Anivia,42,15,27,35.71
Ryze,Quinn,28,14,14,50
Ryze,Talon,50,35,15,70
Ryze,Ambessa,92,46,46,50
Ryze,Udyr,32,21,11,65.63
Ryze,Veigar,83,41,42,49.4
Ryze,Sion,72,40,32,55.56
Ryze,Graves,58,11,47,18.97
Ryze,Pantheon,135,82,53,60.74
Ryze,Volibear,83,40,43,48.19
Ryze,Skarner,43,20,23,46.51
Ryze,Singed,31,15,16,48.39
Ryze,Lillia,30,17,13,56.67
Ryze,Gangplank,57,34,23,59.65
Ryze,Camille,39,17,22,43.59
Ryze,Alistar,53,32,21,60.38
Ryze,Orianna,43,30,13,69.77
Ryze,Renekton,43,23,20,53.49
Ryze,Hecarim,22,20,2,90.91
Ryze,Karthus,36,21,15,58.33
Ryze,Xayah,48,24,24,50
Ryze,Sett,102,60,42,58.82
Ryze,Zeri,57,28,29,49.12
Ryze,Rell,47,25,22,53.19
Ryze,Kennen,23,9,14,39.13
Ryze,FiddleSticks,48,22,26,45.83
Ryze,Akshan,27,8,19,29.63
Ryze,Illaoi,38,23,15,60.53
Ryze,Maokai,42,24,18,57.14
Ryze,Khazix,34,14,20,41.18
Ryze,Jayce,24,14,10,58.33
Ryze,Rengar,34,17,17,50
Ryze,TwistedFate,56,30,26,53.57
Ryze,Syndra,58,32,26,55.17
Ryze,Leona,84,50,34,59.52
Ryze,Blitzcrank,68,41,27,60.29
Ryze,Nautilus,108,55,53,50.93
Ryze,Sylas,154,88,66,57.14
Ryze,Velkoz,42,26,16,61.9
Ryze,Corki,38,22,16,57.89
Ryze,Kayle,33,15,18,45.45
Ryze,Aphelios,61,33,28,54.1
Ryze,AurelionSol,36,18,18,50
Ryze,Senna,68,36,32,52.94
Ryze,Vex,43,23,20,53.49
Ryze,Rakan,49,31,18,63.27
Ryze,Kindred,28,18,10,64.29
Ryze,Fiora,46,19,27,41.3
Ryze,XinZhao,74,37,37,50
Ryze,Lucian,77,27,50,35.06
Ryze,Taliyah,38,20,18,52.63
Ryze,Fizz,50,26,24,52
Ryze,Janna,22,8,14,36.36
Ryze,Shen,80,46,34,57.5
Ryze,Lissandra,22,8,14,36.36
Ryze,Bard,24,5,19,20.83
Ryze,Annie,14,7,7,50
Ryze,Kled,17,5,12,29.41
Ryze,Evelynn,14,6,8,42.86
Ryze,Zoe,25,10,15,40
Ryze,Ivern,19,8,11,42.11
Ryze,Neeko,50,29,21,58
Ryze,Olaf,20,8,12,40
Ryze,Tryndamere,16,11,5,68.75
Ryze,Renata,16,8,8,50
Ryze,Naafiri,15,7,8,46.67
Ryze,RekSai,11,6,5,54.55
Ryze,Kassadin,11,5,6,45.45
Ryze,Nidalee,36,27,9,75
Ryze,Kalista,22,12,10,54.55
Ryze,Rumble,21,12,9,57.14
Ryze,Taric,23,14,9,60.87
Rell,Shen,136,72,64,52.94
Rell,Vi,201,108,93,53.73
Rell,Swain,135,78,57,57.78
Rell,Nilah,62,32,30,51.61
Rell,Nami,156,79,77,50.64
Rell,Kennen,55,42,13,76.36
Rell,Ashe,318,188,130,59.12
Rell,Lux,278,148,130,53.24
Rell,Leona,211,97,114,45.97
Rell,Jax,107,54,53,50.47
Rell,Diana,216,117,99,54.17
Rell,Akshan,42,16,26,38.1
Rell,Milio,110,47,63,42.73
Rell,Gangplank,108,34,74,31.48
Rell,Pantheon,272,120,152,44.12
Rell,TwistedFate,50,28,22,56
Rell,Kaisa,237,117,120,49.37
Rell,Braum,138,78,60,56.52
Rell,Kayle,87,22,65,25.29
Rell,Evelynn,49,22,27,44.9
Rell,Vladimir,127,67,60,52.76
Rell,Maokai,78,40,38,51.28
Rell,Yorick,121,56,65,46.28
Rell,Skarner,90,40,50,44.44
Rell,Mel,330,168,162,50.91
Rell,Smolder,136,36,100,26.47
Rell,Senna,114,50,64,43.86
Rell,Heimerdinger,97,57,40,58.76
Rell,Briar,86,49,37,56.98
Rell,Irelia,107,48,59,44.86
Rell,Jhin,332,161,171,48.49
Rell,Vayne,211,105,106,49.76
Rell,Ivern,28,15,13,53.57
Rell,Qiyana,33,16,17,48.48
Rell,Ahri,236,115,121,48.73
Rell,Seraphine,105,51,54,48.57
Rell,Chogath,203,95,108,46.8
Rell,MasterYi,130,69,61,53.08
Rell,Singed,56,26,30,46.43
Rell,Tristana,119,57,62,47.9
Rell,Zyra,114,53,61,46.49
Rell,Warwick,187,81,106,43.32
Rell,Nunu,95,48,47,50.53
Rell,Malzahar,190,88,102,46.32
Rell,Samira,106,51,55,48.11
Rell,Pyke,95,60,35,63.16
Rell,DrMundo,70,48,22,68.57
Rell,LeeSin,280,148,132,52.86
Rell,Zed,162,80,82,49.38
Rell,Zeri,102,53,49,51.96
Rell,Lulu,237,124,113,52.32
Rell,Riven,78,42,36,53.85
Rell,Nocturne,189,102,87,53.97
Rell,Akali,162,87,75,53.7
Rell,Soraka,61,37,24,60.66
Rell,Darius,301,157,144,52.16
Rell,Sylas,214,121,93,56.54
Rell,Jinx,381,159,222,41.73
Rell,TahmKench,157,72,85,45.86
Rell,Talon,85,64,21,75.29
Rell,Lissandra,71,23,48,32.39
Rell,Corki,94,43,51,45.74
Rell,Udyr,39,20,19,51.28
Rell,Ornn,116,58,58,50
Rell,Gnar,90,44,46,48.89
Rell,Aatrox,158,71,87,44.94
Rell,MissFortune,269,145,124,53.9
Rell,Nautilus,300,150,150,50
Rell,Viego,214,99,115,46.26
Rell,Galio,140,57,83,40.71
Rell,Draven,95,63,32,66.32
Rell,Zoe,76,44,32,57.89
Rell,Ezreal,395,201,194,50.89
Rell,Aurora,143,79,64,55.24
Rell,Kindred,62,26,36,41.94
Rell,Urgot,88,51,37,57.95
Rell,Karthus,47,19,28,40.43
Rell,Caitlyn,411,203,208,49.39
Rell,Gragas,127,82,45,64.57
Rell,Ekko,135,61,74,45.19
Rell,Viktor,182,91,91,50
Rell,Lucian,124,63,61,50.81
Rell,Sett,193,88,105,45.6
Rell,XinZhao,119,53,66,44.54
Rell,Morgana,150,78,72,52
Rell,Thresh,290,141,149,48.62
Rell,Xayah,98,47,51,47.96
Rell,Trundle,75,34,41,45.33
Rell,Teemo,126,54,72,42.86
Rell,Kassadin,13,8,5,61.54
Rell,KSante,117,53,64,45.3
Rell,FiddleSticks,78,38,40,48.72
Rell,Illaoi,49,29,20,59.18
Rell,MonkeyKing,139,52,87,37.41
Rell,Rakan,86,35,51,40.7
Rell,Kayn,224,104,120,46.43
Rell,Karma,202,98,104,48.51
Rell,Camille,66,31,35,46.97
Rell,Olaf,57,21,36,36.84
Rell,Volibear,212,114,98,53.77
Rell,Xerath,124,41,83,33.06
Rell,Renekton,81,39,42,48.15
Rell,Lillia,73,32,41,43.84
Rell,Amumu,195,83,112,42.56
Rell,Sivir,100,47,53,47
Rell,Tryndamere,46,25,21,54.35
Rell,Yuumi,169,72,97,42.6
Rell,Taliyah,48,24,24,50
Rell,Syndra,101,46,55,45.54
Rell,Janna,90,40,50,44.44
Rell,Malphite,179,69,110,38.55
Rell,Neeko,54,23,31,42.59
Rell,Ziggs,61,36,25,59.02
Rell,Veigar,126,50,76,39.68
Rell,Brand,86,45,41,52.33
Rell,Poppy,146,82,64,56.16
Rell,Katarina,103,65,38,63.11
Rell,Elise,123,62,61,50.41
Rell,Velkoz,83,52,31,62.65
Rell,Hecarim,57,33,24,57.89
Rell,Nidalee,69,47,22,68.12
Rell,Yasuo,277,137,140,49.46
Rell,Yone,237,140,97,59.07
Rell,Blitzcrank,160,90,70,56.25
Rell,Aphelios,80,34,46,42.5
Rell,Vex,106,59,47,55.66
Rell,Varus,171,87,84,50.88
Rell,Sejuani,101,39,62,38.61
Rell,Zilean,51,17,34,33.33
Rell,Gwen,81,38,43,46.91
Rell,AurelionSol,78,40,38,51.28
Rell,Mordekaiser,220,130,90,59.09
Rell,Graves,80,29,51,36.25
Rell,Orianna,90,42,48,46.67
Rell,Hwei,110,71,39,64.55
Rell,Kalista,47,27,20,57.45
Rell,Shaco,100,53,47,53
Rell,Alistar,116,50,66,43.1
Rell,Rengar,48,16,32,33.33
Rell,Sion,199,89,110,44.72
Rell,Sona,33,21,12,63.64
Rell,Annie,62,35,27,56.45
Rell,Zac,92,48,44,52.17
Rell,Jayce,65,45,20,69.23
Rell,Ryze,47,22,25,46.81
Rell,JarvanIV,136,49,87,36.03
Rell,Bard,48,19,29,39.58
Rell,Nasus,60,33,27,55
Rell,Garen,170,85,85,50
Rell,Fiora,55,21,34,38.18
Rell,Fizz,63,29,34,46.03
Rell,Azir,69,35,34,50.72
Rell,Khazix,69,35,34,50.72
Rell,Quinn,55,29,26,52.73
Rell,Leblanc,91,41,50,45.05
Rell,Ambessa,125,76,49,60.8
Rell,Twitch,106,47,59,44.34
Rell,KogMaw,49,24,25,48.98
Rell,RekSai,17,3,14,17.65
Rell,Cassiopeia,34,19,15,55.88
Rell,Belveth,33,17,16,51.52
Rell,Shyvana,30,9,21,30
Rell,Anivia,59,18,41,30.51
Rell,Taric,25,9,16,36
Rell,Kled,27,13,14,48.15
Rell,Renata,41,15,26,36.59
Rell,Rammus,33,18,15,54.55
Rell,Rumble,38,11,27,28.95
Rell,Naafiri,39,17,22,43.59
Rengar,Shen,54,23,31,42.59
Rengar,Vi,77,26,51,33.77
Rengar,Swain,63,30,33,47.62
Rengar,Nilah,38,11,27,28.95
Rengar,Nami,77,26,51,33.77
Rengar,Malphite,104,42,62,40.38
Rengar,Khazix,72,33,39,45.83
Rengar,Galio,72,28,44,38.89
Rengar,Smolder,58,23,35,39.66
Rengar,Thresh,115,47,68,40.87
Rengar,Yorick,48,23,25,47.92
Rengar,Diana,86,33,53,38.37
Rengar,Akali,48,14,34,29.17
Rengar,Ashe,122,65,57,53.28
Rengar,Milio,40,21,19,52.5
Rengar,Darius,85,30,55,35.29
Rengar,LeeSin,108,37,71,34.26
Rengar,Katarina,24,13,11,54.17
Rengar,Caitlyn,136,49,87,36.03
Rengar,Jinx,166,76,90,45.78
Rengar,Aatrox,71,34,37,47.89
Rengar,Ekko,65,31,34,47.69
Rengar,Chogath,83,38,45,45.78
Rengar,Zyra,42,11,31,26.19
Rengar,Irelia,47,25,22,53.19
Rengar,Rammus,15,3,12,20
Rengar,Mordekaiser,87,33,54,37.93
Rengar,KogMaw,14,3,11,21.43
Rengar,Lux,172,76,96,44.19
Rengar,Rumble,11,3,8,27.27
Rengar,Fizz,24,9,15,37.5
Rengar,Zilean,24,11,13,45.83
Rengar,Jhin,127,70,57,55.12
Rengar,Garen,94,35,59,37.23
Rengar,Shaco,58,13,45,22.41
Rengar,Hwei,39,16,23,41.03
Rengar,Leblanc,62,32,30,51.61
Rengar,Ivern,20,8,12,40
Rengar,Skarner,17,5,12,29.41
Rengar,Yuumi,82,33,49,40.24
Rengar,Gwen,37,13,24,35.14
Rengar,Blitzcrank,55,22,33,40
Rengar,Ornn,42,17,25,40.48
Rengar,Gragas,29,16,13,55.17
Rengar,Yasuo,136,50,86,36.76
Rengar,Tristana,79,54,25,68.35
Rengar,Bard,34,19,15,55.88
Rengar,Fiora,29,10,19,34.48
Rengar,MissFortune,149,72,77,48.32
Rengar,Brand,54,14,40,25.93
Rengar,Yone,98,48,50,48.98
Rengar,Janna,17,9,8,52.94
Rengar,Warwick,92,43,49,46.74
Rengar,Kayn,119,68,51,57.14
Rengar,Malzahar,62,46,16,74.19
Rengar,Kaisa,74,29,45,39.19
Rengar,Viktor,57,20,37,35.09
Rengar,Amumu,100,43,57,43
Rengar,TahmKench,54,32,22,59.26
Rengar,Xerath,83,32,51,38.55
Rengar,Mel,132,54,78,40.91
Rengar,Vayne,88,30,58,34.09
Rengar,Sylas,94,58,36,61.7
Rengar,Jax,52,17,35,32.69
Rengar,Viego,84,48,36,57.14
Rengar,Sona,20,9,11,45
Rengar,Nocturne,82,48,34,58.54
Rengar,Quinn,24,8,16,33.33
Rengar,Elise,42,20,22,47.62
Rengar,Lucian,44,22,22,50
Rengar,Zac,54,21,33,38.89
Rengar,Naafiri,36,11,25,30.56
Rengar,Braum,43,18,25,41.86
Rengar,Belveth,18,9,9,50
Rengar,Vladimir,33,15,18,45.45
Rengar,Soraka,23,14,9,60.87
Rengar,JarvanIV,55,18,37,32.73
Rengar,Varus,37,26,11,70.27
Rengar,XinZhao,28,20,8,71.43
Rengar,Gnar,40,24,16,60
Rengar,Lulu,92,55,37,59.78
Rengar,Samira,55,33,22,60
Rengar,Morgana,45,17,28,37.78
Rengar,Trundle,28,17,11,60.71
Rengar,MasterYi,56,32,24,57.14
Rengar,Kindred,21,10,11,47.62
Rengar,Lissandra,29,5,24,17.24
Rengar,Pantheon,104,39,65,37.5
Rengar,Volibear,63,26,37,41.27
Rengar,AurelionSol,26,14,12,53.85
Rengar,Aphelios,41,19,22,46.34
Rengar,Xayah,55,14,41,25.45
Rengar,Rakan,47,21,26,44.68
Rengar,Jayce,28,11,17,39.29
Rengar,Veigar,61,26,35,42.62
Rengar,Talon,50,34,16,68
Rengar,Olaf,9,5,4,55.56
Rengar,Tryndamere,39,26,13,66.67
Rengar,Lillia,23,12,11,52.17
Rengar,Pyke,51,31,20,60.78
Rengar,Renata,21,13,8,61.9
Rengar,Corki,30,11,19,36.67
Rengar,Aurora,51,27,24,52.94
Rengar,Rell,48,32,16,66.67
Rengar,Teemo,47,18,29,38.3
Rengar,Riven,25,16,9,64
Rengar,Kassadin,13,6,7,46.15
Rengar,Alistar,32,14,18,43.75
Rengar,Ezreal,152,63,89,41.45
Rengar,Velkoz,52,18,34,34.62
Rengar,Zed,60,32,28,53.33
Rengar,Udyr,22,6,16,27.27
Rengar,Seraphine,53,18,35,33.96
Rengar,Nasus,31,13,18,41.94
Rengar,Karma,64,33,31,51.56
Rengar,Sett,74,26,48,35.14
Rengar,Nautilus,60,24,36,40
Rengar,FiddleSticks,31,8,23,25.81
Rengar,Briar,43,25,18,58.14
Rengar,Ambessa,39,25,14,64.1
Rengar,Camille,37,14,23,37.84
Rengar,Poppy,45,22,23,48.89
Rengar,Ryze,34,17,17,50
Rengar,Taric,20,17,3,85
Rengar,Leona,51,22,29,43.14
Rengar,Sion,53,29,24,54.72
Rengar,Senna,35,13,22,37.14
Rengar,Nunu,38,13,25,34.21
Rengar,TwistedFate,22,10,12,45.45
Rengar,Neeko,35,10,25,28.57
Rengar,Sivir,35,14,21,40
Rengar,Renekton,28,10,18,35.71
Rengar,Karthus,30,17,13,56.67
Rengar,Kayle,39,26,13,66.67
Rengar,KSante,38,25,13,65.79
Rengar,Kalista,23,6,17,26.09
Rengar,Sejuani,41,12,29,29.27
Rengar,Zeri,40,14,26,35
Rengar,Twitch,35,16,19,45.71
Rengar,Ahri,86,40,46,46.51
Rengar,MonkeyKing,38,11,27,28.95
Rengar,DrMundo,38,11,27,28.95
Rengar,Syndra,33,12,21,36.36
Rengar,Akshan,15,10,5,66.67
Rengar,Singed,32,25,7,78.13
Rengar,Illaoi,15,0,15,0
Rengar,Taliyah,14,2,12,14.29
Rengar,Urgot,32,15,17,46.88
Rengar,Heimerdinger,14,9,5,64.29
Rengar,Kled,18,12,6,66.67
Rengar,Graves,35,25,10,71.43
Rengar,Vex,22,3,19,13.64
Rengar,Ziggs,19,10,9,52.63
Rengar,Evelynn,21,8,13,38.1
Rengar,Nidalee,31,13,18,41.94
Rengar,Draven,28,18,10,64.29
Rengar,Qiyana,13,11,2,84.62
Rengar,Cassiopeia,21,8,13,38.1
Rengar,Azir,27,10,17,37.04
Rengar,Orianna,30,13,17,43.33
Rengar,Gangplank,29,10,19,34.48
Rengar,Zoe,21,12,9,57.14
Rengar,Shyvana,8,2,6,25
Rengar,Annie,16,10,6,62.5
Rengar,Kennen,14,6,8,42.86
Rengar,Anivia,30,12,18,40
Rengar,Hecarim,8,0,8,0
Rengar,Maokai,36,9,27,25
Anivia,Sion,75,34,41,45.33
Anivia,RekSai,29,15,14,51.72
Anivia,Viktor,94,62,32,65.96
Anivia,KogMaw,35,14,21,40
Anivia,Ashe,166,83,83,50
Anivia,Vayne,97,36,61,37.11
Anivia,Ivern,20,12,8,60
Anivia,Qiyana,23,15,8,65.22
Anivia,Ahri,137,84,53,61.31
Anivia,Seraphine,52,35,17,67.31
Anivia,Sett,107,55,52,51.4
Anivia,Diana,148,86,62,58.11
Anivia,Yasuo,201,87,114,43.28
Anivia,Lulu,129,50,79,38.76
Anivia,Malphite,89,37,52,41.57
Anivia,Nocturne,107,66,41,61.68
Anivia,Malzahar,68,28,40,41.18
Anivia,Samira,77,34,43,44.16
Anivia,Pyke,83,56,27,67.47
Anivia,Aatrox,74,49,25,66.22
Anivia,Leona,82,46,36,56.1
Anivia,Veigar,93,41,52,44.09
Anivia,Kaisa,176,112,64,63.64
Anivia,Elise,93,57,36,61.29
Anivia,Chogath,125,57,68,45.6
Anivia,LeeSin,179,89,90,49.72
Anivia,Syndra,103,46,57,44.66
Anivia,Caitlyn,216,99,117,45.83
Anivia,Blitzcrank,78,45,33,57.69
Anivia,Heimerdinger,22,17,5,77.27
Anivia,Darius,153,76,77,49.67
Anivia,Xayah,48,28,20,58.33
Anivia,Rakan,52,27,25,51.92
Anivia,DrMundo,50,36,14,72
Anivia,Maokai,58,25,33,43.1
Anivia,Orianna,54,29,25,53.7
Anivia,Mel,178,78,100,43.82
Anivia,Gangplank,62,37,25,59.68
Anivia,Karthus,35,21,14,60
Anivia,Varus,75,38,37,50.67
Anivia,Lux,178,79,99,44.38
Anivia,Evelynn,27,12,15,44.44
Anivia,Aurora,78,37,41,47.44
Anivia,Jinx,238,114,124,47.9
Anivia,Brand,37,12,25,32.43
Anivia,Mordekaiser,109,54,55,49.54
Anivia,Jax,65,33,32,50.77
Anivia,Jayce,42,16,26,38.1
Anivia,Fiora,22,17,5,77.27
Anivia,XinZhao,67,36,31,53.73
Anivia,Fizz,48,26,22,54.17
Anivia,Draven,50,31,19,62
Anivia,Nautilus,133,90,43,67.67
Anivia,Warwick,110,49,61,44.55
Anivia,Udyr,45,11,34,24.44
Anivia,Jhin,146,83,63,56.85
Anivia,Ezreal,206,111,95,53.88
Anivia,Sejuani,48,23,25,47.92
Anivia,Gwen,36,17,19,47.22
Anivia,Ornn,71,44,27,61.97
Anivia,Zac,84,45,39,53.57
Anivia,Nami,101,52,49,51.49
Anivia,Ryze,42,27,15,64.29
Anivia,Tristana,87,42,45,48.28
Anivia,Viego,102,64,38,62.75
Anivia,Taliyah,17,14,3,82.35
Anivia,Thresh,172,98,74,56.98
Anivia,Kassadin,22,8,14,36.36
Anivia,Gragas,83,35,48,42.17
Anivia,FiddleSticks,21,12,9,57.14
Anivia,MasterYi,98,54,44,55.1
Anivia,Akali,57,23,34,40.35
Anivia,Khazix,32,19,13,59.38
Anivia,Zed,94,48,46,51.06
Anivia,Sivir,41,20,21,48.78
Anivia,Irelia,70,30,40,42.86
Anivia,Skarner,45,13,32,28.89
Anivia,Ekko,69,39,30,56.52
Anivia,Senna,53,24,29,45.28
Anivia,Briar,37,13,24,35.14
Anivia,Ziggs,43,32,11,74.42
Anivia,Janna,34,19,15,55.88
Anivia,Yone,129,72,57,55.81
Anivia,Naafiri,26,11,15,42.31
Anivia,Riven,20,11,9,55
Anivia,Zeri,52,20,32,38.46
Anivia,Yuumi,93,46,47,49.46
Anivia,Urgot,44,23,21,52.27
Anivia,Graves,50,29,21,58
Anivia,Hwei,52,26,26,50
Anivia,Galio,129,61,68,47.29
Anivia,Shyvana,15,5,10,33.33
Anivia,Sylas,139,60,79,43.17
Anivia,Ambessa,55,31,24,56.36
Anivia,Velkoz,42,20,22,47.62
Anivia,Lucian,81,45,36,55.56
Anivia,Lissandra,35,24,11,68.57
Anivia,MissFortune,161,80,81,49.69
Anivia,Shaco,77,42,35,54.55
Anivia,Corki,28,12,16,42.86
Anivia,Vi,114,50,64,43.86
Anivia,Poppy,47,11,36,23.4
Anivia,Kayle,28,9,19,32.14
Anivia,Olaf,30,17,13,56.67
Anivia,Belveth,20,10,10,50
Anivia,Leblanc,38,27,11,71.05
Anivia,Shen,78,40,38,51.28
Anivia,Kayn,85,40,45,47.06
Anivia,Amumu,90,39,51,43.33
Anivia,Swain,80,37,43,46.25
Anivia,Quinn,19,10,9,52.63
Anivia,Twitch,72,35,37,48.61
Anivia,Soraka,34,12,22,35.29
Anivia,JarvanIV,64,44,20,68.75
Anivia,Lillia,40,32,8,80
Anivia,Nunu,53,31,22,58.49
Anivia,Zoe,41,22,19,53.66
Anivia,Zyra,64,24,40,37.5
Anivia,Renekton,38,27,11,71.05
Anivia,Katarina,39,17,22,43.59
Anivia,Alistar,69,39,30,56.52
Anivia,Rumble,24,15,9,62.5
Anivia,Garen,129,70,59,54.26
Anivia,Pantheon,132,75,57,56.82
Anivia,Neeko,42,20,22,47.62
Anivia,Vladimir,31,19,12,61.29
Anivia,Kindred,23,17,6,73.91
Anivia,Tryndamere,25,19,6,76
Anivia,Kled,17,9,8,52.94
Anivia,Annie,25,20,5,80
Anivia,Aphelios,40,19,21,47.5
Anivia,TahmKench,86,42,44,48.84
Anivia,Azir,32,24,8,75
Anivia,Gnar,50,27,23,54
Anivia,Cassiopeia,33,21,12,63.64
Anivia,Teemo,63,28,35,44.44
Anivia,MonkeyKing,72,45,27,62.5
Anivia,Nasus,25,13,12,52
Anivia,Karma,109,49,60,44.95
Anivia,Xerath,87,54,33,62.07
Anivia,Rell,59,41,18,69.49
Anivia,Morgana,64,31,33,48.44
Anivia,Yorick,69,36,33,52.17
Anivia,Vex,39,15,24,38.46
Anivia,KSante,57,27,30,47.37
Anivia,Smolder,49,23,26,46.94
Anivia,AurelionSol,43,24,19,55.81
Anivia,Rammus,28,11,17,39.29
Anivia,Volibear,54,40,14,74.07
Anivia,Nidalee,36,11,25,30.56
Anivia,Renata,15,10,5,66.67
Anivia,Hecarim,28,18,10,64.29
Anivia,Illaoi,46,25,21,54.35
Anivia,Trundle,42,16,26,38.1
Anivia,Zilean,23,11,12,47.83
Anivia,Taric,8,8,0,100
Anivia,Braum,47,21,26,44.68
Anivia,Bard,24,10,14,41.67
Anivia,TwistedFate,30,13,17,43.33
Anivia,Camille,54,31,23,57.41
Anivia,Nilah,26,9,17,34.62
Anivia,Sona,14,14,0,100
Anivia,Akshan,13,11,2,84.62
Anivia,Milio,50,19,31,38
Anivia,Kalista,21,15,6,71.43
Anivia,Kennen,16,9,7,56.25
Anivia,Singed,34,21,13,61.76
Anivia,Talon,22,17,5,77.27
Anivia,Rengar,30,18,12,60
RekSai,Teemo,41,13,28,31.71
RekSai,Viego,56,28,28,50
RekSai,Anivia,29,14,15,48.28
RekSai,MissFortune,65,38,27,58.46
RekSai,TahmKench,24,7,17,29.17
RekSai,Illaoi,15,0,15,0
RekSai,Twitch,39,11,28,28.21
RekSai,Ahri,45,17,28,37.78
RekSai,Kaisa,41,29,12,70.73
RekSai,Ashe,89,40,49,44.94
RekSai,MasterYi,42,20,22,47.62
RekSai,Warwick,41,12,29,29.27
RekSai,Kassadin,8,3,5,37.5
RekSai,Pyke,34,19,15,55.88
RekSai,Sett,40,8,32,20
RekSai,Nautilus,29,18,11,62.07
RekSai,Shen,36,20,16,55.56
RekSai,Mel,84,33,51,39.29
RekSai,Galio,57,30,27,52.63
RekSai,Volibear,44,21,23,47.73
RekSai,Amumu,39,28,11,71.79
RekSai,Katarina,20,9,11,45
RekSai,Vayne,29,7,22,24.14
RekSai,Poppy,23,6,17,26.09
RekSai,Yorick,24,8,16,33.33
RekSai,Karma,85,43,42,50.59
RekSai,Xayah,40,22,18,55
RekSai,Rakan,32,11,21,34.38
RekSai,Chogath,19,9,10,47.37
RekSai,Hwei,22,13,9,59.09
RekSai,Caitlyn,116,43,73,37.07
RekSai,Mordekaiser,48,30,18,62.5
RekSai,Yone,67,37,30,55.22
RekSai,Maokai,18,9,9,50
RekSai,Ziggs,16,4,12,25
RekSai,Renekton,39,22,17,56.41
RekSai,Kayn,46,24,22,52.17
RekSai,Samira,19,13,6,68.42
RekSai,Leona,34,18,16,52.94
RekSai,Garen,45,20,25,44.44
RekSai,Briar,20,10,10,50
RekSai,Naafiri,11,6,5,54.55
RekSai,Thresh,53,21,32,39.62
RekSai,LeeSin,68,32,36,47.06
RekSai,Zed,51,17,34,33.33
RekSai,Zeri,26,11,15,42.31
RekSai,Yuumi,28,14,14,50
RekSai,Gragas,34,14,20,41.18
RekSai,Yasuo,78,48,30,61.54
RekSai,Jhin,61,32,29,52.46
RekSai,Lulu,54,26,28,48.15
RekSai,Malphite,48,15,33,31.25
RekSai,MonkeyKing,32,6,26,18.75
RekSai,Veigar,43,14,29,32.56
RekSai,Pantheon,84,38,46,45.24
RekSai,Vladimir,19,8,11,42.11
RekSai,Tristana,46,26,20,56.52
RekSai,Viktor,28,13,15,46.43
RekSai,Ekko,34,12,22,35.29
RekSai,Nasus,20,12,8,60
RekSai,Ezreal,117,75,42,64.1
RekSai,Nami,41,16,25,39.02
RekSai,Vi,44,19,25,43.18
RekSai,AurelionSol,19,7,12,36.84
RekSai,Milio,36,17,19,47.22
RekSai,Zac,23,12,11,52.17
RekSai,Sion,40,17,23,42.5
RekSai,Shaco,37,15,22,40.54
RekSai,Xerath,32,14,18,43.75
RekSai,Nocturne,52,25,27,48.08
RekSai,Jinx,79,36,43,45.57
RekSai,Lux,59,36,23,61.02
RekSai,Gangplank,32,15,17,46.88
RekSai,Quinn,13,11,2,84.62
RekSai,Akali,32,15,17,46.88
RekSai,Fiora,16,2,14,12.5
RekSai,Azir,16,11,5,68.75
RekSai,Zoe,8,0,8,0
RekSai,Lucian,31,13,18,41.94
RekSai,Nunu,17,12,5,70.59
RekSai,Neeko,15,7,8,46.67
RekSai,Darius,55,26,29,47.27
RekSai,Syndra,29,11,18,37.93
RekSai,DrMundo,14,11,3,78.57
RekSai,Kalista,6,3,3,50
RekSai,Senna,24,3,21,12.5
RekSai,Brand,31,12,19,38.71
RekSai,Trundle,8,5,3,62.5
RekSai,Kennen,3,3,0,100
RekSai,KSante,29,14,15,48.28
RekSai,Morgana,42,22,20,52.38
RekSai,Tryndamere,19,12,7,63.16
RekSai,Rell,17,14,3,82.35
RekSai,Annie,23,15,8,65.22
RekSai,Vex,15,6,9,40
RekSai,Leblanc,29,8,21,27.59
RekSai,Khazix,20,5,15,25
RekSai,Varus,24,7,17,29.17
RekSai,Evelynn,18,12,6,66.67
RekSai,Orianna,31,17,14,54.84
RekSai,Camille,15,7,8,46.67
RekSai,XinZhao,31,11,20,35.48
RekSai,Kayle,23,6,17,26.09
RekSai,Gnar,24,10,14,41.67
RekSai,Renata,13,8,5,61.54
RekSai,Graves,15,5,10,33.33
RekSai,Karthus,11,6,5,54.55
RekSai,Ivern,4,0,4,0
RekSai,Diana,29,15,14,51.72
RekSai,Akshan,9,6,3,66.67
RekSai,Swain,23,20,3,86.96
RekSai,Malzahar,39,26,13,66.67
RekSai,Sylas,47,28,19,59.57
RekSai,Seraphine,22,17,5,77.27
RekSai,Zyra,14,8,6,57.14
RekSai,Elise,21,15,6,71.43
RekSai,Urgot,15,5,10,33.33
RekSai,JarvanIV,23,11,12,47.83
RekSai,Riven,14,11,3,78.57
RekSai,Rumble,11,8,3,72.73
RekSai,Smolder,14,9,5,64.29
RekSai,Blitzcrank,45,19,26,42.22
RekSai,Shyvana,2,2,0,100
RekSai,Aurora,36,19,17,52.78
RekSai,Irelia,12,6,6,50
RekSai,Braum,34,15,19,44.12
RekSai,Sejuani,35,7,28,20
RekSai,Belveth,8,2,6,25
RekSai,Soraka,20,10,10,50
RekSai,Alistar,8,3,5,37.5
RekSai,Talon,23,14,9,60.87
RekSai,Velkoz,15,9,6,60
RekSai,Lissandra,30,13,17,43.33
RekSai,Rammus,21,11,10,52.38
RekSai,Nilah,16,11,5,68.75
RekSai,Udyr,13,7,6,53.85
RekSai,Taric,10,2,8,20
RekSai,Ambessa,27,19,8,70.37
RekSai,Hecarim,8,5,3,62.5
RekSai,Cassiopeia,8,5,3,62.5
RekSai,Lillia,17,6,11,35.29
RekSai,Aphelios,34,11,23,32.35
RekSai,Fizz,13,6,7,46.15
RekSai,Heimerdinger,8,3,5,37.5
RekSai,Ryze,11,5,6,45.45
RekSai,Ornn,32,15,17,46.88
RekSai,Kled,5,3,2,60
RekSai,Corki,26,9,17,34.62
RekSai,Olaf,8,3,5,37.5
RekSai,Zilean,11,8,3,72.73
RekSai,Gwen,24,9,15,37.5
RekSai,Aatrox,41,21,20,51.22
RekSai,Sivir,15,0,15,0
RekSai,Bard,15,9,6,60
RekSai,Jax,21,12,9,57.14
RekSai,Qiyana,6,3,3,50
RekSai,Janna,12,0,12,0
RekSai,Taliyah,6,3,3,50
RekSai,KogMaw,6,0,6,0
RekSai,Draven,21,3,18,14.29
RekSai,Kindred,11,6,5,54.55
RekSai,FiddleSticks,18,3,15,16.67
RekSai,Singed,3,3,0,100
RekSai,TwistedFate,8,3,5,37.5
RekSai,Nidalee,11,0,11,0
RekSai,Skarner,3,3,0,100
RekSai,Jayce,14,9,5,64.29
RekSai,Sona,3,0,3,0
KogMaw,Teemo,84,34,50,40.48
KogMaw,Viego,74,41,33,55.41
KogMaw,Anivia,35,21,14,60
KogMaw,MissFortune,124,48,76,38.71
KogMaw,TahmKench,82,40,42,48.78
KogMaw,Nasus,60,29,31,48.33
KogMaw,Amumu,89,44,45,49.44
KogMaw,Sylas,92,45,47,48.91
KogMaw,Twitch,70,38,32,54.29
KogMaw,Lulu,109,52,57,47.71
KogMaw,Jayce,29,16,13,55.17
KogMaw,Sejuani,67,50,17,74.63
KogMaw,Fizz,33,14,19,42.42
KogMaw,Caitlyn,192,82,110,42.71
KogMaw,Alistar,58,19,39,32.76
KogMaw,KSante,58,34,24,58.62
KogMaw,Zac,54,22,32,40.74
KogMaw,Yasuo,128,74,54,57.81
KogMaw,Annie,29,18,11,62.07
KogMaw,Malphite,79,44,35,55.7
KogMaw,Gangplank,42,34,8,80.95
KogMaw,LeeSin,111,64,47,57.66
KogMaw,Jhin,135,68,67,50.37
KogMaw,Thresh,126,63,63,50
KogMaw,Vi,91,31,60,34.07
KogMaw,Riven,25,8,17,32
KogMaw,Yone,116,47,69,40.52
KogMaw,Smolder,42,28,14,66.67
KogMaw,Aatrox,87,40,47,45.98
KogMaw,Pantheon,109,51,58,46.79
KogMaw,AurelionSol,43,23,20,53.49
KogMaw,Lux,157,82,75,52.23
KogMaw,Shaco,79,33,46,41.77
KogMaw,Kennen,41,20,21,48.78
KogMaw,Vladimir,45,18,27,40
KogMaw,Corki,44,25,19,56.82
KogMaw,Bard,15,6,9,40
KogMaw,Fiora,35,21,14,60
KogMaw,Rengar,14,11,3,78.57
KogMaw,Syndra,57,27,30,47.37
KogMaw,Nilah,27,12,15,44.44
KogMaw,Mel,156,82,74,52.56
KogMaw,Garen,106,34,72,32.08
KogMaw,Leblanc,66,31,35,46.97
KogMaw,Blitzcrank,85,50,35,58.82
KogMaw,Gwen,29,16,13,55.17
KogMaw,Diana,102,56,46,54.9
KogMaw,Zed,81,40,41,49.38
KogMaw,Xayah,31,19,12,61.29
KogMaw,Nautilus,87,46,41,52.87
KogMaw,Urgot,50,25,25,50
KogMaw,Kayn,74,35,39,47.3
KogMaw,Zyra,56,32,24,57.14
KogMaw,Ornn,49,18,31,36.73
KogMaw,Graves,70,26,44,37.14
KogMaw,Morgana,80,33,47,41.25
KogMaw,Hwei,39,29,10,74.36
KogMaw,Qiyana,17,5,12,29.41
KogMaw,Lucian,55,32,23,58.18
KogMaw,Shen,50,19,31,38
KogMaw,Aurora,55,36,19,65.45
KogMaw,Draven,38,13,25,34.21
KogMaw,Senna,46,22,24,47.83
KogMaw,Lillia,49,34,15,69.39
KogMaw,Jinx,231,103,128,44.59
KogMaw,Milio,54,28,26,51.85
KogMaw,MasterYi,64,45,19,70.31
KogMaw,Malzahar,92,50,42,54.35
KogMaw,Mordekaiser,101,51,50,50.5
KogMaw,Katarina,55,29,26,52.73
KogMaw,Vayne,68,29,39,42.65
KogMaw,Kayle,29,16,13,55.17
KogMaw,Skarner,33,13,20,39.39
KogMaw,Ambessa,62,21,41,33.87
KogMaw,Talon,22,11,11,50
KogMaw,Ashe,136,62,74,45.59
KogMaw,Quinn,28,11,17,39.29
KogMaw,Rammus,44,18,26,40.91
KogMaw,Rakan,21,7,14,33.33
KogMaw,Yorick,89,30,59,33.71
KogMaw,Jax,85,43,42,50.59
KogMaw,Xerath,69,29,40,42.03
KogMaw,Briar,29,13,16,44.83
KogMaw,Ekko,60,37,23,61.67
KogMaw,Ryze,26,17,9,65.38
KogMaw,Seraphine,53,35,18,66.04
KogMaw,DrMundo,29,15,14,51.72
KogMaw,Orianna,37,12,25,32.43
KogMaw,Gnar,42,19,23,45.24
KogMaw,Viktor,66,24,42,36.36
KogMaw,Varus,83,40,43,48.19
KogMaw,Nunu,45,28,17,62.22
KogMaw,Shyvana,13,3,10,23.08
KogMaw,Poppy,60,40,20,66.67
KogMaw,Nocturne,71,29,42,40.85
KogMaw,Pyke,63,27,36,42.86
KogMaw,Karma,81,41,40,50.62
KogMaw,Tristana,46,38,8,82.61
KogMaw,Leona,79,38,41,48.1
KogMaw,Sivir,28,19,9,67.86
KogMaw,Gragas,53,25,28,47.17
KogMaw,Taliyah,16,10,6,62.5
KogMaw,Akali,62,24,38,38.71
KogMaw,Ezreal,189,105,84,55.56
KogMaw,Ahri,105,62,43,59.05
KogMaw,Volibear,77,34,43,44.16
KogMaw,Galio,100,54,46,54
KogMaw,Nami,114,72,42,63.16
KogMaw,Tryndamere,30,24,6,80
KogMaw,MonkeyKing,53,25,28,47.17
KogMaw,Sett,91,50,41,54.95
KogMaw,Braum,81,55,26,67.9
KogMaw,Irelia,38,24,14,63.16
KogMaw,TwistedFate,28,11,17,39.29
KogMaw,Ziggs,27,17,10,62.96
KogMaw,Janna,11,5,6,45.45
KogMaw,Azir,23,9,14,39.13
KogMaw,Chogath,95,52,43,54.74
KogMaw,Kaisa,147,97,50,65.99
KogMaw,Samira,51,27,24,52.94
KogMaw,Elise,64,25,39,39.06
KogMaw,Vex,55,24,31,43.64
KogMaw,Soraka,45,19,26,42.22
KogMaw,Naafiri,6,6,0,100
KogMaw,FiddleSticks,35,19,16,54.29
KogMaw,Zilean,19,13,6,68.42
KogMaw,Kled,11,3,8,27.27
KogMaw,Warwick,102,52,50,50.98
KogMaw,Swain,69,35,34,50.72
KogMaw,Sion,65,35,30,53.85
KogMaw,Akshan,13,8,5,61.54
KogMaw,Velkoz,28,11,17,39.29
KogMaw,Khazix,28,17,11,60.71
KogMaw,XinZhao,27,11,16,40.74
KogMaw,Illaoi,37,27,10,72.97
KogMaw,Nidalee,10,8,2,80
KogMaw,Heimerdinger,27,13,14,48.15
KogMaw,Camille,21,18,3,85.71
KogMaw,Rell,49,25,24,51.02
KogMaw,Veigar,67,29,38,43.28
KogMaw,Darius,102,50,52,49.02
KogMaw,Zoe,43,17,26,39.53
KogMaw,Lissandra,34,13,21,38.24
KogMaw,Zeri,45,17,28,37.78
KogMaw,Brand,32,21,11,65.63
KogMaw,Cassiopeia,23,14,9,60.87
KogMaw,Maokai,36,25,11,69.44
KogMaw,Kindred,15,9,6,60
KogMaw,Trundle,30,15,15,50
KogMaw,JarvanIV,67,38,29,56.72
KogMaw,Taric,6,2,4,33.33
KogMaw,Renata,14,11,3,78.57
KogMaw,Aphelios,31,20,11,64.52
KogMaw,Udyr,10,10,0,100
KogMaw,Neeko,15,7,8,46.67
KogMaw,Renekton,31,18,13,58.06
KogMaw,Kalista,17,11,6,64.71
KogMaw,Belveth,9,2,7,22.22
KogMaw,Evelynn,17,4,13,23.53
KogMaw,Ivern,14,9,5,64.29
KogMaw,Yuumi,47,16,31,34.04
KogMaw,Rumble,18,8,10,44.44
KogMaw,Karthus,10,10,0,100
KogMaw,Hecarim,20,10,10,50
KogMaw,Olaf,3,3,0,100
KogMaw,Kassadin,9,6,3,66.67
KogMaw,Singed,12,9,3,75
KogMaw,RekSai,6,6,0,100
KogMaw,Sona,3,3,0,100
Aatrox,Jayce,159,95,64,59.75
Aatrox,Hecarim,94,44,50,46.81
Aatrox,Milio,172,74,98,43.02
Aatrox,Caitlyn,541,259,282,47.87
Aatrox,Zoe,110,59,51,53.64
Aatrox,Sett,305,137,168,44.92
Aatrox,LeeSin,608,267,341,43.91
Aatrox,Hwei,178,87,91,48.88
Aatrox,Jhin,434,203,231,46.77
Aatrox,Zilean,72,32,40,44.44
Aatrox,Briar,135,55,80,40.74
Aatrox,Nocturne,363,153,210,42.15
Aatrox,Lissandra,88,31,57,35.23
Aatrox,Shen,178,71,107,39.89
Aatrox,Malphite,247,111,136,44.94
Aatrox,Graves,225,102,123,45.33
Aatrox,Vladimir,153,67,86,43.79
Aatrox,Ezreal,653,311,342,47.63
Aatrox,Camille,124,68,56,54.84
Aatrox,Kayle,94,34,60,36.17
Aatrox,Viego,354,191,163,53.95
Aatrox,Yasuo,468,239,229,51.07
Aatrox,Braum,161,46,115,28.57
Aatrox,Kalista,97,52,45,53.61
Aatrox,Amumu,224,87,137,38.84
Aatrox,Ashe,577,310,267,53.73
Aatrox,Irelia,135,83,52,61.48
Aatrox,Darius,519,251,268,48.36
Aatrox,Vi,275,109,166,39.64
Aatrox,Aurora,224,115,109,51.34
Aatrox,Vayne,281,144,137,51.25
Aatrox,Yuumi,272,129,143,47.43
Aatrox,Kennen,74,35,39,47.3
Aatrox,Garen,391,162,229,41.43
Aatrox,Talon,142,81,61,57.04
Aatrox,Aphelios,165,75,90,45.45
Aatrox,Pyke,206,106,100,51.46
Aatrox,Gwen,138,71,67,51.45
Aatrox,MasterYi,226,114,112,50.44
Aatrox,Akshan,59,36,23,61.02
Aatrox,Zeri,132,59,73,44.7
Aatrox,Rakan,110,59,51,53.64
Aatrox,Mordekaiser,333,146,187,43.84
Aatrox,Kayn,252,106,146,42.06
Aatrox,Ziggs,88,38,50,43.18
Aatrox,Nautilus,293,153,140,52.22
Aatrox,Yone,513,223,290,43.47
Aatrox,Warwick,310,176,134,56.77
Aatrox,Gnar,115,63,52,54.78
Aatrox,JarvanIV,189,99,90,52.38
Aatrox,Rumble,83,39,44,46.99
Aatrox,Galio,351,189,162,53.85
Aatrox,Lulu,405,198,207,48.89
Aatrox,Nasus,122,42,80,34.43
Aatrox,Lux,565,300,265,53.1
Aatrox,Xayah,157,80,77,50.96
Aatrox,Maokai,141,76,65,53.9
Aatrox,TahmKench,220,131,89,59.55
Aatrox,Tristana,225,106,119,47.11
Aatrox,Nunu,137,80,57,58.39
Aatrox,Ornn,157,75,82,47.77
Aatrox,Ahri,335,178,157,53.13
Aatrox,Anivia,74,25,49,33.78
Aatrox,MissFortune,444,227,217,51.13
Aatrox,Teemo,248,126,122,50.81
Aatrox,DrMundo,107,54,53,50.47
Aatrox,KogMaw,87,47,40,54.02
Aatrox,Yorick,168,72,96,42.86
Aatrox,Nidalee,120,65,55,54.17
Aatrox,Twitch,126,73,53,57.94
Aatrox,Rell,158,87,71,55.06
Aatrox,KSante,218,106,112,48.62
Aatrox,Seraphine,142,47,95,33.1
Aatrox,Pantheon,357,191,166,53.5
Aatrox,Gragas,184,101,83,54.89
Aatrox,Rengar,71,37,34,52.11
Aatrox,Malzahar,241,123,118,51.04
Aatrox,Senna,133,76,57,57.14
Aatrox,Ryze,100,57,43,57
Aatrox,Jinx,575,246,329,42.78
Aatrox,Heimerdinger,71,35,36,49.3
Aatrox,Fizz,73,35,38,47.95
Aatrox,Blitzcrank,210,81,129,38.57
Aatrox,Renekton,168,86,82,51.19
Aatrox,Skarner,127,67,60,52.76
Aatrox,Smolder,156,81,75,51.92
Aatrox,Riven,75,41,34,54.67
Aatrox,Azir,136,65,71,47.79
Aatrox,Sylas,436,200,236,45.87
Aatrox,Zed,245,113,132,46.12
Aatrox,Lillia,117,66,51,56.41
Aatrox,Sion,181,88,93,48.62
Aatrox,Jax,211,101,110,47.87
Aatrox,Nami,254,114,140,44.88
Aatrox,Chogath,249,106,143,42.57
Aatrox,Renata,62,38,24,61.29
Aatrox,Diana,362,164,198,45.3
Aatrox,Illaoi,104,54,50,51.92
Aatrox,Evelynn,64,22,42,34.38
Aatrox,Mel,468,218,250,46.58
Aatrox,Kaisa,475,245,230,51.58
Aatrox,Trundle,102,51,51,50
Aatrox,Rammus,88,39,49,44.32
Aatrox,AurelionSol,99,37,62,37.37
Aatrox,Neeko,129,63,66,48.84
Aatrox,Sejuani,164,58,106,35.37
Aatrox,Kindred,125,87,38,69.6
Aatrox,Karma,323,157,166,48.61
Aatrox,Singed,104,38,66,36.54
Aatrox,Swain,238,113,125,47.48
Aatrox,Thresh,560,237,323,42.32
Aatrox,Urgot,133,64,69,48.12
Aatrox,Akali,240,94,146,39.17
Aatrox,Kled,64,34,30,53.13
Aatrox,Kassadin,45,24,21,53.33
Aatrox,XinZhao,136,62,74,45.59
Aatrox,Katarina,151,69,82,45.7
Aatrox,Lucian,270,139,131,51.48
Aatrox,Cassiopeia,75,47,28,62.67
Aatrox,Olaf,53,14,39,26.42
Aatrox,Morgana,194,88,106,45.36
Aatrox,Poppy,203,115,88,56.65
Aatrox,Ekko,205,107,98,52.2
Aatrox,Ambessa,229,93,136,40.61
Aatrox,Zac,166,90,76,54.22
Aatrox,Corki,98,52,46,53.06
Aatrox,Syndra,166,83,83,50
Aatrox,Brand,110,54,56,49.09
Aatrox,Gangplank,228,111,117,48.68
Aatrox,Alistar,146,72,74,49.32
Aatrox,Nilah,65,20,45,30.77
Aatrox,Samira,183,92,91,50.27
Aatrox,Leona,255,110,145,43.14
Aatrox,Draven,121,53,68,43.8
Aatrox,Tryndamere,69,31,38,44.93
Aatrox,Fiora,96,58,38,60.42
Aatrox,Viktor,207,94,113,45.41
Aatrox,Elise,181,79,102,43.65
Aatrox,Xerath,227,122,105,53.74
Aatrox,Bard,86,43,43,50
Aatrox,Leblanc,143,73,70,51.05
Aatrox,Varus,241,118,123,48.96
Aatrox,Volibear,264,149,115,56.44
Aatrox,MonkeyKing,184,86,98,46.74
Aatrox,Velkoz,125,66,59,52.8
Aatrox,Shaco,158,87,71,55.06
Aatrox,Sona,51,31,20,60.78
Aatrox,Qiyana,61,36,25,59.02
Aatrox,Veigar,202,102,100,50.5
Aatrox,FiddleSticks,112,45,67,40.18
Aatrox,Orianna,141,59,82,41.84
Aatrox,Soraka,120,49,71,40.83
Aatrox,Sivir,152,65,87,42.76
Aatrox,Naafiri,94,31,63,32.98
Aatrox,Taliyah,78,41,37,52.56
Aatrox,Karthus,72,56,16,77.78
Aatrox,Khazix,94,44,50,46.81
Aatrox,Annie,74,45,29,60.81
Aatrox,Zyra,180,79,101,43.89
Aatrox,Udyr,90,47,43,52.22
Aatrox,TwistedFate,88,41,47,46.59
Aatrox,Quinn,81,48,33,59.26
Aatrox,Janna,68,30,38,44.12
Aatrox,Shyvana,44,16,28,36.36
Aatrox,Vex,103,56,47,54.37
Aatrox,Taric,34,17,17,50
Aatrox,Belveth,37,25,12,67.57
Aatrox,Ivern,33,22,11,66.67
Aatrox,RekSai,41,20,21,48.78
MasterYi,Jayce,110,63,47,57.27
MasterYi,Hecarim,59,26,33,44.07
MasterYi,Milio,144,56,88,38.89
MasterYi,Caitlyn,632,312,320,49.37
MasterYi,Zoe,77,35,42,45.45
MasterYi,Gangplank,128,61,67,47.66
MasterYi,FiddleSticks,146,56,90,38.36
MasterYi,Veigar,185,86,99,46.49
MasterYi,Ezreal,574,286,288,49.83
MasterYi,Lux,491,250,241,50.92
MasterYi,Nasus,154,85,69,55.19
MasterYi,Shaco,179,106,73,59.22
MasterYi,Xerath,223,119,104,53.36
MasterYi,Lulu,310,128,182,41.29
MasterYi,Yone,400,203,197,50.75
MasterYi,Diana,308,151,157,49.03
MasterYi,Gragas,202,97,105,48.02
MasterYi,Yasuo,495,232,263,46.87
MasterYi,Nami,221,105,116,47.51
MasterYi,Fiora,53,25,28,47.17
MasterYi,Singed,82,44,38,53.66
MasterYi,Ornn,143,73,70,51.05
MasterYi,Kindred,83,58,25,69.88
MasterYi,Talon,98,59,39,60.2
MasterYi,Samira,184,88,96,47.83
MasterYi,Ashe,449,236,213,52.56
MasterYi,Jax,280,122,158,43.57
MasterYi,Graves,140,64,76,45.71
MasterYi,Kassadin,36,23,13,63.89
MasterYi,Tristana,207,97,110,46.86
MasterYi,Malphite,302,155,147,51.32
MasterYi,Vladimir,152,54,98,35.53
MasterYi,Camille,92,48,44,52.17
MasterYi,RekSai,42,22,20,52.38
MasterYi,Nunu,140,80,60,57.14
MasterYi,Hwei,110,50,60,45.45
MasterYi,Morgana,222,112,110,50.45
MasterYi,Nautilus,296,131,165,44.26
MasterYi,Sejuani,130,43,87,33.08
MasterYi,Fizz,106,47,59,44.34
MasterYi,Alistar,100,42,58,42
MasterYi,Warwick,335,151,184,45.07
MasterYi,LeeSin,394,216,178,54.82
MasterYi,Viktor,209,85,124,40.67
MasterYi,Lucian,164,91,73,55.49
MasterYi,Kennen,80,47,33,58.75
MasterYi,XinZhao,152,64,88,42.11
MasterYi,Brand,114,76,38,66.67
MasterYi,Elise,177,76,101,42.94
MasterYi,Quinn,62,33,29,53.23
MasterYi,Kaisa,354,198,156,55.93
MasterYi,Nocturne,268,149,119,55.6
MasterYi,Malzahar,247,100,147,40.49
MasterYi,Pyke,188,95,93,50.53
MasterYi,Gnar,107,65,42,60.75
MasterYi,Amumu,293,136,157,46.42
MasterYi,Aurora,138,65,73,47.1
MasterYi,Thresh,389,210,179,53.98
MasterYi,Kayn,307,175,132,57
MasterYi,Irelia,160,69,91,43.13
MasterYi,Rell,130,61,69,46.92
MasterYi,Leona,248,113,135,45.56
MasterYi,Rammus,274,122,152,44.53
MasterYi,Twitch,144,74,70,51.39
MasterYi,Aatrox,226,112,114,49.56
MasterYi,Zac,120,61,59,50.83
MasterYi,Zed,239,127,112,53.14
MasterYi,Varus,226,109,117,48.23
MasterYi,Soraka,97,50,47,51.55
MasterYi,Akali,210,96,114,45.71
MasterYi,Jinx,556,259,297,46.58
MasterYi,Yorick,176,59,117,33.52
MasterYi,Annie,56,18,38,32.14
MasterYi,Jhin,405,206,199,50.86
MasterYi,Renekton,91,51,40,56.04
MasterYi,TwistedFate,87,55,32,63.22
MasterYi,Mel,475,258,217,54.32
MasterYi,Seraphine,132,68,64,51.52
MasterYi,Darius,480,242,238,50.42
MasterYi,Pantheon,391,210,181,53.71
MasterYi,Mordekaiser,276,149,127,53.99
MasterYi,Volibear,260,112,148,43.08
MasterYi,Azir,102,55,47,53.92
MasterYi,Tryndamere,92,37,55,40.22
MasterYi,Vayne,326,115,211,35.28
MasterYi,Senna,136,79,57,58.09
MasterYi,Syndra,131,48,83,36.64
MasterYi,Xayah,101,35,66,34.65
MasterYi,Rakan,135,54,81,40
MasterYi,Vi,254,112,142,44.09
MasterYi,Renata,79,40,39,50.63
MasterYi,Sylas,367,183,184,49.86
MasterYi,Vex,114,42,72,36.84
MasterYi,Poppy,197,104,93,52.79
MasterYi,Riven,88,33,55,37.5
MasterYi,TahmKench,242,135,107,55.79
MasterYi,Sett,301,126,175,41.86
MasterYi,MissFortune,480,216,264,45
MasterYi,Gwen,132,58,74,43.94
MasterYi,Smolder,170,92,78,54.12
MasterYi,Katarina,155,62,93,40
MasterYi,Ekko,199,109,90,54.77
MasterYi,Teemo,217,110,107,50.69
MasterYi,Maokai,103,52,51,50.49
MasterYi,Chogath,298,124,174,41.61
MasterYi,Taliyah,66,36,30,54.55
MasterYi,DrMundo,126,43,83,34.13
MasterYi,Qiyana,58,36,22,62.07
MasterYi,Zeri,106,53,53,50
MasterYi,Ahri,279,161,118,57.71
MasterYi,Garen,383,196,187,51.17
MasterYi,Galio,230,104,126,45.22
MasterYi,Lillia,104,41,63,39.42
MasterYi,KogMaw,64,19,45,29.69
MasterYi,Karthus,101,54,47,53.47
MasterYi,Taric,58,21,37,36.21
MasterYi,Shen,189,67,122,35.45
MasterYi,Kayle,111,59,52,53.15
MasterYi,Karma,269,131,138,48.7
MasterYi,Braum,165,72,93,43.64
MasterYi,MonkeyKing,189,90,99,47.62
MasterYi,Zyra,157,79,78,50.32
MasterYi,Nilah,67,21,46,31.34
MasterYi,Briar,131,50,81,38.17
MasterYi,Blitzcrank,167,80,87,47.9
MasterYi,Zilean,61,19,42,31.15
MasterYi,Ivern,49,25,24,51.02
MasterYi,Ambessa,149,73,76,48.99
MasterYi,Rengar,56,24,32,42.86
MasterYi,Ryze,62,19,43,30.65
MasterYi,Janna,68,29,39,42.65
MasterYi,Cassiopeia,35,16,19,45.71
MasterYi,Sivir,136,74,62,54.41
MasterYi,Kalista,83,46,37,55.42
MasterYi,Bard,43,26,17,60.47
MasterYi,Evelynn,66,32,34,48.48
MasterYi,KSante,169,88,81,52.07
MasterYi,Skarner,95,41,54,43.16
MasterYi,Naafiri,77,46,31,59.74
MasterYi,Trundle,129,62,67,48.06
MasterYi,Viego,229,107,122,46.72
MasterYi,Aphelios,118,61,57,51.69
MasterYi,JarvanIV,209,98,111,46.89
MasterYi,AurelionSol,89,37,52,41.57
MasterYi,Corki,79,37,42,46.84
MasterYi,Orianna,127,50,77,39.37
MasterYi,Khazix,128,53,75,41.41
MasterYi,Anivia,98,44,54,44.9
MasterYi,Illaoi,128,78,50,60.94
MasterYi,Yuumi,206,103,103,50
MasterYi,Leblanc,130,82,48,63.08
MasterYi,Nidalee,63,30,33,47.62
MasterYi,Swain,219,115,104,52.51
MasterYi,Heimerdinger,92,45,47,48.91
MasterYi,Draven,99,50,49,50.51
MasterYi,Neeko,140,78,62,55.71
MasterYi,Sion,153,84,69,54.9
MasterYi,Velkoz,116,61,55,52.59
MasterYi,Urgot,126,68,58,53.97
MasterYi,Akshan,54,29,25,53.7
MasterYi,Sona,49,20,29,40.82
MasterYi,Olaf,48,31,17,64.58
MasterYi,Shyvana,74,32,42,43.24
MasterYi,Rumble,78,47,31,60.26
MasterYi,Lissandra,102,46,56,45.1
MasterYi,Belveth,38,15,23,39.47
MasterYi,Ziggs,70,39,31,55.71
MasterYi,Udyr,55,27,28,49.09
MasterYi,Kled,34,21,13,61.76
Jayce,Aatrox,159,64,95,40.25
Jayce,MasterYi,110,47,63,42.73
Jayce,TwistedFate,46,28,18,60.87
Jayce,Varus,126,66,60,52.38
Jayce,Lux,242,128,114,52.89
Jayce,Twitch,58,23,35,39.66
Jayce,Lillia,51,28,23,54.9
Jayce,Katarina,80,41,39,51.25
Jayce,Vayne,157,74,83,47.13
Jayce,Blitzcrank,138,62,76,44.93
Jayce,Tryndamere,36,22,14,61.11
Jayce,Akali,144,90,54,62.5
Jayce,KogMaw,29,13,16,44.83
Jayce,Swain,99,49,50,49.49
Jayce,Yorick,96,49,47,51.04
Jayce,Nunu,40,18,22,45
Jayce,Bard,44,20,24,45.45
Jayce,Gnar,72,38,34,52.78
Jayce,Kindred,48,33,15,68.75
Jayce,Syndra,77,41,36,53.25
Jayce,Jinx,319,159,160,49.84
Jayce,Braum,99,63,36,63.64
Jayce,Yone,170,90,80,52.94
Jayce,Sejuani,87,29,58,33.33
Jayce,Hwei,63,20,43,31.75
Jayce,Chogath,151,58,93,38.41
Jayce,Sett,124,60,64,48.39
Jayce,Graves,114,65,49,57.02
Jayce,Mel,225,115,110,51.11
Jayce,TahmKench,91,39,52,42.86
Jayce,Zed,134,64,70,47.76
Jayce,Thresh,220,100,120,45.45
Jayce,Zac,61,36,25,59.02
Jayce,Kayn,99,60,39,60.61
Jayce,Caitlyn,284,142,142,50
Jayce,Janna,41,16,25,39.02
Jayce,DrMundo,46,20,26,43.48
Jayce,Yasuo,224,106,118,47.32
Jayce,Xerath,145,76,69,52.41
Jayce,Lucian,138,81,57,58.7
Jayce,Nami,90,39,51,43.33
Jayce,Garen,153,52,101,33.99
Jayce,Mordekaiser,113,61,52,53.98
Jayce,Ahri,176,97,79,55.11
Jayce,Kaisa,191,97,94,50.79
Jayce,Lulu,187,78,109,41.71
Jayce,Ambessa,105,48,57,45.71
Jayce,Udyr,31,11,20,35.48
Jayce,Corki,43,21,22,48.84
Jayce,Alistar,84,49,35,58.33
Jayce,Viktor,125,66,59,52.8
Jayce,Vi,184,92,92,50
Jayce,Poppy,72,36,36,50
Jayce,Veigar,107,66,41,61.68
Jayce,Ziggs,24,15,9,62.5
Jayce,Morgana,112,46,66,41.07
Jayce,Viego,175,75,100,42.86
Jayce,Irelia,130,70,60,53.85
Jayce,Kennen,52,25,27,48.08
Jayce,Amumu,140,62,78,44.29
Jayce,Ezreal,404,224,180,55.45
Jayce,Warwick,78,30,48,38.46
Jayce,Tristana,87,36,51,41.38
Jayce,Milio,70,26,44,37.14
Jayce,Ashe,253,118,135,46.64
Jayce,Orianna,66,38,28,57.58
Jayce,Ivern,24,14,10,58.33
Jayce,Karma,192,108,84,56.25
Jayce,Shen,62,33,29,53.23
Jayce,Hecarim,45,28,17,62.22
Jayce,Jax,95,45,50,47.37
Jayce,LeeSin,298,163,135,54.7
Jayce,Senna,82,44,38,53.66
Jayce,Ekko,84,28,56,33.33
Jayce,KSante,97,53,44,54.64
Jayce,Teemo,96,52,44,54.17
Jayce,Skarner,39,16,23,41.03
Jayce,Cassiopeia,36,21,15,58.33
Jayce,Brand,42,19,23,45.24
Jayce,Soraka,75,41,34,54.67
Jayce,Pantheon,205,107,98,52.2
Jayce,Belveth,32,18,14,56.25
Jayce,Anivia,42,26,16,61.9
Jayce,Briar,55,26,29,47.27
Jayce,Velkoz,40,18,22,45
Jayce,Malzahar,98,42,56,42.86
Jayce,Shaco,75,35,40,46.67
Jayce,Nilah,45,23,22,51.11
Jayce,Aurora,117,52,65,44.44
Jayce,Sona,22,9,13,40.91
Jayce,Nasus,79,37,42,46.84
Jayce,Fiora,65,42,23,64.62
Jayce,Xayah,53,26,27,49.06
Jayce,Nocturne,124,59,65,47.58
Jayce,Diana,169,87,82,51.48
Jayce,Vladimir,77,42,35,54.55
Jayce,Yuumi,98,54,44,55.1
Jayce,MissFortune,195,102,93,52.31
Jayce,Nautilus,143,78,65,54.55
Jayce,Gangplank,84,41,43,48.81
Jayce,Rengar,28,17,11,60.71
Jayce,Taliyah,35,19,16,54.29
Jayce,Rammus,41,30,11,73.17
Jayce,Smolder,80,45,35,56.25
Jayce,Kayle,55,30,25,54.55
Jayce,Karthus,45,22,23,48.89
Jayce,Rakan,61,32,29,52.46
Jayce,Gragas,127,55,72,43.31
Jayce,Lissandra,30,19,11,63.33
Jayce,Azir,72,39,33,54.17
Jayce,Draven,41,23,18,56.1
Jayce,Trundle,48,26,22,54.17
Jayce,Elise,101,51,50,50.5
Jayce,Quinn,55,20,35,36.36
Jayce,Malphite,141,56,85,39.72
Jayce,Heimerdinger,55,29,26,52.73
Jayce,Pyke,105,52,53,49.52
Jayce,Darius,244,109,135,44.67
Jayce,Illaoi,52,34,18,65.38
Jayce,Galio,147,65,82,44.22
Jayce,Rell,65,20,45,30.77
Jayce,XinZhao,105,42,63,40
Jayce,Kalista,46,26,20,56.52
Jayce,Rumble,60,38,22,63.33
Jayce,Shyvana,28,9,19,32.14
Jayce,Samira,82,22,60,26.83
Jayce,Riven,33,22,11,66.67
Jayce,Naafiri,25,13,12,52
Jayce,Leblanc,74,42,32,56.76
Jayce,Leona,92,54,38,58.7
Jayce,Ryze,24,10,14,41.67
Jayce,Sion,111,51,60,45.95
Jayce,Sylas,176,98,78,55.68
Jayce,FiddleSticks,70,36,34,51.43
Jayce,Jhin,222,126,96,56.76
Jayce,Zilean,31,8,23,25.81
Jayce,Maokai,35,27,8,77.14
Jayce,Volibear,76,49,27,64.47
Jayce,Zoe,46,10,36,21.74
Jayce,Renata,36,25,11,69.44
Jayce,Camille,72,42,30,58.33
Jayce,Aphelios,53,21,32,39.62
Jayce,MonkeyKing,78,26,52,33.33
Jayce,Kled,16,6,10,37.5
Jayce,Talon,68,32,36,47.06
Jayce,Renekton,53,24,29,45.28
Jayce,Sivir,52,14,38,26.92
Jayce,Urgot,48,30,18,62.5
Jayce,Zeri,53,24,29,45.28
Jayce,Ornn,68,30,38,44.12
Jayce,Seraphine,69,42,27,60.87
Jayce,Taric,25,13,12,52
Jayce,JarvanIV,116,65,51,56.03
Jayce,Fizz,41,24,17,58.54
Jayce,Vex,67,35,32,52.24
Jayce,Neeko,41,13,28,31.71
Jayce,Evelynn,15,7,8,46.67
Jayce,Zyra,104,46,58,44.23
Jayce,Gwen,45,24,21,53.33
Jayce,Annie,21,12,9,57.14
Jayce,Nidalee,43,29,14,67.44
Jayce,Akshan,23,13,10,56.52
Jayce,Kassadin,20,11,9,55
Jayce,Olaf,40,23,17,57.5
Jayce,AurelionSol,48,21,27,43.75
Jayce,Singed,28,14,14,50
Jayce,Khazix,54,27,27,50
Jayce,Qiyana,11,6,5,54.55
Jayce,RekSai,14,5,9,35.71
Zoe,Aatrox,110,51,59,46.36
Zoe,MasterYi,77,42,35,54.55
Zoe,TwistedFate,51,29,22,56.86
Zoe,Varus,92,49,43,53.26
Zoe,Lux,232,128,104,55.17
Zoe,Nasus,61,32,29,52.46
Zoe,Amumu,112,56,56,50
Zoe,Sylas,186,105,81,56.45
Zoe,Twitch,47,32,15,68.09
Zoe,Lulu,198,108,90,54.55
Zoe,Malphite,106,33,73,31.13
Zoe,Vi,129,49,80,37.98
Zoe,Azir,35,21,14,60
Zoe,MissFortune,210,96,114,45.71
Zoe,Kayn,105,36,69,34.29
Zoe,Ekko,88,47,41,53.41
Zoe,Teemo,83,42,41,50.6
Zoe,Sivir,67,28,39,41.79
Zoe,Velkoz,50,31,19,62
Zoe,Mordekaiser,130,71,59,54.62
Zoe,XinZhao,98,59,39,60.2
Zoe,Diana,152,66,86,43.42
Zoe,Tristana,112,44,68,39.29
Zoe,Thresh,142,70,72,49.3
Zoe,Gnar,51,26,25,50.98
Zoe,Ahri,160,82,78,51.25
Zoe,Karma,133,60,73,45.11
Zoe,Ornn,58,18,40,31.03
Zoe,Jax,63,22,41,34.92
Zoe,Ashe,190,105,85,55.26
Zoe,Yuumi,97,36,61,37.11
Zoe,Shen,75,26,49,34.67
Zoe,Xayah,42,16,26,38.1
Zoe,Viktor,84,32,52,38.1
Zoe,Sejuani,61,40,21,65.57
Zoe,Nami,131,45,86,34.35
Zoe,Kennen,31,15,16,48.39
Zoe,Illaoi,50,28,22,56
Zoe,Malzahar,112,47,65,41.96
Zoe,Vayne,111,64,47,57.66
Zoe,Milio,96,41,55,42.71
Zoe,Yasuo,166,63,103,37.95
Zoe,Ezreal,232,126,106,54.31
Zoe,TahmKench,93,50,43,53.76
Zoe,Jhin,170,64,106,37.65
Zoe,Nautilus,110,46,64,41.82
Zoe,Fiora,32,8,24,25
Zoe,LeeSin,185,85,100,45.95
Zoe,Samira,33,22,11,66.67
Zoe,Rell,76,32,44,42.11
Zoe,Yorick,66,37,29,56.06
Zoe,Hwei,65,30,35,46.15
Zoe,Shaco,86,26,60,30.23
Zoe,Lucian,94,32,62,34.04
Zoe,Heimerdinger,27,11,16,40.74
Zoe,Morgana,93,28,65,30.11
Zoe,Renekton,81,44,37,54.32
Zoe,Jinx,257,102,155,39.69
Zoe,Warwick,109,34,75,31.19
Zoe,Camille,51,13,38,25.49
Zoe,Caitlyn,245,130,115,53.06
Zoe,Zyra,70,39,31,55.71
Zoe,Sion,77,32,45,41.56
Zoe,Kindred,45,25,20,55.56
Zoe,Nidalee,47,28,19,59.57
Zoe,Yone,166,99,67,59.64
Zoe,JarvanIV,43,24,19,55.81
Zoe,Fizz,26,5,21,19.23
Zoe,Mel,158,89,69,56.33
Zoe,Seraphine,50,26,24,52
Zoe,Gragas,93,59,34,63.44
Zoe,Pyke,61,28,33,45.9
Zoe,Trundle,36,17,19,47.22
Zoe,AurelionSol,43,21,22,48.84
Zoe,Zeri,52,12,40,23.08
Zoe,Kaisa,194,86,108,44.33
Zoe,KSante,80,48,32,60
Zoe,Hecarim,29,12,17,41.38
Zoe,Lissandra,41,12,29,29.27
Zoe,Brand,75,40,35,53.33
Zoe,Singed,24,9,15,37.5
Zoe,FiddleSticks,43,21,22,48.84
Zoe,Pantheon,173,76,97,43.93
Zoe,Leona,100,51,49,51
Zoe,DrMundo,51,14,37,27.45
Zoe,Draven,53,13,40,24.53
Zoe,Blitzcrank,97,39,58,40.21
Zoe,Cassiopeia,44,28,16,63.64
Zoe,Vladimir,60,32,28,53.33
Zoe,Riven,32,21,11,65.63
Zoe,Skarner,51,18,33,35.29
Zoe,Orianna,56,24,32,42.86
Zoe,Braum,71,26,45,36.62
Zoe,Naafiri,34,24,10,70.59
Zoe,Sett,138,71,67,51.45
Zoe,Briar,35,20,15,57.14
Zoe,Syndra,76,32,44,42.11
Zoe,Poppy,62,34,28,54.84
Zoe,Alistar,50,27,23,54
Zoe,Darius,192,93,99,48.44
Zoe,Leblanc,61,22,39,36.07
Zoe,Soraka,13,8,5,61.54
Zoe,Aurora,49,39,10,79.59
Zoe,Gangplank,63,20,43,31.75
Zoe,Katarina,55,23,32,41.82
Zoe,Udyr,38,21,17,55.26
Zoe,Zed,92,36,56,39.13
Zoe,Garen,110,40,70,36.36
Zoe,Vex,35,14,21,40
Zoe,Bard,14,12,2,85.71
Zoe,Chogath,108,57,51,52.78
Zoe,Aphelios,50,29,21,58
Zoe,Volibear,86,37,49,43.02
Zoe,Rumble,35,8,27,22.86
Zoe,Irelia,53,22,31,41.51
Zoe,Kassadin,16,13,3,81.25
Zoe,Quinn,34,19,15,55.88
Zoe,Nocturne,96,49,47,51.04
Zoe,Akali,103,60,43,58.25
Zoe,Ambessa,78,30,48,38.46
Zoe,Viego,149,54,95,36.24
Zoe,Janna,35,18,17,51.43
Zoe,Ziggs,30,13,17,43.33
Zoe,Kled,16,9,7,56.25
Zoe,RekSai,8,8,0,100
Zoe,Xerath,70,39,31,55.71
Zoe,Nilah,25,10,15,40
Zoe,Evelynn,26,15,11,57.69
Zoe,Smolder,58,36,22,62.07
Zoe,Sona,17,12,5,70.59
Zoe,Belveth,19,10,9,52.63
Zoe,Zilean,36,11,25,30.56
Zoe,Elise,102,47,55,46.08
Zoe,Jayce,46,36,10,78.26
Zoe,Khazix,84,40,44,47.62
Zoe,Kayle,33,11,22,33.33
Zoe,Swain,74,26,48,35.14
Zoe,Veigar,90,42,48,46.67
Zoe,Tryndamere,42,14,28,33.33
Zoe,Anivia,41,19,22,46.34
Zoe,Rammus,50,32,18,64
Zoe,MonkeyKing,46,17,29,36.96
Zoe,Nunu,48,20,28,41.67
Zoe,Taric,23,9,14,39.13
Zoe,KogMaw,43,26,17,60.47
Zoe,Qiyana,20,14,6,70
Zoe,Akshan,36,15,21,41.67
Zoe,Maokai,53,27,26,50.94
Zoe,Senna,40,21,19,52.5
Zoe,Galio,129,39,90,30.23
Zoe,Zac,55,43,12,78.18
Zoe,Rakan,48,15,33,31.25
Zoe,Annie,26,17,9,65.38
Zoe,Taliyah,11,9,2,81.82
Zoe,Shyvana,14,10,4,71.43
Zoe,Gwen,43,24,19,55.81
Zoe,Karthus,32,18,14,56.25
Zoe,Graves,54,31,23,57.41
Zoe,Ivern,22,14,8,63.64
Zoe,Rengar,21,9,12,42.86
Zoe,Neeko,60,34,26,56.67
Zoe,Ryze,25,15,10,60
Zoe,Urgot,33,23,10,69.7
Zoe,Corki,36,24,12,66.67
Zoe,Talon,71,32,39,45.07
Zoe,Kalista,38,23,15,60.53
Zoe,Lillia,26,18,8,69.23
Zoe,Renata,17,3,14,17.65
Zoe,Olaf,18,3,15,16.67
Kennen,Gnar,39,12,27,30.77
Kennen,Hecarim,17,11,6,64.71
Kennen,Viktor,77,47,30,61.04
Kennen,MissFortune,121,63,58,52.07
Kennen,Rell,55,13,42,23.64
Kennen,Yorick,56,34,22,60.71
Kennen,Skarner,32,16,16,50
Kennen,Mel,154,73,81,47.4
Kennen,Smolder,41,24,17,58.54
Kennen,Senna,49,42,7,85.71
Kennen,Nasus,36,23,13,63.89
Kennen,MasterYi,80,33,47,41.25
Kennen,Chogath,110,41,69,37.27
Kennen,Ezreal,228,124,104,54.39
Kennen,Amumu,80,37,43,46.25
Kennen,Aatrox,74,39,35,52.7
Kennen,Sejuani,40,21,19,52.5
Kennen,Yasuo,122,80,42,65.57
Kennen,Annie,23,11,12,47.83
Kennen,Nami,71,22,49,30.99
Kennen,Garen,85,33,52,38.82
Kennen,Trundle,43,17,26,39.53
Kennen,Katarina,53,30,23,56.6
Kennen,Zoe,31,16,15,51.61
Kennen,Zac,57,19,38,33.33
Kennen,Nocturne,100,56,44,56
Kennen,Veigar,47,35,12,74.47
Kennen,KogMaw,41,21,20,51.22
Kennen,Morgana,59,33,26,55.93
Kennen,Kled,23,8,15,34.78
Kennen,Vladimir,42,10,32,23.81
Kennen,Jhin,161,69,92,42.86
Kennen,Pyke,75,31,44,41.33
Kennen,Mordekaiser,93,41,52,44.09
Kennen,Shaco,62,34,28,54.84
Kennen,Leblanc,50,25,25,50
Kennen,Nilah,16,5,11,31.25
Kennen,Thresh,145,86,59,59.31
Kennen,Jax,51,27,24,52.94
Kennen,Khazix,33,20,13,60.61
Kennen,Vex,46,27,19,58.7
Kennen,Caitlyn,183,73,110,39.89
Kennen,Ambessa,47,32,15,68.09
Kennen,Jayce,52,27,25,51.92
Kennen,Draven,67,29,38,43.28
Kennen,Vi,76,40,36,52.63
Kennen,Renata,13,0,13,0
Kennen,Heimerdinger,34,11,23,32.35
Kennen,Ivern,11,3,8,27.27
Kennen,Ashe,147,94,53,63.95
Kennen,Warwick,61,23,38,37.7
Kennen,Renekton,50,13,37,26
Kennen,Irelia,64,37,27,57.81
Kennen,Alistar,49,20,29,40.82
Kennen,LeeSin,154,86,68,55.84
Kennen,Jinx,137,65,72,47.45
Kennen,Lux,138,56,82,40.58
Kennen,Kayn,70,38,32,54.29
Kennen,Viego,110,50,60,45.45
Kennen,Akali,79,45,34,56.96
Kennen,Corki,36,8,28,22.22
Kennen,Lillia,33,11,22,33.33
Kennen,Aurora,72,44,28,61.11
Kennen,Lulu,114,69,45,60.53
Kennen,Gragas,51,28,23,54.9
Kennen,Kaisa,126,63,63,50
Kennen,Nautilus,84,34,50,40.48
Kennen,JarvanIV,66,18,48,27.27
Kennen,Ahri,131,56,75,42.75
Kennen,Briar,39,21,18,53.85
Kennen,Yone,127,76,51,59.84
Kennen,FiddleSticks,39,14,25,35.9
Kennen,Janna,34,17,17,50
Kennen,Darius,175,97,78,55.43
Kennen,Rammus,21,10,11,47.62
Kennen,Gwen,32,15,17,46.88
Kennen,Karthus,25,12,13,48
Kennen,Tristana,50,29,21,58
Kennen,Swain,74,26,48,35.14
Kennen,Sion,53,27,26,50.94
Kennen,Kassadin,8,2,6,25
Kennen,Quinn,34,10,24,29.41
Kennen,Azir,26,17,9,65.38
Kennen,Yuumi,49,25,24,51.02
Kennen,Fizz,41,18,23,43.9
Kennen,Shen,34,15,19,44.12
Kennen,Ryze,23,14,9,60.87
Kennen,Riven,15,6,9,40
Kennen,Kayle,20,6,14,30
Kennen,Seraphine,33,19,14,57.58
Kennen,Pantheon,98,56,42,57.14
Kennen,Zed,77,37,40,48.05
Kennen,Graves,56,32,24,57.14
Kennen,Tryndamere,22,11,11,50
Kennen,Malphite,80,37,43,46.25
Kennen,Zyra,79,34,45,43.04
Kennen,Qiyana,16,5,11,31.25
Kennen,Singed,12,6,6,50
Kennen,Galio,91,62,29,68.13
Kennen,Camille,30,18,12,60
Kennen,Diana,93,37,56,39.78
Kennen,Syndra,31,18,13,58.06
Kennen,Aphelios,65,33,32,50.77
Kennen,Gangplank,54,31,23,57.41
Kennen,Sylas,113,57,56,50.44
Kennen,Velkoz,35,8,27,22.86
Kennen,Illaoi,34,23,11,67.65
Kennen,Leona,69,37,32,53.62
Kennen,Twitch,23,9,14,39.13
Kennen,Milio,50,19,31,38
Kennen,Olaf,18,10,8,55.56
Kennen,Nunu,39,26,13,66.67
Kennen,Soraka,14,6,8,42.86
Kennen,Varus,74,47,27,63.51
Kennen,Sett,77,46,31,59.74
Kennen,RekSai,3,0,3,0
Kennen,Ekko,56,15,41,26.79
Kennen,Talon,32,12,20,37.5
Kennen,Poppy,48,19,29,39.58
Kennen,Vayne,98,44,54,44.9
Kennen,Malzahar,57,27,30,47.37
Kennen,Karma,65,29,36,44.62
Kennen,Rumble,28,9,19,32.14
Kennen,Evelynn,27,16,11,59.26
Kennen,Xayah,34,19,15,55.88
Kennen,Teemo,86,49,37,56.98
Kennen,MonkeyKing,44,14,30,31.82
Kennen,Volibear,70,23,47,32.86
Kennen,Neeko,37,18,19,48.65
Kennen,Blitzcrank,39,25,14,64.1
Kennen,Urgot,26,14,12,53.85
Kennen,Braum,55,36,19,65.45
Kennen,Naafiri,15,5,10,33.33
Kennen,Rakan,39,31,8,79.49
Kennen,Samira,43,29,14,67.44
Kennen,Belveth,10,4,6,40
Kennen,Bard,44,23,21,52.27
Kennen,XinZhao,55,28,27,50.91
Kennen,Xerath,90,46,44,51.11
Kennen,Sivir,34,16,18,47.06
Kennen,Akshan,17,12,5,70.59
Kennen,DrMundo,35,17,18,48.57
Kennen,Elise,52,23,29,44.23
Kennen,Orianna,47,18,29,38.3
Kennen,Ziggs,21,9,12,42.86
Kennen,Brand,38,13,25,34.21
Kennen,Kindred,25,19,6,76
Kennen,Nidalee,27,19,8,70.37
Kennen,Fiora,20,8,12,40
Kennen,Taliyah,25,17,8,68
Kennen,Kalista,14,0,14,0
Kennen,Lucian,41,25,16,60.98
Kennen,Ornn,48,15,33,31.25
Kennen,TahmKench,46,13,33,28.26
Kennen,Zeri,34,8,26,23.53
Kennen,Hwei,53,15,38,28.3
Kennen,Udyr,31,22,9,70.97
Kennen,Maokai,45,15,30,33.33
Kennen,AurelionSol,15,2,13,13.33
Kennen,Anivia,16,7,9,43.75
Kennen,Rengar,14,8,6,57.14
Kennen,TwistedFate,24,11,13,45.83
Kennen,KSante,43,28,15,65.12
Kennen,Shyvana,10,0,10,0
Kennen,Cassiopeia,31,17,14,54.84
Kennen,Zilean,5,5,0,100
Kennen,Taric,11,5,6,45.45
Kennen,Lissandra,23,12,11,52.17
Kennen,Sona,9,3,6,33.33
Gnar,Kennen,39,27,12,69.23
Gnar,Vi,104,41,63,39.42
Gnar,Ashe,252,144,108,57.14
Gnar,Lux,259,120,139,46.33
Gnar,Leona,151,66,85,43.71
Gnar,Jhin,229,90,139,39.3
Gnar,Ekko,95,29,66,30.53
Gnar,Akali,136,60,76,44.12
Gnar,Ambessa,87,25,62,28.74
Gnar,Karma,177,78,99,44.07
Gnar,Pantheon,205,119,86,58.05
Gnar,Talon,72,32,40,44.44
Gnar,Kaisa,199,116,83,58.29
Gnar,Soraka,67,36,31,53.73
Gnar,Chogath,181,84,97,46.41
Gnar,MasterYi,107,42,65,39.25
Gnar,Gangplank,81,39,42,48.15
Gnar,AurelionSol,41,13,28,31.71
Gnar,Jayce,72,34,38,47.22
Gnar,Singed,31,16,15,51.61
Gnar,JarvanIV,114,69,45,60.53
Gnar,Leblanc,65,27,38,41.54
Gnar,Heimerdinger,56,35,21,62.5
Gnar,Orianna,70,29,41,41.43
Gnar,LeeSin,224,110,114,49.11
Gnar,Seraphine,67,28,39,41.79
Gnar,Aatrox,115,52,63,45.22
Gnar,Ivern,29,15,14,51.72
Gnar,Twitch,96,41,55,42.71
Gnar,Elise,153,68,85,44.44
Gnar,Yasuo,247,103,144,41.7
Gnar,Shaco,74,39,35,52.7
Gnar,Zoe,51,25,26,49.02
Gnar,Thresh,193,89,104,46.11
Gnar,Sett,164,88,76,53.66
Gnar,Lillia,66,15,51,22.73
Gnar,Katarina,91,38,53,41.76
Gnar,Yuumi,132,69,63,52.27
Gnar,Illaoi,39,19,20,48.72
Gnar,Amumu,123,48,75,39.02
Gnar,Vladimir,101,27,74,26.73
Gnar,Mordekaiser,147,65,82,44.22
Gnar,Qiyana,26,23,3,88.46
Gnar,Kalista,50,39,11,78
Gnar,Nautilus,156,73,83,46.79
Gnar,Naafiri,34,14,20,41.18
Gnar,Jinx,380,156,224,41.05
Gnar,Jax,71,31,40,43.66
Gnar,Diana,179,80,99,44.69
Gnar,Irelia,147,69,78,46.94
Gnar,Malphite,196,74,122,37.76
Gnar,Yorick,103,48,55,46.6
Gnar,Nidalee,57,36,21,63.16
Gnar,Yone,184,100,84,54.35
Gnar,Rell,90,46,44,51.11
Gnar,Aurora,105,57,48,54.29
Gnar,Ryze,43,24,19,55.81
Gnar,Maokai,60,24,36,40
Gnar,Kayn,122,58,64,47.54
Gnar,Zed,146,78,68,53.42
Gnar,Draven,59,31,28,52.54
Gnar,Rakan,95,38,57,40
Gnar,Camille,60,22,38,36.67
Gnar,Malzahar,95,38,57,40
Gnar,Caitlyn,258,119,139,46.12
Gnar,Zyra,96,42,54,43.75
Gnar,Sion,98,44,54,44.9
Gnar,Annie,35,29,6,82.86
Gnar,Vayne,158,56,102,35.44
Gnar,Neeko,71,35,36,49.3
Gnar,Volibear,101,35,66,34.65
Gnar,Lissandra,58,17,41,29.31
Gnar,Veigar,132,55,77,41.67
Gnar,Hecarim,59,36,23,61.02
Gnar,Tristana,101,68,33,67.33
Gnar,Fiora,37,17,20,45.95
Gnar,Sejuani,79,22,57,27.85
Gnar,Swain,136,58,78,42.65
Gnar,Zac,91,31,60,34.07
Gnar,Sylas,189,99,90,52.38
Gnar,Smolder,103,45,58,43.69
Gnar,Warwick,130,52,78,40
Gnar,TahmKench,131,50,81,38.17
Gnar,Kled,19,9,10,47.37
Gnar,Mel,196,108,88,55.1
Gnar,Morgana,95,40,55,42.11
Gnar,Aphelios,73,50,23,68.49
Gnar,Milio,81,33,48,40.74
Gnar,Ahri,206,78,128,37.86
Gnar,Ezreal,301,134,167,44.52
Gnar,Blitzcrank,121,60,61,49.59
Gnar,Briar,46,14,32,30.43
Gnar,Sivir,52,23,29,44.23
Gnar,Shen,125,46,79,36.8
Gnar,Zilean,41,23,18,56.1
Gnar,Lulu,187,69,118,36.9
Gnar,Renekton,53,21,32,39.62
Gnar,Gragas,111,64,47,57.66
Gnar,MissFortune,234,98,136,41.88
Gnar,Corki,60,21,39,35
Gnar,Darius,302,136,166,45.03
Gnar,Urgot,53,25,28,47.17
Gnar,Brand,76,41,35,53.95
Gnar,MonkeyKing,111,55,56,49.55
Gnar,Viktor,142,49,93,34.51
Gnar,Ziggs,46,21,25,45.65
Gnar,Garen,187,75,112,40.11
Gnar,Rengar,40,16,24,40
Gnar,Bard,37,16,21,43.24
Gnar,Teemo,88,33,55,37.5
Gnar,Viego,175,73,102,41.71
Gnar,Nilah,37,11,26,29.73
Gnar,Janna,35,14,21,40
Gnar,Pyke,92,40,52,43.48
Gnar,Nasus,57,15,42,26.32
Gnar,Lucian,97,36,61,37.11
Gnar,Alistar,67,22,45,32.84
Gnar,Varus,91,42,49,46.15
Gnar,KSante,103,62,41,60.19
Gnar,Poppy,86,55,31,63.95
Gnar,Galio,137,65,72,47.45
Gnar,Tryndamere,39,19,20,48.72
Gnar,Zeri,55,24,31,43.64
Gnar,DrMundo,54,16,38,29.63
Gnar,Skarner,64,29,35,45.31
Gnar,Trundle,47,23,24,48.94
Gnar,KogMaw,42,23,19,54.76
Gnar,Braum,84,43,41,51.19
Gnar,Riven,49,23,26,46.94
Gnar,Xayah,88,44,44,50
Gnar,Taliyah,47,20,27,42.55
Gnar,Kindred,52,38,14,73.08
Gnar,Karthus,42,25,17,59.52
Gnar,Renata,38,20,18,52.63
Gnar,Kayle,57,32,25,56.14
Gnar,Syndra,103,40,63,38.83
Gnar,Nocturne,134,61,73,45.52
Gnar,Evelynn,27,14,13,51.85
Gnar,Nami,127,38,89,29.92
Gnar,Khazix,51,30,21,58.82
Gnar,XinZhao,90,39,51,43.33
Gnar,Velkoz,68,38,30,55.88
Gnar,Udyr,53,33,20,62.26
Gnar,Akshan,27,11,16,40.74
Gnar,Senna,58,30,28,51.72
Gnar,Samira,55,17,38,30.91
Gnar,Xerath,77,52,25,67.53
Gnar,Nunu,75,29,46,38.67
Gnar,Fizz,46,29,17,63.04
Gnar,Gwen,47,25,22,53.19
Gnar,Azir,42,23,19,54.76
Gnar,Hwei,79,30,49,37.97
Gnar,TwistedFate,35,11,24,31.43
Gnar,FiddleSticks,49,20,29,40.82
Gnar,Olaf,50,14,36,28
Gnar,Quinn,42,34,8,80.95
Gnar,Taric,32,13,19,40.63
Gnar,Rumble,35,17,18,48.57
Gnar,Anivia,50,23,27,46
Gnar,Ornn,72,33,39,45.83
Gnar,Shyvana,28,13,15,46.43
Gnar,RekSai,24,14,10,58.33
Gnar,Rammus,42,23,19,54.76
Gnar,Cassiopeia,26,19,7,73.08
Gnar,Graves,65,34,31,52.31
Gnar,Vex,37,18,19,48.65
Gnar,Belveth,24,10,14,41.67
Gnar,Kassadin,14,9,5,64.29
Gnar,Sona,5,0,5,0
Amumu,DrMundo,152,87,65,57.24
Amumu,Sejuani,205,111,94,54.15
Amumu,Veigar,328,182,146,55.49
Amumu,Jinx,690,352,338,51.01
Amumu,Nami,290,141,149,48.62
Amumu,Kayn,380,212,168,55.79
Amumu,Shaco,200,127,73,63.5
Amumu,Zoe,112,56,56,50
Amumu,KogMaw,89,45,44,50.56
Amumu,TwistedFate,110,67,43,60.91
Amumu,Yasuo,490,286,204,58.37
Amumu,Diana,395,210,185,53.16
Amumu,Naafiri,99,53,46,53.54
Amumu,MissFortune,526,262,264,49.81
Amumu,Azir,105,64,41,60.95
Amumu,Irelia,210,114,96,54.29
Amumu,Malphite,322,190,132,59.01
Amumu,Jhin,516,261,255,50.58
Amumu,Karma,293,156,137,53.24
Amumu,Trundle,161,85,76,52.8
Amumu,Ashe,482,245,237,50.83
Amumu,Braum,230,134,96,58.26
Amumu,Briar,154,82,72,53.25
Amumu,Nocturne,276,116,160,42.03
Amumu,Lissandra,106,49,57,46.23
Amumu,Caitlyn,675,358,317,53.04
Amumu,Shen,253,141,112,55.73
Amumu,Malzahar,262,125,137,47.71
Amumu,Garen,402,206,196,51.24
Amumu,Lucian,232,128,104,55.17
Amumu,Aatrox,224,137,87,61.16
Amumu,Teemo,258,127,131,49.22
Amumu,Aurora,229,125,104,54.59
Amumu,Sivir,150,79,71,52.67
Amumu,Blitzcrank,254,150,104,59.06
Amumu,Heimerdinger,102,60,42,58.82
Amumu,Leona,268,126,142,47.01
Amumu,Kennen,80,43,37,53.75
Amumu,XinZhao,189,101,88,53.44
Amumu,Brand,210,106,104,50.48
Amumu,Morgana,272,154,118,56.62
Amumu,Darius,532,297,235,55.83
Amumu,Vi,308,171,137,55.52
Amumu,Vayne,349,166,183,47.56
Amumu,Yuumi,210,103,107,49.05
Amumu,Yone,441,280,161,63.49
Amumu,Talon,133,74,59,55.64
Amumu,Vladimir,176,71,105,40.34
Amumu,Swain,307,159,148,51.79
Amumu,Thresh,477,232,245,48.64
Amumu,Chogath,375,202,173,53.87
Amumu,MasterYi,293,157,136,53.58
Amumu,Gangplank,171,94,77,54.97
Amumu,AurelionSol,123,64,59,52.03
Amumu,TahmKench,293,157,136,53.58
Amumu,Viego,372,191,181,51.34
Amumu,Zed,268,141,127,52.61
Amumu,Ziggs,110,85,25,77.27
Amumu,RekSai,39,11,28,28.21
Amumu,Akali,235,142,93,60.43
Amumu,Bard,84,53,31,63.1
Amumu,Camille,112,60,52,53.57
Amumu,Milio,179,108,71,60.34
Amumu,Xayah,192,110,82,57.29
Amumu,Viktor,199,105,94,52.76
Amumu,Gnar,123,75,48,60.98
Amumu,LeeSin,377,231,146,61.27
Amumu,Fizz,130,73,57,56.15
Amumu,Seraphine,216,112,104,51.85
Amumu,Mordekaiser,367,197,170,53.68
Amumu,Ambessa,185,107,78,57.84
Amumu,Ryze,109,59,50,54.13
Amumu,Smolder,181,97,84,53.59
Amumu,Yorick,282,145,137,51.42
Amumu,Sylas,470,242,228,51.49
Amumu,Draven,135,73,62,54.07
Amumu,Quinn,94,45,49,47.87
Amumu,Lux,591,344,247,58.21
Amumu,Varus,225,141,84,62.67
Amumu,Lulu,323,174,149,53.87
Amumu,Illaoi,121,56,65,46.28
Amumu,Ezreal,627,362,265,57.74
Amumu,Sona,49,28,21,57.14
Amumu,Jayce,140,78,62,55.71
Amumu,Mel,608,314,294,51.64
Amumu,Renata,73,41,32,56.16
Amumu,JarvanIV,240,143,97,59.58
Amumu,Elise,206,112,94,54.37
Amumu,Karthus,70,39,31,55.71
Amumu,Gragas,165,91,74,55.15
Amumu,Orianna,144,71,73,49.31
Amumu,Nilah,96,43,53,44.79
Amumu,Samira,195,110,85,56.41
Amumu,Corki,124,74,50,59.68
Amumu,Poppy,194,108,86,55.67
Amumu,Warwick,398,212,186,53.27
Amumu,Tryndamere,97,43,54,44.33
Amumu,Urgot,108,61,47,56.48
Amumu,Janna,69,41,28,59.42
Amumu,Jax,201,113,88,56.22
Amumu,Volibear,258,154,104,59.69
Amumu,Kaisa,385,223,162,57.92
Amumu,Fiora,101,49,52,48.51
Amumu,Leblanc,155,83,72,53.55
Amumu,Rakan,137,60,77,43.8
Amumu,Rengar,100,57,43,57
Amumu,Ahri,379,216,163,56.99
Amumu,Nautilus,396,195,201,49.24
Amumu,Kassadin,48,24,24,50
Amumu,Aphelios,147,81,66,55.1
Amumu,Maokai,122,66,56,54.1
Amumu,Tristana,272,129,143,47.43
Amumu,Kindred,140,94,46,67.14
Amumu,MonkeyKing,212,115,97,54.25
Amumu,Renekton,118,64,54,54.24
Amumu,Belveth,81,30,51,37.04
Amumu,Pantheon,441,258,183,58.5
Amumu,Zeri,119,79,40,66.39
Amumu,Gwen,115,58,57,50.43
Amumu,Rell,195,112,83,57.44
Amumu,Soraka,104,66,38,63.46
Amumu,Ornn,155,87,68,56.13
Amumu,Udyr,65,37,28,56.92
Amumu,Ekko,219,106,113,48.4
Amumu,Rammus,66,35,31,53.03
Amumu,Katarina,180,97,83,53.89
Amumu,Zyra,213,119,94,55.87
Amumu,Hwei,179,105,74,58.66
Amumu,Singed,74,36,38,48.65
Amumu,FiddleSticks,111,55,56,49.55
Amumu,Riven,106,69,37,65.09
Amumu,Galio,355,175,180,49.3
Amumu,Sion,239,117,122,48.95
Amumu,Neeko,160,103,57,64.38
Amumu,Sett,310,165,145,53.23
Amumu,Khazix,121,62,59,51.24
Amumu,Xerath,201,103,98,51.24
Amumu,Nidalee,90,56,34,62.22
Amumu,Alistar,134,79,55,58.96
Amumu,Kayle,146,87,59,59.59
Amumu,Shyvana,67,35,32,52.24
Amumu,Annie,62,36,26,58.06
Amumu,Zilean,100,58,42,58
Amumu,Ivern,43,28,15,65.12
Amumu,Evelynn,79,43,36,54.43
Amumu,Nasus,173,84,89,48.55
Amumu,Akshan,93,51,42,54.84
Amumu,Twitch,212,122,90,57.55
Amumu,Taliyah,85,48,37,56.47
Amumu,Lillia,134,81,53,60.45
Amumu,Cassiopeia,51,27,24,52.94
Amumu,Qiyana,57,26,31,45.61
Amumu,Skarner,146,79,67,54.11
Amumu,Taric,47,30,17,63.83
Amumu,Pyke,180,110,70,61.11
Amumu,Zac,187,106,81,56.68
Amumu,Velkoz,178,117,61,65.73
Amumu,Kalista,87,68,19,78.16
Amumu,Vex,151,100,51,66.23
Amumu,Nunu,219,129,90,58.9
Amumu,Syndra,127,75,52,59.06
Amumu,Graves,185,84,101,45.41
Amumu,Rumble,61,35,26,57.38
Amumu,Olaf,66,33,33,50
Amumu,Hecarim,105,49,56,46.67
Amumu,Anivia,90,51,39,56.67
Amumu,KSante,189,87,102,46.03
Amumu,Kled,39,24,15,61.54
Amumu,Senna,126,47,79,37.3
Shyvana,Nasus,32,14,18,43.75
Shyvana,Sejuani,34,10,24,29.41
Shyvana,Malzahar,60,31,29,51.67
Shyvana,TwistedFate,17,8,9,47.06
Shyvana,Seraphine,56,21,35,37.5
Shyvana,Teemo,66,32,34,48.48
Shyvana,Rammus,11,8,3,72.73
Shyvana,Leblanc,32,14,18,43.75
Shyvana,Caitlyn,157,75,82,47.77
Shyvana,Karma,78,52,26,66.67
Shyvana,Aurora,67,39,28,58.21
Shyvana,Diana,97,68,29,70.1
Shyvana,Ryze,27,14,13,51.85
Shyvana,Mordekaiser,72,32,40,44.44
Shyvana,Maokai,28,25,3,89.29
Shyvana,Gwen,37,13,24,35.14
Shyvana,Skarner,41,17,24,41.46
Shyvana,AurelionSol,30,13,17,43.33
Shyvana,Lux,148,71,77,47.97
Shyvana,Volibear,63,29,34,46.03
Shyvana,Shaco,51,17,34,33.33
Shyvana,Yone,74,38,36,51.35
Shyvana,Varus,62,26,36,41.94
Shyvana,Ashe,111,65,46,58.56
Shyvana,Yorick,69,44,25,63.77
Shyvana,Kayn,70,54,16,77.14
Shyvana,Vladimir,32,20,12,62.5
Shyvana,Ezreal,126,71,55,56.35
Shyvana,Xerath,64,31,33,48.44
Shyvana,Urgot,30,15,15,50
Shyvana,Evelynn,9,9,0,100
Shyvana,Briar,51,14,37,27.45
Shyvana,Kalista,26,14,12,53.85
Shyvana,Sett,77,49,28,63.64
Shyvana,TahmKench,62,24,38,38.71
Shyvana,Warwick,84,46,38,54.76
Shyvana,Akali,55,25,30,45.45
Shyvana,Twitch,63,39,24,61.9
Shyvana,Fiora,8,2,6,25
Shyvana,Nocturne,60,33,27,55
Shyvana,Viktor,34,17,17,50
Shyvana,Aphelios,41,18,23,43.9
Shyvana,Morgana,33,17,16,51.52
Shyvana,Malphite,62,26,36,41.94
Shyvana,Yasuo,106,52,54,49.06
Shyvana,Lucian,44,13,31,29.55
Shyvana,Milio,29,17,12,58.62
Shyvana,XinZhao,36,20,16,55.56
Shyvana,Jax,36,11,25,30.56
Shyvana,Kaisa,79,42,37,53.16
Shyvana,Senna,35,23,12,65.71
Shyvana,Ornn,31,18,13,58.06
Shyvana,Heimerdinger,26,18,8,69.23
Shyvana,Lulu,80,45,35,56.25
Shyvana,Talon,31,21,10,67.74
Shyvana,Sivir,33,22,11,66.67
Shyvana,Zyra,38,20,18,52.63
Shyvana,DrMundo,46,26,20,56.52
Shyvana,Amumu,67,32,35,47.76
Shyvana,Mel,116,59,57,50.86
Shyvana,Tristana,35,18,17,51.43
Shyvana,Pantheon,91,58,33,63.74
Shyvana,Veigar,64,36,28,56.25
Shyvana,KogMaw,13,10,3,76.92
Shyvana,Nautilus,56,32,24,57.14
Shyvana,Lillia,23,14,9,60.87
Shyvana,Smolder,41,19,22,46.34
Shyvana,Nami,60,36,24,60
Shyvana,Tryndamere,20,12,8,60
Shyvana,Gragas,39,28,11,71.79
Shyvana,Azir,32,27,5,84.38
Shyvana,Fizz,40,22,18,55
Shyvana,Kayle,26,15,11,57.69
Shyvana,Zac,33,21,12,63.64
Shyvana,Zed,45,23,22,51.11
Shyvana,Pyke,45,26,19,57.78
Shyvana,Darius,91,42,49,46.15
Shyvana,Jinx,153,88,65,57.52
Shyvana,Hecarim,28,9,19,32.14
Shyvana,Thresh,63,39,24,61.9
Shyvana,Orianna,35,20,15,57.14
Shyvana,Zilean,23,15,8,65.22
Shyvana,FiddleSticks,20,14,6,70
Shyvana,Janna,23,18,5,78.26
Shyvana,Chogath,57,40,17,70.18
Shyvana,Jhin,77,38,39,49.35
Shyvana,Rakan,21,9,12,42.86
Shyvana,Naafiri,11,9,2,81.82
Shyvana,Syndra,48,33,15,68.75
Shyvana,Blitzcrank,46,27,19,58.7
Shyvana,Kassadin,3,0,3,0
Shyvana,Draven,26,17,9,65.38
Shyvana,Alistar,45,31,14,68.89
Shyvana,Sylas,60,36,24,60
Shyvana,Samira,33,21,12,63.64
Shyvana,Jayce,28,19,9,67.86
Shyvana,Belveth,14,8,6,57.14
Shyvana,Lissandra,17,9,8,52.94
Shyvana,Sona,17,11,6,64.71
Shyvana,Hwei,20,10,10,50
Shyvana,Soraka,19,16,3,84.21
Shyvana,Braum,38,21,17,55.26
Shyvana,MasterYi,74,42,32,56.76
Shyvana,Viego,84,64,20,76.19
Shyvana,MissFortune,89,52,37,58.43
Shyvana,Trundle,25,14,11,56
Shyvana,Kled,15,8,7,53.33
Shyvana,Anivia,15,10,5,66.67
Shyvana,Garen,75,41,34,54.67
Shyvana,MonkeyKing,31,23,8,74.19
Shyvana,Ahri,72,41,31,56.94
Shyvana,Akshan,29,18,11,62.07
Shyvana,Vi,75,40,35,53.33
Shyvana,Aatrox,44,28,16,63.64
Shyvana,Nidalee,17,2,15,11.76
Shyvana,Ekko,44,19,25,43.18
Shyvana,Neeko,26,9,17,34.62
Shyvana,Swain,56,23,33,41.07
Shyvana,Leona,53,23,30,43.4
Shyvana,Renekton,26,15,11,57.69
Shyvana,Nunu,39,26,13,66.67
Shyvana,Xayah,34,17,17,50
Shyvana,Sion,31,17,14,54.84
Shyvana,Khazix,39,26,13,66.67
Shyvana,Irelia,34,20,14,58.82
Shyvana,Udyr,23,14,9,60.87
Shyvana,Vex,35,17,18,48.57
Shyvana,Qiyana,10,7,3,70
Shyvana,Singed,21,18,3,85.71
Shyvana,Galio,74,39,35,52.7
Shyvana,Poppy,44,33,11,75
Shyvana,Graves,35,20,15,57.14
Shyvana,Illaoi,24,11,13,45.83
Shyvana,Vayne,56,35,21,62.5
Shyvana,Elise,43,23,20,53.49
Shyvana,LeeSin,71,26,45,36.62
Shyvana,JarvanIV,32,24,8,75
Shyvana,Annie,17,12,5,70.59
Shyvana,Ziggs,17,14,3,82.35
Shyvana,Nilah,10,10,0,100
Shyvana,Rell,30,21,9,70
Shyvana,Taliyah,17,5,12,29.41
Shyvana,Kindred,29,12,17,41.38
Shyvana,Velkoz,25,7,18,28
Shyvana,Gangplank,26,16,10,61.54
Shyvana,Corki,30,20,10,66.67
Shyvana,Gnar,28,15,13,53.57
Shyvana,Yuumi,36,21,15,58.33
Shyvana,Brand,27,18,9,66.67
Shyvana,Ambessa,32,22,10,68.75
Shyvana,Shen,34,15,19,44.12
Shyvana,Katarina,14,9,5,64.29
Shyvana,Riven,11,4,7,36.36
Shyvana,Zoe,14,4,10,28.57
Shyvana,RekSai,2,0,2,0
Shyvana,Ivern,6,2,4,33.33
Shyvana,Bard,13,10,3,76.92
Shyvana,Renata,24,10,14,41.67
Shyvana,Cassiopeia,7,5,2,71.43
Shyvana,Rengar,8,6,2,75
Shyvana,Rumble,17,9,8,52.94
Shyvana,Quinn,11,8,3,72.73
Shyvana,Kennen,10,10,0,100
Shyvana,Karthus,7,5,2,71.43
Shyvana,Zeri,8,6,2,75
Shyvana,KSante,20,14,6,70
Shyvana,Taric,6,3,3,50
Shyvana,Olaf,14,8,6,57.14
Shyvana,Camille,6,3,3,50
Zyra,Poppy,119,53,66,44.54
Zyra,Zac,132,89,43,67.42
Zyra,Malzahar,199,81,118,40.7
Zyra,MissFortune,348,167,181,47.99
Zyra,TahmKench,175,90,85,51.43
Zyra,Illaoi,102,53,49,51.96
Zyra,Pantheon,269,141,128,52.42
Zyra,Vex,115,65,50,56.52
Zyra,Lucian,184,100,84,54.35
Zyra,Braum,149,77,72,51.68
Zyra,Yorick,152,79,73,51.97
Zyra,Diana,306,155,151,50.65
Zyra,Akali,180,111,69,61.67
Zyra,Ashe,388,207,181,53.35
Zyra,Milio,96,43,53,44.79
Zyra,Sylas,317,145,172,45.74
Zyra,Tristana,119,52,67,43.7
Zyra,Ahri,264,137,127,51.89
Zyra,Graves,117,58,59,49.57
Zyra,Blitzcrank,191,106,85,55.5
Zyra,Yasuo,331,168,163,50.76
Zyra,Kayn,228,114,114,50
Zyra,Irelia,115,64,51,55.65
Zyra,Caitlyn,539,274,265,50.83
Zyra,Rell,114,61,53,53.51
Zyra,Katarina,97,48,49,49.48
Zyra,JarvanIV,176,79,97,44.89
Zyra,Yone,309,168,141,54.37
Zyra,Ornn,115,64,51,55.65
Zyra,Warwick,235,100,135,42.55
Zyra,Veigar,182,87,95,47.8
Zyra,Malphite,219,94,125,42.92
Zyra,Kindred,91,50,41,54.95
Zyra,Akshan,47,20,27,42.55
Zyra,Viktor,188,91,97,48.4
Zyra,Jhin,350,161,189,46
Zyra,Nautilus,251,142,109,56.57
Zyra,Gwen,64,26,38,40.63
Zyra,XinZhao,136,70,66,51.47
Zyra,Zed,181,95,86,52.49
Zyra,Ezreal,460,237,223,51.52
Zyra,Sion,201,84,117,41.79
Zyra,Rengar,42,31,11,73.81
Zyra,Ziggs,71,34,37,47.89
Zyra,KSante,116,48,68,41.38
Zyra,Senna,98,45,53,45.92
Zyra,Trundle,98,49,49,50
Zyra,Lux,491,219,272,44.6
Zyra,Chogath,211,107,104,50.71
Zyra,Sejuani,127,49,78,38.58
Zyra,Mel,328,185,143,56.4
Zyra,Seraphine,164,68,96,41.46
Zyra,Quinn,61,27,34,44.26
Zyra,Ambessa,119,64,55,53.78
Zyra,Brand,106,49,57,46.23
Zyra,Draven,83,59,24,71.08
Zyra,Nami,203,105,98,51.72
Zyra,Mordekaiser,233,117,116,50.21
Zyra,Nunu,100,60,40,60
Zyra,KogMaw,56,24,32,42.86
Zyra,Vladimir,108,60,48,55.56
Zyra,Teemo,158,93,65,58.86
Zyra,Corki,86,40,46,46.51
Zyra,Renekton,93,50,43,53.76
Zyra,MonkeyKing,147,73,74,49.66
Zyra,Smolder,135,67,68,49.63
Zyra,Gnar,96,54,42,56.25
Zyra,Swain,188,64,124,34.04
Zyra,Zoe,70,31,39,44.29
Zyra,Nocturne,176,95,81,53.98
Zyra,Taric,37,21,16,56.76
Zyra,Urgot,86,46,40,53.49
Zyra,LeeSin,343,187,156,54.52
Zyra,Janna,40,26,14,65
Zyra,Vayne,195,112,83,57.44
Zyra,Neeko,139,91,48,65.47
Zyra,Alistar,72,33,39,45.83
Zyra,Garen,273,138,135,50.55
Zyra,Sivir,108,45,63,41.67
Zyra,Leblanc,126,53,73,42.06
Zyra,Kayle,99,42,57,42.42
Zyra,Qiyana,34,20,14,58.82
Zyra,Samira,110,55,55,50
Zyra,Morgana,221,119,102,53.85
Zyra,Camille,90,41,49,45.56
Zyra,Xayah,91,50,41,54.95
Zyra,Shen,120,64,56,53.33
Zyra,Karma,242,138,104,57.02
Zyra,Singed,57,23,34,40.35
Zyra,Ekko,136,68,68,50
Zyra,Aurora,154,86,68,55.84
Zyra,Sett,263,132,131,50.19
Zyra,Jinx,429,210,219,48.95
Zyra,Lillia,109,51,58,46.79
Zyra,Twitch,103,42,61,40.78
Zyra,Lulu,236,121,115,51.27
Zyra,Fiora,61,21,40,34.43
Zyra,FiddleSticks,97,65,32,67.01
Zyra,Leona,144,77,67,53.47
Zyra,Viego,263,114,149,43.35
Zyra,MasterYi,157,78,79,49.68
Zyra,Nasus,88,45,43,51.14
Zyra,Shaco,151,60,91,39.74
Zyra,Darius,314,174,140,55.41
Zyra,Fizz,80,47,33,58.75
Zyra,Hwei,115,75,40,65.22
Zyra,Amumu,213,94,119,44.13
Zyra,Thresh,361,220,141,60.94
Zyra,Olaf,43,15,28,34.88
Zyra,Udyr,74,35,39,47.3
Zyra,Varus,188,76,112,40.43
Zyra,Khazix,84,45,39,53.57
Zyra,Gragas,122,48,74,39.34
Zyra,Ryze,56,28,28,50
Zyra,Gangplank,89,50,39,56.18
Zyra,Vi,203,119,84,58.62
Zyra,Sona,23,14,9,60.87
Zyra,Volibear,163,89,74,54.6
Zyra,Heimerdinger,86,38,48,44.19
Zyra,Kled,30,10,20,33.33
Zyra,Lissandra,92,56,36,60.87
Zyra,Velkoz,81,28,53,34.57
Zyra,Azir,99,52,47,52.53
Zyra,Shyvana,38,18,20,47.37
Zyra,AurelionSol,69,30,39,43.48
Zyra,Soraka,79,27,52,34.18
Zyra,Bard,42,15,27,35.71
Zyra,Naafiri,64,33,31,51.56
Zyra,Xerath,175,69,106,39.43
Zyra,Taliyah,59,25,34,42.37
Zyra,Rammus,48,34,14,70.83
Zyra,Karthus,53,31,22,58.49
Zyra,Kalista,49,41,8,83.67
Zyra,Aphelios,80,34,46,42.5
Zyra,Galio,216,124,92,57.41
Zyra,Briar,99,53,46,53.54
Zyra,DrMundo,91,37,54,40.66
Zyra,Nidalee,74,49,25,66.22
Zyra,Ivern,16,9,7,56.25
Zyra,Riven,65,34,31,52.31
Zyra,Nilah,58,40,18,68.97
Zyra,Yuumi,134,47,87,35.07
Zyra,Orianna,119,65,54,54.62
Zyra,Elise,141,85,56,60.28
Zyra,Kaisa,272,132,140,48.53
Zyra,Jax,161,96,65,59.63
Zyra,Aatrox,180,101,79,56.11
Zyra,Pyke,148,90,58,60.81
Zyra,Tryndamere,81,47,34,58.02
Zyra,Syndra,116,61,55,52.59
Zyra,Cassiopeia,44,20,24,45.45
Zyra,Rakan,92,51,41,55.43
Zyra,Kennen,79,45,34,56.96
Zyra,Kassadin,30,17,13,56.67
Zyra,Renata,42,13,29,30.95
Zyra,Belveth,33,17,16,51.52
Zyra,Hecarim,53,27,26,50.94
Zyra,Anivia,64,40,24,62.5
Zyra,Annie,49,17,32,34.69
Zyra,Evelynn,50,25,25,50
Zyra,Maokai,61,21,40,34.43
Zyra,Zeri,103,47,56,45.63
Zyra,Talon,55,32,23,58.18
Zyra,Rumble,47,17,30,36.17
Zyra,Zilean,37,4,33,10.81
Zyra,RekSai,14,6,8,42.86
Zyra,TwistedFate,39,21,18,53.85
Zyra,Jayce,104,58,46,55.77
Zyra,Skarner,77,45,32,58.44
Kassadin,Gangplank,26,18,8,69.23
Kassadin,LeeSin,67,35,32,52.24
Kassadin,Aurora,27,14,13,51.85
Kassadin,Ashe,83,43,40,51.81
Kassadin,Morgana,31,13,18,41.94
Kassadin,Teemo,37,20,17,54.05
Kassadin,MasterYi,36,13,23,36.11
Kassadin,Katarina,34,16,18,47.06
Kassadin,Samira,43,20,23,46.51
Kassadin,Singed,25,11,14,44
Kassadin,Sylas,80,41,39,51.25
Kassadin,Evelynn,18,9,9,50
Kassadin,Mel,175,102,73,58.29
Kassadin,Varus,62,36,26,58.06
Kassadin,Karma,64,38,26,59.38
Kassadin,KSante,30,16,14,53.33
Kassadin,Nunu,42,23,19,54.76
Kassadin,Akshan,24,16,8,66.67
Kassadin,Ziggs,21,18,3,85.71
Kassadin,Seraphine,36,11,25,30.56
Kassadin,RekSai,8,5,3,62.5
Kassadin,Hwei,29,11,18,37.93
Kassadin,Nautilus,40,15,25,37.5
Kassadin,Yorick,38,27,11,71.05
Kassadin,Briar,25,11,14,44
Kassadin,Veigar,41,24,17,58.54
Kassadin,Yone,55,22,33,40
Kassadin,Vi,57,32,25,56.14
Kassadin,Caitlyn,104,63,41,60.58
Kassadin,Garen,64,38,26,59.38
Kassadin,Malzahar,32,20,12,62.5
Kassadin,Rakan,33,13,20,39.39
Kassadin,Ivern,6,3,3,50
Kassadin,Rammus,19,5,14,26.32
Kassadin,Chogath,56,19,37,33.93
Kassadin,Rumble,18,12,6,66.67
Kassadin,Maokai,29,18,11,62.07
Kassadin,Zed,20,8,12,40
Kassadin,Lux,52,30,22,57.69
Kassadin,Ekko,42,23,19,54.76
Kassadin,Riven,28,14,14,50
Kassadin,Rell,13,5,8,38.46
Kassadin,Amumu,48,24,24,50
Kassadin,Sion,40,17,23,42.5
Kassadin,Lucian,39,21,18,53.85
Kassadin,Lulu,49,25,24,51.02
Kassadin,JarvanIV,42,20,22,47.62
Kassadin,AurelionSol,27,13,14,48.15
Kassadin,Swain,44,26,18,59.09
Kassadin,Thresh,68,25,43,36.76
Kassadin,Aatrox,45,21,24,46.67
Kassadin,Orianna,19,9,10,47.37
Kassadin,Aphelios,28,9,19,32.14
Kassadin,Alistar,11,5,6,45.45
Kassadin,TahmKench,42,20,22,47.62
Kassadin,Xerath,39,14,25,35.9
Kassadin,Milio,38,18,20,47.37
Kassadin,Ornn,35,28,7,80
Kassadin,Elise,47,26,21,55.32
Kassadin,Mordekaiser,63,27,36,42.86
Kassadin,Zac,25,12,13,48
Kassadin,Yasuo,74,48,26,64.86
Kassadin,Diana,73,31,42,42.47
Kassadin,Udyr,8,3,5,37.5
Kassadin,Leblanc,41,18,23,43.9
Kassadin,Ezreal,119,62,57,52.1
Kassadin,Olaf,10,6,4,60
Kassadin,Syndra,26,12,14,46.15
Kassadin,Sejuani,31,17,14,54.84
Kassadin,Galio,52,22,30,42.31
Kassadin,Jhin,49,25,24,51.02
Kassadin,Lillia,28,3,25,10.71
Kassadin,Nami,40,14,26,35
Kassadin,Viego,54,36,18,66.67
Kassadin,Volibear,41,19,22,46.34
Kassadin,Kayle,23,12,11,52.17
Kassadin,Janna,23,18,5,78.26
Kassadin,DrMundo,37,21,16,56.76
Kassadin,XinZhao,35,17,18,48.57
Kassadin,Ahri,67,42,25,62.69
Kassadin,Sivir,23,13,10,56.52
Kassadin,Khazix,25,17,8,68
Kassadin,Darius,53,28,25,52.83
Kassadin,Belveth,3,0,3,0
Kassadin,Kaisa,66,40,26,60.61
Kassadin,Kayn,59,33,26,55.93
Kassadin,Fizz,21,13,8,61.9
Kassadin,MissFortune,94,40,54,42.55
Kassadin,MonkeyKing,26,6,20,23.08
Kassadin,Anivia,22,14,8,63.64
Kassadin,Vayne,58,32,26,55.17
Kassadin,Taric,3,3,0,100
Kassadin,Urgot,19,5,14,26.32
Kassadin,Bard,17,12,5,70.59
Kassadin,Nocturne,53,26,27,49.06
Kassadin,Taliyah,23,17,6,73.91
Kassadin,Braum,39,25,14,64.1
Kassadin,Senna,23,18,5,78.26
Kassadin,Rengar,13,7,6,53.85
Kassadin,Poppy,33,19,14,57.58
Kassadin,Jax,23,11,12,47.83
Kassadin,Pyke,39,13,26,33.33
Kassadin,Fiora,11,5,6,45.45
Kassadin,Viktor,49,31,18,63.27
Kassadin,Azir,15,9,6,60
Kassadin,Soraka,29,24,5,82.76
Kassadin,Shyvana,3,3,0,100
Kassadin,Yuumi,38,9,29,23.68
Kassadin,Shen,53,39,14,73.58
Kassadin,Zeri,21,5,16,23.81
Kassadin,Gragas,34,22,12,64.71
Kassadin,Kennen,8,6,2,75
Kassadin,Neeko,19,9,10,47.37
Kassadin,Warwick,65,47,18,72.31
Kassadin,Kled,11,8,3,72.73
Kassadin,Draven,29,14,15,48.28
Kassadin,Malphite,49,20,29,40.82
Kassadin,Talon,14,8,6,57.14
Kassadin,Skarner,22,14,8,63.64
Kassadin,Illaoi,24,21,3,87.5
Kassadin,Zoe,16,3,13,18.75
Kassadin,Camille,21,8,13,38.1
Kassadin,Smolder,21,8,13,38.1
Kassadin,Jinx,95,34,61,35.79
Kassadin,Zyra,30,13,17,43.33
Kassadin,Ambessa,46,25,21,54.35
Kassadin,Tryndamere,17,7,10,41.18
Kassadin,Velkoz,42,17,25,40.48
Kassadin,Renata,14,9,5,64.29
Kassadin,Qiyana,6,3,3,50
Kassadin,Kalista,13,10,3,76.92
Kassadin,Lissandra,23,18,5,78.26
Kassadin,Tristana,31,11,20,35.48
Kassadin,Shaco,32,23,9,71.88
Kassadin,Heimerdinger,22,14,8,63.64
Kassadin,Kindred,21,12,9,57.14
Kassadin,FiddleSticks,29,16,13,55.17
Kassadin,Corki,17,14,3,82.35
Kassadin,Gwen,36,23,13,63.89
Kassadin,Sona,12,3,9,25
Kassadin,Renekton,31,10,21,32.26
Kassadin,Akali,22,8,14,36.36
Kassadin,Vladimir,29,10,19,34.48
Kassadin,Nidalee,8,5,3,62.5
Kassadin,Leona,51,26,25,50.98
Kassadin,Blitzcrank,38,18,20,47.37
Kassadin,Quinn,13,5,8,38.46
Kassadin,Karthus,11,6,5,54.55
Kassadin,Nilah,11,8,3,72.73
Kassadin,Pantheon,63,27,36,42.86
Kassadin,Sett,47,21,26,44.68
Kassadin,Brand,21,17,4,80.95
Kassadin,Twitch,26,21,5,80.77
Kassadin,Zilean,7,7,0,100
Kassadin,Vex,34,14,20,41.18
Kassadin,Xayah,28,13,15,46.43
Kassadin,Nasus,24,8,16,33.33
Kassadin,Cassiopeia,7,5,2,71.43
Kassadin,Irelia,32,19,13,59.38
Kassadin,TwistedFate,7,2,5,28.57
Kassadin,Gnar,14,5,9,35.71
Kassadin,Trundle,19,8,11,42.11
Kassadin,Jayce,20,9,11,45
Kassadin,Naafiri,2,2,0,100
Kassadin,Ryze,11,6,5,54.55
Kassadin,Graves,16,5,11,31.25
Kassadin,Hecarim,12,3,9,25
Kassadin,KogMaw,9,3,6,33.33
Kassadin,Annie,14,5,9,35.71
Taliyah,Gangplank,30,16,14,53.33
Taliyah,LeeSin,127,68,59,53.54
Taliyah,Aurora,61,28,33,45.9
Taliyah,Ashe,134,67,67,50
Taliyah,Morgana,55,25,30,45.45
Taliyah,Cassiopeia,23,9,14,39.13
Taliyah,Kaisa,103,51,52,49.51
Taliyah,Volibear,74,34,40,45.95
Taliyah,Mel,124,66,58,53.23
Taliyah,Leona,66,35,31,53.03
Taliyah,Darius,126,67,59,53.17
Taliyah,Vi,83,42,41,50.6
Taliyah,Vayne,76,45,31,59.21
Taliyah,Yuumi,83,41,42,49.4
Taliyah,Shen,66,44,22,66.67
Taliyah,Viego,114,58,56,50.88
Taliyah,Yasuo,125,65,60,52
Taliyah,Hwei,75,40,35,53.33
Taliyah,Heimerdinger,22,13,9,59.09
Taliyah,Caitlyn,165,81,84,49.09
Taliyah,Blitzcrank,58,31,27,53.45
Taliyah,Yorick,44,19,25,43.18
Taliyah,Shaco,38,22,16,57.89
Taliyah,Sylas,116,60,56,51.72
Taliyah,Samira,48,26,22,54.17
Taliyah,Sett,79,49,30,62.03
Taliyah,Sejuani,55,23,32,41.82
Taliyah,Tristana,49,21,28,42.86
Taliyah,Varus,76,34,42,44.74
Taliyah,Veigar,37,19,18,51.35
Taliyah,KSante,45,24,21,53.33
Taliyah,Pantheon,108,64,44,59.26
Taliyah,JarvanIV,49,23,26,46.94
Taliyah,Karma,88,43,45,48.86
Taliyah,Irelia,40,16,24,40
Taliyah,Alistar,45,19,26,42.22
Taliyah,Teemo,53,18,35,33.96
Taliyah,Gragas,48,25,23,52.08
Taliyah,Lissandra,20,9,11,45
Taliyah,Lulu,101,51,50,50.5
Taliyah,MasterYi,66,30,36,45.45
Taliyah,Ekko,59,36,23,61.02
Taliyah,Smolder,51,26,25,50.98
Taliyah,Mordekaiser,71,39,32,54.93
Taliyah,Garen,89,35,54,39.33
Taliyah,Nocturne,63,24,39,38.1
Taliyah,Galio,75,47,28,62.67
Taliyah,Lux,133,51,82,38.35
Taliyah,Urgot,36,19,17,52.78
Taliyah,Kindred,21,10,11,47.62
Taliyah,Malphite,72,32,40,44.44
Taliyah,Twitch,47,28,19,59.57
Taliyah,Vex,35,14,21,40
Taliyah,Senna,41,20,21,48.78
Taliyah,MonkeyKing,60,33,27,55
Taliyah,Xerath,54,39,15,72.22
Taliyah,MissFortune,89,42,47,47.19
Taliyah,Rell,48,24,24,50
Taliyah,Evelynn,15,6,9,40
Taliyah,Yone,88,55,33,62.5
Taliyah,Warwick,47,18,29,38.3
Taliyah,Singed,24,12,12,50
Taliyah,Zed,58,35,23,60.34
Taliyah,Ambessa,68,40,28,58.82
Taliyah,Nunu,28,13,15,46.43
Taliyah,Nami,51,16,35,31.37
Taliyah,Katarina,30,11,19,36.67
Taliyah,Lucian,66,28,38,42.42
Taliyah,Braum,42,19,23,45.24
Taliyah,XinZhao,60,30,30,50
Taliyah,Jax,44,18,26,40.91
Taliyah,Rammus,12,6,6,50
Taliyah,Vladimir,29,18,11,62.07
Taliyah,Jhin,111,53,58,47.75
Taliyah,Seraphine,36,16,20,44.44
Taliyah,Jayce,35,16,19,45.71
Taliyah,Orianna,45,26,19,57.78
Taliyah,Olaf,30,14,16,46.67
Taliyah,Zyra,59,34,25,57.63
Taliyah,Chogath,79,56,23,70.89
Taliyah,Nautilus,124,58,66,46.77
Taliyah,Ezreal,150,73,77,48.67
Taliyah,Camille,24,14,10,58.33
Taliyah,Jinx,151,62,89,41.06
Taliyah,Milio,53,27,26,50.94
Taliyah,Gnar,47,27,20,57.45
Taliyah,Elise,64,25,39,39.06
Taliyah,Draven,37,27,10,72.97
Taliyah,Pyke,43,23,20,53.49
Taliyah,Anivia,17,3,14,17.65
Taliyah,Poppy,57,34,23,59.65
Taliyah,Thresh,101,61,40,60.4
Taliyah,Diana,96,50,46,52.08
Taliyah,Sion,37,16,21,43.24
Taliyah,KogMaw,16,6,10,37.5
Taliyah,Kassadin,23,6,17,26.09
Taliyah,Amumu,85,37,48,43.53
Taliyah,Malzahar,65,42,23,64.62
Taliyah,Nilah,31,22,9,70.97
Taliyah,Taric,10,8,2,80
Taliyah,Rumble,18,9,9,50
Taliyah,Ahri,102,48,54,47.06
Taliyah,DrMundo,25,13,12,52
Taliyah,Nidalee,17,8,9,47.06
Taliyah,Brand,38,17,21,44.74
Taliyah,Kalista,15,7,8,46.67
Taliyah,Briar,41,17,24,41.46
Taliyah,Aatrox,78,37,41,47.44
Taliyah,Tryndamere,27,11,16,40.74
Taliyah,AurelionSol,52,23,29,44.23
Taliyah,Rakan,51,19,32,37.25
Taliyah,Aphelios,28,20,8,71.43
Taliyah,Kayn,73,37,36,50.68
Taliyah,Neeko,21,17,4,80.95
Taliyah,Ziggs,33,10,23,30.3
Taliyah,Hecarim,21,16,5,76.19
Taliyah,Syndra,46,24,22,52.17
Taliyah,Lillia,27,13,14,48.15
Taliyah,Xayah,43,18,25,41.86
Taliyah,TahmKench,63,36,27,57.14
Taliyah,Kled,18,6,12,33.33
Taliyah,Velkoz,29,20,9,68.97
Taliyah,TwistedFate,35,15,20,42.86
Taliyah,Viktor,44,13,31,29.55
Taliyah,Illaoi,24,10,14,41.67
Taliyah,Corki,43,27,16,62.79
Taliyah,Renekton,38,24,14,63.16
Taliyah,Talon,17,5,12,29.41
Taliyah,Zeri,44,27,17,61.36
Taliyah,Fiora,36,21,15,58.33
Taliyah,Azir,32,24,8,75
Taliyah,Kayle,26,11,15,42.31
Taliyah,Rengar,14,12,2,85.71
Taliyah,Leblanc,21,3,18,14.29
Taliyah,Swain,53,25,28,47.17
Taliyah,Nasus,32,17,15,53.13
Taliyah,Janna,22,5,17,22.73
Taliyah,Sivir,37,10,27,27.03
Taliyah,Shyvana,17,12,5,70.59
Taliyah,Karthus,23,12,11,52.17
Taliyah,Gwen,32,11,21,34.38
Taliyah,Maokai,34,13,21,38.24
Taliyah,Ryze,38,18,20,47.37
Taliyah,Trundle,12,4,8,33.33
Taliyah,Quinn,24,5,19,20.83
Taliyah,Khazix,28,14,14,50
Taliyah,FiddleSticks,37,16,21,43.24
Taliyah,Ornn,33,19,14,57.58
Taliyah,Zoe,11,2,9,18.18
Taliyah,Riven,12,5,7,41.67
Taliyah,Akshan,20,7,13,35
Taliyah,Fizz,22,20,2,90.91
Taliyah,Kennen,25,8,17,32
Taliyah,Zilean,21,12,9,57.14
Taliyah,Annie,22,5,17,22.73
Taliyah,Ivern,8,2,6,25
Taliyah,Soraka,14,12,2,85.71
Taliyah,Graves,45,11,34,24.44
Taliyah,Udyr,21,11,10,52.38
Taliyah,Bard,21,11,10,52.38
Taliyah,Renata,13,5,8,38.46
Taliyah,Zac,52,24,28,46.15
Taliyah,Akali,33,22,11,66.67
Taliyah,Qiyana,11,3,8,27.27
Taliyah,Skarner,23,10,13,43.48
Taliyah,RekSai,6,3,3,50
Taliyah,Sona,8,3,5,37.5
Taliyah,Naafiri,14,3,11,21.43
Taliyah,Belveth,9,6,3,66.67
Trundle,Akali,95,49,46,51.58
Trundle,Belveth,30,15,15,50
Trundle,Varus,86,44,42,51.16
Trundle,Jhin,193,93,100,48.19
Trundle,Lulu,131,47,84,35.88
Trundle,Tryndamere,47,17,30,36.17
Trundle,Shaco,68,36,32,52.94
Trundle,Leblanc,56,30,26,53.57
Trundle,Caitlyn,291,149,142,51.2
Trundle,Morgana,152,71,81,46.71
Trundle,Mordekaiser,151,85,66,56.29
Trundle,Amumu,161,76,85,47.2
Trundle,Yone,191,114,77,59.69
Trundle,Karma,144,60,84,41.67
Trundle,Khazix,55,34,21,61.82
Trundle,Katarina,46,22,24,47.83
Trundle,Ezreal,290,159,131,54.83
Trundle,Lux,313,154,159,49.2
Trundle,Yorick,140,70,70,50
Trundle,Warwick,170,73,97,42.94
Trundle,Ahri,195,95,100,48.72
Trundle,Chogath,181,91,90,50.28
Trundle,Nocturne,142,78,64,54.93
Trundle,Lissandra,43,20,23,46.51
Trundle,MissFortune,260,150,110,57.69
Trundle,Rakan,75,41,34,54.67
Trundle,Renekton,51,32,19,62.75
Trundle,Jax,128,66,62,51.56
Trundle,Thresh,186,105,81,56.45
Trundle,Sett,193,102,91,52.85
Trundle,Nautilus,152,76,76,50
Trundle,Shen,109,50,59,45.87
Trundle,Mel,240,134,106,55.83
Trundle,Galio,145,76,69,52.41
Trundle,Annie,49,15,34,30.61
Trundle,Kennen,43,26,17,60.47
Trundle,Illaoi,73,39,34,53.42
Trundle,Malzahar,145,63,82,43.45
Trundle,Vayne,163,76,87,46.63
Trundle,Milio,85,39,46,45.88
Trundle,Volibear,119,55,64,46.22
Trundle,Elise,67,29,38,43.28
Trundle,Syndra,80,32,48,40
Trundle,Leona,115,68,47,59.13
Trundle,Lucian,102,51,51,50
Trundle,Kayn,182,79,103,43.41
Trundle,Yasuo,199,91,108,45.73
Trundle,Yuumi,84,42,42,50
Trundle,Neeko,53,21,32,39.62
Trundle,Sejuani,80,35,45,43.75
Trundle,Viktor,74,26,48,35.14
Trundle,Ashe,275,133,142,48.36
Trundle,Braum,97,48,49,49.48
Trundle,Riven,36,26,10,72.22
Trundle,MonkeyKing,91,47,44,51.65
Trundle,AurelionSol,37,15,22,40.54
Trundle,Poppy,68,22,46,32.35
Trundle,TahmKench,175,112,63,64
Trundle,Diana,153,69,84,45.1
Trundle,Zyra,98,49,49,50
Trundle,Urgot,53,33,20,62.26
Trundle,Karthus,25,12,13,48
Trundle,Kaisa,170,90,80,52.94
Trundle,Swain,111,51,60,45.95
Trundle,DrMundo,89,38,51,42.7
Trundle,Briar,72,33,39,45.83
Trundle,Nunu,87,52,35,59.77
Trundle,Ambessa,97,41,56,42.27
Trundle,Rell,75,41,34,54.67
Trundle,Aatrox,102,51,51,50
Trundle,Vladimir,64,27,37,42.19
Trundle,Draven,58,18,40,31.03
Trundle,Pyke,91,41,50,45.05
Trundle,Garen,192,89,103,46.35
Trundle,Soraka,61,24,37,39.34
Trundle,Camille,14,9,5,64.29
Trundle,Zeri,43,20,23,46.51
Trundle,Viego,123,52,71,42.28
Trundle,Darius,222,93,129,41.89
Trundle,Jinx,311,146,165,46.95
Trundle,Zoe,36,19,17,52.78
Trundle,KSante,100,66,34,66
Trundle,Evelynn,24,14,10,58.33
Trundle,Aurora,107,49,58,45.79
Trundle,Lillia,72,40,32,55.56
Trundle,Zed,124,63,61,50.81
Trundle,Sivir,60,31,29,51.67
Trundle,Hwei,85,37,48,43.53
Trundle,Nilah,55,32,23,58.18
Trundle,Nasus,104,44,60,42.31
Trundle,Akshan,38,17,21,44.74
Trundle,Tristana,106,41,65,38.68
Trundle,Twitch,86,39,47,45.35
Trundle,Seraphine,81,56,25,69.14
Trundle,Senna,74,34,40,45.95
Trundle,Taric,17,9,8,52.94
Trundle,Maokai,59,35,24,59.32
Trundle,Gragas,76,29,47,38.16
Trundle,Janna,41,13,28,31.71
Trundle,Rengar,28,11,17,39.29
Trundle,Ryze,39,17,22,43.59
Trundle,Samira,87,53,34,60.92
Trundle,Kindred,46,17,29,36.96
Trundle,LeeSin,146,67,79,45.89
Trundle,Velkoz,64,23,41,35.94
Trundle,Gnar,47,24,23,51.06
Trundle,Graves,55,19,36,34.55
Trundle,Blitzcrank,101,55,46,54.46
Trundle,Skarner,50,27,23,54
Trundle,TwistedFate,33,21,12,63.64
Trundle,MasterYi,129,67,62,51.94
Trundle,Ekko,90,45,45,50
Trundle,Aphelios,53,21,32,39.62
Trundle,Rammus,53,20,33,37.74
Trundle,Bard,18,6,12,33.33
Trundle,Sion,130,62,68,47.69
Trundle,Ivern,36,23,13,63.89
Trundle,Jayce,48,22,26,45.83
Trundle,Hecarim,26,11,15,42.31
Trundle,Malphite,127,64,63,50.39
Trundle,Teemo,115,44,71,38.26
Trundle,FiddleSticks,67,39,28,58.21
Trundle,Qiyana,16,12,4,75
Trundle,JarvanIV,78,38,40,48.72
Trundle,Nami,146,81,65,55.48
Trundle,Kayle,51,21,30,41.18
Trundle,Olaf,50,24,26,48
Trundle,Pantheon,206,121,85,58.74
Trundle,Ziggs,36,15,21,41.67
Trundle,Kled,24,8,16,33.33
Trundle,Irelia,78,50,28,64.1
Trundle,Xayah,72,27,45,37.5
Trundle,Cassiopeia,24,3,21,12.5
Trundle,Fizz,73,46,27,63.01
Trundle,Naafiri,32,11,21,34.38
Trundle,Xerath,103,51,52,49.51
Trundle,Sylas,128,74,54,57.81
Trundle,Zilean,31,19,12,61.29
Trundle,Gangplank,48,28,20,58.33
Trundle,Zac,85,36,49,42.35
Trundle,Renata,32,15,17,46.88
Trundle,Shyvana,25,11,14,44
Trundle,Gwen,75,32,43,42.67
Trundle,Orianna,62,36,26,58.06
Trundle,Veigar,112,57,55,50.89
Trundle,Azir,45,31,14,68.89
Trundle,Ornn,65,27,38,41.54
Trundle,XinZhao,84,41,43,48.81
Trundle,Vi,144,59,85,40.97
Trundle,Alistar,62,28,34,45.16
Trundle,Brand,58,38,20,65.52
Trundle,Corki,58,27,31,46.55
Trundle,Smolder,73,45,28,61.64
Trundle,Quinn,35,18,17,51.43
Trundle,RekSai,8,3,5,37.5
Trundle,Talon,49,26,23,53.06
Trundle,Kalista,55,33,22,60
Trundle,Udyr,56,39,17,69.64
Trundle,Heimerdinger,33,18,15,54.55
Trundle,Taliyah,12,8,4,66.67
Trundle,KogMaw,30,15,15,50
Trundle,Anivia,42,26,16,61.9
Trundle,Rumble,28,14,14,50
Trundle,Fiora,36,26,10,72.22
Trundle,Nidalee,23,18,5,78.26
Trundle,Vex,40,16,24,40
Trundle,Singed,28,17,11,60.71
Trundle,Kassadin,19,11,8,57.89
Trundle,Sona,9,6,3,66.67
Belveth,Trundle,30,15,15,50
Belveth,Sylas,78,36,42,46.15
Belveth,Zac,27,14,13,51.85
Belveth,MissFortune,64,32,32,50
Belveth,Seraphine,34,6,28,17.65
Belveth,Mel,84,40,44,47.62
Belveth,Lulu,55,29,26,52.73
Belveth,Jax,42,25,17,59.52
Belveth,Yasuo,81,41,40,50.62
Belveth,Chogath,29,12,17,41.38
Belveth,Heimerdinger,24,12,12,50
Belveth,Ashe,96,45,51,46.88
Belveth,Orianna,45,20,25,44.44
Belveth,LeeSin,68,37,31,54.41
Belveth,Darius,80,44,36,55
Belveth,Kayn,31,11,20,35.48
Belveth,Ryze,25,11,14,44
Belveth,Jinx,126,55,71,43.65
Belveth,Pantheon,63,38,25,60.32
Belveth,Vladimir,34,9,25,26.47
Belveth,Ekko,21,7,14,33.33
Belveth,Ambessa,34,17,17,50
Belveth,Braum,44,22,22,50
Belveth,Teemo,48,17,31,35.42
Belveth,Mordekaiser,52,28,24,53.85
Belveth,Yone,83,28,55,33.73
Belveth,Maokai,16,8,8,50
Belveth,Ziggs,11,6,5,54.55
Belveth,Singed,8,3,5,37.5
Belveth,Akshan,19,11,8,57.89
Belveth,Velkoz,27,14,13,51.85
Belveth,Gragas,33,21,12,63.64
Belveth,Varus,49,21,28,42.86
Belveth,Camille,34,13,21,38.24
Belveth,Zeri,18,13,5,72.22
Belveth,Viego,82,27,55,32.93
Belveth,Sett,63,31,32,49.21
Belveth,Akali,46,19,27,41.3
Belveth,MonkeyKing,45,20,25,44.44
Belveth,Volibear,77,34,43,44.16
Belveth,Irelia,39,22,17,56.41
Belveth,Caitlyn,105,55,50,52.38
Belveth,Morgana,47,15,32,31.91
Belveth,Yorick,39,19,20,48.72
Belveth,Amumu,81,51,30,62.96
Belveth,Sivir,28,11,17,39.29
Belveth,Lux,110,51,59,46.36
Belveth,Tryndamere,18,8,10,44.44
Belveth,Ahri,54,28,26,51.85
Belveth,Samira,37,15,22,40.54
Belveth,Senna,35,19,16,54.29
Belveth,Renekton,28,6,22,21.43
Belveth,Diana,51,13,38,25.49
Belveth,Brand,24,16,8,66.67
Belveth,Jayce,32,14,18,43.75
Belveth,Rengar,18,9,9,50
Belveth,Nidalee,22,8,14,36.36
Belveth,Garen,63,26,37,41.27
Belveth,Twitch,48,27,21,56.25
Belveth,Nami,61,24,37,39.34
Belveth,Malzahar,47,17,30,36.17
Belveth,Milio,39,17,22,43.59
Belveth,Rumble,22,8,14,36.36
Belveth,Ezreal,100,48,52,48
Belveth,Poppy,39,7,32,17.95
Belveth,Shen,38,17,21,44.74
Belveth,Kassadin,3,3,0,100
Belveth,Karma,55,41,14,74.55
Belveth,Zed,53,36,17,67.92
Belveth,Pyke,17,5,12,29.41
Belveth,Annie,19,13,6,68.42
Belveth,Kaisa,68,35,33,51.47
Belveth,FiddleSticks,22,10,12,45.45
Belveth,Fizz,17,14,3,82.35
Belveth,Jhin,75,39,36,52
Belveth,Blitzcrank,47,28,19,59.57
Belveth,Nasus,32,10,22,31.25
Belveth,Sejuani,12,6,6,50
Belveth,Leblanc,18,13,5,72.22
Belveth,Skarner,21,13,8,61.9
Belveth,Gwen,27,9,18,33.33
Belveth,Shyvana,14,6,8,42.86
Belveth,XinZhao,38,20,18,52.63
Belveth,TwistedFate,15,6,9,40
Belveth,Quinn,8,5,3,62.5
Belveth,Warwick,47,27,20,57.45
Belveth,Sona,8,5,3,62.5
Belveth,Thresh,106,61,45,57.55
Belveth,Sion,46,19,27,41.3
Belveth,Yuumi,35,12,23,34.29
Belveth,Talon,26,9,17,34.62
Belveth,Tristana,37,15,22,40.54
Belveth,Elise,42,18,24,42.86
Belveth,Kindred,23,15,8,65.22
Belveth,Syndra,17,12,5,70.59
Belveth,Xerath,31,23,8,74.19
Belveth,Hecarim,23,11,12,47.83
Belveth,Ornn,34,17,17,50
Belveth,Lucian,46,23,23,50
Belveth,Kalista,14,9,5,64.29
Belveth,Leona,65,35,30,53.85
Belveth,DrMundo,28,16,12,57.14
Belveth,Khazix,23,15,8,65.22
Belveth,Vayne,34,16,18,47.06
Belveth,MasterYi,38,23,15,60.53
Belveth,Anivia,20,10,10,50
Belveth,Swain,37,15,22,40.54
Belveth,Nunu,20,9,11,45
Belveth,Lissandra,24,5,19,20.83
Belveth,Malphite,46,21,25,45.65
Belveth,Zoe,19,9,10,47.37
Belveth,Urgot,15,0,15,0
Belveth,Briar,43,17,26,39.53
Belveth,Corki,16,7,9,43.75
Belveth,Soraka,14,3,11,21.43
Belveth,Kled,6,6,0,100
Belveth,Zyra,33,16,17,48.48
Belveth,Xayah,26,15,11,57.69
Belveth,Bard,20,8,12,40
Belveth,Riven,13,7,6,53.85
Belveth,Zilean,20,14,6,70
Belveth,Rakan,18,8,10,44.44
Belveth,Katarina,21,16,5,76.19
Belveth,Vi,48,17,31,35.42
Belveth,Cassiopeia,22,13,9,59.09
Belveth,TahmKench,37,15,22,40.54
Belveth,Illaoi,8,6,2,75
Belveth,Veigar,41,12,29,29.27
Belveth,Alistar,28,13,15,46.43
Belveth,Aphelios,31,12,19,38.71
Belveth,Rell,33,16,17,48.48
Belveth,Qiyana,11,8,3,72.73
Belveth,Naafiri,4,0,4,0
Belveth,Nautilus,56,27,29,48.21
Belveth,Viktor,51,24,27,47.06
Belveth,Gangplank,23,17,6,73.91
Belveth,Karthus,7,7,0,100
Belveth,Renata,10,6,4,60
Belveth,Galio,46,36,10,78.26
Belveth,Neeko,7,3,4,42.86
Belveth,Kennen,10,6,4,60
Belveth,JarvanIV,34,12,22,35.29
Belveth,Rammus,14,8,6,57.14
Belveth,Shaco,24,22,2,91.67
Belveth,Nocturne,42,20,22,47.62
Belveth,Janna,20,13,7,65
Belveth,KSante,30,14,16,46.67
Belveth,Hwei,17,11,6,64.71
Belveth,Kayle,28,17,11,60.71
Belveth,Udyr,11,5,6,45.45
Belveth,Smolder,15,5,10,33.33
Belveth,Aatrox,37,12,25,32.43
Belveth,Graves,27,12,15,44.44
Belveth,RekSai,8,6,2,75
Belveth,Nilah,14,8,6,57.14
Belveth,Olaf,7,3,4,42.86
Belveth,KogMaw,9,7,2,77.78
Belveth,AurelionSol,16,8,8,50
Belveth,Draven,39,10,29,25.64
Belveth,Ivern,5,2,3,40
Belveth,Azir,17,8,9,47.06
Belveth,Gnar,24,14,10,58.33
Belveth,Aurora,50,28,22,56
Belveth,Fiora,16,10,6,62.5
Belveth,Evelynn,9,0,9,0
Belveth,Vex,14,6,8,42.86
Belveth,Lillia,12,6,6,50
Belveth,Taliyah,9,3,6,33.33
Belveth,Taric,3,0,3,0
Taric,Yorick,51,13,38,25.49
Taric,Viego,67,20,47,29.85
Taric,AurelionSol,35,18,17,51.43
Taric,Ashe,120,59,61,49.17
Taric,Milio,35,21,14,60
Taric,Shen,48,22,26,45.83
Taric,Karthus,13,4,9,30.77
Taric,Ekko,52,25,27,48.08
Taric,Ezreal,114,52,62,45.61
Taric,Soraka,32,14,18,43.75
Taric,Sylas,83,49,34,59.04
Taric,Briar,41,22,19,53.66
Taric,Lux,113,59,54,52.21
Taric,Neeko,23,15,8,65.22
Taric,Blitzcrank,48,23,25,47.92
Taric,Veigar,38,21,17,55.26
Taric,Samira,42,32,10,76.19
Taric,Pantheon,120,65,55,54.17
Taric,Chogath,78,40,38,51.28
Taric,Warwick,51,19,32,37.25
Taric,Yone,68,37,31,54.41
Taric,Tristana,36,26,10,72.22
Taric,Zyra,37,16,21,43.24
Taric,Urgot,34,14,20,41.18
Taric,XinZhao,60,36,24,60
Taric,Mel,102,63,39,61.76
Taric,Draven,25,12,13,48
Taric,Thresh,116,72,44,62.07
Taric,Teemo,55,35,20,63.64
Taric,MasterYi,58,37,21,63.79
Taric,Zed,58,28,30,48.28
Taric,Jhin,100,57,43,57
Taric,Karma,58,34,24,58.62
Taric,Sett,54,36,18,66.67
Taric,Nocturne,61,34,27,55.74
Taric,Jinx,155,73,82,47.1
Taric,Fizz,17,14,3,82.35
Taric,Ornn,29,10,19,34.48
Taric,FiddleSticks,18,7,11,38.89
Taric,Yasuo,93,52,41,55.91
Taric,Irelia,54,29,25,53.7
Taric,Zilean,17,6,11,35.29
Taric,Elise,28,15,13,53.57
Taric,Diana,93,51,42,54.84
Taric,TwistedFate,21,11,10,52.38
Taric,Xayah,33,24,9,72.73
Taric,Rakan,32,23,9,71.88
Taric,Kayn,67,44,23,65.67
Taric,Ahri,68,39,29,57.35
Taric,Leona,66,35,31,53.03
Taric,Darius,110,61,49,55.45
Taric,MonkeyKing,37,15,22,40.54
Taric,Caitlyn,93,30,63,32.26
Taric,Sona,10,4,6,40
Taric,Trundle,17,8,9,47.06
Taric,Heimerdinger,14,8,6,57.14
Taric,Malphite,56,23,33,41.07
Taric,Garen,63,34,29,53.97
Taric,Sejuani,33,19,14,57.58
Taric,Alistar,28,15,13,53.57
Taric,Fiora,34,20,14,58.82
Taric,MissFortune,113,70,43,61.95
Taric,Poppy,30,13,17,43.33
Taric,Yuumi,50,36,14,72
Taric,JarvanIV,44,16,28,36.36
Taric,Katarina,48,23,25,47.92
Taric,Nami,45,26,19,57.78
Taric,Sion,46,32,14,69.57
Taric,Viktor,49,29,20,59.18
Taric,Braum,35,16,19,45.71
Taric,LeeSin,58,45,13,77.59
Taric,Sivir,17,6,11,35.29
Taric,Nautilus,96,49,47,51.04
Taric,Vladimir,29,15,14,51.72
Taric,Kassadin,3,0,3,0
Taric,Lulu,87,48,39,55.17
Taric,Ambessa,41,23,18,56.1
Taric,Taliyah,10,2,8,20
Taric,Qiyana,7,2,5,28.57
Taric,Lucian,42,25,17,59.52
Taric,Amumu,47,17,30,36.17
Taric,Akali,36,25,11,69.44
Taric,Pyke,54,33,21,61.11
Taric,Shaco,31,25,6,80.65
Taric,Kindred,17,9,8,52.94
Taric,Cassiopeia,30,17,13,56.67
Taric,Lillia,31,13,18,41.94
Taric,TahmKench,51,31,20,60.78
Taric,Hecarim,11,6,5,54.55
Taric,Kaisa,87,51,36,58.62
Taric,Skarner,27,12,15,44.44
Taric,Varus,53,25,28,47.17
Taric,Rengar,20,3,17,15
Taric,Twitch,46,27,19,58.7
Taric,DrMundo,20,8,12,40
Taric,Swain,53,21,32,39.62
Taric,KSante,37,20,17,54.05
Taric,Xerath,24,14,10,58.33
Taric,Volibear,55,35,20,63.64
Taric,Smolder,45,33,12,73.33
Taric,Vex,38,9,29,23.68
Taric,Azir,23,11,12,47.83
Taric,Gragas,56,37,19,66.07
Taric,Talon,22,16,6,72.73
Taric,Galio,39,28,11,71.79
Taric,Aatrox,34,17,17,50
Taric,Nunu,39,16,23,41.03
Taric,Corki,23,17,6,73.91
Taric,Zac,36,24,12,66.67
Taric,Seraphine,36,17,19,47.22
Taric,Orianna,26,10,16,38.46
Taric,Kalista,27,17,10,62.96
Taric,Riven,26,23,3,88.46
Taric,Khazix,19,14,5,73.68
Taric,Lissandra,22,16,6,72.73
Taric,Vayne,74,30,44,40.54
Taric,Graves,25,19,6,76
Taric,Gwen,34,21,13,61.76
Taric,Nidalee,15,2,13,13.33
Taric,Kled,8,3,5,37.5
Taric,Udyr,23,18,5,78.26
Taric,Vi,66,24,42,36.36
Taric,Velkoz,42,20,22,47.62
Taric,Brand,15,9,6,60
Taric,Jax,31,14,17,45.16
Taric,Gnar,32,19,13,59.38
Taric,Senna,18,13,5,72.22
Taric,Zoe,23,14,9,60.87
Taric,Hwei,40,25,15,62.5
Taric,Annie,25,13,12,52
Taric,Morgana,33,19,14,57.58
Taric,Renekton,24,16,8,66.67
Taric,Naafiri,14,3,11,21.43
Taric,Olaf,12,5,7,41.67
Taric,Renata,18,5,13,27.78
Taric,Gangplank,31,22,9,70.97
Taric,Malzahar,42,23,19,54.76
Taric,Kayle,20,7,13,35
Taric,Bard,16,8,8,50
Taric,Rell,25,16,9,64
Taric,KogMaw,6,4,2,66.67
Taric,Syndra,47,27,20,57.45
Taric,Ivern,13,11,2,84.62
Taric,Zeri,16,11,5,68.75
Taric,Jayce,25,12,13,48
Taric,Camille,18,9,9,50
Taric,Anivia,8,0,8,0
Taric,Ziggs,10,3,7,30
Taric,Mordekaiser,44,28,16,63.64
Taric,Evelynn,9,5,4,55.56
Taric,Quinn,17,3,14,17.65
Taric,Rumble,15,10,5,66.67
Taric,Aurora,26,18,8,69.23
Taric,Leblanc,20,12,8,60
Taric,Janna,4,0,4,0
Taric,RekSai,10,8,2,80
Taric,Nasus,17,5,12,29.41
Taric,Illaoi,28,11,17,39.29
Taric,Maokai,13,5,8,38.46
Taric,Rammus,8,0,8,0
Taric,Tryndamere,21,11,10,52.38
Taric,Kennen,11,6,5,54.55
Taric,Akshan,11,8,3,72.73
Taric,Aphelios,19,5,14,26.32
Taric,Shyvana,6,3,3,50
Taric,Singed,3,3,0,100
Taric,Ryze,23,9,14,39.13
Taric,Nilah,15,9,6,60
Taric,Belveth,3,3,0,100
Zilean,Aatrox,72,40,32,55.56
Zilean,JarvanIV,52,33,19,63.46
Zilean,Chogath,107,50,57,46.73
Zilean,MissFortune,112,53,59,47.32
Zilean,Yuumi,61,29,32,47.54
Zilean,Twitch,46,24,22,52.17
Zilean,Lillia,50,24,26,48
Zilean,Katarina,47,29,18,61.7
Zilean,Vayne,91,42,49,46.15
Zilean,Blitzcrank,73,34,39,46.58
Zilean,Jax,66,32,34,48.48
Zilean,Yorick,57,28,29,49.12
Zilean,Yasuo,137,81,56,59.12
Zilean,Tristana,49,25,24,51.02
Zilean,Lux,149,83,66,55.7
Zilean,Warwick,86,54,32,62.79
Zilean,Ahri,95,46,49,48.42
Zilean,Ezreal,161,90,71,55.9
Zilean,Sivir,39,18,21,46.15
Zilean,Ryze,32,15,17,46.88
Zilean,Ashe,150,65,85,43.33
Zilean,Senna,35,20,15,57.14
Zilean,Darius,98,51,47,52.04
Zilean,Kayn,81,43,38,53.09
Zilean,Fizz,33,15,18,45.45
Zilean,Caitlyn,203,106,97,52.22
Zilean,Nautilus,98,46,52,46.94
Zilean,Heimerdinger,36,22,14,61.11
Zilean,Velkoz,50,23,27,46
Zilean,Teemo,89,36,53,40.45
Zilean,Morgana,77,46,31,59.74
Zilean,TahmKench,56,19,37,33.93
Zilean,Rengar,24,13,11,54.17
Zilean,Sylas,95,60,35,63.16
Zilean,Lulu,113,61,52,53.98
Zilean,Kled,19,8,11,42.11
Zilean,Jhin,128,53,75,41.41
Zilean,Veigar,95,54,41,56.84
Zilean,Nocturne,79,33,46,41.77
Zilean,Thresh,159,77,82,48.43
Zilean,Corki,47,26,21,55.32
Zilean,Rammus,21,13,8,61.9
Zilean,Illaoi,35,18,17,51.43
Zilean,Evelynn,28,9,19,32.14
Zilean,Mel,132,79,53,59.85
Zilean,Xayah,27,21,6,77.78
Zilean,Gragas,84,40,44,47.62
Zilean,Azir,23,15,8,65.22
Zilean,Volibear,79,53,26,67.09
Zilean,Irelia,47,28,19,59.57
Zilean,Shaco,63,28,35,44.44
Zilean,AurelionSol,26,13,13,50
Zilean,Nilah,26,19,7,73.08
Zilean,Smolder,64,34,30,53.13
Zilean,Nami,89,32,57,35.96
Zilean,Gnar,41,18,23,43.9
Zilean,MonkeyKing,45,16,29,35.56
Zilean,Milio,43,23,20,53.49
Zilean,Yone,115,57,58,49.57
Zilean,Braum,61,35,26,57.38
Zilean,Viego,78,48,30,61.54
Zilean,Draven,33,15,18,45.45
Zilean,Soraka,22,10,12,45.45
Zilean,Viktor,58,27,31,46.55
Zilean,Zed,66,30,36,45.45
Zilean,Taric,17,11,6,64.71
Zilean,MasterYi,61,42,19,68.85
Zilean,Riven,22,9,13,40.91
Zilean,Akali,64,25,39,39.06
Zilean,Sona,17,6,11,35.29
Zilean,Sion,66,39,27,59.09
Zilean,Poppy,47,31,16,65.96
Zilean,Olaf,22,15,7,68.18
Zilean,Skarner,36,8,28,22.22
Zilean,Aphelios,51,23,28,45.1
Zilean,Gangplank,39,22,17,56.41
Zilean,Ivern,29,17,12,58.62
Zilean,Urgot,37,16,21,43.24
Zilean,Leblanc,36,12,24,33.33
Zilean,Vi,74,40,34,54.05
Zilean,Kayle,32,21,11,65.63
Zilean,Bard,14,7,7,50
Zilean,Kindred,28,9,19,32.14
Zilean,Syndra,59,27,32,45.76
Zilean,Amumu,100,42,58,42
Zilean,Jinx,190,96,94,50.53
Zilean,Rell,51,34,17,66.67
Zilean,LeeSin,95,48,47,50.53
Zilean,Ekko,56,21,35,37.5
Zilean,Varus,52,24,28,46.15
Zilean,Garen,135,59,76,43.7
Zilean,Shyvana,23,8,15,34.78
Zilean,Leona,74,33,41,44.59
Zilean,Kaisa,99,61,38,61.62
Zilean,Singed,11,2,9,18.18
Zilean,Graves,26,16,10,61.54
Zilean,Sejuani,53,13,40,24.53
Zilean,Malphite,68,40,28,58.82
Zilean,Nasus,51,25,26,49.02
Zilean,Briar,26,14,12,53.85
Zilean,Galio,81,47,34,58.02
Zilean,Swain,36,8,28,22.22
Zilean,Elise,62,34,28,54.84
Zilean,Karma,102,61,41,59.8
Zilean,Annie,25,12,13,48
Zilean,Trundle,31,12,19,38.71
Zilean,Neeko,40,28,12,70
Zilean,Ziggs,25,14,11,56
Zilean,Pantheon,145,68,77,46.9
Zilean,Hecarim,31,24,7,77.42
Zilean,Ambessa,34,25,9,73.53
Zilean,Udyr,31,17,14,54.84
Zilean,KogMaw,19,6,13,31.58
Zilean,Aurora,52,22,30,42.31
Zilean,Janna,25,5,20,20
Zilean,Diana,101,52,49,51.49
Zilean,Sett,75,27,48,36
Zilean,Jayce,31,23,8,74.19
Zilean,Xerath,38,29,9,76.32
Zilean,Lissandra,25,18,7,72
Zilean,Samira,44,29,15,65.91
Zilean,Shen,31,22,9,70.97
Zilean,Gwen,32,13,19,40.63
Zilean,Malzahar,74,52,22,70.27
Zilean,Nunu,39,31,8,79.49
Zilean,Nidalee,27,19,8,70.37
Zilean,Alistar,46,30,16,65.22
Zilean,Vladimir,54,34,20,62.96
Zilean,Zoe,36,25,11,69.44
Zilean,TwistedFate,30,15,15,50
Zilean,Zeri,24,14,10,58.33
Zilean,Mordekaiser,68,29,39,42.65
Zilean,Belveth,20,6,14,30
Zilean,Renata,27,13,14,48.15
Zilean,Seraphine,16,9,7,56.25
Zilean,FiddleSticks,30,17,13,56.67
Zilean,DrMundo,34,23,11,67.65
Zilean,Fiora,22,13,9,59.09
Zilean,Zac,41,28,13,68.29
Zilean,Akshan,25,13,12,52
Zilean,Karthus,25,18,7,72
Zilean,Vex,25,11,14,44
Zilean,Maokai,38,27,11,71.05
Zilean,Pyke,27,19,8,70.37
Zilean,Rakan,27,18,9,66.67
Zilean,Orianna,34,22,12,64.71
Zilean,Quinn,23,10,13,43.48
Zilean,Renekton,31,21,10,67.74
Zilean,Brand,34,17,17,50
Zilean,Kalista,23,18,5,78.26
Zilean,Lucian,36,21,15,58.33
Zilean,Zyra,37,33,4,89.19
Zilean,Anivia,23,12,11,52.17
Zilean,Camille,20,16,4,80
Zilean,Kassadin,7,0,7,0
Zilean,Talon,20,16,4,80
Zilean,Ornn,24,11,13,45.83
Zilean,Rumble,22,16,6,72.73
Zilean,XinZhao,27,10,17,37.04
Zilean,Khazix,40,19,21,47.5
Zilean,Hwei,49,25,24,51.02
Zilean,KSante,49,27,22,55.1
Zilean,Taliyah,21,9,12,42.86
Zilean,Naafiri,18,14,4,77.78
Zilean,Kennen,5,0,5,0
Zilean,Cassiopeia,22,9,13,40.91
Zilean,RekSai,11,3,8,27.27
Zilean,Qiyana,9,3,6,33.33
Zilean,Tryndamere,15,9,6,60
Orianna,Sett,143,64,79,44.76
Orianna,Kindred,36,17,19,47.22
Orianna,Mel,327,202,125,61.77
Orianna,Twitch,77,38,39,49.35
Orianna,Lulu,210,94,116,44.76
Orianna,Sejuani,115,39,76,33.91
Orianna,Viktor,159,74,85,46.54
Orianna,Jinx,360,173,187,48.06
Orianna,Lux,294,142,152,48.3
Orianna,Malphite,160,89,71,55.63
Orianna,Ivern,55,28,27,50.91
Orianna,Ahri,230,111,119,48.26
Orianna,Ashe,254,126,128,49.61
Orianna,Warwick,158,74,84,46.84
Orianna,Vladimir,110,57,53,51.82
Orianna,Akali,137,84,53,61.31
Orianna,Vayne,160,91,69,56.88
Orianna,Nami,137,70,67,51.09
Orianna,Viego,191,73,118,38.22
Orianna,Hwei,105,64,41,60.95
Orianna,Gnar,70,41,29,58.57
Orianna,Belveth,45,25,20,55.56
Orianna,Samira,82,33,49,40.24
Orianna,TahmKench,103,62,41,60.19
Orianna,Yone,133,76,57,57.14
Orianna,Kalista,33,21,12,63.64
Orianna,Nautilus,202,108,94,53.47
Orianna,Ornn,66,21,45,31.82
Orianna,Veigar,96,45,51,46.88
Orianna,Yasuo,184,89,95,48.37
Orianna,Pantheon,246,132,114,53.66
Orianna,Zac,84,56,28,66.67
Orianna,Kayn,121,70,51,57.85
Orianna,Zed,102,51,51,50
Orianna,Caitlyn,257,128,129,49.81
Orianna,Janna,54,20,34,37.04
Orianna,Camille,77,42,35,54.55
Orianna,Udyr,44,25,19,56.82
Orianna,Jhin,216,128,88,59.26
Orianna,Talon,61,33,28,54.1
Orianna,Xerath,117,60,57,51.28
Orianna,Soraka,51,20,31,39.22
Orianna,Briar,53,28,25,52.83
Orianna,Ekko,102,49,53,48.04
Orianna,Urgot,63,35,28,55.56
Orianna,Nasus,68,34,34,50
Orianna,Amumu,144,73,71,50.69
Orianna,Malzahar,113,62,51,54.87
Orianna,MissFortune,286,144,142,50.35
Orianna,Vex,61,23,38,37.7
Orianna,Kaisa,205,97,108,47.32
Orianna,Pyke,108,54,54,50
Orianna,KSante,101,60,41,59.41
Orianna,Shaco,62,24,38,38.71
Orianna,Diana,168,66,102,39.29
Orianna,Yuumi,106,34,72,32.08
Orianna,Shen,108,50,58,46.3
Orianna,Ziggs,45,29,16,64.44
Orianna,Swain,122,47,75,38.52
Orianna,Garen,210,93,117,44.29
Orianna,LeeSin,234,135,99,57.69
Orianna,Jayce,66,28,38,42.42
Orianna,MonkeyKing,84,62,22,73.81
Orianna,Azir,68,23,45,33.82
Orianna,Volibear,108,58,50,53.7
Orianna,Cassiopeia,37,22,15,59.46
Orianna,Poppy,108,61,47,56.48
Orianna,Darius,216,115,101,53.24
Orianna,Rakan,93,57,36,61.29
Orianna,Anivia,54,25,29,46.3
Orianna,Morgana,90,44,46,48.89
Orianna,Milio,68,37,31,54.41
Orianna,Kled,40,21,19,52.5
Orianna,Kassadin,19,10,9,52.63
Orianna,Ezreal,316,143,173,45.25
Orianna,Olaf,44,17,27,38.64
Orianna,Gragas,100,55,45,55
Orianna,Bard,46,20,26,43.48
Orianna,Leblanc,76,36,40,47.37
Orianna,Yorick,97,57,40,58.76
Orianna,Thresh,214,97,117,45.33
Orianna,Gangplank,68,41,27,60.29
Orianna,Evelynn,35,7,28,20
Orianna,Seraphine,95,52,43,54.74
Orianna,JarvanIV,119,50,69,42.02
Orianna,Draven,61,26,35,42.62
Orianna,Varus,138,69,69,50
Orianna,Mordekaiser,163,87,76,53.37
Orianna,Nocturne,170,83,87,48.82
Orianna,Karma,179,88,91,49.16
Orianna,Tryndamere,44,17,27,38.64
Orianna,Syndra,100,40,60,40
Orianna,Blitzcrank,106,60,46,56.6
Orianna,Lillia,103,54,49,52.43
Orianna,Fizz,43,21,22,48.84
Orianna,Khazix,62,45,17,72.58
Orianna,Elise,85,54,31,63.53
Orianna,Senna,65,40,25,61.54
Orianna,Fiora,39,24,15,61.54
Orianna,Aphelios,68,29,39,42.65
Orianna,DrMundo,58,28,30,48.28
Orianna,Renata,36,18,18,50
Orianna,Nunu,67,32,35,47.76
Orianna,Ambessa,85,43,42,50.59
Orianna,Qiyana,32,17,15,53.13
Orianna,Zoe,56,32,24,57.14
Orianna,KogMaw,37,25,12,67.57
Orianna,Taliyah,45,19,26,42.22
Orianna,Rammus,22,11,11,50
Orianna,Smolder,90,37,53,41.11
Orianna,Jax,111,45,66,40.54
Orianna,Katarina,55,24,31,43.64
Orianna,Lucian,114,60,54,52.63
Orianna,Shyvana,35,15,20,42.86
Orianna,Leona,125,66,59,52.8
Orianna,MasterYi,127,77,50,60.63
Orianna,Aatrox,141,82,59,58.16
Orianna,Vi,97,54,43,55.67
Orianna,Sylas,188,78,110,41.49
Orianna,Rell,90,48,42,53.33
Orianna,Irelia,84,37,47,44.05
Orianna,Graves,116,59,57,50.86
Orianna,Sion,90,40,50,44.44
Orianna,Sivir,72,39,33,54.17
Orianna,Brand,43,21,22,48.84
Orianna,Ryze,43,13,30,30.23
Orianna,Aurora,105,58,47,55.24
Orianna,Alistar,74,35,39,47.3
Orianna,AurelionSol,38,19,19,50
Orianna,Karthus,25,16,9,64
Orianna,Velkoz,56,29,27,51.79
Orianna,Riven,38,16,22,42.11
Orianna,Zyra,119,54,65,45.38
Orianna,Chogath,152,82,70,53.95
Orianna,Zeri,61,28,33,45.9
Orianna,TwistedFate,30,17,13,56.67
Orianna,Rumble,53,36,17,67.92
Orianna,Maokai,70,35,35,50
Orianna,Galio,135,56,79,41.48
Orianna,Nilah,32,14,18,43.75
Orianna,Hecarim,54,20,34,37.04
Orianna,Corki,84,50,34,59.52
Orianna,Trundle,62,26,36,41.94
Orianna,FiddleSticks,62,28,34,45.16
Orianna,Braum,78,44,34,56.41
Orianna,Gwen,57,20,37,35.09
Orianna,Kayle,53,21,32,39.62
Orianna,Akshan,40,33,7,82.5
Orianna,Skarner,65,30,35,46.15
Orianna,Teemo,88,45,43,51.14
Orianna,Naafiri,43,23,20,53.49
Orianna,Xayah,80,47,33,58.75
Orianna,Taric,26,16,10,61.54
Orianna,Heimerdinger,88,58,30,65.91
Orianna,Renekton,41,27,14,65.85
Orianna,Tristana,107,53,54,49.53
Orianna,Nidalee,56,43,13,76.79
Orianna,RekSai,31,14,17,45.16
Orianna,Quinn,36,18,18,50
Orianna,XinZhao,99,54,45,54.55
Orianna,Neeko,49,32,17,65.31
Orianna,Singed,35,10,25,28.57
Orianna,Zilean,34,12,22,35.29
Orianna,Sona,13,5,8,38.46
Orianna,Lissandra,45,26,19,57.78
Orianna,Kennen,47,29,18,61.7
Orianna,Rengar,30,17,13,56.67
Orianna,Illaoi,56,29,27,51.79
Orianna,Annie,26,17,9,65.38
Talon,Gnar,72,40,32,55.56
Talon,Evelynn,29,15,14,51.72
Talon,Malphite,110,64,46,58.18
Talon,Lucian,110,58,52,52.73
Talon,Mel,268,139,129,51.87
Talon,Quinn,39,15,24,38.46
Talon,MasterYi,98,39,59,39.8
Talon,Garen,159,62,97,38.99
Talon,Smolder,79,38,41,48.1
Talon,Nautilus,141,62,79,43.97
Talon,Sett,160,56,104,35
Talon,Ekko,95,47,48,49.47
Talon,Azir,47,18,29,38.3
Talon,Jinx,300,148,152,49.33
Talon,Nami,145,61,84,42.07
Talon,Aatrox,142,61,81,42.96
Talon,Sejuani,72,29,43,40.28
Talon,Yasuo,286,120,166,41.96
Talon,Annie,43,26,17,60.47
Talon,Gwen,80,37,43,46.25
Talon,Amumu,133,59,74,44.36
Talon,DrMundo,44,14,30,31.82
Talon,Tristana,93,41,52,44.09
Talon,Lulu,157,85,72,54.14
Talon,XinZhao,114,44,70,38.6
Talon,Chogath,121,50,71,41.32
Talon,Ashe,245,120,125,48.98
Talon,Rell,85,21,64,24.71
Talon,Lux,251,119,132,47.41
Talon,Caitlyn,275,136,139,49.45
Talon,Karma,130,74,56,56.92
Talon,Vi,165,63,102,38.18
Talon,Orianna,61,28,33,45.9
Talon,Swain,100,44,56,44
Talon,Renekton,73,35,38,47.95
Talon,MonkeyKing,104,41,63,39.42
Talon,Sylas,211,96,115,45.5
Talon,Seraphine,84,43,41,51.19
Talon,Olaf,29,11,18,37.93
Talon,Gragas,76,34,42,44.74
Talon,Zed,141,71,70,50.35
Talon,Rakan,52,27,25,51.92
Talon,Nasus,67,33,34,49.25
Talon,Malzahar,107,48,59,44.86
Talon,MissFortune,228,96,132,42.11
Talon,Vex,80,36,44,45
Talon,Darius,177,71,106,40.11
Talon,JarvanIV,86,40,46,46.51
Talon,Warwick,143,72,71,50.35
Talon,Akali,145,64,81,44.14
Talon,TahmKench,119,56,63,47.06
Talon,Fiora,57,27,30,47.37
Talon,Jhin,160,60,100,37.5
Talon,Riven,43,17,26,39.53
Talon,Thresh,255,108,147,42.35
Talon,Kaisa,175,93,82,53.14
Talon,Yone,190,100,90,52.63
Talon,Nocturne,132,64,68,48.48
Talon,Leblanc,106,48,58,45.28
Talon,Sion,112,57,55,50.89
Talon,Poppy,77,22,55,28.57
Talon,Kayn,147,67,80,45.58
Talon,Draven,23,12,11,52.17
Talon,Tryndamere,29,17,12,58.62
Talon,Hecarim,44,11,33,25
Talon,Shaco,80,53,27,66.25
Talon,Ziggs,61,23,38,37.7
Talon,Hwei,77,33,44,42.86
Talon,Jax,61,34,27,55.74
Talon,Vayne,140,53,87,37.86
Talon,Alistar,47,21,26,44.68
Talon,AurelionSol,47,12,35,25.53
Talon,Ezreal,300,138,162,46
Talon,Yuumi,96,55,41,57.29
Talon,Teemo,105,43,62,40.95
Talon,Briar,41,25,16,60.98
Talon,Pantheon,157,62,95,39.49
Talon,Milio,76,34,42,44.74
Talon,Nidalee,55,33,22,60
Talon,Rumble,33,15,18,45.45
Talon,Udyr,30,17,13,56.67
Talon,Gangplank,70,35,35,50
Talon,LeeSin,298,173,125,58.05
Talon,Leona,97,49,48,50.52
Talon,Mordekaiser,115,53,62,46.09
Talon,Varus,148,72,76,48.65
Talon,Ambessa,88,43,45,48.86
Talon,Nunu,64,29,35,45.31
Talon,Xerath,103,48,55,46.6
Talon,Katarina,79,25,54,31.65
Talon,Aphelios,53,22,31,41.51
Talon,Blitzcrank,140,61,79,43.57
Talon,Graves,61,36,25,59.02
Talon,Veigar,89,35,54,39.33
Talon,KogMaw,22,11,11,50
Talon,Viktor,93,35,58,37.63
Talon,Elise,125,51,74,40.8
Talon,Vladimir,72,41,31,56.94
Talon,Diana,136,55,81,40.44
Talon,Shyvana,31,10,21,32.26
Talon,Soraka,38,13,25,34.21
Talon,Galio,170,95,75,55.88
Talon,Cassiopeia,37,20,17,54.05
Talon,Lillia,75,39,36,52
Talon,Ryze,50,15,35,30
Talon,Xayah,65,24,41,36.92
Talon,Rengar,50,16,34,32
Talon,Janna,26,16,10,61.54
Talon,Illaoi,55,20,35,36.36
Talon,Rammus,29,23,6,79.31
Talon,Renata,24,12,12,50
Talon,Kayle,57,24,33,42.11
Talon,Twitch,76,35,41,46.05
Talon,Camille,67,31,36,46.27
Talon,FiddleSticks,61,26,35,42.62
Talon,Irelia,83,40,43,48.19
Talon,Urgot,55,29,26,52.73
Talon,Kassadin,14,6,8,42.86
Talon,Shen,109,50,59,45.87
Talon,Aurora,118,65,53,55.08
Talon,Khazix,82,36,46,43.9
Talon,Samira,89,33,56,37.08
Talon,Yorick,76,34,42,44.74
Talon,Pyke,85,45,40,52.94
Talon,Sivir,84,52,32,61.9
Talon,Brand,45,22,23,48.89
Talon,Belveth,26,17,9,65.38
Talon,Lissandra,29,12,17,41.38
Talon,Morgana,84,48,36,57.14
Talon,Karthus,30,21,9,70
Talon,Ahri,130,57,73,43.85
Talon,Braum,70,31,39,44.29
Talon,Nilah,51,23,28,45.1
Talon,Volibear,85,35,50,41.18
Talon,Zac,54,25,29,46.3
Talon,Velkoz,62,36,26,58.06
Talon,Senna,79,28,51,35.44
Talon,Ornn,75,37,38,49.33
Talon,Taliyah,17,12,5,70.59
Talon,Viego,145,74,71,51.03
Talon,Taric,22,6,16,27.27
Talon,Syndra,46,20,26,43.48
Talon,Trundle,49,23,26,46.94
Talon,Maokai,40,17,23,42.5
Talon,Jayce,68,36,32,52.94
Talon,Kennen,32,20,12,62.5
Talon,Bard,36,19,17,52.78
Talon,TwistedFate,48,20,28,41.67
Talon,Ivern,22,8,14,36.36
Talon,Kindred,47,31,16,65.96
Talon,Corki,41,14,27,34.15
Talon,Naafiri,44,21,23,47.73
Talon,Zyra,55,23,32,41.82
Talon,Neeko,76,26,50,34.21
Talon,Zilean,20,4,16,20
Talon,Sona,22,3,19,13.64
Talon,Kled,19,13,6,68.42
Talon,Akshan,32,5,27,15.63
Talon,Zeri,61,29,32,47.54
Talon,Fizz,34,18,16,52.94
Talon,Skarner,46,21,25,45.65
Talon,KSante,69,38,31,55.07
Talon,RekSai,23,9,14,39.13
Talon,Anivia,22,5,17,22.73
Talon,Heimerdinger,27,12,15,44.44
Talon,Singed,20,5,15,25
Talon,Zoe,71,39,32,54.93
Talon,Qiyana,17,6,11,35.29
Talon,Kalista,33,12,21,36.36
Cassiopeia,Illaoi,27,15,12,55.56
Cassiopeia,Briar,58,29,29,50
Cassiopeia,Taliyah,23,14,9,60.87
Cassiopeia,Twitch,60,42,18,70
Cassiopeia,Morgana,58,26,32,44.83
Cassiopeia,Ahri,90,43,47,47.78
Cassiopeia,Kaisa,99,47,52,47.47
Cassiopeia,Ashe,125,75,50,60
Cassiopeia,Olaf,25,14,11,56
Cassiopeia,Nidalee,41,30,11,73.17
Cassiopeia,Ryze,38,20,18,52.63
Cassiopeia,Caitlyn,175,109,66,62.29
Cassiopeia,Brand,26,10,16,38.46
Cassiopeia,Urgot,27,14,13,51.85
Cassiopeia,Mordekaiser,91,54,37,59.34
Cassiopeia,Malzahar,65,36,29,55.38
Cassiopeia,Ezreal,134,80,54,59.7
Cassiopeia,Mel,141,79,62,56.03
Cassiopeia,Gangplank,29,12,17,41.38
Cassiopeia,XinZhao,62,19,43,30.65
Cassiopeia,Azir,17,3,14,17.65
Cassiopeia,Lux,119,55,64,46.22
Cassiopeia,Maokai,32,20,12,62.5
Cassiopeia,Orianna,37,15,22,40.54
Cassiopeia,Tristana,97,48,49,49.48
Cassiopeia,Chogath,96,43,53,44.79
Cassiopeia,Nocturne,58,28,30,48.28
Cassiopeia,Akali,73,45,28,61.64
Cassiopeia,Samira,48,27,21,56.25
Cassiopeia,Thresh,97,52,45,53.61
Cassiopeia,Renekton,39,20,19,51.28
Cassiopeia,Diana,73,43,30,58.9
Cassiopeia,Zed,70,47,23,67.14
Cassiopeia,Jinx,132,68,64,51.52
Cassiopeia,Senna,37,26,11,70.27
Cassiopeia,Jayce,36,15,21,41.67
Cassiopeia,Draven,30,16,14,53.33
Cassiopeia,Syndra,52,32,20,61.54
Cassiopeia,Jhin,115,69,46,60
Cassiopeia,Nautilus,106,56,50,52.83
Cassiopeia,Sett,69,41,28,59.42
Cassiopeia,FiddleSticks,38,15,23,39.47
Cassiopeia,Veigar,57,22,35,38.6
Cassiopeia,MissFortune,113,51,62,45.13
Cassiopeia,Shaco,55,20,35,36.36
Cassiopeia,Pantheon,91,52,39,57.14
Cassiopeia,Tryndamere,14,5,9,35.71
Cassiopeia,Kayn,86,56,30,65.12
Cassiopeia,Viktor,71,39,32,54.93
Cassiopeia,Kayle,35,20,15,57.14
Cassiopeia,Evelynn,22,5,17,22.73
Cassiopeia,Aatrox,75,28,47,37.33
Cassiopeia,Nilah,48,24,24,50
Cassiopeia,Milio,46,23,23,50
Cassiopeia,Seraphine,60,19,41,31.67
Cassiopeia,Nami,90,43,47,47.78
Cassiopeia,Teemo,72,36,36,50
Cassiopeia,Lissandra,43,21,22,48.84
Cassiopeia,Lucian,60,26,34,43.33
Cassiopeia,Volibear,59,36,23,61.02
Cassiopeia,Nunu,47,15,32,31.91
Cassiopeia,Zoe,44,16,28,36.36
Cassiopeia,Swain,47,27,20,57.45
Cassiopeia,TahmKench,62,35,27,56.45
Cassiopeia,Warwick,94,52,42,55.32
Cassiopeia,Sion,63,26,37,41.27
Cassiopeia,Gragas,51,28,23,54.9
Cassiopeia,Irelia,35,15,20,42.86
Cassiopeia,MasterYi,35,19,16,54.29
Cassiopeia,Karma,85,52,33,61.18
Cassiopeia,Garen,113,63,50,55.75
Cassiopeia,Malphite,96,59,37,61.46
Cassiopeia,Pyke,55,26,29,47.27
Cassiopeia,Alistar,38,30,8,78.95
Cassiopeia,Elise,78,30,48,38.46
Cassiopeia,Yasuo,108,63,45,58.33
Cassiopeia,Renata,16,10,6,62.5
Cassiopeia,Talon,37,17,20,45.95
Cassiopeia,Singed,23,11,12,47.83
Cassiopeia,Kindred,40,26,14,65
Cassiopeia,Lulu,98,64,34,65.31
Cassiopeia,Ornn,43,23,20,53.49
Cassiopeia,MonkeyKing,56,21,35,37.5
Cassiopeia,Darius,129,63,66,48.84
Cassiopeia,Viego,40,13,27,32.5
Cassiopeia,Vladimir,50,29,21,58
Cassiopeia,Sejuani,46,21,25,45.65
Cassiopeia,Riven,15,6,9,40
Cassiopeia,Sivir,40,28,12,70
Cassiopeia,Xerath,61,23,38,37.7
Cassiopeia,Lillia,37,22,15,59.46
Cassiopeia,Amumu,51,24,27,47.06
Cassiopeia,Zac,64,31,33,48.44
Cassiopeia,Yone,105,60,45,57.14
Cassiopeia,Yuumi,70,41,29,58.57
Cassiopeia,Hwei,48,25,23,52.08
Cassiopeia,Aurora,47,30,17,63.83
Cassiopeia,Varus,48,27,21,56.25
Cassiopeia,Trundle,24,21,3,87.5
Cassiopeia,Vi,76,46,30,60.53
Cassiopeia,Zeri,44,27,17,61.36
Cassiopeia,Gwen,29,10,19,34.48
Cassiopeia,Smolder,56,21,35,37.5
Cassiopeia,Taric,30,13,17,43.33
Cassiopeia,Katarina,37,27,10,72.97
Cassiopeia,Fizz,31,25,6,80.65
Cassiopeia,Heimerdinger,26,21,5,80.77
Cassiopeia,Blitzcrank,36,13,23,36.11
Cassiopeia,Karthus,16,11,5,68.75
Cassiopeia,JarvanIV,62,50,12,80.65
Cassiopeia,Neeko,51,34,17,66.67
Cassiopeia,Nasus,27,8,19,29.63
Cassiopeia,Vayne,107,61,46,57.01
Cassiopeia,Quinn,20,6,14,30
Cassiopeia,Zyra,44,24,20,54.55
Cassiopeia,Corki,31,17,14,54.84
Cassiopeia,Rakan,35,24,11,68.57
Cassiopeia,Kalista,20,11,9,55
Cassiopeia,Fiora,10,8,2,80
Cassiopeia,Graves,48,20,28,41.67
Cassiopeia,TwistedFate,24,20,4,83.33
Cassiopeia,Naafiri,21,8,13,38.1
Cassiopeia,KSante,51,24,27,47.06
Cassiopeia,LeeSin,118,68,50,57.63
Cassiopeia,Ziggs,23,11,12,47.83
Cassiopeia,Rammus,16,11,5,68.75
Cassiopeia,Soraka,38,22,16,57.89
Cassiopeia,Ambessa,52,28,24,53.85
Cassiopeia,Shen,36,17,19,47.22
Cassiopeia,Belveth,22,9,13,40.91
Cassiopeia,Xayah,42,16,26,38.1
Cassiopeia,Sylas,91,61,30,67.03
Cassiopeia,Jax,38,21,17,55.26
Cassiopeia,Aphelios,26,12,14,46.15
Cassiopeia,Annie,35,20,15,57.14
Cassiopeia,Velkoz,26,15,11,57.69
Cassiopeia,AurelionSol,33,25,8,75.76
Cassiopeia,Rell,34,15,19,44.12
Cassiopeia,Galio,61,23,38,37.7
Cassiopeia,Janna,19,9,10,47.37
Cassiopeia,Kled,16,9,7,56.25
Cassiopeia,Sona,17,11,6,64.71
Cassiopeia,Hecarim,11,6,5,54.55
Cassiopeia,Poppy,40,25,15,62.5
Cassiopeia,Anivia,33,12,21,36.36
Cassiopeia,DrMundo,31,19,12,61.29
Cassiopeia,KogMaw,23,9,14,39.13
Cassiopeia,Yorick,33,14,19,42.42
Cassiopeia,Leona,60,26,34,43.33
Cassiopeia,Qiyana,17,14,3,82.35
Cassiopeia,Ekko,37,22,15,59.46
Cassiopeia,Gnar,26,7,19,26.92
Cassiopeia,Udyr,19,17,2,89.47
Cassiopeia,Rengar,21,13,8,61.9
Cassiopeia,Camille,30,20,10,66.67
Cassiopeia,Braum,40,26,14,65
Cassiopeia,Skarner,31,17,14,54.84
Cassiopeia,Bard,12,4,8,33.33
Cassiopeia,Vex,20,11,9,55
Cassiopeia,Shyvana,7,2,5,28.57
Cassiopeia,Rumble,21,10,11,47.62
Cassiopeia,Kassadin,7,2,5,28.57
Cassiopeia,RekSai,8,3,5,37.5
Cassiopeia,Leblanc,28,8,20,28.57
Cassiopeia,Ivern,14,12,2,85.71
Cassiopeia,Kennen,31,14,17,45.16
Cassiopeia,Zilean,22,13,9,59.09
Cassiopeia,Khazix,18,6,12,33.33
Cassiopeia,Akshan,9,6,3,66.67
Illaoi,Cassiopeia,27,12,15,44.44
Illaoi,Kaisa,193,104,89,53.89
Illaoi,Volibear,145,91,54,62.76
Illaoi,Mel,199,95,104,47.74
Illaoi,Leona,108,47,61,43.52
Illaoi,Camille,45,10,35,22.22
Illaoi,Diana,170,93,77,54.71
Illaoi,Malzahar,102,52,50,50.98
Illaoi,Sivir,74,43,31,58.11
Illaoi,Zyra,102,49,53,48.04
Illaoi,Jax,120,75,45,62.5
Illaoi,RekSai,15,15,0,100
Illaoi,Xayah,69,28,41,40.58
Illaoi,Rakan,70,37,33,52.86
Illaoi,Heimerdinger,47,27,20,57.45
Illaoi,LeeSin,164,86,78,52.44
Illaoi,AurelionSol,45,13,32,28.89
Illaoi,Jinx,231,103,128,44.59
Illaoi,Garen,201,97,104,48.26
Illaoi,Briar,58,28,30,48.28
Illaoi,Neeko,47,31,16,65.96
Illaoi,Jhin,189,94,95,49.74
Illaoi,Lulu,138,62,76,44.93
Illaoi,Riven,44,24,20,54.55
Illaoi,Nocturne,116,65,51,56.03
Illaoi,Akali,103,49,54,47.57
Illaoi,Ashe,238,126,112,52.94
Illaoi,Soraka,39,28,11,71.79
Illaoi,Gnar,39,20,19,51.28
Illaoi,Fizz,49,29,20,59.18
Illaoi,Seraphine,79,41,38,51.9
Illaoi,Trundle,73,34,39,46.58
Illaoi,Katarina,60,33,27,55
Illaoi,Ezreal,253,114,139,45.06
Illaoi,Zoe,50,22,28,44
Illaoi,Mordekaiser,198,85,113,42.93
Illaoi,Azir,33,17,16,51.52
Illaoi,Caitlyn,323,161,162,49.85
Illaoi,Pantheon,202,97,105,48.02
Illaoi,Ekko,72,41,31,56.94
Illaoi,Vex,92,36,56,39.13
Illaoi,Lucian,101,50,51,49.5
Illaoi,Morgana,79,30,49,37.97
Illaoi,Sett,185,85,100,45.95
Illaoi,Amumu,121,65,56,53.72
Illaoi,Irelia,99,55,44,55.56
Illaoi,MissFortune,239,110,129,46.03
Illaoi,Aatrox,104,50,54,48.08
Illaoi,Sylas,142,73,69,51.41
Illaoi,Zilean,35,17,18,48.57
Illaoi,Darius,220,119,101,54.09
Illaoi,Veigar,114,52,62,45.61
Illaoi,Lux,265,146,119,55.09
Illaoi,Nautilus,162,66,96,40.74
Illaoi,Zed,147,57,90,38.78
Illaoi,Yuumi,95,41,54,43.16
Illaoi,Vi,145,85,60,58.62
Illaoi,TahmKench,119,66,53,55.46
Illaoi,Zac,51,24,27,47.06
Illaoi,Yasuo,220,107,113,48.64
Illaoi,Rell,49,20,29,40.82
Illaoi,Yone,198,102,96,51.52
Illaoi,XinZhao,64,29,35,45.31
Illaoi,Blitzcrank,96,56,40,58.33
Illaoi,Singed,30,9,21,30
Illaoi,Gragas,97,56,41,57.73
Illaoi,Hwei,85,54,31,63.53
Illaoi,Swain,104,51,53,49.04
Illaoi,Malphite,116,60,56,51.72
Illaoi,Rammus,33,27,6,81.82
Illaoi,Aurora,100,62,38,62
Illaoi,Kayn,164,89,75,54.27
Illaoi,Milio,64,37,27,57.81
Illaoi,Teemo,80,41,39,51.25
Illaoi,Bard,36,24,12,66.67
Illaoi,JarvanIV,92,28,64,30.43
Illaoi,Karma,120,62,58,51.67
Illaoi,Yorick,98,45,53,45.92
Illaoi,Chogath,135,85,50,62.96
Illaoi,Elise,92,43,49,46.74
Illaoi,Udyr,49,28,21,57.14
Illaoi,Varus,111,52,59,46.85
Illaoi,Lissandra,58,30,28,51.72
Illaoi,Vayne,115,58,57,50.43
Illaoi,Kled,16,8,8,50
Illaoi,Viktor,66,38,28,57.58
Illaoi,Akshan,26,6,20,23.08
Illaoi,Braum,73,36,37,49.32
Illaoi,Renekton,74,49,25,66.22
Illaoi,Twitch,72,33,39,45.83
Illaoi,Nami,93,33,60,35.48
Illaoi,Rumble,34,18,16,52.94
Illaoi,Sejuani,66,31,35,46.97
Illaoi,Smolder,62,29,33,46.77
Illaoi,Kindred,40,19,21,47.5
Illaoi,Thresh,189,82,107,43.39
Illaoi,Nidalee,21,12,9,57.14
Illaoi,Kalista,40,23,17,57.5
Illaoi,Alistar,51,28,23,54.9
Illaoi,KSante,59,35,24,59.32
Illaoi,Draven,54,33,21,61.11
Illaoi,Pyke,87,56,31,64.37
Illaoi,Nasus,73,34,39,46.58
Illaoi,Olaf,48,25,23,52.08
Illaoi,Ornn,89,47,42,52.81
Illaoi,MasterYi,128,50,78,39.06
Illaoi,Samira,70,37,33,52.86
Illaoi,Vladimir,54,32,22,59.26
Illaoi,Viego,121,35,86,28.93
Illaoi,Talon,55,35,20,63.64
Illaoi,Hecarim,28,15,13,53.57
Illaoi,Ahri,117,52,65,44.44
Illaoi,Graves,65,33,32,50.77
Illaoi,Warwick,142,80,62,56.34
Illaoi,Renata,26,14,12,53.85
Illaoi,Jayce,52,18,34,34.62
Illaoi,Kayle,51,16,35,31.37
Illaoi,MonkeyKing,64,35,29,54.69
Illaoi,Ambessa,87,52,35,59.77
Illaoi,Syndra,60,31,29,51.67
Illaoi,Urgot,67,36,31,53.73
Illaoi,Maokai,50,21,29,42
Illaoi,Ryze,38,15,23,39.47
Illaoi,Kassadin,24,3,21,12.5
Illaoi,Brand,62,27,35,43.55
Illaoi,Velkoz,64,18,46,28.13
Illaoi,DrMundo,55,38,17,69.09
Illaoi,Khazix,67,40,27,59.7
Illaoi,Sion,98,43,55,43.88
Illaoi,Taliyah,24,14,10,58.33
Illaoi,Galio,126,80,46,63.49
Illaoi,Kennen,34,11,23,32.35
Illaoi,Fiora,43,14,29,32.56
Illaoi,KogMaw,37,10,27,27.03
Illaoi,Poppy,80,46,34,57.5
Illaoi,Gwen,67,31,36,46.27
Illaoi,Tristana,71,45,26,63.38
Illaoi,Leblanc,59,32,27,54.24
Illaoi,Aphelios,53,31,22,58.49
Illaoi,Skarner,45,14,31,31.11
Illaoi,Gangplank,38,14,24,36.84
Illaoi,Shen,96,48,48,50
Illaoi,Shyvana,24,13,11,54.17
Illaoi,Naafiri,24,15,9,62.5
Illaoi,Belveth,8,2,6,25
Illaoi,Janna,30,11,19,36.67
Illaoi,Rengar,15,15,0,100
Illaoi,Lillia,71,29,42,40.85
Illaoi,Corki,42,17,25,40.48
Illaoi,Annie,33,8,25,24.24
Illaoi,FiddleSticks,41,15,26,36.59
Illaoi,Ziggs,46,16,30,34.78
Illaoi,Shaco,81,51,30,62.96
Illaoi,TwistedFate,41,15,26,36.59
Illaoi,Quinn,16,3,13,18.75
Illaoi,Senna,58,16,42,27.59
Illaoi,Nunu,90,52,38,57.78
Illaoi,Anivia,46,21,25,45.65
Illaoi,Xerath,85,45,40,52.94
Illaoi,Nilah,34,21,13,61.76
Illaoi,Tryndamere,42,26,16,61.9
Illaoi,Zeri,48,30,18,62.5
Illaoi,Sona,22,17,5,77.27
Illaoi,Orianna,56,27,29,48.21
Illaoi,Ivern,11,5,6,45.45
Illaoi,Evelynn,25,6,19,24
Illaoi,Taric,28,17,11,60.71
Illaoi,Karthus,34,16,18,47.06
Illaoi,Qiyana,12,0,12,0
Briar,Cassiopeia,58,29,29,50
Briar,Kaisa,191,96,95,50.26
Briar,Volibear,147,71,76,48.3
Briar,Mel,245,138,107,56.33
Briar,Leona,130,62,68,47.69
Briar,Aatrox,135,80,55,59.26
Briar,Lillia,72,25,47,34.72
Briar,Hwei,107,42,65,39.25
Briar,Ashe,266,162,104,60.9
Briar,Amumu,154,72,82,46.75
Briar,Darius,243,129,114,53.09
Briar,Nocturne,198,90,108,45.45
Briar,Katarina,78,44,34,56.41
Briar,Lucian,79,51,28,64.56
Briar,Nami,104,56,48,53.85
Briar,Twitch,112,69,43,61.61
Briar,Garen,177,75,102,42.37
Briar,Fizz,75,43,32,57.33
Briar,Karma,190,107,83,56.32
Briar,Vladimir,77,38,39,49.35
Briar,Lux,293,147,146,50.17
Briar,Rell,86,37,49,43.02
Briar,Malphite,166,96,70,57.83
Briar,Kayn,176,110,66,62.5
Briar,Ryze,49,27,22,55.1
Briar,Illaoi,58,30,28,51.72
Briar,Warwick,167,75,92,44.91
Briar,Ekko,119,52,67,43.7
Briar,MissFortune,259,114,145,44.02
Briar,Rakan,41,17,24,41.46
Briar,JarvanIV,96,58,38,60.42
Briar,Rumble,37,20,17,54.05
Briar,Galio,137,77,60,56.2
Briar,Lulu,161,81,80,50.31
Briar,Sylas,171,98,73,57.31
Briar,Pantheon,219,117,102,53.42
Briar,Shen,92,50,42,54.35
Briar,Hecarim,56,22,34,39.29
Briar,Kassadin,25,14,11,56
Briar,Varus,136,84,52,61.76
Briar,Alistar,66,46,20,69.7
Briar,TwistedFate,49,34,15,69.39
Briar,Vex,63,28,35,44.44
Briar,Morgana,120,75,45,62.5
Briar,Kindred,39,29,10,74.36
Briar,Yasuo,224,140,84,62.5
Briar,Draven,83,40,43,48.19
Briar,Taric,41,19,22,46.34
Briar,Irelia,86,41,45,47.67
Briar,Xayah,93,58,35,62.37
Briar,Jax,103,42,61,40.78
Briar,Elise,85,36,49,42.35
Briar,Riven,72,31,41,43.06
Briar,Nautilus,198,98,100,49.49
Briar,Urgot,51,32,19,62.75
Briar,Karthus,33,26,7,78.79
Briar,Akali,108,62,46,57.41
Briar,Swain,138,78,60,56.52
Briar,Gangplank,75,42,33,56
Briar,Zed,157,73,84,46.5
Briar,Zeri,49,25,24,51.02
Briar,Quinn,50,23,27,46
Briar,Ambessa,62,33,29,53.23
Briar,Brand,58,41,17,70.69
Briar,KSante,79,50,29,63.29
Briar,Jhin,243,137,106,56.38
Briar,Orianna,53,25,28,47.17
Briar,Kled,23,15,8,65.22
Briar,Veigar,119,60,59,50.42
Briar,Thresh,198,105,93,53.03
Briar,Yorick,148,66,82,44.59
Briar,Aurora,97,46,51,47.42
Briar,Diana,206,132,74,64.08
Briar,Jinx,316,146,170,46.2
Briar,Sona,16,8,8,50
Briar,Trundle,72,39,33,54.17
Briar,Singed,39,17,22,43.59
Briar,Leblanc,74,44,30,59.46
Briar,Ezreal,337,184,153,54.6
Briar,FiddleSticks,53,33,20,62.26
Briar,Yone,224,121,103,54.02
Briar,Sejuani,92,28,64,30.43
Briar,Azir,47,27,20,57.45
Briar,Milio,68,39,29,57.35
Briar,Poppy,105,51,54,48.57
Briar,Mordekaiser,211,107,104,50.71
Briar,Ahri,202,97,105,48.02
Briar,Chogath,189,100,89,52.91
Briar,DrMundo,59,32,27,54.24
Briar,TahmKench,141,84,57,59.57
Briar,Vayne,144,68,76,47.22
Briar,Vi,121,64,57,52.89
Briar,Caitlyn,323,149,174,46.13
Briar,Gnar,46,32,14,69.57
Briar,RekSai,20,10,10,50
Briar,Ziggs,37,24,13,64.86
Briar,Senna,78,50,28,64.1
Briar,Skarner,40,28,12,70
Briar,Gragas,94,63,31,67.02
Briar,Blitzcrank,107,57,50,53.27
Briar,Ivern,26,12,14,46.15
Briar,Malzahar,105,68,37,64.76
Briar,Nunu,72,42,30,58.33
Briar,Talon,41,16,25,39.02
Briar,MasterYi,131,81,50,61.83
Briar,Shyvana,51,37,14,72.55
Briar,Jayce,55,29,26,52.73
Briar,Khazix,49,34,15,69.39
Briar,Qiyana,22,15,7,68.18
Briar,Neeko,48,35,13,72.92
Briar,Pyke,89,60,29,67.42
Briar,Sett,189,103,86,54.5
Briar,Gwen,49,27,22,55.1
Briar,KogMaw,29,16,13,55.17
Briar,Fiora,38,19,19,50
Briar,Ornn,61,40,21,65.57
Briar,Soraka,68,31,37,45.59
Briar,Heimerdinger,63,28,35,44.44
Briar,Teemo,115,46,69,40
Briar,Seraphine,93,45,48,48.39
Briar,Viktor,118,74,44,62.71
Briar,Renekton,67,37,30,55.22
Briar,Tristana,72,31,41,43.06
Briar,Braum,110,57,53,51.82
Briar,MonkeyKing,67,26,41,38.81
Briar,Zoe,35,15,20,42.86
Briar,AurelionSol,53,31,22,58.49
Briar,Kennen,39,18,21,46.15
Briar,Udyr,58,38,20,65.52
Briar,Samira,115,43,72,37.39
Briar,Akshan,38,22,16,57.89
Briar,Nasus,72,35,37,48.61
Briar,Zyra,99,46,53,46.46
Briar,Yuumi,88,48,40,54.55
Briar,Zilean,26,12,14,46.15
Briar,Anivia,37,24,13,64.86
Briar,Janna,29,18,11,62.07
Briar,Shaco,100,58,42,58
Briar,Sivir,56,18,38,32.14
Briar,Smolder,84,59,25,70.24
Briar,Taliyah,41,24,17,58.54
Briar,Kalista,46,34,12,73.91
Briar,Xerath,89,37,52,41.57
Briar,Nilah,39,34,5,87.18
Briar,Kayle,81,46,35,56.79
Briar,LeeSin,204,129,75,63.24
Briar,Rengar,43,18,25,41.86
Briar,XinZhao,82,40,42,48.78
Briar,Naafiri,32,27,5,84.38
Briar,Lissandra,34,22,12,64.71
Briar,Bard,45,17,28,37.78
Briar,Camille,35,20,15,57.14
Briar,Evelynn,58,29,29,50
Briar,Viego,133,66,67,49.62
Briar,Maokai,65,37,28,56.92
Briar,Aphelios,69,26,43,37.68
Briar,Syndra,74,44,30,59.46
Briar,Olaf,42,19,23,45.24
Briar,Sion,113,52,61,46.02
Briar,Corki,48,37,11,77.08
Briar,Velkoz,68,20,48,29.41
Briar,Rammus,77,39,38,50.65
Briar,Zac,60,30,30,50
Briar,Nidalee,39,23,16,58.97
Briar,Belveth,43,26,17,60.47
Briar,Graves,59,20,39,33.9
Briar,Tryndamere,38,14,24,36.84
Briar,Renata,15,10,5,66.67
Briar,Annie,20,6,14,30
Karthus,Darius,118,62,56,52.54
Karthus,Vi,68,30,38,44.12
Karthus,Malzahar,70,25,45,35.71
Karthus,Aphelios,31,16,15,51.61
Karthus,Soraka,35,15,20,42.86
Karthus,Warwick,58,21,37,36.21
Karthus,Katarina,51,26,25,50.98
Karthus,Taric,13,9,4,69.23
Karthus,Zed,55,29,26,52.73
Karthus,FiddleSticks,42,24,18,57.14
Karthus,Hwei,55,32,23,58.18
Karthus,Teemo,48,29,19,60.42
Karthus,Jhin,113,67,46,59.29
Karthus,Janna,11,8,3,72.73
Karthus,Malphite,57,32,25,56.14
Karthus,Vladimir,37,21,16,56.76
Karthus,Ekko,55,22,33,40
Karthus,Smolder,25,12,13,48
Karthus,KSante,42,23,19,54.76
Karthus,LeeSin,129,67,62,51.94
Karthus,Ahri,61,21,40,34.43
Karthus,Vayne,81,29,52,35.8
Karthus,Seraphine,31,20,11,64.52
Karthus,Trundle,25,13,12,52
Karthus,Briar,33,7,26,21.21
Karthus,Vex,36,15,21,41.67
Karthus,MissFortune,106,54,52,50.94
Karthus,Rell,47,28,19,59.57
Karthus,Nocturne,86,33,53,38.37
Karthus,Azir,26,17,9,65.38
Karthus,Sona,15,6,9,40
Karthus,Amumu,70,31,39,44.29
Karthus,Yone,81,38,43,46.91
Karthus,Kaisa,111,63,48,56.76
Karthus,Renata,11,6,5,54.55
Karthus,Rumble,13,13,0,100
Karthus,Blitzcrank,46,22,24,47.83
Karthus,Xerath,49,16,33,32.65
Karthus,Caitlyn,146,80,66,54.79
Karthus,Thresh,94,47,47,50
Karthus,Anivia,35,14,21,40
Karthus,MasterYi,101,47,54,46.53
Karthus,Karma,94,51,43,54.26
Karthus,Chogath,61,42,19,68.85
Karthus,Shaco,50,26,24,52
Karthus,Nautilus,65,35,30,53.85
Karthus,MonkeyKing,54,19,35,35.19
Karthus,Rammus,18,16,2,88.89
Karthus,Pyke,59,37,22,62.71
Karthus,Lillia,50,36,14,72
Karthus,Lux,103,50,53,48.54
Karthus,Fiora,20,11,9,55
Karthus,Nami,81,27,54,33.33
Karthus,Poppy,60,32,28,53.33
Karthus,Ezreal,165,61,104,36.97
Karthus,Viego,77,37,40,48.05
Karthus,Mel,121,65,56,53.72
Karthus,Alistar,29,22,7,75.86
Karthus,Riven,29,21,8,72.41
Karthus,Sejuani,20,9,11,45
Karthus,Syndra,66,35,31,53.03
Karthus,Camille,39,23,16,58.97
Karthus,Swain,53,19,34,35.85
Karthus,Irelia,34,11,23,32.35
Karthus,Khazix,38,16,22,42.11
Karthus,AurelionSol,25,9,16,36
Karthus,Nilah,29,13,16,44.83
Karthus,Ashe,108,58,50,53.7
Karthus,Sion,64,32,32,50
Karthus,Leblanc,25,14,11,56
Karthus,Jinx,170,62,108,36.47
Karthus,Milio,36,19,17,52.78
Karthus,Urgot,24,11,13,45.83
Karthus,Lulu,82,39,43,47.56
Karthus,Evelynn,19,11,8,57.89
Karthus,Jax,34,22,12,64.71
Karthus,Lucian,55,34,21,61.82
Karthus,Jayce,45,23,22,51.11
Karthus,Sett,81,42,39,51.85
Karthus,Zyra,53,22,31,41.51
Karthus,Xayah,33,9,24,27.27
Karthus,Rakan,48,22,26,45.83
Karthus,Nasus,36,3,33,8.33
Karthus,Kayn,85,46,39,54.12
Karthus,Ambessa,49,27,22,55.1
Karthus,Brand,39,17,22,43.59
Karthus,Yorick,45,21,24,46.67
Karthus,Aurora,44,27,17,61.36
Karthus,Leona,67,31,36,46.27
Karthus,Pantheon,85,44,41,51.76
Karthus,Kayle,24,11,13,45.83
Karthus,Volibear,53,33,20,62.26
Karthus,Akali,64,34,30,53.13
Karthus,Skarner,26,12,14,46.15
Karthus,Shen,48,20,28,41.67
Karthus,Kennen,25,13,12,52
Karthus,Maokai,36,14,22,38.89
Karthus,Udyr,26,8,18,30.77
Karthus,Ryze,36,15,21,41.67
Karthus,Draven,30,25,5,83.33
Karthus,Viktor,51,36,15,70.59
Karthus,Yasuo,83,40,43,48.19
Karthus,Galio,82,34,48,41.46
Karthus,JarvanIV,40,21,19,52.5
Karthus,TwistedFate,11,11,0,100
Karthus,Braum,54,32,22,59.26
Karthus,Gnar,42,17,25,40.48
Karthus,Orianna,25,9,16,36
Karthus,Naafiri,14,12,2,85.71
Karthus,Kindred,27,21,6,77.78
Karthus,Ziggs,18,15,3,83.33
Karthus,Aatrox,72,16,56,22.22
Karthus,Fizz,32,8,24,25
Karthus,Zeri,36,22,14,61.11
Karthus,Hecarim,29,5,24,17.24
Karthus,Renekton,30,14,16,46.67
Karthus,Quinn,25,17,8,68
Karthus,Diana,79,28,51,35.44
Karthus,Mordekaiser,83,42,41,50.6
Karthus,Varus,52,35,17,67.31
Karthus,XinZhao,58,28,30,48.28
Karthus,Lissandra,26,15,11,57.69
Karthus,TahmKench,53,26,27,49.06
Karthus,Graves,38,16,22,42.11
Karthus,Cassiopeia,16,5,11,31.25
Karthus,Twitch,41,20,21,48.78
Karthus,Talon,30,9,21,30
Karthus,Veigar,54,32,22,59.26
Karthus,Gragas,32,16,16,50
Karthus,Tryndamere,22,7,15,31.82
Karthus,Tristana,61,29,32,47.54
Karthus,Samira,46,23,23,50
Karthus,Rengar,30,13,17,43.33
Karthus,Nunu,33,23,10,69.7
Karthus,Akshan,17,14,3,82.35
Karthus,Sylas,102,41,61,40.2
Karthus,Garen,99,57,42,57.58
Karthus,Senna,24,10,14,41.67
Karthus,Neeko,14,11,3,78.57
Karthus,Annie,21,7,14,33.33
Karthus,Qiyana,9,4,5,44.44
Karthus,Yuumi,41,14,27,34.15
Karthus,Elise,38,21,17,55.26
Karthus,Zilean,25,7,18,28
Karthus,Corki,17,7,10,41.18
Karthus,Kled,5,5,0,100
Karthus,Kassadin,11,5,6,45.45
Karthus,Taliyah,23,11,12,47.83
Karthus,Bard,23,12,11,52.17
Karthus,Belveth,7,0,7,0
Karthus,Heimerdinger,11,5,6,45.45
Karthus,RekSai,11,5,6,45.45
Karthus,DrMundo,24,8,16,33.33
Karthus,Singed,6,0,6,0
Karthus,Velkoz,24,15,9,62.5
Karthus,Nidalee,29,17,12,58.62
Karthus,Zoe,32,14,18,43.75
Karthus,Gangplank,28,16,12,57.14
Karthus,Zac,27,12,15,44.44
Karthus,Gwen,25,14,11,56
Karthus,Morgana,44,21,23,47.73
Karthus,KogMaw,10,0,10,0
Karthus,Illaoi,34,18,16,52.94
Karthus,Ivern,10,8,2,80
Karthus,Shyvana,7,2,5,28.57
Karthus,Kalista,11,11,0,100
Karthus,Ornn,24,11,13,45.83
Karthus,Sivir,11,5,6,45.45
Karthus,Olaf,9,6,3,66.67
Aphelios,Riven,48,25,23,52.08
Aphelios,Karthus,31,15,16,48.39
Aphelios,Mel,262,125,137,47.71
Aphelios,Lucian,96,55,41,57.29
Aphelios,Nami,122,50,72,40.98
Aphelios,FiddleSticks,70,25,45,35.71
Aphelios,Hwei,81,50,31,61.73
Aphelios,Teemo,122,58,64,47.54
Aphelios,Jhin,266,113,153,42.48
Aphelios,Janna,44,24,20,54.55
Aphelios,Aatrox,165,90,75,54.55
Aphelios,Sejuani,65,27,38,41.54
Aphelios,Yasuo,284,143,141,50.35
Aphelios,Annie,32,14,18,43.75
Aphelios,Malzahar,143,89,54,62.24
Aphelios,Gragas,116,62,54,53.45
Aphelios,Ezreal,362,197,165,54.42
Aphelios,Lulu,229,119,110,51.97
Aphelios,Volibear,145,84,61,57.93
Aphelios,Jax,100,39,61,39
Aphelios,Ashe,259,114,145,44.02
Aphelios,Pantheon,205,90,115,43.9
Aphelios,Darius,213,110,103,51.64
Aphelios,Nunu,89,56,33,62.92
Aphelios,Thresh,217,93,124,42.86
Aphelios,Varus,124,76,48,61.29
Aphelios,DrMundo,56,28,28,50
Aphelios,MissFortune,205,117,88,57.07
Aphelios,Aurora,115,58,57,50.43
Aphelios,Rakan,70,32,38,45.71
Aphelios,Nocturne,158,75,83,47.47
Aphelios,Caitlyn,335,176,159,52.54
Aphelios,Xerath,91,37,54,40.66
Aphelios,Twitch,107,47,60,43.93
Aphelios,Zac,119,49,70,41.18
Aphelios,Gwen,65,35,30,53.85
Aphelios,Ahri,198,92,106,46.46
Aphelios,Jinx,405,202,203,49.88
Aphelios,Amumu,147,66,81,44.9
Aphelios,Sion,105,58,47,55.24
Aphelios,Zed,127,61,66,48.03
Aphelios,Malphite,143,54,89,37.76
Aphelios,Diana,203,101,102,49.75
Aphelios,Kaisa,233,115,118,49.36
Aphelios,Seraphine,120,43,77,35.83
Aphelios,Shaco,85,52,33,61.18
Aphelios,Yone,215,104,111,48.37
Aphelios,XinZhao,59,31,28,52.54
Aphelios,Lillia,70,36,34,51.43
Aphelios,Katarina,89,51,38,57.3
Aphelios,Yuumi,120,67,53,55.83
Aphelios,Gnar,73,23,50,31.51
Aphelios,Lux,291,172,119,59.11
Aphelios,Kayn,185,88,97,47.57
Aphelios,Warwick,154,62,92,40.26
Aphelios,Veigar,99,49,50,49.49
Aphelios,Samira,96,40,56,41.67
Aphelios,Kled,17,9,8,52.94
Aphelios,Kassadin,28,19,9,67.86
Aphelios,Sett,167,89,78,53.29
Aphelios,Akali,120,50,70,41.67
Aphelios,MonkeyKing,90,32,58,35.56
Aphelios,Vladimir,92,51,41,55.43
Aphelios,Smolder,114,42,72,36.84
Aphelios,Azir,64,41,23,64.06
Aphelios,Ambessa,81,50,31,61.73
Aphelios,Rammus,38,16,22,42.11
Aphelios,Karma,155,88,67,56.77
Aphelios,Maokai,57,20,37,35.09
Aphelios,Swain,124,55,69,44.35
Aphelios,Ekko,94,33,61,35.11
Aphelios,Galio,127,66,61,51.97
Aphelios,Nilah,52,19,33,36.54
Aphelios,Olaf,34,16,18,47.06
Aphelios,Syndra,99,67,32,67.68
Aphelios,Bard,46,23,23,50
Aphelios,Shyvana,41,23,18,56.1
Aphelios,Milio,62,41,21,66.13
Aphelios,Yorick,118,61,57,51.69
Aphelios,Khazix,65,37,28,56.92
Aphelios,Talon,53,31,22,58.49
Aphelios,Gangplank,79,36,43,45.57
Aphelios,Poppy,97,45,52,46.39
Aphelios,Fizz,40,11,29,27.5
Aphelios,Draven,56,23,33,41.07
Aphelios,Camille,67,39,28,58.21
Aphelios,Mordekaiser,125,53,72,42.4
Aphelios,Irelia,120,52,68,43.33
Aphelios,Zilean,51,28,23,54.9
Aphelios,Orianna,68,39,29,57.35
Aphelios,Blitzcrank,138,72,66,52.17
Aphelios,Viego,177,91,86,51.41
Aphelios,Ornn,86,53,33,61.63
Aphelios,Rell,80,46,34,57.5
Aphelios,Evelynn,29,7,22,24.14
Aphelios,Vex,80,42,38,52.5
Aphelios,Tristana,91,53,38,58.24
Aphelios,Neeko,56,30,26,53.57
Aphelios,Rengar,41,22,19,53.66
Aphelios,Senna,66,35,31,53.03
Aphelios,Nasus,44,23,21,52.27
Aphelios,Velkoz,57,32,25,56.14
Aphelios,Brand,53,33,20,62.26
Aphelios,Hecarim,53,19,34,35.85
Aphelios,Kayle,61,18,43,29.51
Aphelios,Pyke,74,36,38,48.65
Aphelios,MasterYi,118,57,61,48.31
Aphelios,Heimerdinger,51,11,40,21.57
Aphelios,Trundle,53,32,21,60.38
Aphelios,Graves,87,37,50,42.53
Aphelios,Zeri,72,42,30,58.33
Aphelios,KSante,84,50,34,59.52
Aphelios,Lissandra,68,26,42,38.24
Aphelios,Viktor,106,42,64,39.62
Aphelios,Braum,98,42,56,42.86
Aphelios,Shen,107,50,57,46.73
Aphelios,Fiora,43,16,27,37.21
Aphelios,Morgana,99,34,65,34.34
Aphelios,Vayne,138,45,93,32.61
Aphelios,Zyra,80,46,34,57.5
Aphelios,Sivir,86,48,38,55.81
Aphelios,Singed,24,17,7,70.83
Aphelios,Leblanc,62,32,30,51.61
Aphelios,Sona,20,11,9,55
Aphelios,TahmKench,101,40,61,39.6
Aphelios,Sylas,201,108,93,53.73
Aphelios,Skarner,56,26,30,46.43
Aphelios,Zoe,50,21,29,42
Aphelios,Taliyah,28,8,20,28.57
Aphelios,Briar,69,43,26,62.32
Aphelios,Akshan,47,22,25,46.81
Aphelios,Garen,211,127,84,60.19
Aphelios,Quinn,46,15,31,32.61
Aphelios,Soraka,72,24,48,33.33
Aphelios,Elise,94,55,39,58.51
Aphelios,Xayah,55,28,27,50.91
Aphelios,Chogath,166,66,100,39.76
Aphelios,Corki,62,34,28,54.84
Aphelios,Leona,137,88,49,64.23
Aphelios,Vi,143,68,75,47.55
Aphelios,AurelionSol,55,21,34,38.18
Aphelios,Nautilus,142,83,59,58.45
Aphelios,Kennen,65,32,33,49.23
Aphelios,Naafiri,41,16,25,39.02
Aphelios,Qiyana,23,20,3,86.96
Aphelios,Ryze,61,28,33,45.9
Aphelios,LeeSin,213,138,75,64.79
Aphelios,Ziggs,49,29,20,59.18
Aphelios,Urgot,60,30,30,50
Aphelios,Illaoi,53,22,31,41.51
Aphelios,Jayce,53,32,21,60.38
Aphelios,Alistar,86,41,45,47.67
Aphelios,Cassiopeia,26,14,12,53.85
Aphelios,JarvanIV,115,45,70,39.13
Aphelios,Belveth,31,19,12,61.29
Aphelios,Kindred,44,21,23,47.73
Aphelios,Udyr,43,18,25,41.86
Aphelios,Anivia,40,21,19,52.5
Aphelios,Tryndamere,36,9,27,25
Aphelios,Rumble,20,3,17,15
Aphelios,Ivern,24,11,13,45.83
Aphelios,Renata,32,12,20,37.5
Aphelios,Kalista,32,24,8,75
Aphelios,Renekton,69,38,31,55.07
Aphelios,KogMaw,31,11,20,35.48
Aphelios,Nidalee,26,13,13,50
Aphelios,RekSai,34,23,11,67.65
Aphelios,Taric,19,14,5,73.68
Aphelios,TwistedFate,38,20,18,52.63
Naafiri,Akali,57,31,26,54.39
Naafiri,Amumu,99,46,53,46.46
Naafiri,Riven,29,11,18,37.93
Naafiri,Caitlyn,141,71,70,50.35
Naafiri,Lux,139,77,62,55.4
Naafiri,Yorick,58,29,29,50
Naafiri,Kayn,86,48,38,55.81
Naafiri,Sylas,93,57,36,61.29
Naafiri,MissFortune,168,93,75,55.36
Naafiri,Renata,24,8,16,33.33
Naafiri,Malphite,70,26,44,37.14
Naafiri,Vladimir,39,14,25,35.9
Naafiri,Ekko,77,30,47,38.96
Naafiri,Smolder,86,46,40,53.49
Naafiri,Soraka,41,29,12,70.73
Naafiri,Renekton,36,24,12,66.67
Naafiri,Elise,32,14,18,43.75
Naafiri,Jinx,202,92,110,45.54
Naafiri,Thresh,130,88,42,67.69
Naafiri,Gwen,37,19,18,51.35
Naafiri,Rammus,24,11,13,45.83
Naafiri,Zed,80,30,50,37.5
Naafiri,Tristana,68,38,30,55.88
Naafiri,Mel,127,66,61,51.97
Naafiri,Gnar,34,20,14,58.82
Naafiri,Lillia,39,17,22,43.59
Naafiri,Yone,150,76,74,50.67
Naafiri,Draven,36,18,18,50
Naafiri,AurelionSol,41,15,26,36.59
Naafiri,Swain,55,17,38,30.91
Naafiri,Leona,67,26,41,38.81
Naafiri,Garen,124,63,61,50.81
Naafiri,Gragas,47,23,24,48.94
Naafiri,Tryndamere,27,9,18,33.33
Naafiri,Leblanc,28,11,17,39.29
Naafiri,Varus,61,37,24,60.66
Naafiri,Urgot,40,19,21,47.5
Naafiri,LeeSin,125,65,60,52
Naafiri,Diana,106,56,50,52.83
Naafiri,Janna,29,14,15,48.28
Naafiri,Jax,62,34,28,54.84
Naafiri,Volibear,76,44,32,57.89
Naafiri,Kaisa,104,52,52,50
Naafiri,Yuumi,43,28,15,65.12
Naafiri,Mordekaiser,103,53,50,51.46
Naafiri,Sett,87,40,47,45.98
Naafiri,Milio,46,22,24,47.83
Naafiri,RekSai,11,5,6,45.45
Naafiri,Ziggs,21,8,13,38.1
Naafiri,Senna,46,27,19,58.7
Naafiri,Ashe,126,67,59,53.17
Naafiri,Darius,97,42,55,43.3
Naafiri,Malzahar,83,47,36,56.63
Naafiri,Aurora,63,28,35,44.44
Naafiri,Camille,28,21,7,75
Naafiri,Rengar,36,25,11,69.44
Naafiri,Jhin,92,34,58,36.96
Naafiri,Samira,63,25,38,39.68
Naafiri,Akshan,18,15,3,83.33
Naafiri,Nunu,57,43,14,75.44
Naafiri,Gangplank,31,16,15,51.61
Naafiri,Poppy,42,21,21,50
Naafiri,Fizz,32,10,22,31.25
Naafiri,Seraphine,46,12,34,26.09
Naafiri,Veigar,78,32,46,41.03
Naafiri,JarvanIV,66,45,21,68.18
Naafiri,Nami,76,43,33,56.58
Naafiri,Zeri,42,26,16,61.9
Naafiri,Rakan,43,11,32,25.58
Naafiri,Teemo,80,41,39,51.25
Naafiri,Lulu,95,63,32,66.32
Naafiri,MasterYi,77,31,46,40.26
Naafiri,Zoe,34,10,24,29.41
Naafiri,Lucian,43,15,28,34.88
Naafiri,Kindred,16,8,8,50
Naafiri,Syndra,54,23,31,42.59
Naafiri,Zyra,64,31,33,48.44
Naafiri,Khazix,30,4,26,13.33
Naafiri,Irelia,38,14,24,36.84
Naafiri,Brand,35,20,15,57.14
Naafiri,Lissandra,27,12,15,44.44
Naafiri,Twitch,65,36,29,55.38
Naafiri,Pyke,52,27,25,51.92
Naafiri,Kayle,35,25,10,71.43
Naafiri,TahmKench,60,29,31,48.33
Naafiri,XinZhao,50,22,28,44
Naafiri,Hwei,48,18,30,37.5
Naafiri,Nocturne,69,20,49,28.99
Naafiri,Galio,75,44,31,58.67
Naafiri,Ezreal,147,72,75,48.98
Naafiri,Pantheon,92,52,40,56.52
Naafiri,FiddleSticks,34,11,23,32.35
Naafiri,Vayne,79,43,36,54.43
Naafiri,Ambessa,73,31,42,42.47
Naafiri,MonkeyKing,37,20,17,54.05
Naafiri,Shyvana,11,2,9,18.18
Naafiri,Yasuo,129,74,55,57.36
Naafiri,Blitzcrank,60,17,43,28.33
Naafiri,Hecarim,27,16,11,59.26
Naafiri,Ahri,85,42,43,49.41
Naafiri,Aatrox,94,63,31,67.02
Naafiri,Sejuani,39,20,19,51.28
Naafiri,Karma,61,23,38,37.7
Naafiri,Xayah,22,9,13,40.91
Naafiri,Karthus,14,2,12,14.29
Naafiri,Chogath,89,50,39,56.18
Naafiri,Briar,32,5,27,15.63
Naafiri,Morgana,65,26,39,40
Naafiri,Shen,78,35,43,44.87
Naafiri,TwistedFate,17,14,3,82.35
Naafiri,Trundle,32,21,11,65.63
Naafiri,Anivia,26,15,11,57.69
Naafiri,Velkoz,38,27,11,71.05
Naafiri,Sion,51,21,30,41.18
Naafiri,Vex,64,33,31,51.56
Naafiri,KogMaw,6,0,6,0
Naafiri,Jayce,25,12,13,48
Naafiri,Alistar,44,11,33,25
Naafiri,Warwick,54,26,28,48.15
Naafiri,Corki,21,8,13,38.1
Naafiri,Vi,83,43,40,51.81
Naafiri,Viktor,48,23,25,47.92
Naafiri,Quinn,18,16,2,88.89
Naafiri,Olaf,12,5,7,41.67
Naafiri,Cassiopeia,21,13,8,61.9
Naafiri,Viego,73,42,31,57.53
Naafiri,Aphelios,41,25,16,60.98
Naafiri,Fiora,31,8,23,25.81
Naafiri,DrMundo,18,10,8,55.56
Naafiri,Heimerdinger,30,14,16,46.67
Naafiri,Graves,34,17,17,50
Naafiri,Xerath,69,36,33,52.17
Naafiri,Sivir,21,13,8,61.9
Naafiri,Nautilus,69,33,36,47.83
Naafiri,Kled,8,5,3,62.5
Naafiri,Orianna,43,20,23,46.51
Naafiri,Maokai,46,35,11,76.09
Naafiri,Annie,18,13,5,72.22
Naafiri,Illaoi,24,9,15,37.5
Naafiri,Azir,35,16,19,45.71
Naafiri,Udyr,23,14,9,60.87
Naafiri,KSante,42,17,25,40.48
Naafiri,Katarina,32,18,14,56.25
Naafiri,Nasus,31,11,20,35.48
Naafiri,Belveth,4,4,0,100
Naafiri,Ornn,20,10,10,50
Naafiri,Skarner,25,22,3,88
Naafiri,Talon,44,23,21,52.27
Naafiri,Kalista,10,3,7,30
Naafiri,Braum,38,22,16,57.89
Naafiri,Neeko,40,15,25,37.5
Naafiri,Kennen,15,10,5,66.67
Naafiri,Qiyana,10,5,5,50
Naafiri,Taric,14,11,3,78.57
Naafiri,Bard,19,16,3,84.21
Naafiri,Singed,10,5,5,50
Naafiri,Nilah,24,13,11,54.17
Naafiri,Ivern,13,0,13,0
Naafiri,Zac,33,19,14,57.58
Naafiri,Evelynn,13,9,4,69.23
Naafiri,Shaco,37,19,18,51.35
Naafiri,Zilean,18,4,14,22.22
Naafiri,Rell,39,22,17,56.41
Naafiri,Ryze,15,8,7,53.33
Naafiri,Rumble,20,12,8,60
Naafiri,Kassadin,2,0,2,0
Naafiri,Nidalee,23,12,11,52.17
Naafiri,Taliyah,14,11,3,78.57
Naafiri,Sona,2,0,2,0
Singed,Shen,61,27,34,44.26
Singed,MasterYi,82,38,44,46.34
Singed,Katarina,36,27,9,75
Singed,Jhin,106,55,51,51.89
Singed,Karma,88,36,52,40.91
Singed,Jax,45,30,15,66.67
Singed,Graves,54,36,18,66.67
Singed,Kassadin,25,14,11,56
Singed,Tristana,68,36,32,52.94
Singed,Nami,77,36,41,46.75
Singed,Kayle,41,30,11,73.17
Singed,Evelynn,22,10,12,45.45
Singed,Irelia,42,19,23,45.24
Singed,Corki,24,21,3,87.5
Singed,Syndra,35,16,19,45.71
Singed,Yasuo,139,63,76,45.32
Singed,Kayn,80,43,37,53.75
Singed,Caitlyn,152,89,63,58.55
Singed,Rell,56,30,26,53.57
Singed,Gnar,31,15,16,48.39
Singed,Kindred,24,5,19,20.83
Singed,Jinx,172,77,95,44.77
Singed,Braum,41,12,29,29.27
Singed,Thresh,109,48,61,44.04
Singed,Lillia,56,35,21,62.5
Singed,Yone,102,38,64,37.25
Singed,MissFortune,120,69,51,57.5
Singed,Sett,51,27,24,52.94
Singed,Nunu,29,14,15,48.28
Singed,Lux,123,64,59,52.03
Singed,Milio,44,22,22,50
Singed,Warwick,80,37,43,46.25
Singed,Rammus,20,15,5,75
Singed,Mel,128,75,53,58.59
Singed,Pantheon,90,40,50,44.44
Singed,DrMundo,45,17,28,37.78
Singed,Briar,39,22,17,56.41
Singed,Galio,69,29,40,42.03
Singed,Lucian,54,26,28,48.15
Singed,Volibear,62,27,35,43.55
Singed,Veigar,81,38,43,46.91
Singed,Morgana,60,30,30,50
Singed,Vladimir,23,11,12,47.83
Singed,Belveth,8,5,3,62.5
Singed,Samira,43,13,30,30.23
Singed,Alistar,47,25,22,53.19
Singed,Illaoi,30,21,9,70
Singed,Shaco,36,23,13,63.89
Singed,Aatrox,104,66,38,63.46
Singed,XinZhao,54,29,25,53.7
Singed,Xayah,41,29,12,70.73
Singed,Darius,80,53,27,66.25
Singed,Nocturne,87,48,39,55.17
Singed,Varus,35,22,13,62.86
Singed,Zyra,57,34,23,59.65
Singed,Tryndamere,25,14,11,56
Singed,Hecarim,17,12,5,70.59
Singed,Leblanc,30,21,9,70
Singed,Ashe,115,77,38,66.96
Singed,Poppy,44,24,20,54.55
Singed,FiddleSticks,31,24,7,77.42
Singed,Sivir,47,30,17,63.83
Singed,Vayne,48,26,22,54.17
Singed,LeeSin,92,43,49,46.74
Singed,Fizz,31,13,18,41.94
Singed,Kaisa,101,57,44,56.44
Singed,Aurora,40,29,11,72.5
Singed,Nidalee,12,6,6,50
Singed,Gangplank,32,20,12,62.5
Singed,Akali,52,38,14,73.08
Singed,Yorick,70,40,30,57.14
Singed,Hwei,45,19,26,42.22
Singed,Heimerdinger,25,15,10,60
Singed,Malzahar,54,33,21,61.11
Singed,Maokai,23,13,10,56.52
Singed,Taliyah,24,12,12,50
Singed,Annie,13,10,3,76.92
Singed,Mordekaiser,62,44,18,70.97
Singed,Amumu,74,38,36,51.35
Singed,Zoe,24,15,9,62.5
Singed,Twitch,55,44,11,80
Singed,Smolder,54,29,25,53.7
Singed,Lulu,102,51,51,50
Singed,Ahri,72,37,35,51.39
Singed,Seraphine,45,28,17,62.22
Singed,Riven,26,15,11,57.69
Singed,Skarner,33,27,6,81.82
Singed,TwistedFate,15,13,2,86.67
Singed,Cassiopeia,23,12,11,52.17
Singed,Gragas,44,35,9,79.55
Singed,Vex,27,12,15,44.44
Singed,Sion,64,32,32,50
Singed,Ezreal,128,57,71,44.53
Singed,Zilean,11,9,2,81.82
Singed,Khazix,30,19,11,63.33
Singed,Aphelios,24,7,17,29.17
Singed,TahmKench,41,21,20,51.22
Singed,Ekko,60,29,31,48.33
Singed,Rakan,15,8,7,53.33
Singed,Zed,53,32,21,60.38
Singed,Janna,30,21,9,70
Singed,Viego,67,42,25,62.69
Singed,Sylas,78,31,47,39.74
Singed,Ryze,31,16,15,51.61
Singed,KSante,29,15,14,51.72
Singed,Swain,64,33,31,51.56
Singed,Malphite,76,50,26,65.79
Singed,Zac,44,30,14,68.18
Singed,Teemo,52,34,18,65.38
Singed,Garen,96,39,57,40.63
Singed,Udyr,31,17,14,54.84
Singed,Soraka,33,13,20,39.39
Singed,Zeri,30,15,15,50
Singed,Yuumi,64,45,19,70.31
Singed,Camille,24,5,19,20.83
Singed,Xerath,44,22,22,50
Singed,Quinn,18,8,10,44.44
Singed,Lissandra,33,13,20,39.39
Singed,Diana,64,39,25,60.94
Singed,Viktor,62,30,32,48.39
Singed,Nautilus,82,38,44,46.34
Singed,Nilah,21,17,4,80.95
Singed,Leona,46,30,16,65.22
Singed,AurelionSol,26,8,18,30.77
Singed,Kennen,12,6,6,50
Singed,Blitzcrank,41,33,8,80.49
Singed,Gwen,30,18,12,60
Singed,Velkoz,45,28,17,62.22
Singed,Fiora,19,14,5,73.68
Singed,Ambessa,42,25,17,59.52
Singed,Brand,32,21,11,65.63
Singed,Neeko,27,19,8,70.37
Singed,Shyvana,21,3,18,14.29
Singed,MonkeyKing,42,22,20,52.38
Singed,Ziggs,22,15,7,68.18
Singed,Nasus,63,37,26,58.73
Singed,Kled,8,2,6,25
Singed,Sona,10,5,5,50
Singed,Sejuani,36,22,14,61.11
Singed,Rengar,32,7,25,21.88
Singed,Ornn,40,25,15,62.5
Singed,Senna,29,14,15,48.28
Singed,Orianna,35,25,10,71.43
Singed,Azir,28,23,5,82.14
Singed,Chogath,60,35,25,58.33
Singed,Elise,44,28,16,63.64
Singed,JarvanIV,39,28,11,71.79
Singed,Kalista,21,10,11,47.62
Singed,Naafiri,10,5,5,50
Singed,Urgot,27,10,17,37.04
Singed,Karthus,6,6,0,100
Singed,Vi,45,22,23,48.89
Singed,Renekton,14,3,11,21.43
Singed,Renata,8,0,8,0
Singed,Pyke,25,18,7,72
Singed,Rumble,20,9,11,45
Singed,Trundle,28,11,17,39.29
Singed,Olaf,32,17,15,53.13
Singed,Anivia,34,13,21,38.24
Singed,Talon,20,15,5,75
Singed,Draven,16,4,12,25
Singed,Akshan,16,7,9,43.75
Singed,Jayce,28,14,14,50
Singed,Bard,17,9,8,52.94
Singed,Taric,3,0,3,0
Singed,KogMaw,12,3,9,25
Singed,Qiyana,6,3,3,50
Singed,Ivern,6,3,3,50
Singed,RekSai,3,0,3,0
Akshan,Gragas,38,10,28,26.32
Akshan,Viego,52,19,33,36.54
Akshan,Xayah,45,22,23,48.89
Akshan,Lucian,62,31,31,50
Akshan,Rell,42,26,16,61.9
Akshan,Teemo,74,39,35,52.7
Akshan,Renekton,38,15,23,39.47
Akshan,Kassadin,24,8,16,33.33
Akshan,Jinx,166,71,95,42.77
Akshan,Soraka,32,14,18,43.75
Akshan,Leona,71,35,36,49.3
Akshan,Rammus,26,9,17,34.62
Akshan,Lux,154,64,90,41.56
Akshan,Twitch,55,30,25,54.55
Akshan,Aatrox,59,23,36,38.98
Akshan,TwistedFate,18,5,13,27.78
Akshan,JarvanIV,70,42,28,60
Akshan,Vex,46,29,17,63.04
Akshan,MissFortune,129,72,57,55.81
Akshan,Morgana,88,44,44,50
Akshan,Malzahar,84,38,46,45.24
Akshan,Elise,55,39,16,70.91
Akshan,Zyra,47,27,20,57.45
Akshan,Varus,54,28,26,51.85
Akshan,Riven,30,11,19,36.67
Akshan,Nocturne,81,43,38,53.09
Akshan,Ahri,90,38,52,42.22
Akshan,Kaisa,105,60,45,57.14
Akshan,Vladimir,53,31,22,58.49
Akshan,Belveth,19,8,11,42.11
Akshan,Veigar,60,28,32,46.67
Akshan,Samira,41,17,24,41.46
Akshan,Alistar,30,18,12,60
Akshan,Ambessa,56,29,27,51.79
Akshan,Darius,134,47,87,35.07
Akshan,Katarina,50,25,25,50
Akshan,Vayne,96,29,67,30.21
Akshan,Yuumi,60,27,33,45
Akshan,Illaoi,26,20,6,76.92
Akshan,FiddleSticks,31,23,8,74.19
Akshan,Aurora,73,39,34,53.42
Akshan,Pyke,49,24,25,48.98
Akshan,Kayn,106,44,62,41.51
Akshan,Nilah,32,17,15,53.13
Akshan,Nasus,56,33,23,58.93
Akshan,Trundle,38,21,17,55.26
Akshan,Hecarim,30,14,16,46.67
Akshan,Akali,60,28,32,46.67
Akshan,Zed,79,31,48,39.24
Akshan,Mordekaiser,96,55,41,57.29
Akshan,Ezreal,170,95,75,55.88
Akshan,Jax,68,26,42,38.24
Akshan,Naafiri,18,3,15,16.67
Akshan,Mel,178,94,84,52.81
Akshan,Gwen,23,11,12,47.83
Akshan,Tristana,63,26,37,41.27
Akshan,Warwick,141,75,66,53.19
Akshan,Xerath,59,28,31,47.46
Akshan,Heimerdinger,28,23,5,82.14
Akshan,Volibear,44,23,21,52.27
Akshan,Lissandra,26,14,12,53.85
Akshan,Caitlyn,207,122,85,58.94
Akshan,XinZhao,52,22,30,42.31
Akshan,Sylas,67,45,22,67.16
Akshan,Amumu,93,42,51,45.16
Akshan,Seraphine,42,26,16,61.9
Akshan,KSante,36,17,19,47.22
Akshan,Ekko,50,26,24,52
Akshan,Viktor,69,30,39,43.48
Akshan,Bard,29,14,15,48.28
Akshan,Nunu,57,25,32,43.86
Akshan,Yasuo,129,46,83,35.66
Akshan,Corki,41,21,20,51.22
Akshan,Gangplank,38,10,28,26.32
Akshan,Draven,30,13,17,43.33
Akshan,Zac,33,13,20,39.39
Akshan,Yone,110,41,69,37.27
Akshan,Graves,49,14,35,28.57
Akshan,Ashe,112,49,63,43.75
Akshan,Briar,38,16,22,42.11
Akshan,Shaco,38,23,15,60.53
Akshan,DrMundo,36,16,20,44.44
Akshan,Sejuani,29,13,16,44.83
Akshan,Swain,79,29,50,36.71
Akshan,Poppy,40,23,17,57.5
Akshan,Senna,56,26,30,46.43
Akshan,Sett,91,54,37,59.34
Akshan,Nautilus,98,28,70,28.57
Akshan,Fiora,32,22,10,68.75
Akshan,Lillia,32,20,12,62.5
Akshan,Shen,59,28,31,47.46
Akshan,Evelynn,16,11,5,68.75
Akshan,Lulu,98,51,47,52.04
Akshan,Urgot,49,27,22,55.1
Akshan,Leblanc,34,24,10,70.59
Akshan,Nami,105,59,46,56.19
Akshan,MasterYi,54,25,29,46.3
Akshan,Ryze,27,19,8,70.37
Akshan,Pantheon,109,55,54,50.46
Akshan,Yorick,51,15,36,29.41
Akshan,Jhin,123,60,63,48.78
Akshan,TahmKench,78,35,43,44.87
Akshan,Sion,54,32,22,59.26
Akshan,Hwei,52,28,24,53.85
Akshan,Aphelios,47,25,22,53.19
Akshan,Syndra,51,26,25,50.98
Akshan,Chogath,112,49,63,43.75
Akshan,Khazix,28,15,13,53.57
Akshan,Skarner,44,27,17,61.36
Akshan,Thresh,116,53,63,45.69
Akshan,Malphite,100,50,50,50
Akshan,MonkeyKing,54,26,28,48.15
Akshan,Diana,92,43,49,46.74
Akshan,LeeSin,80,35,45,43.75
Akshan,Irelia,30,23,7,76.67
Akshan,Braum,36,19,17,52.78
Akshan,Shyvana,29,11,18,37.93
Akshan,Gnar,27,16,11,59.26
Akshan,Smolder,49,25,24,51.02
Akshan,Azir,33,14,19,42.42
Akshan,Milio,46,18,28,39.13
Akshan,Neeko,22,14,8,63.64
Akshan,Rakan,27,12,15,44.44
Akshan,Orianna,40,7,33,17.5
Akshan,KogMaw,13,5,8,38.46
Akshan,Nidalee,34,15,19,44.12
Akshan,Quinn,35,14,21,40
Akshan,Fizz,32,18,14,56.25
Akshan,Karthus,17,3,14,17.65
Akshan,Camille,34,8,26,23.53
Akshan,Olaf,11,8,3,72.73
Akshan,Velkoz,29,22,7,75.86
Akshan,Brand,25,2,23,8
Akshan,Karma,83,48,35,57.83
Akshan,Ivern,24,15,9,62.5
Akshan,Garen,66,31,35,46.97
Akshan,Zeri,17,8,9,47.06
Akshan,Rengar,15,5,10,33.33
Akshan,Tryndamere,25,17,8,68
Akshan,Vi,78,48,30,61.54
Akshan,Annie,15,3,12,20
Akshan,Rumble,23,8,15,34.78
Akshan,Kalista,21,8,13,38.1
Akshan,Kayle,29,13,16,44.83
Akshan,Galio,48,18,30,37.5
Akshan,Zilean,25,12,13,48
Akshan,Zoe,36,21,15,58.33
Akshan,Blitzcrank,47,26,21,55.32
Akshan,Maokai,32,17,15,53.13
Akshan,AurelionSol,31,13,18,41.94
Akshan,Janna,26,14,12,53.85
Akshan,Kennen,17,5,12,29.41
Akshan,Ornn,45,27,18,60
Akshan,RekSai,9,3,6,33.33
Akshan,Sivir,27,10,17,37.04
Akshan,Taliyah,20,13,7,65
Akshan,Udyr,34,22,12,64.71
Akshan,Renata,23,11,12,47.83
Akshan,Talon,32,27,5,84.38
Akshan,Kindred,17,10,7,58.82
Akshan,Anivia,13,2,11,15.38
Akshan,Ziggs,15,5,10,33.33
Akshan,Kled,11,6,5,54.55
Akshan,Jayce,23,10,13,43.48
Akshan,Taric,11,3,8,27.27
Akshan,Singed,16,9,7,56.25
Akshan,Qiyana,13,7,6,53.85
Akshan,Sona,6,6,0,100
Akshan,Cassiopeia,9,3,6,33.33
Alistar,Jax,92,38,54,41.3
Alistar,Pantheon,218,106,112,48.62
Alistar,TwistedFate,62,41,21,66.13
Alistar,Sivir,105,41,64,39.05
Alistar,Milio,66,37,29,56.06
Alistar,Ambessa,73,25,48,34.25
Alistar,Graves,63,31,32,49.21
Alistar,Ahri,173,88,85,50.87
Alistar,AurelionSol,36,18,18,50
Alistar,Rakan,63,27,36,42.86
Alistar,Tryndamere,31,21,10,67.74
Alistar,MasterYi,100,58,42,58
Alistar,Akali,108,59,49,54.63
Alistar,KogMaw,58,39,19,67.24
Alistar,Swain,138,66,72,47.83
Alistar,Mordekaiser,185,86,99,46.49
Alistar,Kayn,147,66,81,44.9
Alistar,Kayle,70,29,41,41.43
Alistar,Caitlyn,301,153,148,50.83
Alistar,Shen,89,36,53,40.45
Alistar,Varus,129,67,62,51.94
Alistar,Vex,76,39,37,51.32
Alistar,Jhin,195,104,91,53.33
Alistar,Lux,226,107,119,47.35
Alistar,Brand,44,13,31,29.55
Alistar,Nami,101,53,48,52.48
Alistar,Yorick,85,34,51,40
Alistar,Briar,66,20,46,30.3
Alistar,Sylas,308,141,167,45.78
Alistar,Veigar,116,74,42,63.79
Alistar,Ziggs,36,18,18,50
Alistar,Renekton,66,39,27,59.09
Alistar,Shaco,123,81,42,65.85
Alistar,Thresh,307,147,160,47.88
Alistar,Vladimir,84,32,52,38.1
Alistar,Volibear,115,51,64,44.35
Alistar,Malzahar,117,50,67,42.74
Alistar,Jayce,84,35,49,41.67
Alistar,Sion,89,37,52,41.57
Alistar,Darius,241,108,133,44.81
Alistar,Leona,150,75,75,50
Alistar,Taliyah,45,26,19,57.78
Alistar,Vi,157,93,64,59.24
Alistar,Seraphine,52,28,24,53.85
Alistar,Chogath,166,62,104,37.35
Alistar,Khazix,95,53,42,55.79
Alistar,Hwei,93,33,60,35.48
Alistar,Jinx,330,146,184,44.24
Alistar,Warwick,136,59,77,43.38
Alistar,Kaisa,232,131,101,56.47
Alistar,Pyke,97,47,50,48.45
Alistar,TahmKench,107,61,46,57.01
Alistar,Zac,86,34,52,39.53
Alistar,Yasuo,273,132,141,48.35
Alistar,Lucian,119,75,44,63.03
Alistar,Kindred,62,37,25,59.68
Alistar,Gangplank,82,45,37,54.88
Alistar,Zeri,77,31,46,40.26
Alistar,Yuumi,105,61,44,58.1
Alistar,Malphite,167,84,83,50.3
Alistar,Zyra,72,39,33,54.17
Alistar,Ezreal,279,150,129,53.76
Alistar,Blitzcrank,174,103,71,59.2
Alistar,Singed,47,22,25,46.81
Alistar,Akshan,30,12,18,40
Alistar,Ashe,254,124,130,48.82
Alistar,Velkoz,57,29,28,50.88
Alistar,Sett,190,99,91,52.11
Alistar,Diana,206,103,103,50
Alistar,Yone,261,136,125,52.11
Alistar,Tristana,121,39,82,32.23
Alistar,Nautilus,223,118,105,52.91
Alistar,KSante,110,61,49,55.45
Alistar,Evelynn,53,13,40,24.53
Alistar,Annie,29,15,14,51.72
Alistar,Kled,25,14,11,56
Alistar,Kassadin,11,6,5,54.55
Alistar,Mel,291,138,153,47.42
Alistar,Lillia,64,29,35,45.31
Alistar,Viktor,144,77,67,53.47
Alistar,LeeSin,268,141,127,52.61
Alistar,Fizz,54,27,27,50
Alistar,Morgana,123,48,75,39.02
Alistar,Nasus,76,34,42,44.74
Alistar,Talon,47,26,21,55.32
Alistar,XinZhao,99,57,42,57.58
Alistar,Elise,93,53,40,56.99
Alistar,Skarner,67,35,32,52.24
Alistar,Garen,213,98,115,46.01
Alistar,Ekko,93,44,49,47.31
Alistar,Gragas,99,43,56,43.43
Alistar,Karthus,29,7,22,24.14
Alistar,Galio,128,48,80,37.5
Alistar,Corki,61,43,18,70.49
Alistar,Braum,96,50,46,52.08
Alistar,Aatrox,146,74,72,50.68
Alistar,Karma,138,71,67,51.45
Alistar,Soraka,27,8,19,29.63
Alistar,Riven,37,20,17,54.05
Alistar,Sejuani,72,44,28,61.11
Alistar,Syndra,105,48,57,45.71
Alistar,Kennen,49,29,20,59.18
Alistar,Vayne,189,94,95,49.74
Alistar,MissFortune,224,107,117,47.77
Alistar,Nilah,42,23,19,54.76
Alistar,Sona,19,11,8,57.89
Alistar,Gnar,67,45,22,67.16
Alistar,Nocturne,169,86,83,50.89
Alistar,DrMundo,57,36,21,63.16
Alistar,Amumu,134,55,79,41.04
Alistar,Taric,28,13,15,46.43
Alistar,Rammus,51,30,21,58.82
Alistar,Ornn,54,18,36,33.33
Alistar,Cassiopeia,38,8,30,21.05
Alistar,Urgot,84,36,48,42.86
Alistar,Leblanc,86,37,49,43.02
Alistar,Samira,84,53,31,63.1
Alistar,JarvanIV,82,39,43,47.56
Alistar,Irelia,91,50,41,54.95
Alistar,Viego,179,105,74,58.66
Alistar,Illaoi,51,23,28,45.1
Alistar,Lulu,160,81,79,50.63
Alistar,Lissandra,50,22,28,44
Alistar,Xayah,72,35,37,48.61
Alistar,Azir,67,45,22,67.16
Alistar,Hecarim,59,31,28,52.54
Alistar,Draven,76,28,48,36.84
Alistar,Rell,116,66,50,56.9
Alistar,Zoe,50,23,27,46
Alistar,Maokai,71,32,39,45.07
Alistar,Rengar,32,18,14,56.25
Alistar,Renata,40,24,16,60
Alistar,Xerath,100,28,72,28
Alistar,Ryze,53,21,32,39.62
Alistar,FiddleSticks,64,31,33,48.44
Alistar,Zed,136,96,40,70.59
Alistar,Shyvana,45,14,31,31.11
Alistar,Poppy,127,51,76,40.16
Alistar,Orianna,74,39,35,52.7
Alistar,MonkeyKing,94,45,49,47.87
Alistar,Aurora,87,35,52,40.23
Alistar,Teemo,139,71,68,51.08
Alistar,Katarina,74,42,32,56.76
Alistar,Nunu,63,32,31,50.79
Alistar,Naafiri,44,33,11,75
Alistar,Bard,31,12,19,38.71
Alistar,Gwen,60,21,39,35
Alistar,Twitch,75,47,28,62.67
Alistar,Senna,68,34,34,50
Alistar,Trundle,62,34,28,54.84
Alistar,Zilean,46,16,30,34.78
Alistar,Qiyana,17,9,8,52.94
Alistar,Olaf,33,12,21,36.36
Alistar,Rumble,48,36,12,75
Alistar,Udyr,51,25,26,49.02
Alistar,Aphelios,86,45,41,52.33
Alistar,Ivern,19,19,0,100
Alistar,Quinn,51,28,23,54.9
Alistar,Anivia,69,30,39,43.48
Alistar,Smolder,102,32,70,31.37
Alistar,Fiora,52,23,29,44.23
Alistar,Janna,44,27,17,61.36
Alistar,Belveth,28,15,13,53.57
Alistar,Nidalee,33,17,16,51.52
Alistar,Heimerdinger,46,28,18,60.87
Alistar,Camille,56,25,31,44.64
Alistar,RekSai,8,5,3,62.5
Alistar,Neeko,51,38,13,74.51
Alistar,Kalista,34,22,12,64.71
Khazix,Malphite,177,67,110,37.85
Khazix,Vi,135,55,80,40.74
Khazix,Azir,38,26,12,68.42
Khazix,MissFortune,222,106,116,47.75
Khazix,Lulu,187,79,108,42.25
Khazix,Rengar,72,39,33,54.17
Khazix,Warwick,154,76,78,49.35
Khazix,Irelia,88,46,42,52.27
Khazix,Ashe,226,111,115,49.12
Khazix,Nautilus,169,72,97,42.6
Khazix,Trundle,55,21,34,38.18
Khazix,Mel,229,116,113,50.66
Khazix,Jinx,304,144,160,47.37
Khazix,Morgana,123,50,73,40.65
Khazix,Yorick,91,59,32,64.84
Khazix,Ahri,169,68,101,40.24
Khazix,Ezreal,310,149,161,48.06
Khazix,Lux,358,205,153,57.26
Khazix,Sett,131,55,76,41.98
Khazix,LeeSin,255,123,132,48.24
Khazix,Lissandra,51,25,26,49.02
Khazix,TahmKench,97,47,50,48.45
Khazix,Malzahar,99,46,53,46.46
Khazix,Chogath,132,53,79,40.15
Khazix,Nocturne,101,40,61,39.6
Khazix,Rakan,75,46,29,61.33
Khazix,Volibear,105,42,63,40
Khazix,Jax,99,47,52,47.47
Khazix,Yasuo,184,86,98,46.74
Khazix,Pantheon,204,110,94,53.92
Khazix,Darius,214,109,105,50.93
Khazix,Evelynn,57,15,42,26.32
Khazix,Fizz,75,37,38,49.33
Khazix,MonkeyKing,61,20,41,32.79
Khazix,Zac,77,26,51,33.77
Khazix,Katarina,93,54,39,58.06
Khazix,Thresh,171,79,92,46.2
Khazix,Diana,162,89,73,54.94
Khazix,Kennen,33,13,20,39.39
Khazix,Kayn,133,69,64,51.88
Khazix,Yuumi,98,31,67,31.63
Khazix,Urgot,56,14,42,25
Khazix,XinZhao,78,36,42,46.15
Khazix,Draven,58,31,27,53.45
Khazix,Nami,148,63,85,42.57
Khazix,Mordekaiser,150,77,73,51.33
Khazix,Yone,201,101,100,50.25
Khazix,Caitlyn,319,143,176,44.83
Khazix,Senna,51,38,13,74.51
Khazix,TwistedFate,36,27,9,75
Khazix,Kaisa,203,115,88,56.65
Khazix,Alistar,95,42,53,44.21
Khazix,Xayah,67,35,32,52.24
Khazix,Smolder,91,41,50,45.05
Khazix,FiddleSticks,80,45,35,56.25
Khazix,Aurora,118,66,52,55.93
Khazix,Varus,132,67,65,50.76
Khazix,Karma,153,67,86,43.79
Khazix,Ambessa,78,39,39,50
Khazix,Ekko,97,41,56,42.27
Khazix,Vayne,143,63,80,44.06
Khazix,Milio,76,41,35,53.95
Khazix,Tryndamere,41,21,20,51.22
Khazix,Sylas,149,80,69,53.69
Khazix,Sion,89,23,66,25.84
Khazix,JarvanIV,73,42,31,57.53
Khazix,Soraka,42,13,29,30.95
Khazix,Gragas,117,69,48,58.97
Khazix,Corki,49,23,26,46.94
Khazix,Blitzcrank,79,41,38,51.9
Khazix,Riven,54,22,32,40.74
Khazix,Shaco,99,47,52,47.47
Khazix,Sivir,57,28,29,49.12
Khazix,Viego,151,82,69,54.3
Khazix,Galio,146,82,64,56.16
Khazix,Ziggs,39,13,26,33.33
Khazix,Braum,80,32,48,40
Khazix,Nidalee,66,30,36,45.45
Khazix,Heimerdinger,61,30,31,49.18
Khazix,Zyra,84,39,45,46.43
Khazix,Teemo,96,47,49,48.96
Khazix,Lucian,129,61,68,47.29
Khazix,Brand,62,26,36,41.94
Khazix,Shen,107,51,56,47.66
Khazix,AurelionSol,49,14,35,28.57
Khazix,Leona,96,45,51,46.88
Khazix,Briar,49,15,34,30.61
Khazix,Fiora,50,27,23,54
Khazix,Jhin,203,105,98,51.72
Khazix,Qiyana,16,9,7,56.25
Khazix,Seraphine,79,22,57,27.85
Khazix,Leblanc,60,35,25,58.33
Khazix,Orianna,62,17,45,27.42
Khazix,Aphelios,65,28,37,43.08
Khazix,Olaf,36,16,20,44.44
Khazix,Amumu,121,59,62,48.76
Khazix,Swain,115,66,49,57.39
Khazix,Veigar,71,33,38,46.48
Khazix,Sejuani,90,45,45,50
Khazix,Samira,91,40,51,43.96
Khazix,Graves,65,28,37,43.08
Khazix,Sona,30,15,15,50
Khazix,Hwei,97,54,43,55.67
Khazix,Karthus,38,22,16,57.89
Khazix,Gangplank,76,38,38,50
Khazix,Kassadin,25,8,17,32
Khazix,Nasus,71,38,33,53.52
Khazix,Vladimir,65,32,33,49.23
Khazix,Rammus,30,20,10,66.67
Khazix,Naafiri,30,26,4,86.67
Khazix,Renekton,64,44,20,68.75
Khazix,Kalista,30,24,6,80
Khazix,Ivern,20,11,9,55
Khazix,Garen,173,87,86,50.29
Khazix,Zeri,61,22,39,36.07
Khazix,Twitch,81,45,36,55.56
Khazix,MasterYi,128,75,53,58.59
Khazix,Akali,114,56,58,49.12
Khazix,Vex,55,33,22,60
Khazix,Anivia,32,13,19,40.63
Khazix,Singed,30,11,19,36.67
Khazix,KSante,72,26,46,36.11
Khazix,Xerath,106,38,68,35.85
Khazix,Zed,161,70,91,43.48
Khazix,Pyke,63,41,22,65.08
Khazix,Quinn,36,15,21,41.67
Khazix,Aatrox,94,50,44,53.19
Khazix,Lillia,88,46,42,52.27
Khazix,Janna,37,22,15,59.46
Khazix,Talon,82,46,36,56.1
Khazix,Nunu,64,25,39,39.06
Khazix,Gwen,62,24,38,38.71
Khazix,Poppy,67,28,39,41.79
Khazix,Illaoi,67,27,40,40.3
Khazix,Akshan,28,13,15,46.43
Khazix,Ryze,34,20,14,58.82
Khazix,Gnar,51,21,30,41.18
Khazix,Viktor,143,63,80,44.06
Khazix,Velkoz,71,38,33,53.52
Khazix,Rell,69,34,35,49.28
Khazix,Neeko,39,15,24,38.46
Khazix,Belveth,23,8,15,34.78
Khazix,Shyvana,39,13,26,33.33
Khazix,KogMaw,28,11,17,39.29
Khazix,Elise,84,43,41,51.19
Khazix,Syndra,93,58,35,62.37
Khazix,Zoe,84,44,40,52.38
Khazix,Tristana,94,59,35,62.77
Khazix,Renata,25,7,18,28
Khazix,Skarner,50,15,35,30
Khazix,Nilah,38,19,19,50
Khazix,Kled,26,23,3,88.46
Khazix,Taric,19,5,14,26.32
Khazix,Maokai,53,35,18,66.04
Khazix,DrMundo,55,22,33,40
Khazix,Hecarim,35,16,19,45.71
Khazix,RekSai,20,15,5,75
Khazix,Udyr,56,39,17,69.64
Khazix,Kayle,73,33,40,45.21
Khazix,Rumble,28,22,6,78.57
Khazix,Taliyah,28,14,14,50
Khazix,Kindred,47,33,14,70.21
Khazix,Ornn,46,29,17,63.04
Khazix,Zilean,40,21,19,52.5
Khazix,Camille,40,13,27,32.5
Khazix,Bard,21,13,8,61.9
Khazix,Jayce,54,27,27,50
Khazix,Cassiopeia,18,12,6,66.67
Khazix,Annie,22,11,11,50
Gwen,Chogath,180,99,81,55
Gwen,MonkeyKing,82,45,37,54.88
Gwen,Veigar,101,50,51,49.5
Gwen,Caitlyn,276,137,139,49.64
Gwen,Mel,247,128,119,51.82
Gwen,Malphite,153,67,86,43.79
Gwen,Kayn,123,48,75,39.02
Gwen,Ryze,58,24,34,41.38
Gwen,Lucian,83,47,36,56.63
Gwen,Leona,121,64,57,52.89
Gwen,Yone,189,102,87,53.97
Gwen,Talon,80,43,37,53.75
Gwen,Vladimir,68,19,49,27.94
Gwen,Swain,148,67,81,45.27
Gwen,Thresh,243,117,126,48.15
Gwen,Yasuo,206,100,106,48.54
Gwen,Evelynn,33,20,13,60.61
Gwen,Vayne,123,65,58,52.85
Gwen,Milio,67,22,45,32.84
Gwen,Warwick,149,50,99,33.56
Gwen,Ornn,111,46,65,41.44
Gwen,Katarina,77,37,40,48.05
Gwen,Tristana,77,30,47,38.96
Gwen,Lux,239,131,108,54.81
Gwen,Mordekaiser,169,98,71,57.99
Gwen,Naafiri,37,18,19,48.65
Gwen,Rammus,40,21,19,52.5
Gwen,Twitch,93,41,52,44.09
Gwen,Aatrox,138,67,71,48.55
Gwen,XinZhao,103,41,62,39.81
Gwen,Diana,209,109,100,52.15
Gwen,TahmKench,118,49,69,41.53
Gwen,Lissandra,44,28,16,63.64
Gwen,Corki,60,31,29,51.67
Gwen,Udyr,48,31,17,64.58
Gwen,Shaco,80,50,30,62.5
Gwen,Zyra,64,38,26,59.38
Gwen,Elise,64,37,27,57.81
Gwen,Kaisa,194,96,98,49.48
Gwen,Viego,158,65,93,41.14
Gwen,Vex,84,46,38,54.76
Gwen,Jhin,187,93,94,49.73
Gwen,Renata,26,13,13,50
Gwen,Volibear,142,76,66,53.52
Gwen,Ambessa,66,25,41,37.88
Gwen,KogMaw,29,13,16,44.83
Gwen,Zac,91,56,35,61.54
Gwen,Yuumi,90,42,48,46.67
Gwen,Yorick,96,54,42,56.25
Gwen,MissFortune,200,88,112,44
Gwen,Morgana,96,44,52,45.83
Gwen,Nami,101,43,58,42.57
Gwen,Nocturne,155,81,74,52.26
Gwen,Malzahar,119,52,67,43.7
Gwen,Urgot,61,40,21,65.57
Gwen,MasterYi,132,74,58,56.06
Gwen,Akali,90,33,57,36.67
Gwen,Ezreal,255,109,146,42.75
Gwen,Shyvana,37,24,13,64.86
Gwen,Fizz,47,30,17,63.83
Gwen,Jinx,299,151,148,50.5
Gwen,Rengar,37,24,13,64.86
Gwen,Sejuani,78,47,31,60.26
Gwen,Ahri,153,74,79,48.37
Gwen,Nautilus,175,94,81,53.71
Gwen,FiddleSticks,73,36,37,49.32
Gwen,Vi,128,64,64,50
Gwen,Aurora,113,51,62,45.13
Gwen,Varus,93,51,42,54.84
Gwen,Karma,130,66,64,50.77
Gwen,Ashe,244,131,113,53.69
Gwen,Braum,113,56,57,49.56
Gwen,Irelia,67,34,33,50.75
Gwen,Aphelios,65,30,35,46.15
Gwen,Graves,115,43,72,37.39
Gwen,Samira,82,53,29,64.63
Gwen,Sett,163,72,91,44.17
Gwen,Seraphine,95,44,51,46.32
Gwen,Ivern,24,21,3,87.5
Gwen,AurelionSol,55,29,26,52.73
Gwen,Lulu,160,74,86,46.25
Gwen,Kindred,59,33,26,55.93
Gwen,Blitzcrank,91,54,37,59.34
Gwen,Sion,196,107,89,54.59
Gwen,Amumu,115,57,58,49.57
Gwen,Ekko,75,35,40,46.67
Gwen,Darius,190,98,92,51.58
Gwen,Velkoz,47,28,19,59.57
Gwen,LeeSin,172,76,96,44.19
Gwen,Pyke,78,35,43,44.87
Gwen,Shen,116,56,60,48.28
Gwen,Sivir,77,36,41,46.75
Gwen,Skarner,52,21,31,40.38
Gwen,KSante,131,66,65,50.38
Gwen,Pantheon,225,111,114,49.33
Gwen,Akshan,23,12,11,52.17
Gwen,Syndra,74,23,51,31.08
Gwen,Hwei,80,46,34,57.5
Gwen,Anivia,36,19,17,52.78
Gwen,Camille,61,31,30,50.82
Gwen,Nilah,41,25,16,60.98
Gwen,Soraka,40,13,27,32.5
Gwen,Galio,146,63,83,43.15
Gwen,Briar,49,22,27,44.9
Gwen,Kayle,45,15,30,33.33
Gwen,Viktor,124,62,62,50
Gwen,Rakan,51,17,34,33.33
Gwen,Senna,77,34,43,44.16
Gwen,Tryndamere,44,12,32,27.27
Gwen,Sona,28,17,11,60.71
Gwen,Fiora,61,34,27,55.74
Gwen,Rell,81,43,38,53.09
Gwen,Nunu,68,45,23,66.18
Gwen,Brand,61,35,26,57.38
Gwen,Gragas,56,24,32,42.86
Gwen,Neeko,67,34,33,50.75
Gwen,Gangplank,40,20,20,50
Gwen,Smolder,82,51,31,62.2
Gwen,Rumble,31,20,11,64.52
Gwen,Jax,82,41,41,50
Gwen,Teemo,95,57,38,60
Gwen,Kennen,32,17,15,53.13
Gwen,Maokai,62,34,28,54.84
Gwen,DrMundo,51,27,24,52.94
Gwen,Bard,43,13,30,30.23
Gwen,Poppy,85,27,58,31.76
Gwen,Sylas,168,99,69,58.93
Gwen,Nasus,50,14,36,28
Gwen,Kalista,36,19,17,52.78
Gwen,Belveth,27,18,9,66.67
Gwen,Khazix,62,38,24,61.29
Gwen,Cassiopeia,29,19,10,65.52
Gwen,Trundle,75,43,32,57.33
Gwen,Alistar,60,39,21,65
Gwen,Xayah,69,38,31,55.07
Gwen,Orianna,57,37,20,64.91
Gwen,Garen,180,88,92,48.89
Gwen,Singed,30,12,18,40
Gwen,Zed,93,50,43,53.76
Gwen,Annie,40,18,22,45
Gwen,Zilean,32,19,13,59.38
Gwen,Azir,43,31,12,72.09
Gwen,JarvanIV,130,64,66,49.23
Gwen,Illaoi,67,36,31,53.73
Gwen,Xerath,72,26,46,36.11
Gwen,Lillia,41,26,15,63.41
Gwen,Janna,39,20,19,51.28
Gwen,Nidalee,33,17,16,51.52
Gwen,Zeri,82,43,39,52.44
Gwen,Renekton,59,47,12,79.66
Gwen,Gnar,47,22,25,46.81
Gwen,Ziggs,48,24,24,50
Gwen,Kassadin,36,13,23,36.11
Gwen,Taric,34,13,21,38.24
Gwen,TwistedFate,47,20,27,42.55
Gwen,Riven,63,32,31,50.79
Gwen,Leblanc,55,25,30,45.45
Gwen,Taliyah,32,21,11,65.63
Gwen,Quinn,24,15,9,62.5
Gwen,Draven,48,25,23,52.08
Gwen,Heimerdinger,41,13,28,31.71
Gwen,Zoe,43,19,24,44.19
Gwen,Karthus,25,11,14,44
Gwen,Kled,21,8,13,38.1
Gwen,Hecarim,31,14,17,45.16
Gwen,Qiyana,17,3,14,17.65
Gwen,Jayce,45,21,24,46.67
Gwen,Olaf,16,5,11,31.25
Gwen,RekSai,24,15,9,62.5
KSante,Sylas,225,112,113,49.78
KSante,Evelynn,54,29,25,53.7
KSante,Mel,277,101,176,36.46
KSante,Varus,163,88,75,53.99
KSante,Karma,255,117,138,45.88
KSante,Teemo,81,47,34,58.02
KSante,Renekton,141,69,72,48.94
KSante,Kassadin,30,14,16,46.67
KSante,Jinx,373,147,226,39.41
KSante,Soraka,90,34,56,37.78
KSante,Jax,104,47,57,45.19
KSante,Yorick,110,27,83,24.55
KSante,Yasuo,320,152,168,47.5
KSante,Tristana,127,57,70,44.88
KSante,Lux,333,164,169,49.25
KSante,MonkeyKing,129,55,74,42.64
KSante,Vayne,221,90,131,40.72
KSante,Fiora,112,63,49,56.25
KSante,Azir,45,24,21,53.33
KSante,Yone,281,121,160,43.06
KSante,Kayn,168,66,102,39.29
KSante,Malzahar,148,61,87,41.22
KSante,KogMaw,58,24,34,41.38
KSante,Veigar,144,73,71,50.69
KSante,Chogath,150,81,69,54
KSante,Sivir,117,40,77,34.19
KSante,Ryze,72,51,21,70.83
KSante,Ashe,372,163,209,43.82
KSante,Senna,99,61,38,61.62
KSante,DrMundo,66,23,43,34.85
KSante,LeeSin,332,163,169,49.1
KSante,Zed,120,70,50,58.33
KSante,Zeri,140,56,84,40
KSante,Lulu,307,169,138,55.05
KSante,Shen,110,43,67,39.09
KSante,Xayah,97,48,49,49.48
KSante,Viktor,177,75,102,42.37
KSante,Sejuani,109,41,68,37.61
KSante,Nami,153,56,97,36.6
KSante,Aatrox,218,112,106,51.38
KSante,Karthus,42,19,23,45.24
KSante,Annie,58,32,26,55.17
KSante,Ekko,138,62,76,44.93
KSante,Nilah,72,42,30,58.33
KSante,Zyra,116,68,48,58.62
KSante,Poppy,151,59,92,39.07
KSante,Taliyah,45,21,24,46.67
KSante,Nautilus,247,117,130,47.37
KSante,XinZhao,139,72,67,51.8
KSante,Vladimir,104,41,63,39.42
KSante,Corki,72,33,39,45.83
KSante,Morgana,160,77,83,48.13
KSante,Briar,79,29,50,36.71
KSante,Caitlyn,389,195,194,50.13
KSante,Urgot,81,38,43,46.91
KSante,Camille,64,30,34,46.88
KSante,Orianna,101,41,60,40.59
KSante,Tryndamere,47,24,23,51.06
KSante,Nidalee,68,38,30,55.88
KSante,Vex,86,46,40,53.49
KSante,Rell,117,64,53,54.7
KSante,Nocturne,245,119,126,48.57
KSante,Alistar,110,49,61,44.55
KSante,Jayce,97,44,53,45.36
KSante,Viego,187,99,88,52.94
KSante,Katarina,111,52,59,46.85
KSante,Draven,86,42,44,48.84
KSante,Thresh,348,139,209,39.94
KSante,Trundle,100,34,66,34
KSante,Shaco,128,57,71,44.53
KSante,AurelionSol,63,25,38,39.68
KSante,Seraphine,96,47,49,48.96
KSante,Lillia,144,55,89,38.19
KSante,Ornn,97,42,55,43.3
KSante,Elise,154,70,84,45.45
KSante,Rakan,96,43,53,44.79
KSante,Zoe,80,32,48,40
KSante,Braum,135,52,83,38.52
KSante,Riven,66,34,32,51.52
KSante,Udyr,74,41,33,55.41
KSante,Leblanc,101,35,66,34.65
KSante,Ezreal,383,212,171,55.35
KSante,Aurora,147,80,67,54.42
KSante,Sona,23,13,10,56.52
KSante,Gwen,131,65,66,49.62
KSante,Samira,132,75,57,56.82
KSante,Pyke,121,62,59,51.24
KSante,Gnar,103,41,62,39.81
KSante,Gragas,169,74,95,43.79
KSante,Ahri,272,117,155,43.01
KSante,Jhin,364,186,178,51.1
KSante,Maokai,61,31,30,50.82
KSante,JarvanIV,164,64,100,39.02
KSante,Kaisa,278,118,160,42.45
KSante,TahmKench,104,45,59,43.27
KSante,Yuumi,153,72,81,47.06
KSante,Rumble,45,23,22,51.11
KSante,Mordekaiser,311,155,156,49.84
KSante,MasterYi,169,81,88,47.93
KSante,FiddleSticks,71,29,42,40.85
KSante,Janna,45,14,31,31.11
KSante,Illaoi,59,24,35,40.68
KSante,Aphelios,84,34,50,40.48
KSante,Ambessa,218,107,111,49.08
KSante,Hwei,108,52,56,48.15
KSante,Brand,51,25,26,49.02
KSante,Nasus,70,20,50,28.57
KSante,Akshan,36,19,17,52.78
KSante,MissFortune,282,140,142,49.65
KSante,Malphite,145,66,79,45.52
KSante,Irelia,112,57,55,50.89
KSante,Volibear,174,83,91,47.7
KSante,Sett,249,129,120,51.81
KSante,Akali,191,103,88,53.93
KSante,Renata,47,24,23,51.06
KSante,Garen,328,145,183,44.21
KSante,Singed,29,14,15,48.28
KSante,Graves,113,52,61,46.02
KSante,Khazix,72,46,26,63.89
KSante,Blitzcrank,146,72,74,49.32
KSante,Pantheon,223,108,115,48.43
KSante,Milio,86,51,35,59.3
KSante,Diana,280,116,164,41.43
KSante,Zac,102,46,56,45.1
KSante,Twitch,109,41,68,37.61
KSante,Heimerdinger,42,21,21,50
KSante,Swain,166,69,97,41.57
KSante,Lissandra,77,45,32,58.44
KSante,Kalista,43,24,19,55.81
KSante,Kayle,69,27,42,39.13
KSante,Kindred,62,24,38,38.71
KSante,Galio,255,133,122,52.16
KSante,Hecarim,71,41,30,57.75
KSante,Warwick,169,92,77,54.44
KSante,Taric,37,17,20,45.95
KSante,Xerath,143,61,82,42.66
KSante,Fizz,57,24,33,42.11
KSante,Vi,201,93,108,46.27
KSante,Darius,308,129,179,41.88
KSante,Rengar,38,13,25,34.21
KSante,Cassiopeia,51,27,24,52.94
KSante,Leona,175,80,95,45.71
KSante,Amumu,189,102,87,53.97
KSante,Syndra,105,46,59,43.81
KSante,Smolder,114,55,59,48.25
KSante,Velkoz,79,26,53,32.91
KSante,Quinn,43,15,28,34.88
KSante,RekSai,29,15,14,51.72
KSante,Gangplank,66,33,33,50
KSante,Nunu,81,52,29,64.2
KSante,Naafiri,42,25,17,59.52
KSante,Skarner,80,44,36,55
KSante,TwistedFate,64,28,36,43.75
KSante,Sion,116,62,54,53.45
KSante,Olaf,42,10,32,23.81
KSante,Anivia,57,30,27,52.63
KSante,Lucian,130,61,69,46.92
KSante,Neeko,72,32,40,44.44
KSante,Belveth,30,16,14,53.33
KSante,Bard,62,35,27,56.45
KSante,Ziggs,38,16,22,42.11
KSante,Zilean,49,22,27,44.9
KSante,Ivern,32,16,16,50
KSante,Talon,69,31,38,44.93
KSante,Rammus,28,20,8,71.43
KSante,Kennen,43,15,28,34.88
KSante,Kled,28,17,11,60.71
KSante,Qiyana,21,16,5,76.19
KSante,Shyvana,20,6,14,30
Bard,Sylas,94,38,56,40.43
Bard,Evelynn,31,19,12,61.29
Bard,Mel,159,75,84,47.17
Bard,Varus,100,46,54,46
Bard,Karma,119,55,64,46.22
Bard,MonkeyKing,69,27,42,39.13
Bard,Vayne,93,53,40,56.99
Bard,Fiora,14,2,12,14.29
Bard,Soraka,52,22,30,42.31
Bard,Azir,24,12,12,50
Bard,Jayce,44,24,20,54.55
Bard,Graves,54,27,27,50
Bard,Lux,217,131,86,60.37
Bard,Caitlyn,205,111,94,54.15
Bard,Seraphine,49,31,18,63.27
Bard,TahmKench,67,43,24,64.18
Bard,JarvanIV,58,31,27,53.45
Bard,Viktor,71,26,45,36.62
Bard,Kaisa,118,55,63,46.61
Bard,Morgana,60,36,24,60
Bard,Volibear,62,36,26,58.06
Bard,Amumu,84,31,53,36.9
Bard,Katarina,58,26,32,44.83
Bard,Poppy,75,48,27,64
Bard,Zac,57,35,22,61.4
Bard,Nocturne,103,49,54,47.57
Bard,Veigar,91,43,48,47.25
Bard,KogMaw,15,9,6,60
Bard,Irelia,38,27,11,71.05
Bard,Kayn,72,41,31,56.94
Bard,Ahri,110,70,40,63.64
Bard,Twitch,68,43,25,63.24
Bard,Thresh,157,82,75,52.23
Bard,Rengar,34,15,19,44.12
Bard,Smolder,57,30,27,52.63
Bard,Janna,23,5,18,21.74
Bard,Malphite,78,39,39,50
Bard,Yasuo,100,46,54,46
Bard,Kled,22,9,13,40.91
Bard,Orianna,46,26,20,56.52
Bard,Illaoi,36,12,24,33.33
Bard,XinZhao,59,35,24,59.32
Bard,Jinx,167,66,101,39.52
Bard,Blitzcrank,54,32,22,59.26
Bard,Sett,107,67,40,62.62
Bard,Skarner,30,16,14,53.33
Bard,Chogath,123,71,52,57.72
Bard,Aphelios,46,23,23,50
Bard,Gnar,37,21,16,56.76
Bard,Brand,39,16,23,41.03
Bard,Tristana,87,42,45,48.28
Bard,Lulu,75,54,21,72
Bard,Ornn,57,28,29,49.12
Bard,LeeSin,104,48,56,46.15
Bard,Qiyana,14,9,5,64.29
Bard,Diana,117,62,55,52.99
Bard,Renekton,51,24,27,47.06
Bard,Draven,33,24,9,72.73
Bard,Nautilus,93,51,42,54.84
Bard,Aatrox,86,43,43,50
Bard,Milio,62,27,35,43.55
Bard,Aurora,58,22,36,37.93
Bard,MasterYi,43,17,26,39.53
Bard,Ambessa,53,31,22,58.49
Bard,Jhin,129,72,57,55.81
Bard,Zilean,14,7,7,50
Bard,Zyra,42,27,15,64.29
Bard,Velkoz,43,27,16,62.79
Bard,Nami,88,40,48,45.45
Bard,Trundle,18,12,6,66.67
Bard,Annie,24,10,14,41.67
Bard,Nasus,39,20,19,51.28
Bard,Akshan,29,15,14,51.72
Bard,MissFortune,123,51,72,41.46
Bard,Gragas,59,20,39,33.9
Bard,Kassadin,17,5,12,29.41
Bard,Yuumi,72,38,34,52.78
Bard,Nunu,60,36,24,60
Bard,Gangplank,24,9,15,37.5
Bard,Yone,90,50,40,55.56
Bard,Xayah,67,26,41,38.81
Bard,Pantheon,101,60,41,59.41
Bard,Corki,36,22,14,61.11
Bard,Vex,30,11,19,36.67
Bard,Udyr,46,14,32,30.43
Bard,Ziggs,26,15,11,57.69
Bard,Vi,88,49,39,55.68
Bard,Mordekaiser,82,46,36,56.1
Bard,AurelionSol,36,19,17,52.78
Bard,Leona,54,16,38,29.63
Bard,Gwen,43,30,13,69.77
Bard,Rakan,58,29,29,50
Bard,DrMundo,35,16,19,45.71
Bard,Zeri,21,13,8,61.9
Bard,Rell,48,29,19,60.42
Bard,Vladimir,44,16,28,36.36
Bard,Hwei,56,33,23,58.93
Bard,Zoe,14,2,12,14.29
Bard,Urgot,30,9,21,30
Bard,Briar,45,28,17,62.22
Bard,Warwick,69,37,32,53.62
Bard,Swain,74,44,30,59.46
Bard,Darius,122,66,56,54.1
Bard,Galio,91,40,51,43.96
Bard,Quinn,28,11,17,39.29
Bard,Zed,60,23,37,38.33
Bard,Ezreal,143,70,73,48.95
Bard,FiddleSticks,41,16,25,39.02
Bard,Xerath,58,30,28,51.72
Bard,Kalista,18,12,6,66.67
Bard,Alistar,31,19,12,61.29
Bard,Elise,61,29,32,47.54
Bard,Sivir,31,18,13,58.06
Bard,Samira,44,21,23,47.73
Bard,Akali,71,47,24,66.2
Bard,Syndra,52,21,31,40.38
Bard,Lucian,51,16,35,31.37
Bard,TwistedFate,22,13,9,59.09
Bard,Braum,66,38,28,57.58
Bard,Rumble,14,3,11,21.43
Bard,Tryndamere,31,17,14,54.84
Bard,Senna,57,32,25,56.14
Bard,Ekko,55,22,33,40
Bard,Malzahar,91,41,50,45.05
Bard,Nilah,32,18,14,56.25
Bard,Shen,54,29,25,53.7
Bard,Ashe,99,68,31,68.69
Bard,Belveth,20,12,8,60
Bard,Viego,120,52,68,43.33
Bard,Shaco,55,27,28,49.09
Bard,Talon,36,17,19,47.22
Bard,Kayle,28,9,19,32.14
Bard,Garen,121,56,65,46.28
Bard,Karthus,23,11,12,47.83
Bard,Lissandra,17,9,8,52.94
Bard,Teemo,62,40,22,64.52
Bard,Camille,35,18,17,51.43
Bard,Kennen,44,21,23,47.73
Bard,Taric,16,8,8,50
Bard,Riven,32,16,16,50
Bard,Jax,50,26,24,52
Bard,Heimerdinger,23,12,11,52.17
Bard,Kindred,36,31,5,86.11
Bard,Fizz,19,11,8,57.89
Bard,Maokai,28,20,8,71.43
Bard,Ivern,16,5,11,31.25
Bard,Naafiri,19,3,16,15.79
Bard,Hecarim,10,6,4,60
Bard,Lillia,31,16,15,51.61
Bard,Pyke,34,14,20,41.18
Bard,Anivia,24,14,10,58.33
Bard,KSante,62,27,35,43.55
Bard,Ryze,24,19,5,79.17
Bard,Yorick,73,27,46,36.99
Bard,Cassiopeia,12,8,4,66.67
Bard,Rammus,19,5,14,26.32
Bard,Sion,54,23,31,42.59
Bard,Shyvana,13,3,10,23.08
Bard,Nidalee,11,6,5,54.55
Bard,Sona,16,6,10,37.5
Bard,Taliyah,21,10,11,47.62
Bard,Neeko,21,9,12,42.86
Bard,Sejuani,43,22,21,51.16
Bard,Khazix,21,8,13,38.1
Bard,Renata,5,2,3,40
Bard,Olaf,11,2,9,18.18
Bard,Leblanc,37,17,20,45.95
Bard,Singed,17,8,9,47.06
Bard,RekSai,15,6,9,40
Skarner,Leblanc,90,47,43,52.22
Skarner,Kayn,128,72,56,56.25
Skarner,Teemo,88,42,46,47.73
Skarner,Ashe,226,104,122,46.02
Skarner,Nautilus,174,106,68,60.92
Skarner,Darius,229,107,122,46.72
Skarner,Veigar,81,35,46,43.21
Skarner,Varus,112,50,62,44.64
Skarner,Pyke,94,39,55,41.49
Skarner,Tryndamere,32,15,17,46.88
Skarner,Nunu,63,26,37,41.27
Skarner,Kennen,32,16,16,50
Skarner,Samira,104,69,35,66.35
Skarner,Rell,90,50,40,55.56
Skarner,Vi,124,48,76,38.71
Skarner,Riven,53,27,26,50.94
Skarner,Yone,225,116,109,51.56
Skarner,Smolder,98,47,51,47.96
Skarner,Thresh,190,85,105,44.74
Skarner,Ornn,79,34,45,43.04
Skarner,LeeSin,264,120,144,45.45
Skarner,Hwei,89,36,53,40.45
Skarner,Jhin,191,87,104,45.55
Skarner,TahmKench,104,50,54,48.08
Skarner,Aatrox,127,60,67,47.24
Skarner,XinZhao,119,66,53,55.46
Skarner,Vladimir,61,29,32,47.54
Skarner,Corki,45,29,16,64.44
Skarner,Morgana,86,34,52,39.53
Skarner,Rengar,17,12,5,70.59
Skarner,Ahri,149,93,56,62.42
Skarner,Lux,217,103,114,47.47
Skarner,Urgot,47,18,29,38.3
Skarner,Udyr,30,21,9,70
Skarner,Azir,69,27,42,39.13
Skarner,Jinx,321,141,180,43.93
Skarner,Shyvana,41,24,17,58.54
Skarner,Fizz,50,41,9,82
Skarner,Volibear,109,51,58,46.79
Skarner,Pantheon,176,111,65,63.07
Skarner,Yorick,85,46,39,54.12
Skarner,Elise,117,52,65,44.44
Skarner,Poppy,76,54,22,71.05
Skarner,Aurora,102,54,48,52.94
Skarner,Kindred,51,24,27,47.06
Skarner,Mel,190,90,100,47.37
Skarner,Jax,112,69,43,61.61
Skarner,Akali,98,55,43,56.12
Skarner,Caitlyn,240,109,131,45.42
Skarner,Senna,90,42,48,46.67
Skarner,Briar,40,12,28,30
Skarner,Galio,162,97,65,59.88
Skarner,Seraphine,90,42,48,46.67
Skarner,Jayce,39,23,16,58.97
Skarner,Draven,85,44,41,51.76
Skarner,Syndra,80,47,33,58.75
Skarner,Shen,103,43,60,41.75
Skarner,Sejuani,108,38,70,35.19
Skarner,Alistar,67,32,35,47.76
Skarner,Kayle,51,22,29,43.14
Skarner,Bard,30,14,16,46.67
Skarner,DrMundo,56,32,24,57.14
Skarner,Nilah,43,14,29,32.56
Skarner,Warwick,138,80,58,57.97
Skarner,Yasuo,155,78,77,50.32
Skarner,KogMaw,33,20,13,60.61
Skarner,Yuumi,117,58,59,49.57
Skarner,Ivern,25,15,10,60
Skarner,Kaisa,213,129,84,60.56
Skarner,Gwen,52,31,21,59.62
Skarner,Zed,129,58,71,44.96
Skarner,Irelia,99,52,47,52.53
Skarner,Malphite,98,48,50,48.98
Skarner,Zac,90,58,32,64.44
Skarner,Shaco,60,33,27,55
Skarner,Lucian,106,74,32,69.81
Skarner,FiddleSticks,39,28,11,71.79
Skarner,Nocturne,129,64,65,49.61
Skarner,Xerath,92,41,51,44.57
Skarner,Blitzcrank,93,55,38,59.14
Skarner,Soraka,43,17,26,39.53
Skarner,Sett,180,89,91,49.44
Skarner,Hecarim,69,46,23,66.67
Skarner,Camille,36,17,19,47.22
Skarner,Mordekaiser,161,87,74,54.04
Skarner,Zilean,36,28,8,77.78
Skarner,Milio,121,54,67,44.63
Skarner,Singed,33,6,27,18.18
Skarner,Zoe,51,33,18,64.71
Skarner,Tristana,111,68,43,61.26
Skarner,Gnar,64,35,29,54.69
Skarner,Nasus,69,36,33,52.17
Skarner,MasterYi,95,54,41,56.84
Skarner,Trundle,50,23,27,46
Skarner,Sivir,77,34,43,44.16
Skarner,JarvanIV,101,41,60,40.59
Skarner,AurelionSol,52,28,24,53.85
Skarner,MissFortune,174,84,90,48.28
Skarner,Fiora,49,16,33,32.65
Skarner,Ambessa,69,28,41,40.58
Skarner,Lulu,168,111,57,66.07
Skarner,Vayne,147,68,79,46.26
Skarner,Kled,22,11,11,50
Skarner,Malzahar,122,54,68,44.26
Skarner,Ezreal,277,157,120,56.68
Skarner,Chogath,105,43,62,40.95
Skarner,Maokai,56,30,26,53.57
Skarner,Xayah,80,40,40,50
Skarner,Rakan,60,34,26,56.67
Skarner,Sion,102,39,63,38.24
Skarner,Lillia,81,32,49,39.51
Skarner,Nami,145,82,63,56.55
Skarner,Ryze,43,23,20,53.49
Skarner,Gragas,101,49,52,48.51
Skarner,Anivia,45,32,13,71.11
Skarner,Rumble,46,29,17,63.04
Skarner,Quinn,29,24,5,82.76
Skarner,Amumu,146,67,79,45.89
Skarner,Ekko,96,30,66,31.25
Skarner,Karthus,26,14,12,53.85
Skarner,Renekton,60,37,23,61.67
Skarner,Leona,76,33,43,43.42
Skarner,Garen,169,79,90,46.75
Skarner,Diana,172,97,75,56.4
Skarner,Brand,59,36,23,61.02
Skarner,Graves,66,40,26,60.61
Skarner,Kassadin,22,8,14,36.36
Skarner,Katarina,57,31,26,54.39
Skarner,Swain,76,29,47,38.16
Skarner,Kalista,47,8,39,17.02
Skarner,Belveth,21,8,13,38.1
Skarner,Aphelios,56,30,26,53.57
Skarner,Viego,157,70,87,44.59
Skarner,Akshan,44,17,27,38.64
Skarner,Taric,27,15,12,55.56
Skarner,Neeko,43,26,17,60.47
Skarner,Karma,156,79,77,50.64
Skarner,Lissandra,23,13,10,56.52
Skarner,Renata,29,15,14,51.72
Skarner,Khazix,50,35,15,70
Skarner,Orianna,65,35,30,53.85
Skarner,Vex,42,17,25,40.48
Skarner,Twitch,89,51,38,57.3
Skarner,Velkoz,40,16,24,40
Skarner,Illaoi,45,31,14,68.89
Skarner,Gangplank,83,50,33,60.24
Skarner,Nidalee,37,30,7,81.08
Skarner,Sylas,149,62,87,41.61
Skarner,Ziggs,42,15,27,35.71
Skarner,Braum,112,48,64,42.86
Skarner,KSante,80,36,44,45
Skarner,Olaf,46,11,35,23.91
Skarner,Viktor,141,62,79,43.97
Skarner,Qiyana,18,10,8,55.56
Skarner,Naafiri,25,3,22,12
Skarner,TwistedFate,39,29,10,74.36
Skarner,MonkeyKing,47,19,28,40.43
Skarner,Zeri,57,36,21,63.16
Skarner,Heimerdinger,26,14,12,53.85
Skarner,Janna,12,8,4,66.67
Skarner,Cassiopeia,31,14,17,45.16
Skarner,Talon,46,25,21,54.35
Skarner,Zyra,77,32,45,41.56
Skarner,Evelynn,17,7,10,41.18
Skarner,Annie,37,22,15,59.46
Skarner,Taliyah,23,13,10,56.52
Skarner,Rammus,29,12,17,41.38
Skarner,Sona,17,3,14,17.65
Skarner,RekSai,3,0,3,0
Sona,Malphite,40,21,19,52.5
Sona,Graves,31,12,19,38.71
Sona,Vladimir,15,3,12,20
Sona,Ezreal,93,35,58,37.63
Sona,Camille,32,18,14,56.25
Sona,Chogath,44,24,20,54.55
Sona,Yasuo,72,33,39,45.83
Sona,MissFortune,67,32,35,47.76
Sona,Yuumi,31,17,14,54.84
Sona,FiddleSticks,33,18,15,54.55
Sona,Galio,33,16,17,48.48
Sona,Lulu,50,26,24,52
Sona,Urgot,17,5,12,29.41
Sona,Kindred,25,15,10,60
Sona,Veigar,49,14,35,28.57
Sona,Ashe,97,41,56,42.27
Sona,Karthus,15,9,6,60
Sona,Ekko,42,11,31,26.19
Sona,Zeri,18,5,13,27.78
Sona,Seraphine,43,21,22,48.84
Sona,Sett,78,28,50,35.9
Sona,Amumu,49,21,28,42.86
Sona,Irelia,34,19,15,55.88
Sona,Morgana,51,19,32,37.25
Sona,Ahri,63,36,27,57.14
Sona,Shaco,46,23,23,50
Sona,Mordekaiser,66,27,39,40.91
Sona,Jhin,84,51,33,60.71
Sona,Karma,43,24,19,55.81
Sona,Shen,27,15,12,55.56
Sona,Briar,16,8,8,50
Sona,Nautilus,38,26,12,68.42
Sona,Warwick,50,20,30,40
Sona,Twitch,49,22,27,44.9
Sona,Kalista,29,18,11,62.07
Sona,Renata,18,3,15,16.67
Sona,Ambessa,47,29,18,61.7
Sona,Kayn,51,28,23,54.9
Sona,Vayne,42,22,20,52.38
Sona,Milio,35,20,15,57.14
Sona,Heimerdinger,20,11,9,55
Sona,Mel,86,44,42,51.16
Sona,Volibear,48,29,19,60.42
Sona,Caitlyn,99,62,37,62.63
Sona,Soraka,16,4,12,25
Sona,Akali,26,12,14,46.15
Sona,Nocturne,53,24,29,45.28
Sona,Rengar,20,11,9,55
Sona,Malzahar,35,24,11,68.57
Sona,Yone,72,41,31,56.94
Sona,Hwei,36,14,22,38.89
Sona,Zed,49,28,21,57.14
Sona,Lucian,44,19,25,43.18
Sona,Zilean,17,11,6,64.71
Sona,Ornn,30,17,13,56.67
Sona,Brand,21,11,10,52.38
Sona,Ryze,29,15,14,51.72
Sona,Vi,39,20,19,51.28
Sona,Senna,47,27,20,57.45
Sona,Nilah,17,6,11,35.29
Sona,Blitzcrank,33,22,11,66.67
Sona,Jax,26,14,12,53.85
Sona,Viktor,37,18,19,48.65
Sona,Taric,10,6,4,60
Sona,Nami,73,41,32,56.16
Sona,KSante,23,10,13,43.48
Sona,Darius,79,33,46,41.77
Sona,Elise,35,20,15,57.14
Sona,Ziggs,18,6,12,33.33
Sona,Lux,102,59,43,57.84
Sona,Zyra,23,9,14,39.13
Sona,Jayce,22,13,9,59.09
Sona,Khazix,30,15,15,50
Sona,Alistar,19,8,11,42.11
Sona,Varus,34,15,19,44.12
Sona,Syndra,48,30,18,62.5
Sona,Riven,24,13,11,54.17
Sona,LeeSin,50,25,25,50
Sona,Sylas,76,41,35,53.95
Sona,Kaisa,68,42,26,61.76
Sona,Gwen,28,11,17,39.29
Sona,MonkeyKing,25,14,11,56
Sona,Azir,14,8,6,57.14
Sona,Diana,50,24,26,48
Sona,Thresh,60,26,34,43.33
Sona,Zac,31,19,12,61.29
Sona,Jinx,135,61,74,45.19
Sona,Udyr,17,11,6,64.71
Sona,Janna,24,7,17,29.17
Sona,Sejuani,26,5,21,19.23
Sona,Yorick,37,14,23,37.84
Sona,Pantheon,58,23,35,39.66
Sona,Velkoz,11,0,11,0
Sona,Aatrox,51,20,31,39.22
Sona,Leblanc,20,11,9,55
Sona,Teemo,41,28,13,68.29
Sona,Viego,46,23,23,50
Sona,Evelynn,6,6,0,100
Sona,Poppy,33,10,23,30.3
Sona,Braum,33,15,18,45.45
Sona,Garen,45,28,17,62.22
Sona,Tristana,53,27,26,50.94
Sona,Pyke,44,18,26,40.91
Sona,Rell,33,12,21,36.36
Sona,Smolder,19,5,14,26.32
Sona,AurelionSol,21,16,5,76.19
Sona,Fizz,16,3,13,18.75
Sona,Aphelios,20,9,11,45
Sona,Aurora,29,20,9,68.97
Sona,Rammus,16,8,8,50
Sona,Leona,31,13,18,41.94
Sona,Rakan,41,15,26,36.59
Sona,Xayah,26,8,18,30.77
Sona,Nasus,33,22,11,66.67
Sona,MasterYi,49,29,20,59.18
Sona,Gangplank,21,18,3,85.71
Sona,Shyvana,17,6,11,35.29
Sona,XinZhao,37,20,17,54.05
Sona,Samira,22,8,14,36.36
Sona,Belveth,8,3,5,37.5
Sona,Sion,31,11,20,35.48
Sona,Olaf,6,0,6,0
Sona,Katarina,17,6,11,35.29
Sona,Draven,15,7,8,46.67
Sona,Nunu,33,13,20,39.39
Sona,TwistedFate,18,12,6,66.67
Sona,Zoe,17,5,12,29.41
Sona,Swain,26,9,17,34.62
Sona,Gragas,36,22,14,61.11
Sona,Kayle,32,15,17,46.88
Sona,Fiora,17,6,11,35.29
Sona,Xerath,36,18,18,50
Sona,Maokai,13,5,8,38.46
Sona,Singed,10,5,5,50
Sona,Kassadin,12,9,3,75
Sona,Lillia,14,8,6,57.14
Sona,DrMundo,39,17,22,43.59
Sona,Cassiopeia,17,6,11,35.29
Sona,Sivir,22,14,8,63.64
Sona,Ivern,2,0,2,0
Sona,Quinn,8,2,6,25
Sona,JarvanIV,28,9,19,32.14
Sona,TahmKench,37,20,17,54.05
Sona,Orianna,13,8,5,61.54
Sona,Neeko,8,4,4,50
Sona,Annie,19,5,14,26.32
Sona,Hecarim,19,10,9,52.63
Sona,Talon,22,19,3,86.36
Sona,Corki,13,7,6,53.85
Sona,Anivia,14,0,14,0
Sona,Illaoi,22,5,17,22.73
Sona,Vex,29,14,15,48.28
Sona,Bard,16,10,6,62.5
Sona,Lissandra,13,4,9,30.77
Sona,Kled,8,0,8,0
Sona,Gnar,5,5,0,100
Sona,Akshan,6,0,6,0
Sona,Kennen,9,6,3,66.67
Sona,Rumble,3,3,0,100
Sona,Qiyana,3,0,3,0
Sona,Skarner,17,14,3,82.35
Sona,Nidalee,19,14,5,73.68
Sona,Renekton,6,0,6,0
Sona,Trundle,9,3,6,33.33
Sona,KogMaw,3,0,3,0
Sona,Taliyah,8,5,3,62.5
Sona,Tryndamere,6,6,0,100
Sona,RekSai,3,3,0,100
Sona,Naafiri,2,2,0,100
Camille,Aatrox,124,56,68,45.16
Camille,MasterYi,92,44,48,47.83
Camille,Mel,213,103,110,48.36
Camille,Tristana,81,44,37,54.32
Camille,Sona,32,14,18,43.75
Camille,Illaoi,45,35,10,77.78
Camille,Pantheon,128,64,64,50
Camille,Vex,69,42,27,60.87
Camille,Lucian,78,44,34,56.41
Camille,Braum,88,39,49,44.32
Camille,Poppy,88,41,47,46.59
Camille,FiddleSticks,70,31,39,44.29
Camille,Lux,227,115,112,50.66
Camille,Ashe,218,100,118,45.87
Camille,Sett,145,77,68,53.1
Camille,Darius,178,87,91,48.88
Camille,Leblanc,54,32,22,59.26
Camille,MissFortune,195,97,98,49.74
Camille,Renekton,60,33,27,55
Camille,Diana,164,90,74,54.88
Camille,Katarina,39,25,14,64.1
Camille,Varus,67,36,31,53.73
Camille,Karma,145,70,75,48.28
Camille,Amumu,112,52,60,46.43
Camille,Caitlyn,213,113,100,53.05
Camille,Brand,35,19,16,54.29
Camille,Yone,163,80,83,49.08
Camille,Ambessa,131,64,67,48.85
Camille,Twitch,61,42,19,68.85
Camille,Hwei,68,36,32,52.94
Camille,DrMundo,38,24,14,63.16
Camille,Zed,102,54,48,52.94
Camille,Orianna,77,35,42,45.45
Camille,Sivir,72,39,33,54.17
Camille,Nami,130,78,52,60
Camille,Rumble,31,14,17,45.16
Camille,Maokai,47,23,24,48.94
Camille,MonkeyKing,98,40,58,40.82
Camille,Viktor,63,21,42,33.33
Camille,Seraphine,73,41,32,56.16
Camille,Gnar,60,38,22,63.33
Camille,Swain,95,35,60,36.84
Camille,Jhin,174,90,84,51.72
Camille,Zoe,51,38,13,74.51
Camille,KSante,64,34,30,53.13
Camille,Shaco,62,29,33,46.77
Camille,Jinx,237,109,128,45.99
Camille,Yuumi,129,65,64,50.39
Camille,Shen,95,45,50,47.37
Camille,Smolder,68,21,47,30.88
Camille,Soraka,54,18,36,33.33
Camille,Heimerdinger,25,13,12,52
Camille,Irelia,36,14,22,38.89
Camille,Ezreal,269,159,110,59.11
Camille,Rakan,67,20,47,29.85
Camille,Volibear,65,34,31,52.31
Camille,Warwick,113,47,66,41.59
Camille,Malzahar,74,47,27,63.51
Camille,Draven,38,14,24,36.84
Camille,Leona,71,38,33,53.52
Camille,Aurora,107,60,47,56.07
Camille,Nocturne,100,40,60,40
Camille,Kaisa,144,82,62,56.94
Camille,Zyra,90,49,41,54.44
Camille,Trundle,14,5,9,35.71
Camille,Belveth,34,21,13,61.76
Camille,Veigar,94,30,64,31.91
Camille,Rell,66,35,31,53.03
Camille,Milio,67,42,25,62.69
Camille,Zeri,62,21,41,33.87
Camille,Lulu,213,91,122,42.72
Camille,Zac,55,35,20,63.64
Camille,Naafiri,28,7,21,25
Camille,Ornn,59,23,36,38.98
Camille,Olaf,25,7,18,28
Camille,Skarner,36,19,17,52.78
Camille,Aphelios,67,28,39,41.79
Camille,JarvanIV,99,47,52,47.47
Camille,Nidalee,39,30,9,76.92
Camille,Yorick,37,24,13,64.86
Camille,Blitzcrank,65,37,28,56.92
Camille,Gwen,61,30,31,49.18
Camille,Karthus,39,16,23,41.03
Camille,Chogath,122,45,77,36.89
Camille,Samira,63,34,29,53.97
Camille,Urgot,48,13,35,27.08
Camille,Syndra,75,34,41,45.33
Camille,Vayne,159,92,67,57.86
Camille,Taliyah,24,10,14,41.67
Camille,Sylas,188,102,86,54.26
Camille,Yasuo,182,78,104,42.86
Camille,Teemo,67,28,39,41.79
Camille,Ahri,129,61,68,47.29
Camille,Viego,105,44,61,41.9
Camille,Morgana,106,51,55,48.11
Camille,Udyr,30,20,10,66.67
Camille,Jax,90,46,44,51.11
Camille,TahmKench,93,34,59,36.56
Camille,Sion,73,40,33,54.79
Camille,Qiyana,23,0,23,0
Camille,XinZhao,73,26,47,35.62
Camille,Thresh,169,86,83,50.89
Camille,Ryze,39,22,17,56.41
Camille,Sejuani,92,33,59,35.87
Camille,Fizz,47,23,24,48.94
Camille,Rammus,21,12,9,57.14
Camille,Kindred,34,20,14,58.82
Camille,Talon,67,36,31,53.73
Camille,Malphite,85,44,41,51.76
Camille,Annie,18,9,9,50
Camille,Kayn,93,46,47,49.46
Camille,Riven,39,15,24,38.46
Camille,Ekko,68,20,48,29.41
Camille,Senna,56,27,29,48.21
Camille,Briar,35,15,20,42.86
Camille,Xerath,65,27,38,41.54
Camille,Rengar,37,23,14,62.16
Camille,Galio,129,57,72,44.19
Camille,Ivern,24,13,11,54.17
Camille,LeeSin,211,120,91,56.87
Camille,TwistedFate,36,21,15,58.33
Camille,Hecarim,38,19,19,50
Camille,Kassadin,21,13,8,61.9
Camille,Garen,183,106,77,57.92
Camille,Kalista,31,12,19,38.71
Camille,Pyke,70,31,39,44.29
Camille,Singed,24,19,5,79.17
Camille,Nasus,82,36,46,43.9
Camille,Graves,86,45,41,52.33
Camille,AurelionSol,47,19,28,40.43
Camille,Mordekaiser,105,46,59,43.81
Camille,Evelynn,17,7,10,41.18
Camille,Janna,33,14,19,42.42
Camille,Kennen,30,12,18,40
Camille,Akshan,34,26,8,76.47
Camille,Gangplank,52,18,34,34.62
Camille,Vladimir,71,25,46,35.21
Camille,Nautilus,127,61,66,48.03
Camille,Kayle,42,28,14,66.67
Camille,Kled,17,6,11,35.29
Camille,Velkoz,56,36,20,64.29
Camille,Gragas,89,42,47,47.19
Camille,Neeko,27,18,9,66.67
Camille,Akali,75,34,41,45.33
Camille,Nilah,46,15,31,32.61
Camille,Jayce,72,30,42,41.67
Camille,KogMaw,21,3,18,14.29
Camille,Quinn,28,16,12,57.14
Camille,Azir,49,30,19,61.22
Camille,Corki,55,30,25,54.55
Camille,Fiora,65,35,30,53.85
Camille,Xayah,68,22,46,32.35
Camille,Vi,127,73,54,57.48
Camille,RekSai,15,8,7,53.33
Camille,Alistar,56,31,25,55.36
Camille,Bard,35,17,18,48.57
Camille,Nunu,49,20,29,40.82
Camille,Cassiopeia,30,10,20,33.33
Camille,Taric,18,9,9,50
Camille,Lissandra,37,14,23,37.84
Camille,Zilean,20,4,16,20
Camille,Ziggs,35,16,19,45.71
Camille,Anivia,54,23,31,42.59
Camille,Elise,51,31,20,60.78
Camille,Tryndamere,28,19,9,67.86
Camille,Lillia,44,26,18,59.09
Camille,Khazix,40,27,13,67.5
Camille,Renata,22,17,5,77.27
Camille,Shyvana,6,3,3,50
Vex,Camille,69,27,42,39.13
Vex,Diana,217,139,78,64.06
Vex,Malzahar,149,67,82,44.97
Vex,Sivir,110,47,63,42.73
Vex,Zyra,115,50,65,43.48
Vex,Malphite,167,69,98,41.32
Vex,Chogath,153,61,92,39.87
Vex,Yasuo,404,204,200,50.5
Vex,MissFortune,289,135,154,46.71
Vex,Yuumi,72,43,29,59.72
Vex,Heimerdinger,66,32,34,48.48
Vex,Nunu,61,27,34,44.26
Vex,Teemo,117,60,57,51.28
Vex,Alistar,76,37,39,48.68
Vex,Garen,228,123,105,53.95
Vex,Sejuani,123,44,79,35.77
Vex,Akali,151,91,60,60.26
Vex,Ezreal,322,168,154,52.17
Vex,Karma,198,98,100,49.49
Vex,Shaco,93,43,50,46.24
Vex,Jhin,263,143,120,54.37
Vex,Milio,59,29,30,49.15
Vex,Volibear,126,73,53,57.94
Vex,Jax,113,74,39,65.49
Vex,Ashe,290,149,141,51.38
Vex,Pantheon,206,118,88,57.28
Vex,Briar,63,35,28,55.56
Vex,Akshan,46,17,29,36.96
Vex,Samira,64,41,23,64.06
Vex,Lulu,141,74,67,52.48
Vex,Sion,115,50,65,43.48
Vex,Katarina,87,53,34,60.92
Vex,Mel,166,78,88,46.99
Vex,Gwen,84,38,46,45.24
Vex,Nocturne,167,78,89,46.71
Vex,Aurora,123,61,62,49.59
Vex,Caitlyn,283,147,136,51.94
Vex,Morgana,139,58,81,41.73
Vex,Kennen,46,19,27,41.3
Vex,Kayn,151,86,65,56.95
Vex,Jinx,296,136,160,45.95
Vex,Illaoi,92,56,36,60.87
Vex,Veigar,147,61,86,41.5
Vex,Xayah,115,54,61,46.96
Vex,Brand,69,38,31,55.07
Vex,MasterYi,114,72,42,63.16
Vex,Urgot,60,27,33,45
Vex,Karthus,36,21,15,58.33
Vex,Kaisa,247,155,92,62.75
Vex,Swain,146,72,74,49.32
Vex,Warwick,147,68,79,46.26
Vex,Lux,352,207,145,58.81
Vex,Viktor,130,77,53,59.23
Vex,Qiyana,54,37,17,68.52
Vex,Darius,259,136,123,52.51
Vex,JarvanIV,104,58,46,55.77
Vex,Leblanc,111,63,48,56.76
Vex,Lucian,129,77,52,59.69
Vex,Nami,120,46,74,38.33
Vex,Yorick,118,62,56,52.54
Vex,Orianna,61,38,23,62.3
Vex,Talon,80,44,36,55
Vex,Nilah,46,28,18,60.87
Vex,KSante,86,40,46,46.51
Vex,FiddleSticks,88,31,57,35.23
Vex,Tristana,108,44,64,40.74
Vex,Leona,121,48,73,39.67
Vex,Yone,303,137,166,45.21
Vex,Vi,163,92,71,56.44
Vex,Nautilus,182,105,77,57.69
Vex,XinZhao,91,64,27,70.33
Vex,Lillia,91,41,50,45.05
Vex,DrMundo,46,22,24,47.83
Vex,TahmKench,120,74,46,61.67
Vex,Zeri,43,20,23,46.51
Vex,Varus,135,71,64,52.59
Vex,Seraphine,113,63,50,55.75
Vex,Shen,62,38,24,61.29
Vex,Syndra,109,72,37,66.06
Vex,Mordekaiser,151,85,66,56.29
Vex,Sett,178,91,87,51.12
Vex,LeeSin,236,121,115,51.27
Vex,Vayne,161,79,82,49.07
Vex,Soraka,34,22,12,64.71
Vex,Sylas,255,144,111,56.47
Vex,Braum,93,46,47,49.46
Vex,Taliyah,35,21,14,60
Vex,Gangplank,90,37,53,41.11
Vex,Riven,39,22,17,56.41
Vex,Evelynn,46,22,24,47.83
Vex,Ivern,26,12,14,46.15
Vex,Aphelios,80,38,42,47.5
Vex,Rell,106,47,59,44.34
Vex,Ekko,110,61,49,55.45
Vex,Blitzcrank,137,69,68,50.36
Vex,Ahri,191,95,96,49.74
Vex,Singed,27,15,12,55.56
Vex,Kindred,73,44,29,60.27
Vex,Zed,132,77,55,58.33
Vex,Rakan,107,62,45,57.94
Vex,Gragas,88,59,29,67.05
Vex,Kled,18,6,12,33.33
Vex,Ambessa,100,40,60,40
Vex,Viego,183,87,96,47.54
Vex,Irelia,97,50,47,51.55
Vex,Khazix,55,22,33,40
Vex,Udyr,64,43,21,67.19
Vex,Bard,30,19,11,63.33
Vex,Pyke,112,64,48,57.14
Vex,Neeko,55,36,19,65.45
Vex,Draven,58,34,24,58.62
Vex,Thresh,202,109,93,53.96
Vex,Zoe,35,21,14,60
Vex,Nasus,81,44,37,54.32
Vex,Zac,111,76,35,68.47
Vex,Poppy,103,53,50,51.46
Vex,Fiora,42,23,19,54.76
Vex,Amumu,151,51,100,33.77
Vex,Naafiri,64,31,33,48.44
Vex,Nidalee,43,26,17,60.47
Vex,KogMaw,55,31,24,56.36
Vex,Lissandra,45,33,12,73.33
Vex,Elise,111,59,52,53.15
Vex,Azir,52,47,5,90.38
Vex,Janna,30,17,13,56.67
Vex,Velkoz,46,31,15,67.39
Vex,Hwei,100,49,51,49
Vex,Xerath,116,59,57,50.86
Vex,Fizz,64,38,26,59.38
Vex,Hecarim,27,14,13,51.85
Vex,Twitch,68,37,31,54.41
Vex,Kayle,63,35,28,55.56
Vex,Galio,141,74,67,52.48
Vex,Kalista,41,20,21,48.78
Vex,AurelionSol,27,6,21,22.22
Vex,Senna,73,34,39,46.58
Vex,Shyvana,35,18,17,51.43
Vex,Skarner,42,25,17,59.52
Vex,MonkeyKing,73,32,41,43.84
Vex,Taric,38,29,9,76.32
Vex,Smolder,62,34,28,54.84
Vex,Olaf,42,16,26,38.1
Vex,Aatrox,103,47,56,45.63
Vex,Vladimir,71,46,25,64.79
Vex,Ornn,57,33,24,57.89
Vex,Renekton,59,36,23,61.02
Vex,Ziggs,48,16,32,33.33
Vex,Tryndamere,50,21,29,42
Vex,Ryze,43,20,23,46.51
Vex,TwistedFate,43,24,19,55.81
Vex,Corki,56,27,29,48.21
Vex,RekSai,15,9,6,60
Vex,Rengar,22,19,3,86.36
Vex,Zilean,25,14,11,56
Vex,Rammus,57,24,33,42.11
Vex,Anivia,39,24,15,61.54
Vex,Renata,37,21,16,56.76
Vex,Maokai,68,36,32,52.94
Vex,Jayce,67,32,35,47.76
Vex,Annie,43,18,25,41.86
Vex,Rumble,40,26,14,65
Vex,Cassiopeia,20,9,11,45
Vex,Kassadin,34,20,14,58.82
Vex,Quinn,41,14,27,34.15
Vex,Sona,29,15,14,51.72
Vex,Gnar,37,19,18,51.35
Vex,Trundle,40,24,16,60
Vex,Graves,81,45,36,55.56
Vex,Belveth,14,8,6,57.14
Fizz,Malphite,109,53,56,48.62
Fizz,Chogath,159,65,94,40.88
Fizz,Yasuo,213,113,100,53.05
Fizz,MissFortune,237,107,130,45.15
Fizz,Yuumi,78,43,35,55.13
Fizz,Darius,197,90,107,45.69
Fizz,Aurora,76,45,31,59.21
Fizz,Corki,43,14,29,32.56
Fizz,Briar,75,32,43,42.67
Fizz,Sejuani,64,24,40,37.5
Fizz,Tryndamere,43,21,22,48.84
Fizz,MasterYi,106,59,47,55.66
Fizz,Akali,109,51,58,46.79
Fizz,KogMaw,33,19,14,57.58
Fizz,Swain,108,53,55,49.07
Fizz,Malzahar,131,48,83,36.64
Fizz,Gragas,79,45,34,56.96
Fizz,Ezreal,244,134,110,54.92
Fizz,Lulu,169,78,91,46.15
Fizz,Yorick,83,23,60,27.71
Fizz,Warwick,187,83,104,44.39
Fizz,Annie,47,30,17,63.83
Fizz,Jhin,235,129,106,54.89
Fizz,Nautilus,143,84,59,58.74
Fizz,Khazix,75,38,37,50.67
Fizz,Karma,102,59,43,57.84
Fizz,Illaoi,49,20,29,40.82
Fizz,Amumu,130,57,73,43.85
Fizz,Vladimir,58,15,43,25.86
Fizz,Lux,256,125,131,48.83
Fizz,Jax,72,33,39,45.83
Fizz,Mordekaiser,131,48,83,36.64
Fizz,Ashe,174,77,97,44.25
Fizz,Rammus,71,28,43,39.44
Fizz,Mel,315,154,161,48.89
Fizz,Pantheon,146,69,77,47.26
Fizz,Heimerdinger,45,19,26,42.22
Fizz,Poppy,87,42,45,48.28
Fizz,Zilean,33,18,15,54.55
Fizz,Xayah,49,28,21,57.14
Fizz,Brand,68,28,40,41.18
Fizz,Kindred,44,24,20,54.55
Fizz,Veigar,191,84,107,43.98
Fizz,Aatrox,73,38,35,52.05
Fizz,TahmKench,100,44,56,44
Fizz,Rengar,24,15,9,62.5
Fizz,Sylas,143,68,75,47.55
Fizz,Tristana,121,53,68,43.8
Fizz,Viego,86,41,45,47.67
Fizz,Hwei,61,37,24,60.66
Fizz,Caitlyn,233,108,125,46.35
Fizz,Teemo,89,37,52,41.57
Fizz,Gwen,47,17,30,36.17
Fizz,Skarner,50,9,41,18
Fizz,AurelionSol,69,32,37,46.38
Fizz,Garen,172,73,99,42.44
Fizz,Lillia,60,35,25,58.33
Fizz,Lucian,101,48,53,47.52
Fizz,Diana,132,61,71,46.21
Fizz,Elise,91,35,56,38.46
Fizz,Jinx,284,110,174,38.73
Fizz,Quinn,27,24,3,88.89
Fizz,Vi,138,59,79,42.75
Fizz,Katarina,51,34,17,66.67
Fizz,Zac,68,53,15,77.94
Fizz,Kaisa,150,79,71,52.67
Fizz,Riven,58,27,31,46.55
Fizz,Zoe,26,21,5,80.77
Fizz,Sett,138,72,66,52.17
Fizz,Shaco,101,52,49,51.49
Fizz,Alistar,54,27,27,50
Fizz,Singed,31,18,13,58.06
Fizz,Milio,69,26,43,37.68
Fizz,Shen,93,50,43,53.76
Fizz,Samira,97,54,43,55.67
Fizz,Taric,17,3,14,17.65
Fizz,Irelia,82,37,45,45.12
Fizz,Draven,53,32,21,60.38
Fizz,Soraka,42,21,21,50
Fizz,Zyra,80,33,47,41.25
Fizz,LeeSin,152,62,90,40.79
Fizz,Volibear,130,57,73,43.85
Fizz,Yone,124,72,52,58.06
Fizz,DrMundo,75,51,24,68
Fizz,Anivia,48,22,26,45.83
Fizz,Vayne,135,53,82,39.26
Fizz,Nami,93,39,54,41.94
Fizz,Sion,99,35,64,35.35
Fizz,Thresh,143,63,80,44.06
Fizz,Orianna,43,22,21,51.16
Fizz,Nocturne,97,54,43,55.67
Fizz,Velkoz,69,38,31,55.07
Fizz,Evelynn,44,21,23,47.73
Fizz,Naafiri,32,22,10,68.75
Fizz,Aphelios,40,29,11,72.5
Fizz,Xerath,128,60,68,46.88
Fizz,Kayn,128,82,46,64.06
Fizz,Galio,104,54,50,51.92
Fizz,Smolder,75,34,41,45.33
Fizz,Renekton,62,31,31,50
Fizz,Kled,25,13,12,52
Fizz,FiddleSticks,48,12,36,25
Fizz,Ivern,24,12,12,50
Fizz,Varus,102,57,45,55.88
Fizz,Kalista,23,9,14,39.13
Fizz,Gangplank,53,26,27,49.06
Fizz,Shyvana,40,18,22,45
Fizz,Kassadin,21,8,13,38.1
Fizz,Viktor,121,68,53,56.2
Fizz,Ambessa,43,23,20,53.49
Fizz,Braum,126,59,67,46.83
Fizz,Leblanc,64,19,45,29.69
Fizz,Belveth,17,3,14,17.65
Fizz,Qiyana,23,12,11,52.17
Fizz,Leona,112,56,56,50
Fizz,Urgot,49,17,32,34.69
Fizz,Ekko,97,39,58,40.21
Fizz,Camille,47,24,23,51.06
Fizz,Sivir,52,37,15,71.15
Fizz,Sona,16,13,3,81.25
Fizz,Zed,108,42,66,38.89
Fizz,Pyke,105,62,43,59.05
Fizz,Syndra,91,43,48,47.25
Fizz,Karthus,32,24,8,75
Fizz,Kennen,41,23,18,56.1
Fizz,Trundle,73,27,46,36.99
Fizz,XinZhao,71,33,38,46.48
Fizz,Blitzcrank,79,36,43,45.57
Fizz,Rumble,27,13,14,48.15
Fizz,Hecarim,23,15,8,65.22
Fizz,Cassiopeia,31,6,25,19.35
Fizz,Rell,63,34,29,53.97
Fizz,Neeko,45,19,26,42.22
Fizz,Ahri,102,44,58,43.14
Fizz,Nasus,87,29,58,33.33
Fizz,Nunu,82,46,36,56.1
Fizz,Ornn,55,34,21,61.82
Fizz,Senna,64,16,48,25
Fizz,Twitch,84,35,49,41.67
Fizz,MonkeyKing,81,31,50,38.27
Fizz,KSante,57,33,24,57.89
Fizz,Vex,64,26,38,40.63
Fizz,Morgana,97,48,49,49.48
Fizz,Lissandra,42,14,28,33.33
Fizz,Akshan,32,14,18,43.75
Fizz,Maokai,40,17,23,42.5
Fizz,Gnar,46,17,29,36.96
Fizz,Azir,17,14,3,82.35
Fizz,Rakan,60,35,25,58.33
Fizz,Seraphine,86,58,28,67.44
Fizz,Graves,67,23,44,34.33
Fizz,Nilah,15,6,9,40
Fizz,JarvanIV,86,44,42,51.16
Fizz,Olaf,27,13,14,48.15
Fizz,Fiora,39,13,26,33.33
Fizz,Renata,22,12,10,54.55
Fizz,Kayle,43,21,22,48.84
Fizz,Ryze,50,24,26,48
Fizz,Bard,19,8,11,42.11
Fizz,Jayce,41,17,24,41.46
Fizz,Janna,32,12,20,37.5
Fizz,Taliyah,22,2,20,9.09
Fizz,Talon,34,16,18,47.06
Fizz,TwistedFate,42,32,10,76.19
Fizz,Udyr,23,12,11,52.17
Fizz,Ziggs,32,17,15,53.13
Fizz,Nidalee,22,14,8,63.64
Fizz,Zeri,22,11,11,50
Fizz,RekSai,13,7,6,53.85
Janna,Yorick,34,11,23,32.35
Janna,Kayn,83,40,43,48.19
Janna,Sylas,84,47,37,55.95
Janna,MissFortune,91,46,45,50.55
Janna,Renata,9,3,6,33.33
Janna,Aphelios,44,20,24,45.45
Janna,Udyr,19,16,3,84.21
Janna,Yasuo,98,44,54,44.9
Janna,Lucian,69,34,35,49.28
Janna,Karthus,11,3,8,27.27
Janna,Ambessa,72,40,32,55.56
Janna,Ekko,63,30,33,47.62
Janna,Lux,116,42,74,36.21
Janna,Caitlyn,167,99,68,59.28
Janna,Soraka,30,15,15,50
Janna,Vladimir,28,14,14,50
Janna,Viego,97,40,57,41.24
Janna,Hwei,53,37,16,69.81
Janna,Tristana,70,44,26,62.86
Janna,Lulu,108,48,60,44.44
Janna,Renekton,26,8,18,30.77
Janna,Jax,69,37,32,53.62
Janna,Leblanc,40,31,9,77.5
Janna,Thresh,138,83,55,60.14
Janna,Jayce,41,25,16,60.98
Janna,Vi,66,46,20,69.7
Janna,Orianna,54,34,20,62.96
Janna,Jhin,136,80,56,58.82
Janna,Volibear,63,34,29,53.97
Janna,Elise,67,34,33,50.75
Janna,Syndra,42,14,28,33.33
Janna,Leona,101,46,55,45.54
Janna,Nasus,51,38,13,74.51
Janna,Amumu,69,28,41,40.58
Janna,Naafiri,29,15,14,51.72
Janna,Varus,65,42,23,64.62
Janna,Zyra,40,14,26,35
Janna,Ornn,48,27,21,56.25
Janna,Gragas,74,45,29,60.81
Janna,Bard,23,18,5,78.26
Janna,Darius,106,51,55,48.11
Janna,Malzahar,63,30,33,47.62
Janna,JarvanIV,83,45,38,54.22
Janna,Yuumi,54,36,18,66.67
Janna,TahmKench,65,29,36,44.62
Janna,Rengar,17,8,9,47.06
Janna,Jinx,178,89,89,50
Janna,Milio,48,30,18,62.5
Janna,Sejuani,57,17,40,29.82
Janna,Aurora,87,32,55,36.78
Janna,Kaisa,96,58,38,60.42
Janna,Nautilus,95,41,54,43.16
Janna,Yone,103,56,47,54.37
Janna,Galio,74,46,28,62.16
Janna,Ziggs,37,19,18,51.35
Janna,Chogath,104,53,51,50.96
Janna,Tryndamere,23,15,8,65.22
Janna,Viktor,61,24,37,39.34
Janna,Shen,65,34,31,52.31
Janna,Diana,87,45,42,51.72
Janna,Rell,90,50,40,55.56
Janna,Irelia,63,28,35,44.44
Janna,Zeri,36,17,19,47.22
Janna,Mordekaiser,94,55,39,58.51
Janna,Mel,126,81,45,64.29
Janna,Nami,95,65,30,68.42
Janna,Nunu,35,22,13,62.86
Janna,Xerath,42,19,23,45.24
Janna,Nidalee,32,16,16,50
Janna,Braum,61,28,33,45.9
Janna,Shaco,53,36,17,67.92
Janna,Kassadin,23,5,18,21.74
Janna,Ezreal,166,76,90,45.78
Janna,Gnar,35,21,14,60
Janna,Trundle,41,28,13,68.29
Janna,Morgana,70,40,30,57.14
Janna,Ashe,140,68,72,48.57
Janna,Veigar,50,29,21,58
Janna,Karma,104,47,57,45.19
Janna,MasterYi,68,39,29,57.35
Janna,Swain,64,43,21,67.19
Janna,Brand,40,31,9,77.5
Janna,Urgot,32,23,9,71.88
Janna,DrMundo,20,11,9,55
Janna,Pantheon,88,57,31,64.77
Janna,Xayah,57,39,18,68.42
Janna,Rakan,61,31,30,50.82
Janna,Katarina,36,23,13,63.89
Janna,KSante,45,31,14,68.89
Janna,Quinn,36,9,27,25
Janna,Fiora,16,5,11,31.25
Janna,Riven,30,16,14,53.33
Janna,Qiyana,8,5,3,62.5
Janna,Kindred,38,25,13,65.79
Janna,Lissandra,20,15,5,75
Janna,LeeSin,118,60,58,50.85
Janna,Warwick,71,38,33,53.52
Janna,Sona,24,17,7,70.83
Janna,Olaf,21,14,7,66.67
Janna,Vayne,86,56,30,65.12
Janna,Zac,59,25,34,42.37
Janna,Kennen,34,17,17,50
Janna,Shyvana,23,5,18,21.74
Janna,Poppy,52,43,9,82.69
Janna,Samira,75,30,45,40
Janna,MonkeyKing,44,26,18,59.09
Janna,Singed,30,9,21,30
Janna,Ivern,12,6,6,50
Janna,Talon,26,10,16,38.46
Janna,Kayle,46,19,27,41.3
Janna,Malphite,77,39,38,50.65
Janna,Sett,83,27,56,32.53
Janna,Briar,29,11,18,37.93
Janna,Draven,35,11,24,31.43
Janna,Pyke,52,31,21,59.62
Janna,Teemo,60,38,22,63.33
Janna,Nocturne,61,25,36,40.98
Janna,Anivia,34,15,19,44.12
Janna,Blitzcrank,47,26,21,55.32
Janna,Smolder,54,20,34,37.04
Janna,KogMaw,11,6,5,54.55
Janna,Khazix,37,15,22,40.54
Janna,Annie,11,5,6,45.45
Janna,Ahri,103,54,49,52.43
Janna,XinZhao,50,39,11,78
Janna,FiddleSticks,21,8,13,38.1
Janna,Zed,69,39,30,56.52
Janna,Zoe,35,17,18,48.57
Janna,Gangplank,41,27,14,65.85
Janna,Graves,43,15,28,34.88
Janna,Vex,30,13,17,43.33
Janna,Sivir,25,16,9,64
Janna,Aatrox,68,38,30,55.88
Janna,Zilean,25,20,5,80
Janna,Garen,106,56,50,52.83
Janna,Camille,33,19,14,57.58
Janna,Hecarim,29,12,17,41.38
Janna,Rammus,10,7,3,70
Janna,Seraphine,32,18,14,56.25
Janna,Gwen,39,19,20,48.72
Janna,Sion,53,35,18,66.04
Janna,Neeko,27,13,14,48.15
Janna,Senna,48,27,21,56.25
Janna,Illaoi,30,19,11,63.33
Janna,AurelionSol,28,15,13,53.57
Janna,Evelynn,24,15,9,62.5
Janna,Twitch,43,32,11,74.42
Janna,Alistar,44,17,27,38.64
Janna,Lillia,31,13,18,41.94
Janna,Cassiopeia,19,10,9,52.63
Janna,Taliyah,22,17,5,77.27
Janna,Nilah,27,12,15,44.44
Janna,Akshan,26,12,14,46.15
Janna,Ryze,22,14,8,63.64
Janna,Kalista,20,13,7,65
Janna,Skarner,12,4,8,33.33
Janna,Belveth,20,7,13,35
Janna,Azir,35,22,13,62.86
Janna,Akali,79,32,47,40.51
Janna,TwistedFate,17,10,7,58.82
Janna,Fizz,32,20,12,62.5
Janna,Maokai,25,5,20,20
Janna,Velkoz,40,21,19,52.5
Janna,Taric,4,4,0,100
Janna,Corki,20,5,15,25
Janna,Rumble,11,3,8,27.27
Janna,RekSai,12,12,0,100
Janna,Kled,9,9,0,100
Janna,Heimerdinger,8,2,6,25
Nidalee,Nasus,56,24,32,42.86
Nidalee,Viego,129,40,89,31.01
Nidalee,Cassiopeia,41,11,30,26.83
Nidalee,Ezreal,264,99,165,37.5
Nidalee,Karma,118,56,62,47.46
Nidalee,Yorick,55,11,44,20
Nidalee,Kayn,63,25,38,39.68
Nidalee,Swain,66,19,47,28.79
Nidalee,Caitlyn,218,85,133,38.99
Nidalee,Shen,57,24,33,42.11
Nidalee,Gnar,57,21,36,36.84
Nidalee,Udyr,39,16,23,41.03
Nidalee,Aatrox,120,55,65,45.83
Nidalee,MissFortune,123,59,64,47.97
Nidalee,Nautilus,116,36,80,31.03
Nidalee,Varus,70,39,31,55.71
Nidalee,DrMundo,38,21,17,55.26
Nidalee,Aurora,64,35,29,54.69
Nidalee,Rakan,42,23,19,54.76
Nidalee,Shaco,71,29,42,40.85
Nidalee,Darius,133,62,71,46.62
Nidalee,Sett,113,52,61,46.02
Nidalee,Lux,194,85,109,43.81
Nidalee,Riven,29,11,18,37.93
Nidalee,MonkeyKing,79,41,38,51.9
Nidalee,AurelionSol,19,8,11,42.11
Nidalee,Ashe,194,118,76,60.82
Nidalee,Poppy,77,34,43,44.16
Nidalee,Diana,153,67,86,43.79
Nidalee,LeeSin,241,117,124,48.55
Nidalee,Galio,123,56,67,45.53
Nidalee,Twitch,38,19,19,50
Nidalee,Lulu,122,59,63,48.36
Nidalee,Ekko,70,24,46,34.29
Nidalee,Ahri,123,59,64,47.97
Nidalee,Lucian,93,46,47,49.46
Nidalee,Nami,77,24,53,31.17
Nidalee,TahmKench,77,31,46,40.26
Nidalee,Malzahar,76,28,48,36.84
Nidalee,Draven,51,16,35,31.37
Nidalee,Blitzcrank,91,30,61,32.97
Nidalee,KSante,68,30,38,44.12
Nidalee,FiddleSticks,42,10,32,23.81
Nidalee,Tristana,63,27,36,42.86
Nidalee,Leona,71,35,36,49.3
Nidalee,Heimerdinger,28,14,14,50
Nidalee,Zoe,47,19,28,40.43
Nidalee,Sylas,120,64,56,53.33
Nidalee,Smolder,56,29,27,51.79
Nidalee,Morgana,59,25,34,42.37
Nidalee,Zed,80,55,25,68.75
Nidalee,Singed,12,6,6,50
Nidalee,Khazix,66,36,30,54.55
Nidalee,Irelia,57,19,38,33.33
Nidalee,Malphite,68,44,24,64.71
Nidalee,Talon,55,22,33,40
Nidalee,Qiyana,27,16,11,59.26
Nidalee,Yone,145,69,76,47.59
Nidalee,Belveth,22,14,8,63.64
Nidalee,Vladimir,68,28,40,41.18
Nidalee,Mel,184,92,92,50
Nidalee,Soraka,56,31,25,55.36
Nidalee,Kayle,43,17,26,39.53
Nidalee,Zac,76,27,49,35.53
Nidalee,Jhin,182,73,109,40.11
Nidalee,Xerath,85,33,52,38.82
Nidalee,Xayah,61,30,31,49.18
Nidalee,Senna,29,21,8,72.41
Nidalee,Vayne,92,38,54,41.3
Nidalee,Kindred,12,0,12,0
Nidalee,Yasuo,115,35,80,30.43
Nidalee,Nilah,25,14,11,56
Nidalee,Yuumi,100,45,55,45
Nidalee,Pantheon,158,68,90,43.04
Nidalee,JarvanIV,81,41,40,50.62
Nidalee,Akali,100,39,61,39
Nidalee,Janna,32,16,16,50
Nidalee,Garen,126,60,66,47.62
Nidalee,Volibear,47,27,20,57.45
Nidalee,Kaisa,171,60,111,35.09
Nidalee,Amumu,90,34,56,37.78
Nidalee,Warwick,67,14,53,20.9
Nidalee,Rell,69,22,47,31.88
Nidalee,Camille,39,9,30,23.08
Nidalee,Mordekaiser,99,54,45,54.55
Nidalee,Gragas,68,36,32,52.94
Nidalee,Lissandra,38,16,22,42.11
Nidalee,Elise,82,37,45,45.12
Nidalee,Urgot,42,12,30,28.57
Nidalee,Leblanc,35,16,19,45.71
Nidalee,Corki,33,13,20,39.39
Nidalee,Illaoi,21,9,12,42.86
Nidalee,Sivir,45,19,26,42.22
Nidalee,Syndra,52,20,32,38.46
Nidalee,Ambessa,73,28,45,38.36
Nidalee,Veigar,60,19,41,31.67
Nidalee,Seraphine,60,16,44,26.67
Nidalee,Sion,53,23,30,43.4
Nidalee,Samira,58,20,38,34.48
Nidalee,Renekton,72,37,35,51.39
Nidalee,Hwei,82,55,27,67.07
Nidalee,Rumble,35,18,17,51.43
Nidalee,Hecarim,23,14,9,60.87
Nidalee,Taliyah,17,9,8,52.94
Nidalee,Zyra,74,25,49,33.78
Nidalee,Tryndamere,26,17,9,65.38
Nidalee,MasterYi,63,33,30,52.38
Nidalee,Azir,43,23,20,53.49
Nidalee,Chogath,90,44,46,48.89
Nidalee,Brand,34,27,7,79.41
Nidalee,Jax,64,36,28,56.25
Nidalee,Sejuani,52,23,29,44.23
Nidalee,Viktor,62,16,46,25.81
Nidalee,Vex,43,17,26,39.53
Nidalee,Thresh,159,66,93,41.51
Nidalee,Milio,53,25,28,47.17
Nidalee,TwistedFate,30,15,15,50
Nidalee,Shyvana,17,15,2,88.24
Nidalee,Akshan,34,19,15,55.88
Nidalee,Zilean,27,8,19,29.63
Nidalee,KogMaw,10,2,8,20
Nidalee,Braum,46,27,19,58.7
Nidalee,Kalista,28,12,16,42.86
Nidalee,Olaf,35,19,16,54.29
Nidalee,Rammus,21,5,16,23.81
Nidalee,Katarina,43,17,26,39.53
Nidalee,Gwen,33,16,17,48.48
Nidalee,Briar,39,16,23,41.03
Nidalee,XinZhao,55,25,30,45.45
Nidalee,Skarner,37,7,30,18.92
Nidalee,Teemo,83,34,49,40.96
Nidalee,Kassadin,8,3,5,37.5
Nidalee,Taric,15,13,2,86.67
Nidalee,Nocturne,78,39,39,50
Nidalee,Fiora,33,13,20,39.39
Nidalee,Orianna,56,13,43,23.21
Nidalee,Alistar,33,16,17,48.48
Nidalee,Lillia,47,20,27,42.55
Nidalee,Zeri,39,22,17,56.41
Nidalee,Maokai,55,28,27,50.91
Nidalee,Ornn,59,21,38,35.59
Nidalee,Jinx,222,100,122,45.05
Nidalee,Nunu,42,15,27,35.71
Nidalee,Rengar,31,18,13,58.06
Nidalee,Anivia,36,25,11,69.44
Nidalee,Pyke,71,29,42,40.85
Nidalee,Quinn,26,10,16,38.46
Nidalee,Karthus,29,12,17,41.38
Nidalee,Kennen,27,8,19,29.63
Nidalee,Gangplank,42,13,29,30.95
Nidalee,Trundle,23,5,18,21.74
Nidalee,Bard,11,5,6,45.45
Nidalee,Aphelios,26,13,13,50
Nidalee,Renata,8,5,3,62.5
Nidalee,Graves,91,36,55,39.56
Nidalee,Fizz,22,8,14,36.36
Nidalee,Kled,10,3,7,30
Nidalee,Velkoz,18,13,5,72.22
Nidalee,Neeko,38,9,29,23.68
Nidalee,Vi,76,36,40,47.37
Nidalee,Ivern,12,0,12,0
Nidalee,Annie,36,15,21,41.67
Nidalee,Jayce,43,14,29,32.56
Nidalee,Evelynn,16,8,8,50
Nidalee,Ryze,36,9,27,25
Nidalee,Ziggs,19,8,11,42.11
Nidalee,Naafiri,23,11,12,47.83
Nidalee,Sona,19,5,14,26.32
Nidalee,RekSai,11,11,0,100
Brand,Nasus,122,66,56,54.1
Brand,Viego,141,53,88,37.59
Brand,Cassiopeia,26,16,10,61.54
Brand,Ezreal,312,187,125,59.94
Brand,Karma,115,39,76,33.91
Brand,Mordekaiser,172,76,96,44.19
Brand,Hecarim,41,19,22,46.34
Brand,Sett,149,64,85,42.95
Brand,Xayah,61,27,34,44.26
Brand,Lulu,163,74,89,45.4
Brand,Sion,119,64,55,53.78
Brand,Ambessa,106,55,51,51.89
Brand,Viktor,148,57,91,38.51
Brand,Jinx,339,116,223,34.22
Brand,Mel,267,159,108,59.55
Brand,MasterYi,114,38,76,33.33
Brand,Chogath,115,55,60,47.83
Brand,Amumu,210,104,106,49.52
Brand,Nocturne,148,72,76,48.65
Brand,Poppy,76,37,39,48.68
Brand,Caitlyn,354,173,181,48.87
Brand,Gangplank,74,43,31,58.11
Brand,Ekko,116,57,59,49.14
Brand,Elise,98,29,69,29.59
Brand,Alistar,44,31,13,70.45
Brand,Draven,71,47,24,66.2
Brand,Camille,35,16,19,45.71
Brand,Akali,141,71,70,50.35
Brand,Shaco,98,61,37,62.24
Brand,Jhin,230,106,124,46.09
Brand,Milio,74,28,46,37.84
Brand,Nunu,94,52,42,55.32
Brand,Lux,370,166,204,44.86
Brand,Diana,201,96,105,47.76
Brand,Velkoz,80,26,54,32.5
Brand,Ashe,275,113,162,41.09
Brand,MissFortune,276,123,153,44.57
Brand,Warwick,164,65,99,39.63
Brand,Graves,51,29,22,56.86
Brand,Azir,35,23,12,65.71
Brand,Nami,104,45,59,43.27
Brand,Darius,188,79,109,42.02
Brand,Kayn,154,95,59,61.69
Brand,Fizz,68,40,28,58.82
Brand,Nautilus,179,96,83,53.63
Brand,Vex,69,31,38,44.93
Brand,Lucian,103,46,57,44.66
Brand,Morgana,140,65,75,46.43
Brand,Urgot,73,30,43,41.1
Brand,XinZhao,79,28,51,35.44
Brand,Vladimir,75,38,37,50.67
Brand,Ryze,40,21,19,52.5
Brand,Braum,129,56,73,43.41
Brand,Zyra,106,57,49,53.77
Brand,Briar,58,17,41,29.31
Brand,TwistedFate,56,32,24,57.14
Brand,Sivir,36,16,20,44.44
Brand,Yasuo,181,87,94,48.07
Brand,TahmKench,172,81,91,47.09
Brand,Leona,137,77,60,56.2
Brand,Jax,91,48,43,52.75
Brand,Evelynn,44,13,31,29.55
Brand,Kaisa,178,100,78,56.18
Brand,Seraphine,138,62,76,44.93
Brand,Garen,231,91,140,39.39
Brand,Hwei,73,26,47,35.62
Brand,Leblanc,58,32,26,55.17
Brand,Ivern,29,10,19,34.48
Brand,Teemo,148,57,91,38.51
Brand,Shen,119,67,52,56.3
Brand,Ziggs,40,20,20,50
Brand,Swain,149,75,74,50.34
Brand,Tristana,106,52,54,49.06
Brand,Kindred,39,20,19,51.28
Brand,Yone,174,71,103,40.8
Brand,Soraka,56,20,36,35.71
Brand,Rengar,54,40,14,74.07
Brand,Malzahar,137,83,54,60.58
Brand,Fiora,21,11,10,52.38
Brand,Sejuani,84,40,44,47.62
Brand,Volibear,152,63,89,41.45
Brand,Nilah,58,39,19,67.24
Brand,Pantheon,192,108,84,56.25
Brand,Vi,141,74,67,52.48
Brand,Zed,143,55,88,38.46
Brand,Aurora,82,41,41,50
Brand,JarvanIV,83,53,30,63.86
Brand,Ahri,172,83,89,48.26
Brand,Zeri,68,24,44,35.29
Brand,Jayce,42,23,19,54.76
Brand,AurelionSol,66,29,37,43.94
Brand,Yuumi,99,44,55,44.44
Brand,Sylas,130,73,57,56.15
Brand,Malphite,116,56,60,48.28
Brand,Twitch,101,42,59,41.58
Brand,Senna,68,24,44,35.29
Brand,Zoe,75,35,40,46.67
Brand,Gnar,76,35,41,46.05
Brand,Belveth,24,8,16,33.33
Brand,Irelia,73,35,38,47.95
Brand,Anivia,37,25,12,67.57
Brand,Katarina,92,50,42,54.35
Brand,Vayne,139,65,74,46.76
Brand,DrMundo,69,40,29,57.97
Brand,Rumble,26,13,13,50
Brand,Khazix,62,36,26,58.06
Brand,Corki,50,35,15,70
Brand,Aatrox,110,56,54,50.91
Brand,Udyr,51,43,8,84.31
Brand,Rell,86,41,45,47.67
Brand,Sona,21,10,11,47.62
Brand,Veigar,129,65,64,50.39
Brand,Bard,39,23,16,58.97
Brand,Yorick,113,44,69,38.94
Brand,Janna,40,9,31,22.5
Brand,Quinn,35,13,22,37.14
Brand,Rammus,28,17,11,60.71
Brand,Rakan,73,33,40,45.21
Brand,Ornn,64,29,35,45.31
Brand,Samira,88,40,48,45.45
Brand,Lissandra,32,14,18,43.75
Brand,Olaf,29,10,19,34.48
Brand,Thresh,205,117,88,57.07
Brand,Gragas,90,42,48,46.67
Brand,Neeko,55,30,25,54.55
Brand,Varus,88,45,43,51.14
Brand,Aphelios,53,20,33,37.74
Brand,Naafiri,35,15,20,42.86
Brand,Tryndamere,65,32,33,49.23
Brand,Gwen,61,26,35,42.62
Brand,Smolder,94,39,55,41.49
Brand,KSante,51,26,25,50.98
Brand,Karthus,39,22,17,56.41
Brand,Syndra,83,38,45,45.78
Brand,Blitzcrank,89,42,47,47.19
Brand,Taliyah,38,21,17,55.26
Brand,Orianna,43,22,21,51.16
Brand,Galio,122,60,62,49.18
Brand,LeeSin,157,82,75,52.23
Brand,FiddleSticks,93,44,49,47.31
Brand,Qiyana,42,21,21,50
Brand,Riven,48,10,38,20.83
Brand,Pyke,81,42,39,51.85
Brand,Skarner,59,23,36,38.98
Brand,Nidalee,34,7,27,20.59
Brand,Lillia,76,43,33,56.58
Brand,MonkeyKing,60,27,33,45
Brand,Illaoi,62,35,27,56.45
Brand,Heimerdinger,59,21,38,35.59
Brand,Talon,45,23,22,51.11
Brand,Zac,65,33,32,50.77
Brand,Xerath,83,41,42,49.4
Brand,Kayle,50,20,30,40
Brand,Singed,32,11,21,34.38
Brand,Akshan,25,23,2,92
Brand,Trundle,58,20,38,34.48
Brand,RekSai,31,19,12,61.29
Brand,Renata,24,14,10,58.33
Brand,Taric,15,6,9,40
Brand,Annie,55,31,24,56.36
Brand,Renekton,51,32,19,62.75
Brand,KogMaw,32,11,21,34.38
Brand,Kalista,39,19,20,48.72
Brand,Maokai,42,19,23,45.24
Brand,Kled,26,13,13,50
Brand,Zilean,34,17,17,50
Brand,Kassadin,21,4,17,19.05
Brand,Shyvana,27,9,18,33.33
Brand,Kennen,38,25,13,65.79
Kalista,Gangplank,49,31,18,63.27
Kalista,Pantheon,141,56,85,39.72
Kalista,TwistedFate,42,20,22,47.62
Kalista,Kaisa,113,54,59,47.79
Kalista,Braum,69,35,34,50.72
Kalista,Aatrox,97,45,52,46.39
Kalista,Teemo,74,34,40,45.95
Kalista,Aurora,70,43,27,61.43
Kalista,Sivir,50,13,37,26
Kalista,Blitzcrank,85,45,40,52.94
Kalista,Sett,109,45,64,41.28
Kalista,JarvanIV,71,24,47,33.8
Kalista,Veigar,74,22,52,29.73
Kalista,Lux,137,57,80,41.61
Kalista,Thresh,126,52,74,41.27
Kalista,Ivern,14,8,6,57.14
Kalista,Orianna,33,12,21,36.36
Kalista,Twitch,41,24,17,58.54
Kalista,Gnar,50,11,39,22
Kalista,Graves,72,41,31,56.94
Kalista,Ezreal,244,124,120,50.82
Kalista,Karma,69,35,34,50.72
Kalista,Shen,65,24,41,36.92
Kalista,Diana,134,76,58,56.72
Kalista,Yorick,59,33,26,55.93
Kalista,Nasus,64,33,31,51.56
Kalista,Darius,136,69,67,50.74
Kalista,Chogath,77,39,38,50.65
Kalista,Jinx,179,85,94,47.49
Kalista,Sona,29,11,18,37.93
Kalista,MonkeyKing,38,13,25,34.21
Kalista,Syndra,94,48,46,51.06
Kalista,Yasuo,153,80,73,52.29
Kalista,Caitlyn,166,80,86,48.19
Kalista,Heimerdinger,16,7,9,43.75
Kalista,XinZhao,39,12,27,30.77
Kalista,Malzahar,66,26,40,39.39
Kalista,Varus,51,22,29,43.14
Kalista,Maokai,33,25,8,75.76
Kalista,Warwick,101,51,50,50.5
Kalista,LeeSin,148,71,77,47.97
Kalista,Neeko,26,17,9,65.38
Kalista,Lucian,83,32,51,38.55
Kalista,Yone,128,57,71,44.53
Kalista,Viktor,96,35,61,36.46
Kalista,Vladimir,54,19,35,35.19
Kalista,Shyvana,26,12,14,46.15
Kalista,Katarina,75,28,47,37.33
Kalista,Draven,51,27,24,52.94
Kalista,Malphite,93,46,47,49.46
Kalista,MissFortune,177,99,78,55.93
Kalista,Elise,79,42,37,53.16
Kalista,Nocturne,84,40,44,47.62
Kalista,TahmKench,56,32,24,57.14
Kalista,Lillia,37,18,19,48.65
Kalista,AurelionSol,26,15,11,57.69
Kalista,Garen,145,64,81,44.14
Kalista,Viego,122,51,71,41.8
Kalista,Morgana,88,49,39,55.68
Kalista,Renekton,39,15,24,38.46
Kalista,Kindred,43,24,19,55.81
Kalista,Ahri,117,54,63,46.15
Kalista,Lulu,109,46,63,42.2
Kalista,Mordekaiser,123,72,51,58.54
Kalista,Hwei,61,28,33,45.9
Kalista,MasterYi,83,37,46,44.58
Kalista,Ashe,183,83,100,45.36
Kalista,Milio,55,26,29,47.27
Kalista,Nunu,38,23,15,60.53
Kalista,Vayne,89,31,58,34.83
Kalista,Rakan,40,6,34,15
Kalista,Illaoi,40,17,23,42.5
Kalista,Zac,65,29,36,44.62
Kalista,Mel,149,58,91,38.93
Kalista,Fizz,23,14,9,60.87
Kalista,Sejuani,55,23,32,41.82
Kalista,Sylas,124,56,68,45.16
Kalista,Jhin,140,70,70,50
Kalista,Nautilus,98,55,43,56.12
Kalista,Ambessa,54,26,28,48.15
Kalista,Udyr,27,10,17,37.04
Kalista,Seraphine,54,20,34,37.04
Kalista,Khazix,30,6,24,20
Kalista,Leona,77,38,39,49.35
Kalista,Jax,42,26,16,61.9
Kalista,Galio,86,48,38,55.81
Kalista,Velkoz,40,26,14,65
Kalista,Irelia,42,17,25,40.48
Kalista,Kayn,73,46,27,63.01
Kalista,Smolder,57,24,33,42.11
Kalista,Zyra,49,8,41,16.33
Kalista,Fiora,32,18,14,56.25
Kalista,Rell,47,20,27,42.55
Kalista,Nami,67,22,45,32.84
Kalista,Taliyah,15,8,7,53.33
Kalista,Riven,17,6,11,35.29
Kalista,Gragas,64,29,35,45.31
Kalista,Pyke,67,38,29,56.72
Kalista,Briar,46,12,34,26.09
Kalista,Corki,36,26,10,72.22
Kalista,Leblanc,78,34,44,43.59
Kalista,KSante,43,19,24,44.19
Kalista,Jayce,46,20,26,43.48
Kalista,Skarner,47,39,8,82.98
Kalista,Gwen,36,17,19,47.22
Kalista,Zed,66,38,28,57.58
Kalista,Samira,65,25,40,38.46
Kalista,Amumu,87,19,68,21.84
Kalista,Senna,49,20,29,40.82
Kalista,Swain,70,25,45,35.71
Kalista,Camille,31,19,12,61.29
Kalista,Ekko,39,13,26,33.33
Kalista,Bard,18,6,12,33.33
Kalista,Belveth,14,5,9,35.71
Kalista,Vi,75,41,34,54.67
Kalista,Tristana,53,21,32,39.62
Kalista,Poppy,90,43,47,47.78
Kalista,Xerath,46,25,21,54.35
Kalista,Cassiopeia,20,9,11,45
Kalista,Vex,41,21,20,51.22
Kalista,Kayle,29,13,16,44.83
Kalista,Rengar,23,17,6,73.91
Kalista,RekSai,6,3,3,50
Kalista,Kassadin,13,3,10,23.08
Kalista,Soraka,39,23,16,58.97
Kalista,Nidalee,28,16,12,57.14
Kalista,Hecarim,33,25,8,75.76
Kalista,DrMundo,33,7,26,21.21
Kalista,Urgot,26,8,18,30.77
Kalista,Renata,25,11,14,44
Kalista,Taric,27,10,17,37.04
Kalista,Olaf,17,0,17,0
Kalista,Sion,54,28,26,51.85
Kalista,Trundle,55,22,33,40
Kalista,Akshan,21,13,8,61.9
Kalista,Azir,35,26,9,74.29
Kalista,Yuumi,78,38,40,48.72
Kalista,Akali,61,37,24,60.66
Kalista,Volibear,43,26,17,60.47
Kalista,Lissandra,35,25,10,71.43
Kalista,Naafiri,10,7,3,70
Kalista,FiddleSticks,22,13,9,59.09
Kalista,Annie,17,14,3,82.35
Kalista,Nilah,22,4,18,18.18
Kalista,Evelynn,15,4,11,26.67
Kalista,Brand,39,20,19,51.28
Kalista,Aphelios,32,8,24,25
Kalista,Rammus,43,25,18,58.14
Kalista,Janna,20,7,13,35
Kalista,Qiyana,12,7,5,58.33
Kalista,Zilean,23,5,18,21.74
Kalista,Xayah,38,15,23,39.47
Kalista,Kled,17,9,8,52.94
Kalista,Singed,21,11,10,52.38
Kalista,Shaco,28,9,19,32.14
Kalista,Ziggs,21,8,13,38.1
Kalista,Kennen,14,14,0,100
Kalista,Ornn,58,21,37,36.21
Kalista,Quinn,19,8,11,42.11
Kalista,Rumble,21,8,13,38.1
Kalista,Zeri,38,16,22,42.11
Kalista,KogMaw,17,6,11,35.29
Kalista,Anivia,21,6,15,28.57
Kalista,Tryndamere,34,17,17,50
Kalista,Karthus,11,0,11,0
Kalista,Talon,33,21,12,63.64
Kalista,Zoe,38,15,23,39.47
Kalista,Alistar,34,12,22,35.29
Kalista,Ryze,22,10,12,45.45
Zeri,Leona,143,74,69,51.75
Zeri,Rammus,40,21,19,52.5
Zeri,Lux,218,122,96,55.96
Zeri,Twitch,81,46,35,56.79
Zeri,Aatrox,132,73,59,55.3
Zeri,TahmKench,88,46,42,52.27
Zeri,Viego,159,95,64,59.75
Zeri,Zed,97,42,55,43.3
Zeri,Veigar,97,49,48,50.52
Zeri,Ziggs,28,24,4,85.71
Zeri,KSante,140,84,56,60
Zeri,Gragas,79,35,44,44.3
Zeri,Irelia,66,25,41,37.88
Zeri,Caitlyn,222,109,113,49.1
Zeri,Rell,102,49,53,48.04
Zeri,Riven,46,27,19,58.7
Zeri,Shaco,84,41,43,48.81
Zeri,Katarina,71,35,36,49.3
Zeri,Tristana,84,43,41,51.19
Zeri,Milio,105,51,54,48.57
Zeri,Jax,88,45,43,51.14
Zeri,LeeSin,236,123,113,52.12
Zeri,Malzahar,133,67,66,50.38
Zeri,Jinx,329,143,186,43.47
Zeri,Ornn,75,34,41,45.33
Zeri,Akali,130,66,64,50.77
Zeri,Elise,101,64,37,63.37
Zeri,Draven,89,53,36,59.55
Zeri,Pyke,100,66,34,66
Zeri,Qiyana,35,18,17,51.43
Zeri,Briar,49,24,25,48.98
Zeri,Hwei,64,43,21,67.19
Zeri,Lucian,112,61,51,54.46
Zeri,Darius,194,76,118,39.18
Zeri,Nocturne,134,80,54,59.7
Zeri,Azir,73,55,18,75.34
Zeri,Jhin,185,114,71,61.62
Zeri,Sona,18,13,5,72.22
Zeri,Sion,92,46,46,50
Zeri,MasterYi,106,53,53,50
Zeri,Mel,237,137,100,57.81
Zeri,Ahri,140,42,98,30
Zeri,Teemo,87,46,41,52.87
Zeri,Karma,170,81,89,47.65
Zeri,Vladimir,83,38,45,45.78
Zeri,Kayn,109,58,51,53.21
Zeri,Volibear,116,60,56,51.72
Zeri,Blitzcrank,99,49,50,49.49
Zeri,Alistar,77,46,31,59.74
Zeri,Evelynn,39,18,21,46.15
Zeri,Vex,43,23,20,53.49
Zeri,Sivir,66,28,38,42.42
Zeri,Annie,43,23,20,53.49
Zeri,Trundle,43,23,20,53.49
Zeri,Belveth,18,5,13,27.78
Zeri,Yasuo,219,103,116,47.03
Zeri,Zoe,52,40,12,76.92
Zeri,Mordekaiser,140,65,75,46.43
Zeri,Amumu,119,40,79,33.61
Zeri,Brand,68,44,24,64.71
Zeri,Yorick,101,59,42,58.42
Zeri,Kayle,35,12,23,34.29
Zeri,Shen,74,27,47,36.49
Zeri,Garen,171,79,92,46.2
Zeri,Viktor,109,52,57,47.71
Zeri,Camille,62,41,21,66.13
Zeri,Tryndamere,20,15,5,75
Zeri,Thresh,232,95,137,40.95
Zeri,Aurora,95,48,47,50.53
Zeri,Janna,36,19,17,52.78
Zeri,RekSai,26,15,11,57.69
Zeri,Neeko,61,37,24,60.66
Zeri,Poppy,97,56,41,57.73
Zeri,Sejuani,78,41,37,52.56
Zeri,Velkoz,39,17,22,43.59
Zeri,Ivern,28,8,20,28.57
Zeri,Nilah,38,21,17,55.26
Zeri,Ekko,76,37,39,48.68
Zeri,Ashe,231,130,101,56.28
Zeri,Nami,84,34,50,40.48
Zeri,Sett,155,69,86,44.52
Zeri,Renekton,58,31,27,53.45
Zeri,Ezreal,324,177,147,54.63
Zeri,Gnar,55,31,24,56.36
Zeri,Urgot,36,14,22,38.89
Zeri,Leblanc,97,44,53,45.36
Zeri,Corki,58,16,42,27.59
Zeri,Naafiri,42,16,26,38.1
Zeri,Seraphine,46,23,23,50
Zeri,Diana,182,89,93,48.9
Zeri,Lissandra,51,18,33,35.29
Zeri,Aphelios,72,30,42,41.67
Zeri,Lulu,232,133,99,57.33
Zeri,Khazix,61,39,22,63.93
Zeri,Malphite,111,64,47,57.66
Zeri,Nasus,79,48,31,60.76
Zeri,MonkeyKing,112,61,51,54.46
Zeri,Smolder,94,54,40,57.45
Zeri,Udyr,34,23,11,67.65
Zeri,Yone,239,139,100,58.16
Zeri,Nautilus,139,76,63,54.68
Zeri,Quinn,33,20,13,60.61
Zeri,Samira,92,60,32,65.22
Zeri,Pantheon,181,94,87,51.93
Zeri,Fiora,68,46,22,67.65
Zeri,Kassadin,21,16,5,76.19
Zeri,Varus,97,50,47,51.55
Zeri,XinZhao,75,48,27,64
Zeri,Ryze,57,29,28,50.88
Zeri,Sylas,143,84,59,58.74
Zeri,JarvanIV,94,52,42,55.32
Zeri,Bard,21,8,13,38.1
Zeri,Zac,87,51,36,58.62
Zeri,Karthus,36,14,22,38.89
Zeri,Kaisa,235,123,112,52.34
Zeri,Lillia,68,42,26,61.76
Zeri,Orianna,61,33,28,54.1
Zeri,Xayah,91,45,46,49.45
Zeri,Chogath,178,83,95,46.63
Zeri,FiddleSticks,72,24,48,33.33
Zeri,Yuumi,129,53,76,41.09
Zeri,Cassiopeia,44,17,27,38.64
Zeri,Rakan,62,20,42,32.26
Zeri,MissFortune,167,71,96,42.51
Zeri,Warwick,104,54,50,51.92
Zeri,Morgana,85,45,40,52.94
Zeri,Singed,30,15,15,50
Zeri,Anivia,52,32,20,61.54
Zeri,Vayne,173,81,92,46.82
Zeri,Xerath,88,40,48,45.45
Zeri,Nunu,58,29,29,50
Zeri,Heimerdinger,44,23,21,52.27
Zeri,Hecarim,62,23,39,37.1
Zeri,Vi,146,61,85,41.78
Zeri,Swain,112,46,66,41.07
Zeri,Rengar,40,26,14,65
Zeri,Senna,39,16,23,41.03
Zeri,Gwen,82,39,43,47.56
Zeri,Maokai,60,28,32,46.67
Zeri,Zilean,24,10,14,41.67
Zeri,DrMundo,53,19,34,35.85
Zeri,Taliyah,44,17,27,38.64
Zeri,Akshan,17,9,8,52.94
Zeri,TwistedFate,34,20,14,58.82
Zeri,Nidalee,39,17,22,43.59
Zeri,KogMaw,45,28,17,62.22
Zeri,Soraka,59,41,18,69.49
Zeri,Jayce,53,29,24,54.72
Zeri,Zyra,103,56,47,54.37
Zeri,Olaf,34,9,25,26.47
Zeri,Kled,28,9,19,32.14
Zeri,Skarner,57,21,36,36.84
Zeri,Gangplank,55,24,31,43.64
Zeri,Syndra,78,47,31,60.26
Zeri,Taric,16,5,11,31.25
Zeri,Rumble,31,16,15,51.61
Zeri,AurelionSol,38,20,18,52.63
Zeri,Galio,137,76,61,55.47
Zeri,Illaoi,48,18,30,37.5
Zeri,Kindred,35,28,7,80
Zeri,Talon,61,32,29,52.46
Zeri,Ambessa,54,29,25,53.7
Zeri,Braum,72,35,37,48.61
Zeri,Graves,97,48,49,49.48
Zeri,Kalista,38,22,16,57.89
Zeri,Kennen,34,26,8,76.47
Zeri,Renata,16,3,13,18.75
Zeri,Fizz,22,11,11,50
Zeri,Shyvana,8,2,6,25
Rumble,Aatrox,83,44,39,53.01
Rumble,Briar,37,17,20,45.95
Rumble,Ahri,82,41,41,50
Rumble,Ezreal,181,83,98,45.86
Rumble,Elise,78,31,47,39.74
Rumble,Ornn,56,24,32,42.86
Rumble,Jax,77,52,25,67.53
Rumble,Ashe,128,71,57,55.47
Rumble,Yuumi,67,31,36,46.27
Rumble,Mordekaiser,73,30,43,41.1
Rumble,Gragas,77,20,57,25.97
Rumble,Neeko,34,19,15,55.88
Rumble,Karma,91,45,46,49.45
Rumble,Sylas,123,65,58,52.85
Rumble,Lux,126,57,69,45.24
Rumble,Camille,31,17,14,54.84
Rumble,Shaco,36,13,23,36.11
Rumble,Kassadin,18,6,12,33.33
Rumble,Jhin,175,72,103,41.14
Rumble,Blitzcrank,50,23,27,46
Rumble,Yorick,46,21,25,45.65
Rumble,Karthus,13,0,13,0
Rumble,Zed,88,40,48,45.45
Rumble,TahmKench,53,25,28,47.17
Rumble,Rengar,11,8,3,72.73
Rumble,Tristana,79,35,44,44.3
Rumble,Lulu,147,56,91,38.1
Rumble,Darius,125,68,57,54.4
Rumble,FiddleSticks,56,13,43,23.21
Rumble,Ekko,64,20,44,31.25
Rumble,Kayle,52,22,30,42.31
Rumble,LeeSin,173,98,75,56.65
Rumble,Qiyana,9,9,0,100
Rumble,Samira,44,22,22,50
Rumble,Morgana,85,45,40,52.94
Rumble,Kayn,54,30,24,55.56
Rumble,Mel,138,66,72,47.83
Rumble,Seraphine,45,19,26,42.22
Rumble,Vladimir,51,22,29,43.14
Rumble,Zac,65,45,20,69.23
Rumble,Katarina,49,17,32,34.69
Rumble,Lucian,81,37,44,45.68
Rumble,Renata,18,10,8,55.56
Rumble,Pantheon,123,59,64,47.97
Rumble,Irelia,47,16,31,34.04
Rumble,Kaisa,124,56,68,45.16
Rumble,Milio,36,22,14,61.11
Rumble,Pyke,70,13,57,18.57
Rumble,Talon,33,18,15,54.55
Rumble,Brand,26,13,13,50
Rumble,Braum,68,28,40,41.18
Rumble,Malphite,84,39,45,46.43
Rumble,Nocturne,91,44,47,48.35
Rumble,Malzahar,78,36,42,46.15
Rumble,Varus,89,47,42,52.81
Rumble,Udyr,36,21,15,58.33
Rumble,Viego,111,54,57,48.65
Rumble,Sett,77,33,44,42.86
Rumble,Illaoi,34,16,18,47.06
Rumble,Lillia,48,15,33,31.25
Rumble,Nami,58,26,32,44.83
Rumble,Volibear,49,7,42,14.29
Rumble,Vayne,92,40,52,43.48
Rumble,Yasuo,138,54,84,39.13
Rumble,KSante,45,22,23,48.89
Rumble,Belveth,22,14,8,63.64
Rumble,Viktor,65,33,32,50.77
Rumble,MissFortune,141,75,66,53.19
Rumble,Nautilus,112,57,55,50.89
Rumble,Gwen,31,11,20,35.48
Rumble,Aurora,79,51,28,64.56
Rumble,Jinx,182,74,108,40.66
Rumble,Thresh,143,87,56,60.84
Rumble,Swain,72,21,51,29.17
Rumble,Gangplank,45,26,19,57.78
Rumble,Skarner,46,17,29,36.96
Rumble,Senna,42,17,25,40.48
Rumble,Hwei,47,21,26,44.68
Rumble,Nidalee,35,17,18,48.57
Rumble,Taliyah,18,9,9,50
Rumble,Warwick,88,43,45,48.86
Rumble,Galio,135,74,61,54.81
Rumble,Urgot,36,16,20,44.44
Rumble,Sejuani,47,21,26,44.68
Rumble,Shen,58,30,28,51.72
Rumble,TwistedFate,23,10,13,43.48
Rumble,Soraka,25,11,14,44
Rumble,Hecarim,34,19,15,55.88
Rumble,Draven,35,18,17,51.43
Rumble,Riven,14,5,9,35.71
Rumble,Jayce,60,22,38,36.67
Rumble,Orianna,53,17,36,32.08
Rumble,Zoe,35,27,8,77.14
Rumble,Quinn,23,5,18,21.74
Rumble,Teemo,83,30,53,36.14
Rumble,Rammus,29,9,20,31.03
Rumble,Xayah,43,9,34,20.93
Rumble,Olaf,27,6,21,22.22
Rumble,Yone,133,76,57,57.14
Rumble,DrMundo,37,29,8,78.38
Rumble,Evelynn,19,8,11,42.11
Rumble,Fizz,27,14,13,51.85
Rumble,Renekton,40,25,15,62.5
Rumble,Twitch,48,15,33,31.25
Rumble,Fiora,31,10,21,32.26
Rumble,Leblanc,40,20,20,50
Rumble,Rakan,45,19,26,42.22
Rumble,Akali,58,23,35,39.66
Rumble,MasterYi,78,31,47,39.74
Rumble,Amumu,61,26,35,42.62
Rumble,Chogath,69,32,37,46.38
Rumble,Sivir,47,25,22,53.19
Rumble,Bard,14,11,3,78.57
Rumble,Diana,120,69,51,57.5
Rumble,Alistar,48,12,36,25
Rumble,Sion,75,24,51,32
Rumble,Xerath,72,36,36,50
Rumble,Kennen,28,19,9,67.86
Rumble,Velkoz,47,27,20,57.45
Rumble,Tryndamere,18,6,12,33.33
Rumble,Azir,41,25,16,60.98
Rumble,Caitlyn,164,76,88,46.34
Rumble,Nunu,43,20,23,46.51
Rumble,Anivia,24,9,15,37.5
Rumble,Akshan,23,15,8,65.22
Rumble,Kindred,45,32,13,71.11
Rumble,Gnar,35,18,17,51.43
Rumble,Leona,62,34,28,54.84
Rumble,Aphelios,20,17,3,85
Rumble,Khazix,28,6,22,21.43
Rumble,Corki,40,28,12,70
Rumble,Vi,72,34,38,47.22
Rumble,Graves,54,19,35,35.19
Rumble,AurelionSol,15,10,5,66.67
Rumble,Veigar,45,18,27,40
Rumble,Zyra,47,30,17,63.83
Rumble,Syndra,47,22,25,46.81
Rumble,Ziggs,20,12,8,60
Rumble,Poppy,51,30,21,58.82
Rumble,Ambessa,61,14,47,22.95
Rumble,Ivern,15,11,4,73.33
Rumble,Nasus,35,11,24,31.43
Rumble,Lissandra,23,7,16,30.43
Rumble,Zeri,31,15,16,48.39
Rumble,Kled,20,10,10,50
Rumble,Trundle,28,14,14,50
Rumble,Zilean,22,6,16,27.27
Rumble,Garen,90,44,46,48.89
Rumble,RekSai,11,3,8,27.27
Rumble,Heimerdinger,12,2,10,16.67
Rumble,Vex,40,14,26,35
Rumble,Kalista,21,13,8,61.9
Rumble,JarvanIV,49,24,25,48.98
Rumble,Singed,20,11,9,55
Rumble,Maokai,29,18,11,62.07
Rumble,Smolder,31,16,15,51.61
Rumble,Taric,15,5,10,33.33
Rumble,XinZhao,33,21,12,63.64
Rumble,KogMaw,18,10,8,55.56
Rumble,Cassiopeia,21,11,10,52.38
Rumble,Shyvana,17,8,9,47.06
Rumble,Rell,38,27,11,71.05
Rumble,MonkeyKing,44,14,30,31.82
Rumble,Janna,11,8,3,72.73
Rumble,Naafiri,20,8,12,40
Rumble,Annie,15,6,9,40
Rumble,Ryze,21,9,12,42.86
Rumble,Nilah,6,3,3,50
Rumble,Sona,3,0,3,0
