Name,Opponent,Games,Wins,Losses,WR
Singed,Chogath,370,195,175,52.7
Singed,Viego,434,213,221,49.08
Singed,Galio,286,157,129,54.9
Singed,Sivir,158,98,60,62.03
Singed,Pyke,245,135,110,55.1
Singed,Garen,565,272,293,48.14
Singed,Nocturne,417,189,228,45.32
Singed,Fizz,169,92,77,54.44
Singed,Jinx,984,478,506,48.58
Singed,Thresh,460,259,201,56.3
Singed,Warwick,487,256,231,52.57
Singed,Tristana,395,167,228,42.28
Singed,Vayne,449,223,226,49.67
Singed,Tryndamere,240,137,103,57.08
Singed,Amumu,299,147,152,49.16
Singed,Vex,187,99,88,52.94
Singed,Mel,716,370,346,51.68
Singed,Rumble,78,52,26,66.67
Singed,Yasuo,653,327,326,50.08
Singed,Lulu,466,227,239,48.71
Singed,Sejuani,156,74,82,47.44
Singed,Ekko,370,177,193,47.84
Singed,Sylas,434,213,221,49.08
Singed,Caitlyn,853,430,423,50.41
Singed,Karma,444,209,235,47.07
Singed,DrMundo,226,103,123,45.58
Singed,Jax,287,139,148,48.43
Singed,AurelionSol,129,60,69,46.51
Singed,Rakan,139,57,82,41.01
Singed,Briar,190,84,106,44.21
Singed,Akali,326,174,152,53.37
Singed,MissFortune,697,386,311,55.38
Singed,TahmKench,238,125,113,52.52
Singed,Yorick,310,134,176,43.23
Singed,Volibear,359,184,175,51.25
Singed,Vladimir,225,116,109,51.56
Singed,Zeri,141,77,64,54.61
Singed,Senna,205,106,99,51.71
Singed,FiddleSticks,158,90,68,56.96
Singed,Katarina,254,149,105,58.66
Singed,Ezreal,702,373,329,53.13
Singed,Nautilus,361,175,186,48.48
Singed,Diana,513,252,261,49.12
Singed,Yone,567,304,263,53.62
Singed,Lux,794,378,416,47.61
Singed,Trundle,204,99,105,48.53
Singed,Kindred,142,75,67,52.82
Singed,Swain,356,182,174,51.12
Singed,Quinn,137,87,50,63.5
Singed,MonkeyKing,202,115,87,56.93
Singed,Aurora,172,89,83,51.74
Singed,Karthus,109,56,53,51.38
Singed,Kled,82,31,51,37.8
Singed,Shaco,275,159,116,57.82
Singed,Zoe,116,66,50,56.9
Singed,Twitch,286,152,134,53.15
Singed,Gangplank,164,78,86,47.56
Singed,Annie,108,44,64,40.74
Singed,Morgana,394,198,196,50.25
Singed,Malphite,295,151,144,51.19
Singed,JarvanIV,186,93,93,50
Singed,Malzahar,407,199,208,48.89
Singed,KogMaw,76,32,44,42.11
Singed,Heimerdinger,157,73,84,46.5
Singed,Lucian,253,147,106,58.1
Singed,Teemo,415,202,213,48.67
Singed,Kassadin,78,39,39,50
Singed,Ashe,702,336,366,47.86
Singed,Blitzcrank,174,98,76,56.32
Singed,Nasus,293,137,156,46.76
Singed,Milio,243,128,115,52.67
Singed,Fiora,106,33,73,31.13
Singed,Pantheon,388,190,198,48.97
Singed,Hwei,230,130,100,56.52
Singed,Viktor,276,135,141,48.91
Singed,Jhin,624,320,304,51.28
Singed,Camille,106,65,41,61.32
Singed,Udyr,145,47,98,32.41
Singed,Zed,378,214,164,56.61
Singed,Kaisa,521,248,273,47.6
Singed,Elise,227,108,119,47.58
Singed,Urgot,192,88,104,45.83
Singed,Khazix,178,84,94,47.19
Singed,Alistar,142,77,65,54.23
Singed,Yuumi,263,148,115,56.27
Singed,Ziggs,121,70,51,57.85
Singed,LeeSin,470,258,212,54.89
Singed,Poppy,207,104,103,50.24
Singed,Aatrox,280,155,125,55.36
Singed,Ornn,131,81,50,61.83
Singed,Xerath,332,190,142,57.23
Singed,Gwen,163,106,57,65.03
Singed,Irelia,259,155,104,59.85
Singed,Seraphine,251,147,104,58.57
Singed,Kayn,467,199,268,42.61
Singed,Syndra,215,94,121,43.72
Singed,Kayle,263,107,156,40.68
Singed,Ivern,63,14,49,22.22
Singed,Nami,373,181,192,48.53
Singed,Mordekaiser,438,239,199,54.57
Singed,Anivia,113,51,62,45.13
Singed,Zilean,128,55,73,42.97
Singed,Skarner,96,68,28,70.83
Singed,Ryze,121,57,64,47.11
Singed,Varus,296,172,124,58.11
Singed,Azir,121,75,46,61.98
Singed,Veigar,307,148,159,48.21
Singed,Draven,152,77,75,50.66
Singed,Rell,185,109,76,58.92
Singed,Orianna,124,58,66,46.77
Singed,Taric,63,25,38,39.68
Singed,Sett,467,247,220,52.89
Singed,Darius,561,283,278,50.45
Singed,Rengar,97,46,51,47.42
Singed,RekSai,56,25,31,44.64
Singed,Brand,251,138,113,54.98
Singed,Ahri,335,188,147,56.12
Singed,Leona,243,134,109,55.14
Singed,Belveth,97,46,51,47.42
Singed,Kalista,89,57,32,64.04
Singed,Vi,300,172,128,57.33
Singed,Naafiri,116,71,45,61.21
Singed,Corki,116,74,42,63.79
Singed,Illaoi,158,91,67,57.59
Singed,Rammus,114,58,56,50.88
Singed,Shen,212,89,123,41.98
Singed,Ambessa,225,130,95,57.78
Singed,Smolder,211,114,97,54.03
Singed,Soraka,179,100,79,55.87
Singed,Zyra,311,160,151,51.45
Singed,MasterYi,423,220,203,52.01
Singed,TwistedFate,101,59,42,58.42
Singed,Graves,231,136,95,58.87
Singed,Sona,109,51,58,46.79
Singed,Samira,208,118,90,56.73
Singed,Janna,124,57,67,45.97
Singed,Taliyah,78,40,38,51.28
Singed,Renekton,127,64,63,50.39
Singed,Maokai,111,64,47,57.66
Singed,Velkoz,184,80,104,43.48
Singed,Lillia,179,96,83,53.63
Singed,Neeko,151,72,79,47.68
Singed,Renata,44,15,29,34.09
Singed,Talon,159,89,70,55.97
Singed,KSante,139,88,51,63.31
Singed,Hecarim,161,92,69,57.14
Singed,Jayce,157,89,68,56.69
Singed,Aphelios,189,93,96,49.21
Singed,Qiyana,66,35,31,53.03
Singed,Sion,355,207,148,58.31
Singed,XinZhao,167,94,73,56.29
Singed,Bard,100,51,49,51
Singed,Evelynn,118,53,65,44.92
Singed,Gnar,129,76,53,58.91
Singed,Leblanc,191,90,101,47.12
Singed,Lissandra,89,45,44,50.56
Singed,Gragas,190,101,89,53.16
Singed,Riven,163,92,71,56.44
Singed,Zac,126,60,66,47.62
Singed,Braum,199,113,86,56.78
Singed,Xayah,148,83,65,56.08
Singed,Cassiopeia,95,39,56,41.05
Singed,Nunu,218,116,102,53.21
Singed,Akshan,117,67,50,57.26
Singed,Shyvana,80,46,34,57.5
Singed,Kennen,64,24,40,37.5
Singed,Nidalee,72,43,29,59.72
Singed,Olaf,63,32,31,50.79
Singed,Nilah,125,57,68,45.6
LeeSin,Chogath,1743,785,958,45.04
LeeSin,Viego,3900,1860,2040,47.69
LeeSin,Galio,1681,804,877,47.83
LeeSin,Sivir,970,489,481,50.41
LeeSin,Pyke,1563,808,755,51.7
LeeSin,Aurora,1460,761,699,52.12
LeeSin,Corki,773,402,371,52.01
LeeSin,Orianna,900,433,467,48.11
LeeSin,Xayah,798,375,423,46.99
LeeSin,Nami,1438,660,778,45.9
LeeSin,Mordekaiser,1939,935,1004,48.22
LeeSin,Kayn,2240,1017,1223,45.4
LeeSin,Talon,1286,618,668,48.06
LeeSin,MissFortune,3792,1888,1904,49.79
LeeSin,Lulu,2792,1297,1495,46.45
LeeSin,Trundle,827,386,441,46.67
LeeSin,Volibear,1552,767,785,49.42
LeeSin,Viktor,1895,947,948,49.97
LeeSin,Garen,2606,1223,1383,46.93
LeeSin,Graves,1951,920,1031,47.16
LeeSin,Malzahar,1552,708,844,45.62
LeeSin,Lucian,1410,772,638,54.75
LeeSin,Lux,4011,1915,2096,47.74
LeeSin,Jax,1787,871,916,48.74
LeeSin,Shaco,1758,930,828,52.9
LeeSin,Yone,3837,1919,1918,50.01
LeeSin,KogMaw,434,190,244,43.78
LeeSin,Morgana,1892,876,1016,46.3
LeeSin,Briar,1051,495,556,47.1
LeeSin,Diana,3431,1663,1768,48.47
LeeSin,Veigar,1303,622,681,47.74
LeeSin,Brand,1087,535,552,49.22
LeeSin,Pantheon,3209,1541,1668,48.02
LeeSin,Jhin,3913,1869,2044,47.76
LeeSin,Nocturne,2316,1035,1281,44.69
LeeSin,Velkoz,934,453,481,48.5
LeeSin,Darius,3166,1481,1685,46.78
LeeSin,Lillia,1201,535,666,44.55
LeeSin,Vex,846,364,482,43.03
LeeSin,Kaisa,3598,1773,1825,49.28
LeeSin,Neeko,716,323,393,45.11
LeeSin,Sion,1182,502,680,42.47
LeeSin,Sylas,3641,1827,1814,50.18
LeeSin,Zed,2422,1210,1212,49.96
LeeSin,Tristana,1630,766,864,46.99
LeeSin,Karthus,547,265,282,48.45
LeeSin,Ekko,1706,821,885,48.12
LeeSin,Warwick,2100,997,1103,47.48
LeeSin,Fizz,814,393,421,48.28
LeeSin,Jinx,4995,2366,2629,47.37
LeeSin,Thresh,2755,1269,1486,46.06
LeeSin,Poppy,1465,626,839,42.73
LeeSin,Evelynn,542,266,276,49.08
LeeSin,Elise,1804,930,874,51.55
LeeSin,Teemo,1914,903,1011,47.18
LeeSin,Sejuani,923,452,471,48.97
LeeSin,Yasuo,3606,1635,1971,45.34
LeeSin,Nautilus,2087,1000,1087,47.92
LeeSin,Swain,1575,742,833,47.11
LeeSin,Ashe,4426,2090,2336,47.22
LeeSin,Zyra,2171,1038,1133,47.81
LeeSin,Varus,1855,943,912,50.84
LeeSin,Vladimir,1212,580,632,47.85
LeeSin,Vayne,2043,947,1096,46.35
LeeSin,FiddleSticks,812,445,367,54.8
LeeSin,Gwen,781,409,372,52.37
LeeSin,Rammus,525,233,292,44.38
LeeSin,Karma,2972,1384,1588,46.57
LeeSin,Malphite,1768,840,928,47.51
LeeSin,MasterYi,1988,985,1003,49.55
LeeSin,Naafiri,492,235,257,47.76
LeeSin,Caitlyn,4699,2338,2361,49.76
LeeSin,Soraka,932,431,501,46.24
LeeSin,Urgot,669,314,355,46.94
LeeSin,Vi,2409,1143,1266,47.45
LeeSin,KSante,1278,681,597,53.29
LeeSin,Ahri,2302,1100,1202,47.78
LeeSin,Draven,838,418,420,49.88
LeeSin,Leona,1466,686,780,46.79
LeeSin,Shen,957,486,471,50.78
LeeSin,Riven,817,342,475,41.86
LeeSin,Gangplank,1016,511,505,50.3
LeeSin,Quinn,525,250,275,47.62
LeeSin,Khazix,1044,561,483,53.74
LeeSin,Nidalee,1094,591,503,54.02
LeeSin,Bard,599,236,363,39.4
LeeSin,Tryndamere,841,331,510,39.36
LeeSin,Smolder,1036,548,488,52.9
LeeSin,Yorick,1351,599,752,44.34
LeeSin,Xerath,2052,1007,1045,49.07
LeeSin,Rengar,525,243,282,46.29
LeeSin,Ryze,837,443,394,52.93
LeeSin,Milio,875,392,483,44.8
LeeSin,JarvanIV,1060,481,579,45.38
LeeSin,Sett,2734,1265,1469,46.27
LeeSin,Taliyah,486,234,252,48.15
LeeSin,Akshan,514,265,249,51.56
LeeSin,Ezreal,6188,3033,3155,49.01
LeeSin,Zilean,497,216,281,43.46
LeeSin,Aatrox,2026,985,1041,48.62
LeeSin,Akali,2256,1136,1120,50.35
LeeSin,Gragas,1261,665,596,52.74
LeeSin,Janna,569,225,344,39.54
LeeSin,Camille,657,350,307,53.27
LeeSin,XinZhao,1631,768,863,47.09
LeeSin,Nilah,362,176,186,48.62
LeeSin,Udyr,619,309,310,49.92
LeeSin,Kayle,804,406,398,50.5
LeeSin,Ambessa,1496,763,733,51
LeeSin,Braum,1152,560,592,48.61
LeeSin,Irelia,1686,857,829,50.83
LeeSin,TahmKench,1084,527,557,48.62
LeeSin,Nasus,1109,489,620,44.09
LeeSin,Senna,1079,552,527,51.16
LeeSin,Jayce,1517,771,746,50.82
LeeSin,Twitch,1173,580,593,49.45
LeeSin,Aphelios,908,438,470,48.24
LeeSin,Gnar,785,375,410,47.77
LeeSin,Annie,728,362,366,49.73
LeeSin,Hecarim,913,490,423,53.67
LeeSin,Renekton,1080,554,526,51.3
LeeSin,Katarina,1309,571,738,43.62
LeeSin,Nunu,812,393,419,48.4
LeeSin,Samira,1060,514,546,48.49
LeeSin,Skarner,497,228,269,45.88
LeeSin,Seraphine,998,491,507,49.2
LeeSin,Fiora,645,344,301,53.33
LeeSin,Ziggs,523,252,271,48.18
LeeSin,Mel,3678,1887,1791,51.31
LeeSin,Amumu,1511,731,780,48.38
LeeSin,AurelionSol,521,254,267,48.75
LeeSin,Blitzcrank,1563,805,758,51.5
LeeSin,Ornn,797,400,397,50.19
LeeSin,Yuumi,1511,740,771,48.97
LeeSin,Syndra,1099,599,500,54.5
LeeSin,Alistar,845,427,418,50.53
LeeSin,Renata,268,132,136,49.25
LeeSin,TwistedFate,730,355,375,48.63
LeeSin,Singed,470,212,258,45.11
LeeSin,Belveth,372,184,188,49.46
LeeSin,Zeri,964,489,475,50.73
LeeSin,Olaf,552,241,311,43.66
LeeSin,Leblanc,1655,801,854,48.4
LeeSin,Rumble,680,339,341,49.85
LeeSin,Zac,1119,556,563,49.69
LeeSin,Kassadin,332,147,185,44.28
LeeSin,MonkeyKing,1332,648,684,48.65
LeeSin,Rakan,819,369,450,45.05
LeeSin,Ivern,222,102,120,45.95
LeeSin,Kennen,512,220,292,42.97
LeeSin,Kindred,791,394,397,49.81
LeeSin,Heimerdinger,724,307,417,42.4
LeeSin,Maokai,851,374,477,43.95
LeeSin,Hwei,1217,592,625,48.64
LeeSin,Taric,368,192,176,52.17
LeeSin,Azir,780,393,387,50.38
LeeSin,Rell,843,401,442,47.57
LeeSin,Anivia,580,273,307,47.07
LeeSin,Cassiopeia,419,181,238,43.2
LeeSin,Sona,446,190,256,42.6
LeeSin,Kalista,530,263,267,49.62
LeeSin,Qiyana,447,225,222,50.34
LeeSin,DrMundo,820,382,438,46.59
LeeSin,Lissandra,560,278,282,49.64
LeeSin,Illaoi,749,348,401,46.46
LeeSin,Zoe,761,375,386,49.28
LeeSin,Shyvana,300,154,146,51.33
LeeSin,RekSai,359,167,192,46.52
LeeSin,Kled,252,113,139,44.84
Yasuo,Chogath,2915,1506,1409,51.66
Yasuo,Viego,3484,1736,1748,49.83
Yasuo,Galio,1849,919,930,49.7
Yasuo,Sivir,1199,653,546,54.46
Yasuo,Pyke,1952,1058,894,54.2
Yasuo,Aurora,1645,844,801,51.31
Yasuo,Corki,918,497,421,54.14
Yasuo,Orianna,877,451,426,51.43
Yasuo,Xayah,1189,558,631,46.93
Yasuo,Nami,2094,1021,1073,48.76
Yasuo,Renekton,1651,765,886,46.34
Yasuo,Nocturne,2915,1301,1614,44.63
Yasuo,Viktor,1758,849,909,48.29
Yasuo,Tryndamere,1361,647,714,47.54
Yasuo,Lillia,1258,649,609,51.59
Yasuo,Tristana,2343,1223,1120,52.2
Yasuo,Senna,1762,886,876,50.28
Yasuo,Irelia,2314,1183,1131,51.12
Yasuo,Hecarim,930,497,433,53.44
Yasuo,Malzahar,2597,1212,1385,46.67
Yasuo,Vayne,3225,1607,1618,49.83
Yasuo,Pantheon,4088,1980,2108,48.43
Yasuo,MasterYi,3034,1337,1697,44.07
Yasuo,Azir,826,390,436,47.22
Yasuo,Lucian,1596,843,753,52.82
Yasuo,Mel,5024,2610,2414,51.95
Yasuo,Diana,3604,1795,1809,49.81
Yasuo,Gragas,1256,662,594,52.71
Yasuo,Zed,3270,1720,1550,52.6
Yasuo,Caitlyn,6607,3263,3344,49.39
Yasuo,Soraka,1195,610,585,51.05
Yasuo,Zac,1074,547,527,50.93
Yasuo,Khazix,1154,622,532,53.9
Yasuo,Katarina,1809,952,857,52.63
Yasuo,Samira,1820,925,895,50.82
Yasuo,Leona,1981,1039,942,52.45
Yasuo,Singed,653,326,327,49.92
Yasuo,Evelynn,775,395,380,50.97
Yasuo,Yone,5810,3108,2702,53.49
Yasuo,Warwick,3621,1719,1902,47.47
Yasuo,Shen,1400,644,756,46
Yasuo,Velkoz,1300,655,645,50.38
Yasuo,Varus,2013,1047,966,52.01
Yasuo,Rakan,943,457,486,48.46
Yasuo,Jax,2455,1230,1225,50.1
Yasuo,Rengar,828,478,350,57.73
Yasuo,Camille,767,417,350,54.37
Yasuo,Karma,2761,1357,1404,49.15
Yasuo,Fiora,842,400,442,47.51
Yasuo,Graves,1471,791,680,53.77
Yasuo,Ashe,4639,2274,2365,49.02
Yasuo,Braum,1305,614,691,47.05
Yasuo,Quinn,931,386,545,41.46
Yasuo,Trundle,1491,743,748,49.83
Yasuo,Kassadin,420,216,204,51.43
Yasuo,DrMundo,1349,688,661,51
Yasuo,Akali,2934,1449,1485,49.39
Yasuo,Nilah,756,289,467,38.23
Yasuo,Illaoi,1184,574,610,48.48
Yasuo,Leblanc,1328,700,628,52.71
Yasuo,Anivia,687,336,351,48.91
Yasuo,Darius,4436,2116,2320,47.7
Yasuo,Vladimir,1825,889,936,48.71
Yasuo,Jinx,6667,3301,3366,49.51
Yasuo,Morgana,2893,1427,1466,49.33
Yasuo,Volibear,2735,1395,1340,51.01
Yasuo,Veigar,2396,1123,1273,46.87
Yasuo,Lulu,3066,1496,1570,48.79
Yasuo,Ekko,2163,1138,1025,52.61
Yasuo,Jhin,4962,2505,2457,50.48
Yasuo,Nautilus,2555,1287,1268,50.37
Yasuo,Ambessa,1428,748,680,52.38
Yasuo,Taliyah,615,305,310,49.59
Yasuo,Vex,1751,790,961,45.12
Yasuo,MissFortune,5418,2742,2676,50.61
Yasuo,Elise,1600,810,790,50.63
Yasuo,XinZhao,1421,680,741,47.85
Yasuo,Briar,1727,800,927,46.32
Yasuo,AurelionSol,919,461,458,50.16
Yasuo,Twitch,1845,979,866,53.06
Yasuo,Heimerdinger,1111,599,512,53.92
Yasuo,Renata,341,173,168,50.73
Yasuo,Nunu,1222,602,620,49.26
Yasuo,Sion,1637,803,834,49.05
Yasuo,Sylas,3628,1887,1741,52.01
Yasuo,Olaf,494,246,248,49.8
Yasuo,Shaco,2219,1182,1037,53.27
Yasuo,Lissandra,1016,482,534,47.44
Yasuo,Sett,3908,1912,1996,48.93
Yasuo,Aatrox,1924,976,948,50.73
Yasuo,Neeko,951,483,468,50.79
Yasuo,TahmKench,1815,1006,809,55.43
Yasuo,Teemo,3100,1594,1506,51.42
Yasuo,Lux,5970,3040,2930,50.92
Yasuo,Blitzcrank,1624,817,807,50.31
Yasuo,Udyr,893,451,442,50.5
Yasuo,FiddleSticks,1208,566,642,46.85
Yasuo,Kennen,642,325,317,50.62
Yasuo,Taric,538,258,280,47.96
Yasuo,Mordekaiser,2899,1398,1501,48.22
Yasuo,Yorick,2461,1187,1274,48.23
Yasuo,Syndra,1174,616,558,52.47
Yasuo,Gangplank,1157,597,560,51.6
Yasuo,RekSai,253,126,127,49.8
Yasuo,Xerath,2102,1098,1004,52.24
Yasuo,Riven,1200,559,641,46.58
Yasuo,Zoe,785,445,340,56.69
Yasuo,Vi,2181,1092,1089,50.07
Yasuo,Kayn,3483,1680,1803,48.23
Yasuo,Kaisa,3986,2052,1934,51.48
Yasuo,Cassiopeia,643,326,317,50.7
Yasuo,Naafiri,750,422,328,56.27
Yasuo,Brand,1777,874,903,49.18
Yasuo,LeeSin,3606,1971,1635,54.66
Yasuo,Ezreal,5708,2998,2710,52.52
Yasuo,Amumu,2461,1141,1320,46.36
Yasuo,Talon,1529,809,720,52.91
Yasuo,KSante,1285,701,584,54.55
Yasuo,Ahri,2783,1376,1407,49.44
Yasuo,Sona,699,321,378,45.92
Yasuo,Urgot,1194,572,622,47.91
Yasuo,Sejuani,858,433,425,50.47
Yasuo,Kayle,1525,684,841,44.85
Yasuo,Kled,416,237,179,56.97
Yasuo,Aphelios,1196,620,576,51.84
Yasuo,Zilean,714,388,326,54.34
Yasuo,Swain,2352,1108,1244,47.11
Yasuo,Garen,4114,2036,2078,49.49
Yasuo,Zeri,939,453,486,48.24
Yasuo,Rumble,684,391,293,57.16
Yasuo,Jayce,1109,595,514,53.65
Yasuo,Hwei,1460,759,701,51.99
Yasuo,Malphite,2711,1283,1428,47.33
Yasuo,Akshan,662,343,319,51.81
Yasuo,Draven,1124,615,509,54.72
Yasuo,Seraphine,1607,891,716,55.44
Yasuo,Poppy,1444,712,732,49.31
Yasuo,Rammus,930,429,501,46.13
Yasuo,Nasus,1844,902,942,48.92
Yasuo,Janna,881,426,455,48.35
Yasuo,Thresh,3090,1421,1669,45.99
Yasuo,Kindred,932,499,433,53.54
Yasuo,Ornn,868,462,406,53.23
Yasuo,Gnar,914,482,432,52.74
Yasuo,Alistar,942,451,491,47.88
Yasuo,Milio,1276,593,683,46.47
Yasuo,Annie,955,425,530,44.5
Yasuo,Ryze,777,363,414,46.72
Yasuo,Qiyana,570,309,261,54.21
Yasuo,Zyra,2174,1136,1038,52.25
Yasuo,Gwen,1063,542,521,50.99
Yasuo,Fizz,1415,746,669,52.72
Yasuo,Karthus,687,347,340,50.51
Yasuo,Yuumi,1882,1015,867,53.93
Yasuo,KogMaw,653,330,323,50.54
Yasuo,Smolder,1433,777,656,54.22
Yasuo,Shyvana,520,274,246,52.69
Yasuo,TwistedFate,739,371,368,50.2
Yasuo,Ziggs,763,374,389,49.02
Yasuo,Skarner,506,299,207,59.09
Yasuo,MonkeyKing,1606,791,815,49.25
Yasuo,JarvanIV,1231,584,647,47.44
Yasuo,Rell,1083,515,568,47.55
Yasuo,Nidalee,655,362,293,55.27
Yasuo,Maokai,1021,510,511,49.95
Yasuo,Kalista,517,214,303,41.39
Yasuo,Belveth,519,235,284,45.28
Yasuo,Ivern,314,161,153,51.27
Yasuo,Bard,659,317,342,48.1
Caitlyn,Chogath,3839,1861,1978,48.48
Caitlyn,Viego,4709,2254,2455,47.87
Caitlyn,Galio,2797,1422,1375,50.84
Caitlyn,Sivir,1955,962,993,49.21
Caitlyn,Pyke,2681,1368,1313,51.03
Caitlyn,Darius,6112,3046,3066,49.84
Caitlyn,Rammus,1003,439,564,43.77
Caitlyn,Qiyana,823,451,372,54.8
Caitlyn,Ezreal,9941,5159,4782,51.9
Caitlyn,Swain,3180,1659,1521,52.17
Caitlyn,Shen,1976,1017,959,51.47
Caitlyn,Belveth,709,369,340,52.05
Caitlyn,Akali,3617,1887,1730,52.17
Caitlyn,Varus,3215,1646,1569,51.2
Caitlyn,Lulu,4058,2098,1960,51.7
Caitlyn,Renekton,1563,795,768,50.86
Caitlyn,Nocturne,4091,1841,2250,45
Caitlyn,Viktor,2873,1459,1414,50.78
Caitlyn,Xayah,1503,774,729,51.5
Caitlyn,Tryndamere,1967,1035,932,52.62
Caitlyn,Lillia,1793,950,843,52.98
Caitlyn,Tristana,3443,1823,1620,52.95
Caitlyn,Senna,2440,1206,1234,49.43
Caitlyn,Irelia,2964,1422,1542,47.98
Caitlyn,MasterYi,4177,2080,2097,49.8
Caitlyn,Azir,1047,526,521,50.24
Caitlyn,Lucian,2218,1141,1077,51.44
Caitlyn,Mel,6464,3414,3050,52.82
Caitlyn,Ambessa,1974,1064,910,53.9
Caitlyn,Ekko,3143,1633,1510,51.96
Caitlyn,Yasuo,6607,3344,3263,50.61
Caitlyn,Veigar,3374,1661,1713,49.23
Caitlyn,Warwick,5078,2492,2586,49.07
Caitlyn,Hecarim,1308,629,679,48.09
Caitlyn,Diana,5300,2515,2785,47.45
Caitlyn,Ziggs,1450,714,736,49.24
Caitlyn,Karma,4066,2000,2066,49.19
Caitlyn,Sett,5028,2377,2651,47.28
Caitlyn,Leblanc,2025,974,1051,48.1
Caitlyn,Jinx,11587,5690,5897,49.11
Caitlyn,Alistar,1301,646,655,49.65
Caitlyn,Ivern,448,235,213,52.46
Caitlyn,Anivia,975,505,470,51.79
Caitlyn,Ashe,7644,3829,3815,50.09
Caitlyn,Aatrox,2730,1474,1256,53.99
Caitlyn,Rumble,837,422,415,50.42
Caitlyn,Kayn,4945,2515,2430,50.86
Caitlyn,Akshan,1085,576,509,53.09
Caitlyn,Jhin,8840,4284,4556,48.46
Caitlyn,Yuumi,2544,1336,1208,52.52
Caitlyn,Mordekaiser,4186,2091,2095,49.95
Caitlyn,Skarner,759,417,342,54.94
Caitlyn,MissFortune,9540,4700,4840,49.27
Caitlyn,Lux,8792,4317,4475,49.1
Caitlyn,Vladimir,2219,1185,1034,53.4
Caitlyn,Pantheon,5166,2579,2587,49.92
Caitlyn,Teemo,4215,2077,2138,49.28
Caitlyn,Amumu,3625,1765,1860,48.69
Caitlyn,Khazix,1706,915,791,53.63
Caitlyn,Milio,1999,949,1050,47.47
Caitlyn,Gragas,1719,934,785,54.33
Caitlyn,Kaisa,5216,2720,2496,52.15
Caitlyn,Nautilus,3711,1819,1892,49.02
Caitlyn,Yone,6129,3324,2805,54.23
Caitlyn,Fizz,2024,1057,967,52.22
Caitlyn,Briar,2338,1104,1234,47.22
Caitlyn,Seraphine,2645,1297,1348,49.04
Caitlyn,Blitzcrank,2432,1244,1188,51.15
Caitlyn,Volibear,3833,1900,1933,49.57
Caitlyn,Yorick,3389,1546,1843,45.62
Caitlyn,Rengar,962,537,425,55.82
Caitlyn,Soraka,1612,767,845,47.58
Caitlyn,Zed,3873,2022,1851,52.21
Caitlyn,Brand,2715,1341,1374,49.39
Caitlyn,Malzahar,3520,1710,1810,48.58
Caitlyn,Vi,3052,1580,1472,51.77
Caitlyn,Ahri,4456,2282,2174,51.21
Caitlyn,Jax,3000,1595,1405,53.17
Caitlyn,Twitch,2720,1461,1259,53.71
Caitlyn,Velkoz,2014,961,1053,47.72
Caitlyn,Sion,2292,1118,1174,48.78
Caitlyn,Sylas,4620,2339,2281,50.63
Caitlyn,Trundle,2031,1002,1029,49.34
Caitlyn,Draven,1723,893,830,51.83
Caitlyn,Rell,1552,764,788,49.23
Caitlyn,Singed,853,423,430,49.59
Caitlyn,Thresh,4090,2023,2067,49.46
Caitlyn,Aurora,2175,1125,1050,51.72
Caitlyn,Evelynn,1218,639,579,52.46
Caitlyn,TahmKench,2453,1266,1187,51.61
Caitlyn,FiddleSticks,1502,792,710,52.73
Caitlyn,Corki,1145,644,501,56.24
Caitlyn,Elise,2194,1019,1175,46.44
Caitlyn,Gangplank,1484,770,714,51.89
Caitlyn,RekSai,294,139,155,47.28
Caitlyn,Xerath,3222,1582,1640,49.1
Caitlyn,Vayne,4194,2100,2094,50.07
Caitlyn,Nasus,2406,1235,1171,51.33
Caitlyn,Kennen,751,377,374,50.2
Caitlyn,Ryze,1093,543,550,49.68
Caitlyn,Neeko,1444,690,754,47.78
Caitlyn,Syndra,2011,1019,992,50.67
Caitlyn,Urgot,1766,857,909,48.53
Caitlyn,Zoe,1141,547,594,47.94
Caitlyn,Shaco,3238,1757,1481,54.26
Caitlyn,AurelionSol,1230,617,613,50.16
Caitlyn,Smolder,2071,1094,977,52.82
Caitlyn,Morgana,4129,1948,2181,47.18
Caitlyn,TwistedFate,1171,612,559,52.26
Caitlyn,KSante,1675,864,811,51.58
Caitlyn,Katarina,2552,1252,1300,49.06
Caitlyn,Leona,2794,1421,1373,50.86
Caitlyn,Talon,1734,915,819,52.77
Caitlyn,Nami,3117,1516,1601,48.64
Caitlyn,Orianna,1387,668,719,48.16
Caitlyn,Illaoi,1520,794,726,52.24
Caitlyn,Zyra,3309,1591,1718,48.08
Caitlyn,Kayle,2281,1118,1163,49.01
Caitlyn,LeeSin,4699,2361,2338,50.24
Caitlyn,Gnar,1294,661,633,51.08
Caitlyn,Taric,699,339,360,48.5
Caitlyn,Udyr,1353,697,656,51.52
Caitlyn,Taliyah,701,343,358,48.93
Caitlyn,Hwei,2186,994,1192,45.47
Caitlyn,Kalista,742,421,321,56.74
Caitlyn,Poppy,1782,886,896,49.72
Caitlyn,Samira,2420,1211,1209,50.04
Caitlyn,Zilean,1042,524,518,50.29
Caitlyn,Nilah,870,407,463,46.78
Caitlyn,Bard,937,509,428,54.32
Caitlyn,Camille,1082,539,543,49.82
Caitlyn,Gwen,1544,760,784,49.22
Caitlyn,Quinn,1227,555,672,45.23
Caitlyn,MonkeyKing,2292,1138,1154,49.65
Caitlyn,Garen,5416,2688,2728,49.63
Caitlyn,Kassadin,735,402,333,54.69
Caitlyn,Rakan,1100,587,513,53.36
Caitlyn,Fiora,1074,557,517,51.86
Caitlyn,XinZhao,2043,1050,993,51.4
Caitlyn,Graves,2043,1033,1010,50.56
Caitlyn,Karthus,885,464,421,52.43
Caitlyn,Janna,930,497,433,53.44
Caitlyn,DrMundo,1796,858,938,47.77
Caitlyn,Heimerdinger,1594,765,829,47.99
Caitlyn,Riven,1336,660,676,49.4
Caitlyn,Jayce,1557,849,708,54.53
Caitlyn,Kindred,1376,717,659,52.11
Caitlyn,Annie,1010,495,515,49.01
Caitlyn,Nunu,1809,903,906,49.92
Caitlyn,Aphelios,1822,880,942,48.3
Caitlyn,Braum,1937,973,964,50.23
Caitlyn,JarvanIV,1797,853,944,47.47
Caitlyn,Kled,583,299,284,51.29
Caitlyn,Vex,1729,795,934,45.98
Caitlyn,Naafiri,1122,546,576,48.66
Caitlyn,Malphite,3391,1681,1710,49.57
Caitlyn,Maokai,1440,706,734,49.03
Caitlyn,Shyvana,775,378,397,48.77
Caitlyn,Sejuani,1358,717,641,52.8
Caitlyn,Lissandra,1009,520,489,51.54
Caitlyn,Zeri,1124,580,544,51.6
Caitlyn,Sona,1071,494,577,46.13
Caitlyn,Ornn,1327,657,670,49.51
Caitlyn,Nidalee,905,460,445,50.83
Caitlyn,Renata,448,239,209,53.35
Caitlyn,Cassiopeia,854,423,431,49.53
Caitlyn,KogMaw,1004,503,501,50.1
Caitlyn,Olaf,777,416,361,53.54
Caitlyn,Zac,1607,822,785,51.15
Yuumi,Chogath,1102,511,591,46.37
Yuumi,Viego,1351,648,703,47.96
Yuumi,Galio,777,355,422,45.69
Yuumi,Sivir,385,201,184,52.21
Yuumi,Pyke,782,465,317,59.46
Yuumi,Gangplank,439,215,224,48.97
Yuumi,Evelynn,354,170,184,48.02
Yuumi,Mel,1847,980,867,53.06
Yuumi,Ashe,1957,958,999,48.95
Yuumi,Elise,734,324,410,44.14
Yuumi,Gwen,457,245,212,53.61
Yuumi,Skarner,256,142,114,55.47
Yuumi,DrMundo,531,259,272,48.78
Yuumi,Samira,652,284,368,43.56
Yuumi,Malphite,876,437,439,49.89
Yuumi,Mordekaiser,1271,580,691,45.63
Yuumi,Karthus,273,158,115,57.88
Yuumi,Katarina,693,313,380,45.17
Yuumi,Jhin,1991,998,993,50.13
Yuumi,Karma,1231,592,639,48.09
Yuumi,Fiora,349,166,183,47.56
Yuumi,Warwick,1202,543,659,45.17
Yuumi,Zed,1086,535,551,49.26
Yuumi,Swain,852,444,408,52.11
Yuumi,Garen,1466,665,801,45.36
Yuumi,Diana,1472,710,762,48.23
Yuumi,Vladimir,632,350,282,55.38
Yuumi,Caitlyn,2544,1208,1336,47.48
Yuumi,Lulu,1529,758,771,49.57
Yuumi,Renekton,474,223,251,47.05
Yuumi,Aurora,634,316,318,49.84
Yuumi,Corki,389,224,165,57.58
Yuumi,Pantheon,1444,627,817,43.42
Yuumi,Ornn,354,194,160,54.8
Yuumi,Fizz,491,242,249,49.29
Yuumi,Ezreal,2046,1091,955,53.32
Yuumi,Rakan,333,142,191,42.64
Yuumi,Kayle,603,328,275,54.39
Yuumi,Nasus,635,299,336,47.09
Yuumi,Anivia,320,149,171,46.56
Yuumi,KogMaw,334,172,162,51.5
Yuumi,Nami,1027,532,495,51.8
Yuumi,MonkeyKing,572,231,341,40.38
Yuumi,Kassadin,184,75,109,40.76
Yuumi,Lucian,697,349,348,50.07
Yuumi,Gnar,326,159,167,48.77
Yuumi,Rammus,328,144,184,43.9
Yuumi,Veigar,914,418,496,45.73
Yuumi,Soraka,543,252,291,46.41
Yuumi,Darius,1713,823,890,48.04
Yuumi,Varus,889,463,426,52.08
Yuumi,Trundle,525,264,261,50.29
Yuumi,Sett,1246,620,626,49.76
Yuumi,Amumu,875,430,445,49.14
Yuumi,Taliyah,216,88,128,40.74
Yuumi,Xayah,449,190,259,42.32
Yuumi,Braum,443,203,240,45.82
Yuumi,Urgot,457,201,256,43.98
Yuumi,Jax,835,361,474,43.23
Yuumi,Teemo,1162,582,580,50.09
Yuumi,Shaco,864,456,408,52.78
Yuumi,Annie,342,179,163,52.34
Yuumi,Yone,1801,879,922,48.81
Yuumi,Kayn,1288,637,651,49.46
Yuumi,Orianna,372,164,208,44.09
Yuumi,Kaisa,1649,782,867,47.42
Yuumi,Bard,311,183,128,58.84
Yuumi,Akali,1042,535,507,51.34
Yuumi,Morgana,1049,510,539,48.62
Yuumi,Tristana,870,400,470,45.98
Yuumi,Leona,878,404,474,46.01
Yuumi,Ahri,1090,538,552,49.36
Yuumi,Draven,487,219,268,44.97
Yuumi,Quinn,343,171,172,49.85
Yuumi,Talon,668,283,385,42.37
Yuumi,Vayne,1125,530,595,47.11
Yuumi,Lux,2349,1150,1199,48.96
Yuumi,Graves,681,376,305,55.21
Yuumi,Thresh,1287,575,712,44.68
Yuumi,Ambessa,576,277,299,48.09
Yuumi,Rengar,345,183,162,53.04
Yuumi,Gragas,574,243,331,42.33
Yuumi,Sejuani,406,178,228,43.84
Yuumi,Malzahar,956,435,521,45.5
Yuumi,JarvanIV,539,266,273,49.35
Yuumi,MissFortune,2128,1020,1108,47.93
Yuumi,Seraphine,628,315,313,50.16
Yuumi,MasterYi,1092,507,585,46.43
Yuumi,Nilah,284,136,148,47.89
Yuumi,Zilean,404,221,183,54.7
Yuumi,Kled,139,76,63,54.68
Yuumi,Cassiopeia,281,128,153,45.55
Yuumi,Blitzcrank,637,354,283,55.57
Yuumi,Twitch,781,418,363,53.52
Yuumi,Illaoi,406,209,197,51.48
Yuumi,Yasuo,1882,867,1015,46.07
Yuumi,Zyra,918,437,481,47.6
Yuumi,Riven,448,203,245,45.31
Yuumi,Brand,694,355,339,51.15
Yuumi,Ekko,837,430,407,51.37
Yuumi,Yorick,888,395,493,44.48
Yuumi,Qiyana,222,125,97,56.31
Yuumi,TwistedFate,312,172,140,55.13
Yuumi,LeeSin,1511,771,740,51.03
Yuumi,Nocturne,1167,582,585,49.87
Yuumi,Sona,301,114,187,37.87
Yuumi,Udyr,353,180,173,50.99
Yuumi,Rell,509,230,279,45.19
Yuumi,Singed,263,115,148,43.73
Yuumi,Neeko,376,192,184,51.06
Yuumi,Milio,572,264,308,46.15
Yuumi,Viktor,821,401,420,48.84
Yuumi,Camille,325,157,168,48.31
Yuumi,Akshan,345,185,160,53.62
Yuumi,Syndra,718,314,404,43.73
Yuumi,Naafiri,336,177,159,52.68
Yuumi,Smolder,569,318,251,55.89
Yuumi,Irelia,871,416,455,47.76
Yuumi,Zoe,346,164,182,47.4
Yuumi,Velkoz,518,259,259,50
Yuumi,Leblanc,623,319,304,51.2
Yuumi,Taric,211,72,139,34.12
Yuumi,Aphelios,556,257,299,46.22
Yuumi,Sylas,1279,603,676,47.15
Yuumi,FiddleSticks,496,248,248,50
Yuumi,Kalista,248,106,142,42.74
Yuumi,Azir,381,198,183,51.97
Yuumi,Jinx,2560,1218,1342,47.58
Yuumi,Ziggs,254,134,120,52.76
Yuumi,Xerath,894,440,454,49.22
Yuumi,Briar,710,335,375,47.18
Yuumi,Sion,663,333,330,50.23
Yuumi,TahmKench,580,270,310,46.55
Yuumi,Volibear,1037,489,548,47.16
Yuumi,Nidalee,292,164,128,56.16
Yuumi,Maokai,412,198,214,48.06
Yuumi,Poppy,567,256,311,45.15
Yuumi,Nautilus,1069,425,644,39.76
Yuumi,Kennen,233,134,99,57.51
Yuumi,Aatrox,868,453,415,52.19
Yuumi,Belveth,211,87,124,41.23
Yuumi,Vi,957,442,515,46.19
Yuumi,Nunu,524,226,298,43.13
Yuumi,Hecarim,365,189,176,51.78
Yuumi,Janna,301,128,173,42.52
Yuumi,Tryndamere,538,215,323,39.96
Yuumi,Ryze,318,136,182,42.77
Yuumi,Shyvana,212,110,102,51.89
Yuumi,Vex,500,228,272,45.6
Yuumi,XinZhao,587,293,294,49.91
Yuumi,Heimerdinger,350,152,198,43.43
Yuumi,Olaf,195,93,102,47.69
Yuumi,Lillia,505,221,284,43.76
Yuumi,Khazix,387,194,193,50.13
Yuumi,Jayce,481,264,217,54.89
Yuumi,Hwei,630,304,326,48.25
Yuumi,Ivern,147,62,85,42.18
Yuumi,RekSai,122,51,71,41.8
Yuumi,Rumble,228,111,117,48.68
Yuumi,Zac,533,272,261,51.03
Yuumi,Zeri,381,183,198,48.03
Yuumi,Shen,558,276,282,49.46
Yuumi,KSante,530,256,274,48.3
Yuumi,Renata,105,60,45,57.14
Yuumi,Alistar,351,186,165,52.99
Yuumi,Lissandra,317,158,159,49.84
Yuumi,Senna,714,396,318,55.46
Yuumi,Kindred,379,191,188,50.4
Yuumi,AurelionSol,338,188,150,55.62
Chogath,Singed,370,175,195,47.3
Chogath,LeeSin,1743,958,785,54.96
Chogath,Yasuo,2915,1409,1506,48.34
Chogath,Caitlyn,3839,1978,1861,51.52
Chogath,Yuumi,1102,591,511,53.63
Chogath,Sett,2373,1156,1217,48.71
Chogath,MasterYi,1803,931,872,51.64
Chogath,Vladimir,997,543,454,54.46
Chogath,Zilean,473,226,247,47.78
Chogath,Senna,1057,542,515,51.28
Chogath,Darius,2715,1388,1327,51.12
Chogath,Zac,648,325,323,50.15
Chogath,Malzahar,1506,727,779,48.27
Chogath,Ziggs,528,251,277,47.54
Chogath,Sona,459,215,244,46.84
Chogath,Gwen,940,487,453,51.81
Chogath,Nocturne,1834,835,999,45.53
Chogath,Veigar,1549,819,730,52.87
Chogath,Jinx,4219,2063,2156,48.9
Chogath,Morgana,1677,839,838,50.03
Chogath,Irelia,1202,607,595,50.5
Chogath,Diana,2231,1167,1064,52.31
Chogath,Fizz,826,408,418,49.39
Chogath,Vayne,2082,966,1116,46.4
Chogath,Vi,1347,720,627,53.45
Chogath,Ahri,1847,925,922,50.08
Chogath,Jhin,2812,1388,1424,49.36
Chogath,Pyke,1204,634,570,52.66
Chogath,Volibear,1721,889,832,51.66
Chogath,Sejuani,553,281,272,50.81
Chogath,Lux,3445,1752,1693,50.86
Chogath,Nautilus,1547,823,724,53.2
Chogath,Tryndamere,912,450,462,49.34
Chogath,Shyvana,352,190,162,53.98
Chogath,Ambessa,735,396,339,53.88
Chogath,Thresh,1789,920,869,51.43
Chogath,Naafiri,471,260,211,55.2
Chogath,Akali,1467,782,685,53.31
Chogath,Zyra,1278,634,644,49.61
Chogath,Kled,239,117,122,48.95
Chogath,Warwick,2233,1113,1120,49.84
Chogath,Syndra,922,444,478,48.16
Chogath,Ashe,2706,1395,1311,51.55
Chogath,Milio,813,404,409,49.69
Chogath,Mordekaiser,2070,947,1123,45.75
Chogath,Kayle,1079,547,532,50.7
Chogath,TahmKench,1199,627,572,52.29
Chogath,Rengar,427,202,225,47.31
Chogath,Ezreal,3014,1679,1335,55.71
Chogath,Briar,1040,517,523,49.71
Chogath,Brand,1143,567,576,49.61
Chogath,Pantheon,2008,1095,913,54.53
Chogath,Leona,1307,615,692,47.05
Chogath,Lillia,865,403,462,46.59
Chogath,Tristana,1470,778,692,52.93
Chogath,Smolder,841,405,436,48.16
Chogath,Lulu,1818,933,885,51.32
Chogath,Sion,1150,572,578,49.74
Chogath,Talon,767,382,385,49.8
Chogath,Nami,1528,772,756,50.52
Chogath,Graves,917,472,445,51.47
Chogath,FiddleSticks,725,408,317,56.28
Chogath,Yone,2641,1350,1291,51.12
Chogath,Sylas,1824,954,870,52.3
Chogath,Velkoz,904,429,475,47.46
Chogath,Kaisa,2147,1096,1051,51.05
Chogath,Illaoi,766,369,397,48.17
Chogath,Aurora,912,484,428,53.07
Chogath,Jax,1168,651,517,55.74
Chogath,MissFortune,3381,1750,1631,51.76
Chogath,Garen,2363,1268,1095,53.66
Chogath,Shaco,1282,686,596,53.51
Chogath,Fiora,623,364,259,58.43
Chogath,Viego,1951,1009,942,51.72
Chogath,Braum,842,444,398,52.73
Chogath,Poppy,860,474,386,55.12
Chogath,Karthus,388,220,168,56.7
Chogath,Zeri,556,287,269,51.62
Chogath,Leblanc,759,421,338,55.47
Chogath,Gragas,704,391,313,55.54
Chogath,Janna,486,237,249,48.77
Chogath,Kayn,2090,1057,1033,50.57
Chogath,KogMaw,471,222,249,47.13
Chogath,Yorick,1756,881,875,50.17
Chogath,Orianna,601,315,286,52.41
Chogath,Lucian,897,471,426,52.51
Chogath,DrMundo,1067,486,581,45.55
Chogath,Elise,958,461,497,48.12
Chogath,Hwei,910,436,474,47.91
Chogath,Zed,1524,821,703,53.87
Chogath,Aphelios,723,400,323,55.33
Chogath,Swain,1442,735,707,50.97
Chogath,Blitzcrank,938,524,414,55.86
Chogath,Aatrox,1114,539,575,48.38
Chogath,Alistar,606,322,284,53.14
Chogath,Mel,3081,1661,1420,53.91
Chogath,Camille,435,221,214,50.8
Chogath,Galio,1162,596,566,51.29
Chogath,Akshan,549,300,249,54.64
Chogath,Varus,1171,604,567,51.58
Chogath,Khazix,666,379,287,56.91
Chogath,XinZhao,838,410,428,48.93
Chogath,Evelynn,518,287,231,55.41
Chogath,Rakan,567,301,266,53.09
Chogath,Annie,470,261,209,55.53
Chogath,RekSai,161,119,42,73.91
Chogath,Nasus,1011,538,473,53.21
Chogath,Shen,908,482,426,53.08
Chogath,Teemo,2027,1068,959,52.69
Chogath,Corki,550,308,242,56
Chogath,Draven,719,380,339,52.85
Chogath,Soraka,800,422,378,52.75
Chogath,Udyr,566,276,290,48.76
Chogath,Azir,481,254,227,52.81
Chogath,Gnar,567,273,294,48.15
Chogath,Trundle,885,434,451,49.04
Chogath,Amumu,1669,854,815,51.17
Chogath,Olaf,364,179,185,49.18
Chogath,AurelionSol,569,283,286,49.74
Chogath,Xerath,1255,648,607,51.63
Chogath,Katarina,1075,622,453,57.86
Chogath,Anivia,481,228,253,47.4
Chogath,Lissandra,446,250,196,56.05
Chogath,Urgot,725,336,389,46.34
Chogath,Sivir,776,380,396,48.97
Chogath,Kassadin,295,147,148,49.83
Chogath,JarvanIV,862,403,459,46.75
Chogath,Jayce,561,296,265,52.76
Chogath,Nidalee,323,179,144,55.42
Chogath,Viktor,1153,578,575,50.13
Chogath,Ekko,1338,648,690,48.43
Chogath,Maokai,668,323,345,48.35
Chogath,Nunu,755,369,386,48.87
Chogath,Ryze,429,238,191,55.48
Chogath,Malphite,1392,754,638,54.17
Chogath,Seraphine,1017,465,552,45.72
Chogath,Zoe,522,245,277,46.93
Chogath,Gangplank,638,352,286,55.17
Chogath,Skarner,304,156,148,51.32
Chogath,Vex,691,369,322,53.4
Chogath,Kindred,558,302,256,54.12
Chogath,Nilah,544,260,284,47.79
Chogath,Karma,1605,822,783,51.21
Chogath,Xayah,650,325,325,50
Chogath,Riven,568,307,261,54.05
Chogath,Ivern,192,86,106,44.79
Chogath,Kennen,377,199,178,52.79
Chogath,Samira,1000,545,455,54.5
Chogath,Rumble,316,165,151,52.22
Chogath,Neeko,608,316,292,51.97
Chogath,Qiyana,309,175,134,56.63
Chogath,Taric,354,190,164,53.67
Chogath,Rammus,441,256,185,58.05
Chogath,Rell,598,311,287,52.01
Chogath,Heimerdinger,626,322,304,51.44
Chogath,KSante,602,322,280,53.49
Chogath,MonkeyKing,875,463,412,52.91
Chogath,Ornn,593,309,284,52.11
Chogath,TwistedFate,464,250,214,53.88
Chogath,Bard,412,183,229,44.42
Chogath,Renekton,603,339,264,56.22
Chogath,Kalista,268,156,112,58.21
Chogath,Quinn,442,227,215,51.36
Chogath,Hecarim,546,282,264,51.65
Chogath,Twitch,1202,641,561,53.33
Chogath,Cassiopeia,458,253,205,55.24
Chogath,Belveth,297,153,144,51.52
Chogath,Taliyah,324,165,159,50.93
Chogath,Renata,200,102,98,51
Viego,Singed,434,221,213,50.92
Viego,LeeSin,3900,2040,1860,52.31
Viego,Yasuo,3484,1748,1736,50.17
Viego,Caitlyn,4709,2455,2254,52.13
Viego,Yuumi,1351,703,648,52.04
Viego,Pantheon,3012,1553,1459,51.56
Viego,Belveth,449,262,187,58.35
Viego,Katarina,1459,721,738,49.42
Viego,KogMaw,512,229,283,44.73
Viego,Lux,4109,2045,2064,49.77
Viego,Gwen,803,464,339,57.78
Viego,Khazix,962,540,422,56.13
Viego,TwistedFate,635,341,294,53.7
Viego,Varus,1585,771,814,48.64
Viego,Thresh,2525,1238,1287,49.03
Viego,Tryndamere,984,483,501,49.09
Viego,Amumu,1814,869,945,47.91
Viego,Vex,883,430,453,48.7
Viego,Jinx,5023,2483,2540,49.43
Viego,Mel,3528,1874,1654,53.12
Viego,Jax,1682,796,886,47.32
Viego,Warwick,2528,1186,1342,46.91
Viego,Galio,1531,785,746,51.27
Viego,Ezreal,4344,2203,2141,50.71
Viego,Nami,1613,768,845,47.61
Viego,Ambessa,1184,623,561,52.62
Viego,JarvanIV,976,454,522,46.52
Viego,Sylas,2654,1399,1255,52.71
Viego,Ashe,3708,1902,1806,51.29
Viego,Alistar,836,413,423,49.4
Viego,MonkeyKing,1360,674,686,49.56
Viego,Kaisa,2910,1520,1390,52.23
Viego,Renata,329,190,139,57.75
Viego,Teemo,1968,934,1034,47.46
Viego,Skarner,425,244,181,57.41
Viego,Yone,3284,1766,1518,53.78
Viego,Blitzcrank,1271,652,619,51.3
Viego,Sion,1355,654,701,48.27
Viego,Udyr,714,348,366,48.74
Viego,Ryze,614,287,327,46.74
Viego,Leona,1507,772,735,51.23
Viego,Anivia,523,288,235,55.07
Viego,MissFortune,3992,1944,2048,48.7
Viego,Velkoz,938,470,468,50.11
Viego,Maokai,808,415,393,51.36
Viego,Ziggs,608,287,321,47.2
Viego,Lucian,1198,637,561,53.17
Viego,Sona,454,215,239,47.36
Viego,Garen,2651,1295,1356,48.85
Viego,Akali,1967,935,1032,47.53
Viego,Zed,2059,1010,1049,49.05
Viego,Viktor,1615,779,836,48.24
Viego,Urgot,797,396,401,49.69
Viego,Darius,3267,1580,1687,48.36
Viego,Malzahar,1647,820,827,49.79
Viego,Trundle,1007,477,530,47.37
Viego,Volibear,1985,1033,952,52.04
Viego,Naafiri,603,302,301,50.08
Viego,Jhin,3729,1854,1875,49.72
Viego,Veigar,1663,815,848,49.01
Viego,Hwei,1206,604,602,50.08
Viego,Brand,1148,576,572,50.17
Viego,MasterYi,2122,1011,1111,47.64
Viego,Rakan,703,375,328,53.34
Viego,Gragas,944,519,425,54.98
Viego,Kayn,2733,1303,1430,47.68
Viego,Janna,530,291,239,54.91
Viego,Ekko,1700,881,819,51.82
Viego,Vladimir,1196,651,545,54.43
Viego,Rell,856,378,478,44.16
Viego,Shaco,1594,801,793,50.25
Viego,Chogath,1951,942,1009,48.28
Viego,Diana,3102,1586,1516,51.13
Viego,Xayah,713,358,355,50.21
Viego,TahmKench,1314,685,629,52.13
Viego,Morgana,1777,910,867,51.21
Viego,Mordekaiser,1962,958,1004,48.83
Viego,Shen,1078,533,545,49.44
Viego,Yorick,1695,745,950,43.95
Viego,Orianna,779,421,358,54.04
Viego,Kennen,513,252,261,49.12
Viego,Braum,1029,440,589,42.76
Viego,Nasus,1228,563,665,45.85
Viego,Fiora,574,282,292,49.13
Viego,Karma,2187,1115,1072,50.98
Viego,Aatrox,1659,785,874,47.32
Viego,Vi,1706,881,825,51.64
Viego,AurelionSol,649,347,302,53.47
Viego,Heimerdinger,732,374,358,51.09
Viego,Lillia,977,493,484,50.46
Viego,Lulu,2349,1237,1112,52.66
Viego,Sett,2705,1297,1408,47.95
Viego,Rengar,533,273,260,51.22
Viego,Irelia,1524,744,780,48.82
Viego,Corki,768,387,381,50.39
Viego,Pyke,1470,765,705,52.04
Viego,Briar,1174,597,577,50.85
Viego,Nidalee,609,330,279,54.19
Viego,Illaoi,755,385,370,50.99
Viego,Kindred,794,429,365,54.03
Viego,Gangplank,873,458,415,52.46
Viego,Sejuani,609,282,327,46.31
Viego,Vayne,2142,1069,1073,49.91
Viego,Ahri,2041,986,1055,48.31
Viego,Neeko,869,428,441,49.25
Viego,Tristana,1748,870,878,49.77
Viego,Nautilus,2053,963,1090,46.91
Viego,Kayle,1088,541,547,49.72
Viego,Soraka,860,418,442,48.6
Viego,Cassiopeia,499,259,240,51.9
Viego,Graves,1176,588,588,50
Viego,Aphelios,838,415,423,49.52
Viego,Kassadin,330,174,156,52.73
Viego,Sivir,863,400,463,46.35
Viego,Renekton,960,483,477,50.31
Viego,Taliyah,413,212,201,51.33
Viego,Senna,1318,661,657,50.15
Viego,Zyra,1649,888,761,53.85
Viego,Twitch,1228,611,617,49.76
Viego,Swain,1620,854,766,52.72
Viego,Annie,546,286,260,52.38
Viego,Smolder,1002,499,503,49.8
Viego,Shyvana,394,187,207,47.46
Viego,Fizz,1002,479,523,47.8
Viego,Olaf,417,215,202,51.56
Viego,Xerath,1694,804,890,47.46
Viego,Zilean,583,307,276,52.66
Viego,Milio,963,477,486,49.53
Viego,Gnar,691,326,365,47.18
Viego,Elise,1343,656,687,48.85
Viego,XinZhao,1156,583,573,50.43
Viego,Samira,1221,640,581,52.42
Viego,Poppy,1040,476,564,45.77
Viego,Karthus,457,217,240,47.48
Viego,Nocturne,2043,1026,1017,50.22
Viego,Nunu,921,446,475,48.43
Viego,Riven,861,399,462,46.34
Viego,FiddleSticks,837,377,460,45.04
Viego,Aurora,1268,607,661,47.87
Viego,KSante,889,476,413,53.54
Viego,Syndra,1166,562,604,48.2
Viego,Bard,559,272,287,48.66
Viego,Ornn,713,371,342,52.03
Viego,Evelynn,598,287,311,47.99
Viego,Seraphine,1312,655,657,49.92
Viego,Jayce,970,536,434,55.26
Viego,Camille,588,334,254,56.8
Viego,Nilah,543,256,287,47.15
Viego,Ivern,266,136,130,51.13
Viego,Talon,1109,609,500,54.91
Viego,Rumble,504,257,247,50.99
Viego,Draven,824,458,366,55.58
Viego,DrMundo,952,514,438,53.99
Viego,Leblanc,1126,530,596,47.07
Viego,Zac,931,428,503,45.97
Viego,Malphite,1726,840,886,48.67
Viego,Azir,596,369,227,61.91
Viego,Zeri,755,404,351,53.51
Viego,Lissandra,565,313,252,55.4
Viego,Qiyana,486,250,236,51.44
Viego,Kalista,460,226,234,49.13
Viego,Rammus,605,286,319,47.27
Viego,Akshan,679,332,347,48.9
Viego,Hecarim,769,395,374,51.37
Viego,Quinn,636,294,342,46.23
Viego,Kled,259,138,121,53.28
Viego,Taric,333,191,142,57.36
Viego,Zoe,701,349,352,49.79
Viego,RekSai,226,134,92,59.29
Galio,Singed,286,129,157,45.1
Galio,LeeSin,1681,877,804,52.17
Galio,Yasuo,1849,930,919,50.3
Galio,Caitlyn,2797,1375,1422,49.16
Galio,Yuumi,777,422,355,54.31
Galio,Irelia,880,493,387,56.02
Galio,Hecarim,389,223,166,57.33
Galio,Malzahar,1174,609,565,51.87
Galio,Vayne,1313,612,701,46.61
Galio,Pantheon,1503,805,698,53.56
Galio,Jax,1090,588,502,53.94
Galio,Amumu,1109,510,599,45.99
Galio,Ahri,1577,766,811,48.57
Galio,Lulu,1361,763,598,56.06
Galio,Yorick,937,463,474,49.41
Galio,Briar,664,333,331,50.15
Galio,Jhin,2123,1056,1067,49.74
Galio,Nautilus,1183,619,564,52.32
Galio,Sett,1651,798,853,48.33
Galio,Nasus,640,290,350,45.31
Galio,Aurora,767,402,365,52.41
Galio,Varus,1007,529,478,52.53
Galio,Mel,2145,1142,1003,53.24
Galio,Vi,1030,538,492,52.23
Galio,Soraka,551,259,292,47.01
Galio,Garen,1688,844,844,50
Galio,Graves,655,324,331,49.47
Galio,Diana,2009,1056,953,52.56
Galio,Shaco,919,460,459,50.05
Galio,Malphite,1110,585,525,52.7
Galio,Viego,1531,746,785,48.73
Galio,Twitch,800,387,413,48.38
Galio,Sejuani,359,188,171,52.37
Galio,Ekko,1032,533,499,51.65
Galio,Sylas,2097,1128,969,53.79
Galio,Karma,1309,715,594,54.62
Galio,Volibear,1116,569,547,50.99
Galio,Ezreal,2763,1533,1230,55.48
Galio,Brand,882,470,412,53.29
Galio,Skarner,229,121,108,52.84
Galio,MissFortune,2400,1198,1202,49.92
Galio,Lux,2564,1284,1280,50.08
Galio,DrMundo,606,278,328,45.87
Galio,AurelionSol,359,166,193,46.24
Galio,Rakan,374,207,167,55.35
Galio,Ashe,2231,1142,1089,51.19
Galio,Warwick,1510,819,691,54.24
Galio,Zed,1023,531,492,51.91
Galio,Morgana,1195,628,567,52.55
Galio,Elise,767,415,352,54.11
Galio,Fizz,652,343,309,52.61
Galio,Shen,668,347,321,51.95
Galio,Darius,1868,958,910,51.28
Galio,Vladimir,677,326,351,48.15
Galio,Urgot,482,255,227,52.9
Galio,Anivia,308,165,143,53.57
Galio,Jinx,2883,1415,1468,49.08
Galio,Ambessa,764,437,327,57.2
Galio,Rengar,326,191,135,58.59
Galio,Veigar,903,449,454,49.72
Galio,Kaisa,1893,1034,859,54.62
Galio,Swain,1061,544,517,51.27
Galio,Renekton,533,272,261,51.03
Galio,Velkoz,621,304,317,48.95
Galio,Xerath,1028,489,539,47.57
Galio,Teemo,1456,712,744,48.9
Galio,Kayn,1353,642,711,47.45
Galio,Rumble,371,194,177,52.29
Galio,Yone,1992,1021,971,51.26
Galio,Akali,1502,775,727,51.6
Galio,Ziggs,439,259,180,59
Galio,Hwei,737,353,384,47.9
Galio,Chogath,1162,566,596,48.71
Galio,Nocturne,1303,634,669,48.66
Galio,Nilah,265,122,143,46.04
Galio,Braum,494,255,239,51.62
Galio,Nunu,545,325,220,59.63
Galio,Tristana,1023,579,444,56.6
Galio,Zeri,460,250,210,54.35
Galio,Talon,570,299,271,52.46
Galio,Taliyah,213,101,112,47.42
Galio,MasterYi,1287,669,618,51.98
Galio,Janna,291,131,160,45.02
Galio,Xayah,517,267,250,51.64
Galio,Senna,754,362,392,48.01
Galio,Gangplank,478,258,220,53.97
Galio,Camille,379,229,150,60.42
Galio,Udyr,410,209,201,50.98
Galio,Nidalee,323,171,152,52.94
Galio,MonkeyKing,698,326,372,46.7
Galio,Lucian,630,328,302,52.06
Galio,Annie,337,162,175,48.07
Galio,Evelynn,340,180,160,52.94
Galio,Corki,509,287,222,56.39
Galio,Zyra,1078,550,528,51.02
Galio,Vex,472,258,214,54.66
Galio,Samira,638,327,311,51.25
Galio,Taric,178,92,86,51.69
Galio,Jayce,555,331,224,59.64
Galio,Thresh,1496,716,780,47.86
Galio,FiddleSticks,567,278,289,49.03
Galio,Rammus,350,182,168,52
Galio,Gnar,406,209,197,51.48
Galio,Lillia,668,343,325,51.35
Galio,Milio,501,267,234,53.29
Galio,Belveth,278,139,139,50
Galio,Rell,508,233,275,45.87
Galio,RekSai,139,64,75,46.04
Galio,Tryndamere,507,210,297,41.42
Galio,Leblanc,765,359,406,46.93
Galio,Aphelios,482,226,256,46.89
Galio,Gragas,564,288,276,51.06
Galio,Cassiopeia,295,170,125,57.63
Galio,KogMaw,264,140,124,53.03
Galio,Nami,1004,490,514,48.8
Galio,Aatrox,952,483,469,50.74
Galio,TahmKench,681,363,318,53.3
Galio,JarvanIV,622,289,333,46.46
Galio,Draven,507,279,228,55.03
Galio,Viktor,896,448,448,50
Galio,Fiora,414,173,241,41.79
Galio,Naafiri,310,168,142,54.19
Galio,Gwen,524,284,240,54.2
Galio,Smolder,670,366,304,54.63
Galio,Zoe,455,254,201,55.82
Galio,Heimerdinger,472,242,230,51.27
Galio,Pyke,810,396,414,48.89
Galio,Seraphine,693,359,334,51.8
Galio,Syndra,633,309,324,48.82
Galio,Riven,479,260,219,54.28
Galio,XinZhao,648,316,332,48.77
Galio,Qiyana,205,104,101,50.73
Galio,Sona,343,174,169,50.73
Galio,Katarina,914,514,400,56.24
Galio,Illaoi,495,259,236,52.32
Galio,Blitzcrank,761,388,373,50.99
Galio,Alistar,477,234,243,49.06
Galio,Kindred,510,259,251,50.78
Galio,Leona,989,521,468,52.68
Galio,Neeko,488,261,227,53.48
Galio,Khazix,434,243,191,55.99
Galio,Zilean,305,137,168,44.92
Galio,Kassadin,182,98,84,53.85
Galio,Kennen,266,137,129,51.5
Galio,Kayle,658,356,302,54.1
Galio,Kled,162,80,82,49.38
Galio,Trundle,619,258,361,41.68
Galio,Poppy,661,336,325,50.83
Galio,Mordekaiser,1255,644,611,51.31
Galio,Zac,549,258,291,46.99
Galio,Quinn,367,167,200,45.5
Galio,Ornn,429,207,222,48.25
Galio,Ryze,391,196,195,50.13
Galio,Bard,287,144,143,50.17
Galio,Orianna,399,181,218,45.36
Galio,Sivir,565,312,253,55.22
Galio,Sion,793,404,389,50.95
Galio,KSante,636,322,314,50.63
Galio,Akshan,265,137,128,51.7
Galio,Karthus,328,161,167,49.09
Galio,Azir,372,183,189,49.19
Galio,Olaf,235,120,115,51.06
Galio,Ivern,106,66,40,62.26
Galio,Renata,196,105,91,53.57
Galio,Lissandra,322,140,182,43.48
Galio,TwistedFate,330,185,145,56.06
Galio,Maokai,505,248,257,49.11
Galio,Kalista,226,111,115,49.12
Galio,Shyvana,242,116,126,47.93
Sivir,Singed,158,60,98,37.97
Sivir,LeeSin,970,481,489,49.59
Sivir,Yasuo,1199,546,653,45.54
Sivir,Caitlyn,1955,993,962,50.79
Sivir,Yuumi,385,184,201,47.79
Sivir,Gnar,297,140,157,47.14
Sivir,Zyra,643,294,349,45.72
Sivir,Azir,224,125,99,55.8
Sivir,Varus,589,298,291,50.59
Sivir,Nautilus,689,404,285,58.64
Sivir,Renekton,291,169,122,58.08
Sivir,XinZhao,356,167,189,46.91
Sivir,Kalista,141,65,76,46.1
Sivir,Pantheon,987,517,470,52.38
Sivir,Teemo,853,393,460,46.07
Sivir,Orianna,248,102,146,41.13
Sivir,Tristana,580,274,306,47.24
Sivir,Lux,1451,689,762,47.48
Sivir,Tryndamere,352,164,188,46.59
Sivir,Shyvana,153,73,80,47.71
Sivir,Ambessa,397,193,204,48.61
Sivir,Jhin,1241,592,649,47.7
Sivir,Thresh,828,437,391,52.78
Sivir,Irelia,594,321,273,54.04
Sivir,Diana,1056,578,478,54.73
Sivir,Katarina,432,197,235,45.6
Sivir,Soraka,369,199,170,53.93
Sivir,Kayle,361,171,190,47.37
Sivir,Nasus,453,221,232,48.79
Sivir,Anivia,198,95,103,47.98
Sivir,KogMaw,189,89,100,47.09
Sivir,Nami,639,290,349,45.38
Sivir,Malphite,666,317,349,47.6
Sivir,Ekko,653,319,334,48.85
Sivir,Mel,1287,652,635,50.66
Sivir,Sejuani,229,110,119,48.03
Sivir,Sylas,925,478,447,51.68
Sivir,Karma,903,451,452,49.94
Sivir,Urgot,301,155,146,51.5
Sivir,Amumu,657,334,323,50.84
Sivir,Brand,466,241,225,51.72
Sivir,Yorick,662,302,360,45.62
Sivir,Trundle,398,191,207,47.99
Sivir,Malzahar,700,335,365,47.86
Sivir,Ezreal,1899,1036,863,54.56
Sivir,Pyke,607,344,263,56.67
Sivir,Garen,1044,560,484,53.64
Sivir,Belveth,111,48,63,43.24
Sivir,Qiyana,158,90,68,56.96
Sivir,Corki,263,141,122,53.61
Sivir,Nocturne,810,386,424,47.65
Sivir,Kassadin,154,68,86,44.16
Sivir,Veigar,676,312,364,46.15
Sivir,Smolder,377,205,172,54.38
Sivir,Ashe,1487,735,752,49.43
Sivir,Mordekaiser,778,405,373,52.06
Sivir,Draven,274,142,132,51.82
Sivir,Jax,635,313,322,49.29
Sivir,Darius,1090,588,502,53.94
Sivir,MissFortune,1552,779,773,50.19
Sivir,TahmKench,416,220,196,52.88
Sivir,Shaco,656,322,334,49.09
Sivir,Morgana,856,432,424,50.47
Sivir,Shen,383,182,201,47.52
Sivir,Seraphine,499,230,269,46.09
Sivir,Ahri,888,468,420,52.7
Sivir,Kayn,883,446,437,50.51
Sivir,Sett,898,460,438,51.22
Sivir,Rengar,164,89,75,54.27
Sivir,Kaisa,1028,571,457,55.54
Sivir,Janna,227,118,109,51.98
Sivir,Vladimir,456,261,195,57.24
Sivir,FiddleSticks,335,165,170,49.25
Sivir,Xerath,579,295,284,50.95
Sivir,Nunu,358,168,190,46.93
Sivir,Vex,316,153,163,48.42
Sivir,Lucian,399,225,174,56.39
Sivir,Riven,327,173,154,52.91
Sivir,Aatrox,571,269,302,47.11
Sivir,Vi,643,333,310,51.79
Sivir,Gangplank,355,166,189,46.76
Sivir,Warwick,892,399,493,44.73
Sivir,Yone,1072,547,525,51.03
Sivir,Akali,661,332,329,50.23
Sivir,Viego,863,463,400,53.65
Sivir,Twitch,431,231,200,53.6
Sivir,Khazix,295,152,143,51.53
Sivir,Milio,318,153,165,48.11
Sivir,Ornn,216,112,104,51.85
Sivir,Karthus,214,103,111,48.13
Sivir,Viktor,592,314,278,53.04
Sivir,TwistedFate,207,119,88,57.49
Sivir,Blitzcrank,716,433,283,60.47
Sivir,Swain,608,281,327,46.22
Sivir,Gwen,315,184,131,58.41
Sivir,Lulu,749,347,402,46.33
Sivir,Jinx,1777,887,890,49.92
Sivir,Syndra,369,182,187,49.32
Sivir,Nilah,170,89,81,52.35
Sivir,Volibear,619,291,328,47.01
Sivir,Aphelios,310,173,137,55.81
Sivir,Evelynn,224,138,86,61.61
Sivir,Poppy,358,189,169,52.79
Sivir,Senna,501,235,266,46.91
Sivir,Chogath,776,396,380,51.03
Sivir,Zeri,293,150,143,51.19
Sivir,Aurora,496,256,240,51.61
Sivir,Vayne,714,317,397,44.4
Sivir,Fizz,272,148,124,54.41
Sivir,Kindred,286,143,143,50
Sivir,Akshan,206,116,90,56.31
Sivir,Sona,169,74,95,43.79
Sivir,AurelionSol,262,131,131,50
Sivir,Renata,125,72,53,57.6
Sivir,Elise,435,189,246,43.45
Sivir,Nidalee,191,96,95,50.26
Sivir,Samira,399,184,215,46.12
Sivir,MasterYi,715,365,350,51.05
Sivir,Camille,208,92,116,44.23
Sivir,Leona,642,358,284,55.76
Sivir,Fiora,220,99,121,45
Sivir,Zed,747,338,409,45.25
Sivir,Jayce,334,137,197,41.02
Sivir,Braum,306,141,165,46.08
Sivir,Briar,458,211,247,46.07
Sivir,Illaoi,299,153,146,51.17
Sivir,Taric,116,45,71,38.79
Sivir,Zoe,230,119,111,51.74
Sivir,Rammus,170,85,85,50
Sivir,Lissandra,205,101,104,49.27
Sivir,Rumble,173,105,68,60.69
Sivir,Neeko,273,165,108,60.44
Sivir,JarvanIV,413,227,186,54.96
Sivir,Sion,468,242,226,51.71
Sivir,Zac,323,172,151,53.25
Sivir,Ivern,93,53,40,56.99
Sivir,Gragas,303,170,133,56.11
Sivir,Heimerdinger,227,95,132,41.85
Sivir,MonkeyKing,406,216,190,53.2
Sivir,Naafiri,193,87,106,45.08
Sivir,Rakan,247,127,120,51.42
Sivir,Cassiopeia,153,68,85,44.44
Sivir,Quinn,217,122,95,56.22
Sivir,Zilean,228,121,107,53.07
Sivir,Velkoz,404,208,196,51.49
Sivir,Maokai,253,124,129,49.01
Sivir,Annie,239,127,112,53.14
Sivir,Lillia,354,189,165,53.39
Sivir,Udyr,235,118,117,50.21
Sivir,Galio,565,253,312,44.78
Sivir,KSante,264,151,113,57.2
Sivir,Hecarim,285,144,141,50.53
Sivir,Hwei,362,204,158,56.35
Sivir,Alistar,324,189,135,58.33
Sivir,Kled,95,47,48,49.47
Sivir,Ryze,205,107,98,52.2
Sivir,Olaf,192,121,71,63.02
Sivir,Graves,365,177,188,48.49
Sivir,Ziggs,204,106,98,51.96
Sivir,Rell,267,133,134,49.81
Sivir,Xayah,283,146,137,51.59
Sivir,Skarner,149,78,71,52.35
Sivir,Talon,432,210,222,48.61
Sivir,Leblanc,400,208,192,52
Sivir,Bard,183,109,74,59.56
Sivir,DrMundo,264,131,133,49.62
Sivir,Taliyah,151,81,70,53.64
Sivir,Kennen,173,90,83,52.02
Sivir,RekSai,102,55,47,53.92
Pyke,Singed,245,110,135,44.9
Pyke,LeeSin,1563,755,808,48.3
Pyke,Yasuo,1952,893,1059,45.75
Pyke,Caitlyn,2681,1313,1368,48.97
Pyke,Yuumi,782,317,465,40.54
Pyke,Yorick,938,417,521,44.46
Pyke,Warwick,1391,677,714,48.67
Pyke,Veigar,961,463,498,48.18
Pyke,Tristana,943,447,496,47.4
Pyke,Thresh,1356,577,779,42.55
Pyke,Riven,405,184,221,45.43
Pyke,Sejuani,410,206,204,50.24
Pyke,Sylas,1433,751,682,52.41
Pyke,Lucian,712,322,390,45.22
Pyke,Soraka,535,242,293,45.23
Pyke,Gragas,489,254,235,51.94
Pyke,Pantheon,1703,877,826,51.5
Pyke,Mel,1813,921,892,50.8
Pyke,Darius,1726,867,859,50.23
Pyke,Amumu,939,462,477,49.2
Pyke,Aurora,672,305,367,45.39
Pyke,Lux,2706,1373,1333,50.74
Pyke,Seraphine,615,344,271,55.93
Pyke,Diana,1408,728,680,51.7
Pyke,Zed,1113,568,545,51.03
Pyke,Trundle,572,248,324,43.36
Pyke,Malphite,1047,471,576,44.99
Pyke,Hwei,605,286,319,47.27
Pyke,Twitch,653,324,329,49.62
Pyke,Milio,496,242,254,48.79
Pyke,Sett,1347,664,683,49.29
Pyke,Nocturne,1215,620,595,51.03
Pyke,Azir,312,147,165,47.12
Pyke,Ezreal,2549,1245,1304,48.84
Pyke,Qiyana,247,108,139,43.72
Pyke,Chogath,1204,570,634,47.34
Pyke,Vayne,1149,566,583,49.26
Pyke,Olaf,238,104,134,43.7
Pyke,Shaco,865,432,433,49.94
Pyke,Lissandra,285,128,157,44.91
Pyke,Ashe,2002,966,1036,48.25
Pyke,Leona,800,420,380,52.5
Pyke,Aatrox,783,343,440,43.81
Pyke,Evelynn,319,172,147,53.92
Pyke,Katarina,744,341,403,45.83
Pyke,Kaisa,1643,789,854,48.02
Pyke,Mordekaiser,1111,563,548,50.68
Pyke,Akali,1171,574,597,49.02
Pyke,Jinx,2691,1342,1349,49.87
Pyke,Irelia,785,372,413,47.39
Pyke,Rammus,323,140,183,43.34
Pyke,Karma,1224,570,654,46.57
Pyke,Jax,1036,523,513,50.48
Pyke,Fizz,523,244,279,46.65
Pyke,Vi,872,423,449,48.51
Pyke,Ekko,857,427,430,49.82
Pyke,Varus,817,431,386,52.75
Pyke,Kayn,1392,638,754,45.83
Pyke,Sivir,607,263,344,43.33
Pyke,Zoe,355,169,186,47.61
Pyke,Maokai,492,213,279,43.29
Pyke,JarvanIV,477,229,248,48.01
Pyke,Ziggs,323,171,152,52.94
Pyke,Sona,292,129,163,44.18
Pyke,Malzahar,954,444,510,46.54
Pyke,Annie,334,145,189,43.41
Pyke,Teemo,1336,616,720,46.11
Pyke,Brand,719,345,374,47.98
Pyke,MasterYi,1245,621,624,49.88
Pyke,Naafiri,343,160,183,46.65
Pyke,Senna,706,374,332,52.97
Pyke,Ivern,130,70,60,53.85
Pyke,Ahri,1198,631,567,52.67
Pyke,Draven,464,254,210,54.74
Pyke,Quinn,329,151,178,45.9
Pyke,Khazix,513,264,249,51.46
Pyke,Nidalee,269,118,151,43.87
Pyke,Udyr,369,173,196,46.88
Pyke,Vladimir,553,254,299,45.93
Pyke,Poppy,702,319,383,45.44
Pyke,Rell,478,228,250,47.7
Pyke,Leblanc,600,276,324,46
Pyke,MonkeyKing,663,295,368,44.49
Pyke,Gangplank,465,249,216,53.55
Pyke,Camille,335,189,146,56.42
Pyke,Swain,948,435,513,45.89
Pyke,Jhin,1888,921,967,48.78
Pyke,Ryze,348,174,174,50
Pyke,MissFortune,2054,998,1056,48.59
Pyke,Viego,1470,705,765,47.96
Pyke,Yone,1828,942,886,51.53
Pyke,Neeko,426,208,218,48.83
Pyke,Orianna,398,177,221,44.47
Pyke,Nasus,658,298,360,45.29
Pyke,Lulu,1174,566,608,48.21
Pyke,Shen,623,312,311,50.08
Pyke,Kalista,252,110,142,43.65
Pyke,Samira,695,332,363,47.77
Pyke,Morgana,1095,556,539,50.78
Pyke,Alistar,411,205,206,49.88
Pyke,Kindred,425,235,190,55.29
Pyke,Cassiopeia,296,144,152,48.65
Pyke,Xayah,387,205,182,52.97
Pyke,Fiora,344,150,194,43.6
Pyke,Syndra,557,287,270,51.53
Pyke,Kassadin,188,95,93,50.53
Pyke,Renata,144,67,77,46.53
Pyke,Viktor,764,358,406,46.86
Pyke,Bard,285,134,151,47.02
Pyke,Ornn,350,183,167,52.29
Pyke,Xerath,901,466,435,51.72
Pyke,Kayle,712,319,393,44.8
Pyke,Braum,612,270,342,44.12
Pyke,Illaoi,501,252,249,50.3
Pyke,Graves,662,276,386,41.69
Pyke,Tryndamere,570,312,258,54.74
Pyke,Zilean,308,172,136,55.84
Pyke,TwistedFate,348,165,183,47.41
Pyke,Gnar,369,183,186,49.59
Pyke,Nautilus,1146,517,629,45.11
Pyke,Smolder,618,317,301,51.29
Pyke,KSante,515,248,267,48.16
Pyke,Briar,646,308,338,47.68
Pyke,TahmKench,635,333,302,52.44
Pyke,AurelionSol,370,178,192,48.11
Pyke,Hecarim,394,192,202,48.73
Pyke,Galio,810,414,396,51.11
Pyke,Rengar,359,185,174,51.53
Pyke,Akshan,288,161,127,55.9
Pyke,Velkoz,503,233,270,46.32
Pyke,Kennen,221,114,107,51.58
Pyke,Rakan,441,234,207,53.06
Pyke,Sion,608,315,293,51.81
Pyke,Lillia,486,253,233,52.06
Pyke,Taric,207,87,120,42.03
Pyke,Nami,842,394,448,46.79
Pyke,Garen,1490,680,810,45.64
Pyke,Volibear,1174,531,643,45.23
Pyke,Belveth,197,80,117,40.61
Pyke,Karthus,243,125,118,51.44
Pyke,Rumble,293,144,149,49.15
Pyke,Talon,604,278,326,46.03
Pyke,Zac,453,215,238,47.46
Pyke,Taliyah,213,101,112,47.42
Pyke,KogMaw,252,133,119,52.78
Pyke,Ambessa,569,290,279,50.97
Pyke,FiddleSticks,442,221,221,50
Pyke,Aphelios,460,222,238,48.26
Pyke,Kled,171,78,93,45.61
Pyke,Urgot,457,223,234,48.8
Pyke,Shyvana,195,84,111,43.08
Pyke,Renekton,489,235,254,48.06
Pyke,Elise,758,342,416,45.12
Pyke,Blitzcrank,681,372,309,54.63
Pyke,DrMundo,577,270,307,46.79
Pyke,Skarner,189,112,77,59.26
Pyke,Zyra,816,420,396,51.47
Pyke,XinZhao,567,279,288,49.21
Pyke,Corki,425,204,221,48
Pyke,Janna,313,145,168,46.33
Pyke,Heimerdinger,420,182,238,43.33
Pyke,Nunu,537,240,297,44.69
Pyke,Anivia,232,125,107,53.88
Pyke,Nilah,284,121,163,42.61
Pyke,Vex,530,282,248,53.21
Pyke,Zeri,395,183,212,46.33
Pyke,Gwen,496,227,269,45.77
Pyke,Jayce,494,249,245,50.4
Pyke,RekSai,110,61,49,55.45
Jax,Gragas,800,412,388,51.5
Jax,Kayn,1598,759,839,47.5
Jax,Mel,2103,989,1114,47.03
Jax,Jinx,3302,1584,1718,47.97
Jax,Thresh,1411,659,752,46.7
Jax,Mordekaiser,1485,684,801,46.06
Jax,Skarner,290,158,132,54.48
Jax,Galio,1090,502,588,46.06
Jax,MissFortune,2763,1226,1537,44.37
Jax,Lux,2930,1398,1532,47.71
Jax,Kayle,857,422,435,49.24
Jax,Darius,1905,911,994,47.82
Jax,Malphite,1149,557,592,48.48
Jax,Ezreal,2838,1543,1295,54.37
Jax,Nami,1017,479,538,47.1
Jax,Gwen,551,289,262,52.45
Jax,Khazix,550,257,293,46.73
Jax,TwistedFate,424,217,207,51.18
Jax,Varus,1035,566,469,54.69
Jax,Riven,520,264,256,50.77
Jax,Ziggs,411,186,225,45.26
Jax,Katarina,812,392,420,48.28
Jax,LeeSin,1787,916,871,51.26
Jax,Renekton,580,263,317,45.34
Jax,XinZhao,754,374,380,49.6
Jax,Yasuo,2455,1225,1230,49.9
Jax,Kalista,306,143,163,46.73
Jax,Pantheon,1661,839,822,50.51
Jax,Gnar,348,186,162,53.45
Jax,Sylas,1670,865,805,51.8
Jax,Ashe,2259,1153,1106,51.04
Jax,Seraphine,812,359,453,44.21
Jax,Viego,1682,886,796,52.68
Jax,Irelia,1171,518,653,44.24
Jax,Twitch,811,398,413,49.08
Jax,Lulu,1522,687,835,45.14
Jax,Talon,584,265,319,45.38
Jax,Caitlyn,3000,1402,1598,46.73
Jax,Alistar,503,237,266,47.12
Jax,Yorick,1122,505,617,45.01
Jax,Nocturne,1577,768,809,48.7
Jax,Zed,1197,588,609,49.12
Jax,Xayah,524,273,251,52.1
Jax,Karma,1305,599,706,45.9
Jax,Gangplank,499,259,240,51.9
Jax,Hecarim,473,218,255,46.09
Jax,Aurora,774,404,370,52.2
Jax,Jhin,2229,1009,1220,45.27
Jax,Brand,831,389,442,46.81
Jax,Singed,287,148,139,51.57
Jax,Diana,1916,949,967,49.53
Jax,Viktor,992,481,511,48.49
Jax,Kennen,281,140,141,49.82
Jax,Ekko,1083,566,517,52.26
Jax,Leblanc,790,369,421,46.71
Jax,Pyke,1036,513,523,49.52
Jax,Yone,2478,1318,1160,53.19
Jax,Ahri,1425,729,696,51.16
Jax,Velkoz,652,294,358,45.09
Jax,Orianna,462,199,263,43.07
Jax,Quinn,369,156,213,42.28
Jax,Evelynn,387,191,196,49.35
Jax,KogMaw,338,166,172,49.11
Jax,Braum,678,332,346,48.97
Jax,Olaf,271,121,150,44.65
Jax,Malzahar,1082,539,543,49.82
Jax,Syndra,699,324,375,46.35
Jax,Kaisa,1905,942,963,49.45
Jax,Amumu,1136,527,609,46.39
Jax,Volibear,1333,655,678,49.14
Jax,Xerath,1054,506,548,48.01
Jax,Yuumi,835,474,361,56.77
Jax,KSante,606,321,285,52.97
Jax,Leona,1014,530,484,52.27
Jax,TahmKench,717,363,354,50.63
Jax,Nautilus,1185,581,604,49.03
Jax,Teemo,1370,624,746,45.55
Jax,Graves,821,415,406,50.55
Jax,Samira,753,362,391,48.07
Jax,Elise,851,384,467,45.12
Jax,Taliyah,311,135,176,43.41
Jax,Zyra,1069,491,578,45.93
Jax,FiddleSticks,526,253,273,48.1
Jax,Naafiri,322,154,168,47.83
Jax,Sion,735,379,356,51.56
Jax,Shaco,1017,491,526,48.28
Jax,Soraka,656,308,348,46.95
Jax,Draven,531,268,263,50.47
Jax,Sett,1719,857,862,49.85
Jax,Taric,206,91,115,44.17
Jax,Chogath,1168,517,651,44.26
Jax,Zoe,458,224,234,48.91
Jax,Anivia,359,164,195,45.68
Jax,MasterYi,1837,903,934,49.16
Jax,Veigar,1128,528,600,46.81
Jax,Senna,826,420,406,50.85
Jax,Shen,738,369,369,50
Jax,Sivir,635,322,313,50.71
Jax,Fizz,706,320,386,45.33
Jax,Morgana,1387,703,684,50.68
Jax,DrMundo,667,318,349,47.68
Jax,Qiyana,266,154,112,57.89
Jax,Sejuani,399,199,200,49.87
Jax,Aatrox,953,495,458,51.94
Jax,Briar,788,392,396,49.75
Jax,Warwick,1950,906,1044,46.46
Jax,Kassadin,248,144,104,58.06
Jax,Jayce,531,242,289,45.57
Jax,Swain,1146,511,635,44.59
Jax,Tristana,1195,604,591,50.54
Jax,Vladimir,810,372,438,45.93
Jax,JarvanIV,636,331,305,52.04
Jax,Trundle,780,407,373,52.18
Jax,Neeko,542,280,262,51.66
Jax,Blitzcrank,812,418,394,51.48
Jax,Azir,366,186,180,50.82
Jax,Ryze,366,188,178,51.37
Jax,Vayne,1390,659,731,47.41
Jax,Garen,2327,1043,1284,44.82
Jax,RekSai,123,41,82,33.33
Jax,Poppy,714,367,347,51.4
Jax,Lissandra,352,176,176,50
Jax,Kindred,499,222,277,44.49
Jax,Bard,373,171,202,45.84
Jax,Illaoi,652,292,360,44.79
Jax,Sona,388,186,202,47.94
Jax,Nasus,673,322,351,47.85
Jax,Aphelios,561,318,243,56.68
Jax,AurelionSol,416,207,209,49.76
Jax,Rengar,332,184,148,55.42
Jax,Lucian,804,432,372,53.73
Jax,MonkeyKing,703,355,348,50.5
Jax,Udyr,410,216,194,52.68
Jax,Janna,338,152,186,44.97
Jax,Vex,561,311,250,55.44
Jax,Vi,1076,567,509,52.7
Jax,Lillia,626,290,336,46.33
Jax,Maokai,491,253,238,51.53
Jax,Nunu,603,288,315,47.76
Jax,Hwei,656,350,306,53.35
Jax,Camille,445,252,193,56.63
Jax,Rammus,323,135,188,41.8
Jax,Rumble,286,165,121,57.69
Jax,Zac,590,288,302,48.81
Jax,Ambessa,723,349,374,48.27
Jax,Shyvana,221,95,126,42.99
Jax,Smolder,778,402,376,51.67
Jax,Rakan,480,228,252,47.5
Jax,Akali,1277,640,637,50.12
Jax,Annie,364,183,181,50.27
Jax,Nilah,322,174,148,54.04
Jax,Heimerdinger,464,193,271,41.59
Jax,Kled,189,90,99,47.62
Jax,Karthus,300,156,144,52
Jax,Milio,647,299,348,46.21
Jax,Urgot,489,246,243,50.31
Jax,Tryndamere,714,353,361,49.44
Jax,Rell,584,296,288,50.68
Jax,Belveth,209,130,79,62.2
Jax,Fiora,435,191,244,43.91
Jax,Cassiopeia,254,102,152,40.16
Jax,Zeri,502,266,236,52.99
Jax,Corki,452,227,225,50.22
Jax,Ivern,152,68,84,44.74
Jax,Renata,213,116,97,54.46
Jax,Ornn,402,210,192,52.24
Jax,Nidalee,293,158,135,53.92
Jax,Zilean,319,158,161,49.53
Jax,Akshan,388,188,200,48.45
Nocturne,Gragas,749,391,358,52.2
Nocturne,Kayn,2322,1252,1070,53.92
Nocturne,Mel,2968,1750,1218,58.96
Nocturne,Jinx,4204,2127,2077,50.59
Nocturne,Thresh,1963,1008,955,51.35
Nocturne,Pantheon,2569,1428,1141,55.59
Nocturne,Yasuo,2915,1613,1302,55.33
Nocturne,Caitlyn,4091,2250,1841,55
Nocturne,Yorick,1478,779,699,52.71
Nocturne,MasterYi,2064,1008,1056,48.84
Nocturne,Ahri,2016,1093,923,54.22
Nocturne,Ezreal,3664,1989,1675,54.28
Nocturne,Morgana,1799,984,815,54.7
Nocturne,Chogath,1834,999,835,54.47
Nocturne,Kindred,674,344,330,51.04
Nocturne,Katarina,1099,598,501,54.41
Nocturne,Tristana,1577,869,708,55.1
Nocturne,Neeko,620,340,280,54.84
Nocturne,Gwen,799,418,381,52.32
Nocturne,Fizz,898,469,429,52.23
Nocturne,Ivern,218,114,104,52.29
Nocturne,Singed,417,228,189,54.68
Nocturne,Shaco,1695,859,836,50.68
Nocturne,Hwei,956,434,522,45.4
Nocturne,Jhin,3242,1774,1468,54.72
Nocturne,Janna,462,235,227,50.87
Nocturne,Darius,2810,1505,1305,53.56
Nocturne,Lillia,885,477,408,53.9
Nocturne,Garen,2523,1309,1214,51.88
Nocturne,Pyke,1215,595,620,48.97
Nocturne,Elise,1119,578,541,51.65
Nocturne,Viktor,1228,637,591,51.87
Nocturne,Corki,670,373,297,55.67
Nocturne,Milio,797,376,421,47.18
Nocturne,Nautilus,1591,869,722,54.62
Nocturne,FiddleSticks,785,408,377,51.97
Nocturne,Vladimir,1014,550,464,54.24
Nocturne,Nasus,1048,501,547,47.81
Nocturne,Sylas,2455,1200,1255,48.88
Nocturne,Kaisa,2669,1445,1224,54.14
Nocturne,Volibear,1854,971,883,52.37
Nocturne,Khazix,775,418,357,53.94
Nocturne,Lux,4046,2185,1861,54
Nocturne,Velkoz,1053,509,544,48.34
Nocturne,Shyvana,455,227,228,49.89
Nocturne,Annie,511,277,234,54.21
Nocturne,Varus,1354,759,595,56.06
Nocturne,Renekton,708,353,355,49.86
Nocturne,Veigar,1463,766,697,52.36
Nocturne,Vayne,1846,908,938,49.19
Nocturne,MissFortune,3669,1902,1767,51.84
Nocturne,Diana,2468,1236,1232,50.08
Nocturne,Malzahar,1670,933,737,55.87
Nocturne,Vi,1523,860,663,56.47
Nocturne,Soraka,824,398,426,48.3
Nocturne,Warwick,2490,1279,1211,51.37
Nocturne,LeeSin,2316,1281,1035,55.31
Nocturne,Kassadin,310,144,166,46.45
Nocturne,Jax,1577,809,768,51.3
Nocturne,Ekko,1522,802,720,52.69
Nocturne,Zeri,658,298,360,45.29
Nocturne,Amumu,1764,825,939,46.77
Nocturne,Irelia,1362,742,620,54.48
Nocturne,Zed,1796,934,862,52
Nocturne,Xayah,806,408,398,50.62
Nocturne,Nidalee,458,247,211,53.93
Nocturne,Graves,953,548,405,57.5
Nocturne,Mordekaiser,1893,995,898,52.56
Nocturne,Syndra,991,542,449,54.69
Nocturne,Karma,1778,918,860,51.63
Nocturne,Teemo,2016,1003,1013,49.75
Nocturne,Ashe,3130,1648,1482,52.65
Nocturne,Lucian,1114,552,562,49.55
Nocturne,Briar,1206,605,601,50.17
Nocturne,Maokai,669,345,324,51.57
Nocturne,Ornn,588,308,280,52.38
Nocturne,Aurora,1016,562,454,55.31
Nocturne,Zilean,559,243,316,43.47
Nocturne,MonkeyKing,1216,620,596,50.99
Nocturne,Poppy,885,500,385,56.5
Nocturne,Vex,872,462,410,52.98
Nocturne,Leona,1400,757,643,54.07
Nocturne,Gnar,687,343,344,49.93
Nocturne,Sivir,810,424,386,52.35
Nocturne,Taric,318,159,159,50
Nocturne,Ambessa,1013,602,411,59.43
Nocturne,Sejuani,607,348,259,57.33
Nocturne,Akali,1682,860,822,51.13
Nocturne,Ziggs,579,319,260,55.09
Nocturne,Bard,427,194,233,45.43
Nocturne,Draven,752,361,391,48.01
Nocturne,Gangplank,788,451,337,57.23
Nocturne,Aphelios,775,412,363,53.16
Nocturne,Jayce,681,377,304,55.36
Nocturne,Rammus,507,275,232,54.24
Nocturne,Shen,929,541,388,58.23
Nocturne,Rengar,532,285,247,53.57
Nocturne,Yone,2754,1460,1294,53.01
Nocturne,Illaoi,664,317,347,47.74
Nocturne,DrMundo,854,428,426,50.12
Nocturne,Sett,2336,1206,1130,51.63
Nocturne,Seraphine,1109,582,527,52.48
Nocturne,Malphite,1600,896,704,56
Nocturne,Aatrox,1351,764,587,56.55
Nocturne,Camille,516,276,240,53.49
Nocturne,Galio,1303,669,634,51.34
Nocturne,Anivia,429,224,205,52.21
Nocturne,Braum,822,405,417,49.27
Nocturne,Brand,1180,633,547,53.64
Nocturne,KSante,770,432,338,56.1
Nocturne,Nilah,456,242,214,53.07
Nocturne,Swain,1389,644,745,46.36
Nocturne,Twitch,1248,673,575,53.93
Nocturne,Kled,290,153,137,52.76
Nocturne,Trundle,923,543,380,58.83
Nocturne,Lulu,1944,1044,900,53.7
Nocturne,Ryze,583,293,290,50.26
Nocturne,TahmKench,1213,639,574,52.68
Nocturne,Talon,860,416,444,48.37
Nocturne,Zyra,1669,842,827,50.45
Nocturne,Quinn,599,304,295,50.75
Nocturne,RekSai,155,81,74,52.26
Nocturne,Olaf,367,187,180,50.95
Nocturne,Nami,1480,804,676,54.32
Nocturne,Belveth,381,235,146,61.68
Nocturne,Smolder,948,529,419,55.8
Nocturne,Leblanc,993,530,463,53.37
Nocturne,Xerath,1465,822,643,56.11
Nocturne,Kennen,401,196,205,48.88
Nocturne,Yuumi,1167,585,582,50.13
Nocturne,Hecarim,607,323,284,53.21
Nocturne,Lissandra,488,269,219,55.12
Nocturne,Senna,1095,618,477,56.44
Nocturne,Sion,1106,599,507,54.16
Nocturne,JarvanIV,1032,509,523,49.32
Nocturne,Rakan,556,285,271,51.26
Nocturne,Zac,759,345,414,45.45
Nocturne,Riven,628,338,290,53.82
Nocturne,AurelionSol,558,262,296,46.95
Nocturne,Fiora,528,263,265,49.81
Nocturne,KogMaw,443,239,204,53.95
Nocturne,Orianna,566,273,293,48.23
Nocturne,Viego,2043,1017,1026,49.78
Nocturne,Rell,781,431,350,55.19
Nocturne,Urgot,797,389,408,48.81
Nocturne,Naafiri,512,302,210,58.98
Nocturne,Udyr,619,300,319,48.47
Nocturne,Blitzcrank,1140,645,495,56.58
Nocturne,Samira,1028,491,537,47.76
Nocturne,Nunu,826,433,393,52.42
Nocturne,Azir,464,260,204,56.03
Nocturne,Rumble,385,208,177,54.03
Nocturne,Sona,476,264,212,55.46
Nocturne,Alistar,596,362,234,60.74
Nocturne,Zoe,578,296,282,51.21
Nocturne,Kalista,389,209,180,53.73
Nocturne,Tryndamere,795,414,381,52.08
Nocturne,Kayle,957,457,500,47.75
Nocturne,Renata,296,158,138,53.38
Nocturne,Evelynn,625,378,247,60.48
Nocturne,Cassiopeia,341,190,151,55.72
Nocturne,XinZhao,1114,556,558,49.91
Nocturne,Karthus,429,222,207,51.75
Nocturne,Qiyana,382,229,153,59.95
Nocturne,Taliyah,338,164,174,48.52
Nocturne,Akshan,527,300,227,56.93
Nocturne,Skarner,330,180,150,54.55
Nocturne,Heimerdinger,674,318,356,47.18
Nocturne,TwistedFate,515,304,211,59.03
Syndra,Gragas,447,247,200,55.26
Syndra,Kayn,1108,554,554,50
Syndra,Mel,1435,753,682,52.47
Syndra,Jinx,2128,1109,1019,52.11
Syndra,Thresh,1024,499,525,48.73
Syndra,Rakan,342,156,186,45.61
Syndra,Ekko,826,418,408,50.61
Syndra,Veigar,774,403,371,52.07
Syndra,Ashe,1447,743,704,51.35
Syndra,Soraka,455,221,234,48.57
Syndra,Pantheon,1192,628,564,52.68
Syndra,Gwen,352,209,143,59.38
Syndra,Fizz,523,249,274,47.61
Syndra,Ivern,117,69,48,58.97
Syndra,Chogath,922,478,444,51.84
Syndra,Malzahar,892,417,475,46.75
Syndra,MissFortune,1613,806,807,49.97
Syndra,Nami,843,377,466,44.72
Syndra,Yasuo,1174,558,616,47.53
Syndra,Udyr,309,181,128,58.58
Syndra,Qiyana,201,102,99,50.75
Syndra,Seraphine,468,230,238,49.15
Syndra,Yone,1268,669,599,52.76
Syndra,Nocturne,991,449,542,45.31
Syndra,Ahri,1216,649,567,53.37
Syndra,Velkoz,451,216,235,47.89
Syndra,Caitlyn,2011,992,1019,49.33
Syndra,Khazix,434,217,217,50
Syndra,Sejuani,271,147,124,54.24
Syndra,Lux,1775,903,872,50.87
Syndra,Poppy,503,236,267,46.92
Syndra,Gnar,307,175,132,57
Syndra,TwistedFate,281,152,129,54.09
Syndra,Jhin,1505,753,752,50.03
Syndra,Karma,1065,517,548,48.54
Syndra,Jax,699,375,324,53.65
Syndra,Vi,757,379,378,50.07
Syndra,Tristana,728,405,323,55.63
Syndra,Riven,397,190,207,47.86
Syndra,FiddleSticks,390,182,208,46.67
Syndra,Neeko,320,150,170,46.88
Syndra,Milio,496,218,278,43.95
Syndra,Olaf,179,94,85,52.51
Syndra,Hwei,670,334,336,49.85
Syndra,Varus,709,386,323,54.44
Syndra,Swain,663,307,356,46.3
Syndra,Renekton,401,223,178,55.61
Syndra,Rengar,267,140,127,52.43
Syndra,Zilean,259,117,142,45.17
Syndra,Lucian,568,280,288,49.3
Syndra,Camille,304,147,157,48.36
Syndra,Aurora,544,302,242,55.51
Syndra,Shaco,718,386,332,53.76
Syndra,Lulu,1206,636,570,52.74
Syndra,Teemo,910,477,433,52.42
Syndra,Zed,867,423,444,48.79
Syndra,Ezreal,1820,906,914,49.78
Syndra,Annie,303,174,129,57.43
Syndra,MasterYi,824,390,434,47.33
Syndra,Mordekaiser,943,452,491,47.93
Syndra,Kaisa,1308,645,663,49.31
Syndra,Ornn,301,148,153,49.17
Syndra,JarvanIV,478,248,230,51.88
Syndra,Nautilus,881,455,426,51.65
Syndra,Garen,1239,598,641,48.26
Syndra,Rammus,211,96,115,45.5
Syndra,Lissandra,253,96,157,37.94
Syndra,Brand,473,251,222,53.07
Syndra,Shen,413,220,193,53.27
Syndra,Warwick,1022,519,503,50.78
Syndra,Akali,650,290,360,44.62
Syndra,Anivia,345,152,193,44.06
Syndra,Tryndamere,452,210,242,46.46
Syndra,Diana,1163,585,578,50.3
Syndra,Orianna,392,194,198,49.49
Syndra,Maokai,364,187,177,51.37
Syndra,Alistar,337,181,156,53.71
Syndra,Yorick,745,356,389,47.79
Syndra,Volibear,778,378,400,48.59
Syndra,Kassadin,171,79,92,46.2
Syndra,Katarina,621,299,322,48.15
Syndra,Pyke,557,270,287,48.47
Syndra,Darius,1433,726,707,50.66
Syndra,Briar,490,256,234,52.24
Syndra,Viktor,921,479,442,52.01
Syndra,Xayah,342,184,158,53.8
Syndra,Gangplank,327,164,163,50.15
Syndra,Illaoi,330,148,182,44.85
Syndra,Sivir,369,187,182,50.68
Syndra,Jayce,386,198,188,51.3
Syndra,Vayne,1053,528,525,50.14
Syndra,Aatrox,663,387,276,58.37
Syndra,Samira,451,221,230,49
Syndra,Blitzcrank,506,264,242,52.17
Syndra,LeeSin,1099,500,599,45.5
Syndra,Leblanc,430,210,220,48.84
Syndra,Aphelios,430,225,205,52.33
Syndra,Trundle,453,235,218,51.88
Syndra,Vladimir,506,280,226,55.34
Syndra,KSante,327,194,133,59.33
Syndra,Urgot,325,139,186,42.77
Syndra,Lillia,388,225,163,57.99
Syndra,Zeri,357,178,179,49.86
Syndra,Akshan,267,139,128,52.06
Syndra,Twitch,716,381,335,53.21
Syndra,Ambessa,477,238,239,49.9
Syndra,Yuumi,718,404,314,56.27
Syndra,TahmKench,478,239,239,50
Syndra,Nasus,480,233,247,48.54
Syndra,Fiora,285,120,165,42.11
Syndra,Viego,1166,604,562,51.8
Syndra,Xerath,789,345,444,43.73
Syndra,Singed,215,121,94,56.28
Syndra,Morgana,823,444,379,53.95
Syndra,Irelia,550,258,292,46.91
Syndra,Zyra,725,341,384,47.03
Syndra,Sylas,839,423,416,50.42
Syndra,RekSai,101,68,33,67.33
Syndra,Galio,633,324,309,51.18
Syndra,Sion,640,314,326,49.06
Syndra,Graves,604,326,278,53.97
Syndra,AurelionSol,317,160,157,50.47
Syndra,Talon,390,208,182,53.33
Syndra,Sona,193,81,112,41.97
Syndra,Evelynn,251,143,108,56.97
Syndra,Naafiri,233,102,131,43.78
Syndra,Elise,609,302,307,49.59
Syndra,Rumble,197,82,115,41.62
Syndra,Corki,329,186,143,56.53
Syndra,Skarner,169,76,93,44.97
Syndra,DrMundo,335,184,151,54.93
Syndra,Zoe,331,157,174,47.43
Syndra,Vex,369,222,147,60.16
Syndra,Bard,287,157,130,54.7
Syndra,Cassiopeia,312,179,133,57.37
Syndra,Sett,1048,543,505,51.81
Syndra,Belveth,179,86,93,48.04
Syndra,Kayle,546,256,290,46.89
Syndra,Janna,306,153,153,50
Syndra,Leona,686,360,326,52.48
Syndra,Kindred,319,174,145,54.55
Syndra,KogMaw,267,142,125,53.18
Syndra,Zac,372,195,177,52.42
Syndra,Ryze,215,108,107,50.23
Syndra,Taric,164,99,65,60.37
Syndra,Draven,498,258,240,51.81
Syndra,Amumu,750,362,388,48.27
Syndra,Braum,460,196,264,42.61
Syndra,Malphite,697,326,371,46.77
Syndra,Kalista,178,85,93,47.75
Syndra,Renata,158,89,69,56.33
Syndra,Nilah,234,108,126,46.15
Syndra,Rell,395,218,177,55.19
Syndra,Taliyah,230,136,94,59.13
Syndra,Smolder,429,230,199,53.61
Syndra,XinZhao,510,291,219,57.06
Syndra,MonkeyKing,513,271,242,52.83
Syndra,Karthus,219,114,105,52.05
Syndra,Quinn,327,155,172,47.4
Syndra,Kennen,197,91,106,46.19
Syndra,Nunu,395,199,196,50.38
Syndra,Heimerdinger,376,164,212,43.62
Syndra,Senna,491,266,225,54.18
Syndra,Hecarim,376,200,176,53.19
Syndra,Shyvana,145,53,92,36.55
Syndra,Azir,285,144,141,50.53
Syndra,Ziggs,219,116,103,52.97
Syndra,Nidalee,227,125,102,55.07
Syndra,Kled,154,76,78,49.35
Smolder,Gragas,374,170,204,45.45
Smolder,Kayn,1057,507,550,47.97
Smolder,Mel,1529,731,798,47.81
Smolder,Jinx,2151,1007,1144,46.82
Smolder,Thresh,976,452,524,46.31
Smolder,Olaf,187,96,91,51.34
Smolder,Diana,1223,533,690,43.58
Smolder,Sylas,914,476,438,52.08
Smolder,Tristana,750,377,373,50.27
Smolder,Kennen,192,126,66,65.63
Smolder,Ornn,295,142,153,48.14
Smolder,Shaco,716,366,350,51.12
Smolder,Aurora,467,239,228,51.18
Smolder,Caitlyn,2071,977,1094,47.18
Smolder,Zilean,214,84,130,39.25
Smolder,Chogath,841,436,405,51.84
Smolder,Evelynn,204,93,111,45.59
Smolder,Lux,1718,834,884,48.54
Smolder,Twitch,627,280,347,44.66
Smolder,Ashe,1384,632,752,45.66
Smolder,Tryndamere,399,187,212,46.87
Smolder,Volibear,768,376,392,48.96
Smolder,Annie,234,114,120,48.72
Smolder,Samira,487,234,253,48.05
Smolder,Seraphine,466,209,257,44.85
Smolder,TahmKench,560,278,282,49.64
Smolder,Akali,742,362,380,48.79
Smolder,Sona,232,106,126,45.69
Smolder,Neeko,253,135,118,53.36
Smolder,JarvanIV,431,220,211,51.04
Smolder,Yone,1378,697,681,50.58
Smolder,Swain,734,341,393,46.46
Smolder,Irelia,571,223,348,39.05
Smolder,DrMundo,505,246,259,48.71
Smolder,Viktor,731,325,406,44.46
Smolder,Brand,552,241,311,43.66
Smolder,Pantheon,1206,534,672,44.28
Smolder,Hecarim,330,166,164,50.3
Smolder,Naafiri,242,128,114,52.89
Smolder,MissFortune,1637,801,836,48.93
Smolder,Nautilus,834,390,444,46.76
Smolder,Velkoz,429,192,237,44.76
Smolder,Kaisa,1202,640,562,53.24
Smolder,Veigar,775,344,431,44.39
Smolder,Teemo,937,447,490,47.71
Smolder,Rammus,236,105,131,44.49
Smolder,Ekko,644,332,312,51.55
Smolder,Sivir,377,172,205,45.62
Smolder,Ambessa,386,187,199,48.45
Smolder,Khazix,383,181,202,47.26
Smolder,Malzahar,1060,569,491,53.68
Smolder,Corki,280,118,162,42.14
Smolder,Morgana,836,374,462,44.74
Smolder,Jayce,347,162,185,46.69
Smolder,Yorick,817,382,435,46.76
Smolder,Hwei,454,208,246,45.81
Smolder,Jhin,1637,791,846,48.32
Smolder,Soraka,401,188,213,46.88
Smolder,LeeSin,1036,488,548,47.1
Smolder,Garen,1117,544,573,48.7
Smolder,AurelionSol,299,127,172,42.47
Smolder,Akshan,275,132,143,48
Smolder,Ezreal,1909,945,964,49.5
Smolder,Shen,522,239,283,45.79
Smolder,Warwick,996,495,501,49.7
Smolder,Kayle,583,261,322,44.77
Smolder,Sett,1099,537,562,48.86
Smolder,Lissandra,211,75,136,35.55
Smolder,Alistar,328,157,171,47.87
Smolder,KSante,378,182,196,48.15
Smolder,Aatrox,583,243,340,41.68
Smolder,Rakan,327,163,164,49.85
Smolder,Maokai,339,180,159,53.1
Smolder,Lucian,479,229,250,47.81
Smolder,Janna,254,108,146,42.52
Smolder,Sion,583,280,303,48.03
Smolder,Shyvana,222,123,99,55.41
Smolder,Draven,406,198,208,48.77
Smolder,Vladimir,438,229,209,52.28
Smolder,Ahri,927,471,456,50.81
Smolder,Taric,154,78,76,50.65
Smolder,Malphite,807,363,444,44.98
Smolder,Nami,791,356,435,45.01
Smolder,Nocturne,948,419,529,44.2
Smolder,Talon,409,222,187,54.28
Smolder,Leona,624,300,324,48.08
Smolder,Yasuo,1433,656,777,45.78
Smolder,Viego,1002,503,499,50.2
Smolder,Katarina,530,265,265,50
Smolder,Zyra,619,294,325,47.5
Smolder,Urgot,348,143,205,41.09
Smolder,MasterYi,935,410,525,43.85
Smolder,Senna,522,246,276,47.13
Smolder,Blitzcrank,478,246,232,51.46
Smolder,Vayne,947,406,541,42.87
Smolder,Karma,865,402,463,46.47
Smolder,KogMaw,209,96,113,45.93
Smolder,Ryze,236,103,133,43.64
Smolder,Darius,1499,707,792,47.16
Smolder,Briar,533,223,310,41.84
Smolder,Azir,272,121,151,44.49
Smolder,Zac,407,215,192,52.83
Smolder,Zed,819,380,439,46.4
Smolder,Elise,497,244,253,49.09
Smolder,Gwen,363,195,168,53.72
Smolder,Trundle,446,216,230,48.43
Smolder,Vi,649,322,327,49.61
Smolder,Pyke,618,301,317,48.71
Smolder,Nasus,555,237,318,42.7
Smolder,Galio,670,304,366,45.37
Smolder,Leblanc,448,243,205,54.24
Smolder,Qiyana,182,79,103,43.41
Smolder,Renekton,370,172,198,46.49
Smolder,Yuumi,569,251,318,44.11
Smolder,Orianna,275,108,167,39.27
Smolder,Rell,384,181,203,47.14
Smolder,Jax,778,376,402,48.33
Smolder,Karthus,192,95,97,49.48
Smolder,Amumu,835,397,438,47.54
Smolder,Aphelios,385,166,219,43.12
Smolder,Illaoi,370,190,180,51.35
Smolder,RekSai,105,46,59,43.81
Smolder,Mordekaiser,849,392,457,46.17
Smolder,Kled,133,59,74,44.36
Smolder,Nilah,245,93,152,37.96
Smolder,Vex,366,168,198,45.9
Smolder,Anivia,221,106,115,47.96
Smolder,TwistedFate,262,122,140,46.56
Smolder,Udyr,298,127,171,42.62
Smolder,MonkeyKing,530,231,299,43.58
Smolder,Varus,637,340,297,53.38
Smolder,Lulu,988,422,566,42.71
Smolder,Kalista,215,128,87,59.53
Smolder,Xerath,654,318,336,48.62
Smolder,Singed,211,97,114,45.97
Smolder,Nidalee,181,97,84,53.59
Smolder,Graves,458,233,225,50.87
Smolder,Xayah,325,164,161,50.46
Smolder,Renata,121,58,63,47.93
Smolder,Fiora,221,97,124,43.89
Smolder,Bard,223,104,119,46.64
Smolder,Riven,309,139,170,44.98
Smolder,Sejuani,301,198,103,65.78
Smolder,Gangplank,293,144,149,49.15
Smolder,Heimerdinger,341,131,210,38.42
Smolder,Cassiopeia,191,98,93,51.31
Smolder,Zoe,236,101,135,42.8
Smolder,Rumble,182,99,83,54.4
Smolder,Gnar,258,119,139,46.12
Smolder,Skarner,185,105,80,56.76
Smolder,FiddleSticks,352,171,181,48.58
Smolder,XinZhao,477,211,266,44.23
Smolder,Ivern,115,76,39,66.09
Smolder,Belveth,168,82,86,48.81
Smolder,Syndra,429,199,230,46.39
Smolder,Milio,427,190,237,44.5
Smolder,Taliyah,148,80,68,54.05
Smolder,Kindred,266,119,147,44.74
Smolder,Ziggs,261,110,151,42.15
Smolder,Camille,221,112,109,50.68
Smolder,Braum,381,190,191,49.87
Smolder,Fizz,462,222,240,48.05
Smolder,Nunu,311,177,134,56.91
Smolder,Kassadin,186,75,111,40.32
Smolder,Poppy,358,199,159,55.59
Smolder,Rengar,187,93,94,49.73
Smolder,Quinn,251,109,142,43.43
Smolder,Lillia,403,177,226,43.92
Smolder,Zeri,341,147,194,43.11
Zyra,Gragas,717,428,289,59.69
Zyra,Kayn,1639,816,823,49.79
Zyra,Mel,2322,1157,1165,49.83
Zyra,Jinx,3307,1687,1620,51.01
Zyra,Thresh,1433,752,681,52.48
Zyra,Gangplank,599,318,281,53.09
Zyra,MissFortune,2860,1417,1443,49.55
Zyra,KSante,643,305,338,47.43
Zyra,Hwei,771,392,379,50.84
Zyra,Evelynn,428,228,200,53.27
Zyra,Sivir,643,349,294,54.28
Zyra,Sion,873,423,450,48.45
Zyra,Vi,1134,588,546,51.85
Zyra,Sylas,1695,883,812,52.09
Zyra,Lucian,831,436,395,52.47
Zyra,Pantheon,1879,981,898,52.21
Zyra,Karma,1640,826,814,50.37
Zyra,Ivern,170,102,68,60
Zyra,Anivia,419,203,216,48.45
Zyra,Ashe,2422,1250,1172,51.61
Zyra,Aatrox,1001,531,470,53.05
Zyra,Sett,1751,884,867,50.49
Zyra,Vex,642,315,327,49.07
Zyra,Xerath,1305,617,688,47.28
Zyra,Yone,2044,1099,945,53.77
Zyra,Teemo,1483,728,755,49.09
Zyra,Fizz,672,320,352,47.62
Zyra,Briar,814,382,432,46.93
Zyra,Seraphine,955,508,447,53.19
Zyra,Volibear,1166,619,547,53.09
Zyra,Sejuani,427,217,210,50.82
Zyra,Lux,2940,1503,1437,51.12
Zyra,Jhin,2624,1326,1298,50.53
Zyra,Nautilus,1151,582,569,50.56
Zyra,Chogath,1278,644,634,50.39
Zyra,Zed,1295,658,637,50.81
Zyra,Vayne,1398,677,721,48.43
Zyra,Senna,935,471,464,50.37
Zyra,Karthus,405,219,186,54.07
Zyra,Ekko,1082,567,515,52.4
Zyra,KogMaw,284,139,145,48.94
Zyra,Lulu,1557,793,764,50.93
Zyra,Ambessa,835,455,380,54.49
Zyra,Hecarim,495,268,227,54.14
Zyra,Katarina,838,452,386,53.94
Zyra,Veigar,1037,567,470,54.68
Zyra,Nami,1169,629,540,53.81
Zyra,LeeSin,2171,1133,1038,52.19
Zyra,Akali,1357,672,685,49.52
Zyra,Soraka,690,345,345,50
Zyra,TahmKench,827,465,362,56.23
Zyra,Sona,355,158,197,44.51
Zyra,Neeko,583,311,272,53.34
Zyra,JarvanIV,671,349,322,52.01
Zyra,Swain,1043,560,483,53.69
Zyra,Renekton,528,274,254,51.89
Zyra,Rengar,288,145,143,50.35
Zyra,Zilean,340,183,157,53.82
Zyra,Caitlyn,3309,1718,1591,51.92
Zyra,Garen,1731,824,907,47.6
Zyra,Belveth,255,130,125,50.98
Zyra,Qiyana,276,145,131,52.54
Zyra,Corki,443,252,191,56.88
Zyra,Vladimir,814,437,377,53.69
Zyra,Udyr,400,193,207,48.25
Zyra,Diana,1919,902,1017,47
Zyra,Amumu,1139,534,605,46.88
Zyra,Velkoz,625,321,304,51.36
Zyra,Darius,2208,1243,965,56.3
Zyra,Yorick,1070,513,557,47.94
Zyra,Annie,437,207,230,47.37
Zyra,Jax,1069,578,491,54.07
Zyra,Irelia,989,504,485,50.96
Zyra,Poppy,680,394,286,57.94
Zyra,Malzahar,1228,619,609,50.41
Zyra,Fiora,367,181,186,49.32
Zyra,Elise,823,454,369,55.16
Zyra,Samira,786,412,374,52.42
Zyra,Aurora,938,438,500,46.7
Zyra,Mordekaiser,1427,759,668,53.19
Zyra,Skarner,248,151,97,60.89
Zyra,Lillia,662,305,357,46.07
Zyra,Draven,512,287,225,56.05
Zyra,Camille,419,229,190,54.65
Zyra,Ahri,1401,804,597,57.39
Zyra,Milio,609,299,310,49.1
Zyra,Riven,474,224,250,47.26
Zyra,Shen,730,361,369,49.45
Zyra,Maokai,639,345,294,53.99
Zyra,Warwick,1618,746,872,46.11
Zyra,Kalista,261,135,126,51.72
Zyra,Braum,587,304,283,51.79
Zyra,Yasuo,2174,1038,1136,47.75
Zyra,FiddleSticks,600,276,324,46
Zyra,Urgot,566,266,300,47
Zyra,Khazix,592,302,290,51.01
Zyra,MasterYi,1337,704,633,52.66
Zyra,Taliyah,276,158,118,57.25
Zyra,Rammus,299,137,162,45.82
Zyra,Varus,1104,529,575,47.92
Zyra,XinZhao,754,371,383,49.2
Zyra,Shaco,1195,575,620,48.12
Zyra,Kaisa,1845,966,879,52.36
Zyra,Rakan,421,234,187,55.58
Zyra,Nasus,687,370,317,53.86
Zyra,Twitch,890,467,423,52.47
Zyra,Ziggs,402,203,199,50.5
Zyra,Leblanc,773,422,351,54.59
Zyra,Nocturne,1669,827,842,49.55
Zyra,Rumble,405,184,221,45.43
Zyra,Ezreal,3016,1633,1383,54.14
Zyra,Viego,1649,761,888,46.15
Zyra,Yuumi,918,481,437,52.4
Zyra,DrMundo,634,284,350,44.79
Zyra,Graves,741,406,335,54.79
Zyra,Gnar,443,247,196,55.76
Zyra,Galio,1078,528,550,48.98
Zyra,Brand,923,491,432,53.2
Zyra,Tristana,1105,576,529,52.13
Zyra,Zac,604,323,281,53.48
Zyra,Rell,540,301,239,55.74
Zyra,Naafiri,370,203,167,54.86
Zyra,Smolder,619,325,294,52.5
Zyra,Leona,1071,590,481,55.09
Zyra,Aphelios,609,310,299,50.9
Zyra,Morgana,1529,781,748,51.08
Zyra,Lissandra,364,190,174,52.2
Zyra,Zeri,580,276,304,47.59
Zyra,Illaoi,519,283,236,54.53
Zyra,MonkeyKing,826,385,441,46.61
Zyra,Trundle,626,317,309,50.64
Zyra,Blitzcrank,912,489,423,53.62
Zyra,Kennen,298,138,160,46.31
Zyra,Malphite,1145,571,574,49.87
Zyra,Olaf,256,135,121,52.73
Zyra,Syndra,725,384,341,52.97
Zyra,TwistedFate,415,226,189,54.46
Zyra,Viktor,1110,565,545,50.9
Zyra,Kayle,687,333,354,48.47
Zyra,Nunu,564,307,257,54.43
Zyra,Taric,220,109,111,49.55
Zyra,Orianna,460,217,243,47.17
Zyra,Bard,402,201,201,50
Zyra,Xayah,414,219,195,52.9
Zyra,Shyvana,270,138,132,51.11
Zyra,Heimerdinger,552,289,263,52.36
Zyra,Ryze,373,203,170,54.42
Zyra,Gwen,641,343,298,53.51
Zyra,Azir,363,191,172,52.62
Zyra,Tryndamere,513,267,246,52.05
Zyra,Ornn,436,212,224,48.62
Zyra,Alistar,417,209,208,50.12
Zyra,Jayce,646,369,277,57.12
Zyra,Cassiopeia,317,159,158,50.16
Zyra,Talon,684,378,306,55.26
Zyra,Nilah,279,119,160,42.65
Zyra,Singed,311,151,160,48.55
Zyra,AurelionSol,399,213,186,53.38
Zyra,Akshan,329,163,166,49.54
Zyra,Janna,350,178,172,50.86
Zyra,Pyke,816,396,420,48.53
Zyra,Kassadin,207,97,110,46.86
Zyra,Kled,214,112,102,52.34
Zyra,Nidalee,443,267,176,60.27
Zyra,Kindred,467,227,240,48.61
Zyra,Zoe,426,218,208,51.17
Zyra,Quinn,434,207,227,47.7
Zyra,RekSai,121,76,45,62.81
Zyra,Renata,152,80,72,52.63
Gragas,Jax,800,388,412,48.5
Gragas,Nocturne,749,358,391,47.8
Gragas,Syndra,447,200,247,44.74
Gragas,Smolder,374,204,170,54.55
Gragas,Zyra,717,289,428,40.31
Gragas,Renekton,309,151,158,48.87
Gragas,Viktor,623,276,347,44.3
Gragas,Xayah,294,121,173,41.16
Gragas,Pyke,489,234,255,47.85
Gragas,Ambessa,476,241,235,50.63
Gragas,Ekko,636,313,323,49.21
Gragas,Yasuo,1256,594,662,47.29
Gragas,Veigar,596,282,314,47.32
Gragas,Warwick,757,362,395,47.82
Gragas,Shen,440,213,227,48.41
Gragas,Velkoz,382,198,184,51.83
Gragas,Varus,602,318,284,52.82
Gragas,Rakan,229,120,109,52.4
Gragas,Quinn,242,113,129,46.69
Gragas,Trundle,402,218,184,54.23
Gragas,Kassadin,180,70,110,38.89
Gragas,Caitlyn,1719,785,934,45.67
Gragas,Senna,462,257,205,55.63
Gragas,Mordekaiser,679,292,387,43
Gragas,Talon,400,201,199,50.25
Gragas,Alistar,301,138,163,45.85
Gragas,Naafiri,190,89,101,46.84
Gragas,MasterYi,723,350,373,48.41
Gragas,Akali,673,325,348,48.29
Gragas,Jhin,1273,597,676,46.9
Gragas,Zed,803,373,430,46.45
Gragas,Jinx,1883,891,992,47.32
Gragas,Soraka,377,145,232,38.46
Gragas,Nasus,379,180,199,47.49
Gragas,Corki,267,138,129,51.69
Gragas,Lux,1387,646,741,46.58
Gragas,Yone,1122,561,561,50
Gragas,Kayn,825,403,422,48.85
Gragas,Vladimir,461,212,249,45.99
Gragas,Vayne,831,371,460,44.65
Gragas,Thresh,944,413,531,43.75
Gragas,KSante,384,220,164,57.29
Gragas,Diana,1033,481,552,46.56
Gragas,Ahri,775,404,371,52.13
Gragas,Lulu,971,468,503,48.2
Gragas,Teemo,694,298,396,42.94
Gragas,Ashe,1180,569,611,48.22
Gragas,JarvanIV,394,161,233,40.86
Gragas,Brand,465,204,261,43.87
Gragas,Kaisa,1054,562,492,53.32
Gragas,Darius,1097,495,602,45.12
Gragas,Karma,886,415,471,46.84
Gragas,Viego,944,425,519,45.02
Gragas,AurelionSol,235,125,110,53.19
Gragas,Ezreal,1889,925,964,48.97
Gragas,Nami,594,283,311,47.64
Gragas,Sylas,1065,537,528,50.42
Gragas,Xerath,595,283,312,47.56
Gragas,Chogath,704,313,391,44.46
Gragas,LeeSin,1261,596,665,47.26
Gragas,Katarina,549,285,264,51.91
Gragas,Mel,1176,583,593,49.57
Gragas,Qiyana,175,90,85,51.43
Gragas,Shaco,586,282,304,48.12
Gragas,Draven,340,141,199,41.47
Gragas,Yuumi,574,331,243,57.67
Gragas,Aatrox,658,331,327,50.3
Gragas,Taric,124,64,60,51.61
Gragas,Gangplank,327,173,154,52.91
Gragas,Graves,447,196,251,43.85
Gragas,Elise,537,277,260,51.58
Gragas,Nunu,336,152,184,45.24
Gragas,Vex,358,153,205,42.74
Gragas,Lucian,433,236,197,54.5
Gragas,Riven,306,147,159,48.04
Gragas,FiddleSticks,325,148,177,45.54
Gragas,Irelia,465,240,225,51.61
Gragas,Twitch,553,283,270,51.18
Gragas,Milio,368,182,186,49.46
Gragas,Pantheon,1155,593,562,51.34
Gragas,Shyvana,164,96,68,58.54
Gragas,Gnar,305,168,137,55.08
Gragas,Rammus,186,99,87,53.23
Gragas,Morgana,629,276,353,43.88
Gragas,Camille,224,110,114,49.11
Gragas,Kindred,303,121,182,39.93
Gragas,Malzahar,509,242,267,47.54
Gragas,Fizz,341,178,163,52.2
Gragas,Kayle,449,227,222,50.56
Gragas,Sett,1005,500,505,49.75
Gragas,Zac,363,181,182,49.86
Gragas,Braum,358,189,169,52.79
Gragas,Seraphine,364,200,164,54.95
Gragas,Garen,994,427,567,42.96
Gragas,Hecarim,342,184,158,53.8
Gragas,Ziggs,237,112,125,47.26
Gragas,Rell,329,129,200,39.21
Gragas,TahmKench,478,219,259,45.82
Gragas,Anivia,182,87,95,47.8
Gragas,MissFortune,1266,612,654,48.34
Gragas,Illaoi,278,144,134,51.8
Gragas,Rengar,222,116,106,52.25
Gragas,Nautilus,838,423,415,50.48
Gragas,Galio,564,276,288,48.94
Gragas,Fiora,221,104,117,47.06
Gragas,Aurora,471,261,210,55.41
Gragas,Sona,219,86,133,39.27
Gragas,Volibear,697,336,361,48.21
Gragas,Skarner,173,106,67,61.27
Gragas,Sejuani,236,124,112,52.54
Gragas,Swain,617,286,331,46.35
Gragas,Bard,218,104,114,47.71
Gragas,Sion,481,250,231,51.98
Gragas,Leona,550,276,274,50.18
Gragas,Malphite,585,238,347,40.68
Gragas,Ornn,279,115,164,41.22
Gragas,Briar,470,261,209,55.53
Gragas,Orianna,294,135,159,45.92
Gragas,Zilean,199,103,96,51.76
Gragas,Yorick,562,235,327,41.81
Gragas,Blitzcrank,451,223,228,49.45
Gragas,Zoe,262,103,159,39.31
Gragas,Tristana,576,270,306,46.88
Gragas,Zeri,334,157,177,47.01
Gragas,Urgot,278,131,147,47.12
Gragas,Jayce,381,200,181,52.49
Gragas,Udyr,272,137,135,50.37
Gragas,Hwei,400,189,211,47.25
Gragas,TwistedFate,224,114,110,50.89
Gragas,Amumu,619,269,350,43.46
Gragas,DrMundo,317,176,141,55.52
Gragas,MonkeyKing,490,251,239,51.22
Gragas,Vi,735,391,344,53.2
Gragas,Gwen,266,123,143,46.24
Gragas,Aphelios,344,172,172,50
Gragas,Tryndamere,348,203,145,58.33
Gragas,Janna,238,118,120,49.58
Gragas,Belveth,163,75,88,46.01
Gragas,Rumble,189,103,86,54.5
Gragas,Khazix,318,142,176,44.65
Gragas,Poppy,401,192,209,47.88
Gragas,Evelynn,176,103,73,58.52
Gragas,Heimerdinger,236,89,147,37.71
Gragas,Kled,128,52,76,40.63
Gragas,Lissandra,228,115,113,50.44
Gragas,Cassiopeia,147,75,72,51.02
Gragas,Neeko,253,105,148,41.5
Gragas,Sivir,303,133,170,43.89
Gragas,Ryze,255,97,158,38.04
Gragas,Leblanc,473,242,231,51.16
Gragas,KogMaw,189,99,90,52.38
Gragas,Annie,237,106,131,44.73
Gragas,Azir,255,133,122,52.16
Gragas,Samira,480,229,251,47.71
Gragas,Kennen,187,80,107,42.78
Gragas,Maokai,295,112,183,37.97
Gragas,Olaf,173,101,72,58.38
Gragas,XinZhao,354,153,201,43.22
Gragas,Renata,96,49,47,51.04
Gragas,Nilah,180,81,99,45
Gragas,Akshan,188,83,105,44.15
Gragas,Kalista,169,99,70,58.58
Gragas,Karthus,180,101,79,56.11
Gragas,Singed,190,89,101,46.84
Gragas,Taliyah,163,73,90,44.79
Gragas,Ivern,78,44,34,56.41
Gragas,Lillia,344,169,175,49.13
Gragas,RekSai,79,35,44,44.3
Gragas,Nidalee,205,102,103,49.76
Kayn,Jax,1598,839,759,52.5
Kayn,Nocturne,2322,1070,1252,46.08
Kayn,Syndra,1108,554,554,50
Kayn,Smolder,1057,550,507,52.03
Kayn,Zyra,1639,823,816,50.21
Kayn,Darius,3403,1710,1693,50.25
Kayn,LeeSin,2240,1223,1017,54.6
Kayn,Diana,2933,1529,1404,52.13
Kayn,KogMaw,531,240,291,45.2
Kayn,Thresh,2146,1088,1058,50.7
Kayn,Irelia,1512,788,724,52.12
Kayn,MasterYi,2411,1134,1277,47.03
Kayn,Azir,411,208,203,50.61
Kayn,Lucian,1193,577,616,48.37
Kayn,Mel,3543,1848,1695,52.16
Kayn,Pantheon,2717,1434,1283,52.78
Kayn,Evelynn,627,312,315,49.76
Kayn,Ekko,1790,829,961,46.31
Kayn,Jinx,5005,2403,2602,48.01
Kayn,Khazix,879,453,426,51.54
Kayn,Aurora,1020,517,503,50.69
Kayn,Ashe,3311,1732,1579,52.31
Kayn,Garen,2779,1392,1387,50.09
Kayn,Vladimir,1261,640,621,50.75
Kayn,Caitlyn,4945,2430,2515,49.14
Kayn,Lulu,2223,1063,1160,47.82
Kayn,Zac,766,448,318,58.49
Kayn,Katarina,1297,606,691,46.72
Kayn,Samira,1326,657,669,49.55
Kayn,Leona,1565,782,783,49.97
Kayn,Yone,3238,1793,1445,55.37
Kayn,Warwick,2965,1371,1594,46.24
Kayn,Hwei,1062,558,504,52.54
Kayn,Varus,1405,753,652,53.59
Kayn,Malphite,1780,909,871,51.07
Kayn,Ambessa,997,560,437,56.17
Kayn,Graves,1120,520,600,46.43
Kayn,Akali,1793,950,843,52.98
Kayn,Anivia,566,253,313,44.7
Kayn,Renekton,812,420,392,51.72
Kayn,Corki,807,471,336,58.36
Kayn,Sion,1296,682,614,52.62
Kayn,Ezreal,3789,1946,1843,51.36
Kayn,Teemo,2291,1063,1228,46.4
Kayn,Mordekaiser,2370,1172,1198,49.45
Kayn,Vi,1625,819,806,50.4
Kayn,Vex,877,443,434,50.51
Kayn,Seraphine,1286,656,630,51.01
Kayn,Orianna,718,341,377,47.49
Kayn,Tristana,1833,906,927,49.43
Kayn,Lux,4448,2232,2216,50.18
Kayn,Yorick,1868,989,879,52.94
Kayn,Kindred,876,431,445,49.2
Kayn,Veigar,1857,900,957,48.47
Kayn,Nautilus,1860,975,885,52.42
Kayn,Blitzcrank,1137,581,556,51.1
Kayn,Zed,2168,1129,1039,52.08
Kayn,Xayah,660,320,340,48.48
Kayn,Karma,1863,886,977,47.56
Kayn,Nunu,862,422,440,48.96
Kayn,Qiyana,457,280,177,61.27
Kayn,Morgana,2105,1027,1078,48.79
Kayn,Sett,2608,1289,1319,49.42
Kayn,XinZhao,1058,573,485,54.16
Kayn,Fizz,1082,544,538,50.28
Kayn,Vayne,2306,1118,1188,48.48
Kayn,Shen,1098,591,507,53.83
Kayn,Amumu,1988,992,996,49.9
Kayn,Jhin,3685,1960,1725,53.19
Kayn,TahmKench,1309,695,614,53.09
Kayn,Sejuani,674,371,303,55.04
Kayn,Sylas,2053,1160,893,56.5
Kayn,Shaco,1688,821,867,48.64
Kayn,Gangplank,785,380,405,48.41
Kayn,RekSai,179,75,104,41.9
Kayn,Xerath,1601,764,837,47.72
Kayn,Gnar,619,316,303,51.05
Kayn,Rammus,506,254,252,50.2
Kayn,Soraka,994,484,510,48.69
Kayn,Briar,1341,629,712,46.91
Kayn,Yasuo,3483,1803,1680,51.77
Kayn,Trundle,1064,559,505,52.54
Kayn,Malzahar,1903,878,1025,46.14
Kayn,Pyke,1392,754,638,54.17
Kayn,Gragas,825,422,403,51.15
Kayn,Braum,1000,476,524,47.6
Kayn,Nasus,1202,590,612,49.08
Kayn,Ahri,2226,1115,1111,50.09
Kayn,Rell,765,379,386,49.54
Kayn,Swain,1565,753,812,48.12
Kayn,Talon,889,472,417,53.09
Kayn,Ziggs,652,360,292,55.21
Kayn,Zeri,584,290,294,49.66
Kayn,Senna,1315,671,644,51.03
Kayn,Ivern,216,121,95,56.02
Kayn,Kassadin,374,235,139,62.83
Kayn,MissFortune,4285,2207,2078,51.51
Kayn,Shyvana,500,252,248,50.4
Kayn,Milio,1087,453,634,41.67
Kayn,Viego,2733,1430,1303,52.32
Kayn,AurelionSol,628,315,313,50.16
Kayn,Nami,1733,814,919,46.97
Kayn,Ornn,706,338,368,47.88
Kayn,Rumble,475,266,209,56
Kayn,Tryndamere,1083,538,545,49.68
Kayn,Yuumi,1288,651,637,50.54
Kayn,Kayle,1175,561,614,47.74
Kayn,Belveth,420,229,191,54.52
Kayn,Camille,556,249,307,44.78
Kayn,Alistar,662,346,316,52.27
Kayn,Nidalee,438,269,169,61.42
Kayn,Draven,885,456,429,51.53
Kayn,Illaoi,838,416,422,49.64
Kayn,Kaisa,2570,1300,1270,50.58
Kayn,Gwen,808,407,401,50.37
Kayn,Taliyah,373,180,193,48.26
Kayn,Poppy,1023,461,562,45.06
Kayn,Rengar,611,319,292,52.21
Kayn,Zoe,600,285,315,47.5
Kayn,Leblanc,918,478,440,52.07
Kayn,Chogath,2090,1033,1057,49.43
Kayn,Aatrox,1424,765,659,53.72
Kayn,Bard,527,258,269,48.96
Kayn,Velkoz,1095,575,520,52.51
Kayn,MonkeyKing,1271,609,662,47.92
Kayn,Naafiri,628,298,330,47.45
Kayn,Sivir,883,437,446,49.49
Kayn,Urgot,927,398,529,42.93
Kayn,Jayce,685,338,347,49.34
Kayn,Udyr,747,429,318,57.43
Kayn,Volibear,2262,1163,1099,51.41
Kayn,JarvanIV,984,485,499,49.29
Kayn,Quinn,665,284,381,42.71
Kayn,Brand,1336,716,620,53.59
Kayn,Galio,1353,711,642,52.55
Kayn,Kled,324,149,175,45.99
Kayn,FiddleSticks,994,507,487,51.01
Kayn,Zilean,562,284,278,50.53
Kayn,Annie,539,285,254,52.88
Kayn,Olaf,369,190,179,51.49
Kayn,Kennen,363,189,174,52.07
Kayn,TwistedFate,582,293,289,50.34
Kayn,Hecarim,660,326,334,49.39
Kayn,Cassiopeia,480,242,238,50.42
Kayn,Maokai,770,417,353,54.16
Kayn,Janna,630,284,346,45.08
Kayn,Riven,795,408,387,51.32
Kayn,DrMundo,944,471,473,49.89
Kayn,Taric,420,210,210,50
Kayn,Neeko,715,376,339,52.59
Kayn,Skarner,463,276,187,59.61
Kayn,Elise,1130,553,577,48.94
Kayn,Viktor,1395,702,693,50.32
Kayn,Twitch,1501,811,690,54.03
Kayn,Fiora,639,314,325,49.14
Kayn,Lissandra,534,248,286,46.44
Kayn,KSante,755,446,309,59.07
Kayn,Lillia,973,492,481,50.57
Kayn,Karthus,490,261,229,53.27
Kayn,Rakan,613,348,265,56.77
Kayn,Aphelios,887,465,422,52.42
Kayn,Renata,297,154,143,51.85
Kayn,Singed,467,268,199,57.39
Kayn,Kalista,382,222,160,58.12
Kayn,Ryze,524,241,283,45.99
Kayn,Nilah,575,270,305,46.96
Kayn,Heimerdinger,886,409,477,46.16
Kayn,Akshan,650,295,355,45.38
Kayn,Sona,602,274,328,45.51
Mel,Jax,2103,1114,989,52.97
Mel,Nocturne,2968,1215,1753,40.94
Mel,Syndra,1435,682,753,47.53
Mel,Smolder,1529,798,731,52.19
Mel,Zyra,2322,1165,1157,50.17
Mel,Renekton,1162,618,544,53.18
Mel,Viktor,2445,1136,1309,46.46
Mel,Xayah,1061,485,576,45.71
Mel,Pyke,1813,892,921,49.2
Mel,Teemo,3205,1435,1770,44.77
Mel,FiddleSticks,1099,555,544,50.5
Mel,Yone,4307,2125,2182,49.34
Mel,Nilah,740,274,466,37.03
Mel,Rell,1230,579,651,47.07
Mel,Garen,3892,1810,2082,46.51
Mel,Sejuani,879,393,486,44.71
Mel,Katarina,2052,931,1121,45.37
Mel,Varus,2100,1062,1038,50.57
Mel,Yuumi,1847,867,980,46.94
Mel,Ornn,806,414,392,51.36
Mel,Kayn,3543,1695,1848,47.84
Mel,Yasuo,5024,2414,2610,48.05
Mel,Caitlyn,6464,3050,3414,47.18
Mel,Morgana,2871,1354,1517,47.16
Mel,Pantheon,3804,1827,1977,48.03
Mel,Evelynn,809,376,433,46.48
Mel,Ekko,2413,1163,1250,48.2
Mel,Jinx,7134,3275,3859,45.91
Mel,Zac,1187,613,574,51.64
Mel,Khazix,1138,577,561,50.7
Mel,Samira,1630,855,775,52.45
Mel,Leona,2382,1109,1273,46.56
Mel,Urgot,1143,533,610,46.63
Mel,Talon,1337,640,697,47.87
Mel,Ahri,2317,1125,1192,48.55
Mel,Aphelios,1249,607,642,48.6
Mel,Maokai,1027,501,526,48.78
Mel,Rumble,603,296,307,49.09
Mel,Shaco,2362,1171,1191,49.58
Mel,Veigar,2367,1135,1232,47.95
Mel,Lux,6051,3039,3012,50.22
Mel,Singed,716,346,370,48.32
Mel,Viego,3528,1654,1874,46.88
Mel,Zed,2463,1201,1262,48.76
Mel,Zeri,949,467,482,49.21
Mel,Milio,1344,524,820,38.99
Mel,Amumu,2513,1126,1387,44.81
Mel,Galio,2145,1003,1142,46.76
Mel,Warwick,3449,1498,1951,43.43
Mel,Shen,1367,696,671,50.91
Mel,Velkoz,1423,680,743,47.79
Mel,Rakan,1073,514,559,47.9
Mel,Fiora,861,367,494,42.62
Mel,Graves,1423,711,712,49.96
Mel,Azir,925,436,489,47.14
Mel,Ashe,4741,2286,2455,48.22
Mel,Braum,1270,549,721,43.23
Mel,Skarner,569,268,301,47.1
Mel,Irelia,2075,1057,1018,50.94
Mel,MissFortune,5859,2733,3126,46.65
Mel,Alistar,1106,535,571,48.37
Mel,Yorick,2372,1007,1365,42.45
Mel,Rammus,644,310,334,48.14
Mel,Swain,2233,1079,1154,48.32
Mel,Sett,3730,1682,2048,45.09
Mel,Ziggs,963,385,578,39.98
Mel,Kaisa,3891,1796,2095,46.16
Mel,Trundle,1422,621,801,43.67
Mel,Vi,2290,1097,1193,47.9
Mel,Fizz,1982,929,1053,46.87
Mel,Sivir,1287,635,652,49.34
Mel,Diana,4171,1916,2255,45.94
Mel,Draven,1274,632,642,49.61
Mel,Aatrox,1978,956,1022,48.33
Mel,Darius,4360,2019,2341,46.31
Mel,TahmKench,1825,908,917,49.75
Mel,Ivern,275,144,131,52.36
Mel,Nunu,1309,644,665,49.2
Mel,JarvanIV,1319,596,723,45.19
Mel,Twitch,1956,988,968,50.51
Mel,Lulu,3082,1416,1666,45.94
Mel,Kayle,1699,843,856,49.62
Mel,Briar,1847,796,1051,43.1
Mel,Malzahar,2636,1272,1364,48.25
Mel,Brand,1733,850,883,49.05
Mel,KogMaw,722,304,418,42.11
Mel,Mordekaiser,3141,1403,1738,44.67
Mel,Lucian,1697,859,838,50.62
Mel,Nami,2136,1014,1122,47.47
Mel,Rengar,865,446,419,51.56
Mel,Akali,2736,1283,1453,46.89
Mel,Jhin,5132,2424,2708,47.23
Mel,Ezreal,5549,2738,2811,49.34
Mel,Sona,785,355,430,45.22
Mel,Naafiri,842,422,420,50.12
Mel,Nidalee,563,262,301,46.54
Mel,Renata,261,115,146,44.06
Mel,Volibear,2747,1390,1357,50.6
Mel,Xerath,2773,1276,1497,46.02
Mel,Illaoi,1093,525,568,48.03
Mel,XinZhao,1544,707,837,45.79
Mel,Sylas,3468,1679,1789,48.41
Mel,Vex,1014,530,484,52.27
Mel,MasterYi,2992,1433,1559,47.89
Mel,Karthus,676,329,347,48.67
Mel,Gangplank,1074,554,520,51.58
Mel,Lillia,1176,552,624,46.94
Mel,Karma,2850,1270,1580,44.56
Mel,DrMundo,1353,614,739,45.38
Mel,AurelionSol,1199,540,659,45.04
Mel,Udyr,974,502,472,51.54
Mel,Vladimir,1730,812,918,46.94
Mel,Poppy,1380,659,721,47.75
Mel,Tristana,2367,1110,1257,46.89
Mel,Thresh,2971,1427,1544,48.03
Mel,Tryndamere,1442,732,710,50.76
Mel,Soraka,1556,693,863,44.54
Mel,Riven,1053,457,596,43.4
Mel,Vayne,3137,1448,1689,46.16
Mel,Taliyah,590,280,310,47.46
Mel,Kalista,598,270,328,45.15
Mel,KSante,1144,549,595,47.99
Mel,Seraphine,1640,787,853,47.99
Mel,Gragas,1176,593,583,50.43
Mel,Janna,811,410,401,50.55
Mel,Gnar,909,440,469,48.4
Mel,Orianna,1345,572,773,42.53
Mel,Gwen,1077,557,520,51.72
Mel,TwistedFate,665,316,349,47.52
Mel,Shyvana,544,281,263,51.65
Mel,Nautilus,2639,1218,1421,46.15
Mel,Corki,901,444,457,49.28
Mel,Zilean,711,331,380,46.55
Mel,Heimerdinger,1085,503,582,46.36
Mel,Kled,433,206,227,47.58
Mel,Kassadin,706,351,355,49.72
Mel,Malphite,2339,1118,1221,47.8
Mel,Ambessa,1360,717,643,52.72
Mel,Chogath,3081,1420,1661,46.09
Mel,Annie,818,370,448,45.23
Mel,Aurora,1584,751,833,47.41
Mel,Kindred,914,399,515,43.65
Mel,Sion,1712,807,905,47.14
Mel,MonkeyKing,1632,753,879,46.14
Mel,Hwei,1533,683,850,44.55
Mel,Nasus,1821,809,1012,44.43
Mel,Anivia,711,335,376,47.12
Mel,Quinn,942,405,537,42.99
Mel,Jayce,1085,515,570,47.47
Mel,Ryze,810,361,449,44.57
Mel,Blitzcrank,1585,813,772,51.29
Mel,Qiyana,578,279,299,48.27
Mel,Hecarim,1039,534,505,51.4
Mel,Cassiopeia,763,343,420,44.95
Mel,LeeSin,3678,1791,1887,48.69
Mel,Taric,552,268,284,48.55
Mel,Camille,846,408,438,48.23
Mel,Lissandra,748,356,392,47.59
Mel,Zoe,791,381,410,48.17
Mel,Belveth,513,249,264,48.54
Mel,Leblanc,1211,604,607,49.88
Mel,Bard,709,326,383,45.98
Mel,Elise,1469,694,775,47.24
Mel,Senna,1865,859,1006,46.06
Mel,Neeko,1082,532,550,49.17
Mel,Kennen,605,296,309,48.93
Mel,RekSai,254,141,113,55.51
Mel,Olaf,534,279,255,52.25
Mel,Akshan,822,380,442,46.23
Jinx,Jax,3302,1718,1584,52.03
Jinx,Nocturne,4204,2073,2131,49.31
Jinx,Syndra,2128,1019,1109,47.89
Jinx,Smolder,2151,1144,1007,53.18
Jinx,Zyra,3307,1620,1687,48.99
Jinx,Warwick,5173,2475,2698,47.84
Jinx,Khazix,1584,865,719,54.61
Jinx,Yorick,3471,1693,1778,48.78
Jinx,Vayne,4841,2521,2320,52.08
Jinx,Lulu,4385,2267,2118,51.7
Jinx,Darius,6390,3247,3143,50.81
Jinx,Zac,1446,661,785,45.71
Jinx,Malzahar,3637,1879,1758,51.66
Jinx,Ziggs,1282,669,613,52.18
Jinx,Sona,1219,626,593,51.35
Jinx,Volibear,4095,2102,1993,51.33
Jinx,Zoe,1267,624,643,49.25
Jinx,Samira,2674,1414,1260,52.88
Jinx,Pantheon,5215,2766,2449,53.04
Jinx,Gangplank,1530,791,739,51.7
Jinx,Kayn,5005,2602,2403,51.99
Jinx,Mel,7134,3858,3276,54.08
Jinx,MissFortune,9701,4869,4832,50.19
Jinx,Thresh,4459,2288,2171,51.31
Jinx,Chogath,4219,2156,2063,51.1
Jinx,Kindred,1673,847,826,50.63
Jinx,Katarina,2553,1322,1231,51.78
Jinx,Tristana,3749,1912,1837,51
Jinx,Neeko,1489,768,721,51.58
Jinx,Azir,1181,661,520,55.97
Jinx,Jhin,7805,4121,3684,52.8
Jinx,Senna,2642,1341,1301,50.76
Jinx,Urgot,1856,895,961,48.22
Jinx,Briar,2673,1323,1350,49.49
Jinx,Ahri,4346,2306,2040,53.06
Jinx,Caitlyn,11587,5896,5691,50.88
Jinx,Lux,8188,4085,4103,49.89
Jinx,Singed,984,506,478,51.42
Jinx,Shaco,3162,1661,1501,52.53
Jinx,Hwei,2187,1105,1082,50.53
Jinx,Janna,1205,582,623,48.3
Jinx,FiddleSticks,1680,894,786,53.21
Jinx,Yone,6245,3350,2895,53.64
Jinx,Varus,3299,1694,1605,51.35
Jinx,Zilean,1089,525,564,48.21
Jinx,Talon,1943,1041,902,53.58
Jinx,Aphelios,2232,1162,1070,52.06
Jinx,Maokai,1478,738,740,49.93
Jinx,Viego,5023,2540,2483,50.57
Jinx,Zed,3707,1939,1768,52.31
Jinx,Zeri,1542,781,761,50.65
Jinx,Milio,1949,953,996,48.9
Jinx,Evelynn,1160,571,589,49.22
Jinx,Nami,3710,1922,1788,51.81
Jinx,Sett,4984,2574,2410,51.65
Jinx,Nasus,2492,1189,1303,47.71
Jinx,Aurora,2387,1280,1107,53.62
Jinx,Lillia,1753,912,841,52.03
Jinx,Renata,648,331,317,51.08
Jinx,Renekton,1693,835,858,49.32
Jinx,Shyvana,784,405,379,51.66
Jinx,Veigar,3577,1844,1733,51.55
Jinx,Yasuo,6667,3365,3302,50.47
Jinx,Xerath,2987,1458,1529,48.81
Jinx,Ekko,3257,1592,1665,48.88
Jinx,Rammus,1184,611,573,51.6
Jinx,Swain,3297,1637,1660,49.65
Jinx,Tryndamere,2136,1054,1082,49.34
Jinx,Poppy,1964,1030,934,52.44
Jinx,Kassadin,696,376,320,54.02
Jinx,Ashe,8141,4098,4043,50.34
Jinx,Soraka,1919,925,994,48.2
Jinx,Velkoz,2096,1059,1037,50.52
Jinx,Garen,5535,2869,2666,51.83
Jinx,Irelia,2834,1447,1387,51.06
Jinx,Rengar,1145,582,563,50.83
Jinx,Fizz,1990,992,998,49.85
Jinx,KogMaw,1276,583,693,45.69
Jinx,Kaisa,6211,3274,2937,52.71
Jinx,Gragas,1883,991,892,52.63
Jinx,Quinn,1318,648,670,49.17
Jinx,Vladimir,2427,1199,1228,49.4
Jinx,Ezreal,8783,4665,4118,53.11
Jinx,Brand,2557,1356,1201,53.03
Jinx,Hecarim,1504,825,679,54.85
Jinx,Lissandra,1210,582,628,48.1
Jinx,Lucian,2509,1342,1167,53.49
Jinx,TahmKench,2502,1356,1146,54.2
Jinx,Twitch,3642,1787,1855,49.07
Jinx,Mordekaiser,4507,2184,2323,48.46
Jinx,LeeSin,4995,2628,2367,52.61
Jinx,Nilah,1072,565,507,52.71
Jinx,Braum,1814,877,937,48.35
Jinx,Diana,5581,2916,2665,52.25
Jinx,Leona,2935,1539,1396,52.44
Jinx,Olaf,719,344,375,47.84
Jinx,Trundle,2013,1101,912,54.69
Jinx,Vex,1777,943,834,53.07
Jinx,Pyke,2691,1349,1342,50.13
Jinx,Nunu,1741,911,830,52.33
Jinx,Aatrox,3030,1574,1456,51.95
Jinx,Teemo,4174,2170,2004,51.99
Jinx,Sylas,4583,2396,2187,52.28
Jinx,Morgana,4143,2101,2042,50.71
Jinx,Skarner,772,432,340,55.96
Jinx,Blitzcrank,2277,1202,1075,52.79
Jinx,Sion,2532,1274,1258,50.32
Jinx,Udyr,1326,696,630,52.49
Jinx,Ryze,1069,557,512,52.1
Jinx,Anivia,1113,554,559,49.78
Jinx,Gwen,1653,898,755,54.33
Jinx,JarvanIV,2084,999,1085,47.94
Jinx,Annie,1161,603,558,51.94
Jinx,Riven,1601,854,747,53.34
Jinx,Jayce,1827,901,926,49.32
Jinx,Gnar,1379,707,672,51.27
Jinx,Ambessa,2010,1100,910,54.73
Jinx,Malphite,3502,1798,1704,51.34
Jinx,MasterYi,4256,2123,2133,49.88
Jinx,Naafiri,1045,573,472,54.83
Jinx,Akali,3578,1757,1821,49.11
Jinx,Seraphine,2578,1275,1303,49.46
Jinx,Orianna,1539,771,768,50.1
Jinx,Sejuani,1317,673,644,51.1
Jinx,Bard,1022,522,500,51.08
Jinx,Taric,777,434,343,55.86
Jinx,Elise,2300,1155,1145,50.22
Jinx,Fiora,1179,645,534,54.71
Jinx,Karthus,994,528,466,53.12
Jinx,Akshan,1223,598,625,48.9
Jinx,Kayle,2457,1202,1255,48.92
Jinx,Belveth,830,472,358,56.87
Jinx,Shen,2061,1143,918,55.46
Jinx,Heimerdinger,1577,759,818,48.13
Jinx,Xayah,1413,723,690,51.17
Jinx,Kennen,821,383,438,46.65
Jinx,Viktor,3208,1617,1591,50.41
Jinx,MonkeyKing,2371,1226,1145,51.71
Jinx,Rakan,1338,728,610,54.41
Jinx,Cassiopeia,1006,535,471,53.18
Jinx,Draven,1844,962,882,52.17
Jinx,Rell,1568,806,762,51.4
Jinx,Galio,2883,1468,1415,50.92
Jinx,Karma,4053,2063,1990,50.9
Jinx,KSante,1789,966,823,54
Jinx,Amumu,3599,1754,1845,48.74
Jinx,Leblanc,2022,1034,988,51.14
Jinx,Qiyana,725,385,340,53.1
Jinx,Illaoi,1568,770,798,49.11
Jinx,Taliyah,834,451,383,54.08
Jinx,Kled,605,300,305,49.59
Jinx,Vi,3266,1688,1578,51.68
Jinx,Rumble,946,545,401,57.61
Jinx,DrMundo,2096,1085,1011,51.77
Jinx,TwistedFate,1190,668,522,56.13
Jinx,Nautilus,3670,2040,1630,55.59
Jinx,XinZhao,2179,1090,1089,50.02
Jinx,Sivir,1777,890,887,50.08
Jinx,Ivern,411,205,206,49.88
Jinx,Kalista,778,424,354,54.5
Jinx,Nidalee,890,480,410,53.93
Jinx,Camille,1136,619,517,54.49
Jinx,Graves,2260,1235,1025,54.65
Jinx,Ornn,1416,693,723,48.94
Jinx,Alistar,1397,756,641,54.12
Jinx,Yuumi,2560,1342,1218,52.42
Jinx,AurelionSol,1259,636,623,50.52
Jinx,RekSai,360,204,156,56.67
Jinx,Corki,1354,675,679,49.85
Thresh,Jax,1411,752,659,53.3
Thresh,Nocturne,1963,955,1008,48.65
Thresh,Syndra,1024,525,499,51.27
Thresh,Smolder,976,524,452,53.69
Thresh,Zyra,1433,681,752,47.52
Thresh,Garen,2473,1124,1349,45.45
Thresh,Diana,2635,1356,1279,51.46
Thresh,Sylas,2356,1263,1093,53.61
Thresh,Kaisa,2817,1447,1370,51.37
Thresh,Pyke,1356,779,577,57.45
Thresh,Warwick,2307,1137,1170,49.28
Thresh,Briar,1031,541,490,52.47
Thresh,Zed,1817,956,861,52.61
Thresh,Ziggs,507,222,285,43.79
Thresh,Xerath,1427,713,714,49.96
Thresh,Mordekaiser,1988,949,1039,47.74
Thresh,Kayn,2146,1058,1088,49.3
Thresh,Talon,895,505,390,56.42
Thresh,MissFortune,3423,1684,1739,49.2
Thresh,Lulu,2421,1277,1144,52.75
Thresh,Pantheon,2340,1201,1139,51.32
Thresh,Evelynn,478,246,232,51.46
Thresh,Ekko,1509,749,760,49.64
Thresh,Jinx,4459,2168,2291,48.62
Thresh,Gnar,675,375,300,55.56
Thresh,Azir,571,324,247,56.74
Thresh,Varus,1457,774,683,53.12
Thresh,Nautilus,1962,1051,911,53.57
Thresh,Ornn,591,272,319,46.02
Thresh,Malzahar,1617,776,841,47.99
Thresh,Vayne,2123,1066,1057,50.21
Thresh,Aatrox,1622,833,789,51.36
Thresh,Khazix,801,420,381,52.43
Thresh,Fizz,901,455,446,50.5
Thresh,Lux,3958,1916,2042,48.41
Thresh,Neeko,657,319,338,48.55
Thresh,Singed,460,201,259,43.7
Thresh,Shaco,1359,703,656,51.73
Thresh,Hwei,1032,502,530,48.64
Thresh,Jhin,3245,1678,1567,51.71
Thresh,Janna,558,254,304,45.52
Thresh,Trundle,834,441,393,52.88
Thresh,Volibear,1740,871,869,50.06
Thresh,Viktor,1419,710,709,50.04
Thresh,Xayah,800,394,406,49.25
Thresh,Viego,2525,1287,1238,50.97
Thresh,Aurora,1125,560,565,49.78
Thresh,Yorick,1495,680,815,45.48
Thresh,Elise,1159,581,578,50.13
Thresh,Corki,664,340,324,51.2
Thresh,Milio,951,468,483,49.21
Thresh,Vi,1452,799,653,55.03
Thresh,Ahri,1960,986,974,50.31
Thresh,Sett,2269,1157,1112,50.99
Thresh,MonkeyKing,1186,597,589,50.34
Thresh,Anivia,503,264,239,52.49
Thresh,Ivern,207,117,90,56.52
Thresh,Veigar,1345,620,725,46.1
Thresh,Brand,1055,514,541,48.72
Thresh,Rammus,510,252,258,49.41
Thresh,Swain,1611,739,872,45.87
Thresh,Chogath,1789,869,920,48.57
Thresh,Sivir,828,391,437,47.22
Thresh,Sejuani,702,325,377,46.3
Thresh,Caitlyn,4090,2067,2023,50.54
Thresh,Karma,2146,1075,1071,50.09
Thresh,DrMundo,790,400,390,50.63
Thresh,MasterYi,1839,922,917,50.14
Thresh,Irelia,1368,722,646,52.78
Thresh,Malphite,1593,825,768,51.79
Thresh,LeeSin,2755,1486,1269,53.94
Thresh,Nilah,427,182,245,42.62
Thresh,Braum,1218,626,592,51.4
Thresh,Udyr,656,299,357,45.58
Thresh,FiddleSticks,759,421,338,55.47
Thresh,Kennen,442,212,230,47.96
Thresh,Taric,405,209,196,51.6
Thresh,Leblanc,1074,528,546,49.16
Thresh,TahmKench,1233,656,577,53.2
Thresh,Qiyana,342,180,162,52.63
Thresh,Katarina,1224,593,631,48.45
Thresh,Ezreal,4247,2201,2046,51.82
Thresh,Akali,1704,900,804,52.82
Thresh,Zilean,554,266,288,48.01
Thresh,Gragas,944,531,413,56.25
Thresh,Amumu,1441,651,790,45.18
Thresh,Camille,548,287,261,52.37
Thresh,Nami,1565,767,798,49.01
Thresh,Urgot,716,330,386,46.09
Thresh,Darius,2978,1476,1502,49.56
Thresh,Teemo,1768,874,894,49.43
Thresh,Graves,1199,579,620,48.29
Thresh,Samira,1035,594,441,57.39
Thresh,Shen,993,443,550,44.61
Thresh,Riven,736,384,352,52.17
Thresh,Fiora,613,315,298,51.39
Thresh,Seraphine,1050,527,523,50.19
Thresh,Velkoz,959,484,475,50.47
Thresh,JarvanIV,1020,550,470,53.92
Thresh,Zeri,720,384,336,53.33
Thresh,Mel,2971,1541,1430,51.87
Thresh,Jayce,919,463,456,50.38
Thresh,Soraka,843,398,445,47.21
Thresh,Vex,858,442,416,51.52
Thresh,Tryndamere,865,431,434,49.83
Thresh,Taliyah,456,182,274,39.91
Thresh,Yasuo,3090,1669,1421,54.01
Thresh,Poppy,1036,502,534,48.46
Thresh,Tristana,1502,775,727,51.6
Thresh,Leona,1561,800,761,51.25
Thresh,KogMaw,468,213,255,45.51
Thresh,Morgana,1969,924,1045,46.93
Thresh,Vladimir,1025,535,490,52.2
Thresh,Yone,2956,1621,1335,54.84
Thresh,Yuumi,1287,712,575,55.32
Thresh,Rengar,480,259,221,53.96
Thresh,Belveth,393,194,199,49.36
Thresh,Kayle,999,481,518,48.15
Thresh,Shyvana,379,163,216,43.01
Thresh,AurelionSol,470,233,237,49.57
Thresh,Ashe,3229,1615,1614,50.02
Thresh,Renata,279,140,139,50.18
Thresh,Blitzcrank,1242,677,565,54.51
Thresh,Illaoi,658,308,350,46.81
Thresh,TwistedFate,621,292,329,47.02
Thresh,Lucian,1050,564,486,53.71
Thresh,Rakan,688,373,315,54.22
Thresh,Kled,277,123,154,44.4
Thresh,Nasus,963,493,470,51.19
Thresh,Senna,1158,582,576,50.26
Thresh,Orianna,673,384,289,57.06
Thresh,Renekton,827,407,420,49.21
Thresh,Quinn,527,257,270,48.77
Thresh,RekSai,163,85,78,52.15
Thresh,Karthus,492,246,246,50
Thresh,Draven,861,442,419,51.34
Thresh,XinZhao,1124,579,545,51.51
Thresh,Gwen,789,416,373,52.72
Thresh,Kassadin,394,210,184,53.3
Thresh,Rell,848,412,436,48.58
Thresh,Twitch,1172,595,577,50.77
Thresh,Galio,1496,780,716,52.14
Thresh,Lissandra,552,236,316,42.75
Thresh,Maokai,689,307,382,44.56
Thresh,Naafiri,440,239,201,54.32
Thresh,Zoe,611,283,328,46.32
Thresh,Gangplank,719,382,337,53.13
Thresh,Alistar,807,403,404,49.94
Thresh,Kindred,735,372,363,50.61
Thresh,Ambessa,1013,528,485,52.12
Thresh,Heimerdinger,597,296,301,49.58
Thresh,Zac,829,419,410,50.54
Thresh,Annie,544,291,253,53.49
Thresh,Skarner,395,208,187,52.66
Thresh,Sona,476,227,249,47.69
Thresh,Nunu,742,321,421,43.26
Thresh,Hecarim,663,327,336,49.32
Thresh,Nidalee,543,286,257,52.67
Thresh,Lillia,836,454,382,54.31
Thresh,Bard,569,272,297,47.8
Thresh,Cassiopeia,479,242,237,50.52
Thresh,KSante,833,441,392,52.94
Thresh,Aphelios,885,441,444,49.83
Thresh,Kalista,396,207,189,52.27
Thresh,Sion,1263,611,652,48.38
Thresh,Ryze,680,325,355,47.79
Thresh,Olaf,369,158,211,42.82
Thresh,Akshan,478,251,227,52.51
Thresh,Rumble,423,231,192,54.61
Garen,Yorick,1891,880,1011,46.54
Garen,Warwick,2957,1497,1460,50.63
Garen,Veigar,1996,1008,988,50.5
Garen,Tristana,1841,970,871,52.69
Garen,Thresh,2473,1349,1124,54.55
Garen,Gangplank,811,446,365,54.99
Garen,Evelynn,596,309,287,51.85
Garen,Mel,3892,2082,1810,53.49
Garen,Ashe,3798,2008,1790,52.87
Garen,Elise,1332,736,596,55.26
Garen,Singed,565,293,272,51.86
Garen,Shaco,1782,932,850,52.3
Garen,Hwei,1123,544,579,48.44
Garen,Jhin,3966,2117,1849,53.38
Garen,Janna,658,326,332,49.54
Garen,Sion,1389,744,645,53.56
Garen,Vi,1830,964,866,52.68
Garen,Sylas,2706,1382,1324,51.07
Garen,Lucian,1201,657,544,54.7
Garen,Pantheon,3007,1462,1545,48.62
Garen,Rumble,433,188,245,43.42
Garen,Kayn,2779,1387,1392,49.91
Garen,Akshan,607,276,331,45.47
Garen,Yuumi,1466,801,665,54.64
Garen,Sett,3268,1535,1733,46.97
Garen,Nocturne,2523,1214,1309,48.12
Garen,Azir,597,317,280,53.1
Garen,Ezreal,4577,2383,2194,52.06
Garen,Qiyana,489,274,215,56.03
Garen,TahmKench,1552,782,770,50.39
Garen,LeeSin,2606,1383,1223,53.07
Garen,Karma,2296,1139,1157,49.61
Garen,Nasus,1602,856,746,53.43
Garen,Aurora,1259,699,560,55.52
Garen,Varus,1726,972,754,56.32
Garen,Fiora,676,336,340,49.7
Garen,Graves,1187,676,511,56.95
Garen,Braum,1083,543,540,50.14
Garen,Irelia,1652,870,782,52.66
Garen,MasterYi,2489,1131,1358,45.44
Garen,Galio,1688,844,844,50
Garen,Draven,848,428,420,50.47
Garen,Nautilus,2118,1092,1026,51.56
Garen,Heimerdinger,849,393,456,46.29
Garen,Renata,345,193,152,55.94
Garen,Mordekaiser,2677,1179,1498,44.04
Garen,Talon,1069,608,461,56.88
Garen,Lux,4859,2449,2410,50.4
Garen,Jinx,5535,2666,2869,48.17
Garen,Darius,4119,1985,2134,48.19
Garen,Sejuani,664,362,302,54.52
Garen,Yone,3557,1915,1642,53.84
Garen,Milio,1063,522,541,49.11
Garen,Olaf,487,269,218,55.24
Garen,Diana,3201,1546,1655,48.3
Garen,Kennen,410,228,182,55.61
Garen,FiddleSticks,961,492,469,51.2
Garen,Vladimir,1101,544,557,49.41
Garen,Zed,2310,1239,1071,53.64
Garen,Nilah,625,302,323,48.32
Garen,Fizz,1245,636,609,51.08
Garen,Samira,1271,688,583,54.13
Garen,Ambessa,1088,631,457,58
Garen,Hecarim,791,427,364,53.98
Garen,Katarina,1455,733,722,50.38
Garen,Nami,1947,992,955,50.95
Garen,Trundle,1238,688,550,55.57
Garen,JarvanIV,1151,569,582,49.44
Garen,Twitch,1529,776,753,50.75
Garen,Lulu,2390,1176,1214,49.21
Garen,Urgot,1007,527,480,52.33
Garen,Briar,1366,679,687,49.71
Garen,Zoe,652,343,309,52.61
Garen,Akali,2147,1113,1034,51.84
Garen,Sona,621,308,313,49.6
Garen,Viego,2651,1356,1295,51.15
Garen,Orianna,859,457,402,53.2
Garen,Illaoi,998,554,444,55.51
Garen,Nunu,1071,533,538,49.77
Garen,Sivir,1044,484,560,46.36
Garen,Zyra,1731,907,824,52.4
Garen,Neeko,804,415,389,51.62
Garen,Camille,1096,545,551,49.73
Garen,XinZhao,1249,657,592,52.6
Garen,MissFortune,4575,2326,2249,50.84
Garen,Ahri,2395,1169,1226,48.81
Garen,Morgana,2280,1163,1117,51.01
Garen,KogMaw,587,270,317,46
Garen,Zilean,614,298,316,48.53
Garen,Vayne,2774,1335,1439,48.13
Garen,Ekko,1750,843,907,48.17
Garen,Yasuo,4114,2078,2036,50.51
Garen,Amumu,1999,978,1021,48.92
Garen,Poppy,1120,556,564,49.64
Garen,Chogath,2363,1095,1268,46.34
Garen,Bard,552,282,270,51.09
Garen,Teemo,2501,1206,1295,48.22
Garen,Smolder,1117,573,544,51.3
Garen,Alistar,740,363,377,49.05
Garen,Corki,827,452,375,54.66
Garen,Gwen,1034,571,463,55.22
Garen,Khazix,862,497,365,57.66
Garen,Ziggs,700,392,308,56
Garen,Caitlyn,5416,2728,2688,50.37
Garen,Malzahar,2019,1003,1016,49.68
Garen,Rammus,600,297,303,49.5
Garen,Aphelios,992,489,503,49.29
Garen,Volibear,2322,1195,1127,51.46
Garen,Syndra,1239,641,598,51.74
Garen,Xayah,867,474,393,54.67
Garen,Malphite,1766,924,842,52.32
Garen,Riven,942,481,461,51.06
Garen,Viktor,1687,890,797,52.76
Garen,Aatrox,1666,892,774,53.54
Garen,Anivia,599,317,282,52.92
Garen,Tryndamere,1347,666,681,49.44
Garen,Brand,1488,804,684,54.03
Garen,Lillia,1219,649,570,53.24
Garen,Jax,2327,1284,1043,55.18
Garen,DrMundo,1131,588,543,51.99
Garen,Shyvana,584,319,265,54.62
Garen,MonkeyKing,1348,683,665,50.67
Garen,Blitzcrank,1325,672,653,50.72
Garen,Gnar,777,381,396,49.03
Garen,Karthus,550,291,259,52.91
Garen,Kaisa,2989,1533,1456,51.29
Garen,KSante,1028,610,418,59.34
Garen,AurelionSol,684,390,294,57.02
Garen,Kalista,446,228,218,51.12
Garen,Rell,801,402,399,50.19
Garen,Naafiri,638,324,314,50.78
Garen,Swain,2018,1038,980,51.44
Garen,Leona,1642,860,782,52.38
Garen,Kayle,1539,706,833,45.87
Garen,Udyr,716,365,351,50.98
Garen,Kled,314,147,167,46.82
Garen,Renekton,1006,594,412,59.05
Garen,Gragas,994,567,427,57.04
Garen,Taric,443,217,226,48.98
Garen,Seraphine,1388,699,689,50.36
Garen,Zac,911,450,461,49.4
Garen,Leblanc,1097,573,524,52.23
Garen,Ivern,301,159,142,52.82
Garen,Zeri,790,425,365,53.8
Garen,Skarner,434,235,199,54.15
Garen,Vex,922,503,419,54.56
Garen,Rengar,606,287,319,47.36
Garen,Taliyah,469,239,230,50.96
Garen,Rakan,749,387,362,51.67
Garen,Cassiopeia,483,266,217,55.07
Garen,Kindred,952,476,476,50
Garen,Kassadin,395,209,186,52.91
Garen,Senna,1481,741,740,50.03
Garen,Soraka,1044,548,496,52.49
Garen,Xerath,1625,796,829,48.98
Garen,Velkoz,1187,570,617,48.02
Garen,Ornn,813,402,411,49.45
Garen,Shen,1211,609,602,50.29
Garen,Pyke,1490,810,680,54.36
Garen,TwistedFate,720,377,343,52.36
Garen,Lissandra,546,214,332,39.19
Garen,Belveth,411,216,195,52.55
Garen,Quinn,815,417,398,51.17
Garen,Jayce,736,427,309,58.02
Garen,RekSai,197,112,85,56.85
Garen,Ryze,617,271,346,43.92
Garen,Annie,648,341,307,52.62
Garen,Nidalee,457,289,168,63.24
Garen,Maokai,859,413,446,48.08
Diana,Yorick,1961,980,981,49.97
Diana,Warwick,2991,1382,1609,46.21
Diana,Veigar,2033,1029,1004,50.61
Diana,Tristana,1838,970,868,52.77
Diana,Thresh,2635,1279,1356,48.54
Diana,Darius,3693,1864,1829,50.47
Diana,Zac,952,491,461,51.58
Diana,Malzahar,2093,1091,1002,52.13
Diana,Ziggs,713,311,402,43.62
Diana,Sona,638,319,319,50
Diana,Mordekaiser,2527,1227,1300,48.56
Diana,Karthus,666,351,315,52.7
Diana,Katarina,1522,787,735,51.71
Diana,Jhin,3808,1952,1856,51.26
Diana,Karma,2489,1327,1162,53.31
Diana,Kayn,2933,1404,1529,47.87
Diana,Talon,1213,607,606,50.04
Diana,MissFortune,4743,2421,2322,51.04
Diana,Lulu,2726,1358,1368,49.82
Diana,Ambessa,1266,649,617,51.26
Diana,Ekko,1796,915,881,50.95
Diana,Yasuo,3604,1809,1795,50.19
Diana,Pyke,1408,680,728,48.3
Diana,Urgot,1026,501,525,48.83
Diana,Vi,1856,970,886,52.26
Diana,Caitlyn,5300,2785,2515,52.55
Diana,Bard,603,290,313,48.09
Diana,Fiora,678,387,291,57.08
Diana,Zed,2472,1298,1174,52.51
Diana,Swain,1794,906,888,50.5
Diana,Chogath,2231,1064,1167,47.69
Diana,Rumble,566,300,266,53
Diana,Akshan,586,309,277,52.73
Diana,Yuumi,1472,762,710,51.77
Diana,JarvanIV,1038,545,493,52.5
Diana,Orianna,823,471,352,57.23
Diana,Nocturne,2468,1232,1236,49.92
Diana,Xerath,1772,884,888,49.89
Diana,Volibear,2163,1083,1080,50.07
Diana,LeeSin,3431,1768,1663,51.53
Diana,Irelia,1548,802,746,51.81
Diana,MasterYi,2595,1281,1314,49.36
Diana,Galio,2009,953,1056,47.44
Diana,Draven,920,466,454,50.65
Diana,Nautilus,2134,1112,1022,52.11
Diana,Xayah,890,432,458,48.54
Diana,Velkoz,1134,542,592,47.8
Diana,Akali,2163,1136,1027,52.52
Diana,Lux,4832,2468,2364,51.08
Diana,Sivir,1056,478,578,45.27
Diana,Morgana,2332,1229,1103,52.7
Diana,Garen,3201,1655,1546,51.7
Diana,Smolder,1223,690,533,56.42
Diana,Kennen,591,293,298,49.58
Diana,Ashe,3917,2091,1826,53.38
Diana,Leona,1643,862,781,52.47
Diana,Trundle,1143,517,626,45.23
Diana,Graves,1267,653,614,51.54
Diana,Mel,4171,2255,1916,54.06
Diana,DrMundo,1069,541,528,50.61
Diana,Jax,1916,967,949,50.47
Diana,AurelionSol,622,327,295,52.57
Diana,Rakan,723,368,355,50.9
Diana,Olaf,384,198,186,51.56
Diana,Pantheon,3252,1719,1533,52.86
Diana,Leblanc,1287,683,604,53.07
Diana,Jinx,5581,2665,2916,47.75
Diana,Sett,3075,1458,1617,47.41
Diana,Evelynn,708,390,318,55.08
Diana,Vladimir,1320,703,617,53.26
Diana,Khazix,925,488,437,52.76
Diana,Sejuani,754,403,351,53.45
Diana,Poppy,1129,598,531,52.97
Diana,TahmKench,1373,714,659,52
Diana,Shaco,1887,998,889,52.89
Diana,Hwei,1152,557,595,48.35
Diana,Gangplank,921,504,417,54.72
Diana,Kaisa,3243,1689,1554,52.08
Diana,Gragas,1033,552,481,53.44
Diana,Ezreal,4906,2594,2312,52.87
Diana,Annie,607,324,283,53.38
Diana,Illaoi,951,499,452,52.47
Diana,Naafiri,661,309,352,46.75
Diana,Maokai,893,464,429,51.96
Diana,Kayle,1278,693,585,54.23
Diana,Kassadin,434,214,220,49.31
Diana,Teemo,2574,1297,1277,50.39
Diana,Rammus,574,317,257,55.23
Diana,Brand,1478,686,792,46.41
Diana,Shen,1140,554,586,48.6
Diana,Zyra,1919,1017,902,53
Diana,Elise,1317,688,629,52.24
Diana,Fizz,1122,600,522,53.48
Diana,Samira,1312,681,631,51.91
Diana,Aatrox,1654,862,792,52.12
Diana,Ahri,2549,1353,1196,53.08
Diana,Amumu,2204,1044,1160,47.37
Diana,Seraphine,1394,732,662,52.51
Diana,Tryndamere,990,472,518,47.68
Diana,FiddleSticks,1014,513,501,50.59
Diana,Ryze,700,336,364,48
Diana,Senna,1378,676,702,49.06
Diana,Yone,3521,1832,1689,52.03
Diana,Singed,513,261,252,50.88
Diana,Braum,1035,527,508,50.92
Diana,Viego,3102,1516,1586,48.87
Diana,Gnar,765,393,372,51.37
Diana,Viktor,1658,834,824,50.3
Diana,Sylas,2930,1568,1362,53.52
Diana,KSante,1061,560,501,52.78
Diana,Rengar,593,334,259,56.32
Diana,Soraka,962,517,445,53.74
Diana,Renekton,985,496,489,50.36
Diana,Quinn,624,293,331,46.96
Diana,Vayne,2372,1148,1224,48.4
Diana,XinZhao,1341,682,659,50.86
Diana,Aurora,1530,763,767,49.87
Diana,Kindred,869,432,437,49.71
Diana,Nami,1988,963,1025,48.44
Diana,Kalista,463,225,238,48.6
Diana,Alistar,850,437,413,51.41
Diana,Janna,648,293,355,45.22
Diana,Vex,1038,521,517,50.19
Diana,Nunu,955,473,482,49.53
Diana,Taric,420,199,221,47.38
Diana,Lillia,1110,610,500,54.95
Diana,MonkeyKing,1399,645,754,46.1
Diana,Lucian,1330,726,604,54.59
Diana,Milio,1044,528,516,50.57
Diana,Udyr,769,412,357,53.58
Diana,Syndra,1163,578,585,49.7
Diana,Blitzcrank,1339,684,655,51.08
Diana,RekSai,186,120,66,64.52
Diana,Varus,1737,893,844,51.41
Diana,Qiyana,482,264,218,54.77
Diana,Skarner,435,244,191,56.09
Diana,TwistedFate,695,392,303,56.4
Diana,Gwen,1042,565,477,54.22
Diana,Twitch,1583,785,798,49.59
Diana,Taliyah,471,243,228,51.59
Diana,Camille,695,383,312,55.11
Diana,Cassiopeia,651,303,348,46.54
Diana,Riven,803,427,376,53.18
Diana,Briar,1467,677,790,46.15
Diana,Neeko,880,451,429,51.25
Diana,Zeri,792,386,406,48.74
Diana,Jayce,1013,513,500,50.64
Diana,Nasus,1402,718,684,51.21
Diana,Azir,752,401,351,53.32
Diana,Aphelios,1062,527,535,49.62
Diana,Rell,939,503,436,53.57
Diana,Sion,1378,679,699,49.27
Diana,Zoe,675,330,345,48.89
Diana,Malphite,1812,940,872,51.88
Diana,Shyvana,475,271,204,57.05
Diana,KogMaw,549,278,271,50.64
Diana,Kled,293,152,141,51.88
Diana,Belveth,399,206,193,51.63
Diana,Heimerdinger,824,370,454,44.9
Diana,Ornn,786,406,380,51.65
Diana,Ivern,242,143,99,59.09
Diana,Zilean,548,284,264,51.82
Diana,Nilah,564,286,278,50.71
Diana,Lissandra,683,311,372,45.53
Diana,Nidalee,583,356,227,61.06
Diana,Renata,301,158,143,52.49
Diana,Corki,717,361,356,50.35
Diana,Hecarim,743,370,373,49.8
Diana,Anivia,600,254,346,42.33
Sylas,Yorick,1333,688,645,51.61
Sylas,Warwick,2442,1164,1278,47.67
Sylas,Veigar,1452,712,740,49.04
Sylas,Tristana,1579,707,872,44.78
Sylas,Thresh,2356,1093,1263,46.39
Sylas,Malphite,2698,1454,1244,53.89
Sylas,Amumu,1698,824,874,48.53
Sylas,Ahri,2628,1356,1272,51.6
Sylas,Kaisa,3190,1559,1631,48.87
Sylas,Pyke,1433,682,751,47.59
Sylas,Garen,2706,1324,1382,48.93
Sylas,Rengar,426,202,224,47.42
Sylas,Lissandra,526,266,260,50.57
Sylas,Zyra,1695,812,883,47.91
Sylas,Riven,704,352,352,50
Sylas,Nocturne,2455,1255,1200,51.12
Sylas,Nilah,484,230,254,47.52
Sylas,Renekton,945,446,499,47.2
Sylas,Shyvana,370,187,183,50.54
Sylas,Vayne,1895,898,997,47.39
Sylas,MissFortune,3789,1744,2045,46.03
Sylas,Jax,1670,805,865,48.2
Sylas,Skarner,485,244,241,50.31
Sylas,Irelia,1482,787,695,53.1
Sylas,Alistar,1041,552,489,53.03
Sylas,Kayle,1004,461,543,45.92
Sylas,LeeSin,3641,1814,1827,49.82
Sylas,Yasuo,3628,1741,1887,47.99
Sylas,Caitlyn,4620,2281,2339,49.37
Sylas,Karma,2005,965,1040,48.13
Sylas,Volibear,1685,822,863,48.78
Sylas,Smolder,914,438,476,47.92
Sylas,Lux,3825,1760,2065,46.01
Sylas,Singed,434,221,213,50.92
Sylas,Kayn,2053,893,1160,43.5
Sylas,Galio,2097,969,1128,46.21
Sylas,Sivir,925,447,478,48.32
Sylas,Teemo,1916,886,1030,46.24
Sylas,Lillia,957,435,522,45.45
Sylas,Poppy,960,431,529,44.9
Sylas,Viego,2654,1255,1399,47.29
Sylas,Nami,1356,643,713,47.42
Sylas,Sett,2475,1073,1402,43.35
Sylas,MasterYi,1784,874,910,48.99
Sylas,Katarina,1204,604,600,50.17
Sylas,Aphelios,763,337,426,44.17
Sylas,Trundle,847,423,424,49.94
Sylas,JarvanIV,947,493,454,52.06
Sylas,Twitch,1138,521,617,45.78
Sylas,Lulu,2380,1178,1202,49.5
Sylas,Briar,1012,445,567,43.97
Sylas,Malzahar,1440,675,765,46.88
Sylas,Brand,1034,490,544,47.39
Sylas,Aatrox,1533,762,771,49.71
Sylas,Vi,1870,893,977,47.75
Sylas,Zoe,673,303,370,45.02
Sylas,Nautilus,2166,1124,1042,51.89
Sylas,Pantheon,2773,1247,1526,44.97
Sylas,Jinx,4583,2187,2396,47.72
Sylas,Leona,1594,766,828,48.06
Sylas,Mordekaiser,1935,875,1060,45.22
Sylas,Akshan,498,233,265,46.79
Sylas,Maokai,890,396,494,44.49
Sylas,Naafiri,556,254,302,45.68
Sylas,Soraka,861,398,463,46.23
Sylas,Chogath,1824,870,954,47.7
Sylas,Mel,3468,1789,1679,51.59
Sylas,Renata,258,147,111,56.98
Sylas,Illaoi,776,302,474,38.92
Sylas,Draven,793,428,365,53.97
Sylas,Nunu,899,438,461,48.72
Sylas,Shaco,1369,633,736,46.24
Sylas,Fizz,851,470,381,55.23
Sylas,FiddleSticks,924,467,457,50.54
Sylas,Jhin,3275,1612,1663,49.22
Sylas,Senna,1104,485,619,43.93
Sylas,Yone,3796,1846,1950,48.63
Sylas,Sejuani,784,394,390,50.26
Sylas,Zac,1012,483,529,47.73
Sylas,Darius,2681,1335,1346,49.79
Sylas,Ekko,1635,789,846,48.26
Sylas,Taric,322,136,186,42.24
Sylas,Xayah,879,405,474,46.08
Sylas,Diana,2930,1362,1568,46.48
Sylas,Akali,2518,1278,1240,50.75
Sylas,Leblanc,1176,592,584,50.34
Sylas,Samira,1179,531,648,45.04
Sylas,Gragas,1065,528,537,49.58
Sylas,Morgana,1737,818,919,47.09
Sylas,Bard,489,214,275,43.76
Sylas,Swain,1792,793,999,44.25
Sylas,Velkoz,839,398,441,47.44
Sylas,Kindred,732,346,386,47.27
Sylas,Sion,1193,538,655,45.1
Sylas,Seraphine,1222,590,632,48.28
Sylas,Vex,1056,483,573,45.74
Sylas,Hwei,1020,516,504,50.59
Sylas,Nasus,1049,505,544,48.14
Sylas,Tryndamere,785,412,373,52.48
Sylas,Gnar,759,391,368,51.52
Sylas,Ezreal,4979,2505,2474,50.31
Sylas,Udyr,585,293,292,50.09
Sylas,Ashe,3992,2023,1969,50.68
Sylas,TahmKench,1124,596,528,53.02
Sylas,Rammus,474,224,250,47.26
Sylas,DrMundo,827,434,393,52.48
Sylas,Zed,2097,1096,1001,52.27
Sylas,Talon,1175,599,576,50.98
Sylas,Rakan,781,400,381,51.22
Sylas,Gwen,759,386,373,50.86
Sylas,Vladimir,1158,571,587,49.31
Sylas,Olaf,374,164,210,43.85
Sylas,Ornn,766,359,407,46.87
Sylas,Graves,1175,574,601,48.85
Sylas,Anivia,518,260,258,50.19
Sylas,Blitzcrank,1464,763,701,52.12
Sylas,Sona,482,244,238,50.62
Sylas,Fiora,553,274,279,49.55
Sylas,Rell,844,394,450,46.68
Sylas,Shen,930,454,476,48.82
Sylas,Ziggs,474,244,230,51.48
Sylas,Corki,711,363,348,51.05
Sylas,Evelynn,534,243,291,45.51
Sylas,Zeri,736,436,300,59.24
Sylas,Xerath,1591,778,813,48.9
Sylas,Urgot,722,349,373,48.34
Sylas,Aurora,1376,668,708,48.55
Sylas,Quinn,546,241,305,44.14
Sylas,Janna,450,205,245,45.56
Sylas,KSante,1065,561,504,52.68
Sylas,Milio,769,375,394,48.76
Sylas,Kennen,576,316,260,54.86
Sylas,Neeko,805,419,386,52.05
Sylas,Karthus,488,211,277,43.24
Sylas,Yuumi,1279,676,603,52.85
Sylas,Orianna,787,393,394,49.94
Sylas,Viktor,1607,824,783,51.28
Sylas,Ivern,224,98,126,43.75
Sylas,AurelionSol,463,213,250,46
Sylas,Syndra,839,416,423,49.58
Sylas,Zilean,545,264,281,48.44
Sylas,Gangplank,885,419,466,47.34
Sylas,Ryze,760,343,417,45.13
Sylas,Kassadin,276,112,164,40.58
Sylas,Hecarim,791,410,381,51.83
Sylas,RekSai,178,100,78,56.18
Sylas,Lucian,1183,632,551,53.42
Sylas,Jayce,1046,481,565,45.98
Sylas,Braum,1014,482,532,47.53
Sylas,Varus,1794,871,923,48.55
Sylas,Azir,734,354,380,48.23
Sylas,Qiyana,433,201,232,46.42
Sylas,Kalista,433,238,195,54.97
Sylas,KogMaw,432,221,211,51.16
Sylas,XinZhao,1154,584,570,50.61
Sylas,Camille,581,304,277,52.32
Sylas,Heimerdinger,728,258,470,35.44
Sylas,TwistedFate,642,298,344,46.42
Sylas,Khazix,811,390,421,48.09
Sylas,MonkeyKing,1199,565,634,47.12
Sylas,Cassiopeia,550,237,313,43.09
Sylas,Taliyah,500,225,275,45
Sylas,Nidalee,565,307,258,54.34
Sylas,Ambessa,1176,605,571,51.45
Sylas,Elise,1278,651,627,50.94
Sylas,Rumble,590,276,314,46.78
Sylas,Belveth,341,163,178,47.8
Sylas,Kled,304,137,167,45.07
Sylas,Annie,520,240,280,46.15
Kaisa,Yorick,1741,796,945,45.72
Kaisa,Warwick,2675,1283,1392,47.96
Kaisa,Veigar,1628,761,867,46.74
Kaisa,Tristana,1844,913,931,49.51
Kaisa,Thresh,2817,1370,1447,48.63
Kaisa,Riven,909,457,452,50.28
Kaisa,Sejuani,799,401,398,50.19
Kaisa,Sylas,3190,1631,1559,51.13
Kaisa,Lucian,1436,663,773,46.17
Kaisa,Soraka,1067,485,582,45.45
Kaisa,Rakan,860,395,465,45.93
Kaisa,Ekko,1811,877,934,48.43
Kaisa,Ashe,4110,1881,2229,45.77
Kaisa,Kayle,1151,520,631,45.18
Kaisa,Darius,3517,1718,1799,48.85
Kaisa,Malphite,1846,887,959,48.05
Kaisa,Ezreal,7261,3784,3477,52.11
Kaisa,Nami,1873,931,942,49.71
Kaisa,Nocturne,2669,1224,1445,45.86
Kaisa,Nilah,545,249,296,45.69
Kaisa,Lissandra,620,293,327,47.26
Kaisa,Quinn,607,291,316,47.94
Kaisa,Trundle,1074,536,538,49.91
Kaisa,Kassadin,397,178,219,44.84
Kaisa,Caitlyn,5216,2493,2723,47.8
Kaisa,Senna,1435,714,721,49.76
Kaisa,Mordekaiser,2210,1008,1202,45.61
Kaisa,Shaco,1848,907,941,49.08
Kaisa,Xerath,1834,913,921,49.78
Kaisa,Karma,2695,1292,1403,47.94
Kaisa,LeeSin,3598,1825,1773,50.72
Kaisa,Zed,2411,1220,1191,50.6
Kaisa,Lulu,2591,1141,1450,44.04
Kaisa,Heimerdinger,813,380,433,46.74
Kaisa,Kindred,934,464,470,49.68
Kaisa,Mel,3891,2092,1799,53.77
Kaisa,Jhin,4128,2127,2001,51.53
Kaisa,Ornn,841,382,459,45.42
Kaisa,Jinx,6211,2934,3277,47.24
Kaisa,Sett,2973,1425,1548,47.93
Kaisa,Hecarim,832,413,419,49.64
Kaisa,Graves,1463,735,728,50.24
Kaisa,Irelia,1808,791,1017,43.75
Kaisa,Briar,1182,527,655,44.59
Kaisa,Vayne,2779,1390,1389,50.02
Kaisa,Pyke,1643,854,789,51.98
Kaisa,Yone,3832,1931,1901,50.39
Kaisa,Ahri,2572,1214,1358,47.2
Kaisa,Velkoz,1133,538,595,47.48
Kaisa,Teemo,2291,1059,1232,46.22
Kaisa,Morgana,2080,1020,1060,49.04
Kaisa,KSante,1167,616,551,52.78
Kaisa,Swain,1852,830,1022,44.82
Kaisa,Yasuo,3986,1934,2052,48.52
Kaisa,Lux,4504,2211,2293,49.09
Kaisa,Aatrox,1817,881,936,48.49
Kaisa,Viego,2910,1390,1520,47.77
Kaisa,Naafiri,647,290,357,44.82
Kaisa,Brand,1341,689,652,51.38
Kaisa,Milio,1083,499,584,46.08
Kaisa,Talon,1317,653,664,49.58
Kaisa,Malzahar,1899,866,1033,45.6
Kaisa,MissFortune,4618,2210,2408,47.86
Kaisa,Leona,1688,836,852,49.53
Kaisa,Taliyah,515,243,272,47.18
Kaisa,Blitzcrank,1299,716,583,55.12
Kaisa,Jax,1905,963,942,50.55
Kaisa,Vi,1974,979,995,49.59
Kaisa,Diana,3243,1554,1689,47.92
Kaisa,Renekton,1102,505,597,45.83
Kaisa,Rell,894,433,461,48.43
Kaisa,Volibear,2070,997,1073,48.16
Kaisa,Sona,580,278,302,47.93
Kaisa,Xayah,1279,557,722,43.55
Kaisa,Chogath,2147,1051,1096,48.95
Kaisa,Smolder,1202,562,640,46.76
Kaisa,Renata,370,205,165,55.41
Kaisa,Amumu,1886,847,1039,44.91
Kaisa,Elise,1586,737,849,46.47
Kaisa,Fizz,1170,589,581,50.34
Kaisa,Nautilus,2062,1013,1049,49.13
Kaisa,Gragas,1054,492,562,46.68
Kaisa,Varus,1809,986,823,54.51
Kaisa,Bard,650,318,332,48.92
Kaisa,Aurora,1483,691,792,46.59
Kaisa,Sion,1516,746,770,49.21
Kaisa,Shen,1123,551,572,49.07
Kaisa,Twitch,1447,670,777,46.3
Kaisa,Ryze,825,328,497,39.76
Kaisa,Khazix,1015,495,520,48.77
Kaisa,Vladimir,1355,674,681,49.74
Kaisa,Zilean,656,302,354,46.04
Kaisa,Tryndamere,1000,509,491,50.9
Kaisa,Akali,2251,1004,1247,44.6
Kaisa,Yuumi,1649,867,782,52.58
Kaisa,Nunu,1012,517,495,51.09
Kaisa,Draven,992,434,558,43.75
Kaisa,DrMundo,1081,547,534,50.6
Kaisa,Vex,961,478,483,49.74
Kaisa,MasterYi,2281,1074,1207,47.08
Kaisa,Kayn,2570,1270,1300,49.42
Kaisa,Viktor,1809,886,923,48.98
Kaisa,Gangplank,1048,502,546,47.9
Kaisa,Evelynn,621,280,341,45.09
Kaisa,Janna,731,356,375,48.7
Kaisa,Syndra,1308,663,645,50.69
Kaisa,Illaoi,875,460,415,52.57
Kaisa,Rengar,650,354,296,54.46
Kaisa,Leblanc,1341,693,648,51.68
Kaisa,Kalista,521,211,310,40.5
Kaisa,XinZhao,1401,637,764,45.47
Kaisa,Galio,1893,859,1034,45.38
Kaisa,Hwei,1242,607,635,48.87
Kaisa,Rumble,584,289,295,49.49
Kaisa,Annie,697,300,397,43.04
Kaisa,Sivir,1028,457,571,44.46
Kaisa,Qiyana,476,210,266,44.12
Kaisa,Samira,1311,680,631,51.87
Kaisa,Zac,1027,509,518,49.56
Kaisa,Katarina,1463,677,786,46.27
Kaisa,TahmKench,1396,688,708,49.28
Kaisa,Aphelios,1031,517,514,50.15
Kaisa,Gnar,843,420,423,49.82
Kaisa,Zyra,1845,879,966,47.64
Kaisa,JarvanIV,1232,660,572,53.57
Kaisa,Orianna,908,479,429,52.75
Kaisa,Anivia,709,342,367,48.24
Kaisa,Nasus,1247,530,717,42.5
Kaisa,Pantheon,3198,1562,1636,48.84
Kaisa,Corki,818,435,383,53.18
Kaisa,Garen,2989,1456,1533,48.71
Kaisa,Maokai,933,399,534,42.77
Kaisa,Udyr,761,372,389,48.88
Kaisa,AurelionSol,638,327,311,51.25
Kaisa,Ambessa,1306,681,625,52.14
Kaisa,Gwen,885,457,428,51.64
Kaisa,Poppy,1367,651,716,47.62
Kaisa,Ziggs,687,347,340,50.51
Kaisa,Braum,1222,564,658,46.15
Kaisa,Alistar,903,419,484,46.4
Kaisa,Karthus,600,226,374,37.67
Kaisa,Skarner,540,296,244,54.81
Kaisa,Singed,521,273,248,52.4
Kaisa,Zeri,923,462,461,50.05
Kaisa,Neeko,804,393,411,48.88
Kaisa,Fiora,691,314,377,45.44
Kaisa,Lillia,1087,555,532,51.06
Kaisa,KogMaw,561,224,337,39.93
Kaisa,Azir,698,356,342,51
Kaisa,Urgot,998,428,570,42.89
Kaisa,MonkeyKing,1309,577,732,44.08
Kaisa,Ivern,257,101,156,39.3
Kaisa,TwistedFate,773,377,396,48.77
Kaisa,Rammus,578,278,300,48.1
Kaisa,Olaf,409,187,222,45.72
Kaisa,Seraphine,1352,626,726,46.3
Kaisa,FiddleSticks,944,444,500,47.03
Kaisa,Jayce,1011,494,517,48.86
Kaisa,Camille,731,380,351,51.98
Kaisa,Cassiopeia,562,279,283,49.64
Kaisa,Taric,380,204,176,53.68
Kaisa,Shyvana,488,222,266,45.49
Kaisa,Akshan,582,285,297,48.97
Kaisa,Belveth,466,247,219,53
Kaisa,Nidalee,689,360,329,52.25
Kaisa,Kennen,546,246,300,45.05
Kaisa,Zoe,778,389,389,50
Kaisa,RekSai,235,138,97,58.72
Kaisa,Kled,349,184,165,52.72
Yorick,Garen,1891,1011,880,53.46
Yorick,Diana,1961,981,980,50.03
Yorick,Sylas,1333,645,688,48.39
Yorick,Kaisa,1741,942,799,54.11
Yorick,Pyke,938,521,417,55.54
Yorick,Teemo,1800,956,844,53.11
Yorick,MonkeyKing,797,442,355,55.46
Yorick,Katarina,874,446,428,51.03
Yorick,Jinx,3471,1778,1693,51.22
Yorick,Blitzcrank,763,431,332,56.49
Yorick,Nasus,916,495,421,54.04
Yorick,Nocturne,1478,696,782,47.09
Yorick,Vladimir,723,412,311,56.98
Yorick,Jhin,2505,1346,1159,53.73
Yorick,Seraphine,954,523,431,54.82
Yorick,Tryndamere,1062,560,502,52.73
Yorick,Lillia,655,351,304,53.59
Yorick,Viktor,905,472,433,52.15
Yorick,Tristana,1298,744,554,57.32
Yorick,Senna,926,522,404,56.37
Yorick,Renekton,612,341,271,55.72
Yorick,Trundle,846,461,385,54.49
Yorick,Mordekaiser,1834,935,899,50.98
Yorick,Nautilus,1369,737,632,53.83
Yorick,Darius,2277,1267,1010,55.64
Yorick,Lux,3244,1787,1457,55.09
Yorick,Lucian,801,464,337,57.93
Yorick,Thresh,1495,812,683,54.31
Yorick,Urgot,869,448,421,51.55
Yorick,MasterYi,1669,907,762,54.34
Yorick,Galio,937,474,463,50.59
Yorick,Varus,1006,561,445,55.77
Yorick,Morgana,1574,839,735,53.3
Yorick,Talon,615,303,312,49.27
Yorick,Ahri,1589,824,765,51.86
Yorick,Aphelios,629,323,306,51.35
Yorick,Maokai,533,321,212,60.23
Yorick,Shen,811,427,384,52.65
Yorick,Amumu,1446,791,655,54.7
Yorick,Orianna,539,315,224,58.44
Yorick,Caitlyn,3389,1842,1547,54.35
Yorick,Sona,458,257,201,56.11
Yorick,Briar,986,473,513,47.97
Yorick,Veigar,1428,748,680,52.38
Yorick,MissFortune,3130,1576,1554,50.35
Yorick,Brand,983,486,497,49.44
Yorick,Kayn,1868,879,989,47.06
Yorick,Rammus,373,189,184,50.67
Yorick,Xerath,1005,513,492,51.04
Yorick,Vayne,1506,784,722,52.06
Yorick,Nami,1241,666,575,53.67
Yorick,Mel,2372,1364,1008,57.5
Yorick,Poppy,643,331,312,51.48
Yorick,Kassadin,212,92,120,43.4
Yorick,Ashe,2434,1344,1090,55.22
Yorick,Soraka,701,364,337,51.93
Yorick,Jax,1122,617,505,54.99
Yorick,Ekko,1185,655,530,55.27
Yorick,Zeri,397,210,187,52.9
Yorick,Ornn,469,238,231,50.75
Yorick,Gwen,742,406,336,54.72
Yorick,Fizz,704,389,315,55.26
Yorick,Ezreal,2534,1343,1191,53
Yorick,Rakan,383,203,180,53
Yorick,Yasuo,2461,1274,1187,51.77
Yorick,Udyr,476,279,197,58.61
Yorick,Qiyana,265,139,126,52.45
Yorick,Riven,401,219,182,54.61
Yorick,Graves,634,352,282,55.52
Yorick,TahmKench,914,506,408,55.36
Yorick,Ryze,377,187,190,49.6
Yorick,Neeko,536,284,252,52.99
Yorick,Zoe,396,221,175,55.81
Yorick,Sivir,662,360,302,54.38
Yorick,Volibear,1392,733,659,52.66
Yorick,Annie,434,229,205,52.76
Yorick,Samira,832,489,343,58.77
Yorick,Yone,2336,1295,1041,55.44
Yorick,Malzahar,1383,757,626,54.74
Yorick,Belveth,275,145,130,52.73
Yorick,Corki,428,212,216,49.53
Yorick,Ambessa,549,327,222,59.56
Yorick,Singed,310,176,134,56.77
Yorick,Draven,661,389,272,58.85
Yorick,Elise,669,351,318,52.47
Yorick,Taliyah,198,108,90,54.55
Yorick,Zyra,1070,557,513,52.06
Yorick,RekSai,95,59,36,62.11
Yorick,Swain,1202,566,636,47.09
Yorick,Kled,194,88,106,45.36
Yorick,Shaco,1202,661,541,54.99
Yorick,Camille,287,165,122,57.49
Yorick,FiddleSticks,513,261,252,50.88
Yorick,Kennen,273,142,131,52.01
Yorick,Rengar,373,222,151,59.52
Yorick,Smolder,817,435,382,53.24
Yorick,Pantheon,1876,984,892,52.45
Yorick,TwistedFate,413,239,174,57.87
Yorick,Ziggs,396,209,187,52.78
Yorick,Janna,370,180,190,48.65
Yorick,Warwick,2143,1015,1128,47.36
Yorick,Khazix,573,345,228,60.21
Yorick,Braum,560,280,280,50
Yorick,Bard,343,196,147,57.14
Yorick,Akali,1198,632,566,52.75
Yorick,LeeSin,1351,751,600,55.59
Yorick,Velkoz,811,433,378,53.39
Yorick,Sett,1763,907,856,51.45
Yorick,XinZhao,821,402,419,48.96
Yorick,Heimerdinger,584,302,282,51.71
Yorick,Kayle,982,469,513,47.76
Yorick,Karma,1283,655,628,51.05
Yorick,Akshan,462,250,212,54.11
Yorick,Hecarim,431,257,174,59.63
Yorick,Hwei,731,398,333,54.45
Yorick,Viego,1695,950,745,56.05
Yorick,Chogath,1756,875,881,49.83
Yorick,Sion,1015,514,501,50.64
Yorick,Sejuani,484,231,253,47.73
Yorick,Aatrox,830,461,369,55.54
Yorick,Lissandra,384,202,182,52.6
Yorick,Alistar,474,273,201,57.59
Yorick,Vi,1081,581,500,53.75
Yorick,Malphite,1156,600,556,51.9
Yorick,Kalista,226,128,98,56.64
Yorick,Evelynn,390,201,189,51.54
Yorick,Twitch,975,482,493,49.44
Yorick,Lulu,1376,687,689,49.93
Yorick,Aurora,711,404,307,56.82
Yorick,Anivia,360,183,177,50.83
Yorick,Zilean,341,179,162,52.49
Yorick,Nunu,728,366,362,50.27
Yorick,Syndra,745,389,356,52.21
Yorick,Azir,335,213,122,63.58
Yorick,Naafiri,442,217,225,49.1
Yorick,Fiora,404,226,178,55.94
Yorick,Vex,635,321,314,50.55
Yorick,Zed,1152,629,523,54.6
Yorick,Yuumi,888,493,395,55.52
Yorick,Irelia,1160,585,575,50.43
Yorick,DrMundo,689,371,318,53.85
Yorick,Leona,1006,513,493,50.99
Yorick,JarvanIV,649,329,320,50.69
Yorick,Karthus,300,174,126,58
Yorick,Olaf,230,147,83,63.91
Yorick,Leblanc,620,301,319,48.55
Yorick,KSante,497,317,180,63.78
Yorick,Cassiopeia,369,206,163,55.83
Yorick,Skarner,315,209,106,66.35
Yorick,Nidalee,299,164,135,54.85
Yorick,Gragas,562,327,235,58.19
Yorick,AurelionSol,518,259,259,50
Yorick,Nilah,374,190,184,50.8
Yorick,Xayah,519,254,265,48.94
Yorick,Milio,716,345,371,48.18
Yorick,Shyvana,310,186,124,60
Yorick,Illaoi,649,395,254,60.86
Yorick,Zac,557,263,294,47.22
Yorick,Gangplank,516,245,271,47.48
Yorick,Gnar,413,215,198,52.06
Yorick,KogMaw,351,180,171,51.28
Yorick,Kindred,527,277,250,52.56
Yorick,Rell,565,313,252,55.4
Yorick,Taric,279,167,112,59.86
Yorick,Jayce,538,275,263,51.12
Yorick,Quinn,455,250,205,54.95
Yorick,Renata,159,83,76,52.2
Yorick,Rumble,220,130,90,59.09
Yorick,Ivern,113,73,40,64.6
Warwick,Garen,2957,1459,1498,49.34
Warwick,Diana,2991,1609,1382,53.79
Warwick,Sylas,2442,1278,1164,52.33
Warwick,Kaisa,2675,1389,1286,51.93
Warwick,Pyke,1391,711,680,51.11
Warwick,Darius,3756,1914,1842,50.96
Warwick,Rammus,665,336,329,50.53
Warwick,Qiyana,366,223,143,60.93
Warwick,Ezreal,3549,1910,1639,53.82
Warwick,Swain,1794,881,913,49.11
Warwick,Teemo,2438,1265,1173,51.89
Warwick,MonkeyKing,1254,689,565,54.94
Warwick,Katarina,1369,790,579,57.71
Warwick,Jinx,5173,2698,2475,52.16
Warwick,Blitzcrank,1266,678,588,53.55
Warwick,DrMundo,1126,558,568,49.56
Warwick,Rengar,569,321,248,56.41
Warwick,Zilean,485,255,230,52.58
Warwick,Ashe,3433,1912,1521,55.69
Warwick,Thresh,2307,1170,1137,50.72
Warwick,Urgot,971,446,525,45.93
Warwick,Vi,1758,977,781,55.57
Warwick,Ekko,1745,882,863,50.54
Warwick,Caitlyn,5078,2586,2492,50.93
Warwick,Bard,466,263,203,56.44
Warwick,Irelia,1416,762,654,53.81
Warwick,Fizz,1125,598,527,53.16
Warwick,Vayne,2406,1273,1133,52.91
Warwick,Yuumi,1202,659,543,54.83
Warwick,Tryndamere,1152,646,506,56.08
Warwick,Kayn,2965,1594,1371,53.76
Warwick,Viktor,1294,673,621,52.01
Warwick,Jhin,3707,1819,1888,49.07
Warwick,Ornn,755,429,326,56.82
Warwick,Singed,487,231,256,47.43
Warwick,Ahri,2310,1234,1076,53.42
Warwick,Sett,2791,1405,1386,50.34
Warwick,Gragas,757,395,362,52.18
Warwick,Yasuo,3621,1902,1719,52.53
Warwick,Kalista,416,228,188,54.81
Warwick,Mel,3449,1951,1498,56.57
Warwick,Sion,1267,589,678,46.49
Warwick,Shaco,1760,924,836,52.5
Warwick,Malzahar,1786,897,889,50.22
Warwick,Milio,1030,511,519,49.61
Warwick,Aatrox,1384,698,686,50.43
Warwick,Graves,950,476,474,50.11
Warwick,Malphite,1736,854,882,49.19
Warwick,Viego,2528,1342,1186,53.09
Warwick,Twitch,1550,782,768,50.45
Warwick,Lulu,1830,933,897,50.98
Warwick,Pantheon,2598,1329,1269,51.15
Warwick,Veigar,1870,984,886,52.62
Warwick,Nocturne,2490,1211,1279,48.63
Warwick,Velkoz,1086,574,512,52.85
Warwick,Mordekaiser,2758,1463,1295,53.05
Warwick,LeeSin,2100,1103,997,52.52
Warwick,Zed,1844,963,881,52.22
Warwick,Nilah,567,280,287,49.38
Warwick,Braum,829,397,432,47.89
Warwick,Olaf,380,183,197,48.16
Warwick,Trundle,1380,738,642,53.48
Warwick,Vex,1004,565,439,56.27
Warwick,Xerath,1523,777,746,51.02
Warwick,Chogath,2233,1120,1113,50.16
Warwick,MissFortune,4597,2355,2242,51.23
Warwick,Nami,1663,768,895,46.18
Warwick,Renekton,839,447,392,53.28
Warwick,Ziggs,682,370,312,54.25
Warwick,Nasus,1296,647,649,49.92
Warwick,Amumu,2257,1126,1131,49.89
Warwick,Ryze,570,257,313,45.09
Warwick,Neeko,777,418,359,53.8
Warwick,Khazix,693,383,310,55.27
Warwick,Maokai,793,453,340,57.12
Warwick,Naafiri,670,333,337,49.7
Warwick,Nidalee,373,210,163,56.3
Warwick,Xayah,751,391,360,52.06
Warwick,Renata,331,178,153,53.78
Warwick,TahmKench,1473,806,667,54.72
Warwick,Akali,2035,1104,931,54.25
Warwick,Sona,611,281,330,45.99
Warwick,Vladimir,1012,546,466,53.95
Warwick,Zeri,684,334,350,48.83
Warwick,Galio,1510,691,819,45.76
Warwick,Udyr,751,364,387,48.47
Warwick,XinZhao,1077,555,522,51.53
Warwick,Lux,4735,2497,2238,52.73
Warwick,Leona,1566,801,765,51.15
Warwick,Akshan,616,314,302,50.97
Warwick,Draven,979,484,495,49.44
Warwick,Sejuani,708,377,331,53.25
Warwick,Seraphine,1500,780,720,52
Warwick,MasterYi,2514,1338,1176,53.22
Warwick,Poppy,1004,548,456,54.58
Warwick,Ambessa,957,553,404,57.78
Warwick,Aurora,1071,556,515,51.91
Warwick,Yorick,2143,1128,1015,52.64
Warwick,Yone,3255,1851,1404,56.87
Warwick,Varus,1410,756,654,53.62
Warwick,Belveth,425,211,214,49.65
Warwick,Rell,843,418,425,49.58
Warwick,Riven,803,442,361,55.04
Warwick,Ivern,228,106,122,46.49
Warwick,Smolder,996,501,495,50.3
Warwick,Morgana,2286,1151,1135,50.35
Warwick,Gangplank,722,361,361,50
Warwick,Soraka,1019,515,504,50.54
Warwick,Kayle,1177,620,557,52.68
Warwick,Leblanc,901,490,411,54.38
Warwick,Samira,1375,767,608,55.78
Warwick,Rumble,431,252,179,58.47
Warwick,Karma,1680,871,809,51.85
Warwick,Gnar,703,371,332,52.77
Warwick,Shen,1075,558,517,51.91
Warwick,Cassiopeia,475,235,240,49.47
Warwick,Anivia,527,271,256,51.42
Warwick,KSante,691,348,343,50.36
Warwick,AurelionSol,672,333,339,49.55
Warwick,Zyra,1618,872,746,53.89
Warwick,Evelynn,677,346,331,51.11
Warwick,Syndra,1022,503,519,49.22
Warwick,Brand,1420,675,745,47.54
Warwick,Alistar,685,318,367,46.42
Warwick,Nunu,984,535,449,54.37
Warwick,Taric,402,200,202,49.75
Warwick,Jax,1950,1041,909,53.38
Warwick,Volibear,2517,1386,1131,55.07
Warwick,FiddleSticks,834,427,407,51.2
Warwick,Gwen,967,527,440,54.5
Warwick,Fiora,615,319,296,51.87
Warwick,Zoe,512,253,259,49.41
Warwick,Kassadin,316,142,174,44.94
Warwick,Hwei,1127,601,526,53.33
Warwick,Illaoi,900,475,425,52.78
Warwick,Sivir,892,493,399,55.27
Warwick,Kindred,750,382,368,50.93
Warwick,Orianna,675,366,309,54.22
Warwick,Zac,702,323,379,46.01
Warwick,RekSai,189,120,69,63.49
Warwick,Janna,511,258,253,50.49
Warwick,Quinn,670,312,358,46.57
Warwick,Elise,928,531,397,57.22
Warwick,Nautilus,1876,1028,848,54.8
Warwick,Lucian,1116,597,519,53.49
Warwick,Talon,1060,574,486,54.15
Warwick,Kennen,369,201,168,54.47
Warwick,Senna,1347,696,651,51.67
Warwick,Rakan,643,345,298,53.65
Warwick,Briar,1487,723,764,48.62
Warwick,Jayce,620,302,318,48.71
Warwick,Azir,592,323,269,54.56
Warwick,Aphelios,853,446,407,52.29
Warwick,TwistedFate,599,307,292,51.25
Warwick,Tristana,1859,1007,852,54.17
Warwick,Lillia,1029,552,477,53.64
Warwick,JarvanIV,934,466,468,49.89
Warwick,Annie,586,283,303,48.29
Warwick,Karthus,503,259,244,51.49
Warwick,KogMaw,574,263,311,45.82
Warwick,Corki,574,323,251,56.27
Warwick,Kled,295,157,138,53.22
Warwick,Camille,585,312,273,53.33
Warwick,Heimerdinger,899,433,466,48.16
Warwick,Lissandra,587,279,308,47.53
Warwick,Taliyah,371,178,193,47.98
Warwick,Shyvana,438,216,222,49.32
Warwick,Hecarim,593,320,273,53.96
Warwick,Skarner,371,237,134,63.88
Veigar,Garen,1996,988,1008,49.5
Veigar,Diana,2033,1004,1029,49.39
Veigar,Sylas,1452,740,712,50.96
Veigar,Kaisa,1628,864,764,53.07
Veigar,Pyke,961,498,463,51.82
Veigar,Illaoi,616,332,284,53.9
Veigar,Pantheon,1748,921,827,52.69
Veigar,Syndra,774,371,403,47.93
Veigar,Milio,664,333,331,50.15
Veigar,Gragas,596,314,282,52.68
Veigar,Zed,1288,564,724,43.79
Veigar,Caitlyn,3374,1713,1661,50.77
Veigar,Soraka,741,380,361,51.28
Veigar,Chogath,1549,730,819,47.13
Veigar,Kindred,550,272,278,49.45
Veigar,Katarina,1076,505,571,46.93
Veigar,Tristana,1273,693,580,54.44
Veigar,Neeko,554,296,258,53.43
Veigar,Nautilus,1277,681,596,53.33
Veigar,FiddleSticks,551,283,268,51.36
Veigar,Vladimir,737,384,353,52.1
Veigar,Jhin,2343,1161,1182,49.55
Veigar,Morgana,1716,830,886,48.37
Veigar,Mel,2367,1232,1135,52.05
Veigar,Ezreal,2368,1205,1163,50.89
Veigar,Teemo,1796,919,877,51.17
Veigar,Nasus,963,464,499,48.18
Veigar,MasterYi,1557,768,789,49.33
Veigar,Sett,1941,965,976,49.72
Veigar,Aurora,757,409,348,54.03
Veigar,Varus,1055,532,523,50.43
Veigar,Fiora,348,191,157,54.89
Veigar,Nocturne,1463,697,766,47.64
Veigar,Jinx,3577,1733,1844,48.45
Veigar,Trundle,708,364,344,51.41
Veigar,Shaco,1214,602,612,49.59
Veigar,Yasuo,2396,1273,1123,53.13
Veigar,Yorick,1428,680,748,47.62
Veigar,Volibear,1486,771,715,51.88
Veigar,LeeSin,1303,681,622,52.26
Veigar,Thresh,1345,725,620,53.9
Veigar,Kayn,1857,957,900,51.53
Veigar,Rammus,368,190,178,51.63
Veigar,Xerath,1105,550,555,49.77
Veigar,Vayne,1634,819,815,50.12
Veigar,Nami,1231,620,611,50.37
Veigar,Warwick,1870,886,984,47.38
Veigar,Kassadin,288,138,150,47.92
Veigar,Quinn,465,251,214,53.98
Veigar,Olaf,294,143,151,48.64
Veigar,Kennen,282,180,102,63.83
Veigar,Lux,3492,1735,1757,49.68
Veigar,Ashe,2458,1247,1211,50.73
Veigar,Leona,977,502,475,51.38
Veigar,Yone,2156,1146,1010,53.15
Veigar,Fizz,971,491,480,50.57
Veigar,Draven,666,367,299,55.11
Veigar,Rell,526,284,242,53.99
Veigar,Heimerdinger,614,326,288,53.09
Veigar,Lissandra,312,159,153,50.96
Veigar,TahmKench,1049,548,501,52.24
Veigar,DrMundo,728,359,369,49.31
Veigar,Irelia,888,520,368,58.56
Veigar,MissFortune,3253,1684,1569,51.77
Veigar,Camille,345,195,150,56.52
Veigar,Yuumi,914,496,418,54.27
Veigar,Udyr,511,290,221,56.75
Veigar,Zyra,1037,470,567,45.32
Veigar,Ahri,1672,895,777,53.53
Veigar,Malzahar,1367,672,695,49.16
Veigar,Blitzcrank,840,424,416,50.48
Veigar,Anivia,385,161,224,41.82
Veigar,Gwen,566,309,257,54.59
Veigar,Velkoz,819,418,401,51.04
Veigar,Tryndamere,759,366,393,48.22
Veigar,Annie,402,200,202,49.75
Veigar,Samira,841,469,372,55.77
Veigar,Seraphine,975,472,503,48.41
Veigar,XinZhao,708,318,390,44.92
Veigar,Khazix,548,282,266,51.46
Veigar,Viego,1663,848,815,50.99
Veigar,Smolder,775,431,344,55.61
Veigar,Renata,158,98,60,62.03
Veigar,Ekko,1195,654,541,54.73
Veigar,Sivir,676,364,312,53.85
Veigar,Brand,1025,502,523,48.98
Veigar,Amumu,1443,737,706,51.07
Veigar,Hwei,789,433,356,54.88
Veigar,Orianna,432,238,194,55.09
Veigar,Lucian,753,378,375,50.2
Veigar,Poppy,667,381,286,57.12
Veigar,Kayle,931,453,478,48.66
Veigar,Darius,2343,1228,1115,52.41
Veigar,Jax,1128,597,531,52.93
Veigar,Rumble,266,153,113,57.52
Veigar,Gangplank,495,250,245,50.51
Veigar,Taliyah,207,97,110,46.86
Veigar,Swain,1196,584,612,48.83
Veigar,Evelynn,513,262,251,51.07
Veigar,Corki,438,240,198,54.79
Veigar,Karthus,341,189,152,55.43
Veigar,Zeri,401,237,164,59.1
Veigar,Lulu,1391,714,677,51.33
Veigar,Urgot,650,374,276,57.54
Veigar,Karma,1099,539,560,49.04
Veigar,Talon,536,265,271,49.44
Veigar,Akali,1287,709,578,55.09
Veigar,Naafiri,449,266,183,59.24
Veigar,KSante,506,271,235,53.56
Veigar,Kalista,293,181,112,61.77
Veigar,Ryze,430,198,232,46.05
Veigar,Galio,903,454,449,50.28
Veigar,Twitch,938,427,511,45.52
Veigar,Braum,621,326,295,52.5
Veigar,Leblanc,627,297,330,47.37
Veigar,Ambessa,552,275,277,49.82
Veigar,Alistar,435,202,233,46.44
Veigar,Nunu,616,321,295,52.11
Veigar,Taric,244,136,108,55.74
Veigar,AurelionSol,549,250,299,45.54
Veigar,Riven,536,298,238,55.6
Veigar,Sion,907,470,437,51.82
Veigar,Shyvana,298,127,171,42.62
Veigar,Briar,902,426,476,47.23
Veigar,Senna,873,426,447,48.8
Veigar,Malphite,1157,629,528,54.36
Veigar,Maokai,539,260,279,48.24
Veigar,Renekton,548,264,284,48.18
Veigar,Vex,665,312,353,46.92
Veigar,MonkeyKing,807,388,419,48.08
Veigar,Vi,1061,539,522,50.8
Veigar,Zoe,446,217,229,48.65
Veigar,Bard,300,174,126,58
Veigar,Viktor,1028,524,504,50.97
Veigar,Xayah,506,271,235,53.56
Veigar,TwistedFate,403,213,190,52.85
Veigar,Mordekaiser,1675,807,868,48.18
Veigar,Ornn,445,254,191,57.08
Veigar,Hecarim,430,266,164,61.86
Veigar,Rengar,377,182,195,48.28
Veigar,Elise,689,328,361,47.61
Veigar,Rakan,418,235,183,56.22
Veigar,Aphelios,605,340,265,56.2
Veigar,Janna,356,196,160,55.06
Veigar,Sejuani,475,257,218,54.11
Veigar,Zac,477,212,265,44.44
Veigar,Zilean,349,177,172,50.72
Veigar,Nidalee,283,158,125,55.83
Veigar,Graves,692,336,356,48.55
Veigar,Jayce,422,218,204,51.66
Veigar,Aatrox,889,485,404,54.56
Veigar,Azir,314,171,143,54.46
Veigar,Sona,410,225,185,54.88
Veigar,Kled,215,99,116,46.05
Veigar,Belveth,239,135,104,56.49
Veigar,Skarner,257,141,116,54.86
Veigar,Ivern,116,70,46,60.34
Veigar,Singed,307,159,148,51.79
Veigar,Lillia,572,269,303,47.03
Veigar,Ziggs,441,218,223,49.43
Veigar,Shen,693,353,340,50.94
Veigar,Cassiopeia,370,186,184,50.27
Veigar,KogMaw,398,169,229,42.46
Veigar,Akshan,409,222,187,54.28
Veigar,Gnar,478,255,223,53.35
Veigar,JarvanIV,640,314,326,49.06
Veigar,Qiyana,293,126,167,43
Veigar,Nilah,358,161,197,44.97
Veigar,RekSai,129,87,42,67.44
Tristana,Garen,1841,871,970,47.31
Tristana,Diana,1838,868,970,47.23
Tristana,Sylas,1579,872,707,55.22
Tristana,Kaisa,1844,931,913,50.49
Tristana,Pyke,943,496,447,52.6
Tristana,Yorick,1298,554,744,42.68
Tristana,Rammus,371,173,198,46.63
Tristana,Yasuo,2343,1120,1223,47.8
Tristana,Caitlyn,3443,1620,1823,47.05
Tristana,Lulu,1487,761,726,51.18
Tristana,Gwen,640,307,333,47.97
Tristana,Skarner,274,155,119,56.57
Tristana,DrMundo,737,365,372,49.53
Tristana,Samira,796,343,453,43.09
Tristana,Malphite,1232,604,628,49.03
Tristana,Nocturne,1577,708,869,44.9
Tristana,Veigar,1273,580,693,45.56
Tristana,Jinx,3749,1837,1912,49
Tristana,Morgana,1466,751,715,51.23
Tristana,Sion,859,453,406,52.74
Tristana,Vi,1068,502,566,47
Tristana,Lucian,782,397,385,50.77
Tristana,Pantheon,1714,792,922,46.21
Tristana,Graves,703,322,381,45.8
Tristana,Malzahar,1301,589,712,45.27
Tristana,Lux,2983,1410,1573,47.27
Tristana,Singed,395,228,167,57.72
Tristana,Ahri,1551,792,759,51.06
Tristana,Jhin,2632,1380,1252,52.43
Tristana,Heimerdinger,506,225,281,44.47
Tristana,Kayn,1833,927,906,50.57
Tristana,Sivir,580,306,274,52.76
Tristana,Neeko,568,246,322,43.31
Tristana,Volibear,1387,628,759,45.28
Tristana,Sejuani,470,215,255,45.74
Tristana,Nautilus,1334,630,704,47.23
Tristana,Xerath,1063,502,561,47.22
Tristana,Vayne,1730,851,879,49.19
Tristana,Nami,1067,513,554,48.08
Tristana,Viktor,902,457,445,50.67
Tristana,Janna,374,170,204,45.45
Tristana,Kayle,865,436,429,50.4
Tristana,LeeSin,1630,864,766,53.01
Tristana,Karma,1405,702,703,49.96
Tristana,Darius,2293,1108,1185,48.32
Tristana,Yone,2088,1051,1037,50.34
Tristana,Ezreal,2803,1426,1377,50.87
Tristana,Milio,691,308,383,44.57
Tristana,Smolder,750,373,377,49.73
Tristana,MasterYi,1584,764,820,48.23
Tristana,Irelia,926,454,472,49.03
Tristana,MissFortune,3434,1619,1815,47.15
Tristana,Azir,390,167,223,42.82
Tristana,TahmKench,924,461,463,49.89
Tristana,Qiyana,314,194,120,61.78
Tristana,Katarina,894,459,435,51.34
Tristana,Sett,1838,839,999,45.65
Tristana,Aphelios,593,309,284,52.11
Tristana,Poppy,809,365,444,45.12
Tristana,Khazix,581,276,305,47.5
Tristana,Chogath,1470,692,778,47.07
Tristana,Evelynn,406,206,200,50.74
Tristana,Twitch,1083,567,516,52.35
Tristana,Ashe,2426,1292,1134,53.26
Tristana,Mordekaiser,1555,721,834,46.37
Tristana,Talon,649,335,314,51.62
Tristana,Leona,1025,502,523,48.98
Tristana,Syndra,728,323,405,44.37
Tristana,Amumu,1208,532,676,44.04
Tristana,Akshan,476,257,219,53.99
Tristana,Maokai,566,312,254,55.12
Tristana,Teemo,1512,706,806,46.69
Tristana,Swain,1181,584,597,49.45
Tristana,Ekko,1185,570,615,48.1
Tristana,Illaoi,622,344,278,55.31
Tristana,Tryndamere,683,339,344,49.63
Tristana,FiddleSticks,518,262,256,50.58
Tristana,Shaco,1136,531,605,46.74
Tristana,Mel,2367,1257,1110,53.11
Tristana,Braum,715,338,377,47.27
Tristana,Akali,1259,641,618,50.91
Tristana,JarvanIV,691,386,305,55.86
Tristana,Leblanc,629,300,329,47.69
Tristana,Xayah,547,285,262,52.1
Tristana,Yuumi,870,470,400,54.02
Tristana,Olaf,280,140,140,50
Tristana,Shen,776,368,408,47.42
Tristana,Taliyah,289,139,150,48.1
Tristana,Renekton,586,290,296,49.49
Tristana,Thresh,1502,727,775,48.4
Tristana,Gangplank,559,279,280,49.91
Tristana,Orianna,508,263,245,51.77
Tristana,Urgot,619,317,302,51.21
Tristana,Fiora,414,206,208,49.76
Tristana,Udyr,501,248,253,49.5
Tristana,Kassadin,242,119,123,49.17
Tristana,Aatrox,950,484,466,50.95
Tristana,Vex,668,319,349,47.75
Tristana,Hwei,733,357,376,48.7
Tristana,Nasus,783,411,372,52.49
Tristana,Senna,805,416,389,51.68
Tristana,Seraphine,908,488,420,53.74
Tristana,Jax,1195,591,604,49.46
Tristana,Naafiri,421,210,211,49.88
Tristana,Riven,533,311,222,58.35
Tristana,Galio,1023,444,579,43.4
Tristana,Anivia,440,193,247,43.86
Tristana,Briar,902,447,455,49.56
Tristana,Annie,369,199,170,53.93
Tristana,Sona,413,156,257,37.77
Tristana,Viego,1748,878,870,50.23
Tristana,MonkeyKing,858,378,480,44.06
Tristana,Blitzcrank,829,441,388,53.2
Tristana,Karthus,315,147,168,46.67
Tristana,Elise,739,383,356,51.83
Tristana,Quinn,503,232,271,46.12
Tristana,Zoe,467,254,213,54.39
Tristana,Velkoz,780,398,382,51.03
Tristana,Rakan,470,225,245,47.87
Tristana,Zed,1319,683,636,51.78
Tristana,Trundle,632,324,308,51.27
Tristana,TwistedFate,405,203,202,50.12
Tristana,Zyra,1105,529,576,47.87
Tristana,Nunu,669,340,329,50.82
Tristana,Fizz,642,354,288,55.14
Tristana,Alistar,459,246,213,53.59
Tristana,RekSai,124,67,57,54.03
Tristana,Vladimir,815,391,424,47.98
Tristana,Varus,1048,535,513,51.05
Tristana,Ivern,172,79,93,45.93
Tristana,Warwick,1859,852,1007,45.83
Tristana,Soraka,666,308,358,46.25
Tristana,Rengar,370,212,158,57.3
Tristana,Taric,261,127,134,48.66
Tristana,Gnar,448,211,237,47.1
Tristana,Kindred,490,234,256,47.76
Tristana,Rumble,329,178,151,54.1
Tristana,Ornn,497,242,255,48.69
Tristana,Draven,544,272,272,50
Tristana,Brand,877,436,441,49.71
Tristana,Gragas,576,306,270,53.13
Tristana,KSante,496,247,249,49.8
Tristana,Zac,441,194,247,43.99
Tristana,Jayce,482,248,234,51.45
Tristana,Kalista,284,156,128,54.93
Tristana,Rell,626,308,318,49.2
Tristana,Aurora,811,421,390,51.91
Tristana,Lillia,598,329,269,55.02
Tristana,Zilean,346,153,193,44.22
Tristana,Corki,592,310,282,52.36
Tristana,Ryze,427,191,236,44.73
Tristana,Renata,203,118,85,58.13
Tristana,Lissandra,385,178,207,46.23
Tristana,Ambessa,620,320,300,51.61
Tristana,KogMaw,371,191,180,51.48
Tristana,Nilah,354,164,190,46.33
Tristana,Ziggs,465,237,228,50.97
Tristana,Hecarim,497,242,255,48.69
Tristana,Zeri,405,174,231,42.96
Tristana,Camille,387,184,203,47.55
Tristana,Shyvana,286,131,155,45.8
Tristana,Nidalee,389,211,178,54.24
Tristana,Belveth,320,140,180,43.75
Tristana,AurelionSol,403,200,203,49.63
Tristana,Kennen,293,143,150,48.81
Tristana,XinZhao,774,409,365,52.84
Tristana,Cassiopeia,347,159,188,45.82
Tristana,Kled,197,88,109,44.67
Tristana,Bard,364,169,195,46.43
Riven,Malphite,605,280,325,46.28
Riven,Amumu,525,243,282,46.29
Riven,Ahri,681,316,365,46.4
Riven,Kaisa,909,449,460,49.39
Riven,Pyke,405,221,184,54.57
Riven,Jax,520,253,267,48.65
Riven,Shaco,487,234,253,48.05
Riven,Yone,979,558,421,57
Riven,KogMaw,200,99,101,49.5
Riven,Morgana,578,251,327,43.43
Riven,Nasus,319,159,160,49.84
Riven,MasterYi,626,321,305,51.28
Riven,Sylas,704,352,352,50
Riven,Neeko,228,119,109,52.19
Riven,Yorick,401,182,219,45.39
Riven,Udyr,231,108,123,46.75
Riven,Malzahar,559,248,311,44.36
Riven,Jhin,1095,573,522,52.33
Riven,TahmKench,372,203,169,54.57
Riven,Ivern,78,58,20,74.36
Riven,Yasuo,1200,641,559,53.42
Riven,Draven,415,198,217,47.71
Riven,Milio,367,188,179,51.23
Riven,Gwen,316,166,150,52.53
Riven,Ekko,580,302,278,52.07
Riven,Syndra,397,207,190,52.14
Riven,Pantheon,773,335,438,43.34
Riven,Renekton,451,213,238,47.23
Riven,Mordekaiser,717,334,383,46.58
Riven,Rell,308,151,157,49.03
Riven,Aatrox,400,175,225,43.75
Riven,Belveth,110,62,48,56.36
Riven,Jinx,1601,747,854,46.66
Riven,Lulu,841,431,410,51.25
Riven,Illaoi,243,115,128,47.33
Riven,Xerath,479,235,244,49.06
Riven,Ashe,986,487,499,49.39
Riven,Tryndamere,298,171,127,57.38
Riven,LeeSin,817,475,342,58.14
Riven,MissFortune,1108,530,578,47.83
Riven,Thresh,736,352,384,47.83
Riven,Camille,222,127,95,57.21
Riven,Darius,1094,589,505,53.84
Riven,Warwick,803,361,442,44.96
Riven,Mel,1053,596,457,56.6
Riven,Zyra,474,250,224,52.74
Riven,Gangplank,269,148,121,55.02
Riven,Evelynn,201,92,109,45.77
Riven,Orianna,271,142,129,52.4
Riven,Leona,398,182,216,45.73
Riven,Fiora,268,136,132,50.75
Riven,Kassadin,160,74,86,46.25
Riven,Lux,1107,517,590,46.7
Riven,Garen,942,461,481,48.94
Riven,Aurora,361,167,194,46.26
Riven,Swain,501,254,247,50.7
Riven,FiddleSticks,294,142,152,48.3
Riven,Zed,713,392,321,54.98
Riven,Caitlyn,1336,676,660,50.6
Riven,Karma,762,369,393,48.43
Riven,Gragas,306,159,147,51.96
Riven,Irelia,483,223,260,46.17
Riven,Sivir,327,154,173,47.09
Riven,Zilean,192,102,90,53.13
Riven,Sejuani,234,118,116,50.43
Riven,Azir,159,65,94,40.88
Riven,Naafiri,185,88,97,47.57
Riven,Tristana,533,222,311,41.65
Riven,Veigar,536,238,298,44.4
Riven,Ambessa,366,215,151,58.74
Riven,Kayn,795,387,408,48.68
Riven,Rakan,258,142,116,55.04
Riven,Katarina,488,239,249,48.98
Riven,Soraka,358,182,176,50.84
Riven,Nunu,254,132,122,51.97
Riven,Hwei,390,184,206,47.18
Riven,Ezreal,1358,722,636,53.17
Riven,Ryze,173,100,73,57.8
Riven,Taliyah,139,66,73,47.48
Riven,Nami,647,317,330,49
Riven,Teemo,600,278,322,46.33
Riven,Xayah,214,116,98,54.21
Riven,Senna,400,196,204,49
Riven,Corki,244,137,107,56.15
Riven,Quinn,195,96,99,49.23
Riven,Nilah,159,57,102,35.85
Riven,Fizz,316,142,174,44.94
Riven,Yuumi,448,245,203,54.69
Riven,Seraphine,349,171,178,49
Riven,Diana,803,376,427,46.82
Riven,Sion,379,188,191,49.6
Riven,Khazix,271,152,119,56.09
Riven,Vladimir,431,232,199,53.83
Riven,Vayne,772,419,353,54.27
Riven,Blitzcrank,418,245,173,58.61
Riven,Elise,430,211,219,49.07
Riven,Urgot,360,168,192,46.67
Riven,Karthus,175,104,71,59.43
Riven,JarvanIV,311,143,168,45.98
Riven,Leblanc,311,151,160,48.55
Riven,Sona,192,105,87,54.69
Riven,Trundle,289,122,167,42.21
Riven,Nocturne,628,290,338,46.18
Riven,Sett,794,364,430,45.84
Riven,Velkoz,346,165,181,47.69
Riven,Qiyana,183,95,88,51.91
Riven,AurelionSol,203,84,119,41.38
Riven,Viktor,490,267,223,54.49
Riven,Vi,495,226,269,45.66
Riven,KSante,284,146,138,51.41
Riven,Graves,325,174,151,53.54
Riven,Ornn,218,89,129,40.83
Riven,Viego,861,462,399,53.66
Riven,Kayle,360,176,184,48.89
Riven,TwistedFate,219,103,116,47.03
Riven,Nautilus,583,310,273,53.17
Riven,Briar,389,184,205,47.3
Riven,Braum,372,186,186,50
Riven,Varus,498,254,244,51
Riven,Nidalee,165,90,75,54.55
Riven,Akshan,170,80,90,47.06
Riven,Volibear,611,262,349,42.88
Riven,Ziggs,190,98,92,51.58
Riven,Heimerdinger,161,77,84,47.83
Riven,Twitch,465,235,230,50.54
Riven,Brand,352,165,187,46.88
Riven,Lillia,280,129,151,46.07
Riven,Galio,479,219,260,45.72
Riven,Poppy,361,169,192,46.81
Riven,Lucian,390,229,161,58.72
Riven,Vex,248,125,123,50.4
Riven,Jayce,283,136,147,48.06
Riven,Maokai,202,110,92,54.46
Riven,Chogath,568,261,307,45.95
Riven,Taric,158,81,77,51.27
Riven,Rumble,183,93,90,50.82
Riven,Olaf,78,34,44,43.59
Riven,Aphelios,326,141,185,43.25
Riven,Kennen,205,107,98,52.2
Riven,Anivia,177,94,83,53.11
Riven,Skarner,125,76,49,60.8
Riven,MonkeyKing,413,190,223,46
Riven,Janna,254,124,130,48.82
Riven,Talon,348,175,173,50.29
Riven,Zac,228,93,135,40.79
Riven,Rammus,205,80,125,39.02
Riven,Shyvana,134,76,58,56.72
Riven,Shen,397,216,181,54.41
Riven,Zoe,205,119,86,58.05
Riven,Samira,343,189,154,55.1
Riven,Kalista,126,68,58,53.97
Riven,Alistar,250,104,146,41.6
Riven,Lissandra,206,99,107,48.06
Riven,Hecarim,251,122,129,48.61
Riven,Smolder,309,170,139,55.02
Riven,DrMundo,241,107,134,44.4
Riven,Rengar,163,95,68,58.28
Riven,Renata,83,51,32,61.45
Riven,Akali,556,342,214,61.51
Riven,XinZhao,388,147,241,37.89
Riven,Singed,163,71,92,43.56
Riven,Kindred,260,139,121,53.46
Riven,Zeri,265,134,131,50.57
Riven,Gnar,181,104,77,57.46
Riven,Kled,88,21,67,23.86
Riven,Annie,189,112,77,59.26
Riven,Bard,199,98,101,49.25
Riven,Cassiopeia,136,77,59,56.62
Riven,RekSai,77,50,27,64.94
Sejuani,Malphite,432,217,215,50.23
Sejuani,Amumu,529,230,299,43.48
Sejuani,Ahri,670,333,337,49.7
Sejuani,Kaisa,799,398,401,49.81
Sejuani,Pyke,410,204,206,49.76
Sejuani,Teemo,522,277,245,53.07
Sejuani,FiddleSticks,244,120,124,49.18
Sejuani,Yone,770,388,382,50.39
Sejuani,Nilah,155,63,92,40.65
Sejuani,Rell,262,120,142,45.8
Sejuani,Gangplank,260,151,109,58.08
Sejuani,Evelynn,159,79,80,49.69
Sejuani,Mel,879,486,393,55.29
Sejuani,Ashe,925,454,471,49.08
Sejuani,Elise,337,171,166,50.74
Sejuani,Aatrox,458,188,270,41.05
Sejuani,Khazix,180,92,88,51.11
Sejuani,Fizz,305,161,144,52.79
Sejuani,Lux,1060,491,569,46.32
Sejuani,Neeko,172,87,85,50.58
Sejuani,Chogath,553,272,281,49.19
Sejuani,Anivia,175,110,65,62.86
Sejuani,Tristana,470,255,215,54.26
Sejuani,Zyra,427,210,217,49.18
Sejuani,Garen,664,302,362,45.48
Sejuani,MonkeyKing,355,142,213,40
Sejuani,Akshan,152,72,80,47.37
Sejuani,Swain,459,198,261,43.14
Sejuani,Singed,156,82,74,52.56
Sejuani,Kayn,674,303,371,44.96
Sejuani,Galio,359,171,188,47.63
Sejuani,Sivir,229,119,110,51.97
Sejuani,Thresh,702,377,325,53.7
Sejuani,Pantheon,755,371,384,49.14
Sejuani,Skarner,135,82,53,60.74
Sejuani,MissFortune,1096,522,574,47.63
Sejuani,Ezreal,1216,599,617,49.26
Sejuani,Volibear,541,237,304,43.81
Sejuani,Rengar,140,69,71,49.29
Sejuani,Malzahar,519,234,285,45.09
Sejuani,Diana,754,351,403,46.55
Sejuani,Syndra,271,124,147,45.76
Sejuani,TahmKench,336,167,169,49.7
Sejuani,Mordekaiser,600,232,368,38.67
Sejuani,LeeSin,923,471,452,51.03
Sejuani,Katarina,356,183,173,51.4
Sejuani,Darius,907,429,478,47.3
Sejuani,Yasuo,858,425,433,49.53
Sejuani,Jhin,1006,464,542,46.12
Sejuani,Velkoz,291,121,170,41.58
Sejuani,Nocturne,607,259,348,42.67
Sejuani,Aurora,398,228,170,57.29
Sejuani,Vayne,701,346,355,49.36
Sejuani,Karma,591,253,338,42.81
Sejuani,Poppy,293,139,154,47.44
Sejuani,Warwick,708,331,377,46.75
Sejuani,Irelia,421,208,213,49.41
Sejuani,Jinx,1317,644,673,48.9
Sejuani,TwistedFate,164,85,79,51.83
Sejuani,Ziggs,170,92,78,54.12
Sejuani,Janna,148,80,68,54.05
Sejuani,Heimerdinger,157,77,80,49.04
Sejuani,Rammus,157,74,83,47.13
Sejuani,Sylas,784,390,394,49.74
Sejuani,Morgana,628,305,323,48.57
Sejuani,Gwen,316,141,175,44.62
Sejuani,Briar,289,114,175,39.45
Sejuani,Xayah,243,134,109,55.14
Sejuani,Milio,322,154,168,47.83
Sejuani,Illaoi,201,109,92,54.23
Sejuani,Leblanc,295,147,148,49.83
Sejuani,Nautilus,583,337,246,57.8
Sejuani,Fiora,177,82,95,46.33
Sejuani,Trundle,284,124,160,43.66
Sejuani,Soraka,265,96,169,36.23
Sejuani,Yorick,484,253,231,52.27
Sejuani,Sett,707,329,378,46.53
Sejuani,Kennen,100,48,52,48
Sejuani,Sion,345,159,186,46.09
Sejuani,Twitch,332,163,169,49.1
Sejuani,KogMaw,179,102,77,56.98
Sejuani,Gnar,251,142,109,56.57
Sejuani,Jax,399,200,199,50.13
Sejuani,Shaco,401,198,203,49.38
Sejuani,Vladimir,382,163,219,42.67
Sejuani,Draven,238,112,126,47.06
Sejuani,Yuumi,406,228,178,56.16
Sejuani,Senna,321,152,169,47.35
Sejuani,Nunu,271,138,133,50.92
Sejuani,Aphelios,237,108,129,45.57
Sejuani,Urgot,243,104,139,42.8
Sejuani,Viego,609,327,282,53.69
Sejuani,Leona,385,183,202,47.53
Sejuani,Riven,234,116,118,49.57
Sejuani,Nami,398,208,190,52.26
Sejuani,Zac,260,138,122,53.08
Sejuani,Shen,312,157,155,50.32
Sejuani,Naafiri,132,53,79,40.15
Sejuani,Zed,519,266,253,51.25
Sejuani,Brand,389,181,208,46.53
Sejuani,JarvanIV,277,121,156,43.68
Sejuani,AurelionSol,183,83,100,45.36
Sejuani,Lulu,639,326,313,51.02
Sejuani,XinZhao,356,209,147,58.71
Sejuani,Renata,67,41,26,61.19
Sejuani,MasterYi,566,268,298,47.35
Sejuani,Caitlyn,1358,641,717,47.2
Sejuani,Vi,529,266,263,50.28
Sejuani,Bard,116,51,65,43.97
Sejuani,Annie,171,87,84,50.88
Sejuani,Belveth,87,40,47,45.98
Sejuani,Corki,202,81,121,40.1
Sejuani,Nasus,340,177,163,52.06
Sejuani,Lucian,318,168,150,52.83
Sejuani,Vex,295,137,158,46.44
Sejuani,Zilean,117,41,76,35.04
Sejuani,Orianna,238,121,117,50.84
Sejuani,Samira,313,149,164,47.6
Sejuani,Alistar,234,125,109,53.42
Sejuani,Tryndamere,294,149,145,50.68
Sejuani,Varus,395,231,164,58.48
Sejuani,Viktor,447,267,180,59.73
Sejuani,Hwei,377,205,172,54.38
Sejuani,Kindred,197,103,94,52.28
Sejuani,Jayce,226,122,104,53.98
Sejuani,Ryze,142,64,78,45.07
Sejuani,Gragas,236,112,124,47.46
Sejuani,Veigar,475,218,257,45.89
Sejuani,Cassiopeia,183,79,104,43.17
Sejuani,DrMundo,274,151,123,55.11
Sejuani,Graves,307,169,138,55.05
Sejuani,Olaf,113,55,58,48.67
Sejuani,Talon,296,165,131,55.74
Sejuani,Kled,92,57,35,61.96
Sejuani,Lillia,285,132,153,46.32
Sejuani,Renekton,295,172,123,58.31
Sejuani,Xerath,387,172,215,44.44
Sejuani,Kalista,102,62,40,60.78
Sejuani,Ekko,392,189,203,48.21
Sejuani,Azir,206,91,115,44.17
Sejuani,Zeri,219,114,105,52.05
Sejuani,Ornn,198,83,115,41.92
Sejuani,Rakan,193,87,106,45.08
Sejuani,Taliyah,140,61,79,43.57
Sejuani,Udyr,163,86,77,52.76
Sejuani,Shyvana,87,35,52,40.23
Sejuani,Braum,277,123,154,44.4
Sejuani,KSante,296,160,136,54.05
Sejuani,Maokai,233,96,137,41.2
Sejuani,Akali,461,236,225,51.19
Sejuani,Zoe,159,73,86,45.91
Sejuani,Taric,99,38,61,38.38
Sejuani,Lissandra,166,100,66,60.24
Sejuani,Ambessa,281,171,110,60.85
Sejuani,Nidalee,127,55,72,43.31
Sejuani,Quinn,152,76,76,50
Sejuani,Blitzcrank,331,197,134,59.52
Sejuani,Kayle,262,128,134,48.85
Sejuani,Karthus,116,44,72,37.93
Sejuani,Camille,181,91,90,50.28
Sejuani,RekSai,73,43,30,58.9
Sejuani,Smolder,301,103,198,34.22
Sejuani,Seraphine,351,175,176,49.86
Sejuani,Rumble,86,45,41,52.33
Sejuani,Sona,148,77,71,52.03
Sejuani,Qiyana,99,40,59,40.4
Sejuani,Hecarim,202,98,104,48.51
Sejuani,Ivern,55,28,27,50.91
Sejuani,Kassadin,77,44,33,57.14
Lucian,Malphite,910,469,441,51.54
Lucian,Amumu,795,386,409,48.55
Lucian,Ahri,1128,580,548,51.42
Lucian,Kaisa,1436,773,663,53.83
Lucian,Pyke,712,390,322,54.78
Lucian,Ornn,347,190,157,54.76
Lucian,Kayn,1193,616,577,51.63
Lucian,Yasuo,1596,753,843,47.18
Lucian,Caitlyn,2218,1077,1141,48.56
Lucian,Morgana,893,467,426,52.3
Lucian,Garen,1201,544,657,45.3
Lucian,Rengar,281,150,131,53.38
Lucian,Lissandra,309,139,170,44.98
Lucian,Tristana,782,385,397,49.23
Lucian,Zyra,831,395,436,47.53
Lucian,Darius,1569,791,778,50.41
Lucian,Kindred,325,175,150,53.85
Lucian,Yone,1483,796,687,53.67
Lucian,Samira,541,273,268,50.46
Lucian,Rell,410,217,193,52.93
Lucian,Yorick,801,337,464,42.07
Lucian,Elise,657,326,331,49.62
Lucian,Viktor,783,361,422,46.1
Lucian,Corki,356,177,179,49.72
Lucian,Milio,444,201,243,45.27
Lucian,TahmKench,669,310,359,46.34
Lucian,LeeSin,1410,638,772,45.25
Lucian,Hwei,497,232,265,46.68
Lucian,Karma,1121,537,584,47.9
Lucian,DrMundo,375,145,230,38.67
Lucian,Akali,883,445,438,50.4
Lucian,Nilah,253,75,178,29.64
Lucian,Shen,462,206,256,44.59
Lucian,Poppy,549,287,262,52.28
Lucian,Katarina,596,282,314,47.32
Lucian,Ezreal,2436,1213,1223,49.79
Lucian,Yuumi,697,348,349,49.93
Lucian,Pantheon,1256,552,704,43.95
Lucian,MonkeyKing,665,333,332,50.08
Lucian,Jhin,1816,892,924,49.12
Lucian,Lux,2059,977,1082,47.45
Lucian,Urgot,370,173,197,46.76
Lucian,Rammus,270,126,144,46.67
Lucian,Xerath,750,370,380,49.33
Lucian,Jinx,2509,1167,1342,46.51
Lucian,Lulu,1238,588,650,47.5
Lucian,Nocturne,1114,562,552,50.45
Lucian,KogMaw,233,108,125,46.35
Lucian,Braum,474,205,269,43.25
Lucian,KSante,457,257,200,56.24
Lucian,MasterYi,955,460,495,48.17
Lucian,Naafiri,231,94,137,40.69
Lucian,Twitch,639,330,309,51.64
Lucian,Swain,689,303,386,43.98
Lucian,Olaf,221,121,100,54.75
Lucian,Mel,1697,838,859,49.38
Lucian,Malzahar,819,420,399,51.28
Lucian,Viego,1198,561,637,46.83
Lucian,Illaoi,384,224,160,58.33
Lucian,Syndra,568,288,280,50.7
Lucian,Taliyah,226,107,119,47.35
Lucian,Leblanc,495,245,250,49.49
Lucian,Sona,246,102,144,41.46
Lucian,Renekton,409,202,207,49.39
Lucian,Karthus,289,146,143,50.52
Lucian,Fizz,489,227,262,46.42
Lucian,Vladimir,565,239,326,42.3
Lucian,Veigar,753,375,378,49.8
Lucian,Kayle,577,270,307,46.79
Lucian,Ekko,823,394,429,47.87
Lucian,Orianna,395,212,183,53.67
Lucian,Bard,260,107,153,41.15
Lucian,Fiora,291,120,171,41.24
Lucian,Aurora,599,276,323,46.08
Lucian,Vi,831,440,391,52.95
Lucian,Sett,1069,515,554,48.18
Lucian,Gangplank,443,210,233,47.4
Lucian,Senna,647,297,350,45.9
Lucian,Chogath,897,426,471,47.49
Lucian,Sion,637,281,356,44.11
Lucian,Ambessa,556,261,295,46.94
Lucian,Shyvana,199,113,86,56.78
Lucian,Zoe,286,122,164,42.66
Lucian,Ashe,1775,811,964,45.69
Lucian,Maokai,332,182,150,54.82
Lucian,Trundle,495,216,279,43.64
Lucian,Shaco,751,377,374,50.2
Lucian,Irelia,671,321,350,47.84
Lucian,Zeri,379,167,212,44.06
Lucian,Janna,308,147,161,47.73
Lucian,Udyr,368,213,155,57.88
Lucian,Aatrox,744,357,387,47.98
Lucian,Gnar,389,206,183,52.96
Lucian,FiddleSticks,415,206,209,49.64
Lucian,Vayne,1202,577,625,48
Lucian,Kalista,208,120,88,57.69
Lucian,Thresh,1050,486,564,46.29
Lucian,Camille,304,142,162,46.71
Lucian,Diana,1330,604,726,45.41
Lucian,Annie,280,124,156,44.29
Lucian,Blitzcrank,571,313,258,54.82
Lucian,Zed,1002,460,542,45.91
Lucian,Gragas,433,197,236,45.5
Lucian,Sivir,399,174,225,43.61
Lucian,Zilean,262,88,174,33.59
Lucian,Singed,253,106,147,41.9
Lucian,Nunu,344,164,180,47.67
Lucian,Nautilus,955,489,466,51.2
Lucian,JarvanIV,440,192,248,43.64
Lucian,MissFortune,1952,965,987,49.44
Lucian,Tryndamere,493,218,275,44.22
Lucian,Lillia,444,198,246,44.59
Lucian,Smolder,479,250,229,52.19
Lucian,Volibear,871,397,474,45.58
Lucian,Soraka,442,187,255,42.31
Lucian,Mordekaiser,1017,521,496,51.23
Lucian,Cassiopeia,225,93,132,41.33
Lucian,Xayah,398,225,173,56.53
Lucian,Teemo,963,485,478,50.36
Lucian,TwistedFate,308,138,170,44.81
Lucian,Talon,522,225,297,43.1
Lucian,Qiyana,206,104,102,50.49
Lucian,Gwen,400,216,184,54
Lucian,Warwick,1116,519,597,46.51
Lucian,Belveth,177,84,93,47.46
Lucian,Galio,630,302,328,47.94
Lucian,Nasus,512,248,264,48.44
Lucian,Brand,632,329,303,52.06
Lucian,Briar,496,218,278,43.95
Lucian,Velkoz,463,221,242,47.73
Lucian,Akshan,268,108,160,40.3
Lucian,Sejuani,318,150,168,47.17
Lucian,Kled,158,72,86,45.57
Lucian,Vex,386,173,213,44.82
Lucian,Ziggs,270,159,111,58.89
Lucian,Azir,279,114,165,40.86
Lucian,Jax,804,372,432,46.27
Lucian,Varus,696,363,333,52.16
Lucian,Draven,445,182,263,40.9
Lucian,Aphelios,362,159,203,43.92
Lucian,Heimerdinger,389,183,206,47.04
Lucian,Rakan,344,195,149,56.69
Lucian,Nidalee,233,128,105,54.94
Lucian,Zac,415,177,238,42.65
Lucian,Nami,824,387,437,46.97
Lucian,Hecarim,353,186,167,52.69
Lucian,Khazix,453,219,234,48.34
Lucian,Riven,390,161,229,41.28
Lucian,Anivia,300,142,158,47.33
Lucian,Sylas,1183,551,632,46.58
Lucian,AurelionSol,293,134,159,45.73
Lucian,Alistar,333,170,163,51.05
Lucian,Graves,640,304,336,47.5
Lucian,Rumble,240,101,139,42.08
Lucian,Kennen,213,104,109,48.83
Lucian,Leona,626,270,356,43.13
Lucian,Quinn,268,113,155,42.16
Lucian,Kassadin,205,106,99,51.71
Lucian,XinZhao,553,305,248,55.15
Lucian,Skarner,186,85,101,45.7
Lucian,Renata,128,67,61,52.34
Lucian,Seraphine,506,276,230,54.55
Lucian,Jayce,447,242,205,54.14
Lucian,Ryze,285,142,143,49.82
Lucian,Evelynn,270,141,129,52.22
Lucian,Ivern,86,45,41,52.33
Lucian,Taric,161,73,88,45.34
Lucian,Neeko,344,176,168,51.16
Lucian,RekSai,117,66,51,56.41
Soraka,Malphite,576,277,299,48.09
Soraka,Amumu,636,321,315,50.47
Soraka,Ahri,815,443,372,54.36
Soraka,Kaisa,1067,582,485,54.55
Soraka,Pyke,535,293,242,54.77
Soraka,Illaoi,291,156,135,53.61
Soraka,Pantheon,1016,568,448,55.91
Soraka,Syndra,455,234,221,51.43
Soraka,Milio,510,250,260,49.02
Soraka,Ambessa,397,210,187,52.9
Soraka,Ekko,704,340,364,48.3
Soraka,Yasuo,1195,585,610,48.95
Soraka,Veigar,741,361,380,48.72
Soraka,Darius,1152,569,583,49.39
Soraka,Volibear,839,454,385,54.11
Soraka,Ashe,1363,696,667,51.06
Soraka,Lulu,1037,512,525,49.37
Soraka,Shen,468,225,243,48.08
Soraka,Orianna,300,144,156,48
Soraka,Caitlyn,1612,845,767,52.42
Soraka,Sona,217,118,99,54.38
Soraka,Zed,724,378,346,52.21
Soraka,Jhin,1428,784,644,54.9
Soraka,Nautilus,723,403,320,55.74
Soraka,Nocturne,824,426,398,51.7
Soraka,Galio,551,292,259,52.99
Soraka,Morgana,724,376,348,51.93
Soraka,Yorick,701,337,364,48.07
Soraka,Lux,1676,878,798,52.39
Soraka,Jinx,1919,994,925,51.8
Soraka,Bard,236,138,98,58.47
Soraka,Akali,721,408,313,56.59
Soraka,JarvanIV,460,235,225,51.09
Soraka,Sivir,369,170,199,46.07
Soraka,Shaco,704,378,326,53.69
Soraka,Gragas,377,232,145,61.54
Soraka,Gangplank,343,198,145,57.73
Soraka,Hecarim,298,149,149,50
Soraka,Aurora,403,235,168,58.31
Soraka,Brand,473,262,211,55.39
Soraka,Camille,247,124,123,50.2
Soraka,Kayn,994,510,484,51.31
Soraka,Quinn,307,151,156,49.19
Soraka,Yuumi,543,291,252,53.59
Soraka,Gnar,256,133,123,51.95
Soraka,Poppy,350,201,149,57.43
Soraka,TwistedFate,227,113,114,49.78
Soraka,Karma,917,466,451,50.82
Soraka,Teemo,823,433,390,52.61
Soraka,Zyra,690,345,345,50
Soraka,Tryndamere,407,228,179,56.02
Soraka,Annie,223,99,124,44.39
Soraka,Samira,465,236,229,50.75
Soraka,Seraphine,473,217,256,45.88
Soraka,TahmKench,441,229,212,51.93
Soraka,Talon,373,227,146,60.86
Soraka,Irelia,582,267,315,45.88
Soraka,Ziggs,264,145,119,54.92
Soraka,Kayle,489,242,247,49.49
Soraka,LeeSin,932,501,431,53.76
Soraka,Sylas,861,463,398,53.77
Soraka,Taric,166,89,77,53.61
Soraka,Khazix,355,197,158,55.49
Soraka,Vex,307,142,165,46.25
Soraka,Jax,656,348,308,53.05
Soraka,Rammus,201,118,83,58.71
Soraka,Ryze,226,111,115,49.12
Soraka,Swain,686,339,347,49.42
Soraka,Aatrox,498,251,247,50.4
Soraka,Rakan,250,133,117,53.2
Soraka,AurelionSol,222,102,120,45.95
Soraka,Graves,374,204,170,54.55
Soraka,Zoe,257,120,137,46.69
Soraka,Anivia,224,100,124,44.64
Soraka,Leona,583,350,233,60.03
Soraka,Kennen,212,90,122,42.45
Soraka,Rengar,207,102,105,49.28
Soraka,Smolder,401,213,188,53.12
Soraka,Thresh,843,445,398,52.79
Soraka,Yone,1108,628,480,56.68
Soraka,Mel,1556,863,693,55.46
Soraka,Akshan,263,125,138,47.53
Soraka,Aphelios,375,211,164,56.27
Soraka,Xayah,307,161,146,52.44
Soraka,Velkoz,447,236,211,52.8
Soraka,MasterYi,762,357,405,46.85
Soraka,Corki,286,161,125,56.29
Soraka,Mordekaiser,856,429,427,50.12
Soraka,Nasus,490,227,263,46.33
Soraka,Warwick,1019,504,515,49.46
Soraka,Janna,232,108,124,46.55
Soraka,Diana,962,445,517,46.26
Soraka,Kalista,186,79,107,42.47
Soraka,Sejuani,265,169,96,63.77
Soraka,Nami,924,469,455,50.76
Soraka,MonkeyKing,479,253,226,52.82
Soraka,Neeko,269,151,118,56.13
Soraka,Draven,419,198,221,47.26
Soraka,Qiyana,137,79,58,57.66
Soraka,Ezreal,1455,793,662,54.5
Soraka,Vladimir,449,265,184,59.02
Soraka,Katarina,545,293,252,53.76
Soraka,Varus,569,311,258,54.66
Soraka,Sett,937,496,441,52.93
Soraka,FiddleSticks,329,156,173,47.42
Soraka,Malzahar,712,388,324,54.49
Soraka,Vayne,814,406,408,49.88
Soraka,Udyr,273,145,128,53.11
Soraka,Twitch,583,303,280,51.97
Soraka,MissFortune,1485,742,743,49.97
Soraka,Urgot,295,151,144,51.19
Soraka,Lillia,313,156,157,49.84
Soraka,Riven,358,176,182,49.16
Soraka,Gwen,326,178,148,54.6
Soraka,Lucian,442,255,187,57.69
Soraka,Maokai,239,122,117,51.05
Soraka,Viego,860,442,418,51.4
Soraka,RekSai,91,47,44,51.65
Soraka,DrMundo,320,183,137,57.19
Soraka,Fizz,351,178,173,50.71
Soraka,Chogath,800,378,422,47.25
Soraka,Leblanc,349,175,174,50.14
Soraka,Nidalee,142,76,66,53.52
Soraka,Hwei,396,170,226,42.93
Soraka,Alistar,262,111,151,42.37
Soraka,Trundle,408,183,225,44.85
Soraka,Belveth,211,116,95,54.98
Soraka,Rell,285,132,153,46.32
Soraka,Viktor,610,337,273,55.25
Soraka,Vi,574,323,251,56.27
Soraka,Zilean,226,97,129,42.92
Soraka,Tristana,666,358,308,53.75
Soraka,Blitzcrank,414,203,211,49.03
Soraka,XinZhao,396,240,156,60.61
Soraka,Zac,331,135,196,40.79
Soraka,Briar,552,288,264,52.17
Soraka,Zeri,274,173,101,63.14
Soraka,Olaf,132,65,67,49.24
Soraka,Ornn,254,149,105,58.66
Soraka,Taliyah,156,93,63,59.62
Soraka,Naafiri,215,115,100,53.49
Soraka,Azir,228,100,128,43.86
Soraka,Braum,328,167,161,50.91
Soraka,Kled,113,68,45,60.18
Soraka,Renekton,328,177,151,53.96
Soraka,Garen,1044,496,548,47.51
Soraka,Skarner,179,101,78,56.42
Soraka,Senna,530,265,265,50
Soraka,Rumble,161,67,94,41.61
Soraka,Evelynn,223,109,114,48.88
Soraka,Kassadin,137,74,63,54.01
Soraka,Sion,545,266,279,48.81
Soraka,Lissandra,225,100,125,44.44
Soraka,Xerath,575,345,230,60
Soraka,Fiora,259,114,145,44.02
Soraka,Heimerdinger,283,136,147,48.06
Soraka,Karthus,238,119,119,50
Soraka,Singed,179,79,100,44.13
Soraka,Shyvana,157,80,77,50.96
Soraka,Kindred,294,160,134,54.42
Soraka,Nunu,392,219,173,55.87
Soraka,Nilah,189,75,114,39.68
Soraka,KSante,337,192,145,56.97
Soraka,Cassiopeia,186,101,85,54.3
Soraka,Elise,444,223,221,50.23
Soraka,KogMaw,202,103,99,50.99
Soraka,Renata,109,47,62,43.12
Soraka,Ivern,78,28,50,35.9
Soraka,Jayce,334,162,172,48.5
Malphite,Riven,605,325,280,53.72
Malphite,Sejuani,432,215,217,49.77
Malphite,Sylas,2698,1244,1454,46.11
Malphite,Lucian,910,441,469,48.46
Malphite,Soraka,576,299,277,51.91
Malphite,Pantheon,2107,1101,1006,52.25
Malphite,Volibear,1219,608,611,49.88
Malphite,Zed,1907,1087,820,57
Malphite,Tristana,1232,628,604,50.97
Malphite,Yuumi,876,439,437,50.11
Malphite,Darius,2068,971,1097,46.95
Malphite,Khazix,542,289,253,53.32
Malphite,Aphelios,667,362,305,54.27
Malphite,Pyke,1047,576,471,55.01
Malphite,Teemo,2326,1101,1225,47.33
Malphite,Jax,1149,592,557,51.52
Malphite,Fizz,698,337,361,48.28
Malphite,Kaisa,1846,959,887,51.95
Malphite,Morgana,1605,767,838,47.79
Malphite,Tryndamere,948,502,446,52.95
Malphite,Kayn,1780,871,909,48.93
Malphite,Viktor,911,458,453,50.27
Malphite,Jhin,2391,1222,1169,51.11
Malphite,Ornn,531,280,251,52.73
Malphite,Warwick,1736,882,854,50.81
Malphite,Galio,1110,525,585,47.3
Malphite,Ezreal,2972,1421,1551,47.81
Malphite,Nami,1197,573,624,47.87
Malphite,Kayle,914,422,492,46.17
Malphite,Elise,761,389,372,51.12
Malphite,Swain,1209,547,662,45.24
Malphite,Kalista,310,148,162,47.74
Malphite,Karma,1365,621,744,45.49
Malphite,Trundle,752,367,385,48.8
Malphite,Vi,1102,576,526,52.27
Malphite,Sivir,666,349,317,52.4
Malphite,Velkoz,751,374,377,49.8
Malphite,TahmKench,893,426,467,47.7
Malphite,Ziggs,466,218,248,46.78
Malphite,Twitch,998,541,457,54.21
Malphite,Thresh,1593,768,825,48.21
Malphite,Gnar,680,340,340,50
Malphite,Poppy,629,312,317,49.6
Malphite,TwistedFate,344,183,161,53.2
Malphite,MissFortune,2939,1431,1508,48.69
Malphite,Ashe,2336,1178,1158,50.43
Malphite,Renekton,549,280,269,51
Malphite,Evelynn,393,193,200,49.11
Malphite,Samira,772,383,389,49.61
Malphite,Leona,1092,555,537,50.82
Malphite,Irelia,1050,555,495,52.86
Malphite,DrMundo,719,331,388,46.04
Malphite,Brand,889,410,479,46.12
Malphite,LeeSin,1768,928,840,52.49
Malphite,Jinx,3502,1704,1798,48.66
Malphite,Neeko,550,281,269,51.09
Malphite,FiddleSticks,566,272,294,48.06
Malphite,Ahri,1462,765,697,52.33
Malphite,Ryze,339,158,181,46.61
Malphite,Mordekaiser,1835,827,1008,45.07
Malphite,Yasuo,2711,1428,1283,52.67
Malphite,Lillia,675,342,333,50.67
Malphite,Qiyana,344,170,174,49.42
Malphite,Gangplank,539,282,257,52.32
Malphite,Yone,2486,1292,1194,51.97
Malphite,Seraphine,985,505,480,51.27
Malphite,Xerath,1167,577,590,49.44
Malphite,Lux,3201,1568,1633,48.98
Malphite,Rumble,314,166,148,52.87
Malphite,Kindred,537,300,237,55.87
Malphite,Akali,1151,587,564,51
Malphite,KSante,474,212,262,44.73
Malphite,Zilean,361,188,173,52.08
Malphite,Yorick,1156,556,600,48.1
Malphite,Rell,613,276,337,45.02
Malphite,Garen,1766,842,924,47.68
Malphite,Shen,652,303,349,46.47
Malphite,Nocturne,1600,704,896,44
Malphite,Xayah,651,283,368,43.47
Malphite,Rakan,497,236,261,47.48
Malphite,XinZhao,777,391,386,50.32
Malphite,Mel,2339,1221,1118,52.2
Malphite,Singed,295,144,151,48.81
Malphite,JarvanIV,720,354,366,49.17
Malphite,Nasus,959,455,504,47.45
Malphite,Nautilus,1422,767,655,53.94
Malphite,Heimerdinger,618,280,338,45.31
Malphite,Veigar,1157,528,629,45.64
Malphite,Caitlyn,3391,1710,1681,50.43
Malphite,Gwen,690,349,341,50.58
Malphite,MasterYi,1496,732,764,48.93
Malphite,Quinn,725,355,370,48.97
Malphite,RekSai,132,57,75,43.18
Malphite,Katarina,936,489,447,52.24
Malphite,Smolder,807,444,363,55.02
Malphite,Lulu,1585,879,706,55.46
Malphite,Vex,566,292,274,51.59
Malphite,Ekko,1047,477,570,45.56
Malphite,Kassadin,252,107,145,42.46
Malphite,Udyr,516,249,267,48.26
Malphite,Vayne,1978,1036,942,52.38
Malphite,Amumu,1222,546,676,44.68
Malphite,Shaco,1168,569,599,48.72
Malphite,Annie,401,185,216,46.13
Malphite,Leblanc,675,374,301,55.41
Malphite,Zeri,516,284,232,55.04
Malphite,Draven,656,324,332,49.39
Malphite,Camille,328,190,138,57.93
Malphite,Sett,1816,913,903,50.28
Malphite,Malzahar,1269,631,638,49.72
Malphite,Taliyah,271,135,136,49.82
Malphite,Maokai,533,230,303,43.15
Malphite,MonkeyKing,839,398,441,47.44
Malphite,Lissandra,420,208,212,49.52
Malphite,Milio,699,308,391,44.06
Malphite,Gragas,585,347,238,59.32
Malphite,Zoe,372,199,173,53.49
Malphite,Kennen,312,162,150,51.92
Malphite,Vladimir,667,316,351,47.38
Malphite,Urgot,620,302,318,48.71
Malphite,Fiora,338,217,121,64.2
Malphite,Hecarim,444,189,255,42.57
Malphite,Zyra,1145,574,571,50.13
Malphite,Diana,1812,872,940,48.12
Malphite,Chogath,1392,638,754,45.83
Malphite,Shyvana,321,150,171,46.73
Malphite,Rengar,391,213,178,54.48
Malphite,Varus,1110,592,518,53.33
Malphite,Jayce,656,317,339,48.32
Malphite,Orianna,428,203,225,47.43
Malphite,Ambessa,606,348,258,57.43
Malphite,Bard,327,148,179,45.26
Malphite,Taric,266,126,140,47.37
Malphite,Braum,634,324,310,51.1
Malphite,Naafiri,432,208,224,48.15
Malphite,Aurora,840,403,437,47.98
Malphite,Nidalee,363,179,184,49.31
Malphite,Briar,880,382,498,43.41
Malphite,Azir,373,175,198,46.92
Malphite,Rammus,371,188,183,50.67
Malphite,Sion,958,442,516,46.14
Malphite,Hwei,681,345,336,50.66
Malphite,KogMaw,359,196,163,54.6
Malphite,Viego,1726,886,840,51.33
Malphite,Sona,341,164,177,48.09
Malphite,Nunu,607,315,292,51.89
Malphite,Aatrox,1043,484,559,46.4
Malphite,Akshan,520,271,249,52.12
Malphite,Ivern,130,52,78,40
Malphite,Blitzcrank,749,359,390,47.93
Malphite,Karthus,333,177,156,53.15
Malphite,AurelionSol,459,194,265,42.27
Malphite,Zac,554,278,276,50.18
Malphite,Janna,334,155,179,46.41
Malphite,Skarner,257,141,116,54.86
Malphite,Syndra,697,371,326,53.23
Malphite,Graves,707,411,296,58.13
Malphite,Talon,714,327,387,45.8
Malphite,Alistar,461,217,244,47.07
Malphite,Senna,925,531,394,57.41
Malphite,Illaoi,582,292,290,50.17
Malphite,Anivia,277,147,130,53.07
Malphite,Nilah,406,197,209,48.52
Malphite,Kled,187,101,86,54.01
Malphite,Corki,432,205,227,47.45
Malphite,Renata,162,77,85,47.53
Malphite,Belveth,295,162,133,54.92
Malphite,Cassiopeia,274,137,137,50
Malphite,Olaf,234,84,150,35.9
Amumu,Riven,525,282,243,53.71
Amumu,Sejuani,529,299,230,56.52
Amumu,Sylas,1698,874,824,51.47
Amumu,Lucian,795,409,386,51.45
Amumu,Soraka,636,315,321,49.53
Amumu,Trundle,821,404,417,49.21
Amumu,Briar,949,529,420,55.74
Amumu,Katarina,923,516,407,55.9
Amumu,Jhin,2617,1279,1338,48.87
Amumu,Pyke,939,477,462,50.8
Amumu,Mordekaiser,1842,916,926,49.73
Amumu,Skarner,329,181,148,55.02
Amumu,Galio,1109,599,510,54.01
Amumu,MissFortune,2998,1580,1418,52.7
Amumu,Lux,3336,1700,1636,50.96
Amumu,Singed,299,152,147,50.84
Amumu,Viego,1814,945,869,52.09
Amumu,Zed,1273,688,585,54.05
Amumu,Zeri,412,206,206,50
Amumu,Milio,769,375,394,48.76
Amumu,Evelynn,439,240,199,54.67
Amumu,Yone,2263,1268,995,56.03
Amumu,Caitlyn,3625,1860,1765,51.31
Amumu,Nami,1196,629,567,52.59
Amumu,Sett,1971,921,1050,46.73
Amumu,Nasus,914,448,466,49.02
Amumu,Aurora,699,394,305,56.37
Amumu,Varus,997,550,447,55.17
Amumu,Mel,2513,1387,1126,55.19
Amumu,Yorick,1446,655,791,45.3
Amumu,Rengar,362,171,191,47.24
Amumu,Irelia,1018,548,470,53.83
Amumu,Ezreal,2711,1407,1304,51.9
Amumu,Nocturne,1764,939,825,53.23
Amumu,Xayah,594,314,280,52.86
Amumu,Karma,1318,668,650,50.68
Amumu,Vex,703,344,359,48.93
Amumu,Kayn,1988,996,992,50.1
Amumu,Darius,2340,1246,1094,53.25
Amumu,Janna,416,242,174,58.17
Amumu,Warwick,2257,1131,1126,50.11
Amumu,Hwei,744,348,396,46.77
Amumu,Seraphine,1033,501,532,48.5
Amumu,Pantheon,1872,1043,829,55.72
Amumu,Nunu,780,438,342,56.15
Amumu,Viktor,1008,510,498,50.6
Amumu,Sivir,657,323,334,49.16
Amumu,Morgana,1645,867,778,52.71
Amumu,Khazix,559,339,220,60.64
Amumu,Poppy,773,397,376,51.36
Amumu,Yasuo,2461,1320,1141,53.64
Amumu,Volibear,1689,835,854,49.44
Amumu,Ahri,1643,873,770,53.13
Amumu,Teemo,1806,933,873,51.66
Amumu,Yuumi,875,445,430,50.86
Amumu,Jax,1136,609,527,53.61
Amumu,Vi,1010,511,499,50.59
Amumu,Tristana,1208,676,532,55.96
Amumu,Thresh,1441,790,651,54.82
Amumu,DrMundo,727,358,369,49.24
Amumu,Twitch,1086,599,487,55.16
Amumu,Brand,1027,531,496,51.7
Amumu,Kayle,939,483,456,51.44
Amumu,Kaisa,1886,1039,847,55.09
Amumu,Swain,1261,633,628,50.2
Amumu,JarvanIV,752,388,364,51.6
Amumu,Zyra,1139,605,534,53.12
Amumu,Ambessa,667,360,307,53.97
Amumu,TwistedFate,452,252,200,55.75
Amumu,Ziggs,418,202,216,48.33
Amumu,Veigar,1443,706,737,48.93
Amumu,Orianna,483,250,233,51.76
Amumu,Diana,2204,1160,1044,52.63
Amumu,Ashe,2376,1236,1140,52.02
Amumu,Zoe,393,194,199,49.36
Amumu,Kennen,293,160,133,54.61
Amumu,TahmKench,1092,592,500,54.21
Amumu,Urgot,719,351,368,48.82
Amumu,Lulu,1228,640,588,52.12
Amumu,Akali,1292,693,599,53.64
Amumu,Garen,1999,1021,978,51.08
Amumu,Draven,680,384,296,56.47
Amumu,Blitzcrank,810,403,407,49.75
Amumu,Renekton,643,344,299,53.5
Amumu,Aphelios,644,308,336,47.83
Amumu,Rell,541,272,269,50.28
Amumu,Talon,651,372,279,57.14
Amumu,Jinx,3599,1845,1754,51.26
Amumu,Neeko,609,313,296,51.4
Amumu,Nautilus,1575,903,672,57.33
Amumu,Shaco,1174,640,534,54.51
Amumu,Ryze,361,183,178,50.69
Amumu,Leblanc,640,304,336,47.5
Amumu,Olaf,260,124,136,47.69
Amumu,Qiyana,296,161,135,54.39
Amumu,MasterYi,1717,870,847,50.67
Amumu,Rakan,490,270,220,55.1
Amumu,Lissandra,423,216,207,51.06
Amumu,Vayne,1529,782,747,51.14
Amumu,Heimerdinger,589,282,307,47.88
Amumu,Rammus,366,242,124,66.12
Amumu,Leona,1205,652,553,54.11
Amumu,Gnar,491,242,249,49.29
Amumu,Samira,918,505,413,55.01
Amumu,Taric,294,134,160,45.58
Amumu,Sion,983,561,422,57.07
Amumu,MonkeyKing,762,390,372,51.18
Amumu,Annie,401,214,187,53.37
Amumu,Fiora,422,202,220,47.87
Amumu,Azir,347,197,150,56.77
Amumu,Chogath,1669,815,854,48.83
Amumu,Malphite,1222,676,546,55.32
Amumu,Zilean,406,212,194,52.22
Amumu,Graves,631,325,306,51.51
Amumu,Taliyah,277,148,129,53.43
Amumu,Aatrox,870,459,411,52.76
Amumu,Kindred,597,330,267,55.28
Amumu,LeeSin,1511,780,731,51.62
Amumu,Malzahar,1357,712,645,52.47
Amumu,Shen,838,467,371,55.73
Amumu,Hecarim,512,269,243,52.54
Amumu,Camille,368,180,188,48.91
Amumu,Fizz,792,378,414,47.73
Amumu,Senna,955,492,463,51.52
Amumu,Ekko,1306,688,618,52.68
Amumu,Belveth,277,145,132,52.35
Amumu,Quinn,419,244,175,58.23
Amumu,KogMaw,408,200,208,49.02
Amumu,Udyr,472,245,227,51.91
Amumu,Kled,252,132,120,52.38
Amumu,AurelionSol,481,252,229,52.39
Amumu,Alistar,501,267,234,53.29
Amumu,Karthus,368,181,187,49.18
Amumu,Gangplank,446,254,192,56.95
Amumu,Sona,370,184,186,49.73
Amumu,Vladimir,778,449,329,57.71
Amumu,Kalista,271,167,104,61.62
Amumu,Ornn,418,196,222,46.89
Amumu,Braum,698,354,344,50.72
Amumu,FiddleSticks,632,284,348,44.94
Amumu,Xerath,1120,570,550,50.89
Amumu,Naafiri,417,227,190,54.44
Amumu,Nilah,422,225,197,53.32
Amumu,Shyvana,395,197,198,49.87
Amumu,Gragas,619,350,269,56.54
Amumu,Smolder,835,438,397,52.46
Amumu,Kassadin,261,150,111,57.47
Amumu,Cassiopeia,368,212,156,57.61
Amumu,Zac,569,270,299,47.45
Amumu,KSante,525,304,221,57.9
Amumu,Illaoi,630,335,295,53.17
Amumu,Jayce,497,255,242,51.31
Amumu,Lillia,743,323,420,43.47
Amumu,Velkoz,834,418,416,50.12
Amumu,Bard,345,182,163,52.75
Amumu,XinZhao,766,368,398,48.04
Amumu,Gwen,651,349,302,53.61
Amumu,Syndra,750,388,362,51.73
Amumu,Rumble,321,145,176,45.17
Amumu,Anivia,378,189,189,50
Amumu,Tryndamere,763,440,323,57.67
Amumu,Ivern,132,71,61,53.79
Amumu,Elise,744,384,360,51.61
Amumu,Maokai,534,267,267,50
Amumu,Nidalee,257,132,125,51.36
Amumu,Akshan,444,252,192,56.76
Amumu,Corki,432,245,187,56.71
Amumu,RekSai,133,78,55,58.65
Amumu,Renata,155,91,64,58.71
Ahri,Riven,681,365,316,53.6
Ahri,Sejuani,670,337,333,50.3
Ahri,Sylas,2628,1272,1356,48.4
Ahri,Lucian,1128,548,580,48.58
Ahri,Soraka,815,372,443,45.64
Ahri,Nasus,1110,537,573,48.38
Ahri,Nocturne,2016,923,1093,45.78
Ahri,Vladimir,1016,497,519,48.92
Ahri,Jhin,3162,1566,1596,49.53
Ahri,Seraphine,1214,594,620,48.93
Ahri,Sett,2336,1167,1169,49.96
Ahri,Lillia,886,434,452,48.98
Ahri,Leblanc,1100,551,549,50.09
Ahri,Jinx,4346,2040,2306,46.94
Ahri,Alistar,611,296,315,48.45
Ahri,Mordekaiser,2073,996,1077,48.05
Ahri,Skarner,388,215,173,55.41
Ahri,Galio,1577,811,766,51.43
Ahri,MissFortune,3873,1898,1975,49.01
Ahri,Lux,4229,2071,2158,48.97
Ahri,Yorick,1589,765,824,48.14
Ahri,JarvanIV,1022,499,523,48.83
Ahri,Mel,2317,1192,1125,51.45
Ahri,Chogath,1847,922,925,49.92
Ahri,Warwick,2310,1076,1234,46.58
Ahri,Tristana,1551,759,792,48.94
Ahri,Vayne,1804,880,924,48.78
Ahri,Thresh,1960,974,986,49.69
Ahri,Shen,962,457,505,47.51
Ahri,Caitlyn,4456,2174,2282,48.79
Ahri,Morgana,1859,933,926,50.19
Ahri,Jax,1425,696,729,48.84
Ahri,Syndra,1216,567,649,46.63
Ahri,Kaisa,2572,1358,1214,52.8
Ahri,Karma,2003,1026,977,51.22
Ahri,Poppy,906,399,507,44.04
Ahri,Evelynn,570,303,267,53.16
Ahri,Zed,1567,813,754,51.88
Ahri,Corki,598,301,297,50.33
Ahri,Elise,1029,509,520,49.47
Ahri,Renekton,777,419,358,53.93
Ahri,Teemo,1872,882,990,47.12
Ahri,Samira,958,448,510,46.76
Ahri,Leona,1313,663,650,50.5
Ahri,Aatrox,1420,700,720,49.3
Ahri,Vi,1515,756,759,49.9
Ahri,Veigar,1672,777,895,46.47
Ahri,Rell,722,332,390,45.98
Ahri,Briar,1151,553,598,48.05
Ahri,Maokai,709,337,372,47.53
Ahri,Amumu,1643,770,873,46.87
Ahri,Taliyah,446,249,197,55.83
Ahri,Xayah,673,309,364,45.91
Ahri,Braum,860,409,451,47.56
Ahri,Gangplank,780,379,401,48.59
Ahri,Yasuo,2783,1407,1376,50.56
Ahri,Gragas,775,371,404,47.87
Ahri,Kayn,2226,1111,1115,49.91
Ahri,Hwei,1100,547,553,49.73
Ahri,Milio,941,423,518,44.95
Ahri,KSante,774,405,369,52.33
Ahri,Katarina,1208,590,618,48.84
Ahri,Ashe,3270,1663,1607,50.86
Ahri,Yone,2980,1606,1374,53.89
Ahri,Nunu,745,353,392,47.38
Ahri,Irelia,1243,600,643,48.27
Ahri,Illaoi,746,368,378,49.33
Ahri,Xerath,1433,676,757,47.17
Ahri,Lulu,2041,1021,1020,50.02
Ahri,Graves,1005,460,545,45.77
Ahri,Brand,1204,530,674,44.02
Ahri,TahmKench,1165,574,591,49.27
Ahri,Heimerdinger,651,284,367,43.63
Ahri,LeeSin,2302,1202,1100,52.22
Ahri,Ezreal,3751,1903,1848,50.73
Ahri,Pyke,1198,567,631,47.33
Ahri,Diana,2549,1196,1353,46.92
Ahri,MasterYi,1815,906,909,49.92
Ahri,Garen,2395,1226,1169,51.19
Ahri,DrMundo,906,409,497,45.14
Ahri,AurelionSol,569,282,287,49.56
Ahri,Nami,1471,695,776,47.25
Ahri,Fiora,495,253,242,51.11
Ahri,Shaco,1492,656,836,43.97
Ahri,Swain,1693,791,902,46.72
Ahri,Velkoz,906,428,478,47.24
Ahri,Ekko,1507,730,777,48.44
Ahri,Darius,2880,1431,1449,49.69
Ahri,Zoe,654,304,350,46.48
Ahri,Anivia,448,236,212,52.68
Ahri,MonkeyKing,1044,504,540,48.28
Ahri,Kayle,1012,498,514,49.21
Ahri,Nautilus,1754,892,862,50.86
Ahri,Malphite,1462,697,765,47.67
Ahri,Ziggs,505,252,253,49.9
Ahri,Neeko,702,365,337,51.99
Ahri,Sona,514,240,274,46.69
Ahri,Jayce,858,443,415,51.63
Ahri,Zyra,1401,597,804,42.61
Ahri,Akshan,644,338,306,52.48
Ahri,Zilean,531,258,273,48.59
Ahri,Trundle,852,384,468,45.07
Ahri,Viktor,1237,650,587,52.55
Ahri,Yuumi,1090,552,538,50.64
Ahri,Quinn,506,252,254,49.8
Ahri,Akali,1673,804,869,48.06
Ahri,Sivir,888,420,468,47.3
Ahri,Aurora,1179,605,574,51.31
Ahri,Azir,589,328,261,55.69
Ahri,Blitzcrank,1178,677,501,57.47
Ahri,Urgot,765,331,434,43.27
Ahri,Hecarim,662,366,296,55.29
Ahri,Udyr,571,275,296,48.16
Ahri,Rumble,421,199,222,47.27
Ahri,FiddleSticks,636,335,301,52.67
Ahri,Pantheon,2406,1206,1200,50.12
Ahri,Rengar,479,242,237,50.52
Ahri,Senna,1242,556,686,44.77
Ahri,Taric,304,134,170,44.08
Ahri,Gnar,654,324,330,49.54
Ahri,Viego,2041,1055,986,51.69
Ahri,Kassadin,354,183,171,51.69
Ahri,Kennen,413,201,212,48.67
Ahri,Kled,245,136,109,55.51
Ahri,Rammus,465,238,227,51.18
Ahri,Shyvana,382,210,172,54.97
Ahri,Smolder,927,456,471,49.19
Ahri,Annie,567,295,272,52.03
Ahri,Draven,695,340,355,48.92
Ahri,Kindred,690,332,358,48.12
Ahri,Orianna,842,411,431,48.81
Ahri,Malzahar,1674,737,937,44.03
Ahri,Talon,899,482,417,53.62
Ahri,Bard,526,254,272,48.29
Ahri,Khazix,721,375,346,52.01
Ahri,Nilah,462,249,213,53.9
Ahri,Fizz,854,403,451,47.19
Ahri,Sion,1150,563,587,48.96
Ahri,Varus,1332,679,653,50.98
Ahri,Aphelios,794,411,383,51.76
Ahri,Naafiri,434,193,241,44.47
Ahri,Tryndamere,803,428,375,53.3
Ahri,Ornn,606,290,316,47.85
Ahri,Vex,953,466,487,48.9
Ahri,Qiyana,378,188,190,49.74
Ahri,Renata,239,127,112,53.14
Ahri,Ryze,532,237,295,44.55
Ahri,Belveth,323,138,185,42.72
Ahri,Rakan,618,309,309,50
Ahri,Janna,471,246,225,52.23
Ahri,Volibear,1684,811,873,48.16
Ahri,Ambessa,936,481,455,51.39
Ahri,Zeri,629,307,322,48.81
Ahri,Twitch,1189,621,568,52.23
Ahri,KogMaw,467,223,244,47.75
Ahri,Kalista,346,195,151,56.36
Ahri,XinZhao,1041,505,536,48.51
Ahri,Gwen,742,396,346,53.37
Ahri,Zac,701,359,342,51.21
Ahri,Olaf,340,170,170,50
Ahri,TwistedFate,603,327,276,54.23
Ahri,Cassiopeia,482,244,238,50.62
Ahri,Singed,335,147,188,43.88
Ahri,Camille,536,280,256,52.24
Ahri,Karthus,349,190,159,54.44
Ahri,Lissandra,524,259,265,49.43
Ahri,Nidalee,483,276,207,57.14
Ahri,Ivern,206,89,117,43.2
Ahri,RekSai,224,119,105,53.13
Vladimir,Sion,582,297,285,51.03
Vladimir,MasterYi,953,443,510,46.48
Vladimir,Annie,299,133,166,44.48
Vladimir,Ezreal,1922,998,924,51.93
Vladimir,Lux,1795,900,895,50.14
Vladimir,Poppy,514,268,246,52.14
Vladimir,Zac,434,204,230,47
Vladimir,Chogath,997,454,543,45.54
Vladimir,Xayah,374,197,177,52.67
Vladimir,Nami,879,400,479,45.51
Vladimir,Yorick,723,311,412,43.02
Vladimir,Ahri,1016,519,497,51.08
Vladimir,Morgana,801,396,405,49.44
Vladimir,Rumble,284,126,158,44.37
Vladimir,Kayn,1261,621,640,49.25
Vladimir,Akshan,294,172,122,58.5
Vladimir,Jhin,1762,881,881,50
Vladimir,Yuumi,632,282,350,44.62
Vladimir,Renekton,429,247,182,57.58
Vladimir,Evelynn,250,138,112,55.2
Vladimir,Lissandra,327,153,174,46.79
Vladimir,Corki,352,190,162,53.98
Vladimir,Rakan,397,188,209,47.36
Vladimir,Viktor,645,267,378,41.4
Vladimir,Nocturne,1014,464,550,45.76
Vladimir,Veigar,737,353,384,47.9
Vladimir,Brand,585,281,304,48.03
Vladimir,Shaco,750,363,387,48.4
Vladimir,Caitlyn,2219,1034,1185,46.6
Vladimir,Yasuo,1825,936,889,51.29
Vladimir,Zed,1019,502,517,49.26
Vladimir,Xerath,607,278,329,45.8
Vladimir,Illaoi,313,165,148,52.72
Vladimir,Briar,494,250,244,50.61
Vladimir,Katarina,760,430,330,56.58
Vladimir,Seraphine,557,296,261,53.14
Vladimir,Camille,295,171,124,57.97
Vladimir,Jinx,2427,1228,1199,50.6
Vladimir,Urgot,383,161,222,42.04
Vladimir,Rammus,253,112,141,44.27
Vladimir,Lulu,1264,667,597,52.77
Vladimir,Garen,1101,557,544,50.59
Vladimir,Nidalee,265,135,130,50.94
Vladimir,Akali,863,459,404,53.19
Vladimir,Olaf,209,117,92,55.98
Vladimir,Trundle,393,202,191,51.4
Vladimir,Vex,369,226,143,61.25
Vladimir,Talon,531,297,234,55.93
Vladimir,Diana,1320,617,703,46.74
Vladimir,Velkoz,497,252,245,50.7
Vladimir,Ambessa,454,245,209,53.96
Vladimir,Hecarim,374,206,168,55.08
Vladimir,Gragas,461,249,212,54.01
Vladimir,Fizz,543,294,249,54.14
Vladimir,Varus,624,319,305,51.12
Vladimir,Braum,525,251,274,47.81
Vladimir,Aatrox,623,313,310,50.24
Vladimir,Rengar,280,163,117,58.21
Vladimir,Neeko,327,177,150,54.13
Vladimir,Swain,815,421,394,51.66
Vladimir,Teemo,1026,501,525,48.83
Vladimir,Darius,1521,700,821,46.02
Vladimir,Sona,259,110,149,42.47
Vladimir,LeeSin,1212,632,580,52.15
Vladimir,Nautilus,845,430,415,50.89
Vladimir,Ashe,1547,738,809,47.71
Vladimir,Warwick,1012,466,546,46.05
Vladimir,Leona,680,324,356,47.65
Vladimir,Karma,1024,547,477,53.42
Vladimir,Shen,536,274,262,51.12
Vladimir,Zyra,814,377,437,46.31
Vladimir,Singed,225,109,116,48.44
Vladimir,MonkeyKing,583,302,281,51.8
Vladimir,Orianna,420,198,222,47.14
Vladimir,Draven,424,224,200,52.83
Vladimir,Pantheon,1322,620,702,46.9
Vladimir,Twitch,660,309,351,46.82
Vladimir,Galio,677,351,326,51.85
Vladimir,Yone,1560,763,797,48.91
Vladimir,Lucian,565,326,239,57.7
Vladimir,Volibear,869,411,458,47.3
Vladimir,Janna,300,151,149,50.33
Vladimir,Elise,628,331,297,52.71
Vladimir,Mel,1730,918,812,53.06
Vladimir,MissFortune,1593,797,796,50.03
Vladimir,Pyke,553,299,254,54.07
Vladimir,Sett,1048,510,538,48.66
Vladimir,Viego,1196,545,651,45.57
Vladimir,Malzahar,895,399,496,44.58
Vladimir,Lillia,393,186,207,47.33
Vladimir,Kaisa,1355,681,674,50.26
Vladimir,Gwen,489,266,223,54.4
Vladimir,JarvanIV,500,241,259,48.2
Vladimir,Ekko,774,359,415,46.38
Vladimir,Aphelios,434,205,229,47.24
Vladimir,Taric,191,90,101,47.12
Vladimir,Nasus,598,284,314,47.49
Vladimir,Irelia,746,365,381,48.93
Vladimir,Kennen,276,131,145,47.46
Vladimir,Thresh,1025,490,535,47.8
Vladimir,Leblanc,521,289,232,55.47
Vladimir,Milio,609,272,337,44.66
Vladimir,Senna,601,280,321,46.59
Vladimir,Vi,731,410,321,56.09
Vladimir,Sejuani,382,219,163,57.33
Vladimir,Sivir,456,195,261,42.76
Vladimir,Soraka,449,184,265,40.98
Vladimir,Heimerdinger,383,197,186,51.44
Vladimir,Qiyana,210,118,92,56.19
Vladimir,Kassadin,237,116,121,48.95
Vladimir,Kindred,362,184,178,50.83
Vladimir,Kayle,631,285,346,45.17
Vladimir,Jax,810,438,372,54.07
Vladimir,Udyr,290,154,136,53.1
Vladimir,Vayne,1228,591,637,48.13
Vladimir,Samira,501,245,256,48.9
Vladimir,Quinn,287,137,150,47.74
Vladimir,Bard,215,126,89,58.6
Vladimir,Smolder,438,209,229,47.72
Vladimir,RekSai,91,51,40,56.04
Vladimir,FiddleSticks,425,198,227,46.59
Vladimir,XinZhao,483,230,253,47.62
Vladimir,Blitzcrank,558,260,298,46.59
Vladimir,Ornn,317,139,178,43.85
Vladimir,Karthus,280,164,116,58.57
Vladimir,KSante,340,205,135,60.29
Vladimir,Renata,108,63,45,58.33
Vladimir,Sylas,1158,587,571,50.69
Vladimir,Gnar,331,162,169,48.94
Vladimir,Mordekaiser,1016,494,522,48.62
Vladimir,TahmKench,557,249,308,44.7
Vladimir,Ziggs,248,133,115,53.63
Vladimir,Riven,431,199,232,46.17
Vladimir,Zoe,305,138,167,45.25
Vladimir,Alistar,347,168,179,48.41
Vladimir,Khazix,435,210,225,48.28
Vladimir,DrMundo,467,227,240,48.61
Vladimir,Aurora,550,271,279,49.27
Vladimir,Graves,483,230,253,47.62
Vladimir,Tristana,815,424,391,52.02
Vladimir,Ryze,413,209,204,50.61
Vladimir,Zilean,259,116,143,44.79
Vladimir,Syndra,506,226,280,44.66
Vladimir,Hwei,471,229,242,48.62
Vladimir,Zeri,340,154,186,45.29
Vladimir,Malphite,667,351,316,52.62
Vladimir,Maokai,358,194,164,54.19
Vladimir,Skarner,204,108,96,52.94
Vladimir,Amumu,778,329,449,42.29
Vladimir,Jayce,419,210,209,50.12
Vladimir,Naafiri,248,129,119,52.02
Vladimir,TwistedFate,220,101,119,45.91
Vladimir,Gangplank,450,213,237,47.33
Vladimir,Azir,268,141,127,52.61
Vladimir,Fiora,296,161,135,54.39
Vladimir,AurelionSol,305,127,178,41.64
Vladimir,Shyvana,232,130,102,56.03
Vladimir,Nunu,375,198,177,52.8
Vladimir,Ivern,91,26,65,28.57
Vladimir,Tryndamere,415,177,238,42.65
Vladimir,Anivia,254,120,134,47.24
Vladimir,Rell,366,162,204,44.26
Vladimir,Cassiopeia,256,120,136,46.88
Vladimir,Belveth,172,97,75,56.4
Vladimir,Nilah,235,89,146,37.87
Vladimir,Kalista,181,87,94,48.07
Vladimir,Taliyah,161,83,78,51.55
Vladimir,Kled,162,82,80,50.62
Vladimir,KogMaw,264,139,125,52.65
Rammus,Sion,252,100,152,39.68
Rammus,MasterYi,1310,748,562,57.1
Rammus,Annie,104,56,48,53.85
Rammus,Ezreal,826,416,410,50.36
Rammus,Lux,906,470,436,51.88
Rammus,Warwick,665,329,336,49.47
Rammus,Vi,311,154,157,49.52
Rammus,Irelia,398,213,185,53.52
Rammus,Caitlyn,1003,564,439,56.23
Rammus,Nautilus,444,255,189,57.43
Rammus,Tryndamere,278,133,145,47.84
Rammus,Lillia,282,141,141,50
Rammus,Viktor,324,177,147,54.63
Rammus,Tristana,371,198,173,53.37
Rammus,Senna,252,137,115,54.37
Rammus,Yorick,373,184,189,49.33
Rammus,Kindred,150,70,80,46.67
Rammus,Veigar,368,178,190,48.37
Rammus,Darius,683,344,339,50.37
Rammus,Mel,644,334,310,51.86
Rammus,Jinx,1184,573,611,48.4
Rammus,Thresh,510,258,252,50.59
Rammus,Gangplank,159,75,84,47.17
Rammus,Hecarim,141,78,63,55.32
Rammus,Aurora,191,100,91,52.36
Rammus,Jhin,741,354,387,47.77
Rammus,Brand,273,123,150,45.05
Rammus,Lissandra,131,55,76,41.98
Rammus,Volibear,404,204,200,50.5
Rammus,Vladimir,253,141,112,55.73
Rammus,Lucian,270,144,126,53.33
Rammus,Nami,345,176,169,51.01
Rammus,Elise,217,118,99,54.38
Rammus,Anivia,138,76,62,55.07
Rammus,Swain,321,147,174,45.79
Rammus,Pyke,323,183,140,56.66
Rammus,Camille,102,68,34,66.67
Rammus,Kayn,506,252,254,49.8
Rammus,Quinn,129,71,58,55.04
Rammus,Yuumi,328,184,144,56.1
Rammus,Sett,535,271,264,50.65
Rammus,Katarina,317,187,130,58.99
Rammus,Aphelios,176,88,88,50
Rammus,Poppy,225,104,121,46.22
Rammus,Ambessa,174,103,71,59.2
Rammus,LeeSin,525,292,233,55.62
Rammus,Varus,328,141,187,42.99
Rammus,Xerath,312,130,182,41.67
Rammus,Malzahar,376,180,196,47.87
Rammus,Draven,197,92,105,46.7
Rammus,Rakan,155,65,90,41.94
Rammus,Illaoi,220,91,129,41.36
Rammus,Shaco,268,119,149,44.4
Rammus,Pantheon,617,317,300,51.38
Rammus,Diana,574,257,317,44.77
Rammus,Smolder,236,131,105,55.51
Rammus,Leona,366,196,170,53.55
Rammus,Kennen,79,49,30,62.03
Rammus,Talon,215,118,97,54.88
Rammus,Soraka,201,83,118,41.29
Rammus,Velkoz,200,81,119,40.5
Rammus,Nocturne,507,232,275,45.76
Rammus,Seraphine,250,99,151,39.6
Rammus,Sejuani,157,83,74,52.87
Rammus,Yone,849,470,379,55.36
Rammus,Yasuo,930,501,429,53.87
Rammus,Zac,125,59,66,47.2
Rammus,Mordekaiser,480,191,289,39.79
Rammus,Naafiri,114,60,54,52.63
Rammus,Garen,600,301,299,50.17
Rammus,MissFortune,868,414,454,47.7
Rammus,Morgana,480,242,238,50.42
Rammus,Syndra,211,113,98,53.55
Rammus,Xayah,149,68,81,45.64
Rammus,Milio,198,94,104,47.47
Rammus,Zyra,299,162,137,54.18
Rammus,Amumu,366,124,242,33.88
Rammus,Zed,503,279,224,55.47
Rammus,Gwen,194,82,112,42.27
Rammus,Ashe,817,418,399,51.16
Rammus,Blitzcrank,262,146,116,55.73
Rammus,RekSai,44,20,24,45.45
Rammus,Gragas,186,87,99,46.77
Rammus,Sylas,474,250,224,52.74
Rammus,Ekko,319,137,182,42.95
Rammus,Renekton,169,91,78,53.85
Rammus,Shen,248,119,129,47.98
Rammus,Neeko,180,100,80,55.56
Rammus,Twitch,295,144,151,48.81
Rammus,Briar,362,196,166,54.14
Rammus,Ahri,465,227,238,48.82
Rammus,DrMundo,197,83,114,42.13
Rammus,Rumble,103,44,59,42.72
Rammus,Galio,350,168,182,48
Rammus,Sona,101,57,44,56.44
Rammus,Fiora,142,62,80,43.66
Rammus,Ziggs,126,63,63,50
Rammus,Vayne,565,285,280,50.44
Rammus,Lulu,506,266,240,52.57
Rammus,TahmKench,237,123,114,51.9
Rammus,Karma,353,162,191,45.89
Rammus,Teemo,466,235,231,50.43
Rammus,Zeri,101,49,52,48.51
Rammus,Karthus,104,51,53,49.04
Rammus,Samira,290,167,123,57.59
Rammus,Kled,49,26,23,53.06
Rammus,Fizz,240,131,109,54.58
Rammus,Trundle,292,155,137,53.08
Rammus,Hwei,185,96,89,51.89
Rammus,Taliyah,86,42,44,48.84
Rammus,Rell,166,77,89,46.39
Rammus,FiddleSticks,166,66,100,39.76
Rammus,Jax,323,188,135,58.2
Rammus,Kaisa,578,300,278,51.9
Rammus,Nasus,230,127,103,55.22
Rammus,Orianna,138,63,75,45.65
Rammus,AurelionSol,121,51,70,42.15
Rammus,MonkeyKing,216,87,129,40.28
Rammus,Rengar,112,71,41,63.39
Rammus,TwistedFate,101,51,50,50.5
Rammus,Taric,70,26,44,37.14
Rammus,KSante,185,104,81,56.22
Rammus,XinZhao,239,111,128,46.44
Rammus,Malphite,371,183,188,49.33
Rammus,Chogath,441,185,256,41.95
Rammus,Sivir,170,85,85,50
Rammus,Ornn,93,40,53,43.01
Rammus,Aatrox,341,207,134,60.7
Rammus,Singed,114,56,58,49.12
Rammus,Riven,205,125,80,60.98
Rammus,Jayce,119,89,30,74.79
Rammus,Azir,125,81,44,64.8
Rammus,Cassiopeia,102,37,65,36.27
Rammus,Viego,605,319,286,52.73
Rammus,Kalista,110,75,35,68.18
Rammus,Graves,205,102,103,49.76
Rammus,Gnar,116,56,60,48.28
Rammus,Kayle,288,150,138,52.08
Rammus,Urgot,213,111,102,52.11
Rammus,Qiyana,64,41,23,64.06
Rammus,Renata,57,33,24,57.89
Rammus,Khazix,165,92,73,55.76
Rammus,Janna,158,61,97,38.61
Rammus,Braum,248,127,121,51.21
Rammus,Alistar,161,90,71,55.9
Rammus,Akali,398,191,207,47.99
Rammus,Leblanc,186,88,98,47.31
Rammus,Ryze,152,81,71,53.29
Rammus,Nidalee,72,43,29,59.72
Rammus,Evelynn,87,39,48,44.83
Rammus,Heimerdinger,184,96,88,52.17
Rammus,Maokai,163,74,89,45.4
Rammus,Zilean,70,31,39,44.29
Rammus,JarvanIV,147,88,59,59.86
Rammus,Akshan,127,54,73,42.52
Rammus,Corki,117,62,55,52.99
Rammus,Bard,90,58,32,64.44
Rammus,Udyr,94,44,50,46.81
Rammus,Vex,170,78,92,45.88
Rammus,Kassadin,99,43,56,43.43
Rammus,KogMaw,113,58,55,51.33
Rammus,Nilah,112,66,46,58.93
Rammus,Ivern,35,20,15,57.14
Rammus,Belveth,95,56,39,58.95
Rammus,Nunu,150,52,98,34.67
Rammus,Olaf,74,35,39,47.3
Rammus,Skarner,55,38,17,69.09
Rammus,Zoe,136,76,60,55.88
Rammus,Shyvana,53,32,21,60.38
Katarina,Sion,643,334,309,51.94
Katarina,MasterYi,1112,542,570,48.74
Katarina,Annie,321,189,132,58.88
Katarina,Ezreal,2010,1040,970,51.74
Katarina,Lux,2330,1144,1186,49.1
Katarina,Darius,1675,818,857,48.84
Katarina,Viego,1459,738,721,50.58
Katarina,Viktor,662,325,337,49.09
Katarina,Draven,503,239,264,47.51
Katarina,Leona,779,385,394,49.42
Katarina,Warwick,1369,579,790,42.29
Katarina,Khazix,439,232,207,52.85
Katarina,Yorick,874,428,446,48.97
Katarina,Vayne,1105,463,642,41.9
Katarina,Lulu,1319,642,677,48.67
Katarina,Gangplank,435,239,196,54.94
Katarina,Evelynn,328,149,179,45.43
Katarina,Mel,2052,1121,931,54.63
Katarina,Ashe,1938,933,1005,48.14
Katarina,Elise,609,295,314,48.44
Katarina,Amumu,923,407,516,44.1
Katarina,Aurora,600,339,261,56.5
Katarina,Seraphine,667,321,346,48.13
Katarina,Renekton,496,236,260,47.58
Katarina,Diana,1522,735,787,48.29
Katarina,Azir,253,130,123,51.38
Katarina,MissFortune,2068,972,1096,47
Katarina,Yuumi,693,380,313,54.83
Katarina,Gwen,476,257,219,53.99
Katarina,Nocturne,1099,501,598,45.59
Katarina,Veigar,1076,571,505,53.07
Katarina,Jinx,2553,1230,1323,48.18
Katarina,Morgana,1075,538,537,50.05
Katarina,Yasuo,1809,857,952,47.37
Katarina,Kayn,1297,691,606,53.28
Katarina,Xayah,456,214,242,46.93
Katarina,Rakan,390,189,201,48.46
Katarina,Ambessa,597,330,267,55.28
Katarina,Graves,567,319,248,56.26
Katarina,Akali,1023,486,537,47.51
Katarina,Anivia,332,132,200,39.76
Katarina,Jax,812,420,392,51.72
Katarina,Shaco,955,468,487,49.01
Katarina,Yone,1711,916,795,53.54
Katarina,KogMaw,292,110,182,37.67
Katarina,Shyvana,222,106,116,47.75
Katarina,Varus,910,469,441,51.54
Katarina,Mordekaiser,1125,534,591,47.47
Katarina,Vi,870,441,429,50.69
Katarina,Vex,479,239,240,49.9
Katarina,Xerath,747,362,385,48.46
Katarina,Karma,1154,599,555,51.91
Katarina,Teemo,1037,509,528,49.08
Katarina,Volibear,1076,515,561,47.86
Katarina,Vladimir,760,330,430,43.42
Katarina,JarvanIV,501,221,280,44.11
Katarina,Sivir,432,235,197,54.4
Katarina,Quinn,375,194,181,51.73
Katarina,Zac,429,180,249,41.96
Katarina,Brand,664,316,348,47.59
Katarina,Pantheon,1447,674,773,46.58
Katarina,MonkeyKing,644,306,338,47.52
Katarina,Kassadin,221,114,107,51.58
Katarina,Lucian,596,314,282,52.68
Katarina,Nami,1023,454,569,44.38
Katarina,Irelia,767,393,374,51.24
Katarina,Briar,709,328,381,46.26
Katarina,Pyke,744,402,342,54.03
Katarina,Kayle,635,308,327,48.5
Katarina,Malzahar,853,398,455,46.66
Katarina,TahmKench,655,365,290,55.73
Katarina,Camille,301,149,152,49.5
Katarina,Ekko,868,421,447,48.5
Katarina,Tristana,894,435,459,48.66
Katarina,Thresh,1224,631,593,51.55
Katarina,Garen,1455,721,734,49.55
Katarina,Udyr,288,139,149,48.26
Katarina,Jhin,1953,985,968,50.44
Katarina,Zyra,838,386,452,46.06
Katarina,Rammus,317,130,187,41.01
Katarina,Zed,1131,582,549,51.46
Katarina,Sylas,1204,600,604,49.83
Katarina,Swain,877,438,439,49.94
Katarina,Zilean,292,130,162,44.52
Katarina,KSante,409,199,210,48.66
Katarina,Trundle,525,253,272,48.19
Katarina,Sejuani,356,173,183,48.6
Katarina,Nautilus,938,466,472,49.68
Katarina,Ahri,1208,618,590,51.16
Katarina,Caitlyn,2552,1300,1252,50.94
Katarina,Poppy,498,247,251,49.6
Katarina,Fizz,533,258,275,48.41
Katarina,Orianna,377,215,162,57.03
Katarina,Belveth,254,144,110,56.69
Katarina,Qiyana,289,171,118,59.17
Katarina,Corki,430,215,215,50
Katarina,Sett,1355,647,708,47.75
Katarina,Rengar,307,181,126,58.96
Katarina,Zoe,351,176,175,50.14
Katarina,Kennen,199,79,120,39.7
Katarina,Singed,254,105,149,41.34
Katarina,Talon,580,324,256,55.86
Katarina,Samira,639,316,323,49.45
Katarina,Akshan,292,131,161,44.86
Katarina,Gragas,549,264,285,48.09
Katarina,Janna,377,197,180,52.25
Katarina,Milio,610,272,338,44.59
Katarina,Ziggs,320,143,177,44.69
Katarina,Heimerdinger,442,190,252,42.99
Katarina,DrMundo,534,263,271,49.25
Katarina,Twitch,748,400,348,53.48
Katarina,Kled,136,61,75,44.85
Katarina,Zeri,352,194,158,55.11
Katarina,Renata,151,79,72,52.32
Katarina,Jayce,462,236,226,51.08
Katarina,Soraka,545,252,293,46.24
Katarina,TwistedFate,302,123,179,40.73
Katarina,Kaisa,1463,786,677,53.73
Katarina,Urgot,447,189,258,42.28
Katarina,Lillia,473,231,242,48.84
Katarina,Riven,488,249,239,51.02
Katarina,RekSai,122,68,54,55.74
Katarina,Fiora,322,180,142,55.9
Katarina,Syndra,621,322,299,51.85
Katarina,Shen,541,243,298,44.92
Katarina,Olaf,183,94,89,51.37
Katarina,LeeSin,1309,738,571,56.38
Katarina,Malphite,936,447,489,47.76
Katarina,AurelionSol,379,209,170,55.15
Katarina,Smolder,530,265,265,50
Katarina,Alistar,376,184,192,48.94
Katarina,Bard,248,135,113,54.44
Katarina,Chogath,1075,453,622,42.14
Katarina,Rumble,255,135,120,52.94
Katarina,Kalista,226,123,103,54.42
Katarina,Senna,574,302,272,52.61
Katarina,Illaoi,439,218,221,49.66
Katarina,Nasus,606,279,327,46.04
Katarina,Nunu,437,252,185,57.67
Katarina,Hwei,639,300,339,46.95
Katarina,Tryndamere,547,257,290,46.98
Katarina,Cassiopeia,268,124,144,46.27
Katarina,Gnar,319,156,163,48.9
Katarina,Nidalee,244,144,100,59.02
Katarina,Ornn,320,197,123,61.56
Katarina,Sona,264,117,147,44.32
Katarina,Naafiri,276,113,163,40.94
Katarina,Taliyah,183,86,97,46.99
Katarina,Hecarim,398,190,208,47.74
Katarina,Blitzcrank,596,300,296,50.34
Katarina,Leblanc,516,254,262,49.22
Katarina,Velkoz,564,282,282,50
Katarina,Maokai,357,185,172,51.82
Katarina,Rell,411,187,224,45.5
Katarina,Aphelios,512,258,254,50.39
Katarina,Aatrox,837,429,408,51.25
Katarina,XinZhao,608,310,298,50.99
Katarina,Galio,914,400,514,43.76
Katarina,Lissandra,377,205,172,54.38
Katarina,Karthus,287,131,156,45.64
Katarina,Neeko,383,202,181,52.74
Katarina,Kindred,362,166,196,45.86
Katarina,Ivern,143,73,70,51.05
Katarina,FiddleSticks,435,199,236,45.75
Katarina,Skarner,211,117,94,55.45
Katarina,Nilah,307,150,157,48.86
Katarina,Braum,555,272,283,49.01
Katarina,Taric,187,109,78,58.29
Katarina,Ryze,275,116,159,42.18
Draven,Sion,479,226,253,47.18
Draven,MasterYi,707,346,361,48.94
Draven,Annie,213,102,111,47.89
Draven,Ezreal,1347,648,699,48.11
Draven,Lux,1540,764,776,49.61
Draven,Pantheon,852,455,397,53.4
Draven,Belveth,160,80,80,50
Draven,Katarina,503,264,239,52.49
Draven,KogMaw,199,115,84,57.79
Draven,Ambessa,316,190,126,60.13
Draven,Graves,402,224,178,55.72
Draven,Akali,525,269,256,51.24
Draven,Anivia,199,92,107,46.23
Draven,Leona,544,252,292,46.32
Draven,Garen,848,420,428,49.53
Draven,Diana,920,454,466,49.35
Draven,Varus,594,317,277,53.37
Draven,Shaco,609,329,280,54.02
Draven,Trundle,327,135,192,41.28
Draven,Veigar,666,299,367,44.89
Draven,Caitlyn,1723,830,893,48.17
Draven,Mel,1274,642,632,50.39
Draven,Udyr,255,122,133,47.84
Draven,FiddleSticks,251,122,129,48.61
Draven,Kennen,133,60,73,45.11
Draven,Nilah,167,70,97,41.92
Draven,Taric,154,68,86,44.16
Draven,Riven,415,217,198,52.29
Draven,Nunu,342,136,206,39.77
Draven,Zoe,236,101,135,42.8
Draven,XinZhao,395,193,202,48.86
Draven,TahmKench,468,251,217,53.63
Draven,Rammus,197,105,92,53.3
Draven,Zed,674,361,313,53.56
Draven,Ashe,1302,652,650,50.08
Draven,Yorick,661,272,389,41.15
Draven,Volibear,776,381,395,49.1
Draven,Vladimir,424,200,224,47.17
Draven,Zeri,219,108,111,49.32
Draven,Senna,422,193,229,45.73
Draven,Warwick,979,495,484,50.56
Draven,LeeSin,838,420,418,50.12
Draven,Sylas,793,365,428,46.03
Draven,Pyke,464,210,254,45.26
Draven,Talon,357,180,177,50.42
Draven,Twitch,541,275,266,50.83
Draven,Neeko,268,118,150,44.03
Draven,Jax,531,263,268,49.53
Draven,Ryze,239,120,119,50.21
Draven,Swain,520,236,284,45.38
Draven,Nocturne,752,391,361,51.99
Draven,Aphelios,327,162,165,49.54
Draven,Teemo,741,331,410,44.67
Draven,Kayle,473,208,265,43.97
Draven,Jayce,284,160,124,56.34
Draven,Morgana,654,317,337,48.47
Draven,Amumu,680,296,384,43.53
Draven,Irelia,498,253,245,50.8
Draven,MissFortune,1413,652,761,46.14
Draven,Poppy,333,157,176,47.15
Draven,Mordekaiser,673,332,341,49.33
Draven,Kaisa,992,558,434,56.25
Draven,Yasuo,1124,509,615,45.28
Draven,Hecarim,304,154,150,50.66
Draven,Jhin,1284,629,655,48.99
Draven,Zyra,512,225,287,43.95
Draven,Ekko,577,274,303,47.49
Draven,Yone,1025,541,484,52.78
Draven,Lulu,833,435,398,52.22
Draven,Tryndamere,358,161,197,44.97
Draven,Leblanc,341,180,161,52.79
Draven,Sivir,274,132,142,48.18
Draven,Nami,742,352,390,47.44
Draven,Sett,819,317,502,38.71
Draven,Kayn,885,429,456,48.47
Draven,Brand,495,222,273,44.85
Draven,Rengar,196,88,108,44.9
Draven,Jinx,1844,882,962,47.83
Draven,Yuumi,487,268,219,55.03
Draven,DrMundo,348,162,186,46.55
Draven,Xerath,541,274,267,50.65
Draven,Aatrox,614,342,272,55.7
Draven,Karma,751,384,367,51.13
Draven,Kalista,166,95,71,57.23
Draven,Braum,456,212,244,46.49
Draven,Shen,401,199,202,49.63
Draven,Soraka,419,221,198,52.74
Draven,Gragas,340,199,141,58.53
Draven,Sejuani,238,126,112,52.94
Draven,Malzahar,661,316,345,47.81
Draven,Darius,1115,544,571,48.79
Draven,Seraphine,461,241,220,52.28
Draven,Gangplank,301,124,177,41.2
Draven,Smolder,406,208,198,51.23
Draven,Aurora,425,235,190,55.29
Draven,Olaf,187,105,82,56.15
Draven,Lissandra,219,90,129,41.1
Draven,Rumble,144,62,82,43.06
Draven,Chogath,719,339,380,47.15
Draven,Ahri,695,355,340,51.08
Draven,Janna,248,123,125,49.6
Draven,Thresh,861,419,442,48.66
Draven,Ornn,267,142,125,53.18
Draven,Quinn,226,109,117,48.23
Draven,Kindred,258,117,141,45.35
Draven,Azir,215,117,98,54.42
Draven,Malphite,656,332,324,50.61
Draven,Qiyana,160,92,68,57.5
Draven,MonkeyKing,405,213,192,52.59
Draven,Briar,471,220,251,46.71
Draven,Nasus,385,165,220,42.86
Draven,Illaoi,242,93,149,38.43
Draven,Viktor,565,288,277,50.97
Draven,JarvanIV,445,240,205,53.93
Draven,Shyvana,155,67,88,43.23
Draven,Hwei,420,227,193,54.05
Draven,Corki,257,116,141,45.14
Draven,Orianna,229,122,107,53.28
Draven,Lucian,445,263,182,59.1
Draven,Vi,568,294,274,51.76
Draven,Fizz,341,174,167,51.03
Draven,Rell,252,122,130,48.41
Draven,Urgot,373,171,202,45.84
Draven,Lillia,317,192,125,60.57
Draven,Milio,376,200,176,53.19
Draven,Galio,507,228,279,44.97
Draven,Ziggs,225,95,130,42.22
Draven,Velkoz,414,205,209,49.52
Draven,Kassadin,108,55,53,50.93
Draven,Vayne,878,434,444,49.43
Draven,Gnar,230,117,113,50.87
Draven,Nautilus,634,300,334,47.32
Draven,Karthus,210,119,91,56.67
Draven,Naafiri,195,95,100,48.72
Draven,TwistedFate,302,153,149,50.66
Draven,Gwen,298,143,155,47.99
Draven,Tristana,544,272,272,50
Draven,Xayah,297,155,142,52.19
Draven,Alistar,277,112,165,40.43
Draven,Elise,372,185,187,49.73
Draven,Sona,210,92,118,43.81
Draven,Evelynn,201,91,110,45.27
Draven,Fiora,213,81,132,38.03
Draven,Viego,824,366,458,44.42
Draven,Blitzcrank,346,195,151,56.36
Draven,Heimerdinger,267,122,145,45.69
Draven,Nidalee,155,74,81,47.74
Draven,Singed,152,75,77,49.34
Draven,Zilean,154,82,72,53.25
Draven,Kled,118,58,60,49.15
Draven,Renekton,281,165,116,58.72
Draven,Zac,294,151,143,51.36
Draven,Akshan,236,120,116,50.85
Draven,Camille,247,118,129,47.77
Draven,Rakan,238,83,155,34.87
Draven,Khazix,301,145,156,48.17
Draven,Syndra,498,240,258,48.19
Draven,Skarner,133,63,70,47.37
Draven,Cassiopeia,188,83,105,44.15
Draven,Vex,250,108,142,43.2
Draven,AurelionSol,221,115,106,52.04
Draven,Samira,447,206,241,46.09
Draven,Ivern,74,34,40,45.95
Draven,Bard,183,83,100,45.36
Draven,Taliyah,134,45,89,33.58
Draven,Renata,106,50,56,47.17
Draven,KSante,293,165,128,56.31
Draven,Maokai,229,130,99,56.77
Draven,RekSai,74,49,25,66.22
Senna,Sion,683,320,363,46.85
Senna,MasterYi,1042,501,541,48.08
Senna,Annie,297,149,148,50.17
Senna,Ezreal,2082,1048,1034,50.34
Senna,Lux,2250,1056,1194,46.93
Senna,Poppy,519,249,270,47.98
Senna,Zac,370,183,187,49.46
Senna,Chogath,1057,515,542,48.72
Senna,Xayah,389,202,187,51.93
Senna,Nami,951,456,495,47.95
Senna,Yorick,926,404,522,43.63
Senna,Rammus,252,115,137,45.63
Senna,Yasuo,1762,876,886,49.72
Senna,Caitlyn,2440,1231,1209,50.45
Senna,Lulu,1357,661,696,48.71
Senna,Pantheon,1359,640,719,47.09
Senna,Gwen,380,198,182,52.11
Senna,Fizz,560,259,301,46.25
Senna,Jinx,2642,1301,1341,49.24
Senna,Ivern,133,52,81,39.1
Senna,Renekton,406,202,204,49.75
Senna,Gragas,462,205,257,44.37
Senna,Kaisa,1435,721,714,50.24
Senna,Nautilus,1066,539,527,50.56
Senna,Naafiri,261,138,123,52.87
Senna,Akali,925,478,447,51.68
Senna,Jhin,1769,842,927,47.6
Senna,Zyra,935,464,471,49.63
Senna,Kayn,1315,644,671,48.97
Senna,Vi,799,418,381,52.32
Senna,Ekko,863,432,431,50.06
Senna,Pyke,706,332,374,47.03
Senna,Singed,205,99,106,48.29
Senna,MonkeyKing,638,286,352,44.83
Senna,Orianna,365,184,181,50.41
Senna,Draven,422,229,193,54.27
Senna,Teemo,1091,532,559,48.76
Senna,Azir,265,108,157,40.75
Senna,Karthus,292,135,157,46.23
Senna,Seraphine,767,398,369,51.89
Senna,Jayce,467,236,231,50.54
Senna,Darius,1742,885,857,50.8
Senna,Diana,1378,702,676,50.94
Senna,Taric,175,94,81,53.71
Senna,Sett,1362,672,690,49.34
Senna,Volibear,915,439,476,47.98
Senna,Yone,1602,821,781,51.25
Senna,Sylas,1104,619,485,56.07
Senna,Jax,826,406,420,49.15
Senna,Rumble,215,107,108,49.77
Senna,Brand,639,281,358,43.97
Senna,Gangplank,349,179,170,51.29
Senna,Taliyah,236,104,132,44.07
Senna,Milio,596,305,291,51.17
Senna,Trundle,511,252,259,49.32
Senna,Kindred,424,199,225,46.93
Senna,Swain,941,455,486,48.35
Senna,Udyr,395,228,167,57.72
Senna,Lucian,647,350,297,54.1
Senna,Morgana,1216,616,600,50.66
Senna,Heimerdinger,413,179,234,43.34
Senna,Lillia,482,262,220,54.36
Senna,Vladimir,601,321,280,53.41
Senna,Illaoi,405,230,175,56.79
Senna,LeeSin,1079,527,552,48.84
Senna,Tristana,805,389,416,48.32
Senna,Janna,366,208,158,56.83
Senna,Aatrox,660,344,316,52.12
Senna,Sejuani,321,169,152,52.65
Senna,Ahri,1242,686,556,55.23
Senna,Kayle,622,307,315,49.36
Senna,Mordekaiser,1104,535,569,48.46
Senna,Blitzcrank,586,309,277,52.73
Senna,Veigar,873,444,429,50.86
Senna,Thresh,1158,576,582,49.74
Senna,Riven,400,201,199,50.25
Senna,Skarner,181,106,75,58.56
Senna,Galio,754,392,362,51.99
Senna,Viego,1318,657,661,49.85
Senna,Vayne,1062,553,509,52.07
Senna,Braum,508,284,224,55.91
Senna,Aurora,587,346,241,58.94
Senna,Zed,971,485,486,49.95
Senna,Warwick,1347,648,699,48.11
Senna,Ashe,1693,803,890,47.43
Senna,Zilean,295,139,156,47.12
Senna,Xerath,718,353,365,49.16
Senna,Ambessa,529,292,237,55.2
Senna,Katarina,574,272,302,47.39
Senna,Ornn,416,170,246,40.87
Senna,Kennen,195,71,124,36.41
Senna,Quinn,388,186,202,47.94
Senna,Sivir,501,266,235,53.09
Senna,Rengar,249,114,135,45.78
Senna,Samira,616,299,317,48.54
Senna,Smolder,522,276,246,52.87
Senna,Bard,294,167,127,56.8
Senna,Anivia,281,126,155,44.84
Senna,Nocturne,1095,477,618,43.56
Senna,Karma,1118,575,543,51.43
Senna,Nunu,418,229,189,54.78
Senna,Zeri,368,177,191,48.1
Senna,XinZhao,515,235,280,45.63
Senna,TahmKench,727,364,363,50.07
Senna,Irelia,702,333,369,47.44
Senna,Ziggs,332,152,180,45.78
Senna,Sona,304,159,145,52.3
Senna,Malzahar,944,437,507,46.29
Senna,Twitch,736,356,380,48.37
Senna,Shen,579,336,243,58.03
Senna,Nasus,540,267,273,49.44
Senna,Amumu,955,463,492,48.48
Senna,FiddleSticks,396,226,170,57.07
Senna,Tryndamere,525,271,254,51.62
Senna,Ryze,296,125,171,42.23
Senna,Aphelios,488,247,241,50.61
Senna,Graves,523,280,243,53.54
Senna,Velkoz,566,238,328,42.05
Senna,Varus,813,409,404,50.31
Senna,Garen,1481,739,742,49.9
Senna,Corki,346,200,146,57.8
Senna,DrMundo,454,196,258,43.17
Senna,Maokai,390,202,188,51.79
Senna,Mel,1865,1006,859,53.94
Senna,Camille,307,174,133,56.68
Senna,Talon,555,306,249,55.14
Senna,MissFortune,2066,1001,1065,48.45
Senna,Kled,131,65,66,49.62
Senna,Belveth,192,100,92,52.08
Senna,Alistar,311,142,169,45.66
Senna,AurelionSol,336,175,161,52.08
Senna,Kassadin,155,76,79,49.03
Senna,Soraka,530,265,265,50
Senna,Viktor,834,433,401,51.92
Senna,Shaco,845,440,405,52.07
Senna,Nidalee,249,139,110,55.82
Senna,Khazix,395,202,193,51.14
Senna,Neeko,393,209,184,53.18
Senna,Urgot,494,210,284,42.51
Senna,Elise,656,323,333,49.24
Senna,Lissandra,248,138,110,55.65
Senna,Evelynn,306,147,159,48.04
Senna,Rell,395,223,172,56.46
Senna,Gnar,381,185,196,48.56
Senna,Qiyana,218,129,89,59.17
Senna,Fiora,321,155,166,48.29
Senna,Hecarim,366,196,170,53.55
Senna,Cassiopeia,269,136,133,50.56
Senna,Briar,638,278,360,43.57
Senna,Rakan,348,142,206,40.8
Senna,Leona,586,277,309,47.27
Senna,Hwei,613,280,333,45.68
Senna,Kalista,189,88,101,46.56
Senna,Malphite,925,394,531,42.59
Senna,Vex,427,188,239,44.03
Senna,Renata,149,85,64,57.05
Senna,KSante,405,223,182,55.06
Senna,Shyvana,259,127,132,49.03
Senna,Nilah,245,110,135,44.9
Senna,Leblanc,477,265,212,55.56
Senna,Olaf,211,133,78,63.03
Senna,Zoe,320,184,136,57.5
Senna,KogMaw,303,142,161,46.86
Senna,JarvanIV,558,300,258,53.76
Senna,Akshan,301,131,170,43.52
Senna,Syndra,491,225,266,45.82
Senna,TwistedFate,285,125,160,43.86
Senna,Yuumi,714,318,396,44.54
Senna,RekSai,78,38,40,48.72
Sion,Vladimir,582,285,297,48.97
Sion,Rammus,252,152,100,60.32
Sion,Katarina,643,309,334,48.06
Sion,Draven,479,253,226,52.82
Sion,Senna,683,363,320,53.15
Sion,Garen,1389,645,744,46.44
Sion,Rengar,295,177,118,60
Sion,Lissandra,277,156,121,56.32
Sion,Tristana,859,406,453,47.26
Sion,Zyra,873,450,423,51.55
Sion,Kayn,1296,614,682,47.38
Sion,Shyvana,210,101,109,48.1
Sion,Annie,281,145,136,51.6
Sion,Varus,817,462,355,56.55
Sion,Lux,2015,1091,924,54.14
Sion,Warwick,1267,678,589,53.51
Sion,Ekko,852,444,408,52.11
Sion,Hwei,559,301,258,53.85
Sion,Jhin,1704,926,778,54.34
Sion,Nami,974,460,514,47.23
Sion,Kayle,653,315,338,48.24
Sion,LeeSin,1182,680,502,57.53
Sion,Yasuo,1637,834,803,50.95
Sion,Caitlyn,2292,1174,1118,51.22
Sion,Karma,1019,465,554,45.63
Sion,Camille,263,135,128,51.33
Sion,Darius,1692,886,806,52.36
Sion,Viego,1355,701,654,51.73
Sion,Taliyah,266,108,158,40.6
Sion,Jinx,2532,1258,1274,49.68
Sion,Blitzcrank,548,265,283,48.36
Sion,Chogath,1150,578,572,50.26
Sion,Swain,801,360,441,44.94
Sion,Jax,735,356,379,48.44
Sion,Lillia,525,227,298,43.24
Sion,Malzahar,1092,523,569,47.89
Sion,Kaisa,1516,770,746,50.79
Sion,Seraphine,611,354,257,57.94
Sion,Aatrox,686,307,379,44.75
Sion,Rakan,343,169,174,49.27
Sion,Samira,503,291,212,57.85
Sion,AurelionSol,352,174,178,49.43
Sion,KSante,404,225,179,55.69
Sion,Brand,717,375,342,52.3
Sion,MonkeyKing,640,315,325,49.22
Sion,Alistar,429,211,218,49.18
Sion,MasterYi,966,492,474,50.93
Sion,Corki,389,206,183,52.96
Sion,Mordekaiser,1041,536,505,51.49
Sion,Lulu,1268,607,661,47.87
Sion,DrMundo,468,254,214,54.27
Sion,Hecarim,408,209,199,51.23
Sion,Akali,871,448,423,51.44
Sion,Xerath,708,350,358,49.44
Sion,Yorick,1015,501,514,49.36
Sion,Orianna,361,185,176,51.25
Sion,Lucian,637,356,281,55.89
Sion,Pantheon,1356,754,602,55.6
Sion,Sylas,1193,655,538,54.9
Sion,Sejuani,345,186,159,53.91
Sion,KogMaw,307,144,163,46.91
Sion,Yone,1639,815,824,49.73
Sion,Ezreal,2138,1064,1074,49.77
Sion,Neeko,350,191,159,54.57
Sion,Mel,1712,905,807,52.86
Sion,XinZhao,571,323,248,56.57
Sion,Maokai,395,216,179,54.68
Sion,Gangplank,403,189,214,46.9
Sion,Shaco,857,465,392,54.26
Sion,Veigar,907,437,470,48.18
Sion,Smolder,583,303,280,51.97
Sion,Amumu,983,422,561,42.93
Sion,Twitch,744,387,357,52.02
Sion,Janna,349,165,184,47.28
Sion,Nasus,667,335,332,50.22
Sion,Aurora,599,299,300,49.92
Sion,FiddleSticks,473,277,196,58.56
Sion,Sett,1484,789,695,53.17
Sion,Gwen,567,307,260,54.14
Sion,Zed,1077,593,484,55.06
Sion,Sona,267,109,158,40.82
Sion,Trundle,613,273,340,44.54
Sion,Khazix,415,219,196,52.77
Sion,Riven,379,191,188,50.4
Sion,Zoe,318,179,139,56.29
Sion,Renekton,355,189,166,53.24
Sion,Ahri,1150,587,563,51.04
Sion,Fizz,486,258,228,53.09
Sion,Volibear,1008,495,513,49.11
Sion,RekSai,106,51,55,48.11
Sion,MissFortune,1965,1016,949,51.7
Sion,Kennen,234,107,127,45.73
Sion,Quinn,362,176,186,48.62
Sion,Nautilus,954,492,462,51.57
Sion,Teemo,1338,657,681,49.1
Sion,Urgot,483,227,256,47
Sion,Ashe,1637,880,757,53.76
Sion,Zilean,357,172,185,48.18
Sion,Vayne,1289,604,685,46.86
Sion,Anivia,299,127,172,42.47
Sion,Nocturne,1106,507,599,45.84
Sion,Illaoi,349,174,175,49.86
Sion,Diana,1378,699,679,50.73
Sion,Gnar,330,162,168,49.09
Sion,Ziggs,318,143,175,44.97
Sion,Milio,525,248,277,47.24
Sion,Gragas,481,231,250,48.02
Sion,Morgana,1017,487,530,47.89
Sion,Zac,429,198,231,46.15
Sion,JarvanIV,476,236,240,49.58
Sion,Naafiri,268,158,110,58.96
Sion,Jayce,366,210,156,57.38
Sion,Tryndamere,502,241,261,48.01
Sion,Elise,644,351,293,54.5
Sion,Irelia,688,344,344,50
Sion,Vex,431,222,209,51.51
Sion,Qiyana,231,119,112,51.52
Sion,Syndra,640,326,314,50.94
Sion,Leona,702,396,306,56.41
Sion,Vi,828,415,413,50.12
Sion,Yuumi,663,330,333,49.77
Sion,Cassiopeia,252,123,129,48.81
Sion,Briar,646,302,344,46.75
Sion,Pyke,608,293,315,48.19
Sion,Ivern,113,52,61,46.02
Sion,Shen,649,315,334,48.54
Sion,Viktor,748,349,399,46.66
Sion,Graves,545,236,309,43.3
Sion,Poppy,456,260,196,57.02
Sion,Soraka,545,279,266,51.19
Sion,Evelynn,340,185,155,54.41
Sion,Kled,144,76,68,52.78
Sion,Talon,489,262,227,53.58
Sion,Malphite,958,516,442,53.86
Sion,Rumble,242,132,110,54.55
Sion,Bard,300,174,126,58
Sion,Heimerdinger,431,232,199,53.83
Sion,Sivir,468,226,242,48.29
Sion,Braum,500,251,249,50.2
Sion,Velkoz,508,263,245,51.77
Sion,Thresh,1263,652,611,51.62
Sion,Kindred,405,212,193,52.35
Sion,Nunu,521,275,246,52.78
Sion,Leblanc,421,204,217,48.46
Sion,Nilah,291,122,169,41.92
Sion,TahmKench,605,326,279,53.88
Sion,Taric,226,102,124,45.13
Sion,Belveth,182,83,99,45.6
Sion,TwistedFate,297,197,100,66.33
Sion,Ambessa,568,270,298,47.54
Sion,Zeri,353,209,144,59.21
Sion,Galio,793,389,404,49.05
Sion,Azir,255,152,103,59.61
Sion,Xayah,360,161,199,44.72
Sion,Karthus,238,111,127,46.64
Sion,Olaf,182,91,91,50
Sion,Singed,355,148,207,41.69
Sion,Udyr,402,220,182,54.73
Sion,Fiora,394,182,212,46.19
Sion,Nidalee,257,146,111,56.81
Sion,Ornn,304,160,144,52.63
Sion,Kassadin,179,84,95,46.93
Sion,Ryze,265,132,133,49.81
Sion,Aphelios,545,311,234,57.06
Sion,Renata,126,69,57,54.76
Sion,Skarner,227,132,95,58.15
Sion,Rell,384,209,175,54.43
Sion,Akshan,298,190,108,63.76
Sion,Kalista,209,110,99,52.63
MasterYi,Vladimir,953,510,443,53.52
MasterYi,Rammus,1310,562,748,42.9
MasterYi,Katarina,1112,570,542,51.26
MasterYi,Draven,707,361,346,51.06
MasterYi,Senna,1042,541,501,51.92
MasterYi,Poppy,756,403,353,53.31
MasterYi,Zac,511,248,263,48.53
MasterYi,Chogath,1803,872,931,48.36
MasterYi,Xayah,680,343,337,50.44
MasterYi,Nami,1427,712,715,49.89
MasterYi,Nasus,1170,551,619,47.09
MasterYi,Nocturne,2064,1056,1008,51.16
MasterYi,Jhin,3103,1630,1473,52.53
MasterYi,Seraphine,1040,533,507,51.25
MasterYi,Ornn,544,285,259,52.39
MasterYi,Kayn,2411,1277,1134,52.97
MasterYi,Yasuo,3034,1697,1337,55.93
MasterYi,Caitlyn,4177,2094,2083,50.13
MasterYi,Morgana,1852,969,883,52.32
MasterYi,Malzahar,1577,710,867,45.02
MasterYi,Vayne,1939,932,1007,48.07
MasterYi,Lulu,1647,911,736,55.31
MasterYi,Yorick,1669,762,907,45.66
MasterYi,Briar,1165,572,593,49.1
MasterYi,Nautilus,1751,914,837,52.2
MasterYi,Riven,626,302,324,48.24
MasterYi,Veigar,1557,786,771,50.48
MasterYi,Nilah,472,241,231,51.06
MasterYi,Lissandra,550,261,289,47.45
MasterYi,Teemo,2027,1018,1009,50.22
MasterYi,MissFortune,3634,1853,1781,50.99
MasterYi,Blitzcrank,1069,505,564,47.24
MasterYi,Garen,2489,1358,1131,54.56
MasterYi,Graves,865,416,449,48.09
MasterYi,Diana,2595,1314,1281,50.64
MasterYi,Varus,1315,695,620,52.85
MasterYi,Shaco,1462,690,772,47.2
MasterYi,Belveth,286,141,145,49.3
MasterYi,Ashe,2984,1514,1470,50.74
MasterYi,Olaf,336,183,153,54.46
MasterYi,Leona,1422,642,780,45.15
MasterYi,Gragas,723,373,350,51.59
MasterYi,Zed,1719,928,791,53.98
MasterYi,Sett,2202,1049,1153,47.64
MasterYi,Hecarim,525,293,232,55.81
MasterYi,Karma,1580,789,791,49.94
MasterYi,Trundle,869,393,476,45.22
MasterYi,Khazix,741,380,361,51.28
MasterYi,Tristana,1584,820,764,51.77
MasterYi,Thresh,1839,917,922,49.86
MasterYi,Sylas,1784,910,874,51.01
MasterYi,Swain,1380,715,665,51.81
MasterYi,JarvanIV,734,383,351,52.18
MasterYi,Twitch,1264,622,642,49.21
MasterYi,Gnar,546,264,282,48.35
MasterYi,TwistedFate,465,241,224,51.83
MasterYi,Volibear,1774,910,864,51.3
MasterYi,Lucian,955,495,460,51.83
MasterYi,Ambessa,742,426,316,57.41
MasterYi,Lux,3977,1989,1988,50.01
MasterYi,Kayle,970,512,458,52.78
MasterYi,LeeSin,1988,1003,985,50.45
MasterYi,Jinx,4256,2133,2123,50.12
MasterYi,Pyke,1245,624,621,50.12
MasterYi,Akali,1636,831,805,50.79
MasterYi,TahmKench,1207,602,605,49.88
MasterYi,Mel,2992,1559,1433,52.11
MasterYi,Bard,402,229,173,56.97
MasterYi,Ekko,1389,687,702,49.46
MasterYi,Elise,919,439,480,47.77
MasterYi,Aurora,1006,487,519,48.41
MasterYi,Ahri,1815,909,906,50.08
MasterYi,Viego,2122,1111,1011,52.36
MasterYi,Leblanc,774,415,359,53.62
MasterYi,Ivern,157,83,74,52.87
MasterYi,Warwick,2514,1173,1341,46.66
MasterYi,Syndra,824,434,390,52.67
MasterYi,Jax,1837,934,903,50.84
MasterYi,Illaoi,773,419,354,54.2
MasterYi,Gangplank,537,265,272,49.35
MasterYi,Irelia,1310,680,630,51.91
MasterYi,Kaisa,2281,1207,1074,52.92
MasterYi,Velkoz,951,480,471,50.47
MasterYi,Yone,2819,1506,1313,53.42
MasterYi,Neeko,739,384,355,51.96
MasterYi,Ziggs,570,271,299,47.54
MasterYi,Viktor,1301,667,634,51.27
MasterYi,Ezreal,3350,1724,1626,51.46
MasterYi,Braum,840,385,455,45.83
MasterYi,Sion,966,474,492,49.07
MasterYi,Orianna,625,312,313,49.92
MasterYi,Soraka,762,405,357,53.15
MasterYi,MonkeyKing,995,486,509,48.84
MasterYi,Karthus,421,240,181,57.01
MasterYi,Hwei,905,433,472,47.85
MasterYi,Rakan,558,289,269,51.79
MasterYi,Xerath,1242,641,601,51.61
MasterYi,Brand,1194,632,562,52.93
MasterYi,Aphelios,686,340,346,49.56
MasterYi,KSante,658,327,331,49.7
MasterYi,Quinn,581,269,312,46.3
MasterYi,Darius,2788,1395,1393,50.04
MasterYi,Amumu,1717,847,870,49.33
MasterYi,Pantheon,2277,1174,1103,51.56
MasterYi,Vi,1403,658,745,46.9
MasterYi,FiddleSticks,702,376,326,53.56
MasterYi,Annie,477,242,235,50.73
MasterYi,Nunu,822,450,372,54.74
MasterYi,Zyra,1337,633,704,47.34
MasterYi,Kindred,609,329,280,54.02
MasterYi,Samira,1066,569,497,53.38
MasterYi,Tryndamere,991,491,500,49.55
MasterYi,Yuumi,1092,585,507,53.57
MasterYi,Shyvana,330,191,139,57.88
MasterYi,Azir,413,219,194,53.03
MasterYi,Galio,1287,618,669,48.02
MasterYi,Malphite,1496,764,732,51.07
MasterYi,Skarner,328,167,161,50.91
MasterYi,Sejuani,566,298,268,52.65
MasterYi,Milio,738,343,395,46.48
MasterYi,Qiyana,426,203,223,47.65
MasterYi,Renekton,697,340,357,48.78
MasterYi,Taric,350,154,196,44
MasterYi,Alistar,578,282,296,48.79
MasterYi,Mordekaiser,1903,1005,898,52.81
MasterYi,Zilean,449,212,237,47.22
MasterYi,Fiora,481,270,211,56.13
MasterYi,DrMundo,887,422,465,47.58
MasterYi,Shen,831,458,373,55.11
MasterYi,Rengar,514,314,200,61.09
MasterYi,Smolder,935,525,410,56.15
MasterYi,Anivia,439,233,206,53.08
MasterYi,Corki,512,265,247,51.76
MasterYi,Naafiri,440,249,191,56.59
MasterYi,Zeri,516,234,282,45.35
MasterYi,Rell,618,300,318,48.54
MasterYi,Udyr,650,320,330,49.23
MasterYi,AurelionSol,560,291,269,51.96
MasterYi,Rumble,329,177,152,53.8
MasterYi,Lillia,668,356,312,53.29
MasterYi,Maokai,589,286,303,48.56
MasterYi,Kennen,344,175,169,50.87
MasterYi,Nidalee,314,178,136,56.69
MasterYi,Zoe,616,300,316,48.7
MasterYi,Taliyah,316,146,170,46.2
MasterYi,Sivir,715,350,365,48.95
MasterYi,Aatrox,1190,645,545,54.2
MasterYi,Evelynn,512,276,236,53.91
MasterYi,Urgot,834,372,462,44.6
MasterYi,Talon,723,376,347,52.01
MasterYi,Jayce,609,308,301,50.57
MasterYi,Gwen,739,400,339,54.13
MasterYi,XinZhao,888,416,472,46.85
MasterYi,KogMaw,374,176,198,47.06
MasterYi,Cassiopeia,354,181,173,51.13
MasterYi,Janna,420,202,218,48.1
MasterYi,Fizz,986,553,433,56.09
MasterYi,Kled,227,101,126,44.49
MasterYi,Vex,757,417,340,55.09
MasterYi,Singed,423,203,220,47.99
MasterYi,Sona,489,233,256,47.65
MasterYi,RekSai,136,62,74,45.59
MasterYi,Ryze,404,225,179,55.69
MasterYi,Heimerdinger,710,335,375,47.18
MasterYi,Akshan,511,221,290,43.25
MasterYi,Kalista,311,164,147,52.73
MasterYi,Renata,291,174,117,59.79
MasterYi,Camille,473,244,229,51.59
MasterYi,Kassadin,315,150,165,47.62
Annie,Vladimir,299,166,133,55.52
Annie,Rammus,104,48,56,46.15
Annie,Katarina,321,132,189,41.12
Annie,Draven,213,111,102,52.11
Annie,Senna,297,148,149,49.83
Annie,Sion,281,136,145,48.4
Annie,Nocturne,511,234,277,45.79
Annie,Ezreal,1100,527,573,47.91
Annie,Teemo,540,270,270,50
Annie,Kayle,279,141,138,50.54
Annie,Jinx,1161,558,603,48.06
Annie,Diana,607,283,324,46.62
Annie,Orianna,187,115,72,61.5
Annie,Pyke,334,189,145,56.59
Annie,Yorick,434,205,229,47.24
Annie,Elise,255,152,103,59.61
Annie,Veigar,402,202,200,50.25
Annie,Smolder,234,120,114,51.28
Annie,Soraka,223,124,99,55.61
Annie,TahmKench,260,163,97,62.69
Annie,Taliyah,143,68,75,47.55
Annie,Jhin,789,392,397,49.68
Annie,Zyra,437,230,207,52.63
Annie,Ambessa,264,124,140,46.97
Annie,Lillia,200,104,96,52
Annie,Syndra,303,129,174,42.57
Annie,Yuumi,342,163,179,47.66
Annie,Mordekaiser,496,244,252,49.19
Annie,Talon,226,120,106,53.1
Annie,Alistar,203,116,87,57.14
Annie,Sett,566,261,305,46.11
Annie,Rengar,124,73,51,58.87
Annie,Yasuo,955,530,425,55.5
Annie,Kaisa,697,397,300,56.96
Annie,Janna,137,50,87,36.5
Annie,MasterYi,477,235,242,49.27
Annie,Mel,818,448,370,54.77
Annie,Morgana,580,281,299,48.45
Annie,Singed,108,64,44,59.26
Annie,Kayn,539,254,285,47.12
Annie,Aurora,337,174,163,51.63
Annie,Caitlyn,1010,515,495,50.99
Annie,Lulu,570,300,270,52.63
Annie,Poppy,211,114,97,54.03
Annie,Naafiri,115,49,66,42.61
Annie,Lucian,280,156,124,55.71
Annie,Milio,174,80,94,45.98
Annie,Aatrox,325,152,173,46.77
Annie,XinZhao,292,155,137,53.08
Annie,Chogath,470,209,261,44.47
Annie,Tristana,369,170,199,46.07
Annie,Maokai,163,81,82,49.69
Annie,LeeSin,728,366,362,50.27
Annie,Twitch,279,146,133,52.33
Annie,Amumu,401,187,214,46.63
Annie,Ahri,567,272,295,47.97
Annie,MissFortune,916,486,430,53.06
Annie,Akali,477,252,225,52.83
Annie,Graves,233,133,100,57.08
Annie,Quinn,161,90,71,55.9
Annie,Viego,546,260,286,47.62
Annie,Galio,337,175,162,51.93
Annie,Ashe,865,430,435,49.71
Annie,Malphite,401,216,185,53.87
Annie,Karma,516,257,259,49.81
Annie,Darius,712,339,373,47.61
Annie,Sejuani,171,84,87,49.12
Annie,Varus,336,197,139,58.63
Annie,Fizz,202,89,113,44.06
Annie,Skarner,117,57,60,48.72
Annie,Tryndamere,223,141,82,63.23
Annie,Nunu,247,118,129,47.77
Annie,Nautilus,418,209,209,50
Annie,Volibear,402,214,188,53.23
Annie,Shyvana,86,36,50,41.86
Annie,Zoe,145,80,65,55.17
Annie,Thresh,544,253,291,46.51
Annie,Vayne,464,232,232,50
Annie,Urgot,203,114,89,56.16
Annie,Xayah,173,106,67,61.27
Annie,Trundle,217,99,118,45.62
Annie,Cassiopeia,116,62,54,53.45
Annie,Warwick,586,303,283,51.71
Annie,Olaf,81,55,26,67.9
Annie,Vi,372,183,189,49.19
Annie,Briar,276,150,126,54.35
Annie,Ekko,353,182,171,51.56
Annie,Kennen,74,44,30,59.46
Annie,Rakan,150,56,94,37.33
Annie,Shen,219,104,115,47.49
Annie,Zeri,179,93,86,51.96
Annie,Hwei,224,134,90,59.82
Annie,Rumble,162,79,83,48.77
Annie,Lux,997,487,510,48.85
Annie,Jax,364,181,183,49.73
Annie,Xerath,441,246,195,55.78
Annie,Heimerdinger,182,89,93,48.9
Annie,Jayce,213,112,101,52.58
Annie,Zilean,132,71,61,53.79
Annie,Ornn,160,85,75,53.13
Annie,Fiora,164,82,82,50
Annie,Gwen,222,100,122,45.05
Annie,Malzahar,423,221,202,52.25
Annie,Aphelios,188,90,98,47.87
Annie,AurelionSol,142,85,57,59.86
Annie,Zac,192,81,111,42.19
Annie,KSante,195,111,84,56.92
Annie,Anivia,116,61,55,52.59
Annie,Swain,403,191,212,47.39
Annie,Yone,750,401,349,53.47
Annie,Kindred,161,70,91,43.48
Annie,Ivern,62,31,31,50
Annie,Ziggs,118,54,64,45.76
Annie,Kalista,89,67,22,75.28
Annie,Leblanc,300,173,127,57.67
Annie,MonkeyKing,218,117,101,53.67
Annie,Taric,79,35,44,44.3
Annie,DrMundo,234,87,147,37.18
Annie,Gragas,237,131,106,55.27
Annie,TwistedFate,157,73,84,46.5
Annie,Illaoi,148,76,72,51.35
Annie,Hecarim,185,85,100,45.95
Annie,Shaco,363,175,188,48.21
Annie,Irelia,326,165,161,50.61
Annie,Zed,495,242,253,48.89
Annie,Renekton,241,142,99,58.92
Annie,JarvanIV,262,120,142,45.8
Annie,Nilah,79,42,37,53.16
Annie,Nami,412,204,208,49.51
Annie,Udyr,132,75,57,56.82
Annie,Sivir,239,112,127,46.86
Annie,Blitzcrank,288,163,125,56.6
Annie,Vex,254,113,141,44.49
Annie,Renata,58,38,20,65.52
Annie,Nidalee,153,80,73,52.29
Annie,Qiyana,91,44,47,48.35
Annie,Braum,237,114,123,48.1
Annie,Garen,648,307,341,47.38
Annie,Akshan,119,69,50,57.98
Annie,Seraphine,259,115,144,44.4
Annie,Gnar,163,101,62,61.96
Annie,Pantheon,606,338,268,55.78
Annie,Nasus,236,120,116,50.85
Annie,Corki,155,80,75,51.61
Annie,Karthus,139,80,59,57.55
Annie,Kled,81,30,51,37.04
Annie,Leona,374,175,199,46.79
Annie,Samira,291,152,139,52.23
Annie,Belveth,109,61,48,55.96
Annie,Azir,109,61,48,55.96
Annie,Brand,221,110,111,49.77
Annie,Sylas,520,280,240,53.85
Annie,FiddleSticks,185,83,102,44.86
Annie,Viktor,396,226,170,57.07
Annie,Velkoz,258,121,137,46.9
Annie,Gangplank,166,84,82,50.6
Annie,Neeko,161,89,72,55.28
Annie,Khazix,182,89,93,48.9
Annie,Kassadin,104,42,62,40.38
Annie,Riven,189,77,112,40.74
Annie,Rell,137,80,57,58.39
Annie,Bard,92,50,42,54.35
Annie,Ryze,115,57,58,49.57
Annie,Sona,135,77,58,57.04
Annie,KogMaw,118,69,49,58.47
Annie,Camille,120,78,42,65
Annie,RekSai,53,26,27,49.06
Annie,Lissandra,122,60,62,49.18
Annie,Evelynn,89,41,48,46.07
Ezreal,Vladimir,1922,924,998,48.07
Ezreal,Rammus,826,408,418,49.39
Ezreal,Katarina,2010,970,1040,48.26
Ezreal,Draven,1347,699,648,51.89
Ezreal,Senna,2082,1034,1048,49.66
Ezreal,Warwick,3549,1639,1910,46.18
Ezreal,Vi,3183,1566,1617,49.2
Ezreal,Irelia,2643,1338,1305,50.62
Ezreal,Caitlyn,9941,4780,5161,48.08
Ezreal,Nautilus,3624,1731,1893,47.76
Ezreal,Nasus,1789,838,951,46.84
Ezreal,Nocturne,3664,1675,1989,45.72
Ezreal,Jhin,7081,3427,3654,48.4
Ezreal,Seraphine,1846,947,899,51.3
Ezreal,Darius,4980,2302,2678,46.22
Ezreal,Lillia,1745,853,892,48.88
Ezreal,Garen,4577,2194,2383,47.94
Ezreal,Pyke,2549,1304,1245,51.16
Ezreal,Teemo,3383,1587,1796,46.91
Ezreal,Jax,2838,1295,1543,45.63
Ezreal,Fizz,1508,769,739,50.99
Ezreal,Kaisa,7261,3475,3786,47.86
Ezreal,Morgana,3192,1518,1674,47.56
Ezreal,Renekton,1568,778,790,49.62
Ezreal,Evelynn,954,426,528,44.65
Ezreal,Lissandra,1068,481,587,45.04
Ezreal,Corki,1291,661,630,51.2
Ezreal,Rakan,1276,655,621,51.33
Ezreal,FiddleSticks,1436,671,765,46.73
Ezreal,Rumble,1103,611,492,55.39
Ezreal,Shaco,2704,1332,1372,49.26
Ezreal,Veigar,2368,1163,1205,49.11
Ezreal,Lux,6677,3255,3422,48.75
Ezreal,Hwei,1867,960,907,51.42
Ezreal,Twitch,1959,943,1016,48.14
Ezreal,Karma,4107,2067,2040,50.33
Ezreal,Kayn,3789,1843,1946,48.64
Ezreal,Shyvana,639,289,350,45.23
Ezreal,Annie,1100,573,527,52.09
Ezreal,Varus,3171,1642,1529,51.78
Ezreal,Shen,1509,716,793,47.45
Ezreal,Amumu,2711,1304,1407,48.1
Ezreal,Orianna,1410,713,697,50.57
Ezreal,Sona,828,361,467,43.6
Ezreal,Poppy,1620,819,801,50.56
Ezreal,Taliyah,764,388,376,50.79
Ezreal,MissFortune,6989,3373,3616,48.26
Ezreal,Malphite,2972,1551,1421,52.19
Ezreal,Viego,4344,2141,2203,49.29
Ezreal,Lulu,4516,2122,2394,46.99
Ezreal,Ekko,2679,1323,1356,49.38
Ezreal,Vex,1539,772,767,50.16
Ezreal,Neeko,1264,617,647,48.81
Ezreal,Yorick,2534,1191,1343,47
Ezreal,Yone,5882,3022,2860,51.38
Ezreal,Xayah,1307,650,657,49.73
Ezreal,Yuumi,2046,955,1091,46.68
Ezreal,MonkeyKing,2063,1009,1054,48.91
Ezreal,Akshan,911,434,477,47.64
Ezreal,Tristana,2803,1377,1426,49.13
Ezreal,Swain,2469,1119,1350,45.32
Ezreal,Akali,3458,1809,1649,52.31
Ezreal,TahmKench,1799,895,904,49.75
Ezreal,Camille,1087,597,490,54.92
Ezreal,Briar,1792,835,957,46.6
Ezreal,Jinx,8783,4116,4667,46.86
Ezreal,Pantheon,5038,2514,2524,49.9
Ezreal,Kassadin,580,262,318,45.17
Ezreal,Lucian,2436,1223,1213,50.21
Ezreal,Nami,2645,1206,1439,45.6
Ezreal,Galio,2763,1230,1533,44.52
Ezreal,Malzahar,2703,1205,1498,44.58
Ezreal,Sejuani,1216,617,599,50.74
Ezreal,Milio,1547,677,870,43.76
Ezreal,Udyr,1078,536,542,49.72
Ezreal,Thresh,4247,2046,2201,48.18
Ezreal,Elise,2438,1170,1268,47.99
Ezreal,Gangplank,1564,774,790,49.49
Ezreal,Trundle,1527,729,798,47.74
Ezreal,Chogath,3014,1335,1679,44.29
Ezreal,Sivir,1899,863,1036,45.44
Ezreal,Zoe,1207,565,642,46.81
Ezreal,Vayne,4008,1947,2061,48.58
Ezreal,TwistedFate,1081,570,511,52.73
Ezreal,Yasuo,5708,2708,3000,47.44
Ezreal,Anivia,842,395,447,46.91
Ezreal,Gwen,1384,693,691,50.07
Ezreal,Mel,5549,2811,2738,50.66
Ezreal,Velkoz,1640,798,842,48.66
Ezreal,Urgot,1200,576,624,48
Ezreal,KogMaw,754,349,405,46.29
Ezreal,Kayle,1602,771,831,48.13
Ezreal,Diana,4906,2312,2594,47.13
Ezreal,Illaoi,1162,586,576,50.43
Ezreal,Karthus,967,489,478,50.57
Ezreal,Naafiri,883,423,460,47.9
Ezreal,Maokai,1386,687,699,49.57
Ezreal,Zeri,1501,704,797,46.9
Ezreal,Gnar,1310,590,720,45.04
Ezreal,Khazix,1447,716,731,49.48
Ezreal,Leona,2660,1331,1329,50.04
Ezreal,Ambessa,2214,1126,1088,50.86
Ezreal,Ziggs,989,514,475,51.97
Ezreal,Ahri,3751,1848,1903,49.27
Ezreal,Samira,1805,956,849,52.96
Ezreal,Gragas,1889,964,925,51.03
Ezreal,Janna,1014,467,547,46.06
Ezreal,Singed,702,329,373,46.87
Ezreal,Zed,3447,1727,1720,50.1
Ezreal,Graves,2120,1053,1067,49.67
Ezreal,Nidalee,1183,667,516,56.38
Ezreal,Syndra,1820,914,906,50.22
Ezreal,Mordekaiser,3462,1610,1852,46.5
Ezreal,Skarner,757,394,363,52.05
Ezreal,Rengar,881,450,431,51.08
Ezreal,Ryze,1068,450,618,42.13
Ezreal,Ashe,7171,3676,3495,51.26
Ezreal,LeeSin,6188,3155,3033,50.99
Ezreal,Sett,4143,1934,2209,46.68
Ezreal,Smolder,1909,964,945,50.5
Ezreal,MasterYi,3350,1626,1724,48.54
Ezreal,Aphelios,1499,768,731,51.23
Ezreal,Taric,511,240,271,46.97
Ezreal,Viktor,2921,1488,1433,50.94
Ezreal,Volibear,2676,1292,1384,48.28
Ezreal,Kindred,1208,584,624,48.34
Ezreal,Soraka,1455,662,793,45.5
Ezreal,Aurora,2243,1120,1123,49.93
Ezreal,Sion,2138,1074,1064,50.23
Ezreal,Sylas,4979,2474,2505,49.69
Ezreal,Zilean,981,486,495,49.54
Ezreal,Brand,1930,889,1041,46.06
Ezreal,JarvanIV,1759,842,917,47.87
Ezreal,Xerath,3246,1559,1687,48.03
Ezreal,Talon,2059,969,1090,47.06
Ezreal,Rell,1452,648,804,44.63
Ezreal,Tryndamere,1500,722,778,48.13
Ezreal,Aatrox,2774,1290,1484,46.5
Ezreal,Hecarim,1266,636,630,50.24
Ezreal,Zac,1634,791,843,48.41
Ezreal,Riven,1358,636,722,46.83
Ezreal,Leblanc,2330,1143,1187,49.06
Ezreal,RekSai,438,222,216,50.68
Ezreal,Blitzcrank,2513,1268,1245,50.46
Ezreal,Azir,1038,545,493,52.5
Ezreal,Zyra,3016,1383,1633,45.86
Ezreal,Fiora,1051,509,542,48.43
Ezreal,Quinn,1033,472,561,45.69
Ezreal,Belveth,671,335,336,49.93
Ezreal,Braum,1598,753,845,47.12
Ezreal,Kalista,918,399,519,43.46
Ezreal,XinZhao,2085,1026,1059,49.21
Ezreal,Renata,439,187,252,42.6
Ezreal,Ornn,1199,573,626,47.79
Ezreal,Ivern,440,234,206,53.18
Ezreal,Jayce,1992,934,1058,46.89
Ezreal,KSante,1750,874,876,49.94
Ezreal,AurelionSol,1092,561,531,51.37
Ezreal,Nunu,1492,670,822,44.91
Ezreal,Qiyana,726,409,317,56.34
Ezreal,Alistar,1297,673,624,51.89
Ezreal,Kennen,796,406,390,51.01
Ezreal,Heimerdinger,1103,490,613,44.42
Ezreal,Olaf,708,341,367,48.16
Ezreal,Bard,923,462,461,50.05
Ezreal,DrMundo,1401,645,756,46.04
Ezreal,Nilah,774,352,422,45.48
Ezreal,Kled,564,276,288,48.94
Ezreal,Cassiopeia,808,384,424,47.52
Lux,Vladimir,1795,895,900,49.86
Lux,Rammus,906,434,472,47.9
Lux,Katarina,2330,1186,1144,50.9
Lux,Draven,1540,776,764,50.39
Lux,Senna,2250,1194,1056,53.07
Lux,Darius,5734,2875,2859,50.14
Lux,Viego,4109,2064,2045,50.23
Lux,Viktor,2549,1320,1229,51.79
Lux,Leona,2723,1301,1422,47.78
Lux,Trundle,1877,932,945,49.65
Lux,Briar,2313,1045,1268,45.18
Lux,Jhin,6449,3181,3268,49.33
Lux,Pyke,2706,1330,1376,49.15
Lux,Sett,4464,2254,2210,50.49
Lux,Lillia,1450,767,683,52.9
Lux,Leblanc,1913,977,936,51.07
Lux,Jinx,8188,4103,4085,50.11
Lux,Alistar,1069,551,518,51.54
Lux,Malzahar,3372,1605,1767,47.6
Lux,Sejuani,1060,569,491,53.68
Lux,Jayce,1148,618,530,53.83
Lux,Thresh,3958,2042,1916,51.59
Lux,Gangplank,1345,712,633,52.94
Lux,FiddleSticks,1339,697,642,52.05
Lux,Yone,5494,2913,2581,53.02
Lux,Varus,2592,1323,1269,51.04
Lux,Zilean,934,480,454,51.39
Lux,Jax,2930,1532,1398,52.29
Lux,Amumu,3336,1636,1700,49.04
Lux,Ahri,4229,2158,2071,51.03
Lux,Caitlyn,8792,4475,4317,50.9
Lux,Lulu,3520,1743,1777,49.52
Lux,Gwen,1443,773,670,53.57
Lux,Khazix,1525,879,646,57.64
Lux,TwistedFate,1012,555,457,54.84
Lux,Yorick,3244,1457,1787,44.91
Lux,Elise,1866,970,896,51.98
Lux,Corki,1098,587,511,53.46
Lux,Milio,1667,785,882,47.09
Lux,TahmKench,2439,1191,1248,48.83
Lux,LeeSin,4011,2096,1915,52.26
Lux,Hwei,1902,960,942,50.47
Lux,Tristana,2983,1573,1410,52.73
Lux,Karma,3643,1846,1797,50.67
Lux,Urgot,1628,811,817,49.82
Lux,Talon,1444,795,649,55.06
Lux,Aphelios,1452,807,645,55.58
Lux,Maokai,1352,708,644,52.37
Lux,Pantheon,4481,2256,2225,50.35
Lux,Mel,6051,3012,3039,49.78
Lux,Ezreal,6677,3420,3257,51.22
Lux,Teemo,4298,2108,2190,49.05
Lux,Shaco,3009,1564,1445,51.98
Lux,KogMaw,908,445,463,49.01
Lux,Morgana,4945,2452,2493,49.59
Lux,Nocturne,4046,1861,2185,46
Lux,Twitch,2497,1323,1174,52.98
Lux,Renata,443,231,212,52.14
Lux,Sion,2015,924,1091,45.86
Lux,Fizz,2079,1021,1058,49.11
Lux,Seraphine,2935,1506,1429,51.31
Lux,Heimerdinger,1652,851,801,51.51
Lux,Kayn,4448,2216,2232,49.82
Lux,Sivir,1451,762,689,52.52
Lux,Neeko,1607,857,750,53.33
Lux,Chogath,3445,1693,1752,49.14
Lux,Anivia,900,450,450,50
Lux,Zyra,2940,1437,1503,48.88
Lux,Tryndamere,1956,963,993,49.23
Lux,Poppy,1519,774,745,50.95
Lux,Kassadin,650,326,324,50.15
Lux,Ashe,5837,2960,2877,50.71
Lux,Soraka,1676,798,878,47.61
Lux,Garen,4859,2410,2449,49.6
Lux,Irelia,2444,1239,1205,50.7
Lux,Nami,3103,1464,1639,47.18
Lux,MissFortune,7602,3673,3929,48.32
Lux,Nunu,1685,867,818,51.45
Lux,Qiyana,681,380,301,55.8
Lux,Diana,4832,2364,2468,48.92
Lux,Vi,2575,1245,1330,48.35
Lux,Velkoz,2240,1034,1206,46.16
Lux,Rengar,959,523,436,54.54
Lux,Aurora,2016,1093,923,54.22
Lux,Bard,735,370,365,50.34
Lux,Quinn,1107,503,604,45.44
Lux,Zac,1231,636,595,51.67
Lux,Brand,2624,1286,1338,49.01
Lux,Olaf,646,333,313,51.55
Lux,Sylas,3825,2065,1760,53.99
Lux,Kennen,726,353,373,48.62
Lux,Nasus,2157,1040,1117,48.22
Lux,Renekton,1374,711,663,51.75
Lux,Veigar,3492,1757,1735,50.32
Lux,Lissandra,883,472,411,53.45
Lux,Aatrox,2363,1228,1135,51.97
Lux,Lucian,2059,1082,977,52.55
Lux,Ambessa,1709,937,772,54.83
Lux,Evelynn,1054,520,534,49.34
Lux,Xayah,1354,721,633,53.25
Lux,Ekko,2875,1541,1334,53.6
Lux,Yasuo,5970,2930,3040,49.08
Lux,Rakan,1139,603,536,52.94
Lux,Akali,3293,1669,1624,50.68
Lux,Galio,2564,1280,1284,49.92
Lux,Volibear,3558,1796,1762,50.48
Lux,Swain,3098,1559,1539,50.32
Lux,JarvanIV,1615,778,837,48.17
Lux,RekSai,306,161,145,52.61
Lux,Xerath,3550,1765,1785,49.72
Lux,Vayne,3725,1765,1960,47.38
Lux,Nautilus,3164,1650,1514,52.15
Lux,Gragas,1387,741,646,53.42
Lux,Ziggs,1262,609,653,48.26
Lux,Nidalee,737,408,329,55.36
Lux,Graves,1669,801,868,47.99
Lux,Gnar,1087,554,533,50.97
Lux,Syndra,1775,872,903,49.13
Lux,Zoe,1168,608,560,52.05
Lux,Kaisa,4504,2293,2211,50.91
Lux,Samira,2334,1192,1142,51.07
Lux,Mordekaiser,3908,1925,1983,49.26
Lux,Smolder,1718,884,834,51.46
Lux,Skarner,636,346,290,54.4
Lux,Blitzcrank,2475,1226,1249,49.54
Lux,Kindred,1342,681,661,50.75
Lux,Illaoi,1503,784,719,52.16
Lux,XinZhao,1777,867,910,48.79
Lux,Zed,3553,1824,1729,51.34
Lux,Camille,958,508,450,53.03
Lux,MasterYi,3977,1988,1989,49.99
Lux,Warwick,4735,2238,2497,47.27
Lux,AurelionSol,1177,565,612,48
Lux,Shen,1804,934,870,51.77
Lux,Orianna,1184,605,579,51.1
Lux,Zeri,1035,541,494,52.27
Lux,Rumble,713,361,352,50.63
Lux,Hecarim,1145,571,574,49.87
Lux,Janna,822,436,386,53.04
Lux,Singed,794,416,378,52.39
Lux,Braum,1465,702,763,47.92
Lux,Ornn,1252,603,649,48.16
Lux,MonkeyKing,1993,1012,981,50.78
Lux,Karthus,883,493,390,55.83
Lux,Malphite,3201,1633,1568,51.02
Lux,Ryze,793,379,414,47.79
Lux,Taliyah,625,332,293,53.12
Lux,KSante,1275,677,598,53.1
Lux,Rell,1366,726,640,53.15
Lux,Naafiri,1042,518,524,49.71
Lux,Yuumi,2349,1199,1150,51.04
Lux,Riven,1107,590,517,53.3
Lux,Sona,965,504,461,52.23
Lux,DrMundo,1816,908,908,50
Lux,Vex,1700,839,861,49.35
Lux,Azir,840,449,391,53.45
Lux,Kayle,2074,978,1096,47.16
Lux,Belveth,625,323,302,51.68
Lux,Kalista,734,406,328,55.31
Lux,Udyr,1047,547,500,52.24
Lux,Fiora,1004,533,471,53.09
Lux,Taric,599,324,275,54.09
Lux,Nilah,846,415,431,49.05
Lux,Ivern,349,190,159,54.44
Lux,Akshan,1080,527,553,48.8
Lux,Cassiopeia,667,359,308,53.82
Lux,Shyvana,713,333,380,46.7
Lux,Annie,997,510,487,51.15
Lux,Kled,499,244,255,48.9
Pantheon,Darius,3477,1736,1741,49.93
Pantheon,Viego,3012,1459,1553,48.44
Pantheon,Viktor,1772,927,845,52.31
Pantheon,Draven,852,397,455,46.6
Pantheon,Leona,1685,852,833,50.56
Pantheon,Renekton,1026,471,555,45.91
Pantheon,Nocturne,2569,1141,1428,44.41
Pantheon,Xayah,923,474,449,51.35
Pantheon,Pyke,1703,826,877,48.5
Pantheon,Rakan,780,446,334,57.18
Pantheon,Ekko,1784,918,866,51.46
Pantheon,Veigar,1748,827,921,47.31
Pantheon,Ashe,3644,1771,1873,48.6
Pantheon,Soraka,1016,448,568,44.09
Pantheon,Gwen,855,438,417,51.23
Pantheon,Skarner,477,276,201,57.86
Pantheon,DrMundo,1140,551,589,48.33
Pantheon,Samira,1327,709,618,53.43
Pantheon,Malphite,2107,1006,1101,47.75
Pantheon,Kayle,1164,626,538,53.78
Pantheon,Mordekaiser,2325,1075,1250,46.24
Pantheon,Yasuo,4088,2106,1982,51.52
Pantheon,Varus,1711,892,819,52.13
Pantheon,Galio,1503,698,805,46.44
Pantheon,Trundle,1011,551,460,54.5
Pantheon,Jinx,5215,2447,2768,46.92
Pantheon,Nautilus,2015,1016,999,50.42
Pantheon,Gangplank,951,458,493,48.16
Pantheon,Kayn,2717,1283,1434,47.22
Pantheon,Mel,3804,1977,1827,51.97
Pantheon,MissFortune,4289,2152,2137,50.17
Pantheon,Thresh,2340,1139,1201,48.68
Pantheon,Azir,670,324,346,48.36
Pantheon,Syndra,1192,564,628,47.32
Pantheon,Jhin,3802,1962,1840,51.6
Pantheon,Senna,1359,719,640,52.91
Pantheon,Garen,3007,1545,1462,51.38
Pantheon,Rengar,646,371,275,57.43
Pantheon,Lissandra,616,294,322,47.73
Pantheon,Tristana,1714,922,792,53.79
Pantheon,Zyra,1879,898,981,47.79
Pantheon,Rumble,541,265,276,48.98
Pantheon,Shaco,1746,888,858,50.86
Pantheon,Caitlyn,5166,2587,2579,50.08
Pantheon,Lux,4481,2222,2259,49.59
Pantheon,JarvanIV,1124,518,606,46.09
Pantheon,Orianna,873,384,489,43.99
Pantheon,Yuumi,1444,817,627,56.58
Pantheon,Jax,1661,822,839,49.49
Pantheon,Camille,719,363,356,50.49
Pantheon,Sivir,987,470,517,47.62
Pantheon,Karma,2320,1114,1206,48.02
Pantheon,Heimerdinger,800,348,452,43.5
Pantheon,Malzahar,1877,856,1021,45.6
Pantheon,Neeko,816,383,433,46.94
Pantheon,Yone,3939,1990,1949,50.52
Pantheon,Zac,966,515,451,53.31
Pantheon,Anivia,509,212,297,41.65
Pantheon,Blitzcrank,1457,787,670,54.02
Pantheon,Warwick,2598,1266,1332,48.73
Pantheon,LeeSin,3209,1668,1541,51.98
Pantheon,Kassadin,401,199,202,49.63
Pantheon,Morgana,2241,1171,1070,52.25
Pantheon,Poppy,1223,608,615,49.71
Pantheon,Katarina,1447,773,674,53.42
Pantheon,Ezreal,5038,2524,2514,50.1
Pantheon,Aatrox,1608,783,825,48.69
Pantheon,Lucian,1256,704,552,56.05
Pantheon,Nami,1676,767,909,45.76
Pantheon,TahmKench,1353,679,674,50.18
Pantheon,Ziggs,678,352,326,51.92
Pantheon,Twitch,1461,739,722,50.58
Pantheon,Akali,2070,1023,1047,49.42
Pantheon,Sejuani,755,384,371,50.86
Pantheon,Milio,1108,539,569,48.65
Pantheon,Urgot,965,449,516,46.53
Pantheon,Lillia,1095,595,500,54.34
Pantheon,Diana,3252,1533,1719,47.14
Pantheon,Aphelios,932,454,478,48.71
Pantheon,Talon,1184,600,584,50.68
Pantheon,Akshan,651,359,292,55.15
Pantheon,Velkoz,1063,506,557,47.6
Pantheon,Udyr,689,394,295,57.18
Pantheon,Qiyana,464,258,206,55.6
Pantheon,Seraphine,1440,758,682,52.64
Pantheon,Amumu,1872,829,1043,44.28
Pantheon,Brand,1519,725,794,47.73
Pantheon,Vi,1748,893,855,51.09
Pantheon,Vayne,2287,1116,1171,48.8
Pantheon,Rell,944,457,487,48.41
Pantheon,Chogath,2008,913,1095,45.47
Pantheon,Sylas,2773,1526,1247,55.03
Pantheon,Riven,773,438,335,56.66
Pantheon,FiddleSticks,889,432,457,48.59
Pantheon,Gnar,803,403,400,50.19
Pantheon,Irelia,1411,698,713,49.47
Pantheon,Smolder,1206,672,534,55.72
Pantheon,Sona,558,276,282,49.46
Pantheon,Teemo,2156,1108,1048,51.39
Pantheon,Rammus,617,300,317,48.62
Pantheon,RekSai,209,99,110,47.37
Pantheon,Vladimir,1322,702,620,53.1
Pantheon,Swain,1849,885,964,47.86
Pantheon,Elise,1439,690,749,47.95
Pantheon,Sett,2941,1404,1537,47.74
Pantheon,Taric,381,184,197,48.29
Pantheon,Zed,2200,1176,1024,53.45
Pantheon,Yorick,1876,892,984,47.55
Pantheon,Bard,603,299,304,49.59
Pantheon,Hecarim,708,341,367,48.16
Pantheon,Lulu,2407,1163,1244,48.32
Pantheon,Nasus,1258,660,598,52.46
Pantheon,Kindred,785,413,372,52.61
Pantheon,Illaoi,856,448,408,52.34
Pantheon,Hwei,1195,588,607,49.21
Pantheon,Khazix,926,466,460,50.32
Pantheon,Leblanc,1278,661,617,51.72
Pantheon,Volibear,2143,1087,1056,50.72
Pantheon,Sion,1356,602,754,44.4
Pantheon,XinZhao,1233,595,638,48.26
Pantheon,Aurora,1393,722,671,51.83
Pantheon,Vex,941,453,488,48.14
Pantheon,KogMaw,510,226,284,44.31
Pantheon,MonkeyKing,1375,685,690,49.82
Pantheon,Kled,319,170,149,53.29
Pantheon,Zoe,678,325,353,47.94
Pantheon,Janna,719,382,337,53.13
Pantheon,KSante,1156,638,518,55.19
Pantheon,Shen,1128,586,542,51.95
Pantheon,Jayce,942,473,469,50.21
Pantheon,Ahri,2406,1200,1206,49.88
Pantheon,MasterYi,2277,1103,1174,48.44
Pantheon,Ambessa,1197,633,564,52.88
Pantheon,Briar,1350,650,700,48.15
Pantheon,Braum,1037,513,524,49.47
Pantheon,Nilah,569,277,292,48.68
Pantheon,Graves,1177,561,616,47.66
Pantheon,Taliyah,498,242,256,48.59
Pantheon,Gragas,1155,562,593,48.66
Pantheon,Singed,388,198,190,51.03
Pantheon,TwistedFate,627,333,294,53.11
Pantheon,Ryze,621,315,306,50.72
Pantheon,Corki,751,401,350,53.4
Pantheon,Kaisa,3198,1634,1564,51.09
Pantheon,Kennen,512,256,256,50
Pantheon,Naafiri,585,265,320,45.3
Pantheon,Fiora,717,388,329,54.11
Pantheon,AurelionSol,624,308,316,49.36
Pantheon,Quinn,645,284,361,44.03
Pantheon,Kalista,420,224,196,53.33
Pantheon,Zilean,596,309,287,51.85
Pantheon,Cassiopeia,534,262,272,49.06
Pantheon,Fizz,1091,552,539,50.6
Pantheon,Tryndamere,1006,503,503,50
Pantheon,Ornn,827,388,439,46.92
Pantheon,Evelynn,622,317,305,50.96
Pantheon,Xerath,1684,800,884,47.51
Pantheon,Nunu,923,461,462,49.95
Pantheon,Shyvana,404,204,200,50.5
Pantheon,Maokai,884,414,470,46.83
Pantheon,Alistar,804,407,397,50.62
Pantheon,Ivern,211,111,100,52.61
Pantheon,Belveth,421,236,185,56.06
Pantheon,Karthus,556,276,280,49.64
Pantheon,Zeri,702,330,372,47.01
Pantheon,Olaf,444,199,245,44.82
Pantheon,Renata,227,100,127,44.05
Pantheon,Annie,606,268,338,44.22
Pantheon,Nidalee,601,302,299,50.25
Belveth,Darius,500,243,257,48.6
Belveth,Viego,449,187,262,41.65
Belveth,Viktor,250,133,117,53.2
Belveth,Draven,160,80,80,50
Belveth,Leona,244,120,124,49.18
Belveth,Mordekaiser,358,177,181,49.44
Belveth,Vi,298,151,147,50.67
Belveth,Yone,486,223,263,45.88
Belveth,Caitlyn,709,340,369,47.95
Belveth,Alistar,86,40,46,46.51
Belveth,Heimerdinger,133,63,70,47.37
Belveth,MasterYi,286,145,141,50.7
Belveth,Azir,123,69,54,56.1
Belveth,Varus,284,159,125,55.99
Belveth,Renata,53,26,27,49.06
Belveth,Olaf,50,21,29,42
Belveth,Riven,110,48,62,43.64
Belveth,Hwei,205,123,82,60
Belveth,Swain,283,130,153,45.94
Belveth,Neeko,75,38,37,50.67
Belveth,JarvanIV,182,65,117,35.71
Belveth,Ashe,554,256,298,46.21
Belveth,Yorick,275,130,145,47.27
Belveth,Nunu,137,63,74,45.99
Belveth,Katarina,254,110,144,43.31
Belveth,Sivir,111,63,48,56.76
Belveth,Zyra,255,125,130,49.02
Belveth,Warwick,425,214,211,50.35
Belveth,Kayn,420,191,229,45.48
Belveth,Jinx,830,358,472,43.13
Belveth,Lulu,358,162,196,45.25
Belveth,Volibear,269,134,135,49.81
Belveth,Irelia,184,94,90,51.09
Belveth,Jhin,575,270,305,46.96
Belveth,Karma,338,176,162,52.07
Belveth,KSante,145,64,81,44.14
Belveth,Kalista,67,35,32,52.24
Belveth,Fizz,155,61,94,39.35
Belveth,Thresh,393,199,194,50.64
Belveth,Ryze,120,42,78,35
Belveth,Lux,625,302,323,48.32
Belveth,Taliyah,107,35,72,32.71
Belveth,Nami,308,140,168,45.45
Belveth,Akali,312,162,150,51.92
Belveth,Nocturne,381,146,235,38.32
Belveth,Talon,161,82,79,50.93
Belveth,Ezreal,671,336,335,50.07
Belveth,XinZhao,188,89,99,47.34
Belveth,Vex,132,57,75,43.18
Belveth,Lucian,177,93,84,52.54
Belveth,Sejuani,87,47,40,54.02
Belveth,Galio,278,139,139,50
Belveth,Soraka,211,95,116,45.02
Belveth,Malzahar,268,95,173,35.45
Belveth,Shaco,234,107,127,45.73
Belveth,Ziggs,98,44,54,44.9
Belveth,Nautilus,294,161,133,54.76
Belveth,LeeSin,372,188,184,50.54
Belveth,Vayne,340,168,172,49.41
Belveth,Mel,513,264,249,51.46
Belveth,Poppy,162,59,103,36.42
Belveth,Teemo,353,153,200,43.34
Belveth,Amumu,277,132,145,47.65
Belveth,Ahri,323,185,138,57.28
Belveth,Kayle,198,103,95,52.02
Belveth,Diana,399,193,206,48.37
Belveth,Yasuo,519,284,235,54.72
Belveth,Zeri,127,55,72,43.31
Belveth,MissFortune,624,328,296,52.56
Belveth,Tryndamere,168,88,80,52.38
Belveth,Briar,189,99,90,52.38
Belveth,Zilean,86,35,51,40.7
Belveth,Veigar,239,104,135,43.51
Belveth,Senna,192,92,100,47.92
Belveth,Gragas,163,88,75,53.99
Belveth,Kaisa,466,219,247,47
Belveth,Rengar,95,45,50,47.37
Belveth,Lillia,144,67,77,46.53
Belveth,Lissandra,89,49,40,55.06
Belveth,Pyke,197,117,80,59.39
Belveth,TahmKench,213,117,96,54.93
Belveth,KogMaw,60,31,29,51.67
Belveth,Yuumi,211,124,87,58.77
Belveth,AurelionSol,110,45,65,40.91
Belveth,Samira,136,57,79,41.91
Belveth,Rell,154,73,81,47.4
Belveth,Garen,411,195,216,47.45
Belveth,Nasus,215,102,113,47.44
Belveth,Singed,97,51,46,52.58
Belveth,Seraphine,209,101,108,48.33
Belveth,Aatrox,235,113,122,48.09
Belveth,Skarner,79,54,25,68.35
Belveth,Graves,177,104,73,58.76
Belveth,Syndra,179,93,86,51.96
Belveth,Milio,177,92,85,51.98
Belveth,Sett,355,166,189,46.76
Belveth,Cassiopeia,102,52,50,50.98
Belveth,Janna,95,22,73,23.16
Belveth,Jax,209,79,130,37.8
Belveth,Vladimir,172,75,97,43.6
Belveth,Pantheon,421,185,236,43.94
Belveth,Illaoi,139,64,75,46.04
Belveth,Quinn,109,42,67,38.53
Belveth,FiddleSticks,166,82,84,49.4
Belveth,Morgana,276,149,127,53.99
Belveth,Renekton,132,53,79,40.15
Belveth,Xerath,300,152,148,50.67
Belveth,Udyr,120,64,56,53.33
Belveth,Aphelios,120,64,56,53.33
Belveth,Sion,182,99,83,54.4
Belveth,Ekko,228,106,122,46.49
Belveth,MonkeyKing,153,91,62,59.48
Belveth,Ornn,117,60,57,51.28
Belveth,Akshan,107,33,74,30.84
Belveth,Tristana,320,180,140,56.25
Belveth,Leblanc,163,70,93,42.94
Belveth,Evelynn,77,30,47,38.96
Belveth,Smolder,168,86,82,51.19
Belveth,Shen,178,76,102,42.7
Belveth,Sylas,341,178,163,52.2
Belveth,Urgot,157,55,102,35.03
Belveth,Kassadin,66,27,39,40.91
Belveth,Kled,56,25,31,44.64
Belveth,Kindred,131,66,65,50.38
Belveth,Blitzcrank,162,68,94,41.98
Belveth,Trundle,173,79,94,45.66
Belveth,Karthus,86,45,41,52.33
Belveth,Corki,100,46,54,46
Belveth,DrMundo,120,44,76,36.67
Belveth,Gnar,102,60,42,58.82
Belveth,Bard,76,36,40,47.37
Belveth,Chogath,297,144,153,48.48
Belveth,Annie,109,48,61,44.04
Belveth,Rakan,104,56,48,53.85
Belveth,Gwen,151,65,86,43.05
Belveth,Hecarim,132,56,76,42.42
Belveth,Aurora,188,112,76,59.57
Belveth,Elise,197,88,109,44.67
Belveth,Qiyana,76,23,53,30.26
Belveth,Khazix,145,68,77,46.9
Belveth,Twitch,181,64,117,35.36
Belveth,Gangplank,136,62,74,45.59
Belveth,Orianna,151,73,78,48.34
Belveth,Malphite,295,133,162,45.08
Belveth,Brand,214,95,119,44.39
Belveth,Nilah,104,41,63,39.42
Belveth,Jayce,116,60,56,51.72
Belveth,Zed,267,122,145,45.69
Belveth,Fiora,112,51,61,45.54
Belveth,Zoe,93,28,65,30.11
Belveth,Braum,158,61,97,38.61
Belveth,Rumble,91,44,47,48.35
Belveth,Rammus,95,39,56,41.05
Belveth,Xayah,147,71,76,48.3
Belveth,Sona,95,44,51,46.32
Belveth,Ivern,17,10,7,58.82
Belveth,Zac,100,65,35,65
Belveth,TwistedFate,75,40,35,53.33
Belveth,Maokai,168,69,99,41.07
Belveth,Kennen,55,23,32,41.82
Belveth,Ambessa,190,101,89,53.16
Belveth,Velkoz,157,89,68,56.69
Belveth,Shyvana,60,35,25,58.33
Belveth,Taric,60,45,15,75
Belveth,Naafiri,67,37,30,55.22
Belveth,Camille,83,44,39,53.01
Belveth,Anivia,76,52,24,68.42
Belveth,Nidalee,73,34,39,46.58
Belveth,RekSai,22,14,8,63.64
KogMaw,Darius,727,379,348,52.13
KogMaw,Viego,512,283,229,55.27
KogMaw,Viktor,311,151,160,48.55
KogMaw,Draven,199,84,115,42.21
KogMaw,Leona,278,132,146,47.48
KogMaw,Mordekaiser,474,234,240,49.37
KogMaw,Kayn,531,291,240,54.8
KogMaw,Talon,179,97,82,54.19
KogMaw,MissFortune,800,410,390,51.25
KogMaw,Lulu,527,265,262,50.28
KogMaw,Trundle,230,116,114,50.43
KogMaw,Volibear,507,265,242,52.27
KogMaw,Xayah,134,53,81,39.55
KogMaw,Riven,200,101,99,50.5
KogMaw,Ziggs,141,83,58,58.87
KogMaw,Katarina,292,182,110,62.33
KogMaw,LeeSin,434,244,190,56.22
KogMaw,Lux,908,463,445,50.99
KogMaw,Yone,629,341,288,54.21
KogMaw,Nunu,162,84,78,51.85
KogMaw,Qiyana,80,43,37,53.75
KogMaw,Jinx,1276,693,583,54.31
KogMaw,Morgana,434,232,202,53.46
KogMaw,Gangplank,211,100,111,47.39
KogMaw,Kindred,158,81,77,51.27
KogMaw,Aurora,242,129,113,53.31
KogMaw,Sivir,189,100,89,52.91
KogMaw,Yuumi,334,162,172,48.5
KogMaw,Camille,111,61,50,54.95
KogMaw,Hwei,230,115,115,50
KogMaw,Jhin,701,353,348,50.36
KogMaw,Zyra,284,145,139,51.06
KogMaw,Quinn,149,79,70,53.02
KogMaw,Jax,338,172,166,50.89
KogMaw,Lucian,233,125,108,53.65
KogMaw,Mel,722,418,304,57.89
KogMaw,Briar,311,130,181,41.8
KogMaw,Maokai,179,90,89,50.28
KogMaw,Xerath,293,155,138,52.9
KogMaw,Ezreal,754,405,349,53.71
KogMaw,Garen,587,317,270,54
KogMaw,Zed,314,181,133,57.64
KogMaw,Leblanc,214,117,97,54.67
KogMaw,Twitch,415,194,221,46.75
KogMaw,Karma,438,201,237,45.89
KogMaw,Vayne,583,315,268,54.03
KogMaw,XinZhao,234,127,107,54.27
KogMaw,Chogath,471,249,222,52.87
KogMaw,Nilah,75,31,44,41.33
KogMaw,Thresh,468,255,213,54.49
KogMaw,Irelia,297,170,127,57.24
KogMaw,Varus,332,194,138,58.43
KogMaw,Kayle,256,113,143,44.14
KogMaw,Sion,307,163,144,53.09
KogMaw,Sejuani,179,77,102,43.02
KogMaw,Akali,347,211,136,60.81
KogMaw,Pantheon,510,284,226,55.69
KogMaw,Gwen,189,97,92,51.32
KogMaw,Lillia,202,121,81,59.9
KogMaw,Seraphine,261,116,145,44.44
KogMaw,Ornn,116,68,48,58.62
KogMaw,Singed,76,44,32,57.89
KogMaw,TwistedFate,99,63,36,63.64
KogMaw,Ashe,774,427,347,55.17
KogMaw,Shen,237,142,95,59.92
KogMaw,Samira,233,100,133,42.92
KogMaw,TahmKench,275,116,159,42.18
KogMaw,Urgot,160,63,97,39.38
KogMaw,Yasuo,653,323,330,49.46
KogMaw,Nasus,282,132,150,46.81
KogMaw,Aatrox,277,181,96,65.34
KogMaw,Fizz,220,104,116,47.27
KogMaw,Galio,264,124,140,46.97
KogMaw,Smolder,209,113,96,54.07
KogMaw,Milio,256,115,141,44.92
KogMaw,Nocturne,443,204,239,46.05
KogMaw,Kaisa,561,337,224,60.07
KogMaw,Kennen,83,38,45,45.78
KogMaw,Malzahar,396,204,192,51.52
KogMaw,Janna,131,67,64,51.15
KogMaw,DrMundo,220,109,111,49.55
KogMaw,Amumu,408,208,200,50.98
KogMaw,Ekko,344,168,176,48.84
KogMaw,Poppy,209,115,94,55.02
KogMaw,Khazix,173,103,70,59.54
KogMaw,Nautilus,338,205,133,60.65
KogMaw,Teemo,485,248,237,51.13
KogMaw,Vi,344,187,157,54.36
KogMaw,Ahri,467,244,223,52.25
KogMaw,Karthus,142,67,75,47.18
KogMaw,Brand,278,131,147,47.12
KogMaw,Diana,549,271,278,49.36
KogMaw,Warwick,574,311,263,54.18
KogMaw,Evelynn,144,65,79,45.14
KogMaw,Graves,202,86,116,42.57
KogMaw,Aphelios,163,69,94,42.33
KogMaw,Swain,396,214,182,54.04
KogMaw,Zoe,148,81,67,54.73
KogMaw,Nami,379,185,194,48.81
KogMaw,Zilean,134,69,65,51.49
KogMaw,MasterYi,374,198,176,52.94
KogMaw,Anivia,115,64,51,55.65
KogMaw,Braum,233,151,82,64.81
KogMaw,Caitlyn,1004,501,503,49.9
KogMaw,Taric,97,45,52,46.39
KogMaw,Blitzcrank,230,127,103,55.22
KogMaw,Pyke,252,119,133,47.22
KogMaw,Yorick,351,171,180,48.72
KogMaw,Sona,184,101,83,54.89
KogMaw,JarvanIV,237,131,106,55.27
KogMaw,Skarner,84,66,18,78.57
KogMaw,FiddleSticks,228,118,110,51.75
KogMaw,Shaco,281,139,142,49.47
KogMaw,Veigar,398,229,169,57.54
KogMaw,Malphite,359,163,196,45.4
KogMaw,Belveth,60,29,31,48.33
KogMaw,Sylas,432,211,221,48.84
KogMaw,Tristana,371,180,191,48.52
KogMaw,Rell,170,93,77,54.71
KogMaw,Tryndamere,207,93,114,44.93
KogMaw,Kassadin,75,41,34,54.67
KogMaw,Fiora,133,76,57,57.14
KogMaw,Kalista,67,36,31,53.73
KogMaw,Illaoi,181,83,98,45.86
KogMaw,Neeko,151,79,72,52.32
KogMaw,Orianna,150,72,78,48
KogMaw,Rengar,87,51,36,58.62
KogMaw,Syndra,267,125,142,46.82
KogMaw,Jayce,159,91,68,57.23
KogMaw,Taliyah,95,60,35,63.16
KogMaw,Gragas,189,90,99,47.62
KogMaw,Zac,139,62,77,44.6
KogMaw,Elise,263,136,127,51.71
KogMaw,KSante,190,99,91,52.11
KogMaw,Ryze,142,62,80,43.66
KogMaw,Renata,69,41,28,59.42
KogMaw,Kled,79,33,46,41.77
KogMaw,Vladimir,264,125,139,47.35
KogMaw,Soraka,202,99,103,49.01
KogMaw,Rakan,113,49,64,43.36
KogMaw,Rumble,115,69,46,60
KogMaw,Udyr,179,110,69,61.45
KogMaw,Sett,573,317,256,55.32
KogMaw,Senna,303,161,142,53.14
KogMaw,Lissandra,126,76,50,60.32
KogMaw,Ivern,57,43,14,75.44
KogMaw,Renekton,172,95,77,55.23
KogMaw,Bard,107,67,40,62.62
KogMaw,Alistar,111,62,49,55.86
KogMaw,MonkeyKing,226,123,103,54.42
KogMaw,Vex,167,73,94,43.71
KogMaw,Cassiopeia,94,49,45,52.13
KogMaw,Rammus,113,55,58,48.67
KogMaw,Naafiri,110,54,56,49.09
KogMaw,Zeri,100,41,59,41
KogMaw,Ambessa,256,137,119,53.52
KogMaw,Olaf,76,40,36,52.63
KogMaw,Heimerdinger,185,98,87,52.97
KogMaw,Hecarim,163,84,79,51.53
KogMaw,Gnar,134,60,74,44.78
KogMaw,AurelionSol,138,39,99,28.26
KogMaw,Annie,118,49,69,41.53
KogMaw,Azir,102,54,48,52.94
KogMaw,Corki,155,95,60,61.29
KogMaw,Akshan,143,77,66,53.85
KogMaw,Velkoz,221,111,110,50.23
KogMaw,Shyvana,71,40,31,56.34
KogMaw,Nidalee,103,42,61,40.78
KogMaw,RekSai,40,15,25,37.5
Darius,Pantheon,3477,1741,1736,50.07
Darius,Belveth,500,257,243,51.4
Darius,Katarina,1675,857,818,51.16
Darius,KogMaw,727,348,379,47.87
Darius,Lux,5734,2859,2875,49.86
Darius,Warwick,3756,1842,1914,49.04
Darius,Vi,2083,1030,1053,49.45
Darius,Irelia,1673,875,798,52.3
Darius,Caitlyn,6112,3066,3046,50.16
Darius,Nautilus,2514,1263,1251,50.24
Darius,Trundle,1327,610,717,45.97
Darius,Briar,1702,800,902,47
Darius,Jhin,4650,2277,2373,48.97
Darius,Pyke,1726,859,867,49.77
Darius,Gnar,957,454,503,47.44
Darius,Diana,3693,1829,1864,49.53
Darius,Chogath,2715,1327,1388,48.88
Darius,Jinx,6390,3142,3248,49.17
Darius,Nami,2178,1080,1098,49.59
Darius,Mordekaiser,3335,1624,1711,48.7
Darius,Kayn,3403,1693,1710,49.75
Darius,Talon,1245,646,599,51.89
Darius,MissFortune,5450,2626,2824,48.18
Darius,Lulu,2715,1416,1299,52.15
Darius,Malphite,2068,1097,971,53.05
Darius,Hwei,1544,752,792,48.7
Darius,Twitch,1852,916,936,49.46
Darius,Milio,1339,654,685,48.84
Darius,Jayce,974,461,513,47.33
Darius,Kennen,687,390,297,56.77
Darius,Lucian,1569,778,791,49.59
Darius,Elise,1464,712,752,48.63
Darius,Gangplank,998,499,499,50
Darius,FiddleSticks,1127,530,597,47.03
Darius,Yone,3933,2113,1820,53.72
Darius,Varus,1881,1014,867,53.91
Darius,Zilean,680,327,353,48.09
Darius,Sett,4183,1965,2218,46.98
Darius,Nocturne,2810,1305,1505,46.44
Darius,Azir,732,368,364,50.27
Darius,Ezreal,4980,2678,2302,53.78
Darius,Qiyana,542,306,236,56.46
Darius,Teemo,2942,1428,1514,48.54
Darius,Jax,1905,994,911,52.18
Darius,Fizz,1417,769,648,54.27
Darius,Kaisa,3517,1799,1718,51.15
Darius,Morgana,2574,1243,1331,48.29
Darius,Yorick,2277,1009,1268,44.31
Darius,Viktor,1816,913,903,50.28
Darius,Corki,911,468,443,51.37
Darius,Seraphine,1652,779,873,47.15
Darius,Yasuo,4436,2320,2116,52.3
Darius,Zed,2482,1352,1130,54.47
Darius,Xerath,1881,922,959,49.02
Darius,Shaco,2063,1063,1000,51.53
Darius,Soraka,1152,583,569,50.61
Darius,Rammus,683,339,344,49.63
Darius,Ekko,2072,1061,1011,51.21
Darius,Swain,2118,1063,1055,50.19
Darius,Karma,2504,1288,1216,51.44
Darius,Samira,1538,780,758,50.72
Darius,Janna,827,416,411,50.3
Darius,MonkeyKing,1743,879,864,50.43
Darius,Vayne,3349,1646,1703,49.15
Darius,Bard,681,388,293,56.98
Darius,LeeSin,3166,1685,1481,53.22
Darius,Garen,4119,2134,1985,51.81
Darius,Akshan,843,424,419,50.3
Darius,Tristana,2293,1185,1108,51.68
Darius,Shen,1361,708,653,52.02
Darius,Amumu,2340,1094,1246,46.75
Darius,Akali,2106,1063,1043,50.47
Darius,TahmKench,1701,889,812,52.26
Darius,Kassadin,487,241,246,49.49
Darius,Volibear,3016,1553,1463,51.49
Darius,Rengar,698,373,325,53.44
Darius,Malzahar,2383,1174,1209,49.27
Darius,Udyr,1105,537,568,48.6
Darius,Mel,4360,2341,2019,53.69
Darius,Nidalee,561,312,249,55.61
Darius,Graves,1416,740,676,52.26
Darius,DrMundo,1374,633,741,46.07
Darius,Lillia,1174,633,541,53.92
Darius,Yuumi,1713,890,823,51.96
Darius,Maokai,1030,486,544,47.18
Darius,Sion,1692,806,886,47.64
Darius,Ryze,815,378,437,46.38
Darius,Leona,1918,888,1030,46.3
Darius,Alistar,884,458,426,51.81
Darius,Olaf,503,285,218,56.66
Darius,Vladimir,1521,821,700,53.98
Darius,Renekton,1164,585,579,50.26
Darius,Viego,3267,1687,1580,51.64
Darius,Thresh,2978,1502,1476,50.44
Darius,Ashe,4524,2319,2205,51.26
Darius,Naafiri,721,365,356,50.62
Darius,Kayle,1612,766,846,47.52
Darius,Sejuani,907,478,429,52.7
Darius,Xayah,967,498,469,51.5
Darius,Rakan,874,443,431,50.69
Darius,Taliyah,500,230,270,46
Darius,Zyra,2208,965,1243,43.7
Darius,Neeko,1037,568,469,54.77
Darius,Gragas,1097,602,495,54.88
Darius,Galio,1868,910,958,48.72
Darius,Camille,762,368,394,48.29
Darius,Poppy,1163,578,585,49.7
Darius,Velkoz,1419,698,721,49.19
Darius,Nunu,1238,606,632,48.95
Darius,Ahri,2880,1449,1431,50.31
Darius,Senna,1742,857,885,49.2
Darius,Veigar,2343,1115,1228,47.59
Darius,Ziggs,805,390,415,48.45
Darius,Aurora,1618,803,815,49.63
Darius,Sivir,1090,502,588,46.06
Darius,Riven,1094,505,589,46.16
Darius,Ivern,288,155,133,53.82
Darius,Sylas,2681,1346,1335,50.21
Darius,Braum,1241,611,630,49.23
Darius,Orianna,952,471,481,49.47
Darius,Skarner,541,297,244,54.9
Darius,Brand,1797,871,926,48.47
Darius,Gwen,1010,510,500,50.5
Darius,KSante,1156,610,546,52.77
Darius,Karthus,687,354,333,51.53
Darius,Evelynn,722,372,350,51.52
Darius,Nasus,1545,788,757,51
Darius,Tryndamere,1409,752,657,53.37
Darius,Kled,422,237,185,56.16
Darius,Urgot,1263,619,644,49.01
Darius,Leblanc,1137,570,567,50.13
Darius,Heimerdinger,1188,576,612,48.48
Darius,MasterYi,2788,1393,1395,49.96
Darius,Rell,1002,456,546,45.51
Darius,Draven,1115,571,544,51.21
Darius,Nilah,658,308,350,46.81
Darius,Taric,556,280,276,50.36
Darius,Blitzcrank,1641,875,766,53.32
Darius,Aatrox,1921,990,931,51.54
Darius,Kindred,1021,514,507,50.34
Darius,Shyvana,592,302,290,51.01
Darius,Vex,1020,467,553,45.78
Darius,Cassiopeia,640,344,296,53.75
Darius,Fiora,706,368,338,52.12
Darius,Zeri,745,409,336,54.9
Darius,Quinn,972,476,496,48.97
Darius,Illaoi,1081,511,570,47.27
Darius,Ornn,938,476,462,50.75
Darius,Renata,327,189,138,57.8
Darius,Syndra,1433,707,726,49.34
Darius,Ambessa,1312,750,562,57.16
Darius,AurelionSol,852,424,428,49.77
Darius,Khazix,1077,564,513,52.37
Darius,Annie,712,373,339,52.39
Darius,Hecarim,933,515,418,55.2
Darius,Lissandra,697,361,336,51.79
Darius,XinZhao,1404,676,728,48.15
Darius,JarvanIV,1272,643,629,50.55
Darius,Kalista,465,267,198,57.42
Darius,Smolder,1499,792,707,52.84
Darius,Anivia,724,335,389,46.27
Darius,Aphelios,1181,618,563,52.33
Darius,Zac,944,482,462,51.06
Darius,TwistedFate,692,381,311,55.06
Darius,Sona,742,376,366,50.67
Darius,Rumble,526,308,218,58.56
Darius,Singed,561,278,283,49.55
Darius,RekSai,286,152,134,53.15
Darius,Zoe,779,352,427,45.19
Leona,Pantheon,1685,833,852,49.44
Leona,Belveth,244,124,120,50.82
Leona,Katarina,779,394,385,50.58
Leona,KogMaw,278,146,132,52.52
Leona,Lux,2723,1422,1301,52.22
Leona,Yasuo,1981,942,1039,47.55
Leona,Kayn,1565,783,782,50.03
Leona,Mel,2382,1273,1109,53.44
Leona,Xayah,519,272,247,52.41
Leona,Rakan,369,177,192,47.97
Leona,Aatrox,860,397,463,46.16
Leona,Draven,544,292,252,53.68
Leona,Blitzcrank,972,524,448,53.91
Leona,Maokai,477,266,211,55.77
Leona,MasterYi,1422,777,645,54.64
Leona,Samira,733,375,358,51.16
Leona,Pyke,800,380,420,47.5
Leona,Nasus,749,372,377,49.67
Leona,Diana,1643,781,862,47.53
Leona,Renekton,589,310,279,52.63
Leona,Veigar,977,475,502,48.62
Leona,Seraphine,719,326,393,45.34
Leona,Irelia,994,477,517,47.99
Leona,Briar,756,344,412,45.5
Leona,Vayne,1426,675,751,47.34
Leona,Olaf,272,137,135,50.37
Leona,Leblanc,590,314,276,53.22
Leona,Jinx,2935,1396,1539,47.56
Leona,Karma,1161,515,646,44.36
Leona,RekSai,93,47,46,50.54
Leona,Ahri,1313,650,663,49.5
Leona,Malphite,1092,537,555,49.18
Leona,Chogath,1307,692,615,52.95
Leona,Sylas,1594,828,766,51.94
Leona,Ashe,2027,968,1059,47.76
Leona,Morgana,1334,639,695,47.9
Leona,Kaisa,1688,849,839,50.3
Leona,Tristana,1025,523,502,51.02
Leona,Swain,1033,462,571,44.72
Leona,Darius,1918,1030,888,53.7
Leona,Viego,1507,735,772,48.77
Leona,Taliyah,236,109,127,46.19
Leona,Jax,1014,481,533,47.44
Leona,MonkeyKing,695,343,352,49.35
Leona,Caitlyn,2794,1373,1421,49.14
Leona,Poppy,880,436,444,49.55
Leona,Gnar,362,169,193,46.69
Leona,Vladimir,680,356,324,52.35
Leona,Twitch,715,349,366,48.81
Leona,Lulu,1119,539,580,48.17
Leona,Warwick,1566,765,801,48.85
Leona,Skarner,277,152,125,54.87
Leona,Teemo,1329,632,697,47.55
Leona,Nocturne,1400,643,757,45.93
Leona,Ezreal,2660,1329,1331,49.96
Leona,Nami,894,448,446,50.11
Leona,Vi,971,450,521,46.34
Leona,Kayle,639,268,371,41.94
Leona,TahmKench,827,401,426,48.49
Leona,Mordekaiser,1374,614,760,44.69
Leona,MissFortune,2298,1148,1150,49.96
Leona,Heimerdinger,410,195,215,47.56
Leona,Rammus,366,170,196,46.45
Leona,LeeSin,1466,780,686,53.21
Leona,Karthus,288,141,147,48.96
Leona,Fizz,662,351,311,53.02
Leona,Jhin,2010,984,1026,48.96
Leona,Corki,385,180,205,46.75
Leona,Soraka,583,233,350,39.97
Leona,Shaco,916,421,495,45.96
Leona,Zilean,273,116,157,42.49
Leona,Malzahar,1027,467,560,45.47
Leona,Rell,553,259,294,46.84
Leona,JarvanIV,487,238,249,48.87
Leona,Yuumi,878,474,404,53.99
Leona,Evelynn,315,149,166,47.3
Leona,Yone,1891,974,917,51.51
Leona,Thresh,1561,761,800,48.75
Leona,Cassiopeia,296,147,149,49.66
Leona,Riven,398,216,182,54.27
Leona,Viktor,858,431,427,50.23
Leona,Neeko,454,216,238,47.58
Leona,Gangplank,426,206,220,48.36
Leona,Ekko,1013,516,497,50.94
Leona,Kassadin,200,104,96,52
Leona,Varus,926,531,395,57.34
Leona,Sejuani,385,202,183,52.47
Leona,Zed,1108,527,581,47.56
Leona,Illaoi,493,244,249,49.49
Leona,Amumu,1205,553,652,45.89
Leona,Rengar,297,150,147,50.51
Leona,Sett,1601,767,834,47.91
Leona,Brand,814,390,424,47.91
Leona,Elise,631,296,335,46.91
Leona,Nautilus,1262,666,596,52.77
Leona,Smolder,624,324,300,51.92
Leona,Orianna,470,217,253,46.17
Leona,Hwei,613,323,290,52.69
Leona,Garen,1642,782,860,47.62
Leona,Yorick,1006,493,513,49.01
Leona,Quinn,328,174,154,53.05
Leona,Kindred,404,216,188,53.47
Leona,Azir,366,201,165,54.92
Leona,Kalista,198,103,95,52.02
Leona,Sona,294,146,148,49.66
Leona,Zyra,1071,481,590,44.91
Leona,Xerath,925,505,420,54.59
Leona,Khazix,380,180,200,47.37
Leona,Ziggs,327,186,141,56.88
Leona,Braum,722,329,393,45.57
Leona,Volibear,1147,588,559,51.26
Leona,Lillia,622,336,286,54.02
Leona,Gragas,550,274,276,49.82
Leona,Ambessa,615,306,309,49.76
Leona,Bard,271,133,138,49.08
Leona,Akali,1043,539,504,51.68
Leona,Naafiri,350,156,194,44.57
Leona,FiddleSticks,502,253,249,50.4
Leona,Graves,610,311,299,50.98
Leona,Ivern,133,58,75,43.61
Leona,TwistedFate,299,147,152,49.16
Leona,Fiora,374,219,155,58.56
Leona,Ryze,391,182,209,46.55
Leona,Sivir,642,284,358,44.24
Leona,Milio,576,282,294,48.96
Leona,DrMundo,582,299,283,51.37
Leona,Gwen,449,217,232,48.33
Leona,Jayce,486,241,245,49.59
Leona,Sion,702,306,396,43.59
Leona,Velkoz,610,296,314,48.52
Leona,KSante,529,277,252,52.36
Leona,AurelionSol,440,229,211,52.05
Leona,Kled,214,115,99,53.74
Leona,Trundle,602,302,300,50.17
Leona,XinZhao,697,340,357,48.78
Leona,Taric,271,132,139,48.71
Leona,Aurora,709,349,360,49.22
Leona,Zac,438,192,246,43.84
Leona,Alistar,559,271,288,48.48
Leona,Zoe,348,169,179,48.56
Leona,Galio,989,468,521,47.32
Leona,Lucian,626,356,270,56.87
Leona,Akshan,352,169,183,48.01
Leona,Hecarim,428,225,203,52.57
Leona,Singed,243,109,134,44.86
Leona,Shen,644,326,318,50.62
Leona,Rumble,315,167,148,53.02
Leona,Ornn,447,199,248,44.52
Leona,Syndra,686,326,360,47.52
Leona,Nunu,543,298,245,54.88
Leona,Anivia,327,167,160,51.07
Leona,Lissandra,330,141,189,42.73
Leona,Camille,325,128,197,39.38
Leona,Urgot,484,218,266,45.04
Leona,Shyvana,299,146,153,48.83
Leona,Renata,151,86,65,56.95
Leona,Udyr,440,228,212,51.82
Leona,Senna,586,306,280,52.22
Leona,Vex,557,311,246,55.83
Leona,Nilah,313,132,181,42.17
Leona,Qiyana,219,92,127,42.01
Leona,Zeri,421,200,221,47.51
Leona,Annie,374,199,175,53.21
Leona,Tryndamere,497,286,211,57.55
Leona,Aphelios,537,255,282,47.49
Leona,Janna,369,166,203,44.99
Leona,Nidalee,280,175,105,62.5
Leona,Talon,549,255,294,46.45
Leona,Kennen,220,94,126,42.73
Qiyana,Warwick,366,143,223,39.07
Qiyana,Vi,202,91,111,45.05
Qiyana,Irelia,267,142,125,53.18
Qiyana,Caitlyn,823,372,451,45.2
Qiyana,Nautilus,326,161,165,49.39
Qiyana,Darius,542,236,306,43.54
Qiyana,Lillia,166,72,94,43.37
Qiyana,Garen,489,215,274,43.97
Qiyana,Pyke,247,139,108,56.28
Qiyana,Kayn,457,177,280,38.73
Qiyana,Rengar,112,59,53,52.68
Qiyana,Fizz,145,67,78,46.21
Qiyana,KogMaw,80,37,43,46.25
Qiyana,Lux,681,301,380,44.2
Qiyana,Sett,383,155,228,40.47
Qiyana,Aurora,258,128,130,49.61
Qiyana,Aphelios,182,83,99,45.6
Qiyana,Bard,116,37,79,31.9
Qiyana,Yorick,265,126,139,47.55
Qiyana,Syndra,201,99,102,49.25
Qiyana,Samira,214,113,101,52.8
Qiyana,Pantheon,464,206,258,44.4
Qiyana,Camille,100,51,49,51
Qiyana,Shaco,295,134,161,45.42
Qiyana,Ekko,295,116,179,39.32
Qiyana,Tristana,314,120,194,38.22
Qiyana,Thresh,342,162,180,47.37
Qiyana,Nunu,170,73,97,42.94
Qiyana,Katarina,289,118,171,40.83
Qiyana,Sivir,158,68,90,43.04
Qiyana,Zyra,276,131,145,47.46
Qiyana,Malphite,344,174,170,50.58
Qiyana,Akali,338,176,162,52.07
Qiyana,Jhin,665,320,345,48.12
Qiyana,Rell,133,54,79,40.6
Qiyana,KSante,158,97,61,61.39
Qiyana,Gragas,175,85,90,48.57
Qiyana,Jax,266,112,154,42.11
Qiyana,Evelynn,92,47,45,51.09
Qiyana,Ashe,609,312,297,51.23
Qiyana,Yasuo,570,261,309,45.79
Qiyana,Kaisa,476,266,210,55.88
Qiyana,Soraka,137,58,79,42.34
Qiyana,Gwen,131,69,62,52.67
Qiyana,Amumu,296,135,161,45.61
Qiyana,Jinx,725,340,385,46.9
Qiyana,Renata,32,14,18,43.75
Qiyana,Gangplank,90,51,39,56.67
Qiyana,Graves,211,83,128,39.34
Qiyana,Vladimir,210,92,118,43.81
Qiyana,Elise,281,126,155,44.84
Qiyana,JarvanIV,161,52,109,32.3
Qiyana,Yone,508,240,268,47.24
Qiyana,Vayne,367,186,181,50.68
Qiyana,Velkoz,219,101,118,46.12
Qiyana,Rumble,79,31,48,39.24
Qiyana,Jayce,188,89,99,47.34
Qiyana,Nami,335,153,182,45.67
Qiyana,Heimerdinger,120,55,65,45.83
Qiyana,Diana,482,218,264,45.23
Qiyana,Karma,447,214,233,47.87
Qiyana,Teemo,293,115,178,39.25
Qiyana,Volibear,334,173,161,51.8
Qiyana,Kassadin,76,43,33,56.58
Qiyana,Trundle,149,63,86,42.28
Qiyana,Vex,200,96,104,48
Qiyana,Kayle,186,97,89,52.15
Qiyana,Mel,578,299,279,51.73
Qiyana,Lucian,206,102,104,49.51
Qiyana,Illaoi,120,49,71,40.83
Qiyana,MissFortune,631,295,336,46.75
Qiyana,Azir,117,40,77,34.19
Qiyana,Milio,214,110,104,51.4
Qiyana,Urgot,128,47,81,36.72
Qiyana,MasterYi,426,223,203,52.35
Qiyana,Yuumi,222,97,125,43.69
Qiyana,Ornn,124,41,83,33.06
Qiyana,Zeri,146,73,73,50
Qiyana,Zed,411,195,216,47.45
Qiyana,Draven,160,68,92,42.5
Qiyana,Twitch,236,99,137,41.95
Qiyana,Riven,183,88,95,48.09
Qiyana,Skarner,75,36,39,48
Qiyana,Ezreal,726,317,409,43.66
Qiyana,Xerath,227,84,143,37
Qiyana,Ambessa,197,92,105,46.7
Qiyana,Hwei,186,67,119,36.02
Qiyana,Kindred,126,51,75,40.48
Qiyana,Nilah,87,36,51,41.38
Qiyana,Gnar,121,56,65,46.28
Qiyana,Ahri,378,190,188,50.26
Qiyana,Rakan,91,43,48,47.25
Qiyana,Blitzcrank,213,110,103,51.64
Qiyana,Fiora,136,70,66,51.47
Qiyana,Zac,139,55,84,39.57
Qiyana,Kalista,84,31,53,36.9
Qiyana,Orianna,196,107,89,54.59
Qiyana,Nasus,194,106,88,54.64
Qiyana,Smolder,182,103,79,56.59
Qiyana,Seraphine,185,97,88,52.43
Qiyana,Swain,232,96,136,41.38
Qiyana,Hecarim,126,60,66,47.62
Qiyana,Sion,231,112,119,48.48
Qiyana,Galio,205,101,104,49.27
Qiyana,Poppy,195,101,94,51.79
Qiyana,Ryze,114,57,57,50
Qiyana,Zoe,149,53,96,35.57
Qiyana,LeeSin,447,222,225,49.66
Qiyana,Lissandra,116,46,70,39.66
Qiyana,Sylas,433,232,201,53.58
Qiyana,Aatrox,312,153,159,49.04
Qiyana,Shyvana,71,26,45,36.62
Qiyana,Lulu,458,245,213,53.49
Qiyana,Shen,200,95,105,47.5
Qiyana,Chogath,309,134,175,43.37
Qiyana,Renekton,155,72,83,46.45
Qiyana,TahmKench,187,78,109,41.71
Qiyana,Alistar,131,67,64,51.15
Qiyana,Malzahar,256,109,147,42.58
Qiyana,Xayah,152,73,79,48.03
Qiyana,Cassiopeia,88,49,39,55.68
Qiyana,Viktor,266,124,142,46.62
Qiyana,Nidalee,85,36,49,42.35
Qiyana,Senna,218,89,129,40.83
Qiyana,Leblanc,140,77,63,55
Qiyana,Varus,262,113,149,43.13
Qiyana,DrMundo,137,59,78,43.07
Qiyana,Brand,184,69,115,37.5
Qiyana,Khazix,194,122,72,62.89
Qiyana,Udyr,136,60,76,44.12
Qiyana,Viego,486,236,250,48.56
Qiyana,Karthus,100,50,50,50
Qiyana,Morgana,279,136,143,48.75
Qiyana,FiddleSticks,131,72,59,54.96
Qiyana,Mordekaiser,299,145,154,48.49
Qiyana,Zilean,104,48,56,46.15
Qiyana,Annie,91,47,44,51.65
Qiyana,Neeko,97,37,60,38.14
Qiyana,TwistedFate,93,35,58,37.63
Qiyana,Janna,160,78,82,48.75
Qiyana,Nocturne,382,153,229,40.05
Qiyana,Rammus,64,23,41,35.94
Qiyana,Braum,130,66,64,50.77
Qiyana,XinZhao,180,105,75,58.33
Qiyana,MonkeyKing,206,95,111,46.12
Qiyana,Talon,183,99,84,54.1
Qiyana,Singed,66,31,35,46.97
Qiyana,Leona,219,127,92,57.99
Qiyana,Briar,173,80,93,46.24
Qiyana,Anivia,79,35,44,44.3
Qiyana,Corki,148,70,78,47.3
Qiyana,Taliyah,93,42,51,45.16
Qiyana,Naafiri,93,34,59,36.56
Qiyana,Kled,57,24,33,42.11
Qiyana,Veigar,293,167,126,57
Qiyana,Tryndamere,214,105,109,49.07
Qiyana,Akshan,123,57,66,46.34
Qiyana,Sejuani,99,59,40,59.6
Qiyana,Ziggs,96,55,41,57.29
Qiyana,Quinn,85,33,52,38.82
Qiyana,Belveth,76,53,23,69.74
Qiyana,Sona,69,29,40,42.03
Qiyana,Olaf,90,38,52,42.22
Qiyana,Maokai,126,39,87,30.95
Qiyana,Kennen,62,31,31,50
Qiyana,Ivern,30,19,11,63.33
Qiyana,Taric,65,23,42,35.38
Qiyana,AurelionSol,104,56,48,53.85
Qiyana,RekSai,28,11,17,39.29
Swain,Warwick,1794,913,881,50.89
Swain,Vi,1045,555,490,53.11
Swain,Irelia,984,484,500,49.19
Swain,Caitlyn,3180,1521,1659,47.83
Swain,Nautilus,1370,768,602,56.06
Swain,Aurora,784,421,363,53.7
Swain,Corki,381,223,158,58.53
Swain,Orianna,403,220,183,54.59
Swain,Xayah,479,241,238,50.31
Swain,Nami,993,480,513,48.34
Swain,Diana,1794,888,906,49.5
Swain,Fizz,666,348,318,52.25
Swain,Vayne,1523,725,798,47.6
Swain,Yuumi,852,408,444,47.89
Swain,Darius,2118,1055,1063,49.81
Swain,Mel,2233,1154,1079,51.68
Swain,Jinx,3297,1659,1638,50.32
Swain,Thresh,1611,872,739,54.13
Swain,Malphite,1209,662,547,54.76
Swain,Shyvana,338,151,187,44.67
Swain,Naafiri,341,189,152,55.43
Swain,MissFortune,2963,1528,1435,51.57
Swain,Maokai,503,260,243,51.69
Swain,Sejuani,459,261,198,56.86
Swain,Yone,2014,1048,966,52.04
Swain,Ezreal,2469,1348,1121,54.6
Swain,Milio,560,267,293,47.68
Swain,Sett,1829,869,960,47.51
Swain,Hecarim,430,231,199,53.72
Swain,Graves,706,387,319,54.82
Swain,Jhin,2323,1228,1095,52.86
Swain,Karma,1254,624,630,49.76
Swain,Azir,392,210,182,53.57
Swain,Lux,3098,1537,1561,49.61
Swain,Rammus,321,174,147,54.21
Swain,MasterYi,1380,665,715,48.19
Swain,Katarina,877,439,438,50.06
Swain,Aphelios,569,315,254,55.36
Swain,Poppy,585,320,265,54.7
Swain,Aatrox,975,520,455,53.33
Swain,Evelynn,352,211,141,59.94
Swain,Kaisa,1852,1022,830,55.18
Swain,Zilean,384,187,197,48.7
Swain,Volibear,1434,754,680,52.58
Swain,JarvanIV,608,308,300,50.66
Swain,Zed,1295,673,622,51.97
Swain,Lucian,689,386,303,56.02
Swain,Mordekaiser,1565,743,822,47.48
Swain,Talon,594,276,318,46.46
Swain,Malzahar,1382,669,713,48.41
Swain,Leona,1033,571,462,55.28
Swain,Olaf,222,110,112,49.55
Swain,LeeSin,1575,833,742,52.89
Swain,Nasus,926,470,456,50.76
Swain,Kindred,593,292,301,49.24
Swain,Ashe,2366,1197,1169,50.59
Swain,Shaco,1172,639,533,54.52
Swain,TahmKench,904,484,420,53.54
Swain,Kayn,1565,812,753,51.88
Swain,Akali,1246,650,596,52.17
Swain,Sona,401,201,200,50.12
Swain,Belveth,283,153,130,54.06
Swain,Syndra,663,354,309,53.39
Swain,Lulu,1404,729,675,51.92
Swain,Camille,319,172,147,53.92
Swain,Lissandra,353,177,176,50.14
Swain,Smolder,734,393,341,53.54
Swain,Zyra,1043,483,560,46.31
Swain,Sion,801,441,360,55.06
Swain,Vladimir,815,394,421,48.34
Swain,Amumu,1261,628,633,49.8
Swain,Tristana,1181,597,584,50.55
Swain,Ambessa,668,378,290,56.59
Swain,Briar,827,399,428,48.25
Swain,Yorick,1202,636,566,52.91
Swain,Pantheon,1849,964,885,52.14
Swain,Twitch,945,480,465,50.79
Swain,Neeko,533,298,235,55.91
Swain,Ekko,1017,541,476,53.2
Swain,Ahri,1693,902,791,53.28
Swain,Kennen,284,128,156,45.07
Swain,Soraka,686,347,339,50.58
Swain,Draven,520,284,236,54.62
Swain,Velkoz,696,397,299,57.04
Swain,Gnar,499,244,255,48.9
Swain,Nidalee,295,167,128,56.61
Swain,Yasuo,2352,1243,1109,52.85
Swain,Trundle,734,367,367,50
Swain,Ryze,369,199,170,53.93
Swain,Singed,356,174,182,48.88
Swain,Viktor,938,472,466,50.32
Swain,Veigar,1196,612,584,51.17
Swain,Senna,941,486,455,51.65
Swain,Rumble,244,114,130,46.72
Swain,Seraphine,842,433,409,51.43
Swain,Pyke,948,513,435,54.11
Swain,Sylas,1792,999,793,55.75
Swain,Renekton,575,316,259,54.96
Swain,Blitzcrank,789,430,359,54.5
Swain,MonkeyKing,825,428,397,51.88
Swain,Ziggs,419,214,205,51.07
Swain,KSante,533,275,258,51.59
Swain,Kalista,251,119,132,47.41
Swain,Fiora,393,177,216,45.04
Swain,Udyr,512,257,255,50.2
Swain,Kassadin,244,123,121,50.41
Swain,Galio,1061,517,544,48.73
Swain,Rengar,330,180,150,54.55
Swain,Quinn,393,196,197,49.87
Swain,Chogath,1442,707,735,49.03
Swain,Teemo,1521,744,777,48.92
Swain,Riven,501,247,254,49.3
Swain,Elise,693,329,364,47.47
Swain,Brand,1018,513,505,50.39
Swain,Jax,1146,635,511,55.41
Swain,Samira,818,464,354,56.72
Swain,Nunu,560,304,256,54.29
Swain,Nocturne,1389,745,644,53.64
Swain,Heimerdinger,592,279,313,47.13
Swain,Janna,397,191,206,48.11
Swain,Cassiopeia,392,200,192,51.02
Swain,Skarner,268,160,108,59.7
Swain,TwistedFate,349,156,193,44.7
Swain,Hwei,680,313,367,46.03
Swain,Morgana,1459,700,759,47.98
Swain,Gwen,575,321,254,55.83
Swain,Illaoi,536,282,254,52.61
Swain,Karthus,352,160,192,45.45
Swain,Gangplank,426,221,205,51.88
Swain,Rakan,400,211,189,52.75
Swain,Viego,1620,766,854,47.28
Swain,Garen,2018,978,1040,48.46
Swain,Xerath,1069,552,517,51.64
Swain,Sivir,608,327,281,53.78
Swain,Kayle,846,423,423,50
Swain,Tryndamere,637,321,316,50.39
Swain,Anivia,325,160,165,49.23
Swain,Braum,688,311,377,45.2
Swain,Ornn,472,240,232,50.85
Swain,Nilah,434,230,204,53
Swain,Gragas,617,331,286,53.65
Swain,Taliyah,240,125,115,52.08
Swain,Vex,590,339,251,57.46
Swain,Kled,197,113,84,57.36
Swain,Varus,1080,545,535,50.46
Swain,Rell,531,305,226,57.44
Swain,Khazix,493,259,234,52.54
Swain,Ivern,147,78,69,53.06
Swain,Shen,727,404,323,55.57
Swain,Renata,180,80,100,44.44
Swain,Qiyana,232,136,96,58.62
Swain,KogMaw,396,182,214,45.96
Swain,Lillia,691,345,346,49.93
Swain,Leblanc,662,359,303,54.23
Swain,Alistar,561,308,253,54.9
Swain,RekSai,96,65,31,67.71
Swain,Zoe,322,186,136,57.76
Swain,Zac,517,315,202,60.93
Swain,DrMundo,654,370,284,56.57
Swain,Bard,254,121,133,47.64
Swain,Annie,403,212,191,52.61
Swain,Zeri,393,220,173,55.98
Swain,Urgot,555,283,272,50.99
Swain,Akshan,409,208,201,50.86
Swain,Taric,266,148,118,55.64
Swain,XinZhao,801,432,369,53.93
Swain,Jayce,475,254,221,53.47
Swain,AurelionSol,415,206,209,49.64
Swain,FiddleSticks,547,285,262,52.1
Vi,Darius,2083,1053,1030,50.55
Vi,Rammus,311,155,156,49.84
Vi,Qiyana,202,111,91,54.95
Vi,Ezreal,3183,1617,1566,50.8
Vi,Swain,1045,488,557,46.7
Vi,Shen,676,373,303,55.18
Vi,Belveth,298,147,151,49.33
Vi,Akali,1232,681,551,55.28
Vi,Varus,999,513,486,51.35
Vi,Lulu,1501,763,738,50.83
Vi,Warwick,1758,781,977,44.43
Vi,Hecarim,498,238,260,47.79
Vi,Diana,1856,886,970,47.74
Vi,Ziggs,317,142,175,44.79
Vi,Karma,1553,809,744,52.09
Vi,Garen,1830,866,964,47.32
Vi,Rengar,342,199,143,58.19
Vi,Lissandra,362,167,195,46.13
Vi,Tristana,1068,566,502,53
Vi,Zyra,1134,546,588,48.15
Vi,Ivern,156,67,89,42.95
Vi,Anivia,369,182,187,49.32
Vi,Ashe,2413,1132,1281,46.91
Vi,Aatrox,983,518,465,52.7
Vi,Chogath,1347,627,720,46.55
Vi,Vayne,1478,800,678,54.13
Vi,Thresh,1452,653,799,44.97
Vi,Kayn,1625,806,819,49.6
Vi,Katarina,870,429,441,49.31
Vi,Jhin,2124,1049,1075,49.39
Vi,Blitzcrank,804,393,411,48.88
Vi,Sett,1682,844,838,50.18
Vi,MonkeyKing,933,492,441,52.73
Vi,Corki,435,231,204,53.1
Vi,Nocturne,1523,663,860,43.53
Vi,Galio,1030,492,538,47.77
Vi,Caitlyn,3052,1472,1580,48.23
Vi,Morgana,1450,715,735,49.31
Vi,Ambessa,782,377,405,48.21
Vi,Taliyah,319,173,146,54.23
Vi,Vex,584,293,291,50.17
Vi,MissFortune,2557,1260,1297,49.28
Vi,Elise,831,377,454,45.37
Vi,Malphite,1102,526,576,47.73
Vi,Ekko,991,460,531,46.42
Vi,Mel,2290,1193,1097,52.1
Vi,Lux,2575,1330,1245,51.65
Vi,RekSai,111,53,58,47.75
Vi,Yasuo,2181,1089,1092,49.93
Vi,Pyke,872,449,423,51.49
Vi,Pantheon,1748,855,893,48.91
Vi,Ahri,1515,759,756,50.1
Vi,Nami,1133,520,613,45.9
Vi,Irelia,975,459,516,47.08
Vi,Mordekaiser,1431,700,731,48.92
Vi,Sylas,1870,977,893,52.25
Vi,Milio,653,308,345,47.17
Vi,Talon,716,333,383,46.51
Vi,Syndra,757,378,379,49.93
Vi,Kaisa,1974,995,979,50.41
Vi,Amumu,1010,499,511,49.41
Vi,Leona,971,521,450,53.66
Vi,Teemo,1345,652,693,48.48
Vi,Graves,713,347,366,48.67
Vi,Brand,800,386,414,48.25
Vi,Samira,699,356,343,50.93
Vi,TahmKench,777,413,364,53.15
Vi,LeeSin,2409,1266,1143,52.55
Vi,Nautilus,1240,615,625,49.6
Vi,Senna,799,381,418,47.68
Vi,Zed,1361,733,628,53.86
Vi,Rakan,474,231,243,48.73
Vi,AurelionSol,431,227,204,52.67
Vi,Lillia,641,322,319,50.23
Vi,Lucian,831,391,440,47.05
Vi,Gangplank,561,261,300,46.52
Vi,Yone,2202,1160,1042,52.68
Vi,Gnar,483,218,265,45.13
Vi,Orianna,510,266,244,52.16
Vi,Trundle,587,275,312,46.85
Vi,Viego,1706,825,881,48.36
Vi,Yorick,1081,499,582,46.16
Vi,Briar,836,380,456,45.45
Vi,Rumble,381,156,225,40.94
Vi,Twitch,829,446,383,53.8
Vi,Vladimir,731,321,410,43.91
Vi,MasterYi,1403,745,658,53.1
Vi,Seraphine,777,389,388,50.06
Vi,XinZhao,887,435,452,49.04
Vi,Jinx,3266,1577,1689,48.29
Vi,Poppy,777,364,413,46.85
Vi,Xayah,735,348,387,47.35
Vi,Urgot,548,274,274,50
Vi,Sivir,643,310,333,48.21
Vi,Volibear,1339,639,700,47.72
Vi,Fiora,409,210,199,51.34
Vi,Nunu,579,274,305,47.32
Vi,Hwei,720,354,366,49.17
Vi,Nasus,808,447,361,55.32
Vi,Leblanc,752,368,384,48.94
Vi,Shaco,1003,533,470,53.14
Vi,Illaoi,495,248,247,50.1
Vi,KSante,614,306,308,49.84
Vi,Tryndamere,588,290,298,49.32
Vi,Aurora,765,349,416,45.62
Vi,Velkoz,593,285,308,48.06
Vi,Malzahar,1114,575,539,51.62
Vi,Ornn,447,207,240,46.31
Vi,Xerath,1196,580,616,48.49
Vi,Sejuani,529,263,266,49.72
Vi,Veigar,1061,522,539,49.2
Vi,Maokai,443,214,229,48.31
Vi,Viktor,1016,483,533,47.54
Vi,Zac,600,303,297,50.5
Vi,Kalista,287,144,143,50.17
Vi,Kindred,459,227,232,49.46
Vi,Zeri,571,346,225,60.6
Vi,Soraka,574,251,323,43.73
Vi,Azir,390,213,177,54.62
Vi,TwistedFate,430,225,205,52.33
Vi,FiddleSticks,528,266,262,50.38
Vi,Kassadin,267,127,140,47.57
Vi,Draven,568,274,294,48.24
Vi,JarvanIV,712,363,349,50.98
Vi,Karthus,386,185,201,47.93
Vi,Jax,1076,509,567,47.3
Vi,Riven,495,269,226,54.34
Vi,Akshan,366,180,186,49.18
Vi,Kayle,724,316,408,43.65
Vi,Smolder,649,327,322,50.39
Vi,Quinn,445,227,218,51.01
Vi,Neeko,494,210,284,42.51
Vi,Fizz,633,286,347,45.18
Vi,Janna,345,141,204,40.87
Vi,Annie,372,189,183,50.81
Vi,Zilean,353,194,159,54.96
Vi,Camille,365,191,174,52.33
Vi,KogMaw,344,157,187,45.64
Vi,Udyr,427,226,201,52.93
Vi,Sona,328,160,168,48.78
Vi,Gragas,735,344,391,46.8
Vi,Sion,828,413,415,49.88
Vi,Braum,674,306,368,45.4
Vi,Kennen,282,128,154,45.39
Vi,Jayce,681,308,373,45.23
Vi,Ryze,396,178,218,44.95
Vi,Alistar,528,261,267,49.43
Vi,Evelynn,474,253,221,53.38
Vi,Heimerdinger,473,259,214,54.76
Vi,Kled,215,86,129,40
Vi,Zoe,463,252,211,54.43
Vi,Bard,293,143,150,48.81
Vi,Khazix,482,215,267,44.61
Vi,Yuumi,957,515,442,53.81
Vi,DrMundo,612,310,302,50.65
Vi,Renekton,597,264,333,44.22
Vi,Singed,300,128,172,42.67
Vi,Olaf,314,152,162,48.41
Vi,Nidalee,332,201,131,60.54
Vi,Gwen,455,243,212,53.41
Vi,Aphelios,527,259,268,49.15
Vi,Nilah,322,124,198,38.51
Vi,Naafiri,342,181,161,52.92
Vi,Taric,257,105,152,40.86
Vi,Rell,556,270,286,48.56
Vi,Shyvana,271,106,165,39.11
Vi,Skarner,285,158,127,55.44
Vi,Cassiopeia,323,140,183,43.34
Vi,Renata,217,121,96,55.76
Irelia,Darius,1673,798,875,47.7
Irelia,Rammus,398,185,213,46.48
Irelia,Qiyana,267,125,142,46.82
Irelia,Ezreal,2643,1303,1340,49.3
Irelia,Swain,984,500,484,50.81
Irelia,Kayle,776,373,403,48.07
Irelia,Mordekaiser,1251,629,622,50.28
Irelia,Yasuo,2314,1131,1183,48.88
Irelia,Varus,856,455,401,53.15
Irelia,Galio,880,387,493,43.98
Irelia,Ornn,437,221,216,50.57
Irelia,Kayn,1512,724,788,47.88
Irelia,Caitlyn,2964,1542,1422,52.02
Irelia,Morgana,1095,522,573,47.67
Irelia,Fiora,390,186,204,47.69
Irelia,Warwick,1416,651,765,45.97
Irelia,Zed,1278,652,626,51.02
Irelia,Chogath,1202,595,607,49.5
Irelia,Shen,551,292,259,52.99
Irelia,Amumu,1018,470,548,46.17
Irelia,Orianna,397,210,187,52.9
Irelia,Sona,314,167,147,53.18
Irelia,Gnar,450,250,200,55.56
Irelia,Sylas,1482,695,787,46.9
Irelia,Mel,2075,1018,1057,49.06
Irelia,Ashe,2081,981,1100,47.14
Irelia,Seraphine,695,342,353,49.21
Irelia,Garen,1652,780,872,47.22
Irelia,Graves,635,295,340,46.46
Irelia,Diana,1548,746,802,48.19
Irelia,Shaco,962,498,464,51.77
Irelia,Jax,1171,653,518,55.76
Irelia,Nami,957,467,490,48.8
Irelia,Nocturne,1362,620,742,45.52
Irelia,Nasus,651,305,346,46.85
Irelia,Talon,657,365,292,55.56
Irelia,Lux,2444,1200,1244,49.1
Irelia,Jinx,2834,1387,1447,48.94
Irelia,Akali,1296,606,690,46.76
Irelia,JarvanIV,541,282,259,52.13
Irelia,Sivir,594,273,321,45.96
Irelia,Volibear,1160,556,604,47.93
Irelia,Aurora,696,365,331,52.44
Irelia,Brand,804,438,366,54.48
Irelia,Trundle,589,258,331,43.8
Irelia,Khazix,517,266,251,51.45
Irelia,Veigar,888,368,520,41.44
Irelia,Tristana,926,472,454,50.97
Irelia,Thresh,1368,646,722,47.22
Irelia,Aatrox,951,522,429,54.89
Irelia,Evelynn,355,182,173,51.27
Irelia,Katarina,767,374,393,48.76
Irelia,Kaisa,1808,1017,791,56.25
Irelia,Leona,994,517,477,52.01
Irelia,Tryndamere,518,246,272,47.49
Irelia,Elise,766,412,354,53.79
Irelia,Anivia,307,154,153,50.16
Irelia,Pyke,785,413,372,52.61
Irelia,Briar,769,369,400,47.98
Irelia,Vi,975,514,461,52.72
Irelia,Zoe,384,242,142,63.02
Irelia,Nautilus,1170,604,566,51.62
Irelia,Malzahar,1082,499,583,46.12
Irelia,MissFortune,2423,1178,1245,48.62
Irelia,Kindred,455,239,216,52.53
Irelia,Karma,1343,677,666,50.41
Irelia,Illaoi,498,251,247,50.4
Irelia,XinZhao,664,338,326,50.9
Irelia,Ahri,1243,643,600,51.73
Irelia,Jhin,2154,1053,1101,48.89
Irelia,TahmKench,713,340,373,47.69
Irelia,Soraka,582,315,267,54.12
Irelia,Heimerdinger,492,200,292,40.65
Irelia,Malphite,1050,495,555,47.14
Irelia,Smolder,571,348,223,60.95
Irelia,Pantheon,1411,713,698,50.53
Irelia,Hecarim,427,220,207,51.52
Irelia,Naafiri,358,172,186,48.04
Irelia,Gangplank,566,300,266,53
Irelia,Yone,2293,1209,1084,52.73
Irelia,Samira,706,341,365,48.3
Irelia,Neeko,503,275,228,54.67
Irelia,Zyra,989,485,504,49.04
Irelia,Sett,1706,784,922,45.96
Irelia,Rengar,375,231,144,61.6
Irelia,Velkoz,619,306,313,49.43
Irelia,Sejuani,421,213,208,50.59
Irelia,Bard,327,153,174,46.79
Irelia,Nidalee,330,181,149,54.85
Irelia,Draven,498,245,253,49.2
Irelia,Ambessa,703,384,319,54.62
Irelia,Lillia,621,323,298,52.01
Irelia,Fizz,553,293,260,52.98
Irelia,Lulu,1279,656,623,51.29
Irelia,Rell,519,258,261,49.71
Irelia,MasterYi,1310,630,680,48.09
Irelia,Olaf,166,88,78,53.01
Irelia,Vayne,1316,695,621,52.81
Irelia,Corki,378,195,183,51.59
Irelia,Ryze,398,219,179,55.03
Irelia,Blitzcrank,782,406,376,51.92
Irelia,DrMundo,481,263,218,54.68
Irelia,Xerath,942,453,489,48.09
Irelia,Teemo,1226,553,673,45.11
Irelia,Vladimir,746,381,365,51.07
Irelia,Belveth,184,90,94,48.91
Irelia,Kennen,323,170,153,52.63
Irelia,MonkeyKing,670,300,370,44.78
Irelia,KogMaw,297,127,170,42.76
Irelia,Braum,537,242,295,45.07
Irelia,AurelionSol,313,171,142,54.63
Irelia,LeeSin,1686,829,857,49.17
Irelia,Xayah,464,198,266,42.67
Irelia,Rakan,412,186,226,45.15
Irelia,Lucian,671,350,321,52.16
Irelia,Viego,1524,780,744,51.18
Irelia,Aphelios,548,283,265,51.64
Irelia,FiddleSticks,507,293,214,57.79
Irelia,Camille,304,169,135,55.59
Irelia,Udyr,378,186,192,49.21
Irelia,Nunu,508,270,238,53.15
Irelia,Vex,579,298,281,51.47
Irelia,Riven,483,260,223,53.83
Irelia,Janna,317,166,151,52.37
Irelia,Gragas,465,225,240,48.39
Irelia,Ekko,1017,565,452,55.56
Irelia,Leblanc,638,295,343,46.24
Irelia,Skarner,255,138,117,54.12
Irelia,Taliyah,274,128,146,46.72
Irelia,Poppy,668,305,363,45.66
Irelia,Twitch,724,378,346,52.21
Irelia,Kassadin,171,112,59,65.5
Irelia,Renata,160,84,76,52.5
Irelia,Zilean,324,155,169,47.84
Irelia,Yorick,1160,575,585,49.57
Irelia,Ziggs,323,155,168,47.99
Irelia,Milio,597,258,339,43.22
Irelia,Ivern,121,67,54,55.37
Irelia,Azir,351,180,171,51.28
Irelia,Senna,702,369,333,52.56
Irelia,Akshan,315,178,137,56.51
Irelia,Jayce,600,318,282,53
Irelia,Singed,259,104,155,40.15
Irelia,KSante,554,275,279,49.64
Irelia,Alistar,440,206,234,46.82
Irelia,Hwei,626,344,282,54.95
Irelia,Yuumi,871,455,416,52.24
Irelia,Sion,688,344,344,50
Irelia,Taric,167,85,82,50.9
Irelia,Syndra,550,290,260,52.73
Irelia,Shyvana,263,127,136,48.29
Irelia,Maokai,478,252,226,52.72
Irelia,Nilah,268,133,135,49.63
Irelia,Gwen,425,238,187,56
Irelia,Rumble,360,202,158,56.11
Irelia,Kalista,273,134,139,49.08
Irelia,Renekton,457,208,249,45.51
Irelia,Kled,151,84,67,55.63
Irelia,TwistedFate,333,196,137,58.86
Irelia,Karthus,285,150,135,52.63
Irelia,Urgot,458,198,260,43.23
Irelia,Viktor,927,483,444,52.1
Irelia,Zeri,368,216,152,58.7
Irelia,Lissandra,402,183,219,45.52
Irelia,Annie,326,161,165,49.39
Irelia,Cassiopeia,300,160,140,53.33
Irelia,Zac,483,208,275,43.06
Irelia,Quinn,343,173,170,50.44
Irelia,RekSai,86,46,40,53.49
Nautilus,Darius,2514,1251,1263,49.76
Nautilus,Rammus,444,189,255,42.57
Nautilus,Qiyana,326,165,161,50.61
Nautilus,Ezreal,3624,1893,1731,52.24
Nautilus,Swain,1370,602,768,43.94
Nautilus,Volibear,1386,667,719,48.12
Nautilus,Yorick,1369,632,737,46.17
Nautilus,Zoe,532,297,235,55.83
Nautilus,Samira,678,326,352,48.08
Nautilus,Pantheon,2015,999,1016,49.58
Nautilus,KSante,736,392,344,53.26
Nautilus,Hwei,871,421,450,48.34
Nautilus,Evelynn,449,224,225,49.89
Nautilus,Sivir,689,285,404,41.36
Nautilus,Thresh,1962,911,1051,46.43
Nautilus,Urgot,662,285,377,43.05
Nautilus,MasterYi,1751,837,914,47.8
Nautilus,Galio,1183,564,619,47.68
Nautilus,Varus,1084,545,539,50.28
Nautilus,Morgana,1570,741,829,47.2
Nautilus,Viktor,1252,603,649,48.16
Nautilus,Nocturne,1591,722,869,45.38
Nautilus,Veigar,1277,596,681,46.67
Nautilus,Brand,1016,465,551,45.77
Nautilus,Quinn,350,159,191,45.43
Nautilus,Trundle,733,336,397,45.84
Nautilus,Kassadin,269,125,144,46.47
Nautilus,Caitlyn,3711,1892,1819,50.98
Nautilus,Senna,1066,527,539,49.44
Nautilus,Gangplank,600,294,306,49
Nautilus,Chogath,1547,724,823,46.8
Nautilus,Anivia,416,189,227,45.43
Nautilus,Tristana,1334,704,630,52.77
Nautilus,Zyra,1151,569,582,49.44
Nautilus,Yasuo,2555,1268,1287,49.63
Nautilus,Talon,747,407,340,54.48
Nautilus,Soraka,723,320,403,44.26
Nautilus,Kayn,1860,885,975,47.58
Nautilus,Xerath,1337,647,690,48.39
Nautilus,Vayne,1896,909,987,47.94
Nautilus,Nami,1243,554,689,44.57
Nautilus,Ekko,1174,542,632,46.17
Nautilus,MissFortune,3023,1347,1676,44.56
Nautilus,Garen,2118,1026,1092,48.44
Nautilus,Graves,905,466,439,51.49
Nautilus,Diana,2134,1022,1112,47.89
Nautilus,Shaco,1172,552,620,47.1
Nautilus,Camille,440,235,205,53.41
Nautilus,Lux,3164,1514,1650,47.85
Nautilus,Irelia,1170,566,604,48.38
Nautilus,Mordekaiser,1569,759,810,48.37
Nautilus,Sylas,2166,1042,1124,48.11
Nautilus,Ashe,2742,1423,1319,51.9
Nautilus,Milio,724,317,407,43.78
Nautilus,Ornn,559,246,313,44.01
Nautilus,Aurora,929,467,462,50.27
Nautilus,Zilean,399,152,247,38.1
Nautilus,LeeSin,2087,1087,1000,52.08
Nautilus,Katarina,938,472,466,50.32
Nautilus,Vladimir,845,415,430,49.11
Nautilus,FiddleSticks,646,320,326,49.54
Nautilus,Illaoi,656,333,323,50.76
Nautilus,Jax,1185,604,581,50.97
Nautilus,Lulu,1789,875,914,48.91
Nautilus,Yone,2514,1307,1207,51.99
Nautilus,Gnar,550,273,277,49.64
Nautilus,Smolder,834,444,390,53.24
Nautilus,Sona,325,158,167,48.62
Nautilus,Vi,1240,625,615,50.4
Nautilus,AurelionSol,495,264,231,53.33
Nautilus,Kaisa,2062,1049,1013,50.87
Nautilus,Jhin,2601,1275,1326,49.02
Nautilus,Velkoz,820,369,451,45
Nautilus,Seraphine,930,436,494,46.88
Nautilus,Singed,361,186,175,51.52
Nautilus,Zed,1449,748,701,51.62
Nautilus,Ahri,1754,862,892,49.14
Nautilus,Sett,2006,972,1034,48.45
Nautilus,XinZhao,846,436,410,51.54
Nautilus,Neeko,562,273,289,48.58
Nautilus,Ziggs,516,266,250,51.55
Nautilus,Karma,1634,844,790,51.65
Nautilus,Teemo,1602,710,892,44.32
Nautilus,Blitzcrank,1029,568,461,55.2
Nautilus,Sejuani,583,246,337,42.2
Nautilus,JarvanIV,748,370,378,49.47
Nautilus,Syndra,881,426,455,48.35
Nautilus,Renekton,726,345,381,47.52
Nautilus,Mel,2639,1421,1218,53.85
Nautilus,Braum,1205,554,651,45.98
Nautilus,Shen,830,391,439,47.11
Nautilus,Amumu,1575,672,903,42.67
Nautilus,Kalista,325,154,171,47.38
Nautilus,Kled,272,131,141,48.16
Nautilus,Nasus,880,400,480,45.45
Nautilus,Lissandra,438,227,211,51.83
Nautilus,Heimerdinger,557,236,321,42.37
Nautilus,Lucian,955,466,489,48.8
Nautilus,MonkeyKing,877,393,484,44.81
Nautilus,Viego,2053,1090,963,53.09
Nautilus,Malphite,1422,655,767,46.06
Nautilus,TahmKench,1118,588,530,52.59
Nautilus,Xayah,768,320,448,41.67
Nautilus,Janna,430,202,228,46.98
Nautilus,Warwick,1876,848,1028,45.2
Nautilus,Jinx,3670,1630,2040,44.41
Nautilus,Leona,1262,596,666,47.23
Nautilus,Zac,696,334,362,47.99
Nautilus,Maokai,585,269,316,45.98
Nautilus,Malzahar,1324,623,701,47.05
Nautilus,Twitch,943,462,481,48.99
Nautilus,Renata,289,142,147,49.13
Nautilus,Ambessa,858,454,404,52.91
Nautilus,DrMundo,687,329,358,47.89
Nautilus,Vex,755,377,378,49.93
Nautilus,Kindred,633,302,331,47.71
Nautilus,Jayce,682,343,339,50.29
Nautilus,Gwen,664,329,335,49.55
Nautilus,Nunu,702,337,365,48.01
Nautilus,Fizz,785,392,393,49.94
Nautilus,Alistar,786,391,395,49.75
Nautilus,Sion,954,462,492,48.43
Nautilus,Leblanc,828,427,401,51.57
Nautilus,Khazix,603,299,304,49.59
Nautilus,Akali,1390,684,706,49.21
Nautilus,Aphelios,667,317,350,47.53
Nautilus,Lillia,718,365,353,50.84
Nautilus,Gragas,838,415,423,49.52
Nautilus,Annie,418,209,209,50
Nautilus,Rell,680,319,361,46.91
Nautilus,Belveth,294,133,161,45.24
Nautilus,Orianna,601,297,304,49.42
Nautilus,Poppy,896,399,497,44.53
Nautilus,Udyr,515,275,240,53.4
Nautilus,Bard,342,178,164,52.05
Nautilus,Rakan,496,210,286,42.34
Nautilus,Zeri,588,318,270,54.08
Nautilus,Naafiri,388,193,195,49.74
Nautilus,Draven,634,334,300,52.68
Nautilus,Pyke,1146,629,517,54.89
Nautilus,Riven,583,273,310,46.83
Nautilus,Rumble,349,169,180,48.42
Nautilus,Fiora,500,231,269,46.2
Nautilus,Rengar,376,182,194,48.4
Nautilus,Azir,438,193,245,44.06
Nautilus,KogMaw,338,133,205,39.35
Nautilus,Ryze,517,260,257,50.29
Nautilus,Kayle,751,346,405,46.07
Nautilus,Aatrox,1091,542,549,49.68
Nautilus,Elise,936,429,507,45.83
Nautilus,Briar,880,405,475,46.02
Nautilus,Shyvana,315,127,188,40.32
Nautilus,Tryndamere,743,365,378,49.13
Nautilus,Akshan,403,205,198,50.87
Nautilus,Corki,521,252,269,48.37
Nautilus,Yuumi,1069,644,425,60.24
Nautilus,Cassiopeia,337,159,178,47.18
Nautilus,Skarner,392,172,220,43.88
Nautilus,Nilah,407,170,237,41.77
Nautilus,Taliyah,292,103,189,35.27
Nautilus,Taric,457,193,264,42.23
Nautilus,Kennen,321,149,172,46.42
Nautilus,Olaf,364,199,165,54.67
Nautilus,Ivern,146,74,72,50.68
Nautilus,Hecarim,557,284,273,50.99
Nautilus,Karthus,383,215,168,56.14
Nautilus,TwistedFate,441,236,205,53.51
Nautilus,Nidalee,382,224,158,58.64
Nautilus,RekSai,133,75,58,56.39
Aurora,Alistar,356,167,189,46.91
Aurora,LeeSin,1460,699,761,47.88
Aurora,Yasuo,1645,801,844,48.69
Aurora,Hwei,605,274,331,45.29
Aurora,Swain,784,363,421,46.3
Aurora,Trundle,510,239,271,46.86
Aurora,Briar,521,212,309,40.69
Aurora,Katarina,600,261,339,43.5
Aurora,Jhin,1628,834,794,51.23
Aurora,Pyke,672,367,305,54.61
Aurora,Ornn,364,162,202,44.51
Aurora,Kayn,1020,503,517,49.31
Aurora,Malzahar,813,348,465,42.8
Aurora,Vayne,1114,560,554,50.27
Aurora,Lulu,1230,622,608,50.57
Aurora,Gwen,388,193,195,49.74
Aurora,Khazix,441,180,261,40.82
Aurora,TwistedFate,350,178,172,50.86
Aurora,Varus,757,356,401,47.03
Aurora,Thresh,1125,565,560,50.22
Aurora,JarvanIV,544,247,297,45.4
Aurora,Orianna,350,172,178,49.14
Aurora,Yuumi,634,318,316,50.16
Aurora,Garen,1259,560,699,44.48
Aurora,Amumu,699,305,394,43.63
Aurora,Veigar,757,348,409,45.97
Aurora,Jinx,2387,1107,1280,46.38
Aurora,Galio,767,365,402,47.59
Aurora,Gnar,368,185,183,50.27
Aurora,MonkeyKing,593,328,265,55.31
Aurora,Bard,290,135,155,46.55
Aurora,Sett,1178,581,597,49.32
Aurora,XinZhao,500,257,243,51.4
Aurora,Fizz,434,217,217,50
Aurora,Karma,1207,603,604,49.96
Aurora,Kayle,543,241,302,44.38
Aurora,Nasus,522,261,261,50
Aurora,Anivia,275,131,144,47.64
Aurora,KogMaw,242,113,129,46.69
Aurora,Nami,806,377,429,46.77
Aurora,Gangplank,428,209,219,48.83
Aurora,Qiyana,258,130,128,50.39
Aurora,Xerath,756,374,382,49.47
Aurora,Twitch,685,349,336,50.95
Aurora,Lux,2016,923,1093,45.78
Aurora,Jax,774,370,404,47.8
Aurora,Rammus,191,91,100,47.64
Aurora,Viktor,901,449,452,49.83
Aurora,Soraka,403,168,235,41.69
Aurora,Teemo,1001,487,514,48.65
Aurora,Lillia,459,220,239,47.93
Aurora,Irelia,696,331,365,47.56
Aurora,Caitlyn,2175,1050,1125,48.28
Aurora,Kennen,253,98,155,38.74
Aurora,Ekko,714,306,408,42.86
Aurora,Leblanc,561,285,276,50.8
Aurora,MissFortune,1873,855,1018,45.65
Aurora,Yone,1668,864,804,51.8
Aurora,Nocturne,1016,454,562,44.69
Aurora,AurelionSol,280,135,145,48.21
Aurora,Smolder,467,228,239,48.82
Aurora,Nautilus,929,462,467,49.73
Aurora,Ambessa,527,250,277,47.44
Aurora,Kassadin,150,82,68,54.67
Aurora,Sejuani,398,170,228,42.71
Aurora,Akali,988,456,532,46.15
Aurora,Ziggs,270,129,141,47.78
Aurora,Quinn,333,173,160,51.95
Aurora,Chogath,912,428,484,46.93
Aurora,Kaisa,1483,792,691,53.41
Aurora,Nidalee,255,150,105,58.82
Aurora,Aatrox,776,376,400,48.45
Aurora,MasterYi,1006,519,487,51.59
Aurora,Syndra,544,242,302,44.49
Aurora,Seraphine,564,281,283,49.82
Aurora,KSante,428,197,231,46.03
Aurora,Zyra,938,500,438,53.3
Aurora,Warwick,1071,515,556,48.09
Aurora,Nilah,240,125,115,52.08
Aurora,Blitzcrank,601,338,263,56.24
Aurora,Shaco,738,376,362,50.95
Aurora,Lucian,599,323,276,53.92
Aurora,Darius,1618,815,803,50.37
Aurora,Zilean,291,161,130,55.33
Aurora,Singed,172,83,89,48.26
Aurora,Ahri,1179,574,605,48.69
Aurora,Mordekaiser,922,455,467,49.35
Aurora,Pantheon,1393,671,722,48.17
Aurora,Diana,1530,767,763,50.13
Aurora,Rengar,258,128,130,49.61
Aurora,Janna,262,98,164,37.4
Aurora,Riven,361,194,167,53.74
Aurora,Elise,638,327,311,51.25
Aurora,Ezreal,2243,1123,1120,50.07
Aurora,Yorick,711,307,404,43.18
Aurora,Zed,921,470,451,51.03
Aurora,Illaoi,396,220,176,55.56
Aurora,Kindred,385,161,224,41.82
Aurora,Velkoz,469,236,233,50.32
Aurora,Annie,337,163,174,48.37
Aurora,Mel,1584,833,751,52.59
Aurora,Morgana,880,442,438,50.23
Aurora,Samira,511,296,215,57.93
Aurora,Rakan,366,169,197,46.17
Aurora,Poppy,491,242,249,49.29
Aurora,Brand,538,248,290,46.1
Aurora,Aphelios,428,215,213,50.23
Aurora,Talon,531,236,295,44.44
Aurora,Naafiri,292,166,126,56.85
Aurora,Vex,456,211,245,46.27
Aurora,Draven,425,190,235,44.71
Aurora,Renekton,486,237,249,48.77
Aurora,Sion,599,300,299,50.08
Aurora,Vi,765,416,349,54.38
Aurora,Milio,503,217,286,43.14
Aurora,Ashe,1839,888,951,48.29
Aurora,Senna,587,241,346,41.06
Aurora,RekSai,104,75,29,72.12
Aurora,Xayah,377,202,175,53.58
Aurora,Vladimir,550,279,271,50.73
Aurora,Neeko,417,194,223,46.52
Aurora,Shyvana,205,103,102,50.24
Aurora,Evelynn,314,160,154,50.96
Aurora,Lissandra,279,132,147,47.31
Aurora,Gragas,471,210,261,44.59
Aurora,Braum,422,197,225,46.68
Aurora,FiddleSticks,406,205,201,50.49
Aurora,Zac,445,220,225,49.44
Aurora,Sivir,496,240,256,48.39
Aurora,Fiora,328,154,174,46.95
Aurora,TahmKench,541,256,285,47.32
Aurora,Karthus,290,151,139,52.07
Aurora,Zoe,342,197,145,57.6
Aurora,Sona,272,103,169,37.87
Aurora,Sylas,1376,708,668,51.45
Aurora,Viego,1268,661,607,52.13
Aurora,Zeri,370,160,210,43.24
Aurora,Akshan,349,171,178,49
Aurora,Corki,332,158,174,47.59
Aurora,Volibear,845,461,384,54.56
Aurora,Taric,184,81,103,44.02
Aurora,Renata,164,68,96,41.46
Aurora,Ryze,273,132,141,48.35
Aurora,Tristana,811,390,421,48.09
Aurora,Rumble,259,137,122,52.9
Aurora,Heimerdinger,326,165,161,50.61
Aurora,Camille,312,164,148,52.56
Aurora,Udyr,323,179,144,55.42
Aurora,Cassiopeia,293,148,145,50.51
Aurora,Malphite,840,437,403,52.02
Aurora,Urgot,396,187,209,47.22
Aurora,Jayce,522,240,282,45.98
Aurora,DrMundo,455,225,230,49.45
Aurora,Graves,501,233,268,46.51
Aurora,Leona,709,360,349,50.78
Aurora,Shen,522,272,250,52.11
Aurora,Rell,400,198,202,49.5
Aurora,Tryndamere,411,172,239,41.85
Aurora,Olaf,185,86,99,46.49
Aurora,Taliyah,224,87,137,38.84
Aurora,Nunu,457,195,262,42.67
Aurora,Kalista,135,63,72,46.67
Aurora,Maokai,378,156,222,41.27
Aurora,Kled,114,68,46,59.65
Aurora,Skarner,220,134,86,60.91
Aurora,Azir,303,148,155,48.84
Aurora,Hecarim,370,202,168,54.59
Aurora,Belveth,188,76,112,40.43
Aurora,Ivern,101,45,56,44.55
Corki,Alistar,242,122,120,50.41
Corki,LeeSin,773,371,402,47.99
Corki,Yasuo,918,421,497,45.86
Corki,Hwei,283,133,150,47
Corki,Swain,381,158,223,41.47
Corki,Darius,911,443,468,48.63
Corki,Nocturne,670,297,373,44.33
Corki,Lux,1098,511,587,46.54
Corki,Lucian,356,179,177,50.28
Corki,Thresh,664,324,340,48.8
Corki,Ambessa,363,183,180,50.41
Corki,XinZhao,287,135,152,47.04
Corki,Vladimir,352,162,190,46.02
Corki,Ezreal,1291,630,661,48.8
Corki,Karma,630,322,308,51.11
Corki,Kayn,807,336,471,41.64
Corki,JarvanIV,358,182,176,50.84
Corki,Orianna,254,113,141,44.49
Corki,Jhin,941,452,489,48.03
Corki,Yuumi,389,165,224,42.42
Corki,Urgot,230,76,154,33.04
Corki,Vi,435,204,231,46.9
Corki,Ryze,202,92,110,45.54
Corki,MissFortune,1002,471,531,47.01
Corki,TahmKench,271,132,139,48.71
Corki,Briar,267,136,131,50.94
Corki,Malzahar,459,222,237,48.37
Corki,Caitlyn,1145,501,644,43.76
Corki,Rakan,235,109,126,46.38
Corki,Renekton,244,113,131,46.31
Corki,Gragas,267,129,138,48.31
Corki,Ziggs,148,64,84,43.24
Corki,Milio,317,124,193,39.12
Corki,Gnar,195,82,113,42.05
Corki,Poppy,372,169,203,45.43
Corki,TwistedFate,202,82,120,40.59
Corki,Ahri,598,297,301,49.67
Corki,Varus,465,181,284,38.92
Corki,Renata,98,52,46,53.06
Corki,Yorick,428,216,212,50.47
Corki,Nunu,225,110,115,48.89
Corki,Katarina,430,215,215,50
Corki,Sivir,263,122,141,46.39
Corki,Zyra,443,191,252,43.12
Corki,Aatrox,429,200,229,46.62
Corki,Samira,353,194,159,54.96
Corki,AurelionSol,141,72,69,51.06
Corki,Smolder,280,162,118,57.86
Corki,Zed,511,279,232,54.6
Corki,Graves,336,185,151,55.06
Corki,Zoe,232,114,118,49.14
Corki,Anivia,139,49,90,35.25
Corki,Leona,385,205,180,53.25
Corki,Shen,321,172,149,53.58
Corki,Xerath,386,175,211,45.34
Corki,Sion,389,183,206,47.04
Corki,Garen,827,375,452,45.34
Corki,Soraka,286,125,161,43.71
Corki,FiddleSticks,221,93,128,42.08
Corki,Irelia,378,183,195,48.41
Corki,Veigar,438,198,240,45.21
Corki,Leblanc,372,192,180,51.61
Corki,KSante,313,151,162,48.24
Corki,Mel,901,457,444,50.72
Corki,Braum,336,154,182,45.83
Corki,Viego,768,381,387,49.61
Corki,Yone,832,391,441,47
Corki,Neeko,212,106,106,50
Corki,Vayne,645,337,308,52.25
Corki,Morgana,487,236,251,48.46
Corki,Kassadin,144,46,98,31.94
Corki,Ashe,1119,527,592,47.1
Corki,Blitzcrank,349,162,187,46.42
Corki,Kennen,155,43,112,27.74
Corki,Viktor,438,219,219,50
Corki,Gwen,280,140,140,50
Corki,Ekko,490,249,241,50.82
Corki,Nami,592,301,291,50.84
Corki,Teemo,539,232,307,43.04
Corki,Volibear,464,217,247,46.77
Corki,Chogath,550,242,308,44
Corki,Pantheon,751,350,401,46.6
Corki,Shaco,442,200,242,45.25
Corki,Kaisa,818,383,435,46.82
Corki,Riven,244,107,137,43.85
Corki,Jayce,297,152,145,51.18
Corki,Lulu,823,375,448,45.57
Corki,Brand,282,141,141,50
Corki,Akali,480,246,234,51.25
Corki,Talon,300,134,166,44.67
Corki,Karthus,172,74,98,43.02
Corki,Galio,509,222,287,43.61
Corki,Hecarim,268,131,137,48.88
Corki,Twitch,464,208,256,44.83
Corki,Sejuani,202,121,81,59.9
Corki,Ornn,198,95,103,47.98
Corki,Sylas,711,348,363,48.95
Corki,Draven,257,141,116,54.86
Corki,MasterYi,512,247,265,48.24
Corki,Khazix,244,97,147,39.75
Corki,Camille,197,105,92,53.3
Corki,Rengar,208,114,94,54.81
Corki,Skarner,107,51,56,47.66
Corki,Trundle,232,112,120,48.28
Corki,Quinn,221,104,117,47.06
Corki,Fiora,158,93,65,58.86
Corki,Aurora,332,174,158,52.41
Corki,Gangplank,234,115,119,49.15
Corki,Elise,404,206,198,50.99
Corki,Senna,346,146,200,42.2
Corki,Aphelios,261,119,142,45.59
Corki,Tryndamere,302,149,153,49.34
Corki,Akshan,185,76,109,41.08
Corki,DrMundo,222,104,118,46.85
Corki,Mordekaiser,423,197,226,46.57
Corki,Naafiri,138,73,65,52.9
Corki,Tristana,592,282,310,47.64
Corki,Warwick,574,251,323,43.73
Corki,Nautilus,521,269,252,51.63
Corki,Sett,636,294,342,46.23
Corki,Lissandra,163,74,89,45.4
Corki,Syndra,329,143,186,43.47
Corki,Janna,198,72,126,36.36
Corki,Singed,116,42,74,36.21
Corki,Nidalee,153,81,72,52.94
Corki,Diana,717,356,361,49.65
Corki,Illaoi,212,95,117,44.81
Corki,Udyr,201,83,118,41.29
Corki,Velkoz,328,139,189,42.38
Corki,Cassiopeia,117,49,68,41.88
Corki,Maokai,213,101,112,47.42
Corki,Nilah,192,90,102,46.88
Corki,Jax,452,225,227,49.78
Corki,Nasus,292,149,143,51.03
Corki,Ivern,80,37,43,46.25
Corki,Pyke,425,221,204,52
Corki,Zeri,223,110,113,49.33
Corki,Sona,108,60,48,55.56
Corki,Seraphine,290,124,166,42.76
Corki,Annie,155,75,80,48.39
Corki,Jinx,1354,679,675,50.15
Corki,Shyvana,125,66,59,52.8
Corki,Belveth,100,54,46,54
Corki,Kayle,355,162,193,45.63
Corki,Qiyana,148,78,70,52.7
Corki,Xayah,221,110,111,49.77
Corki,Malphite,432,227,205,52.55
Corki,Taliyah,140,67,73,47.86
Corki,Rell,334,167,167,50
Corki,Zilean,166,75,91,45.18
Corki,Heimerdinger,185,65,120,35.14
Corki,Vex,222,93,129,41.89
Corki,Olaf,120,61,59,50.83
Corki,Rammus,117,55,62,47.01
Corki,Lillia,240,127,113,52.92
Corki,Fizz,250,108,142,43.2
Corki,MonkeyKing,326,149,177,45.71
Corki,Bard,181,91,90,50.28
Corki,Kled,83,33,50,39.76
Corki,Zac,319,180,139,56.43
Corki,Kindred,234,113,121,48.29
Corki,Evelynn,152,56,96,36.84
Corki,Azir,159,83,76,52.2
Corki,RekSai,70,48,22,68.57
Corki,Amumu,432,187,245,43.29
Corki,KogMaw,155,60,95,38.71
Corki,Kalista,122,55,67,45.08
Corki,Taric,136,60,76,44.12
Corki,Rumble,159,83,76,52.2
Orianna,Alistar,229,120,109,52.4
Orianna,LeeSin,900,467,433,51.89
Orianna,Yasuo,877,426,451,48.57
Orianna,Hwei,340,174,166,51.18
Orianna,Swain,403,183,220,45.41
Orianna,Renekton,278,120,158,43.17
Orianna,Diana,823,352,471,42.77
Orianna,Aurora,350,178,172,50.86
Orianna,Corki,254,141,113,55.51
Orianna,Pantheon,873,489,384,56.01
Orianna,Heimerdinger,244,102,142,41.8
Orianna,Kayn,718,377,341,52.51
Orianna,Malzahar,571,256,315,44.83
Orianna,Sivir,248,146,102,58.87
Orianna,Neeko,209,116,93,55.5
Orianna,Yorick,539,224,315,41.56
Orianna,Rengar,183,71,112,38.8
Orianna,Irelia,397,187,210,47.1
Orianna,Ezreal,1410,697,713,49.43
Orianna,Soraka,300,156,144,52
Orianna,Teemo,586,269,317,45.9
Orianna,Jax,462,263,199,56.93
Orianna,Zed,492,246,246,50
Orianna,MissFortune,1102,562,540,51
Orianna,Ashe,1050,535,515,50.95
Orianna,Sett,647,315,332,48.69
Orianna,Annie,187,72,115,38.5
Orianna,Garen,859,402,457,46.8
Orianna,Katarina,377,162,215,42.97
Orianna,Caitlyn,1387,719,668,51.84
Orianna,Volibear,559,279,280,49.91
Orianna,Vladimir,420,222,198,52.86
Orianna,Zeri,195,89,106,45.64
Orianna,Senna,365,181,184,49.59
Orianna,Amumu,483,233,250,48.24
Orianna,Veigar,432,194,238,44.91
Orianna,Jinx,1539,768,771,49.9
Orianna,Lux,1184,579,605,48.9
Orianna,Tryndamere,213,99,114,46.48
Orianna,Akali,526,273,253,51.9
Orianna,Lucian,395,183,212,46.33
Orianna,Yuumi,372,208,164,55.91
Orianna,Darius,952,481,471,50.53
Orianna,MasterYi,625,313,312,50.08
Orianna,Mordekaiser,573,282,291,49.21
Orianna,Lulu,751,347,404,46.21
Orianna,Gangplank,277,132,145,47.65
Orianna,Vi,510,244,266,47.84
Orianna,Mel,1345,773,572,57.47
Orianna,Poppy,356,159,197,44.66
Orianna,Riven,271,129,142,47.6
Orianna,Viktor,584,272,312,46.58
Orianna,Tristana,508,245,263,48.23
Orianna,Viego,779,358,421,45.96
Orianna,Chogath,601,286,315,47.59
Orianna,Sion,361,176,185,48.75
Orianna,Yone,861,401,460,46.57
Orianna,XinZhao,353,178,175,50.42
Orianna,Pyke,398,221,177,55.53
Orianna,Brand,283,160,123,56.54
Orianna,Braum,298,153,145,51.34
Orianna,Syndra,392,198,194,50.51
Orianna,Shen,336,176,160,52.38
Orianna,Shaco,486,240,246,49.38
Orianna,Kaisa,908,429,479,47.25
Orianna,Nami,529,242,287,45.75
Orianna,DrMundo,240,103,137,42.92
Orianna,Warwick,675,309,366,45.78
Orianna,Trundle,269,129,140,47.96
Orianna,Vex,255,122,133,47.84
Orianna,Thresh,673,289,384,42.94
Orianna,FiddleSticks,311,143,168,45.98
Orianna,Ahri,842,431,411,51.19
Orianna,KSante,265,137,128,51.7
Orianna,Graves,314,165,149,52.55
Orianna,Leblanc,380,204,176,53.68
Orianna,Twitch,426,214,212,50.23
Orianna,Taric,141,73,68,51.77
Orianna,Kennen,167,87,80,52.1
Orianna,Naafiri,182,92,90,50.55
Orianna,Leona,470,253,217,53.83
Orianna,Kindred,225,89,136,39.56
Orianna,Kled,88,44,44,50
Orianna,Morgana,625,329,296,52.64
Orianna,Vayne,714,315,399,44.12
Orianna,Ekko,465,215,250,46.24
Orianna,Ziggs,170,71,99,41.76
Orianna,Aatrox,463,250,213,54
Orianna,Sejuani,238,117,121,49.16
Orianna,Azir,173,97,76,56.07
Orianna,Varus,504,273,231,54.17
Orianna,Xerath,520,236,284,45.38
Orianna,Rell,257,150,107,58.37
Orianna,TahmKench,335,162,173,48.36
Orianna,Nautilus,601,304,297,50.58
Orianna,Draven,229,107,122,46.72
Orianna,Nocturne,566,293,273,51.77
Orianna,Karma,695,332,363,47.77
Orianna,Lillia,256,128,128,50
Orianna,Zilean,205,105,100,51.22
Orianna,Gragas,294,159,135,54.08
Orianna,Seraphine,365,191,174,52.33
Orianna,Illaoi,260,136,124,52.31
Orianna,Qiyana,196,89,107,45.41
Orianna,Rammus,138,75,63,54.35
Orianna,Samira,273,148,125,54.21
Orianna,Briar,336,158,178,47.02
Orianna,Fizz,253,114,139,45.06
Orianna,Malphite,428,225,203,52.57
Orianna,Smolder,275,167,108,60.73
Orianna,Camille,201,117,84,58.21
Orianna,Udyr,181,124,57,68.51
Orianna,Sylas,787,394,393,50.06
Orianna,Xayah,217,90,127,41.47
Orianna,Sona,126,56,70,44.44
Orianna,Kayle,284,145,139,51.06
Orianna,Khazix,257,149,108,57.98
Orianna,Jhin,947,439,508,46.36
Orianna,Zyra,460,243,217,52.83
Orianna,Zoe,174,87,87,50
Orianna,Rakan,190,87,103,45.79
Orianna,Gnar,259,125,134,48.26
Orianna,Lissandra,160,63,97,39.38
Orianna,Olaf,152,76,76,50
Orianna,Nilah,156,83,73,53.21
Orianna,Bard,215,104,111,48.37
Orianna,Rumble,156,101,55,64.74
Orianna,Skarner,160,77,83,48.13
Orianna,Singed,124,66,58,53.23
Orianna,Fiora,140,82,58,58.57
Orianna,MonkeyKing,344,156,188,45.35
Orianna,Cassiopeia,123,70,53,56.91
Orianna,Kassadin,117,58,59,49.57
Orianna,Nasus,327,199,128,60.86
Orianna,Evelynn,152,71,81,46.71
Orianna,Aphelios,287,159,128,55.4
Orianna,KogMaw,150,78,72,52
Orianna,Kalista,163,100,63,61.35
Orianna,Karthus,159,92,67,57.86
Orianna,Nunu,255,134,121,52.55
Orianna,Velkoz,295,138,157,46.78
Orianna,Elise,426,200,226,46.95
Orianna,Milio,349,155,194,44.41
Orianna,Galio,399,218,181,54.64
Orianna,Quinn,182,103,79,56.59
Orianna,AurelionSol,178,84,94,47.19
Orianna,Hecarim,233,131,102,56.22
Orianna,Jayce,354,173,181,48.87
Orianna,Ryze,177,91,86,51.41
Orianna,Ambessa,417,217,200,52.04
Orianna,Ivern,89,44,45,49.44
Orianna,RekSai,78,32,46,41.03
Orianna,Maokai,251,132,119,52.59
Orianna,Ornn,247,152,95,61.54
Orianna,Taliyah,157,75,82,47.77
Orianna,Urgot,267,124,143,46.44
Orianna,TwistedFate,185,80,105,43.24
Orianna,Renata,100,56,44,56
Orianna,Blitzcrank,375,194,181,51.73
Orianna,JarvanIV,296,145,151,48.99
Orianna,Gwen,223,119,104,53.36
Orianna,Talon,308,163,145,52.92
Orianna,Zac,251,122,129,48.61
Orianna,Belveth,151,78,73,51.66
Orianna,Akshan,175,84,91,48
Orianna,Nidalee,216,105,111,48.61
Orianna,Janna,186,79,107,42.47
Orianna,Anivia,186,52,134,27.96
Orianna,Shyvana,109,49,60,44.95
Xayah,Alistar,284,137,147,48.24
Xayah,LeeSin,798,423,375,53.01
Xayah,Yasuo,1189,631,558,53.07
Xayah,Hwei,322,161,161,50
Xayah,Swain,479,238,241,49.69
Xayah,Gragas,294,173,121,58.84
Xayah,Pantheon,923,449,474,48.65
Xayah,Caitlyn,1503,729,774,48.5
Xayah,Mel,1061,576,485,54.29
Xayah,Sett,872,413,459,47.36
Xayah,MasterYi,680,337,343,49.56
Xayah,Vladimir,374,177,197,47.33
Xayah,Zilean,147,85,62,57.82
Xayah,Senna,389,187,202,48.07
Xayah,Gwen,257,140,117,54.47
Xayah,Akali,607,290,317,47.78
Xayah,KogMaw,134,81,53,60.45
Xayah,Thresh,800,406,394,50.75
Xayah,Zac,339,157,182,46.31
Xayah,Khazix,226,107,119,47.35
Xayah,Katarina,456,242,214,53.07
Xayah,Samira,473,243,230,51.37
Xayah,Leona,519,247,272,47.59
Xayah,Jax,524,251,273,47.9
Xayah,Kayn,660,340,320,51.52
Xayah,Ekko,497,241,256,48.49
Xayah,Zeri,274,165,109,60.22
Xayah,Amumu,594,280,314,47.14
Xayah,Nocturne,806,398,408,49.38
Xayah,Diana,890,458,432,51.46
Xayah,Nasus,360,182,178,50.56
Xayah,Ashe,1101,541,560,49.14
Xayah,Ornn,243,116,127,47.74
Xayah,Fizz,332,157,175,47.29
Xayah,Ezreal,1307,657,650,50.27
Xayah,Rakan,240,118,122,49.17
Xayah,Tryndamere,255,114,141,44.71
Xayah,Rengar,254,134,120,52.76
Xayah,Viktor,454,228,226,50.22
Xayah,Lux,1354,633,721,46.75
Xayah,Aatrox,437,212,225,48.51
Xayah,Neeko,223,115,108,51.57
Xayah,Volibear,609,313,296,51.4
Xayah,Ahri,673,364,309,54.09
Xayah,Teemo,598,295,303,49.33
Xayah,Yuumi,449,259,190,57.68
Xayah,Warwick,751,360,391,47.94
Xayah,Yone,1018,461,557,45.28
Xayah,Brand,367,188,179,51.23
Xayah,Illaoi,240,134,106,55.83
Xayah,Shaco,501,252,249,50.3
Xayah,Trundle,308,135,173,43.83
Xayah,Naafiri,177,86,91,48.59
Xayah,Jhin,1055,538,517,51
Xayah,Evelynn,220,116,104,52.73
Xayah,Darius,967,469,498,48.5
Xayah,Kaisa,1279,722,557,56.45
Xayah,Camille,239,133,106,55.65
Xayah,XinZhao,407,187,220,45.95
Xayah,MissFortune,1204,595,609,49.42
Xayah,Viego,713,355,358,49.79
Xayah,Maokai,275,164,111,59.64
Xayah,Kindred,201,93,108,46.27
Xayah,Jinx,1413,690,723,48.83
Xayah,Morgana,621,317,304,51.05
Xayah,Soraka,307,146,161,47.56
Xayah,Gnar,245,125,120,51.02
Xayah,Skarner,147,88,59,59.86
Xayah,Tristana,547,262,285,47.9
Xayah,Urgot,219,110,109,50.23
Xayah,Sylas,879,474,405,53.92
Xayah,Karma,603,278,325,46.1
Xayah,Sejuani,243,109,134,44.86
Xayah,Zed,675,331,344,49.04
Xayah,Seraphine,345,142,203,41.16
Xayah,Nunu,267,135,132,50.56
Xayah,Varus,441,210,231,47.62
Xayah,Garen,867,393,474,45.33
Xayah,Rammus,149,81,68,54.36
Xayah,Lissandra,209,110,99,52.63
Xayah,Mordekaiser,688,349,339,50.73
Xayah,Irelia,464,266,198,57.33
Xayah,Malphite,651,368,283,56.53
Xayah,Renata,92,50,42,54.35
Xayah,Vi,735,387,348,52.65
Xayah,Blitzcrank,429,235,194,54.78
Xayah,Kayle,393,196,197,49.87
Xayah,Lucian,398,173,225,43.47
Xayah,Pyke,387,182,205,47.03
Xayah,Poppy,364,163,201,44.78
Xayah,Quinn,185,96,89,51.89
Xayah,RekSai,73,42,31,57.53
Xayah,Nautilus,768,448,320,58.33
Xayah,Riven,214,98,116,45.79
Xayah,Taliyah,148,81,67,54.73
Xayah,Galio,517,250,267,48.36
Xayah,Shyvana,132,58,74,43.94
Xayah,Nami,496,238,258,47.98
Xayah,Vex,284,149,135,52.46
Xayah,Gangplank,254,144,110,56.69
Xayah,Syndra,342,158,184,46.2
Xayah,Kennen,165,75,90,45.45
Xayah,Aurora,377,175,202,46.42
Xayah,Vayne,722,373,349,51.66
Xayah,Bard,147,71,76,48.3
Xayah,DrMundo,302,171,131,56.62
Xayah,TwistedFate,172,92,80,53.49
Xayah,Veigar,506,235,271,46.44
Xayah,Lulu,731,381,350,52.12
Xayah,Renekton,285,141,144,49.47
Xayah,Elise,401,190,211,47.38
Xayah,Leblanc,364,175,189,48.08
Xayah,Karthus,173,90,83,52.02
Xayah,Annie,173,67,106,38.73
Xayah,Xerath,480,262,218,54.58
Xayah,AurelionSol,184,87,97,47.28
Xayah,Kassadin,94,56,38,59.57
Xayah,Lillia,271,134,137,49.45
Xayah,Draven,297,142,155,47.81
Xayah,Janna,180,77,103,42.78
Xayah,KSante,252,151,101,59.92
Xayah,Anivia,211,80,131,37.91
Xayah,Briar,371,178,193,47.98
Xayah,Yorick,519,265,254,51.06
Xayah,Orianna,217,127,90,58.53
Xayah,Taric,118,65,53,55.08
Xayah,Ryze,185,72,113,38.92
Xayah,Nilah,262,137,125,52.29
Xayah,Zyra,414,195,219,47.1
Xayah,Jayce,234,132,102,56.41
Xayah,JarvanIV,307,138,169,44.95
Xayah,Rell,301,176,125,58.47
Xayah,Chogath,650,325,325,50
Xayah,Ivern,88,38,50,43.18
Xayah,Talon,361,192,169,53.19
Xayah,TahmKench,357,177,180,49.58
Xayah,FiddleSticks,310,169,141,54.52
Xayah,Qiyana,152,79,73,51.97
Xayah,Sona,126,70,56,55.56
Xayah,Udyr,216,100,116,46.3
Xayah,Milio,265,120,145,45.28
Xayah,Hecarim,226,87,139,38.5
Xayah,Kalista,159,76,83,47.8
Xayah,MonkeyKing,395,202,193,51.14
Xayah,Braum,282,143,139,50.71
Xayah,Smolder,325,161,164,49.54
Xayah,Aphelios,250,103,147,41.2
Xayah,Ziggs,165,75,90,45.45
Xayah,Malzahar,617,303,314,49.11
Xayah,Fiora,139,71,68,51.08
Xayah,Twitch,412,212,200,51.46
Xayah,Sion,360,199,161,55.28
Xayah,Shen,393,196,197,49.87
Xayah,Zoe,161,91,70,56.52
Xayah,Kled,104,44,60,42.31
Xayah,Nidalee,161,85,76,52.8
Xayah,Heimerdinger,224,133,91,59.38
Xayah,Corki,221,111,110,50.23
Xayah,Sivir,283,137,146,48.41
Xayah,Akshan,121,76,45,62.81
Xayah,Azir,193,80,113,41.45
Xayah,Singed,148,65,83,43.92
Xayah,Rumble,185,120,65,64.86
Xayah,Cassiopeia,136,66,70,48.53
Xayah,Velkoz,305,123,182,40.33
Xayah,Ambessa,332,169,163,50.9
Xayah,Olaf,144,82,62,56.94
Xayah,Graves,269,149,120,55.39
Xayah,Belveth,147,76,71,51.7
Nami,Alistar,428,230,198,53.74
Nami,LeeSin,1438,778,660,54.1
Nami,Yasuo,2094,1073,1021,51.24
Nami,Hwei,779,402,377,51.6
Nami,Swain,993,513,480,51.66
Nami,Sett,1564,727,837,46.48
Nami,MasterYi,1427,715,712,50.11
Nami,Vladimir,879,479,400,54.49
Nami,Zilean,475,235,240,49.47
Nami,Senna,951,494,457,51.95
Nami,Darius,2178,1098,1080,50.41
Nami,Zac,488,245,243,50.2
Nami,Malzahar,1348,682,666,50.59
Nami,Ziggs,398,187,211,46.98
Nami,Sona,504,234,270,46.43
Nami,Teemo,1380,707,673,51.23
Nami,Jax,1017,538,479,52.9
Nami,Fizz,716,396,320,55.31
Nami,Kaisa,1873,942,931,50.29
Nami,Morgana,1225,639,586,52.16
Nami,Rumble,294,156,138,53.06
Nami,Amumu,1196,567,629,47.41
Nami,Jinx,3710,1788,1922,48.19
Nami,Lulu,2391,1272,1119,53.2
Nami,Yorick,1241,575,666,46.33
Nami,Kindred,558,280,278,50.18
Nami,Veigar,1231,611,620,49.63
Nami,Tristana,1067,554,513,51.92
Nami,Nautilus,1243,689,554,55.43
Nami,Sion,974,514,460,52.77
Nami,Shaco,1112,584,528,52.52
Nami,Milio,1042,469,573,45.01
Nami,Malphite,1197,624,573,52.13
Nami,Viego,1613,845,768,52.39
Nami,Irelia,957,490,467,51.2
Nami,Twitch,1141,580,561,50.83
Nami,Mordekaiser,1458,712,746,48.83
Nami,Talon,699,324,375,46.35
Nami,Lux,3103,1637,1466,52.76
Nami,Ashe,2133,1115,1018,52.27
Nami,Gangplank,600,303,297,50.5
Nami,Aurora,806,429,377,53.23
Nami,Sivir,639,349,290,54.62
Nami,Yuumi,1027,495,532,48.2
Nami,Poppy,587,295,292,50.26
Nami,Katarina,1023,568,455,55.52
Nami,Ezreal,2645,1439,1206,54.4
Nami,Pantheon,1676,909,767,54.24
Nami,MonkeyKing,849,478,371,56.3
Nami,Jhin,2597,1405,1192,54.1
Nami,Urgot,651,294,357,45.16
Nami,Rammus,345,169,176,48.99
Nami,Xerath,1040,515,525,49.52
Nami,Kled,218,113,105,51.83
Nami,Warwick,1663,894,769,53.76
Nami,Syndra,843,466,377,55.28
Nami,Ambessa,693,385,308,55.56
Nami,JarvanIV,904,482,422,53.32
Nami,Sylas,1356,713,643,52.58
Nami,Garen,1947,955,992,49.05
Nami,Udyr,526,291,235,55.32
Nami,Zyra,1169,540,629,46.19
Nami,Aatrox,1126,573,553,50.89
Nami,Vi,1133,613,520,54.1
Nami,Vayne,1521,767,754,50.43
Nami,Rell,567,264,303,46.56
Nami,KSante,527,302,225,57.31
Nami,Naafiri,376,169,207,44.95
Nami,Olaf,256,108,148,42.19
Nami,Mel,2136,1122,1014,52.53
Nami,TahmKench,850,454,396,53.41
Nami,Rengar,558,328,230,58.78
Nami,Akali,1142,629,513,55.08
Nami,Brand,817,426,391,52.14
Nami,Camille,484,231,253,47.73
Nami,Chogath,1528,756,772,49.48
Nami,Caitlyn,3117,1599,1518,51.3
Nami,Gnar,563,278,285,49.38
Nami,MissFortune,2549,1370,1179,53.75
Nami,Thresh,1565,798,767,50.99
Nami,Khazix,651,320,331,49.16
Nami,Leona,894,446,448,49.89
Nami,FiddleSticks,609,292,317,47.95
Nami,Varus,1004,502,502,50
Nami,Briar,705,364,341,51.63
Nami,Bard,444,192,252,43.24
Nami,Ekko,1163,597,566,51.33
Nami,Elise,952,479,473,50.32
Nami,XinZhao,785,417,368,53.12
Nami,Ahri,1471,776,695,52.75
Nami,Zoe,399,186,213,46.62
Nami,Kennen,286,156,130,54.55
Nami,Volibear,1352,763,589,56.43
Nami,Gragas,594,311,283,52.36
Nami,Kayn,1733,919,814,53.03
Nami,Janna,616,353,263,57.31
Nami,Kayle,928,486,442,52.37
Nami,Fiora,484,215,269,44.42
Nami,Braum,746,381,365,51.07
Nami,Draven,742,390,352,52.56
Nami,Samira,768,400,368,52.08
Nami,Kalista,278,162,116,58.27
Nami,Karma,1990,1064,926,53.47
Nami,Trundle,601,300,301,49.92
Nami,TwistedFate,458,259,199,56.55
Nami,Soraka,924,455,469,49.24
Nami,Diana,1988,1025,963,51.56
Nami,Maokai,484,249,235,51.45
Nami,Quinn,452,218,234,48.23
Nami,Zeri,495,283,212,57.17
Nami,Leblanc,683,351,332,51.39
Nami,Seraphine,860,459,401,53.37
Nami,Renekton,617,359,258,58.18
Nami,Zed,1347,724,623,53.75
Nami,Hecarim,587,336,251,57.24
Nami,Azir,402,193,209,48.01
Nami,Sejuani,398,190,208,47.74
Nami,Evelynn,462,249,213,53.9
Nami,Qiyana,335,182,153,54.33
Nami,Vex,515,260,255,50.49
Nami,Orianna,529,287,242,54.25
Nami,Corki,592,291,301,49.16
Nami,Taric,218,122,96,55.96
Nami,Riven,647,330,317,51
Nami,Belveth,308,168,140,54.55
Nami,Karthus,361,200,161,55.4
Nami,Shen,698,364,334,52.15
Nami,Gwen,680,392,288,57.65
Nami,Nocturne,1480,676,804,45.68
Nami,Smolder,791,435,356,54.99
Nami,Yone,1886,989,897,52.44
Nami,Xayah,496,258,238,52.02
Nami,Rakan,471,266,205,56.48
Nami,Viktor,1106,585,521,52.89
Nami,Cassiopeia,351,175,176,49.86
Nami,Tryndamere,683,360,323,52.71
Nami,Blitzcrank,668,359,309,53.74
Nami,Akshan,497,255,242,51.31
Nami,Jayce,469,206,263,43.92
Nami,AurelionSol,403,178,225,44.17
Nami,Illaoi,525,298,227,56.76
Nami,Velkoz,720,361,359,50.14
Nami,Kassadin,326,156,170,47.85
Nami,Galio,1004,514,490,51.2
Nami,Lillia,538,281,257,52.23
Nami,Heimerdinger,519,239,280,46.05
Nami,Ornn,548,302,246,55.11
Nami,Nidalee,273,171,102,62.64
Nami,Singed,373,192,181,51.47
Nami,Graves,742,412,330,55.53
Nami,Lucian,824,437,387,53.03
Nami,Nasus,662,358,304,54.08
Nami,Skarner,272,159,113,58.46
Nami,Nunu,626,305,321,48.72
Nami,Anivia,452,217,235,48.01
Nami,KogMaw,379,194,185,51.19
Nami,Lissandra,442,233,209,52.71
Nami,Aphelios,672,349,323,51.93
Nami,Pyke,842,448,394,53.21
Nami,Shyvana,294,178,116,60.54
Nami,Renata,232,128,104,55.17
Nami,RekSai,154,73,81,47.4
Nami,Nilah,416,205,211,49.28
Nami,Ryze,371,179,192,48.25
Nami,DrMundo,675,303,372,44.89
Nami,Ivern,221,106,115,47.96
Nami,Neeko,497,269,228,54.12
Nami,Annie,412,208,204,50.49
Nami,Taliyah,334,157,177,47.01
Alistar,Aurora,356,189,167,53.09
Alistar,Corki,242,120,122,49.59
Alistar,Orianna,229,109,120,47.6
Alistar,Xayah,284,147,137,51.76
Alistar,Nami,428,198,230,46.26
Alistar,Shen,288,136,152,47.22
Alistar,Belveth,86,46,40,53.49
Alistar,Akali,477,279,198,58.49
Alistar,Varus,382,206,176,53.93
Alistar,Lulu,668,327,341,48.95
Alistar,Urgot,234,112,122,47.86
Alistar,Briar,313,121,192,38.66
Alistar,Ahri,611,315,296,51.55
Alistar,Caitlyn,1301,655,646,50.35
Alistar,Lux,1069,518,551,48.46
Alistar,Gnar,253,142,111,56.13
Alistar,Sylas,1041,489,552,46.97
Alistar,Mel,1106,571,535,51.63
Alistar,Ashe,1005,517,488,51.44
Alistar,Seraphine,275,135,140,49.09
Alistar,Jax,503,266,237,52.88
Alistar,Gragas,301,163,138,54.15
Alistar,Zed,594,329,265,55.39
Alistar,Twitch,350,148,202,42.29
Alistar,Poppy,360,206,154,57.22
Alistar,Viego,836,423,413,50.6
Alistar,Vayne,779,386,393,49.55
Alistar,Darius,884,426,458,48.19
Alistar,Fizz,289,145,144,50.17
Alistar,Sion,429,218,211,50.82
Alistar,Evelynn,170,90,80,52.94
Alistar,Braum,342,178,164,52.05
Alistar,Garen,740,377,363,50.95
Alistar,Kayn,662,316,346,47.73
Alistar,AurelionSol,169,66,103,39.05
Alistar,Annie,203,87,116,42.86
Alistar,Yasuo,942,491,451,52.12
Alistar,Yorick,474,201,273,42.41
Alistar,Cassiopeia,146,67,79,45.89
Alistar,Smolder,328,171,157,52.13
Alistar,Anivia,118,62,56,52.54
Alistar,Diana,850,413,437,48.59
Alistar,Milio,268,119,149,44.4
Alistar,Chogath,606,284,322,46.86
Alistar,Samira,488,286,202,58.61
Alistar,Mordekaiser,624,281,343,45.03
Alistar,Trundle,262,132,130,50.38
Alistar,Warwick,685,367,318,53.58
Alistar,Veigar,435,233,202,53.56
Alistar,Sett,748,357,391,47.73
Alistar,Syndra,337,156,181,46.29
Alistar,Pyke,411,206,205,50.12
Alistar,Yone,878,454,424,51.71
Alistar,Ambessa,358,165,193,46.09
Alistar,Rengar,171,98,73,57.31
Alistar,Katarina,376,192,184,51.06
Alistar,Ziggs,154,78,76,50.65
Alistar,Soraka,262,151,111,57.63
Alistar,MasterYi,578,296,282,51.21
Alistar,Vladimir,347,179,168,51.59
Alistar,Kaisa,903,484,419,53.6
Alistar,Heimerdinger,203,89,114,43.84
Alistar,Thresh,807,404,403,50.06
Alistar,Teemo,594,280,314,47.14
Alistar,Tristana,459,213,246,46.41
Alistar,Nautilus,786,395,391,50.25
Alistar,Graves,376,186,190,49.47
Alistar,Singed,142,65,77,45.77
Alistar,Aatrox,507,276,231,54.44
Alistar,Sejuani,234,109,125,46.58
Alistar,Azir,193,101,92,52.33
Alistar,Xerath,418,221,197,52.87
Alistar,LeeSin,845,418,427,49.47
Alistar,MissFortune,1000,474,526,47.4
Alistar,FiddleSticks,245,110,135,44.9
Alistar,Zac,325,169,156,52
Alistar,Jhin,940,494,446,52.55
Alistar,Morgana,382,170,212,44.5
Alistar,Lillia,268,135,133,50.37
Alistar,Nasus,328,130,198,39.63
Alistar,Vex,247,113,134,45.75
Alistar,Ezreal,1297,624,673,48.11
Alistar,Camille,207,114,93,55.07
Alistar,Amumu,501,234,267,46.71
Alistar,Fiora,140,75,65,53.57
Alistar,Kassadin,97,45,52,46.39
Alistar,Irelia,440,234,206,53.18
Alistar,Shaco,450,227,223,50.44
Alistar,Leblanc,374,179,195,47.86
Alistar,Draven,277,165,112,59.57
Alistar,Nilah,168,88,80,52.38
Alistar,Jinx,1397,641,756,45.88
Alistar,Kennen,174,89,85,51.15
Alistar,Velkoz,238,126,112,52.94
Alistar,Neeko,201,88,113,43.78
Alistar,JarvanIV,365,155,210,42.47
Alistar,Rumble,157,93,64,59.24
Alistar,Ornn,226,124,102,54.87
Alistar,Senna,311,169,142,54.34
Alistar,Jayce,250,115,135,46
Alistar,Malzahar,516,211,305,40.89
Alistar,KSante,262,135,127,51.53
Alistar,Swain,561,253,308,45.1
Alistar,Aphelios,202,103,99,50.99
Alistar,Lucian,333,163,170,48.95
Alistar,Nocturne,596,234,362,39.26
Alistar,DrMundo,224,124,100,55.36
Alistar,Vi,528,267,261,50.57
Alistar,Pantheon,804,397,407,49.38
Alistar,Galio,477,243,234,50.94
Alistar,Leona,559,288,271,51.52
Alistar,Lissandra,208,109,99,52.4
Alistar,Blitzcrank,540,258,282,47.78
Alistar,Tryndamere,253,134,119,52.96
Alistar,XinZhao,354,179,175,50.56
Alistar,Zyra,417,208,209,49.88
Alistar,Khazix,194,101,93,52.06
Alistar,TahmKench,401,213,188,53.12
Alistar,Gangplank,257,112,145,43.58
Alistar,Qiyana,131,64,67,48.85
Alistar,Elise,363,195,168,53.72
Alistar,Volibear,509,275,234,54.03
Alistar,Renekton,258,123,135,47.67
Alistar,MonkeyKing,355,154,201,43.38
Alistar,Olaf,142,65,77,45.77
Alistar,Talon,306,167,139,54.58
Alistar,Ekko,491,255,236,51.93
Alistar,Udyr,209,136,73,65.07
Alistar,Hwei,296,149,147,50.34
Alistar,Ivern,90,49,41,54.44
Alistar,Kalista,150,74,76,49.33
Alistar,Ryze,167,80,87,47.9
Alistar,Riven,250,146,104,58.4
Alistar,TwistedFate,163,95,68,58.28
Alistar,Karthus,168,81,87,48.21
Alistar,RekSai,69,40,29,57.97
Alistar,Brand,317,161,156,50.79
Alistar,Renata,120,60,60,50
Alistar,Karma,552,249,303,45.11
Alistar,Rell,394,199,195,50.51
Alistar,Malphite,461,244,217,52.93
Alistar,Taric,124,61,63,49.19
Alistar,Hecarim,189,110,79,58.2
Alistar,Janna,209,104,105,49.76
Alistar,Gwen,197,105,92,53.3
Alistar,Illaoi,238,94,144,39.5
Alistar,Naafiri,129,73,56,56.59
Alistar,Quinn,144,82,62,56.94
Alistar,Sivir,324,135,189,41.67
Alistar,Viktor,484,229,255,47.31
Alistar,Zilean,150,70,80,46.67
Alistar,Rakan,179,105,74,58.66
Alistar,Rammus,161,71,90,44.1
Alistar,Kayle,271,117,154,43.17
Alistar,Zoe,164,76,88,46.34
Alistar,Taliyah,93,48,45,51.61
Alistar,Zeri,267,138,129,51.69
Alistar,Skarner,128,81,47,63.28
Alistar,Akshan,126,67,59,53.17
Alistar,Kindred,205,125,80,60.98
Alistar,Shyvana,147,75,72,51.02
Alistar,Yuumi,351,165,186,47.01
Alistar,Bard,129,78,51,60.47
Alistar,KogMaw,111,49,62,44.14
Alistar,Sona,123,47,76,38.21
Alistar,Nunu,217,88,129,40.55
Alistar,Maokai,259,125,134,48.26
Alistar,Kled,75,47,28,62.67
Alistar,Nidalee,127,66,61,51.97
Hwei,Aurora,605,331,274,54.71
Hwei,Corki,283,150,133,53
Hwei,Orianna,340,166,174,48.82
Hwei,Xayah,322,161,161,50
Hwei,Nami,779,377,402,48.4
Hwei,Gnar,308,161,147,52.27
Hwei,Zyra,771,379,392,49.16
Hwei,Azir,284,125,159,44.01
Hwei,Varus,718,358,360,49.86
Hwei,Nautilus,871,450,421,51.66
Hwei,Darius,1544,792,752,51.3
Hwei,Khazix,450,225,225,50
Hwei,Zed,745,360,385,48.32
Hwei,Aphelios,491,237,254,48.27
Hwei,Pyke,605,319,286,52.73
Hwei,Garen,1123,579,544,51.56
Hwei,Nocturne,956,522,434,54.6
Hwei,Fizz,433,212,221,48.96
Hwei,Jinx,2187,1082,1105,49.47
Hwei,Thresh,1032,530,502,51.36
Hwei,Graves,446,221,225,49.55
Hwei,Malzahar,839,425,414,50.66
Hwei,Lucian,497,265,232,53.32
Hwei,Lux,1902,942,960,49.53
Hwei,Tryndamere,391,190,201,48.59
Hwei,Kayn,1062,504,558,47.46
Hwei,Viktor,950,444,506,46.74
Hwei,Jhin,1683,785,898,46.64
Hwei,Ornn,330,171,159,51.82
Hwei,Volibear,836,438,398,52.39
Hwei,Ezreal,1867,907,960,48.58
Hwei,Velkoz,465,224,241,48.17
Hwei,Sion,559,258,301,46.15
Hwei,Shaco,710,357,353,50.28
Hwei,Milio,454,241,213,53.08
Hwei,Karthus,210,107,103,50.95
Hwei,Ekko,788,354,434,44.92
Hwei,KogMaw,230,115,115,50
Hwei,Lulu,1104,579,525,52.45
Hwei,Nasus,518,235,283,45.37
Hwei,Amumu,744,396,348,53.23
Hwei,Ryze,250,125,125,50
Hwei,Ashe,1629,847,782,52
Hwei,Neeko,352,183,169,51.99
Hwei,Akali,724,366,358,50.55
Hwei,Diana,1152,595,557,51.65
Hwei,Talon,434,201,233,46.31
Hwei,Vayne,934,476,458,50.96
Hwei,Zilean,303,138,165,45.54
Hwei,Renekton,386,219,167,56.74
Hwei,Mordekaiser,1004,506,498,50.4
Hwei,Ahri,1100,553,547,50.27
Hwei,Rell,374,168,206,44.92
Hwei,Aatrox,656,321,335,48.93
Hwei,Belveth,205,82,123,40
Hwei,Syndra,670,336,334,50.15
Hwei,Ambessa,445,203,242,45.62
Hwei,Viego,1206,602,604,49.92
Hwei,TwistedFate,315,157,158,49.84
Hwei,Ziggs,311,168,143,54.02
Hwei,Veigar,789,356,433,45.12
Hwei,Shyvana,175,93,82,53.14
Hwei,Sett,1113,527,586,47.35
Hwei,Xerath,901,455,446,50.5
Hwei,Caitlyn,2186,1192,994,54.53
Hwei,Kennen,215,116,99,53.95
Hwei,Rengar,262,150,112,57.25
Hwei,Yasuo,1460,701,759,48.01
Hwei,Smolder,454,246,208,54.19
Hwei,Kayle,536,291,245,54.29
Hwei,Pantheon,1195,607,588,50.79
Hwei,Samira,494,267,227,54.05
Hwei,TahmKench,600,315,285,52.5
Hwei,MasterYi,905,472,433,52.15
Hwei,Yorick,731,333,398,45.55
Hwei,Nunu,390,189,201,48.46
Hwei,Sylas,1020,504,516,49.41
Hwei,Tristana,733,376,357,51.3
Hwei,Yone,1362,714,648,52.42
Hwei,Kaisa,1242,635,607,51.13
Hwei,Quinn,302,144,158,47.68
Hwei,Lissandra,178,102,76,57.3
Hwei,Chogath,910,474,436,52.09
Hwei,Teemo,861,445,416,51.68
Hwei,Mel,1533,850,683,55.45
Hwei,Gwen,403,216,187,53.6
Hwei,Galio,737,384,353,52.1
Hwei,Brand,618,352,266,56.96
Hwei,Shen,449,248,201,55.23
Hwei,Kalista,174,103,71,59.2
Hwei,MissFortune,1695,838,857,49.44
Hwei,Hecarim,306,153,153,50
Hwei,Vex,372,199,173,53.49
Hwei,Warwick,1127,526,601,46.67
Hwei,Riven,390,206,184,52.82
Hwei,Vi,720,366,354,50.83
Hwei,Swain,680,367,313,53.97
Hwei,Singed,230,100,130,43.48
Hwei,Bard,207,84,123,40.58
Hwei,Soraka,396,226,170,57.07
Hwei,Gangplank,354,195,159,55.08
Hwei,Leona,613,290,323,47.31
Hwei,Naafiri,248,120,128,48.39
Hwei,Briar,548,274,274,50
Hwei,Blitzcrank,588,320,268,54.42
Hwei,Illaoi,359,173,186,48.19
Hwei,Draven,420,193,227,45.95
Hwei,Sejuani,377,172,205,45.62
Hwei,Trundle,452,235,217,51.99
Hwei,Janna,277,125,152,45.13
Hwei,Vladimir,471,242,229,51.38
Hwei,Rammus,185,89,96,48.11
Hwei,Karma,1035,489,546,47.25
Hwei,Morgana,890,452,438,50.79
Hwei,Lillia,391,211,180,53.96
Hwei,Katarina,639,339,300,53.05
Hwei,Elise,593,278,315,46.88
Hwei,Qiyana,186,119,67,63.98
Hwei,Heimerdinger,393,184,209,46.82
Hwei,DrMundo,385,196,189,50.91
Hwei,Nidalee,264,153,111,57.95
Hwei,Zoe,297,155,142,52.19
Hwei,Jax,656,306,350,46.65
Hwei,Kassadin,203,104,99,51.23
Hwei,Irelia,626,282,344,45.05
Hwei,FiddleSticks,352,207,145,58.81
Hwei,KSante,400,198,202,49.5
Hwei,Rakan,307,144,163,46.91
Hwei,LeeSin,1217,625,592,51.36
Hwei,Gragas,400,211,189,52.75
Hwei,Annie,224,90,134,40.18
Hwei,Anivia,239,133,106,55.65
Hwei,Twitch,597,282,315,47.24
Hwei,Kindred,326,170,156,52.15
Hwei,Seraphine,562,288,274,51.25
Hwei,Urgot,407,195,212,47.91
Hwei,Zac,391,209,182,53.45
Hwei,Skarner,231,103,128,44.59
Hwei,Nilah,248,131,117,52.82
Hwei,Taric,133,64,69,48.12
Hwei,AurelionSol,294,137,157,46.6
Hwei,Malphite,681,336,345,49.34
Hwei,Rumble,245,119,126,48.57
Hwei,RekSai,97,36,61,37.11
Hwei,Maokai,390,219,171,56.15
Hwei,Jayce,372,205,167,55.11
Hwei,Braum,445,224,221,50.34
Hwei,Cassiopeia,199,104,95,52.26
Hwei,XinZhao,500,223,277,44.6
Hwei,Camille,267,146,121,54.68
Hwei,Alistar,296,147,149,49.66
Hwei,Taliyah,239,121,118,50.63
Hwei,MonkeyKing,573,292,281,50.96
Hwei,Poppy,449,250,199,55.68
Hwei,Ivern,102,54,48,52.94
Hwei,Akshan,266,108,158,40.6
Hwei,Renata,95,39,56,41.05
Hwei,Senna,613,333,280,54.32
Hwei,JarvanIV,406,216,190,53.2
Hwei,Yuumi,630,326,304,51.75
Hwei,Fiora,292,136,156,46.58
Hwei,Leblanc,500,248,252,49.6
Hwei,Sivir,362,158,204,43.65
Hwei,Sona,264,123,141,46.59
Hwei,Evelynn,233,111,122,47.64
Hwei,Zeri,335,201,134,60
Hwei,Udyr,348,205,143,58.91
Hwei,Kled,145,63,82,43.45
Hwei,Olaf,165,82,83,49.7
Mordekaiser,Shen,1101,554,547,50.32
Mordekaiser,Belveth,358,181,177,50.56
Mordekaiser,Akali,1889,1023,866,54.16
Mordekaiser,Varus,1302,642,660,49.31
Mordekaiser,Lulu,1705,949,756,55.66
Mordekaiser,Irelia,1251,622,629,49.72
Mordekaiser,Hecarim,593,325,268,54.81
Mordekaiser,Malzahar,1615,808,807,50.03
Mordekaiser,Vayne,2086,993,1093,47.6
Mordekaiser,Pantheon,2325,1250,1075,53.76
Mordekaiser,Renekton,770,456,314,59.22
Mordekaiser,Diana,2527,1300,1227,51.44
Mordekaiser,Azir,473,244,229,51.59
Mordekaiser,MissFortune,4085,2137,1948,52.31
Mordekaiser,Yuumi,1271,691,580,54.37
Mordekaiser,Darius,3335,1711,1624,51.3
Mordekaiser,LeeSin,1939,1004,935,51.78
Mordekaiser,KogMaw,474,240,234,50.63
Mordekaiser,Thresh,1988,1039,949,52.26
Mordekaiser,Volibear,2252,1182,1070,52.49
Mordekaiser,Yorick,1834,899,935,49.02
Mordekaiser,Zoe,551,269,282,48.82
Mordekaiser,Samira,1213,674,539,55.56
Mordekaiser,Jax,1485,801,684,53.94
Mordekaiser,Amumu,1842,926,916,50.27
Mordekaiser,Ahri,2073,1077,996,51.95
Mordekaiser,Caitlyn,4186,2095,2091,50.05
Mordekaiser,Aatrox,1358,671,687,49.41
Mordekaiser,Kayn,2370,1198,1172,50.55
Mordekaiser,Katarina,1125,591,534,52.53
Mordekaiser,Jhin,3107,1651,1456,53.14
Mordekaiser,Blitzcrank,1007,536,471,53.23
Mordekaiser,Ekko,1425,740,685,51.93
Mordekaiser,Kaisa,2210,1202,1008,54.39
Mordekaiser,Gragas,679,387,292,57
Mordekaiser,Zed,1665,876,789,52.61
Mordekaiser,Twitch,1299,711,588,54.73
Mordekaiser,Garen,2677,1498,1179,55.96
Mordekaiser,Lillia,892,459,433,51.46
Mordekaiser,Nami,1458,746,712,51.17
Mordekaiser,Vex,780,434,346,55.64
Mordekaiser,Neeko,707,349,358,49.36
Mordekaiser,Sett,2705,1375,1330,50.83
Mordekaiser,XinZhao,981,538,443,54.84
Mordekaiser,Fizz,946,542,404,57.29
Mordekaiser,Karma,1659,819,840,49.37
Mordekaiser,Warwick,2758,1295,1463,46.95
Mordekaiser,Jinx,4507,2323,2184,51.54
Mordekaiser,Yasuo,2899,1501,1398,51.78
Mordekaiser,Chogath,2070,1123,947,54.25
Mordekaiser,Pyke,1111,548,563,49.32
Mordekaiser,Yone,2793,1522,1271,54.49
Mordekaiser,Nocturne,1893,898,995,47.44
Mordekaiser,Velkoz,887,399,488,44.98
Mordekaiser,Shaco,1513,823,690,54.4
Mordekaiser,Vi,1431,731,700,51.08
Mordekaiser,Nautilus,1569,810,759,51.63
Mordekaiser,Evelynn,529,267,262,50.47
Mordekaiser,Lux,3908,1983,1925,50.74
Mordekaiser,Ashe,3009,1548,1461,51.45
Mordekaiser,Mel,3141,1738,1403,55.33
Mordekaiser,Tristana,1555,834,721,53.63
Mordekaiser,Swain,1565,822,743,52.52
Mordekaiser,Teemo,1983,1038,945,52.34
Mordekaiser,Sejuani,600,368,232,61.33
Mordekaiser,Urgot,793,397,396,50.06
Mordekaiser,Riven,717,383,334,53.42
Mordekaiser,Hwei,1004,498,506,49.6
Mordekaiser,Milio,868,444,424,51.15
Mordekaiser,KSante,809,401,408,49.57
Mordekaiser,Nunu,905,475,430,52.49
Mordekaiser,Sylas,1935,1060,875,54.78
Mordekaiser,Ziggs,580,332,248,57.24
Mordekaiser,Zeri,564,311,253,55.14
Mordekaiser,Leona,1374,760,614,55.31
Mordekaiser,Ambessa,816,426,390,52.21
Mordekaiser,Graves,870,436,434,50.11
Mordekaiser,Anivia,502,263,239,52.39
Mordekaiser,Kayle,1094,486,608,44.42
Mordekaiser,Jayce,529,278,251,52.55
Mordekaiser,Morgana,1887,989,898,52.41
Mordekaiser,Trundle,1050,548,502,52.19
Mordekaiser,Draven,673,341,332,50.67
Mordekaiser,Rell,656,363,293,55.34
Mordekaiser,Ezreal,3462,1852,1610,53.5
Mordekaiser,Zyra,1427,668,759,46.81
Mordekaiser,Malphite,1835,1008,827,54.93
Mordekaiser,Akshan,473,251,222,53.07
Mordekaiser,Aphelios,816,380,436,46.57
Mordekaiser,Zilean,430,224,206,52.09
Mordekaiser,Tryndamere,913,436,477,47.75
Mordekaiser,Leblanc,844,471,373,55.81
Mordekaiser,Sivir,778,373,405,47.94
Mordekaiser,AurelionSol,599,344,255,57.43
Mordekaiser,Annie,496,252,244,50.81
Mordekaiser,Rammus,480,289,191,60.21
Mordekaiser,Sion,1041,505,536,48.51
Mordekaiser,Orianna,573,291,282,50.79
Mordekaiser,Soraka,856,427,429,49.88
Mordekaiser,MonkeyKing,1101,559,542,50.77
Mordekaiser,Karthus,418,215,203,51.44
Mordekaiser,Rakan,558,259,299,46.42
Mordekaiser,Ornn,672,375,297,55.8
Mordekaiser,Syndra,943,491,452,52.07
Mordekaiser,Aurora,922,467,455,50.65
Mordekaiser,Gangplank,653,367,286,56.2
Mordekaiser,Viego,1962,1004,958,51.17
Mordekaiser,Kennen,309,152,157,49.19
Mordekaiser,Braum,861,451,410,52.38
Mordekaiser,Briar,1231,566,665,45.98
Mordekaiser,Seraphine,1201,658,543,54.79
Mordekaiser,JarvanIV,796,411,385,51.63
Mordekaiser,Xayah,688,339,349,49.27
Mordekaiser,Alistar,624,343,281,54.97
Mordekaiser,Illaoi,996,555,441,55.72
Mordekaiser,Brand,1181,592,589,50.13
Mordekaiser,Quinn,467,205,262,43.9
Mordekaiser,Camille,479,257,222,53.65
Mordekaiser,Poppy,851,437,414,51.35
Mordekaiser,Viktor,1195,616,579,51.55
Mordekaiser,Senna,1104,569,535,51.54
Mordekaiser,Gnar,494,247,247,50
Mordekaiser,Kindred,634,367,267,57.89
Mordekaiser,RekSai,165,100,65,60.61
Mordekaiser,Lucian,1017,496,521,48.77
Mordekaiser,Lissandra,475,195,280,41.05
Mordekaiser,Nasus,1188,593,595,49.92
Mordekaiser,TahmKench,1407,729,678,51.81
Mordekaiser,Rengar,513,299,214,58.28
Mordekaiser,Gwen,677,367,310,54.21
Mordekaiser,Vladimir,1016,522,494,51.38
Mordekaiser,Taliyah,327,187,140,57.19
Mordekaiser,MasterYi,1903,898,1005,47.19
Mordekaiser,Veigar,1675,868,807,51.82
Mordekaiser,FiddleSticks,671,336,335,50.07
Mordekaiser,Rumble,384,225,159,58.59
Mordekaiser,Sona,419,201,218,47.97
Mordekaiser,Zac,596,289,307,48.49
Mordekaiser,Naafiri,548,274,274,50
Mordekaiser,Kassadin,339,169,170,49.85
Mordekaiser,Nidalee,278,158,120,56.83
Mordekaiser,DrMundo,964,466,498,48.34
Mordekaiser,Singed,438,199,239,45.43
Mordekaiser,Shyvana,386,198,188,51.3
Mordekaiser,Maokai,708,357,351,50.42
Mordekaiser,Khazix,750,405,345,54
Mordekaiser,Corki,423,226,197,53.43
Mordekaiser,Skarner,346,185,161,53.47
Mordekaiser,Ivern,181,93,88,51.38
Mordekaiser,Udyr,655,331,324,50.53
Mordekaiser,Xerath,1327,667,660,50.26
Mordekaiser,Talon,773,444,329,57.44
Mordekaiser,Kled,244,144,100,59.02
Mordekaiser,Heimerdinger,733,351,382,47.89
Mordekaiser,Smolder,849,457,392,53.83
Mordekaiser,Taric,384,169,215,44.01
Mordekaiser,Fiora,656,296,360,45.12
Mordekaiser,Kalista,347,175,172,50.43
Mordekaiser,Janna,454,228,226,50.22
Mordekaiser,Nilah,423,201,222,47.52
Mordekaiser,TwistedFate,480,233,247,48.54
Mordekaiser,Cassiopeia,384,186,198,48.44
Mordekaiser,Olaf,582,302,280,51.89
Mordekaiser,Galio,1255,611,644,48.69
Mordekaiser,Qiyana,299,154,145,51.51
Mordekaiser,Bard,435,224,211,51.49
Mordekaiser,Elise,842,458,384,54.39
Mordekaiser,Renata,236,123,113,52.12
Mordekaiser,Ryze,500,286,214,57.2
Yone,Shen,1342,656,686,48.88
Yone,Belveth,486,263,223,54.12
Yone,Akali,3239,1504,1735,46.43
Yone,Varus,1969,1015,954,51.55
Yone,Lulu,2771,1230,1541,44.39
Yone,Mel,4307,2182,2125,50.66
Yone,Trundle,1390,653,737,46.98
Yone,Zed,2502,1235,1267,49.36
Yone,Vayne,2561,1150,1411,44.9
Yone,Sejuani,770,382,388,49.61
Yone,Jayce,1195,526,669,44.02
Yone,Talon,1361,721,640,52.98
Yone,Kennen,587,271,316,46.17
Yone,Lucian,1483,687,796,46.33
Yone,Elise,1513,775,738,51.22
Yone,Darius,3933,1820,2113,46.28
Yone,Volibear,2477,1161,1316,46.87
Yone,Jinx,6245,2894,3351,46.34
Yone,Lux,5494,2581,2913,46.98
Yone,Tryndamere,1179,576,603,48.85
Yone,Kayn,3238,1445,1793,44.63
Yone,Viktor,2020,958,1062,47.43
Yone,Jhin,4583,2207,2376,48.16
Yone,Ornn,792,389,403,49.12
Yone,Riven,979,421,558,43
Yone,Ziggs,742,349,393,47.04
Yone,Katarina,1711,795,916,46.46
Yone,LeeSin,3837,1918,1919,49.99
Yone,Rumble,681,348,333,51.1
Yone,Amumu,2263,995,1268,43.97
Yone,Yasuo,5810,2701,3109,46.49
Yone,Caitlyn,6129,2805,3324,45.77
Yone,Zyra,2044,945,1099,46.23
Yone,XinZhao,1462,697,765,47.67
Yone,Briar,1676,710,966,42.36
Yone,AurelionSol,733,372,361,50.75
Yone,Ashe,4379,2117,2262,48.34
Yone,Pantheon,3939,1949,1990,49.48
Yone,Rengar,719,319,400,44.37
Yone,Fizz,1228,524,704,42.67
Yone,KogMaw,629,288,341,45.79
Yone,Gwen,1053,497,556,47.2
Yone,Ezreal,5882,2860,3022,48.62
Yone,Rakan,907,407,500,44.87
Yone,Garen,3557,1642,1915,46.16
Yone,MonkeyKing,1561,708,853,45.36
Yone,Akshan,702,347,355,49.43
Yone,Tristana,2088,1037,1051,49.66
Yone,Swain,2014,966,1048,47.96
Yone,Graves,1416,673,743,47.53
Yone,Veigar,2156,1010,1146,46.85
Yone,Jax,2478,1160,1318,46.81
Yone,Mordekaiser,2793,1271,1522,45.51
Yone,Syndra,1268,599,669,47.24
Yone,Kaisa,3832,1901,1931,49.61
Yone,Karma,2627,1247,1380,47.47
Yone,Shaco,2071,1020,1051,49.25
Yone,Aurora,1668,804,864,48.2
Yone,Zilean,670,332,338,49.55
Yone,Gragas,1122,561,561,50
Yone,Braum,1165,530,635,45.49
Yone,Gnar,891,451,440,50.62
Yone,Viego,3284,1518,1766,46.22
Yone,TwistedFate,749,429,320,57.28
Yone,Naafiri,724,385,339,53.18
Yone,Nidalee,664,366,298,55.12
Yone,Xayah,1018,557,461,54.72
Yone,Renata,355,175,180,49.3
Yone,Illaoi,1048,507,541,48.38
Yone,Ahri,2980,1374,1606,46.11
Yone,TahmKench,1592,753,839,47.3
Yone,Camille,662,327,335,49.4
Yone,Lissandra,703,317,386,45.09
Yone,Smolder,1378,681,697,49.42
Yone,Yorick,2336,1041,1295,44.56
Yone,Khazix,1051,517,534,49.19
Yone,Vex,1320,642,678,48.64
Yone,Nautilus,2514,1207,1307,48.01
Yone,Chogath,2641,1291,1350,48.88
Yone,Sett,3537,1537,2000,43.45
Yone,Irelia,2293,1084,1209,47.27
Yone,Aatrox,2189,1056,1133,48.24
Yone,Vladimir,1560,797,763,51.09
Yone,Renekton,1431,620,811,43.33
Yone,Lillia,1231,621,610,50.45
Yone,Yuumi,1801,922,879,51.19
Yone,Warwick,3255,1404,1851,43.13
Yone,Diana,3521,1689,1832,47.97
Yone,Soraka,1108,480,628,43.32
Yone,Singed,567,263,304,46.38
Yone,Teemo,2522,1099,1423,43.58
Yone,Skarner,588,299,289,50.85
Yone,Senna,1602,781,821,48.75
Yone,Draven,1025,484,541,47.22
Yone,Bard,583,280,303,48.03
Yone,Sylas,3796,1950,1846,51.37
Yone,MissFortune,5328,2533,2795,47.54
Yone,Neeko,1066,502,564,47.09
Yone,Brand,1639,755,884,46.06
Yone,Heimerdinger,1126,507,619,45.03
Yone,Rammus,849,379,470,44.64
Yone,Morgana,2507,1204,1303,48.03
Yone,Malzahar,2139,1030,1109,48.15
Yone,Vi,2202,1042,1160,47.32
Yone,Rell,1018,491,527,48.23
Yone,MasterYi,2819,1313,1506,46.58
Yone,Seraphine,1547,793,754,51.26
Yone,Kayle,1316,664,652,50.46
Yone,Malphite,2486,1194,1292,48.03
Yone,Leona,1891,917,974,48.49
Yone,Leblanc,1440,677,763,47.01
Yone,Urgot,950,390,560,41.05
Yone,Samira,1584,697,887,44
Yone,Thresh,2956,1335,1621,45.16
Yone,Quinn,780,361,419,46.28
Yone,Janna,677,330,347,48.74
Yone,KSante,1225,655,570,53.47
Yone,Nocturne,2754,1294,1460,46.99
Yone,Hwei,1362,648,714,47.58
Yone,Kalista,522,235,287,45.02
Yone,Galio,1992,971,1021,48.74
Yone,Sion,1639,824,815,50.27
Yone,Corki,832,441,391,53
Yone,Pyke,1828,886,942,48.47
Yone,Udyr,797,404,393,50.69
Yone,Orianna,861,460,401,53.43
Yone,Qiyana,508,268,240,52.76
Yone,Nasus,1597,804,793,50.34
Yone,Taliyah,500,245,255,49
Yone,FiddleSticks,1022,481,541,47.06
Yone,Azir,698,345,353,49.43
Yone,Maokai,1016,512,504,50.39
Yone,Fiora,816,360,456,44.12
Yone,Nilah,646,270,376,41.8
Yone,Blitzcrank,1790,902,888,50.39
Yone,Gangplank,1060,543,517,51.23
Yone,JarvanIV,1204,576,628,47.84
Yone,Velkoz,1299,557,742,42.88
Yone,Sivir,1072,525,547,48.97
Yone,Cassiopeia,636,287,349,45.13
Yone,Kindred,951,424,527,44.58
Yone,Alistar,878,424,454,48.29
Yone,Ekko,1934,890,1044,46.02
Yone,Twitch,1577,756,821,47.94
Yone,Shyvana,486,234,252,48.15
Yone,Nami,1886,897,989,47.56
Yone,DrMundo,1195,598,597,50.04
Yone,Taric,430,185,245,43.02
Yone,Kled,411,204,207,49.64
Yone,Evelynn,789,375,414,47.53
Yone,Sona,660,283,377,42.88
Yone,Xerath,2044,947,1097,46.33
Yone,Nunu,1150,566,584,49.22
Yone,Aphelios,1079,500,579,46.34
Yone,Milio,1186,528,658,44.52
Yone,Karthus,648,308,340,47.53
Yone,Zeri,925,428,497,46.27
Yone,Ivern,303,166,137,54.79
Yone,Ambessa,1335,633,702,47.42
Yone,Kassadin,396,181,215,45.71
Yone,Olaf,476,222,254,46.64
Yone,Poppy,1348,602,746,44.66
Yone,Hecarim,832,438,394,52.64
Yone,Zoe,900,416,484,46.22
Yone,Ryze,779,320,459,41.08
Yone,Annie,750,349,401,46.53
Yone,Zac,1137,495,642,43.54
Yone,Anivia,536,251,285,46.83
Yone,RekSai,216,108,108,50
Shen,Mordekaiser,1101,547,554,49.68
Shen,Vi,676,303,373,44.82
Shen,Yone,1342,686,656,51.12
Shen,Caitlyn,1976,959,1017,48.53
Shen,Alistar,288,152,136,52.78
Shen,Sett,1203,556,647,46.22
Shen,Gragas,440,227,213,51.59
Shen,Yasuo,1400,756,644,54
Shen,Kalista,139,87,52,62.59
Shen,Mel,1367,671,696,49.09
Shen,Khazix,311,158,153,50.8
Shen,Lissandra,255,110,145,43.14
Shen,Lucian,462,256,206,55.41
Shen,Rell,379,166,213,43.8
Shen,Yorick,811,384,427,47.35
Shen,Rengar,278,140,138,50.36
Shen,Irelia,551,259,292,47.01
Shen,Ezreal,1509,793,716,52.55
Shen,Soraka,468,243,225,51.92
Shen,Talon,362,186,176,51.38
Shen,Viktor,666,322,344,48.35
Shen,Malzahar,720,304,416,42.22
Shen,Ahri,962,505,457,52.49
Shen,Varus,650,310,340,47.69
Shen,Vex,367,164,203,44.69
Shen,Kayn,1098,507,591,46.17
Shen,Darius,1361,653,708,47.98
Shen,Janna,285,123,162,43.16
Shen,Vladimir,536,262,274,48.88
Shen,Udyr,288,141,147,48.96
Shen,Diana,1140,586,554,51.4
Shen,Jhin,1492,727,765,48.73
Shen,Lux,1804,870,934,48.23
Shen,TahmKench,564,324,240,57.45
Shen,Evelynn,244,125,119,51.23
Shen,Kassadin,167,98,69,58.68
Shen,MissFortune,1843,882,961,47.86
Shen,Thresh,993,550,443,55.39
Shen,LeeSin,957,471,486,49.22
Shen,Galio,668,321,347,48.05
Shen,Akali,696,307,389,44.11
Shen,Ekko,723,371,352,51.31
Shen,Kaisa,1123,572,551,50.93
Shen,Jax,738,369,369,50
Shen,Nasus,479,234,245,48.85
Shen,Kindred,333,183,150,54.95
Shen,Jinx,2061,918,1143,44.54
Shen,Morgana,888,379,509,42.68
Shen,Ornn,305,160,145,52.46
Shen,Velkoz,484,248,236,51.24
Shen,Corki,321,149,172,46.42
Shen,Shaco,717,376,341,52.44
Shen,Smolder,522,283,239,54.21
Shen,Fiora,261,133,128,50.96
Shen,Zoe,255,134,121,52.55
Shen,Tristana,776,408,368,52.58
Shen,KSante,356,185,171,51.97
Shen,Sivir,383,201,182,52.48
Shen,Aatrox,617,276,341,44.73
Shen,Bard,245,112,133,45.71
Shen,Viego,1078,545,533,50.56
Shen,Ziggs,226,126,100,55.75
Shen,Samira,540,274,266,50.74
Shen,Warwick,1075,517,558,48.09
Shen,Zyra,730,369,361,50.55
Shen,Nocturne,929,388,541,41.77
Shen,Braum,421,202,219,47.98
Shen,Neeko,352,160,192,45.45
Shen,Draven,401,202,199,50.37
Shen,Nautilus,830,439,391,52.89
Shen,Rumble,174,83,91,47.7
Shen,Twitch,573,305,268,53.23
Shen,Brand,546,244,302,44.69
Shen,Malphite,652,349,303,53.53
Shen,Zed,826,398,428,48.18
Shen,Syndra,413,193,220,46.73
Shen,Pantheon,1128,542,586,48.05
Shen,Ambessa,495,269,226,54.34
Shen,Lillia,410,210,200,51.22
Shen,MonkeyKing,495,245,250,49.49
Shen,Hwei,449,201,248,44.77
Shen,Pyke,623,311,312,49.92
Shen,Tryndamere,456,218,238,47.81
Shen,Orianna,336,160,176,47.62
Shen,Ashe,1387,676,711,48.74
Shen,Vayne,1071,489,582,45.66
Shen,Rammus,248,129,119,52.02
Shen,Zilean,256,130,126,50.78
Shen,Kled,172,86,86,50
Shen,Illaoi,365,164,201,44.93
Shen,KogMaw,237,95,142,40.08
Shen,Chogath,908,426,482,46.92
Shen,Sejuani,312,155,157,49.68
Shen,Katarina,541,298,243,55.08
Shen,Nami,698,334,364,47.85
Shen,Karma,827,420,407,50.79
Shen,Renekton,307,171,136,55.7
Shen,Fizz,487,262,225,53.8
Shen,MasterYi,831,373,458,44.89
Shen,Akshan,235,137,98,58.3
Shen,Amumu,838,371,467,44.27
Shen,Sylas,930,476,454,51.18
Shen,Blitzcrank,580,273,307,47.07
Shen,Graves,470,215,255,45.74
Shen,Senna,579,243,336,41.97
Shen,Gangplank,346,143,203,41.33
Shen,Aphelios,383,215,168,56.14
Shen,Skarner,132,71,61,53.79
Shen,Camille,256,125,131,48.83
Shen,Elise,516,261,255,50.58
Shen,Seraphine,479,240,239,50.1
Shen,JarvanIV,511,240,271,46.97
Shen,Swain,727,323,404,44.43
Shen,Shyvana,200,105,95,52.5
Shen,Nunu,400,195,205,48.75
Shen,Teemo,917,472,445,51.47
Shen,Annie,219,115,104,52.51
Shen,Leblanc,406,179,227,44.09
Shen,Xerath,582,294,288,50.52
Shen,Garen,1211,602,609,49.71
Shen,AurelionSol,282,157,125,55.67
Shen,Milio,363,174,189,47.93
Shen,Volibear,832,405,427,48.68
Shen,Sion,649,334,315,51.46
Shen,Briar,514,243,271,47.28
Shen,Olaf,198,101,97,51.01
Shen,Taric,148,77,71,52.03
Shen,Anivia,233,121,112,51.93
Shen,Maokai,354,167,187,47.18
Shen,Aurora,522,250,272,47.89
Shen,Qiyana,200,105,95,52.5
Shen,Nilah,270,136,134,50.37
Shen,Veigar,693,340,353,49.06
Shen,Kayle,530,224,306,42.26
Shen,TwistedFate,221,124,97,56.11
Shen,Urgot,356,176,180,49.44
Shen,Leona,644,318,326,49.38
Shen,Taliyah,170,67,103,39.41
Shen,Nidalee,199,121,78,60.8
Shen,Ivern,110,55,55,50
Shen,Singed,212,123,89,58.02
Shen,Renata,108,60,48,55.56
Shen,Zac,327,191,136,58.41
Shen,Azir,250,136,114,54.4
Shen,Poppy,420,207,213,49.29
Shen,Riven,397,181,216,45.59
Shen,Rakan,261,148,113,56.7
Shen,DrMundo,401,164,237,40.9
Shen,Hecarim,307,148,159,48.21
Shen,XinZhao,440,267,173,60.68
Shen,Sona,242,99,143,40.91
Shen,Trundle,436,219,217,50.23
Shen,Heimerdinger,359,172,187,47.91
Shen,Gnar,304,164,140,53.95
Shen,Lulu,1011,480,531,47.48
Shen,Ryze,239,103,136,43.1
Shen,FiddleSticks,342,192,150,56.14
Shen,Belveth,178,102,76,57.3
Shen,Quinn,247,111,136,44.94
Shen,Xayah,393,197,196,50.13
Shen,RekSai,109,57,52,52.29
Shen,Jayce,300,128,172,42.67
Shen,Naafiri,220,113,107,51.36
Shen,Karthus,179,95,84,53.07
Shen,Yuumi,558,282,276,50.54
Shen,Cassiopeia,201,99,102,49.25
Shen,Kennen,167,103,64,61.68
Shen,Zeri,268,108,160,40.3
Shen,Gwen,433,211,222,48.73
Akali,Mordekaiser,1889,866,1023,45.84
Akali,Vi,1232,551,681,44.72
Akali,Yone,3239,1735,1504,53.57
Akali,Caitlyn,3617,1727,1890,47.75
Akali,Alistar,477,198,279,41.51
Akali,Trundle,777,371,406,47.75
Akali,Volibear,1543,737,806,47.76
Akali,Viktor,1202,630,572,52.41
Akali,Xayah,607,317,290,52.22
Akali,Lulu,1662,818,844,49.22
Akali,Gangplank,565,286,279,50.62
Akali,FiddleSticks,650,308,342,47.38
Akali,Varus,1129,566,563,50.13
Akali,Zilean,353,153,200,43.34
Akali,Aatrox,1071,547,524,51.07
Akali,Kayn,1793,843,950,47.02
Akali,Katarina,1023,537,486,52.49
Akali,Draven,525,256,269,48.76
Akali,Blitzcrank,1002,563,439,56.19
Akali,Yasuo,2934,1485,1449,50.61
Akali,Khazix,608,295,313,48.52
Akali,Lissandra,488,275,213,56.35
Akali,Lucian,883,438,445,49.6
Akali,Rell,631,299,332,47.39
Akali,Irelia,1296,690,606,53.24
Akali,Diana,2163,1027,1136,47.48
Akali,Soraka,721,313,408,43.41
Akali,Vex,868,354,514,40.78
Akali,Darius,2106,1043,1063,49.53
Akali,Ezreal,3458,1649,1809,47.69
Akali,Janna,369,156,213,42.28
Akali,Chogath,1467,685,782,46.69
Akali,Gragas,673,348,325,51.71
Akali,Zed,1674,817,857,48.81
Akali,Vayne,1732,779,953,44.98
Akali,Senna,925,447,478,48.32
Akali,Rumble,376,171,205,45.48
Akali,Vladimir,863,404,459,46.81
Akali,Jhin,2721,1373,1348,50.46
Akali,TahmKench,934,511,423,54.71
Akali,Pantheon,2070,1047,1023,50.58
Akali,Skarner,328,189,139,57.62
Akali,MissFortune,3440,1679,1761,48.81
Akali,Lux,3293,1621,1672,49.23
Akali,Ekko,1261,613,648,48.61
Akali,Pyke,1171,597,574,50.98
Akali,Renekton,675,327,348,48.44
Akali,Ziggs,520,281,239,54.04
Akali,Milio,645,318,327,49.3
Akali,Shaco,1272,682,590,53.62
Akali,Leblanc,834,410,424,49.16
Akali,Hwei,724,358,366,49.45
Akali,Thresh,1704,804,900,47.18
Akali,Illaoi,619,329,290,53.15
Akali,Briar,920,468,452,50.87
Akali,Mel,2736,1453,1283,53.11
Akali,Nami,1142,513,629,44.92
Akali,Teemo,1707,803,904,47.04
Akali,Ashe,2804,1382,1422,49.29
Akali,Zyra,1357,685,672,50.48
Akali,Warwick,2035,931,1104,45.75
Akali,Garen,2147,1034,1113,48.16
Akali,Smolder,742,380,362,51.21
Akali,Swain,1246,596,650,47.83
Akali,Gnar,470,237,233,50.43
Akali,Viego,1967,1032,935,52.47
Akali,Twitch,873,470,403,53.84
Akali,Sona,391,192,199,49.1
Akali,Singed,326,152,174,46.63
Akali,MasterYi,1636,805,831,49.21
Akali,Neeko,630,318,312,50.48
Akali,Jinx,3578,1821,1757,50.89
Akali,Braum,675,295,380,43.7
Akali,Nocturne,1682,822,860,48.87
Akali,Aurora,988,532,456,53.85
Akali,Karma,1666,841,825,50.48
Akali,Graves,805,363,442,45.09
Akali,Amumu,1292,599,693,46.36
Akali,Malzahar,1113,560,553,50.31
Akali,Shen,696,389,307,55.89
Akali,Orianna,526,253,273,48.1
Akali,Kaisa,2251,1247,1004,55.4
Akali,Bard,341,169,172,49.56
Akali,Hecarim,482,250,232,51.87
Akali,Yorick,1198,566,632,47.25
Akali,Yuumi,1042,507,535,48.66
Akali,Udyr,517,271,246,52.42
Akali,Heimerdinger,559,273,286,48.84
Akali,Lillia,766,374,392,48.83
Akali,Qiyana,338,162,176,47.93
Akali,Sett,2008,952,1056,47.41
Akali,XinZhao,865,462,403,53.41
Akali,Morgana,1636,766,870,46.82
Akali,Brand,977,502,475,51.38
Akali,Kayle,821,406,415,49.45
Akali,Tristana,1259,618,641,49.09
Akali,Sylas,2518,1240,1278,49.25
Akali,Ornn,495,251,244,50.71
Akali,Evelynn,431,231,200,53.6
Akali,Velkoz,654,329,325,50.31
Akali,LeeSin,2256,1120,1136,49.65
Akali,Ahri,1673,869,804,51.94
Akali,Sion,871,420,451,48.22
Akali,Veigar,1287,578,709,44.91
Akali,Fizz,763,376,387,49.28
Akali,Urgot,617,264,353,42.79
Akali,Malphite,1151,564,587,49
Akali,Maokai,531,255,276,48.02
Akali,KogMaw,347,136,211,39.19
Akali,Syndra,650,360,290,55.38
Akali,Taric,257,129,128,50.19
Akali,Ambessa,839,431,408,51.37
Akali,Galio,1502,727,775,48.4
Akali,Kindred,497,271,226,54.53
Akali,KSante,744,401,343,53.9
Akali,Nilah,355,163,192,45.92
Akali,Zoe,455,230,225,50.55
Akali,Aphelios,565,271,294,47.96
Akali,Tryndamere,701,363,338,51.78
Akali,Nunu,707,349,358,49.36
Akali,Kassadin,264,152,112,57.58
Akali,Sivir,661,329,332,49.77
Akali,Renata,231,118,113,51.08
Akali,Belveth,312,150,162,48.08
Akali,Corki,480,234,246,48.75
Akali,Poppy,808,362,446,44.8
Akali,Naafiri,452,223,229,49.34
Akali,Nasus,815,395,420,48.47
Akali,Annie,477,225,252,47.17
Akali,Azir,432,232,200,53.7
Akali,Taliyah,328,144,184,43.9
Akali,Jayce,669,332,337,49.63
Akali,Nautilus,1390,706,684,50.79
Akali,Gwen,653,376,277,57.58
Akali,TwistedFate,443,244,199,55.08
Akali,Samira,829,411,418,49.58
Akali,MonkeyKing,891,416,475,46.69
Akali,Shyvana,348,156,192,44.83
Akali,Kled,226,111,115,49.12
Akali,Nidalee,456,219,237,48.03
Akali,AurelionSol,380,214,166,56.32
Akali,Karthus,404,186,218,46.04
Akali,Zac,645,296,349,45.89
Akali,Quinn,481,250,231,51.98
Akali,Kennen,352,173,179,49.15
Akali,Ryze,451,211,240,46.78
Akali,Rakan,537,261,276,48.6
Akali,Seraphine,1018,489,529,48.04
Akali,Leona,1043,504,539,48.32
Akali,Rengar,378,213,165,56.35
Akali,Olaf,307,193,114,62.87
Akali,Jax,1277,637,640,49.88
Akali,JarvanIV,649,329,320,50.69
Akali,Elise,912,423,489,46.38
Akali,Sejuani,461,225,236,48.81
Akali,Fiora,448,226,222,50.45
Akali,Talon,826,444,382,53.75
Akali,Zeri,556,296,260,53.24
Akali,RekSai,118,42,76,35.59
Akali,Xerath,1193,608,585,50.96
Akali,Kalista,382,193,189,50.52
Akali,Camille,408,182,226,44.61
Akali,Ivern,160,77,83,48.13
Akali,Anivia,356,168,188,47.19
Akali,Akshan,442,184,258,41.63
Akali,Riven,556,214,342,38.49
Akali,Rammus,398,207,191,52.01
Akali,DrMundo,707,370,337,52.33
Akali,Cassiopeia,297,143,154,48.15
Varus,Mordekaiser,1302,660,642,50.69
Varus,Vi,999,486,513,48.65
Varus,Yone,1969,954,1015,48.45
Varus,Caitlyn,3215,1566,1649,48.71
Varus,Alistar,382,176,206,46.07
Varus,Gangplank,466,240,226,51.5
Varus,Evelynn,318,168,150,52.83
Varus,Mel,2100,1038,1062,49.43
Varus,Ashe,2593,1266,1327,48.82
Varus,Elise,849,424,425,49.94
Varus,Irelia,856,401,455,46.85
Varus,Hecarim,502,233,269,46.41
Varus,Malzahar,1076,500,576,46.47
Varus,Vayne,1319,643,676,48.75
Varus,Pantheon,1711,819,892,47.87
Varus,KSante,636,334,302,52.52
Varus,Hwei,718,360,358,50.14
Varus,Sivir,589,291,298,49.41
Varus,Thresh,1457,683,774,46.88
Varus,Darius,1881,867,1014,46.09
Varus,Volibear,1246,558,688,44.78
Varus,Akali,1129,563,566,49.87
Varus,Jinx,3299,1605,1694,48.65
Varus,Lux,2592,1266,1326,48.84
Varus,Jax,1035,469,566,45.31
Varus,Viego,1585,814,771,51.36
Varus,Aurora,757,401,356,52.97
Varus,Yorick,1006,445,561,44.23
Varus,Briar,698,309,389,44.27
Varus,Jhin,2367,1178,1189,49.77
Varus,Nautilus,1084,539,545,49.72
Varus,Tryndamere,593,311,282,52.45
Varus,Kayn,1405,652,753,46.41
Varus,Viktor,954,449,505,47.06
Varus,Ornn,495,257,238,51.92
Varus,Garen,1726,754,972,43.68
Varus,Amumu,997,447,550,44.83
Varus,Veigar,1055,523,532,49.57
Varus,Galio,1007,478,529,47.47
Varus,Sett,1643,761,882,46.32
Varus,Gragas,602,284,318,47.18
Varus,Yasuo,2013,966,1047,47.99
Varus,Kalista,322,166,156,51.55
Varus,Sion,817,352,465,43.08
Varus,Nocturne,1354,595,759,43.94
Varus,Katarina,910,441,469,48.46
Varus,Ezreal,3171,1529,1642,48.22
Varus,Teemo,1226,566,660,46.17
Varus,Renekton,532,290,242,54.51
Varus,Shyvana,254,113,141,44.49
Varus,MissFortune,2538,1170,1368,46.1
Varus,Aatrox,1015,504,511,49.66
Varus,Blitzcrank,801,411,390,51.31
Varus,Shen,650,340,310,52.31
Varus,Morgana,1261,615,646,48.77
Varus,MasterYi,1315,620,695,47.15
Varus,Draven,594,277,317,46.63
Varus,XinZhao,696,320,376,45.98
Varus,AurelionSol,366,193,173,52.73
Varus,Belveth,284,125,159,44.01
Varus,Seraphine,792,409,383,51.64
Varus,JarvanIV,662,310,352,46.83
Varus,Fizz,587,285,302,48.55
Varus,Karma,1486,673,813,45.29
Varus,DrMundo,587,267,320,45.49
Varus,Lillia,572,309,263,54.02
Varus,Yuumi,889,426,463,47.92
Varus,Rengar,399,216,183,54.14
Varus,Pyke,817,386,431,47.25
Varus,Poppy,681,389,292,57.12
Varus,Zed,1224,571,653,46.65
Varus,Corki,465,284,181,61.08
Varus,Vladimir,624,305,319,48.88
Varus,Gnar,501,252,249,50.3
Varus,TwistedFate,377,195,182,51.72
Varus,Syndra,709,323,386,45.56
Varus,Lulu,1476,727,749,49.25
Varus,LeeSin,1855,912,943,49.16
Varus,Graves,774,385,389,49.74
Varus,FiddleSticks,459,246,213,53.59
Varus,Gwen,548,262,286,47.81
Varus,Rammus,328,187,141,57.01
Varus,Nami,1004,502,502,50
Varus,Vex,591,320,271,54.15
Varus,Kaisa,1809,823,986,45.49
Varus,Rakan,411,219,192,53.28
Varus,Warwick,1410,654,756,46.38
Varus,Ekko,1027,476,551,46.35
Varus,Aphelios,558,289,269,51.79
Varus,Velkoz,611,305,306,49.92
Varus,Xayah,441,231,210,52.38
Varus,Leona,926,395,531,42.66
Varus,Kennen,319,136,183,42.63
Varus,MonkeyKing,738,361,377,48.92
Varus,KogMaw,332,138,194,41.57
Varus,Braum,605,277,328,45.79
Varus,Nasus,702,352,350,50.14
Varus,Soraka,569,258,311,45.34
Varus,Zyra,1104,575,529,52.08
Varus,Chogath,1171,567,604,48.42
Varus,Shaco,948,474,474,50
Varus,Trundle,580,271,309,46.72
Varus,Ryze,393,190,203,48.35
Varus,Twitch,862,420,442,48.72
Varus,Milio,610,288,322,47.21
Varus,Kindred,440,202,238,45.91
Varus,Diana,1737,844,893,48.59
Varus,Zac,677,325,352,48.01
Varus,Maokai,497,241,256,48.49
Varus,Talon,684,349,335,51.02
Varus,Skarner,280,159,121,56.79
Varus,Kayle,690,329,361,47.68
Varus,Annie,336,139,197,41.37
Varus,Neeko,464,239,225,51.51
Varus,Tristana,1048,513,535,48.95
Varus,Camille,426,226,200,53.05
Varus,Udyr,427,226,201,52.93
Varus,TahmKench,818,413,405,50.49
Varus,Ahri,1332,653,679,49.02
Varus,Naafiri,342,175,167,51.17
Varus,Anivia,315,135,180,42.86
Varus,Orianna,504,231,273,45.83
Varus,Samira,680,357,323,52.5
Varus,Fiora,360,193,167,53.61
Varus,Sejuani,395,164,231,41.52
Varus,Lucian,696,333,363,47.84
Varus,Ambessa,727,373,354,51.31
Varus,Zoe,417,220,197,52.76
Varus,Karthus,318,144,174,45.28
Varus,Sona,340,156,184,45.88
Varus,Ziggs,387,162,225,41.86
Varus,Zeri,508,265,243,52.17
Varus,Azir,393,226,167,57.51
Varus,Riven,498,244,254,49
Varus,Urgot,420,167,253,39.76
Varus,Senna,813,404,409,49.69
Varus,Brand,720,380,340,52.78
Varus,Swain,1080,535,545,49.54
Varus,Bard,308,146,162,47.4
Varus,Malphite,1110,518,592,46.67
Varus,Rell,497,232,265,46.68
Varus,Singed,296,124,172,41.89
Varus,Sylas,1794,923,871,51.45
Varus,Illaoi,485,223,262,45.98
Varus,Zilean,343,146,197,42.57
Varus,Nunu,568,255,313,44.89
Varus,Kassadin,225,104,121,46.22
Varus,Smolder,637,297,340,46.62
Varus,Jayce,706,335,371,47.45
Varus,Taliyah,317,136,181,42.9
Varus,Rumble,336,174,162,51.79
Varus,Qiyana,262,149,113,56.87
Varus,Nidalee,324,189,135,58.33
Varus,Leblanc,684,352,332,51.46
Varus,Janna,367,157,210,42.78
Varus,Heimerdinger,400,172,228,43
Varus,Ivern,127,61,66,48.03
Varus,Olaf,334,162,172,48.5
Varus,Xerath,1067,499,568,46.77
Varus,Lissandra,355,151,204,42.54
Varus,RekSai,132,72,60,54.55
Varus,Khazix,577,277,300,48.01
Varus,Nilah,256,114,142,44.53
Varus,Kled,218,126,92,57.8
Varus,Quinn,399,181,218,45.36
Varus,Renata,150,70,80,46.67
Varus,Cassiopeia,309,137,172,44.34
Varus,Taric,216,131,85,60.65
Varus,Akshan,392,200,192,51.02
Lulu,Mordekaiser,1705,756,949,44.34
Lulu,Vi,1501,736,765,49.03
Lulu,Yone,2771,1541,1230,55.61
Lulu,Caitlyn,4058,1960,2098,48.3
Lulu,Alistar,668,341,327,51.05
Lulu,Teemo,1673,845,828,50.51
Lulu,MonkeyKing,1163,646,517,55.55
Lulu,Katarina,1319,677,642,51.33
Lulu,Jinx,4385,2118,2267,48.3
Lulu,Blitzcrank,1272,606,666,47.64
Lulu,Tryndamere,817,423,394,51.77
Lulu,Lillia,883,395,488,44.73
Lulu,Viktor,1626,755,871,46.43
Lulu,Tristana,1487,726,761,48.82
Lulu,Senna,1357,696,661,51.29
Lulu,Darius,2715,1299,1416,47.85
Lulu,LeeSin,2792,1495,1297,53.55
Lulu,Diana,2726,1368,1358,50.18
Lulu,KogMaw,527,262,265,49.72
Lulu,Thresh,2421,1144,1277,47.25
Lulu,MasterYi,1647,736,911,44.69
Lulu,Khazix,827,425,402,51.39
Lulu,Aurora,1230,608,622,49.43
Lulu,Ashe,3232,1499,1733,46.38
Lulu,Gwen,744,378,366,50.81
Lulu,Akali,1662,844,818,50.78
Lulu,Rumble,516,243,273,47.09
Lulu,Kayn,2223,1160,1063,52.18
Lulu,Akshan,503,264,239,52.49
Lulu,Jhin,3457,1761,1696,50.94
Lulu,Yuumi,1529,771,758,50.43
Lulu,Skarner,417,228,189,54.68
Lulu,Galio,1361,598,763,43.94
Lulu,MissFortune,3196,1564,1632,48.94
Lulu,Lux,3520,1775,1745,50.43
Lulu,Singed,466,239,227,51.29
Lulu,Evelynn,576,299,277,51.91
Lulu,Nami,2391,1119,1272,46.8
Lulu,Trundle,737,331,406,44.91
Lulu,Shaco,1465,735,730,50.17
Lulu,Yasuo,3066,1570,1496,51.21
Lulu,Soraka,1037,525,512,50.63
Lulu,Jax,1522,835,687,54.86
Lulu,Warwick,1830,897,933,49.02
Lulu,Ezreal,4516,2392,2124,52.97
Lulu,Xerath,1368,629,739,45.98
Lulu,Karma,2684,1329,1355,49.52
Lulu,Talon,1107,572,535,51.67
Lulu,Vex,628,329,299,52.39
Lulu,Kaisa,2591,1450,1141,55.96
Lulu,Neeko,619,321,298,51.86
Lulu,Quinn,517,224,293,43.33
Lulu,Zed,1771,896,875,50.59
Lulu,Camille,641,319,322,49.77
Lulu,Hwei,1104,525,579,47.55
Lulu,Zyra,1557,764,793,49.07
Lulu,Lissandra,625,299,326,47.84
Lulu,Volibear,1516,732,784,48.28
Lulu,Vladimir,1264,597,667,47.23
Lulu,Lucian,1238,650,588,52.5
Lulu,TahmKench,885,466,419,52.66
Lulu,Ziggs,538,257,281,47.77
Lulu,Twitch,1353,652,701,48.19
Lulu,Kayle,1040,483,557,46.44
Lulu,Malzahar,1606,805,801,50.12
Lulu,Garen,2390,1212,1178,50.71
Lulu,Sylas,2380,1202,1178,50.5
Lulu,Mel,3082,1666,1416,54.06
Lulu,Zilean,697,365,332,52.37
Lulu,Chogath,1818,885,933,48.68
Lulu,Gangplank,830,393,437,47.35
Lulu,Gragas,971,503,468,51.8
Lulu,Olaf,404,171,233,42.33
Lulu,Riven,841,410,431,48.75
Lulu,Varus,1476,749,727,50.75
Lulu,Swain,1404,675,729,48.08
Lulu,Leona,1119,580,539,51.83
Lulu,Nautilus,1789,914,875,51.09
Lulu,Ahri,2041,1020,1021,49.98
Lulu,Kled,320,150,170,46.88
Lulu,Ekko,1390,639,751,45.97
Lulu,Aphelios,946,461,485,48.73
Lulu,Aatrox,1499,766,733,51.1
Lulu,Syndra,1206,568,638,47.1
Lulu,Seraphine,1206,540,666,44.78
Lulu,Renekton,815,464,351,56.93
Lulu,Nunu,731,372,359,50.89
Lulu,Graves,1157,594,563,51.34
Lulu,Amumu,1228,588,640,47.88
Lulu,Ornn,696,348,348,50
Lulu,FiddleSticks,859,430,429,50.06
Lulu,Milio,1390,665,725,47.84
Lulu,Draven,833,398,435,47.78
Lulu,Bard,514,246,268,47.86
Lulu,Udyr,612,309,303,50.49
Lulu,Irelia,1279,623,656,48.71
Lulu,Belveth,358,196,162,54.75
Lulu,Pantheon,2407,1244,1163,51.68
Lulu,Sion,1268,661,607,52.13
Lulu,Orianna,751,404,347,53.79
Lulu,AurelionSol,507,226,281,44.58
Lulu,Veigar,1391,677,714,48.67
Lulu,Brand,1071,547,524,51.07
Lulu,Elise,1217,562,655,46.18
Lulu,Ryze,611,356,255,58.27
Lulu,Taliyah,455,222,233,48.79
Lulu,Vayne,1825,891,934,48.82
Lulu,XinZhao,1071,552,519,51.54
Lulu,Nilah,433,188,245,43.42
Lulu,Kennen,473,215,258,45.45
Lulu,Braum,993,457,536,46.02
Lulu,Nasus,1032,510,522,49.42
Lulu,Rengar,592,292,300,49.32
Lulu,Viego,2349,1112,1237,47.34
Lulu,Yorick,1376,689,687,50.07
Lulu,JarvanIV,979,405,574,41.37
Lulu,Karthus,503,268,235,53.28
Lulu,Samira,980,531,449,54.18
Lulu,Taric,383,197,186,51.44
Lulu,Gnar,723,363,360,50.21
Lulu,Nidalee,487,283,204,58.11
Lulu,Pyke,1174,608,566,51.79
Lulu,Kindred,788,357,431,45.3
Lulu,Annie,570,270,300,47.37
Lulu,Morgana,1650,808,842,48.97
Lulu,TwistedFate,635,305,330,48.03
Lulu,Maokai,694,325,369,46.83
Lulu,Janna,703,347,356,49.36
Lulu,DrMundo,713,344,369,48.25
Lulu,Illaoi,622,315,307,50.64
Lulu,Zac,834,421,413,50.48
Lulu,Anivia,486,248,238,51.03
Lulu,RekSai,176,87,89,49.43
Lulu,Nocturne,1944,900,1044,46.3
Lulu,Azir,663,355,308,53.54
Lulu,Malphite,1585,706,879,44.54
Lulu,Corki,823,448,375,54.43
Lulu,Kassadin,318,161,157,50.63
Lulu,Renata,305,152,153,49.84
Lulu,Sejuani,639,313,326,48.98
Lulu,Sona,542,286,256,52.77
Lulu,Fizz,816,436,380,53.43
Lulu,Sivir,749,402,347,53.67
Lulu,Kalista,406,203,203,50
Lulu,Briar,1068,553,515,51.78
Lulu,Rammus,506,240,266,47.43
Lulu,Xayah,731,350,381,47.88
Lulu,Hecarim,765,349,416,45.62
Lulu,Rell,747,360,387,48.19
Lulu,Heimerdinger,553,272,281,49.19
Lulu,Naafiri,499,242,257,48.5
Lulu,Ambessa,1175,615,560,52.34
Lulu,Jayce,985,429,556,43.55
Lulu,KSante,959,545,414,56.83
Lulu,Ivern,284,133,151,46.83
Lulu,Rakan,609,320,289,52.55
Lulu,Urgot,823,422,401,51.28
Lulu,Poppy,904,470,434,51.99
Lulu,Zeri,687,350,337,50.95
Lulu,Sett,2081,1071,1010,51.47
Lulu,Fiora,576,324,252,56.25
Lulu,Shyvana,368,189,179,51.36
Lulu,Leblanc,985,509,476,51.68
Lulu,Zoe,597,296,301,49.58
Lulu,Velkoz,925,469,456,50.7
Lulu,Qiyana,458,213,245,46.51
Lulu,Smolder,988,566,422,57.29
Lulu,Shen,1011,531,480,52.52
Lulu,Cassiopeia,450,242,208,53.78
Renekton,Gragas,309,158,151,51.13
Renekton,Pantheon,1026,555,471,54.09
Renekton,Yasuo,1651,886,765,53.66
Renekton,Caitlyn,1563,768,795,49.14
Renekton,Mel,1162,544,618,46.82
Renekton,Mordekaiser,770,314,456,40.78
Renekton,Karthus,174,99,75,56.9
Renekton,Katarina,496,260,236,52.42
Renekton,Jhin,1316,651,665,49.47
Renekton,Karma,815,387,428,47.48
Renekton,Volibear,635,256,379,40.31
Renekton,Yorick,612,271,341,44.28
Renekton,Zoe,257,96,161,37.35
Renekton,Samira,465,234,231,50.32
Renekton,Ambessa,626,347,279,55.43
Renekton,XinZhao,382,183,199,47.91
Renekton,Vladimir,429,182,247,42.42
Renekton,Ezreal,1568,790,778,50.38
Renekton,Kayn,812,392,420,48.28
Renekton,JarvanIV,413,184,229,44.55
Renekton,Orianna,278,158,120,56.83
Renekton,Yuumi,474,251,223,52.95
Renekton,Jax,580,317,263,54.66
Renekton,Rengar,195,112,83,57.44
Renekton,Camille,260,106,154,40.77
Renekton,Sivir,291,122,169,41.92
Renekton,Quinn,225,89,136,39.56
Renekton,Trundle,356,187,169,52.53
Renekton,Kassadin,139,72,67,51.8
Renekton,Senna,406,204,202,50.25
Renekton,Fiora,221,108,113,48.87
Renekton,Nocturne,708,355,353,50.14
Renekton,Sylas,945,499,446,52.8
Renekton,Jinx,1693,858,835,50.68
Renekton,Varus,532,242,290,45.49
Renekton,Kennen,132,52,80,39.39
Renekton,Lux,1374,663,711,48.25
Renekton,Ashe,1376,644,732,46.8
Renekton,Leona,589,279,310,47.37
Renekton,Nasus,439,198,241,45.1
Renekton,Warwick,839,392,447,46.72
Renekton,Akali,675,348,327,51.56
Renekton,Corki,244,131,113,53.69
Renekton,RekSai,75,50,25,66.67
Renekton,Ahri,777,358,419,46.07
Renekton,Malphite,549,269,280,49
Renekton,Riven,451,238,213,52.77
Renekton,Kaisa,1102,597,505,54.17
Renekton,Hwei,386,167,219,43.26
Renekton,Milio,337,156,181,46.29
Renekton,Illaoi,323,141,182,43.65
Renekton,Darius,1164,579,585,49.74
Renekton,Syndra,401,178,223,44.39
Renekton,Zyra,528,254,274,48.11
Renekton,Briar,385,185,200,48.05
Renekton,Lucian,409,207,202,50.61
Renekton,Aatrox,710,390,320,54.93
Renekton,Elise,494,233,261,47.17
Renekton,Yone,1431,811,620,56.67
Renekton,MissFortune,1330,653,677,49.1
Renekton,Zilean,186,100,86,53.76
Renekton,Ekko,588,297,291,50.51
Renekton,Zeri,288,118,170,40.97
Renekton,Lulu,815,351,464,43.07
Renekton,Gangplank,232,104,128,44.83
Renekton,Kalista,167,79,88,47.31
Renekton,Poppy,433,212,221,48.96
Renekton,Diana,985,489,496,49.64
Renekton,Zed,665,331,334,49.77
Renekton,Tristana,586,296,290,50.51
Renekton,Sett,1089,542,547,49.77
Renekton,Amumu,643,299,344,46.5
Renekton,Blitzcrank,460,222,238,48.26
Renekton,Gnar,256,129,127,50.39
Renekton,Leblanc,340,159,181,46.76
Renekton,Gwen,278,140,138,50.36
Renekton,Naafiri,162,86,76,53.09
Renekton,Swain,575,259,316,45.04
Renekton,Twitch,509,246,263,48.33
Renekton,Nautilus,726,381,345,52.48
Renekton,Shaco,579,286,293,49.4
Renekton,Ziggs,197,98,99,49.75
Renekton,Brand,331,179,152,54.08
Renekton,Galio,533,261,272,48.97
Renekton,Taric,135,66,69,48.89
Renekton,TwistedFate,213,116,97,54.46
Renekton,Vayne,656,300,356,45.73
Renekton,Nami,617,258,359,41.82
Renekton,Janna,201,113,88,56.22
Renekton,Rammus,169,78,91,46.15
Renekton,Neeko,256,109,147,42.58
Renekton,LeeSin,1080,526,554,48.7
Renekton,Aurora,486,249,237,51.23
Renekton,Thresh,827,420,407,50.79
Renekton,Viego,960,477,483,49.69
Renekton,Jayce,333,165,168,49.55
Renekton,Veigar,548,284,264,51.82
Renekton,Kayle,331,189,142,57.1
Renekton,Braum,350,150,200,42.86
Renekton,Garen,1006,412,594,40.95
Renekton,MasterYi,697,357,340,51.22
Renekton,MonkeyKing,420,215,205,51.19
Renekton,Viktor,536,247,289,46.08
Renekton,Sion,355,166,189,46.76
Renekton,Shen,307,136,171,44.3
Renekton,KSante,402,217,185,53.98
Renekton,Lillia,374,185,189,49.47
Renekton,Xayah,285,144,141,50.53
Renekton,Rakan,217,91,126,41.94
Renekton,Taliyah,185,74,111,40
Renekton,Malzahar,517,254,263,49.13
Renekton,Maokai,263,158,105,60.08
Renekton,Shyvana,115,57,58,49.57
Renekton,Xerath,553,287,266,51.9
Renekton,FiddleSticks,275,134,141,48.73
Renekton,Graves,402,163,239,40.55
Renekton,Velkoz,359,147,212,40.95
Renekton,Teemo,566,244,322,43.11
Renekton,Talon,408,217,191,53.19
Renekton,Smolder,370,198,172,53.51
Renekton,Soraka,328,151,177,46.04
Renekton,Lissandra,240,114,126,47.5
Renekton,Ornn,223,102,121,45.74
Renekton,Azir,216,96,120,44.44
Renekton,Renata,105,48,57,45.71
Renekton,Sejuani,295,123,172,41.69
Renekton,DrMundo,240,104,136,43.33
Renekton,TahmKench,412,231,181,56.07
Renekton,Irelia,457,249,208,54.49
Renekton,Udyr,214,110,104,51.4
Renekton,Ryze,246,124,122,50.41
Renekton,Heimerdinger,254,114,140,44.88
Renekton,Sona,250,127,123,50.8
Renekton,Draven,281,116,165,41.28
Renekton,Rell,302,176,126,58.28
Renekton,Zac,370,223,147,60.27
Renekton,Qiyana,155,83,72,53.55
Renekton,Khazix,260,110,150,42.31
Renekton,Chogath,603,264,339,43.78
Renekton,Vi,597,333,264,55.78
Renekton,Pyke,489,254,235,51.94
Renekton,Olaf,114,69,45,60.53
Renekton,Kindred,215,112,103,52.09
Renekton,Morgana,684,318,366,46.49
Renekton,Cassiopeia,175,65,110,37.14
Renekton,Evelynn,199,86,113,43.22
Renekton,Alistar,258,135,123,52.33
Renekton,Seraphine,398,214,184,53.77
Renekton,Kled,112,51,61,45.54
Renekton,Fizz,375,195,180,52
Renekton,Belveth,132,79,53,59.85
Renekton,Nunu,335,143,192,42.69
Renekton,Annie,241,99,142,41.08
Renekton,Singed,127,63,64,49.61
Renekton,Hecarim,255,134,121,52.55
Renekton,Skarner,170,96,74,56.47
Renekton,Urgot,290,147,143,50.69
Renekton,Vex,353,172,181,48.73
Renekton,AurelionSol,210,86,124,40.95
Renekton,Nidalee,223,130,93,58.3
Renekton,Anivia,174,80,94,45.98
Renekton,Akshan,191,96,95,50.26
Renekton,KogMaw,172,77,95,44.77
Renekton,Rumble,135,54,81,40
Renekton,Aphelios,292,133,159,45.55
Renekton,Tryndamere,237,117,120,49.37
Renekton,Bard,199,101,98,50.75
Renekton,Ivern,78,29,49,37.18
Renekton,Nilah,158,80,78,50.63
Viktor,Pantheon,1772,845,927,47.69
Viktor,Belveth,250,117,133,46.8
Viktor,Katarina,662,336,326,50.76
Viktor,KogMaw,311,160,151,51.45
Viktor,Lux,2549,1229,1320,48.21
Viktor,Gragas,623,347,276,55.7
Viktor,Yasuo,1758,909,849,51.71
Viktor,Caitlyn,2873,1414,1459,49.22
Viktor,Mel,2445,1309,1136,53.54
Viktor,Yorick,905,433,472,47.85
Viktor,Rammus,324,147,177,45.37
Viktor,Lulu,1626,871,755,53.57
Viktor,Gwen,588,308,280,52.38
Viktor,LeeSin,1895,948,947,50.03
Viktor,Akali,1202,569,633,47.34
Viktor,Thresh,1419,709,710,49.96
Viktor,Darius,1816,903,913,49.72
Viktor,Nocturne,1228,591,637,48.13
Viktor,Lucian,783,422,361,53.9
Viktor,Nautilus,1252,649,603,51.84
Viktor,FiddleSticks,483,231,252,47.83
Viktor,Vladimir,645,378,267,58.6
Viktor,Jhin,2257,1100,1157,48.74
Viktor,Morgana,1139,568,571,49.87
Viktor,Yone,2020,1062,958,52.57
Viktor,Warwick,1294,620,674,47.91
Viktor,Hwei,950,506,444,53.26
Viktor,Varus,954,502,452,52.62
Viktor,Malphite,911,453,458,49.73
Viktor,Shen,666,344,322,51.65
Viktor,Ekko,1131,558,573,49.34
Viktor,Zed,1102,554,548,50.27
Viktor,Zac,565,278,287,49.2
Viktor,Anivia,357,160,197,44.82
Viktor,Tristana,902,445,457,49.33
Viktor,Blitzcrank,757,395,362,52.18
Viktor,Gangplank,528,205,323,38.83
Viktor,Hecarim,521,236,285,45.3
Viktor,Aurora,901,452,449,50.17
Viktor,Brand,708,349,359,49.29
Viktor,Ambessa,773,376,397,48.64
Viktor,Evelynn,392,167,225,42.6
Viktor,Xayah,454,226,228,49.78
Viktor,Velkoz,680,317,363,46.62
Viktor,DrMundo,534,269,265,50.37
Viktor,Jax,992,511,481,51.51
Viktor,AurelionSol,404,180,224,44.55
Viktor,Rakan,426,212,214,49.77
Viktor,Urgot,590,280,310,47.46
Viktor,Amumu,1008,498,510,49.4
Viktor,Gnar,471,226,245,47.98
Viktor,Viego,1615,836,779,51.76
Viktor,Twitch,855,421,434,49.24
Viktor,Heimerdinger,437,222,215,50.8
Viktor,Smolder,731,406,325,55.54
Viktor,Kayle,660,332,328,50.3
Viktor,Aatrox,937,455,482,48.56
Viktor,Samira,639,341,298,53.36
Viktor,Illaoi,406,212,194,52.22
Viktor,Kaisa,1809,923,886,51.02
Viktor,MasterYi,1301,634,667,48.73
Viktor,Diana,1658,824,834,49.7
Viktor,Ashe,2252,1085,1167,48.18
Viktor,TahmKench,711,346,365,48.66
Viktor,Shaco,932,507,425,54.4
Viktor,Trundle,541,250,291,46.21
Viktor,Kindred,396,184,212,46.46
Viktor,Ezreal,2921,1433,1488,49.06
Viktor,Swain,938,466,472,49.68
Viktor,Ahri,1237,587,650,47.45
Viktor,Jinx,3208,1591,1617,49.59
Viktor,Seraphine,710,355,355,50
Viktor,Orianna,584,312,272,53.42
Viktor,Leona,858,427,431,49.77
Viktor,Xerath,1083,527,556,48.66
Viktor,Garen,1687,797,890,47.24
Viktor,Kled,215,124,91,57.67
Viktor,Zoe,415,201,214,48.43
Viktor,KSante,620,366,254,59.03
Viktor,MissFortune,2116,1060,1056,50.09
Viktor,Nasus,654,322,332,49.24
Viktor,Mordekaiser,1195,579,616,48.45
Viktor,Vayne,1376,706,670,51.31
Viktor,Maokai,596,281,315,47.15
Viktor,Graves,720,330,390,45.83
Viktor,Corki,438,219,219,50
Viktor,Volibear,1084,562,522,51.85
Viktor,Pyke,764,406,358,53.14
Viktor,Karma,1510,720,790,47.68
Viktor,Teemo,1190,587,603,49.33
Viktor,Singed,276,141,135,51.09
Viktor,Ziggs,360,170,190,47.22
Viktor,Sivir,592,278,314,46.96
Viktor,Nami,1106,521,585,47.11
Viktor,Syndra,921,442,479,47.99
Viktor,Kayn,1395,693,702,49.68
Viktor,Rell,516,259,257,50.19
Viktor,Olaf,273,130,143,47.62
Viktor,Malzahar,1301,648,653,49.81
Viktor,Veigar,1028,504,524,49.03
Viktor,Fiora,438,201,237,45.89
Viktor,Elise,838,377,461,44.99
Viktor,Lissandra,358,174,184,48.6
Viktor,Vi,1016,533,483,52.46
Viktor,MonkeyKing,840,442,398,52.62
Viktor,Poppy,751,372,379,49.53
Viktor,Renekton,536,289,247,53.92
Viktor,Aphelios,541,283,258,52.31
Viktor,Soraka,610,273,337,44.75
Viktor,Tryndamere,559,295,264,52.77
Viktor,Kassadin,244,98,146,40.16
Viktor,Draven,565,277,288,49.03
Viktor,JarvanIV,655,321,334,49.01
Viktor,Yuumi,821,420,401,51.16
Viktor,Janna,388,190,198,48.97
Viktor,Sejuani,447,180,267,40.27
Viktor,Ryze,416,219,197,52.64
Viktor,XinZhao,742,382,360,51.48
Viktor,Leblanc,668,390,278,58.38
Viktor,Rumble,300,153,147,51
Viktor,Kennen,315,162,153,51.43
Viktor,Riven,490,223,267,45.51
Viktor,Lillia,680,353,327,51.91
Viktor,Chogath,1153,575,578,49.87
Viktor,Sett,1478,709,769,47.97
Viktor,Ivern,126,59,67,46.83
Viktor,Galio,896,448,448,50
Viktor,Braum,634,335,299,52.84
Viktor,Ornn,455,218,237,47.91
Viktor,Taliyah,256,88,168,34.38
Viktor,Jayce,620,323,297,52.1
Viktor,Khazix,514,247,267,48.05
Viktor,Bard,329,173,156,52.58
Viktor,Sylas,1607,783,824,48.72
Viktor,Sona,345,188,157,54.49
Viktor,TwistedFate,450,265,185,58.89
Viktor,Rengar,323,164,159,50.77
Viktor,Briar,666,345,321,51.8
Viktor,Zilean,373,190,183,50.94
Viktor,Zyra,1110,545,565,49.1
Viktor,Talon,718,340,378,47.35
Viktor,Camille,449,187,262,41.65
Viktor,Senna,834,400,434,47.96
Viktor,Udyr,460,255,205,55.43
Viktor,Sion,748,399,349,53.34
Viktor,Taric,222,115,107,51.8
Viktor,Renata,206,120,86,58.25
Viktor,Irelia,927,444,483,47.9
Viktor,Cassiopeia,374,172,202,45.99
Viktor,Skarner,283,177,106,62.54
Viktor,Kalista,260,116,144,44.62
Viktor,Neeko,444,221,223,49.77
Viktor,Qiyana,266,142,124,53.38
Viktor,Nunu,498,213,285,42.77
Viktor,Quinn,403,190,213,47.15
Viktor,Azir,434,258,176,59.45
Viktor,Naafiri,309,131,178,42.39
Viktor,Zeri,488,272,216,55.74
Viktor,Alistar,484,255,229,52.69
Viktor,Milio,655,298,357,45.5
Viktor,Fizz,529,257,272,48.58
Viktor,Vex,523,258,265,49.33
Viktor,Nidalee,369,216,153,58.54
Viktor,Annie,396,170,226,42.93
Viktor,Karthus,293,126,167,43
Viktor,Akshan,359,185,174,51.53
Viktor,Nilah,264,104,160,39.39
Viktor,Shyvana,267,150,117,56.18
Viktor,RekSai,127,71,56,55.91
Poppy,Sett,1043,495,548,47.46
Poppy,MasterYi,756,353,403,46.69
Poppy,Vladimir,514,246,268,47.86
Poppy,Zilean,228,96,132,42.11
Poppy,Senna,519,270,249,52.02
Poppy,Aatrox,526,254,272,48.29
Poppy,Graves,437,226,211,51.72
Poppy,Ekko,655,336,319,51.3
Poppy,Ezreal,1620,801,819,49.44
Poppy,Bard,250,117,133,46.8
Poppy,Volibear,767,390,377,50.85
Poppy,Yorick,643,312,331,48.52
Poppy,Lux,1519,745,774,49.05
Poppy,Jinx,1964,934,1030,47.56
Poppy,Pantheon,1223,615,608,50.29
Poppy,MonkeyKing,468,202,266,43.16
Poppy,Kassadin,167,81,86,48.5
Poppy,Lucian,549,262,287,47.72
Poppy,Nami,587,292,295,49.74
Poppy,Ambessa,455,268,187,58.9
Poppy,JarvanIV,453,223,230,49.23
Poppy,Sylas,960,529,431,55.1
Poppy,Ashe,1477,764,713,51.73
Poppy,Alistar,360,154,206,42.78
Poppy,Rammus,225,121,104,53.78
Poppy,Zed,823,421,402,51.15
Poppy,Tristana,809,444,365,54.88
Poppy,Swain,585,265,320,45.3
Poppy,Diana,1129,531,598,47.03
Poppy,Amumu,773,376,397,48.64
Poppy,Syndra,503,267,236,53.08
Poppy,TahmKench,527,277,250,52.56
Poppy,Malphite,629,317,312,50.4
Poppy,Corki,372,203,169,54.57
Poppy,Soraka,350,149,201,42.57
Poppy,Gnar,365,195,170,53.42
Poppy,LeeSin,1465,839,626,57.27
Poppy,Ahri,906,507,399,55.96
Poppy,Varus,681,292,389,42.88
Poppy,Renata,176,92,84,52.27
Poppy,Maokai,389,193,196,49.61
Poppy,Ziggs,237,130,107,54.85
Poppy,Sona,194,93,101,47.94
Poppy,KSante,488,286,202,58.61
Poppy,Nocturne,885,385,500,43.5
Poppy,Katarina,498,251,247,50.4
Poppy,Leona,880,444,436,50.45
Poppy,Khazix,364,177,187,48.63
Poppy,Caitlyn,1782,896,886,50.28
Poppy,Zyra,680,286,394,42.06
Poppy,Darius,1163,585,578,50.3
Poppy,Sejuani,293,154,139,52.56
Poppy,Malzahar,687,317,370,46.14
Poppy,Morgana,725,378,347,52.14
Poppy,Neeko,297,162,135,54.55
Poppy,Elise,534,266,268,49.81
Poppy,Mel,1380,721,659,52.25
Poppy,MissFortune,1497,758,739,50.63
Poppy,Pyke,702,383,319,54.56
Poppy,Ivern,89,54,35,60.67
Poppy,TwistedFate,295,149,146,50.51
Poppy,Jhin,1340,681,659,50.82
Poppy,Kayle,431,239,192,55.45
Poppy,Jayce,425,215,210,50.59
Poppy,Garen,1120,564,556,50.36
Poppy,Warwick,1004,456,548,45.42
Poppy,Veigar,667,286,381,42.88
Poppy,Draven,333,176,157,52.85
Poppy,Teemo,744,370,374,49.73
Poppy,Yasuo,1444,732,712,50.69
Poppy,Rell,438,231,207,52.74
Poppy,Fiora,247,137,110,55.47
Poppy,Kayn,1023,562,461,54.94
Poppy,Zoe,266,148,118,55.64
Poppy,Thresh,1036,534,502,51.54
Poppy,Renekton,433,221,212,51.04
Poppy,Gwen,361,195,166,54.02
Poppy,Akshan,224,111,113,49.55
Poppy,Chogath,860,386,474,44.88
Poppy,Trundle,413,229,184,55.45
Poppy,AurelionSol,232,107,125,46.12
Poppy,Brand,440,225,215,51.14
Poppy,Orianna,356,197,159,55.34
Poppy,Briar,468,224,244,47.86
Poppy,Nasus,480,232,248,48.33
Poppy,Braum,476,217,259,45.59
Poppy,Camille,222,117,105,52.7
Poppy,Annie,211,97,114,45.97
Poppy,Blitzcrank,521,305,216,58.54
Poppy,Vi,777,413,364,53.15
Poppy,Velkoz,364,163,201,44.78
Poppy,Mordekaiser,851,414,437,48.65
Poppy,Vayne,1049,517,532,49.29
Poppy,Fizz,400,222,178,55.5
Poppy,Twitch,520,265,255,50.96
Poppy,Ornn,311,168,143,54.02
Poppy,Aurora,491,249,242,50.71
Poppy,Xayah,364,201,163,55.22
Poppy,Azir,232,127,105,54.74
Poppy,Aphelios,380,178,202,46.84
Poppy,Kalista,222,136,86,61.26
Poppy,Milio,352,151,201,42.9
Poppy,Jax,714,347,367,48.6
Poppy,Udyr,239,129,110,53.97
Poppy,Karthus,219,103,116,47.03
Poppy,Irelia,668,363,305,54.34
Poppy,Akali,808,446,362,55.2
Poppy,Talon,466,266,200,57.08
Poppy,Vex,339,180,159,53.1
Poppy,Kaisa,1367,716,651,52.38
Poppy,Viktor,751,379,372,50.47
Poppy,Taliyah,190,102,88,53.68
Poppy,Skarner,177,110,67,62.15
Poppy,Leblanc,542,279,263,51.48
Poppy,Sivir,358,169,189,47.21
Poppy,DrMundo,351,169,182,48.15
Poppy,Nautilus,896,497,399,55.47
Poppy,Singed,207,103,104,49.76
Poppy,Belveth,162,103,59,63.58
Poppy,Tryndamere,347,181,166,52.16
Poppy,Viego,1040,564,476,54.23
Poppy,Illaoi,337,166,171,49.26
Poppy,KogMaw,209,94,115,44.98
Poppy,Lulu,904,434,470,48.01
Poppy,Heimerdinger,296,122,174,41.22
Poppy,Seraphine,483,229,254,47.41
Poppy,Xerath,588,286,302,48.64
Poppy,Gangplank,340,138,202,40.59
Poppy,Nunu,331,175,156,52.87
Poppy,Karma,824,416,408,50.49
Poppy,Yone,1348,746,602,55.34
Poppy,Anivia,232,107,125,46.12
Poppy,Qiyana,195,94,101,48.21
Poppy,Riven,361,192,169,53.19
Poppy,Urgot,297,152,145,51.18
Poppy,FiddleSticks,314,161,153,51.27
Poppy,RekSai,129,76,53,58.91
Poppy,Shaco,613,313,300,51.06
Poppy,Sion,456,196,260,42.98
Poppy,Nilah,159,86,73,54.09
Poppy,Taric,162,60,102,37.04
Poppy,Gragas,401,209,192,52.12
Poppy,Samira,510,302,208,59.22
Poppy,Olaf,207,81,126,39.13
Poppy,Evelynn,229,98,131,42.79
Poppy,Hecarim,287,126,161,43.9
Poppy,Yuumi,567,311,256,54.85
Poppy,Lissandra,217,97,120,44.7
Poppy,Kennen,182,73,109,40.11
Poppy,Zac,469,273,196,58.21
Poppy,Rumble,259,135,124,52.12
Poppy,Ryze,278,107,171,38.49
Poppy,XinZhao,528,273,255,51.7
Poppy,Hwei,449,199,250,44.32
Poppy,Shen,420,213,207,50.71
Poppy,Kled,154,87,67,56.49
Poppy,Galio,661,325,336,49.17
Poppy,Kindred,327,147,180,44.95
Poppy,Lillia,465,248,217,53.33
Poppy,Rakan,400,205,195,51.25
Poppy,Janna,268,155,113,57.84
Poppy,Naafiri,224,114,110,50.89
Poppy,Rengar,264,136,128,51.52
Poppy,Zeri,357,211,146,59.1
Poppy,Smolder,358,159,199,44.41
Poppy,Quinn,209,79,130,37.8
Poppy,Shyvana,167,74,93,44.31
Poppy,Cassiopeia,203,99,104,48.77
Poppy,Nidalee,266,118,148,44.36
Zac,Sett,909,450,459,49.5
Zac,MasterYi,511,263,248,51.47
Zac,Vladimir,434,230,204,53
Zac,Zilean,220,119,101,54.09
Zac,Senna,370,187,183,50.54
Zac,Gnar,250,136,114,54.4
Zac,Diana,952,461,491,48.42
Zac,Chogath,648,323,325,49.85
Zac,Jinx,1446,785,661,54.29
Zac,Nami,488,243,245,49.8
Zac,Yasuo,1074,527,547,49.07
Zac,Kayn,766,318,448,41.51
Zac,Mel,1187,574,613,48.36
Zac,Xayah,339,182,157,53.69
Zac,Rakan,225,113,112,50.22
Zac,Pantheon,966,451,515,46.69
Zac,Viktor,565,287,278,50.8
Zac,Samira,411,232,179,56.45
Zac,Janna,252,131,121,51.98
Zac,Camille,232,140,92,60.34
Zac,Briar,398,211,187,53.02
Zac,Katarina,429,249,180,58.04
Zac,Lux,1231,595,636,48.33
Zac,Heimerdinger,244,130,114,53.28
Zac,Rammus,125,66,59,52.8
Zac,Sylas,1012,529,483,52.27
Zac,Vayne,730,398,332,54.52
Zac,Morgana,606,323,283,53.3
Zac,Nasus,364,204,160,56.04
Zac,Kaisa,1027,515,512,50.15
Zac,JarvanIV,325,170,155,52.31
Zac,Ezreal,1634,843,791,51.59
Zac,Bard,159,87,72,54.72
Zac,Gangplank,263,126,137,47.91
Zac,Sejuani,260,122,138,46.92
Zac,Ekko,584,288,296,49.32
Zac,Lulu,834,413,421,49.52
Zac,Warwick,702,379,323,53.99
Zac,Shaco,528,280,248,53.03
Zac,Twitch,390,188,202,48.21
Zac,Ivern,68,40,28,58.82
Zac,Zed,600,303,297,50.5
Zac,MissFortune,1137,549,588,48.28
Zac,Neeko,194,120,74,61.86
Zac,MonkeyKing,478,266,212,55.65
Zac,Varus,677,352,325,51.99
Zac,Nautilus,696,362,334,52.01
Zac,KSante,435,218,217,50.11
Zac,Gragas,363,182,181,50.14
Zac,Illaoi,255,138,117,54.12
Zac,Graves,443,220,223,49.66
Zac,TahmKench,348,187,161,53.74
Zac,Azir,329,170,159,51.67
Zac,Ambessa,385,210,175,54.55
Zac,Vi,600,297,303,49.5
Zac,Fiora,237,129,108,54.43
Zac,Karthus,197,115,82,58.38
Zac,TwistedFate,216,113,103,52.31
Zac,Jhin,1148,608,540,52.96
Zac,Zyra,604,281,323,46.52
Zac,Garen,911,461,450,50.6
Zac,Ziggs,203,95,108,46.8
Zac,Ashe,1306,693,613,53.06
Zac,Karma,822,431,391,52.43
Zac,Aurora,445,225,220,50.56
Zac,Alistar,325,156,169,48
Zac,Trundle,256,135,121,52.73
Zac,Khazix,248,129,119,52.02
Zac,Lissandra,182,95,87,52.2
Zac,Thresh,829,407,422,49.1
Zac,Nocturne,759,411,348,54.15
Zac,Talon,363,193,170,53.17
Zac,Smolder,407,192,215,47.17
Zac,Soraka,331,196,135,59.21
Zac,Akali,645,349,296,54.11
Zac,LeeSin,1119,563,556,50.31
Zac,Elise,483,229,254,47.41
Zac,Leblanc,416,213,203,51.2
Zac,Zeri,274,130,144,47.45
Zac,Sion,429,231,198,53.85
Zac,Mordekaiser,596,307,289,51.51
Zac,Lillia,399,192,207,48.12
Zac,Veigar,477,265,212,55.56
Zac,Sona,176,91,85,51.7
Zac,Volibear,646,297,349,45.98
Zac,Qiyana,139,84,55,60.43
Zac,Lucian,415,238,177,57.35
Zac,Rell,320,175,145,54.69
Zac,Renata,103,48,55,46.6
Zac,Darius,944,462,482,48.94
Zac,Tristana,441,247,194,56.01
Zac,Jax,590,302,288,51.19
Zac,Teemo,652,325,327,49.85
Zac,Fizz,291,128,163,43.99
Zac,Tryndamere,223,111,112,49.78
Zac,Amumu,569,299,270,52.55
Zac,Ryze,210,117,93,55.71
Zac,Blitzcrank,432,240,192,55.56
Zac,Yorick,557,294,263,52.78
Zac,Nidalee,239,153,86,64.02
Zac,Ahri,701,342,359,48.79
Zac,Braum,334,156,178,46.71
Zac,Hwei,391,182,209,46.55
Zac,Swain,517,202,315,39.07
Zac,Malzahar,554,250,304,45.13
Zac,Leona,438,246,192,56.16
Zac,Poppy,469,196,273,41.79
Zac,Pyke,453,238,215,52.54
Zac,Aatrox,587,287,300,48.89
Zac,Shyvana,162,93,69,57.41
Zac,DrMundo,266,113,153,42.48
Zac,Rengar,185,95,90,51.35
Zac,Ornn,274,143,131,52.19
Zac,Viego,931,503,428,54.03
Zac,Milio,274,138,136,50.36
Zac,Renekton,370,147,223,39.73
Zac,Draven,294,143,151,48.64
Zac,Sivir,323,151,172,46.75
Zac,Annie,192,111,81,57.81
Zac,Udyr,247,129,118,52.23
Zac,Caitlyn,1607,785,822,48.85
Zac,Riven,228,135,93,59.21
Zac,Xerath,586,298,288,50.85
Zac,Shen,327,136,191,41.59
Zac,Brand,415,180,235,43.37
Zac,Nunu,317,149,168,47
Zac,Syndra,372,177,195,47.58
Zac,KogMaw,139,77,62,55.4
Zac,Cassiopeia,151,66,85,43.71
Zac,Maokai,240,108,132,45
Zac,Malphite,554,276,278,49.82
Zac,Galio,549,291,258,53.01
Zac,Rumble,196,84,112,42.86
Zac,Yone,1137,642,495,56.46
Zac,Aphelios,307,154,153,50.16
Zac,Velkoz,313,162,151,51.76
Zac,Evelynn,187,80,107,42.78
Zac,Akshan,195,81,114,41.54
Zac,Quinn,168,73,95,43.45
Zac,Nilah,178,87,91,48.88
Zac,Jayce,309,166,143,53.72
Zac,FiddleSticks,327,153,174,46.79
Zac,Kassadin,128,83,45,64.84
Zac,Hecarim,243,129,114,53.09
Zac,Kalista,109,60,49,55.05
Zac,Yuumi,533,261,272,48.97
Zac,Irelia,483,275,208,56.94
Zac,Skarner,196,108,88,55.1
Zac,Olaf,116,51,65,43.97
Zac,Taliyah,148,83,65,56.08
Zac,XinZhao,424,229,195,54.01
Zac,Seraphine,390,195,195,50
Zac,Taric,116,66,50,56.9
Zac,Singed,126,66,60,52.38
Zac,Gwen,338,184,154,54.44
Zac,Orianna,251,129,122,51.39
Zac,Naafiri,164,82,82,50
Zac,Corki,319,139,180,43.57
Zac,Kled,113,69,44,61.06
Zac,Kayle,328,179,149,54.57
Zac,Kennen,163,96,67,58.9
Zac,Zoe,217,106,111,48.85
Zac,AurelionSol,176,86,90,48.86
Zac,Anivia,177,75,102,42.37
Zac,Belveth,100,35,65,35
Zac,Vex,265,128,137,48.3
Zac,Urgot,231,114,117,49.35
Zac,Kindred,253,127,126,50.2
Zac,RekSai,67,33,34,49.25
Sett,Poppy,1043,548,495,52.54
Sett,Zac,909,459,450,50.5
Sett,Chogath,2373,1217,1156,51.29
Sett,Xayah,872,459,413,52.64
Sett,Nami,1564,837,727,53.52
Sett,Urgot,1079,536,543,49.68
Sett,Briar,1186,589,597,49.66
Sett,Ahri,2336,1169,1167,50.04
Sett,Caitlyn,5028,2651,2377,52.72
Sett,Lux,4464,2210,2254,49.51
Sett,Darius,4183,2218,1965,53.02
Sett,Lillia,963,509,454,52.86
Sett,Garen,3268,1733,1535,53.03
Sett,Pyke,1347,683,664,50.71
Sett,Gnar,644,326,318,50.62
Sett,Volibear,2428,1169,1259,48.15
Sett,Fizz,1053,571,482,54.23
Sett,Aphelios,857,476,381,55.54
Sett,Zyra,1751,867,884,49.51
Sett,Amumu,1971,1050,921,53.27
Sett,Veigar,1941,976,965,50.28
Sett,Jinx,4984,2410,2574,48.35
Sett,Galio,1651,853,798,51.67
Sett,Warwick,2791,1386,1405,49.66
Sett,Shen,1203,647,556,53.78
Sett,Velkoz,1089,595,494,54.64
Sett,Varus,1643,882,761,53.68
Sett,Rakan,628,312,316,49.68
Sett,Vi,1682,838,844,49.82
Sett,Ryze,561,311,250,55.44
Sett,MissFortune,4381,2188,2193,49.94
Sett,Thresh,2269,1112,1157,49.01
Sett,Mordekaiser,2705,1330,1375,49.17
Sett,Kayn,2608,1319,1289,50.58
Sett,Aurora,1178,597,581,50.68
Sett,Morgana,2293,1176,1117,51.29
Sett,Heimerdinger,902,455,447,50.44
Sett,Kindred,768,407,361,52.99
Sett,Mel,3730,2048,1682,54.91
Sett,Jhin,3625,1920,1705,52.97
Sett,Ornn,769,399,370,51.89
Sett,Gangplank,727,397,330,54.61
Sett,Qiyana,383,228,155,59.53
Sett,Xerath,1690,895,795,52.96
Sett,Twitch,1491,819,672,54.93
Sett,Swain,1829,960,869,52.49
Sett,MasterYi,2202,1153,1049,52.36
Sett,Yasuo,3908,1996,1912,51.07
Sett,Kaisa,2973,1548,1425,52.07
Sett,Talon,1014,582,432,57.4
Sett,Diana,3075,1617,1458,52.59
Sett,Akshan,618,337,281,54.53
Sett,Rammus,535,264,271,49.35
Sett,Zed,1885,924,961,49.02
Sett,Sylas,2475,1402,1073,56.65
Sett,Tristana,1838,999,839,54.35
Sett,Aatrox,1780,870,910,48.88
Sett,Vayne,2174,1042,1132,47.93
Sett,Rell,890,460,430,51.69
Sett,Ashe,3689,1916,1773,51.94
Sett,Teemo,1990,994,996,49.95
Sett,Yuumi,1246,626,620,50.24
Sett,Kayle,1247,586,661,46.99
Sett,Orianna,647,332,315,51.31
Sett,Malzahar,1945,916,1029,47.1
Sett,KSante,1046,551,495,52.68
Sett,Nunu,901,492,409,54.61
Sett,Yone,3537,2000,1537,56.55
Sett,Samira,1474,736,738,49.93
Sett,Neeko,817,426,391,52.14
Sett,Hwei,1113,586,527,52.65
Sett,Kalista,454,253,201,55.73
Sett,Blitzcrank,1414,799,615,56.51
Sett,Quinn,546,262,284,47.99
Sett,Khazix,826,487,339,58.96
Sett,Nidalee,555,299,256,53.87
Sett,Nasus,1150,558,592,48.52
Sett,Karma,1866,984,882,52.73
Sett,Irelia,1706,922,784,54.04
Sett,Elise,1149,574,575,49.96
Sett,Katarina,1355,708,647,52.25
Sett,Jax,1719,862,857,50.15
Sett,Pantheon,2941,1537,1404,52.26
Sett,Vladimir,1048,538,510,51.34
Sett,Skarner,453,269,184,59.38
Sett,Senna,1362,690,672,50.66
Sett,DrMundo,1022,532,490,52.05
Sett,Ekko,1662,851,811,51.2
Sett,Akali,2008,1056,952,52.59
Sett,Yorick,1763,856,907,48.55
Sett,Nautilus,2006,1034,972,51.55
Sett,Draven,819,502,317,61.29
Sett,LeeSin,2734,1469,1265,53.73
Sett,Ezreal,4143,2209,1934,53.32
Sett,Zilean,446,215,231,48.21
Sett,MonkeyKing,1318,648,670,49.17
Sett,Karthus,501,268,233,53.49
Sett,Renekton,1089,547,542,50.23
Sett,Shaco,1668,776,892,46.52
Sett,Taliyah,390,195,195,50
Sett,Seraphine,1415,737,678,52.08
Sett,Udyr,748,384,364,51.34
Sett,Lucian,1069,554,515,51.82
Sett,Sejuani,707,378,329,53.47
Sett,TahmKench,1475,807,668,54.71
Sett,Cassiopeia,473,260,213,54.97
Sett,Smolder,1099,562,537,51.14
Sett,Anivia,488,235,253,48.16
Sett,Ziggs,648,315,333,48.61
Sett,JarvanIV,867,469,398,54.09
Sett,Braum,910,453,457,49.78
Sett,Trundle,1045,507,538,48.52
Sett,Naafiri,583,259,324,44.43
Sett,Nocturne,2336,1130,1206,48.37
Sett,Ambessa,1155,641,514,55.5
Sett,Viego,2705,1408,1297,52.05
Sett,Annie,566,305,261,53.89
Sett,Sivir,898,438,460,48.78
Sett,Renata,269,150,119,55.76
Sett,Jayce,757,353,404,46.63
Sett,Bard,450,232,218,51.56
Sett,FiddleSticks,878,484,394,55.13
Sett,Soraka,937,441,496,47.07
Sett,Brand,1321,715,606,54.13
Sett,Illaoi,996,488,508,49
Sett,Fiora,660,386,274,58.48
Sett,AurelionSol,657,370,287,56.32
Sett,Leona,1601,834,767,52.09
Sett,Maokai,818,404,414,49.39
Sett,Alistar,748,391,357,52.27
Sett,TwistedFate,571,285,286,49.91
Sett,Kassadin,299,124,175,41.47
Sett,Janna,489,206,283,42.13
Sett,Gragas,1005,505,500,50.25
Sett,Milio,885,432,453,48.81
Sett,Sion,1484,695,789,46.83
Sett,Graves,1040,548,492,52.69
Sett,Leblanc,1128,571,557,50.62
Sett,Taric,366,166,200,45.36
Sett,Shyvana,424,231,193,54.48
Sett,Zoe,679,340,339,50.07
Sett,Tryndamere,978,505,473,51.64
Sett,Hecarim,684,382,302,55.85
Sett,XinZhao,1149,632,517,55
Sett,Malphite,1816,903,913,49.72
Sett,Lissandra,531,287,244,54.05
Sett,Kennen,449,236,213,52.56
Sett,Vex,862,460,402,53.36
Sett,Rengar,497,298,199,59.96
Sett,Riven,794,430,364,54.16
Sett,Gwen,877,485,392,55.3
Sett,Sona,496,233,263,46.98
Sett,Viktor,1478,769,709,52.03
Sett,Lulu,2081,1010,1071,48.53
Sett,Azir,519,284,235,54.72
Sett,Nilah,587,254,333,43.27
Sett,Ivern,213,98,115,46.01
Sett,Rumble,512,261,251,50.98
Sett,RekSai,205,109,96,53.17
Sett,Evelynn,614,301,313,49.02
Sett,Corki,636,342,294,53.77
Sett,Zeri,631,344,287,54.52
Sett,Singed,467,220,247,47.11
Sett,Olaf,377,203,174,53.85
Sett,Camille,625,329,296,52.64
Sett,Syndra,1048,505,543,48.19
Sett,Belveth,355,189,166,53.24
Sett,Kled,295,170,125,57.63
Sett,KogMaw,573,256,317,44.68
Zilean,Poppy,228,132,96,57.89
Zilean,Zac,220,101,119,45.91
Zilean,Chogath,473,247,226,52.22
Zilean,Xayah,147,62,85,42.18
Zilean,Nami,475,240,235,50.53
Zilean,Warwick,485,230,255,47.42
Zilean,Briar,295,141,154,47.8
Zilean,Zed,499,259,240,51.9
Zilean,Ziggs,142,72,70,50.7
Zilean,Xerath,345,166,179,48.12
Zilean,Darius,680,353,327,51.91
Zilean,Volibear,445,218,227,48.99
Zilean,Akali,353,200,153,56.66
Zilean,Jinx,1089,564,525,51.79
Zilean,Lux,934,454,480,48.61
Zilean,Fiora,169,80,89,47.34
Zilean,Graves,297,158,139,53.2
Zilean,Azir,147,87,60,59.18
Zilean,Ashe,796,339,457,42.59
Zilean,Braum,234,138,96,58.97
Zilean,Trundle,191,113,78,59.16
Zilean,JarvanIV,294,134,160,45.58
Zilean,Katarina,292,162,130,55.48
Zilean,Twitch,352,213,139,60.51
Zilean,Lulu,697,332,365,47.63
Zilean,Teemo,529,259,270,48.96
Zilean,Morgana,473,242,231,51.16
Zilean,KSante,197,116,81,58.88
Zilean,Swain,384,197,187,51.3
Zilean,Yone,670,338,332,50.45
Zilean,Nocturne,559,316,243,56.53
Zilean,AurelionSol,132,67,65,50.76
Zilean,Smolder,214,130,84,60.75
Zilean,Nautilus,399,247,152,61.9
Zilean,TahmKench,248,136,112,54.84
Zilean,Shaco,403,218,185,54.09
Zilean,Leblanc,195,104,91,53.33
Zilean,Hwei,303,165,138,54.46
Zilean,Thresh,554,288,266,51.99
Zilean,Illaoi,137,70,67,51.09
Zilean,Syndra,259,142,117,54.83
Zilean,Jhin,818,423,395,51.71
Zilean,Zyra,340,157,183,46.18
Zilean,Garen,614,316,298,51.47
Zilean,Karma,552,258,294,46.74
Zilean,Renekton,186,86,100,46.24
Zilean,Lillia,199,103,96,51.76
Zilean,Yasuo,714,326,388,45.66
Zilean,Caitlyn,1042,518,524,49.71
Zilean,Ambessa,246,116,130,47.15
Zilean,Kaisa,656,354,302,53.96
Zilean,Neeko,150,92,58,61.33
Zilean,Hecarim,152,95,57,62.5
Zilean,Mordekaiser,430,206,224,47.91
Zilean,Talon,263,116,147,44.11
Zilean,Aurora,291,130,161,44.67
Zilean,Samira,242,103,139,42.56
Zilean,Leona,273,157,116,57.51
Zilean,Vayne,476,255,221,53.57
Zilean,LeeSin,497,281,216,56.54
Zilean,Sett,446,231,215,51.79
Zilean,Ahri,531,273,258,51.41
Zilean,Aatrox,390,202,188,51.79
Zilean,Ekko,390,184,206,47.18
Zilean,Bard,191,106,85,55.5
Zilean,Mel,711,380,331,53.45
Zilean,Malphite,361,173,188,47.92
Zilean,Sona,166,97,69,58.43
Zilean,Yorick,341,162,179,47.51
Zilean,Kayn,562,278,284,49.47
Zilean,Ezreal,981,495,486,50.46
Zilean,Velkoz,264,136,128,51.52
Zilean,Nunu,172,102,70,59.3
Zilean,Vex,176,94,82,53.41
Zilean,Lucian,262,174,88,66.41
Zilean,Riven,192,90,102,46.88
Zilean,Anivia,124,66,58,53.23
Zilean,Aphelios,205,98,107,47.8
Zilean,Gangplank,187,99,88,52.94
Zilean,Kindred,156,92,64,58.97
Zilean,Shen,256,126,130,49.22
Zilean,Yuumi,404,183,221,45.3
Zilean,Shyvana,85,51,34,60
Zilean,TwistedFate,148,85,63,57.43
Zilean,Udyr,151,56,95,37.09
Zilean,Rakan,183,82,101,44.81
Zilean,MissFortune,851,431,420,50.65
Zilean,Senna,295,156,139,52.88
Zilean,Gnar,172,91,81,52.91
Zilean,Amumu,406,194,212,47.78
Zilean,Irelia,324,169,155,52.16
Zilean,DrMundo,196,93,103,47.45
Zilean,MasterYi,449,237,212,52.78
Zilean,Heimerdinger,208,120,88,57.69
Zilean,Viego,583,276,307,47.34
Zilean,Brand,265,127,138,47.92
Zilean,Pantheon,596,287,309,48.15
Zilean,Kennen,118,88,30,74.58
Zilean,Sejuani,117,76,41,64.96
Zilean,Soraka,226,129,97,57.08
Zilean,Sion,357,185,172,51.82
Zilean,Vladimir,259,143,116,55.21
Zilean,Renata,59,30,29,50.85
Zilean,Pyke,308,136,172,44.16
Zilean,Evelynn,131,77,54,58.78
Zilean,Tryndamere,200,127,73,63.5
Zilean,Jayce,268,130,138,48.51
Zilean,Orianna,205,100,105,48.78
Zilean,Malzahar,397,203,194,51.13
Zilean,Janna,163,77,86,47.24
Zilean,Veigar,349,172,177,49.28
Zilean,Gragas,199,96,103,48.24
Zilean,Seraphine,221,101,120,45.7
Zilean,Nasus,295,141,154,47.8
Zilean,Kassadin,99,58,41,58.59
Zilean,Vi,353,159,194,45.04
Zilean,Zoe,162,78,84,48.15
Zilean,Naafiri,133,68,65,51.13
Zilean,Singed,128,73,55,57.03
Zilean,Belveth,86,51,35,59.3
Zilean,Viktor,373,183,190,49.06
Zilean,Gwen,167,68,99,40.72
Zilean,Kayle,312,171,141,54.81
Zilean,Sylas,545,281,264,51.56
Zilean,Tristana,346,193,153,55.78
Zilean,MonkeyKing,253,108,145,42.69
Zilean,Diana,548,264,284,48.18
Zilean,KogMaw,134,65,69,48.51
Zilean,Annie,132,61,71,46.21
Zilean,Draven,154,72,82,46.75
Zilean,Blitzcrank,231,131,100,56.71
Zilean,Urgot,206,117,89,56.8
Zilean,Zeri,161,77,84,47.83
Zilean,Varus,343,197,146,57.43
Zilean,Rumble,115,78,37,67.83
Zilean,Lissandra,127,68,59,53.54
Zilean,Kalista,89,47,42,52.81
Zilean,Milio,208,98,110,47.12
Zilean,Olaf,67,44,23,65.67
Zilean,Rengar,145,86,59,59.31
Zilean,Galio,305,168,137,55.08
Zilean,Khazix,175,95,80,54.29
Zilean,Ryze,164,81,83,49.39
Zilean,Sivir,228,107,121,46.93
Zilean,Rell,168,85,83,50.6
Zilean,Maokai,204,102,102,50
Zilean,Qiyana,104,56,48,53.85
Zilean,Nilah,138,68,70,49.28
Zilean,FiddleSticks,225,108,117,48
Zilean,Ornn,218,105,113,48.17
Zilean,Alistar,150,80,70,53.33
Zilean,Karthus,119,52,67,43.7
Zilean,Nidalee,118,53,65,44.92
Zilean,Cassiopeia,107,60,47,56.07
Zilean,Elise,255,159,96,62.35
Zilean,Rammus,70,39,31,55.71
Zilean,Corki,166,91,75,54.82
Zilean,XinZhao,232,117,115,50.43
Zilean,Akshan,125,54,71,43.2
Zilean,Skarner,71,29,42,40.85
Zilean,Jax,319,161,158,50.47
Zilean,Quinn,148,63,85,42.57
Zilean,Taliyah,91,48,43,52.75
Zilean,Fizz,199,89,110,44.72
Zilean,RekSai,44,20,24,45.45
Zilean,Camille,131,63,68,48.09
Zilean,Taric,56,31,25,55.36
Zilean,Kled,63,30,33,47.62
Zilean,Ivern,32,21,11,65.63
Teemo,Warwick,2438,1173,1265,48.11
Teemo,Khazix,632,347,285,54.91
Teemo,Yorick,1800,844,956,46.89
Teemo,Vayne,1913,1018,895,53.21
Teemo,Lulu,1673,828,845,49.49
Teemo,Mel,3205,1770,1435,55.23
Teemo,Trundle,886,428,458,48.31
Teemo,Zed,1742,972,770,55.8
Teemo,Sejuani,522,245,277,46.93
Teemo,Kayle,941,497,444,52.82
Teemo,Darius,2942,1514,1428,51.46
Teemo,Malphite,2326,1225,1101,52.67
Teemo,Ezreal,3383,1796,1587,53.09
Teemo,Nami,1380,673,707,48.77
Teemo,Rumble,460,254,206,55.22
Teemo,Shaco,1612,818,794,50.74
Teemo,Veigar,1796,877,919,48.83
Teemo,Caitlyn,4215,2136,2079,50.68
Teemo,Lux,4298,2188,2110,50.91
Teemo,Volibear,1771,941,830,53.13
Teemo,Velkoz,1009,526,483,52.13
Teemo,Gangplank,704,330,374,46.88
Teemo,Lillia,791,431,360,54.49
Teemo,Renata,256,111,145,43.36
Teemo,Kayn,2291,1228,1063,53.6
Teemo,Shyvana,382,192,190,50.26
Teemo,Annie,540,270,270,50
Teemo,Varus,1226,660,566,53.83
Teemo,Kennen,431,229,202,53.13
Teemo,Zyra,1483,755,728,50.91
Teemo,Heimerdinger,922,446,476,48.37
Teemo,Malzahar,1782,886,896,49.72
Teemo,Sivir,853,460,393,53.93
Teemo,Neeko,814,439,375,53.93
Teemo,Illaoi,631,367,264,58.16
Teemo,MasterYi,2027,1009,1018,49.78
Teemo,Leblanc,884,430,454,48.64
Teemo,Anivia,439,216,223,49.2
Teemo,Briar,1134,609,525,53.7
Teemo,Katarina,1037,528,509,50.92
Teemo,Jhin,2989,1467,1522,49.08
Teemo,Seraphine,1275,641,634,50.27
Teemo,Sylas,1916,1030,886,53.76
Teemo,Aurora,1001,514,487,51.35
Teemo,Brand,1248,647,601,51.84
Teemo,Ekko,1394,705,689,50.57
Teemo,Yasuo,3100,1506,1594,48.58
Teemo,Nocturne,2016,1013,1003,50.25
Teemo,Orianna,586,317,269,54.1
Teemo,Kalista,309,176,133,56.96
Teemo,Aatrox,1316,686,630,52.13
Teemo,Evelynn,528,306,222,57.95
Teemo,Kaisa,2291,1232,1059,53.78
Teemo,Zilean,529,270,259,51.04
Teemo,RekSai,127,70,57,55.12
Teemo,Ahri,1872,990,882,52.88
Teemo,Jinx,4174,2004,2170,48.01
Teemo,Mordekaiser,1983,945,1038,47.66
Teemo,LeeSin,1914,1011,903,52.82
Teemo,Gnar,551,262,289,47.55
Teemo,Viego,1968,1034,934,52.54
Teemo,TwistedFate,478,277,201,57.95
Teemo,Olaf,444,199,245,44.82
Teemo,Sett,1990,996,994,50.05
Teemo,Amumu,1806,873,933,48.34
Teemo,Taliyah,285,160,125,56.14
Teemo,Xayah,598,303,295,50.67
Teemo,Braum,762,384,378,50.39
Teemo,Gragas,694,396,298,57.06
Teemo,Akali,1707,904,803,52.96
Teemo,Soraka,823,390,433,47.39
Teemo,Vladimir,1026,525,501,51.17
Teemo,Twitch,1198,622,576,51.92
Teemo,Pyke,1336,720,616,53.89
Teemo,Graves,796,450,346,56.53
Teemo,FiddleSticks,771,322,449,41.76
Teemo,Leona,1329,697,632,52.45
Teemo,Lissandra,457,235,222,51.42
Teemo,Tristana,1512,806,706,53.31
Teemo,Jax,1370,746,624,54.45
Teemo,Vi,1345,693,652,51.52
Teemo,Ashe,2933,1516,1417,51.69
Teemo,Thresh,1768,894,874,50.57
Teemo,Pantheon,2156,1048,1108,48.61
Teemo,Diana,2574,1277,1297,49.61
Teemo,Smolder,937,490,447,52.29
Teemo,Elise,898,499,399,55.57
Teemo,Zeri,556,283,273,50.9
Teemo,Senna,1091,559,532,51.24
Teemo,Ambessa,697,377,320,54.09
Teemo,Ziggs,652,350,302,53.68
Teemo,Xerath,1372,670,702,48.83
Teemo,Milio,746,384,362,51.47
Teemo,Zoe,440,257,183,58.41
Teemo,TahmKench,1100,577,523,52.45
Teemo,Syndra,910,433,477,47.58
Teemo,Draven,741,410,331,55.33
Teemo,Yuumi,1162,580,582,49.91
Teemo,Jayce,730,426,304,58.36
Teemo,Taric,281,149,132,53.02
Teemo,Nilah,495,262,233,52.93
Teemo,Blitzcrank,1031,529,502,51.31
Teemo,Fiora,405,218,187,53.83
Teemo,Yone,2522,1423,1099,56.42
Teemo,MissFortune,3842,1938,1904,50.44
Teemo,Maokai,725,383,342,52.83
Teemo,Tryndamere,904,463,441,51.22
Teemo,Garen,2501,1295,1206,51.78
Teemo,AurelionSol,523,249,274,47.61
Teemo,Poppy,744,374,370,50.27
Teemo,Nautilus,1602,892,710,55.68
Teemo,Camille,432,243,189,56.25
Teemo,Rengar,469,255,214,54.37
Teemo,Nasus,1227,565,662,46.05
Teemo,Irelia,1226,673,553,54.89
Teemo,Galio,1456,744,712,51.1
Teemo,Hwei,861,416,445,48.32
Teemo,Aphelios,736,413,323,56.11
Teemo,Swain,1521,777,744,51.08
Teemo,Kassadin,263,130,133,49.43
Teemo,Udyr,490,276,214,56.33
Teemo,Singed,415,213,202,51.33
Teemo,Nunu,878,414,464,47.15
Teemo,DrMundo,935,437,498,46.74
Teemo,Karma,1629,805,824,49.42
Teemo,MonkeyKing,967,455,512,47.05
Teemo,Morgana,2037,1032,1005,50.66
Teemo,Corki,539,307,232,56.96
Teemo,Qiyana,293,178,115,60.75
Teemo,Akshan,563,277,286,49.2
Teemo,Lucian,963,478,485,49.64
Teemo,Chogath,2027,959,1068,47.31
Teemo,Riven,600,322,278,53.67
Teemo,Skarner,375,191,184,50.93
Teemo,Fizz,957,481,476,50.26
Teemo,Gwen,532,318,214,59.77
Teemo,Viktor,1190,603,587,50.67
Teemo,Vex,886,434,452,48.98
Teemo,Kindred,632,332,300,52.53
Teemo,Bard,356,192,164,53.93
Teemo,JarvanIV,762,351,411,46.06
Teemo,Sona,493,223,270,45.23
Teemo,Urgot,796,402,394,50.5
Teemo,Ivern,202,111,91,54.95
Teemo,Alistar,594,314,280,52.86
Teemo,Ryze,562,309,253,54.98
Teemo,XinZhao,789,412,377,52.22
Teemo,Sion,1338,681,657,50.9
Teemo,Ornn,526,262,264,49.81
Teemo,Hecarim,567,310,257,54.67
Teemo,Rammus,466,231,235,49.57
Teemo,Samira,1209,608,601,50.29
Teemo,Rell,619,331,288,53.47
Teemo,Belveth,353,200,153,56.66
Teemo,Karthus,497,258,239,51.91
Teemo,Renekton,566,322,244,56.89
Teemo,KogMaw,485,237,248,48.87
Teemo,Rakan,459,215,244,46.84
Teemo,Naafiri,549,270,279,49.18
Teemo,Talon,838,464,374,55.37
Teemo,Shen,917,445,472,48.53
Teemo,Zac,652,327,325,50.15
Teemo,Quinn,649,360,289,55.47
Teemo,Cassiopeia,550,311,239,56.55
Teemo,Nidalee,379,231,148,60.95
Teemo,Janna,351,191,160,54.42
Teemo,KSante,449,259,190,57.68
Teemo,Kled,226,127,99,56.19
Teemo,Azir,399,218,181,54.64
MonkeyKing,Warwick,1254,565,689,45.06
MonkeyKing,Khazix,394,215,179,54.57
MonkeyKing,Yorick,797,355,442,44.54
MonkeyKing,Vayne,1107,553,554,49.95
MonkeyKing,Lulu,1163,517,646,44.45
MonkeyKing,Urgot,452,248,204,54.87
MonkeyKing,Vi,933,441,492,47.27
MonkeyKing,Ryze,266,127,139,47.74
MonkeyKing,MissFortune,1886,940,946,49.84
MonkeyKing,Thresh,1186,589,597,49.66
MonkeyKing,Darius,1743,864,879,49.57
MonkeyKing,Braum,512,249,263,48.63
MonkeyKing,Aurora,593,265,328,44.69
MonkeyKing,Ashe,1645,850,795,51.67
MonkeyKing,Nunu,431,231,200,53.6
MonkeyKing,Sejuani,355,213,142,60
MonkeyKing,Yone,1561,853,708,54.64
MonkeyKing,Ezreal,2063,1054,1009,51.09
MonkeyKing,Milio,473,204,269,43.13
MonkeyKing,Poppy,468,266,202,56.84
MonkeyKing,Katarina,644,338,306,52.48
MonkeyKing,Yuumi,572,341,231,59.62
MonkeyKing,Aatrox,679,334,345,49.19
MonkeyKing,Shaco,739,376,363,50.88
MonkeyKing,Neeko,348,191,157,54.89
MonkeyKing,Lucian,665,332,333,49.92
MonkeyKing,Nami,849,371,478,43.7
MonkeyKing,Viego,1360,686,674,50.44
MonkeyKing,Naafiri,265,126,139,47.55
MonkeyKing,Nilah,264,132,132,50
MonkeyKing,Brand,622,277,345,44.53
MonkeyKing,KSante,428,247,181,57.71
MonkeyKing,Nocturne,1216,596,620,49.01
MonkeyKing,Leona,695,352,343,50.65
MonkeyKing,Volibear,1058,495,563,46.79
MonkeyKing,Vladimir,583,281,302,48.2
MonkeyKing,Zeri,310,135,175,43.55
MonkeyKing,Senna,638,352,286,55.17
MonkeyKing,Sion,640,325,315,50.78
MonkeyKing,Evelynn,275,142,133,51.64
MonkeyKing,Ahri,1044,540,504,51.72
MonkeyKing,Sett,1318,670,648,50.83
MonkeyKing,MasterYi,995,509,486,51.16
MonkeyKing,Mordekaiser,1101,542,559,49.23
MonkeyKing,Jinx,2371,1145,1226,48.29
MonkeyKing,Lux,1993,981,1012,49.22
MonkeyKing,Singed,202,87,115,43.07
MonkeyKing,Caitlyn,2292,1154,1138,50.35
MonkeyKing,Pyke,663,368,295,55.51
MonkeyKing,Kayn,1271,662,609,52.08
MonkeyKing,Fizz,499,264,235,52.91
MonkeyKing,Karma,1117,545,572,48.79
MonkeyKing,Talon,482,291,191,60.37
MonkeyKing,Swain,825,397,428,48.12
MonkeyKing,Irelia,670,370,300,55.22
MonkeyKing,Varus,738,377,361,51.08
MonkeyKing,Nasus,597,291,306,48.74
MonkeyKing,Tryndamere,475,233,242,49.05
MonkeyKing,Soraka,479,226,253,47.18
MonkeyKing,Malzahar,898,468,430,52.12
MonkeyKing,Pantheon,1375,690,685,50.18
MonkeyKing,AurelionSol,309,137,172,44.34
MonkeyKing,Twitch,716,395,321,55.17
MonkeyKing,Graves,585,290,295,49.57
MonkeyKing,Leblanc,500,253,247,50.6
MonkeyKing,Diana,1399,754,645,53.9
MonkeyKing,Kindred,402,188,214,46.77
MonkeyKing,Mel,1632,879,753,53.86
MonkeyKing,Shen,495,250,245,50.51
MonkeyKing,Kalista,200,113,87,56.5
MonkeyKing,Ekko,810,443,367,54.69
MonkeyKing,Jayce,452,223,229,49.34
MonkeyKing,Jhin,1734,917,817,52.88
MonkeyKing,Nautilus,877,484,393,55.19
MonkeyKing,Teemo,967,512,455,52.95
MonkeyKing,Garen,1348,665,683,49.33
MonkeyKing,Amumu,762,372,390,48.82
MonkeyKing,Tristana,858,480,378,55.94
MonkeyKing,Zac,478,212,266,44.35
MonkeyKing,Maokai,350,179,171,51.14
MonkeyKing,Galio,698,372,326,53.3
MonkeyKing,DrMundo,411,200,211,48.66
MonkeyKing,Veigar,807,419,388,51.92
MonkeyKing,Gnar,301,134,167,44.52
MonkeyKing,Ziggs,296,155,141,52.36
MonkeyKing,Taliyah,205,73,132,35.61
MonkeyKing,Gangplank,417,182,235,43.65
MonkeyKing,Zed,845,499,346,59.05
MonkeyKing,Renekton,420,205,215,48.81
MonkeyKing,Viktor,840,398,442,47.38
MonkeyKing,JarvanIV,594,290,304,48.82
MonkeyKing,Sona,239,108,131,45.19
MonkeyKing,Yasuo,1606,815,791,50.75
MonkeyKing,Draven,405,192,213,47.41
MonkeyKing,Morgana,893,438,455,49.05
MonkeyKing,Malphite,839,441,398,52.56
MonkeyKing,Akali,891,475,416,53.31
MonkeyKing,TahmKench,594,313,281,52.69
MonkeyKing,Ivern,109,58,51,53.21
MonkeyKing,Zoe,299,126,173,42.14
MonkeyKing,Udyr,334,160,174,47.9
MonkeyKing,FiddleSticks,383,179,204,46.74
MonkeyKing,Jax,703,348,355,49.5
MonkeyKing,Trundle,454,240,214,52.86
MonkeyKing,Zyra,826,441,385,53.39
MonkeyKing,Ambessa,534,290,244,54.31
MonkeyKing,LeeSin,1332,684,648,51.35
MonkeyKing,Kaisa,1309,732,577,55.92
MonkeyKing,Fiora,329,163,166,49.54
MonkeyKing,Kassadin,176,92,84,52.27
MonkeyKing,Seraphine,532,268,264,50.38
MonkeyKing,Kennen,209,92,117,44.02
MonkeyKing,TwistedFate,264,126,138,47.73
MonkeyKing,Gragas,490,239,251,48.78
MonkeyKing,Rammus,216,129,87,59.72
MonkeyKing,Zilean,253,145,108,57.31
MonkeyKing,Akshan,281,131,150,46.62
MonkeyKing,Samira,566,323,243,57.07
MonkeyKing,Xerath,715,345,370,48.25
MonkeyKing,XinZhao,568,358,210,63.03
MonkeyKing,Lillia,468,224,244,47.86
MonkeyKing,Rell,358,176,182,49.16
MonkeyKing,Orianna,344,188,156,54.65
MonkeyKing,Karthus,210,101,109,48.1
MonkeyKing,Chogath,875,412,463,47.09
MonkeyKing,Kayle,493,245,248,49.7
MonkeyKing,Elise,515,209,306,40.58
MonkeyKing,Camille,324,176,148,54.32
MonkeyKing,Velkoz,517,252,265,48.74
MonkeyKing,Azir,343,172,171,50.15
MonkeyKing,Smolder,530,299,231,56.42
MonkeyKing,Alistar,355,201,154,56.62
MonkeyKing,Hecarim,312,200,112,64.1
MonkeyKing,Riven,413,223,190,54
MonkeyKing,Cassiopeia,278,147,131,52.88
MonkeyKing,Sivir,406,190,216,46.8
MonkeyKing,Bard,253,136,117,53.75
MonkeyKing,Hwei,573,281,292,49.04
MonkeyKing,Xayah,395,193,202,48.86
MonkeyKing,Gwen,419,205,214,48.93
MonkeyKing,Annie,218,101,117,46.33
MonkeyKing,Sylas,1199,634,565,52.88
MonkeyKing,Aphelios,403,226,177,56.08
MonkeyKing,Briar,554,291,263,52.53
MonkeyKing,Ornn,330,151,179,45.76
MonkeyKing,Belveth,153,62,91,40.52
MonkeyKing,Janna,309,172,137,55.66
MonkeyKing,Rengar,252,155,97,61.51
MonkeyKing,Rakan,351,189,162,53.85
MonkeyKing,Illaoi,389,164,225,42.16
MonkeyKing,Qiyana,206,111,95,53.88
MonkeyKing,Syndra,513,242,271,47.17
MonkeyKing,Shyvana,174,84,90,48.28
MonkeyKing,Blitzcrank,615,338,277,54.96
MonkeyKing,Lissandra,324,157,167,48.46
MonkeyKing,Heimerdinger,347,214,133,61.67
MonkeyKing,Quinn,315,169,146,53.65
MonkeyKing,Vex,378,175,203,46.3
MonkeyKing,Nidalee,251,125,126,49.8
MonkeyKing,Kled,126,65,61,51.59
MonkeyKing,Taric,171,98,73,57.31
MonkeyKing,Corki,326,177,149,54.29
MonkeyKing,Renata,151,80,71,52.98
MonkeyKing,Olaf,190,104,86,54.74
MonkeyKing,KogMaw,226,103,123,45.58
MonkeyKing,Skarner,231,122,109,52.81
MonkeyKing,Rumble,204,113,91,55.39
MonkeyKing,Anivia,261,135,126,51.72
MonkeyKing,RekSai,78,26,52,33.33
Blitzcrank,Warwick,1266,588,678,46.45
Blitzcrank,Khazix,419,190,229,45.35
Blitzcrank,Yorick,763,332,431,43.51
Blitzcrank,Vayne,1010,498,512,49.31
Blitzcrank,Lulu,1272,666,606,52.36
Blitzcrank,Ambessa,569,318,251,55.89
Blitzcrank,Graves,558,248,310,44.44
Blitzcrank,Akali,1002,439,563,43.81
Blitzcrank,Anivia,243,121,122,49.79
Blitzcrank,Leona,972,448,524,46.09
Blitzcrank,Mordekaiser,1007,471,536,46.77
Blitzcrank,Vi,804,411,393,51.12
Blitzcrank,Vex,534,255,279,47.75
Blitzcrank,Varus,801,390,411,48.69
Blitzcrank,Seraphine,614,326,288,53.09
Blitzcrank,Illaoi,424,207,217,48.82
Blitzcrank,MasterYi,1069,564,505,52.76
Blitzcrank,Leblanc,632,329,303,52.06
Blitzcrank,Caitlyn,2432,1188,1244,48.85
Blitzcrank,Pantheon,1457,670,787,45.98
Blitzcrank,Kayn,1137,556,581,48.9
Blitzcrank,Viktor,757,362,395,47.82
Blitzcrank,Samira,623,282,341,45.26
Blitzcrank,Janna,285,137,148,48.07
Blitzcrank,Malzahar,768,378,390,49.22
Blitzcrank,Ekko,804,398,406,49.5
Blitzcrank,Yasuo,1624,807,817,49.69
Blitzcrank,Urgot,397,229,168,57.68
Blitzcrank,Veigar,840,416,424,49.52
Blitzcrank,Maokai,357,165,192,46.22
Blitzcrank,Jhin,1719,909,810,52.88
Blitzcrank,Gnar,310,139,171,44.84
Blitzcrank,Viego,1271,619,652,48.7
Blitzcrank,TwistedFate,312,160,152,51.28
Blitzcrank,Jinx,2277,1075,1202,47.21
Blitzcrank,Lux,2475,1249,1226,50.46
Blitzcrank,Sion,548,283,265,51.64
Blitzcrank,Udyr,332,166,166,50
Blitzcrank,Ryze,333,145,188,43.54
Blitzcrank,Kaisa,1299,583,716,44.88
Blitzcrank,KSante,488,245,243,50.2
Blitzcrank,Taliyah,183,75,108,40.98
Blitzcrank,Sona,228,131,97,57.46
Blitzcrank,Shyvana,207,97,110,46.86
Blitzcrank,Sett,1414,615,799,43.49
Blitzcrank,Xerath,976,441,535,45.18
Blitzcrank,Milio,432,200,232,46.3
Blitzcrank,Teemo,1031,502,529,48.69
Blitzcrank,Aurora,601,263,338,43.76
Blitzcrank,Velkoz,553,262,291,47.38
Blitzcrank,DrMundo,467,231,236,49.46
Blitzcrank,MissFortune,2036,1016,1020,49.9
Blitzcrank,Karma,1128,543,585,48.14
Blitzcrank,Olaf,246,106,140,43.09
Blitzcrank,Amumu,810,407,403,50.25
Blitzcrank,Nautilus,1029,461,568,44.8
Blitzcrank,Renekton,460,238,222,51.74
Blitzcrank,Volibear,984,474,510,48.17
Blitzcrank,Irelia,782,376,406,48.08
Blitzcrank,Ahri,1178,501,677,42.53
Blitzcrank,Kayle,462,244,218,52.81
Blitzcrank,Kindred,414,180,234,43.48
Blitzcrank,Swain,789,359,430,45.5
Blitzcrank,Chogath,938,414,524,44.14
Blitzcrank,Thresh,1242,565,677,45.49
Blitzcrank,Poppy,521,216,305,41.46
Blitzcrank,Naafiri,267,164,103,61.42
Blitzcrank,Lucian,571,258,313,45.18
Blitzcrank,Fiora,247,94,153,38.06
Blitzcrank,AurelionSol,364,176,188,48.35
Blitzcrank,Darius,1641,766,875,46.68
Blitzcrank,Rammus,262,116,146,44.27
Blitzcrank,Jax,812,394,418,48.52
Blitzcrank,Lillia,508,240,268,47.24
Blitzcrank,Diana,1339,655,684,48.92
Blitzcrank,Twitch,629,331,298,52.62
Blitzcrank,Shaco,823,398,425,48.36
Blitzcrank,Singed,174,76,98,43.68
Blitzcrank,Corki,349,187,162,53.58
Blitzcrank,Neeko,375,199,176,53.07
Blitzcrank,Kennen,251,126,125,50.2
Blitzcrank,FiddleSticks,373,179,194,47.99
Blitzcrank,Ziggs,342,168,174,49.12
Blitzcrank,TahmKench,678,364,314,53.69
Blitzcrank,Yone,1790,888,902,49.61
Blitzcrank,Briar,611,224,387,36.66
Blitzcrank,Xayah,429,194,235,45.22
Blitzcrank,Senna,586,277,309,47.27
Blitzcrank,Ezreal,2513,1245,1268,49.54
Blitzcrank,Garen,1325,653,672,49.28
Blitzcrank,Mel,1585,772,813,48.71
Blitzcrank,Tristana,829,388,441,46.8
Blitzcrank,Aphelios,464,250,214,53.88
Blitzcrank,Yuumi,637,283,354,44.43
Blitzcrank,Vladimir,558,298,260,53.41
Blitzcrank,Ivern,90,60,30,66.67
Blitzcrank,Zed,987,488,499,49.44
Blitzcrank,Aatrox,871,407,464,46.73
Blitzcrank,Braum,559,233,326,41.68
Blitzcrank,Nasus,563,300,263,53.29
Blitzcrank,Sivir,716,283,433,39.53
Blitzcrank,Fizz,419,209,210,49.88
Blitzcrank,Elise,596,298,298,50
Blitzcrank,Lissandra,235,111,124,47.23
Blitzcrank,LeeSin,1563,758,805,48.5
Blitzcrank,Talon,460,240,220,52.17
Blitzcrank,Nami,668,309,359,46.26
Blitzcrank,Sylas,1464,701,763,47.88
Blitzcrank,Riven,418,173,245,41.39
Blitzcrank,Quinn,296,164,132,55.41
Blitzcrank,Syndra,506,242,264,47.83
Blitzcrank,Hwei,588,268,320,45.58
Blitzcrank,Soraka,414,211,203,50.97
Blitzcrank,Shen,580,307,273,52.93
Blitzcrank,Smolder,478,232,246,48.54
Blitzcrank,Camille,283,130,153,45.94
Blitzcrank,Trundle,500,231,269,46.2
Blitzcrank,Zyra,912,423,489,46.38
Blitzcrank,Skarner,248,145,103,58.47
Blitzcrank,Qiyana,213,103,110,48.36
Blitzcrank,Katarina,596,296,300,49.66
Blitzcrank,Ashe,1963,1006,957,51.25
Blitzcrank,Brand,585,289,296,49.4
Blitzcrank,Morgana,1082,525,557,48.52
Blitzcrank,Nocturne,1140,495,645,43.42
Blitzcrank,Gragas,451,228,223,50.55
Blitzcrank,Taric,194,79,115,40.72
Blitzcrank,Tryndamere,492,262,230,53.25
Blitzcrank,Rumble,271,137,134,50.55
Blitzcrank,Draven,346,151,195,43.64
Blitzcrank,Zac,432,192,240,44.44
Blitzcrank,Heimerdinger,341,156,185,45.75
Blitzcrank,Jayce,497,224,273,45.07
Blitzcrank,Zilean,231,100,131,43.29
Blitzcrank,KogMaw,230,103,127,44.78
Blitzcrank,Galio,761,373,388,49.01
Blitzcrank,Gwen,403,184,219,45.66
Blitzcrank,XinZhao,534,261,273,48.88
Blitzcrank,Rell,370,178,192,48.11
Blitzcrank,Alistar,540,282,258,52.22
Blitzcrank,Gangplank,419,222,197,52.98
Blitzcrank,Cassiopeia,231,110,121,47.62
Blitzcrank,Kalista,211,106,105,50.24
Blitzcrank,Sejuani,331,134,197,40.48
Blitzcrank,Rengar,237,132,105,55.7
Blitzcrank,Azir,324,151,173,46.6
Blitzcrank,Evelynn,309,168,141,54.37
Blitzcrank,Renata,110,61,49,55.45
Blitzcrank,Malphite,749,390,359,52.07
Blitzcrank,Rakan,294,129,165,43.88
Blitzcrank,Pyke,681,309,372,45.37
Blitzcrank,Karthus,289,146,143,50.52
Blitzcrank,Annie,288,125,163,43.4
Blitzcrank,Akshan,274,128,146,46.72
Blitzcrank,Nunu,442,210,232,47.51
Blitzcrank,Ornn,377,186,191,49.34
Blitzcrank,Belveth,162,94,68,58.02
Blitzcrank,MonkeyKing,615,277,338,45.04
Blitzcrank,Kassadin,169,91,78,53.85
Blitzcrank,Kled,117,52,65,44.44
Blitzcrank,Bard,203,114,89,56.16
Blitzcrank,Orianna,375,181,194,48.27
Blitzcrank,Zeri,386,184,202,47.67
Blitzcrank,JarvanIV,441,170,271,38.55
Blitzcrank,Hecarim,357,213,144,59.66
Blitzcrank,Zoe,336,159,177,47.32
Blitzcrank,Nilah,215,101,114,46.98
Blitzcrank,Nidalee,264,139,125,52.65
Blitzcrank,RekSai,106,54,52,50.94
Khazix,Teemo,632,285,347,45.09
Khazix,MonkeyKing,394,179,215,45.43
Khazix,Katarina,439,206,233,46.92
Khazix,Jinx,1584,719,865,45.39
Khazix,Blitzcrank,419,229,190,54.65
Khazix,Trundle,276,119,157,43.12
Khazix,Malphite,542,253,289,46.68
Khazix,Hwei,450,225,225,50
Khazix,Twitch,495,236,259,47.68
Khazix,Milio,333,170,163,51.05
Khazix,Ornn,246,97,149,39.43
Khazix,Kayn,879,426,453,48.46
Khazix,Malzahar,594,266,328,44.78
Khazix,Vayne,755,348,407,46.09
Khazix,Lulu,827,402,425,48.61
Khazix,Sejuani,180,88,92,48.89
Khazix,Jayce,278,128,150,46.04
Khazix,Jhin,1165,558,607,47.9
Khazix,Thresh,801,381,420,47.57
Khazix,Yasuo,1154,531,623,46.01
Khazix,Mel,1138,561,577,49.3
Khazix,Xayah,226,119,107,52.65
Khazix,Rakan,244,151,93,61.89
Khazix,Jax,550,293,257,53.27
Khazix,Viego,962,422,540,43.87
Khazix,Aurora,441,261,180,59.18
Khazix,Lux,1525,646,879,42.36
Khazix,Nocturne,775,357,418,46.06
Khazix,Karma,859,387,472,45.05
Khazix,Gangplank,272,149,123,54.78
Khazix,Lillia,295,157,138,53.22
Khazix,Caitlyn,1706,791,915,46.37
Khazix,Renata,90,39,51,43.33
Khazix,DrMundo,347,167,180,48.13
Khazix,Rengar,354,195,159,55.08
Khazix,Akali,608,313,295,51.48
Khazix,Nilah,173,63,110,36.42
Khazix,Shen,311,153,158,49.2
Khazix,MasterYi,741,361,380,48.72
Khazix,Irelia,517,251,266,48.55
Khazix,MissFortune,1294,580,714,44.82
Khazix,Diana,925,437,488,47.24
Khazix,Amumu,559,220,339,39.36
Khazix,Syndra,434,217,217,50
Khazix,Tristana,581,305,276,52.5
Khazix,TahmKench,391,211,180,53.96
Khazix,Morgana,640,331,309,51.72
Khazix,Warwick,693,310,383,44.73
Khazix,Ekko,569,282,287,49.56
Khazix,Yone,1051,534,517,50.81
Khazix,Veigar,548,266,282,48.54
Khazix,Ezreal,1447,731,716,50.52
Khazix,Nami,651,331,320,50.84
Khazix,Ashe,1153,484,669,41.98
Khazix,Soraka,355,158,197,44.51
Khazix,Poppy,364,187,177,51.37
Khazix,Sett,826,339,487,41.04
Khazix,LeeSin,1044,483,561,46.26
Khazix,Pyke,513,249,264,48.54
Khazix,Smolder,383,202,181,52.74
Khazix,Zed,723,359,364,49.65
Khazix,Ambessa,339,166,173,48.97
Khazix,Kaisa,1015,520,495,51.23
Khazix,Neeko,250,120,130,48
Khazix,Yorick,573,228,345,39.79
Khazix,Rumble,169,77,92,45.56
Khazix,Brand,481,220,261,45.74
Khazix,Pantheon,926,460,466,49.68
Khazix,Taliyah,156,51,105,32.69
Khazix,Kindred,252,112,140,44.44
Khazix,Evelynn,240,102,138,42.5
Khazix,Velkoz,317,177,140,55.84
Khazix,Garen,862,365,497,42.34
Khazix,AurelionSol,186,99,87,53.23
Khazix,Seraphine,488,260,228,53.28
Khazix,Briar,419,177,242,42.24
Khazix,Shyvana,110,50,60,45.45
Khazix,Zoe,204,101,103,49.51
Khazix,Maokai,181,83,98,45.86
Khazix,FiddleSticks,326,165,161,50.61
Khazix,Zyra,592,290,302,48.99
Khazix,Udyr,183,85,98,46.45
Khazix,Chogath,666,287,379,43.09
Khazix,Talon,465,247,218,53.12
Khazix,Nasus,390,195,195,50
Khazix,Sivir,295,143,152,48.47
Khazix,Sion,415,196,219,47.23
Khazix,Nunu,271,135,136,49.82
Khazix,Riven,271,119,152,43.91
Khazix,Xerath,590,276,314,46.78
Khazix,Darius,1077,513,564,47.63
Khazix,Ahri,721,346,375,47.99
Khazix,Elise,441,216,225,48.98
Khazix,Vladimir,435,225,210,51.72
Khazix,Braum,311,110,201,35.37
Khazix,Illaoi,239,119,120,49.79
Khazix,KSante,297,183,114,61.62
Khazix,Shaco,603,300,303,49.75
Khazix,Graves,504,272,232,53.97
Khazix,Vex,303,137,166,45.21
Khazix,Camille,231,148,83,64.07
Khazix,Singed,178,94,84,52.81
Khazix,Ziggs,218,99,119,45.41
Khazix,Nautilus,603,304,299,50.41
Khazix,Fizz,309,123,186,39.81
Khazix,Akshan,243,103,140,42.39
Khazix,Heimerdinger,255,102,153,40
Khazix,Zac,248,119,129,47.98
Khazix,Aphelios,365,158,207,43.29
Khazix,Leona,380,200,180,52.63
Khazix,Kayle,350,141,209,40.29
Khazix,Corki,244,147,97,60.25
Khazix,Aatrox,562,263,299,46.8
Khazix,XinZhao,366,173,193,47.27
Khazix,Ryze,197,97,100,49.24
Khazix,Quinn,256,116,140,45.31
Khazix,Karthus,199,112,87,56.28
Khazix,Skarner,130,45,85,34.62
Khazix,Azir,247,109,138,44.13
Khazix,KogMaw,173,70,103,40.46
Khazix,JarvanIV,306,140,166,45.75
Khazix,Swain,493,234,259,47.46
Khazix,Anivia,172,75,97,43.6
Khazix,Ivern,79,39,40,49.37
Khazix,Viktor,514,267,247,51.95
Khazix,Leblanc,364,191,173,52.47
Khazix,Lucian,453,234,219,51.66
Khazix,Rell,305,163,142,53.44
Khazix,Mordekaiser,750,345,405,46
Khazix,Orianna,257,108,149,42.02
Khazix,Kled,97,39,58,40.21
Khazix,Gragas,318,175,143,55.03
Khazix,Kennen,191,92,99,48.17
Khazix,Hecarim,284,140,144,49.3
Khazix,Lissandra,223,91,132,40.81
Khazix,Senna,395,193,202,48.86
Khazix,Fiora,217,96,121,44.24
Khazix,Vi,482,267,215,55.39
Khazix,Renekton,260,150,110,57.69
Khazix,Alistar,194,93,101,47.94
Khazix,Cassiopeia,176,87,89,49.43
Khazix,Samira,368,160,208,43.48
Khazix,Galio,434,191,243,44.01
Khazix,Sona,211,85,126,40.28
Khazix,Draven,301,156,145,51.83
Khazix,Volibear,609,256,353,42.04
Khazix,Sylas,811,421,390,51.91
Khazix,Qiyana,194,72,122,37.11
Khazix,Zilean,175,80,95,45.71
Khazix,Urgot,307,126,181,41.04
Khazix,Taric,140,58,82,41.43
Khazix,Gwen,277,137,140,49.46
Khazix,Varus,577,300,277,51.99
Khazix,Kassadin,143,84,59,58.74
Khazix,Naafiri,169,73,96,43.2
Khazix,Tryndamere,273,151,122,55.31
Khazix,Yuumi,387,193,194,49.87
Khazix,Gnar,231,109,122,47.19
Khazix,Rammus,165,73,92,44.24
Khazix,Janna,203,113,90,55.67
Khazix,Kalista,142,58,84,40.85
Khazix,Zeri,270,121,149,44.81
Khazix,Nidalee,264,146,118,55.3
Khazix,Belveth,145,77,68,53.1
Khazix,Annie,182,93,89,51.1
Khazix,RekSai,36,19,17,52.78
Khazix,TwistedFate,244,122,122,50
Khazix,Olaf,109,56,53,51.38
Khazix,Bard,155,58,97,37.42
Vayne,Teemo,1913,895,1018,46.79
Vayne,MonkeyKing,1107,554,553,50.05
Vayne,Katarina,1105,642,463,58.1
Vayne,Jinx,4841,2320,2521,47.92
Vayne,Blitzcrank,1010,512,498,50.69
Vayne,FiddleSticks,732,318,414,43.44
Vayne,Yone,2561,1411,1150,55.1
Vayne,Nilah,480,259,221,53.96
Vayne,Rell,745,345,400,46.31
Vayne,Kayle,1102,543,559,49.27
Vayne,Mordekaiser,2086,1093,993,52.4
Vayne,Yasuo,3225,1618,1607,50.17
Vayne,Varus,1319,676,643,51.25
Vayne,Galio,1313,701,612,53.39
Vayne,MasterYi,1939,1007,932,51.93
Vayne,Khazix,755,407,348,53.91
Vayne,Aurora,1114,554,560,49.73
Vayne,Ashe,2887,1479,1408,51.23
Vayne,Thresh,2123,1057,1066,49.79
Vayne,Fiora,491,285,206,58.04
Vayne,Warwick,2406,1133,1273,47.09
Vayne,Zed,1772,899,873,50.73
Vayne,Swain,1523,798,725,52.4
Vayne,Chogath,2082,1116,966,53.6
Vayne,Gwen,682,366,316,53.67
Vayne,TwistedFate,504,266,238,52.78
Vayne,Singed,449,226,223,50.33
Vayne,Vi,1478,678,800,45.87
Vayne,Ahri,1804,924,880,51.22
Vayne,Jhin,3304,1801,1503,54.51
Vayne,Pyke,1149,583,566,50.74
Vayne,Nocturne,1846,938,908,50.81
Vayne,Sylas,1895,997,898,52.61
Vayne,Yorick,1506,722,784,47.94
Vayne,Kindred,633,347,286,54.82
Vayne,Veigar,1634,815,819,49.88
Vayne,Tristana,1730,879,851,50.81
Vayne,Nautilus,1896,987,909,52.06
Vayne,Darius,3349,1703,1646,50.85
Vayne,Braum,930,453,477,48.71
Vayne,Nunu,747,358,389,47.93
Vayne,Kayn,2306,1188,1118,51.52
Vayne,Morgana,1782,920,862,51.63
Vayne,Naafiri,492,238,254,48.37
Vayne,Akali,1732,953,779,55.02
Vayne,Zyra,1398,721,677,51.57
Vayne,Aatrox,1287,671,616,52.14
Vayne,Evelynn,498,254,244,51
Vayne,Kaisa,2779,1389,1390,49.98
Vayne,Leona,1426,751,675,52.66
Vayne,Volibear,1801,961,840,53.36
Vayne,Rengar,538,315,223,58.55
Vayne,Malzahar,1566,739,827,47.19
Vayne,TahmKench,1401,765,636,54.6
Vayne,Ambessa,943,545,398,57.79
Vayne,JarvanIV,861,425,436,49.36
Vayne,Alistar,779,393,386,50.45
Vayne,Camille,516,260,256,50.39
Vayne,Caitlyn,4194,2094,2100,49.93
Vayne,Lux,3725,1960,1765,52.62
Vayne,Fizz,1003,519,484,51.74
Vayne,Samira,1267,659,608,52.01
Vayne,Ekko,1546,757,789,48.97
Vayne,Sett,2174,1132,1042,52.07
Vayne,Pantheon,2287,1171,1116,51.2
Vayne,MissFortune,3745,1890,1855,50.47
Vayne,Nami,1521,754,767,49.57
Vayne,Shaco,1491,774,717,51.91
Vayne,Leblanc,841,456,385,54.22
Vayne,Hwei,934,458,476,49.04
Vayne,Gragas,831,460,371,55.35
Vayne,Ezreal,4008,2061,1947,51.42
Vayne,LeeSin,2043,1096,947,53.65
Vayne,Sejuani,701,355,346,50.64
Vayne,Ziggs,516,263,253,50.97
Vayne,Bard,390,192,198,49.23
Vayne,Garen,2774,1439,1335,51.87
Vayne,Vex,805,403,402,50.06
Vayne,Zilean,476,221,255,46.43
Vayne,Udyr,587,311,276,52.98
Vayne,Akshan,643,326,317,50.7
Vayne,Zac,730,332,398,45.48
Vayne,Mel,3137,1689,1448,53.84
Vayne,Irelia,1316,621,695,47.19
Vayne,Sona,511,222,289,43.44
Vayne,KogMaw,583,268,315,45.97
Vayne,Lulu,1825,934,891,51.18
Vayne,Diana,2372,1224,1148,51.6
Vayne,Yuumi,1125,595,530,52.89
Vayne,Ornn,649,341,308,52.54
Vayne,Rakan,598,310,288,51.84
Vayne,Ryze,567,282,285,49.74
Vayne,Karma,1749,946,803,54.09
Vayne,Gnar,597,279,318,46.73
Vayne,Tryndamere,852,451,401,52.93
Vayne,Taric,418,201,217,48.09
Vayne,Lucian,1202,625,577,52
Vayne,Briar,1020,500,520,49.02
Vayne,Qiyana,367,181,186,49.32
Vayne,Corki,645,308,337,47.75
Vayne,Amumu,1529,747,782,48.86
Vayne,Nidalee,349,178,171,51
Vayne,Nasus,1199,626,573,52.21
Vayne,Soraka,814,408,406,50.12
Vayne,Vladimir,1228,637,591,51.87
Vayne,Viego,2142,1073,1069,50.09
Vayne,Renekton,656,356,300,54.27
Vayne,Poppy,1049,532,517,50.71
Vayne,Viktor,1376,670,706,48.69
Vayne,Twitch,1389,706,683,50.83
Vayne,Kennen,415,222,193,53.49
Vayne,Shen,1071,582,489,54.34
Vayne,Maokai,771,407,364,52.79
Vayne,Cassiopeia,400,193,207,48.25
Vayne,Jax,1390,731,659,52.59
Vayne,Gangplank,686,310,376,45.19
Vayne,Neeko,672,353,319,52.53
Vayne,Hecarim,690,372,318,53.91
Vayne,Taliyah,348,157,191,45.11
Vayne,Senna,1062,509,553,47.93
Vayne,Talon,829,490,339,59.11
Vayne,Kassadin,372,186,186,50
Vayne,Renata,235,123,112,52.34
Vayne,Quinn,595,300,295,50.42
Vayne,Xayah,722,349,373,48.34
Vayne,Malphite,1978,942,1036,47.62
Vayne,Jayce,593,313,280,52.78
Vayne,Rumble,357,164,193,45.94
Vayne,Kalista,404,241,163,59.65
Vayne,XinZhao,1004,530,474,52.79
Vayne,Orianna,714,399,315,55.88
Vayne,Lillia,861,463,398,53.77
Vayne,Milio,906,435,471,48.01
Vayne,Syndra,1053,525,528,49.86
Vayne,Rammus,565,280,285,49.56
Vayne,Riven,772,353,419,45.73
Vayne,Elise,1025,500,525,48.78
Vayne,Graves,895,465,430,51.96
Vayne,Shyvana,431,239,192,55.45
Vayne,Azir,455,226,229,49.67
Vayne,Smolder,947,541,406,57.13
Vayne,Sion,1289,685,604,53.14
Vayne,Janna,569,283,286,49.74
Vayne,Brand,1149,594,555,51.7
Vayne,Belveth,340,172,168,50.59
Vayne,Annie,464,232,232,50
Vayne,Aphelios,778,368,410,47.3
Vayne,Heimerdinger,711,309,402,43.46
Vayne,Sivir,714,397,317,55.6
Vayne,AurelionSol,600,311,289,51.83
Vayne,Karthus,458,242,216,52.84
Vayne,Xerath,1307,666,641,50.96
Vayne,Draven,878,444,434,50.57
Vayne,Trundle,853,432,421,50.64
Vayne,Anivia,414,192,222,46.38
Vayne,Kled,308,161,147,52.27
Vayne,Seraphine,993,493,500,49.65
Vayne,Ivern,207,79,128,38.16
Vayne,Urgot,769,389,380,50.59
Vayne,KSante,791,486,305,61.44
Vayne,Illaoi,713,356,357,49.93
Vayne,Zoe,553,294,259,53.16
Vayne,Skarner,451,238,213,52.77
Vayne,Lissandra,590,274,316,46.44
Vayne,Zeri,627,348,279,55.5
Vayne,DrMundo,951,449,502,47.21
Vayne,Velkoz,981,482,499,49.13
Vayne,RekSai,145,91,54,62.76
Vayne,Olaf,326,152,174,46.63
Morgana,Nasus,1064,533,531,50.09
Morgana,Nocturne,1799,815,984,45.3
Morgana,Vladimir,801,405,396,50.56
Morgana,Jhin,2903,1433,1470,49.36
Morgana,Seraphine,1322,628,694,47.5
Morgana,Irelia,1095,573,522,52.33
Morgana,MasterYi,1852,883,969,47.68
Morgana,Azir,423,200,223,47.28
Morgana,Lucian,893,426,467,47.7
Morgana,Mel,2871,1517,1354,52.84
Morgana,Chogath,1677,838,839,49.97
Morgana,Kindred,662,309,353,46.68
Morgana,Katarina,1075,537,538,49.95
Morgana,Tristana,1466,715,751,48.77
Morgana,Neeko,716,301,415,42.04
Morgana,Kayle,1129,555,574,49.16
Morgana,Darius,2574,1331,1243,51.71
Morgana,Malphite,1605,838,767,52.21
Morgana,Ezreal,3192,1674,1518,52.44
Morgana,Nami,1225,586,639,47.84
Morgana,Yorick,1574,735,839,46.7
Morgana,Briar,1115,546,569,48.97
Morgana,Malzahar,1509,755,754,50.03
Morgana,Nautilus,1570,829,741,52.8
Morgana,Viktor,1139,571,568,50.13
Morgana,Veigar,1716,886,830,51.63
Morgana,Brand,1325,681,644,51.4
Morgana,Riven,578,327,251,56.57
Morgana,Ziggs,648,343,305,52.93
Morgana,LeeSin,1892,1016,876,53.7
Morgana,Lux,4945,2493,2452,50.41
Morgana,Yasuo,2893,1466,1427,50.67
Morgana,Zed,1615,887,728,54.92
Morgana,Xerath,1448,741,707,51.17
Morgana,Vi,1450,735,715,50.69
Morgana,Ahri,1859,926,933,49.81
Morgana,Varus,1261,646,615,51.23
Morgana,Soraka,724,348,376,48.07
Morgana,Aatrox,1113,538,575,48.34
Morgana,Graves,817,407,410,49.82
Morgana,Ekko,1338,717,621,53.59
Morgana,Bard,320,164,156,51.25
Morgana,Pantheon,2241,1070,1171,47.75
Morgana,Velkoz,931,425,506,45.65
Morgana,Kayn,2105,1078,1027,51.21
Morgana,Rengar,414,228,186,55.07
Morgana,Fizz,926,459,467,49.57
Morgana,KogMaw,434,202,232,46.54
Morgana,Diana,2332,1103,1229,47.3
Morgana,Sett,2293,1117,1176,48.71
Morgana,XinZhao,958,492,466,51.36
Morgana,Vayne,1782,862,920,48.37
Morgana,Karma,1684,763,921,45.31
Morgana,Hecarim,520,295,225,56.73
Morgana,Rumble,346,205,141,59.25
Morgana,FiddleSticks,726,330,396,45.45
Morgana,TahmKench,1165,643,522,55.19
Morgana,Aphelios,720,339,381,47.08
Morgana,Urgot,708,362,346,51.13
Morgana,Amumu,1645,778,867,47.29
Morgana,Evelynn,507,243,264,47.93
Morgana,Kaisa,2080,1060,1020,50.96
Morgana,Zilean,473,231,242,48.84
Morgana,Quinn,545,228,317,41.83
Morgana,Khazix,640,309,331,48.28
Morgana,Maokai,668,375,293,56.14
Morgana,Jinx,4143,2042,2101,49.29
Morgana,Leona,1334,695,639,52.1
Morgana,Caitlyn,4129,2181,1948,52.82
Morgana,Zeri,528,282,246,53.41
Morgana,Galio,1195,567,628,47.45
Morgana,Udyr,569,278,291,48.86
Morgana,Vex,842,431,411,51.19
Morgana,Elise,879,431,448,49.03
Morgana,Ashe,2989,1610,1379,53.86
Morgana,Garen,2280,1117,1163,48.99
Morgana,Leblanc,802,399,403,49.75
Morgana,Twitch,1119,529,590,47.27
Morgana,Poppy,725,347,378,47.86
Morgana,Smolder,836,462,374,55.26
Morgana,Mordekaiser,1887,898,989,47.59
Morgana,Draven,654,337,317,51.53
Morgana,Sona,523,256,267,48.95
Morgana,Viego,1777,867,910,48.79
Morgana,Yuumi,1049,539,510,51.38
Morgana,Shen,888,509,379,57.32
Morgana,Heimerdinger,726,331,395,45.59
Morgana,Xayah,621,304,317,48.95
Morgana,Akali,1636,870,766,53.18
Morgana,Sejuani,628,323,305,51.43
Morgana,Yone,2507,1303,1204,51.97
Morgana,Zac,606,283,323,46.7
Morgana,Warwick,2286,1135,1151,49.65
Morgana,Sivir,856,424,432,49.53
Morgana,Ryze,421,180,241,42.76
Morgana,Zoe,522,251,271,48.08
Morgana,AurelionSol,563,315,248,55.95
Morgana,Volibear,1727,922,805,53.39
Morgana,Sylas,1737,919,818,52.91
Morgana,Nunu,835,424,411,50.78
Morgana,Shaco,1445,767,678,53.08
Morgana,Thresh,1969,1045,924,53.07
Morgana,Fiora,445,232,213,52.13
Morgana,Talon,766,387,379,50.52
Morgana,Jax,1387,684,703,49.32
Morgana,Karthus,369,170,199,46.07
Morgana,MissFortune,3626,1815,1811,50.06
Morgana,Senna,1216,600,616,49.34
Morgana,Trundle,886,441,445,49.77
Morgana,Samira,1015,559,456,55.07
Morgana,Rammus,480,238,242,49.58
Morgana,Kassadin,338,174,164,51.48
Morgana,Milio,824,398,426,48.3
Morgana,Annie,580,299,281,51.55
Morgana,Corki,487,251,236,51.54
Morgana,Singed,394,196,198,49.75
Morgana,Aurora,880,438,442,49.77
Morgana,Lulu,1650,842,808,51.03
Morgana,JarvanIV,694,327,367,47.12
Morgana,Gnar,494,252,242,51.01
Morgana,Pyke,1095,539,556,49.22
Morgana,Lillia,854,452,402,52.93
Morgana,Anivia,492,253,239,51.42
Morgana,Gragas,629,353,276,56.12
Morgana,Teemo,2037,1005,1032,49.34
Morgana,Tryndamere,885,456,429,51.53
Morgana,Swain,1459,759,700,52.02
Morgana,Skarner,319,190,129,59.56
Morgana,Olaf,388,181,207,46.65
Morgana,Lissandra,458,211,247,46.07
Morgana,Camille,381,220,161,57.74
Morgana,Gwen,668,376,292,56.29
Morgana,Orianna,625,296,329,47.36
Morgana,DrMundo,957,477,480,49.84
Morgana,MonkeyKing,893,455,438,50.95
Morgana,RekSai,147,86,61,58.5
Morgana,Zyra,1529,748,781,48.92
Morgana,Alistar,382,212,170,55.5
Morgana,Hwei,890,438,452,49.21
Morgana,Braum,676,352,324,52.07
Morgana,Rakan,558,305,253,54.66
Morgana,Taliyah,275,147,128,53.45
Morgana,Sion,1017,530,487,52.11
Morgana,Renata,184,108,76,58.7
Morgana,Naafiri,493,226,267,45.84
Morgana,Blitzcrank,1082,557,525,51.48
Morgana,Syndra,823,379,444,46.05
Morgana,Kalista,324,163,161,50.31
Morgana,Gangplank,664,295,369,44.43
Morgana,Illaoi,805,408,397,50.68
Morgana,Ivern,151,59,92,39.07
Morgana,KSante,587,321,266,54.68
Morgana,Janna,369,182,187,49.32
Morgana,Kled,228,111,117,48.68
Morgana,Rell,655,353,302,53.89
Morgana,Ornn,550,293,257,53.27
Morgana,Renekton,684,366,318,53.51
Morgana,Kennen,298,147,151,49.33
Morgana,Belveth,276,127,149,46.01
Morgana,Jayce,556,285,271,51.26
Morgana,Qiyana,279,143,136,51.25
Morgana,TwistedFate,436,234,202,53.67
Morgana,Ambessa,726,368,358,50.69
Morgana,Taric,246,114,132,46.34
Morgana,Akshan,485,227,258,46.8
Morgana,Cassiopeia,424,196,228,46.23
Morgana,Nilah,490,241,249,49.18
Morgana,Shyvana,346,204,142,58.96
Morgana,Nidalee,320,155,165,48.44
Nasus,Yorick,916,421,495,45.96
Nasus,MasterYi,1170,619,551,52.91
Nasus,Ahri,1110,573,537,51.62
Nasus,Ezreal,1789,951,838,53.16
Nasus,Morgana,1064,531,533,49.91
Nasus,Riven,319,160,159,50.16
Nasus,Nocturne,1048,547,501,52.19
Nasus,Veigar,963,499,464,51.82
Nasus,Nilah,276,136,140,49.28
Nasus,Lissandra,282,146,136,51.77
Nasus,Garen,1602,746,856,46.57
Nasus,Amumu,914,466,448,50.98
Nasus,Jinx,2492,1302,1190,52.25
Nasus,Galio,640,350,290,54.69
Nasus,Irelia,651,343,308,52.69
Nasus,Zed,840,448,392,53.33
Nasus,Xayah,360,178,182,49.44
Nasus,Velkoz,452,207,245,45.8
Nasus,Gangplank,285,136,149,47.72
Nasus,Kindred,355,201,154,56.62
Nasus,Aurora,522,261,261,50
Nasus,Sivir,453,232,221,51.21
Nasus,Yuumi,635,336,299,52.91
Nasus,Kennen,270,150,120,55.56
Nasus,Volibear,1105,562,543,50.86
Nasus,Lux,2157,1117,1040,51.78
Nasus,Ashe,1668,885,783,53.06
Nasus,Leona,749,377,372,50.33
Nasus,Renekton,439,241,198,54.9
Nasus,Gragas,379,199,180,52.51
Nasus,Ziggs,298,148,150,49.66
Nasus,Caitlyn,2406,1171,1235,48.67
Nasus,Milio,420,208,212,49.52
Nasus,Warwick,1296,649,647,50.08
Nasus,Hwei,518,283,235,54.63
Nasus,Seraphine,674,353,321,52.37
Nasus,Swain,926,456,470,49.24
Nasus,Kayn,1202,612,590,50.92
Nasus,Heimerdinger,499,257,242,51.5
Nasus,Lillia,475,228,247,48
Nasus,Naafiri,307,164,143,53.42
Nasus,Karma,943,471,472,49.95
Nasus,Fiora,282,146,136,51.77
Nasus,Sett,1150,592,558,51.48
Nasus,Shen,479,245,234,51.15
Nasus,Udyr,304,175,129,57.57
Nasus,Pantheon,1258,595,663,47.3
Nasus,Graves,456,254,202,55.7
Nasus,Yasuo,1844,942,902,51.08
Nasus,Soraka,490,263,227,53.67
Nasus,Teemo,1227,662,565,53.95
Nasus,Shaco,802,450,352,56.11
Nasus,Vladimir,598,314,284,52.51
Nasus,Brand,759,344,415,45.32
Nasus,Kayle,715,407,308,56.92
Nasus,Viego,1228,665,563,54.15
Nasus,Varus,702,350,352,49.86
Nasus,Lulu,1032,522,510,50.58
Nasus,Fizz,537,308,229,57.36
Nasus,Darius,1545,757,788,49
Nasus,MonkeyKing,597,306,291,51.26
Nasus,Sylas,1049,544,505,51.86
Nasus,Rakan,272,134,138,49.26
Nasus,Aatrox,686,354,332,51.6
Nasus,Evelynn,307,132,175,43
Nasus,Jhin,1684,850,834,50.48
Nasus,Poppy,480,248,232,51.67
Nasus,Illaoi,500,253,247,50.6
Nasus,LeeSin,1109,620,489,55.91
Nasus,Tristana,783,372,411,47.51
Nasus,Janna,288,133,155,46.18
Nasus,Yone,1597,793,804,49.66
Nasus,Nidalee,205,121,84,59.02
Nasus,MissFortune,2180,1137,1043,52.16
Nasus,Pyke,658,356,302,54.1
Nasus,Vayne,1199,573,626,47.79
Nasus,Viktor,654,332,322,50.76
Nasus,Zac,364,160,204,43.96
Nasus,Trundle,640,351,289,54.84
Nasus,Mel,1821,1012,809,55.57
Nasus,Anivia,286,122,164,42.66
Nasus,Nautilus,880,480,400,54.55
Nasus,Singed,293,156,137,53.24
Nasus,TahmKench,658,335,323,50.91
Nasus,Urgot,535,257,278,48.04
Nasus,Chogath,1011,473,538,46.79
Nasus,Malphite,959,504,455,52.55
Nasus,Zyra,687,317,370,46.14
Nasus,Thresh,963,470,493,48.81
Nasus,Vi,808,361,447,44.68
Nasus,Neeko,368,228,140,61.96
Nasus,Ryze,298,129,169,43.29
Nasus,Kaisa,1247,717,530,57.5
Nasus,Mordekaiser,1188,595,593,50.08
Nasus,Twitch,600,319,281,53.17
Nasus,Tryndamere,538,319,219,59.29
Nasus,Khazix,390,194,196,49.74
Nasus,Malzahar,872,458,414,52.52
Nasus,Ekko,691,346,345,50.07
Nasus,Sion,667,332,335,49.78
Nasus,Akali,815,420,395,51.53
Nasus,Quinn,294,147,147,50
Nasus,KogMaw,282,150,132,53.19
Nasus,Blitzcrank,563,263,300,46.71
Nasus,Talon,368,183,185,49.73
Nasus,Lucian,512,264,248,51.56
Nasus,Karthus,175,94,81,53.71
Nasus,TwistedFate,273,143,130,52.38
Nasus,Ornn,307,175,132,57
Nasus,Sejuani,340,163,177,47.94
Nasus,Jax,673,351,322,52.15
Nasus,Katarina,606,327,279,53.96
Nasus,Samira,622,337,285,54.18
Nasus,Draven,385,220,165,57.14
Nasus,Diana,1402,684,718,48.79
Nasus,Braum,434,239,195,55.07
Nasus,Zeri,330,175,155,53.03
Nasus,Rell,361,197,164,54.57
Nasus,Camille,291,153,138,52.58
Nasus,Rengar,255,149,106,58.43
Nasus,Ivern,116,54,62,46.55
Nasus,Senna,540,273,267,50.56
Nasus,Alistar,328,198,130,60.37
Nasus,Leblanc,406,229,177,56.4
Nasus,Gwen,430,234,196,54.42
Nasus,Smolder,555,318,237,57.3
Nasus,Zoe,210,114,96,54.29
Nasus,Skarner,160,88,72,55
Nasus,Taliyah,140,65,75,46.43
Nasus,Sona,287,118,169,41.11
Nasus,Briar,678,346,332,51.03
Nasus,Ambessa,382,200,182,52.36
Nasus,Kled,156,71,85,45.51
Nasus,Syndra,480,247,233,51.46
Nasus,Zilean,295,154,141,52.2
Nasus,Rammus,230,103,127,44.78
Nasus,Qiyana,194,88,106,45.36
Nasus,Nami,662,304,358,45.92
Nasus,Kalista,186,86,100,46.24
Nasus,Taric,149,77,72,51.68
Nasus,FiddleSticks,401,194,207,48.38
Nasus,Vex,447,236,211,52.8
Nasus,Aphelios,427,217,210,50.82
Nasus,Hecarim,409,209,200,51.1
Nasus,DrMundo,491,269,222,54.79
Nasus,KSante,364,217,147,59.62
Nasus,Belveth,215,113,102,52.56
Nasus,Kassadin,184,111,73,60.33
Nasus,Xerath,688,374,314,54.36
Nasus,AurelionSol,371,180,191,48.52
Nasus,Rumble,197,94,103,47.72
Nasus,Orianna,327,128,199,39.14
Nasus,Nunu,431,218,213,50.58
Nasus,XinZhao,451,250,201,55.43
Nasus,Renata,161,76,85,47.2
Nasus,Gnar,258,139,119,53.88
Nasus,Maokai,394,212,182,53.81
Nasus,Corki,292,143,149,48.97
Nasus,Elise,443,222,221,50.11
Nasus,Annie,236,116,120,49.15
Nasus,Cassiopeia,228,105,123,46.05
Nasus,Olaf,160,74,86,46.25
Nasus,Bard,244,124,120,50.82
Nasus,Azir,238,119,119,50
Nasus,JarvanIV,445,232,213,52.13
Nasus,Shyvana,190,81,109,42.63
Nasus,Akshan,272,148,124,54.41
Nasus,Jayce,295,176,119,59.66
Nasus,RekSai,80,43,37,53.75
Jhin,Yorick,2505,1159,1346,46.27
Jhin,MasterYi,3103,1473,1630,47.47
Jhin,Ahri,3162,1596,1566,50.47
Jhin,Ezreal,7081,3654,3427,51.6
Jhin,Morgana,2903,1470,1433,50.64
Jhin,Darius,4650,2373,2277,51.03
Jhin,Amumu,2617,1338,1279,51.13
Jhin,Aurora,1628,794,834,48.77
Jhin,Lux,6449,3265,3184,50.63
Jhin,Seraphine,1880,964,916,51.28
Jhin,Renekton,1316,665,651,50.53
Jhin,Diana,3808,1856,1952,48.74
Jhin,Azir,807,424,383,52.54
Jhin,MissFortune,6411,3135,3276,48.9
Jhin,Yuumi,1991,993,998,49.87
Jhin,Pantheon,3802,1840,1962,48.4
Jhin,Gwen,1108,514,594,46.39
Jhin,Fizz,1469,693,776,47.17
Jhin,Jinx,7805,3684,4121,47.2
Jhin,Ivern,337,182,155,54.01
Jhin,Aatrox,2100,1011,1089,48.14
Jhin,Khazix,1165,607,558,52.1
Jhin,Neeko,1038,542,496,52.22
Jhin,Garen,3966,1848,2118,46.6
Jhin,Nocturne,3242,1468,1774,45.28
Jhin,Thresh,3245,1567,1678,48.29
Jhin,Vladimir,1762,881,881,50
Jhin,Caitlyn,8840,4556,4284,51.54
Jhin,Lulu,3457,1696,1761,49.06
Jhin,Urgot,1282,624,658,48.67
Jhin,Galio,2123,1067,1056,50.26
Jhin,Varus,2367,1189,1178,50.23
Jhin,Viktor,2257,1156,1101,51.22
Jhin,Veigar,2343,1182,1161,50.45
Jhin,Brand,1816,939,877,51.71
Jhin,Yone,4583,2376,2207,51.84
Jhin,Warwick,3707,1885,1822,50.85
Jhin,Hwei,1683,898,785,53.36
Jhin,Malphite,2391,1169,1222,48.89
Jhin,Chogath,2812,1424,1388,50.64
Jhin,Tristana,2632,1252,1380,47.57
Jhin,Vayne,3304,1503,1801,45.49
Jhin,Corki,941,489,452,51.97
Jhin,Mordekaiser,3107,1456,1651,46.86
Jhin,Vi,2124,1075,1049,50.61
Jhin,Vex,1295,643,652,49.65
Jhin,Gangplank,1207,594,613,49.21
Jhin,Anivia,781,354,427,45.33
Jhin,Zyra,2624,1298,1326,49.47
Jhin,Yasuo,4962,2457,2505,49.52
Jhin,Talon,1421,704,717,49.54
Jhin,Soraka,1428,644,784,45.1
Jhin,Sion,1704,778,926,45.66
Jhin,Shaco,2342,1169,1173,49.91
Jhin,Malzahar,2634,1316,1318,49.96
Jhin,Milio,1455,714,741,49.07
Jhin,Ambessa,1456,777,679,53.37
Jhin,Taliyah,538,266,272,49.44
Jhin,Elise,1654,859,795,51.93
Jhin,Zed,2893,1427,1466,49.33
Jhin,Sivir,1241,649,592,52.3
Jhin,Teemo,2989,1522,1467,50.92
Jhin,Volibear,2743,1386,1357,50.53
Jhin,Ashe,5541,2787,2754,50.3
Jhin,Xerath,2396,1223,1173,51.04
Jhin,XinZhao,1560,750,810,48.08
Jhin,Briar,1852,865,987,46.71
Jhin,AurelionSol,947,454,493,47.94
Jhin,LeeSin,3913,2044,1869,52.24
Jhin,Kassadin,501,252,249,50.3
Jhin,Heimerdinger,1162,545,617,46.9
Jhin,Renata,422,201,221,47.63
Jhin,Sett,3625,1705,1920,47.03
Jhin,Ziggs,867,429,438,49.48
Jhin,Kaisa,4128,2001,2127,48.47
Jhin,Kayn,3685,1725,1960,46.81
Jhin,Janna,777,388,389,49.94
Jhin,Gragas,1273,676,597,53.1
Jhin,Senna,1769,927,842,52.4
Jhin,Karthus,802,376,426,46.88
Jhin,Ekko,2367,1158,1209,48.92
Jhin,KogMaw,701,348,353,49.64
Jhin,Jax,2229,1220,1009,54.73
Jhin,Rammus,741,387,354,52.23
Jhin,Swain,2323,1095,1228,47.14
Jhin,Kayle,1744,865,879,49.6
Jhin,Lucian,1816,924,892,50.88
Jhin,Nami,2597,1191,1406,45.86
Jhin,Nidalee,672,372,300,55.36
Jhin,Akali,2721,1348,1373,49.54
Jhin,Skarner,572,325,247,56.82
Jhin,Riven,1095,522,573,47.67
Jhin,Graves,1654,793,861,47.94
Jhin,Aphelios,1311,674,637,51.41
Jhin,TahmKench,1743,874,869,50.14
Jhin,Nunu,1309,618,691,47.21
Jhin,Hecarim,1028,586,442,57
Jhin,Katarina,1953,968,985,49.56
Jhin,Syndra,1505,752,753,49.97
Jhin,Cassiopeia,692,357,335,51.59
Jhin,Samira,1606,818,788,50.93
Jhin,Blitzcrank,1719,810,909,47.12
Jhin,Illaoi,1098,504,594,45.9
Jhin,Mel,5132,2708,2424,52.77
Jhin,FiddleSticks,1236,637,599,51.54
Jhin,Irelia,2154,1101,1053,51.11
Jhin,Camille,827,409,418,49.46
Jhin,Rengar,850,478,372,56.24
Jhin,Zilean,818,395,423,48.29
Jhin,Viego,3729,1875,1854,50.28
Jhin,Xayah,1055,517,538,49
Jhin,KSante,1201,643,558,53.54
Jhin,Karma,3136,1488,1648,47.45
Jhin,Shen,1492,765,727,51.27
Jhin,Sejuani,1006,542,464,53.88
Jhin,Nautilus,2601,1326,1275,50.98
Jhin,Annie,789,397,392,50.32
Jhin,Leona,2010,1026,984,51.04
Jhin,Naafiri,875,408,467,46.63
Jhin,Quinn,954,440,514,46.12
Jhin,Poppy,1340,659,681,49.18
Jhin,Kennen,673,354,319,52.6
Jhin,Smolder,1637,846,791,51.68
Jhin,Lillia,1338,633,705,47.31
Jhin,Draven,1284,655,629,51.01
Jhin,Sylas,3275,1663,1612,50.78
Jhin,Qiyana,665,345,320,51.88
Jhin,Ornn,963,445,518,46.21
Jhin,Velkoz,1484,762,722,51.35
Jhin,Pyke,1888,967,921,51.22
Jhin,Belveth,575,305,270,53.04
Jhin,Jayce,1252,628,624,50.16
Jhin,Udyr,923,507,416,54.93
Jhin,Sona,830,414,416,49.88
Jhin,DrMundo,1454,740,714,50.89
Jhin,Rell,1077,539,538,50.05
Jhin,Nasus,1684,831,853,49.35
Jhin,Braum,1337,598,739,44.73
Jhin,Twitch,1944,1009,935,51.9
Jhin,Olaf,564,291,273,51.6
Jhin,Trundle,1434,710,724,49.51
Jhin,Gnar,1058,519,539,49.05
Jhin,MonkeyKing,1734,817,917,47.12
Jhin,Rakan,993,468,525,47.13
Jhin,Maokai,1009,440,569,43.61
Jhin,Kalista,617,315,302,51.05
Jhin,Singed,624,304,320,48.72
Jhin,Shyvana,608,308,300,50.66
Jhin,Tryndamere,1380,667,713,48.33
Jhin,Bard,765,370,395,48.37
Jhin,Zoe,907,423,484,46.64
Jhin,Zac,1148,540,608,47.04
Jhin,Leblanc,1534,769,765,50.13
Jhin,JarvanIV,1418,617,801,43.51
Jhin,Akshan,848,444,404,52.36
Jhin,Alistar,940,446,494,47.45
Jhin,RekSai,254,104,150,40.94
Jhin,Rumble,721,360,361,49.93
Jhin,Kindred,1040,567,473,54.52
Jhin,Evelynn,784,388,396,49.49
Jhin,Zeri,921,462,459,50.16
Jhin,Orianna,947,508,439,53.64
Jhin,Nilah,694,340,354,48.99
Jhin,Fiora,912,444,468,48.68
Jhin,Ryze,827,436,391,52.72
Jhin,Taric,482,226,256,46.89
Jhin,Lissandra,824,412,412,50
Jhin,Kled,443,215,228,48.53
Jhin,TwistedFate,980,564,416,57.55
Seraphine,Yorick,954,431,523,45.18
Seraphine,MasterYi,1040,507,533,48.75
Seraphine,Ahri,1214,620,594,51.07
Seraphine,Ezreal,1846,899,947,48.7
Seraphine,Morgana,1322,694,628,52.5
Seraphine,Trundle,537,274,263,51.02
Seraphine,Briar,737,348,389,47.22
Seraphine,Katarina,667,346,321,51.87
Seraphine,Jhin,1880,916,964,48.72
Seraphine,Pyke,615,271,344,44.07
Seraphine,Aatrox,727,382,345,52.54
Seraphine,Kayn,1286,630,656,48.99
Seraphine,Blitzcrank,614,288,326,46.91
Seraphine,Kennen,204,104,100,50.98
Seraphine,Darius,1652,873,779,52.85
Seraphine,Lux,2935,1429,1506,48.69
Seraphine,Caitlyn,2645,1348,1297,50.96
Seraphine,Zyra,955,447,508,46.81
Seraphine,Jax,812,453,359,55.79
Seraphine,Skarner,190,114,76,60
Seraphine,Irelia,695,353,342,50.79
Seraphine,MissFortune,2282,1070,1212,46.89
Seraphine,Alistar,275,140,135,50.91
Seraphine,Teemo,1275,634,641,49.73
Seraphine,Volibear,1163,553,610,47.55
Seraphine,Vladimir,557,261,296,46.86
Seraphine,Ashe,1647,843,804,51.18
Seraphine,Xerath,737,351,386,47.63
Seraphine,Heimerdinger,482,224,258,46.47
Seraphine,Azir,259,141,118,54.44
Seraphine,Varus,792,383,409,48.36
Seraphine,Renata,146,74,72,50.68
Seraphine,Leona,719,393,326,54.66
Seraphine,TahmKench,641,374,267,58.35
Seraphine,Syndra,468,238,230,50.85
Seraphine,Samira,639,300,339,46.95
Seraphine,Pantheon,1440,682,758,47.36
Seraphine,Nasus,674,321,353,47.63
Seraphine,Amumu,1033,532,501,51.5
Seraphine,Ryze,261,119,142,45.59
Seraphine,Neeko,507,270,237,53.25
Seraphine,Elise,540,255,285,47.22
Seraphine,Veigar,975,503,472,51.59
Seraphine,Smolder,466,257,209,55.15
Seraphine,Soraka,473,256,217,54.12
Seraphine,Naafiri,350,189,161,54
Seraphine,Jinx,2578,1303,1275,50.54
Seraphine,Nautilus,930,494,436,53.12
Seraphine,Diana,1394,662,732,47.49
Seraphine,Karma,1134,560,574,49.38
Seraphine,Aurora,564,283,281,50.18
Seraphine,Shaco,882,456,426,51.7
Seraphine,Lulu,1206,666,540,55.22
Seraphine,Ekko,811,410,401,50.55
Seraphine,Thresh,1050,523,527,49.81
Seraphine,Sion,611,257,354,42.06
Seraphine,Gangplank,362,157,205,43.37
Seraphine,Aphelios,432,221,211,51.16
Seraphine,Warwick,1500,720,780,48
Seraphine,Ambessa,415,208,207,50.12
Seraphine,Ivern,119,68,51,57.14
Seraphine,TwistedFate,322,174,148,54.04
Seraphine,Senna,767,369,398,48.11
Seraphine,Yasuo,1607,716,891,44.56
Seraphine,Rammus,250,151,99,60.4
Seraphine,Velkoz,606,295,311,48.68
Seraphine,Gwen,437,213,224,48.74
Seraphine,Yone,1547,754,793,48.74
Seraphine,Xayah,345,203,142,58.84
Seraphine,Milio,494,230,264,46.56
Seraphine,KSante,374,199,175,53.21
Seraphine,Rengar,262,130,132,49.62
Seraphine,Malzahar,1060,527,533,49.72
Seraphine,Sivir,499,269,230,53.91
Seraphine,Malphite,985,480,505,48.73
Seraphine,Viktor,710,355,355,50
Seraphine,Sett,1415,678,737,47.92
Seraphine,FiddleSticks,483,212,271,43.89
Seraphine,Mel,1640,853,787,52.01
Seraphine,Sona,373,148,225,39.68
Seraphine,Khazix,488,228,260,46.72
Seraphine,Ziggs,343,187,156,54.52
Seraphine,Camille,317,157,160,49.53
Seraphine,Swain,842,409,433,48.57
Seraphine,DrMundo,520,280,240,53.85
Seraphine,XinZhao,596,272,324,45.64
Seraphine,Sylas,1222,632,590,51.72
Seraphine,Twitch,764,388,376,50.79
Seraphine,Mordekaiser,1201,543,658,45.21
Seraphine,Nocturne,1109,527,582,47.52
Seraphine,Braum,385,175,210,45.45
Seraphine,Lillia,480,235,245,48.96
Seraphine,Zed,879,473,406,53.81
Seraphine,Nami,860,401,459,46.63
Seraphine,Nunu,518,249,269,48.07
Seraphine,Taric,138,89,49,64.49
Seraphine,Urgot,570,285,285,50
Seraphine,KogMaw,261,145,116,55.56
Seraphine,Vi,777,388,389,49.94
Seraphine,Draven,461,220,241,47.72
Seraphine,Tristana,908,420,488,46.26
Seraphine,Yuumi,628,313,315,49.84
Seraphine,Kayle,696,352,344,50.57
Seraphine,JarvanIV,477,235,242,49.27
Seraphine,Vex,488,267,221,54.71
Seraphine,Tryndamere,475,232,243,48.84
Seraphine,Riven,349,178,171,51
Seraphine,AurelionSol,325,179,146,55.08
Seraphine,LeeSin,998,507,491,50.8
Seraphine,Brand,769,339,430,44.08
Seraphine,Gragas,364,164,200,45.05
Seraphine,Gnar,320,169,151,52.81
Seraphine,Anivia,271,124,147,45.76
Seraphine,Garen,1388,689,699,49.64
Seraphine,Illaoi,420,188,232,44.76
Seraphine,Kled,137,56,81,40.88
Seraphine,Fizz,587,308,279,52.47
Seraphine,Singed,251,104,147,41.43
Seraphine,Akali,1018,529,489,51.96
Seraphine,Nidalee,204,120,84,58.82
Seraphine,Zoe,304,149,155,49.01
Seraphine,Ornn,369,194,175,52.57
Seraphine,Orianna,365,174,191,47.67
Seraphine,Zilean,221,120,101,54.3
Seraphine,Shen,479,239,240,49.9
Seraphine,Talon,446,185,261,41.48
Seraphine,Chogath,1017,552,465,54.28
Seraphine,Qiyana,185,88,97,47.57
Seraphine,Poppy,483,254,229,52.59
Seraphine,Galio,693,334,359,48.2
Seraphine,Vayne,993,500,493,50.35
Seraphine,MonkeyKing,532,264,268,49.62
Seraphine,Viego,1312,657,655,50.08
Seraphine,Jayce,360,190,170,52.78
Seraphine,Kaisa,1352,726,626,53.7
Seraphine,Evelynn,302,169,133,55.96
Seraphine,Akshan,313,167,146,53.35
Seraphine,Leblanc,485,216,269,44.54
Seraphine,Rakan,302,161,141,53.31
Seraphine,Kalista,203,88,115,43.35
Seraphine,Hwei,562,274,288,48.75
Seraphine,Nilah,318,178,140,55.97
Seraphine,Bard,233,114,119,48.93
Seraphine,Belveth,209,108,101,51.67
Seraphine,Karthus,231,114,117,49.35
Seraphine,Taliyah,195,82,113,42.05
Seraphine,Lissandra,253,125,128,49.41
Seraphine,Kindred,375,201,174,53.6
Seraphine,Renekton,398,184,214,46.23
Seraphine,Zeri,336,164,172,48.81
Seraphine,Janna,281,138,143,49.11
Seraphine,Hecarim,335,188,147,56.12
Seraphine,Sejuani,351,176,175,50.14
Seraphine,Udyr,346,168,178,48.55
Seraphine,Annie,259,144,115,55.6
Seraphine,Graves,429,197,232,45.92
Seraphine,Lucian,506,230,276,45.45
Seraphine,Rumble,167,89,78,53.29
Seraphine,Kassadin,176,75,101,42.61
Seraphine,Quinn,385,198,187,51.43
Seraphine,Rell,372,176,196,47.31
Seraphine,Corki,290,166,124,57.24
Seraphine,Fiora,303,150,153,49.5
Seraphine,Maokai,394,168,226,42.64
Seraphine,Cassiopeia,221,110,111,49.77
Seraphine,Zac,390,195,195,50
Seraphine,Olaf,178,91,87,51.12
Seraphine,RekSai,87,40,47,45.98
Seraphine,Shyvana,203,105,98,51.72
Illaoi,Rakan,212,115,97,54.25
Illaoi,Ekko,543,277,266,51.01
Illaoi,Veigar,616,284,332,46.1
Illaoi,Ashe,1207,609,598,50.46
Illaoi,Soraka,291,135,156,46.39
Illaoi,Teemo,631,264,367,41.84
Illaoi,Briar,417,194,223,46.52
Illaoi,Yasuo,1184,609,575,51.44
Illaoi,MissFortune,1602,752,850,46.94
Illaoi,Blitzcrank,424,217,207,51.18
Illaoi,Volibear,828,392,436,47.34
Illaoi,Vladimir,313,148,165,47.28
Illaoi,Xerath,515,253,262,49.13
Illaoi,TahmKench,485,248,237,51.13
Illaoi,Rengar,150,86,64,57.33
Illaoi,Akali,619,290,329,46.85
Illaoi,Jhin,1098,594,504,54.1
Illaoi,Brand,463,212,251,45.79
Illaoi,Yone,1048,541,507,51.62
Illaoi,Nunu,307,160,147,52.12
Illaoi,Irelia,498,247,251,49.6
Illaoi,Mel,1093,568,525,51.97
Illaoi,Lux,1503,719,784,47.84
Illaoi,Jayce,228,111,117,48.68
Illaoi,Diana,951,452,499,47.53
Illaoi,Anivia,165,54,111,32.73
Illaoi,Ezreal,1162,576,586,49.57
Illaoi,Renekton,323,182,141,56.35
Illaoi,Zilean,137,67,70,48.91
Illaoi,Lucian,384,160,224,41.67
Illaoi,Riven,243,128,115,52.67
Illaoi,Nautilus,656,323,333,49.24
Illaoi,Ahri,746,378,368,50.67
Illaoi,Caitlyn,1520,726,794,47.76
Illaoi,Garen,998,444,554,44.49
Illaoi,Rammus,220,129,91,58.64
Illaoi,Malzahar,590,280,310,47.46
Illaoi,Xayah,240,106,134,44.17
Illaoi,Chogath,766,397,369,51.83
Illaoi,Sylas,776,474,302,61.08
Illaoi,Tristana,622,278,344,44.69
Illaoi,MasterYi,773,354,419,45.8
Illaoi,Vex,245,105,140,42.86
Illaoi,Kayle,410,173,237,42.2
Illaoi,Pantheon,856,408,448,47.66
Illaoi,Samira,440,238,202,54.09
Illaoi,Kayn,838,422,416,50.36
Illaoi,Viktor,406,194,212,47.78
Illaoi,Sejuani,201,92,109,45.77
Illaoi,Kaisa,875,415,460,47.43
Illaoi,JarvanIV,297,141,156,47.47
Illaoi,Nocturne,664,347,317,52.26
Illaoi,Nasus,500,247,253,49.4
Illaoi,Senna,405,175,230,43.21
Illaoi,Mordekaiser,996,441,555,44.28
Illaoi,Jinx,1568,797,771,50.83
Illaoi,Thresh,658,350,308,53.19
Illaoi,Viego,755,370,385,49.01
Illaoi,Aurora,396,176,220,44.44
Illaoi,Sett,996,508,488,51
Illaoi,Leona,493,249,244,50.51
Illaoi,Warwick,900,425,475,47.22
Illaoi,Shen,365,201,164,55.07
Illaoi,Twitch,400,208,192,52
Illaoi,Lulu,622,307,315,49.36
Illaoi,Vi,495,247,248,49.9
Illaoi,Zed,640,280,360,43.75
Illaoi,Kalista,134,69,65,51.49
Illaoi,Milio,303,156,147,51.49
Illaoi,Swain,536,254,282,47.39
Illaoi,Darius,1081,570,511,52.73
Illaoi,Qiyana,120,71,49,59.17
Illaoi,Yuumi,406,197,209,48.52
Illaoi,Zac,255,117,138,45.88
Illaoi,Shaco,551,273,278,49.55
Illaoi,Jax,652,360,292,55.21
Illaoi,Katarina,439,221,218,50.34
Illaoi,Khazix,239,120,119,50.21
Illaoi,Syndra,330,182,148,55.15
Illaoi,Nilah,174,102,72,58.62
Illaoi,Ziggs,185,100,85,54.05
Illaoi,Lissandra,199,104,95,52.26
Illaoi,Lillia,273,134,139,49.08
Illaoi,Pyke,501,249,252,49.7
Illaoi,Gragas,278,134,144,48.2
Illaoi,Seraphine,420,232,188,55.24
Illaoi,Ornn,237,107,130,45.15
Illaoi,Heimerdinger,235,94,141,40
Illaoi,Nami,525,227,298,43.24
Illaoi,Kassadin,93,34,59,36.56
Illaoi,Draven,242,149,93,61.57
Illaoi,Karma,515,224,291,43.5
Illaoi,DrMundo,367,178,189,48.5
Illaoi,Hwei,359,186,173,51.81
Illaoi,Sion,349,175,174,50.14
Illaoi,TwistedFate,199,105,94,52.76
Illaoi,Zyra,519,236,283,45.47
Illaoi,Gangplank,207,118,89,57
Illaoi,Elise,352,147,205,41.76
Illaoi,Ambessa,292,162,130,55.48
Illaoi,Poppy,337,171,166,50.74
Illaoi,Cassiopeia,120,65,55,54.17
Illaoi,Kindred,232,111,121,47.84
Illaoi,Velkoz,318,129,189,40.57
Illaoi,Shyvana,157,98,59,62.42
Illaoi,Zoe,152,78,74,51.32
Illaoi,Orianna,260,124,136,47.69
Illaoi,Leblanc,318,179,139,56.29
Illaoi,Taliyah,123,60,63,48.78
Illaoi,Quinn,162,74,88,45.68
Illaoi,Maokai,296,157,139,53.04
Illaoi,Naafiri,170,66,104,38.82
Illaoi,Graves,292,113,179,38.7
Illaoi,Morgana,805,397,408,49.32
Illaoi,Olaf,159,92,67,57.86
Illaoi,Aphelios,281,109,172,38.79
Illaoi,Yorick,649,254,395,39.14
Illaoi,Urgot,251,137,114,54.58
Illaoi,Tryndamere,344,186,158,54.07
Illaoi,Rell,244,140,104,57.38
Illaoi,Trundle,414,204,210,49.28
Illaoi,Galio,495,236,259,47.68
Illaoi,Braum,260,121,139,46.54
Illaoi,Kled,103,44,59,42.72
Illaoi,Amumu,630,295,335,46.83
Illaoi,Azir,205,118,87,57.56
Illaoi,Sivir,299,146,153,48.83
Illaoi,Smolder,370,180,190,48.65
Illaoi,Hecarim,173,102,71,58.96
Illaoi,Varus,485,262,223,54.02
Illaoi,Vayne,713,357,356,50.07
Illaoi,Skarner,142,84,58,59.15
Illaoi,Gnar,179,109,70,60.89
Illaoi,Sona,156,82,74,52.56
Illaoi,Aatrox,429,211,218,49.18
Illaoi,XinZhao,344,149,195,43.31
Illaoi,Singed,158,67,91,42.41
Illaoi,LeeSin,749,401,348,53.54
Illaoi,Fizz,282,155,127,54.96
Illaoi,KogMaw,181,98,83,54.14
Illaoi,Ivern,41,18,23,43.9
Illaoi,Talon,252,149,103,59.13
Illaoi,Belveth,139,75,64,53.96
Illaoi,Camille,193,106,87,54.92
Illaoi,Udyr,213,107,106,50.23
Illaoi,Karthus,161,97,64,60.25
Illaoi,Corki,212,117,95,55.19
Illaoi,AurelionSol,218,84,134,38.53
Illaoi,KSante,271,156,115,57.56
Illaoi,Annie,148,72,76,48.65
Illaoi,Malphite,582,290,292,49.83
Illaoi,Fiora,169,85,84,50.3
Illaoi,MonkeyKing,389,225,164,57.84
Illaoi,Alistar,238,144,94,60.5
Illaoi,Evelynn,182,89,93,48.9
Illaoi,FiddleSticks,266,153,113,57.52
Illaoi,Nidalee,151,76,75,50.33
Illaoi,Renata,83,31,52,37.35
Illaoi,Akshan,171,61,110,35.67
Illaoi,Janna,168,68,100,40.48
Illaoi,Ryze,180,73,107,40.56
Illaoi,Neeko,258,160,98,62.02
Illaoi,Kennen,97,46,51,47.42
Illaoi,Gwen,272,140,132,51.47
Illaoi,Taric,104,50,54,48.08
Illaoi,Zeri,178,81,97,45.51
Illaoi,RekSai,46,20,26,43.48
Illaoi,Bard,150,75,75,50
Illaoi,Rumble,146,65,81,44.52
Milio,Rakan,244,112,132,45.9
Milio,Ekko,756,402,354,53.17
Milio,Veigar,664,331,333,49.85
Milio,Ashe,1397,767,630,54.9
Milio,Soraka,510,260,250,50.98
Milio,Darius,1339,685,654,51.16
Milio,Khazix,333,163,170,48.95
Milio,Zed,802,454,348,56.61
Milio,Aphelios,422,215,207,50.95
Milio,Pyke,496,254,242,51.21
Milio,Nocturne,797,421,376,52.82
Milio,Lux,1667,882,785,52.91
Milio,Lucian,444,243,201,54.73
Milio,Thresh,951,483,468,50.79
Milio,Tryndamere,458,220,238,48.03
Milio,Amumu,769,394,375,51.24
Milio,Vex,318,184,134,57.86
Milio,Jinx,1949,996,953,51.1
Milio,Mel,1344,820,524,61.01
Milio,Gangplank,384,217,167,56.51
Milio,Lillia,429,225,204,52.45
Milio,Caitlyn,1999,1050,949,52.53
Milio,Renata,132,60,72,45.45
Milio,Warwick,1030,519,511,50.39
Milio,Hwei,454,213,241,46.92
Milio,Jhin,1455,741,714,50.93
Milio,Nami,1042,573,469,54.99
Milio,Shyvana,153,100,53,65.36
Milio,Ambessa,409,223,186,54.52
Milio,Garen,1063,541,522,50.89
Milio,MonkeyKing,473,269,204,56.87
Milio,Akshan,237,138,99,58.23
Milio,Tristana,691,383,308,55.43
Milio,Swain,560,293,267,52.32
Milio,TahmKench,465,272,193,58.49
Milio,Briar,442,232,210,52.49
Milio,Malzahar,852,429,423,50.35
Milio,Pantheon,1108,567,541,51.17
Milio,Skarner,175,97,78,55.43
Milio,MissFortune,1439,761,678,52.88
Milio,Ezreal,1547,868,679,56.11
Milio,Olaf,188,95,93,50.53
Milio,Trundle,397,198,199,49.87
Milio,Xerath,619,300,319,48.47
Milio,Chogath,813,409,404,50.31
Milio,Nasus,420,212,208,50.48
Milio,Akali,645,327,318,50.7
Milio,Corki,317,193,124,60.88
Milio,Riven,367,179,188,48.77
Milio,Nunu,350,167,183,47.71
Milio,Nilah,180,104,76,57.78
Milio,Zoe,266,122,144,45.86
Milio,Aatrox,627,349,278,55.66
Milio,Vi,653,345,308,52.83
Milio,Kaisa,1083,584,499,53.92
Milio,Nautilus,724,407,317,56.22
Milio,Anivia,225,106,119,47.11
Milio,Gwen,375,187,188,49.87
Milio,Velkoz,385,196,189,50.91
Milio,Syndra,496,278,218,56.05
Milio,Renekton,337,181,156,53.71
Milio,Mordekaiser,868,424,444,48.85
Milio,Ahri,941,518,423,55.05
Milio,Rell,318,153,165,48.11
Milio,Teemo,746,362,384,48.53
Milio,Kayn,1087,634,453,58.33
Milio,Kalista,170,91,79,53.53
Milio,Blitzcrank,432,232,200,53.7
Milio,Zeri,259,95,164,36.68
Milio,Camille,279,146,133,52.33
Milio,Lulu,1390,725,665,52.16
Milio,DrMundo,370,198,172,53.51
Milio,Shaco,706,398,308,56.37
Milio,LeeSin,875,483,392,55.2
Milio,Neeko,264,152,112,57.58
Milio,Sona,294,138,156,46.94
Milio,Jayce,297,181,116,60.94
Milio,Zyra,609,310,299,50.9
Milio,Urgot,369,195,174,52.85
Milio,Senna,596,291,305,48.83
Milio,Sejuani,322,168,154,52.17
Milio,Seraphine,494,264,230,53.44
Milio,Evelynn,245,135,110,55.1
Milio,Katarina,610,338,272,55.41
Milio,Karma,959,487,472,50.78
Milio,Ornn,291,125,166,42.96
Milio,JarvanIV,387,188,199,48.58
Milio,Yasuo,1276,683,593,53.53
Milio,Volibear,809,446,363,55.13
Milio,Vladimir,609,337,272,55.34
Milio,Rammus,198,104,94,52.53
Milio,Lissandra,256,109,147,42.58
Milio,Brand,459,254,205,55.34
Milio,Alistar,268,149,119,55.6
Milio,Rengar,305,151,154,49.51
Milio,Kassadin,177,87,90,49.15
Milio,Morgana,824,426,398,51.7
Milio,Diana,1044,516,528,49.43
Milio,Annie,174,94,80,54.02
Milio,Singed,243,115,128,47.33
Milio,Gragas,368,186,182,50.54
Milio,Varus,610,322,288,52.79
Milio,Kindred,308,179,129,58.12
Milio,Ryze,217,89,128,41.01
Milio,Taliyah,190,113,77,59.47
Milio,Illaoi,303,147,156,48.51
Milio,Poppy,352,201,151,57.1
Milio,Talon,426,245,181,57.51
Milio,Sivir,318,165,153,51.89
Milio,Twitch,680,333,347,48.97
Milio,Kayle,480,239,241,49.79
Milio,Aurora,503,286,217,56.86
Milio,Samira,504,285,219,56.55
Milio,Sett,885,453,432,51.19
Milio,Qiyana,214,104,110,48.6
Milio,Kennen,162,75,87,46.3
Milio,MasterYi,738,395,343,53.52
Milio,Hecarim,350,192,158,54.86
Milio,Naafiri,207,101,106,48.79
Milio,Vayne,906,471,435,51.99
Milio,Galio,501,234,267,46.71
Milio,KSante,323,186,137,57.59
Milio,Irelia,597,339,258,56.78
Milio,Ziggs,230,127,103,55.22
Milio,Yone,1186,658,528,55.48
Milio,Yuumi,572,308,264,53.85
Milio,Viego,963,486,477,50.47
Milio,KogMaw,256,141,115,55.08
Milio,Braum,406,191,215,47.04
Milio,Draven,376,176,200,46.81
Milio,Rumble,170,86,84,50.59
Milio,Malphite,699,391,308,55.94
Milio,Sion,525,277,248,52.76
Milio,Udyr,291,153,138,52.58
Milio,AurelionSol,251,114,137,45.42
Milio,Sylas,769,394,375,51.24
Milio,FiddleSticks,383,195,188,50.91
Milio,Elise,524,278,246,53.05
Milio,Leblanc,377,193,184,51.19
Milio,Yorick,716,371,345,51.82
Milio,Leona,576,294,282,51.04
Milio,Shen,363,189,174,52.07
Milio,Cassiopeia,152,78,74,51.32
Milio,Graves,436,224,212,51.38
Milio,Fizz,389,214,175,55.01
Milio,Heimerdinger,247,120,127,48.58
Milio,Karthus,207,128,79,61.84
Milio,Azir,237,122,115,51.48
Milio,XinZhao,380,221,159,58.16
Milio,Taric,152,70,82,46.05
Milio,Maokai,289,170,119,58.82
Milio,Fiora,258,137,121,53.1
Milio,Nidalee,175,90,85,51.43
Milio,TwistedFate,278,185,93,66.55
Milio,Zac,274,136,138,49.64
Milio,Ivern,127,67,60,52.76
Milio,Zilean,208,110,98,52.88
Milio,Jax,647,348,299,53.79
Milio,Belveth,177,85,92,48.02
Milio,Xayah,265,145,120,54.72
Milio,RekSai,113,52,61,46.02
Milio,Janna,338,175,163,51.78
Milio,Gnar,320,179,141,55.94
Milio,Bard,215,128,87,59.53
Milio,Orianna,349,194,155,55.59
Milio,Smolder,427,237,190,55.5
Milio,Quinn,252,121,131,48.02
Milio,Viktor,655,357,298,54.5
Milio,Kled,112,52,60,46.43
Rakan,Illaoi,212,97,115,45.75
Rakan,Pantheon,780,334,446,42.82
Rakan,Syndra,342,186,156,54.39
Rakan,Kaisa,860,465,395,54.07
Rakan,Milio,244,132,112,54.1
Rakan,Zac,225,112,113,49.78
Rakan,Khazix,244,93,151,38.11
Rakan,Katarina,390,201,189,51.54
Rakan,Samira,286,157,129,54.9
Rakan,Leona,369,192,177,52.03
Rakan,Ambessa,271,164,107,60.52
Rakan,XinZhao,310,131,179,42.26
Rakan,Vladimir,397,209,188,52.64
Rakan,Ezreal,1276,621,655,48.67
Rakan,Karma,614,316,298,51.47
Rakan,Sett,628,316,312,50.32
Rakan,Gragas,229,109,120,47.6
Rakan,Yasuo,943,486,457,51.54
Rakan,Kalista,103,59,44,57.28
Rakan,Mel,1073,559,514,52.1
Rakan,Yorick,383,180,203,47
Rakan,Lillia,271,154,117,56.83
Rakan,Yone,907,500,407,55.13
Rakan,Xayah,240,122,118,50.83
Rakan,Yuumi,333,191,142,57.36
Rakan,Evelynn,184,114,70,61.96
Rakan,Lux,1139,536,603,47.06
Rakan,Corki,235,126,109,53.62
Rakan,Singed,139,82,57,58.99
Rakan,Diana,723,355,368,49.1
Rakan,Viktor,426,214,212,50.23
Rakan,MissFortune,1000,474,526,47.4
Rakan,Galio,374,167,207,44.65
Rakan,TahmKench,302,175,127,57.95
Rakan,Rammus,155,90,65,58.06
Rakan,Zed,540,259,281,47.96
Rakan,Ashe,1020,516,504,50.59
Rakan,Shaco,405,187,218,46.17
Rakan,Darius,874,431,443,49.31
Rakan,Malzahar,431,208,223,48.26
Rakan,Viego,703,328,375,46.66
Rakan,Varus,411,192,219,46.72
Rakan,Sion,343,174,169,50.73
Rakan,Vi,474,243,231,51.27
Rakan,Soraka,250,117,133,46.8
Rakan,MasterYi,558,269,289,48.21
Rakan,Mordekaiser,558,299,259,53.58
Rakan,Jinx,1338,610,728,45.59
Rakan,Gwen,211,91,120,43.13
Rakan,Tryndamere,246,128,118,52.03
Rakan,Caitlyn,1100,513,587,46.64
Rakan,Nasus,272,138,134,50.74
Rakan,Vayne,598,288,310,48.16
Rakan,Irelia,412,226,186,54.85
Rakan,Malphite,497,261,236,52.52
Rakan,Amumu,490,220,270,44.9
Rakan,Brand,251,141,110,56.18
Rakan,Akshan,160,79,81,49.38
Rakan,Braum,367,201,166,54.77
Rakan,Skarner,106,49,57,46.23
Rakan,Aurora,366,197,169,53.83
Rakan,Smolder,327,164,163,50.15
Rakan,Chogath,567,266,301,46.91
Rakan,JarvanIV,259,119,140,45.95
Rakan,Bard,179,85,94,47.49
Rakan,Riven,258,116,142,44.96
Rakan,DrMundo,251,110,141,43.82
Rakan,Jhin,993,525,468,52.87
Rakan,Zyra,421,187,234,44.42
Rakan,Fizz,212,121,91,57.08
Rakan,Thresh,688,315,373,45.78
Rakan,Shyvana,132,77,55,58.33
Rakan,Sylas,781,381,400,48.78
Rakan,Nami,471,205,266,43.52
Rakan,Volibear,457,249,208,54.49
Rakan,Swain,400,189,211,47.25
Rakan,Zilean,183,101,82,55.19
Rakan,Warwick,643,298,345,46.35
Rakan,Urgot,210,93,117,44.29
Rakan,Tristana,470,245,225,52.13
Rakan,Velkoz,287,150,137,52.26
Rakan,Naafiri,152,85,67,55.92
Rakan,Ivern,64,34,30,53.13
Rakan,Leblanc,293,127,166,43.34
Rakan,Renekton,217,126,91,58.06
Rakan,Lissandra,147,59,88,40.14
Rakan,Elise,449,203,246,45.21
Rakan,Rumble,153,80,73,52.29
Rakan,Nocturne,556,271,285,48.74
Rakan,Aphelios,262,136,126,51.91
Rakan,Anivia,148,77,71,52.03
Rakan,Nautilus,496,286,210,57.66
Rakan,Morgana,558,253,305,45.34
Rakan,AurelionSol,213,116,97,54.46
Rakan,Kayn,613,265,348,43.23
Rakan,Veigar,418,183,235,43.78
Rakan,Gangplank,216,90,126,41.67
Rakan,LeeSin,819,450,369,54.95
Rakan,Udyr,178,102,76,57.3
Rakan,Qiyana,91,48,43,52.75
Rakan,Lucian,344,149,195,43.31
Rakan,Renata,99,31,68,31.31
Rakan,Garen,749,362,387,48.33
Rakan,Akali,537,276,261,51.4
Rakan,Ahri,618,309,309,50
Rakan,Lulu,609,289,320,47.45
Rakan,Teemo,459,244,215,53.16
Rakan,Vex,228,108,120,47.37
Rakan,Briar,349,168,181,48.14
Rakan,Annie,150,94,56,62.67
Rakan,Pyke,441,207,234,46.94
Rakan,Hwei,307,163,144,53.09
Rakan,Jax,480,252,228,52.5
Rakan,Karthus,146,67,79,45.89
Rakan,Sejuani,193,106,87,54.92
Rakan,Nilah,107,57,50,53.27
Rakan,Neeko,211,88,123,41.71
Rakan,Hecarim,207,93,114,44.93
Rakan,Orianna,190,103,87,54.21
Rakan,Maokai,244,146,98,59.84
Rakan,Kayle,281,127,154,45.2
Rakan,Seraphine,302,141,161,46.69
Rakan,Camille,160,87,73,54.38
Rakan,Trundle,280,120,160,42.86
Rakan,Fiora,186,104,82,55.91
Rakan,Sona,145,69,76,47.59
Rakan,Ekko,460,238,222,51.74
Rakan,Rell,255,112,143,43.92
Rakan,Rengar,165,105,60,63.64
Rakan,Azir,152,76,76,50
Rakan,Gnar,162,68,94,41.98
Rakan,Graves,359,182,177,50.7
Rakan,Aatrox,443,193,250,43.57
Rakan,Quinn,158,89,69,56.33
Rakan,Cassiopeia,151,70,81,46.36
Rakan,Jayce,292,133,159,45.55
Rakan,Taliyah,147,70,77,47.62
Rakan,Zeri,184,87,97,47.28
Rakan,Draven,238,155,83,65.13
Rakan,Sivir,247,120,127,48.58
Rakan,Xerath,385,179,206,46.49
Rakan,RekSai,55,26,29,47.27
Rakan,Ziggs,180,101,79,56.11
Rakan,Twitch,343,188,155,54.81
Rakan,Shen,261,113,148,43.3
Rakan,Blitzcrank,294,165,129,56.12
Rakan,Nidalee,139,84,55,60.43
Rakan,Senna,348,206,142,59.2
Rakan,Janna,163,76,87,46.63
Rakan,Nunu,219,101,118,46.12
Rakan,Kassadin,86,54,32,62.79
Rakan,MonkeyKing,351,162,189,46.15
Rakan,Poppy,400,195,205,48.75
Rakan,Heimerdinger,206,110,96,53.4
Rakan,Ryze,181,85,96,46.96
Rakan,Kled,80,38,42,47.5
Rakan,Kindred,180,93,87,51.67
Rakan,KogMaw,113,64,49,56.64
Rakan,Alistar,179,74,105,41.34
Rakan,Zoe,190,103,87,54.21
Rakan,Kennen,114,57,57,50
Rakan,FiddleSticks,221,96,125,43.44
Rakan,Ornn,197,95,102,48.22
Rakan,TwistedFate,156,84,72,53.85
Rakan,Talon,265,144,121,54.34
Rakan,Belveth,104,48,56,46.15
Rakan,KSante,275,141,134,51.27
Rakan,Olaf,115,64,51,55.65
Rakan,Taric,85,50,35,58.82
Ekko,Illaoi,543,266,277,48.99
Ekko,Pantheon,1784,866,918,48.54
Ekko,Syndra,826,408,418,49.39
Ekko,Kaisa,1811,934,877,51.57
Ekko,Milio,756,354,402,46.83
Ekko,Gangplank,581,278,303,47.85
Ekko,Kayn,1790,961,829,53.69
Ekko,Mel,2413,1250,1163,51.8
Ekko,MissFortune,2592,1277,1315,49.27
Ekko,Thresh,1509,760,749,50.36
Ekko,Diana,1796,881,915,49.05
Ekko,Gragas,636,323,313,50.79
Ekko,Zed,1642,875,767,53.29
Ekko,Caitlyn,3143,1510,1633,48.04
Ekko,Soraka,704,364,340,51.7
Ekko,Warwick,1745,863,882,49.46
Ekko,Hecarim,480,244,236,50.83
Ekko,Ziggs,417,186,231,44.6
Ekko,Karma,1357,665,692,49.01
Ekko,Yasuo,2163,1025,1138,47.39
Ekko,Talon,679,317,362,46.69
Ekko,Viktor,1131,573,558,50.66
Ekko,Sion,852,408,444,47.89
Ekko,Shaco,1178,578,600,49.07
Ekko,Malzahar,1257,659,598,52.43
Ekko,Jinx,3257,1665,1592,51.12
Ekko,Poppy,655,319,336,48.7
Ekko,Taliyah,291,142,149,48.8
Ekko,Morgana,1338,621,717,46.41
Ekko,Darius,2072,1011,1061,48.79
Ekko,Nautilus,1174,632,542,53.83
Ekko,Ambessa,666,340,326,51.05
Ekko,Vex,486,220,266,45.27
Ekko,Elise,980,521,459,53.16
Ekko,Mordekaiser,1425,685,740,48.07
Ekko,Xerath,1011,543,468,53.71
Ekko,Ezreal,2679,1356,1323,50.62
Ekko,Yorick,1185,530,655,44.73
Ekko,Nocturne,1522,720,802,47.31
Ekko,Xayah,497,256,241,51.51
Ekko,Trundle,649,302,347,46.53
Ekko,Vi,991,531,460,53.58
Ekko,Fizz,735,356,379,48.44
Ekko,Sivir,653,334,319,51.15
Ekko,Velkoz,726,365,361,50.28
Ekko,Camille,387,196,191,50.65
Ekko,LeeSin,1706,885,821,51.88
Ekko,Hwei,788,434,354,55.08
Ekko,Jhin,2367,1209,1158,51.08
Ekko,Zyra,1082,515,567,47.6
Ekko,Singed,370,193,177,52.16
Ekko,Galio,1032,499,533,48.35
Ekko,Heimerdinger,543,266,277,48.99
Ekko,Olaf,279,143,136,51.25
Ekko,Lissandra,431,205,226,47.56
Ekko,TahmKench,884,472,412,53.39
Ekko,Teemo,1394,689,705,49.43
Ekko,Lux,2875,1334,1541,46.4
Ekko,Blitzcrank,804,406,398,50.5
Ekko,Kled,192,93,99,48.44
Ekko,Ashe,2232,1118,1114,50.09
Ekko,Akali,1261,648,613,51.39
Ekko,Jax,1083,517,566,47.74
Ekko,Aurora,714,408,306,57.14
Ekko,Udyr,446,204,242,45.74
Ekko,Qiyana,295,179,116,60.68
Ekko,Katarina,868,447,421,51.5
Ekko,Vayne,1546,789,757,51.03
Ekko,Rengar,432,205,227,47.45
Ekko,Pyke,857,430,427,50.18
Ekko,Riven,580,278,302,47.93
Ekko,FiddleSticks,550,283,267,51.45
Ekko,Neeko,479,229,250,47.81
Ekko,Khazix,569,287,282,50.44
Ekko,Veigar,1195,541,654,45.27
Ekko,Smolder,644,312,332,48.45
Ekko,Senna,863,431,432,49.94
Ekko,Ivern,135,50,85,37.04
Ekko,Tristana,1185,615,570,51.9
Ekko,Volibear,1280,651,629,50.86
Ekko,Lulu,1390,751,639,54.03
Ekko,Nami,1163,566,597,48.67
Ekko,MasterYi,1389,702,687,50.54
Ekko,DrMundo,627,352,275,56.14
Ekko,Jayce,491,233,258,47.45
Ekko,Fiora,425,213,212,50.12
Ekko,Swain,1017,476,541,46.8
Ekko,Seraphine,811,401,410,49.45
Ekko,Renekton,588,291,297,49.49
Ekko,Nunu,701,351,350,50.07
Ekko,Ornn,455,214,241,47.03
Ekko,Garen,1750,907,843,51.83
Ekko,Ahri,1507,777,730,51.56
Ekko,Shen,723,352,371,48.69
Ekko,Viego,1700,819,881,48.18
Ekko,Twitch,929,482,447,51.88
Ekko,Lucian,823,429,394,52.13
Ekko,TwistedFate,368,181,187,49.18
Ekko,Draven,577,303,274,52.51
Ekko,Bard,373,209,164,56.03
Ekko,Sett,1662,811,851,48.8
Ekko,Varus,1027,551,476,53.65
Ekko,Kennen,285,161,124,56.49
Ekko,Vladimir,774,415,359,53.62
Ekko,Sylas,1635,846,789,51.74
Ekko,Braum,673,325,348,48.29
Ekko,KSante,572,292,280,51.05
Ekko,Zilean,390,206,184,52.82
Ekko,Brand,810,346,464,42.72
Ekko,Gwen,567,282,285,49.74
Ekko,Tryndamere,665,327,338,49.17
Ekko,Leona,1013,497,516,49.06
Ekko,Kayle,818,397,421,48.53
Ekko,Kindred,494,221,273,44.74
Ekko,Renata,174,97,77,55.75
Ekko,Shyvana,315,147,168,46.67
Ekko,Zoe,395,207,188,52.41
Ekko,Maokai,547,252,295,46.07
Ekko,Urgot,637,276,361,43.33
Ekko,JarvanIV,626,340,286,54.31
Ekko,Gnar,426,254,172,59.62
Ekko,MonkeyKing,810,367,443,45.31
Ekko,Irelia,1017,452,565,44.44
Ekko,Rammus,319,182,137,57.05
Ekko,Corki,490,241,249,49.18
Ekko,Zac,584,296,288,50.68
Ekko,Anivia,358,179,179,50
Ekko,Aphelios,626,285,341,45.53
Ekko,Briar,850,392,458,46.12
Ekko,Naafiri,373,176,197,47.18
Ekko,Aatrox,956,541,415,56.59
Ekko,Akshan,424,217,207,51.18
Ekko,Yone,1934,1044,890,53.98
Ekko,Nasus,691,345,346,49.93
Ekko,Graves,685,383,302,55.91
Ekko,Cassiopeia,341,166,175,48.68
Ekko,Lillia,657,299,358,45.51
Ekko,Yuumi,837,407,430,48.63
Ekko,Malphite,1047,570,477,54.44
Ekko,Rell,472,225,247,47.67
Ekko,XinZhao,753,362,391,48.07
Ekko,Orianna,465,250,215,53.76
Ekko,Samira,848,412,436,48.58
Ekko,AurelionSol,445,215,230,48.31
Ekko,Karthus,336,191,145,56.85
Ekko,Rumble,302,159,143,52.65
Ekko,Amumu,1306,618,688,47.32
Ekko,Quinn,400,193,207,48.25
Ekko,KogMaw,344,176,168,51.16
Ekko,Skarner,269,137,132,50.93
Ekko,Kassadin,267,117,150,43.82
Ekko,Chogath,1338,690,648,51.57
Ekko,Annie,353,171,182,48.44
Ekko,Ryze,410,204,206,49.76
Ekko,Sejuani,392,203,189,51.79
Ekko,Nilah,279,143,136,51.25
Ekko,Azir,334,169,165,50.6
Ekko,Evelynn,438,215,223,49.09
Ekko,Sona,374,173,201,46.26
Ekko,Taric,249,115,134,46.18
Ekko,Rakan,460,222,238,48.26
Ekko,RekSai,123,77,46,62.6
Ekko,Leblanc,636,290,346,45.6
Ekko,Nidalee,293,168,125,57.34
Ekko,Alistar,491,236,255,48.07
Ekko,Kalista,313,135,178,43.13
Ekko,Zeri,471,216,255,45.86
Ekko,Belveth,228,122,106,53.51
Ekko,Janna,385,210,175,54.55
Ashe,Illaoi,1207,598,609,49.54
Ashe,Pantheon,3644,1873,1771,51.4
Ashe,Syndra,1447,704,743,48.65
Ashe,Kaisa,4110,2229,1881,54.23
Ashe,Milio,1397,630,767,45.1
Ashe,Garen,3798,1790,2008,47.13
Ashe,Sejuani,925,471,454,50.92
Ashe,Katarina,1938,1005,933,51.86
Ashe,Varus,2593,1327,1266,51.18
Ashe,Yuumi,1957,999,958,51.05
Ashe,Warwick,3433,1521,1912,44.31
Ashe,Briar,1682,790,892,46.97
Ashe,Zed,2658,1392,1266,52.37
Ashe,Ziggs,938,502,436,53.52
Ashe,Xerath,2327,1136,1191,48.82
Ashe,Ornn,982,491,491,50
Ashe,Kayn,3311,1579,1732,47.69
Ashe,Malzahar,2425,1199,1226,49.44
Ashe,Vayne,2887,1408,1479,48.77
Ashe,Lulu,3232,1733,1499,53.62
Ashe,Tryndamere,1277,656,621,51.37
Ashe,Vi,2413,1281,1132,53.09
Ashe,Caitlyn,7644,3815,3829,49.91
Ashe,Zyra,2422,1172,1250,48.39
Ashe,Volibear,2697,1344,1353,49.83
Ashe,Yasuo,4639,2365,2274,50.98
Ashe,Mel,4741,2455,2286,51.78
Ashe,Zilean,796,457,339,57.41
Ashe,Trundle,1442,690,752,47.85
Ashe,Shaco,2290,1155,1135,50.44
Ashe,Soraka,1363,667,696,48.94
Ashe,Jax,2259,1106,1153,48.96
Ashe,Skarner,640,343,297,53.59
Ashe,Irelia,2081,1100,981,52.86
Ashe,MissFortune,6587,3212,3375,48.76
Ashe,Alistar,1005,488,517,48.56
Ashe,Yorick,2434,1090,1344,44.78
Ashe,Lux,5837,2877,2960,49.29
Ashe,Jinx,8141,4043,4098,49.66
Ashe,Bard,723,363,360,50.21
Ashe,Jhin,5541,2754,2787,49.7
Ashe,Seraphine,1647,804,843,48.82
Ashe,Yone,4379,2262,2117,51.66
Ashe,Samira,1509,732,777,48.51
Ashe,MasterYi,2984,1470,1514,49.26
Ashe,Xayah,1101,560,541,50.86
Ashe,Velkoz,1315,621,694,47.22
Ashe,Lillia,1454,719,735,49.45
Ashe,Nami,2133,1018,1115,47.73
Ashe,Gnar,945,500,445,52.91
Ashe,MonkeyKing,1645,795,850,48.33
Ashe,Maokai,1078,509,569,47.22
Ashe,Pyke,2002,1036,966,51.75
Ashe,Nasus,1668,783,885,46.94
Ashe,Diana,3917,1826,2091,46.62
Ashe,Renekton,1376,732,644,53.2
Ashe,Veigar,2458,1211,1247,49.27
Ashe,Chogath,2706,1311,1395,48.45
Ashe,Ekko,2232,1114,1118,49.91
Ashe,Talon,1393,682,711,48.96
Ashe,Akshan,765,393,372,51.37
Ashe,RekSai,261,135,126,51.72
Ashe,Poppy,1477,713,764,48.27
Ashe,Viego,3708,1806,1902,48.71
Ashe,Hwei,1629,782,847,48
Ashe,Malphite,2336,1158,1178,49.57
Ashe,Nocturne,3130,1482,1648,47.35
Ashe,Orianna,1050,515,535,49.05
Ashe,Kalista,620,306,314,49.35
Ashe,Brand,1822,808,1014,44.35
Ashe,Kayle,1339,678,661,50.63
Ashe,Aatrox,2320,1156,1164,49.83
Ashe,Zoe,1037,543,494,52.36
Ashe,Nautilus,2742,1319,1423,48.1
Ashe,Sett,3689,1773,1916,48.06
Ashe,Leona,2027,1059,968,52.24
Ashe,Mordekaiser,3009,1461,1548,48.55
Ashe,Tristana,2426,1134,1292,46.74
Ashe,Smolder,1384,752,632,54.34
Ashe,Swain,2366,1169,1197,49.41
Ashe,Heimerdinger,1129,549,580,48.63
Ashe,Gwen,1076,582,494,54.09
Ashe,Gragas,1180,611,569,51.78
Ashe,LeeSin,4426,2336,2090,52.78
Ashe,Akali,2804,1422,1382,50.71
Ashe,Ahri,3270,1607,1663,49.14
Ashe,Camille,827,437,390,52.84
Ashe,Belveth,554,298,256,53.79
Ashe,Lissandra,738,360,378,48.78
Ashe,Vladimir,1547,809,738,52.29
Ashe,Zeri,1064,530,534,49.81
Ashe,Galio,2231,1089,1142,48.81
Ashe,Riven,986,499,487,50.61
Ashe,Darius,4524,2205,2319,48.74
Ashe,Draven,1302,650,652,49.92
Ashe,Rakan,1020,504,516,49.41
Ashe,Teemo,2933,1417,1516,48.31
Ashe,Graves,1653,860,793,52.03
Ashe,TahmKench,1746,831,915,47.59
Ashe,Khazix,1153,669,484,58.02
Ashe,Vex,1335,668,667,50.04
Ashe,Sivir,1487,752,735,50.57
Ashe,Morgana,2989,1379,1610,46.14
Ashe,Kled,441,195,246,44.22
Ashe,Aphelios,1160,591,569,50.95
Ashe,Fiora,951,479,472,50.37
Ashe,Amumu,2376,1140,1236,47.98
Ashe,Jayce,1399,738,661,52.75
Ashe,Taric,447,230,217,51.45
Ashe,Sona,707,323,384,45.69
Ashe,TwistedFate,861,461,400,53.54
Ashe,Rumble,670,354,316,52.84
Ashe,Gangplank,1142,575,567,50.35
Ashe,Neeko,1170,608,562,51.97
Ashe,Ezreal,7171,3495,3676,48.74
Ashe,Taliyah,605,278,327,45.95
Ashe,Viktor,2252,1167,1085,51.82
Ashe,Ryze,824,394,430,47.82
Ashe,Evelynn,842,416,426,49.41
Ashe,Leblanc,1696,879,817,51.83
Ashe,Quinn,916,421,495,45.96
Ashe,Karma,3247,1607,1640,49.49
Ashe,JarvanIV,1355,631,724,46.57
Ashe,Thresh,3229,1614,1615,49.98
Ashe,Naafiri,782,385,397,49.23
Ashe,DrMundo,1347,627,720,46.55
Ashe,Qiyana,609,297,312,48.77
Ashe,Urgot,1099,481,618,43.77
Ashe,Lucian,1775,964,811,54.31
Ashe,Braum,1280,582,698,45.47
Ashe,Elise,1690,869,821,51.42
Ashe,Kassadin,475,207,268,43.58
Ashe,Nunu,1296,712,584,54.94
Ashe,KogMaw,774,347,427,44.83
Ashe,Sylas,3992,1969,2023,49.32
Ashe,XinZhao,1593,755,838,47.39
Ashe,Shen,1387,711,676,51.26
Ashe,Rammus,817,399,418,48.84
Ashe,Twitch,1903,935,968,49.13
Ashe,FiddleSticks,1229,620,609,50.45
Ashe,Singed,702,366,336,52.14
Ashe,Corki,1119,592,527,52.9
Ashe,Anivia,730,359,371,49.18
Ashe,Ambessa,1604,804,800,50.12
Ashe,Kennen,600,318,282,53
Ashe,Kindred,1032,519,513,50.29
Ashe,Aurora,1839,951,888,51.71
Ashe,Nilah,634,328,306,51.74
Ashe,Nidalee,930,550,380,59.14
Ashe,Annie,865,435,430,50.29
Ashe,Udyr,926,518,408,55.94
Ashe,Senna,1693,890,803,52.57
Ashe,Olaf,596,267,329,44.8
Ashe,KSante,1469,766,703,52.14
Ashe,Shyvana,592,278,314,46.96
Ashe,Karthus,703,340,363,48.36
Ashe,Zac,1306,613,693,46.94
Ashe,Cassiopeia,604,320,284,52.98
Ashe,Rell,1144,564,580,49.3
Ashe,Sion,1637,757,880,46.24
Ashe,AurelionSol,877,440,437,50.17
Ashe,Rengar,684,364,320,53.22
Ashe,Fizz,1364,651,713,47.73
Ashe,Janna,803,385,418,47.95
Ashe,Blitzcrank,1963,957,1006,48.75
Ashe,Hecarim,970,506,464,52.16
Ashe,Renata,394,213,181,54.06
Ashe,Azir,866,446,420,51.5
Ashe,Ivern,294,146,148,49.66
Tryndamere,Yorick,1062,502,560,47.27
Tryndamere,Rammus,278,145,133,52.16
Tryndamere,Yasuo,1361,714,647,52.46
Tryndamere,Caitlyn,1967,932,1035,47.38
Tryndamere,Lulu,817,394,423,48.23
Tryndamere,Karma,645,340,305,52.71
Tryndamere,Ivern,85,40,45,47.06
Tryndamere,Anivia,232,102,130,43.97
Tryndamere,Ashe,1277,621,656,48.63
Tryndamere,Aatrox,504,237,267,47.02
Tryndamere,Yone,1179,603,576,51.15
Tryndamere,Warwick,1152,506,646,43.92
Tryndamere,Hwei,391,201,190,51.41
Tryndamere,Varus,593,282,311,47.55
Tryndamere,Malphite,948,446,502,47.05
Tryndamere,Singed,240,103,137,42.92
Tryndamere,Viego,984,501,483,50.91
Tryndamere,Zed,736,371,365,50.41
Tryndamere,Zeri,238,114,124,47.9
Tryndamere,Milio,458,238,220,51.97
Tryndamere,Volibear,930,437,493,46.99
Tryndamere,Lux,1956,993,963,50.77
Tryndamere,Jinx,2136,1082,1054,50.66
Tryndamere,Bard,170,70,100,41.18
Tryndamere,Chogath,912,462,450,50.66
Tryndamere,Shaco,668,345,323,51.65
Tryndamere,Sivir,352,188,164,53.41
Tryndamere,Ambessa,396,227,169,57.32
Tryndamere,Evelynn,214,115,99,53.74
Tryndamere,Xayah,255,141,114,55.29
Tryndamere,Velkoz,418,205,213,49.04
Tryndamere,Irelia,518,272,246,52.51
Tryndamere,Elise,304,135,169,44.41
Tryndamere,Veigar,759,393,366,51.78
Tryndamere,Smolder,399,212,187,53.13
Tryndamere,Soraka,407,179,228,43.98
Tryndamere,Riven,298,127,171,42.62
Tryndamere,Neeko,322,149,173,46.27
Tryndamere,FiddleSticks,315,154,161,48.89
Tryndamere,Diana,990,518,472,52.32
Tryndamere,Tristana,683,344,339,50.37
Tryndamere,Kayn,1083,545,538,50.32
Tryndamere,Orianna,213,114,99,53.52
Tryndamere,Kaisa,1000,491,509,49.1
Tryndamere,LeeSin,841,510,331,60.64
Tryndamere,Mel,1442,710,732,49.24
Tryndamere,Mordekaiser,913,477,436,52.25
Tryndamere,Teemo,904,441,463,48.78
Tryndamere,Draven,358,197,161,55.03
Tryndamere,Thresh,865,434,431,50.17
Tryndamere,Gangplank,324,174,150,53.7
Tryndamere,Ekko,665,338,327,50.83
Tryndamere,Kassadin,150,70,80,46.67
Tryndamere,Rakan,246,118,128,47.97
Tryndamere,Darius,1409,657,752,46.63
Tryndamere,MonkeyKing,475,242,233,50.95
Tryndamere,Sylas,785,373,412,47.52
Tryndamere,Vex,369,151,218,40.92
Tryndamere,MissFortune,1664,825,839,49.58
Tryndamere,Heimerdinger,371,195,176,52.56
Tryndamere,Vayne,852,401,451,47.07
Tryndamere,MasterYi,991,500,491,50.45
Tryndamere,Akali,701,338,363,48.22
Tryndamere,Garen,1347,681,666,50.56
Tryndamere,Syndra,452,242,210,53.54
Tryndamere,Ezreal,1500,778,722,51.87
Tryndamere,Shen,456,238,218,52.19
Tryndamere,Hecarim,280,161,119,57.5
Tryndamere,Lucian,493,275,218,55.78
Tryndamere,Rengar,248,123,125,49.6
Tryndamere,Aphelios,310,151,159,48.71
Tryndamere,Morgana,885,429,456,48.47
Tryndamere,Nasus,538,219,319,40.71
Tryndamere,Seraphine,475,243,232,51.16
Tryndamere,Vi,588,298,290,50.68
Tryndamere,Camille,214,109,105,50.93
Tryndamere,Malzahar,750,357,393,47.6
Tryndamere,Jhin,1380,713,667,51.67
Tryndamere,TahmKench,579,278,301,48.01
Tryndamere,Azir,214,134,80,62.62
Tryndamere,Nami,683,323,360,47.29
Tryndamere,Sett,978,473,505,48.36
Tryndamere,Rell,295,145,150,49.15
Tryndamere,Galio,507,297,210,58.58
Tryndamere,Viktor,559,264,295,47.23
Tryndamere,Samira,516,265,251,51.36
Tryndamere,Quinn,252,118,134,46.83
Tryndamere,Annie,223,82,141,36.77
Tryndamere,Sejuani,294,145,149,49.32
Tryndamere,Pyke,570,258,312,45.26
Tryndamere,Swain,637,316,321,49.61
Tryndamere,Braum,395,187,208,47.34
Tryndamere,Gwen,329,176,153,53.5
Tryndamere,Poppy,347,166,181,47.84
Tryndamere,Ahri,803,375,428,46.7
Tryndamere,Zilean,200,73,127,36.5
Tryndamere,Kindred,342,162,180,47.37
Tryndamere,Katarina,547,290,257,53.02
Tryndamere,Nilah,248,112,136,45.16
Tryndamere,Senna,525,254,271,48.38
Tryndamere,Akshan,256,119,137,46.48
Tryndamere,Gnar,228,107,121,46.93
Tryndamere,Pantheon,1006,503,503,50
Tryndamere,Ziggs,218,110,108,50.46
Tryndamere,Udyr,310,172,138,55.48
Tryndamere,Sion,502,261,241,51.99
Tryndamere,Corki,302,153,149,50.66
Tryndamere,TwistedFate,223,118,105,52.91
Tryndamere,Briar,470,225,245,47.87
Tryndamere,Karthus,173,86,87,49.71
Tryndamere,Ryze,196,90,106,45.92
Tryndamere,Blitzcrank,492,230,262,46.75
Tryndamere,Belveth,168,80,88,47.62
Tryndamere,Jayce,281,125,156,44.48
Tryndamere,Janna,186,121,65,65.05
Tryndamere,Nautilus,743,378,365,50.87
Tryndamere,Naafiri,199,114,85,57.29
Tryndamere,Xerath,579,292,287,50.43
Tryndamere,Zac,223,112,111,50.22
Tryndamere,Taric,171,95,76,55.56
Tryndamere,Illaoi,344,158,186,45.93
Tryndamere,Vladimir,415,238,177,57.35
Tryndamere,Gragas,348,145,203,41.67
Tryndamere,Talon,352,197,155,55.97
Tryndamere,Twitch,521,266,255,51.06
Tryndamere,Maokai,255,157,98,61.57
Tryndamere,Leblanc,352,162,190,46.02
Tryndamere,Kalista,149,72,77,48.32
Tryndamere,Rumble,115,76,39,66.09
Tryndamere,Nocturne,795,381,414,47.92
Tryndamere,Aurora,411,239,172,58.15
Tryndamere,Fizz,506,251,255,49.6
Tryndamere,Zyra,513,246,267,47.95
Tryndamere,Olaf,159,88,71,55.35
Tryndamere,Alistar,253,119,134,47.04
Tryndamere,XinZhao,437,224,213,51.26
Tryndamere,KogMaw,207,114,93,55.07
Tryndamere,Trundle,437,221,216,50.57
Tryndamere,Jax,714,361,353,50.56
Tryndamere,Kennen,143,73,70,51.05
Tryndamere,Yuumi,538,323,215,60.04
Tryndamere,RekSai,54,26,28,48.15
Tryndamere,Taliyah,139,66,73,47.48
Tryndamere,Graves,407,197,210,48.4
Tryndamere,JarvanIV,387,196,191,50.65
Tryndamere,Urgot,376,178,198,47.34
Tryndamere,Zoe,282,124,158,43.97
Tryndamere,DrMundo,413,209,204,50.61
Tryndamere,Sona,238,109,129,45.8
Tryndamere,Fiora,221,83,138,37.56
Tryndamere,Cassiopeia,217,99,118,45.62
Tryndamere,Kayle,507,231,276,45.56
Tryndamere,Khazix,273,122,151,44.69
Tryndamere,Amumu,763,323,440,42.33
Tryndamere,Lillia,336,165,171,49.11
Tryndamere,Nidalee,173,87,86,50.29
Tryndamere,Leona,497,211,286,42.45
Tryndamere,Nunu,377,174,203,46.15
Tryndamere,Brand,633,323,310,51.03
Tryndamere,Qiyana,214,109,105,50.93
Tryndamere,Ornn,240,122,118,50.83
Tryndamere,Shyvana,133,59,74,44.36
Tryndamere,KSante,246,120,126,48.78
Tryndamere,Skarner,117,68,49,58.12
Tryndamere,Kled,121,53,68,43.8
Tryndamere,Lissandra,209,85,124,40.67
Tryndamere,Renekton,237,120,117,50.63
Tryndamere,Renata,133,73,60,54.89
Tryndamere,AurelionSol,273,140,133,51.28
Lillia,Yorick,655,304,351,46.41
Lillia,Rammus,282,141,141,50
Lillia,Yasuo,1258,609,649,48.41
Lillia,Caitlyn,1793,843,950,47.02
Lillia,Lulu,883,488,395,55.27
Lillia,Urgot,321,185,136,57.63
Lillia,Briar,487,230,257,47.23
Lillia,Ahri,886,452,434,51.02
Lillia,Lux,1450,683,767,47.1
Lillia,Sett,963,454,509,47.14
Lillia,Nocturne,885,408,477,46.1
Lillia,Azir,213,112,101,52.58
Lillia,Ezreal,1745,892,853,51.12
Lillia,Qiyana,166,94,72,56.63
Lillia,Teemo,791,360,431,45.51
Lillia,Khazix,295,138,157,46.78
Lillia,Jinx,1753,841,912,47.97
Lillia,Milio,429,204,225,47.55
Lillia,Mordekaiser,892,433,459,48.54
Lillia,Talon,369,179,190,48.51
Lillia,Ashe,1454,735,719,50.55
Lillia,LeeSin,1201,666,535,55.45
Lillia,Zed,622,302,320,48.55
Lillia,Ornn,255,142,113,55.69
Lillia,Gwen,279,119,160,42.65
Lillia,Fizz,357,189,168,52.94
Lillia,Rakan,271,117,154,43.17
Lillia,Sylas,957,522,435,54.55
Lillia,Volibear,734,369,365,50.27
Lillia,Aurora,459,239,220,52.07
Lillia,Brand,471,249,222,52.87
Lillia,Olaf,178,106,72,59.55
Lillia,Pantheon,1095,500,595,45.66
Lillia,Leblanc,415,174,241,41.93
Lillia,Karma,819,398,421,48.6
Lillia,Darius,1174,541,633,46.08
Lillia,Elise,414,172,242,41.55
Lillia,Gangplank,273,132,141,48.35
Lillia,Varus,572,263,309,45.98
Lillia,Trundle,387,170,217,43.93
Lillia,Chogath,865,462,403,53.41
Lillia,Evelynn,230,124,106,53.91
Lillia,Twitch,530,273,257,51.51
Lillia,Nasus,475,247,228,52
Lillia,TwistedFate,198,105,93,53.03
Lillia,Samira,434,246,188,56.68
Lillia,Mel,1176,624,552,53.06
Lillia,Sion,525,298,227,56.76
Lillia,Shaco,606,301,305,49.67
Lillia,Aatrox,564,241,323,42.73
Lillia,Yone,1231,610,621,49.55
Lillia,MissFortune,1562,767,795,49.1
Lillia,Zilean,199,96,103,48.24
Lillia,FiddleSticks,351,180,171,51.28
Lillia,Annie,200,96,104,48
Lillia,Irelia,621,298,323,47.99
Lillia,Vladimir,393,207,186,52.67
Lillia,Hecarim,324,156,168,48.15
Lillia,Jhin,1338,705,633,52.69
Lillia,Zyra,662,357,305,53.93
Lillia,Malphite,675,333,342,49.33
Lillia,Vi,641,319,322,49.77
Lillia,Akali,766,392,374,51.17
Lillia,Rell,379,189,190,49.87
Lillia,Camille,209,60,149,28.71
Lillia,Udyr,298,139,159,46.64
Lillia,Viego,977,484,493,49.54
Lillia,Senna,482,220,262,45.64
Lillia,Seraphine,480,245,235,51.04
Lillia,Ambessa,433,233,200,53.81
Lillia,KogMaw,202,81,121,40.1
Lillia,Shen,410,200,210,48.78
Lillia,Diana,1110,500,610,45.05
Lillia,Aphelios,368,182,186,49.46
Lillia,Morgana,854,402,452,47.07
Lillia,Blitzcrank,508,268,240,52.76
Lillia,Garen,1219,570,649,46.76
Lillia,Vex,411,225,186,54.74
Lillia,Lucian,444,246,198,55.41
Lillia,Katarina,473,242,231,51.16
Lillia,Soraka,313,157,156,50.16
Lillia,Ekko,657,358,299,54.49
Lillia,Vayne,861,398,463,46.23
Lillia,Galio,668,325,343,48.65
Lillia,Kayn,973,481,492,49.43
Lillia,Anivia,192,78,114,40.63
Lillia,Illaoi,273,139,134,50.92
Lillia,Renekton,374,189,185,50.53
Lillia,Shyvana,166,84,82,50.6
Lillia,Lissandra,245,99,146,40.41
Lillia,Warwick,1029,477,552,46.36
Lillia,Naafiri,205,106,99,51.71
Lillia,Nautilus,718,353,365,49.16
Lillia,DrMundo,436,256,180,58.72
Lillia,Malzahar,663,356,307,53.7
Lillia,Syndra,388,163,225,42.01
Lillia,Draven,317,125,192,39.43
Lillia,Kaisa,1087,532,555,48.94
Lillia,TahmKench,508,256,252,50.39
Lillia,Cassiopeia,199,98,101,49.25
Lillia,Bard,231,100,131,43.29
Lillia,Zeri,276,171,105,61.96
Lillia,Orianna,256,128,128,50
Lillia,Alistar,268,133,135,49.63
Lillia,Nami,538,257,281,47.77
Lillia,Kayle,474,216,258,45.57
Lillia,Graves,428,215,213,50.23
Lillia,Hwei,391,180,211,46.04
Lillia,Viktor,680,327,353,48.09
Lillia,Ivern,70,40,30,57.14
Lillia,Jax,626,336,290,53.67
Lillia,Leona,622,286,336,45.98
Lillia,MasterYi,668,312,356,46.71
Lillia,Xayah,271,137,134,50.55
Lillia,Zac,399,207,192,51.88
Lillia,Sejuani,285,153,132,53.68
Lillia,Nidalee,149,66,83,44.3
Lillia,Akshan,209,105,104,50.24
Lillia,Karthus,224,119,105,53.13
Lillia,Kled,110,35,75,31.82
Lillia,Nilah,230,123,107,53.48
Lillia,Thresh,836,382,454,45.69
Lillia,Ryze,177,74,103,41.81
Lillia,Riven,280,151,129,53.93
Lillia,Fiora,226,124,102,54.87
Lillia,Ziggs,216,100,116,46.3
Lillia,Swain,691,346,345,50.07
Lillia,Tristana,598,269,329,44.98
Lillia,Pyke,486,233,253,47.94
Lillia,Jayce,363,153,210,42.15
Lillia,Velkoz,342,142,200,41.52
Lillia,Veigar,572,303,269,52.97
Lillia,Renata,65,41,24,63.08
Lillia,Belveth,144,77,67,53.47
Lillia,AurelionSol,268,157,111,58.58
Lillia,MonkeyKing,468,244,224,52.14
Lillia,Heimerdinger,359,159,200,44.29
Lillia,Amumu,743,420,323,56.53
Lillia,Taric,115,70,45,60.87
Lillia,Gnar,234,111,123,47.44
Lillia,Kindred,289,145,144,50.17
Lillia,Zoe,259,132,127,50.97
Lillia,KSante,410,250,160,60.98
Lillia,Janna,206,119,87,57.77
Lillia,Nunu,376,179,197,47.61
Lillia,Poppy,465,217,248,46.67
Lillia,Sivir,354,165,189,46.61
Lillia,Yuumi,505,284,221,56.24
Lillia,Quinn,242,108,134,44.63
Lillia,Singed,179,83,96,46.37
Lillia,Maokai,335,181,154,54.03
Lillia,Kassadin,162,78,84,48.15
Lillia,Sona,201,83,118,41.29
Lillia,Taliyah,156,86,70,55.13
Lillia,Tryndamere,336,171,165,50.89
Lillia,XinZhao,424,194,230,45.75
Lillia,Kennen,165,72,93,43.64
Lillia,Kalista,135,88,47,65.19
Lillia,Corki,240,113,127,47.08
Lillia,Smolder,403,226,177,56.08
Lillia,Neeko,302,169,133,55.96
Lillia,Gragas,344,175,169,50.87
Lillia,Rengar,189,117,72,61.9
Lillia,Rumble,180,78,102,43.33
Lillia,Xerath,532,250,282,46.99
Lillia,Skarner,229,126,103,55.02
Lillia,Braum,344,169,175,49.13
Lillia,JarvanIV,355,161,194,45.35
Lillia,RekSai,87,36,51,41.38
FiddleSticks,Mel,1099,544,555,49.5
FiddleSticks,Trundle,326,184,142,56.44
FiddleSticks,Zed,716,373,343,52.09
FiddleSticks,Vayne,732,414,318,56.56
FiddleSticks,Sejuani,244,124,120,50.82
FiddleSticks,Darius,1127,597,530,52.97
FiddleSticks,Volibear,659,303,356,45.98
FiddleSticks,Akali,650,342,308,52.62
FiddleSticks,Jinx,1680,786,894,46.79
FiddleSticks,Lux,1339,642,697,47.95
FiddleSticks,Viktor,483,252,231,52.17
FiddleSticks,Nocturne,785,377,408,48.03
FiddleSticks,Veigar,551,268,283,48.64
FiddleSticks,Ezreal,1436,765,671,53.27
FiddleSticks,Brand,388,174,214,44.85
FiddleSticks,Garen,961,469,492,48.8
FiddleSticks,Nidalee,146,59,87,40.41
FiddleSticks,Caitlyn,1502,710,792,47.27
FiddleSticks,Morgana,726,396,330,54.55
FiddleSticks,Kayle,377,174,203,46.15
FiddleSticks,Yasuo,1208,642,566,53.15
FiddleSticks,Draven,251,129,122,51.39
FiddleSticks,Thresh,759,338,421,44.53
FiddleSticks,Gwen,245,137,108,55.92
FiddleSticks,Ekko,550,267,283,48.55
FiddleSticks,Syndra,390,208,182,53.33
FiddleSticks,Jhin,1236,599,637,48.46
FiddleSticks,Pantheon,889,457,432,51.41
FiddleSticks,Teemo,771,449,322,58.24
FiddleSticks,LeeSin,812,367,445,45.2
FiddleSticks,Chogath,725,317,408,43.72
FiddleSticks,Varus,459,213,246,46.41
FiddleSticks,Nautilus,646,326,320,50.46
FiddleSticks,Hecarim,281,137,144,48.75
FiddleSticks,Naafiri,185,98,87,52.97
FiddleSticks,MissFortune,1337,671,666,50.19
FiddleSticks,Elise,443,221,222,49.89
FiddleSticks,Nami,609,317,292,52.05
FiddleSticks,Ambessa,353,164,189,46.46
FiddleSticks,Jax,526,273,253,51.9
FiddleSticks,Malzahar,550,211,339,38.36
FiddleSticks,Karma,769,333,436,43.3
FiddleSticks,Malphite,566,294,272,51.94
FiddleSticks,Tryndamere,315,161,154,51.11
FiddleSticks,Yorick,513,252,261,49.12
FiddleSticks,Singed,158,68,90,43.04
FiddleSticks,Diana,1014,501,513,49.41
FiddleSticks,Tristana,518,256,262,49.42
FiddleSticks,Zeri,270,142,128,52.59
FiddleSticks,Lillia,351,171,180,48.72
FiddleSticks,Camille,206,107,99,51.94
FiddleSticks,Lulu,859,429,430,49.94
FiddleSticks,Sylas,924,457,467,49.46
FiddleSticks,Shaco,637,296,341,46.47
FiddleSticks,Corki,221,128,93,57.92
FiddleSticks,Taliyah,117,58,59,49.57
FiddleSticks,Seraphine,483,271,212,56.11
FiddleSticks,Aatrox,522,233,289,44.64
FiddleSticks,XinZhao,400,198,202,49.5
FiddleSticks,Twitch,528,251,277,47.54
FiddleSticks,Ryze,183,92,91,50.27
FiddleSticks,Evelynn,135,75,60,55.56
FiddleSticks,Riven,294,152,142,51.7
FiddleSticks,Kayn,994,487,507,48.99
FiddleSticks,Ahri,636,301,335,47.33
FiddleSticks,Zyra,600,324,276,54
FiddleSticks,Graves,385,187,198,48.57
FiddleSticks,Lucian,415,209,206,50.36
FiddleSticks,Sett,878,394,484,44.87
FiddleSticks,MasterYi,702,326,376,46.44
FiddleSticks,Urgot,260,137,123,52.69
FiddleSticks,Khazix,326,161,165,49.39
FiddleSticks,Sivir,335,170,165,50.75
FiddleSticks,Warwick,834,407,427,48.8
FiddleSticks,Briar,385,151,234,39.22
FiddleSticks,Yone,1022,541,481,52.94
FiddleSticks,Taric,120,41,79,34.17
FiddleSticks,Irelia,507,214,293,42.21
FiddleSticks,Nilah,177,95,82,53.67
FiddleSticks,Soraka,329,173,156,52.58
FiddleSticks,Gragas,325,177,148,54.46
FiddleSticks,Ashe,1229,609,620,49.55
FiddleSticks,Blitzcrank,373,194,179,52.01
FiddleSticks,Talon,322,171,151,53.11
FiddleSticks,Vladimir,425,227,198,53.41
FiddleSticks,Kindred,247,117,130,47.37
FiddleSticks,Orianna,311,168,143,54.02
FiddleSticks,Samira,380,216,164,56.84
FiddleSticks,Leblanc,362,167,195,46.13
FiddleSticks,Sion,473,196,277,41.44
FiddleSticks,TahmKench,443,246,197,55.53
FiddleSticks,Galio,567,289,278,50.97
FiddleSticks,Kennen,166,72,94,43.37
FiddleSticks,Quinn,238,118,120,49.58
FiddleSticks,Mordekaiser,671,335,336,49.93
FiddleSticks,Aurora,406,201,205,49.51
FiddleSticks,Alistar,245,135,110,55.1
FiddleSticks,Gangplank,227,116,111,51.1
FiddleSticks,MonkeyKing,383,204,179,53.26
FiddleSticks,Rell,254,110,144,43.31
FiddleSticks,Vi,528,262,266,49.62
FiddleSticks,Fizz,362,209,153,57.73
FiddleSticks,Senna,396,170,226,42.93
FiddleSticks,Ornn,277,124,153,44.77
FiddleSticks,Viego,837,460,377,54.96
FiddleSticks,Gnar,226,109,117,48.23
FiddleSticks,Xerath,553,280,273,50.63
FiddleSticks,Renekton,275,141,134,51.27
FiddleSticks,TwistedFate,195,111,84,56.92
FiddleSticks,Sona,207,104,103,50.24
FiddleSticks,Rammus,166,100,66,60.24
FiddleSticks,Anivia,168,94,74,55.95
FiddleSticks,Maokai,260,127,133,48.85
FiddleSticks,Leona,502,249,253,49.6
FiddleSticks,Ziggs,204,96,108,47.06
FiddleSticks,Milio,383,188,195,49.09
FiddleSticks,DrMundo,363,182,181,50.14
FiddleSticks,Kassadin,164,77,87,46.95
FiddleSticks,Hwei,352,145,207,41.19
FiddleSticks,Yuumi,496,248,248,50
FiddleSticks,Kaisa,944,500,444,52.97
FiddleSticks,Nasus,401,207,194,51.62
FiddleSticks,AurelionSol,239,112,127,46.86
FiddleSticks,Bard,195,101,94,51.79
FiddleSticks,Amumu,632,348,284,55.06
FiddleSticks,Rengar,178,101,77,56.74
FiddleSticks,Udyr,225,113,112,50.22
FiddleSticks,Poppy,314,153,161,48.73
FiddleSticks,KSante,345,197,148,57.1
FiddleSticks,Karthus,183,99,84,54.1
FiddleSticks,RekSai,78,40,38,51.28
FiddleSticks,KogMaw,228,110,118,48.25
FiddleSticks,Braum,367,174,193,47.41
FiddleSticks,Heimerdinger,244,111,133,45.49
FiddleSticks,Janna,248,131,117,52.82
FiddleSticks,Xayah,310,141,169,45.48
FiddleSticks,Pyke,442,221,221,50
FiddleSticks,Nunu,331,155,176,46.83
FiddleSticks,Lissandra,187,73,114,39.04
FiddleSticks,Katarina,435,236,199,54.25
FiddleSticks,Belveth,166,84,82,50.6
FiddleSticks,Velkoz,339,175,164,51.62
FiddleSticks,Kled,129,56,73,43.41
FiddleSticks,Neeko,254,137,117,53.94
FiddleSticks,Zoe,221,126,95,57.01
FiddleSticks,Qiyana,131,59,72,45.04
FiddleSticks,Fiora,193,98,95,50.78
FiddleSticks,Zac,327,174,153,53.21
FiddleSticks,Smolder,352,181,171,51.42
FiddleSticks,Shen,342,150,192,43.86
FiddleSticks,Azir,163,85,78,52.15
FiddleSticks,Zilean,225,117,108,52
FiddleSticks,Akshan,186,108,78,58.06
FiddleSticks,Skarner,164,90,74,54.88
FiddleSticks,Vex,293,129,164,44.03
FiddleSticks,Cassiopeia,154,68,86,44.16
FiddleSticks,Illaoi,266,113,153,42.48
FiddleSticks,Rakan,221,125,96,56.56
FiddleSticks,Shyvana,137,61,76,44.53
FiddleSticks,JarvanIV,364,198,166,54.4
FiddleSticks,Aphelios,333,165,168,49.55
FiddleSticks,Swain,547,262,285,47.9
FiddleSticks,Annie,185,102,83,55.14
FiddleSticks,Olaf,178,78,100,43.82
FiddleSticks,Rumble,148,93,55,62.84
FiddleSticks,Jayce,322,153,169,47.52
FiddleSticks,Kalista,115,72,43,62.61
FiddleSticks,Ivern,66,27,39,40.91
FiddleSticks,Renata,97,45,52,46.39
Nilah,Mel,740,466,274,62.97
Nilah,Trundle,187,79,108,42.25
Nilah,Zed,371,212,159,57.14
Nilah,Vayne,480,221,259,46.04
Nilah,Sejuani,155,92,63,59.35
Nilah,Nasus,276,140,136,50.72
Nilah,MasterYi,472,231,241,48.94
Nilah,Sylas,484,254,230,52.48
Nilah,Kaisa,545,296,249,54.31
Nilah,Neeko,181,106,75,58.56
Nilah,Yasuo,756,467,289,61.77
Nilah,Khazix,173,110,63,63.58
Nilah,Lissandra,139,75,64,53.96
Nilah,Lucian,253,178,75,70.36
Nilah,Rell,171,87,84,50.88
Nilah,Garen,625,323,302,51.68
Nilah,Warwick,567,287,280,50.62
Nilah,Fizz,201,107,94,53.23
Nilah,Jinx,1072,507,565,47.29
Nilah,Thresh,427,245,182,57.38
Nilah,Kayle,279,157,122,56.27
Nilah,Volibear,473,252,221,53.28
Nilah,Draven,167,97,70,58.08
Nilah,TahmKench,289,153,136,52.94
Nilah,Ivern,54,30,24,55.56
Nilah,Milio,180,76,104,42.22
Nilah,Gwen,187,108,79,57.75
Nilah,MonkeyKing,264,132,132,50
Nilah,Renata,91,44,47,48.35
Nilah,Ambessa,203,127,76,62.56
Nilah,Teemo,495,233,262,47.07
Nilah,Aurora,240,115,125,47.92
Nilah,Caitlyn,870,463,407,53.22
Nilah,Velkoz,269,138,131,51.3
Nilah,LeeSin,362,186,176,51.38
Nilah,Leblanc,167,90,77,53.89
Nilah,KogMaw,75,44,31,58.67
Nilah,Lulu,433,245,188,56.58
Nilah,FiddleSticks,177,82,95,46.33
Nilah,Camille,127,66,61,51.97
Nilah,Malzahar,444,200,244,45.05
Nilah,Galio,265,143,122,53.96
Nilah,Darius,658,350,308,53.19
Nilah,Nocturne,456,214,242,46.93
Nilah,Akali,355,192,163,54.08
Nilah,Pantheon,569,292,277,51.32
Nilah,Yone,646,376,270,58.2
Nilah,Zeri,126,68,58,53.97
Nilah,Yuumi,284,148,136,52.11
Nilah,Riven,159,102,57,64.15
Nilah,Ziggs,136,61,75,44.85
Nilah,Lux,846,431,415,50.95
Nilah,JarvanIV,203,119,84,58.62
Nilah,AurelionSol,137,64,73,46.72
Nilah,Ashe,634,306,328,48.26
Nilah,Illaoi,174,72,102,41.38
Nilah,Ahri,462,213,249,46.1
Nilah,Sivir,170,81,89,47.65
Nilah,Tryndamere,248,136,112,54.84
Nilah,Shaco,357,185,172,51.82
Nilah,Qiyana,87,51,36,58.62
Nilah,Cassiopeia,105,51,54,48.57
Nilah,Swain,434,204,230,47
Nilah,Yorick,374,184,190,49.2
Nilah,Lillia,230,107,123,46.52
Nilah,Twitch,346,184,162,53.18
Nilah,Alistar,168,80,88,47.62
Nilah,Sett,587,333,254,56.73
Nilah,Viego,543,287,256,52.85
Nilah,Kalista,76,52,24,68.42
Nilah,Braum,186,92,94,49.46
Nilah,Chogath,544,284,260,52.21
Nilah,Ekko,279,136,143,48.75
Nilah,Irelia,268,135,133,50.37
Nilah,Jhin,694,354,340,51.01
Nilah,Rakan,107,50,57,46.73
Nilah,Amumu,422,197,225,46.68
Nilah,Xayah,262,125,137,47.71
Nilah,Jax,322,148,174,45.96
Nilah,Diana,564,278,286,49.29
Nilah,Xerath,263,140,123,53.23
Nilah,Ezreal,774,422,352,54.52
Nilah,Kayn,575,305,270,53.04
Nilah,Sona,119,43,76,36.13
Nilah,Poppy,159,73,86,45.91
Nilah,Orianna,156,73,83,46.79
Nilah,MissFortune,1008,560,448,55.56
Nilah,Elise,249,140,109,56.22
Nilah,Shen,270,134,136,49.63
Nilah,Hwei,248,117,131,47.18
Nilah,Aatrox,282,145,137,51.42
Nilah,RekSai,45,24,21,53.33
Nilah,Smolder,245,152,93,62.04
Nilah,Seraphine,318,140,178,44.03
Nilah,Naafiri,124,92,32,74.19
Nilah,TwistedFate,126,70,56,55.56
Nilah,DrMundo,219,118,101,53.88
Nilah,Tristana,354,190,164,53.67
Nilah,Zoe,127,77,50,60.63
Nilah,Evelynn,124,64,60,51.61
Nilah,Karma,317,167,150,52.68
Nilah,Brand,305,147,158,48.2
Nilah,XinZhao,224,132,92,58.93
Nilah,Mordekaiser,423,222,201,52.48
Nilah,Samira,406,250,156,61.58
Nilah,Olaf,103,73,30,70.87
Nilah,Talon,155,94,61,60.65
Nilah,Nautilus,407,237,170,58.23
Nilah,Nami,416,211,205,50.72
Nilah,Sion,291,169,122,58.08
Nilah,Vladimir,235,146,89,62.13
Nilah,Zyra,279,160,119,57.35
Nilah,Vi,322,198,124,61.49
Nilah,Soraka,189,114,75,60.32
Nilah,Katarina,307,157,150,51.14
Nilah,Annie,79,37,42,46.84
Nilah,Zac,178,91,87,51.12
Nilah,Corki,192,102,90,53.13
Nilah,Vex,213,101,112,47.42
Nilah,Zilean,138,70,68,50.72
Nilah,Syndra,234,126,108,53.85
Nilah,Bard,124,48,76,38.71
Nilah,Akshan,135,78,57,57.78
Nilah,Maokai,189,94,95,49.74
Nilah,Anivia,100,30,70,30
Nilah,Azir,113,54,59,47.79
Nilah,Leona,313,181,132,57.83
Nilah,Varus,256,142,114,55.47
Nilah,Fiora,130,66,64,50.77
Nilah,Gragas,180,99,81,55
Nilah,Morgana,490,249,241,50.82
Nilah,Gnar,107,72,35,67.29
Nilah,Malphite,406,209,197,51.48
Nilah,Aphelios,227,114,113,50.22
Nilah,Senna,245,135,110,55.1
Nilah,Heimerdinger,158,67,91,42.41
Nilah,Gangplank,203,105,98,51.72
Nilah,Taliyah,95,43,52,45.26
Nilah,Ornn,131,65,66,49.62
Nilah,Kindred,150,88,62,58.67
Nilah,Pyke,284,163,121,57.39
Nilah,Urgot,206,104,102,50.49
Nilah,Karthus,123,67,56,54.47
Nilah,Nidalee,78,48,30,61.54
Nilah,Veigar,358,197,161,55.03
Nilah,Udyr,158,107,51,67.72
Nilah,Jayce,131,90,41,68.7
Nilah,Skarner,73,43,30,58.9
Nilah,Rengar,159,97,62,61.01
Nilah,Janna,154,73,81,47.4
Nilah,Graves,196,111,85,56.63
Nilah,Kassadin,51,34,17,66.67
Nilah,Rammus,112,46,66,41.07
Nilah,KSante,158,90,68,56.96
Nilah,Briar,276,136,140,49.28
Nilah,Quinn,120,47,73,39.17
Nilah,Nunu,205,98,107,47.8
Nilah,Belveth,104,63,41,60.58
Nilah,Ryze,100,53,47,53
Nilah,Kennen,69,29,40,42.03
Nilah,Singed,125,68,57,54.4
Nilah,Kled,54,22,32,40.74
Nilah,Viktor,264,160,104,60.61
Nilah,Renekton,158,78,80,49.37
Nilah,Taric,91,58,33,63.74
Nilah,Blitzcrank,215,114,101,53.02
Nilah,Shyvana,95,53,42,55.79
Nilah,Hecarim,119,47,72,39.5
Nilah,Rumble,55,26,29,47.27
Rell,Mel,1230,651,579,52.93
Rell,Trundle,289,129,160,44.64
Rell,Zed,577,286,291,49.57
Rell,Vayne,745,400,345,53.69
Rell,Sejuani,262,142,120,54.2
Rell,Jayce,314,140,174,44.59
Rell,Talon,326,170,156,52.15
Rell,Kennen,115,61,54,53.04
Rell,Lucian,410,193,217,47.07
Rell,Elise,444,235,209,52.93
Rell,DrMundo,303,151,152,49.83
Rell,Rengar,183,82,101,44.81
Rell,Akali,631,332,299,52.61
Rell,Nilah,171,84,87,49.12
Rell,Shen,379,213,166,56.2
Rell,Graves,384,182,202,47.4
Rell,Veigar,526,242,284,46.01
Rell,Caitlyn,1552,788,764,50.77
Rell,Sett,890,430,460,48.31
Rell,Pantheon,944,487,457,51.59
Rell,Ahri,722,390,332,54.02
Rell,MissFortune,1187,566,621,47.68
Rell,Nami,567,303,264,53.44
Rell,Riven,308,157,151,50.97
Rell,Kayn,765,386,379,50.46
Rell,Kaisa,894,461,433,51.57
Rell,Hwei,374,206,168,55.08
Rell,Milio,318,165,153,51.89
Rell,Viego,856,478,378,55.84
Rell,Malzahar,644,312,332,48.45
Rell,Twitch,477,287,190,60.17
Rell,Pyke,478,250,228,52.3
Rell,Mordekaiser,656,293,363,44.66
Rell,TwistedFate,201,128,73,63.68
Rell,Ziggs,206,91,115,44.17
Rell,Janna,291,142,149,48.8
Rell,Irelia,519,261,258,50.29
Rell,Lillia,379,190,189,50.13
Rell,Qiyana,133,79,54,59.4
Rell,Warwick,843,425,418,50.42
Rell,Taliyah,202,95,107,47.03
Rell,Poppy,438,207,231,47.26
Rell,Gangplank,253,119,134,47.04
Rell,Yone,1018,527,491,51.77
Rell,Leona,553,294,259,53.16
Rell,Vex,285,136,149,47.72
Rell,Jinx,1568,762,806,48.6
Rell,Lux,1366,640,726,46.85
Rell,Malphite,613,337,276,54.98
Rell,Amumu,541,269,272,49.72
Rell,Jhin,1077,538,539,49.95
Rell,Brand,372,177,195,47.58
Rell,Ambessa,338,196,142,57.99
Rell,Ryze,228,116,112,50.88
Rell,Karma,676,329,347,48.67
Rell,Darius,1002,546,456,54.49
Rell,Volibear,628,331,297,52.71
Rell,Neeko,259,135,124,52.12
Rell,Udyr,191,109,82,57.07
Rell,Ezreal,1452,804,648,55.37
Rell,Garen,801,399,402,49.81
Rell,Briar,361,181,180,50.14
Rell,Ekko,472,247,225,52.33
Rell,Viktor,516,257,259,49.81
Rell,Nunu,315,146,169,46.35
Rell,Thresh,848,436,412,51.42
Rell,Galio,508,275,233,54.13
Rell,Soraka,285,153,132,53.68
Rell,Tryndamere,295,150,145,50.85
Rell,Zyra,540,239,301,44.26
Rell,Gragas,329,200,129,60.79
Rell,Naafiri,126,60,66,47.62
Rell,Lulu,747,387,360,51.81
Rell,Sylas,844,450,394,53.32
Rell,Ashe,1144,580,564,50.7
Rell,Yuumi,509,279,230,54.81
Rell,Yasuo,1083,568,515,52.45
Rell,Nautilus,680,361,319,53.09
Rell,Nasus,361,164,197,45.43
Rell,Orianna,257,107,150,41.63
Rell,Aatrox,605,333,272,55.04
Rell,FiddleSticks,254,144,110,56.69
Rell,Teemo,619,288,331,46.53
Rell,Diana,939,436,503,46.43
Rell,AurelionSol,234,114,120,48.72
Rell,Draven,252,130,122,51.59
Rell,Maokai,276,132,144,47.83
Rell,Nocturne,781,350,431,44.81
Rell,Lissandra,213,109,104,51.17
Rell,MasterYi,618,318,300,51.46
Rell,Quinn,241,129,112,53.53
Rell,Rammus,166,89,77,53.61
Rell,Zoe,211,117,94,55.45
Rell,Aphelios,345,169,176,48.99
Rell,Zac,320,145,175,45.31
Rell,Swain,531,226,305,42.56
Rell,Shyvana,134,73,61,54.48
Rell,Ornn,247,122,125,49.39
Rell,Olaf,139,76,63,54.68
Rell,Evelynn,171,92,79,53.8
Rell,Heimerdinger,204,104,100,50.98
Rell,Tristana,626,318,308,50.8
Rell,Khazix,305,142,163,46.56
Rell,Katarina,411,224,187,54.5
Rell,JarvanIV,351,190,161,54.13
Rell,Smolder,384,203,181,52.86
Rell,Velkoz,391,171,220,43.73
Rell,LeeSin,843,442,401,52.43
Rell,Varus,497,265,232,53.32
Rell,TahmKench,498,262,236,52.61
Rell,Kindred,241,133,108,55.19
Rell,Illaoi,244,104,140,42.62
Rell,Karthus,210,99,111,47.14
Rell,Xayah,301,125,176,41.53
Rell,Leblanc,309,161,148,52.1
Rell,Taric,126,58,68,46.03
Rell,Singed,185,76,109,41.08
Rell,XinZhao,356,191,165,53.65
Rell,Zeri,245,127,118,51.84
Rell,MonkeyKing,358,182,176,50.84
Rell,Morgana,655,302,353,46.11
Rell,Samira,371,197,174,53.1
Rell,Aurora,400,202,198,50.5
Rell,Braum,390,191,199,48.97
Rell,Renekton,302,126,176,41.72
Rell,Fizz,279,136,143,48.75
Rell,Yorick,565,252,313,44.6
Rell,Rakan,255,143,112,56.08
Rell,Chogath,598,287,311,47.99
Rell,Blitzcrank,370,192,178,51.89
Rell,Renata,99,61,38,61.62
Rell,Belveth,154,81,73,52.6
Rell,Fiora,193,109,84,56.48
Rell,KogMaw,170,77,93,45.29
Rell,Shaco,464,236,228,50.86
Rell,Vladimir,366,204,162,55.74
Rell,Jax,584,288,296,49.32
Rell,Senna,395,172,223,43.54
Rell,Camille,209,121,88,57.89
Rell,Xerath,459,239,220,52.07
Rell,Nidalee,185,113,72,61.08
Rell,Cassiopeia,165,80,85,48.48
Rell,Zilean,168,83,85,49.4
Rell,Gnar,232,117,115,50.43
Rell,KSante,388,215,173,55.41
Rell,Azir,238,131,107,55.04
Rell,Alistar,394,195,199,49.49
Rell,Kayle,349,154,195,44.13
Rell,Syndra,395,177,218,44.81
Rell,Urgot,286,159,127,55.59
Rell,Sona,178,90,88,50.56
Rell,Akshan,183,86,97,46.99
Rell,Vi,556,286,270,51.44
Rell,Seraphine,372,196,176,52.69
Rell,Kled,118,69,49,58.47
Rell,Kalista,103,53,50,51.46
Rell,Ivern,83,39,44,46.99
Rell,Sivir,267,134,133,50.19
Rell,Kassadin,131,85,46,64.89
Rell,Corki,334,167,167,50
Rell,Skarner,159,103,56,64.78
Rell,Anivia,215,110,105,51.16
Rell,Gwen,302,154,148,50.99
Rell,Bard,173,97,76,56.07
Rell,Sion,384,175,209,45.57
Rell,Annie,137,57,80,41.61
Rell,Hecarim,264,113,151,42.8
Rell,RekSai,74,40,34,54.05
Rell,Rumble,199,113,86,56.78
Trundle,Teemo,886,458,428,51.69
Trundle,FiddleSticks,326,142,184,43.56
Trundle,Yone,1390,737,653,53.02
Trundle,Nilah,187,108,79,57.75
Trundle,Rell,289,160,129,55.36
Trundle,Darius,1327,717,610,54.03
Trundle,Amumu,821,417,404,50.79
Trundle,Aurora,510,271,239,53.14
Trundle,Lux,1877,945,932,50.35
Trundle,Seraphine,537,263,274,48.98
Trundle,Volibear,1038,580,458,55.88
Trundle,Yorick,846,385,461,45.51
Trundle,Zoe,252,113,139,44.84
Trundle,Samira,521,284,237,54.51
Trundle,Pantheon,1011,460,551,45.5
Trundle,Khazix,276,157,119,56.88
Trundle,Zed,675,348,327,51.56
Trundle,Aphelios,307,175,132,57
Trundle,Pyke,572,324,248,56.64
Trundle,Gwen,367,192,175,52.32
Trundle,LeeSin,827,441,386,53.33
Trundle,Akali,777,406,371,52.25
Trundle,KogMaw,230,114,116,49.57
Trundle,Thresh,834,393,441,47.12
Trundle,Renekton,356,169,187,47.47
Trundle,Gragas,402,184,218,45.77
Trundle,Yasuo,1491,748,743,50.17
Trundle,Kaisa,1074,538,536,50.09
Trundle,Nautilus,733,397,336,54.16
Trundle,Veigar,708,344,364,48.59
Trundle,Ashe,1442,752,690,52.15
Trundle,Lulu,737,406,331,55.09
Trundle,Malphite,752,385,367,51.2
Trundle,Ekko,649,347,302,53.47
Trundle,Mel,1422,801,621,56.33
Trundle,Caitlyn,2031,1029,1002,50.66
Trundle,Diana,1143,626,517,54.77
Trundle,Fizz,420,198,222,47.14
Trundle,Draven,327,192,135,58.72
Trundle,DrMundo,475,277,198,58.32
Trundle,MasterYi,869,476,393,54.78
Trundle,Irelia,589,331,258,56.2
Trundle,MissFortune,1788,927,861,51.85
Trundle,Warwick,1380,642,738,46.52
Trundle,Udyr,244,144,100,59.02
Trundle,Vladimir,393,191,202,48.6
Trundle,Jinx,2013,912,1101,45.31
Trundle,Milio,397,199,198,50.13
Trundle,Lillia,387,217,170,56.07
Trundle,Ezreal,1527,798,729,52.26
Trundle,Yuumi,525,261,264,49.71
Trundle,Garen,1238,550,688,44.43
Trundle,Sylas,847,424,423,50.06
Trundle,Zilean,191,78,113,40.84
Trundle,Kayn,1064,505,559,47.46
Trundle,Katarina,525,272,253,51.81
Trundle,Sivir,398,207,191,52.01
Trundle,Aatrox,501,272,229,54.29
Trundle,Rengar,172,106,66,61.63
Trundle,Neeko,308,152,156,49.35
Trundle,Viego,1007,530,477,52.63
Trundle,AurelionSol,330,174,156,52.73
Trundle,Xayah,308,173,135,56.17
Trundle,Swain,734,367,367,50
Trundle,Mordekaiser,1050,502,548,47.81
Trundle,XinZhao,461,246,215,53.36
Trundle,Singed,204,105,99,51.47
Trundle,Graves,360,164,196,45.56
Trundle,Viktor,541,291,250,53.79
Trundle,Senna,511,259,252,50.68
Trundle,Poppy,413,184,229,44.55
Trundle,Karthus,174,89,85,51.15
Trundle,Ahri,852,468,384,54.93
Trundle,Zeri,269,138,131,51.3
Trundle,Shaco,725,393,332,54.21
Trundle,Kayle,417,219,198,52.52
Trundle,Sejuani,284,160,124,56.34
Trundle,Nami,601,301,300,50.08
Trundle,Heimerdinger,372,191,181,51.34
Trundle,Karma,749,371,378,49.53
Trundle,Brand,611,312,299,51.06
Trundle,Vi,587,312,275,53.15
Trundle,Morgana,886,445,441,50.23
Trundle,Sett,1045,538,507,51.48
Trundle,Leblanc,376,199,177,52.93
Trundle,Lucian,495,279,216,56.36
Trundle,Alistar,262,130,132,49.62
Trundle,Nunu,387,179,208,46.25
Trundle,Ryze,204,101,103,49.51
Trundle,Taric,159,83,76,52.2
Trundle,Urgot,388,216,172,55.67
Trundle,Elise,387,204,183,52.71
Trundle,Nasus,640,289,351,45.16
Trundle,Renata,89,50,39,56.18
Trundle,Jhin,1434,724,710,50.49
Trundle,Gnar,249,114,135,45.78
Trundle,Jax,780,373,407,47.82
Trundle,JarvanIV,334,176,158,52.69
Trundle,Varus,580,309,271,53.28
Trundle,Ambessa,342,179,163,52.34
Trundle,Nocturne,923,380,543,41.17
Trundle,Qiyana,149,86,63,57.72
Trundle,Orianna,269,140,129,52.04
Trundle,Cassiopeia,201,86,115,42.79
Trundle,Velkoz,366,170,196,46.45
Trundle,Chogath,885,451,434,50.96
Trundle,Xerath,702,343,359,48.86
Trundle,Tristana,632,308,324,48.73
Trundle,Soraka,408,225,183,55.15
Trundle,Sion,613,340,273,55.46
Trundle,Evelynn,254,131,123,51.57
Trundle,Zac,256,121,135,47.27
Trundle,Syndra,453,218,235,48.12
Trundle,Vex,345,156,189,45.22
Trundle,Ziggs,272,129,143,47.43
Trundle,Hwei,452,217,235,48.01
Trundle,Riven,289,167,122,57.79
Trundle,MonkeyKing,454,214,240,47.14
Trundle,Taliyah,161,76,85,47.2
Trundle,Janna,161,75,86,46.58
Trundle,Rammus,292,137,155,46.92
Trundle,Lissandra,296,153,143,51.69
Trundle,Malzahar,821,422,399,51.4
Trundle,Anivia,236,108,128,45.76
Trundle,TahmKench,657,318,339,48.4
Trundle,Corki,232,120,112,51.72
Trundle,Zyra,626,309,317,49.36
Trundle,Annie,217,118,99,54.38
Trundle,Blitzcrank,500,269,231,53.8
Trundle,Smolder,446,230,216,51.57
Trundle,Vayne,853,421,432,49.36
Trundle,Gangplank,312,181,131,58.01
Trundle,Fiora,218,93,125,42.66
Trundle,Ornn,316,166,150,52.53
Trundle,Briar,574,270,304,47.04
Trundle,RekSai,80,40,40,50
Trundle,Twitch,574,319,255,55.57
Trundle,Illaoi,414,210,204,50.72
Trundle,Kennen,141,66,75,46.81
Trundle,Leona,602,300,302,49.83
Trundle,Rumble,109,49,60,44.95
Trundle,Rakan,280,160,120,57.14
Trundle,Tryndamere,437,216,221,49.43
Trundle,Bard,184,100,84,54.35
Trundle,Naafiri,238,115,123,48.32
Trundle,Camille,178,58,120,32.58
Trundle,Kalista,175,78,97,44.57
Trundle,Nidalee,168,75,93,44.64
Trundle,Galio,619,361,258,58.32
Trundle,Braum,378,192,186,50.79
Trundle,Hecarim,301,162,139,53.82
Trundle,Kindred,334,173,161,51.8
Trundle,Shen,436,217,219,49.77
Trundle,Shyvana,158,74,84,46.84
Trundle,Azir,242,111,131,45.87
Trundle,KSante,321,204,117,63.55
Trundle,TwistedFate,260,126,134,48.46
Trundle,Olaf,231,118,113,51.08
Trundle,Kassadin,154,85,69,55.19
Trundle,Maokai,273,127,146,46.52
Trundle,Skarner,160,88,72,55
Trundle,Talon,361,139,222,38.5
Trundle,Akshan,239,149,90,62.34
Trundle,Belveth,173,94,79,54.34
Trundle,Jayce,248,124,124,50
Trundle,Quinn,176,101,75,57.39
Trundle,Ivern,99,54,45,54.55
Trundle,Sona,213,84,129,39.44
Trundle,Kled,120,59,61,49.17
Zed,Teemo,1742,770,972,44.2
Zed,FiddleSticks,716,343,373,47.91
Zed,Yone,2502,1267,1235,50.64
Zed,Nilah,371,159,212,42.86
Zed,Rell,577,291,286,50.43
Zed,Gwen,606,318,288,52.48
Zed,Skarner,311,177,134,56.91
Zed,DrMundo,729,344,385,47.19
Zed,Samira,988,509,479,51.52
Zed,Malphite,1907,820,1087,43
Zed,Rengar,439,218,221,49.66
Zed,Zilean,499,240,259,48.1
Zed,Ashe,2658,1266,1392,47.63
Zed,Thresh,1817,861,956,47.39
Zed,Ambessa,932,496,436,53.22
Zed,Ekko,1642,767,875,46.71
Zed,Yasuo,3270,1550,1720,47.4
Zed,Veigar,1288,724,564,56.21
Zed,Pyke,1113,545,568,48.97
Zed,Trundle,675,327,348,48.44
Zed,Hwei,745,385,360,51.68
Zed,Twitch,1138,518,620,45.52
Zed,Milio,802,348,454,43.39
Zed,Irelia,1278,626,652,48.98
Zed,Diana,2472,1174,1298,47.49
Zed,Fizz,979,486,493,49.64
Zed,Vayne,1772,873,899,49.27
Zed,Yuumi,1086,551,535,50.74
Zed,Tryndamere,736,365,371,49.59
Zed,Amumu,1273,585,688,45.95
Zed,Vex,696,355,341,51.01
Zed,Jinx,3707,1768,1939,47.69
Zed,Mel,2463,1262,1201,51.24
Zed,Darius,2482,1130,1352,45.53
Zed,Vladimir,1019,517,502,50.74
Zed,Morgana,1615,728,887,45.08
Zed,Talon,952,458,494,48.11
Zed,Viktor,1102,548,554,49.73
Zed,Caitlyn,3873,1849,2024,47.74
Zed,Soraka,724,346,378,47.79
Zed,Shyvana,265,118,147,44.53
Zed,Jhin,2893,1466,1427,50.67
Zed,Mordekaiser,1665,789,876,47.39
Zed,Alistar,594,265,329,44.61
Zed,Jax,1197,609,588,50.88
Zed,Kayn,2168,1039,1129,47.92
Zed,Zeri,554,315,239,56.86
Zed,Nocturne,1796,862,934,48
Zed,Nasus,840,392,448,46.67
Zed,Lillia,622,320,302,51.45
Zed,Kaisa,2411,1191,1220,49.4
Zed,Neeko,534,239,295,44.76
Zed,Kayle,818,372,446,45.48
Zed,LeeSin,2422,1212,1210,50.04
Zed,Karma,1731,836,895,48.3
Zed,Naafiri,341,181,160,53.08
Zed,MasterYi,1719,791,928,46.02
Zed,Akali,1674,857,817,51.19
Zed,Zyra,1295,637,658,49.19
Zed,Shaco,1386,708,678,51.08
Zed,Gragas,803,430,373,53.55
Zed,Lulu,1771,875,896,49.41
Zed,Garen,2310,1071,1239,46.36
Zed,Warwick,1844,881,963,47.78
Zed,Sett,1885,961,924,50.98
Zed,Katarina,1131,549,582,48.54
Zed,Aphelios,606,265,341,43.73
Zed,Poppy,823,402,421,48.85
Zed,Gnar,553,273,280,49.37
Zed,Ahri,1567,754,813,48.12
Zed,Varus,1224,653,571,53.35
Zed,Renata,217,131,86,60.37
Zed,Orianna,492,246,246,50
Zed,Kalista,341,167,174,48.97
Zed,Brand,974,521,453,53.49
Zed,KSante,732,371,361,50.68
Zed,Swain,1295,622,673,48.03
Zed,TahmKench,1072,535,537,49.91
Zed,Ziggs,480,265,215,55.21
Zed,Lux,3553,1727,1826,48.61
Zed,Galio,1023,492,531,48.09
Zed,Viego,2059,1049,1010,50.95
Zed,Malzahar,1654,819,835,49.52
Zed,Draven,674,313,361,46.44
Zed,Rakan,540,281,259,52.04
Zed,Vi,1361,628,733,46.14
Zed,Ezreal,3447,1720,1727,49.9
Zed,Nautilus,1449,701,748,48.38
Zed,KogMaw,314,133,181,42.36
Zed,Khazix,723,364,359,50.35
Zed,Corki,511,232,279,45.4
Zed,Nidalee,377,208,169,55.17
Zed,Ornn,565,256,309,45.31
Zed,Syndra,867,444,423,51.21
Zed,Pantheon,2200,1024,1176,46.55
Zed,Jayce,662,313,349,47.28
Zed,MissFortune,3039,1400,1639,46.07
Zed,JarvanIV,769,340,429,44.21
Zed,Briar,964,471,493,48.86
Zed,Xayah,675,344,331,50.96
Zed,Renekton,665,334,331,50.23
Zed,Evelynn,472,236,236,50
Zed,Quinn,558,256,302,45.88
Zed,Lissandra,761,339,422,44.55
Zed,Chogath,1524,703,821,46.13
Zed,Shen,826,428,398,51.82
Zed,Riven,713,321,392,45.02
Zed,Aurora,921,451,470,48.97
Zed,Seraphine,879,406,473,46.19
Zed,Volibear,1549,799,750,51.58
Zed,Urgot,573,279,294,48.69
Zed,Leona,1108,581,527,52.44
Zed,Xerath,1214,632,582,52.06
Zed,Nunu,623,302,321,48.48
Zed,Lucian,1002,542,460,54.09
Zed,Rammus,503,224,279,44.53
Zed,TwistedFate,485,229,256,47.22
Zed,Nami,1347,623,724,46.25
Zed,Hecarim,690,318,372,46.09
Zed,Sylas,2097,1001,1096,47.73
Zed,Kindred,550,248,302,45.09
Zed,Leblanc,938,470,468,50.11
Zed,Maokai,622,307,315,49.36
Zed,Illaoi,640,360,280,56.25
Zed,Kennen,392,215,177,54.85
Zed,XinZhao,956,437,519,45.71
Zed,Zac,600,297,303,49.5
Zed,Blitzcrank,987,499,488,50.56
Zed,Sion,1077,484,593,44.94
Zed,Sejuani,519,253,266,48.75
Zed,AurelionSol,383,196,187,51.17
Zed,Senna,971,486,485,50.05
Zed,Graves,891,439,452,49.27
Zed,Yorick,1152,523,629,45.4
Zed,Zoe,454,221,233,48.68
Zed,Velkoz,763,404,359,52.95
Zed,Cassiopeia,399,184,215,46.12
Zed,Tristana,1319,636,683,48.22
Zed,Taliyah,244,135,109,55.33
Zed,MonkeyKing,845,346,499,40.95
Zed,Gangplank,680,293,387,43.09
Zed,Azir,403,215,188,53.35
Zed,Qiyana,411,216,195,52.55
Zed,Janna,456,209,247,45.83
Zed,Aatrox,1237,595,642,48.1
Zed,Singed,378,164,214,43.39
Zed,Karthus,377,189,188,50.13
Zed,Elise,971,485,486,49.95
Zed,Smolder,819,439,380,53.6
Zed,Rumble,369,193,176,52.3
Zed,Anivia,449,210,239,46.77
Zed,Braum,776,356,420,45.88
Zed,RekSai,152,84,68,55.26
Zed,Sivir,747,409,338,54.75
Zed,Taric,320,142,178,44.38
Zed,Camille,490,231,259,47.14
Zed,Ryze,451,206,245,45.68
Zed,Fiora,508,240,268,47.24
Zed,Sona,355,161,194,45.35
Zed,Heimerdinger,638,303,335,47.49
Zed,Ivern,221,118,103,53.39
Zed,Bard,351,172,179,49
Zed,Kassadin,186,107,79,57.53
Zed,Kled,221,105,116,47.51
Zed,Udyr,545,270,275,49.54
Zed,Annie,495,253,242,51.11
Zed,Olaf,296,147,149,49.66
Zed,Akshan,487,205,282,42.09
Zed,Belveth,267,145,122,54.31
Gangplank,Garen,811,365,446,45.01
Gangplank,Sejuani,260,109,151,41.92
Gangplank,Katarina,435,196,239,45.06
Gangplank,Varus,466,226,240,48.5
Gangplank,Yuumi,439,224,215,51.03
Gangplank,Pantheon,951,493,458,51.84
Gangplank,Evelynn,175,87,88,49.71
Gangplank,Ekko,581,303,278,52.15
Gangplank,Jinx,1530,739,791,48.3
Gangplank,Zyra,599,281,318,46.91
Gangplank,Darius,998,499,499,50
Gangplank,Volibear,579,293,286,50.6
Gangplank,Akali,565,279,286,49.38
Gangplank,Lux,1345,633,712,47.06
Gangplank,Teemo,704,374,330,53.13
Gangplank,Khazix,272,123,149,45.22
Gangplank,Milio,384,167,217,43.49
Gangplank,Jhin,1207,613,594,50.79
Gangplank,Nautilus,600,306,294,51
Gangplank,Kayle,449,183,266,40.76
Gangplank,Nasus,285,149,136,52.28
Gangplank,Anivia,190,91,99,47.89
Gangplank,KogMaw,211,111,100,52.61
Gangplank,Nami,600,297,303,49.5
Gangplank,Sett,727,330,397,45.39
Gangplank,Rengar,239,99,140,41.42
Gangplank,Aurora,428,219,209,51.17
Gangplank,Aphelios,323,137,186,42.41
Gangplank,Bard,201,114,87,56.72
Gangplank,Jax,499,240,259,48.1
Gangplank,Rammus,159,84,75,52.83
Gangplank,Viktor,528,323,205,61.17
Gangplank,Soraka,343,145,198,42.27
Gangplank,Camille,163,104,59,63.8
Gangplank,Kayn,785,405,380,51.59
Gangplank,Yasuo,1157,560,597,48.4
Gangplank,Caitlyn,1484,714,770,48.11
Gangplank,DrMundo,300,135,165,45
Gangplank,Lillia,273,141,132,51.65
Gangplank,Ezreal,1564,790,774,50.51
Gangplank,KSante,277,151,126,54.51
Gangplank,Diana,921,417,504,45.28
Gangplank,Ahri,780,401,379,51.41
Gangplank,Lulu,830,437,393,52.65
Gangplank,Taliyah,138,61,77,44.2
Gangplank,Leblanc,373,179,194,47.99
Gangplank,Sona,202,98,104,48.51
Gangplank,Shaco,530,265,265,50
Gangplank,Irelia,566,266,300,47
Gangplank,Karma,791,397,394,50.19
Gangplank,LeeSin,1016,505,511,49.7
Gangplank,TwistedFate,259,115,144,44.4
Gangplank,Samira,335,169,166,50.45
Gangplank,Mel,1074,520,554,48.42
Gangplank,Ornn,259,133,126,51.35
Gangplank,Nocturne,788,337,451,42.77
Gangplank,MissFortune,1136,573,563,50.44
Gangplank,Seraphine,362,205,157,56.63
Gangplank,Ambessa,368,203,165,55.16
Gangplank,Velkoz,310,159,151,51.29
Gangplank,Ryze,208,73,135,35.1
Gangplank,Ashe,1142,567,575,49.65
Gangplank,Malphite,539,257,282,47.68
Gangplank,MasterYi,537,272,265,50.65
Gangplank,Fizz,357,168,189,47.06
Gangplank,Malzahar,618,267,351,43.2
Gangplank,Vi,561,300,261,53.48
Gangplank,Renekton,232,128,104,55.17
Gangplank,Rell,253,134,119,52.96
Gangplank,Urgot,296,134,162,45.27
Gangplank,Veigar,495,245,250,49.49
Gangplank,Senna,349,170,179,48.71
Gangplank,Warwick,722,361,361,50
Gangplank,Kennen,179,96,83,53.63
Gangplank,Kaisa,1048,546,502,52.1
Gangplank,Janna,234,92,142,39.32
Gangplank,Gnar,259,134,125,51.74
Gangplank,Orianna,277,145,132,52.35
Gangplank,Riven,269,121,148,44.98
Gangplank,Mordekaiser,653,286,367,43.8
Gangplank,Tristana,559,280,279,50.09
Gangplank,Rumble,168,81,87,48.21
Gangplank,Pyke,465,216,249,46.45
Gangplank,Udyr,182,80,102,43.96
Gangplank,Lucian,443,233,210,52.6
Gangplank,Gwen,281,145,136,51.6
Gangplank,Tryndamere,324,150,174,46.3
Gangplank,Leona,426,220,206,51.64
Gangplank,Kled,122,66,56,54.1
Gangplank,Karthus,202,113,89,55.94
Gangplank,Qiyana,90,39,51,43.33
Gangplank,Gragas,327,154,173,47.09
Gangplank,Singed,164,86,78,52.44
Gangplank,Viego,873,415,458,47.54
Gangplank,TahmKench,349,183,166,52.44
Gangplank,Talon,374,205,169,54.81
Gangplank,Maokai,263,143,120,54.37
Gangplank,Zilean,187,88,99,47.06
Gangplank,Braum,310,150,160,48.39
Gangplank,Yone,1060,517,543,48.77
Gangplank,Kindred,247,129,118,52.23
Gangplank,Vayne,686,376,310,54.81
Gangplank,Sion,403,214,189,53.1
Gangplank,Shyvana,121,56,65,46.28
Gangplank,Draven,301,177,124,58.8
Gangplank,Zac,263,137,126,52.09
Gangplank,Vex,262,144,118,54.96
Gangplank,Sivir,355,189,166,53.24
Gangplank,Quinn,260,142,118,54.62
Gangplank,Galio,478,220,258,46.03
Gangplank,Swain,426,205,221,48.12
Gangplank,Xayah,254,110,144,43.31
Gangplank,Neeko,265,114,151,43.02
Gangplank,Hwei,354,159,195,44.92
Gangplank,Xerath,497,240,257,48.29
Gangplank,MonkeyKing,417,235,182,56.35
Gangplank,Syndra,327,163,164,49.85
Gangplank,Heimerdinger,256,130,126,50.78
Gangplank,Zed,680,387,293,56.91
Gangplank,Thresh,719,337,382,46.87
Gangplank,Brand,310,145,165,46.77
Gangplank,Ziggs,197,92,105,46.7
Gangplank,JarvanIV,384,201,183,52.34
Gangplank,Elise,407,202,205,49.63
Gangplank,Aatrox,770,386,384,50.13
Gangplank,FiddleSticks,227,111,116,48.9
Gangplank,Illaoi,207,89,118,43
Gangplank,Ivern,72,31,41,43.06
Gangplank,Shen,346,203,143,58.67
Gangplank,Rakan,216,126,90,58.33
Gangplank,Twitch,460,223,237,48.48
Gangplank,Trundle,312,131,181,41.99
Gangplank,Corki,234,119,115,50.85
Gangplank,Amumu,446,192,254,43.05
Gangplank,Morgana,664,369,295,55.57
Gangplank,Poppy,340,202,138,59.41
Gangplank,Chogath,638,286,352,44.83
Gangplank,Taric,134,58,76,43.28
Gangplank,Vladimir,450,237,213,52.67
Gangplank,Sylas,885,466,419,52.66
Gangplank,Cassiopeia,155,65,90,41.94
Gangplank,XinZhao,404,175,229,43.32
Gangplank,Akshan,218,110,108,50.46
Gangplank,Kassadin,126,74,52,58.73
Gangplank,Graves,445,240,205,53.93
Gangplank,Yorick,516,271,245,52.52
Gangplank,Briar,392,238,154,60.71
Gangplank,Fiora,196,96,100,48.98
Gangplank,AurelionSol,184,96,88,52.17
Gangplank,Jayce,388,220,168,56.7
Gangplank,Alistar,257,145,112,56.42
Gangplank,Blitzcrank,419,197,222,47.02
Gangplank,Zeri,254,102,152,40.16
Gangplank,Smolder,293,149,144,50.85
Gangplank,Kalista,106,43,63,40.57
Gangplank,Skarner,164,81,83,49.39
Gangplank,Nunu,269,142,127,52.79
Gangplank,Renata,101,44,57,43.56
Gangplank,Azir,227,103,124,45.37
Gangplank,Naafiri,160,82,78,51.25
Gangplank,Hecarim,303,149,154,49.17
Gangplank,Nidalee,164,71,93,43.29
Gangplank,RekSai,79,40,39,50.63
Gangplank,Nilah,203,98,105,48.28
Gangplank,Olaf,125,45,80,36
Gangplank,Annie,166,82,84,49.4
Gangplank,Belveth,136,74,62,54.41
Gangplank,Zoe,244,113,131,46.31
Gangplank,Lissandra,155,80,75,51.61
Evelynn,Garen,596,287,309,48.15
Evelynn,Sejuani,159,80,79,50.31
Evelynn,Katarina,328,179,149,54.57
Evelynn,Varus,318,150,168,47.17
Evelynn,Yuumi,354,184,170,51.98
Evelynn,Gangplank,175,88,87,50.29
Evelynn,Kayn,627,315,312,50.24
Evelynn,Mel,809,433,376,53.52
Evelynn,MissFortune,1003,476,527,47.46
Evelynn,Thresh,478,232,246,48.54
Evelynn,Gnar,212,94,118,44.34
Evelynn,Zyra,428,200,228,46.73
Evelynn,Azir,125,54,71,43.2
Evelynn,Nautilus,449,225,224,50.11
Evelynn,Ambessa,295,153,142,51.86
Evelynn,XinZhao,217,115,102,53
Evelynn,Vladimir,250,112,138,44.8
Evelynn,Ezreal,954,528,426,55.35
Evelynn,Karma,504,281,223,55.75
Evelynn,Volibear,518,256,262,49.42
Evelynn,Fizz,275,118,157,42.91
Evelynn,Aphelios,256,117,139,45.7
Evelynn,Rumble,135,88,47,65.19
Evelynn,Amumu,439,199,240,45.33
Evelynn,Yasuo,775,380,395,49.03
Evelynn,Jinx,1160,589,571,50.78
Evelynn,Lulu,576,277,299,48.09
Evelynn,Irelia,355,173,182,48.73
Evelynn,Briar,300,170,130,56.67
Evelynn,Vayne,498,244,254,49
Evelynn,Pyke,319,147,172,46.08
Evelynn,Tryndamere,214,99,115,46.26
Evelynn,Rengar,140,93,47,66.43
Evelynn,Viktor,392,225,167,57.4
Evelynn,Caitlyn,1218,579,639,47.54
Evelynn,Lux,1054,531,523,50.38
Evelynn,TahmKench,367,205,162,55.86
Evelynn,Malzahar,406,185,221,45.57
Evelynn,Rakan,184,70,114,38.04
Evelynn,Talon,239,107,132,44.77
Evelynn,Diana,708,318,390,44.92
Evelynn,Akshan,140,74,66,52.86
Evelynn,Velkoz,282,149,133,52.84
Evelynn,LeeSin,542,276,266,50.92
Evelynn,Ahri,570,267,303,46.84
Evelynn,Renata,59,28,31,47.46
Evelynn,Teemo,528,222,306,42.05
Evelynn,Morgana,507,264,243,52.07
Evelynn,KSante,196,103,93,52.55
Evelynn,Swain,352,141,211,40.06
Evelynn,RekSai,25,11,14,44
Evelynn,Malphite,393,200,193,50.89
Evelynn,Aatrox,354,196,158,55.37
Evelynn,Jax,387,196,191,50.65
Evelynn,Cassiopeia,138,57,81,41.3
Evelynn,Samira,307,166,141,54.07
Evelynn,Mordekaiser,529,262,267,49.53
Evelynn,Lillia,230,106,124,46.09
Evelynn,Tristana,406,200,206,49.26
Evelynn,Smolder,204,111,93,54.41
Evelynn,Kayle,302,139,163,46.03
Evelynn,Kassadin,84,37,47,44.05
Evelynn,Xayah,220,104,116,47.27
Evelynn,Shen,244,119,125,48.77
Evelynn,Brand,335,159,176,47.46
Evelynn,MonkeyKing,275,133,142,48.36
Evelynn,Alistar,170,80,90,47.06
Evelynn,Olaf,78,38,40,48.72
Evelynn,Veigar,513,251,262,48.93
Evelynn,Kaisa,621,341,280,54.91
Evelynn,Camille,122,69,53,56.56
Evelynn,Khazix,240,138,102,57.5
Evelynn,Akali,431,200,231,46.4
Evelynn,Ashe,842,426,416,50.59
Evelynn,Zed,472,236,236,50
Evelynn,Leona,315,166,149,52.7
Evelynn,Riven,201,109,92,54.23
Evelynn,Milio,245,110,135,44.9
Evelynn,Darius,722,350,372,48.48
Evelynn,Xerath,358,189,169,52.79
Evelynn,Sona,121,61,60,50.41
Evelynn,Nasus,307,172,135,56.03
Evelynn,Warwick,677,328,349,48.45
Evelynn,Braum,252,142,110,56.35
Evelynn,DrMundo,263,117,146,44.49
Evelynn,Qiyana,92,45,47,48.91
Evelynn,Yorick,390,189,201,48.46
Evelynn,FiddleSticks,135,60,75,44.44
Evelynn,Vex,245,112,133,45.71
Evelynn,Heimerdinger,206,100,106,48.54
Evelynn,Chogath,518,231,287,44.59
Evelynn,Nami,462,213,249,46.1
Evelynn,Maokai,178,99,79,55.62
Evelynn,Karthus,114,48,66,42.11
Evelynn,Galio,340,160,180,47.06
Evelynn,Yone,789,414,375,52.47
Evelynn,Ziggs,145,56,89,38.62
Evelynn,Trundle,254,123,131,48.43
Evelynn,Lissandra,134,67,67,50
Evelynn,Aurora,314,154,160,49.04
Evelynn,Sivir,224,86,138,38.39
Evelynn,Zilean,131,54,77,41.22
Evelynn,Sylas,534,291,243,54.49
Evelynn,Shaco,427,269,158,63
Evelynn,Taliyah,84,43,41,51.19
Evelynn,Jhin,784,396,388,50.51
Evelynn,Viego,598,311,287,52.01
Evelynn,AurelionSol,172,69,103,40.12
Evelynn,Pantheon,622,305,317,49.04
Evelynn,Twitch,366,158,208,43.17
Evelynn,Rell,171,79,92,46.2
Evelynn,MasterYi,512,236,276,46.09
Evelynn,KogMaw,144,79,65,54.86
Evelynn,Seraphine,302,133,169,44.04
Evelynn,Draven,201,110,91,54.73
Evelynn,Gwen,216,92,124,42.59
Evelynn,Kennen,105,63,42,60
Evelynn,Fiora,152,79,73,51.97
Evelynn,Leblanc,251,126,125,50.2
Evelynn,Soraka,223,114,109,51.12
Evelynn,Sett,614,313,301,50.98
Evelynn,Kindred,177,87,90,49.15
Evelynn,Gragas,176,73,103,41.48
Evelynn,Ekko,438,223,215,50.91
Evelynn,Poppy,229,131,98,57.21
Evelynn,Taric,67,41,26,61.19
Evelynn,Sion,340,155,185,45.59
Evelynn,Syndra,251,108,143,43.03
Evelynn,Vi,474,221,253,46.62
Evelynn,Nilah,124,60,64,48.39
Evelynn,Nocturne,625,247,378,39.52
Evelynn,Senna,306,159,147,51.96
Evelynn,Renekton,199,113,86,56.78
Evelynn,Kalista,115,62,53,53.91
Evelynn,Blitzcrank,309,141,168,45.63
Evelynn,Orianna,152,81,71,53.29
Evelynn,Jayce,200,96,104,48
Evelynn,Graves,251,145,106,57.77
Evelynn,Neeko,178,97,81,54.49
Evelynn,JarvanIV,239,134,105,56.07
Evelynn,Zac,187,107,80,57.22
Evelynn,Janna,140,49,91,35
Evelynn,Udyr,180,84,96,46.67
Evelynn,Quinn,143,71,72,49.65
Evelynn,Belveth,77,47,30,61.04
Evelynn,Elise,347,182,165,52.45
Evelynn,Anivia,122,63,59,51.64
Evelynn,Hecarim,128,67,61,52.34
Evelynn,Illaoi,182,93,89,51.1
Evelynn,Singed,118,65,53,55.08
Evelynn,Hwei,233,122,111,52.36
Evelynn,Shyvana,103,55,48,53.4
Evelynn,Nunu,212,119,93,56.13
Evelynn,TwistedFate,162,80,82,49.38
Evelynn,Lucian,270,129,141,47.78
Evelynn,Naafiri,125,48,77,38.4
Evelynn,Rammus,87,48,39,55.17
Evelynn,Bard,123,44,79,35.77
Evelynn,Nidalee,114,66,48,57.89
Evelynn,Urgot,214,81,133,37.85
Evelynn,Kled,65,40,25,61.54
Evelynn,Ryze,145,77,68,53.1
Evelynn,Skarner,104,52,52,50
Evelynn,Zoe,144,74,70,51.39
Evelynn,Corki,152,96,56,63.16
Evelynn,Ivern,69,36,33,52.17
Evelynn,Ornn,140,65,75,46.43
Evelynn,Zeri,143,87,56,60.84
Evelynn,Annie,89,48,41,53.93
Elise,Garen,1332,596,736,44.74
Elise,Sejuani,337,166,171,49.26
Elise,Katarina,609,314,295,51.56
Elise,Varus,849,425,424,50.06
Elise,Yuumi,734,410,324,55.86
Elise,Darius,1464,752,712,51.37
Elise,Kindred,383,192,191,50.13
Elise,Yone,1513,738,775,48.78
Elise,Samira,491,256,235,52.14
Elise,Rell,444,209,235,47.07
Elise,Nocturne,1119,541,578,48.35
Elise,Lux,1866,893,973,47.86
Elise,Lucian,657,331,326,50.38
Elise,Thresh,1159,578,581,49.87
Elise,Vi,831,454,377,54.63
Elise,Ekko,980,459,521,46.84
Elise,Yasuo,1600,790,810,49.38
Elise,Jhin,1654,795,859,48.07
Elise,Velkoz,460,181,279,39.35
Elise,Malphite,761,372,389,48.88
Elise,Shyvana,168,76,92,45.24
Elise,Naafiri,215,109,106,50.7
Elise,MissFortune,1718,771,947,44.88
Elise,Maokai,443,211,232,47.63
Elise,Irelia,766,354,412,46.21
Elise,Rammus,217,99,118,45.62
Elise,Caitlyn,2194,1172,1022,53.42
Elise,Karma,1203,570,633,47.38
Elise,DrMundo,409,213,196,52.08
Elise,Lillia,414,242,172,58.45
Elise,Ezreal,2438,1268,1170,52.01
Elise,Gnar,380,204,176,53.68
Elise,LeeSin,1804,874,930,48.45
Elise,Ahri,1029,520,509,50.53
Elise,Renata,121,64,57,52.89
Elise,Tryndamere,304,169,135,55.59
Elise,Volibear,701,353,348,50.36
Elise,Annie,255,103,152,40.39
Elise,Seraphine,540,285,255,52.78
Elise,Teemo,898,399,499,44.43
Elise,FiddleSticks,443,222,221,50.11
Elise,Morgana,879,448,431,50.97
Elise,Anivia,287,142,145,49.48
Elise,Diana,1317,629,688,47.76
Elise,AurelionSol,262,143,119,54.58
Elise,Kaisa,1586,849,737,53.53
Elise,Galio,767,352,415,45.89
Elise,Yorick,669,318,351,47.53
Elise,Jax,851,467,384,54.88
Elise,Nami,952,473,479,49.68
Elise,MasterYi,919,480,439,52.23
Elise,Vex,382,204,178,53.4
Elise,Sett,1149,575,574,50.04
Elise,Rengar,371,199,172,53.64
Elise,Pantheon,1439,749,690,52.05
Elise,Zyra,823,369,454,44.84
Elise,Renekton,494,261,233,52.83
Elise,Udyr,309,159,150,51.46
Elise,Vladimir,628,297,331,47.29
Elise,Jinx,2300,1145,1155,49.78
Elise,Poppy,534,268,266,50.19
Elise,Camille,384,186,198,48.44
Elise,TahmKench,580,255,325,43.97
Elise,Urgot,365,181,184,49.59
Elise,Ivern,161,76,85,47.2
Elise,Twitch,616,297,319,48.21
Elise,Lulu,1217,655,562,53.82
Elise,Chogath,958,497,461,51.88
Elise,Rumble,288,150,138,52.08
Elise,Aurora,638,311,327,48.75
Elise,Ashe,1690,821,869,48.58
Elise,Swain,693,364,329,52.53
Elise,Qiyana,281,155,126,55.16
Elise,Gragas,537,260,277,48.42
Elise,Trundle,387,183,204,47.29
Elise,Tristana,739,356,383,48.17
Elise,Warwick,928,397,531,42.78
Elise,Leona,631,335,296,53.09
Elise,KSante,482,241,241,50
Elise,Kayn,1130,577,553,51.06
Elise,Taliyah,197,94,103,47.72
Elise,Gwen,398,174,224,43.72
Elise,Viktor,838,458,380,54.65
Elise,Blitzcrank,596,298,298,50
Elise,Khazix,441,225,216,51.02
Elise,Taric,171,76,95,44.44
Elise,Vayne,1025,525,500,51.22
Elise,Riven,430,219,211,50.93
Elise,Malzahar,771,353,418,45.78
Elise,Singed,227,119,108,52.42
Elise,Xayah,401,211,190,52.62
Elise,Rakan,449,246,203,54.79
Elise,Kayle,436,236,200,54.13
Elise,Zed,971,486,485,50.05
Elise,Janna,339,171,168,50.44
Elise,Gangplank,407,205,202,50.37
Elise,Illaoi,352,205,147,58.24
Elise,Ornn,351,171,180,48.72
Elise,Zoe,436,232,204,53.21
Elise,Viego,1343,687,656,51.15
Elise,Ryze,296,152,144,51.35
Elise,Smolder,497,253,244,50.91
Elise,Ziggs,205,90,115,43.9
Elise,Zac,483,254,229,52.59
Elise,Nidalee,323,155,168,47.99
Elise,Kassadin,192,95,97,49.48
Elise,Ambessa,601,352,249,58.57
Elise,Hwei,593,315,278,53.12
Elise,Veigar,689,361,328,52.39
Elise,Mel,1469,775,694,52.76
Elise,Shen,516,255,261,49.42
Elise,JarvanIV,531,259,272,48.78
Elise,Sivir,435,246,189,56.55
Elise,Skarner,211,129,82,61.14
Elise,Corki,404,198,206,49.01
Elise,Braum,563,255,308,45.29
Elise,Sion,644,290,354,45.03
Elise,Draven,372,187,185,50.27
Elise,Milio,524,246,278,46.95
Elise,Shaco,812,399,413,49.14
Elise,Hecarim,400,215,185,53.75
Elise,Brand,570,310,260,54.39
Elise,Aphelios,413,187,226,45.28
Elise,Nautilus,936,507,429,54.17
Elise,Bard,289,158,131,54.67
Elise,Cassiopeia,234,145,89,61.97
Elise,XinZhao,595,278,317,46.72
Elise,Sona,212,91,121,42.92
Elise,Akali,912,489,423,53.62
Elise,Syndra,609,307,302,50.41
Elise,Nilah,249,109,140,43.78
Elise,TwistedFate,291,166,125,57.04
Elise,Senna,656,333,323,50.76
Elise,Kennen,299,161,138,53.85
Elise,Aatrox,833,426,407,51.14
Elise,Karthus,282,127,155,45.04
Elise,MonkeyKing,515,306,209,59.42
Elise,Alistar,363,168,195,46.28
Elise,Fiora,292,130,162,44.52
Elise,RekSai,109,56,53,51.38
Elise,Pyke,758,416,342,54.88
Elise,Fizz,481,238,243,49.48
Elise,Lissandra,321,128,193,39.88
Elise,KogMaw,263,127,136,48.29
Elise,Xerath,891,444,447,49.83
Elise,Heimerdinger,263,144,119,54.75
Elise,Sylas,1278,627,651,49.06
Elise,Kled,174,72,102,41.38
Elise,Kalista,269,164,105,60.97
Elise,Mordekaiser,842,384,458,45.61
Elise,Orianna,426,226,200,53.05
Elise,Nunu,411,208,203,50.61
Elise,Soraka,444,221,223,49.77
Elise,Neeko,362,185,177,51.1
Elise,Nasus,443,221,222,49.89
Elise,Evelynn,347,165,182,47.55
Elise,Jayce,515,272,243,52.82
Elise,Briar,528,270,258,51.14
Elise,Azir,310,153,157,49.35
Elise,Leblanc,591,342,249,57.87
Elise,Amumu,744,360,384,48.39
Elise,Quinn,304,157,147,51.64
Elise,Zilean,255,96,159,37.65
Elise,Talon,592,307,285,51.86
Elise,Olaf,195,95,100,48.72
Elise,Graves,552,271,281,49.09
Elise,Belveth,197,109,88,55.33
Elise,Akshan,261,140,121,53.64
Elise,Zeri,329,173,156,52.58
Gwen,Pantheon,855,417,438,48.77
Gwen,Volibear,724,336,388,46.41
Gwen,Zed,606,288,318,47.52
Gwen,Tristana,640,333,307,52.03
Gwen,Yuumi,457,212,245,46.39
Gwen,Chogath,940,453,487,48.19
Gwen,Kindred,241,124,117,51.45
Gwen,Katarina,476,219,257,46.01
Gwen,Neeko,270,148,122,54.81
Gwen,Azir,153,85,68,55.56
Gwen,Nocturne,799,381,418,47.68
Gwen,Syndra,352,143,209,40.63
Gwen,Jhin,1108,594,514,53.61
Gwen,Senna,380,182,198,47.89
Gwen,Trundle,367,175,192,47.68
Gwen,Viktor,588,280,308,47.62
Gwen,Xayah,257,117,140,45.53
Gwen,Lulu,744,366,378,49.19
Gwen,Jax,551,262,289,47.55
Gwen,Viego,803,339,464,42.22
Gwen,Aurora,388,195,193,50.26
Gwen,Vayne,682,316,366,46.33
Gwen,Lux,1443,670,773,46.43
Gwen,Yorick,742,336,406,45.28
Gwen,Lillia,279,160,119,57.35
Gwen,Yone,1053,556,497,52.8
Gwen,Aatrox,482,254,228,52.7
Gwen,Naafiri,166,86,80,51.81
Gwen,Nilah,187,79,108,42.25
Gwen,Brand,339,162,177,47.79
Gwen,Ezreal,1384,691,693,49.93
Gwen,Veigar,566,257,309,45.41
Gwen,Jinx,1653,755,898,45.67
Gwen,Milio,375,188,187,50.13
Gwen,Riven,316,150,166,47.47
Gwen,FiddleSticks,245,108,137,44.08
Gwen,Ashe,1076,494,582,45.91
Gwen,Ambessa,328,171,157,52.13
Gwen,LeeSin,781,372,409,47.63
Gwen,Lissandra,198,101,97,51.01
Gwen,Varus,548,286,262,52.19
Gwen,Xerath,485,256,229,52.78
Gwen,Vladimir,489,223,266,45.6
Gwen,Aphelios,343,183,160,53.35
Gwen,Velkoz,393,186,207,47.33
Gwen,Gnar,235,95,140,40.43
Gwen,Kayn,808,401,407,49.63
Gwen,MissFortune,1454,617,837,42.43
Gwen,TahmKench,559,280,279,50.09
Gwen,Fiora,266,153,113,57.52
Gwen,Kalista,129,88,41,68.22
Gwen,Poppy,361,166,195,45.98
Gwen,Darius,1010,500,510,49.5
Gwen,Sejuani,316,175,141,55.38
Gwen,Caitlyn,1544,784,760,50.78
Gwen,Seraphine,437,224,213,51.26
Gwen,Garen,1034,463,571,44.78
Gwen,AurelionSol,202,84,118,41.58
Gwen,Mel,1077,520,557,48.28
Gwen,Gangplank,281,136,145,48.4
Gwen,Ekko,567,285,282,50.26
Gwen,Kassadin,143,67,76,46.85
Gwen,Rakan,211,120,91,56.87
Gwen,Renekton,278,138,140,49.64
Gwen,Olaf,130,71,59,54.62
Gwen,Qiyana,131,62,69,47.33
Gwen,Urgot,281,127,154,45.2
Gwen,Yasuo,1063,521,542,49.01
Gwen,KogMaw,189,92,97,48.68
Gwen,Warwick,967,440,527,45.5
Gwen,Ziggs,232,137,95,59.05
Gwen,Hwei,403,187,216,46.4
Gwen,Rammus,194,112,82,57.73
Gwen,Corki,280,140,140,50
Gwen,Soraka,326,148,178,45.4
Gwen,Malphite,690,341,349,49.42
Gwen,Skarner,186,110,76,59.14
Gwen,Diana,1042,477,565,45.78
Gwen,Swain,575,254,321,44.17
Gwen,Lucian,400,184,216,46
Gwen,Nami,680,288,392,42.35
Gwen,Mordekaiser,677,310,367,45.79
Gwen,TwistedFate,170,83,87,48.82
Gwen,Sion,567,260,307,45.86
Gwen,Thresh,789,373,416,47.28
Gwen,Teemo,532,214,318,40.23
Gwen,Sylas,759,373,386,49.14
Gwen,Fizz,333,164,169,49.25
Gwen,Kaisa,885,428,457,48.36
Gwen,Morgana,668,292,376,43.71
Gwen,Sivir,315,131,184,41.59
Gwen,Elise,398,224,174,56.28
Gwen,Nautilus,664,335,329,50.45
Gwen,Talon,293,139,154,47.44
Gwen,Sona,225,103,122,45.78
Gwen,Briar,427,193,234,45.2
Gwen,Akali,653,277,376,42.42
Gwen,Anivia,191,98,93,51.31
Gwen,Karma,665,263,402,39.55
Gwen,Smolder,363,168,195,46.28
Gwen,Tryndamere,329,153,176,46.5
Gwen,Nasus,430,196,234,45.58
Gwen,Sett,877,392,485,44.7
Gwen,Janna,237,102,135,43.04
Gwen,Singed,163,57,106,34.97
Gwen,DrMundo,478,263,215,55.02
Gwen,Ornn,368,203,165,55.16
Gwen,Taliyah,172,86,86,50
Gwen,Draven,298,155,143,52.01
Gwen,KSante,363,202,161,55.65
Gwen,Shyvana,183,90,93,49.18
Gwen,Galio,524,240,284,45.8
Gwen,Leblanc,322,157,165,48.76
Gwen,Rengar,227,117,110,51.54
Gwen,Karthus,151,66,85,43.71
Gwen,Zilean,167,99,68,59.28
Gwen,Kled,103,49,54,47.57
Gwen,MasterYi,739,339,400,45.87
Gwen,Irelia,425,187,238,44
Gwen,Kayle,389,176,213,45.24
Gwen,Evelynn,216,124,92,57.41
Gwen,Ryze,207,104,103,50.24
Gwen,Twitch,479,249,230,51.98
Gwen,Leona,449,232,217,51.67
Gwen,Gragas,266,143,123,53.76
Gwen,Ahri,742,346,396,46.63
Gwen,Camille,200,94,106,47
Gwen,Zyra,641,298,343,46.49
Gwen,Graves,340,164,176,48.24
Gwen,Vex,313,134,179,42.81
Gwen,Zoe,243,148,95,60.91
Gwen,Blitzcrank,403,219,184,54.34
Gwen,Udyr,305,155,150,50.82
Gwen,Annie,222,122,100,54.95
Gwen,Taric,138,66,72,47.83
Gwen,Hecarim,238,125,113,52.52
Gwen,Bard,213,103,110,48.36
Gwen,Kennen,104,47,57,45.19
Gwen,Jayce,204,105,99,51.47
Gwen,XinZhao,397,204,193,51.39
Gwen,Shaco,481,233,248,48.44
Gwen,Vi,455,212,243,46.59
Gwen,Ivern,123,63,60,51.22
Gwen,MonkeyKing,419,214,205,51.07
Gwen,Khazix,277,140,137,50.54
Gwen,Amumu,651,302,349,46.39
Gwen,Nunu,275,119,156,43.27
Gwen,Heimerdinger,253,129,124,50.99
Gwen,Malzahar,624,273,351,43.75
Gwen,Alistar,197,92,105,46.7
Gwen,Samira,451,205,246,45.45
Gwen,Cassiopeia,141,80,61,56.74
Gwen,Maokai,263,122,141,46.39
Gwen,Quinn,208,90,118,43.27
Gwen,Akshan,176,78,98,44.32
Gwen,Braum,306,126,180,41.18
Gwen,Belveth,151,86,65,56.95
Gwen,Rumble,142,74,68,52.11
Gwen,Orianna,223,104,119,46.64
Gwen,Pyke,496,269,227,54.23
Gwen,Nidalee,140,87,53,62.14
Gwen,JarvanIV,361,147,214,40.72
Gwen,Zeri,222,86,136,38.74
Gwen,Zac,338,154,184,45.56
Gwen,Rell,302,148,154,49.01
Gwen,Illaoi,272,132,140,48.53
Gwen,Shen,433,222,211,51.27
Gwen,Renata,98,57,41,58.16
Gwen,RekSai,80,31,49,38.75
Skarner,Pantheon,477,201,276,42.14
Skarner,Volibear,326,147,179,45.09
Skarner,Zed,311,134,177,43.09
Skarner,Tristana,274,119,155,43.43
Skarner,Yuumi,256,114,142,44.53
Skarner,Jax,290,132,158,45.52
Skarner,Amumu,329,148,181,44.98
Skarner,Ahri,388,173,215,44.59
Skarner,Caitlyn,759,342,417,45.06
Skarner,Lulu,417,189,228,45.32
Skarner,Gnar,113,50,63,44.25
Skarner,Sylas,485,241,244,49.69
Skarner,Mel,569,301,268,52.9
Skarner,Ashe,640,297,343,46.41
Skarner,Seraphine,190,76,114,40
Skarner,Akali,328,139,189,42.38
Skarner,Sejuani,135,53,82,39.26
Skarner,Galio,229,108,121,47.16
Skarner,Jhin,572,247,325,43.18
Skarner,Milio,175,78,97,44.57
Skarner,Viego,425,181,244,42.59
Skarner,TwistedFate,97,45,52,46.39
Skarner,Jinx,772,340,432,44.04
Skarner,Lux,636,290,346,45.6
Skarner,Udyr,120,44,76,36.67
Skarner,XinZhao,220,60,160,27.27
Skarner,Leona,277,125,152,45.13
Skarner,Sett,453,184,269,40.62
Skarner,Yone,588,289,299,49.15
Skarner,Ezreal,757,363,394,47.95
Skarner,Zyra,248,97,151,39.11
Skarner,Darius,541,244,297,45.1
Skarner,JarvanIV,167,73,94,43.71
Skarner,Leblanc,205,90,115,43.9
Skarner,Xayah,147,59,88,40.14
Skarner,Heimerdinger,119,54,65,45.38
Skarner,DrMundo,180,109,71,60.56
Skarner,Karma,367,160,207,43.6
Skarner,Fiora,120,46,74,38.33
Skarner,Kassadin,49,20,29,40.82
Skarner,Aatrox,247,131,116,53.04
Skarner,Malzahar,336,146,190,43.45
Skarner,Samira,188,93,95,49.47
Skarner,Rakan,106,57,49,53.77
Skarner,Diana,435,191,244,43.91
Skarner,Swain,268,108,160,40.3
Skarner,Gwen,186,76,110,40.86
Skarner,MasterYi,328,161,167,49.09
Skarner,Morgana,319,129,190,40.44
Skarner,Kayn,463,187,276,40.39
Skarner,Teemo,375,184,191,49.07
Skarner,Irelia,255,117,138,45.88
Skarner,Senna,181,75,106,41.44
Skarner,LeeSin,497,269,228,54.12
Skarner,Varus,280,121,159,43.21
Skarner,Yasuo,506,207,299,40.91
Skarner,Janna,81,32,49,39.51
Skarner,Kaisa,540,244,296,45.19
Skarner,Shaco,265,112,153,42.26
Skarner,Annie,117,60,57,51.28
Skarner,Poppy,177,67,110,37.85
Skarner,Thresh,395,187,208,47.34
Skarner,Quinn,107,62,45,57.94
Skarner,Qiyana,75,39,36,52
Skarner,AurelionSol,117,49,68,41.88
Skarner,Corki,107,56,51,52.34
Skarner,Gragas,173,67,106,38.73
Skarner,Garen,434,199,235,45.85
Skarner,Ekko,269,132,137,49.07
Skarner,Karthus,104,56,48,53.85
Skarner,Shen,132,61,71,46.21
Skarner,Ziggs,95,44,51,46.32
Skarner,Brand,212,78,134,36.79
Skarner,Ornn,123,46,77,37.4
Skarner,Nasus,160,72,88,45
Skarner,Khazix,130,85,45,65.38
Skarner,Yorick,315,106,209,33.65
Skarner,Blitzcrank,248,103,145,41.53
Skarner,Kindred,141,72,69,51.06
Skarner,TahmKench,201,100,101,49.75
Skarner,Elise,211,82,129,38.86
Skarner,Nami,272,113,159,41.54
Skarner,Chogath,304,148,156,48.68
Skarner,Talon,154,73,81,47.4
Skarner,Vladimir,204,96,108,47.06
Skarner,Soraka,179,78,101,43.58
Skarner,Singed,96,28,68,29.17
Skarner,Mordekaiser,346,161,185,46.53
Skarner,Veigar,257,116,141,45.14
Skarner,Bard,72,30,42,41.67
Skarner,Anivia,83,32,51,38.55
Skarner,Illaoi,142,58,84,40.85
Skarner,Hwei,231,128,103,55.41
Skarner,Maokai,149,80,69,53.69
Skarner,Vayne,451,213,238,47.23
Skarner,Sona,112,45,67,40.18
Skarner,Orianna,160,83,77,51.88
Skarner,Twitch,232,100,132,43.1
Skarner,Syndra,169,93,76,55.03
Skarner,KogMaw,84,18,66,21.43
Skarner,Braum,212,103,109,48.58
Skarner,Riven,125,49,76,39.2
Skarner,Viktor,283,106,177,37.46
Skarner,Belveth,79,25,54,31.65
Skarner,Naafiri,86,44,42,51.16
Skarner,Nautilus,392,220,172,56.12
Skarner,MissFortune,653,278,375,42.57
Skarner,Urgot,119,41,78,34.45
Skarner,Camille,121,68,53,56.2
Skarner,Kalista,86,47,39,54.65
Skarner,Nidalee,86,26,60,30.23
Skarner,Lucian,186,101,85,54.3
Skarner,Briar,167,80,87,47.9
Skarner,Katarina,211,94,117,44.55
Skarner,Malphite,257,116,141,45.14
Skarner,Azir,110,50,60,45.45
Skarner,Draven,133,70,63,52.63
Skarner,Pyke,189,77,112,40.74
Skarner,Smolder,185,80,105,43.24
Skarner,Rumble,87,38,49,43.68
Skarner,Graves,189,78,111,41.27
Skarner,Trundle,160,72,88,45
Skarner,Aurora,220,86,134,39.09
Skarner,Renekton,170,74,96,43.53
Skarner,Aphelios,166,86,80,51.81
Skarner,Ivern,44,22,22,50
Skarner,Nocturne,330,150,180,45.45
Skarner,Gangplank,164,83,81,50.61
Skarner,Vi,285,127,158,44.56
Skarner,FiddleSticks,164,74,90,45.12
Skarner,Zac,196,88,108,44.9
Skarner,Rengar,110,57,53,51.82
Skarner,Velkoz,165,78,87,47.27
Skarner,Warwick,371,134,237,36.12
Skarner,KSante,201,87,114,43.28
Skarner,Alistar,128,47,81,36.72
Skarner,Kayle,212,99,113,46.7
Skarner,Sivir,149,71,78,47.65
Skarner,Olaf,91,58,33,63.74
Skarner,Vex,126,80,46,63.49
Skarner,Zeri,125,60,65,48
Skarner,Rell,159,56,103,35.22
Skarner,Fizz,123,38,85,30.89
Skarner,Hecarim,105,51,54,48.57
Skarner,Zilean,71,42,29,59.15
Skarner,Tryndamere,117,49,68,41.88
Skarner,Sion,227,95,132,41.85
Skarner,Evelynn,104,52,52,50
Skarner,Nilah,73,30,43,41.1
Skarner,MonkeyKing,231,109,122,47.19
Skarner,Ryze,129,53,76,41.09
Skarner,Taric,34,7,27,20.59
Skarner,Renata,49,28,21,57.14
Skarner,Nunu,164,79,85,48.17
Skarner,Kennen,84,38,46,45.24
Skarner,Taliyah,107,41,66,38.32
Skarner,Shyvana,73,35,38,47.95
Skarner,Xerath,288,166,122,57.64
Skarner,Neeko,147,71,76,48.3
Skarner,Lillia,229,103,126,44.98
Skarner,Ambessa,189,67,122,35.45
Skarner,Rammus,55,17,38,30.91
Skarner,Akshan,125,64,61,51.2
Skarner,Lissandra,86,39,47,45.35
Skarner,Zoe,100,46,54,46
Skarner,Cassiopeia,62,29,33,46.77
Skarner,Kled,82,40,42,48.78
Skarner,RekSai,34,11,23,32.35
Skarner,Jayce,138,47,91,34.06
DrMundo,Pantheon,1140,589,551,51.67
DrMundo,Volibear,861,468,393,54.36
DrMundo,Zed,729,385,344,52.81
DrMundo,Tristana,737,372,365,50.47
DrMundo,Yuumi,531,272,259,51.22
DrMundo,Warwick,1126,568,558,50.44
DrMundo,Briar,501,259,242,51.7
DrMundo,Ziggs,236,105,131,44.49
DrMundo,Xerath,594,325,269,54.71
DrMundo,Yasuo,1349,661,688,49
DrMundo,Khazix,347,180,167,51.87
DrMundo,Lissandra,193,82,111,42.49
DrMundo,Lucian,375,230,145,61.33
DrMundo,Rell,303,152,151,50.17
DrMundo,Trundle,475,198,277,41.68
DrMundo,Veigar,728,369,359,50.69
DrMundo,Thresh,790,390,400,49.37
DrMundo,Singed,226,123,103,54.42
DrMundo,Diana,1069,528,541,49.39
DrMundo,Viktor,534,265,269,49.63
DrMundo,MissFortune,1622,850,772,52.4
DrMundo,Galio,606,328,278,54.13
DrMundo,Darius,1374,741,633,53.93
DrMundo,Elise,409,196,213,47.92
DrMundo,Gangplank,300,165,135,55
DrMundo,Varus,587,320,267,54.51
DrMundo,Heimerdinger,322,144,178,44.72
DrMundo,Amumu,727,369,358,50.76
DrMundo,Malphite,719,388,331,53.96
DrMundo,Smolder,505,259,246,51.29
DrMundo,Kayle,393,203,190,51.65
DrMundo,Bard,200,108,92,54
DrMundo,Ekko,627,275,352,43.86
DrMundo,Camille,215,123,92,57.21
DrMundo,XinZhao,385,196,189,50.91
DrMundo,Mel,1353,736,617,54.4
DrMundo,Ahri,906,497,409,54.86
DrMundo,Fiora,211,95,116,45.02
DrMundo,Karthus,200,106,94,53
DrMundo,Malzahar,723,384,339,53.11
DrMundo,Kaisa,1081,534,547,49.4
DrMundo,Milio,370,172,198,46.49
DrMundo,Sett,1022,490,532,47.95
DrMundo,Twitch,554,305,249,55.05
DrMundo,Blitzcrank,467,236,231,50.54
DrMundo,Irelia,481,218,263,45.32
DrMundo,Shaco,647,347,300,53.63
DrMundo,Sion,468,214,254,45.73
DrMundo,Draven,348,186,162,53.45
DrMundo,Skarner,180,71,109,39.44
DrMundo,Katarina,534,271,263,50.75
DrMundo,Seraphine,520,240,280,46.15
DrMundo,Nocturne,854,425,429,49.77
DrMundo,Chogath,1067,581,486,54.45
DrMundo,Jhin,1454,714,740,49.11
DrMundo,Rumble,196,101,95,51.53
DrMundo,Jax,667,349,318,52.32
DrMundo,Evelynn,263,146,117,55.51
DrMundo,Lux,1816,908,908,50
DrMundo,Caitlyn,1796,938,858,52.23
DrMundo,Ashe,1347,720,627,53.45
DrMundo,Ambessa,313,149,164,47.6
DrMundo,Kayn,944,473,471,50.11
DrMundo,Jinx,2096,1008,1088,48.09
DrMundo,Rakan,251,141,110,56.18
DrMundo,Shyvana,175,80,95,45.71
DrMundo,Lulu,713,369,344,51.75
DrMundo,Teemo,935,498,437,53.26
DrMundo,Sylas,827,393,434,47.52
DrMundo,TahmKench,511,274,237,53.62
DrMundo,Garen,1131,543,588,48.01
DrMundo,Taric,181,83,98,45.86
DrMundo,Rammus,197,114,83,57.87
DrMundo,Orianna,240,137,103,57.08
DrMundo,Soraka,320,137,183,42.81
DrMundo,Leblanc,376,182,194,48.4
DrMundo,Zoe,252,130,122,51.59
DrMundo,Nautilus,687,358,329,52.11
DrMundo,KSante,315,171,144,54.29
DrMundo,Graves,369,179,190,48.51
DrMundo,MonkeyKing,411,211,200,51.34
DrMundo,Zyra,634,350,284,55.21
DrMundo,Yone,1195,596,599,49.87
DrMundo,Yorick,689,315,374,45.72
DrMundo,Zilean,196,103,93,52.55
DrMundo,Xayah,302,131,171,43.38
DrMundo,Vladimir,467,240,227,51.39
DrMundo,Morgana,957,480,477,50.16
DrMundo,Fizz,412,212,200,51.46
DrMundo,MasterYi,887,465,422,52.42
DrMundo,Karma,757,409,348,54.03
DrMundo,Aatrox,667,321,346,48.13
DrMundo,Lillia,436,180,256,41.28
DrMundo,Illaoi,367,188,179,51.23
DrMundo,Velkoz,409,192,217,46.94
DrMundo,Poppy,351,182,169,51.85
DrMundo,Samira,463,244,219,52.7
DrMundo,Quinn,290,137,153,47.24
DrMundo,KogMaw,220,111,109,50.45
DrMundo,Gwen,478,215,263,44.98
DrMundo,Sejuani,274,123,151,44.89
DrMundo,Hwei,385,189,196,49.09
DrMundo,Brand,596,323,273,54.19
DrMundo,Nunu,393,208,185,52.93
DrMundo,Ryze,238,100,138,42.02
DrMundo,Senna,454,258,196,56.83
DrMundo,Mordekaiser,964,498,466,51.66
DrMundo,FiddleSticks,363,181,182,49.86
DrMundo,Ezreal,1401,756,645,53.96
DrMundo,Corki,222,118,104,53.15
DrMundo,Renekton,240,136,104,56.67
DrMundo,Cassiopeia,213,105,108,49.3
DrMundo,Leona,582,283,299,48.63
DrMundo,JarvanIV,316,153,163,48.42
DrMundo,Rengar,205,113,92,55.12
DrMundo,Gragas,317,141,176,44.48
DrMundo,Aurora,455,230,225,50.55
DrMundo,Viego,952,438,514,46.01
DrMundo,Alistar,224,100,124,44.64
DrMundo,Nasus,491,222,269,45.21
DrMundo,Janna,195,106,89,54.36
DrMundo,Zac,266,150,116,56.39
DrMundo,LeeSin,820,438,382,53.41
DrMundo,Syndra,335,151,184,45.07
DrMundo,Swain,654,283,371,43.27
DrMundo,Neeko,299,146,153,48.83
DrMundo,Vayne,951,502,449,52.79
DrMundo,Vi,612,302,310,49.35
DrMundo,Udyr,294,126,168,42.86
DrMundo,Nilah,219,101,118,46.12
DrMundo,Ornn,258,132,126,51.16
DrMundo,Naafiri,211,107,104,50.71
DrMundo,TwistedFate,188,126,62,67.02
DrMundo,Akshan,240,118,122,49.17
DrMundo,Braum,325,142,183,43.69
DrMundo,Kennen,186,118,68,63.44
DrMundo,Gnar,259,126,133,48.65
DrMundo,Kindred,298,179,119,60.07
DrMundo,Qiyana,137,78,59,56.93
DrMundo,Nami,675,372,303,55.11
DrMundo,Hecarim,241,120,121,49.79
DrMundo,Aphelios,326,169,157,51.84
DrMundo,Shen,401,237,164,59.1
DrMundo,Annie,234,147,87,62.82
DrMundo,Taliyah,168,94,74,55.95
DrMundo,Tryndamere,413,204,209,49.39
DrMundo,Vex,364,193,171,53.02
DrMundo,Pyke,577,307,270,53.21
DrMundo,Renata,90,60,30,66.67
DrMundo,Urgot,396,225,171,56.82
DrMundo,Sona,218,115,103,52.75
DrMundo,Riven,241,134,107,55.6
DrMundo,AurelionSol,252,120,132,47.62
DrMundo,Belveth,120,76,44,63.33
DrMundo,Akali,707,337,370,47.67
DrMundo,Jayce,290,165,125,56.9
DrMundo,Kassadin,140,61,79,43.57
DrMundo,Maokai,299,147,152,49.16
DrMundo,Azir,193,91,102,47.15
DrMundo,Olaf,102,36,66,35.29
DrMundo,Kalista,162,79,83,48.77
DrMundo,Talon,319,175,144,54.86
DrMundo,Zeri,242,135,107,55.79
DrMundo,Ivern,86,44,42,51.16
DrMundo,Sivir,264,133,131,50.38
DrMundo,Kled,121,51,70,42.15
DrMundo,Anivia,247,113,134,45.75
DrMundo,Nidalee,169,91,78,53.85
DrMundo,RekSai,45,27,18,60
Samira,Pantheon,1327,618,709,46.57
Samira,Volibear,969,504,465,52.01
Samira,Zed,988,479,509,48.48
Samira,Tristana,796,453,343,56.91
Samira,Yuumi,652,368,284,56.44
Samira,Renekton,465,231,234,49.68
Samira,Trundle,521,237,284,45.49
Samira,Mordekaiser,1213,539,674,44.44
Samira,Jinx,2674,1260,1414,47.12
Samira,Nautilus,678,352,326,51.92
Samira,Jayce,354,156,198,44.07
Samira,Talon,424,227,197,53.54
Samira,Kennen,223,107,116,47.98
Samira,Lucian,541,268,273,49.54
Samira,Elise,491,235,256,47.86
Samira,Yasuo,1820,895,925,49.18
Samira,Kayn,1326,669,657,50.45
Samira,Mel,1630,775,855,47.55
Samira,Xayah,473,230,243,48.63
Samira,Rakan,286,129,157,45.1
Samira,XinZhao,480,260,220,54.17
Samira,Briar,618,293,325,47.41
Samira,AurelionSol,321,119,202,37.07
Samira,Ashe,1509,777,732,51.49
Samira,Darius,1538,758,780,49.28
Samira,Zac,411,179,232,43.55
Samira,Anivia,274,124,150,45.26
Samira,Blitzcrank,623,341,282,54.74
Samira,Olaf,165,78,87,47.27
Samira,Shaco,834,398,436,47.72
Samira,Lissandra,229,111,118,48.47
Samira,Leona,733,358,375,48.84
Samira,Udyr,300,136,164,45.33
Samira,Qiyana,214,101,113,47.2
Samira,Seraphine,639,339,300,53.05
Samira,Garen,1271,583,688,45.87
Samira,Nidalee,220,125,95,56.82
Samira,Graves,496,257,239,51.81
Samira,Vayne,1267,608,659,47.99
Samira,Lux,2334,1142,1192,48.93
Samira,RekSai,78,48,30,61.54
Samira,Ahri,958,510,448,53.24
Samira,Malphite,772,389,383,50.39
Samira,Quinn,308,140,168,45.45
Samira,Evelynn,307,141,166,45.93
Samira,Jhin,1606,788,818,49.07
Samira,Brand,682,341,341,50
Samira,Yorick,832,343,489,41.23
Samira,Veigar,841,372,469,44.23
Samira,Smolder,487,253,234,51.95
Samira,Soraka,465,229,236,49.25
Samira,Jax,753,391,362,51.93
Samira,Vi,699,343,356,49.07
Samira,Thresh,1035,441,594,42.61
Samira,Diana,1312,631,681,48.09
Samira,Velkoz,552,246,306,44.57
Samira,Sett,1474,738,736,50.07
Samira,Irelia,706,365,341,51.7
Samira,Ezreal,1805,849,956,47.04
Samira,Karma,835,397,438,47.54
Samira,Gangplank,335,166,169,49.55
Samira,Lillia,434,188,246,43.32
Samira,Naafiri,260,125,135,48.08
Samira,Caitlyn,2420,1209,1211,49.96
Samira,Rengar,281,162,119,57.65
Samira,Zyra,786,374,412,47.58
Samira,Sion,503,212,291,42.15
Samira,Viktor,639,298,341,46.64
Samira,Corki,353,159,194,45.04
Samira,TwistedFate,246,122,124,49.59
Samira,Ziggs,267,126,141,47.19
Samira,Janna,271,142,129,52.4
Samira,Katarina,639,323,316,50.55
Samira,Zilean,242,139,103,57.44
Samira,Illaoi,440,202,238,45.91
Samira,Hwei,494,227,267,45.95
Samira,Nami,768,368,400,47.92
Samira,Sylas,1179,648,531,54.96
Samira,Warwick,1375,608,767,44.22
Samira,Xerath,739,309,430,41.81
Samira,Shen,540,266,274,49.26
Samira,Vex,407,215,192,52.83
Samira,Urgot,449,207,242,46.1
Samira,Yone,1584,887,697,56
Samira,Aatrox,676,348,328,51.48
Samira,Morgana,1015,456,559,44.93
Samira,Kled,91,47,44,51.65
Samira,Zoe,281,156,125,55.52
Samira,Twitch,652,356,296,54.6
Samira,Lulu,980,449,531,45.82
Samira,Kaisa,1311,631,680,48.13
Samira,Alistar,488,202,286,41.39
Samira,Swain,818,354,464,43.28
Samira,Pyke,695,363,332,52.23
Samira,Vladimir,501,256,245,51.1
Samira,Skarner,188,95,93,50.53
Samira,Aurora,511,215,296,42.07
Samira,MissFortune,2280,1079,1201,47.32
Samira,MasterYi,1066,497,569,46.62
Samira,Amumu,918,413,505,44.99
Samira,KogMaw,233,133,100,57.08
Samira,Leblanc,504,259,245,51.39
Samira,FiddleSticks,380,164,216,43.16
Samira,Milio,504,219,285,43.45
Samira,LeeSin,1060,546,514,51.51
Samira,Sona,256,111,145,43.36
Samira,Galio,638,311,327,48.75
Samira,Malzahar,862,383,479,44.43
Samira,Kayle,583,270,313,46.31
Samira,Ekko,848,436,412,51.42
Samira,Nasus,622,285,337,45.82
Samira,Syndra,451,230,221,51
Samira,Sejuani,313,164,149,52.4
Samira,Azir,252,145,107,57.54
Samira,Varus,680,323,357,47.5
Samira,Tryndamere,516,251,265,48.64
Samira,Senna,616,317,299,51.46
Samira,Akali,829,418,411,50.42
Samira,DrMundo,463,219,244,47.3
Samira,Rammus,290,123,167,42.41
Samira,Teemo,1209,601,608,49.71
Samira,Viego,1221,581,640,47.58
Samira,Renata,144,78,66,54.17
Samira,Ornn,299,135,164,45.15
Samira,Fiora,285,142,143,49.82
Samira,Kassadin,168,86,82,51.19
Samira,Ryze,273,133,140,48.72
Samira,Hecarim,335,156,179,46.57
Samira,Nocturne,1028,537,491,52.24
Samira,Sivir,399,215,184,53.88
Samira,Camille,245,146,99,59.59
Samira,Orianna,273,125,148,45.79
Samira,Gnar,278,152,126,54.68
Samira,Taric,188,67,121,35.64
Samira,Shyvana,217,86,131,39.63
Samira,TahmKench,625,368,257,58.88
Samira,Heimerdinger,468,223,245,47.65
Samira,MonkeyKing,566,243,323,42.93
Samira,Fizz,472,235,237,49.79
Samira,Poppy,510,208,302,40.78
Samira,Chogath,1000,455,545,45.5
Samira,Rell,371,174,197,46.9
Samira,Aphelios,355,185,170,52.11
Samira,Ambessa,418,225,193,53.83
Samira,Belveth,136,79,57,58.09
Samira,Maokai,433,229,204,52.89
Samira,Karthus,218,119,99,54.59
Samira,Nilah,406,156,250,38.42
Samira,Khazix,368,208,160,56.52
Samira,Akshan,298,162,136,54.36
Samira,Rumble,189,91,98,48.15
Samira,Cassiopeia,253,121,132,47.83
Samira,Bard,240,145,95,60.42
Samira,Taliyah,179,79,100,44.13
Samira,Braum,425,208,217,48.94
Samira,Riven,343,154,189,44.9
Samira,Zeri,329,184,145,55.93
Samira,Nunu,452,229,223,50.66
Samira,KSante,371,221,150,59.57
Samira,Gragas,480,251,229,52.29
Samira,Singed,208,90,118,43.27
Samira,JarvanIV,328,175,153,53.35
Samira,Neeko,408,174,234,42.65
Samira,Gwen,451,246,205,54.55
Samira,Kalista,171,88,83,51.46
Samira,Ivern,102,46,56,45.1
Samira,Draven,447,241,206,53.91
Samira,Annie,291,139,152,47.77
Samira,Kindred,346,184,162,53.18
Volibear,Gwen,724,388,336,53.59
Volibear,Skarner,326,179,147,54.91
Volibear,DrMundo,861,393,468,45.64
Volibear,Samira,969,465,504,47.99
Volibear,Malphite,1219,611,608,50.12
Volibear,Renekton,635,379,256,59.69
Volibear,Trundle,1038,458,580,44.12
Volibear,Mordekaiser,2252,1070,1182,47.51
Volibear,Jinx,4095,1993,2102,48.67
Volibear,Nautilus,1386,719,667,51.88
Volibear,LeeSin,1552,784,768,50.52
Volibear,Akali,1543,806,737,52.24
Volibear,KogMaw,507,242,265,47.73
Volibear,Thresh,1740,869,871,49.94
Volibear,Gangplank,579,286,293,49.4
Volibear,FiddleSticks,659,356,303,54.02
Volibear,Yone,2477,1316,1161,53.13
Volibear,Varus,1246,688,558,55.22
Volibear,Zilean,445,227,218,51.01
Volibear,Sett,2428,1259,1169,51.85
Volibear,Evelynn,518,262,256,50.58
Volibear,Vex,718,322,396,44.85
Volibear,MissFortune,3466,1685,1781,48.62
Volibear,Xerath,1240,675,565,54.44
Volibear,Teemo,1771,830,941,46.87
Volibear,Nocturne,1854,883,971,47.63
Volibear,Hwei,836,398,438,47.61
Volibear,Twitch,1163,581,582,49.96
Volibear,Karma,1405,683,722,48.61
Volibear,Fiora,437,217,220,49.66
Volibear,Graves,738,371,367,50.27
Volibear,Azir,436,232,204,53.21
Volibear,Ashe,2697,1353,1344,50.17
Volibear,Braum,769,407,362,52.93
Volibear,Shaco,1243,687,556,55.27
Volibear,Yasuo,2735,1340,1395,48.99
Volibear,Caitlyn,3833,1932,1901,50.4
Volibear,Soraka,839,385,454,45.89
Volibear,Chogath,1721,832,889,48.34
Volibear,Anivia,408,173,235,42.4
Volibear,Tristana,1387,759,628,54.72
Volibear,Zyra,1166,547,619,46.91
Volibear,Briar,1062,522,540,49.15
Volibear,Diana,2163,1080,1083,49.93
Volibear,Veigar,1486,715,771,48.12
Volibear,Brand,1177,573,604,48.68
Volibear,Tryndamere,930,493,437,53.01
Volibear,Poppy,767,377,390,49.15
Volibear,Kassadin,269,163,106,60.59
Volibear,Illaoi,828,436,392,52.66
Volibear,Katarina,1076,561,515,52.14
Volibear,Jhin,2743,1357,1386,49.47
Volibear,Seraphine,1163,610,553,52.45
Volibear,Olaf,315,161,154,51.11
Volibear,Sylas,1685,863,822,51.22
Volibear,Kennen,299,168,131,56.19
Volibear,Nasus,1105,543,562,49.14
Volibear,Lillia,734,365,369,49.73
Volibear,Irelia,1160,604,556,52.07
Volibear,Galio,1116,547,569,49.01
Volibear,Urgot,896,418,478,46.65
Volibear,Rammus,404,200,204,49.5
Volibear,Lulu,1516,784,732,51.72
Volibear,Udyr,630,291,339,46.19
Volibear,Nilah,473,221,252,46.72
Volibear,Taric,324,147,177,45.37
Volibear,Darius,3016,1462,1554,48.47
Volibear,Sejuani,541,304,237,56.19
Volibear,Vayne,1801,840,961,46.64
Volibear,Lux,3558,1762,1796,49.52
Volibear,KSante,552,312,240,56.52
Volibear,MasterYi,1774,864,910,48.7
Volibear,Naafiri,498,260,238,52.21
Volibear,Swain,1434,680,754,47.42
Volibear,Amumu,1689,854,835,50.56
Volibear,Taliyah,323,141,182,43.65
Volibear,Xayah,609,296,313,48.6
Volibear,Nidalee,282,174,108,61.7
Volibear,Renata,221,119,102,53.85
Volibear,Jax,1333,678,655,50.86
Volibear,Mel,2747,1356,1391,49.36
Volibear,Yorick,1392,659,733,47.34
Volibear,Elise,701,348,353,49.64
Volibear,Smolder,768,392,376,51.04
Volibear,Viego,1985,952,1033,47.96
Volibear,AurelionSol,550,286,264,52
Volibear,Kaisa,2070,1073,997,51.84
Volibear,Singed,359,175,184,48.75
Volibear,MonkeyKing,1058,563,495,53.21
Volibear,Orianna,559,280,279,50.09
Volibear,Draven,776,395,381,50.9
Volibear,Kled,268,138,130,51.49
Volibear,Ekko,1280,629,651,49.14
Volibear,Aphelios,708,340,368,48.02
Volibear,Vladimir,869,458,411,52.7
Volibear,Jayce,518,265,253,51.16
Volibear,Heimerdinger,619,298,321,48.14
Volibear,Nami,1352,589,763,43.57
Volibear,Gnar,542,253,289,46.68
Volibear,Senna,915,476,439,52.02
Volibear,Kayle,1007,495,512,49.16
Volibear,Rengar,450,205,245,45.56
Volibear,Malzahar,1396,650,746,46.56
Volibear,Aatrox,1067,566,501,53.05
Volibear,Blitzcrank,984,510,474,51.83
Volibear,Morgana,1727,805,922,46.61
Volibear,Pantheon,2143,1056,1087,49.28
Volibear,Neeko,625,330,295,52.8
Volibear,Belveth,269,135,134,50.19
Volibear,Talon,665,340,325,51.13
Volibear,Ornn,495,244,251,49.29
Volibear,JarvanIV,840,408,432,48.57
Volibear,Kayn,2262,1099,1163,48.59
Volibear,Ezreal,2676,1384,1292,51.72
Volibear,Leblanc,762,409,353,53.67
Volibear,Milio,809,363,446,44.87
Volibear,Garen,2322,1127,1195,48.54
Volibear,Lissandra,413,198,215,47.94
Volibear,TahmKench,1069,554,515,51.82
Volibear,Zed,1549,750,799,48.42
Volibear,Warwick,2517,1131,1386,44.93
Volibear,Rell,628,297,331,47.29
Volibear,Fizz,818,447,371,54.65
Volibear,XinZhao,864,438,426,50.69
Volibear,Cassiopeia,363,156,207,42.98
Volibear,Vi,1339,699,640,52.2
Volibear,Lucian,871,474,397,54.42
Volibear,Syndra,778,400,378,51.41
Volibear,Corki,464,247,217,53.23
Volibear,Qiyana,334,161,173,48.2
Volibear,Viktor,1084,522,562,48.15
Volibear,Bard,410,201,209,49.02
Volibear,TwistedFate,448,218,230,48.66
Volibear,Rakan,457,208,249,45.51
Volibear,Zoe,420,227,193,54.05
Volibear,Hecarim,459,266,193,57.95
Volibear,Rumble,268,126,142,47.01
Volibear,Sion,1008,513,495,50.89
Volibear,Sivir,619,328,291,52.99
Volibear,Velkoz,889,435,454,48.93
Volibear,Ziggs,507,261,246,51.48
Volibear,Maokai,674,334,340,49.55
Volibear,Annie,402,188,214,46.77
Volibear,Zeri,474,247,227,52.11
Volibear,Leona,1147,559,588,48.74
Volibear,Gragas,697,361,336,51.79
Volibear,Zac,646,349,297,54.02
Volibear,Ahri,1684,873,811,51.84
Volibear,Kalista,290,160,130,55.17
Volibear,Ambessa,714,384,330,53.78
Volibear,Aurora,845,384,461,45.44
Volibear,Shyvana,401,175,226,43.64
Volibear,Riven,611,349,262,57.12
Volibear,Kindred,578,256,322,44.29
Volibear,Ryze,445,239,206,53.71
Volibear,Camille,452,241,211,53.32
Volibear,Shen,832,427,405,51.32
Volibear,Yuumi,1037,548,489,52.84
Volibear,Pyke,1174,643,531,54.77
Volibear,Janna,437,219,218,50.11
Volibear,Karthus,347,157,190,45.24
Volibear,Akshan,488,226,262,46.31
Volibear,Alistar,509,234,275,45.97
Volibear,Quinn,493,236,257,47.87
Volibear,Nunu,735,367,368,49.93
Volibear,Khazix,609,353,256,57.96
Volibear,RekSai,172,84,88,48.84
Volibear,Ivern,223,103,120,46.19
Volibear,Sona,450,189,261,42
Briar,Darius,1702,902,800,53
Briar,Amumu,949,420,529,44.26
Briar,Aurora,521,309,212,59.31
Briar,Lux,2313,1268,1045,54.82
Briar,Seraphine,737,389,348,52.78
Briar,DrMundo,501,242,259,48.3
Briar,Rengar,279,160,119,57.35
Briar,Zilean,295,154,141,52.2
Briar,Ashe,1682,892,790,53.03
Briar,Thresh,1031,490,541,47.53
Briar,Sett,1186,597,589,50.34
Briar,Lillia,487,257,230,52.77
Briar,Leblanc,505,293,212,58.02
Briar,Jinx,2673,1350,1323,50.51
Briar,Alistar,313,192,121,61.34
Briar,Urgot,490,285,205,58.16
Briar,MasterYi,1165,593,572,50.9
Briar,Galio,664,331,333,49.85
Briar,Varus,698,389,309,55.73
Briar,Morgana,1115,569,546,51.03
Briar,Kennen,207,126,81,60.87
Briar,Caitlyn,2338,1234,1104,52.78
Briar,Zyra,814,432,382,53.07
Briar,Illaoi,417,223,194,53.48
Briar,Anivia,233,117,116,50.21
Briar,Yorick,986,513,473,52.03
Briar,Volibear,1062,540,522,50.85
Briar,LeeSin,1051,556,495,52.9
Briar,Teemo,1134,525,609,46.3
Briar,Vladimir,494,244,250,49.39
Briar,Xerath,703,399,304,56.76
Briar,Yone,1676,966,710,57.64
Briar,Samira,618,325,293,52.59
Briar,Yasuo,1727,927,800,53.68
Briar,Jhin,1852,987,865,53.29
Briar,Quinn,295,129,166,43.73
Briar,Zac,398,187,211,46.98
Briar,Ezreal,1792,957,835,53.4
Briar,Brand,685,352,333,51.39
Briar,Aatrox,698,377,321,54.01
Briar,Evelynn,300,130,170,43.33
Briar,Katarina,709,381,328,53.74
Briar,Kaisa,1182,655,527,55.41
Briar,Leona,756,412,344,54.5
Briar,Corki,267,131,136,49.06
Briar,Milio,442,210,232,47.51
Briar,Garen,1366,687,679,50.29
Briar,Nunu,513,291,222,56.73
Briar,Irelia,769,400,369,52.02
Briar,Kayn,1341,712,629,53.09
Briar,Shaco,853,448,405,52.52
Briar,Chogath,1040,523,517,50.29
Briar,Sylas,1012,567,445,56.03
Briar,Mel,1847,1051,796,56.9
Briar,MissFortune,2210,1179,1031,53.35
Briar,Nocturne,1206,601,605,49.83
Briar,Ahri,1151,598,553,51.95
Briar,KogMaw,311,181,130,58.2
Briar,Braum,411,191,220,46.47
Briar,TahmKench,666,341,325,51.2
Briar,Akali,920,452,468,49.13
Briar,Singed,190,106,84,55.79
Briar,Neeko,358,173,185,48.32
Briar,Renekton,385,200,185,51.95
Briar,Karthus,266,167,99,62.78
Briar,Fizz,507,252,255,49.7
Briar,Swain,827,428,399,51.75
Briar,Nami,705,341,364,48.37
Briar,Vex,499,300,199,60.12
Briar,Sejuani,289,175,114,60.55
Briar,Zed,964,493,471,51.14
Briar,Gnar,293,174,119,59.39
Briar,Khazix,419,242,177,57.76
Briar,Malzahar,930,430,500,46.24
Briar,Poppy,468,244,224,52.14
Briar,Kindred,338,218,120,64.5
Briar,Vi,836,456,380,54.55
Briar,Mordekaiser,1231,665,566,54.02
Briar,Kled,182,80,102,43.96
Briar,Viego,1174,577,597,49.15
Briar,JarvanIV,483,269,214,55.69
Briar,Jax,788,396,392,50.25
Briar,Vayne,1020,520,500,50.98
Briar,Pantheon,1350,700,650,51.85
Briar,Kayle,602,326,276,54.15
Briar,FiddleSticks,385,234,151,60.78
Briar,TwistedFate,282,154,128,54.61
Briar,Graves,483,273,210,56.52
Briar,Tristana,902,455,447,50.44
Briar,Ornn,327,186,141,56.88
Briar,Blitzcrank,611,387,224,63.34
Briar,Rammus,362,166,196,45.86
Briar,Azir,271,150,121,55.35
Briar,Ekko,850,458,392,53.88
Briar,Veigar,902,476,426,52.77
Briar,Kalista,174,104,70,59.77
Briar,Rell,361,180,181,49.86
Briar,Syndra,490,234,256,47.76
Briar,Lucian,496,278,218,56.05
Briar,Jayce,315,183,132,58.1
Briar,Lulu,1068,515,553,48.22
Briar,Diana,1467,790,677,53.85
Briar,Lissandra,278,145,133,52.16
Briar,Draven,471,251,220,53.29
Briar,Warwick,1487,764,723,51.38
Briar,Hwei,548,274,274,50
Briar,Gwen,427,234,193,54.8
Briar,Olaf,187,93,94,49.73
Briar,RekSai,85,48,37,56.47
Briar,Udyr,322,156,166,48.45
Briar,Smolder,533,310,223,58.16
Briar,Bard,217,99,118,45.62
Briar,Ambessa,479,259,220,54.07
Briar,Talon,414,242,172,58.45
Briar,Soraka,552,264,288,47.83
Briar,AurelionSol,349,196,153,56.16
Briar,Renata,122,50,72,40.98
Briar,Taliyah,209,99,110,47.37
Briar,Janna,300,151,149,50.33
Briar,KSante,423,229,194,54.14
Briar,Ryze,325,177,148,54.46
Briar,Nasus,678,332,346,48.97
Briar,Riven,389,205,184,52.7
Briar,Karma,995,544,451,54.67
Briar,Twitch,713,323,390,45.3
Briar,Pyke,646,338,308,52.32
Briar,Annie,276,126,150,45.65
Briar,Gragas,470,209,261,44.47
Briar,Kassadin,159,87,72,54.72
Briar,Trundle,574,304,270,52.96
Briar,Tryndamere,470,245,225,52.13
Briar,Orianna,336,178,158,52.98
Briar,Taric,175,92,83,52.57
Briar,Xayah,371,193,178,52.02
Briar,Rakan,349,181,168,51.86
Briar,Ziggs,306,175,131,57.19
Briar,Belveth,189,90,99,47.62
Briar,Viktor,666,321,345,48.2
Briar,Nautilus,880,475,405,53.98
Briar,Heimerdinger,399,213,186,53.38
Briar,Cassiopeia,214,115,99,53.74
Briar,Akshan,308,144,164,46.75
Briar,Yuumi,710,375,335,52.82
Briar,Sion,646,344,302,53.25
Briar,Shen,514,271,243,52.72
Briar,Sivir,458,247,211,53.93
Briar,Ivern,85,52,33,61.18
Briar,Malphite,880,498,382,56.59
Briar,Gangplank,392,154,238,39.29
Briar,Zoe,253,116,137,45.85
Briar,Velkoz,551,279,272,50.64
Briar,Hecarim,324,201,123,62.04
Briar,Nidalee,191,104,87,54.45
Briar,Maokai,379,215,164,56.73
Briar,Sona,247,137,110,55.47
Briar,Aphelios,440,245,195,55.68
Briar,Skarner,167,87,80,52.1
Briar,MonkeyKing,554,263,291,47.47
Briar,Senna,638,360,278,56.43
Briar,Camille,280,157,123,56.07
Briar,Zeri,316,171,145,54.11
Briar,Fiora,315,151,164,47.94
Briar,Naafiri,309,150,159,48.54
Briar,Elise,528,258,270,48.86
Briar,XinZhao,548,324,224,59.12
Briar,Qiyana,173,93,80,53.76
Briar,Rumble,197,112,85,56.85
Briar,Nilah,276,140,136,50.72
Briar,Shyvana,185,106,79,57.3
Rengar,Warwick,569,248,321,43.59
Rengar,Briar,279,119,160,42.65
Rengar,Zed,439,221,218,50.34
Rengar,Ziggs,114,45,69,39.47
Rengar,Xerath,276,127,149,46.01
Rengar,Sion,295,118,177,40
Rengar,Vi,342,143,199,41.81
Rengar,Sylas,426,224,202,52.58
Rengar,Lucian,281,131,150,46.62
Rengar,Pantheon,646,275,371,42.57
Rengar,Renekton,195,83,112,42.56
Rengar,XinZhao,183,88,95,48.09
Rengar,Yasuo,828,350,478,42.27
Rengar,Kalista,118,56,62,47.46
Rengar,Khazix,354,159,195,44.92
Rengar,Lissandra,148,75,73,50.68
Rengar,Rell,183,101,82,55.19
Rengar,Shen,278,138,140,49.64
Rengar,Amumu,362,191,171,52.76
Rengar,Orianna,183,112,71,61.2
Rengar,Caitlyn,962,423,539,43.97
Rengar,Sona,136,53,83,38.97
Rengar,Yone,719,400,319,55.63
Rengar,Nunu,185,92,93,49.73
Rengar,Qiyana,112,53,59,47.32
Rengar,Jinx,1145,563,582,49.17
Rengar,Morgana,414,186,228,44.93
Rengar,Gangplank,239,140,99,58.58
Rengar,Twitch,352,193,159,54.83
Rengar,Lux,959,434,525,45.26
Rengar,Ambessa,200,105,95,52.5
Rengar,Evelynn,140,47,93,33.57
Rengar,Xayah,254,120,134,47.24
Rengar,Velkoz,266,115,151,43.23
Rengar,Darius,698,325,373,46.56
Rengar,Sejuani,140,71,69,50.71
Rengar,Azir,144,67,77,46.53
Rengar,Vayne,538,223,315,41.45
Rengar,Chogath,427,225,202,52.69
Rengar,Ekko,432,227,205,52.55
Rengar,Varus,399,183,216,45.86
Rengar,Vladimir,280,117,163,41.79
Rengar,TwistedFate,123,43,80,34.96
Rengar,Trundle,172,66,106,38.37
Rengar,Illaoi,150,64,86,42.67
Rengar,Mel,865,419,446,48.44
Rengar,Nami,558,230,328,41.22
Rengar,Syndra,267,127,140,47.57
Rengar,Jhin,850,372,478,43.76
Rengar,Zyra,288,143,145,49.65
Rengar,Irelia,375,144,231,38.4
Rengar,Elise,371,172,199,46.36
Rengar,Katarina,307,126,181,41.04
Rengar,Samira,281,119,162,42.35
Rengar,Karma,514,190,324,36.96
Rengar,Jayce,157,89,68,56.69
Rengar,Yorick,373,151,222,40.48
Rengar,Hwei,262,112,150,42.75
Rengar,Soraka,207,105,102,50.72
Rengar,Udyr,118,72,46,61.02
Rengar,Volibear,450,245,205,54.44
Rengar,Akshan,153,78,75,50.98
Rengar,LeeSin,525,282,243,53.71
Rengar,Neeko,156,67,89,42.95
Rengar,Ezreal,881,431,450,48.92
Rengar,Urgot,260,99,161,38.08
Rengar,Diana,593,259,334,43.68
Rengar,Seraphine,262,132,130,50.38
Rengar,Olaf,88,29,59,32.95
Rengar,Kayn,611,292,319,47.79
Rengar,Cassiopeia,90,46,44,51.11
Rengar,Draven,196,108,88,55.1
Rengar,Teemo,469,214,255,45.63
Rengar,Kaisa,650,296,354,45.54
Rengar,JarvanIV,255,110,145,43.14
Rengar,KSante,229,104,125,45.41
Rengar,Fizz,271,129,142,47.6
Rengar,Thresh,480,221,259,46.04
Rengar,Nocturne,532,247,285,46.43
Rengar,Braum,231,86,145,37.23
Rengar,Ryze,116,61,55,52.59
Rengar,Galio,326,135,191,41.41
Rengar,Yuumi,345,162,183,46.96
Rengar,Swain,330,150,180,45.45
Rengar,Lulu,592,300,292,50.68
Rengar,Aurora,258,130,128,50.39
Rengar,Viego,533,260,273,48.78
Rengar,Annie,124,51,73,41.13
Rengar,Sivir,164,75,89,45.73
Rengar,Renata,78,30,48,38.46
Rengar,Quinn,154,62,92,40.26
Rengar,Hecarim,236,96,140,40.68
Rengar,Ahri,479,237,242,49.48
Rengar,Milio,305,154,151,50.49
Rengar,MissFortune,815,374,441,45.89
Rengar,Leona,297,147,150,49.49
Rengar,Aatrox,312,123,189,39.42
Rengar,Tryndamere,248,125,123,50.4
Rengar,Mordekaiser,513,214,299,41.72
Rengar,Anivia,119,44,75,36.97
Rengar,Shyvana,79,28,51,35.44
Rengar,Alistar,171,73,98,42.69
Rengar,Heimerdinger,167,87,80,52.1
Rengar,Veigar,377,195,182,51.72
Rengar,Gragas,222,106,116,47.75
Rengar,Tristana,370,158,212,42.7
Rengar,Sett,497,199,298,40.04
Rengar,Jax,332,148,184,44.58
Rengar,MasterYi,514,200,314,38.91
Rengar,Senna,249,135,114,54.22
Rengar,Ashe,684,320,364,46.78
Rengar,Gnar,178,72,106,40.45
Rengar,Corki,208,94,114,45.19
Rengar,Nasus,255,106,149,41.57
Rengar,Garen,606,319,287,52.64
Rengar,Camille,155,80,75,51.61
Rengar,Zeri,188,94,94,50
Rengar,Ornn,192,91,101,47.4
Rengar,Taliyah,111,56,55,50.45
Rengar,Nautilus,376,194,182,51.6
Rengar,Shaco,398,192,206,48.24
Rengar,Gwen,227,110,117,48.46
Rengar,Akali,378,165,213,43.65
Rengar,Ivern,71,27,44,38.03
Rengar,Pyke,359,174,185,48.47
Rengar,Malphite,391,178,213,45.52
Rengar,Viktor,323,159,164,49.23
Rengar,DrMundo,205,92,113,44.88
Rengar,FiddleSticks,178,77,101,43.26
Rengar,Vex,228,97,131,42.54
Rengar,Fiora,124,50,74,40.32
Rengar,Kassadin,96,50,46,52.08
Rengar,Rammus,112,41,71,36.61
Rengar,Leblanc,258,134,124,51.94
Rengar,Janna,134,77,57,57.46
Rengar,Naafiri,114,50,64,43.86
Rengar,Belveth,95,50,45,52.63
Rengar,AurelionSol,95,58,37,61.05
Rengar,Brand,306,135,171,44.12
Rengar,Zac,185,90,95,48.65
Rengar,Rakan,165,60,105,36.36
Rengar,Rumble,105,56,49,53.33
Rengar,Talon,199,107,92,53.77
Rengar,Singed,97,51,46,52.58
Rengar,Malzahar,412,178,234,43.2
Rengar,Blitzcrank,237,105,132,44.3
Rengar,Zilean,145,59,86,40.69
Rengar,Kennen,95,47,48,49.47
Rengar,KogMaw,87,36,51,41.38
Rengar,Taric,66,35,31,53.03
Rengar,MonkeyKing,252,97,155,38.49
Rengar,Kled,88,34,54,38.64
Rengar,Kindred,175,59,116,33.71
Rengar,Nidalee,127,61,66,48.03
Rengar,Kayle,292,138,154,47.26
Rengar,TahmKench,264,127,137,48.11
Rengar,Riven,163,68,95,41.72
Rengar,Karthus,153,56,97,36.6
Rengar,Skarner,110,53,57,48.18
Rengar,Aphelios,187,89,98,47.59
Rengar,Poppy,264,128,136,48.48
Rengar,Graves,247,101,146,40.89
Rengar,Zoe,158,87,71,55.06
Rengar,Smolder,187,94,93,50.27
Rengar,Bard,108,60,48,55.56
Rengar,Nilah,159,62,97,38.99
Rengar,Lillia,189,72,117,38.1
Rengar,Maokai,159,66,93,41.51
Rengar,RekSai,28,3,25,10.71
Ziggs,DrMundo,236,131,105,55.51
Ziggs,Rengar,114,69,45,60.53
Ziggs,Zilean,142,70,72,49.3
Ziggs,Ashe,938,436,502,46.48
Ziggs,Thresh,507,285,222,56.21
Ziggs,Gnar,165,83,82,50.3
Ziggs,Diana,713,402,311,56.38
Ziggs,Chogath,528,277,251,52.46
Ziggs,Jinx,1282,613,669,47.82
Ziggs,Nami,398,211,187,53.02
Ziggs,Urgot,225,118,107,52.44
Ziggs,Vi,317,175,142,55.21
Ziggs,Ekko,417,231,186,55.4
Ziggs,Caitlyn,1450,733,717,50.55
Ziggs,Bard,106,45,61,42.45
Ziggs,Jax,411,225,186,54.74
Ziggs,Shaco,458,212,246,46.29
Ziggs,Yone,742,393,349,52.96
Ziggs,KogMaw,141,58,83,41.13
Ziggs,Morgana,648,305,343,47.07
Ziggs,Heimerdinger,204,89,115,43.63
Ziggs,Kindred,182,78,104,42.86
Ziggs,Mel,963,578,385,60.02
Ziggs,Jhin,867,438,429,50.52
Ziggs,Ornn,202,107,95,52.97
Ziggs,Olaf,102,45,57,44.12
Ziggs,Lissandra,156,82,74,52.56
Ziggs,TahmKench,315,162,153,51.43
Ziggs,Malphite,466,248,218,53.22
Ziggs,Pantheon,678,326,352,48.08
Ziggs,Lulu,538,281,257,52.23
Ziggs,Nasus,298,150,148,50.34
Ziggs,Warwick,682,309,373,45.31
Ziggs,Akali,520,239,281,45.96
Ziggs,Corki,148,84,64,56.76
Ziggs,Lux,1262,653,609,51.74
Ziggs,Poppy,237,107,130,45.15
Ziggs,Viego,608,321,287,52.8
Ziggs,Pyke,323,152,171,47.06
Ziggs,Kayn,652,292,360,44.79
Ziggs,Zed,480,215,265,44.79
Ziggs,Soraka,264,119,145,45.08
Ziggs,Mordekaiser,580,248,332,42.76
Ziggs,MissFortune,1088,607,481,55.79
Ziggs,Teemo,652,302,350,46.32
Ziggs,Amumu,418,216,202,51.67
Ziggs,Hwei,311,143,168,45.98
Ziggs,Ezreal,989,475,514,48.03
Ziggs,Brand,313,154,159,49.2
Ziggs,Nocturne,579,260,319,44.91
Ziggs,Aurora,270,141,129,52.22
Ziggs,Vayne,516,253,263,49.03
Ziggs,Karma,529,277,252,52.36
Ziggs,Yorick,396,187,209,47.22
Ziggs,Sejuani,170,78,92,45.88
Ziggs,Samira,267,141,126,52.81
Ziggs,Rell,206,115,91,55.83
Ziggs,Kayle,256,127,129,49.61
Ziggs,Darius,805,415,390,51.55
Ziggs,Ahri,505,253,252,50.1
Ziggs,MasterYi,570,299,271,52.46
Ziggs,Naafiri,136,72,64,52.94
Ziggs,Nautilus,516,250,266,48.45
Ziggs,Aatrox,433,223,210,51.5
Ziggs,Garen,700,308,392,44
Ziggs,AurelionSol,188,95,93,50.53
Ziggs,Seraphine,343,156,187,45.48
Ziggs,Shen,226,100,126,44.25
Ziggs,Vex,213,111,102,52.11
Ziggs,Sett,648,333,315,51.39
Ziggs,Talon,228,120,108,52.63
Ziggs,Katarina,320,177,143,55.31
Ziggs,Swain,419,205,214,48.93
Ziggs,Renekton,197,99,98,50.25
Ziggs,Fizz,297,151,146,50.84
Ziggs,Gwen,232,95,137,40.95
Ziggs,Galio,439,180,259,41
Ziggs,Graves,269,153,116,56.88
Ziggs,Blitzcrank,342,174,168,50.88
Ziggs,Leblanc,217,94,123,43.32
Ziggs,Zyra,402,199,203,49.5
Ziggs,Quinn,160,92,68,57.5
Ziggs,Nilah,136,75,61,55.15
Ziggs,Viktor,360,190,170,52.78
Ziggs,MonkeyKing,296,141,155,47.64
Ziggs,Alistar,154,76,78,49.35
Ziggs,LeeSin,523,271,252,51.82
Ziggs,Vladimir,248,115,133,46.37
Ziggs,Kaisa,687,340,347,49.49
Ziggs,Yasuo,763,389,374,50.98
Ziggs,Rammus,126,63,63,50
Ziggs,Malzahar,501,237,264,47.31
Ziggs,Twitch,326,139,187,42.64
Ziggs,Orianna,170,99,71,58.24
Ziggs,Gragas,237,125,112,52.74
Ziggs,XinZhao,281,144,137,51.25
Ziggs,Irelia,323,168,155,52.01
Ziggs,Evelynn,145,89,56,61.38
Ziggs,Zeri,171,86,85,50.29
Ziggs,Illaoi,185,85,100,45.95
Ziggs,Zac,203,108,95,53.2
Ziggs,Milio,230,103,127,44.78
Ziggs,Khazix,218,119,99,54.59
Ziggs,Gangplank,197,105,92,53.3
Ziggs,Lucian,270,111,159,41.11
Ziggs,Sona,150,65,85,43.33
Ziggs,Volibear,507,246,261,48.52
Ziggs,Sylas,474,230,244,48.52
Ziggs,Trundle,272,143,129,52.57
Ziggs,JarvanIV,227,104,123,45.81
Ziggs,Singed,121,51,70,42.15
Ziggs,Belveth,98,54,44,55.1
Ziggs,Leona,327,138,189,42.2
Ziggs,Senna,332,180,152,54.22
Ziggs,Udyr,166,67,99,40.36
Ziggs,Velkoz,287,162,125,56.45
Ziggs,Draven,225,130,95,57.78
Ziggs,Elise,205,115,90,56.1
Ziggs,Rumble,115,75,40,65.22
Ziggs,Sion,318,175,143,55.03
Ziggs,Tryndamere,218,108,110,49.54
Ziggs,Skarner,95,51,44,53.68
Ziggs,Varus,387,225,162,58.14
Ziggs,FiddleSticks,204,108,96,52.94
Ziggs,Riven,190,89,101,46.84
Ziggs,Briar,306,131,175,42.81
Ziggs,TwistedFate,165,81,84,49.09
Ziggs,Maokai,174,89,85,51.15
Ziggs,Yuumi,254,120,134,47.24
Ziggs,Lillia,216,116,100,53.7
Ziggs,Cassiopeia,108,54,54,50
Ziggs,KSante,232,112,120,48.28
Ziggs,Kassadin,95,51,44,53.68
Ziggs,Fiora,174,90,84,51.72
Ziggs,Veigar,441,220,221,49.89
Ziggs,Ambessa,253,156,97,61.66
Ziggs,Aphelios,179,105,74,58.66
Ziggs,Kalista,108,52,56,48.15
Ziggs,Renata,75,45,30,60
Ziggs,Zoe,188,91,97,48.4
Ziggs,Nunu,277,136,141,49.1
Ziggs,Anivia,144,66,78,45.83
Ziggs,Tristana,465,228,237,49.03
Ziggs,Jayce,182,86,96,47.25
Ziggs,Annie,118,64,54,54.24
Ziggs,Braum,197,108,89,54.82
Ziggs,Xayah,165,90,75,54.55
Ziggs,Rakan,180,79,101,43.89
Ziggs,Camille,157,82,75,52.23
Ziggs,Neeko,134,76,58,56.72
Ziggs,Taric,80,27,53,33.75
Ziggs,Ryze,144,56,88,38.89
Ziggs,Janna,148,76,72,51.35
Ziggs,Hecarim,163,78,85,47.85
Ziggs,Smolder,261,151,110,57.85
Ziggs,Azir,105,65,40,61.9
Ziggs,Taliyah,116,56,60,48.28
Ziggs,Akshan,141,69,72,48.94
Ziggs,Xerath,388,232,156,59.79
Ziggs,Sivir,204,98,106,48.04
Ziggs,Kled,71,48,23,67.61
Ziggs,Ivern,56,19,37,33.93
Ziggs,Qiyana,96,41,55,42.71
Ziggs,Kennen,113,55,58,48.67
Ziggs,Karthus,120,60,60,50
Ziggs,Shyvana,101,48,53,47.52
Ziggs,Nidalee,128,72,56,56.25
Ziggs,Syndra,219,103,116,47.03
Ziggs,RekSai,41,24,17,58.54
Xerath,DrMundo,594,269,325,45.29
Xerath,Rengar,276,147,129,53.26
Xerath,Zilean,345,179,166,51.88
Xerath,Ashe,2327,1191,1136,51.18
Xerath,Thresh,1427,714,713,50.04
Xerath,Gnar,489,240,249,49.08
Xerath,Volibear,1240,565,675,45.56
Xerath,Fizz,726,370,356,50.96
Xerath,Aphelios,523,265,258,50.67
Xerath,Zyra,1305,688,617,52.72
Xerath,Darius,1881,959,922,50.98
Xerath,Diana,1772,888,884,50.11
Xerath,Vladimir,607,329,278,54.2
Xerath,Jinx,2987,1527,1460,51.12
Xerath,Morgana,1448,707,741,48.83
Xerath,Yorick,1005,492,513,48.96
Xerath,Kindred,403,240,163,59.55
Xerath,Veigar,1105,555,550,50.23
Xerath,Tristana,1063,561,502,52.78
Xerath,Nautilus,1337,690,647,51.61
Xerath,Ekko,1011,468,543,46.29
Xerath,Katarina,747,385,362,51.54
Xerath,Kaisa,1834,919,915,50.11
Xerath,Lulu,1368,739,629,54.02
Xerath,Illaoi,515,262,253,50.87
Xerath,Briar,703,304,399,43.24
Xerath,Jhin,2396,1170,1226,48.83
Xerath,Seraphine,737,386,351,52.37
Xerath,Sett,1690,795,895,47.04
Xerath,Aurora,756,382,374,50.53
Xerath,Bard,348,154,194,44.25
Xerath,Lissandra,367,236,131,64.31
Xerath,Lucian,750,380,370,50.67
Xerath,Nami,1040,523,517,50.29
Xerath,Warwick,1523,746,777,48.98
Xerath,Udyr,394,193,201,48.98
Xerath,Milio,619,317,302,51.21
Xerath,Camille,390,207,183,53.08
Xerath,Kayn,1601,837,764,52.28
Xerath,Yasuo,2102,1002,1100,47.67
Xerath,Caitlyn,3222,1640,1582,50.9
Xerath,Lux,3550,1785,1765,50.28
Xerath,Urgot,564,271,293,48.05
Xerath,Jax,1054,548,506,51.99
Xerath,Mel,2773,1497,1276,53.98
Xerath,KogMaw,293,138,155,47.1
Xerath,Karma,1658,821,837,49.52
Xerath,Gwen,485,229,256,47.22
Xerath,Rammus,312,182,130,58.33
Xerath,Riven,479,244,235,50.94
Xerath,Ahri,1433,757,676,52.83
Xerath,Teemo,1372,700,672,51.02
Xerath,Hwei,901,446,455,49.5
Xerath,Kalista,255,145,110,56.86
Xerath,Blitzcrank,976,535,441,54.82
Xerath,Ornn,443,196,247,44.24
Xerath,LeeSin,2052,1045,1007,50.93
Xerath,Velkoz,798,403,395,50.5
Xerath,Corki,386,211,175,54.66
Xerath,Malphite,1167,590,577,50.56
Xerath,MasterYi,1242,601,641,48.39
Xerath,Leblanc,831,390,441,46.93
Xerath,Samira,739,430,309,58.19
Xerath,Gragas,595,312,283,52.44
Xerath,TahmKench,710,352,358,49.58
Xerath,Irelia,942,486,456,51.59
Xerath,Shaco,965,470,495,48.7
Xerath,Sion,708,358,350,50.56
Xerath,Draven,541,267,274,49.35
Xerath,Viktor,1083,556,527,51.34
Xerath,KSante,696,398,298,57.18
Xerath,Evelynn,358,166,192,46.37
Xerath,Galio,1028,539,489,52.43
Xerath,Zed,1214,580,634,47.78
Xerath,Sivir,579,284,295,49.05
Xerath,Zoe,427,219,208,51.29
Xerath,Ezreal,3246,1685,1561,51.91
Xerath,Maokai,491,262,229,53.36
Xerath,Janna,345,144,201,41.74
Xerath,Ambessa,692,391,301,56.5
Xerath,Vi,1196,616,580,51.51
Xerath,Pyke,901,432,469,47.95
Xerath,Swain,1069,517,552,48.36
Xerath,Trundle,702,359,343,51.14
Xerath,Azir,447,235,212,52.57
Xerath,Chogath,1255,607,648,48.37
Xerath,Akshan,336,174,162,51.79
Xerath,Khazix,590,314,276,53.22
Xerath,Viego,1694,890,804,52.54
Xerath,MissFortune,2460,1288,1172,52.36
Xerath,Gangplank,497,257,240,51.71
Xerath,Nocturne,1465,643,822,43.89
Xerath,Taliyah,259,161,98,62.16
Xerath,Senna,718,365,353,50.84
Xerath,Yone,2044,1097,947,53.67
Xerath,Orianna,520,284,236,54.62
Xerath,Alistar,418,197,221,47.13
Xerath,Aatrox,1108,557,551,50.27
Xerath,Hecarim,483,252,231,52.17
Xerath,Leona,925,420,505,45.41
Xerath,Renekton,553,266,287,48.1
Xerath,Singed,332,142,190,42.77
Xerath,Xayah,480,218,262,45.42
Xerath,Quinn,430,209,221,48.6
Xerath,Qiyana,227,143,84,63
Xerath,AurelionSol,379,199,180,52.51
Xerath,Vayne,1307,641,666,49.04
Xerath,Sylas,1591,813,778,51.1
Xerath,FiddleSticks,553,273,280,49.37
Xerath,Syndra,789,444,345,56.27
Xerath,Poppy,588,302,286,51.36
Xerath,Malzahar,1230,611,619,49.67
Xerath,Pantheon,1684,881,803,52.32
Xerath,Karthus,361,192,169,53.19
Xerath,Ryze,392,172,220,43.88
Xerath,Sejuani,387,215,172,55.56
Xerath,TwistedFate,401,216,185,53.87
Xerath,Nunu,581,301,280,51.81
Xerath,Braum,462,227,235,49.13
Xerath,Amumu,1120,550,570,49.11
Xerath,Shen,582,288,294,49.48
Xerath,Garen,1625,829,796,51.02
Xerath,Yuumi,894,454,440,50.78
Xerath,Tryndamere,579,287,292,49.57
Xerath,Mordekaiser,1327,660,667,49.74
Xerath,Annie,441,195,246,44.22
Xerath,Nilah,263,123,140,46.77
Xerath,Fiora,389,189,200,48.59
Xerath,MonkeyKing,715,370,345,51.75
Xerath,Anivia,337,142,195,42.14
Xerath,Jayce,640,335,305,52.34
Xerath,Soraka,575,230,345,40
Xerath,Akali,1193,585,608,49.04
Xerath,Rumble,324,198,126,61.11
Xerath,Heimerdinger,436,199,237,45.64
Xerath,Naafiri,335,138,197,41.19
Xerath,Nasus,688,314,374,45.64
Xerath,Ivern,148,76,72,51.35
Xerath,Shyvana,234,122,112,52.14
Xerath,Smolder,654,336,318,51.38
Xerath,Vex,619,303,316,48.95
Xerath,RekSai,124,70,54,56.45
Xerath,Rakan,385,206,179,53.51
Xerath,Twitch,760,374,386,49.21
Xerath,Zac,586,288,298,49.15
Xerath,Rell,459,220,239,47.93
Xerath,JarvanIV,642,295,347,45.95
Xerath,Graves,815,382,433,46.87
Xerath,Talon,630,334,296,53.02
Xerath,Belveth,300,148,152,49.33
Xerath,Elise,891,447,444,50.17
Xerath,Varus,1067,568,499,53.23
Xerath,Kayle,712,373,339,52.39
Xerath,Zeri,448,223,225,49.78
Xerath,Neeko,505,292,213,57.82
Xerath,XinZhao,748,342,406,45.72
Xerath,Sona,319,165,154,51.72
Xerath,Ziggs,388,156,232,40.21
Xerath,Kled,192,90,102,46.88
Xerath,Taric,195,79,116,40.51
Xerath,Brand,818,436,382,53.3
Xerath,Kassadin,249,124,125,49.8
Xerath,Olaf,227,102,125,44.93
Xerath,Nidalee,397,233,164,58.69
Xerath,Cassiopeia,332,177,155,53.31
Xerath,Renata,173,103,70,59.54
Xerath,Kennen,265,127,138,47.92
Xerath,Skarner,288,122,166,42.36
Xerath,Lillia,532,282,250,53.01
Malzahar,Gnar,540,275,265,50.93
Malzahar,Diana,2093,1002,1091,47.87
Malzahar,Chogath,1506,779,727,51.73
Malzahar,Jinx,3637,1756,1881,48.28
Malzahar,Nami,1348,666,682,49.41
Malzahar,Kayle,973,491,482,50.46
Malzahar,Mordekaiser,1615,807,808,49.97
Malzahar,Yasuo,2597,1383,1214,53.25
Malzahar,Varus,1076,576,500,53.53
Malzahar,Galio,1174,565,609,48.13
Malzahar,MasterYi,1577,867,710,54.98
Malzahar,Khazix,594,328,266,55.22
Malzahar,Aurora,813,465,348,57.2
Malzahar,Ashe,2425,1226,1199,50.56
Malzahar,Thresh,1617,841,776,52.01
Malzahar,Aatrox,1075,574,501,53.4
Malzahar,Fizz,820,441,379,53.78
Malzahar,Lux,3372,1767,1605,52.4
Malzahar,Neeko,506,289,217,57.11
Malzahar,Karma,1539,757,782,49.19
Malzahar,Ivern,145,65,80,44.83
Malzahar,Anivia,423,218,205,51.54
Malzahar,TahmKench,1025,573,452,55.9
Malzahar,LeeSin,1552,844,708,54.38
Malzahar,Hwei,839,414,425,49.34
Malzahar,Tristana,1301,712,589,54.73
Malzahar,Urgot,646,302,344,46.75
Malzahar,Morgana,1509,754,755,49.97
Malzahar,Teemo,1782,896,886,50.28
Malzahar,Pantheon,1877,1021,856,54.4
Malzahar,Orianna,571,315,256,55.17
Malzahar,Warwick,1786,889,897,49.78
Malzahar,Ekko,1257,598,659,47.57
Malzahar,Jhin,2634,1318,1316,50.04
Malzahar,Shen,720,416,304,57.78
Malzahar,Nocturne,1670,737,933,44.13
Malzahar,Caitlyn,3520,1810,1710,51.42
Malzahar,MissFortune,3092,1590,1502,51.42
Malzahar,Blitzcrank,768,390,378,50.78
Malzahar,Ezreal,2703,1498,1205,55.42
Malzahar,Evelynn,406,221,185,54.43
Malzahar,Corki,459,237,222,51.63
Malzahar,Milio,852,421,431,49.41
Malzahar,Darius,2383,1209,1174,50.73
Malzahar,Sejuani,519,285,234,54.91
Malzahar,Azir,388,209,179,53.87
Malzahar,Vayne,1566,827,739,52.81
Malzahar,Kled,234,117,117,50
Malzahar,Syndra,892,475,417,53.25
Malzahar,RekSai,99,58,41,58.59
Malzahar,Katarina,853,455,398,53.34
Malzahar,Lulu,1606,801,805,49.88
Malzahar,Riven,559,311,248,55.64
Malzahar,Graves,736,355,381,48.23
Malzahar,Aphelios,698,347,351,49.71
Malzahar,Sylas,1440,765,675,53.13
Malzahar,Mel,2636,1364,1272,51.75
Malzahar,Veigar,1367,695,672,50.84
Malzahar,Maokai,535,230,305,42.99
Malzahar,Kayn,1903,1025,878,53.86
Malzahar,Sivir,700,365,335,52.14
Malzahar,Zoe,413,221,192,53.51
Malzahar,Irelia,1082,583,499,53.88
Malzahar,Kaisa,1899,1031,868,54.29
Malzahar,Swain,1382,713,669,51.59
Malzahar,Jax,1082,543,539,50.18
Malzahar,Lucian,819,399,420,48.72
Malzahar,Pyke,954,510,444,53.46
Malzahar,Ambessa,643,344,299,53.5
Malzahar,Yorick,1383,626,757,45.26
Malzahar,Viego,1647,827,820,50.21
Malzahar,Rammus,376,196,180,52.13
Malzahar,Zed,1654,835,819,50.48
Malzahar,Shaco,1329,698,631,52.52
Malzahar,Illaoi,590,310,280,52.54
Malzahar,Sett,1945,1029,916,52.9
Malzahar,Vex,632,335,297,53.01
Malzahar,FiddleSticks,550,339,211,61.64
Malzahar,Naafiri,370,186,184,50.27
Malzahar,Zyra,1228,609,619,49.59
Malzahar,Rakan,431,223,208,51.74
Malzahar,Sion,1092,569,523,52.11
Malzahar,Poppy,687,370,317,53.86
Malzahar,Smolder,1060,491,569,46.32
Malzahar,Akali,1113,553,560,49.69
Malzahar,Vladimir,895,496,399,55.42
Malzahar,Rell,644,332,312,51.55
Malzahar,XinZhao,807,410,397,50.81
Malzahar,DrMundo,723,339,384,46.89
Malzahar,Udyr,544,307,237,56.43
Malzahar,Volibear,1396,746,650,53.44
Malzahar,Akshan,482,257,225,53.32
Malzahar,Gangplank,618,351,267,56.8
Malzahar,Yone,2139,1109,1030,51.85
Malzahar,Leona,1027,560,467,54.53
Malzahar,Kalista,324,214,110,66.05
Malzahar,Seraphine,1060,533,527,50.28
Malzahar,Garen,2019,1016,1003,50.32
Malzahar,Briar,930,500,430,53.76
Malzahar,MonkeyKing,898,430,468,47.88
Malzahar,Talon,704,381,323,54.12
Malzahar,AurelionSol,701,309,392,44.08
Malzahar,Twitch,1074,549,525,51.12
Malzahar,Draven,661,345,316,52.19
Malzahar,Yuumi,956,521,435,54.5
Malzahar,JarvanIV,782,428,354,54.73
Malzahar,Ornn,558,277,281,49.64
Malzahar,Singed,407,208,199,51.11
Malzahar,TwistedFate,535,269,266,50.28
Malzahar,Nilah,444,244,200,54.95
Malzahar,Soraka,712,324,388,45.51
Malzahar,Braum,666,371,295,55.71
Malzahar,Skarner,336,190,146,56.55
Malzahar,KSante,597,316,281,52.93
Malzahar,Hecarim,549,271,278,49.36
Malzahar,Shyvana,338,173,165,51.18
Malzahar,Gragas,509,267,242,52.46
Malzahar,Kennen,314,170,144,54.14
Malzahar,Nasus,872,414,458,47.48
Malzahar,Ahri,1674,937,737,55.97
Malzahar,Leblanc,788,408,380,51.78
Malzahar,Vi,1114,539,575,48.38
Malzahar,Nautilus,1324,701,623,52.95
Malzahar,Tryndamere,750,393,357,52.4
Malzahar,Cassiopeia,358,181,177,50.56
Malzahar,Bard,344,178,166,51.74
Malzahar,Viktor,1301,653,648,50.19
Malzahar,Fiora,405,218,187,53.83
Malzahar,Samira,862,479,383,55.57
Malzahar,Ziggs,501,264,237,52.69
Malzahar,Sona,436,203,233,46.56
Malzahar,Amumu,1357,645,712,47.53
Malzahar,Malphite,1269,638,631,50.28
Malzahar,Elise,771,418,353,54.22
Malzahar,Kassadin,251,117,134,46.61
Malzahar,Renekton,517,263,254,50.87
Malzahar,Lillia,663,307,356,46.3
Malzahar,Nidalee,272,168,104,61.76
Malzahar,Belveth,268,173,95,64.55
Malzahar,Velkoz,844,430,414,50.95
Malzahar,Trundle,821,399,422,48.6
Malzahar,Zeri,435,240,195,55.17
Malzahar,Karthus,363,211,152,58.13
Malzahar,KogMaw,396,192,204,48.48
Malzahar,Senna,944,507,437,53.71
Malzahar,Zilean,397,194,203,48.87
Malzahar,Janna,388,188,200,48.45
Malzahar,Xerath,1230,619,611,50.33
Malzahar,Nunu,722,374,348,51.8
Malzahar,Brand,1007,531,476,52.73
Malzahar,Heimerdinger,599,314,285,52.42
Malzahar,Kindred,547,312,235,57.04
Malzahar,Taric,302,166,136,54.97
Malzahar,Alistar,516,305,211,59.11
Malzahar,Olaf,291,141,150,48.45
Malzahar,Taliyah,280,143,137,51.07
Malzahar,Ryze,444,292,152,65.77
Malzahar,Jayce,467,247,220,52.89
Malzahar,Zac,554,304,250,54.87
Malzahar,Rumble,292,159,133,54.45
Malzahar,Annie,423,202,221,47.75
Malzahar,Qiyana,256,147,109,57.42
Malzahar,Rengar,412,234,178,56.8
Malzahar,Lissandra,379,191,188,50.4
Malzahar,Xayah,617,314,303,50.89
Malzahar,Camille,402,183,219,45.52
Malzahar,Quinn,374,175,199,46.79
Malzahar,Gwen,624,351,273,56.25
Malzahar,Renata,184,93,91,50.54
Sona,Gnar,109,48,61,44.04
Sona,Diana,638,319,319,50
Sona,Chogath,459,244,215,53.16
Sona,Jinx,1219,593,626,48.65
Sona,Nami,504,270,234,53.57
Sona,Yorick,458,201,257,43.89
Sona,Rengar,136,83,53,61.03
Sona,Irelia,314,147,167,46.82
Sona,Ezreal,828,467,361,56.4
Sona,Soraka,217,99,118,45.62
Sona,Poppy,194,101,93,52.06
Sona,Viego,454,239,215,52.64
Sona,Mel,785,430,355,54.78
Sona,Pyke,292,163,129,55.82
Sona,Warwick,611,330,281,54.01
Sona,Garen,621,313,308,50.4
Sona,Smolder,232,126,106,54.31
Sona,Swain,401,200,201,49.88
Sona,Zyra,355,197,158,55.49
Sona,Olaf,59,33,26,55.93
Sona,Shaco,357,204,153,57.14
Sona,Vladimir,259,149,110,57.53
Sona,Twitch,307,133,174,43.32
Sona,Pantheon,558,282,276,50.54
Sona,Hecarim,184,83,101,45.11
Sona,Naafiri,98,55,43,56.12
Sona,MissFortune,886,427,459,48.19
Sona,Nautilus,325,167,158,51.38
Sona,Yasuo,699,378,321,54.08
Sona,Akali,391,199,192,50.9
Sona,Kaisa,580,302,278,52.07
Sona,Gangplank,202,104,98,51.49
Sona,Fizz,251,163,88,64.94
Sona,Lucian,246,144,102,58.54
Sona,Blitzcrank,228,97,131,42.54
Sona,Kayle,297,150,147,50.51
Sona,Jayce,152,88,64,57.89
Sona,Ashe,707,384,323,54.31
Sona,Morgana,523,267,256,51.05
Sona,Ahri,514,274,240,53.31
Sona,Ryze,101,60,41,59.41
Sona,Milio,294,156,138,53.06
Sona,Vayne,511,289,222,56.56
Sona,Taliyah,104,44,60,42.31
Sona,Seraphine,373,225,148,60.32
Sona,KSante,163,78,85,47.85
Sona,Evelynn,121,60,61,49.59
Sona,Lux,965,461,504,47.77
Sona,Jhin,830,416,414,50.12
Sona,Zilean,166,69,97,41.57
Sona,Kindred,166,82,84,49.4
Sona,Aatrox,281,148,133,52.67
Sona,XinZhao,252,117,135,46.43
Sona,Tristana,413,257,156,62.23
Sona,Maokai,131,66,65,50.38
Sona,Sion,267,158,109,59.18
Sona,Graves,195,101,94,51.79
Sona,Samira,256,145,111,56.64
Sona,Lulu,542,256,286,47.23
Sona,Rammus,101,44,57,43.56
Sona,Yone,660,377,283,57.12
Sona,Gwen,225,122,103,54.22
Sona,Malzahar,436,233,203,53.44
Sona,Ornn,185,95,90,51.35
Sona,Jax,388,202,186,52.06
Sona,Teemo,493,270,223,54.77
Sona,Urgot,247,89,158,36.03
Sona,MonkeyKing,239,131,108,54.81
Sona,Velkoz,215,117,98,54.42
Sona,Ivern,74,45,29,60.81
Sona,Sylas,482,238,244,49.38
Sona,JarvanIV,237,125,112,52.74
Sona,Karthus,114,58,56,50.88
Sona,Leona,294,148,146,50.34
Sona,Ziggs,150,85,65,56.67
Sona,Yuumi,301,187,114,62.13
Sona,Gragas,219,133,86,60.73
Sona,Senna,304,145,159,47.7
Sona,Riven,192,87,105,45.31
Sona,Aphelios,177,80,97,45.2
Sona,Aurora,272,169,103,62.13
Sona,Varus,340,184,156,54.12
Sona,Janna,182,120,62,65.93
Sona,Sett,496,263,233,53.02
Sona,Akshan,132,71,61,53.79
Sona,Caitlyn,1071,577,494,53.87
Sona,Mordekaiser,419,218,201,52.03
Sona,Sivir,169,95,74,56.21
Sona,Thresh,476,249,227,52.31
Sona,Nasus,287,169,118,58.89
Sona,FiddleSticks,207,103,104,49.76
Sona,Katarina,264,147,117,55.68
Sona,Zac,176,85,91,48.3
Sona,Taric,111,56,55,50.45
Sona,Amumu,370,186,184,50.27
Sona,Draven,210,118,92,56.19
Sona,Vi,328,168,160,51.22
Sona,Orianna,126,70,56,55.56
Sona,Viktor,345,157,188,45.51
Sona,Veigar,410,185,225,45.12
Sona,LeeSin,446,256,190,57.4
Sona,Elise,212,121,91,57.08
Sona,Darius,742,366,376,49.33
Sona,Syndra,193,112,81,58.03
Sona,Galio,343,169,174,49.27
Sona,Nocturne,476,212,264,44.54
Sona,Nilah,119,76,43,63.87
Sona,Bard,101,70,31,69.31
Sona,Kennen,95,43,52,45.26
Sona,Renekton,250,123,127,49.2
Sona,Ekko,374,201,173,53.74
Sona,Zed,355,194,161,54.65
Sona,Rakan,145,76,69,52.41
Sona,Zoe,127,77,50,60.63
Sona,Skarner,112,67,45,59.82
Sona,KogMaw,184,83,101,45.11
Sona,Anivia,108,45,63,41.67
Sona,Ambessa,196,115,81,58.67
Sona,TahmKench,272,136,136,50
Sona,Kled,63,32,31,50.79
Sona,Illaoi,156,74,82,47.44
Sona,Brand,305,174,131,57.05
Sona,Nunu,179,100,79,55.87
Sona,Malphite,341,177,164,51.91
Sona,Kalista,76,34,42,44.74
Sona,Xayah,126,56,70,44.44
Sona,Azir,151,90,61,59.6
Sona,Briar,247,110,137,44.53
Sona,Khazix,211,126,85,59.72
Sona,Leblanc,223,112,111,50.22
Sona,Heimerdinger,203,93,110,45.81
Sona,Karma,482,286,196,59.34
Sona,MasterYi,489,256,233,52.35
Sona,Shen,242,143,99,59.09
Sona,Tryndamere,238,129,109,54.2
Sona,TwistedFate,151,73,78,48.34
Sona,Singed,109,58,51,53.21
Sona,Talon,189,106,83,56.08
Sona,Zeri,130,75,55,57.69
Sona,Kayn,602,328,274,54.49
Sona,Fiora,135,67,68,49.63
Sona,Camille,134,91,43,67.91
Sona,Quinn,144,71,73,49.31
Sona,DrMundo,218,103,115,47.25
Sona,Rell,178,88,90,49.44
Sona,Volibear,450,261,189,58
Sona,Lillia,201,118,83,58.71
Sona,Corki,108,48,60,44.44
Sona,Hwei,264,141,123,53.41
Sona,Braum,139,60,79,43.17
Sona,Xerath,319,154,165,48.28
Sona,RekSai,72,37,35,51.39
Sona,Renata,82,51,31,62.2
Sona,Lissandra,82,39,43,47.56
Sona,Neeko,175,73,102,41.71
Sona,AurelionSol,137,55,82,40.15
Sona,Sejuani,148,71,77,47.97
Sona,Nidalee,110,63,47,57.27
Sona,Udyr,143,52,91,36.36
Sona,Kassadin,78,40,38,51.28
Sona,Alistar,123,76,47,61.79
Sona,Qiyana,69,40,29,57.97
Sona,Shyvana,85,50,35,58.82
Sona,Vex,171,95,76,55.56
Sona,Trundle,213,129,84,60.56
Sona,Annie,135,58,77,42.96
Sona,Belveth,95,51,44,53.68
Sona,Cassiopeia,109,79,30,72.48
Sona,Rumble,95,53,42,55.79
Gnar,Darius,957,503,454,52.56
Gnar,Zac,250,114,136,45.6
Gnar,Malzahar,540,265,275,49.07
Gnar,Ziggs,165,82,83,49.7
Gnar,Sona,109,61,48,55.96
Gnar,KSante,344,176,168,51.16
Gnar,Hwei,308,147,161,47.73
Gnar,Evelynn,212,118,94,55.66
Gnar,Sivir,297,157,140,52.86
Gnar,Thresh,675,300,375,44.44
Gnar,Sett,644,318,326,49.38
Gnar,Vex,280,133,147,47.5
Gnar,MissFortune,1071,489,582,45.66
Gnar,Xerath,489,249,240,50.92
Gnar,Jax,348,162,186,46.55
Gnar,Skarner,113,63,50,55.75
Gnar,Irelia,450,200,250,44.44
Gnar,Alistar,253,111,142,43.87
Gnar,Braum,296,151,145,51.01
Gnar,Aurora,368,183,185,49.73
Gnar,Ashe,945,445,500,47.09
Gnar,Nunu,277,144,133,51.99
Gnar,Camille,193,99,94,51.3
Gnar,Kayn,619,303,316,48.95
Gnar,Lux,1087,533,554,49.03
Gnar,Quinn,201,90,111,44.78
Gnar,Yuumi,326,167,159,51.23
Gnar,Malphite,680,340,340,50
Gnar,MasterYi,546,282,264,51.65
Gnar,Syndra,307,132,175,43
Gnar,Corki,195,113,82,57.95
Gnar,Soraka,256,123,133,48.05
Gnar,Poppy,365,170,195,46.58
Gnar,Zed,553,280,273,50.63
Gnar,Elise,380,176,204,46.32
Gnar,Teemo,551,289,262,52.45
Gnar,Yone,891,440,451,49.38
Gnar,Varus,501,249,252,49.7
Gnar,Blitzcrank,310,171,139,55.16
Gnar,Jinx,1379,672,707,48.73
Gnar,Nami,563,285,278,50.62
Gnar,Akali,470,233,237,49.57
Gnar,Viktor,471,245,226,52.02
Gnar,Ezreal,1310,720,590,54.96
Gnar,Leona,362,193,169,53.31
Gnar,Pantheon,803,400,403,49.81
Gnar,Hecarim,166,55,111,33.13
Gnar,Naafiri,170,87,83,51.18
Gnar,Nautilus,550,277,273,50.36
Gnar,Ambessa,304,137,167,45.07
Gnar,Nocturne,687,344,343,50.07
Gnar,Kassadin,124,51,73,41.13
Gnar,Caitlyn,1294,633,661,48.92
Gnar,Volibear,542,289,253,53.32
Gnar,Aphelios,212,92,120,43.4
Gnar,Swain,499,255,244,51.1
Gnar,Gwen,235,140,95,59.57
Gnar,Diana,765,372,393,48.63
Gnar,JarvanIV,262,125,137,47.71
Gnar,Leblanc,312,138,174,44.23
Gnar,Xayah,245,120,125,48.98
Gnar,Gangplank,259,125,134,48.26
Gnar,Vi,483,265,218,54.87
Gnar,Mel,909,469,440,51.6
Gnar,Renekton,256,127,129,49.61
Gnar,Warwick,703,332,371,47.23
Gnar,Briar,293,119,174,40.61
Gnar,Kennen,139,46,93,33.09
Gnar,Yasuo,914,432,482,47.26
Gnar,Urgot,251,109,142,43.43
Gnar,Talon,270,151,119,55.93
Gnar,Sejuani,251,109,142,43.43
Gnar,Ryze,206,91,115,44.17
Gnar,Karma,623,301,322,48.31
Gnar,Vayne,597,318,279,53.27
Gnar,Sylas,759,368,391,48.48
Gnar,Shaco,475,236,239,49.68
Gnar,Lulu,723,360,363,49.79
Gnar,Aatrox,433,199,234,45.96
Gnar,Lucian,389,183,206,47.04
Gnar,Amumu,491,249,242,50.71
Gnar,Ahri,654,330,324,50.46
Gnar,Twitch,372,164,208,44.09
Gnar,Trundle,249,135,114,54.22
Gnar,LeeSin,785,410,375,52.23
Gnar,Neeko,204,94,110,46.08
Gnar,Morgana,494,242,252,48.99
Gnar,Fizz,274,121,153,44.16
Gnar,Kaisa,843,423,420,50.18
Gnar,Ekko,426,172,254,40.38
Gnar,Jayce,290,152,138,52.41
Gnar,Jhin,1058,539,519,50.95
Gnar,Mordekaiser,494,247,247,50
Gnar,Gragas,305,137,168,44.92
Gnar,Garen,777,396,381,50.97
Gnar,Chogath,567,294,273,51.85
Gnar,RekSai,65,37,28,56.92
Gnar,Vladimir,331,169,162,51.06
Gnar,Taliyah,108,56,52,51.85
Gnar,Zyra,443,196,247,44.24
Gnar,MonkeyKing,301,167,134,55.48
Gnar,Zilean,172,81,91,47.09
Gnar,Galio,406,197,209,48.52
Gnar,Seraphine,320,151,169,47.19
Gnar,Anivia,180,105,75,58.33
Gnar,Viego,691,365,326,52.82
Gnar,Tristana,448,237,211,52.9
Gnar,Rengar,178,106,72,59.55
Gnar,Rumble,172,97,75,56.4
Gnar,Sion,330,168,162,50.91
Gnar,Draven,230,113,117,49.13
Gnar,Pyke,369,186,183,50.41
Gnar,Udyr,228,113,115,49.56
Gnar,Qiyana,121,65,56,53.72
Gnar,Renata,118,56,62,47.46
Gnar,Tryndamere,228,121,107,53.07
Gnar,FiddleSticks,226,117,109,51.77
Gnar,Katarina,319,163,156,51.1
Gnar,Shyvana,124,74,50,59.68
Gnar,Maokai,222,114,108,51.35
Gnar,Olaf,133,73,60,54.89
Gnar,Samira,278,126,152,45.32
Gnar,Orianna,259,134,125,51.74
Gnar,Brand,345,198,147,57.39
Gnar,AurelionSol,167,92,75,55.09
Gnar,Bard,159,64,95,40.25
Gnar,Yorick,413,198,215,47.94
Gnar,Zeri,215,107,108,49.77
Gnar,Cassiopeia,113,41,72,36.28
Gnar,Illaoi,179,70,109,39.11
Gnar,Velkoz,269,122,147,45.35
Gnar,Rakan,162,94,68,58.02
Gnar,Senna,381,196,185,51.44
Gnar,DrMundo,259,133,126,51.35
Gnar,Lillia,234,123,111,52.56
Gnar,Kayle,307,166,141,54.07
Gnar,Azir,181,113,68,62.43
Gnar,Milio,320,141,179,44.06
Gnar,Veigar,478,223,255,46.65
Gnar,Rell,232,115,117,49.57
Gnar,Rammus,116,60,56,51.72
Gnar,TwistedFate,196,93,103,47.45
Gnar,Shen,304,140,164,46.05
Gnar,Karthus,153,82,71,53.59
Gnar,Smolder,258,139,119,53.88
Gnar,Graves,335,159,176,47.46
Gnar,XinZhao,328,151,177,46.04
Gnar,Kalista,121,64,57,52.89
Gnar,Ornn,189,87,102,46.03
Gnar,Kindred,185,89,96,48.11
Gnar,Nasus,258,119,139,46.12
Gnar,Annie,163,62,101,38.04
Gnar,Khazix,231,122,109,52.81
Gnar,TahmKench,395,176,219,44.56
Gnar,Heimerdinger,168,61,107,36.31
Gnar,Singed,129,53,76,41.09
Gnar,Belveth,102,42,60,41.18
Gnar,Nilah,107,35,72,32.71
Gnar,Kled,89,44,45,49.44
Gnar,Lissandra,223,95,128,42.6
Gnar,Zoe,176,89,87,50.57
Gnar,Riven,181,77,104,42.54
Gnar,Janna,173,97,76,56.07
Gnar,Taric,101,50,51,49.5
Gnar,Akshan,167,81,86,48.5
Gnar,KogMaw,134,74,60,55.22
Gnar,Ivern,60,39,21,65
Gnar,Fiora,145,59,86,40.69
Gnar,Nidalee,156,77,79,49.36
Hecarim,Kayle,363,171,192,47.11
Hecarim,Mordekaiser,593,268,325,45.19
Hecarim,Yasuo,930,433,497,46.56
Hecarim,Varus,502,269,233,53.59
Hecarim,Galio,389,166,223,42.67
Hecarim,Urgot,227,100,127,44.05
Hecarim,Vi,498,260,238,52.21
Hecarim,Ekko,480,236,244,49.17
Hecarim,Caitlyn,1308,679,629,51.91
Hecarim,Bard,225,114,111,50.67
Hecarim,Jax,473,255,218,53.91
Hecarim,Rammus,141,63,78,44.68
Hecarim,Viktor,521,285,236,54.7
Hecarim,Jinx,1504,679,825,45.15
Hecarim,Soraka,298,149,149,50
Hecarim,Swain,430,199,231,46.28
Hecarim,MasterYi,525,232,293,44.19
Hecarim,Kaisa,832,419,413,50.36
Hecarim,Morgana,520,225,295,43.27
Hecarim,Garen,791,364,427,46.02
Hecarim,Udyr,239,106,133,44.35
Hecarim,Vladimir,374,168,206,44.92
Hecarim,Jhin,1028,441,587,42.9
Hecarim,Zyra,495,227,268,45.86
Hecarim,Gnar,166,111,55,66.87
Hecarim,FiddleSticks,281,144,137,51.25
Hecarim,Irelia,427,207,220,48.48
Hecarim,Smolder,330,164,166,49.7
Hecarim,Sona,184,101,83,54.89
Hecarim,KSante,283,152,131,53.71
Hecarim,Taliyah,155,78,77,50.32
Hecarim,Leblanc,293,124,169,42.32
Hecarim,Lux,1145,574,571,50.13
Hecarim,Lillia,324,168,156,51.85
Hecarim,Akali,482,232,250,48.13
Hecarim,Pantheon,708,367,341,51.84
Hecarim,Draven,304,150,154,49.34
Hecarim,Zilean,152,57,95,37.5
Hecarim,Shaco,487,240,247,49.28
Hecarim,Sion,408,199,209,48.77
Hecarim,Yorick,431,174,257,40.37
Hecarim,Nunu,294,149,145,50.68
Hecarim,Ahri,662,296,366,44.71
Hecarim,Camille,188,89,99,47.34
Hecarim,Rengar,236,140,96,59.32
Hecarim,Aatrox,414,212,202,51.21
Hecarim,Malzahar,549,278,271,50.64
Hecarim,Nami,587,251,336,42.76
Hecarim,Tryndamere,280,119,161,42.5
Hecarim,Zed,690,372,318,53.91
Hecarim,Ezreal,1266,630,636,49.76
Hecarim,Hwei,306,153,153,50
Hecarim,Rumble,152,71,81,46.71
Hecarim,Kayn,660,334,326,50.61
Hecarim,Jayce,252,107,145,42.46
Hecarim,Vayne,690,318,372,46.09
Hecarim,LeeSin,913,423,490,46.33
Hecarim,Ornn,222,125,97,56.31
Hecarim,Twitch,391,190,201,48.59
Hecarim,Renata,81,33,48,40.74
Hecarim,Shyvana,162,66,96,40.74
Hecarim,Mel,1039,505,534,48.6
Hecarim,Milio,350,158,192,45.14
Hecarim,Volibear,459,193,266,42.05
Hecarim,Corki,268,137,131,51.12
Hecarim,Sett,684,302,382,44.15
Hecarim,Veigar,430,164,266,38.14
Hecarim,Darius,933,418,515,44.8
Hecarim,Gragas,342,158,184,46.2
Hecarim,Naafiri,165,104,61,63.03
Hecarim,MissFortune,977,479,498,49.03
Hecarim,Lulu,765,416,349,54.38
Hecarim,Teemo,567,257,310,45.33
Hecarim,Maokai,241,101,140,41.91
Hecarim,Neeko,224,124,100,55.36
Hecarim,Nocturne,607,284,323,46.79
Hecarim,Amumu,512,243,269,47.46
Hecarim,Xerath,483,231,252,47.83
Hecarim,Ambessa,362,194,168,53.59
Hecarim,Karma,669,316,353,47.23
Hecarim,Malphite,444,255,189,57.43
Hecarim,Katarina,398,207,191,52.01
Hecarim,Samira,335,179,156,53.43
Hecarim,Pyke,394,202,192,51.27
Hecarim,Thresh,663,336,327,50.68
Hecarim,Lucian,353,167,186,47.31
Hecarim,Elise,400,185,215,46.25
Hecarim,Janna,206,92,114,44.66
Hecarim,Quinn,167,89,78,53.29
Hecarim,JarvanIV,326,169,157,51.84
Hecarim,Qiyana,126,66,60,52.38
Hecarim,Ashe,970,464,506,47.84
Hecarim,TahmKench,344,163,181,47.38
Hecarim,XinZhao,295,138,157,46.78
Hecarim,Rakan,207,114,93,55.07
Hecarim,Graves,314,161,153,51.27
Hecarim,Sylas,791,381,410,48.17
Hecarim,Nasus,409,200,209,48.9
Hecarim,Yone,832,394,438,47.36
Hecarim,Illaoi,173,71,102,41.04
Hecarim,Khazix,284,144,140,50.7
Hecarim,Poppy,287,161,126,56.1
Hecarim,Fiora,175,91,84,52
Hecarim,Brand,364,158,206,43.41
Hecarim,Anivia,166,65,101,39.16
Hecarim,AurelionSol,218,103,115,47.25
Hecarim,Gwen,238,113,125,47.48
Hecarim,Leona,428,203,225,47.43
Hecarim,Cassiopeia,157,80,77,50.96
Hecarim,Tristana,497,255,242,51.31
Hecarim,Yuumi,365,176,189,48.22
Hecarim,Kled,87,38,49,43.68
Hecarim,MonkeyKing,312,112,200,35.9
Hecarim,Karthus,160,95,65,59.38
Hecarim,Briar,324,123,201,37.96
Hecarim,Xayah,226,139,87,61.5
Hecarim,DrMundo,241,121,120,50.21
Hecarim,Senna,366,169,197,46.17
Hecarim,Diana,743,373,370,50.2
Hecarim,Shen,307,159,148,51.79
Hecarim,Annie,185,100,85,54.05
Hecarim,Trundle,301,139,162,46.18
Hecarim,Riven,251,129,122,51.39
Hecarim,Velkoz,357,158,199,44.26
Hecarim,Seraphine,335,147,188,43.88
Hecarim,Vex,240,110,130,45.83
Hecarim,Kassadin,105,58,47,55.24
Hecarim,Lissandra,165,80,85,48.48
Hecarim,Taric,109,45,64,41.28
Hecarim,Alistar,189,79,110,41.8
Hecarim,Zeri,230,105,125,45.65
Hecarim,Talon,330,167,163,50.61
Hecarim,Ziggs,163,85,78,52.15
Hecarim,Renekton,255,121,134,47.45
Hecarim,Warwick,593,272,321,45.87
Hecarim,Chogath,546,264,282,48.35
Hecarim,Orianna,233,102,131,43.78
Hecarim,Aphelios,270,140,130,51.85
Hecarim,Akshan,180,102,78,56.67
Hecarim,Singed,161,69,92,42.86
Hecarim,Sivir,285,141,144,49.47
Hecarim,Viego,769,374,395,48.63
Hecarim,Zac,243,114,129,46.91
Hecarim,Nautilus,557,273,284,49.01
Hecarim,Evelynn,128,61,67,47.66
Hecarim,Kennen,128,79,49,61.72
Hecarim,Braum,295,168,127,56.95
Hecarim,Ryze,165,74,91,44.85
Hecarim,Fizz,269,136,133,50.56
Hecarim,TwistedFate,181,105,76,58.01
Hecarim,Gangplank,303,154,149,50.83
Hecarim,Kindred,262,136,126,51.91
Hecarim,Olaf,98,54,44,55.1
Hecarim,Aurora,370,168,202,45.41
Hecarim,Zoe,135,68,67,50.37
Hecarim,Ivern,76,43,33,56.58
Hecarim,Sejuani,202,104,98,51.49
Hecarim,Belveth,132,76,56,57.58
Hecarim,Azir,168,102,66,60.71
Hecarim,Skarner,105,54,51,51.43
Hecarim,Kalista,128,51,77,39.84
Hecarim,Nidalee,149,82,67,55.03
Hecarim,Blitzcrank,357,144,213,40.34
Hecarim,Syndra,376,176,200,46.81
Hecarim,KogMaw,163,79,84,48.47
Hecarim,RekSai,80,23,57,28.75
Hecarim,Rell,264,151,113,57.2
Hecarim,Heimerdinger,170,65,105,38.24
Hecarim,Nilah,119,72,47,60.5
Kayle,Irelia,776,403,373,51.93
Kayle,Hecarim,363,192,171,52.89
Kayle,Malzahar,973,482,491,49.54
Kayle,Vayne,1102,559,543,50.73
Kayle,Pantheon,1164,538,626,46.22
Kayle,Teemo,941,442,499,46.97
Kayle,Jax,857,435,422,50.76
Kayle,Fizz,524,267,257,50.95
Kayle,Kaisa,1151,631,520,54.82
Kayle,Morgana,1129,574,555,50.84
Kayle,Gangplank,449,266,183,59.24
Kayle,Kindred,413,229,184,55.45
Kayle,Aurora,543,302,241,55.62
Kayle,Sivir,361,190,171,52.63
Kayle,Yuumi,603,275,328,45.61
Kayle,Sion,653,338,315,51.76
Kayle,Sylas,1004,543,461,54.08
Kayle,Zed,818,444,374,54.28
Kayle,Tristana,865,429,436,49.6
Kayle,Velkoz,542,298,244,54.98
Kayle,Malphite,914,492,422,53.83
Kayle,Shyvana,191,88,103,46.07
Kayle,Naafiri,257,152,105,59.14
Kayle,MissFortune,1914,962,952,50.26
Kayle,Maokai,399,192,207,48.12
Kayle,Heimerdinger,351,146,205,41.6
Kayle,Olaf,157,86,71,54.78
Kayle,Lissandra,275,152,123,55.27
Kayle,Jhin,1744,879,865,50.4
Kayle,TahmKench,559,301,258,53.85
Kayle,Udyr,329,162,167,49.24
Kayle,FiddleSticks,377,203,174,53.85
Kayle,Kennen,194,104,90,53.61
Kayle,Nilah,279,122,157,43.73
Kayle,Taric,249,129,120,51.81
Kayle,Chogath,1079,532,547,49.3
Kayle,RekSai,94,57,37,60.64
Kayle,Katarina,635,326,309,51.34
Kayle,Lulu,1040,557,483,53.56
Kayle,Mel,1699,856,843,50.38
Kayle,Ashe,1339,661,678,49.37
Kayle,Sett,1247,661,586,53.01
Kayle,Ezreal,1602,829,773,51.75
Kayle,Annie,279,138,141,49.46
Kayle,DrMundo,393,190,203,48.35
Kayle,Viktor,660,328,332,49.7
Kayle,Twitch,753,411,342,54.58
Kayle,Brand,659,341,318,51.75
Kayle,Diana,1278,585,693,45.77
Kayle,Evelynn,302,163,139,53.97
Kayle,Darius,1612,846,766,52.48
Kayle,MasterYi,970,458,512,47.22
Kayle,Caitlyn,2281,1163,1118,50.99
Kayle,Soraka,489,247,242,50.51
Kayle,Aatrox,634,337,297,53.15
Kayle,Amumu,939,456,483,48.56
Kayle,Leona,639,371,268,58.06
Kayle,Yasuo,1525,840,685,55.08
Kayle,Graves,531,260,271,48.96
Kayle,Lucian,577,307,270,53.21
Kayle,Nami,928,440,488,47.41
Kayle,Mordekaiser,1094,608,486,55.58
Kayle,Poppy,431,192,239,44.55
Kayle,Draven,473,265,208,56.03
Kayle,Sona,297,147,150,49.49
Kayle,Ahri,1012,514,498,50.79
Kayle,Braum,488,259,229,53.07
Kayle,Kayn,1175,614,561,52.26
Kayle,Veigar,931,478,453,51.34
Kayle,Ziggs,256,129,127,50.39
Kayle,Volibear,1007,512,495,50.84
Kayle,Akshan,311,145,166,46.62
Kayle,Jinx,2457,1255,1202,51.08
Kayle,Illaoi,410,237,173,57.8
Kayle,Hwei,536,245,291,45.71
Kayle,Yorick,982,513,469,52.24
Kayle,Akali,821,415,406,50.55
Kayle,Yone,1316,652,664,49.54
Kayle,Warwick,1177,557,620,47.32
Kayle,Smolder,583,322,261,55.23
Kayle,Fiora,279,169,110,60.57
Kayle,Trundle,417,198,219,47.48
Kayle,TwistedFate,322,187,135,58.07
Kayle,Ekko,818,421,397,51.47
Kayle,Blitzcrank,462,218,244,47.19
Kayle,LeeSin,804,398,406,49.5
Kayle,Nasus,715,307,408,42.94
Kayle,KogMaw,256,143,113,55.86
Kayle,Thresh,999,518,481,51.85
Kayle,Shaco,769,385,384,50.07
Kayle,Briar,602,276,326,45.85
Kayle,Quinn,311,133,178,42.77
Kayle,Nunu,483,245,238,50.72
Kayle,Kled,150,65,85,43.33
Kayle,Vladimir,631,346,285,54.83
Kayle,Senna,622,315,307,50.64
Kayle,Vex,438,206,232,47.03
Kayle,KSante,404,210,194,51.98
Kayle,Aphelios,447,275,172,61.52
Kayle,Viego,1088,547,541,50.28
Kayle,Seraphine,696,344,352,49.43
Kayle,Cassiopeia,239,127,112,53.14
Kayle,Xayah,393,197,196,50.13
Kayle,Lux,2074,1096,978,52.84
Kayle,Urgot,523,256,267,48.95
Kayle,Gragas,449,221,228,49.22
Kayle,Qiyana,186,89,97,47.85
Kayle,Milio,480,241,239,50.21
Kayle,XinZhao,455,211,244,46.37
Kayle,Renekton,331,142,189,42.9
Kayle,Ryze,268,143,125,53.36
Kayle,Varus,690,361,329,52.32
Kayle,Pyke,712,393,319,55.2
Kayle,Garen,1539,833,706,54.13
Kayle,Samira,583,313,270,53.69
Kayle,Ornn,341,158,183,46.33
Kayle,Swain,846,423,423,50
Kayle,Talon,438,223,215,50.91
Kayle,Elise,436,200,236,45.87
Kayle,Neeko,320,179,141,55.94
Kayle,Khazix,350,209,141,59.71
Kayle,AurelionSol,283,147,136,51.94
Kayle,JarvanIV,523,273,250,52.2
Kayle,Lillia,474,258,216,54.43
Kayle,Karma,893,520,373,58.23
Kayle,Riven,360,184,176,51.11
Kayle,Vi,724,408,316,56.35
Kayle,Azir,250,112,138,44.8
Kayle,Singed,263,156,107,59.32
Kayle,Zeri,270,132,138,48.89
Kayle,Bard,241,128,113,53.11
Kayle,Zoe,267,120,147,44.94
Kayle,Leblanc,388,194,194,50
Kayle,Nautilus,751,405,346,53.93
Kayle,Belveth,198,95,103,47.98
Kayle,Orianna,284,139,145,48.94
Kayle,Zyra,687,354,333,51.53
Kayle,Gwen,389,213,176,54.76
Kayle,Zilean,312,141,171,45.19
Kayle,Ambessa,415,218,197,52.53
Kayle,Rakan,281,154,127,54.8
Kayle,Anivia,315,165,150,52.38
Kayle,Nocturne,957,500,457,52.25
Kayle,Shen,530,306,224,57.74
Kayle,MonkeyKing,493,248,245,50.3
Kayle,Syndra,546,290,256,53.11
Kayle,Sejuani,262,134,128,51.15
Kayle,Galio,658,302,356,45.9
Kayle,Gnar,307,141,166,45.93
Kayle,Karthus,237,128,109,54.01
Kayle,Rumble,172,97,75,56.4
Kayle,Tryndamere,507,276,231,54.44
Kayle,Rammus,288,138,150,47.92
Kayle,Xerath,712,339,373,47.61
Kayle,Rell,349,195,154,55.87
Kayle,Janna,283,160,123,56.54
Kayle,Kalista,217,116,101,53.46
Kayle,Taliyah,180,106,74,58.89
Kayle,Rengar,292,152,140,52.05
Kayle,Alistar,271,154,117,56.83
Kayle,Corki,355,193,162,54.37
Kayle,Renata,109,49,60,44.95
Kayle,Skarner,212,113,99,53.3
Kayle,Ivern,108,59,49,54.63
Kayle,Jayce,268,152,116,56.72
Kayle,Camille,212,111,101,52.36
Kayle,Nidalee,169,92,77,54.44
Kayle,Kassadin,188,87,101,46.28
Kayle,Zac,328,149,179,45.43
Azir,Mordekaiser,473,229,244,48.41
Azir,Karthus,163,69,94,42.33
Azir,Katarina,253,123,130,48.62
Azir,Jhin,807,383,424,47.46
Azir,Karma,548,224,324,40.88
Azir,Ornn,186,79,107,42.47
Azir,Kayn,411,203,208,49.39
Azir,Yasuo,826,436,390,52.78
Azir,Caitlyn,1047,521,526,49.76
Azir,Morgana,423,223,200,52.72
Azir,KSante,264,134,130,50.76
Azir,Hwei,284,159,125,55.99
Azir,Evelynn,125,71,54,56.8
Azir,Sivir,224,99,125,44.2
Azir,Thresh,571,247,324,43.26
Azir,Pantheon,670,346,324,51.64
Azir,Gwen,153,68,85,44.44
Azir,Fizz,177,95,82,53.67
Azir,Jinx,1181,520,661,44.03
Azir,Ivern,68,39,29,57.35
Azir,Darius,732,364,368,49.73
Azir,Lillia,213,101,112,47.42
Azir,Garen,597,280,317,46.9
Azir,Pyke,312,165,147,52.88
Azir,Volibear,436,204,232,46.79
Azir,Mel,925,489,436,52.86
Azir,Zilean,147,60,87,40.82
Azir,Belveth,123,54,69,43.9
Azir,Seraphine,259,118,141,45.56
Azir,Rengar,144,77,67,53.47
Azir,Malzahar,388,179,209,46.13
Azir,Tristana,390,223,167,57.18
Azir,Swain,392,182,210,46.43
Azir,Ambessa,262,132,130,50.38
Azir,TwistedFate,168,87,81,51.79
Azir,Senna,265,157,108,59.25
Azir,Rumble,101,42,59,41.58
Azir,Ahri,589,261,328,44.31
Azir,MissFortune,827,410,417,49.58
Azir,Riven,159,94,65,59.12
Azir,Jax,366,180,186,49.18
Azir,Yone,698,353,345,50.57
Azir,Nami,402,209,193,51.99
Azir,Yorick,335,122,213,36.42
Azir,Briar,271,121,150,44.65
Azir,Lux,840,391,449,46.55
Azir,Poppy,232,105,127,45.26
Azir,MasterYi,413,194,219,46.97
Azir,Brand,220,99,121,45
Azir,Ezreal,1038,493,545,47.5
Azir,Lulu,663,308,355,46.46
Azir,Chogath,481,227,254,47.19
Azir,XinZhao,294,160,134,54.42
Azir,Qiyana,117,77,40,65.81
Azir,Taliyah,116,62,54,53.45
Azir,Lissandra,105,62,43,59.05
Azir,Amumu,347,150,197,43.23
Azir,Xerath,447,212,235,47.43
Azir,Tryndamere,214,80,134,37.38
Azir,Zac,329,159,170,48.33
Azir,Akali,432,200,232,46.3
Azir,Zed,403,188,215,46.65
Azir,Draven,215,98,117,45.58
Azir,Leona,366,165,201,45.08
Azir,Warwick,592,269,323,45.44
Azir,Orianna,173,76,97,43.93
Azir,Samira,252,107,145,42.46
Azir,Alistar,193,92,101,47.67
Azir,Diana,752,351,401,46.68
Azir,Lucian,279,165,114,59.14
Azir,Vayne,455,229,226,50.33
Azir,Irelia,351,171,180,48.72
Azir,Vi,390,177,213,45.38
Azir,Zoe,161,71,90,44.1
Azir,Kalista,118,48,70,40.68
Azir,Udyr,195,100,95,51.28
Azir,Smolder,272,151,121,55.51
Azir,Bard,96,41,55,42.71
Azir,Kaisa,698,342,356,49
Azir,Kayle,250,138,112,55.2
Azir,Shaco,317,173,144,54.57
Azir,Varus,393,167,226,42.49
Azir,Soraka,228,128,100,56.14
Azir,Nunu,197,105,92,53.3
Azir,Khazix,247,138,109,55.87
Azir,Nautilus,438,245,193,55.94
Azir,Aatrox,391,201,190,51.41
Azir,JarvanIV,214,126,88,58.88
Azir,Renekton,216,120,96,55.56
Azir,Sett,519,235,284,45.28
Azir,Nocturne,464,204,260,43.97
Azir,Sejuani,206,115,91,55.83
Azir,Camille,158,73,85,46.2
Azir,Ekko,334,165,169,49.4
Azir,Veigar,314,143,171,45.54
Azir,Vladimir,268,127,141,47.39
Azir,Yuumi,381,183,198,48.03
Azir,LeeSin,780,387,393,49.62
Azir,TahmKench,271,147,124,54.24
Azir,Kindred,188,96,92,51.06
Azir,Twitch,351,146,205,41.6
Azir,Kassadin,77,37,40,48.05
Azir,Ashe,866,420,446,48.5
Azir,Braum,284,124,160,43.66
Azir,Shyvana,68,43,25,63.24
Azir,Singed,121,46,75,38.02
Azir,Aphelios,217,94,123,43.32
Azir,Milio,237,115,122,48.52
Azir,Quinn,156,96,60,61.54
Azir,Leblanc,299,162,137,54.18
Azir,Illaoi,205,87,118,42.44
Azir,Sylas,734,380,354,51.77
Azir,Zyra,363,172,191,47.38
Azir,Fiora,176,97,79,55.11
Azir,Malphite,373,198,175,53.08
Azir,Rakan,152,76,76,50
Azir,Velkoz,230,106,124,46.09
Azir,Viego,596,227,369,38.09
Azir,MonkeyKing,343,171,172,49.85
Azir,Sona,151,61,90,40.4
Azir,Jayce,256,151,105,58.98
Azir,Blitzcrank,324,173,151,53.4
Azir,Shen,250,114,136,45.6
Azir,Gnar,181,68,113,37.57
Azir,Rammus,125,44,81,35.2
Azir,Nidalee,132,62,70,46.97
Azir,Skarner,110,60,50,54.55
Azir,Gragas,255,122,133,47.84
Azir,Vex,168,69,99,41.07
Azir,Teemo,399,181,218,45.36
Azir,Rell,238,107,131,44.96
Azir,Trundle,242,131,111,54.13
Azir,Taric,73,31,42,42.47
Azir,FiddleSticks,163,78,85,47.85
Azir,Viktor,434,176,258,40.55
Azir,Sion,255,103,152,40.39
Azir,Nilah,113,59,54,52.21
Azir,RekSai,54,26,28,48.15
Azir,Maokai,190,94,96,49.47
Azir,Elise,310,157,153,50.65
Azir,Ziggs,105,40,65,38.1
Azir,Janna,127,66,61,51.97
Azir,Gangplank,227,124,103,54.63
Azir,Olaf,84,45,39,53.57
Azir,Aurora,303,155,148,51.16
Azir,Kennen,91,43,48,47.25
Azir,AurelionSol,160,69,91,43.13
Azir,Nasus,238,119,119,50
Azir,Renata,69,38,31,55.07
Azir,Xayah,193,113,80,58.55
Azir,Akshan,138,61,77,44.2
Azir,Galio,372,189,183,50.81
Azir,DrMundo,193,102,91,52.85
Azir,Annie,109,48,61,44.04
Azir,Zeri,189,70,119,37.04
Azir,Heimerdinger,163,69,94,42.33
Azir,Urgot,175,74,101,42.29
Azir,Hecarim,168,66,102,39.29
Azir,Ryze,171,100,71,58.48
Azir,Graves,279,135,144,48.39
Azir,Corki,159,76,83,47.8
Azir,Kled,89,40,49,44.94
Azir,Syndra,285,141,144,49.47
Azir,KogMaw,102,48,54,47.06
Azir,Talon,287,105,182,36.59
Azir,Neeko,126,66,60,52.38
Azir,Cassiopeia,110,65,45,59.09
Azir,Naafiri,99,35,64,35.35
Azir,Anivia,90,31,59,34.44
MissFortune,Mordekaiser,4085,1948,2137,47.69
MissFortune,Karthus,762,429,333,56.3
MissFortune,Katarina,2068,1095,973,52.95
MissFortune,Jhin,6411,3272,3139,51.04
MissFortune,Karma,2793,1354,1439,48.48
MissFortune,Darius,5450,2824,2626,51.82
MissFortune,LeeSin,3792,1904,1888,50.21
MissFortune,Diana,4743,2322,2421,48.96
MissFortune,KogMaw,800,390,410,48.75
MissFortune,Thresh,3423,1739,1684,50.8
MissFortune,Pantheon,4289,2134,2155,49.76
MissFortune,Evelynn,1003,524,479,52.24
MissFortune,Ekko,2592,1315,1277,50.73
MissFortune,Jinx,9701,4831,4870,49.8
MissFortune,Zyra,2860,1443,1417,50.45
MissFortune,Jax,2763,1537,1226,55.63
MissFortune,Amumu,2998,1418,1580,47.3
MissFortune,Ahri,3873,1975,1898,50.99
MissFortune,Caitlyn,9540,4840,4700,50.73
MissFortune,Lulu,3196,1632,1564,51.06
MissFortune,Gnar,1071,582,489,54.34
MissFortune,Volibear,3466,1781,1685,51.38
MissFortune,Fizz,1910,1033,877,54.08
MissFortune,Aphelios,1288,656,632,50.93
MissFortune,Fiora,910,444,466,48.79
MissFortune,Nocturne,3669,1767,1902,48.16
MissFortune,Sylas,3789,2045,1744,53.97
MissFortune,Varus,2538,1368,1170,53.9
MissFortune,Illaoi,1602,850,752,53.06
MissFortune,MasterYi,3634,1781,1853,49.01
MissFortune,Leblanc,1634,873,761,53.43
MissFortune,Anivia,842,419,423,49.76
MissFortune,Sett,4381,2193,2188,50.06
MissFortune,MonkeyKing,1886,946,940,50.16
MissFortune,Corki,1002,531,471,52.99
MissFortune,Ivern,334,193,141,57.78
MissFortune,Mel,5859,3126,2733,53.35
MissFortune,Ashe,6587,3375,3212,51.24
MissFortune,Seraphine,2282,1212,1070,53.11
MissFortune,Yorick,3130,1554,1576,49.65
MissFortune,Aatrox,2168,1118,1050,51.57
MissFortune,Graves,1635,770,865,47.09
MissFortune,Ezreal,6989,3616,3373,51.74
MissFortune,Bard,682,307,375,45.01
MissFortune,Nautilus,3023,1676,1347,55.44
MissFortune,Vi,2557,1297,1260,50.72
MissFortune,Yasuo,5418,2675,2743,49.37
MissFortune,Velkoz,1793,833,960,46.46
MissFortune,Talon,1565,820,745,52.4
MissFortune,Lux,7602,3929,3673,51.68
MissFortune,Kayle,1914,952,962,49.74
MissFortune,Elise,1718,947,771,55.12
MissFortune,Swain,2963,1435,1528,48.43
MissFortune,Kalista,652,384,268,58.9
MissFortune,Heimerdinger,1434,736,698,51.32
MissFortune,Kindred,1210,598,612,49.42
MissFortune,Ornn,1083,521,562,48.11
MissFortune,Trundle,1788,861,927,48.15
MissFortune,Khazix,1294,714,580,55.18
MissFortune,Veigar,3253,1569,1684,48.23
MissFortune,Tristana,3434,1815,1619,52.85
MissFortune,Malzahar,3092,1502,1590,48.58
MissFortune,Akali,3440,1761,1679,51.19
MissFortune,Sejuani,1096,574,522,52.37
MissFortune,Galio,2400,1202,1198,50.08
MissFortune,Milio,1439,678,761,47.12
MissFortune,DrMundo,1622,771,851,47.53
MissFortune,AurelionSol,1115,556,559,49.87
MissFortune,Rakan,1000,526,474,52.6
MissFortune,Kled,392,173,219,44.13
MissFortune,Warwick,4597,2241,2356,48.75
MissFortune,Syndra,1613,807,806,50.03
MissFortune,Aurora,1873,1018,855,54.35
MissFortune,Malphite,2939,1508,1431,51.31
MissFortune,Orianna,1102,540,562,49
MissFortune,Brand,2435,1152,1283,47.31
MissFortune,Briar,2210,1031,1179,46.65
MissFortune,Vayne,3745,1855,1890,49.53
MissFortune,Rell,1187,621,566,52.32
MissFortune,Irelia,2423,1242,1181,51.26
MissFortune,Kaisa,4618,2408,2210,52.14
MissFortune,Viego,3992,2048,1944,51.3
MissFortune,Camille,834,421,413,50.48
MissFortune,Nami,2549,1179,1370,46.25
MissFortune,Vex,1512,742,770,49.07
MissFortune,KSante,1338,750,588,56.05
MissFortune,Nunu,1593,806,787,50.6
MissFortune,FiddleSticks,1337,666,671,49.81
MissFortune,Smolder,1637,836,801,51.07
MissFortune,Sona,886,459,427,51.81
MissFortune,Ziggs,1088,481,607,44.21
MissFortune,Zeri,1052,526,526,50
MissFortune,Leona,2298,1150,1148,50.04
MissFortune,Singed,697,311,386,44.62
MissFortune,Neeko,1503,800,703,53.23
MissFortune,Braum,1695,840,855,49.56
MissFortune,Shen,1843,961,882,52.14
MissFortune,Kayn,4285,2078,2207,48.49
MissFortune,Riven,1108,578,530,52.17
MissFortune,Garen,4575,2249,2326,49.16
MissFortune,Xayah,1204,609,595,50.58
MissFortune,Zoe,1005,576,429,57.31
MissFortune,Kennen,724,383,341,52.9
MissFortune,TahmKench,2236,1223,1013,54.7
MissFortune,Shaco,2582,1322,1260,51.2
MissFortune,Renekton,1330,677,653,50.9
MissFortune,Lillia,1562,795,767,50.9
MissFortune,Udyr,1004,546,458,54.38
MissFortune,Vladimir,1593,796,797,49.97
MissFortune,Poppy,1497,739,758,49.37
MissFortune,Gangplank,1136,563,573,49.56
MissFortune,Draven,1413,761,652,53.86
MissFortune,Chogath,3381,1631,1750,48.24
MissFortune,Teemo,3842,1904,1938,49.56
MissFortune,Zed,3039,1639,1400,53.93
MissFortune,Twitch,2253,1180,1073,52.37
MissFortune,Blitzcrank,2036,1020,1016,50.1
MissFortune,Yone,5328,2795,2533,52.46
MissFortune,Sivir,1552,773,779,49.81
MissFortune,Gwen,1454,837,617,57.57
MissFortune,Azir,827,417,410,50.42
MissFortune,JarvanIV,1456,740,716,50.82
MissFortune,Naafiri,934,492,442,52.68
MissFortune,Cassiopeia,783,394,389,50.32
MissFortune,Morgana,3626,1811,1815,49.94
MissFortune,Maokai,1269,662,607,52.17
MissFortune,Rammus,868,454,414,52.3
MissFortune,Ambessa,1472,777,695,52.79
MissFortune,Tryndamere,1664,839,825,50.42
MissFortune,Jayce,1137,605,532,53.21
MissFortune,Pyke,2054,1053,1001,51.27
MissFortune,Urgot,1586,794,792,50.06
MissFortune,Viktor,2116,1056,1060,49.91
MissFortune,Kassadin,574,248,326,43.21
MissFortune,Nasus,2180,1043,1137,47.84
MissFortune,Lissandra,861,430,431,49.94
MissFortune,Taric,573,284,289,49.56
MissFortune,Yuumi,2128,1108,1020,52.07
MissFortune,Rengar,815,441,374,54.11
MissFortune,Samira,2280,1201,1079,52.68
MissFortune,Hwei,1695,857,838,50.56
MissFortune,Lucian,1952,987,965,50.56
MissFortune,Soraka,1485,743,742,50.03
MissFortune,XinZhao,1779,833,946,46.82
MissFortune,Ryze,867,406,461,46.83
MissFortune,Annie,916,430,486,46.94
MissFortune,Zac,1137,588,549,51.72
MissFortune,Qiyana,631,336,295,53.25
MissFortune,Zilean,851,420,431,49.35
MissFortune,Taliyah,520,218,302,41.92
MissFortune,Xerath,2460,1172,1288,47.64
MissFortune,Hecarim,977,498,479,50.97
MissFortune,Sion,1965,949,1016,48.3
MissFortune,Gragas,1266,654,612,51.66
MissFortune,Alistar,1000,526,474,52.6
MissFortune,Janna,827,398,429,48.13
MissFortune,Rumble,697,327,370,46.92
MissFortune,Olaf,567,317,250,55.91
MissFortune,Shyvana,742,396,346,53.37
MissFortune,Belveth,624,296,328,47.44
MissFortune,Senna,2066,1064,1002,51.5
MissFortune,Nilah,1008,448,560,44.44
MissFortune,Renata,393,191,202,48.6
MissFortune,TwistedFate,899,490,409,54.51
MissFortune,Skarner,653,375,278,57.43
MissFortune,Akshan,1006,506,500,50.3
MissFortune,Quinn,994,487,507,48.99
MissFortune,Nidalee,698,399,299,57.16
MissFortune,RekSai,275,136,139,49.45
Karthus,Renekton,174,75,99,43.1
Karthus,Diana,666,315,351,47.3
Karthus,Azir,163,94,69,57.67
Karthus,MissFortune,762,333,429,43.7
Karthus,Yuumi,273,115,158,42.12
Karthus,Camille,134,78,56,58.21
Karthus,LeeSin,547,282,265,51.55
Karthus,Hwei,210,103,107,49.05
Karthus,Jhin,802,426,376,53.12
Karthus,Zyra,405,186,219,45.93
Karthus,Jayce,219,125,94,57.08
Karthus,Anivia,162,56,106,34.57
Karthus,Ezreal,967,478,489,49.43
Karthus,TahmKench,239,108,131,45.19
Karthus,Ambessa,279,135,144,48.39
Karthus,Briar,266,99,167,37.22
Karthus,Mel,676,347,329,51.33
Karthus,Lucian,289,143,146,49.48
Karthus,Leona,288,147,141,51.04
Karthus,Ivern,65,31,34,47.69
Karthus,TwistedFate,152,64,88,42.11
Karthus,Senna,292,157,135,53.77
Karthus,DrMundo,200,94,106,47
Karthus,Shaco,380,164,216,43.16
Karthus,Vex,198,104,94,52.53
Karthus,Jinx,994,466,528,46.88
Karthus,Chogath,388,168,220,43.3
Karthus,Trundle,174,85,89,48.85
Karthus,AurelionSol,127,66,61,51.97
Karthus,Veigar,341,152,189,44.57
Karthus,Brand,227,128,99,56.39
Karthus,Sett,501,233,268,46.51
Karthus,MasterYi,421,181,240,42.99
Karthus,Mordekaiser,418,203,215,48.56
Karthus,Lux,883,390,493,44.17
Karthus,Darius,687,333,354,48.47
Karthus,Singed,109,53,56,48.62
Karthus,Caitlyn,885,421,464,47.57
Karthus,Morgana,369,199,170,53.93
Karthus,Gangplank,202,89,113,44.06
Karthus,Lulu,503,235,268,46.72
Karthus,Garen,550,259,291,47.09
Karthus,Twitch,285,117,168,41.05
Karthus,Nami,361,161,200,44.6
Karthus,Yasuo,687,340,347,49.49
Karthus,Tristana,315,168,147,53.33
Karthus,Swain,352,192,160,54.55
Karthus,Poppy,219,116,103,52.97
Karthus,Vladimir,280,116,164,41.43
Karthus,Sivir,214,111,103,51.87
Karthus,Thresh,492,246,246,50
Karthus,Evelynn,114,66,48,57.89
Karthus,Taliyah,124,57,67,45.97
Karthus,Corki,172,98,74,56.98
Karthus,Kaisa,600,374,226,62.33
Karthus,Braum,186,90,96,48.39
Karthus,Nasus,175,81,94,46.29
Karthus,Zac,197,82,115,41.62
Karthus,Yorick,300,126,174,42
Karthus,Zed,377,188,189,49.87
Karthus,Ashe,703,363,340,51.64
Karthus,Sona,114,56,58,49.12
Karthus,Kayn,490,229,261,46.73
Karthus,Yone,648,340,308,52.47
Karthus,Rammus,104,53,51,50.96
Karthus,Riven,175,71,104,40.57
Karthus,Ekko,336,145,191,43.15
Karthus,Akali,404,218,186,53.96
Karthus,Heimerdinger,188,103,85,54.79
Karthus,Viego,457,240,217,52.52
Karthus,Malzahar,363,152,211,41.87
Karthus,Xayah,173,83,90,47.98
Karthus,Lissandra,102,32,70,31.37
Karthus,Aatrox,330,134,196,40.61
Karthus,Khazix,199,87,112,43.72
Karthus,Aurora,290,139,151,47.93
Karthus,Teemo,497,239,258,48.09
Karthus,Vi,386,201,185,52.07
Karthus,Varus,318,174,144,54.72
Karthus,Vayne,458,216,242,47.16
Karthus,Skarner,104,48,56,46.15
Karthus,Draven,210,91,119,43.33
Karthus,Warwick,503,244,259,48.51
Karthus,Amumu,368,187,181,50.82
Karthus,Lillia,224,105,119,46.88
Karthus,Nidalee,117,49,68,41.88
Karthus,Olaf,108,55,53,50.93
Karthus,Maokai,175,71,104,40.57
Karthus,KogMaw,142,75,67,52.82
Karthus,Bard,130,69,61,53.08
Karthus,Tryndamere,173,87,86,50.29
Karthus,Xerath,361,169,192,46.81
Karthus,Renata,43,27,16,62.79
Karthus,Sylas,488,277,211,56.76
Karthus,Karma,514,235,279,45.72
Karthus,Gwen,151,85,66,56.29
Karthus,Nunu,189,95,94,50.26
Karthus,Smolder,192,97,95,50.52
Karthus,Rakan,146,79,67,54.11
Karthus,Talon,262,140,122,53.44
Karthus,Naafiri,103,50,53,48.54
Karthus,Urgot,170,88,82,51.76
Karthus,JarvanIV,190,111,79,58.42
Karthus,Rell,210,111,99,52.86
Karthus,Aphelios,191,88,103,46.07
Karthus,Milio,207,79,128,38.16
Karthus,FiddleSticks,183,84,99,45.9
Karthus,Kennen,140,93,47,66.43
Karthus,Pyke,243,118,125,48.56
Karthus,Volibear,347,190,157,54.76
Karthus,Neeko,172,104,68,60.47
Karthus,MonkeyKing,210,109,101,51.9
Karthus,Irelia,285,135,150,47.37
Karthus,Zoe,148,76,72,51.35
Karthus,Elise,282,155,127,54.96
Karthus,Jax,300,144,156,48
Karthus,Katarina,287,156,131,54.36
Karthus,Ahri,349,159,190,45.56
Karthus,Samira,218,99,119,45.41
Karthus,Velkoz,185,85,100,45.95
Karthus,Kassadin,86,39,47,45.35
Karthus,Hecarim,160,65,95,40.63
Karthus,Akshan,120,66,54,55
Karthus,Seraphine,231,117,114,50.65
Karthus,Pantheon,556,280,276,50.36
Karthus,Sejuani,116,72,44,62.07
Karthus,Soraka,238,119,119,50
Karthus,Fizz,129,73,56,56.59
Karthus,Kindred,174,96,78,55.17
Karthus,Illaoi,161,64,97,39.75
Karthus,Orianna,159,67,92,42.14
Karthus,Kayle,237,109,128,45.99
Karthus,Zeri,161,82,79,50.93
Karthus,Leblanc,244,98,146,40.16
Karthus,Janna,132,78,54,59.09
Karthus,Qiyana,100,50,50,50
Karthus,Alistar,168,87,81,51.79
Karthus,Malphite,333,156,177,46.85
Karthus,Blitzcrank,289,143,146,49.48
Karthus,KSante,173,95,78,54.91
Karthus,Nocturne,429,207,222,48.25
Karthus,Gnar,153,71,82,46.41
Karthus,Kalista,64,30,34,46.88
Karthus,Taric,62,35,27,56.45
Karthus,Rumble,128,77,51,60.16
Karthus,Shyvana,52,30,22,57.69
Karthus,Quinn,145,68,77,46.9
Karthus,Ryze,116,64,52,55.17
Karthus,Sion,238,127,111,53.36
Karthus,XinZhao,233,125,108,53.65
Karthus,RekSai,69,38,31,55.07
Karthus,Rengar,153,97,56,63.4
Karthus,Belveth,86,41,45,47.67
Karthus,Annie,139,59,80,42.45
Karthus,Zilean,119,67,52,56.3
Karthus,Fiora,148,84,64,56.76
Karthus,Graves,267,159,108,59.55
Karthus,Syndra,219,105,114,47.95
Karthus,Nautilus,383,168,215,43.86
Karthus,Udyr,108,37,71,34.26
Karthus,Shen,179,84,95,46.93
Karthus,Gragas,180,79,101,43.89
Karthus,Galio,328,167,161,50.91
Karthus,Nilah,123,56,67,45.53
Karthus,Viktor,293,167,126,57
Karthus,Ziggs,120,60,60,50
Karthus,Cassiopeia,64,21,43,32.81
Karthus,Ornn,128,62,66,48.44
Karthus,Kled,45,16,29,35.56
Karma,Renekton,815,428,387,52.52
Karma,Diana,2489,1162,1327,46.69
Karma,Azir,548,324,224,59.12
Karma,MissFortune,2793,1439,1354,51.52
Karma,Yuumi,1231,639,592,51.91
Karma,Urgot,762,376,386,49.34
Karma,Vi,1553,744,809,47.91
Karma,Ekko,1357,692,665,50.99
Karma,Caitlyn,4066,2066,2000,50.81
Karma,Bard,559,248,311,44.36
Karma,Tryndamere,645,305,340,47.29
Karma,Malzahar,1539,782,757,50.81
Karma,Zyra,1640,814,826,49.63
Karma,Garen,2296,1157,1139,50.39
Karma,Graves,1125,574,551,51.02
Karma,Lucian,1121,584,537,52.1
Karma,Lux,3643,1797,1846,49.33
Karma,Evelynn,504,223,281,44.25
Karma,Lissandra,534,306,228,57.3
Karma,Corki,630,308,322,48.89
Karma,Rakan,614,298,316,48.53
Karma,Volibear,1405,722,683,51.39
Karma,Khazix,859,472,387,54.95
Karma,Ezreal,4107,2040,2067,49.67
Karma,Velkoz,907,454,453,50.06
Karma,XinZhao,1037,581,456,56.03
Karma,Yasuo,2761,1404,1357,50.85
Karma,Kalista,401,220,181,54.86
Karma,Pantheon,2320,1206,1114,51.98
Karma,Darius,2504,1216,1288,48.56
Karma,Katarina,1154,555,599,48.09
Karma,Kaisa,2695,1403,1292,52.06
Karma,Lulu,2684,1355,1329,50.48
Karma,Jax,1305,706,599,54.1
Karma,Kayn,1863,977,886,52.44
Karma,Zeri,741,408,333,55.06
Karma,Amumu,1318,650,668,49.32
Karma,Mordekaiser,1659,840,819,50.63
Karma,Aurora,1207,604,603,50.04
Karma,Varus,1486,813,673,54.71
Karma,Morgana,1684,921,763,54.69
Karma,Sion,1019,554,465,54.37
Karma,Sylas,2005,1040,965,51.87
Karma,Zed,1731,895,836,51.7
Karma,Tristana,1405,703,702,50.04
Karma,Malphite,1365,744,621,54.51
Karma,Shyvana,318,158,160,49.69
Karma,Naafiri,423,186,237,43.97
Karma,Maokai,690,347,343,50.29
Karma,Swain,1254,630,624,50.24
Karma,MasterYi,1580,791,789,50.06
Karma,Singed,444,235,209,52.93
Karma,Galio,1309,594,715,45.38
Karma,Sivir,903,452,451,50.06
Karma,Thresh,2146,1071,1075,49.91
Karma,Lillia,819,421,398,51.4
Karma,Aphelios,746,424,322,56.84
Karma,Leona,1161,646,515,55.64
Karma,Elise,1203,633,570,52.62
Karma,Anivia,527,263,264,49.91
Karma,Pyke,1224,654,570,53.43
Karma,Yone,2627,1380,1247,52.53
Karma,Nocturne,1778,860,918,48.37
Karma,Ahri,2003,977,1026,48.78
Karma,Syndra,1065,548,517,51.46
Karma,Soraka,917,451,466,49.18
Karma,Xerath,1658,837,821,50.48
Karma,Irelia,1343,666,677,49.59
Karma,Heimerdinger,592,271,321,45.78
Karma,Ambessa,1134,596,538,52.56
Karma,LeeSin,2972,1588,1384,53.43
Karma,Vladimir,1024,477,547,46.58
Karma,Udyr,540,270,270,50
Karma,Jhin,3136,1648,1488,52.55
Karma,Gangplank,791,394,397,49.81
Karma,Samira,835,438,397,52.46
Karma,Neeko,584,265,319,45.38
Karma,FiddleSticks,769,436,333,56.7
Karma,Gragas,886,471,415,53.16
Karma,Sejuani,591,338,253,57.19
Karma,Akali,1666,825,841,49.52
Karma,Ziggs,529,252,277,47.64
Karma,Nasus,943,472,471,50.05
Karma,TwistedFate,511,269,242,52.64
Karma,Mel,2850,1580,1270,55.44
Karma,Fiora,580,317,263,54.66
Karma,Sett,1866,882,984,47.27
Karma,Seraphine,1134,574,560,50.62
Karma,Rengar,514,324,190,63.04
Karma,TahmKench,991,511,480,51.56
Karma,KogMaw,438,237,201,54.11
Karma,Zilean,552,294,258,53.26
Karma,Twitch,1084,508,576,46.86
Karma,Blitzcrank,1128,585,543,51.86
Karma,Nautilus,1634,790,844,48.35
Karma,Yorick,1283,628,655,48.95
Karma,Akshan,508,283,225,55.71
Karma,Veigar,1099,560,539,50.96
Karma,Xayah,603,325,278,53.9
Karma,Warwick,1680,809,871,48.15
Karma,Leblanc,1084,553,531,51.01
Karma,MonkeyKing,1117,572,545,51.21
Karma,Milio,959,472,487,49.22
Karma,Belveth,338,162,176,47.93
Karma,Ashe,3247,1640,1607,50.51
Karma,Nami,1990,926,1064,46.53
Karma,Trundle,749,378,371,50.47
Karma,Skarner,367,207,160,56.4
Karma,Viego,2187,1072,1115,49.02
Karma,Jinx,4053,1990,2063,49.1
Karma,Quinn,563,281,282,49.91
Karma,Janna,609,294,315,48.28
Karma,Shaco,1436,722,714,50.28
Karma,Brand,922,490,432,53.15
Karma,KSante,943,528,415,55.99
Karma,AurelionSol,525,261,264,49.71
Karma,Draven,751,367,384,48.87
Karma,Gnar,623,322,301,51.69
Karma,Vayne,1749,803,946,45.91
Karma,Rell,676,347,329,51.33
Karma,Camille,622,341,281,54.82
Karma,Riven,762,393,369,51.57
Karma,Taliyah,475,273,202,57.47
Karma,Teemo,1629,824,805,50.58
Karma,JarvanIV,883,420,463,47.57
Karma,Qiyana,447,233,214,52.13
Karma,Aatrox,1294,669,625,51.7
Karma,Ornn,593,306,287,51.6
Karma,Viktor,1510,790,720,52.32
Karma,Renata,307,160,147,52.12
Karma,Annie,516,259,257,50.19
Karma,Shen,827,407,420,49.21
Karma,Taric,274,139,135,50.73
Karma,DrMundo,757,348,409,45.97
Karma,Rammus,353,191,162,54.11
Karma,Illaoi,515,291,224,56.5
Karma,Braum,902,444,458,49.22
Karma,Zac,822,391,431,47.57
Karma,Smolder,865,463,402,53.53
Karma,Gwen,665,402,263,60.45
Karma,Senna,1118,543,575,48.57
Karma,Rumble,531,291,240,54.8
Karma,Zoe,611,295,316,48.28
Karma,Orianna,695,363,332,52.23
Karma,Hwei,1035,546,489,52.75
Karma,Hecarim,669,353,316,52.77
Karma,Vex,694,362,332,52.16
Karma,Kassadin,337,160,177,47.48
Karma,Kayle,893,373,520,41.77
Karma,Kennen,416,206,210,49.52
Karma,Briar,995,451,544,45.33
Karma,Ryze,598,283,315,47.32
Karma,Jayce,1043,523,520,50.14
Karma,Talon,996,476,520,47.79
Karma,Poppy,824,408,416,49.51
Karma,Fizz,789,420,369,53.23
Karma,Karthus,514,279,235,54.28
Karma,Chogath,1605,783,822,48.79
Karma,Nilah,317,150,167,47.32
Karma,Olaf,337,182,155,54.01
Karma,Sona,482,196,286,40.66
Karma,Nunu,718,315,403,43.87
Karma,Kindred,618,320,298,51.78
Karma,Nidalee,574,312,262,54.36
Karma,Alistar,552,303,249,54.89
Karma,Ivern,200,97,103,48.5
Karma,Cassiopeia,392,187,205,47.7
Karma,RekSai,155,74,81,47.74
Karma,Kled,290,163,127,56.21
Talon,Darius,1245,599,646,48.11
Talon,LeeSin,1286,668,618,51.94
Talon,Diana,1213,606,607,49.96
Talon,KogMaw,179,82,97,45.81
Talon,Thresh,895,390,505,43.58
Talon,Kindred,306,148,158,48.37
Talon,Yone,1361,640,721,47.02
Talon,Samira,424,197,227,46.46
Talon,Rell,326,156,170,47.85
Talon,Yorick,615,312,303,50.73
Talon,JarvanIV,377,187,190,49.6
Talon,Mel,1337,697,640,52.13
Talon,Jinx,1943,902,1041,46.42
Talon,Lux,1444,649,795,44.94
Talon,Shen,362,176,186,48.62
Talon,Ekko,679,362,317,53.31
Talon,Zed,952,494,458,51.89
Talon,Jhin,1421,717,704,50.46
Talon,Nautilus,747,340,407,45.52
Talon,Jax,584,319,265,54.62
Talon,Gragas,400,199,201,49.75
Talon,Twitch,535,247,288,46.17
Talon,Lulu,1107,535,572,48.33
Talon,Garen,1069,461,608,43.12
Talon,Lillia,369,190,179,51.49
Talon,Irelia,657,292,365,44.44
Talon,Nami,699,375,324,53.65
Talon,MissFortune,1565,745,820,47.6
Talon,Sett,1014,432,582,42.6
Talon,Evelynn,239,132,107,55.23
Talon,Vladimir,531,234,297,44.07
Talon,Ashe,1393,711,682,51.04
Talon,Pantheon,1184,584,600,49.32
Talon,TahmKench,499,221,278,44.29
Talon,Shaco,678,313,365,46.17
Talon,Leblanc,519,263,256,50.67
Talon,Hwei,434,233,201,53.69
Talon,Kaisa,1317,664,653,50.42
Talon,Tristana,649,314,335,48.38
Talon,Swain,594,318,276,53.54
Talon,Vi,716,383,333,53.49
Talon,Yasuo,1529,720,809,47.09
Talon,Kayn,889,417,472,46.91
Talon,Caitlyn,1734,819,915,47.23
Talon,Soraka,373,146,227,39.14
Talon,Camille,329,157,172,47.72
Talon,Chogath,767,385,382,50.2
Talon,RekSai,98,32,66,32.65
Talon,Draven,357,177,180,49.58
Talon,Rammus,215,97,118,45.12
Talon,Ryze,258,117,141,45.35
Talon,Katarina,580,256,324,44.14
Talon,Zilean,263,147,116,55.89
Talon,AurelionSol,197,92,105,46.7
Talon,Annie,226,106,120,46.9
Talon,Veigar,536,271,265,50.56
Talon,Yuumi,668,385,283,57.63
Talon,Nunu,358,196,162,54.75
Talon,Aphelios,357,171,186,47.9
Talon,Morgana,766,379,387,49.48
Talon,Volibear,665,325,340,48.87
Talon,MonkeyKing,482,191,291,39.63
Talon,Ziggs,228,108,120,47.37
Talon,Gnar,270,119,151,44.07
Talon,Amumu,651,279,372,42.86
Talon,Malzahar,704,323,381,45.88
Talon,Braum,346,153,193,44.22
Talon,Urgot,301,144,157,47.84
Talon,Graves,591,323,268,54.65
Talon,Gangplank,374,169,205,45.19
Talon,Udyr,306,151,155,49.35
Talon,Ezreal,2059,1090,969,52.94
Talon,Cassiopeia,249,116,133,46.59
Talon,Galio,570,271,299,47.54
Talon,Sylas,1175,576,599,49.02
Talon,Fiora,270,100,170,37.04
Talon,Khazix,465,218,247,46.88
Talon,Aurora,531,295,236,55.56
Talon,Lucian,522,297,225,56.9
Talon,Milio,426,181,245,42.49
Talon,Nocturne,860,444,416,51.63
Talon,Rumble,256,132,124,51.56
Talon,FiddleSticks,322,151,171,46.89
Talon,Belveth,161,79,82,49.07
Talon,Corki,300,166,134,55.33
Talon,Smolder,409,187,222,45.72
Talon,Poppy,466,200,266,42.92
Talon,Aatrox,633,346,287,54.66
Talon,Vayne,829,339,490,40.89
Talon,KSante,445,227,218,51.01
Talon,Varus,684,335,349,48.98
Talon,Renata,106,33,73,31.13
Talon,Warwick,1060,486,574,45.85
Talon,Ahri,899,417,482,46.38
Talon,Nasus,368,185,183,50.27
Talon,Brand,446,235,211,52.69
Talon,Gwen,293,154,139,52.56
Talon,Blitzcrank,460,220,240,47.83
Talon,Kayle,438,215,223,49.09
Talon,Janna,279,131,148,46.95
Talon,Zac,363,170,193,46.83
Talon,Briar,414,172,242,41.55
Talon,Velkoz,345,154,191,44.64
Talon,Ambessa,444,242,202,54.5
Talon,Taliyah,162,69,93,42.59
Talon,Naafiri,217,87,130,40.09
Talon,TwistedFate,246,125,121,50.81
Talon,Sejuani,296,131,165,44.26
Talon,Quinn,242,103,139,42.56
Talon,Seraphine,446,261,185,58.52
Talon,Renekton,408,191,217,46.81
Talon,Teemo,838,374,464,44.63
Talon,Skarner,154,81,73,52.6
Talon,Karma,996,520,476,52.21
Talon,MasterYi,723,347,376,47.99
Talon,Taric,118,62,56,52.54
Talon,Akshan,247,144,103,58.3
Talon,Viego,1109,500,609,45.09
Talon,Karthus,262,122,140,46.56
Talon,Senna,555,249,306,44.86
Talon,Viktor,718,378,340,52.65
Talon,Mordekaiser,773,329,444,42.56
Talon,Syndra,390,182,208,46.67
Talon,Tryndamere,352,155,197,44.03
Talon,Anivia,287,143,144,49.83
Talon,Sion,489,227,262,46.42
Talon,Xayah,361,169,192,46.81
Talon,Pyke,604,326,278,53.97
Talon,Akali,826,382,444,46.25
Talon,Kennen,196,108,88,55.1
Talon,Rengar,199,92,107,46.23
Talon,Zoe,265,129,136,48.68
Talon,Kled,120,47,73,39.17
Talon,Riven,348,173,175,49.71
Talon,Vex,349,162,187,46.42
Talon,Nilah,155,61,94,39.35
Talon,Alistar,306,139,167,45.42
Talon,Zyra,684,306,378,44.74
Talon,Illaoi,252,103,149,40.87
Talon,Shyvana,191,84,107,43.98
Talon,Xerath,630,296,334,46.98
Talon,Sona,189,83,106,43.92
Talon,Bard,226,101,125,44.69
Talon,Heimerdinger,291,115,176,39.52
Talon,Malphite,714,387,327,54.2
Talon,Lissandra,269,118,151,43.87
Talon,Hecarim,330,163,167,49.39
Talon,Neeko,314,192,122,61.15
Talon,Jayce,439,218,221,49.66
Talon,Maokai,352,173,179,49.15
Talon,Singed,159,70,89,44.03
Talon,Zeri,345,176,169,51.01
Talon,Trundle,361,222,139,61.5
Talon,Qiyana,183,84,99,45.9
Talon,XinZhao,491,211,280,42.97
Talon,Rakan,265,121,144,45.66
Talon,Olaf,175,94,81,53.71
Talon,Elise,592,285,307,48.14
Talon,Sivir,432,222,210,51.39
Talon,Fizz,388,186,202,47.94
Talon,Orianna,308,145,163,47.08
Talon,Ornn,284,131,153,46.13
Talon,DrMundo,319,144,175,45.14
Talon,Leona,549,294,255,53.55
Talon,Kalista,158,72,86,45.57
Talon,Ivern,86,45,41,52.33
Talon,Nidalee,257,143,114,55.64
Talon,Kassadin,139,65,74,46.76
Talon,Azir,287,182,105,63.41
Ornn,Irelia,437,216,221,49.43
Ornn,MasterYi,544,259,285,47.61
Ornn,Azir,186,107,79,57.53
Ornn,Lucian,347,157,190,45.24
Ornn,Mel,806,392,414,48.64
Ornn,Khazix,246,149,97,60.57
Ornn,Aurora,364,202,162,55.49
Ornn,Ashe,982,491,491,50
Ornn,Thresh,591,319,272,53.98
Ornn,Yone,792,403,389,50.88
Ornn,Warwick,755,326,429,43.18
Ornn,Hwei,330,159,171,48.18
Ornn,Varus,495,238,257,48.08
Ornn,Malphite,531,251,280,47.27
Ornn,Yorick,469,231,238,49.25
Ornn,Lillia,255,113,142,44.31
Ornn,Xayah,243,127,116,52.26
Ornn,Yuumi,354,160,194,45.2
Ornn,Sett,769,370,399,48.11
Ornn,Shaco,377,177,200,46.95
Ornn,Ziggs,202,95,107,47.03
Ornn,Kaisa,841,459,382,54.58
Ornn,MissFortune,1083,562,521,51.89
Ornn,Nocturne,588,280,308,47.62
Ornn,AurelionSol,135,68,67,50.37
Ornn,Smolder,295,153,142,51.86
Ornn,Nautilus,559,313,246,55.99
Ornn,Gangplank,259,126,133,48.65
Ornn,Kayn,706,368,338,52.12
Ornn,Ekko,455,241,214,52.97
Ornn,Aphelios,293,144,149,49.15
Ornn,Zeri,194,85,109,43.81
Ornn,Zed,565,309,256,54.69
Ornn,Camille,181,93,88,51.38
Ornn,Lulu,696,348,348,50
Ornn,Shen,305,145,160,47.54
Ornn,Xerath,443,247,196,55.76
Ornn,Jhin,963,518,445,53.79
Ornn,Lux,1252,649,603,51.84
Ornn,Akali,495,244,251,49.29
Ornn,TahmKench,294,163,131,55.44
Ornn,Mordekaiser,672,297,375,44.2
Ornn,Yasuo,868,406,462,46.77
Ornn,Volibear,495,251,244,50.71
Ornn,Graves,283,134,149,47.35
Ornn,Syndra,301,153,148,50.83
Ornn,Vayne,649,308,341,47.46
Ornn,Milio,291,166,125,57.04
Ornn,KSante,333,167,166,50.15
Ornn,Taliyah,140,79,61,56.43
Ornn,JarvanIV,290,131,159,45.17
Ornn,Malzahar,558,281,277,50.36
Ornn,KogMaw,116,48,68,41.38
Ornn,Briar,327,141,186,43.12
Ornn,Poppy,311,143,168,45.98
Ornn,Vladimir,317,178,139,56.15
Ornn,Sivir,216,104,112,48.15
Ornn,Darius,938,462,476,49.25
Ornn,Hecarim,222,97,125,43.69
Ornn,Karma,593,287,306,48.4
Ornn,Vi,447,240,207,53.69
Ornn,Draven,267,125,142,46.82
Ornn,Pyke,350,167,183,47.71
Ornn,Ezreal,1199,626,573,52.21
Ornn,Sona,185,90,95,48.65
Ornn,LeeSin,797,397,400,49.81
Ornn,Corki,198,103,95,52.02
Ornn,Nasus,307,132,175,43
Ornn,Nunu,290,129,161,44.48
Ornn,Qiyana,124,83,41,66.94
Ornn,Veigar,445,191,254,42.92
Ornn,Janna,152,70,82,46.05
Ornn,Kayle,341,183,158,53.67
Ornn,Sylas,766,407,359,53.13
Ornn,Senna,416,246,170,59.13
Ornn,Illaoi,237,130,107,54.85
Ornn,Velkoz,303,147,156,48.51
Ornn,Teemo,526,264,262,50.19
Ornn,Shyvana,115,63,52,54.78
Ornn,Twitch,414,209,205,50.48
Ornn,Maokai,226,120,106,53.1
Ornn,Renata,84,52,32,61.9
Ornn,Aatrox,439,236,203,53.76
Ornn,Elise,351,180,171,51.28
Ornn,Fizz,279,128,151,45.88
Ornn,Singed,131,50,81,38.17
Ornn,Ahri,606,316,290,52.15
Ornn,Swain,472,232,240,49.15
Ornn,Riven,218,129,89,59.17
Ornn,FiddleSticks,277,153,124,55.23
Ornn,Samira,299,164,135,54.85
Ornn,Skarner,123,77,46,62.6
Ornn,Katarina,320,123,197,38.44
Ornn,Caitlyn,1327,670,657,50.49
Ornn,Soraka,254,105,149,41.34
Ornn,Gwen,368,165,203,44.84
Ornn,Rengar,192,101,91,52.6
Ornn,Viktor,455,237,218,52.09
Ornn,Tristana,497,255,242,51.31
Ornn,Nami,548,246,302,44.89
Ornn,Gragas,279,164,115,58.78
Ornn,Seraphine,369,175,194,47.43
Ornn,Viego,713,342,371,47.97
Ornn,Pantheon,827,439,388,53.08
Ornn,Trundle,316,150,166,47.47
Ornn,Jinx,1416,723,693,51.06
Ornn,Renekton,223,121,102,54.26
Ornn,Rell,247,125,122,50.61
Ornn,Diana,786,380,406,48.35
Ornn,Amumu,418,222,196,53.11
Ornn,Naafiri,111,48,63,43.24
Ornn,Sejuani,198,115,83,58.08
Ornn,Alistar,226,102,124,45.13
Ornn,Garen,813,411,402,50.55
Ornn,Anivia,149,64,85,42.95
Ornn,Annie,160,75,85,46.88
Ornn,Fiora,257,123,134,47.86
Ornn,TwistedFate,160,96,64,60
Ornn,Zac,274,131,143,47.81
Ornn,Morgana,550,257,293,46.73
Ornn,DrMundo,258,126,132,48.84
Ornn,Zyra,436,224,212,51.38
Ornn,Brand,300,145,155,48.33
Ornn,Rammus,93,53,40,56.99
Ornn,Chogath,593,284,309,47.89
Ornn,Neeko,196,112,84,57.14
Ornn,Kalista,90,50,40,55.56
Ornn,Leona,447,248,199,55.48
Ornn,Cassiopeia,131,75,56,57.25
Ornn,Leblanc,292,173,119,59.25
Ornn,Taric,115,58,57,50.43
Ornn,MonkeyKing,330,179,151,54.24
Ornn,Ryze,177,70,107,39.55
Ornn,Belveth,117,57,60,48.72
Ornn,Galio,429,222,207,51.75
Ornn,Vex,277,151,126,54.51
Ornn,Gnar,189,102,87,53.97
Ornn,Rumble,108,60,48,55.56
Ornn,Bard,153,76,77,49.67
Ornn,Zilean,218,113,105,51.83
Ornn,Blitzcrank,377,191,186,50.66
Ornn,Akshan,155,92,63,59.35
Ornn,Kindred,227,125,102,55.07
Ornn,Orianna,247,95,152,38.46
Ornn,Rakan,197,102,95,51.78
Ornn,Heimerdinger,194,86,108,44.33
Ornn,Braum,266,126,140,47.37
Ornn,Jax,402,192,210,47.76
Ornn,Nilah,131,66,65,50.38
Ornn,Kassadin,87,35,52,40.23
Ornn,Olaf,114,39,75,34.21
Ornn,Sion,304,144,160,47.37
Ornn,Tryndamere,240,118,122,49.17
Ornn,Quinn,175,81,94,46.29
Ornn,Lissandra,138,81,57,58.7
Ornn,Talon,284,153,131,53.87
Ornn,Urgot,253,136,117,53.75
Ornn,Kennen,117,70,47,59.83
Ornn,RekSai,53,27,26,50.94
Ornn,Jayce,204,105,99,51.47
Ornn,Kled,90,39,51,43.33
Ornn,XinZhao,284,145,139,51.06
Ornn,Nidalee,148,95,53,64.19
Ornn,Ambessa,308,150,158,48.7
Ornn,Karthus,128,66,62,51.56
Ornn,Evelynn,140,75,65,53.57
Ornn,Ivern,63,35,28,55.56
Ornn,Zoe,186,94,92,50.54
Ornn,Udyr,160,85,75,53.13
Zoe,Renekton,257,161,96,62.65
Zoe,Trundle,252,139,113,55.16
Zoe,Mordekaiser,551,282,269,51.18
Zoe,Jinx,1267,643,624,50.75
Zoe,Nautilus,532,235,297,44.17
Zoe,TahmKench,280,135,145,48.21
Zoe,Ivern,55,24,31,43.64
Zoe,Yasuo,785,340,445,43.31
Zoe,Draven,236,135,101,57.2
Zoe,Milio,266,144,122,54.14
Zoe,Garen,652,309,343,47.39
Zoe,Nunu,276,107,169,38.77
Zoe,Yorick,396,175,221,44.19
Zoe,Caitlyn,1141,594,547,52.06
Zoe,Lux,1168,560,608,47.95
Zoe,Irelia,384,142,242,36.98
Zoe,Sylas,673,370,303,54.98
Zoe,Ashe,1037,494,543,47.64
Zoe,Malzahar,413,192,221,46.49
Zoe,Ezreal,1207,642,565,53.19
Zoe,Pyke,355,186,169,52.39
Zoe,Teemo,440,183,257,41.59
Zoe,Amumu,393,199,194,50.64
Zoe,Katarina,351,175,176,49.86
Zoe,MissFortune,1005,429,576,42.69
Zoe,Nami,399,213,186,53.38
Zoe,Jax,458,234,224,51.09
Zoe,Ahri,654,350,304,53.52
Zoe,Corki,232,118,114,50.86
Zoe,Soraka,257,137,120,53.31
Zoe,Shen,255,121,134,47.45
Zoe,Graves,341,162,179,47.51
Zoe,Taliyah,146,59,87,40.41
Zoe,Poppy,266,118,148,44.36
Zoe,Olaf,114,43,71,37.72
Zoe,Kayn,600,315,285,52.5
Zoe,Cassiopeia,107,53,54,49.53
Zoe,Morgana,522,271,251,51.92
Zoe,Fiora,188,84,104,44.68
Zoe,Khazix,204,103,101,50.49
Zoe,Ekko,395,188,207,47.59
Zoe,Lucian,286,164,122,57.34
Zoe,Braum,273,120,153,43.96
Zoe,Singed,116,50,66,43.1
Zoe,Viktor,415,214,201,51.57
Zoe,Samira,281,125,156,44.48
Zoe,Pantheon,678,353,325,52.06
Zoe,Shaco,355,178,177,50.14
Zoe,Akali,455,225,230,49.45
Zoe,Xerath,427,208,219,48.71
Zoe,XinZhao,248,91,157,36.69
Zoe,Warwick,512,259,253,50.59
Zoe,DrMundo,252,122,130,48.41
Zoe,Volibear,420,193,227,45.95
Zoe,Zed,454,233,221,51.32
Zoe,Udyr,176,84,92,47.73
Zoe,Veigar,446,229,217,51.35
Zoe,Tristana,467,213,254,45.61
Zoe,Sett,679,339,340,49.93
Zoe,Sion,318,139,179,43.71
Zoe,Vladimir,305,167,138,54.75
Zoe,Jhin,907,484,423,53.36
Zoe,Thresh,611,328,283,53.68
Zoe,Heimerdinger,172,71,101,41.28
Zoe,Karma,611,316,295,51.72
Zoe,Twitch,377,202,175,53.58
Zoe,Annie,145,65,80,44.83
Zoe,MonkeyKing,299,173,126,57.86
Zoe,Azir,161,90,71,55.9
Zoe,Aatrox,387,189,198,48.84
Zoe,Elise,436,204,232,46.79
Zoe,Fizz,252,98,154,38.89
Zoe,Varus,417,197,220,47.24
Zoe,Mel,791,410,381,51.83
Zoe,Aurora,342,145,197,42.4
Zoe,Malphite,372,173,199,46.51
Zoe,Hwei,297,142,155,47.81
Zoe,MasterYi,616,316,300,51.3
Zoe,Seraphine,304,155,149,50.99
Zoe,Nasus,210,96,114,45.71
Zoe,Shyvana,105,47,58,44.76
Zoe,Illaoi,152,74,78,48.68
Zoe,Diana,675,345,330,51.11
Zoe,Rell,211,94,117,44.55
Zoe,KSante,265,175,90,66.04
Zoe,Galio,455,201,254,44.18
Zoe,Leblanc,352,167,185,47.44
Zoe,Zilean,162,84,78,51.85
Zoe,Kayle,267,147,120,55.06
Zoe,Naafiri,216,101,115,46.76
Zoe,Yuumi,346,182,164,52.6
Zoe,Chogath,522,277,245,53.07
Zoe,Gragas,262,159,103,60.69
Zoe,Ambessa,279,137,142,49.1
Zoe,TwistedFate,190,93,97,48.95
Zoe,Lulu,597,301,296,50.42
Zoe,Orianna,174,87,87,50
Zoe,KogMaw,148,67,81,45.27
Zoe,Qiyana,149,96,53,64.43
Zoe,Urgot,170,58,112,34.12
Zoe,Vi,463,211,252,45.57
Zoe,Swain,322,136,186,42.24
Zoe,Sejuani,159,86,73,54.09
Zoe,Nocturne,578,282,296,48.79
Zoe,Yone,900,484,416,53.78
Zoe,Kaisa,778,389,389,50
Zoe,Gwen,243,95,148,39.09
Zoe,Brand,323,160,163,49.54
Zoe,Vayne,553,259,294,46.84
Zoe,Sona,127,50,77,39.37
Zoe,Briar,253,137,116,54.15
Zoe,AurelionSol,145,75,70,51.72
Zoe,Sivir,230,111,119,48.26
Zoe,Maokai,239,113,126,47.28
Zoe,Anivia,166,98,68,59.04
Zoe,Syndra,331,174,157,52.57
Zoe,Leona,348,179,169,51.44
Zoe,Neeko,201,115,86,57.21
Zoe,Karthus,148,72,76,48.65
Zoe,Vex,236,106,130,44.92
Zoe,Kalista,83,44,39,53.01
Zoe,Renata,81,43,38,53.09
Zoe,Talon,265,136,129,51.32
Zoe,Quinn,167,75,92,44.91
Zoe,Nilah,127,50,77,39.37
Zoe,Ziggs,188,97,91,51.6
Zoe,LeeSin,761,386,375,50.72
Zoe,Camille,194,101,93,52.06
Zoe,Lissandra,123,61,62,49.59
Zoe,Riven,205,86,119,41.95
Zoe,Tryndamere,282,158,124,56.03
Zoe,Lillia,259,127,132,49.03
Zoe,FiddleSticks,221,95,126,42.99
Zoe,Velkoz,272,114,158,41.91
Zoe,Smolder,236,135,101,57.2
Zoe,Bard,151,81,70,53.64
Zoe,Rumble,167,94,73,56.29
Zoe,Darius,779,427,352,54.81
Zoe,Xayah,161,70,91,43.48
Zoe,Rakan,190,87,103,45.79
Zoe,Aphelios,225,111,114,49.33
Zoe,Alistar,164,88,76,53.66
Zoe,Ryze,168,91,77,54.17
Zoe,Gnar,176,87,89,49.43
Zoe,Kennen,115,53,62,46.09
Zoe,Senna,320,136,184,42.5
Zoe,Viego,701,352,349,50.21
Zoe,Janna,136,66,70,48.53
Zoe,Hecarim,135,67,68,49.63
Zoe,Jayce,235,126,109,53.62
Zoe,Rengar,158,71,87,44.94
Zoe,Kled,94,49,45,52.13
Zoe,Zyra,426,208,218,48.83
Zoe,Evelynn,144,70,74,48.61
Zoe,Gangplank,244,131,113,53.69
Zoe,Nidalee,145,69,76,47.59
Zoe,Belveth,93,65,28,69.89
Zoe,Blitzcrank,336,177,159,52.68
Zoe,Kindred,166,79,87,47.59
Zoe,Zac,217,111,106,51.15
Zoe,Skarner,100,54,46,54
Zoe,Rammus,136,60,76,44.12
Zoe,Zeri,198,113,85,57.07
Zoe,Akshan,211,99,112,46.92
Zoe,JarvanIV,270,132,138,48.89
Zoe,Ornn,186,92,94,49.46
Zoe,Taric,85,41,44,48.24
Zoe,Kassadin,48,26,22,54.17
Zoe,RekSai,81,36,45,44.44
Ambessa,Diana,1266,617,649,48.74
Ambessa,Gragas,476,235,241,49.37
Ambessa,Zed,932,436,496,46.78
Ambessa,Caitlyn,1974,910,1064,46.1
Ambessa,Soraka,397,187,210,47.1
Ambessa,Renekton,626,279,347,44.57
Ambessa,Evelynn,295,142,153,48.14
Ambessa,Lissandra,229,90,139,39.3
Ambessa,Corki,363,180,183,49.59
Ambessa,Rakan,271,107,164,39.48
Ambessa,Aatrox,682,341,341,50
Ambessa,Kayn,997,437,560,43.83
Ambessa,Katarina,597,267,330,44.72
Ambessa,Draven,316,126,190,39.87
Ambessa,Blitzcrank,569,251,318,44.11
Ambessa,Vi,782,405,377,51.79
Ambessa,Ekko,666,326,340,48.95
Ambessa,Yasuo,1428,680,748,47.62
Ambessa,Jhin,1456,679,777,46.63
Ambessa,Velkoz,430,180,250,41.86
Ambessa,Chogath,735,339,396,46.12
Ambessa,Shaco,656,324,332,49.39
Ambessa,Sivir,397,204,193,51.39
Ambessa,Milio,409,186,223,45.48
Ambessa,Tryndamere,396,169,227,42.68
Ambessa,Rengar,200,95,105,47.5
Ambessa,Viktor,773,397,376,51.36
Ambessa,Lux,1709,772,937,45.17
Ambessa,Poppy,455,187,268,41.1
Ambessa,Viego,1184,561,623,47.38
Ambessa,Vayne,943,398,545,42.21
Ambessa,Nami,693,308,385,44.44
Ambessa,Garen,1088,457,631,42
Ambessa,Udyr,304,175,129,57.57
Ambessa,Vladimir,454,209,245,46.04
Ambessa,Zyra,835,380,455,45.51
Ambessa,Camille,433,208,225,48.04
Ambessa,MasterYi,742,316,426,42.59
Ambessa,Malzahar,643,299,344,46.5
Ambessa,Jinx,2010,910,1100,45.27
Ambessa,Gwen,328,157,171,47.87
Ambessa,Rammus,174,71,103,40.8
Ambessa,Karma,1134,538,596,47.44
Ambessa,Gnar,304,167,137,54.93
Ambessa,Yorick,549,222,327,40.44
Ambessa,Aurora,527,277,250,52.56
Ambessa,Taric,146,82,64,56.16
Ambessa,Teemo,697,320,377,45.91
Ambessa,Amumu,667,307,360,46.03
Ambessa,Hwei,445,242,203,54.38
Ambessa,Ezreal,2214,1088,1126,49.14
Ambessa,Brand,485,245,240,50.52
Ambessa,Karthus,279,144,135,51.61
Ambessa,Fizz,403,182,221,45.16
Ambessa,Swain,668,290,378,43.41
Ambessa,FiddleSticks,353,189,164,53.54
Ambessa,Naafiri,255,130,125,50.98
Ambessa,Mordekaiser,816,390,426,47.79
Ambessa,Nocturne,1013,411,602,40.57
Ambessa,Smolder,386,199,187,51.55
Ambessa,Azir,262,130,132,49.62
Ambessa,Seraphine,415,207,208,49.88
Ambessa,Annie,264,140,124,53.03
Ambessa,Irelia,703,319,384,45.38
Ambessa,Khazix,339,173,166,51.03
Ambessa,Zilean,246,130,116,52.85
Ambessa,Gangplank,368,165,203,44.84
Ambessa,Warwick,957,404,553,42.22
Ambessa,Nilah,203,76,127,37.44
Ambessa,Urgot,355,182,173,51.27
Ambessa,Ryze,311,122,189,39.23
Ambessa,Galio,764,327,437,42.8
Ambessa,Twitch,558,239,319,42.83
Ambessa,Yuumi,576,299,277,51.91
Ambessa,Sett,1155,514,641,44.5
Ambessa,LeeSin,1496,733,763,49
Ambessa,Vex,388,162,226,41.75
Ambessa,MissFortune,1472,695,777,47.21
Ambessa,Leblanc,561,248,313,44.21
Ambessa,Rell,338,142,196,42.01
Ambessa,Fiora,256,120,136,46.88
Ambessa,Lucian,556,295,261,53.06
Ambessa,Braum,436,198,238,45.41
Ambessa,Shen,495,226,269,45.66
Ambessa,Veigar,552,277,275,50.18
Ambessa,Pantheon,1197,564,633,47.12
Ambessa,Akali,839,408,431,48.63
Ambessa,Mel,1360,643,717,47.28
Ambessa,Lillia,433,200,233,46.19
Ambessa,Quinn,298,122,176,40.94
Ambessa,Ashe,1604,800,804,49.88
Ambessa,Riven,366,151,215,41.26
Ambessa,DrMundo,313,164,149,52.4
Ambessa,Trundle,342,163,179,47.66
Ambessa,Xerath,692,301,391,43.5
Ambessa,Kaisa,1306,625,681,47.86
Ambessa,Nautilus,858,404,454,47.09
Ambessa,Darius,1312,562,750,42.84
Ambessa,Graves,499,258,241,51.7
Ambessa,Alistar,358,193,165,53.91
Ambessa,Rumble,208,109,99,52.4
Ambessa,Zac,385,175,210,45.45
Ambessa,Kalista,214,105,109,49.07
Ambessa,Senna,529,237,292,44.8
Ambessa,Thresh,1013,485,528,47.88
Ambessa,JarvanIV,412,176,236,42.72
Ambessa,Kindred,272,157,115,57.72
Ambessa,TwistedFate,273,123,150,45.05
Ambessa,Varus,727,354,373,48.69
Ambessa,Briar,479,220,259,45.93
Ambessa,Illaoi,292,130,162,44.52
Ambessa,Hecarim,362,168,194,46.41
Ambessa,Lulu,1175,560,615,47.66
Ambessa,Elise,601,249,352,41.43
Ambessa,Qiyana,197,105,92,53.3
Ambessa,MonkeyKing,534,244,290,45.69
Ambessa,Syndra,477,239,238,50.1
Ambessa,Talon,444,202,242,45.5
Ambessa,Nasus,382,182,200,47.64
Ambessa,Yone,1335,702,633,52.58
Ambessa,Bard,244,139,105,56.97
Ambessa,Janna,295,141,154,47.8
Ambessa,Leona,615,309,306,50.24
Ambessa,Kassadin,170,77,93,45.29
Ambessa,Volibear,714,330,384,46.22
Ambessa,Ahri,936,455,481,48.61
Ambessa,Jax,723,374,349,51.73
Ambessa,Malphite,606,258,348,42.57
Ambessa,Kayle,415,197,218,47.47
Ambessa,Renata,126,45,81,35.71
Ambessa,Zoe,279,142,137,50.9
Ambessa,Aphelios,387,165,222,42.64
Ambessa,Taliyah,197,92,105,46.7
Ambessa,TahmKench,456,221,235,48.46
Ambessa,Olaf,196,94,102,47.96
Ambessa,Ziggs,253,97,156,38.34
Ambessa,Zeri,353,169,184,47.88
Ambessa,Jayce,553,266,287,48.1
Ambessa,Pyke,569,279,290,49.03
Ambessa,Tristana,620,300,320,48.39
Ambessa,Sona,196,81,115,41.33
Ambessa,Sejuani,281,110,171,39.15
Ambessa,Samira,418,193,225,46.17
Ambessa,Maokai,370,147,223,39.73
Ambessa,Singed,225,95,130,42.22
Ambessa,Nidalee,270,129,141,47.78
Ambessa,Cassiopeia,184,91,93,49.46
Ambessa,Morgana,726,358,368,49.31
Ambessa,Sylas,1176,571,605,48.55
Ambessa,Neeko,353,162,191,45.89
Ambessa,AurelionSol,269,125,144,46.47
Ambessa,Sion,568,298,270,52.46
Ambessa,Orianna,417,200,217,47.96
Ambessa,XinZhao,535,228,307,42.62
Ambessa,Kennen,217,92,125,42.4
Ambessa,Ivern,115,57,58,49.57
Ambessa,Nunu,364,177,187,48.63
Ambessa,Kled,115,54,61,46.96
Ambessa,KSante,577,278,299,48.18
Ambessa,Shyvana,178,90,88,50.56
Ambessa,Heimerdinger,267,128,139,47.94
Ambessa,Akshan,267,140,127,52.43
Ambessa,Xayah,332,163,169,49.1
Ambessa,Anivia,243,113,130,46.5
Ambessa,KogMaw,256,119,137,46.48
Ambessa,Skarner,189,122,67,64.55
Ambessa,RekSai,89,44,45,49.44
Ambessa,Ornn,308,158,150,51.3
Ambessa,Belveth,190,89,101,46.84
KSante,Gnar,344,168,176,48.84
KSante,Zyra,643,338,305,52.57
KSante,Azir,264,130,134,49.24
KSante,Varus,636,302,334,47.48
KSante,Nautilus,736,344,392,46.74
KSante,Aatrox,717,360,357,50.21
KSante,Evelynn,196,93,103,47.45
KSante,Katarina,409,210,199,51.34
KSante,Kaisa,1167,551,616,47.22
KSante,Zilean,197,81,116,41.12
KSante,Volibear,552,240,312,43.48
KSante,JarvanIV,365,144,221,39.45
KSante,Zed,732,361,371,49.32
KSante,Lucian,457,200,257,43.76
KSante,Nami,527,225,302,42.69
KSante,Gangplank,277,126,151,45.49
KSante,Jax,606,285,321,47.03
KSante,Yasuo,1285,584,701,45.45
KSante,Gragas,384,164,220,42.71
KSante,MonkeyKing,428,181,247,42.29
KSante,Ahri,774,369,405,47.67
KSante,Caitlyn,1675,811,864,48.42
KSante,Poppy,488,202,286,41.39
KSante,Sett,1046,495,551,47.32
KSante,Mordekaiser,809,408,401,50.43
KSante,Akshan,134,52,82,38.81
KSante,MissFortune,1338,588,750,43.95
KSante,Maokai,293,135,158,46.08
KSante,LeeSin,1278,597,681,46.71
KSante,Jhin,1201,558,643,46.46
KSante,Hecarim,283,131,152,46.29
KSante,Fizz,297,167,130,56.23
KSante,Blitzcrank,488,243,245,49.8
KSante,Sion,404,179,225,44.31
KSante,Aurora,428,231,197,53.97
KSante,Shen,356,171,185,48.03
KSante,Diana,1061,501,560,47.22
KSante,Mel,1144,595,549,52.01
KSante,Kalista,159,97,62,61.01
KSante,Seraphine,374,175,199,46.79
KSante,Darius,1156,546,610,47.23
KSante,Ekko,572,280,292,48.95
KSante,Qiyana,158,61,97,38.61
KSante,Lux,1275,598,677,46.9
KSante,Rengar,229,125,104,54.59
KSante,Belveth,145,81,64,55.86
KSante,Veigar,506,235,271,46.44
KSante,Swain,533,258,275,48.41
KSante,Yone,1225,570,655,46.53
KSante,Corki,313,162,151,51.76
KSante,Warwick,691,343,348,49.64
KSante,Karma,943,415,528,44.01
KSante,Braum,407,168,239,41.28
KSante,Malphite,474,262,212,55.27
KSante,Xerath,696,298,398,42.82
KSante,Smolder,378,196,182,51.85
KSante,Sona,163,85,78,52.15
KSante,Ornn,333,166,167,49.85
KSante,MasterYi,658,331,327,50.3
KSante,Jinx,1789,823,966,46
KSante,Renata,75,41,34,54.67
KSante,Urgot,263,137,126,52.09
KSante,Pantheon,1156,518,638,44.81
KSante,Viktor,620,254,366,40.97
KSante,TahmKench,412,228,184,55.34
KSante,Kayle,404,194,210,48.02
KSante,TwistedFate,208,87,121,41.83
KSante,Nocturne,770,338,432,43.9
KSante,Akali,744,343,401,46.1
KSante,Udyr,248,150,98,60.48
KSante,Malzahar,597,281,316,47.07
KSante,Vi,614,308,306,50.16
KSante,Elise,482,241,241,50
KSante,Zac,435,217,218,49.89
KSante,Vladimir,340,135,205,39.71
KSante,Garen,1028,418,610,40.66
KSante,Talon,445,218,227,48.99
KSante,DrMundo,315,144,171,45.71
KSante,Orianna,265,128,137,48.3
KSante,Ivern,98,34,64,34.69
KSante,Leblanc,444,222,222,50
KSante,Velkoz,323,158,165,48.92
KSante,Shaco,558,280,278,50.18
KSante,Taliyah,174,71,103,40.8
KSante,Milio,323,137,186,42.41
KSante,Kayn,755,309,446,40.93
KSante,Ashe,1469,703,766,47.86
KSante,Khazix,297,114,183,38.38
KSante,Ezreal,1750,876,874,50.06
KSante,Renekton,402,185,217,46.02
KSante,Shyvana,141,74,67,52.48
KSante,Lissandra,206,103,103,50
KSante,Janna,244,135,109,55.33
KSante,Syndra,327,133,194,40.67
KSante,Aphelios,332,172,160,51.81
KSante,Yorick,497,180,317,36.22
KSante,Vex,288,143,145,49.65
KSante,Riven,284,138,146,48.59
KSante,Kassadin,138,57,81,41.3
KSante,Lulu,959,414,545,43.17
KSante,Viego,889,413,476,46.46
KSante,Briar,423,194,229,45.86
KSante,Sylas,1065,504,561,47.32
KSante,Irelia,554,279,275,50.36
KSante,Twitch,449,209,240,46.55
KSante,Pyke,515,267,248,51.84
KSante,Gwen,363,161,202,44.35
KSante,Zoe,265,90,175,33.96
KSante,Jayce,422,170,252,40.28
KSante,Xayah,252,101,151,40.08
KSante,Tristana,496,249,247,50.2
KSante,Anivia,194,99,95,51.03
KSante,Hwei,400,202,198,50.5
KSante,Vayne,791,305,486,38.56
KSante,Alistar,262,127,135,48.47
KSante,Sejuani,296,136,160,45.95
KSante,Leona,529,252,277,47.64
KSante,Amumu,525,221,304,42.1
KSante,Morgana,587,266,321,45.32
KSante,FiddleSticks,345,148,197,42.9
KSante,Thresh,833,392,441,47.06
KSante,Ziggs,232,120,112,51.72
KSante,Rammus,185,81,104,43.78
KSante,Nasus,364,147,217,40.38
KSante,Ryze,250,111,139,44.4
KSante,Fiora,246,114,132,46.34
KSante,Chogath,602,280,322,46.51
KSante,Olaf,153,85,68,55.56
KSante,Kindred,292,114,178,39.04
KSante,Annie,195,84,111,43.08
KSante,Teemo,449,190,259,42.32
KSante,Brand,365,151,214,41.37
KSante,Illaoi,271,115,156,42.44
KSante,Nunu,247,129,118,52.23
KSante,Rell,388,173,215,44.59
KSante,Taric,119,57,62,47.9
KSante,KogMaw,190,91,99,47.89
KSante,Lillia,410,160,250,39.02
KSante,Samira,371,150,221,40.43
KSante,Karthus,173,78,95,45.09
KSante,Soraka,337,145,192,43.03
KSante,Graves,413,207,206,50.12
KSante,AurelionSol,213,112,101,52.58
KSante,Trundle,321,117,204,36.45
KSante,Kennen,101,31,70,30.69
KSante,Singed,139,51,88,36.69
KSante,Sivir,264,113,151,42.8
KSante,Senna,405,182,223,44.94
KSante,Neeko,307,174,133,56.68
KSante,Galio,636,314,322,49.37
KSante,RekSai,107,46,61,42.99
KSante,Skarner,201,114,87,56.72
KSante,Yuumi,530,274,256,51.7
KSante,Ambessa,577,299,278,51.82
KSante,Kled,128,71,57,55.47
KSante,Quinn,160,78,82,48.75
KSante,XinZhao,443,224,219,50.56
KSante,Rakan,275,134,141,48.73
KSante,Tryndamere,246,126,120,51.22
KSante,Camille,217,107,110,49.31
KSante,Nilah,158,68,90,43.04
KSante,Nidalee,227,83,144,36.56
KSante,Heimerdinger,176,86,90,48.86
KSante,Bard,164,73,91,44.51
KSante,Naafiri,163,55,108,33.74
KSante,Draven,293,128,165,43.69
KSante,Zeri,285,135,150,47.37
KSante,Rumble,223,124,99,55.61
KSante,Cassiopeia,198,81,117,40.91
Urgot,Warwick,971,525,446,54.07
Urgot,Hecarim,227,127,100,55.95
Urgot,Diana,1026,525,501,51.17
Urgot,Ziggs,225,107,118,47.56
Urgot,Karma,762,386,376,50.66
Urgot,Sett,1079,543,536,50.32
Urgot,Lillia,321,136,185,42.37
Urgot,Leblanc,305,175,130,57.38
Urgot,Jinx,1856,961,895,51.78
Urgot,Alistar,234,122,112,52.14
Urgot,Yorick,869,421,448,48.45
Urgot,Briar,490,205,285,41.84
Urgot,Malzahar,646,344,302,53.25
Urgot,Jhin,1282,658,624,51.33
Urgot,Nautilus,662,377,285,56.95
Urgot,JarvanIV,310,166,144,53.55
Urgot,Mel,1143,610,533,53.37
Urgot,Lux,1628,817,811,50.18
Urgot,MonkeyKing,452,204,248,45.13
Urgot,Anivia,184,87,97,47.28
Urgot,Corki,230,154,76,66.96
Urgot,Ivern,85,39,46,45.88
Urgot,Lissandra,225,126,99,56
Urgot,Volibear,896,478,418,53.35
Urgot,Vladimir,383,222,161,57.96
Urgot,Lucian,370,197,173,53.24
Urgot,Nami,651,357,294,54.84
Urgot,Olaf,150,83,67,55.33
Urgot,Pantheon,965,516,449,53.47
Urgot,Nunu,334,178,156,53.29
Urgot,Viktor,590,310,280,52.54
Urgot,Sivir,301,146,155,48.5
Urgot,Morgana,708,346,362,48.87
Urgot,Garen,1007,480,527,47.67
Urgot,Caitlyn,1766,909,857,51.47
Urgot,Blitzcrank,397,168,229,42.32
Urgot,Mordekaiser,793,396,397,49.94
Urgot,Xerath,564,293,271,51.95
Urgot,Ezreal,1200,624,576,52
Urgot,Yuumi,457,256,201,56.02
Urgot,Viego,797,401,396,50.31
Urgot,Thresh,716,386,330,53.91
Urgot,Aatrox,545,308,237,56.51
Urgot,LeeSin,669,355,314,53.06
Urgot,Yasuo,1194,622,572,52.09
Urgot,Graves,347,146,201,42.07
Urgot,Amumu,719,368,351,51.18
Urgot,Gangplank,296,162,134,54.73
Urgot,Taliyah,146,88,58,60.27
Urgot,Milio,369,174,195,47.15
Urgot,Rengar,260,161,99,61.92
Urgot,Veigar,650,276,374,42.46
Urgot,Xayah,219,109,110,49.77
Urgot,Quinn,206,110,96,53.4
Urgot,Elise,365,184,181,50.41
Urgot,Ryze,210,104,106,49.52
Urgot,Ahri,765,434,331,56.73
Urgot,Ambessa,355,173,182,48.73
Urgot,Akali,617,353,264,57.21
Urgot,Samira,449,242,207,53.9
Urgot,Yone,950,560,390,58.95
Urgot,Kayn,927,529,398,57.07
Urgot,Tristana,619,302,317,48.79
Urgot,Fiora,192,102,90,53.13
Urgot,Galio,482,227,255,47.1
Urgot,Gnar,251,142,109,56.57
Urgot,Ashe,1099,618,481,56.23
Urgot,Braum,383,170,213,44.39
Urgot,Darius,1263,644,619,50.99
Urgot,Talon,301,157,144,52.16
Urgot,Twitch,599,310,289,51.75
Urgot,Brand,491,260,231,52.95
Urgot,KSante,263,126,137,47.91
Urgot,MissFortune,1586,792,794,49.94
Urgot,Trundle,388,172,216,44.33
Urgot,FiddleSticks,260,123,137,47.31
Urgot,Ekko,637,361,276,56.67
Urgot,Zyra,566,300,266,53
Urgot,Gwen,281,154,127,54.8
Urgot,Zed,573,294,279,51.31
Urgot,Seraphine,570,285,285,50
Urgot,Sejuani,243,139,104,57.2
Urgot,Kennen,183,96,87,52.46
Urgot,TahmKench,539,281,258,52.13
Urgot,Vi,548,274,274,50
Urgot,Katarina,447,258,189,57.72
Urgot,Nasus,535,278,257,51.96
Urgot,Soraka,295,144,151,48.81
Urgot,Kayle,523,267,256,51.05
Urgot,XinZhao,332,204,128,61.45
Urgot,KogMaw,160,97,63,60.63
Urgot,Renata,103,58,45,56.31
Urgot,Qiyana,128,81,47,63.28
Urgot,Rakan,210,117,93,55.71
Urgot,Teemo,796,394,402,49.5
Urgot,Sona,247,158,89,63.97
Urgot,Singed,192,104,88,54.17
Urgot,Chogath,725,389,336,53.66
Urgot,Sion,483,256,227,53
Urgot,Riven,360,192,168,53.33
Urgot,Smolder,348,205,143,58.91
Urgot,Bard,201,112,89,55.72
Urgot,Syndra,325,186,139,57.23
Urgot,Draven,373,202,171,54.16
Urgot,Camille,204,131,73,64.22
Urgot,Annie,203,89,114,43.84
Urgot,Kaisa,998,570,428,57.11
Urgot,Nocturne,797,408,389,51.19
Urgot,Sylas,722,373,349,51.66
Urgot,Malphite,620,318,302,51.29
Urgot,Varus,420,253,167,60.24
Urgot,Lulu,823,401,422,48.72
Urgot,Gragas,278,147,131,52.88
Urgot,MasterYi,834,462,372,55.4
Urgot,Heimerdinger,266,139,127,52.26
Urgot,Fizz,402,181,221,45.02
Urgot,Vayne,769,380,389,49.41
Urgot,Neeko,270,164,106,60.74
Urgot,Naafiri,233,134,99,57.51
Urgot,Zeri,237,133,104,56.12
Urgot,Poppy,297,145,152,48.82
Urgot,Illaoi,251,114,137,45.42
Urgot,Karthus,170,82,88,48.24
Urgot,Aurora,396,209,187,52.78
Urgot,Zoe,170,112,58,65.88
Urgot,Hwei,407,212,195,52.09
Urgot,Zilean,206,89,117,43.2
Urgot,Kalista,126,63,63,50
Urgot,Senna,494,284,210,57.49
Urgot,Pyke,457,234,223,51.2
Urgot,Shen,356,180,176,50.56
Urgot,Jax,489,243,246,49.69
Urgot,Irelia,458,260,198,56.77
Urgot,Shaco,581,269,312,46.3
Urgot,Skarner,119,78,41,65.55
Urgot,Jayce,227,133,94,58.59
Urgot,TwistedFate,224,108,116,48.21
Urgot,Kindred,249,121,128,48.59
Urgot,Khazix,307,181,126,58.96
Urgot,Tryndamere,376,198,178,52.66
Urgot,Velkoz,411,217,194,52.8
Urgot,Udyr,278,164,114,58.99
Urgot,Vex,306,143,163,46.73
Urgot,Leona,484,266,218,54.96
Urgot,Cassiopeia,139,63,76,45.32
Urgot,Rumble,140,82,58,58.57
Urgot,Rell,286,127,159,44.41
Urgot,Taric,129,76,53,58.91
Urgot,DrMundo,396,171,225,43.18
Urgot,Rammus,213,102,111,47.89
Urgot,Swain,555,272,283,49.01
Urgot,Maokai,265,147,118,55.47
Urgot,Kassadin,133,70,63,52.63
Urgot,Akshan,213,115,98,53.99
Urgot,Belveth,157,102,55,64.97
Urgot,Shyvana,188,124,64,65.96
Urgot,Renekton,290,143,147,49.31
Urgot,Nidalee,137,90,47,65.69
Urgot,Janna,241,130,111,53.94
Urgot,Orianna,267,143,124,53.56
Urgot,Nilah,206,102,104,49.51
Urgot,Evelynn,214,133,81,62.15
Urgot,Azir,175,101,74,57.71
Urgot,Ornn,253,117,136,46.25
Urgot,Aphelios,324,171,153,52.78
Urgot,Kled,128,67,61,52.34
Urgot,AurelionSol,290,146,144,50.34
Urgot,Zac,231,117,114,50.65
Urgot,RekSai,80,51,29,63.75
Bard,Warwick,466,203,263,43.56
Bard,Hecarim,225,111,114,49.33
Bard,Diana,603,313,290,51.91
Bard,Ziggs,106,61,45,57.55
Bard,Karma,559,311,248,55.64
Bard,Poppy,250,133,117,53.2
Bard,Taliyah,125,51,74,40.8
Bard,MissFortune,682,375,307,54.99
Bard,Morgana,320,156,164,48.75
Bard,Tryndamere,170,100,70,58.82
Bard,Kassadin,99,53,46,53.54
Bard,Ashe,723,360,363,49.79
Bard,Soraka,236,98,138,41.53
Bard,Darius,681,293,388,43.02
Bard,Braum,262,155,107,59.16
Bard,Aurora,290,155,135,53.45
Bard,Nunu,158,74,84,46.84
Bard,Gangplank,201,87,114,43.28
Bard,Qiyana,116,79,37,68.1
Bard,Xerath,348,194,154,55.75
Bard,Twitch,336,174,162,51.79
Bard,Lux,735,365,370,49.66
Bard,Nami,444,252,192,56.76
Bard,MasterYi,402,173,229,43.03
Bard,Vex,165,64,101,38.79
Bard,Kaisa,650,332,318,51.08
Bard,DrMundo,200,92,108,46
Bard,Jayce,245,132,113,53.88
Bard,Nocturne,427,233,194,54.57
Bard,Heimerdinger,119,48,71,40.34
Bard,Vayne,390,198,192,50.77
Bard,Irelia,327,174,153,53.21
Bard,Jinx,1022,500,522,48.92
Bard,Velkoz,220,118,102,53.64
Bard,LeeSin,599,363,236,60.6
Bard,Akali,341,172,169,50.44
Bard,Lucian,260,153,107,58.85
Bard,Yuumi,311,128,183,41.16
Bard,Garen,552,270,282,48.91
Bard,Shaco,329,171,158,51.98
Bard,Fizz,208,83,125,39.9
Bard,Caitlyn,937,428,509,45.68
Bard,Pantheon,603,304,299,50.41
Bard,Yorick,343,147,196,42.86
Bard,Ekko,373,164,209,43.97
Bard,Yone,583,303,280,51.97
Bard,Lulu,514,268,246,52.14
Bard,Shen,245,133,112,54.29
Bard,Kayn,527,269,258,51.04
Bard,Sylas,489,275,214,56.24
Bard,Zilean,191,85,106,44.5
Bard,Sett,450,218,232,48.44
Bard,Camille,176,98,78,55.68
Bard,Zac,159,72,87,45.28
Bard,Vladimir,215,89,126,41.4
Bard,Rakan,179,94,85,52.51
Bard,Volibear,410,209,201,50.98
Bard,Jax,373,202,171,54.16
Bard,Hwei,207,123,84,59.42
Bard,Pyke,285,151,134,52.98
Bard,Malzahar,344,166,178,48.26
Bard,Jhin,765,395,370,51.63
Bard,Aatrox,309,141,168,45.63
Bard,Xayah,147,76,71,51.7
Bard,TahmKench,233,113,120,48.5
Bard,Teemo,356,164,192,46.07
Bard,Sejuani,116,65,51,56.03
Bard,Katarina,248,113,135,45.56
Bard,Veigar,300,126,174,42
Bard,Ahri,526,272,254,51.71
Bard,Urgot,201,89,112,44.28
Bard,Senna,294,127,167,43.2
Bard,Briar,217,118,99,54.38
Bard,Azir,96,55,41,57.29
Bard,Nautilus,342,164,178,47.95
Bard,Lillia,231,131,100,56.71
Bard,Janna,191,73,118,38.22
Bard,Gragas,218,114,104,52.29
Bard,Kindred,136,36,100,26.47
Bard,Mel,709,383,326,54.02
Bard,Ambessa,244,105,139,43.03
Bard,Leona,271,138,133,50.92
Bard,Fiora,168,74,94,44.05
Bard,Viego,559,287,272,51.34
Bard,Kayle,241,113,128,46.89
Bard,Naafiri,111,52,59,46.85
Bard,Varus,308,162,146,52.6
Bard,Karthus,130,61,69,46.92
Bard,Ezreal,923,461,462,49.95
Bard,Brand,243,127,116,52.26
Bard,Viktor,329,156,173,47.42
Bard,Malphite,327,179,148,54.74
Bard,Elise,289,131,158,45.33
Bard,FiddleSticks,195,94,101,48.21
Bard,Zyra,402,201,201,50
Bard,Thresh,569,297,272,52.2
Bard,Skarner,72,42,30,58.33
Bard,Ivern,78,33,45,42.31
Bard,Sona,101,31,70,30.69
Bard,Gnar,159,95,64,59.75
Bard,JarvanIV,239,112,127,46.86
Bard,Orianna,215,111,104,51.63
Bard,Aphelios,178,99,79,55.62
Bard,Neeko,133,75,58,56.39
Bard,Vi,293,150,143,51.19
Bard,Sion,300,126,174,42
Bard,Graves,203,139,64,68.47
Bard,Swain,254,133,121,52.36
Bard,Seraphine,233,119,114,51.07
Bard,Cassiopeia,118,54,64,45.76
Bard,Gwen,213,110,103,51.64
Bard,Zed,351,179,172,51
Bard,Amumu,345,163,182,47.25
Bard,Syndra,287,130,157,45.3
Bard,Chogath,412,229,183,55.58
Bard,Trundle,184,84,100,45.65
Bard,MonkeyKing,253,117,136,46.25
Bard,Yasuo,659,342,317,51.9
Bard,Samira,240,95,145,39.58
Bard,Smolder,223,119,104,53.36
Bard,Mordekaiser,435,211,224,48.51
Bard,Talon,226,125,101,55.31
Bard,Zoe,151,70,81,46.36
Bard,Galio,287,143,144,49.83
Bard,Milio,215,87,128,40.47
Bard,Maokai,206,95,111,46.12
Bard,Zeri,165,77,88,46.67
Bard,AurelionSol,116,54,62,46.55
Bard,Renata,70,40,30,57.14
Bard,Ornn,153,77,76,50.33
Bard,Nilah,124,76,48,61.29
Bard,Singed,100,49,51,49
Bard,Belveth,76,40,36,52.63
Bard,TwistedFate,131,60,71,45.8
Bard,Nasus,244,120,124,49.18
Bard,Rumble,115,75,40,65.22
Bard,Kalista,103,58,45,56.31
Bard,Blitzcrank,203,89,114,43.84
Bard,Draven,183,100,83,54.64
Bard,Evelynn,123,79,44,64.23
Bard,Olaf,97,58,39,59.79
Bard,Leblanc,231,132,99,57.14
Bard,Rammus,90,32,58,35.56
Bard,Anivia,111,53,58,47.75
Bard,Sivir,183,74,109,40.44
Bard,Corki,181,90,91,49.72
Bard,Alistar,129,51,78,39.53
Bard,Rengar,108,48,60,44.44
Bard,Lissandra,123,37,86,30.08
Bard,KogMaw,107,40,67,37.38
Bard,Quinn,142,75,67,52.82
Bard,RekSai,50,27,23,54
Bard,Tristana,364,195,169,53.57
Bard,Rell,173,76,97,43.93
Bard,Riven,199,101,98,50.75
Bard,KSante,164,91,73,55.49
Bard,Udyr,146,57,89,39.04
Bard,Shyvana,93,50,43,53.76
Bard,Annie,92,42,50,45.65
Bard,Renekton,199,98,101,49.25
Bard,Taric,66,33,33,50
Bard,XinZhao,229,102,127,44.54
Bard,Illaoi,150,75,75,50
Bard,Kennen,87,58,29,66.67
Bard,Nidalee,100,58,42,58
Bard,Akshan,157,78,79,49.68
Bard,Khazix,155,97,58,62.58
Bard,Ryze,130,54,76,41.54
Bard,Kled,51,28,23,54.9
Kindred,Gwen,241,117,124,48.55
Kindred,Nocturne,674,330,344,48.96
Kindred,Veigar,550,278,272,50.55
Kindred,Jinx,1673,826,847,49.37
Kindred,Morgana,662,353,309,53.32
Kindred,Jayce,244,130,114,53.28
Kindred,Talon,306,158,148,51.63
Kindred,Kennen,128,57,71,44.53
Kindred,Lucian,325,150,175,46.15
Kindred,Elise,383,191,192,49.87
Kindred,Kayn,876,445,431,50.8
Kindred,Rammus,150,80,70,53.33
Kindred,Xerath,403,163,240,40.45
Kindred,Vayne,633,286,347,45.18
Kindred,Nami,558,278,280,49.82
Kindred,Kayle,413,184,229,44.55
Kindred,Nasus,355,154,201,43.38
Kindred,Anivia,142,77,65,54.23
Kindred,KogMaw,158,77,81,48.73
Kindred,Sett,768,361,407,47.01
Kindred,Shaco,540,253,287,46.85
Kindred,Ziggs,182,104,78,57.14
Kindred,Kaisa,934,470,464,50.32
Kindred,MissFortune,1210,612,598,50.58
Kindred,Swain,593,301,292,50.76
Kindred,Irelia,455,216,239,47.47
Kindred,Heimerdinger,236,119,117,50.42
Kindred,Lux,1342,661,681,49.25
Kindred,Shen,333,150,183,45.05
Kindred,Udyr,231,113,118,48.92
Kindred,Xayah,201,108,93,53.73
Kindred,Pantheon,785,372,413,47.39
Kindred,Singed,142,67,75,47.18
Kindred,Graves,381,167,214,43.83
Kindred,Viktor,396,212,184,53.54
Kindred,Senna,424,225,199,53.07
Kindred,Ryze,186,78,108,41.94
Kindred,Khazix,252,140,112,55.56
Kindred,Yasuo,932,433,499,46.46
Kindred,Ekko,494,273,221,55.26
Kindred,Sylas,732,386,346,52.73
Kindred,Blitzcrank,414,234,180,56.52
Kindred,Malphite,537,237,300,44.13
Kindred,Briar,338,120,218,35.5
Kindred,Diana,869,437,432,50.29
Kindred,Ezreal,1208,624,584,51.66
Kindred,Maokai,248,130,118,52.42
Kindred,Vladimir,362,178,184,49.17
Kindred,Viego,794,365,429,45.97
Kindred,Aurora,385,224,161,58.18
Kindred,Brand,410,173,237,42.2
Kindred,Caitlyn,1376,659,717,47.89
Kindred,Lulu,788,431,357,54.7
Kindred,MasterYi,609,280,329,45.98
Kindred,Mel,914,515,399,56.35
Kindred,Akali,497,226,271,45.47
Kindred,MonkeyKing,402,214,188,53.23
Kindred,Fizz,334,173,161,51.8
Kindred,Sona,166,84,82,50.6
Kindred,Gangplank,247,118,129,47.77
Kindred,Darius,1021,507,514,49.66
Kindred,TwistedFate,179,82,97,45.81
Kindred,Varus,440,238,202,54.09
Kindred,Zilean,156,64,92,41.03
Kindred,Mordekaiser,634,267,367,42.11
Kindred,Zed,550,302,248,54.91
Kindred,Pyke,425,190,235,44.71
Kindred,Gragas,303,182,121,60.07
Kindred,Warwick,750,368,382,49.07
Kindred,Yone,951,527,424,55.42
Kindred,Milio,308,129,179,41.88
Kindred,FiddleSticks,247,130,117,52.63
Kindred,Jax,499,277,222,55.51
Kindred,Ahri,690,358,332,51.88
Kindred,Ashe,1032,513,519,49.71
Kindred,Teemo,632,300,332,47.47
Kindred,TahmKench,378,175,203,46.3
Kindred,Orianna,225,136,89,60.44
Kindred,Nautilus,633,331,302,52.29
Kindred,Amumu,597,267,330,44.72
Kindred,Draven,258,141,117,54.65
Kindred,Leona,404,188,216,46.53
Kindred,Vi,459,232,227,50.54
Kindred,Thresh,735,363,372,49.39
Kindred,Ambessa,272,115,157,42.28
Kindred,Sejuani,197,94,103,47.72
Kindred,Tristana,490,256,234,52.24
Kindred,Tryndamere,342,180,162,52.63
Kindred,Qiyana,126,75,51,59.52
Kindred,Cassiopeia,153,73,80,47.71
Kindred,Illaoi,232,121,111,52.16
Kindred,Bard,136,100,36,73.53
Kindred,Jhin,1040,473,567,45.48
Kindred,Sivir,286,143,143,50
Kindred,LeeSin,791,397,394,50.19
Kindred,Janna,181,74,107,40.88
Kindred,Skarner,141,69,72,48.94
Kindred,Leblanc,345,171,174,49.57
Kindred,Garen,952,476,476,50
Kindred,Nunu,330,125,205,37.88
Kindred,Chogath,558,256,302,45.88
Kindred,Kalista,123,56,67,45.53
Kindred,Braum,273,116,157,42.49
Kindred,Volibear,578,322,256,55.71
Kindred,Malzahar,547,235,312,42.96
Kindred,XinZhao,326,156,170,47.85
Kindred,Aatrox,434,214,220,49.31
Kindred,Azir,188,92,96,48.94
Kindred,Rell,241,108,133,44.81
Kindred,JarvanIV,332,157,175,47.29
Kindred,Evelynn,177,90,87,50.85
Kindred,Hwei,326,156,170,47.85
Kindred,Yorick,527,250,277,47.44
Kindred,Olaf,120,72,48,60
Kindred,Galio,510,251,259,49.22
Kindred,Akshan,180,95,85,52.78
Kindred,Velkoz,302,150,152,49.67
Kindred,Katarina,362,196,166,54.14
Kindred,Renekton,215,103,112,47.91
Kindred,Rumble,150,88,62,58.67
Kindred,KSante,292,178,114,60.96
Kindred,Annie,161,91,70,56.52
Kindred,Urgot,249,128,121,51.41
Kindred,Twitch,438,216,222,49.32
Kindred,Sion,405,193,212,47.65
Kindred,Taliyah,146,52,94,35.62
Kindred,DrMundo,298,119,179,39.93
Kindred,Lillia,289,144,145,49.83
Kindred,Camille,174,90,84,51.72
Kindred,Neeko,240,123,117,51.25
Kindred,Seraphine,375,174,201,46.4
Kindred,Syndra,319,145,174,45.45
Kindred,Karthus,174,78,96,44.83
Kindred,Karma,618,298,320,48.22
Kindred,Soraka,294,134,160,45.58
Kindred,Poppy,327,180,147,55.05
Kindred,Trundle,334,161,173,48.2
Kindred,Naafiri,173,97,76,56.07
Kindred,Gnar,185,96,89,51.89
Kindred,Quinn,190,99,91,52.11
Kindred,Smolder,266,147,119,55.26
Kindred,Rengar,175,116,59,66.29
Kindred,RekSai,67,42,25,62.69
Kindred,Rakan,180,87,93,48.33
Kindred,Belveth,131,65,66,49.62
Kindred,Aphelios,295,138,157,46.78
Kindred,Ornn,227,102,125,44.93
Kindred,Zeri,207,131,76,63.29
Kindred,AurelionSol,176,90,86,51.14
Kindred,Hecarim,262,126,136,48.09
Kindred,Kassadin,104,63,41,60.58
Kindred,Fiora,171,98,73,57.31
Kindred,Nilah,150,62,88,41.33
Kindred,Riven,260,121,139,46.54
Kindred,Alistar,205,80,125,39.02
Kindred,Vex,278,139,139,50
Kindred,Zyra,467,240,227,51.39
Kindred,Renata,88,52,36,59.09
Kindred,Lissandra,148,68,80,45.95
Kindred,Corki,234,121,113,51.71
Kindred,Ivern,97,47,50,48.45
Kindred,Yuumi,379,188,191,49.6
Kindred,Taric,63,19,44,30.16
Kindred,Samira,346,162,184,46.82
Kindred,Shyvana,130,70,60,53.85
Kindred,Zoe,166,87,79,52.41
Kindred,Kled,96,43,53,44.79
Kindred,Zac,253,126,127,49.8
Kindred,Nidalee,163,90,73,55.21
Neeko,Gwen,270,122,148,45.19
Neeko,Nocturne,620,280,340,45.16
Neeko,Veigar,554,258,296,46.57
Neeko,Jinx,1489,721,768,48.42
Neeko,Morgana,716,415,301,57.96
Neeko,Malzahar,506,217,289,42.89
Neeko,Sejuani,172,85,87,49.42
Neeko,Jayce,286,183,103,63.99
Neeko,Jhin,1038,496,542,47.78
Neeko,Thresh,657,338,319,51.45
Neeko,Riven,228,109,119,47.81
Neeko,Nilah,181,75,106,41.44
Neeko,Lissandra,254,121,133,47.64
Neeko,Teemo,814,375,439,46.07
Neeko,Pantheon,816,433,383,53.06
Neeko,Orianna,209,93,116,44.5
Neeko,Tristana,568,322,246,56.69
Neeko,Lux,1607,750,857,46.67
Neeko,Mordekaiser,707,358,349,50.64
Neeko,LeeSin,716,393,323,54.89
Neeko,Zed,534,295,239,55.24
Neeko,Ezreal,1264,647,617,51.19
Neeko,Lulu,619,298,321,48.14
Neeko,MonkeyKing,348,157,191,45.11
Neeko,Yasuo,951,468,483,49.21
Neeko,Yorick,536,252,284,47.01
Neeko,Warwick,777,359,418,46.2
Neeko,Hwei,352,169,183,48.01
Neeko,Caitlyn,1444,754,690,52.22
Neeko,Seraphine,507,237,270,46.75
Neeko,Vladimir,327,150,177,45.87
Neeko,TwistedFate,172,76,96,44.19
Neeko,Xayah,223,108,115,48.43
Neeko,Trundle,308,156,152,50.65
Neeko,Ekko,479,250,229,52.19
Neeko,Syndra,320,170,150,53.13
Neeko,Camille,172,83,89,48.26
Neeko,Belveth,75,37,38,49.33
Neeko,Smolder,253,118,135,46.64
Neeko,Zyra,583,272,311,46.66
Neeko,Garen,804,389,415,48.38
Neeko,Briar,358,185,173,51.68
Neeko,Akali,630,312,318,49.52
Neeko,MissFortune,1503,703,800,46.77
Neeko,TahmKench,390,184,206,47.18
Neeko,Sett,817,391,426,47.86
Neeko,Shaco,508,264,244,51.97
Neeko,Irelia,503,228,275,45.33
Neeko,Karma,584,319,265,54.62
Neeko,RekSai,62,31,31,50
Neeko,Darius,1037,469,568,45.23
Neeko,Draven,268,150,118,55.97
Neeko,Swain,533,235,298,44.09
Neeko,Malphite,550,269,281,48.91
Neeko,Tryndamere,322,173,149,53.73
Neeko,Udyr,210,89,121,42.38
Neeko,Poppy,297,135,162,45.45
Neeko,Khazix,250,130,120,52
Neeko,Zilean,150,58,92,38.67
Neeko,Ahri,702,337,365,48.01
Neeko,Rengar,156,89,67,57.05
Neeko,Ryze,136,71,65,52.21
Neeko,Ashe,1170,562,608,48.03
Neeko,Milio,264,112,152,42.42
Neeko,Yone,1066,564,502,52.91
Neeko,Nidalee,208,96,112,46.15
Neeko,MasterYi,739,355,384,48.04
Neeko,Naafiri,174,81,93,46.55
Neeko,Nautilus,562,289,273,51.42
Neeko,Volibear,625,295,330,47.2
Neeko,Leona,454,238,216,52.42
Neeko,Brand,502,245,257,48.8
Neeko,Shen,352,192,160,54.55
Neeko,Amumu,609,296,313,48.6
Neeko,Kalista,121,54,67,44.63
Neeko,Soraka,269,118,151,43.87
Neeko,Sion,350,159,191,45.43
Neeko,Corki,212,106,106,50
Neeko,Pyke,426,218,208,51.17
Neeko,Rell,259,124,135,47.88
Neeko,Gnar,204,110,94,53.92
Neeko,Jax,542,262,280,48.34
Neeko,Viego,869,441,428,50.75
Neeko,Kassadin,112,65,47,58.04
Neeko,Blitzcrank,375,176,199,46.93
Neeko,Taliyah,118,57,61,48.31
Neeko,Renekton,256,147,109,57.42
Neeko,Velkoz,299,125,174,41.81
Neeko,Rammus,180,80,100,44.44
Neeko,Vayne,672,319,353,47.47
Neeko,Kled,82,41,41,50
Neeko,Nasus,368,140,228,38.04
Neeko,Kayn,715,339,376,47.41
Neeko,Leblanc,307,152,155,49.51
Neeko,Zac,194,74,120,38.14
Neeko,Maokai,289,145,144,50.17
Neeko,Vex,321,152,169,47.35
Neeko,Gangplank,265,151,114,56.98
Neeko,Varus,464,225,239,48.49
Neeko,Janna,188,88,100,46.81
Neeko,Aurora,417,223,194,53.48
Neeko,Diana,880,429,451,48.75
Neeko,Hecarim,224,100,124,44.64
Neeko,Aphelios,225,125,100,55.56
Neeko,Yuumi,376,184,192,48.94
Neeko,Kayle,320,141,179,44.06
Neeko,Kaisa,804,411,393,51.12
Neeko,Vi,494,284,210,57.49
Neeko,AurelionSol,204,80,124,39.22
Neeko,Fiora,153,85,68,55.56
Neeko,Sylas,805,386,419,47.95
Neeko,Anivia,163,77,86,47.24
Neeko,Alistar,201,113,88,56.22
Neeko,Urgot,270,106,164,39.26
Neeko,Fizz,347,159,188,45.82
Neeko,Rakan,211,123,88,58.29
Neeko,Bard,133,58,75,43.61
Neeko,Chogath,608,292,316,48.03
Neeko,Mel,1082,550,532,50.83
Neeko,Kennen,168,60,108,35.71
Neeko,DrMundo,299,153,146,51.17
Neeko,Karthus,172,68,104,39.53
Neeko,Senna,393,184,209,46.82
Neeko,Nunu,361,193,168,53.46
Neeko,Zoe,201,86,115,42.79
Neeko,Katarina,383,181,202,47.26
Neeko,Ornn,196,84,112,42.86
Neeko,Galio,488,227,261,46.52
Neeko,Sivir,273,108,165,39.56
Neeko,Gragas,253,148,105,58.5
Neeko,Aatrox,404,186,218,46.04
Neeko,Viktor,444,223,221,50.23
Neeko,Braum,256,117,139,45.7
Neeko,KogMaw,151,72,79,47.68
Neeko,Kindred,240,117,123,48.75
Neeko,Ziggs,134,58,76,43.28
Neeko,Shyvana,120,62,58,51.67
Neeko,FiddleSticks,254,117,137,46.06
Neeko,Evelynn,178,81,97,45.51
Neeko,Nami,497,228,269,45.88
Neeko,Heimerdinger,325,157,168,48.31
Neeko,JarvanIV,216,106,110,49.07
Neeko,Twitch,393,186,207,47.33
Neeko,Ambessa,353,191,162,54.11
Neeko,Elise,362,177,185,48.9
Neeko,Xerath,505,213,292,42.18
Neeko,Qiyana,97,60,37,61.86
Neeko,Talon,314,122,192,38.85
Neeko,Samira,408,234,174,57.35
Neeko,Quinn,172,90,82,52.33
Neeko,Singed,151,79,72,52.32
Neeko,KSante,307,133,174,43.32
Neeko,Rumble,113,76,37,67.26
Neeko,Ivern,70,32,38,45.71
Neeko,Akshan,189,99,90,52.38
Neeko,Sona,175,102,73,58.29
Neeko,Lucian,344,168,176,48.84
Neeko,Annie,161,72,89,44.72
Neeko,Graves,295,164,131,55.59
Neeko,Lillia,302,133,169,44.04
Neeko,Cassiopeia,155,72,83,46.45
Neeko,Olaf,141,84,57,59.57
Neeko,Illaoi,258,98,160,37.98
Neeko,Renata,97,58,39,59.79
Neeko,Zeri,188,93,95,49.47
Neeko,Skarner,147,76,71,51.7
Neeko,Azir,126,60,66,47.62
Neeko,XinZhao,334,168,166,50.3
Neeko,Taric,81,44,37,54.32
Twitch,Darius,1852,936,916,50.54
Twitch,Khazix,495,259,236,52.32
Twitch,Zed,1138,620,518,54.48
Twitch,Aphelios,475,245,230,51.58
Twitch,Pyke,653,329,324,50.38
Twitch,Volibear,1163,582,581,50.04
Twitch,Lux,2497,1172,1325,46.94
Twitch,Ezreal,1959,1014,945,51.76
Twitch,Velkoz,590,286,304,48.47
Twitch,Jax,811,413,398,50.92
Twitch,Warwick,1550,768,782,49.55
Twitch,Galio,800,413,387,51.63
Twitch,Nami,1141,561,580,49.17
Twitch,Mordekaiser,1299,588,711,45.27
Twitch,Talon,535,288,247,53.83
Twitch,Yasuo,1845,866,979,46.94
Twitch,Caitlyn,2720,1259,1461,46.29
Twitch,Alistar,350,202,148,57.71
Twitch,Sett,1491,672,819,45.07
Twitch,Rengar,352,159,193,45.17
Twitch,Aurora,685,336,349,49.05
Twitch,Bard,336,162,174,48.21
Twitch,Malphite,998,457,541,45.79
Twitch,Shaco,981,477,504,48.62
Twitch,Pantheon,1461,722,739,49.42
Twitch,Jinx,3642,1855,1787,50.93
Twitch,Lulu,1353,701,652,51.81
Twitch,Garen,1529,751,778,49.12
Twitch,MasterYi,1264,642,622,50.79
Twitch,Sylas,1138,617,521,54.22
Twitch,Mel,1956,968,988,49.49
Twitch,Zilean,352,139,213,39.49
Twitch,JarvanIV,595,229,366,38.49
Twitch,Lucian,639,309,330,48.36
Twitch,Lillia,530,257,273,48.49
Twitch,Tristana,1083,516,567,47.65
Twitch,Smolder,627,347,280,55.34
Twitch,Teemo,1198,576,622,48.08
Twitch,Brand,731,352,379,48.15
Twitch,Sona,307,174,133,56.68
Twitch,Akali,873,403,470,46.16
Twitch,Viktor,855,434,421,50.76
Twitch,Leona,715,366,349,51.19
Twitch,Heimerdinger,404,194,210,48.02
Twitch,Amumu,1086,487,599,44.84
Twitch,Kayle,753,342,411,45.42
Twitch,RekSai,107,53,54,49.53
Twitch,Vladimir,660,351,309,53.18
Twitch,Draven,541,266,275,49.17
Twitch,Swain,945,465,480,49.21
Twitch,TahmKench,761,363,398,47.7
Twitch,Morgana,1119,590,529,52.73
Twitch,KogMaw,415,221,194,53.25
Twitch,Ekko,929,447,482,48.12
Twitch,Kaisa,1447,777,670,53.7
Twitch,Rell,477,190,287,39.83
Twitch,DrMundo,554,249,305,44.95
Twitch,MissFortune,2253,1073,1180,47.63
Twitch,Karma,1084,576,508,53.14
Twitch,Quinn,364,191,173,52.47
Twitch,Elise,616,319,297,51.79
Twitch,Ryze,363,187,176,51.52
Twitch,Taliyah,245,111,134,45.31
Twitch,Katarina,748,348,400,46.52
Twitch,Sejuani,332,169,163,50.9
Twitch,Shyvana,257,139,118,54.09
Twitch,Renekton,509,263,246,51.67
Twitch,FiddleSticks,528,277,251,52.46
Twitch,Seraphine,764,376,388,49.21
Twitch,Ambessa,558,319,239,57.17
Twitch,Veigar,938,511,427,54.48
Twitch,Yorick,975,493,482,50.56
Twitch,Vex,493,265,228,53.75
Twitch,Shen,573,268,305,46.77
Twitch,Vi,829,381,448,45.96
Twitch,Leblanc,511,251,260,49.12
Twitch,MonkeyKing,716,321,395,44.83
Twitch,Malzahar,1074,525,549,48.88
Twitch,Jhin,1944,935,1009,48.1
Twitch,Urgot,599,289,310,48.25
Twitch,Graves,571,257,314,45.01
Twitch,Singed,286,134,152,46.85
Twitch,Samira,652,296,356,45.4
Twitch,LeeSin,1173,593,580,50.55
Twitch,Braum,516,234,282,45.35
Twitch,Fiora,369,214,155,57.99
Twitch,Naafiri,319,133,186,41.69
Twitch,AurelionSol,356,158,198,44.38
Twitch,Gnar,372,208,164,55.91
Twitch,Vayne,1389,683,706,49.17
Twitch,Maokai,419,192,227,45.82
Twitch,Ashe,1903,968,935,50.87
Twitch,Blitzcrank,629,298,331,47.38
Twitch,Poppy,520,255,265,49.04
Twitch,Nocturne,1248,575,673,46.07
Twitch,Fizz,632,297,335,46.99
Twitch,Soraka,583,280,303,48.03
Twitch,Gragas,553,270,283,48.82
Twitch,Varus,862,442,420,51.28
Twitch,Rammus,295,151,144,51.19
Twitch,Kled,170,75,95,44.12
Twitch,Illaoi,400,192,208,48
Twitch,Zyra,890,423,467,47.53
Twitch,Sion,744,357,387,47.98
Twitch,Zac,390,202,188,51.79
Twitch,Nasus,600,281,319,46.83
Twitch,Annie,279,133,146,47.67
Twitch,Karthus,285,168,117,58.95
Twitch,Sivir,431,200,231,46.4
Twitch,Yuumi,781,363,418,46.48
Twitch,Yone,1577,821,756,52.06
Twitch,Milio,680,347,333,51.03
Twitch,Diana,1583,798,785,50.41
Twitch,Irelia,724,346,378,47.79
Twitch,Viego,1228,617,611,50.24
Twitch,Hecarim,391,201,190,51.41
Twitch,Nautilus,943,481,462,51.01
Twitch,Orianna,426,212,214,49.77
Twitch,Ivern,115,61,54,53.04
Twitch,Kassadin,228,123,105,53.95
Twitch,Taric,242,89,153,36.78
Twitch,Corki,464,256,208,55.17
Twitch,Thresh,1172,577,595,49.23
Twitch,Kayn,1501,690,811,45.97
Twitch,Nunu,523,242,281,46.27
Twitch,Ziggs,326,187,139,57.36
Twitch,Qiyana,236,137,99,58.05
Twitch,Jayce,290,164,126,56.55
Twitch,Ornn,414,205,209,49.52
Twitch,Zoe,377,175,202,46.42
Twitch,Syndra,716,333,383,46.51
Twitch,Senna,736,380,356,51.63
Twitch,TwistedFate,372,190,182,51.08
Twitch,Gangplank,460,237,223,51.52
Twitch,KSante,449,240,209,53.45
Twitch,Briar,713,390,323,54.7
Twitch,Evelynn,366,208,158,56.83
Twitch,Ahri,1189,568,621,47.77
Twitch,Nilah,346,162,184,46.82
Twitch,Olaf,193,103,90,53.37
Twitch,Kennen,296,145,151,48.99
Twitch,Aatrox,797,382,415,47.93
Twitch,Renata,185,77,108,41.62
Twitch,Riven,465,230,235,49.46
Twitch,Camille,394,205,189,52.03
Twitch,Azir,351,205,146,58.4
Twitch,Gwen,479,230,249,48.02
Twitch,Tryndamere,521,255,266,48.94
Twitch,Anivia,302,161,141,53.31
Twitch,Janna,370,172,198,46.49
Twitch,Trundle,574,255,319,44.43
Twitch,Hwei,597,315,282,52.76
Twitch,XinZhao,561,267,294,47.59
Twitch,Rumble,220,101,119,45.91
Twitch,Skarner,232,132,100,56.9
Twitch,Kindred,438,222,216,50.68
Twitch,Xerath,760,386,374,50.79
Twitch,Lissandra,337,161,176,47.77
Twitch,Rakan,343,155,188,45.19
Twitch,Neeko,393,207,186,52.67
Twitch,Cassiopeia,311,128,183,41.16
Twitch,Xayah,412,200,212,48.54
Twitch,Chogath,1202,561,641,46.67
Twitch,Zeri,333,182,151,54.65
Twitch,Kalista,185,98,87,52.97
Twitch,Akshan,333,161,172,48.35
Twitch,Belveth,181,117,64,64.64
Twitch,Udyr,452,187,265,41.37
Twitch,Nidalee,209,112,97,53.59
Aphelios,Trundle,307,132,175,43
Aphelios,Malphite,667,305,362,45.73
Aphelios,Hwei,491,254,237,51.73
Aphelios,Twitch,475,230,245,48.42
Aphelios,Milio,422,207,215,49.05
Aphelios,Yorick,629,306,323,48.65
Aphelios,JarvanIV,342,160,182,46.78
Aphelios,Mel,1249,642,607,51.4
Aphelios,Jinx,2232,1070,1162,47.94
Aphelios,Lux,1452,645,807,44.42
Aphelios,Sett,857,381,476,44.46
Aphelios,Evelynn,256,139,117,54.3
Aphelios,Vex,296,127,169,42.91
Aphelios,MissFortune,1288,632,656,49.07
Aphelios,Xerath,523,258,265,49.33
Aphelios,Gangplank,323,186,137,57.59
Aphelios,Qiyana,182,99,83,54.4
Aphelios,Olaf,150,81,69,54
Aphelios,Pantheon,932,478,454,51.29
Aphelios,Leblanc,375,169,206,45.07
Aphelios,Karma,746,322,424,43.16
Aphelios,Udyr,199,86,113,43.22
Aphelios,Malzahar,698,351,347,50.29
Aphelios,Jhin,1311,637,674,48.59
Aphelios,Morgana,720,381,339,52.92
Aphelios,Rammus,176,88,88,50
Aphelios,Zed,606,341,265,56.27
Aphelios,Sylas,763,426,337,55.83
Aphelios,Tristana,593,284,309,47.89
Aphelios,Swain,569,254,315,44.64
Aphelios,Volibear,708,368,340,51.98
Aphelios,Yasuo,1196,576,620,48.16
Aphelios,Ashe,1160,569,591,49.05
Aphelios,Lulu,946,485,461,51.27
Aphelios,Gnar,212,120,92,56.6
Aphelios,Nidalee,178,107,71,60.11
Aphelios,Draven,327,165,162,50.46
Aphelios,Ornn,293,149,144,50.85
Aphelios,Nocturne,775,363,412,46.84
Aphelios,Seraphine,432,211,221,48.84
Aphelios,Ryze,173,98,75,56.65
Aphelios,Mordekaiser,816,436,380,53.43
Aphelios,Soraka,375,164,211,43.73
Aphelios,Gwen,343,160,183,46.65
Aphelios,Varus,558,269,289,48.21
Aphelios,Vladimir,434,229,205,52.76
Aphelios,Ezreal,1499,731,768,48.77
Aphelios,Braum,383,191,192,49.87
Aphelios,Fiora,248,134,114,54.03
Aphelios,Amumu,644,336,308,52.17
Aphelios,Talon,357,186,171,52.1
Aphelios,MasterYi,686,346,340,50.44
Aphelios,Garen,992,503,489,50.71
Aphelios,Quinn,206,105,101,50.97
Aphelios,Shaco,565,284,281,50.27
Aphelios,Lissandra,213,97,116,45.54
Aphelios,Chogath,723,323,400,44.67
Aphelios,Teemo,736,323,413,43.89
Aphelios,Aatrox,541,290,251,53.6
Aphelios,Lillia,368,186,182,50.54
Aphelios,Irelia,548,265,283,48.36
Aphelios,Sejuani,237,129,108,54.43
Aphelios,Caitlyn,1822,942,880,51.7
Aphelios,Brand,437,234,203,53.55
Aphelios,Zilean,205,107,98,52.2
Aphelios,Kayle,447,172,275,38.48
Aphelios,LeeSin,908,470,438,51.76
Aphelios,Akali,565,294,271,52.04
Aphelios,Kaisa,1031,514,517,49.85
Aphelios,Ekko,626,341,285,54.47
Aphelios,Tryndamere,310,159,151,51.29
Aphelios,Nunu,265,130,135,49.06
Aphelios,Aurora,428,213,215,49.77
Aphelios,Viego,838,423,415,50.48
Aphelios,Cassiopeia,201,108,93,53.73
Aphelios,Blitzcrank,464,214,250,46.12
Aphelios,Poppy,380,202,178,53.16
Aphelios,Shyvana,136,74,62,54.41
Aphelios,Jax,561,243,318,43.32
Aphelios,Viktor,541,258,283,47.69
Aphelios,Sivir,310,137,173,44.19
Aphelios,Velkoz,377,173,204,45.89
Aphelios,Warwick,853,407,446,47.71
Aphelios,Syndra,430,205,225,47.67
Aphelios,Galio,482,256,226,53.11
Aphelios,Yone,1079,579,500,53.66
Aphelios,Nautilus,667,350,317,52.47
Aphelios,Taliyah,183,81,102,44.26
Aphelios,Maokai,261,127,134,48.66
Aphelios,Zyra,609,299,310,49.1
Aphelios,Neeko,225,100,125,44.44
Aphelios,Ahri,794,383,411,48.24
Aphelios,Khazix,365,207,158,56.71
Aphelios,Diana,1062,535,527,50.38
Aphelios,Rakan,262,126,136,48.09
Aphelios,Sona,177,97,80,54.8
Aphelios,KSante,332,160,172,48.19
Aphelios,Lucian,362,203,159,56.08
Aphelios,Vayne,778,410,368,52.7
Aphelios,Naafiri,173,97,76,56.07
Aphelios,Kassadin,107,66,41,61.68
Aphelios,Senna,488,241,247,49.39
Aphelios,Shen,383,168,215,43.86
Aphelios,Kayn,887,422,465,47.58
Aphelios,Veigar,605,265,340,43.8
Aphelios,Rell,345,176,169,51.01
Aphelios,Graves,391,188,203,48.08
Aphelios,Corki,261,142,119,54.41
Aphelios,Darius,1181,563,618,47.67
Aphelios,Elise,413,226,187,54.72
Aphelios,Yuumi,556,299,257,53.78
Aphelios,Katarina,512,254,258,49.61
Aphelios,KogMaw,163,94,69,57.67
Aphelios,Ambessa,387,222,165,57.36
Aphelios,TwistedFate,214,92,122,42.99
Aphelios,Gragas,344,172,172,50
Aphelios,Taric,138,61,77,44.2
Aphelios,Illaoi,281,172,109,61.21
Aphelios,Nasus,427,210,217,49.18
Aphelios,Karthus,191,103,88,53.93
Aphelios,Azir,217,123,94,56.68
Aphelios,Alistar,202,99,103,49.01
Aphelios,Nami,672,323,349,48.07
Aphelios,Anivia,234,125,109,53.42
Aphelios,Smolder,385,219,166,56.88
Aphelios,Kled,120,60,60,50
Aphelios,Thresh,885,444,441,50.17
Aphelios,Bard,178,79,99,44.38
Aphelios,Ziggs,179,74,105,41.34
Aphelios,TahmKench,438,244,194,55.71
Aphelios,Kalista,153,85,68,55.56
Aphelios,XinZhao,412,233,179,56.55
Aphelios,Samira,355,170,185,47.89
Aphelios,Riven,326,185,141,56.75
Aphelios,Heimerdinger,248,108,140,43.55
Aphelios,Camille,196,102,94,52.04
Aphelios,Annie,188,98,90,52.13
Aphelios,Pyke,460,238,222,51.74
Aphelios,Vi,527,268,259,50.85
Aphelios,Orianna,287,128,159,44.6
Aphelios,Xayah,250,147,103,58.8
Aphelios,Briar,440,195,245,44.32
Aphelios,DrMundo,326,157,169,48.16
Aphelios,MonkeyKing,403,177,226,43.92
Aphelios,Belveth,120,56,64,46.67
Aphelios,Zac,307,153,154,49.84
Aphelios,Akshan,258,123,135,47.67
Aphelios,Hecarim,270,130,140,48.15
Aphelios,Singed,189,96,93,50.79
Aphelios,Kennen,154,88,66,57.14
Aphelios,Skarner,166,80,86,48.19
Aphelios,Kindred,295,157,138,53.22
Aphelios,Zoe,225,114,111,50.67
Aphelios,Nilah,227,113,114,49.78
Aphelios,Rengar,187,98,89,52.41
Aphelios,Janna,229,124,105,54.15
Aphelios,Rumble,159,69,90,43.4
Aphelios,Zeri,318,172,146,54.09
Aphelios,FiddleSticks,333,168,165,50.45
Aphelios,Leona,537,282,255,52.51
Aphelios,Fizz,316,173,143,54.75
Aphelios,AurelionSol,233,123,110,52.79
Aphelios,Sion,545,234,311,42.94
Aphelios,Urgot,324,153,171,47.22
Aphelios,Renekton,292,159,133,54.45
Aphelios,Ivern,90,31,59,34.44
Aphelios,RekSai,80,28,52,35
Aphelios,Jayce,276,120,156,43.48
Aphelios,Renata,108,70,38,64.81
Fizz,Azir,177,82,95,46.33
Fizz,Nocturne,898,429,469,47.77
Fizz,Syndra,523,274,249,52.39
Fizz,Jhin,1469,776,693,52.83
Fizz,Senna,560,301,259,53.75
Fizz,Malzahar,820,379,441,46.22
Fizz,Sejuani,305,144,161,47.21
Fizz,Jayce,275,111,164,40.36
Fizz,Thresh,901,446,455,49.5
Fizz,Singed,169,77,92,45.56
Fizz,Shaco,745,371,374,49.8
Fizz,Hwei,433,221,212,51.04
Fizz,Janna,208,104,104,50
Fizz,Fiora,233,117,116,50.21
Fizz,Warwick,1125,527,598,46.84
Fizz,Zed,979,493,486,50.36
Fizz,Swain,666,318,348,47.75
Fizz,Chogath,826,418,408,50.61
Fizz,Kayle,524,257,267,49.05
Fizz,Darius,1417,648,769,45.73
Fizz,Malphite,698,361,337,51.72
Fizz,Ezreal,1508,739,769,49.01
Fizz,Nami,716,320,396,44.69
Fizz,Sett,1053,482,571,45.77
Fizz,Evelynn,275,157,118,57.09
Fizz,Vex,363,185,178,50.96
Fizz,MissFortune,1910,877,1033,45.92
Fizz,Xerath,726,356,370,49.04
Fizz,Kennen,168,74,94,44.05
Fizz,Lux,2079,1058,1021,50.89
Fizz,Caitlyn,2024,967,1057,47.78
Fizz,Zyra,672,352,320,52.38
Fizz,Yone,1228,704,524,57.33
Fizz,Nunu,353,174,179,49.29
Fizz,Qiyana,145,78,67,53.79
Fizz,Jinx,1990,998,992,50.15
Fizz,Morgana,926,467,459,50.43
Fizz,Yorick,704,315,389,44.74
Fizz,Lillia,357,168,189,47.06
Fizz,Xayah,332,175,157,52.71
Fizz,Yuumi,491,249,242,50.71
Fizz,Mordekaiser,946,404,542,42.71
Fizz,Kayn,1082,538,544,49.72
Fizz,Aurora,434,217,217,50
Fizz,Varus,587,302,285,51.45
Fizz,Ekko,735,379,356,51.56
Fizz,Mel,1982,1053,929,53.13
Fizz,Trundle,420,222,198,52.86
Fizz,Graves,447,234,213,52.35
Fizz,Veigar,971,480,491,49.43
Fizz,LeeSin,814,421,393,51.72
Fizz,Nilah,201,94,107,46.77
Fizz,Braum,339,131,208,38.64
Fizz,Garen,1245,609,636,48.92
Fizz,Nidalee,180,103,77,57.22
Fizz,Vayne,1003,484,519,48.26
Fizz,Leblanc,404,202,202,50
Fizz,Pyke,523,279,244,53.35
Fizz,Vladimir,543,249,294,45.86
Fizz,Katarina,533,275,258,51.59
Fizz,Alistar,289,144,145,49.83
Fizz,Anivia,211,93,118,44.08
Fizz,Diana,1122,522,600,46.52
Fizz,AurelionSol,290,161,129,55.52
Fizz,Kaisa,1170,581,589,49.66
Fizz,Galio,652,309,343,47.39
Fizz,KSante,297,130,167,43.77
Fizz,Taliyah,134,57,77,42.54
Fizz,Sona,251,88,163,35.06
Fizz,TahmKench,540,252,288,46.67
Fizz,Kassadin,190,86,104,45.26
Fizz,Ambessa,403,221,182,54.84
Fizz,Briar,507,255,252,50.3
Fizz,Lucian,489,262,227,53.58
Fizz,Leona,662,311,351,46.98
Fizz,Heimerdinger,367,152,215,41.42
Fizz,Sylas,851,381,470,44.77
Fizz,Irelia,553,260,293,47.02
Fizz,Bard,208,125,83,60.1
Fizz,Gangplank,357,189,168,52.94
Fizz,Jax,706,386,320,54.67
Fizz,Velkoz,505,254,251,50.3
Fizz,MonkeyKing,499,235,264,47.09
Fizz,Akali,763,387,376,50.72
Fizz,Rengar,271,142,129,52.4
Fizz,Belveth,155,94,61,60.65
Fizz,Nasus,537,229,308,42.64
Fizz,Ziggs,297,146,151,49.16
Fizz,Brand,689,385,304,55.88
Fizz,Udyr,270,121,149,44.81
Fizz,Kled,135,60,75,44.44
Fizz,Volibear,818,371,447,45.35
Fizz,Kindred,334,161,173,48.2
Fizz,Poppy,400,178,222,44.5
Fizz,JarvanIV,446,241,205,54.04
Fizz,Gnar,274,153,121,55.84
Fizz,Twitch,632,335,297,53.01
Fizz,Yasuo,1415,669,746,47.28
Fizz,Rakan,212,91,121,42.92
Fizz,Gragas,341,163,178,47.8
Fizz,Teemo,957,476,481,49.74
Fizz,Soraka,351,173,178,49.29
Fizz,Riven,316,174,142,55.06
Fizz,Gwen,333,169,164,50.75
Fizz,Viego,1002,523,479,52.2
Fizz,KogMaw,220,116,104,52.73
Fizz,Blitzcrank,419,210,209,50.12
Fizz,Lulu,816,380,436,46.57
Fizz,Ahri,854,451,403,52.81
Fizz,Tristana,642,288,354,44.86
Fizz,Nautilus,785,393,392,50.06
Fizz,DrMundo,412,200,212,48.54
Fizz,Sion,486,228,258,46.91
Fizz,Annie,202,113,89,55.94
Fizz,Khazix,309,186,123,60.19
Fizz,Shen,487,225,262,46.2
Fizz,Maokai,278,146,132,52.52
Fizz,Taric,152,85,67,55.92
Fizz,Ornn,279,151,128,54.12
Fizz,Zoe,252,154,98,61.11
Fizz,FiddleSticks,362,153,209,42.27
Fizz,Draven,341,167,174,48.97
Fizz,Rammus,240,109,131,45.42
Fizz,Naafiri,212,100,112,47.17
Fizz,Ashe,1364,713,651,52.27
Fizz,Seraphine,587,279,308,47.53
Fizz,Sivir,272,124,148,45.59
Fizz,Aatrox,579,330,249,56.99
Fizz,Amumu,792,414,378,52.27
Fizz,Pantheon,1091,539,552,49.4
Fizz,Vi,633,347,286,54.82
Fizz,TwistedFate,261,140,121,53.64
Fizz,Ivern,68,48,20,70.59
Fizz,Camille,223,129,94,57.85
Fizz,Orianna,253,139,114,54.94
Fizz,Karma,789,369,420,46.77
Fizz,Urgot,402,221,181,54.98
Fizz,Zac,291,163,128,56.01
Fizz,Rumble,154,64,90,41.56
Fizz,Neeko,347,188,159,54.18
Fizz,Akshan,237,118,119,49.79
Fizz,Samira,472,237,235,50.21
Fizz,Milio,389,175,214,44.99
Fizz,Ryze,207,92,115,44.44
Fizz,Rell,279,143,136,51.25
Fizz,Tryndamere,506,255,251,50.4
Fizz,Lissandra,297,113,184,38.05
Fizz,MasterYi,986,433,553,43.91
Fizz,Illaoi,282,127,155,45.04
Fizz,Karthus,129,56,73,43.41
Fizz,Elise,481,243,238,50.52
Fizz,Renekton,375,180,195,48
Fizz,XinZhao,486,233,253,47.94
Fizz,RekSai,62,32,30,51.61
Fizz,Zeri,263,111,152,42.21
Fizz,Hecarim,269,133,136,49.44
Fizz,Viktor,529,272,257,51.42
Fizz,Smolder,462,240,222,51.95
Fizz,Talon,388,202,186,52.06
Fizz,Shyvana,166,74,92,44.58
Fizz,Corki,250,142,108,56.8
Fizz,Quinn,270,148,122,54.81
Fizz,Aphelios,316,143,173,45.25
Fizz,Skarner,123,85,38,69.11
Fizz,Olaf,137,62,75,45.26
Fizz,Kalista,152,62,90,40.79
Fizz,Cassiopeia,138,95,43,68.84
Fizz,Zilean,199,110,89,55.28
Fizz,Renata,100,42,58,42
Ivern,Azir,68,29,39,42.65
Ivern,Nocturne,218,104,114,47.71
Ivern,Syndra,117,48,69,41.03
Ivern,Jhin,337,155,182,45.99
Ivern,Senna,133,81,52,60.9
Ivern,Tryndamere,85,45,40,52.94
Ivern,Vi,156,89,67,57.05
Ivern,Malzahar,145,80,65,55.17
Ivern,Caitlyn,448,213,235,47.54
Ivern,Zyra,170,68,102,40
Ivern,Urgot,85,46,39,54.12
Ivern,Ryze,44,20,24,45.45
Ivern,MissFortune,334,141,193,42.22
Ivern,Thresh,207,90,117,43.48
Ivern,Riven,78,20,58,25.64
Ivern,Nunu,90,58,32,64.44
Ivern,Mel,275,131,144,47.64
Ivern,Nilah,54,24,30,44.44
Ivern,Zoe,55,31,24,56.36
Ivern,Kayn,216,95,121,43.98
Ivern,Ekko,135,85,50,62.96
Ivern,Pyke,130,60,70,46.15
Ivern,Poppy,89,35,54,39.33
Ivern,MasterYi,157,74,83,47.13
Ivern,Karthus,65,34,31,52.31
Ivern,Seraphine,119,51,68,42.86
Ivern,Darius,288,133,155,46.18
Ivern,Warwick,228,122,106,53.51
Ivern,Quinn,63,25,38,39.68
Ivern,Elise,161,85,76,52.8
Ivern,Taliyah,28,20,8,71.43
Ivern,Kennen,36,17,19,47.22
Ivern,XinZhao,58,21,37,36.21
Ivern,Zac,68,28,40,41.18
Ivern,Blitzcrank,90,30,60,33.33
Ivern,KSante,98,64,34,65.31
Ivern,Graves,146,80,66,54.79
Ivern,Leblanc,94,37,57,39.36
Ivern,Twitch,115,54,61,46.96
Ivern,Taric,39,28,11,71.79
Ivern,Teemo,202,91,111,45.05
Ivern,JarvanIV,120,70,50,58.33
Ivern,Lux,349,159,190,45.56
Ivern,Ezreal,440,206,234,46.82
Ivern,Sona,74,29,45,39.19
Ivern,Irelia,121,54,67,44.63
Ivern,Tristana,172,93,79,54.07
Ivern,Jinx,411,206,205,50.12
Ivern,Rakan,64,30,34,46.88
Ivern,Garen,301,142,159,47.18
Ivern,MonkeyKing,109,51,58,46.79
Ivern,Gangplank,72,41,31,56.94
Ivern,Nasus,116,62,54,53.45
Ivern,Lillia,70,30,40,42.86
Ivern,Yone,303,137,166,45.21
Ivern,LeeSin,222,120,102,54.05
Ivern,Kaisa,257,156,101,60.7
Ivern,Lulu,284,151,133,53.17
Ivern,Viktor,126,67,59,53.17
Ivern,Singed,63,49,14,77.78
Ivern,Fizz,68,20,48,29.41
Ivern,Zeri,69,27,42,39.13
Ivern,Khazix,79,40,39,50.63
Ivern,Swain,147,69,78,46.94
Ivern,Rengar,71,44,27,61.97
Ivern,Akshan,60,30,30,50
Ivern,Vayne,207,128,79,61.84
Ivern,Leona,133,75,58,56.39
Ivern,Sett,213,115,98,53.99
Ivern,Viego,266,130,136,48.87
Ivern,Sylas,224,126,98,56.25
Ivern,Shaco,129,61,68,47.29
Ivern,TwistedFate,50,32,18,64
Ivern,Mordekaiser,181,88,93,48.62
Ivern,Diana,242,99,143,40.91
Ivern,Veigar,116,46,70,39.66
Ivern,Ashe,294,148,146,50.34
Ivern,Bard,78,45,33,57.69
Ivern,Sion,113,61,52,53.98
Ivern,Morgana,151,92,59,60.93
Ivern,Vladimir,91,65,26,71.43
Ivern,Briar,85,33,52,38.82
Ivern,Chogath,192,106,86,55.21
Ivern,Xayah,88,50,38,56.82
Ivern,Jayce,86,56,30,65.12
Ivern,Yasuo,314,153,161,48.73
Ivern,Udyr,58,36,22,62.07
Ivern,Pantheon,211,100,111,47.39
Ivern,AurelionSol,68,25,43,36.76
Ivern,Milio,127,60,67,47.24
Ivern,Zed,221,103,118,46.61
Ivern,Camille,67,26,41,38.81
Ivern,Sivir,93,40,53,43.01
Ivern,Xerath,148,72,76,48.65
Ivern,Katarina,143,70,73,48.95
Ivern,Shen,110,55,55,50
Ivern,Heimerdinger,50,28,22,56
Ivern,Shyvana,30,15,15,50
Ivern,Vex,77,33,44,42.86
Ivern,Illaoi,41,23,18,56.1
Ivern,Annie,62,31,31,50
Ivern,Alistar,90,41,49,45.56
Ivern,Malphite,130,78,52,60
Ivern,Gwen,123,60,63,48.78
Ivern,Hwei,102,48,54,47.06
Ivern,Nami,221,115,106,52.04
Ivern,Aatrox,125,48,77,38.4
Ivern,Varus,127,66,61,51.97
Ivern,Karma,200,103,97,51.5
Ivern,Lissandra,39,23,16,58.97
Ivern,Nidalee,43,26,17,60.47
Ivern,Smolder,115,39,76,33.91
Ivern,Anivia,63,30,33,47.62
Ivern,Volibear,223,120,103,53.81
Ivern,Corki,80,43,37,53.75
Ivern,Nautilus,146,72,74,49.32
Ivern,Janna,57,39,18,68.42
Ivern,Yuumi,147,85,62,57.82
Ivern,Akali,160,83,77,51.88
Ivern,TahmKench,92,33,59,35.87
Ivern,Jax,152,84,68,55.26
Ivern,Amumu,132,61,71,46.21
Ivern,Orianna,89,45,44,50.56
Ivern,Ambessa,115,58,57,50.43
Ivern,Skarner,44,22,22,50
Ivern,Samira,102,56,46,54.9
Ivern,Rell,83,44,39,53.01
Ivern,Brand,93,47,46,50.54
Ivern,Neeko,70,38,32,54.29
Ivern,Naafiri,66,32,34,48.48
Ivern,Kayle,108,49,59,45.37
Ivern,Draven,74,40,34,54.05
Ivern,Rumble,39,17,22,43.59
Ivern,Galio,106,40,66,37.74
Ivern,Lucian,86,41,45,47.67
Ivern,Ahri,206,117,89,56.8
Ivern,Gragas,78,34,44,43.59
Ivern,Hecarim,76,33,43,43.42
Ivern,KogMaw,57,14,43,24.56
Ivern,Cassiopeia,41,20,21,48.78
Ivern,Fiora,50,25,25,50
Ivern,Ziggs,56,37,19,66.07
Ivern,Soraka,78,50,28,64.1
Ivern,Trundle,99,45,54,45.45
Ivern,Sejuani,55,27,28,49.09
Ivern,Velkoz,79,28,51,35.44
Ivern,Kassadin,46,25,21,54.35
Ivern,Olaf,38,15,23,39.47
Ivern,Kindred,97,50,47,51.55
Ivern,Aphelios,90,59,31,65.56
Ivern,Braum,85,35,50,41.18
Ivern,Yorick,113,40,73,35.4
Ivern,Talon,86,41,45,47.67
Ivern,DrMundo,86,42,44,48.84
Ivern,Rammus,35,15,20,42.86
Ivern,Gnar,60,21,39,35
Ivern,Kalista,34,27,7,79.41
Ivern,Renekton,78,49,29,62.82
Ivern,Qiyana,30,11,19,36.67
Ivern,Evelynn,69,33,36,47.83
Ivern,FiddleSticks,66,39,27,59.09
Ivern,Aurora,101,56,45,55.45
Ivern,Belveth,17,7,10,41.18
Ivern,Ornn,63,28,35,44.44
Ivern,Renata,39,24,15,61.54
Ivern,Maokai,85,34,51,40
Ivern,Kled,40,16,24,40
Ivern,RekSai,7,5,2,71.43
Ivern,Zilean,32,11,21,34.38
Leblanc,Urgot,305,130,175,42.62
Leblanc,Briar,505,212,293,41.98
Leblanc,Ahri,1100,549,551,49.91
Leblanc,Caitlyn,2025,1050,975,51.85
Leblanc,Lux,1913,936,977,48.93
Leblanc,Teemo,884,454,430,51.36
Leblanc,Yasuo,1328,627,701,47.21
Leblanc,MissFortune,1634,761,873,46.57
Leblanc,Blitzcrank,632,303,329,47.94
Leblanc,Lillia,415,241,174,58.07
Leblanc,Diana,1287,604,683,46.93
Leblanc,Aphelios,375,206,169,54.93
Leblanc,Leona,590,276,314,46.78
Leblanc,Jax,790,421,369,53.29
Leblanc,Fizz,404,202,202,50
Leblanc,Aurora,561,276,285,49.2
Leblanc,Thresh,1074,543,531,50.56
Leblanc,Akali,834,424,410,50.84
Leblanc,Talon,519,256,263,49.33
Leblanc,Vayne,841,385,456,45.78
Leblanc,Zilean,195,91,104,46.67
Leblanc,Gangplank,373,194,179,52.01
Leblanc,Hecarim,293,169,124,57.68
Leblanc,Lucian,495,250,245,50.51
Leblanc,TahmKench,404,205,199,50.74
Leblanc,MasterYi,774,359,415,46.38
Leblanc,Morgana,802,403,399,50.25
Leblanc,KogMaw,214,97,117,45.33
Leblanc,Mordekaiser,844,373,471,44.19
Leblanc,Draven,341,161,180,47.21
Leblanc,Gnar,312,174,138,55.77
Leblanc,Skarner,205,115,90,56.1
Leblanc,Tristana,629,329,300,52.31
Leblanc,Sylas,1176,584,592,49.66
Leblanc,Warwick,901,411,490,45.62
Leblanc,Xerath,831,441,390,53.07
Leblanc,Ashe,1696,817,879,48.17
Leblanc,Chogath,759,338,421,44.53
Leblanc,Kayn,918,440,478,47.93
Leblanc,Pyke,600,324,276,54
Leblanc,Rumble,243,104,139,42.8
Leblanc,Pantheon,1278,617,661,48.28
Leblanc,Karma,1084,531,553,48.99
Leblanc,XinZhao,544,288,256,52.94
Leblanc,Nilah,167,77,90,46.11
Leblanc,Sejuani,295,148,147,50.17
Leblanc,Yone,1440,763,677,52.99
Leblanc,Kaisa,1341,645,696,48.1
Leblanc,JarvanIV,393,189,204,48.09
Leblanc,Renekton,340,181,159,53.24
Leblanc,Corki,372,180,192,48.39
Leblanc,Quinn,255,114,141,44.71
Leblanc,Trundle,376,177,199,47.07
Leblanc,Naafiri,304,99,205,32.57
Leblanc,Volibear,762,353,409,46.33
Leblanc,Vladimir,521,232,289,44.53
Leblanc,Velkoz,396,180,216,45.45
Leblanc,Ambessa,561,313,248,55.79
Leblanc,Ryze,266,113,153,42.48
Leblanc,Jinx,2022,988,1034,48.86
Leblanc,Twitch,511,260,251,50.88
Leblanc,Brand,490,232,258,47.35
Leblanc,Amumu,640,336,304,52.5
Leblanc,Jayce,484,231,253,47.73
Leblanc,Veigar,627,330,297,52.63
Leblanc,Darius,1137,566,571,49.78
Leblanc,MonkeyKing,500,247,253,49.4
Leblanc,Aatrox,798,352,446,44.11
Leblanc,Nami,683,332,351,48.61
Leblanc,Ezreal,2330,1187,1143,50.94
Leblanc,Vi,752,383,369,50.93
Leblanc,Zed,938,468,470,49.89
Leblanc,Neeko,307,155,152,50.49
Leblanc,Ziggs,217,123,94,56.68
Leblanc,Irelia,638,343,295,53.76
Leblanc,Zyra,773,351,422,45.41
Leblanc,Samira,504,245,259,48.61
Leblanc,Akshan,211,117,94,55.45
Leblanc,FiddleSticks,362,195,167,53.87
Leblanc,DrMundo,376,191,185,50.8
Leblanc,Malzahar,788,380,408,48.22
Leblanc,Soraka,349,174,175,49.86
Leblanc,Nocturne,993,460,533,46.32
Leblanc,Orianna,380,176,204,46.32
Leblanc,Sett,1128,557,571,49.38
Leblanc,Ivern,94,57,37,60.64
Leblanc,KSante,444,222,222,50
Leblanc,Braum,423,185,238,43.74
Leblanc,Graves,607,289,318,47.61
Leblanc,Malphite,675,301,374,44.59
Leblanc,Jhin,1534,765,769,49.87
Leblanc,Garen,1097,524,573,47.77
Leblanc,Poppy,542,263,279,48.52
Leblanc,Nautilus,828,401,427,48.43
Leblanc,Syndra,430,220,210,51.16
Leblanc,Galio,765,406,359,53.07
Leblanc,Rakan,293,166,127,56.66
Leblanc,Anivia,235,119,116,50.64
Leblanc,Yorick,620,319,301,51.45
Leblanc,Riven,311,160,151,51.45
Leblanc,LeeSin,1655,853,802,51.54
Leblanc,Lissandra,381,169,212,44.36
Leblanc,Camille,287,99,188,34.49
Leblanc,Viktor,668,278,390,41.62
Leblanc,Xayah,364,189,175,51.92
Leblanc,Shaco,719,329,390,45.76
Leblanc,Mel,1211,606,605,50.04
Leblanc,Nasus,406,176,230,43.35
Leblanc,Zac,416,203,213,48.8
Leblanc,Heimerdinger,291,126,165,43.3
Leblanc,Olaf,179,103,76,57.54
Leblanc,Gwen,322,165,157,51.24
Leblanc,Smolder,448,205,243,45.76
Leblanc,Zoe,352,185,167,52.56
Leblanc,Kindred,345,174,171,50.43
Leblanc,Illaoi,318,139,179,43.71
Leblanc,Alistar,374,195,179,52.14
Leblanc,Katarina,516,261,255,50.58
Leblanc,Taric,123,51,72,41.46
Leblanc,Maokai,413,196,217,47.46
Leblanc,Kayle,388,194,194,50
Leblanc,Milio,377,184,193,48.81
Leblanc,Yuumi,623,304,319,48.8
Leblanc,Khazix,364,173,191,47.53
Leblanc,Janna,267,123,144,46.07
Leblanc,Lulu,985,476,509,48.32
Leblanc,Shen,406,227,179,55.91
Leblanc,TwistedFate,239,131,108,54.81
Leblanc,Swain,662,303,359,45.77
Leblanc,Seraphine,485,269,216,55.46
Leblanc,Evelynn,251,125,126,49.8
Leblanc,Kassadin,197,88,109,44.67
Leblanc,Kalista,202,124,78,61.39
Leblanc,Rell,309,148,161,47.9
Leblanc,Rengar,258,124,134,48.06
Leblanc,Azir,299,137,162,45.82
Leblanc,Tryndamere,352,190,162,53.98
Leblanc,Nidalee,306,134,172,43.79
Leblanc,Kled,160,92,68,57.5
Leblanc,Viego,1126,596,530,52.93
Leblanc,Zeri,328,166,162,50.61
Leblanc,Nunu,305,168,137,55.08
Leblanc,AurelionSol,225,141,84,62.67
Leblanc,Ekko,636,346,290,54.4
Leblanc,Sona,223,111,112,49.78
Leblanc,Qiyana,140,63,77,45
Leblanc,Sion,421,217,204,51.54
Leblanc,Annie,300,127,173,42.33
Leblanc,Gragas,473,230,243,48.63
Leblanc,Vex,660,325,335,49.24
Leblanc,Varus,684,332,352,48.54
Leblanc,Ornn,292,119,173,40.75
Leblanc,Karthus,244,146,98,59.84
Leblanc,Shyvana,144,77,67,53.47
Leblanc,Belveth,163,93,70,57.06
Leblanc,Udyr,219,104,115,47.49
Leblanc,Hwei,500,252,248,50.4
Leblanc,RekSai,82,35,47,42.68
Leblanc,Singed,191,101,90,52.88
Leblanc,Rammus,186,98,88,52.69
Leblanc,Senna,477,212,265,44.44
Leblanc,Elise,591,249,342,42.13
Leblanc,Bard,231,99,132,42.86
Leblanc,Sivir,400,192,208,48
Leblanc,Renata,116,60,56,51.72
Leblanc,Fiora,270,125,145,46.3
Leblanc,Taliyah,177,89,88,50.28
Leblanc,Kennen,215,131,84,60.93
Leblanc,Cassiopeia,141,82,59,58.16
Aatrox,Malzahar,1075,501,574,46.6
Aatrox,Sejuani,458,270,188,58.95
Aatrox,Jayce,689,378,311,54.86
Aatrox,Jhin,2100,1089,1011,51.86
Aatrox,Thresh,1622,789,833,48.64
Aatrox,Tryndamere,504,267,237,52.98
Aatrox,Vi,983,465,518,47.3
Aatrox,Caitlyn,2730,1256,1474,46.01
Aatrox,Zyra,1001,470,531,46.95
Aatrox,Ambessa,682,341,341,50
Aatrox,Graves,821,433,388,52.74
Aatrox,Akali,1071,524,547,48.93
Aatrox,Anivia,293,127,166,43.34
Aatrox,Leona,860,463,397,53.84
Aatrox,Mordekaiser,1358,687,671,50.59
Aatrox,Vex,573,323,250,56.37
Aatrox,Varus,1015,511,504,50.34
Aatrox,Seraphine,727,345,382,47.46
Aatrox,Poppy,526,272,254,51.71
Aatrox,Warwick,1384,686,698,49.57
Aatrox,Taliyah,309,128,181,41.42
Aatrox,MissFortune,2168,1049,1119,48.39
Aatrox,Morgana,1113,575,538,51.66
Aatrox,Pantheon,1608,825,783,51.31
Aatrox,MonkeyKing,679,345,334,50.81
Aatrox,Yasuo,1924,948,976,49.27
Aatrox,Lux,2363,1135,1228,48.03
Aatrox,Irelia,951,429,522,45.11
Aatrox,Briar,698,321,377,45.99
Aatrox,Mel,1978,1022,956,51.67
Aatrox,Vayne,1287,616,671,47.86
Aatrox,Pyke,783,440,343,56.19
Aatrox,Teemo,1316,630,686,47.87
Aatrox,KSante,717,357,360,49.79
Aatrox,Jinx,3030,1456,1574,48.05
Aatrox,Swain,975,454,521,46.56
Aatrox,Quinn,332,186,146,56.02
Aatrox,Evelynn,354,158,196,44.63
Aatrox,Brand,692,343,349,49.57
Aatrox,Sett,1780,910,870,51.12
Aatrox,Ahri,1420,720,700,50.7
Aatrox,Nami,1126,553,573,49.11
Aatrox,Gwen,482,228,254,47.3
Aatrox,Kaisa,1817,936,881,51.51
Aatrox,Renata,177,93,84,52.54
Aatrox,Sylas,1533,771,762,50.29
Aatrox,Ashe,2320,1164,1156,50.17
Aatrox,Milio,627,278,349,44.34
Aatrox,Vladimir,623,310,313,49.76
Aatrox,TwistedFate,433,238,195,54.97
Aatrox,Xayah,437,225,212,51.49
Aatrox,Trundle,501,229,272,45.71
Aatrox,Olaf,211,92,119,43.6
Aatrox,Riven,400,225,175,56.25
Aatrox,Hwei,656,335,321,51.07
Aatrox,Kayle,634,297,337,46.85
Aatrox,Urgot,545,237,308,43.49
Aatrox,Diana,1654,792,862,47.88
Aatrox,Yone,2189,1132,1057,51.71
Aatrox,Aurora,776,400,376,51.55
Aatrox,Shaco,958,482,476,50.31
Aatrox,Lulu,1499,733,766,48.9
Aatrox,Renekton,710,320,390,45.07
Aatrox,Lillia,564,323,241,57.27
Aatrox,Sion,686,379,307,55.25
Aatrox,Viktor,937,482,455,51.44
Aatrox,Corki,429,229,200,53.38
Aatrox,Soraka,498,247,251,49.6
Aatrox,TahmKench,734,384,350,52.32
Aatrox,Volibear,1067,501,566,46.95
Aatrox,LeeSin,2026,1041,985,51.38
Aatrox,Ziggs,433,210,223,48.5
Aatrox,Shen,617,341,276,55.27
Aatrox,Kayn,1424,659,765,46.28
Aatrox,Zilean,390,188,202,48.21
Aatrox,Yorick,830,369,461,44.46
Aatrox,FiddleSticks,522,289,233,55.36
Aatrox,Viego,1659,874,785,52.68
Aatrox,Samira,676,328,348,48.52
Aatrox,Tristana,950,466,484,49.05
Aatrox,AurelionSol,404,199,205,49.26
Aatrox,Draven,614,272,342,44.3
Aatrox,Nasus,686,332,354,48.4
Aatrox,Braum,582,284,298,48.8
Aatrox,Chogath,1114,575,539,51.62
Aatrox,Jax,953,458,495,48.06
Aatrox,Gragas,658,327,331,49.7
Aatrox,XinZhao,739,396,343,53.59
Aatrox,Lucian,744,387,357,52.02
Aatrox,Gnar,433,234,199,54.04
Aatrox,Leblanc,798,446,352,55.89
Aatrox,Senna,660,316,344,47.88
Aatrox,Aphelios,541,251,290,46.4
Aatrox,Garen,1666,774,892,46.46
Aatrox,Nocturne,1351,586,765,43.38
Aatrox,Skarner,247,116,131,46.96
Aatrox,Smolder,583,340,243,58.32
Aatrox,Hecarim,414,202,212,48.79
Aatrox,Rengar,312,189,123,60.58
Aatrox,Ezreal,2774,1484,1290,53.5
Aatrox,Darius,1921,931,990,48.46
Aatrox,Annie,325,173,152,53.23
Aatrox,Sona,281,133,148,47.33
Aatrox,Sivir,571,302,269,52.89
Aatrox,Kled,226,117,109,51.77
Aatrox,Taric,202,103,99,50.99
Aatrox,Ekko,956,415,541,43.41
Aatrox,Karma,1294,625,669,48.3
Aatrox,Velkoz,566,278,288,49.12
Aatrox,Blitzcrank,871,464,407,53.27
Aatrox,Talon,633,287,346,45.34
Aatrox,KogMaw,277,96,181,34.66
Aatrox,Bard,309,168,141,54.37
Aatrox,Amumu,870,411,459,47.24
Aatrox,Lissandra,358,159,199,44.41
Aatrox,Zed,1237,642,595,51.9
Aatrox,Syndra,663,276,387,41.63
Aatrox,Orianna,463,213,250,46
Aatrox,Alistar,507,231,276,45.56
Aatrox,Xerath,1108,551,557,49.73
Aatrox,DrMundo,667,346,321,51.87
Aatrox,Gangplank,770,384,386,49.87
Aatrox,Galio,952,469,483,49.26
Aatrox,Rell,605,272,333,44.96
Aatrox,Khazix,562,299,263,53.2
Aatrox,Ornn,439,203,236,46.24
Aatrox,Zoe,387,198,189,51.16
Aatrox,Kassadin,215,114,101,53.02
Aatrox,Singed,280,125,155,44.64
Aatrox,Fizz,579,249,330,43.01
Aatrox,Karthus,330,196,134,59.39
Aatrox,Ryze,401,234,167,58.35
Aatrox,Azir,391,190,201,48.59
Aatrox,Akshan,383,189,194,49.35
Aatrox,MasterYi,1190,545,645,45.8
Aatrox,Twitch,797,415,382,52.07
Aatrox,Heimerdinger,460,196,264,42.61
Aatrox,Naafiri,312,165,147,52.88
Aatrox,Nautilus,1091,549,542,50.32
Aatrox,Nunu,442,230,212,52.04
Aatrox,Veigar,889,404,485,45.44
Aatrox,Katarina,837,408,429,48.75
Aatrox,Camille,387,182,205,47.03
Aatrox,Rumble,372,162,210,43.55
Aatrox,Kindred,434,220,214,50.69
Aatrox,Fiora,452,247,205,54.65
Aatrox,Zeri,470,225,245,47.87
Aatrox,Zac,587,300,287,51.11
Aatrox,Qiyana,312,159,153,50.96
Aatrox,Yuumi,868,415,453,47.81
Aatrox,Nilah,282,137,145,48.58
Aatrox,Elise,833,407,426,48.86
Aatrox,Illaoi,429,217,212,50.58
Aatrox,Maokai,451,232,219,51.44
Aatrox,Rammus,341,134,207,39.3
Aatrox,Belveth,235,122,113,51.91
Aatrox,Malphite,1043,559,484,53.6
Aatrox,Udyr,407,195,212,47.91
Aatrox,Neeko,404,218,186,53.96
Aatrox,Rakan,443,250,193,56.43
Aatrox,Kalista,293,129,164,44.03
Aatrox,Cassiopeia,328,171,157,52.13
Aatrox,JarvanIV,590,299,291,50.68
Aatrox,Ivern,125,77,48,61.6
Aatrox,Janna,358,176,182,49.16
Aatrox,Kennen,355,170,185,47.89
Aatrox,Nidalee,366,247,119,67.49
Aatrox,Shyvana,177,93,84,52.54
Aatrox,RekSai,104,50,54,48.08
Jayce,Aatrox,689,311,378,45.14
Jayce,Khazix,278,150,128,53.96
Jayce,Fizz,275,164,111,59.64
Jayce,Lux,1148,530,618,46.17
Jayce,Neeko,286,103,183,36.01
Jayce,Darius,974,513,461,52.67
Jayce,Kindred,244,114,130,46.72
Jayce,Yone,1195,669,526,55.98
Jayce,Samira,354,198,156,55.93
Jayce,Rell,314,174,140,55.41
Jayce,Illaoi,228,117,111,51.32
Jayce,Karthus,219,94,125,42.92
Jayce,Naafiri,153,67,86,43.79
Jayce,Jinx,1827,926,901,50.68
Jayce,Maokai,247,108,139,43.72
Jayce,Volibear,518,253,265,48.84
Jayce,Ekko,491,258,233,52.55
Jayce,Ashe,1399,661,738,47.25
Jayce,Bard,245,113,132,46.12
Jayce,Teemo,730,304,426,41.64
Jayce,Nocturne,681,304,377,44.64
Jayce,Ryze,237,107,130,45.15
Jayce,Senna,467,231,236,49.46
Jayce,Kennen,232,97,135,41.81
Jayce,Rengar,157,68,89,43.31
Jayce,Yasuo,1109,514,595,46.35
Jayce,Smolder,347,185,162,53.31
Jayce,Thresh,919,456,463,49.62
Jayce,Mordekaiser,529,251,278,47.45
Jayce,Poppy,425,210,215,49.41
Jayce,Zed,662,349,313,52.72
Jayce,Draven,284,124,160,43.66
Jayce,Sona,152,64,88,42.11
Jayce,Camille,299,138,161,46.15
Jayce,Udyr,195,91,104,46.67
Jayce,Ahri,858,415,443,48.37
Jayce,Milio,297,116,181,39.06
Jayce,Quinn,232,95,137,40.95
Jayce,Kayn,685,347,338,50.66
Jayce,Jhin,1252,624,628,49.84
Jayce,Janna,216,109,107,50.46
Jayce,Sett,757,404,353,53.37
Jayce,Shaco,520,277,243,53.27
Jayce,MissFortune,1137,531,606,46.7
Jayce,Leblanc,484,253,231,52.27
Jayce,Pantheon,942,469,473,49.79
Jayce,Katarina,462,226,236,48.92
Jayce,Caitlyn,1557,708,849,45.47
Jayce,Jax,531,289,242,54.43
Jayce,LeeSin,1517,746,771,49.18
Jayce,Qiyana,188,99,89,52.66
Jayce,Hecarim,252,144,108,57.14
Jayce,Braum,394,210,184,53.3
Jayce,Gnar,290,138,152,47.59
Jayce,MonkeyKing,452,229,223,50.66
Jayce,Mel,1085,570,515,52.53
Jayce,Renekton,333,168,165,50.45
Jayce,Taliyah,189,79,110,41.8
Jayce,Corki,297,145,152,48.82
Jayce,Galio,555,224,331,40.36
Jayce,Vayne,593,280,313,47.22
Jayce,Nautilus,682,339,343,49.71
Jayce,Briar,315,132,183,41.9
Jayce,Syndra,386,188,198,48.7
Jayce,TahmKench,326,170,156,52.15
Jayce,Graves,591,319,272,53.98
Jayce,Akali,669,337,332,50.37
Jayce,Ezreal,1992,1058,934,53.11
Jayce,Nami,469,262,207,55.86
Jayce,Warwick,620,318,302,51.29
Jayce,Diana,1013,500,513,49.36
Jayce,Twitch,290,126,164,43.45
Jayce,Anivia,192,85,107,44.27
Jayce,AurelionSol,196,83,113,42.35
Jayce,Renata,94,36,58,38.3
Jayce,Sejuani,226,104,122,46.02
Jayce,Chogath,561,265,296,47.24
Jayce,Zeri,363,198,165,54.55
Jayce,Zilean,268,138,130,51.49
Jayce,Brand,346,167,179,48.27
Jayce,Irelia,600,282,318,47
Jayce,Lulu,985,556,429,56.45
Jayce,KSante,422,252,170,59.72
Jayce,Sion,366,156,210,42.62
Jayce,Karma,1043,520,523,49.86
Jayce,Veigar,422,204,218,48.34
Jayce,Malphite,656,339,317,51.68
Jayce,Viego,970,434,536,44.74
Jayce,Viktor,620,296,324,47.74
Jayce,Seraphine,360,170,190,47.22
Jayce,Gragas,381,181,200,47.51
Jayce,MasterYi,609,301,308,49.43
Jayce,Tristana,482,234,248,48.55
Jayce,Vladimir,419,209,210,49.88
Jayce,Kaisa,1011,517,494,51.14
Jayce,Tryndamere,281,156,125,55.52
Jayce,Alistar,250,135,115,54
Jayce,Olaf,191,94,97,49.21
Jayce,Xayah,234,102,132,43.59
Jayce,Leona,486,245,241,50.41
Jayce,Lillia,363,210,153,57.85
Jayce,Sylas,1046,565,481,54.02
Jayce,Riven,283,147,136,51.94
Jayce,Sivir,334,197,137,58.98
Jayce,Vi,681,373,308,54.77
Jayce,Aurora,522,282,240,54.02
Jayce,Malzahar,467,220,247,47.11
Jayce,Amumu,497,242,255,48.69
Jayce,Annie,213,101,112,47.42
Jayce,Blitzcrank,497,273,224,54.93
Jayce,Ambessa,553,287,266,51.9
Jayce,Ivern,86,30,56,34.88
Jayce,Xerath,640,305,335,47.66
Jayce,Gangplank,388,168,220,43.3
Jayce,Zyra,646,277,369,42.88
Jayce,Hwei,372,167,205,44.89
Jayce,Kassadin,155,90,65,58.06
Jayce,Azir,256,105,151,41.02
Jayce,Varus,706,371,335,52.55
Jayce,Rakan,292,159,133,54.45
Jayce,Urgot,227,94,133,41.41
Jayce,Gwen,204,99,105,48.53
Jayce,Rumble,267,147,120,55.06
Jayce,Heimerdinger,262,140,122,53.44
Jayce,TwistedFate,225,119,106,52.89
Jayce,Ziggs,182,96,86,52.75
Jayce,Garen,736,308,428,41.85
Jayce,Rammus,119,30,89,25.21
Jayce,Evelynn,200,104,96,52
Jayce,KogMaw,159,68,91,42.77
Jayce,Morgana,556,271,285,48.74
Jayce,Cassiopeia,176,102,74,57.95
Jayce,Yorick,538,263,275,48.88
Jayce,Zac,309,143,166,46.28
Jayce,Talon,439,221,218,50.34
Jayce,Lucian,447,205,242,45.86
Jayce,Akshan,218,128,90,58.72
Jayce,Yuumi,481,217,264,45.11
Jayce,Elise,515,243,272,47.18
Jayce,Singed,157,68,89,43.31
Jayce,Orianna,354,181,173,51.13
Jayce,Trundle,248,124,124,50
Jayce,Shen,300,172,128,57.33
Jayce,DrMundo,290,125,165,43.1
Jayce,Swain,475,221,254,46.53
Jayce,Velkoz,321,140,181,43.61
Jayce,Kayle,268,116,152,43.28
Jayce,Lissandra,175,74,101,42.29
Jayce,Fiora,200,108,92,54
Jayce,Nunu,217,105,112,48.39
Jayce,Zoe,235,109,126,46.38
Jayce,JarvanIV,356,153,203,42.98
Jayce,Kalista,153,74,79,48.37
Jayce,Shyvana,104,55,49,52.88
Jayce,Nilah,131,41,90,31.3
Jayce,Pyke,494,245,249,49.6
Jayce,FiddleSticks,322,169,153,52.48
Jayce,Soraka,334,172,162,51.5
Jayce,Ornn,204,99,105,48.53
Jayce,Vex,284,129,155,45.42
Jayce,Belveth,116,56,60,48.28
Jayce,Kled,96,57,39,59.38
Jayce,Nasus,295,119,176,40.34
Jayce,XinZhao,442,227,215,51.36
Jayce,Aphelios,276,156,120,56.52
Jayce,Nidalee,249,122,127,49
Jayce,Taric,72,28,44,38.89
Jayce,Skarner,138,91,47,65.94
Jayce,RekSai,86,53,33,61.63
Shaco,Garen,1782,850,932,47.7
Shaco,Nocturne,1695,836,859,49.32
Shaco,Fizz,745,374,371,50.2
Shaco,Jinx,3162,1501,1661,47.47
Shaco,Thresh,1359,656,703,48.27
Shaco,Vladimir,750,387,363,51.6
Shaco,Pantheon,1746,858,888,49.14
Shaco,Mel,2362,1191,1171,50.42
Shaco,Ezreal,2704,1372,1332,50.74
Shaco,Teemo,1612,794,818,49.26
Shaco,Riven,487,253,234,51.95
Shaco,Ziggs,458,246,212,53.71
Shaco,Katarina,955,487,468,50.99
Shaco,LeeSin,1758,828,930,47.1
Shaco,Lux,3009,1445,1564,48.02
Shaco,Darius,2063,1000,1063,48.47
Shaco,Volibear,1243,556,687,44.73
Shaco,Veigar,1214,612,602,50.41
Shaco,Ashe,2290,1135,1155,49.56
Shaco,Lulu,1465,730,735,49.83
Shaco,Warwick,1760,836,924,47.5
Shaco,Ekko,1178,600,578,50.93
Shaco,Hwei,710,353,357,49.72
Shaco,Jhin,2342,1173,1169,50.09
Shaco,Nami,1112,528,584,47.48
Shaco,Tryndamere,668,323,345,48.35
Shaco,Shyvana,298,148,150,49.66
Shaco,Ambessa,656,332,324,50.61
Shaco,Irelia,962,464,498,48.23
Shaco,MasterYi,1462,772,690,52.8
Shaco,Galio,919,459,460,49.95
Shaco,Draven,609,280,329,45.98
Shaco,Nautilus,1172,620,552,52.9
Shaco,Kaisa,1848,941,907,50.92
Shaco,Maokai,512,254,258,49.61
Shaco,Yasuo,2219,1037,1182,46.73
Shaco,Samira,834,436,398,52.28
Shaco,Pyke,865,433,432,50.06
Shaco,Heimerdinger,573,279,294,48.69
Shaco,Kindred,540,287,253,53.15
Shaco,Ornn,377,200,177,53.05
Shaco,Quinn,397,190,207,47.86
Shaco,Zed,1386,678,708,48.92
Shaco,Soraka,704,326,378,46.31
Shaco,MonkeyKing,739,363,376,49.12
Shaco,TahmKench,810,452,358,55.8
Shaco,Kayn,1688,867,821,51.36
Shaco,Twitch,981,504,477,51.38
Shaco,Qiyana,295,161,134,54.58
Shaco,Mordekaiser,1513,690,823,45.6
Shaco,Briar,853,405,448,47.48
Shaco,Caitlyn,3238,1481,1757,45.74
Shaco,Yone,2071,1051,1020,50.75
Shaco,AurelionSol,449,213,236,47.44
Shaco,Smolder,716,350,366,48.88
Shaco,Akali,1272,590,682,46.38
Shaco,Diana,1887,889,998,47.11
Shaco,Talon,678,365,313,53.83
Shaco,Vayne,1491,717,774,48.09
Shaco,Zilean,403,185,218,45.91
Shaco,Swain,1172,533,639,45.48
Shaco,Brand,896,410,486,45.76
Shaco,Sona,357,153,204,42.86
Shaco,Malzahar,1329,631,698,47.48
Shaco,Rakan,405,218,187,53.83
Shaco,Rammus,268,149,119,55.6
Shaco,Xayah,501,249,252,49.7
Shaco,Gangplank,530,265,265,50
Shaco,Neeko,508,244,264,48.03
Shaco,Yorick,1202,541,661,45.01
Shaco,Aatrox,958,476,482,49.69
Shaco,Syndra,718,332,386,46.24
Shaco,Seraphine,882,426,456,48.3
Shaco,Ahri,1492,836,656,56.03
Shaco,MissFortune,2582,1260,1322,48.8
Shaco,Jax,1017,526,491,51.72
Shaco,Lillia,606,305,301,50.33
Shaco,Tristana,1136,605,531,53.26
Shaco,Yuumi,864,408,456,47.22
Shaco,Chogath,1282,596,686,46.49
Shaco,Sylas,1369,736,633,53.76
Shaco,Bard,329,158,171,48.02
Shaco,Fiora,425,219,206,51.53
Shaco,Karthus,380,216,164,56.84
Shaco,Milio,706,308,398,43.63
Shaco,Viego,1594,793,801,49.75
Shaco,Aurora,738,362,376,49.05
Shaco,Braum,548,257,291,46.9
Shaco,Ryze,391,190,201,48.59
Shaco,Leona,916,495,421,54.04
Shaco,Vex,616,305,311,49.51
Shaco,Shen,717,341,376,47.56
Shaco,Viktor,932,425,507,45.6
Shaco,Sivir,656,334,322,50.91
Shaco,Velkoz,679,307,372,45.21
Shaco,FiddleSticks,637,341,296,53.53
Shaco,Sett,1668,892,776,53.48
Shaco,Naafiri,351,156,195,44.44
Shaco,DrMundo,647,300,347,46.37
Shaco,Hecarim,487,247,240,50.72
Shaco,Xerath,965,495,470,51.3
Shaco,Trundle,725,332,393,45.79
Shaco,Morgana,1445,678,767,46.92
Shaco,Nasus,802,352,450,43.89
Shaco,Kayle,769,384,385,49.93
Shaco,Renekton,579,293,286,50.6
Shaco,Karma,1436,714,722,49.72
Shaco,Lissandra,364,192,172,52.75
Shaco,Aphelios,565,281,284,49.73
Shaco,Amumu,1174,534,640,45.49
Shaco,Jayce,520,243,277,46.73
Shaco,Singed,275,116,159,42.18
Shaco,Graves,781,362,419,46.35
Shaco,Gragas,586,304,282,51.88
Shaco,Sejuani,401,203,198,50.62
Shaco,Lucian,751,374,377,49.8
Shaco,Gnar,475,239,236,50.32
Shaco,Akshan,406,206,200,50.74
Shaco,Varus,948,474,474,50
Shaco,Zoe,355,177,178,49.86
Shaco,Zyra,1195,620,575,51.88
Shaco,Blitzcrank,823,425,398,51.64
Shaco,Sion,857,392,465,45.74
Shaco,Orianna,486,246,240,50.62
Shaco,Zac,528,248,280,46.97
Shaco,RekSai,150,72,78,48
Shaco,Vi,1003,470,533,46.86
Shaco,Corki,442,242,200,54.75
Shaco,Zeri,418,207,211,49.52
Shaco,Taric,248,117,131,47.18
Shaco,Illaoi,551,278,273,50.45
Shaco,Cassiopeia,257,128,129,49.81
Shaco,Malphite,1168,599,569,51.28
Shaco,KSante,558,278,280,49.82
Shaco,Skarner,265,153,112,57.74
Shaco,Khazix,603,303,300,50.25
Shaco,JarvanIV,596,268,328,44.97
Shaco,Belveth,234,127,107,54.27
Shaco,Kassadin,223,89,134,39.91
Shaco,Janna,318,164,154,51.57
Shaco,Anivia,362,188,174,51.93
Shaco,XinZhao,672,344,328,51.19
Shaco,Leblanc,719,390,329,54.24
Shaco,Evelynn,427,158,269,37
Shaco,Nilah,357,172,185,48.18
Shaco,Kennen,255,108,147,42.35
Shaco,Azir,317,144,173,45.43
Shaco,Rengar,398,206,192,51.76
Shaco,Alistar,450,223,227,49.56
Shaco,Elise,812,413,399,50.86
Shaco,Nunu,616,278,338,45.13
Shaco,Rumble,355,179,176,50.42
Shaco,Ivern,129,68,61,52.71
Shaco,Camille,357,190,167,53.22
Shaco,Poppy,613,300,313,48.94
Shaco,Renata,162,71,91,43.83
Shaco,Senna,845,405,440,47.93
Shaco,TwistedFate,427,214,213,50.12
Shaco,Kled,166,79,87,47.59
Shaco,KogMaw,281,142,139,50.53
Shaco,Udyr,462,236,226,51.08
Shaco,Rell,464,228,236,49.14
Shaco,Urgot,581,312,269,53.7
Shaco,Gwen,481,248,233,51.56
Shaco,Kalista,201,120,81,59.7
Shaco,Annie,363,188,175,51.79
Shaco,Taliyah,253,124,129,49.01
Shaco,Olaf,250,124,126,49.6
Shaco,Nidalee,278,166,112,59.71
Janna,Garen,658,332,326,50.46
Janna,Nocturne,462,227,235,49.13
Janna,Fizz,208,104,104,50
Janna,Jinx,1205,623,582,51.7
Janna,Thresh,558,304,254,54.48
Janna,Darius,827,411,416,49.7
Janna,Zac,252,121,131,48.02
Janna,Anivia,178,75,103,42.13
Janna,Tristana,374,204,170,54.55
Janna,Blitzcrank,285,148,137,51.93
Janna,Shen,285,162,123,56.84
Janna,Amumu,416,174,242,41.83
Janna,Akali,369,213,156,57.72
Janna,Jhin,777,389,388,50.06
Janna,TahmKench,309,142,167,45.95
Janna,Vladimir,300,149,151,49.67
Janna,Viego,530,239,291,45.09
Janna,AurelionSol,160,67,93,41.88
Janna,Ezreal,1014,547,467,53.94
Janna,Nami,616,263,353,42.69
Janna,Yorick,370,190,180,51.35
Janna,Sejuani,148,68,80,45.95
Janna,Lux,822,386,436,46.96
Janna,Samira,271,129,142,47.6
Janna,Rell,291,149,142,51.2
Janna,Gangplank,234,142,92,60.68
Janna,Graves,258,130,128,50.39
Janna,Yasuo,881,455,426,51.65
Janna,Soraka,232,124,108,53.45
Janna,Chogath,486,249,237,51.23
Janna,LeeSin,569,344,225,60.46
Janna,Katarina,377,180,197,47.75
Janna,Kaisa,731,375,356,51.3
Janna,Mel,811,401,410,49.45
Janna,Jayce,216,107,109,49.54
Janna,Udyr,190,106,84,55.79
Janna,Yone,677,347,330,51.26
Janna,Caitlyn,930,433,497,46.56
Janna,Karma,609,315,294,51.72
Janna,Aurora,262,164,98,62.6
Janna,Annie,137,87,50,63.5
Janna,Sivir,227,109,118,48.02
Janna,Renata,89,35,54,39.33
Janna,Pantheon,719,337,382,46.87
Janna,Diana,648,355,293,54.78
Janna,Nasus,288,155,133,53.82
Janna,Lucian,308,161,147,52.27
Janna,Senna,366,158,208,43.17
Janna,Renekton,201,88,113,43.78
Janna,Irelia,317,151,166,47.63
Janna,Swain,397,206,191,51.89
Janna,Kayn,630,346,284,54.92
Janna,Xerath,345,201,144,58.26
Janna,Smolder,254,146,108,57.48
Janna,Lulu,703,356,347,50.64
Janna,Sion,349,184,165,52.72
Janna,Warwick,511,253,258,49.51
Janna,Galio,291,160,131,54.98
Janna,Sett,489,283,206,57.87
Janna,Draven,248,125,123,50.4
Janna,Nautilus,430,228,202,53.02
Janna,Brand,233,124,109,53.22
Janna,Nunu,257,119,138,46.3
Janna,Skarner,81,49,32,60.49
Janna,Neeko,188,100,88,53.19
Janna,Ornn,152,82,70,53.95
Janna,Zeri,164,77,87,46.95
Janna,Zed,456,247,209,54.17
Janna,Talon,279,148,131,53.05
Janna,Elise,339,168,171,49.56
Janna,KSante,244,109,135,44.67
Janna,MissFortune,827,429,398,51.87
Janna,Kled,88,49,39,55.68
Janna,Nidalee,105,61,44,58.1
Janna,Viktor,388,198,190,51.03
Janna,Vayne,569,286,283,50.26
Janna,Jax,338,186,152,55.03
Janna,Shaco,318,154,164,48.43
Janna,Hwei,277,152,125,54.87
Janna,Trundle,161,86,75,53.42
Janna,Briar,300,149,151,49.67
Janna,Cassiopeia,125,62,63,49.6
Janna,Bard,191,118,73,61.78
Janna,JarvanIV,270,141,129,52.22
Janna,Malzahar,388,200,188,51.55
Janna,Sona,182,62,120,34.07
Janna,Gwen,237,135,102,56.96
Janna,Veigar,356,160,196,44.94
Janna,KogMaw,131,64,67,48.85
Janna,Kindred,181,107,74,59.12
Janna,Ahri,471,225,246,47.77
Janna,Ashe,803,418,385,52.05
Janna,Zilean,163,86,77,52.76
Janna,Ambessa,295,154,141,52.2
Janna,Vi,345,204,141,59.13
Janna,Sylas,450,245,205,54.44
Janna,Xayah,180,103,77,57.22
Janna,Hecarim,206,114,92,55.34
Janna,Leblanc,267,144,123,53.93
Janna,Tryndamere,186,65,121,34.95
Janna,Gragas,238,120,118,50.42
Janna,Twitch,370,198,172,53.51
Janna,Rengar,134,57,77,42.54
Janna,Taliyah,106,49,57,46.23
Janna,Velkoz,242,118,124,48.76
Janna,Morgana,369,187,182,50.68
Janna,DrMundo,195,89,106,45.64
Janna,Volibear,437,218,219,49.89
Janna,Corki,198,126,72,63.64
Janna,FiddleSticks,248,117,131,47.18
Janna,Heimerdinger,156,67,89,42.95
Janna,MasterYi,420,218,202,51.9
Janna,Mordekaiser,454,226,228,49.78
Janna,Riven,254,130,124,51.18
Janna,Yuumi,301,173,128,57.48
Janna,Belveth,95,73,22,76.84
Janna,Syndra,306,153,153,50
Janna,Teemo,351,160,191,45.58
Janna,Milio,338,163,175,48.22
Janna,Karthus,132,54,78,40.91
Janna,Seraphine,281,143,138,50.89
Janna,Varus,367,210,157,57.22
Janna,Malphite,334,179,155,53.59
Janna,Braum,229,112,117,48.91
Janna,Lillia,206,87,119,42.23
Janna,Rakan,163,87,76,53.37
Janna,Lissandra,170,89,81,52.35
Janna,Zyra,350,172,178,49.14
Janna,Singed,124,67,57,54.03
Janna,Ekko,385,175,210,45.45
Janna,Kassadin,88,56,32,63.64
Janna,Kayle,283,123,160,43.46
Janna,MonkeyKing,309,137,172,44.34
Janna,Evelynn,140,91,49,65
Janna,Poppy,268,113,155,42.16
Janna,Ziggs,148,72,76,48.65
Janna,Aatrox,358,182,176,50.84
Janna,Naafiri,130,58,72,44.62
Janna,Alistar,209,105,104,50.24
Janna,Camille,179,102,77,56.98
Janna,Qiyana,160,82,78,51.25
Janna,Maokai,187,84,103,44.92
Janna,Kennen,148,81,67,54.73
Janna,Ivern,57,18,39,31.58
Janna,Olaf,97,64,33,65.98
Janna,Pyke,313,168,145,53.67
Janna,Rammus,158,97,61,61.39
Janna,Khazix,203,90,113,44.33
Janna,Ryze,140,82,58,58.57
Janna,Azir,127,61,66,48.03
Janna,Urgot,241,111,130,46.06
Janna,Aphelios,229,105,124,45.85
Janna,Fiora,151,68,83,45.03
Janna,XinZhao,259,133,126,51.35
Janna,Zoe,136,70,66,51.47
Janna,Kalista,107,56,51,52.34
Janna,Vex,183,104,79,56.83
Janna,TwistedFate,143,77,66,53.85
Janna,Leona,369,203,166,55.01
Janna,Gnar,173,76,97,43.93
Janna,Illaoi,168,100,68,59.52
Janna,Nilah,154,81,73,52.6
Janna,Taric,104,69,35,66.35
Janna,Shyvana,119,76,43,63.87
Janna,RekSai,54,27,27,50
Janna,Quinn,167,90,77,53.89
Janna,Akshan,163,104,59,63.8
Janna,Orianna,186,107,79,57.53
Janna,Rumble,103,63,40,61.17
Lissandra,Sion,277,121,156,43.68
Lissandra,Vi,362,195,167,53.87
Lissandra,Sylas,526,260,266,49.43
Lissandra,Lucian,309,170,139,55.02
Lissandra,Pantheon,616,322,294,52.27
Lissandra,Ambessa,229,139,90,60.7
Lissandra,XinZhao,216,107,109,49.54
Lissandra,Vladimir,327,174,153,53.21
Lissandra,Ezreal,1068,587,481,54.96
Lissandra,Karma,534,228,306,42.7
Lissandra,Nasus,282,136,146,48.23
Lissandra,MasterYi,550,289,261,52.55
Lissandra,Kaisa,620,327,293,52.74
Lissandra,Neeko,254,133,121,52.36
Lissandra,DrMundo,193,111,82,57.51
Lissandra,Rengar,148,73,75,49.32
Lissandra,Akali,488,213,275,43.65
Lissandra,Nilah,139,64,75,46.04
Lissandra,Shen,255,145,110,56.86
Lissandra,Maokai,161,82,79,50.93
Lissandra,Yasuo,1016,534,482,52.56
Lissandra,Samira,229,118,111,51.53
Lissandra,Pyke,285,157,128,55.09
Lissandra,Kayle,275,123,152,44.73
Lissandra,Ekko,431,226,205,52.44
Lissandra,Veigar,312,153,159,49.04
Lissandra,Ziggs,156,74,82,47.44
Lissandra,Lux,883,411,472,46.55
Lissandra,Urgot,225,99,126,44
Lissandra,Rammus,131,76,55,58.02
Lissandra,Xerath,367,131,236,35.69
Lissandra,Jinx,1210,628,582,51.9
Lissandra,Lulu,625,326,299,52.16
Lissandra,JarvanIV,224,109,115,48.66
Lissandra,Yone,703,386,317,54.91
Lissandra,Ashe,738,378,360,51.22
Lissandra,Swain,353,176,177,49.86
Lissandra,Gwen,198,97,101,48.99
Lissandra,Teemo,457,222,235,48.58
Lissandra,Yorick,384,182,202,47.4
Lissandra,Cassiopeia,126,68,58,53.97
Lissandra,Smolder,211,136,75,64.45
Lissandra,Anivia,155,83,72,53.55
Lissandra,Volibear,413,215,198,52.06
Lissandra,Shaco,364,172,192,47.25
Lissandra,Syndra,253,157,96,62.06
Lissandra,Xayah,209,99,110,47.37
Lissandra,Milio,256,147,109,57.42
Lissandra,Hwei,178,76,102,42.7
Lissandra,Zed,761,422,339,55.45
Lissandra,Aphelios,213,116,97,54.46
Lissandra,Amumu,423,207,216,48.94
Lissandra,Nidalee,150,90,60,60
Lissandra,MissFortune,861,431,430,50.06
Lissandra,Nautilus,438,211,227,48.17
Lissandra,Mordekaiser,475,280,195,58.95
Lissandra,Kalista,124,64,60,51.61
Lissandra,Jax,352,176,176,50
Lissandra,Udyr,127,63,64,49.61
Lissandra,Draven,219,129,90,58.9
Lissandra,Morgana,458,247,211,53.93
Lissandra,Vex,148,66,82,44.59
Lissandra,Azir,105,43,62,40.95
Lissandra,Kayn,534,286,248,53.56
Lissandra,Viktor,358,184,174,51.4
Lissandra,Blitzcrank,235,124,111,52.77
Lissandra,Thresh,552,316,236,57.25
Lissandra,Aatrox,358,199,159,55.59
Lissandra,Chogath,446,196,250,43.95
Lissandra,Briar,278,133,145,47.84
Lissandra,Darius,697,336,361,48.21
Lissandra,Evelynn,134,67,67,50
Lissandra,Sett,531,244,287,45.95
Lissandra,Illaoi,199,95,104,47.74
Lissandra,Mel,748,392,356,52.41
Lissandra,KSante,206,103,103,50
Lissandra,Lillia,245,146,99,59.59
Lissandra,Aurora,279,147,132,52.69
Lissandra,Rakan,147,88,59,59.86
Lissandra,Zyra,364,174,190,47.8
Lissandra,Heimerdinger,186,94,92,50.54
Lissandra,Zac,182,87,95,47.8
Lissandra,Nocturne,488,219,269,44.88
Lissandra,Trundle,296,143,153,48.31
Lissandra,Olaf,106,55,51,51.89
Lissandra,Leblanc,381,212,169,55.64
Lissandra,Caitlyn,1009,489,520,48.46
Lissandra,Malphite,420,212,208,50.48
Lissandra,Karthus,102,70,32,68.63
Lissandra,Rell,213,104,109,48.83
Lissandra,Renekton,240,126,114,52.5
Lissandra,Nami,442,209,233,47.29
Lissandra,Diana,683,372,311,54.47
Lissandra,Orianna,160,97,63,60.63
Lissandra,Graves,296,147,149,49.66
Lissandra,Braum,273,121,152,44.32
Lissandra,Naafiri,150,92,58,61.33
Lissandra,Belveth,89,40,49,44.94
Lissandra,Soraka,225,125,100,55.56
Lissandra,Corki,163,89,74,54.6
Lissandra,Tristana,385,207,178,53.77
Lissandra,Poppy,217,120,97,55.3
Lissandra,Qiyana,116,70,46,60.34
Lissandra,Jhin,824,412,412,50
Lissandra,Vayne,590,316,274,53.56
Lissandra,Khazix,223,132,91,59.19
Lissandra,Katarina,377,172,205,45.62
Lissandra,Zilean,127,59,68,46.46
Lissandra,Sivir,205,104,101,50.73
Lissandra,Alistar,208,99,109,47.6
Lissandra,Gragas,228,113,115,49.56
Lissandra,Garen,546,332,214,60.81
Lissandra,Sejuani,166,66,100,39.76
Lissandra,Senna,248,110,138,44.35
Lissandra,Fizz,297,184,113,61.95
Lissandra,LeeSin,560,282,278,50.36
Lissandra,Renata,88,52,36,59.09
Lissandra,Warwick,587,308,279,52.47
Lissandra,Malzahar,379,188,191,49.6
Lissandra,Seraphine,253,128,125,50.59
Lissandra,FiddleSticks,187,114,73,60.96
Lissandra,Irelia,402,219,183,54.48
Lissandra,Twitch,337,176,161,52.23
Lissandra,Viego,565,252,313,44.6
Lissandra,Zoe,123,62,61,50.41
Lissandra,Brand,274,148,126,54.01
Lissandra,Riven,206,107,99,51.94
Lissandra,Ahri,524,265,259,50.57
Lissandra,Elise,321,193,128,60.12
Lissandra,Ryze,130,69,61,53.08
Lissandra,Janna,170,81,89,47.65
Lissandra,Hecarim,165,85,80,51.52
Lissandra,AurelionSol,120,72,48,60
Lissandra,Varus,355,204,151,57.46
Lissandra,Leona,330,189,141,57.27
Lissandra,RekSai,66,25,41,37.88
Lissandra,Ivern,39,16,23,41.03
Lissandra,Talon,269,151,118,56.13
Lissandra,Taric,89,60,29,67.42
Lissandra,Kennen,110,39,71,35.45
Lissandra,TahmKench,257,124,133,48.25
Lissandra,Fiora,123,68,55,55.28
Lissandra,Quinn,138,46,92,33.33
Lissandra,Singed,89,44,45,49.44
Lissandra,Gnar,223,128,95,57.4
Lissandra,MonkeyKing,324,167,157,51.54
Lissandra,Sona,82,43,39,52.44
Lissandra,KogMaw,126,50,76,39.68
Lissandra,Jayce,175,101,74,57.71
Lissandra,Ornn,138,57,81,41.3
Lissandra,Yuumi,317,159,158,50.16
Lissandra,Galio,322,182,140,56.52
Lissandra,Bard,123,86,37,69.92
Lissandra,Velkoz,198,92,106,46.46
Lissandra,Kindred,148,80,68,54.05
Lissandra,Tryndamere,209,124,85,59.33
Lissandra,Shyvana,89,50,39,56.18
Lissandra,Rumble,88,44,44,50
Lissandra,Gangplank,155,75,80,48.39
Lissandra,TwistedFate,151,89,62,58.94
Lissandra,Zeri,152,77,75,50.66
Lissandra,Nunu,230,130,100,56.52
Lissandra,Skarner,86,47,39,54.65
Lissandra,Akshan,138,67,71,48.55
Lissandra,Taliyah,119,54,65,45.38
Lissandra,Kled,65,41,24,63.08
Lissandra,Camille,108,55,53,50.93
Lissandra,Annie,122,62,60,50.82
Lissandra,Kassadin,104,44,60,42.31
Anivia,Tryndamere,232,130,102,56.03
Anivia,Vi,369,187,182,50.68
Anivia,Malzahar,423,205,218,48.46
Anivia,Caitlyn,975,470,505,48.21
Anivia,Zyra,419,216,203,51.55
Anivia,Aatrox,293,166,127,56.66
Anivia,Kayn,566,313,253,55.3
Anivia,Katarina,332,200,132,60.24
Anivia,Draven,199,107,92,53.77
Anivia,Blitzcrank,243,122,121,50.21
Anivia,Teemo,439,223,216,50.8
Anivia,Briar,233,116,117,49.79
Anivia,Yasuo,687,351,336,51.09
Anivia,MissFortune,842,423,419,50.24
Anivia,Volibear,408,235,173,57.6
Anivia,Sejuani,175,65,110,37.14
Anivia,Lux,900,450,450,50
Anivia,Jhin,781,427,354,54.67
Anivia,Nautilus,416,227,189,54.57
Anivia,Urgot,184,97,87,52.72
Anivia,Ryze,163,86,77,52.76
Anivia,Thresh,503,239,264,47.51
Anivia,Pantheon,509,297,212,58.35
Anivia,Viktor,357,197,160,55.18
Anivia,Samira,274,150,124,54.74
Anivia,Janna,178,103,75,57.87
Anivia,Gangplank,190,99,91,52.11
Anivia,Kindred,142,65,77,45.77
Anivia,Aurora,275,144,131,52.36
Anivia,Sivir,198,103,95,52.02
Anivia,Yuumi,320,171,149,53.44
Anivia,Irelia,307,153,154,49.84
Anivia,Rammus,138,62,76,44.93
Anivia,Karma,527,264,263,50.09
Anivia,Ezreal,842,447,395,53.09
Anivia,Viego,523,235,288,44.93
Anivia,Veigar,385,224,161,58.18
Anivia,Jinx,1113,559,554,50.22
Anivia,Milio,225,119,106,52.89
Anivia,Illaoi,165,111,54,67.27
Anivia,Karthus,162,106,56,65.43
Anivia,Naafiri,108,55,53,50.93
Anivia,Maokai,205,121,84,59.02
Anivia,Elise,287,145,142,50.52
Anivia,Fizz,211,118,93,55.92
Anivia,Mordekaiser,502,239,263,47.61
Anivia,Jax,359,195,164,54.32
Anivia,Ahri,448,212,236,47.32
Anivia,Corki,139,90,49,64.75
Anivia,Soraka,224,124,100,55.36
Anivia,Sett,488,253,235,51.84
Anivia,Warwick,527,256,271,48.58
Anivia,Lissandra,155,72,83,46.45
Anivia,Alistar,118,56,62,47.46
Anivia,Fiora,123,58,65,47.15
Anivia,JarvanIV,203,101,102,49.75
Anivia,Galio,308,143,165,46.43
Anivia,Yorick,360,177,183,49.17
Anivia,Syndra,345,193,152,55.94
Anivia,Velkoz,280,147,133,52.5
Anivia,Nasus,286,164,122,57.34
Anivia,Garen,599,282,317,47.08
Anivia,Renata,73,32,41,43.84
Anivia,Nocturne,429,205,224,47.79
Anivia,Zilean,124,58,66,46.77
Anivia,Mel,711,376,335,52.88
Anivia,Nunu,220,124,96,56.36
Anivia,Tristana,440,247,193,56.14
Anivia,Ashe,730,371,359,50.82
Anivia,Morgana,492,239,253,48.58
Anivia,Ekko,358,179,179,50
Anivia,Kaisa,709,367,342,51.76
Anivia,Lulu,486,238,248,48.97
Anivia,Rengar,119,75,44,63.03
Anivia,Chogath,481,253,228,52.6
Anivia,Graves,246,142,104,57.72
Anivia,Seraphine,271,147,124,54.24
Anivia,Lillia,192,114,78,59.38
Anivia,Sylas,518,258,260,49.81
Anivia,TahmKench,288,161,127,55.9
Anivia,Gragas,182,95,87,52.2
Anivia,Jayce,192,107,85,55.73
Anivia,Varus,315,180,135,57.14
Anivia,Gwen,191,93,98,48.69
Anivia,MasterYi,439,206,233,46.92
Anivia,Leblanc,235,116,119,49.36
Anivia,Senna,281,155,126,55.16
Anivia,Sion,299,172,127,57.53
Anivia,Gnar,180,75,105,41.67
Anivia,Shaco,362,174,188,48.07
Anivia,Rakan,148,71,77,47.97
Anivia,Swain,325,165,160,50.77
Anivia,Darius,724,389,335,53.73
Anivia,Braum,251,120,131,47.81
Anivia,Trundle,236,128,108,54.24
Anivia,Vex,148,76,72,51.35
Anivia,FiddleSticks,168,74,94,44.05
Anivia,Vayne,414,222,192,53.62
Anivia,Zed,449,239,210,53.23
Anivia,AurelionSol,180,98,82,54.44
Anivia,Khazix,172,97,75,56.4
Anivia,Xayah,211,131,80,62.09
Anivia,Singed,113,62,51,54.87
Anivia,Shyvana,91,47,44,51.65
Anivia,Neeko,163,86,77,52.76
Anivia,KSante,194,95,99,48.97
Anivia,Nami,452,235,217,51.99
Anivia,Rumble,112,69,43,61.61
Anivia,Poppy,232,125,107,53.88
Anivia,Lucian,300,158,142,52.67
Anivia,Ornn,149,85,64,57.05
Anivia,LeeSin,580,307,273,52.93
Anivia,Udyr,130,76,54,58.46
Anivia,KogMaw,115,51,64,44.35
Anivia,Vladimir,254,134,120,52.76
Anivia,Talon,287,144,143,50.17
Anivia,Twitch,302,141,161,46.69
Anivia,Shen,233,112,121,48.07
Anivia,Taliyah,106,56,50,52.83
Anivia,Aphelios,234,109,125,46.58
Anivia,Hwei,239,106,133,44.35
Anivia,Xerath,337,195,142,57.86
Anivia,Skarner,83,51,32,61.45
Anivia,Hecarim,166,101,65,60.84
Anivia,Zeri,144,69,75,47.92
Anivia,Sona,108,63,45,58.33
Anivia,Kayle,315,150,165,47.62
Anivia,Zoe,166,68,98,40.96
Anivia,Riven,177,83,94,46.89
Anivia,XinZhao,221,103,118,46.61
Anivia,Ziggs,144,78,66,54.17
Anivia,Smolder,221,115,106,52.04
Anivia,Annie,116,55,61,47.41
Anivia,Kalista,93,46,47,49.46
Anivia,Diana,600,346,254,57.67
Anivia,Leona,327,160,167,48.93
Anivia,Olaf,89,53,36,59.55
Anivia,Heimerdinger,191,108,83,56.54
Anivia,Camille,128,81,47,63.28
Anivia,Ivern,63,33,30,52.38
Anivia,Evelynn,122,59,63,48.36
Anivia,Brand,248,127,121,51.21
Anivia,Amumu,378,189,189,50
Anivia,Yone,536,285,251,53.17
Anivia,Nilah,100,70,30,70
Anivia,Akali,356,188,168,52.81
Anivia,Malphite,277,130,147,46.93
Anivia,Qiyana,79,44,35,55.7
Anivia,Kassadin,118,77,41,65.25
Anivia,Pyke,232,107,125,46.12
Anivia,Renekton,174,94,80,54.02
Anivia,Kled,70,26,44,37.14
Anivia,Bard,111,58,53,52.25
Anivia,Kennen,112,43,69,38.39
Anivia,Rell,215,105,110,48.84
Anivia,Cassiopeia,136,81,55,59.56
Anivia,Ambessa,243,130,113,53.5
Anivia,TwistedFate,136,77,59,56.62
Anivia,Quinn,111,59,52,53.15
Anivia,MonkeyKing,261,126,135,48.28
Anivia,Orianna,186,134,52,72.04
Anivia,Akshan,139,70,69,50.36
Anivia,DrMundo,247,134,113,54.25
Anivia,Zac,177,102,75,57.63
Anivia,Nidalee,96,62,34,64.58
Anivia,Belveth,76,24,52,31.58
Anivia,RekSai,41,17,24,41.46
Anivia,Taric,82,38,44,46.34
Anivia,Azir,90,59,31,65.56
Kennen,Darius,687,297,390,43.23
Kennen,Kindred,128,71,57,55.47
Kennen,Yone,587,316,271,53.83
Kennen,Samira,223,116,107,52.02
Kennen,Rell,115,54,61,46.96
Kennen,Teemo,431,202,229,46.87
Kennen,Fizz,168,94,74,55.95
Kennen,Briar,207,81,126,39.13
Kennen,Seraphine,204,100,104,49.02
Kennen,Garen,410,182,228,44.39
Kennen,Volibear,299,131,168,43.81
Kennen,Veigar,282,102,180,36.17
Kennen,Smolder,192,66,126,34.38
Kennen,Lux,726,370,356,50.96
Kennen,Nasus,270,120,150,44.44
Kennen,Diana,591,298,293,50.42
Kennen,Renekton,132,80,52,60.61
Kennen,Kayle,194,90,104,46.39
Kennen,Yasuo,642,317,325,49.38
Kennen,Draven,133,73,60,54.89
Kennen,Thresh,442,230,212,52.04
Kennen,Jax,281,141,140,50.18
Kennen,Aurora,253,155,98,61.26
Kennen,Caitlyn,751,371,380,49.4
Kennen,Amumu,293,133,160,45.39
Kennen,Katarina,199,120,79,60.3
Kennen,MissFortune,724,341,383,47.1
Kennen,Nami,286,130,156,45.45
Kennen,Rammus,79,30,49,37.97
Kennen,Ryze,125,72,53,57.6
Kennen,Swain,284,156,128,54.93
Kennen,Jayce,232,135,97,58.19
Kennen,Yorick,273,131,142,47.99
Kennen,Hwei,215,99,116,46.05
Kennen,Jhin,673,319,354,47.4
Kennen,Soraka,212,122,90,57.55
Kennen,Rumble,99,59,40,59.6
Kennen,Ekko,285,124,161,43.51
Kennen,Brand,227,110,117,48.46
Kennen,Gangplank,179,83,96,46.37
Kennen,Graves,192,117,75,60.94
Kennen,Jinx,821,438,383,53.35
Kennen,Gnar,139,93,46,66.91
Kennen,Sejuani,100,52,48,52
Kennen,Vladimir,276,145,131,52.54
Kennen,TahmKench,230,127,103,55.22
Kennen,Mordekaiser,309,157,152,50.81
Kennen,Viego,513,261,252,50.88
Kennen,Irelia,323,153,170,47.37
Kennen,Varus,319,183,136,57.37
Kennen,Lulu,473,258,215,54.55
Kennen,Kayn,363,174,189,47.93
Kennen,Vayne,415,193,222,46.51
Kennen,Urgot,183,87,96,47.54
Kennen,Ahri,413,212,201,51.33
Kennen,Blitzcrank,251,125,126,49.8
Kennen,Corki,155,112,43,72.26
Kennen,Malzahar,314,144,170,45.86
Kennen,Ashe,600,282,318,47
Kennen,Ivern,36,19,17,52.78
Kennen,Zed,392,177,215,45.15
Kennen,Pantheon,512,256,256,50
Kennen,Warwick,369,168,201,45.53
Kennen,Orianna,167,80,87,47.9
Kennen,Xayah,165,90,75,54.55
Kennen,Milio,162,87,75,53.7
Kennen,Sett,449,213,236,47.44
Kennen,Nocturne,401,205,196,51.12
Kennen,Zilean,118,30,88,25.42
Kennen,FiddleSticks,166,94,72,56.63
Kennen,Sion,234,124,110,52.99
Kennen,Senna,195,124,71,63.59
Kennen,Viktor,315,150,165,47.62
Kennen,KogMaw,83,45,38,54.22
Kennen,Akali,352,179,173,50.85
Kennen,Malphite,312,150,162,48.08
Kennen,Heimerdinger,144,83,61,57.64
Kennen,MasterYi,344,169,175,49.13
Kennen,Ezreal,796,390,406,48.99
Kennen,LeeSin,512,292,220,57.03
Kennen,Shaco,255,147,108,57.65
Kennen,Karma,416,210,206,50.48
Kennen,Naafiri,105,58,47,55.24
Kennen,Zyra,298,160,138,53.69
Kennen,Sylas,576,260,316,45.14
Kennen,Alistar,174,85,89,48.85
Kennen,Twitch,296,151,145,51.01
Kennen,Annie,74,30,44,40.54
Kennen,Pyke,221,107,114,48.42
Kennen,Renata,63,27,36,42.86
Kennen,MonkeyKing,209,117,92,55.98
Kennen,Vex,100,47,53,47
Kennen,Evelynn,105,42,63,40
Kennen,Vi,282,154,128,54.61
Kennen,Trundle,141,75,66,53.19
Kennen,Sona,95,52,43,54.74
Kennen,Khazix,191,99,92,51.83
Kennen,Chogath,377,178,199,47.21
Kennen,Karthus,140,47,93,33.57
Kennen,Kled,43,21,22,48.84
Kennen,Kaisa,546,300,246,54.95
Kennen,JarvanIV,198,88,110,44.44
Kennen,Maokai,152,64,88,42.11
Kennen,RekSai,39,16,23,41.03
Kennen,Lucian,213,109,104,51.17
Kennen,Talon,196,88,108,44.9
Kennen,Poppy,182,109,73,59.89
Kennen,Neeko,168,108,60,64.29
Kennen,Yuumi,233,99,134,42.49
Kennen,Riven,205,98,107,47.8
Kennen,Mel,605,309,296,51.07
Kennen,Cassiopeia,93,56,37,60.22
Kennen,Elise,299,138,161,46.15
Kennen,Tryndamere,143,70,73,48.95
Kennen,TwistedFate,81,52,29,64.2
Kennen,Morgana,298,151,147,50.67
Kennen,Gwen,104,57,47,54.81
Kennen,Rengar,95,48,47,50.53
Kennen,Galio,266,129,137,48.5
Kennen,DrMundo,186,68,118,36.56
Kennen,Nautilus,321,172,149,53.58
Kennen,Gragas,187,107,80,57.22
Kennen,XinZhao,188,113,75,60.11
Kennen,Taric,68,35,33,51.47
Kennen,KSante,101,70,31,69.31
Kennen,Lissandra,110,71,39,64.55
Kennen,Janna,148,67,81,45.27
Kennen,Aatrox,355,185,170,52.11
Kennen,Udyr,105,50,55,47.62
Kennen,Aphelios,154,66,88,42.86
Kennen,Tristana,293,150,143,51.19
Kennen,Ambessa,217,125,92,57.6
Kennen,Hecarim,128,49,79,38.28
Kennen,Olaf,48,25,23,52.08
Kennen,Lillia,165,93,72,56.36
Kennen,Zeri,121,64,57,52.89
Kennen,Rakan,114,57,57,50
Kennen,Azir,91,48,43,52.75
Kennen,Zoe,115,62,53,53.91
Kennen,Syndra,197,106,91,53.81
Kennen,Braum,190,86,104,45.26
Kennen,Shen,167,64,103,38.32
Kennen,Anivia,112,69,43,61.61
Kennen,Ziggs,113,58,55,51.33
Kennen,Quinn,103,48,55,46.6
Kennen,Camille,80,42,38,52.5
Kennen,Nidalee,99,58,41,58.59
Kennen,Singed,64,40,24,62.5
Kennen,Ornn,117,47,70,40.17
Kennen,Skarner,84,46,38,54.76
Kennen,Xerath,265,138,127,52.08
Kennen,Illaoi,97,51,46,52.58
Kennen,Zac,163,67,96,41.1
Kennen,Nilah,69,40,29,57.97
Kennen,Velkoz,152,73,79,48.03
Kennen,AurelionSol,84,51,33,60.71
Kennen,Qiyana,62,31,31,50
Kennen,Kassadin,41,15,26,36.59
Kennen,Kalista,89,52,37,58.43
Kennen,Leona,220,126,94,57.27
Kennen,Leblanc,215,84,131,39.07
Kennen,Bard,87,29,58,33.33
Kennen,Nunu,133,70,63,52.63
Kennen,Belveth,55,32,23,58.18
Kennen,Sivir,173,83,90,47.98
Kennen,Shyvana,69,37,32,53.62
Kennen,Akshan,89,37,52,41.57
Kennen,Fiora,84,41,43,48.81
Kennen,Taliyah,64,32,32,50
Fiora,Irelia,390,204,186,52.31
Fiora,Diana,678,291,387,42.92
Fiora,Fizz,233,116,117,49.79
Fiora,Vayne,491,206,285,41.96
Fiora,Yuumi,349,183,166,52.44
Fiora,Garen,676,340,336,50.3
Fiora,Volibear,437,220,217,50.34
Fiora,Yasuo,842,442,400,52.49
Fiora,Mel,861,494,367,57.38
Fiora,Zilean,169,89,80,52.66
Fiora,Renekton,221,113,108,51.13
Fiora,Shyvana,90,53,37,58.89
Fiora,Veigar,348,157,191,45.11
Fiora,MissFortune,910,466,444,51.21
Fiora,Nasus,282,136,146,48.23
Fiora,Zyra,367,186,181,50.68
Fiora,Ashe,951,472,479,49.63
Fiora,Karma,580,263,317,45.34
Fiora,Ekko,425,212,213,49.88
Fiora,Ahri,495,242,253,48.89
Fiora,Thresh,613,298,315,48.61
Fiora,DrMundo,211,116,95,54.98
Fiora,Shaco,425,206,219,48.47
Fiora,Vex,173,74,99,42.77
Fiora,Jinx,1179,534,645,45.29
Fiora,Teemo,405,187,218,46.17
Fiora,Chogath,623,259,364,41.57
Fiora,Lucian,291,171,120,58.76
Fiora,Nami,484,269,215,55.58
Fiora,Shen,261,128,133,49.04
Fiora,Graves,283,129,154,45.58
Fiora,Taliyah,101,42,59,41.58
Fiora,Poppy,247,110,137,44.53
Fiora,Gwen,266,113,153,42.48
Fiora,Akshan,162,78,84,48.15
Fiora,Nunu,227,115,112,50.66
Fiora,Aphelios,248,114,134,45.97
Fiora,Morgana,445,213,232,47.87
Fiora,Kayle,279,110,169,39.43
Fiora,Sejuani,177,95,82,53.67
Fiora,Caitlyn,1074,517,557,48.14
Fiora,Urgot,192,90,102,46.88
Fiora,Viego,574,292,282,50.87
Fiora,Anivia,123,65,58,52.85
Fiora,Riven,268,132,136,49.25
Fiora,Skarner,120,74,46,61.67
Fiora,Tristana,414,208,206,50.24
Fiora,Swain,393,216,177,54.96
Fiora,Ambessa,256,136,120,53.13
Fiora,Zoe,188,104,84,55.32
Fiora,Maokai,192,120,72,62.5
Fiora,Sett,660,274,386,41.52
Fiora,Warwick,615,296,319,48.13
Fiora,Twitch,369,155,214,42.01
Fiora,Blitzcrank,247,153,94,61.94
Fiora,Yone,816,456,360,55.88
Fiora,Zeri,173,84,89,48.55
Fiora,Singed,106,73,33,68.87
Fiora,Vi,409,199,210,48.66
Fiora,Talon,270,170,100,62.96
Fiora,Katarina,322,142,180,44.1
Fiora,Pyke,344,194,150,56.4
Fiora,Yorick,404,178,226,44.06
Fiora,Ezreal,1051,542,509,51.57
Fiora,Darius,706,338,368,47.88
Fiora,Lux,1004,471,533,46.91
Fiora,Amumu,422,220,202,52.13
Fiora,LeeSin,645,301,344,46.67
Fiora,Kayn,639,325,314,50.86
Fiora,Viktor,438,237,201,54.11
Fiora,Pantheon,717,329,388,45.89
Fiora,Malzahar,405,187,218,46.17
Fiora,Rammus,142,80,62,56.34
Fiora,MasterYi,481,211,270,43.87
Fiora,Zac,237,108,129,45.57
Fiora,Gragas,221,117,104,52.94
Fiora,Varus,360,167,193,46.39
Fiora,Sylas,553,279,274,50.45
Fiora,Nocturne,528,265,263,50.19
Fiora,Aurora,328,174,154,53.05
Fiora,Kaisa,691,377,314,54.56
Fiora,TahmKench,333,181,152,54.35
Fiora,Velkoz,263,121,142,46.01
Fiora,Nautilus,500,269,231,53.8
Fiora,Trundle,218,125,93,57.34
Fiora,Neeko,153,68,85,44.44
Fiora,Galio,414,241,173,58.21
Fiora,MonkeyKing,329,166,163,50.46
Fiora,Samira,285,143,142,50.18
Fiora,Alistar,140,65,75,46.43
Fiora,Qiyana,136,66,70,48.53
Fiora,Malphite,338,121,217,35.8
Fiora,Syndra,285,165,120,57.89
Fiora,Corki,158,65,93,41.14
Fiora,Bard,168,94,74,55.95
Fiora,Braum,299,145,154,48.49
Fiora,Leona,374,155,219,41.44
Fiora,Lulu,576,252,324,43.75
Fiora,Draven,213,132,81,61.97
Fiora,Camille,220,121,99,55
Fiora,TwistedFate,128,84,44,65.63
Fiora,Lillia,226,102,124,45.13
Fiora,AurelionSol,146,68,78,46.58
Fiora,Heimerdinger,160,58,102,36.25
Fiora,Cassiopeia,114,64,50,56.14
Fiora,Jhin,912,468,444,51.32
Fiora,Vladimir,296,135,161,45.61
Fiora,Sivir,220,121,99,55
Fiora,Rengar,124,74,50,59.68
Fiora,Aatrox,452,205,247,45.35
Fiora,Evelynn,152,73,79,48.03
Fiora,Kassadin,60,37,23,61.67
Fiora,Xerath,389,200,189,51.41
Fiora,Brand,273,126,147,46.15
Fiora,Ornn,257,134,123,52.14
Fiora,Hecarim,175,84,91,48
Fiora,Taric,78,34,44,43.59
Fiora,Azir,176,79,97,44.89
Fiora,Kalista,82,50,32,60.98
Fiora,Akali,448,222,226,49.55
Fiora,Ziggs,174,84,90,48.28
Fiora,Milio,258,121,137,46.9
Fiora,Gangplank,196,100,96,51.02
Fiora,Zed,508,268,240,52.76
Fiora,Rakan,186,82,104,44.09
Fiora,Kled,74,38,36,51.35
Fiora,Khazix,217,121,96,55.76
Fiora,Orianna,140,58,82,41.43
Fiora,Soraka,259,145,114,55.98
Fiora,KSante,246,132,114,53.66
Fiora,Rell,193,84,109,43.52
Fiora,Annie,164,82,82,50
Fiora,Mordekaiser,656,360,296,54.88
Fiora,Elise,292,162,130,55.48
Fiora,KogMaw,133,57,76,42.86
Fiora,Jax,435,244,191,56.09
Fiora,Senna,321,166,155,51.71
Fiora,XinZhao,222,94,128,42.34
Fiora,Smolder,221,124,97,56.11
Fiora,Tryndamere,221,138,83,62.44
Fiora,FiddleSticks,193,95,98,49.22
Fiora,Xayah,139,68,71,48.92
Fiora,Briar,315,164,151,52.06
Fiora,Sona,135,68,67,50.37
Fiora,Hwei,292,156,136,53.42
Fiora,Illaoi,169,84,85,49.7
Fiora,Renata,78,43,35,55.13
Fiora,Lissandra,123,55,68,44.72
Fiora,Seraphine,303,153,150,50.5
Fiora,Nilah,130,64,66,49.23
Fiora,JarvanIV,200,114,86,57
Fiora,Karthus,148,64,84,43.24
Fiora,Naafiri,132,53,79,40.15
Fiora,Ryze,151,80,71,52.98
Fiora,Kindred,171,73,98,42.69
Fiora,Janna,151,83,68,54.97
Fiora,Sion,394,212,182,53.81
Fiora,Olaf,72,26,46,36.11
Fiora,Jayce,200,92,108,46
Fiora,Ivern,50,25,25,50
Fiora,Udyr,159,82,77,51.57
Fiora,Quinn,126,48,78,38.1
Fiora,RekSai,63,36,27,57.14
Fiora,Belveth,112,61,51,54.46
Fiora,Rumble,147,82,65,55.78
Fiora,Nidalee,125,75,50,60
Fiora,Leblanc,270,145,125,53.7
Fiora,Gnar,145,86,59,59.31
Fiora,Kennen,84,43,41,51.19
Rumble,Garen,433,245,188,56.58
Rumble,Diana,566,266,300,47
Rumble,Vladimir,284,158,126,55.63
Rumble,Caitlyn,837,415,422,49.58
Rumble,Lulu,516,273,243,52.91
Rumble,Pantheon,541,276,265,51.02
Rumble,Mel,603,307,296,50.91
Rumble,Ezreal,1103,492,611,44.61
Rumble,Teemo,460,206,254,44.78
Rumble,Singed,78,26,52,33.33
Rumble,Evelynn,135,47,88,34.81
Rumble,Yone,681,333,348,48.9
Rumble,Nami,294,138,156,46.94
Rumble,Nidalee,145,52,93,35.86
Rumble,Akali,376,205,171,54.52
Rumble,Morgana,346,141,205,40.75
Rumble,Yasuo,684,293,391,42.84
Rumble,Kayn,475,209,266,44
Rumble,Lux,713,352,361,49.37
Rumble,Kennen,99,40,59,40.4
Rumble,Khazix,169,92,77,54.44
Rumble,Veigar,266,113,153,42.48
Rumble,Ashe,670,316,354,47.16
Rumble,Senna,215,108,107,50.23
Rumble,Azir,101,59,42,58.42
Rumble,Warwick,431,179,252,41.53
Rumble,Leblanc,243,139,104,57.2
Rumble,Malphite,314,148,166,47.13
Rumble,Gangplank,168,87,81,51.79
Rumble,Camille,81,32,49,39.51
Rumble,Swain,244,130,114,53.28
Rumble,DrMundo,196,95,101,48.47
Rumble,Ahri,421,222,199,52.73
Rumble,Elise,288,138,150,47.92
Rumble,Shen,174,91,83,52.3
Rumble,Vi,381,225,156,59.06
Rumble,Kaisa,584,295,289,50.51
Rumble,Galio,371,177,194,47.71
Rumble,Qiyana,79,48,31,60.76
Rumble,Hecarim,152,81,71,53.29
Rumble,Jinx,946,401,545,42.39
Rumble,Braum,204,88,116,43.14
Rumble,Talon,256,124,132,48.44
Rumble,Draven,144,82,62,56.94
Rumble,Zyra,405,221,184,54.57
Rumble,Volibear,268,142,126,52.99
Rumble,Graves,227,116,111,51.1
Rumble,Rammus,103,59,44,57.28
Rumble,Ambessa,208,99,109,47.6
Rumble,Katarina,255,120,135,47.06
Rumble,Vayne,357,193,164,54.06
Rumble,Heimerdinger,172,74,98,43.02
Rumble,Jhin,721,361,360,50.07
Rumble,Karma,531,240,291,45.2
Rumble,Rakan,153,73,80,47.71
Rumble,Mordekaiser,384,159,225,41.41
Rumble,LeeSin,680,341,339,50.15
Rumble,Viktor,300,147,153,49
Rumble,Velkoz,178,75,103,42.13
Rumble,Ekko,302,143,159,47.35
Rumble,Zed,369,176,193,47.7
Rumble,Tristana,329,151,178,45.9
Rumble,Gnar,172,75,97,43.6
Rumble,MasterYi,329,152,177,46.2
Rumble,Ziggs,115,40,75,34.78
Rumble,Milio,170,84,86,49.41
Rumble,MissFortune,697,370,327,53.08
Rumble,Nautilus,349,180,169,51.58
Rumble,Jax,286,121,165,42.31
Rumble,Shaco,355,176,179,49.58
Rumble,Brand,198,94,104,47.47
Rumble,Maokai,158,77,81,48.73
Rumble,Sett,512,251,261,49.02
Rumble,Fizz,154,90,64,58.44
Rumble,Alistar,157,64,93,40.76
Rumble,Irelia,360,158,202,43.89
Rumble,Annie,162,83,79,51.23
Rumble,Blitzcrank,271,134,137,49.45
Rumble,Aatrox,372,210,162,56.45
Rumble,Viego,504,247,257,49.01
Rumble,Aurora,259,122,137,47.1
Rumble,TahmKench,256,127,129,49.61
Rumble,Nocturne,385,177,208,45.97
Rumble,Kassadin,62,29,33,46.77
Rumble,Anivia,112,43,69,38.39
Rumble,Soraka,161,94,67,58.39
Rumble,Kled,75,25,50,33.33
Rumble,Gragas,189,86,103,45.5
Rumble,Riven,183,90,93,49.18
Rumble,Chogath,316,151,165,47.78
Rumble,Trundle,109,60,49,55.05
Rumble,Tryndamere,115,39,76,33.91
Rumble,AurelionSol,91,44,47,48.35
Rumble,Lucian,240,139,101,57.92
Rumble,Pyke,293,149,144,50.85
Rumble,Syndra,197,115,82,58.38
Rumble,Orianna,156,55,101,35.26
Rumble,Twitch,220,119,101,54.09
Rumble,Zilean,115,37,78,32.17
Rumble,Malzahar,292,133,159,45.55
Rumble,Rengar,105,49,56,46.67
Rumble,Poppy,259,124,135,47.88
Rumble,Darius,526,218,308,41.44
Rumble,Hwei,245,126,119,51.43
Rumble,Sivir,173,68,105,39.31
Rumble,Sion,242,110,132,45.45
Rumble,Xerath,324,126,198,38.89
Rumble,Quinn,92,40,52,43.48
Rumble,Nasus,197,103,94,52.28
Rumble,Kindred,150,62,88,41.33
Rumble,Jayce,267,120,147,44.94
Rumble,Leona,315,148,167,46.98
Rumble,Akshan,88,45,43,51.14
Rumble,Samira,189,98,91,51.85
Rumble,Cassiopeia,81,32,49,39.51
Rumble,Varus,336,162,174,48.21
Rumble,Zac,196,112,84,57.14
Rumble,Sejuani,86,41,45,47.67
Rumble,Kayle,172,75,97,43.6
Rumble,Smolder,182,83,99,45.6
Rumble,Sylas,590,314,276,53.22
Rumble,Ornn,108,48,60,44.44
Rumble,Zoe,167,73,94,43.71
Rumble,Amumu,321,176,145,54.83
Rumble,Urgot,140,58,82,41.43
Rumble,Skarner,87,49,38,56.32
Rumble,Seraphine,167,78,89,46.71
Rumble,Karthus,128,51,77,39.84
Rumble,Yuumi,228,117,111,51.32
Rumble,KogMaw,115,46,69,40
Rumble,Thresh,423,192,231,45.39
Rumble,JarvanIV,215,83,132,38.6
Rumble,Neeko,113,37,76,32.74
Rumble,Yorick,220,90,130,40.91
Rumble,Taliyah,107,39,68,36.45
Rumble,Ryze,108,44,64,40.74
Rumble,Naafiri,84,34,50,40.48
Rumble,Zeri,161,88,73,54.66
Rumble,Nunu,150,79,71,52.67
Rumble,Ivern,39,22,17,56.41
Rumble,Aphelios,159,90,69,56.6
Rumble,Bard,115,40,75,34.78
Rumble,XinZhao,222,112,110,50.45
Rumble,Gwen,142,68,74,47.89
Rumble,Xayah,185,65,120,35.14
Rumble,Udyr,107,51,56,47.66
Rumble,Renekton,135,81,54,60
Rumble,FiddleSticks,148,55,93,37.16
Rumble,MonkeyKing,204,91,113,44.61
Rumble,Briar,197,85,112,43.15
Rumble,Vex,151,63,88,41.72
Rumble,Lillia,180,102,78,56.67
Rumble,Lissandra,88,44,44,50
Rumble,Shyvana,83,40,43,48.19
Rumble,Belveth,91,47,44,51.65
Rumble,Renata,50,23,27,46
Rumble,Fiora,147,65,82,44.22
Rumble,Janna,103,40,63,38.83
Rumble,Taric,66,26,40,39.39
Rumble,TwistedFate,124,61,63,49.19
Rumble,Olaf,157,78,79,49.68
Rumble,KSante,223,99,124,44.39
Rumble,Kalista,73,34,39,46.58
Rumble,Illaoi,146,81,65,55.48
Rumble,Sona,95,42,53,44.21
Rumble,Corki,159,76,83,47.8
Rumble,Nilah,55,29,26,52.73
Rumble,Rell,199,86,113,43.22
Rumble,RekSai,44,27,17,61.36
Akshan,Garen,607,331,276,54.53
Akshan,Diana,586,277,309,47.27
Akshan,Vladimir,294,122,172,41.5
Akshan,Caitlyn,1085,509,576,46.91
Akshan,Lulu,503,239,264,47.51
Akshan,Darius,843,419,424,49.7
Akshan,Sejuani,152,80,72,52.63
Akshan,Yone,702,355,347,50.57
Akshan,Ezreal,911,477,434,52.36
Akshan,Milio,237,99,138,41.77
Akshan,Sett,618,281,337,45.47
Akshan,Evelynn,140,66,74,47.14
Akshan,Ashe,765,372,393,48.63
Akshan,Pantheon,651,292,359,44.85
Akshan,KSante,134,82,52,61.19
Akshan,Nunu,225,110,115,48.89
Akshan,Sylas,498,265,233,53.21
Akshan,Tristana,476,219,257,46.01
Akshan,Warwick,616,302,314,49.03
Akshan,Ryze,142,73,69,51.41
Akshan,Mordekaiser,473,222,251,46.93
Akshan,Yasuo,662,319,343,48.19
Akshan,Jinx,1223,625,598,51.1
Akshan,Soraka,263,138,125,52.47
Akshan,Kayle,311,166,145,53.38
Akshan,Rengar,153,75,78,49.02
Akshan,Malzahar,482,225,257,46.68
Akshan,Vayne,643,317,326,49.3
Akshan,LeeSin,514,249,265,48.44
Akshan,Ahri,644,306,338,47.52
Akshan,Smolder,275,143,132,52
Akshan,Karma,508,225,283,44.29
Akshan,Fiora,162,84,78,51.85
Akshan,Yorick,462,212,250,45.89
Akshan,Katarina,292,161,131,55.14
Akshan,Kalista,93,58,35,62.37
Akshan,Poppy,224,113,111,50.45
Akshan,Chogath,549,249,300,45.36
Akshan,Shaco,406,200,206,49.26
Akshan,Rakan,160,81,79,50.63
Akshan,Teemo,563,286,277,50.8
Akshan,Ekko,424,207,217,48.82
Akshan,TwistedFate,145,77,68,53.1
Akshan,Leblanc,211,94,117,44.55
Akshan,Brand,310,141,169,45.48
Akshan,Olaf,106,39,67,36.79
Akshan,AurelionSol,161,74,87,45.96
Akshan,Xerath,336,162,174,48.21
Akshan,Lucian,268,160,108,59.7
Akshan,Nami,497,242,255,48.69
Akshan,Khazix,243,140,103,57.61
Akshan,Jhin,848,404,444,47.64
Akshan,Shen,235,98,137,41.7
Akshan,Naafiri,151,78,73,51.66
Akshan,Lux,1080,553,527,51.2
Akshan,Irelia,315,137,178,43.49
Akshan,Syndra,267,128,139,47.94
Akshan,Yuumi,345,160,185,46.38
Akshan,Tryndamere,256,137,119,53.52
Akshan,Vi,366,186,180,50.82
Akshan,Sivir,206,90,116,43.69
Akshan,Sona,132,61,71,46.21
Akshan,Riven,170,90,80,52.94
Akshan,Lillia,209,104,105,49.76
Akshan,Aurora,349,178,171,51
Akshan,Aatrox,383,194,189,50.65
Akshan,Ivern,60,30,30,50
Akshan,Corki,185,109,76,58.92
Akshan,Pyke,288,127,161,44.1
Akshan,JarvanIV,245,104,141,42.45
Akshan,Vex,236,102,134,43.22
Akshan,Talon,247,103,144,41.7
Akshan,Kassadin,82,44,38,53.66
Akshan,Briar,308,164,144,53.25
Akshan,Seraphine,313,146,167,46.65
Akshan,Gangplank,218,108,110,49.54
Akshan,MonkeyKing,281,150,131,53.38
Akshan,Fizz,237,119,118,50.21
Akshan,Kaisa,582,297,285,51.03
Akshan,Nautilus,403,198,205,49.13
Akshan,Volibear,488,262,226,53.69
Akshan,Kindred,180,85,95,47.22
Akshan,Draven,236,116,120,49.15
Akshan,Leona,352,183,169,51.99
Akshan,Malphite,520,249,271,47.88
Akshan,MissFortune,1006,500,506,49.7
Akshan,DrMundo,240,122,118,50.83
Akshan,Karthus,120,54,66,45
Akshan,RekSai,26,16,10,61.54
Akshan,Samira,298,136,162,45.64
Akshan,Rumble,88,43,45,48.86
Akshan,Udyr,183,61,122,33.33
Akshan,Veigar,409,187,222,45.72
Akshan,Hwei,266,158,108,59.4
Akshan,Zyra,329,166,163,50.46
Akshan,Zac,195,114,81,58.46
Akshan,Graves,245,121,124,49.39
Akshan,Kayn,650,355,295,54.62
Akshan,TahmKench,340,195,145,57.35
Akshan,Thresh,478,227,251,47.49
Akshan,Belveth,107,74,33,69.16
Akshan,Annie,119,50,69,42.02
Akshan,Blitzcrank,274,146,128,53.28
Akshan,MasterYi,511,290,221,56.75
Akshan,Morgana,485,258,227,53.2
Akshan,Viego,679,347,332,51.1
Akshan,Aphelios,258,135,123,52.33
Akshan,Jayce,218,90,128,41.28
Akshan,Hecarim,180,78,102,43.33
Akshan,Nilah,135,57,78,42.22
Akshan,Rell,183,97,86,53.01
Akshan,Urgot,213,98,115,46.01
Akshan,FiddleSticks,186,78,108,41.94
Akshan,Mel,822,442,380,53.77
Akshan,Heimerdinger,177,91,86,51.41
Akshan,Velkoz,237,142,95,59.92
Akshan,Ornn,155,63,92,40.65
Akshan,Akali,442,258,184,58.37
Akshan,Trundle,239,90,149,37.66
Akshan,Maokai,166,85,81,51.2
Akshan,Nocturne,527,227,300,43.07
Akshan,Swain,409,201,208,49.14
Akshan,Gragas,188,105,83,55.85
Akshan,Neeko,189,90,99,47.62
Akshan,Zeri,181,102,79,56.35
Akshan,Taric,94,48,46,51.06
Akshan,Gwen,176,98,78,55.68
Akshan,Ziggs,141,72,69,51.06
Akshan,Galio,265,128,137,48.3
Akshan,Xayah,121,45,76,37.19
Akshan,Alistar,126,59,67,46.83
Akshan,Illaoi,171,110,61,64.33
Akshan,Azir,138,77,61,55.8
Akshan,Zed,487,282,205,57.91
Akshan,Renekton,191,95,96,49.74
Akshan,Qiyana,123,66,57,53.66
Akshan,Senna,301,170,131,56.48
Akshan,Renata,88,36,52,40.91
Akshan,Rammus,127,73,54,57.48
Akshan,Singed,117,50,67,42.74
Akshan,Twitch,333,172,161,51.65
Akshan,Ambessa,267,127,140,47.57
Akshan,Zilean,125,71,54,56.8
Akshan,Taliyah,145,64,81,44.14
Akshan,Nasus,272,124,148,45.59
Akshan,Orianna,175,91,84,52
Akshan,Sion,298,108,190,36.24
Akshan,Elise,261,121,140,46.36
Akshan,Quinn,153,92,61,60.13
Akshan,Gnar,167,86,81,51.5
Akshan,Janna,163,59,104,36.2
Akshan,Varus,392,192,200,48.98
Akshan,Viktor,359,174,185,48.47
Akshan,Amumu,444,192,252,43.24
Akshan,Shyvana,95,57,38,60
Akshan,Camille,122,56,66,45.9
Akshan,Jax,388,200,188,51.55
Akshan,Anivia,139,69,70,49.64
Akshan,Skarner,125,61,64,48.8
Akshan,Lissandra,138,71,67,51.45
Akshan,Braum,265,118,147,44.53
Akshan,XinZhao,241,99,142,41.08
Akshan,Cassiopeia,120,48,72,40
Akshan,Bard,157,79,78,50.32
Akshan,KogMaw,143,66,77,46.15
Akshan,Zoe,211,112,99,53.08
Akshan,Kennen,89,52,37,58.43
Akshan,Kled,60,27,33,45
Akshan,Nidalee,83,55,28,66.27
TwistedFate,Jax,424,207,217,48.82
TwistedFate,Viego,635,294,341,46.3
TwistedFate,Aurora,350,172,178,49.14
TwistedFate,Vayne,504,238,266,47.22
TwistedFate,Lux,1012,457,555,45.16
TwistedFate,Malphite,344,161,183,46.8
TwistedFate,MasterYi,465,224,241,48.17
TwistedFate,Syndra,281,129,152,45.91
TwistedFate,Corki,202,120,82,59.41
TwistedFate,Soraka,227,114,113,50.22
TwistedFate,Aatrox,433,195,238,45.03
TwistedFate,Rengar,123,80,43,65.04
TwistedFate,Ezreal,1081,511,570,47.27
TwistedFate,Caitlyn,1171,559,612,47.74
TwistedFate,Neeko,172,96,76,55.81
TwistedFate,Teemo,478,201,277,42.05
TwistedFate,Skarner,97,52,45,53.61
TwistedFate,Yone,749,320,429,42.72
TwistedFate,Varus,377,182,195,48.28
TwistedFate,Blitzcrank,312,152,160,48.72
TwistedFate,Amumu,452,200,252,44.25
TwistedFate,Hwei,315,158,157,50.16
TwistedFate,Brand,328,183,145,55.79
TwistedFate,Gangplank,259,144,115,55.6
TwistedFate,Lillia,198,93,105,46.97
TwistedFate,Naafiri,114,36,78,31.58
TwistedFate,Karma,511,242,269,47.36
TwistedFate,Poppy,295,146,149,49.49
TwistedFate,Azir,168,81,87,48.21
TwistedFate,Karthus,152,88,64,57.89
TwistedFate,Seraphine,322,148,174,45.96
TwistedFate,Yorick,413,174,239,42.13
TwistedFate,Sejuani,164,79,85,48.17
TwistedFate,Samira,246,124,122,50.41
TwistedFate,Rell,201,73,128,36.32
TwistedFate,Ekko,368,187,181,50.82
TwistedFate,Ashe,861,400,461,46.46
TwistedFate,Maokai,141,67,74,47.52
TwistedFate,Kayle,322,135,187,41.93
TwistedFate,Mel,665,349,316,52.48
TwistedFate,Nami,458,199,259,43.45
TwistedFate,JarvanIV,296,141,155,47.64
TwistedFate,Malzahar,535,266,269,49.72
TwistedFate,KogMaw,99,36,63,36.36
TwistedFate,Thresh,621,329,292,52.98
TwistedFate,KSante,208,121,87,58.17
TwistedFate,Kayn,582,289,293,49.66
TwistedFate,Katarina,302,179,123,59.27
TwistedFate,Lulu,635,330,305,51.97
TwistedFate,Renekton,213,97,116,45.54
TwistedFate,Briar,282,128,154,45.39
TwistedFate,Zed,485,256,229,52.78
TwistedFate,Kindred,179,97,82,54.19
TwistedFate,Sett,571,286,285,50.09
TwistedFate,Pantheon,627,294,333,46.89
TwistedFate,Diana,695,303,392,43.6
TwistedFate,Jinx,1190,522,668,43.87
TwistedFate,Swain,349,193,156,55.3
TwistedFate,Shyvana,103,62,41,60.19
TwistedFate,Akshan,145,68,77,46.9
TwistedFate,Lucian,308,170,138,55.19
TwistedFate,Gwen,170,87,83,51.18
TwistedFate,Volibear,448,230,218,51.34
TwistedFate,Yasuo,739,368,371,49.8
TwistedFate,Sivir,207,88,119,42.51
TwistedFate,Zilean,148,63,85,42.57
TwistedFate,Xayah,172,80,92,46.51
TwistedFate,Yuumi,312,140,172,44.87
TwistedFate,Nasus,273,130,143,47.62
TwistedFate,Veigar,403,190,213,47.15
TwistedFate,Tristana,405,202,203,49.88
TwistedFate,Zac,216,103,113,47.69
TwistedFate,Akali,443,199,244,44.92
TwistedFate,Warwick,599,292,307,48.75
TwistedFate,Illaoi,199,94,105,47.24
TwistedFate,LeeSin,730,375,355,51.37
TwistedFate,Ambessa,273,150,123,54.95
TwistedFate,Vi,430,205,225,47.67
TwistedFate,Ryze,149,64,85,42.95
TwistedFate,Pyke,348,183,165,52.59
TwistedFate,Twitch,372,182,190,48.92
TwistedFate,Riven,219,116,103,52.97
TwistedFate,FiddleSticks,195,84,111,43.08
TwistedFate,Kaisa,773,396,377,51.23
TwistedFate,Talon,246,121,125,49.19
TwistedFate,Fizz,261,121,140,46.36
TwistedFate,Draven,302,149,153,49.34
TwistedFate,Tryndamere,223,105,118,47.09
TwistedFate,Leona,299,152,147,50.84
TwistedFate,Xerath,401,185,216,46.13
TwistedFate,Kalista,98,55,43,56.12
TwistedFate,Ziggs,165,84,81,50.91
TwistedFate,Darius,692,311,381,44.94
TwistedFate,XinZhao,265,120,145,45.28
TwistedFate,Viktor,450,185,265,41.11
TwistedFate,Ivern,50,18,32,36
TwistedFate,Zyra,415,189,226,45.54
TwistedFate,Renata,90,39,51,43.33
TwistedFate,Vladimir,220,119,101,54.09
TwistedFate,MonkeyKing,264,138,126,52.27
TwistedFate,Fiora,128,44,84,34.38
TwistedFate,Leblanc,239,108,131,45.19
TwistedFate,Gragas,224,110,114,49.11
TwistedFate,Zoe,190,97,93,51.05
TwistedFate,Aphelios,214,122,92,57.01
TwistedFate,Camille,156,85,71,54.49
TwistedFate,Rammus,101,50,51,49.5
TwistedFate,Garen,720,343,377,47.64
TwistedFate,Elise,291,125,166,42.96
TwistedFate,Shaco,427,213,214,49.88
TwistedFate,Ornn,160,64,96,40
TwistedFate,Milio,278,93,185,33.45
TwistedFate,Irelia,333,137,196,41.14
TwistedFate,Udyr,191,89,102,46.6
TwistedFate,Nilah,126,56,70,44.44
TwistedFate,Shen,221,97,124,43.89
TwistedFate,Ahri,603,276,327,45.77
TwistedFate,Chogath,464,214,250,46.12
TwistedFate,Graves,364,185,179,50.82
TwistedFate,Smolder,262,140,122,53.44
TwistedFate,TahmKench,337,164,173,48.66
TwistedFate,Nunu,208,85,123,40.87
TwistedFate,MissFortune,899,409,490,45.49
TwistedFate,Taliyah,144,50,94,34.72
TwistedFate,Kennen,81,29,52,35.8
TwistedFate,DrMundo,188,62,126,32.98
TwistedFate,Urgot,224,116,108,51.79
TwistedFate,Mordekaiser,480,247,233,51.46
TwistedFate,Jayce,225,106,119,47.11
TwistedFate,Sylas,642,344,298,53.58
TwistedFate,Braum,238,138,100,57.98
TwistedFate,Alistar,163,68,95,41.72
TwistedFate,Annie,157,84,73,53.5
TwistedFate,Singed,101,42,59,41.58
TwistedFate,Morgana,436,202,234,46.33
TwistedFate,Jhin,980,416,564,42.45
TwistedFate,Sona,151,78,73,51.66
TwistedFate,Gnar,196,103,93,52.55
TwistedFate,Olaf,105,55,50,52.38
TwistedFate,Sion,297,100,197,33.67
TwistedFate,Trundle,260,134,126,51.54
TwistedFate,Kassadin,106,59,47,55.66
TwistedFate,Velkoz,220,89,131,40.45
TwistedFate,Qiyana,93,58,35,62.37
TwistedFate,Zeri,186,73,113,39.25
TwistedFate,Hecarim,181,76,105,41.99
TwistedFate,Nidalee,154,67,87,43.51
TwistedFate,Nautilus,441,205,236,46.49
TwistedFate,Evelynn,162,82,80,50.62
TwistedFate,Bard,131,71,60,54.2
TwistedFate,Vex,162,77,85,47.53
TwistedFate,Rakan,156,72,84,46.15
TwistedFate,Orianna,185,105,80,56.76
TwistedFate,Nocturne,515,211,304,40.97
TwistedFate,Janna,143,66,77,46.15
TwistedFate,Quinn,222,130,92,58.56
TwistedFate,Senna,285,160,125,56.14
TwistedFate,Anivia,136,59,77,43.38
TwistedFate,Galio,330,145,185,43.94
TwistedFate,AurelionSol,151,65,86,43.05
TwistedFate,Heimerdinger,157,56,101,35.67
TwistedFate,Cassiopeia,126,56,70,44.44
TwistedFate,Lissandra,151,62,89,41.06
TwistedFate,Rumble,124,63,61,50.81
TwistedFate,Belveth,75,35,40,46.67
TwistedFate,Taric,107,50,57,46.73
TwistedFate,Khazix,244,122,122,50
TwistedFate,Kled,90,41,49,45.56
TwistedFate,RekSai,54,31,23,57.41
TahmKench,Garen,1552,770,782,49.61
TahmKench,Graves,501,246,255,49.1
TahmKench,Malzahar,1025,452,573,44.1
TahmKench,Lucian,669,359,310,53.66
TahmKench,Lux,2439,1248,1191,51.17
TahmKench,Vex,391,190,201,48.59
TahmKench,Kayn,1309,614,695,46.91
TahmKench,Darius,1701,812,889,47.74
TahmKench,Ezreal,1799,904,895,50.25
TahmKench,Janna,309,167,142,54.05
TahmKench,Kayle,559,258,301,46.15
TahmKench,Ekko,884,412,472,46.61
TahmKench,Veigar,1049,501,548,47.76
TahmKench,Ziggs,315,153,162,48.57
TahmKench,Malphite,893,467,426,52.3
TahmKench,Shaco,810,358,452,44.2
TahmKench,Pantheon,1353,674,679,49.82
TahmKench,Jinx,2502,1146,1356,45.8
TahmKench,Lulu,885,419,466,47.34
TahmKench,Yasuo,1815,809,1006,44.57
TahmKench,Caitlyn,2453,1187,1266,48.39
TahmKench,Seraphine,641,267,374,41.65
TahmKench,Nidalee,198,101,97,51.01
TahmKench,Akali,934,423,511,45.29
TahmKench,Morgana,1165,522,643,44.81
TahmKench,Evelynn,367,162,205,44.14
TahmKench,Corki,271,139,132,51.29
TahmKench,Milio,465,193,272,41.51
TahmKench,Chogath,1199,572,627,47.71
TahmKench,RekSai,69,37,32,53.62
TahmKench,Katarina,655,290,365,44.27
TahmKench,Vayne,1401,636,765,45.4
TahmKench,Yorick,914,408,506,44.64
TahmKench,Udyr,361,177,184,49.03
TahmKench,Jhin,1743,869,874,49.86
TahmKench,Camille,260,127,133,48.85
TahmKench,Tristana,924,463,461,50.11
TahmKench,Thresh,1233,577,656,46.8
TahmKench,Riven,372,169,203,45.43
TahmKench,Nunu,453,208,245,45.92
TahmKench,Mel,1825,917,908,50.25
TahmKench,Nilah,289,136,153,47.06
TahmKench,Zoe,280,145,135,51.79
TahmKench,Khazix,391,180,211,46.04
TahmKench,Sejuani,336,169,167,50.3
TahmKench,Poppy,527,250,277,47.44
TahmKench,Diana,1373,659,714,48
TahmKench,Talon,499,278,221,55.71
TahmKench,Zilean,248,112,136,45.16
TahmKench,Illaoi,485,237,248,48.87
TahmKench,Briar,666,325,341,48.8
TahmKench,Nami,850,396,454,46.59
TahmKench,Yone,1592,839,753,52.7
TahmKench,Irelia,713,373,340,52.31
TahmKench,Warwick,1473,667,806,45.28
TahmKench,Smolder,560,282,278,50.36
TahmKench,Swain,904,420,484,46.46
TahmKench,Zyra,827,362,465,43.77
TahmKench,Jax,717,354,363,49.37
TahmKench,Zed,1072,537,535,50.09
TahmKench,Soraka,441,212,229,48.07
TahmKench,Karthus,239,131,108,54.81
TahmKench,Naafiri,314,149,165,47.45
TahmKench,Maokai,407,195,212,47.91
TahmKench,Draven,468,217,251,46.37
TahmKench,Rakan,302,127,175,42.05
TahmKench,Vi,777,364,413,46.85
TahmKench,Ahri,1165,591,574,50.73
TahmKench,Ashe,1746,915,831,52.41
TahmKench,Zeri,309,142,167,45.95
TahmKench,Leona,827,426,401,51.51
TahmKench,Singed,238,113,125,47.48
TahmKench,MasterYi,1207,605,602,50.12
TahmKench,Neeko,390,206,184,52.82
TahmKench,Braum,485,242,243,49.9
TahmKench,Shen,564,240,324,42.55
TahmKench,Fizz,540,288,252,53.33
TahmKench,Annie,260,97,163,37.31
TahmKench,Teemo,1100,523,577,47.55
TahmKench,Amumu,1092,500,592,45.79
TahmKench,MissFortune,2236,1013,1223,45.3
TahmKench,Leblanc,404,199,205,49.26
TahmKench,Twitch,761,398,363,52.3
TahmKench,Karma,991,480,511,48.44
TahmKench,Aatrox,734,350,384,47.68
TahmKench,Viego,1314,629,685,47.87
TahmKench,Elise,580,325,255,56.03
TahmKench,Hwei,600,285,315,47.5
TahmKench,Gwen,559,279,280,49.91
TahmKench,Viktor,711,365,346,51.34
TahmKench,Sivir,416,196,220,47.12
TahmKench,Velkoz,552,275,277,49.82
TahmKench,Ornn,294,131,163,44.56
TahmKench,Xerath,710,358,352,50.42
TahmKench,Quinn,276,108,168,39.13
TahmKench,Sett,1475,668,807,45.29
TahmKench,Kennen,230,103,127,44.78
TahmKench,KSante,412,184,228,44.66
TahmKench,LeeSin,1084,557,527,51.38
TahmKench,Volibear,1069,515,554,48.18
TahmKench,Sylas,1124,528,596,46.98
TahmKench,Gangplank,349,166,183,47.56
TahmKench,Kaisa,1396,708,688,50.72
TahmKench,Urgot,539,258,281,47.87
TahmKench,Blitzcrank,678,314,364,46.31
TahmKench,Nasus,658,323,335,49.09
TahmKench,Nautilus,1118,530,588,47.41
TahmKench,DrMundo,511,237,274,46.38
TahmKench,Mordekaiser,1407,678,729,48.19
TahmKench,Nocturne,1213,574,639,47.32
TahmKench,FiddleSticks,443,197,246,44.47
TahmKench,KogMaw,275,159,116,57.82
TahmKench,XinZhao,465,205,260,44.09
TahmKench,Bard,233,120,113,51.5
TahmKench,Vladimir,557,308,249,55.3
TahmKench,Kindred,378,203,175,53.7
TahmKench,Kled,133,56,77,42.11
TahmKench,Tryndamere,579,301,278,51.99
TahmKench,Zac,348,161,187,46.26
TahmKench,Jayce,326,156,170,47.85
TahmKench,Gragas,478,259,219,54.18
TahmKench,Anivia,288,127,161,44.1
TahmKench,Varus,818,405,413,49.51
TahmKench,Taric,235,127,108,54.04
TahmKench,Rammus,237,114,123,48.1
TahmKench,Heimerdinger,430,199,231,46.28
TahmKench,Orianna,335,173,162,51.64
TahmKench,MonkeyKing,594,281,313,47.31
TahmKench,Senna,727,363,364,49.93
TahmKench,Fiora,333,152,181,45.65
TahmKench,Lillia,508,252,256,49.61
TahmKench,Galio,681,318,363,46.7
TahmKench,Aurora,541,285,256,52.68
TahmKench,Trundle,657,339,318,51.6
TahmKench,Cassiopeia,270,134,136,49.63
TahmKench,AurelionSol,341,156,185,45.75
TahmKench,Syndra,478,239,239,50
TahmKench,Skarner,201,101,100,50.25
TahmKench,Pyke,635,302,333,47.56
TahmKench,Renekton,412,181,231,43.93
TahmKench,Hecarim,344,181,163,52.62
TahmKench,Samira,625,257,368,41.12
TahmKench,Azir,271,124,147,45.76
TahmKench,Rell,498,236,262,47.39
TahmKench,Rumble,256,129,127,50.39
TahmKench,Ambessa,456,235,221,51.54
TahmKench,Kassadin,157,83,74,52.87
TahmKench,Yuumi,580,310,270,53.45
TahmKench,Ryze,264,111,153,42.05
TahmKench,Aphelios,438,194,244,44.29
TahmKench,Xayah,357,180,177,50.42
TahmKench,Sona,272,136,136,50
TahmKench,Belveth,213,96,117,45.07
TahmKench,Qiyana,187,109,78,58.29
TahmKench,Shyvana,188,108,80,57.45
TahmKench,Alistar,401,188,213,46.88
TahmKench,TwistedFate,337,173,164,51.34
TahmKench,Brand,774,336,438,43.41
TahmKench,Sion,605,279,326,46.12
TahmKench,Akshan,340,145,195,42.65
TahmKench,Kalista,190,115,75,60.53
TahmKench,Lissandra,257,133,124,51.75
TahmKench,Olaf,182,83,99,45.6
TahmKench,Ivern,92,59,33,64.13
TahmKench,Taliyah,176,99,77,56.25
TahmKench,Rengar,264,137,127,51.89
TahmKench,Gnar,395,219,176,55.44
TahmKench,JarvanIV,432,217,215,50.23
TahmKench,Renata,136,69,67,50.74
Graves,TahmKench,501,255,246,50.9
Graves,LeeSin,1951,1031,920,52.84
Graves,Hwei,446,225,221,50.45
Graves,Tristana,703,381,322,54.2
Graves,Karma,1125,551,574,48.98
Graves,Aatrox,821,388,433,47.26
Graves,Kayn,1120,600,520,53.57
Graves,Katarina,567,248,319,43.74
Graves,Draven,402,178,224,44.28
Graves,Blitzcrank,558,310,248,55.56
Graves,Garen,1187,511,676,43.05
Graves,Volibear,738,367,371,49.73
Graves,Yasuo,1471,680,791,46.23
Graves,Mel,1423,712,711,50.04
Graves,Zilean,297,139,158,46.8
Graves,Poppy,437,211,226,48.28
Graves,Warwick,950,474,476,49.89
Graves,Taliyah,219,93,126,42.47
Graves,MissFortune,1635,865,770,52.91
Graves,Morgana,817,410,407,50.18
Graves,Irelia,635,340,295,53.54
Graves,MasterYi,865,449,416,51.91
Graves,Galio,655,331,324,50.53
Graves,Nautilus,905,439,466,48.51
Graves,Yone,1416,743,673,52.47
Graves,Diana,1267,614,653,48.46
Graves,Fizz,447,213,234,47.65
Graves,Rell,384,202,182,52.6
Graves,Swain,706,319,387,45.18
Graves,Kaisa,1463,728,735,49.76
Graves,Darius,1416,676,740,47.74
Graves,Nocturne,953,405,548,42.5
Graves,Samira,496,239,257,48.19
Graves,Lux,1669,868,801,52.01
Graves,Yorick,634,282,352,44.48
Graves,Udyr,296,156,140,52.7
Graves,Malzahar,736,381,355,51.77
Graves,Jhin,1654,861,793,52.06
Graves,Teemo,796,346,450,43.47
Graves,Chogath,917,445,472,48.53
Graves,Varus,774,389,385,50.26
Graves,Jax,821,406,415,49.45
Graves,Vi,713,366,347,51.33
Graves,Ahri,1005,545,460,54.23
Graves,Ashe,1653,793,860,47.97
Graves,Thresh,1199,620,579,51.71
Graves,Urgot,347,201,146,57.93
Graves,Lulu,1157,563,594,48.66
Graves,Kayle,531,270,261,50.85
Graves,Ezreal,2120,1067,1053,50.33
Graves,Akali,805,442,363,54.91
Graves,Mordekaiser,870,434,436,49.89
Graves,Corki,336,151,185,44.94
Graves,Soraka,374,170,204,45.45
Graves,Trundle,360,196,164,54.44
Graves,Kindred,381,214,167,56.17
Graves,Nasus,456,202,254,44.3
Graves,Kennen,192,75,117,39.06
Graves,Janna,258,128,130,49.61
Graves,Fiora,283,154,129,54.42
Graves,Zoe,341,179,162,52.49
Graves,Yuumi,681,305,376,44.79
Graves,Ornn,283,149,134,52.65
Graves,JarvanIV,482,247,235,51.24
Graves,Caitlyn,2043,1010,1033,49.44
Graves,MonkeyKing,585,295,290,50.43
Graves,Talon,591,268,323,45.35
Graves,Twitch,571,314,257,54.99
Graves,Brand,491,262,229,53.36
Graves,Kled,160,85,75,53.13
Graves,Shaco,781,419,362,53.65
Graves,FiddleSticks,385,198,187,51.43
Graves,Kassadin,181,99,82,54.7
Graves,Qiyana,211,128,83,60.66
Graves,Gragas,447,251,196,56.15
Graves,Briar,483,210,273,43.48
Graves,Heimerdinger,268,126,142,47.01
Graves,Pantheon,1177,616,561,52.34
Graves,Viktor,720,390,330,54.17
Graves,Ziggs,269,116,153,43.12
Graves,RekSai,103,56,47,54.37
Graves,Viego,1176,588,588,50
Graves,Cassiopeia,180,96,84,53.33
Graves,Naafiri,215,87,128,40.47
Graves,Vex,343,187,156,54.52
Graves,Ekko,685,302,383,44.09
Graves,Renata,122,54,68,44.26
Graves,Annie,233,100,133,42.92
Graves,Braum,440,204,236,46.36
Graves,DrMundo,369,190,179,51.49
Graves,Orianna,314,149,165,47.45
Graves,Sett,1040,492,548,47.31
Graves,Ivern,146,66,80,45.21
Graves,Zac,443,223,220,50.34
Graves,Zyra,741,335,406,45.21
Graves,Ambessa,499,241,258,48.3
Graves,Zed,891,452,439,50.73
Graves,Sona,195,94,101,48.21
Graves,Rumble,227,111,116,48.9
Graves,Amumu,631,306,325,48.49
Graves,Leblanc,607,317,290,52.22
Graves,Vladimir,483,253,230,52.38
Graves,Anivia,246,104,142,42.28
Graves,Sylas,1175,601,574,51.15
Graves,Jayce,591,272,319,46.02
Graves,Khazix,504,231,273,45.83
Graves,Kalista,200,105,95,52.5
Graves,Vayne,895,430,465,48.04
Graves,Alistar,376,190,186,50.53
Graves,Pyke,662,385,277,58.16
Graves,Shen,470,255,215,54.26
Graves,Lillia,428,213,215,49.77
Graves,Riven,325,151,174,46.46
Graves,Jinx,2260,1024,1236,45.31
Graves,Renekton,402,239,163,59.45
Graves,Sejuani,307,138,169,44.95
Graves,Aphelios,391,203,188,51.92
Graves,Senna,523,243,280,46.46
Graves,Nunu,360,190,170,52.78
Graves,Nami,742,330,412,44.47
Graves,Camille,357,194,163,54.34
Graves,Veigar,692,356,336,51.45
Graves,Maokai,335,158,177,47.16
Graves,Leona,610,299,311,49.02
Graves,Illaoi,292,179,113,61.3
Graves,KogMaw,202,116,86,57.43
Graves,Hecarim,314,153,161,48.73
Graves,Syndra,604,278,326,46.03
Graves,Velkoz,434,178,256,41.01
Graves,Milio,436,212,224,48.62
Graves,Sion,545,309,236,56.7
Graves,Shyvana,214,86,128,40.19
Graves,AurelionSol,364,166,198,45.6
Graves,Lissandra,296,149,147,50.34
Graves,Gangplank,445,205,240,46.07
Graves,Aurora,501,268,233,53.49
Graves,Lucian,640,336,304,52.5
Graves,Gwen,340,176,164,51.76
Graves,Olaf,189,114,75,60.32
Graves,Nidalee,338,175,163,51.78
Graves,Bard,203,64,139,31.53
Graves,TwistedFate,364,179,185,49.18
Graves,Rakan,359,177,182,49.3
Graves,Belveth,177,73,104,41.24
Graves,XinZhao,604,286,318,47.35
Graves,Zeri,311,140,171,45.02
Graves,Xerath,815,433,382,53.13
Graves,Tryndamere,407,210,197,51.6
Graves,Smolder,458,225,233,49.13
Graves,Evelynn,251,106,145,42.23
Graves,Singed,231,95,136,41.13
Graves,Rammus,205,103,102,50.24
Graves,Malphite,707,296,411,41.87
Graves,Akshan,245,124,121,50.61
Graves,KSante,413,206,207,49.88
Graves,Ryze,279,126,153,45.16
Graves,Gnar,335,176,159,52.54
Graves,Skarner,189,111,78,58.73
Graves,Seraphine,429,232,197,54.08
Graves,Karthus,267,108,159,40.45
Graves,Sivir,365,188,177,51.51
Graves,Quinn,272,126,146,46.32
Graves,Rengar,247,146,101,59.11
Graves,Elise,552,281,271,50.91
Graves,Neeko,295,131,164,44.41
Graves,Xayah,269,120,149,44.61
Graves,Nilah,196,85,111,43.37
Graves,Azir,279,144,135,51.61
Graves,Taric,125,71,54,56.8
XinZhao,Renekton,382,199,183,52.09
XinZhao,Evelynn,217,102,115,47
XinZhao,Lissandra,216,109,107,50.46
XinZhao,Corki,287,152,135,52.96
XinZhao,Rakan,310,179,131,57.74
XinZhao,Jax,754,380,374,50.4
XinZhao,Rengar,183,95,88,51.91
XinZhao,Camille,291,159,132,54.64
XinZhao,Sivir,356,189,167,53.09
XinZhao,Karma,1037,456,581,43.97
XinZhao,Yone,1462,765,697,52.33
XinZhao,Samira,480,220,260,45.83
XinZhao,Yasuo,1421,741,680,52.15
XinZhao,Jhin,1560,810,750,51.92
XinZhao,Varus,696,376,320,54.02
XinZhao,Mordekaiser,981,443,538,45.16
XinZhao,Kayn,1058,485,573,45.84
XinZhao,Aurora,500,243,257,48.6
XinZhao,Morgana,958,466,492,48.64
XinZhao,Nunu,387,206,181,53.23
XinZhao,Irelia,664,326,338,49.1
XinZhao,Mel,1544,837,707,54.21
XinZhao,Lux,1777,910,867,51.21
XinZhao,Warwick,1077,522,555,48.47
XinZhao,Skarner,220,160,60,72.73
XinZhao,Veigar,708,390,318,55.08
XinZhao,Draven,395,202,193,51.14
XinZhao,Garen,1249,592,657,47.4
XinZhao,DrMundo,385,189,196,49.09
XinZhao,AurelionSol,247,121,126,48.99
XinZhao,Xayah,407,220,187,54.05
XinZhao,Nami,785,368,417,46.88
XinZhao,Trundle,461,215,246,46.64
XinZhao,Malzahar,807,395,412,48.95
XinZhao,Akali,865,403,462,46.59
XinZhao,Yorick,821,419,402,51.04
XinZhao,Nautilus,846,410,436,48.46
XinZhao,Olaf,181,88,93,48.62
XinZhao,Cassiopeia,238,129,109,54.2
XinZhao,LeeSin,1631,863,768,52.91
XinZhao,Leblanc,544,256,288,47.06
XinZhao,KogMaw,234,107,127,45.73
XinZhao,Lulu,1071,519,552,48.46
XinZhao,Pantheon,1233,636,597,51.58
XinZhao,Diana,1341,659,682,49.14
XinZhao,Caitlyn,2043,993,1050,48.6
XinZhao,FiddleSticks,400,202,198,50.5
XinZhao,Kaisa,1401,764,637,54.53
XinZhao,Seraphine,596,324,272,54.36
XinZhao,Malphite,777,386,391,49.68
XinZhao,Udyr,302,175,127,57.95
XinZhao,Orianna,353,175,178,49.58
XinZhao,Aatrox,739,343,396,46.41
XinZhao,Chogath,838,428,410,51.07
XinZhao,Ashe,1593,838,755,52.61
XinZhao,Zyra,754,383,371,50.8
XinZhao,Volibear,864,426,438,49.31
XinZhao,Vi,887,452,435,50.96
XinZhao,Zoe,248,157,91,63.31
XinZhao,Velkoz,468,245,223,52.35
XinZhao,Sion,571,248,323,43.43
XinZhao,Annie,292,137,155,46.92
XinZhao,MissFortune,1779,946,833,53.18
XinZhao,Sona,252,135,117,53.57
XinZhao,Vladimir,483,253,230,52.38
XinZhao,Ivern,58,37,21,63.79
XinZhao,Zed,956,519,437,54.29
XinZhao,TahmKench,465,260,205,55.91
XinZhao,Azir,294,134,160,45.58
XinZhao,Jinx,2179,1089,1090,49.98
XinZhao,Kayle,455,244,211,53.63
XinZhao,Belveth,188,99,89,52.66
XinZhao,Ezreal,2085,1057,1028,50.7
XinZhao,Thresh,1124,545,579,48.49
XinZhao,Urgot,332,128,204,38.55
XinZhao,Sejuani,356,147,209,41.29
XinZhao,Vayne,1004,474,530,47.21
XinZhao,Ekko,753,391,362,51.93
XinZhao,Ziggs,281,137,144,48.75
XinZhao,Brand,566,306,260,54.06
XinZhao,Sett,1149,517,632,45
XinZhao,Teemo,789,377,412,47.78
XinZhao,Darius,1404,728,676,51.85
XinZhao,Kassadin,137,70,67,51.09
XinZhao,Senna,515,280,235,54.37
XinZhao,Khazix,366,193,173,52.73
XinZhao,Soraka,396,156,240,39.39
XinZhao,Viego,1156,573,583,49.57
XinZhao,Viktor,742,360,382,48.52
XinZhao,Shaco,672,328,344,48.81
XinZhao,JarvanIV,536,260,276,48.51
XinZhao,Heimerdinger,283,129,154,45.58
XinZhao,TwistedFate,265,145,120,54.72
XinZhao,Kindred,326,170,156,52.15
XinZhao,MasterYi,888,472,416,53.15
XinZhao,Ahri,1041,536,505,51.49
XinZhao,Hecarim,295,157,138,53.22
XinZhao,Galio,648,332,316,51.23
XinZhao,Gangplank,404,229,175,56.68
XinZhao,Elise,595,317,278,53.28
XinZhao,Katarina,608,298,310,49.01
XinZhao,Rell,356,165,191,46.35
XinZhao,Twitch,561,294,267,52.41
XinZhao,MonkeyKing,568,210,358,36.97
XinZhao,Milio,380,159,221,41.84
XinZhao,Leona,697,357,340,51.22
XinZhao,Rammus,239,128,111,53.56
XinZhao,Nidalee,247,141,106,57.09
XinZhao,Aphelios,412,179,233,43.45
XinZhao,Blitzcrank,534,273,261,51.12
XinZhao,Illaoi,344,195,149,56.69
XinZhao,Nilah,224,92,132,41.07
XinZhao,Alistar,354,175,179,49.44
XinZhao,Tryndamere,437,213,224,48.74
XinZhao,Braum,459,231,228,50.33
XinZhao,Anivia,221,118,103,53.39
XinZhao,Shyvana,158,82,76,51.9
XinZhao,Amumu,766,398,368,51.96
XinZhao,Lucian,553,248,305,44.85
XinZhao,Sylas,1154,570,584,49.39
XinZhao,Hwei,500,277,223,55.4
XinZhao,Poppy,528,255,273,48.3
XinZhao,Graves,604,318,286,52.65
XinZhao,Gwen,397,193,204,48.61
XinZhao,Nocturne,1114,558,556,50.09
XinZhao,Fizz,486,253,233,52.06
XinZhao,Shen,440,173,267,39.32
XinZhao,Fiora,222,128,94,57.66
XinZhao,Nasus,451,201,250,44.57
XinZhao,Yuumi,587,294,293,50.09
XinZhao,Kennen,188,75,113,39.89
XinZhao,Gnar,328,177,151,53.96
XinZhao,Smolder,477,266,211,55.77
XinZhao,Pyke,567,288,279,50.79
XinZhao,Xerath,748,404,344,54.01
XinZhao,Ryze,277,153,124,55.23
XinZhao,Karthus,233,108,125,46.35
XinZhao,Gragas,354,201,153,56.78
XinZhao,Briar,548,224,324,40.88
XinZhao,Syndra,510,219,291,42.94
XinZhao,Kled,124,65,59,52.42
XinZhao,RekSai,101,49,52,48.51
XinZhao,Qiyana,180,75,105,41.67
XinZhao,Taliyah,211,111,100,52.61
XinZhao,Quinn,216,117,99,54.17
XinZhao,Ambessa,535,307,228,57.38
XinZhao,Tristana,774,365,409,47.16
XinZhao,Singed,167,73,94,43.71
XinZhao,Lillia,424,230,194,54.25
XinZhao,Zeri,308,163,145,52.92
XinZhao,Swain,801,369,432,46.07
XinZhao,Maokai,350,180,170,51.43
XinZhao,Riven,388,241,147,62.11
XinZhao,Zac,424,195,229,45.99
XinZhao,Talon,491,280,211,57.03
XinZhao,Janna,259,126,133,48.65
XinZhao,Rumble,222,110,112,49.55
XinZhao,KSante,443,219,224,49.44
XinZhao,Zilean,232,115,117,49.57
XinZhao,Vex,450,240,210,53.33
XinZhao,Taric,179,95,84,53.07
XinZhao,Kalista,207,110,97,53.14
XinZhao,Bard,229,127,102,55.46
XinZhao,Jayce,442,215,227,48.64
XinZhao,Ornn,284,139,145,48.94
XinZhao,Neeko,334,166,168,49.7
XinZhao,Akshan,241,142,99,58.92
XinZhao,Naafiri,236,114,122,48.31
XinZhao,Renata,117,84,33,71.79
Maokai,Yorick,533,212,321,39.77
Maokai,JarvanIV,269,136,133,50.56
Maokai,Mel,1027,526,501,51.22
Maokai,Jinx,1478,740,738,50.07
Maokai,Lux,1352,644,708,47.63
Maokai,Olaf,158,98,60,62.03
Maokai,Shaco,512,258,254,50.39
Maokai,Lissandra,161,79,82,49.07
Maokai,Ashe,1078,569,509,52.78
Maokai,Leona,477,211,266,44.23
Maokai,Kayle,399,207,192,51.88
Maokai,Elise,443,232,211,52.37
Maokai,Swain,503,243,260,48.31
Maokai,Kalista,136,71,65,52.21
Maokai,Karma,690,343,347,49.71
Maokai,Darius,1030,544,486,52.82
Maokai,Nocturne,669,324,345,48.43
Maokai,Ahri,709,372,337,52.47
Maokai,KogMaw,179,89,90,49.72
Maokai,Braum,298,136,162,45.64
Maokai,Morgana,668,293,375,43.86
Maokai,Warwick,793,340,453,42.88
Maokai,Malzahar,535,305,230,57.01
Maokai,Blitzcrank,357,192,165,53.78
Maokai,Poppy,389,196,193,50.39
Maokai,Viego,808,393,415,48.64
Maokai,Pyke,492,279,213,56.71
Maokai,Jayce,247,139,108,56.28
Maokai,Diana,893,429,464,48.04
Maokai,Anivia,205,84,121,40.98
Maokai,Ezreal,1386,699,687,50.43
Maokai,TahmKench,407,212,195,52.09
Maokai,KSante,293,158,135,53.92
Maokai,Nunu,305,145,160,47.54
Maokai,Sylas,890,494,396,55.51
Maokai,Tristana,566,254,312,44.88
Maokai,Teemo,725,342,383,47.17
Maokai,TwistedFate,141,74,67,52.48
Maokai,Xayah,275,111,164,40.36
Maokai,Zyra,639,294,345,46.01
Maokai,Kindred,248,118,130,47.58
Maokai,Akali,531,276,255,51.98
Maokai,MissFortune,1269,607,662,47.83
Maokai,Nami,484,235,249,48.55
Maokai,Fiora,192,72,120,37.5
Maokai,Khazix,181,98,83,54.14
Maokai,Ekko,547,295,252,53.93
Maokai,Lucian,332,150,182,45.18
Maokai,Viktor,596,315,281,52.85
Maokai,Twitch,419,227,192,54.18
Maokai,Yone,1016,504,512,49.61
Maokai,Kassadin,112,47,65,41.96
Maokai,Sett,818,414,404,50.61
Maokai,Syndra,364,177,187,48.63
Maokai,Vayne,771,364,407,47.21
Maokai,Sion,395,179,216,45.32
Maokai,Evelynn,178,79,99,44.38
Maokai,Annie,163,82,81,50.31
Maokai,Sona,131,65,66,49.62
Maokai,Gangplank,263,120,143,45.63
Maokai,Kayn,770,353,417,45.84
Maokai,Xerath,491,229,262,46.64
Maokai,Smolder,339,159,180,46.9
Maokai,Lulu,694,369,325,53.17
Maokai,Jhin,1009,569,440,56.39
Maokai,Soraka,239,117,122,48.95
Maokai,Heimerdinger,206,94,112,45.63
Maokai,Zed,622,315,307,50.64
Maokai,Veigar,539,279,260,51.76
Maokai,Caitlyn,1440,734,706,50.97
Maokai,Neeko,289,144,145,49.83
Maokai,MonkeyKing,350,171,179,48.86
Maokai,Varus,497,256,241,51.51
Maokai,Kaisa,933,534,399,57.23
Maokai,Nautilus,585,316,269,54.02
Maokai,Vi,443,229,214,51.69
Maokai,Thresh,689,382,307,55.44
Maokai,Renekton,263,105,158,39.92
Maokai,Fizz,278,132,146,47.48
Maokai,Aphelios,261,134,127,51.34
Maokai,Malphite,533,303,230,56.85
Maokai,Ornn,226,106,120,46.9
Maokai,Hecarim,241,140,101,58.09
Maokai,Volibear,674,340,334,50.45
Maokai,AurelionSol,193,89,104,46.11
Maokai,Renata,113,59,54,52.21
Maokai,Zeri,237,135,102,56.96
Maokai,Rell,276,144,132,52.17
Maokai,Jax,491,238,253,48.47
Maokai,MasterYi,589,303,286,51.44
Maokai,Vex,262,132,130,50.38
Maokai,Vladimir,358,164,194,45.81
Maokai,FiddleSticks,260,133,127,51.15
Maokai,LeeSin,851,477,374,56.05
Maokai,Chogath,668,345,323,51.65
Maokai,Graves,335,177,158,52.84
Maokai,Gnar,222,108,114,48.65
Maokai,Leblanc,413,217,196,52.54
Maokai,Senna,390,188,202,48.21
Maokai,Illaoi,296,139,157,46.96
Maokai,Yasuo,1021,511,510,50.05
Maokai,Karthus,175,104,71,59.43
Maokai,Brand,404,189,215,46.78
Maokai,Katarina,357,172,185,48.18
Maokai,Mordekaiser,708,351,357,49.58
Maokai,Irelia,478,226,252,47.28
Maokai,Rumble,158,81,77,51.27
Maokai,Ziggs,174,85,89,48.85
Maokai,Camille,171,94,77,54.97
Maokai,Pantheon,884,470,414,53.17
Maokai,Riven,202,92,110,45.54
Maokai,Rakan,244,98,146,40.16
Maokai,Ryze,185,81,104,43.78
Maokai,Tryndamere,255,98,157,38.43
Maokai,Shen,354,187,167,52.82
Maokai,Sejuani,233,137,96,58.8
Maokai,Yuumi,412,214,198,51.94
Maokai,Milio,289,119,170,41.18
Maokai,Skarner,149,69,80,46.31
Maokai,Kennen,152,88,64,57.89
Maokai,Zoe,239,126,113,52.72
Maokai,Samira,433,204,229,47.11
Maokai,Taric,139,84,55,60.43
Maokai,Ambessa,370,223,147,60.27
Maokai,Aatrox,451,219,232,48.56
Maokai,Hwei,390,171,219,43.85
Maokai,Briar,379,164,215,43.27
Maokai,Zac,240,132,108,55
Maokai,Corki,213,112,101,52.58
Maokai,Zilean,204,102,102,50
Maokai,Gragas,295,183,112,62.03
Maokai,Shyvana,145,77,68,53.1
Maokai,Sivir,253,129,124,50.99
Maokai,Aurora,378,222,156,58.73
Maokai,Udyr,251,120,131,47.81
Maokai,Bard,206,111,95,53.88
Maokai,Nasus,394,182,212,46.19
Maokai,Quinn,192,88,104,45.83
Maokai,Singed,111,47,64,42.34
Maokai,Trundle,273,146,127,53.48
Maokai,Urgot,265,118,147,44.53
Maokai,Janna,187,103,84,55.08
Maokai,Talon,352,179,173,50.85
Maokai,Nilah,189,95,94,50.26
Maokai,Lillia,335,154,181,45.97
Maokai,Azir,190,96,94,50.53
Maokai,Akshan,166,81,85,48.8
Maokai,Seraphine,394,226,168,57.36
Maokai,Gwen,263,141,122,53.61
Maokai,Naafiri,156,87,69,55.77
Maokai,Orianna,251,119,132,47.41
Maokai,Velkoz,313,175,138,55.91
Maokai,XinZhao,350,170,180,48.57
Maokai,RekSai,70,33,37,47.14
Maokai,Amumu,534,267,267,50
Maokai,Garen,859,446,413,51.92
Maokai,Rammus,163,89,74,54.6
Maokai,DrMundo,299,152,147,50.84
Maokai,Cassiopeia,162,90,72,55.56
Maokai,Taliyah,124,72,52,58.06
Maokai,Kled,105,65,40,61.9
Maokai,Qiyana,126,87,39,69.05
Maokai,Draven,229,99,130,43.23
Maokai,Rengar,159,93,66,58.49
Maokai,Galio,505,257,248,50.89
Maokai,Nidalee,131,75,56,57.25
Maokai,Belveth,168,99,69,58.93
Maokai,Ivern,85,51,34,60
Maokai,Alistar,259,134,125,51.74
JarvanIV,Urgot,310,144,166,46.45
JarvanIV,Talon,377,190,187,50.4
JarvanIV,Ahri,1022,523,499,51.17
JarvanIV,Aphelios,342,182,160,53.22
JarvanIV,Maokai,269,133,136,49.44
JarvanIV,Renekton,413,229,184,55.45
JarvanIV,Diana,1038,493,545,47.5
JarvanIV,Aurora,544,297,247,54.6
JarvanIV,Corki,358,176,182,49.16
JarvanIV,Pantheon,1124,606,518,53.91
JarvanIV,Irelia,541,259,282,47.87
JarvanIV,Katarina,501,280,221,55.89
JarvanIV,Varus,662,352,310,53.17
JarvanIV,Soraka,460,225,235,48.91
JarvanIV,Poppy,453,230,223,50.77
JarvanIV,Viego,976,522,454,53.48
JarvanIV,Lux,1615,837,778,51.83
JarvanIV,Vayne,861,436,425,50.64
JarvanIV,Nami,904,422,482,46.68
JarvanIV,Garen,1151,582,569,50.56
JarvanIV,MasterYi,734,351,383,47.82
JarvanIV,Sylas,947,454,493,47.94
JarvanIV,Mel,1319,723,596,54.81
JarvanIV,Zilean,294,160,134,54.42
JarvanIV,KSante,365,221,144,60.55
JarvanIV,Naafiri,199,96,103,48.24
JarvanIV,Twitch,595,366,229,61.51
JarvanIV,Swain,608,299,309,49.18
JarvanIV,Jinx,2084,1085,999,52.06
JarvanIV,Pyke,477,248,229,51.99
JarvanIV,Camille,246,128,118,52.03
JarvanIV,Belveth,182,117,65,64.29
JarvanIV,Lissandra,224,115,109,51.34
JarvanIV,Smolder,431,211,220,48.96
JarvanIV,Zyra,671,322,349,47.99
JarvanIV,Gragas,394,233,161,59.14
JarvanIV,Amumu,752,364,388,48.4
JarvanIV,Velkoz,406,202,204,49.75
JarvanIV,Nunu,437,244,193,55.84
JarvanIV,Thresh,1020,470,550,46.08
JarvanIV,LeeSin,1060,579,481,54.62
JarvanIV,Vladimir,500,259,241,51.8
JarvanIV,Zed,769,429,340,55.79
JarvanIV,Gnar,262,137,125,52.29
JarvanIV,Skarner,167,94,73,56.29
JarvanIV,Tristana,691,305,386,44.14
JarvanIV,Leona,487,249,238,51.13
JarvanIV,Illaoi,297,155,142,52.19
JarvanIV,Rengar,255,145,110,56.86
JarvanIV,Leblanc,393,204,189,51.91
JarvanIV,MissFortune,1456,715,741,49.11
JarvanIV,Nautilus,748,378,370,50.53
JarvanIV,Volibear,840,432,408,51.43
JarvanIV,Graves,482,235,247,48.76
JarvanIV,Syndra,478,230,248,48.12
JarvanIV,Milio,387,199,188,51.42
JarvanIV,Anivia,203,102,101,50.25
JarvanIV,Ashe,1355,724,631,53.43
JarvanIV,Sett,867,398,469,45.91
JarvanIV,Kayn,984,499,485,50.71
JarvanIV,Mordekaiser,796,385,411,48.37
JarvanIV,Lulu,979,574,405,58.63
JarvanIV,Malzahar,782,354,428,45.27
JarvanIV,Ezreal,1759,917,842,52.13
JarvanIV,Briar,483,214,269,44.31
JarvanIV,Qiyana,161,109,52,67.7
JarvanIV,Ornn,290,159,131,54.83
JarvanIV,Singed,186,93,93,50
JarvanIV,TwistedFate,296,155,141,52.36
JarvanIV,Morgana,694,367,327,52.88
JarvanIV,Jax,636,305,331,47.96
JarvanIV,Malphite,720,366,354,50.83
JarvanIV,Yuumi,539,273,266,50.65
JarvanIV,Ekko,626,286,340,45.69
JarvanIV,Fizz,446,205,241,45.96
JarvanIV,Lucian,440,248,192,56.36
JarvanIV,Trundle,334,158,176,47.31
JarvanIV,Ryze,266,116,150,43.61
JarvanIV,Caitlyn,1797,944,853,52.53
JarvanIV,Zac,325,155,170,47.69
JarvanIV,Kaisa,1232,572,660,46.43
JarvanIV,Rakan,259,140,119,54.05
JarvanIV,Heimerdinger,244,119,125,48.77
JarvanIV,Yone,1204,627,577,52.08
JarvanIV,Karma,883,463,420,52.43
JarvanIV,Seraphine,477,242,235,50.73
JarvanIV,Sejuani,277,156,121,56.32
JarvanIV,Nilah,203,84,119,41.38
JarvanIV,Teemo,762,411,351,53.94
JarvanIV,Jhin,1418,801,617,56.49
JarvanIV,MonkeyKing,594,304,290,51.18
JarvanIV,Ivern,120,50,70,41.67
JarvanIV,Yasuo,1231,647,584,52.56
JarvanIV,Kled,139,93,46,66.91
JarvanIV,Yorick,649,320,329,49.31
JarvanIV,Shaco,596,328,268,55.03
JarvanIV,Sona,237,112,125,47.26
JarvanIV,Draven,445,205,240,46.07
JarvanIV,Braum,439,213,226,48.52
JarvanIV,Gangplank,384,183,201,47.66
JarvanIV,Darius,1272,629,643,49.45
JarvanIV,Viktor,655,334,321,50.99
JarvanIV,Nocturne,1032,522,510,50.58
JarvanIV,Ziggs,227,123,104,54.19
JarvanIV,Ambessa,412,236,176,57.28
JarvanIV,Warwick,934,468,466,50.11
JarvanIV,Riven,311,168,143,54.02
JarvanIV,Chogath,862,459,403,53.25
JarvanIV,Galio,622,333,289,53.54
JarvanIV,Kayle,523,250,273,47.8
JarvanIV,Vi,712,349,363,49.02
JarvanIV,Janna,270,129,141,47.78
JarvanIV,Sion,476,240,236,50.42
JarvanIV,XinZhao,536,276,260,51.49
JarvanIV,Vex,324,137,187,42.28
JarvanIV,Shen,511,271,240,53.03
JarvanIV,Elise,531,272,259,51.22
JarvanIV,Khazix,306,166,140,54.25
JarvanIV,Azir,214,88,126,41.12
JarvanIV,Alistar,365,210,155,57.53
JarvanIV,Rell,351,161,190,45.87
JarvanIV,Akshan,245,141,104,57.55
JarvanIV,Hecarim,326,157,169,48.16
JarvanIV,Kassadin,137,73,64,53.28
JarvanIV,Brand,510,262,248,51.37
JarvanIV,DrMundo,316,163,153,51.58
JarvanIV,Shyvana,195,106,89,54.36
JarvanIV,Karthus,190,79,111,41.58
JarvanIV,Xayah,307,169,138,55.05
JarvanIV,Kindred,332,175,157,52.71
JarvanIV,Akali,649,320,329,49.31
JarvanIV,Bard,239,127,112,53.14
JarvanIV,Kennen,198,110,88,55.56
JarvanIV,KogMaw,237,106,131,44.73
JarvanIV,Sivir,413,186,227,45.04
JarvanIV,Cassiopeia,250,139,111,55.6
JarvanIV,Xerath,642,347,295,54.05
JarvanIV,Tryndamere,387,191,196,49.35
JarvanIV,Taric,143,69,74,48.25
JarvanIV,Aatrox,590,291,299,49.32
JarvanIV,Neeko,216,110,106,50.93
JarvanIV,Evelynn,239,105,134,43.93
JarvanIV,Kalista,168,73,95,43.45
JarvanIV,Annie,262,142,120,54.2
JarvanIV,Samira,328,153,175,46.65
JarvanIV,Zeri,281,153,128,54.45
JarvanIV,Hwei,406,190,216,46.8
JarvanIV,Veigar,640,326,314,50.94
JarvanIV,RekSai,89,44,45,49.44
JarvanIV,Rumble,215,132,83,61.4
JarvanIV,Fiora,200,86,114,43
JarvanIV,Nidalee,223,130,93,58.3
JarvanIV,TahmKench,432,215,217,49.77
JarvanIV,Quinn,253,122,131,48.22
JarvanIV,FiddleSticks,364,166,198,45.6
JarvanIV,Senna,558,258,300,46.24
JarvanIV,Nasus,445,213,232,47.87
JarvanIV,Rammus,147,59,88,40.14
JarvanIV,Udyr,297,171,126,57.58
JarvanIV,Orianna,296,151,145,51.01
JarvanIV,Taliyah,168,100,68,59.52
JarvanIV,Gwen,361,214,147,59.28
JarvanIV,Jayce,356,203,153,57.02
JarvanIV,Blitzcrank,441,271,170,61.45
JarvanIV,Lillia,355,194,161,54.65
JarvanIV,AurelionSol,262,126,136,48.09
JarvanIV,Renata,132,48,84,36.36
JarvanIV,Olaf,124,57,67,45.97
JarvanIV,Zoe,270,138,132,51.11
Brand,Nautilus,1016,551,465,54.23
Brand,FiddleSticks,388,214,174,55.15
Brand,Vladimir,585,304,281,51.97
Brand,Jhin,1816,877,939,48.29
Brand,Morgana,1325,644,681,48.6
Brand,Yorick,983,497,486,50.56
Brand,Volibear,1177,604,573,51.32
Brand,LeeSin,1087,552,535,50.78
Brand,Caitlyn,2715,1374,1341,50.61
Brand,Thresh,1055,541,514,51.28
Brand,Camille,271,136,135,50.18
Brand,Briar,685,333,352,48.61
Brand,Katarina,664,348,316,52.41
Brand,Jinx,2557,1201,1356,46.97
Brand,Lux,2624,1338,1286,50.99
Brand,Jax,831,442,389,53.19
Brand,Rammus,273,150,123,54.95
Brand,Viktor,708,359,349,50.71
Brand,Soraka,473,211,262,44.61
Brand,Teemo,1248,601,647,48.16
Brand,Lillia,471,222,249,47.13
Brand,Irelia,804,366,438,45.52
Brand,Galio,882,412,470,46.71
Brand,Pantheon,1519,794,725,52.27
Brand,Nunu,552,272,280,49.28
Brand,Sivir,466,225,241,48.28
Brand,Zed,974,453,521,46.51
Brand,MissFortune,2435,1283,1152,52.69
Brand,Ashe,1822,1014,808,55.65
Brand,Chogath,1143,576,567,50.39
Brand,Sylas,1034,544,490,52.61
Brand,Mel,1733,883,850,50.95
Brand,Aatrox,692,349,343,50.43
Brand,Cassiopeia,234,130,104,55.56
Brand,Samira,682,341,341,50
Brand,Gwen,339,177,162,52.21
Brand,MonkeyKing,622,345,277,55.47
Brand,Yasuo,1777,903,874,50.82
Brand,Kaisa,1341,652,689,48.62
Brand,Renata,133,81,52,60.9
Brand,Illaoi,463,251,212,54.21
Brand,Nami,817,391,426,47.86
Brand,Naafiri,343,162,181,47.23
Brand,Nidalee,207,106,101,51.21
Brand,Xayah,367,179,188,48.77
Brand,Olaf,190,113,77,59.47
Brand,Shaco,896,486,410,54.24
Brand,Twitch,731,379,352,51.85
Brand,Pyke,719,374,345,52.02
Brand,Heimerdinger,494,244,250,49.39
Brand,Amumu,1027,496,531,48.3
Brand,Malphite,889,479,410,53.88
Brand,Smolder,552,311,241,56.34
Brand,Kayle,659,318,341,48.25
Brand,Vi,800,414,386,51.75
Brand,Ahri,1204,674,530,55.98
Brand,Diana,1478,792,686,53.59
Brand,Veigar,1025,523,502,51.02
Brand,Gragas,465,261,204,56.13
Brand,Velkoz,642,320,322,49.84
Brand,Ambessa,485,240,245,49.48
Brand,Viego,1148,572,576,49.83
Brand,TwistedFate,328,145,183,44.21
Brand,Ziggs,313,159,154,50.8
Brand,Sion,717,342,375,47.7
Brand,Evelynn,335,176,159,52.54
Brand,Braum,445,214,231,48.09
Brand,Kennen,227,117,110,51.54
Brand,Khazix,481,261,220,54.26
Brand,Senna,639,358,281,56.03
Brand,Yone,1639,884,755,53.94
Brand,Akali,977,475,502,48.62
Brand,Draven,495,273,222,55.15
Brand,Darius,1797,926,871,51.53
Brand,Poppy,440,215,225,48.86
Brand,Karthus,227,99,128,43.61
Brand,Zeri,266,128,138,48.12
Brand,Lulu,1071,524,547,48.93
Brand,Nasus,759,415,344,54.68
Brand,Ekko,810,464,346,57.28
Brand,Trundle,611,299,312,48.94
Brand,Neeko,502,257,245,51.2
Brand,Renekton,331,152,179,45.92
Brand,MasterYi,1194,562,632,47.07
Brand,Fizz,689,304,385,44.12
Brand,Karma,922,432,490,46.85
Brand,Kayn,1336,620,716,46.41
Brand,Rell,372,195,177,52.42
Brand,Syndra,473,222,251,46.93
Brand,Milio,459,205,254,44.66
Brand,Shen,546,302,244,55.31
Brand,Leblanc,490,258,232,52.65
Brand,Urgot,491,231,260,47.05
Brand,Graves,491,229,262,46.64
Brand,Swain,1018,505,513,49.61
Brand,Warwick,1420,745,675,52.46
Brand,Mordekaiser,1181,589,592,49.87
Brand,Ezreal,1930,1041,889,53.94
Brand,Rakan,251,110,141,43.82
Brand,Kindred,410,237,173,57.8
Brand,Sett,1321,606,715,45.87
Brand,Aphelios,437,203,234,46.45
Brand,Hwei,618,266,352,43.04
Brand,Nocturne,1180,547,633,46.36
Brand,Orianna,283,123,160,43.46
Brand,Garen,1488,684,804,45.97
Brand,Aurora,538,290,248,53.9
Brand,Leona,814,424,390,52.09
Brand,Azir,220,121,99,55
Brand,Akshan,310,169,141,54.52
Brand,Corki,282,141,141,50
Brand,Quinn,295,155,140,52.54
Brand,Kalista,212,104,108,49.06
Brand,Yuumi,694,339,355,48.85
Brand,Sejuani,389,208,181,53.47
Brand,Shyvana,261,118,143,45.21
Brand,Zyra,923,432,491,46.8
Brand,Janna,233,109,124,46.78
Brand,Talon,446,211,235,47.31
Brand,Lucian,632,303,329,47.94
Brand,Seraphine,769,430,339,55.92
Brand,XinZhao,566,260,306,45.94
Brand,Gangplank,310,165,145,53.23
Brand,Kled,159,70,89,44.03
Brand,Zilean,265,138,127,52.08
Brand,Taric,152,72,80,47.37
Brand,Vayne,1149,555,594,48.3
Brand,Jayce,346,179,167,51.73
Brand,Skarner,212,134,78,63.21
Brand,Taliyah,162,70,92,43.21
Brand,Tristana,877,441,436,50.29
Brand,Blitzcrank,585,296,289,50.6
Brand,DrMundo,596,273,323,45.81
Brand,Varus,720,340,380,47.22
Brand,AurelionSol,341,187,154,54.84
Brand,Maokai,404,215,189,53.22
Brand,KogMaw,278,147,131,52.88
Brand,Bard,243,116,127,47.74
Brand,Elise,570,260,310,45.61
Brand,Rumble,198,104,94,52.53
Brand,Malzahar,1007,476,531,47.27
Brand,Riven,352,187,165,53.13
Brand,JarvanIV,510,248,262,48.63
Brand,Gnar,345,147,198,42.61
Brand,Fiora,273,147,126,53.85
Brand,Rengar,306,171,135,55.88
Brand,Kassadin,188,82,106,43.62
Brand,Hecarim,364,206,158,56.59
Brand,Zoe,323,163,160,50.46
Brand,Vex,441,233,208,52.83
Brand,RekSai,107,52,55,48.6
Brand,Ryze,255,116,139,45.49
Brand,Singed,251,113,138,45.02
Brand,Ornn,300,155,145,51.67
Brand,Nilah,305,158,147,51.8
Brand,Sona,305,131,174,42.95
Brand,TahmKench,774,438,336,56.59
Brand,Zac,415,235,180,56.63
Brand,Qiyana,184,115,69,62.5
Brand,Lissandra,274,126,148,45.99
Brand,KSante,365,214,151,58.63
Brand,Udyr,339,173,166,51.03
Brand,Alistar,317,156,161,49.21
Brand,Anivia,248,121,127,48.79
Brand,Ivern,93,46,47,49.46
Brand,Tryndamere,633,310,323,48.97
Brand,Annie,221,111,110,50.23
Brand,Xerath,818,382,436,46.7
Brand,Belveth,214,119,95,55.61
Vex,Gnar,280,147,133,52.5
Vex,Volibear,718,396,322,55.15
Vex,Fizz,363,178,185,49.04
Vex,Aphelios,296,169,127,57.09
Vex,Zyra,642,327,315,50.93
Vex,Singed,187,88,99,47.06
Vex,Viego,883,453,430,51.3
Vex,Zed,696,341,355,48.99
Vex,Zeri,231,104,127,45.02
Vex,Milio,318,134,184,42.14
Vex,Aatrox,573,250,323,43.63
Vex,Kayn,877,434,443,49.49
Vex,Katarina,479,240,239,50.1
Vex,Jhin,1295,652,643,50.35
Vex,Blitzcrank,534,279,255,52.25
Vex,Vi,584,291,293,49.83
Vex,Ekko,486,266,220,54.73
Vex,Yasuo,1751,961,790,54.88
Vex,Velkoz,363,168,195,46.28
Vex,Mordekaiser,780,346,434,44.36
Vex,LeeSin,846,482,364,56.97
Vex,Ezreal,1539,767,772,49.84
Vex,Lulu,628,299,329,47.61
Vex,Shen,367,203,164,55.31
Vex,Amumu,703,359,344,51.07
Vex,Akali,868,514,354,59.22
Vex,TahmKench,391,201,190,51.41
Vex,Warwick,1004,439,565,43.73
Vex,Udyr,210,104,106,49.52
Vex,Vladimir,369,143,226,38.75
Vex,Jinx,1777,834,943,46.93
Vex,Nocturne,872,410,462,47.02
Vex,Yone,1320,678,642,51.36
Vex,MissFortune,1512,770,742,50.93
Vex,Morgana,842,411,431,48.81
Vex,Mel,1014,484,530,47.73
Vex,Malzahar,632,297,335,46.99
Vex,Ashe,1335,667,668,49.96
Vex,Soraka,307,165,142,53.75
Vex,Varus,591,271,320,45.85
Vex,Briar,499,199,300,39.88
Vex,Bard,165,101,64,61.21
Vex,Elise,382,178,204,46.6
Vex,Fiora,173,99,74,57.23
Vex,Karthus,198,94,104,47.47
Vex,Kaisa,961,483,478,50.26
Vex,Illaoi,245,140,105,57.14
Vex,Shaco,616,311,305,50.49
Vex,Vayne,805,402,403,49.94
Vex,Thresh,858,416,442,48.48
Vex,Ziggs,213,102,111,47.89
Vex,Samira,407,192,215,47.17
Vex,Rell,285,149,136,52.28
Vex,Sylas,1056,573,483,54.26
Vex,Tristana,668,349,319,52.25
Vex,Pantheon,941,488,453,51.86
Vex,Ambessa,388,226,162,58.25
Vex,Braum,364,200,164,54.95
Vex,Tryndamere,369,218,151,59.08
Vex,Evelynn,245,133,112,54.29
Vex,Twitch,493,228,265,46.25
Vex,Lux,1700,861,839,50.65
Vex,Diana,1038,517,521,49.81
Vex,Kayle,438,232,206,52.97
Vex,Gragas,358,205,153,57.26
Vex,Irelia,579,281,298,48.53
Vex,Sivir,316,163,153,51.58
Vex,Zilean,176,82,94,46.59
Vex,Lillia,411,186,225,45.26
Vex,Hwei,372,173,199,46.51
Vex,Nami,515,255,260,49.51
Vex,Gangplank,262,118,144,45.04
Vex,Caitlyn,1729,934,795,54.02
Vex,Darius,1020,553,467,54.22
Vex,Graves,343,156,187,45.48
Vex,Aurora,456,245,211,53.73
Vex,Seraphine,488,221,267,45.29
Vex,Qiyana,200,104,96,52
Vex,Orianna,255,133,122,52.16
Vex,Yorick,635,314,321,49.45
Vex,Veigar,665,353,312,53.08
Vex,Poppy,339,159,180,46.9
Vex,Belveth,132,75,57,56.82
Vex,Taliyah,96,44,52,45.83
Vex,Lissandra,148,82,66,55.41
Vex,Malphite,566,274,292,48.41
Vex,Xayah,284,135,149,47.54
Vex,Neeko,321,169,152,52.65
Vex,Teemo,886,452,434,51.02
Vex,Nautilus,755,378,377,50.07
Vex,Galio,472,214,258,45.34
Vex,Khazix,303,166,137,54.79
Vex,Kalista,145,65,80,44.83
Vex,Sejuani,295,158,137,53.56
Vex,Sett,862,402,460,46.64
Vex,Lucian,386,213,173,55.18
Vex,Trundle,345,189,156,54.78
Vex,KSante,288,145,143,50.35
Vex,Anivia,148,72,76,48.65
Vex,Garen,922,419,503,45.44
Vex,Karma,694,332,362,47.84
Vex,Jax,561,250,311,44.56
Vex,Ahri,953,487,466,51.1
Vex,Alistar,247,134,113,54.25
Vex,Maokai,262,130,132,49.62
Vex,Camille,233,117,116,50.21
Vex,Naafiri,241,118,123,48.96
Vex,JarvanIV,324,187,137,57.72
Vex,Heimerdinger,326,175,151,53.68
Vex,Swain,590,251,339,42.54
Vex,Rakan,228,120,108,52.63
Vex,Shyvana,152,83,69,54.61
Vex,Chogath,691,322,369,46.6
Vex,Nunu,331,158,173,47.73
Vex,Akshan,236,134,102,56.78
Vex,Kennen,100,53,47,53
Vex,Nasus,447,211,236,47.2
Vex,Taric,126,70,56,55.56
Vex,Sion,431,209,222,48.49
Vex,Rengar,228,131,97,57.46
Vex,Riven,248,123,125,49.6
Vex,Gwen,313,179,134,57.19
Vex,Kled,93,41,52,44.09
Vex,Syndra,369,147,222,39.84
Vex,Brand,441,208,233,47.17
Vex,Zoe,236,130,106,55.08
Vex,Smolder,366,198,168,54.1
Vex,Olaf,156,76,80,48.72
Vex,Talon,349,187,162,53.58
Vex,Xerath,619,316,303,51.05
Vex,Ivern,77,44,33,57.14
Vex,MasterYi,757,340,417,44.91
Vex,Leblanc,660,335,325,50.76
Vex,Azir,168,99,69,58.93
Vex,Yuumi,500,272,228,54.4
Vex,DrMundo,364,171,193,46.98
Vex,Hecarim,240,130,110,54.17
Vex,Urgot,306,163,143,53.27
Vex,Renata,94,54,40,57.45
Vex,Quinn,226,126,100,55.75
Vex,Annie,254,141,113,55.51
Vex,Ornn,277,126,151,45.49
Vex,Nilah,213,112,101,52.58
Vex,AurelionSol,189,85,104,44.97
Vex,Draven,250,142,108,56.8
Vex,Leona,557,246,311,44.17
Vex,Senna,427,239,188,55.97
Vex,Renekton,353,181,172,51.27
Vex,FiddleSticks,293,164,129,55.97
Vex,Viktor,523,265,258,50.67
Vex,TwistedFate,162,85,77,52.47
Vex,MonkeyKing,378,203,175,53.7
Vex,Pyke,530,248,282,46.79
Vex,Janna,183,79,104,43.17
Vex,Corki,222,129,93,58.11
Vex,Skarner,126,46,80,36.51
Vex,XinZhao,450,210,240,46.67
Vex,Kindred,278,139,139,50
Vex,Rammus,170,92,78,54.12
Vex,Kassadin,120,63,57,52.5
Vex,KogMaw,167,94,73,56.29
Vex,Cassiopeia,159,91,68,57.23
Vex,Rumble,151,88,63,58.28
Vex,RekSai,58,26,32,44.83
Vex,Jayce,284,155,129,54.58
Vex,Sona,171,76,95,44.44
Vex,Ryze,169,86,83,50.89
Vex,Zac,265,137,128,51.7
Vex,Nidalee,165,91,74,55.15
Zeri,Tryndamere,238,124,114,52.1
Zeri,Amumu,412,206,206,50
Zeri,Vex,231,127,104,54.98
Zeri,Jinx,1542,761,781,49.35
Zeri,Mel,949,482,467,50.79
Zeri,Yorick,397,187,210,47.1
Zeri,Nocturne,658,360,298,54.71
Zeri,Zed,554,239,315,43.14
Zeri,Xayah,274,109,165,39.78
Zeri,Karma,741,333,408,44.94
Zeri,Ashe,1064,534,530,50.19
Zeri,Warwick,684,350,334,51.17
Zeri,Ezreal,1501,797,704,53.1
Zeri,Morgana,528,246,282,46.59
Zeri,TahmKench,309,167,142,54.05
Zeri,Kayn,584,294,290,50.34
Zeri,Mordekaiser,564,253,311,44.86
Zeri,MissFortune,1052,526,526,50
Zeri,Heimerdinger,191,106,85,55.5
Zeri,Singed,141,64,77,45.39
Zeri,MonkeyKing,310,175,135,56.45
Zeri,Orianna,195,106,89,54.36
Zeri,Draven,219,111,108,50.68
Zeri,Teemo,556,273,283,49.1
Zeri,Renekton,288,170,118,59.03
Zeri,Nunu,245,122,123,49.8
Zeri,Lux,1035,494,541,47.73
Zeri,Thresh,720,336,384,46.67
Zeri,Ornn,194,109,85,56.19
Zeri,FiddleSticks,270,128,142,47.41
Zeri,Yasuo,939,486,453,51.76
Zeri,Milio,259,164,95,63.32
Zeri,Chogath,556,269,287,48.38
Zeri,Trundle,269,131,138,48.7
Zeri,AurelionSol,164,83,81,50.61
Zeri,Veigar,401,164,237,40.9
Zeri,Brand,266,138,128,51.88
Zeri,Katarina,352,158,194,44.89
Zeri,Lucian,379,212,167,55.94
Zeri,Nami,495,212,283,42.83
Zeri,Fiora,173,89,84,51.45
Zeri,Galio,460,210,250,45.65
Zeri,Nilah,126,58,68,46.03
Zeri,Darius,745,336,409,45.1
Zeri,Shaco,418,211,207,50.48
Zeri,Malphite,516,232,284,44.96
Zeri,Qiyana,146,73,73,50
Zeri,Janna,164,87,77,53.05
Zeri,Diana,792,406,386,51.26
Zeri,Ziggs,171,85,86,49.71
Zeri,Vi,571,225,346,39.4
Zeri,Rammus,101,52,49,51.49
Zeri,Kaisa,923,461,462,49.95
Zeri,Zyra,580,304,276,52.41
Zeri,Nasus,330,155,175,46.97
Zeri,Sivir,293,143,150,48.81
Zeri,Senna,368,191,177,51.9
Zeri,Yone,925,497,428,53.73
Zeri,Volibear,474,227,247,47.89
Zeri,Maokai,237,102,135,43.04
Zeri,Vladimir,340,186,154,54.71
Zeri,LeeSin,964,475,489,49.27
Zeri,Syndra,357,179,178,50.14
Zeri,Garen,790,365,425,46.2
Zeri,Lillia,276,105,171,38.04
Zeri,Malzahar,435,195,240,44.83
Zeri,Soraka,274,101,173,36.86
Zeri,Jayce,363,165,198,45.45
Zeri,MasterYi,516,282,234,54.65
Zeri,Nautilus,588,270,318,45.92
Zeri,Zac,274,144,130,52.55
Zeri,Sylas,736,300,436,40.76
Zeri,Caitlyn,1124,544,580,48.4
Zeri,Rengar,188,94,94,50
Zeri,Taliyah,145,73,72,50.34
Zeri,Jhin,921,459,462,49.84
Zeri,Aurora,370,210,160,56.76
Zeri,Varus,508,243,265,47.83
Zeri,Nidalee,186,106,80,56.99
Zeri,Kayle,270,138,132,51.11
Zeri,Ivern,69,42,27,60.87
Zeri,Naafiri,132,42,90,31.82
Zeri,Ahri,629,322,307,51.19
Zeri,Lulu,687,337,350,49.05
Zeri,Gragas,334,177,157,52.99
Zeri,Annie,179,86,93,48.04
Zeri,Quinn,141,64,77,45.39
Zeri,Belveth,127,72,55,56.69
Zeri,Sejuani,219,105,114,47.95
Zeri,Urgot,237,104,133,43.88
Zeri,Aatrox,470,245,225,52.13
Zeri,Rell,245,118,127,48.16
Zeri,Ambessa,353,184,169,52.12
Zeri,Zilean,161,84,77,52.17
Zeri,Akali,556,260,296,46.76
Zeri,Gnar,215,108,107,50.23
Zeri,Leblanc,328,162,166,49.39
Zeri,Anivia,144,75,69,52.08
Zeri,Sett,631,287,344,45.48
Zeri,Vayne,627,279,348,44.5
Zeri,Renata,66,30,36,45.45
Zeri,Viego,755,351,404,46.49
Zeri,Gangplank,254,152,102,59.84
Zeri,Graves,311,171,140,54.98
Zeri,Rakan,184,97,87,52.72
Zeri,Irelia,368,152,216,41.3
Zeri,Tristana,405,231,174,57.04
Zeri,Swain,393,173,220,44.02
Zeri,Pantheon,702,372,330,52.99
Zeri,Karthus,161,79,82,49.07
Zeri,Samira,329,145,184,44.07
Zeri,Seraphine,336,172,164,51.19
Zeri,Camille,163,69,94,42.33
Zeri,Cassiopeia,177,77,100,43.5
Zeri,Ekko,471,255,216,54.14
Zeri,Sona,130,55,75,42.31
Zeri,Jax,502,236,266,47.01
Zeri,Briar,316,145,171,45.89
Zeri,Xerath,448,225,223,50.22
Zeri,Bard,165,88,77,53.33
Zeri,JarvanIV,281,128,153,45.55
Zeri,Hecarim,230,125,105,54.35
Zeri,Kassadin,94,56,38,59.57
Zeri,Sion,353,144,209,40.79
Zeri,Kalista,106,58,48,54.72
Zeri,Taric,96,32,64,33.33
Zeri,Talon,345,169,176,48.99
Zeri,Viktor,488,216,272,44.26
Zeri,Corki,223,113,110,50.67
Zeri,Twitch,333,151,182,45.35
Zeri,TwistedFate,186,113,73,60.75
Zeri,Kindred,207,76,131,36.71
Zeri,Fizz,263,152,111,57.79
Zeri,Leona,421,221,200,52.49
Zeri,Velkoz,270,135,135,50
Zeri,Yuumi,381,198,183,51.97
Zeri,XinZhao,308,145,163,47.08
Zeri,Kennen,121,57,64,47.11
Zeri,Udyr,181,77,104,42.54
Zeri,Shyvana,113,61,52,53.98
Zeri,Alistar,267,129,138,48.31
Zeri,Akshan,181,79,102,43.65
Zeri,Rumble,161,73,88,45.34
Zeri,Riven,265,131,134,49.43
Zeri,Kled,67,35,32,52.24
Zeri,Aphelios,318,146,172,45.91
Zeri,Khazix,270,149,121,55.19
Zeri,Hwei,335,134,201,40
Zeri,Pyke,395,212,183,53.67
Zeri,Azir,189,119,70,62.96
Zeri,Poppy,357,146,211,40.9
Zeri,Skarner,125,65,60,52
Zeri,Gwen,222,136,86,61.26
Zeri,Blitzcrank,386,202,184,52.33
Zeri,Ryze,157,79,78,50.32
Zeri,Shen,268,160,108,59.7
Zeri,KogMaw,100,59,41,59
Zeri,Olaf,144,63,81,43.75
Zeri,DrMundo,242,107,135,44.21
Zeri,Smolder,341,194,147,56.89
Zeri,Neeko,188,95,93,50.53
Zeri,Illaoi,178,97,81,54.49
Zeri,RekSai,71,33,38,46.48
Zeri,KSante,285,150,135,52.63
Zeri,Lissandra,152,75,77,49.34
Zeri,Braum,252,151,101,59.92
Zeri,Zoe,198,85,113,42.93
Zeri,Elise,329,156,173,47.42
Zeri,Evelynn,143,56,87,39.16
Velkoz,Teemo,1009,483,526,47.87
Velkoz,Nocturne,1053,544,509,51.66
Velkoz,Hwei,465,241,224,51.83
Velkoz,Twitch,590,304,286,51.53
Velkoz,Karma,907,453,454,49.94
Velkoz,Sett,1089,494,595,45.36
Velkoz,Gragas,382,184,198,48.17
Velkoz,Yasuo,1300,645,655,49.62
Velkoz,Kalista,137,76,61,55.47
Velkoz,Mel,1423,743,680,52.21
Velkoz,Ambessa,430,250,180,58.14
Velkoz,Taliyah,160,87,73,54.38
Velkoz,Vex,363,195,168,53.72
Velkoz,MissFortune,1793,960,833,53.54
Velkoz,Elise,460,279,181,60.65
Velkoz,Warwick,1086,512,574,47.15
Velkoz,LeeSin,934,481,453,51.5
Velkoz,Kassadin,152,89,63,58.55
Velkoz,Jinx,2096,1037,1059,49.48
Velkoz,Morgana,931,506,425,54.35
Velkoz,Diana,1134,592,542,52.2
Velkoz,Nasus,452,245,207,54.2
Velkoz,Caitlyn,2014,1053,961,52.28
Velkoz,Ashe,1315,694,621,52.78
Velkoz,Kayle,542,244,298,45.02
Velkoz,Malphite,751,377,374,50.2
Velkoz,Ekko,726,361,365,49.72
Velkoz,Lux,2240,1206,1034,53.84
Velkoz,Tryndamere,418,213,205,50.96
Velkoz,Rengar,266,151,115,56.77
Velkoz,Viktor,680,363,317,53.38
Velkoz,Evelynn,282,133,149,47.16
Velkoz,Vladimir,497,245,252,49.3
Velkoz,Pantheon,1063,557,506,52.4
Velkoz,Jax,652,358,294,54.91
Velkoz,Mordekaiser,887,488,399,55.02
Velkoz,Syndra,451,235,216,52.11
Velkoz,Kaisa,1133,595,538,52.52
Velkoz,Ezreal,1640,842,798,51.34
Velkoz,Viego,938,468,470,49.89
Velkoz,Veigar,819,401,418,48.96
Velkoz,Milio,385,189,196,49.09
Velkoz,Chogath,904,475,429,52.54
Velkoz,Smolder,429,237,192,55.24
Velkoz,Renata,89,52,37,58.43
Velkoz,JarvanIV,406,204,202,50.25
Velkoz,Brand,642,322,320,50.16
Velkoz,Zyra,625,304,321,48.64
Velkoz,Sejuani,291,170,121,58.42
Velkoz,Samira,552,306,246,55.43
Velkoz,Nautilus,820,451,369,55
Velkoz,Irelia,619,313,306,50.57
Velkoz,Ahri,906,478,428,52.76
Velkoz,Thresh,959,475,484,49.53
Velkoz,Darius,1419,721,698,50.81
Velkoz,Bard,220,102,118,46.36
Velkoz,Rammus,200,119,81,59.5
Velkoz,Ryze,234,111,123,47.44
Velkoz,Swain,696,299,397,42.96
Velkoz,Gangplank,310,151,159,48.71
Velkoz,Nilah,269,131,138,48.7
Velkoz,Blitzcrank,553,291,262,52.62
Velkoz,Shen,484,236,248,48.76
Velkoz,Yorick,811,378,433,46.61
Velkoz,Xerath,798,395,403,49.5
Velkoz,Jhin,1484,722,762,48.65
Velkoz,Seraphine,606,311,295,51.32
Velkoz,Gwen,393,207,186,52.67
Velkoz,Varus,611,306,305,50.08
Velkoz,MasterYi,951,471,480,49.53
Velkoz,Fizz,505,251,254,49.7
Velkoz,Soraka,447,211,236,47.2
Velkoz,TahmKench,552,277,275,50.18
Velkoz,Shaco,679,372,307,54.79
Velkoz,Camille,258,112,146,43.41
Velkoz,Khazix,317,140,177,44.16
Velkoz,Akali,654,325,329,49.69
Velkoz,Kayn,1095,520,575,47.49
Velkoz,Sylas,839,441,398,52.56
Velkoz,Leblanc,396,216,180,54.55
Velkoz,Galio,621,317,304,51.05
Velkoz,Anivia,280,133,147,47.5
Velkoz,Zilean,264,128,136,48.48
Velkoz,Aurora,469,233,236,49.68
Velkoz,Qiyana,219,118,101,53.88
Velkoz,XinZhao,468,223,245,47.65
Velkoz,Poppy,364,201,163,55.22
Velkoz,Yone,1299,742,557,57.12
Velkoz,Neeko,299,174,125,58.19
Velkoz,Aatrox,566,288,278,50.88
Velkoz,Vi,593,308,285,51.94
Velkoz,Trundle,366,196,170,53.55
Velkoz,KSante,323,165,158,51.08
Velkoz,Zed,763,359,404,47.05
Velkoz,Udyr,292,169,123,57.88
Velkoz,Tristana,780,382,398,48.97
Velkoz,Lucian,463,242,221,52.27
Velkoz,Sona,215,98,117,45.58
Velkoz,Volibear,889,454,435,51.07
Velkoz,Aphelios,377,204,173,54.11
Velkoz,Nunu,446,233,213,52.24
Velkoz,Rakan,287,137,150,47.74
Velkoz,Ornn,303,156,147,51.49
Velkoz,Heimerdinger,362,195,167,53.87
Velkoz,Nami,720,359,361,49.86
Velkoz,DrMundo,409,217,192,53.06
Velkoz,Naafiri,254,117,137,46.06
Velkoz,Malzahar,844,414,430,49.05
Velkoz,Rumble,178,103,75,57.87
Velkoz,Riven,346,181,165,52.31
Velkoz,Ziggs,287,125,162,43.55
Velkoz,Fiora,263,142,121,53.99
Velkoz,Talon,345,191,154,55.36
Velkoz,Draven,414,209,205,50.48
Velkoz,Illaoi,318,189,129,59.43
Velkoz,Renekton,359,212,147,59.05
Velkoz,Senna,566,328,238,57.95
Velkoz,Katarina,564,282,282,50
Velkoz,Yuumi,518,259,259,50
Velkoz,Pyke,503,270,233,53.68
Velkoz,Alistar,238,112,126,47.06
Velkoz,AurelionSol,298,158,140,53.02
Velkoz,Rell,391,220,171,56.27
Velkoz,Garen,1187,617,570,51.98
Velkoz,Lulu,925,456,469,49.3
Velkoz,Lillia,342,200,142,58.48
Velkoz,Graves,434,256,178,58.99
Velkoz,Leona,610,314,296,51.48
Velkoz,Janna,242,124,118,51.24
Velkoz,Briar,551,272,279,49.36
Velkoz,Amumu,834,416,418,49.88
Velkoz,Vayne,981,499,482,50.87
Velkoz,Azir,230,124,106,53.91
Velkoz,Gnar,269,147,122,54.65
Velkoz,Kindred,302,152,150,50.33
Velkoz,Karthus,185,100,85,54.05
Velkoz,Sion,508,245,263,48.23
Velkoz,MonkeyKing,517,265,252,51.26
Velkoz,Quinn,313,157,156,50.16
Velkoz,FiddleSticks,339,164,175,48.38
Velkoz,Urgot,411,194,217,47.2
Velkoz,Corki,328,189,139,57.62
Velkoz,Hecarim,357,199,158,55.74
Velkoz,Zoe,272,158,114,58.09
Velkoz,Zac,313,151,162,48.24
Velkoz,Sivir,404,196,208,48.51
Velkoz,Orianna,295,157,138,53.22
Velkoz,TwistedFate,220,131,89,59.55
Velkoz,Braum,374,201,173,53.74
Velkoz,Singed,184,104,80,56.52
Velkoz,Olaf,156,81,75,51.92
Velkoz,Akshan,237,95,142,40.08
Velkoz,Zeri,270,135,135,50
Velkoz,Skarner,165,87,78,52.73
Velkoz,Maokai,313,138,175,44.09
Velkoz,Jayce,321,181,140,56.39
Velkoz,Nidalee,205,112,93,54.63
Velkoz,Xayah,305,182,123,59.67
Velkoz,Annie,258,137,121,53.1
Velkoz,Lissandra,198,106,92,53.54
Velkoz,Ivern,79,51,28,64.56
Velkoz,Kled,122,74,48,60.66
Velkoz,Kennen,152,79,73,51.97
Velkoz,Cassiopeia,175,96,79,54.86
Velkoz,Taric,171,87,84,50.88
Velkoz,Shyvana,167,96,71,57.49
Velkoz,Belveth,157,68,89,43.31
Velkoz,KogMaw,221,110,111,49.77
Velkoz,RekSai,65,38,27,58.46
Renata,Teemo,256,145,111,56.64
Renata,Khazix,90,51,39,56.67
Renata,Lux,443,212,231,47.86
Renata,Jinx,648,317,331,48.92
Renata,Milio,132,72,60,54.55
Renata,Garen,345,152,193,44.06
Renata,Belveth,53,27,26,50.94
Renata,Yasuo,341,168,173,49.27
Renata,Jhin,422,221,201,52.37
Renata,Seraphine,146,72,74,49.32
Renata,Poppy,176,84,92,47.73
Renata,Evelynn,59,31,28,52.54
Renata,Zed,217,86,131,39.63
Renata,Corki,98,46,52,46.94
Renata,Elise,121,57,64,47.11
Renata,Aatrox,177,84,93,47.46
Renata,Viego,329,139,190,42.25
Renata,Naafiri,45,19,26,42.22
Renata,Nilah,91,47,44,51.65
Renata,Brand,133,52,81,39.1
Renata,Volibear,221,102,119,46.15
Renata,Warwick,331,153,178,46.22
Renata,Yone,355,180,175,50.7
Renata,Mel,261,146,115,55.94
Renata,Sylas,258,111,147,43.02
Renata,Velkoz,89,37,52,41.57
Renata,Kaisa,370,165,205,44.59
Renata,Veigar,158,60,98,37.97
Renata,KSante,75,34,41,45.33
Renata,Ekko,174,77,97,44.25
Renata,Thresh,279,139,140,49.82
Renata,Sett,269,119,150,44.24
Renata,Rengar,78,48,30,61.54
Renata,Janna,89,54,35,60.67
Renata,Olaf,39,12,27,30.77
Renata,Qiyana,32,18,14,56.25
Renata,Katarina,151,72,79,47.68
Renata,Trundle,89,39,50,43.82
Renata,Xayah,92,42,50,45.65
Renata,Anivia,73,41,32,56.16
Renata,Akali,231,113,118,48.92
Renata,Pyke,144,77,67,53.47
Renata,Vladimir,108,45,63,41.67
Renata,Graves,122,68,54,55.74
Renata,Irelia,160,76,84,47.5
Renata,Vayne,235,112,123,47.66
Renata,Lulu,305,153,152,50.16
Renata,Darius,327,138,189,42.2
Renata,Hecarim,81,48,33,59.26
Renata,Karma,307,147,160,47.88
Renata,Nautilus,289,147,142,50.87
Renata,Talon,106,73,33,68.87
Renata,Urgot,103,45,58,43.69
Renata,Sejuani,67,26,41,38.81
Renata,Taliyah,53,27,26,50.94
Renata,Ezreal,439,252,187,57.4
Renata,Ornn,84,32,52,38.1
Renata,LeeSin,268,136,132,50.75
Renata,Ryze,92,50,42,54.35
Renata,Zilean,59,29,30,49.15
Renata,Jayce,94,58,36,61.7
Renata,Briar,122,72,50,59.02
Renata,Maokai,113,54,59,47.79
Renata,Gnar,118,62,56,52.54
Renata,Kayn,297,143,154,48.15
Renata,Ahri,239,112,127,46.86
Renata,Samira,144,66,78,45.83
Renata,Rakan,99,68,31,68.69
Renata,Sivir,125,53,72,42.4
Renata,Morgana,184,76,108,41.3
Renata,Renekton,105,57,48,54.29
Renata,Karthus,43,16,27,37.21
Renata,Zac,103,55,48,53.4
Renata,Caitlyn,448,209,239,46.65
Renata,Swain,180,100,80,55.56
Renata,Aurora,164,96,68,58.54
Renata,Twitch,185,108,77,58.38
Renata,Kennen,63,36,27,57.14
Renata,TwistedFate,90,51,39,56.67
Renata,Ashe,394,181,213,45.94
Renata,Ambessa,126,81,45,64.29
Renata,Tristana,203,85,118,41.87
Renata,Shaco,162,91,71,56.17
Renata,AurelionSol,79,41,38,51.9
Renata,Lillia,65,24,41,36.92
Renata,Viktor,206,86,120,41.75
Renata,Kalista,66,34,32,51.52
Renata,Udyr,66,32,34,48.48
Renata,Zeri,66,36,30,54.55
Renata,Rell,99,38,61,38.38
Renata,Heimerdinger,55,32,23,58.18
Renata,Ziggs,75,30,45,40
Renata,Zoe,81,38,43,46.91
Renata,Nocturne,296,138,158,46.62
Renata,MissFortune,393,202,191,51.4
Renata,Diana,301,143,158,47.51
Renata,Lissandra,88,36,52,40.91
Renata,Nami,232,104,128,44.83
Renata,Shen,108,48,60,44.44
Renata,Blitzcrank,110,49,61,44.55
Renata,Smolder,121,63,58,52.07
Renata,KogMaw,69,28,41,40.58
Renata,Vex,94,40,54,42.55
Renata,Alistar,120,60,60,50
Renata,Lucian,128,61,67,47.66
Renata,Nasus,161,85,76,52.8
Renata,DrMundo,90,30,60,33.33
Renata,Annie,58,20,38,34.48
Renata,Syndra,158,69,89,43.67
Renata,Pantheon,227,127,100,55.95
Renata,Mordekaiser,236,113,123,47.88
Renata,Bard,70,30,40,42.86
Renata,Leona,151,65,86,43.05
Renata,Hwei,95,56,39,58.95
Renata,MasterYi,291,117,174,40.21
Renata,Singed,44,29,15,65.91
Renata,Senna,149,64,85,42.95
Renata,Rammus,57,24,33,42.11
Renata,Braum,91,55,36,60.44
Renata,Fiora,78,35,43,44.87
Renata,Gragas,96,47,49,48.96
Renata,Yorick,159,76,83,47.8
Renata,Riven,83,32,51,38.55
Renata,Gangplank,101,57,44,56.44
Renata,Sona,82,31,51,37.8
Renata,Jax,213,97,116,45.54
Renata,Camille,84,33,51,39.29
Renata,Kayle,109,60,49,55.05
Renata,Yuumi,105,45,60,42.86
Renata,Soraka,109,62,47,56.88
Renata,Illaoi,83,52,31,62.65
Renata,Orianna,100,44,56,44
Renata,Azir,69,31,38,44.93
Renata,Akshan,88,52,36,59.09
Renata,Galio,196,91,105,46.43
Renata,Chogath,200,98,102,49
Renata,Varus,150,80,70,53.33
Renata,Vi,217,96,121,44.24
Renata,Quinn,59,23,36,38.98
Renata,Sion,126,57,69,45.24
Renata,MonkeyKing,151,71,80,47.02
Renata,Malphite,162,85,77,52.47
Renata,Kindred,88,36,52,40.91
Renata,Nidalee,59,24,35,40.68
Renata,Leblanc,116,56,60,48.28
Renata,Xerath,173,70,103,40.46
Renata,Skarner,49,21,28,42.86
Renata,Draven,106,56,50,52.83
Renata,Neeko,97,39,58,40.21
Renata,Rumble,50,27,23,54
Renata,Malzahar,184,91,93,49.46
Renata,Taric,51,20,31,39.22
Renata,Tryndamere,133,60,73,45.11
Renata,Kled,36,16,20,44.44
Renata,Fizz,100,58,42,58
Renata,Nunu,99,37,62,37.37
Renata,TahmKench,136,67,69,49.26
Renata,JarvanIV,132,84,48,63.64
Renata,Cassiopeia,55,26,29,47.27
Renata,Zyra,152,72,80,47.37
Renata,Ivern,39,15,24,38.46
Renata,Kassadin,22,11,11,50
Renata,Aphelios,108,38,70,35.19
Renata,Amumu,155,64,91,41.29
Renata,XinZhao,117,33,84,28.21
Renata,Shyvana,39,25,14,64.1
Renata,Gwen,98,41,57,41.84
Renata,FiddleSticks,97,52,45,53.61
Renata,RekSai,22,19,3,86.36
Kalista,Warwick,416,188,228,45.19
Kalista,Shen,139,52,87,37.41
Kalista,Velkoz,137,61,76,44.53
Kalista,Varus,322,156,166,48.45
Kalista,Rakan,103,44,59,42.72
Kalista,Jax,306,163,143,53.27
Kalista,Rengar,118,62,56,52.54
Kalista,Camille,132,68,64,51.52
Kalista,Sivir,141,76,65,53.9
Kalista,Karma,401,181,220,45.14
Kalista,Malphite,310,162,148,52.26
Kalista,Shyvana,67,44,23,65.67
Kalista,Naafiri,73,33,40,45.21
Kalista,MissFortune,652,268,384,41.1
Kalista,Maokai,136,65,71,47.79
Kalista,Teemo,309,133,176,43.04
Kalista,Zed,341,174,167,51.03
Kalista,Ashe,620,314,306,50.65
Kalista,Sett,454,201,253,44.27
Kalista,Xerath,255,110,145,43.14
Kalista,Caitlyn,742,321,421,43.26
Kalista,Milio,170,79,91,46.47
Kalista,Renekton,167,88,79,52.69
Kalista,Gwen,129,41,88,31.78
Kalista,Akshan,93,35,58,37.63
Kalista,Mel,598,328,270,54.85
Kalista,Nami,278,116,162,41.73
Kalista,KSante,159,62,97,38.99
Kalista,Malzahar,324,110,214,33.95
Kalista,Soraka,186,107,79,57.53
Kalista,Belveth,67,32,35,47.76
Kalista,Kaisa,521,310,211,59.5
Kalista,Veigar,293,112,181,38.23
Kalista,Swain,251,132,119,52.59
Kalista,Diana,463,238,225,51.4
Kalista,AurelionSol,107,52,55,48.6
Kalista,Draven,166,71,95,42.77
Kalista,Zyra,261,126,135,48.28
Kalista,Yorick,226,98,128,43.36
Kalista,Neeko,121,67,54,55.37
Kalista,Yone,522,287,235,54.98
Kalista,Nautilus,325,171,154,52.62
Kalista,MonkeyKing,200,87,113,43.5
Kalista,Hwei,174,71,103,40.8
Kalista,Lucian,208,88,120,42.31
Kalista,Pyke,252,142,110,56.35
Kalista,Quinn,90,26,64,28.89
Kalista,Ryze,153,100,53,65.36
Kalista,Lux,734,328,406,44.69
Kalista,Taliyah,133,47,86,35.34
Kalista,Illaoi,134,65,69,48.51
Kalista,Poppy,222,86,136,38.74
Kalista,Lissandra,124,60,64,48.39
Kalista,Jhin,617,302,315,48.95
Kalista,Garen,446,218,228,48.88
Kalista,Briar,174,70,104,40.23
Kalista,Ezreal,918,519,399,56.54
Kalista,Brand,212,108,104,50.94
Kalista,Ambessa,214,109,105,50.93
Kalista,Vi,287,143,144,49.83
Kalista,Katarina,226,103,123,45.58
Kalista,Vayne,404,163,241,40.35
Kalista,Lulu,406,203,203,50
Kalista,Pantheon,420,196,224,46.67
Kalista,Leona,198,95,103,47.98
Kalista,Graves,200,95,105,47.5
Kalista,Vex,145,80,65,55.17
Kalista,Darius,465,198,267,42.58
Kalista,Jinx,778,354,424,45.5
Kalista,Azir,118,70,48,59.32
Kalista,Volibear,290,130,160,44.83
Kalista,Qiyana,84,53,31,63.1
Kalista,Nasus,186,100,86,53.76
Kalista,Morgana,324,161,163,49.69
Kalista,Sejuani,102,40,62,39.22
Kalista,Ahri,346,151,195,43.64
Kalista,TwistedFate,98,43,55,43.88
Kalista,Yasuo,517,303,214,58.61
Kalista,Amumu,271,104,167,38.38
Kalista,Tristana,284,128,156,45.07
Kalista,Kindred,123,67,56,54.47
Kalista,Nilah,76,24,52,31.58
Kalista,Yuumi,248,142,106,57.26
Kalista,Kayn,382,160,222,41.88
Kalista,Braum,149,64,85,42.95
Kalista,RekSai,34,23,11,67.65
Kalista,Irelia,273,139,134,50.92
Kalista,Olaf,92,55,37,59.78
Kalista,Leblanc,202,78,124,38.61
Kalista,Taric,79,41,38,51.9
Kalista,Tryndamere,149,77,72,51.68
Kalista,Seraphine,203,115,88,56.65
Kalista,Fiora,82,32,50,39.02
Kalista,LeeSin,530,267,263,50.38
Kalista,Thresh,396,189,207,47.73
Kalista,Sylas,433,195,238,45.03
Kalista,Aphelios,153,68,85,44.44
Kalista,Renata,66,32,34,48.48
Kalista,Urgot,126,63,63,50
Kalista,Nocturne,389,180,209,46.27
Kalista,Zilean,89,42,47,47.19
Kalista,Akali,382,189,193,49.48
Kalista,Ziggs,108,56,52,51.85
Kalista,Zoe,83,39,44,46.99
Kalista,Mordekaiser,347,172,175,49.57
Kalista,Singed,89,32,57,35.96
Kalista,Viktor,260,144,116,55.38
Kalista,Sona,76,42,34,55.26
Kalista,Chogath,268,112,156,41.79
Kalista,Evelynn,115,53,62,46.09
Kalista,Smolder,215,87,128,40.47
Kalista,Blitzcrank,211,105,106,49.76
Kalista,Trundle,175,97,78,55.43
Kalista,Skarner,86,39,47,45.35
Kalista,Ornn,90,40,50,44.44
Kalista,KogMaw,67,31,36,46.27
Kalista,Aatrox,293,164,129,55.97
Kalista,Xayah,159,83,76,52.2
Kalista,Shaco,201,81,120,40.3
Kalista,Annie,89,22,67,24.72
Kalista,Alistar,150,76,74,50.67
Kalista,Kled,53,13,40,24.53
Kalista,Ekko,313,178,135,56.87
Kalista,Orianna,163,63,100,38.65
Kalista,Anivia,93,47,46,50.54
Kalista,Nunu,157,74,83,47.13
Kalista,Riven,126,58,68,46.03
Kalista,Viego,460,234,226,50.87
Kalista,Vladimir,181,94,87,51.93
Kalista,Heimerdinger,97,29,68,29.9
Kalista,JarvanIV,168,95,73,56.55
Kalista,Rammus,110,35,75,31.82
Kalista,Aurora,135,72,63,53.33
Kalista,Elise,269,105,164,39.03
Kalista,Karthus,64,34,30,53.13
Kalista,Gnar,121,57,64,47.11
Kalista,Syndra,178,93,85,52.25
Kalista,Gangplank,106,63,43,59.43
Kalista,Senna,189,101,88,53.44
Kalista,TahmKench,190,75,115,39.47
Kalista,MasterYi,311,147,164,47.27
Kalista,Zeri,106,48,58,45.28
Kalista,Samira,171,83,88,48.54
Kalista,Kayle,217,101,116,46.54
Kalista,Zac,109,49,60,44.95
Kalista,Rell,103,50,53,48.54
Kalista,Twitch,185,87,98,47.03
Kalista,Gragas,169,70,99,41.42
Kalista,Cassiopeia,107,41,66,38.32
Kalista,Khazix,142,84,58,59.15
Kalista,Udyr,107,47,60,43.93
Kalista,Bard,103,45,58,43.69
Kalista,Lillia,135,47,88,34.81
Kalista,Janna,107,51,56,47.66
Kalista,DrMundo,162,83,79,51.23
Kalista,Kassadin,79,42,37,53.16
Kalista,Jayce,153,79,74,51.63
Kalista,XinZhao,207,97,110,46.86
Kalista,Talon,158,86,72,54.43
Kalista,FiddleSticks,115,43,72,37.39
Kalista,Hecarim,128,77,51,60.16
Kalista,Fizz,152,90,62,59.21
Kalista,Nidalee,70,30,40,42.86
Kalista,Sion,209,99,110,47.37
Kalista,Ivern,34,7,27,20.59
Kalista,Kennen,89,37,52,41.57
Kalista,Galio,226,115,111,50.88
Kalista,Corki,122,67,55,54.92
Kalista,Rumble,73,39,34,53.42
Shyvana,Sion,210,109,101,51.9
Shyvana,Nocturne,455,228,227,50.11
Shyvana,Katarina,222,116,106,52.25
Shyvana,Ezreal,639,350,289,54.77
Shyvana,Teemo,382,190,192,49.74
Shyvana,Fiora,90,37,53,41.11
Shyvana,Sylas,370,183,187,49.46
Shyvana,Jinx,784,379,405,48.34
Shyvana,Varus,254,141,113,55.51
Shyvana,Chogath,352,162,190,46.02
Shyvana,Shaco,298,150,148,50.34
Shyvana,Zed,265,147,118,55.47
Shyvana,Sivir,153,80,73,52.29
Shyvana,Milio,153,53,100,34.64
Shyvana,Kayle,191,103,88,53.93
Shyvana,Elise,168,92,76,54.76
Shyvana,Swain,338,187,151,55.33
Shyvana,Kalista,67,23,44,34.33
Shyvana,Karma,318,160,158,50.31
Shyvana,Kayn,500,248,252,49.6
Shyvana,Hwei,175,82,93,46.86
Shyvana,Blitzcrank,207,110,97,53.14
Shyvana,Mel,544,263,281,48.35
Shyvana,Twitch,257,118,139,45.91
Shyvana,Thresh,379,216,163,56.99
Shyvana,Khazix,110,60,50,54.55
Shyvana,Ekko,315,168,147,53.33
Shyvana,Lucian,199,86,113,43.22
Shyvana,Braum,178,93,85,52.25
Shyvana,Gragas,164,68,96,41.46
Shyvana,MasterYi,330,139,191,42.12
Shyvana,Malzahar,338,165,173,48.82
Shyvana,DrMundo,175,95,80,54.29
Shyvana,Gangplank,121,65,56,53.72
Shyvana,Veigar,298,171,127,57.38
Shyvana,Smolder,222,99,123,44.59
Shyvana,Garen,584,265,319,45.38
Shyvana,Ahri,382,172,210,45.03
Shyvana,Taric,48,37,11,77.08
Shyvana,TwistedFate,103,41,62,39.81
Shyvana,Darius,592,290,302,48.99
Shyvana,Caitlyn,775,397,378,51.23
Shyvana,Yone,486,252,234,51.85
Shyvana,Xayah,132,74,58,56.06
Shyvana,Rakan,132,55,77,41.67
Shyvana,Rengar,79,51,28,64.56
Shyvana,Kassadin,58,23,35,39.66
Shyvana,Jhin,608,300,308,49.34
Shyvana,Yasuo,520,246,274,47.31
Shyvana,Viego,394,207,187,52.54
Shyvana,Zilean,85,34,51,40
Shyvana,Sett,424,193,231,45.52
Shyvana,Hecarim,162,96,66,59.26
Shyvana,Brand,261,143,118,54.79
Shyvana,Aphelios,136,62,74,45.59
Shyvana,Naafiri,111,71,40,63.96
Shyvana,Aurora,205,102,103,49.76
Shyvana,Ashe,592,314,278,53.04
Shyvana,KSante,141,67,74,47.52
Shyvana,Lillia,166,82,84,49.4
Shyvana,Ornn,115,52,63,45.22
Shyvana,Vayne,431,192,239,44.55
Shyvana,Olaf,51,31,20,60.78
Shyvana,Renekton,115,58,57,50.43
Shyvana,Akali,348,192,156,55.17
Shyvana,Draven,155,88,67,56.77
Shyvana,Annie,86,50,36,58.14
Shyvana,Illaoi,157,59,98,37.58
Shyvana,Zoe,105,58,47,55.24
Shyvana,Gnar,124,50,74,40.32
Shyvana,Gwen,183,93,90,50.82
Shyvana,Rell,134,61,73,45.52
Shyvana,Malphite,321,171,150,53.27
Shyvana,Diana,475,204,271,42.95
Shyvana,Mordekaiser,386,188,198,48.7
Shyvana,Volibear,401,226,175,56.36
Shyvana,Anivia,91,44,47,48.35
Shyvana,Lux,713,380,333,53.3
Shyvana,MissFortune,742,346,396,46.63
Shyvana,Lulu,368,179,189,48.64
Shyvana,Shen,200,95,105,47.5
Shyvana,Irelia,263,136,127,51.71
Shyvana,Vex,152,69,83,45.39
Shyvana,Jax,221,126,95,57.01
Shyvana,JarvanIV,195,89,106,45.64
Shyvana,Samira,217,131,86,60.37
Shyvana,Pantheon,404,200,204,49.5
Shyvana,Yorick,310,124,186,40
Shyvana,Amumu,395,198,197,50.13
Shyvana,Nautilus,315,188,127,59.68
Shyvana,Vladimir,232,102,130,43.97
Shyvana,Zyra,270,132,138,48.89
Shyvana,Sejuani,87,52,35,59.77
Shyvana,Azir,68,25,43,36.76
Shyvana,Kaisa,488,266,222,54.51
Shyvana,Graves,214,128,86,59.81
Shyvana,Zac,162,69,93,42.59
Shyvana,Qiyana,71,45,26,63.38
Shyvana,Nami,294,116,178,39.46
Shyvana,Heimerdinger,134,60,74,44.78
Shyvana,TahmKench,188,80,108,42.55
Shyvana,XinZhao,158,76,82,48.1
Shyvana,Pyke,195,111,84,56.92
Shyvana,Xerath,234,112,122,47.86
Shyvana,Riven,134,58,76,43.28
Shyvana,Ivern,30,15,15,50
Shyvana,Talon,191,107,84,56.02
Shyvana,Soraka,157,77,80,49.04
Shyvana,Warwick,438,222,216,50.68
Shyvana,Neeko,120,58,62,48.33
Shyvana,Leblanc,144,67,77,46.53
Shyvana,Yuumi,212,102,110,48.11
Shyvana,Udyr,123,65,58,52.85
Shyvana,Trundle,158,84,74,53.16
Shyvana,Tristana,286,155,131,54.2
Shyvana,Maokai,145,68,77,46.9
Shyvana,Leona,299,153,146,51.17
Shyvana,Karthus,52,22,30,42.31
Shyvana,Kled,94,58,36,61.7
Shyvana,LeeSin,300,146,154,48.67
Shyvana,Urgot,188,64,124,34.04
Shyvana,Vi,271,165,106,60.89
Shyvana,Corki,125,59,66,47.2
Shyvana,Senna,259,132,127,50.97
Shyvana,Evelynn,103,48,55,46.6
Shyvana,Morgana,346,142,204,41.04
Shyvana,MonkeyKing,174,90,84,51.72
Shyvana,Zeri,113,52,61,46.02
Shyvana,Aatrox,177,84,93,47.46
Shyvana,FiddleSticks,137,76,61,55.47
Shyvana,Ambessa,178,88,90,49.44
Shyvana,Tryndamere,133,74,59,55.64
Shyvana,Fizz,166,92,74,55.42
Shyvana,Alistar,147,72,75,48.98
Shyvana,Nasus,190,109,81,57.37
Shyvana,Jayce,104,49,55,47.12
Shyvana,Poppy,167,93,74,55.69
Shyvana,Singed,80,34,46,42.5
Shyvana,Janna,119,43,76,36.13
Shyvana,Quinn,115,59,56,51.3
Shyvana,Sona,85,35,50,41.18
Shyvana,Nunu,145,72,73,49.66
Shyvana,Lissandra,89,39,50,43.82
Shyvana,Ziggs,101,53,48,52.48
Shyvana,Camille,121,60,61,49.59
Shyvana,Skarner,73,38,35,52.05
Shyvana,Syndra,145,92,53,63.45
Shyvana,Kindred,130,60,70,46.15
Shyvana,Rumble,83,43,40,51.81
Shyvana,Akshan,95,38,57,40
Shyvana,Bard,93,43,50,46.24
Shyvana,Viktor,267,117,150,43.82
Shyvana,Briar,185,79,106,42.7
Shyvana,Orianna,109,60,49,55.05
Shyvana,Ryze,87,36,51,41.38
Shyvana,AurelionSol,85,43,42,50.59
Shyvana,Nidalee,55,33,22,60
Shyvana,Seraphine,203,98,105,48.28
Shyvana,RekSai,24,7,17,29.17
Shyvana,Velkoz,167,71,96,42.51
Shyvana,Cassiopeia,82,44,38,53.66
Shyvana,Nilah,95,42,53,44.21
Shyvana,Belveth,60,25,35,41.67
Shyvana,Kennen,69,32,37,46.38
Shyvana,KogMaw,71,31,40,43.66
Shyvana,Renata,39,14,25,35.9
Shyvana,Galio,242,126,116,52.07
Shyvana,Rammus,53,21,32,39.62
Shyvana,Taliyah,52,34,18,65.38
Camille,Renekton,260,154,106,59.23
Camille,XinZhao,291,132,159,45.36
Camille,Yasuo,767,350,417,45.63
Camille,Kalista,132,64,68,48.48
Camille,Pantheon,719,356,363,49.51
Camille,Quinn,177,73,104,41.24
Camille,Zac,232,92,140,39.66
Camille,Vladimir,295,124,171,42.03
Camille,Ezreal,1087,490,597,45.08
Camille,Brand,271,135,136,49.82
Camille,Sion,263,128,135,48.67
Camille,Karthus,134,56,78,41.79
Camille,Ekko,387,191,196,49.35
Camille,KogMaw,111,50,61,45.05
Camille,Lulu,641,322,319,50.23
Camille,Gangplank,163,59,104,36.2
Camille,RekSai,32,19,13,59.38
Camille,Xerath,390,183,207,46.92
Camille,Vayne,516,256,260,49.61
Camille,Nautilus,440,205,235,46.59
Camille,TahmKench,260,133,127,51.15
Camille,Qiyana,100,49,51,49
Camille,Katarina,301,152,149,50.5
Camille,Gnar,193,94,99,48.7
Camille,Rammus,102,34,68,33.33
Camille,Veigar,345,150,195,43.48
Camille,Soraka,247,123,124,49.8
Camille,Neeko,172,89,83,51.74
Camille,JarvanIV,246,118,128,47.97
Camille,Yone,662,335,327,50.6
Camille,Ashe,827,390,437,47.16
Camille,Swain,319,147,172,46.08
Camille,Talon,329,172,157,52.28
Camille,Jhin,827,418,409,50.54
Camille,Nami,484,253,231,52.27
Camille,Ambessa,433,225,208,51.96
Camille,Lux,958,450,508,46.97
Camille,MissFortune,834,413,421,49.52
Camille,Thresh,548,261,287,47.63
Camille,Darius,762,394,368,51.71
Camille,Yorick,287,122,165,42.51
Camille,Syndra,304,157,147,51.64
Camille,Garen,1096,551,545,50.27
Camille,DrMundo,215,92,123,42.79
Camille,AurelionSol,159,70,89,44.03
Camille,Xayah,239,106,133,44.35
Camille,Ornn,181,88,93,48.62
Camille,FiddleSticks,206,99,107,48.06
Camille,Milio,279,133,146,47.67
Camille,Kayn,556,307,249,55.22
Camille,Elise,384,198,186,51.56
Camille,Riven,222,95,127,42.79
Camille,Lillia,209,149,60,71.29
Camille,Jayce,299,161,138,53.85
Camille,Caitlyn,1082,543,539,50.18
Camille,Zyra,419,190,229,45.35
Camille,Evelynn,122,53,69,43.44
Camille,Teemo,432,189,243,43.75
Camille,Velkoz,258,146,112,56.59
Camille,Rumble,81,49,32,60.49
Camille,LeeSin,657,307,350,46.73
Camille,Seraphine,317,160,157,50.47
Camille,Pyke,335,146,189,43.58
Camille,Hecarim,188,99,89,52.66
Camille,Karma,622,281,341,45.18
Camille,Chogath,435,214,221,49.2
Camille,Nocturne,516,240,276,46.51
Camille,Irelia,304,135,169,44.41
Camille,Nilah,127,61,66,48.03
Camille,Mordekaiser,479,222,257,46.35
Camille,Poppy,222,105,117,47.3
Camille,Naafiri,127,44,83,34.65
Camille,Lucian,304,162,142,53.29
Camille,Bard,176,78,98,44.32
Camille,Gragas,224,114,110,50.89
Camille,Morgana,381,161,220,42.26
Camille,Galio,379,150,229,39.58
Camille,Diana,695,312,383,44.89
Camille,Tryndamere,214,105,109,49.07
Camille,Cassiopeia,121,62,59,51.24
Camille,Malphite,328,138,190,42.07
Camille,Mel,846,438,408,51.77
Camille,Khazix,231,83,148,35.93
Camille,Singed,106,41,65,38.68
Camille,Varus,426,200,226,46.95
Camille,Amumu,368,188,180,51.09
Camille,Kassadin,96,53,43,55.21
Camille,Yuumi,325,168,157,51.69
Camille,Leblanc,287,188,99,65.51
Camille,Jinx,1136,517,619,45.51
Camille,Blitzcrank,283,153,130,54.06
Camille,Corki,197,92,105,46.7
Camille,Nasus,291,138,153,47.42
Camille,Urgot,204,73,131,35.78
Camille,Shen,256,131,125,51.17
Camille,Vex,233,116,117,49.79
Camille,Alistar,207,93,114,44.93
Camille,Jax,445,193,252,43.37
Camille,Rengar,155,75,80,48.39
Camille,Taliyah,110,39,71,35.45
Camille,Graves,357,163,194,45.66
Camille,Fizz,223,94,129,42.15
Camille,Vi,365,174,191,47.67
Camille,Samira,245,99,146,40.41
Camille,Viego,588,254,334,43.2
Camille,Orianna,201,84,117,41.79
Camille,Senna,307,133,174,43.32
Camille,Maokai,171,77,94,45.03
Camille,Fiora,220,99,121,45
Camille,Azir,158,85,73,53.8
Camille,Sivir,208,116,92,55.77
Camille,Shaco,357,167,190,46.78
Camille,Twitch,394,189,205,47.97
Camille,Braum,255,118,137,46.27
Camille,Aatrox,387,205,182,52.97
Camille,TwistedFate,156,71,85,45.51
Camille,Volibear,452,211,241,46.68
Camille,Aurora,312,148,164,47.44
Camille,Gwen,200,106,94,53
Camille,Kaisa,731,351,380,48.02
Camille,Viktor,449,262,187,58.35
Camille,Ryze,158,93,65,58.86
Camille,Zed,490,259,231,52.86
Camille,Rakan,160,73,87,45.63
Camille,Heimerdinger,112,57,55,50.89
Camille,Warwick,585,273,312,46.67
Camille,Aphelios,196,94,102,47.96
Camille,Ahri,536,256,280,47.76
Camille,Ivern,67,41,26,61.19
Camille,Sett,625,296,329,47.36
Camille,MonkeyKing,324,148,176,45.68
Camille,Draven,247,129,118,52.23
Camille,Trundle,178,120,58,67.42
Camille,Skarner,121,53,68,43.8
Camille,Sylas,581,277,304,47.68
Camille,Hwei,267,121,146,45.32
Camille,Rell,209,88,121,42.11
Camille,Illaoi,193,87,106,45.08
Camille,Kindred,174,84,90,48.28
Camille,Zoe,194,93,101,47.94
Camille,Ziggs,157,75,82,47.77
Camille,Sejuani,181,90,91,49.72
Camille,Tristana,387,203,184,52.45
Camille,Zeri,163,94,69,57.67
Camille,Akali,408,226,182,55.39
Camille,Malzahar,402,219,183,54.48
Camille,Leona,325,197,128,60.62
Camille,Briar,280,123,157,43.93
Camille,Anivia,128,47,81,36.72
Camille,Sona,134,43,91,32.09
Camille,Janna,179,77,102,43.02
Camille,MasterYi,473,229,244,48.41
Camille,Smolder,221,109,112,49.32
Camille,Taric,80,38,42,47.5
Camille,Udyr,170,74,96,43.53
Camille,Renata,84,51,33,60.71
Camille,Nunu,202,89,113,44.06
Camille,Kayle,212,101,111,47.64
Camille,Kennen,80,38,42,47.5
Camille,KSante,217,110,107,50.69
Camille,Shyvana,121,61,60,50.41
Camille,Nidalee,185,112,73,60.54
Camille,Akshan,122,66,56,54.1
Camille,Annie,120,42,78,35
Camille,Zilean,131,68,63,51.91
Camille,Lissandra,108,53,55,49.07
Camille,Belveth,83,39,44,46.99
Camille,Kled,70,30,40,42.86
Camille,Olaf,59,26,33,44.07
Braum,Garen,1083,540,543,49.86
Braum,Volibear,769,362,407,47.07
Braum,Yasuo,1305,691,614,52.95
Braum,Mel,1270,721,549,56.77
Braum,Zilean,234,96,138,41.03
Braum,Gnar,296,145,151,48.99
Braum,MonkeyKing,512,263,249,51.37
Braum,Vayne,930,477,453,51.29
Braum,Bard,262,107,155,40.84
Braum,Warwick,829,432,397,52.11
Braum,Fizz,339,208,131,61.36
Braum,Jinx,1814,937,877,51.65
Braum,Thresh,1218,592,626,48.6
Braum,Jax,678,346,332,51.03
Braum,Lucian,474,269,205,56.75
Braum,Briar,411,220,191,53.53
Braum,Maokai,298,162,136,54.36
Braum,Yone,1165,635,530,54.51
Braum,Kayn,1000,524,476,52.4
Braum,Vladimir,525,274,251,52.19
Braum,Ahri,860,451,409,52.44
Braum,Teemo,762,378,384,49.61
Braum,Yuumi,443,240,203,54.18
Braum,Akali,675,380,295,56.3
Braum,MissFortune,1695,855,840,50.44
Braum,TahmKench,485,243,242,50.1
Braum,Brand,445,231,214,51.91
Braum,Kayle,488,229,259,46.93
Braum,Tristana,715,377,338,52.73
Braum,Alistar,342,164,178,47.95
Braum,Shaco,548,291,257,53.1
Braum,Chogath,842,398,444,47.27
Braum,Nami,746,365,381,48.93
Braum,Yorick,560,280,280,50
Braum,Diana,1035,508,527,49.08
Braum,Lux,1465,763,702,52.08
Braum,Darius,1241,630,611,50.77
Braum,MasterYi,840,455,385,54.17
Braum,Ekko,673,348,325,51.71
Braum,Aphelios,383,192,191,50.13
Braum,Taric,177,80,97,45.2
Braum,Mordekaiser,861,410,451,47.62
Braum,Viego,1029,589,440,57.24
Braum,Irelia,537,295,242,54.93
Braum,Varus,605,328,277,54.21
Braum,Lulu,993,536,457,53.98
Braum,Shen,421,219,202,52.02
Braum,Rengar,231,145,86,62.77
Braum,Corki,336,182,154,54.17
Braum,KSante,407,239,168,58.72
Braum,AurelionSol,274,117,157,42.7
Braum,Draven,456,244,212,53.51
Braum,Zyra,587,283,304,48.21
Braum,Sett,910,457,453,50.22
Braum,Nautilus,1205,651,554,54.02
Braum,Aatrox,582,298,284,51.2
Braum,Evelynn,252,110,142,43.65
Braum,Veigar,621,295,326,47.5
Braum,Jhin,1337,739,598,55.27
Braum,Poppy,476,259,217,54.41
Braum,LeeSin,1152,592,560,51.39
Braum,Vex,364,164,200,45.05
Braum,Seraphine,385,210,175,54.55
Braum,Urgot,383,213,170,55.61
Braum,Talon,346,193,153,55.78
Braum,Ambessa,436,238,198,54.59
Braum,Shyvana,178,85,93,47.75
Braum,Zoe,273,153,120,56.04
Braum,Ashe,1280,698,582,54.53
Braum,Malzahar,666,295,371,44.29
Braum,Caitlyn,1937,964,973,49.77
Braum,Rakan,367,166,201,45.23
Braum,Nocturne,822,417,405,50.73
Braum,Pantheon,1037,524,513,50.53
Braum,Orianna,298,145,153,48.66
Braum,Twitch,516,282,234,54.65
Braum,Galio,494,239,255,48.38
Braum,Rumble,204,116,88,56.86
Braum,Jayce,394,184,210,46.7
Braum,Gangplank,310,160,150,51.61
Braum,Ryze,273,162,111,59.34
Braum,Ezreal,1598,845,753,52.88
Braum,Gragas,358,169,189,47.21
Braum,Senna,508,224,284,44.09
Braum,Blitzcrank,559,326,233,58.32
Braum,Graves,440,236,204,53.64
Braum,Quinn,231,129,102,55.84
Braum,Renekton,350,200,150,57.14
Braum,Pyke,612,342,270,55.88
Braum,Leblanc,423,238,185,56.26
Braum,Kaisa,1222,658,564,53.85
Braum,Khazix,311,201,110,64.63
Braum,Karthus,186,96,90,51.61
Braum,Aurora,422,225,197,53.32
Braum,JarvanIV,439,226,213,51.48
Braum,Karma,902,458,444,50.78
Braum,Nasus,434,195,239,44.93
Braum,Milio,406,215,191,52.96
Braum,Udyr,284,133,151,46.83
Braum,Leona,722,393,329,54.43
Braum,Tryndamere,395,208,187,52.66
Braum,Anivia,251,131,120,52.19
Braum,Swain,688,377,311,54.8
Braum,Morgana,676,324,352,47.93
Braum,Viktor,634,299,335,47.16
Braum,Riven,372,186,186,50
Braum,Soraka,328,161,167,49.09
Braum,Elise,563,308,255,54.71
Braum,Fiora,299,154,145,51.51
Braum,Naafiri,177,104,73,58.76
Braum,Xerath,462,235,227,50.87
Braum,Kled,88,66,22,75
Braum,Zed,776,420,356,54.12
Braum,Kindred,273,157,116,57.51
Braum,Nilah,186,94,92,50.54
Braum,Amumu,698,344,354,49.28
Braum,Malphite,634,310,324,48.9
Braum,Camille,255,137,118,53.73
Braum,RekSai,89,37,52,41.57
Braum,Kalista,149,85,64,57.05
Braum,Nunu,338,172,166,50.89
Braum,Azir,284,160,124,56.34
Braum,Vi,674,368,306,54.6
Braum,Sejuani,277,154,123,55.6
Braum,Sylas,1014,532,482,52.47
Braum,Sivir,306,165,141,53.92
Braum,KogMaw,233,82,151,35.19
Braum,Lissandra,273,152,121,55.68
Braum,Illaoi,260,139,121,53.46
Braum,Zac,334,178,156,53.29
Braum,Rell,390,199,191,51.03
Braum,Cassiopeia,223,111,112,49.78
Braum,Skarner,212,109,103,51.42
Braum,FiddleSticks,367,193,174,52.59
Braum,XinZhao,459,228,231,49.67
Braum,Sion,500,249,251,49.8
Braum,Hwei,445,221,224,49.66
Braum,Neeko,256,139,117,54.3
Braum,DrMundo,325,183,142,56.31
Braum,Samira,425,217,208,51.06
Braum,Xayah,282,139,143,49.29
Braum,Ziggs,197,89,108,45.18
Braum,TwistedFate,238,100,138,42.02
Braum,Trundle,378,186,192,49.21
Braum,Nidalee,215,119,96,55.35
Braum,Janna,229,117,112,51.09
Braum,Syndra,460,264,196,57.39
Braum,Annie,237,123,114,51.9
Braum,Katarina,555,283,272,50.99
Braum,Olaf,159,97,62,61.01
Braum,Velkoz,374,173,201,46.26
Braum,Qiyana,130,64,66,49.23
Braum,Renata,91,36,55,39.56
Braum,Sona,139,79,60,56.83
Braum,Hecarim,295,127,168,43.05
Braum,Rammus,248,121,127,48.79
Braum,Heimerdinger,293,159,134,54.27
Braum,Kassadin,147,57,90,38.78
Braum,Gwen,306,180,126,58.82
Braum,Ornn,266,140,126,52.63
Braum,Taliyah,205,99,106,48.29
Braum,Smolder,381,191,190,50.13
Braum,Singed,199,86,113,43.22
Braum,Kennen,190,104,86,54.74
Braum,Ivern,85,50,35,58.82
Braum,Belveth,158,97,61,61.39
Braum,Lillia,344,175,169,50.87
Braum,Zeri,252,101,151,40.08
Braum,Akshan,265,147,118,55.47
Quinn,Renekton,225,136,89,60.44
Quinn,Gragas,242,129,113,53.31
Quinn,Yasuo,931,545,386,58.54
Quinn,Kaisa,607,316,291,52.06
Quinn,Nautilus,350,191,159,54.57
Quinn,Shaco,397,207,190,52.14
Quinn,Veigar,465,214,251,46.02
Quinn,Lulu,517,293,224,56.67
Quinn,Camille,177,104,73,58.76
Quinn,Briar,295,166,129,56.27
Quinn,Katarina,375,181,194,48.27
Quinn,Jinx,1318,670,648,50.83
Quinn,Lux,1107,604,503,54.56
Quinn,Gnar,201,111,90,55.22
Quinn,Rammus,129,58,71,44.96
Quinn,KogMaw,149,70,79,46.98
Quinn,Soraka,307,156,151,50.81
Quinn,Aatrox,332,146,186,43.98
Quinn,Jax,369,213,156,57.72
Quinn,Cassiopeia,141,67,74,47.52
Quinn,Samira,308,168,140,54.55
Quinn,Morgana,545,317,228,58.17
Quinn,Sett,546,284,262,52.01
Quinn,LeeSin,525,274,251,52.19
Quinn,Aurora,333,160,173,48.05
Quinn,Jhin,954,514,440,53.88
Quinn,Pyke,329,178,151,54.1
Quinn,Singed,137,50,87,36.5
Quinn,Ahri,506,254,252,50.2
Quinn,Caitlyn,1227,671,556,54.69
Quinn,Urgot,206,96,110,46.6
Quinn,Ivern,63,38,25,60.32
Quinn,Twitch,364,173,191,47.53
Quinn,TahmKench,276,168,108,60.87
Quinn,Diana,624,331,293,53.04
Quinn,Ashe,916,495,421,54.04
Quinn,Yuumi,343,172,171,50.15
Quinn,Jayce,232,137,95,59.05
Quinn,Udyr,203,97,106,47.78
Quinn,Yone,780,419,361,53.72
Quinn,Karma,563,282,281,50.09
Quinn,Kayn,665,381,284,57.29
Quinn,Leblanc,255,141,114,55.29
Quinn,Nami,452,234,218,51.77
Quinn,Hwei,302,158,144,52.32
Quinn,MasterYi,581,312,269,53.7
Quinn,Zed,558,302,256,54.12
Quinn,Aphelios,206,101,105,49.03
Quinn,Swain,393,197,196,50.13
Quinn,Rengar,154,92,62,59.74
Quinn,Mordekaiser,467,262,205,56.1
Quinn,Kayle,311,178,133,57.23
Quinn,Ambessa,298,176,122,59.06
Quinn,Vladimir,287,150,137,52.26
Quinn,Kalista,90,64,26,71.11
Quinn,Mel,942,536,406,56.9
Quinn,Malphite,725,370,355,51.03
Quinn,Nocturne,599,295,304,49.25
Quinn,Kassadin,77,47,30,61.04
Quinn,Xayah,185,89,96,48.11
Quinn,Thresh,527,270,257,51.23
Quinn,Darius,972,495,477,50.93
Quinn,Ezreal,1033,561,472,54.31
Quinn,Gangplank,260,118,142,45.38
Quinn,Brand,295,140,155,47.46
Quinn,Warwick,670,358,312,53.43
Quinn,Riven,195,99,96,50.77
Quinn,Ziggs,160,68,92,42.5
Quinn,Nasus,294,147,147,50
Quinn,Naafiri,127,56,71,44.09
Quinn,Annie,161,71,90,44.1
Quinn,Tristana,503,271,232,53.88
Quinn,Braum,231,102,129,44.16
Quinn,Vayne,595,295,300,49.58
Quinn,Pantheon,645,361,284,55.97
Quinn,Draven,226,117,109,51.77
Quinn,Leona,328,154,174,46.95
Quinn,FiddleSticks,238,120,118,50.42
Quinn,Sion,362,186,176,51.38
Quinn,Senna,388,202,186,52.06
Quinn,Blitzcrank,296,132,164,44.59
Quinn,Tryndamere,252,134,118,53.17
Quinn,Nunu,209,118,91,56.46
Quinn,Skarner,107,45,62,42.06
Quinn,Xerath,430,221,209,51.4
Quinn,Khazix,256,140,116,54.69
Quinn,Corki,221,117,104,52.94
Quinn,Akali,481,231,250,48.02
Quinn,Rell,241,112,129,46.47
Quinn,DrMundo,290,153,137,52.76
Quinn,Amumu,419,175,244,41.77
Quinn,Ekko,400,207,193,51.75
Quinn,Vi,445,217,228,48.76
Quinn,AurelionSol,157,90,67,57.32
Quinn,Sylas,546,305,241,55.86
Quinn,Talon,242,139,103,57.44
Quinn,Illaoi,162,88,74,54.32
Quinn,Teemo,649,289,360,44.53
Quinn,Zeri,141,77,64,54.61
Quinn,Hecarim,167,78,89,46.71
Quinn,Azir,156,60,96,38.46
Quinn,Garen,815,398,417,48.83
Quinn,Zoe,167,92,75,55.09
Quinn,Rumble,92,52,40,56.52
Quinn,Lucian,268,155,113,57.84
Quinn,Sejuani,152,76,76,50
Quinn,Volibear,493,257,236,52.13
Quinn,Rakan,158,69,89,43.67
Quinn,Ryze,141,64,77,45.39
Quinn,Belveth,109,67,42,61.47
Quinn,Velkoz,313,156,157,49.84
Quinn,Sivir,217,95,122,43.78
Quinn,Galio,367,200,167,54.5
Quinn,MissFortune,994,507,487,51.01
Quinn,Vex,226,100,126,44.25
Quinn,Chogath,442,215,227,48.64
Quinn,Malzahar,374,199,175,53.21
Quinn,Zac,168,95,73,56.55
Quinn,Yorick,455,205,250,45.05
Quinn,Viktor,403,213,190,52.85
Quinn,Orianna,182,79,103,43.41
Quinn,Evelynn,143,72,71,50.35
Quinn,Sona,144,73,71,50.69
Quinn,Kindred,190,91,99,47.89
Quinn,Maokai,192,104,88,54.17
Quinn,Karthus,145,77,68,53.1
Quinn,Shen,247,136,111,55.06
Quinn,Lillia,242,134,108,55.37
Quinn,Neeko,172,82,90,47.67
Quinn,Seraphine,385,187,198,48.57
Quinn,Heimerdinger,212,101,111,47.64
Quinn,XinZhao,216,99,117,45.83
Quinn,Alistar,144,62,82,43.06
Quinn,Milio,252,131,121,51.98
Quinn,Lissandra,138,92,46,66.67
Quinn,Gwen,208,118,90,56.73
Quinn,MonkeyKing,315,146,169,46.35
Quinn,Elise,304,147,157,48.36
Quinn,Syndra,327,172,155,52.6
Quinn,Nidalee,128,77,51,60.16
Quinn,Irelia,343,170,173,49.56
Quinn,JarvanIV,253,131,122,51.78
Quinn,Viego,636,342,294,53.77
Quinn,Olaf,58,29,29,50
Quinn,Graves,272,146,126,53.68
Quinn,Varus,399,218,181,54.64
Quinn,KSante,160,82,78,51.25
Quinn,Kled,59,27,32,45.76
Quinn,Trundle,176,75,101,42.61
Quinn,TwistedFate,222,92,130,41.44
Quinn,Ornn,175,94,81,53.71
Quinn,Fizz,270,122,148,45.19
Quinn,Taliyah,140,76,64,54.29
Quinn,Taric,61,30,31,49.18
Quinn,Poppy,209,130,79,62.2
Quinn,Qiyana,85,52,33,61.18
Quinn,Renata,59,36,23,61.02
Quinn,Fiora,126,78,48,61.9
Quinn,Kennen,103,55,48,53.4
Quinn,Smolder,251,142,109,56.57
Quinn,Bard,142,67,75,47.18
Quinn,Zilean,148,85,63,57.43
Quinn,Shyvana,115,56,59,48.7
Quinn,Anivia,111,52,59,46.85
Quinn,Nilah,120,73,47,60.83
Quinn,Zyra,434,227,207,52.3
Quinn,Akshan,153,61,92,39.87
Quinn,Janna,167,77,90,46.11
Quinn,RekSai,55,31,24,56.36
Kassadin,Renekton,139,67,72,48.2
Kassadin,Gragas,180,110,70,61.11
Kassadin,Yasuo,420,204,216,48.57
Kassadin,Kaisa,397,219,178,55.16
Kassadin,Nautilus,269,144,125,53.53
Kassadin,Volibear,269,106,163,39.41
Kassadin,Yorick,212,120,92,56.6
Kassadin,Lux,650,324,326,49.85
Kassadin,Jinx,696,320,376,45.98
Kassadin,Bard,99,46,53,46.46
Kassadin,Pantheon,401,202,199,50.37
Kassadin,Jhin,501,249,252,49.7
Kassadin,Veigar,288,150,138,52.08
Kassadin,Nocturne,310,166,144,53.55
Kassadin,Velkoz,152,63,89,41.45
Kassadin,Poppy,167,86,81,51.5
Kassadin,Darius,487,246,241,50.51
Kassadin,Katarina,221,107,114,48.42
Kassadin,Ezreal,580,318,262,54.83
Kassadin,Yuumi,184,109,75,59.24
Kassadin,Diana,434,220,214,50.69
Kassadin,Evelynn,84,47,37,55.95
Kassadin,Gnar,124,73,51,58.87
Kassadin,Aurora,150,68,82,45.33
Kassadin,Sivir,154,86,68,55.84
Kassadin,Taric,51,25,26,49.02
Kassadin,Shen,167,69,98,41.32
Kassadin,Kayn,374,139,235,37.17
Kassadin,Fizz,190,104,86,54.74
Kassadin,Gwen,143,76,67,53.15
Kassadin,Tryndamere,150,80,70,53.33
Kassadin,Caitlyn,735,333,402,45.31
Kassadin,Leona,200,96,104,48
Kassadin,Riven,160,86,74,53.75
Kassadin,Skarner,49,29,20,59.18
Kassadin,Tristana,242,123,119,50.83
Kassadin,Swain,244,121,123,49.59
Kassadin,Teemo,263,133,130,50.57
Kassadin,Graves,181,82,99,45.3
Kassadin,Mel,706,355,351,50.28
Kassadin,MissFortune,574,326,248,56.79
Kassadin,Morgana,338,164,174,48.52
Kassadin,Jax,248,104,144,41.94
Kassadin,Vladimir,237,121,116,51.05
Kassadin,Ashe,475,268,207,56.42
Kassadin,Milio,177,90,87,50.85
Kassadin,Singed,78,39,39,50
Kassadin,Warwick,316,174,142,55.06
Kassadin,Ahri,354,171,183,48.31
Kassadin,Corki,144,98,46,68.06
Kassadin,Neeko,112,47,65,41.96
Kassadin,Maokai,112,65,47,58.04
Kassadin,Sett,299,175,124,58.53
Kassadin,Taliyah,54,20,34,37.04
Kassadin,Syndra,171,92,79,53.8
Kassadin,Qiyana,76,33,43,43.42
Kassadin,Akali,264,112,152,42.42
Kassadin,Viego,330,156,174,47.27
Kassadin,Pyke,188,93,95,49.47
Kassadin,Quinn,77,30,47,38.96
Kassadin,RekSai,38,21,17,55.26
Kassadin,Irelia,171,59,112,34.5
Kassadin,Vayne,372,186,186,50
Kassadin,Lulu,318,157,161,49.37
Kassadin,Shyvana,58,35,23,60.34
Kassadin,Malphite,252,145,107,57.54
Kassadin,Nunu,173,85,88,49.13
Kassadin,Twitch,228,105,123,46.05
Kassadin,Thresh,394,184,210,46.7
Kassadin,Malzahar,251,134,117,53.39
Kassadin,Illaoi,93,59,34,63.44
Kassadin,XinZhao,137,67,70,48.91
Kassadin,Viktor,244,146,98,59.84
Kassadin,Nami,326,170,156,52.15
Kassadin,Chogath,295,148,147,50.17
Kassadin,Shaco,223,134,89,60.09
Kassadin,Camille,96,43,53,44.79
Kassadin,Aatrox,215,101,114,46.98
Kassadin,Vi,267,140,127,52.43
Kassadin,LeeSin,332,185,147,55.72
Kassadin,Elise,192,97,95,50.52
Kassadin,Ryze,104,47,57,45.19
Kassadin,Aphelios,107,41,66,38.32
Kassadin,Draven,108,53,55,49.07
Kassadin,KSante,138,81,57,58.7
Kassadin,Xayah,94,38,56,40.43
Kassadin,Karma,337,177,160,52.52
Kassadin,Hwei,203,99,104,48.77
Kassadin,Ambessa,170,93,77,54.71
Kassadin,MonkeyKing,176,84,92,47.73
Kassadin,Ekko,267,150,117,56.18
Kassadin,Samira,168,82,86,48.81
Kassadin,Alistar,97,52,45,53.61
Kassadin,Garen,395,186,209,47.09
Kassadin,Zilean,99,41,58,41.41
Kassadin,Mordekaiser,339,170,169,50.15
Kassadin,Yone,396,215,181,54.29
Kassadin,Briar,159,72,87,45.28
Kassadin,FiddleSticks,164,87,77,53.05
Kassadin,Akshan,82,38,44,46.34
Kassadin,JarvanIV,137,64,73,46.72
Kassadin,Sylas,276,164,112,59.42
Kassadin,Rumble,62,33,29,53.23
Kassadin,Senna,155,79,76,50.97
Kassadin,TahmKench,157,74,83,47.13
Kassadin,Amumu,261,111,150,42.53
Kassadin,Azir,77,40,37,51.95
Kassadin,Rengar,96,46,50,47.92
Kassadin,Fiora,60,23,37,38.33
Kassadin,Leblanc,197,109,88,55.33
Kassadin,Soraka,137,63,74,45.99
Kassadin,Gangplank,126,52,74,41.27
Kassadin,Nidalee,74,54,20,72.97
Kassadin,Ziggs,95,44,51,46.32
Kassadin,Brand,188,106,82,56.38
Kassadin,KogMaw,75,34,41,45.33
Kassadin,Heimerdinger,123,78,45,63.41
Kassadin,Nasus,184,73,111,39.67
Kassadin,Udyr,82,45,37,54.88
Kassadin,Varus,225,121,104,53.78
Kassadin,Lucian,205,99,106,48.29
Kassadin,Karthus,86,47,39,54.65
Kassadin,Orianna,117,59,58,50.43
Kassadin,Jayce,155,65,90,41.94
Kassadin,Kled,43,19,24,44.19
Kassadin,Zed,186,79,107,42.47
Kassadin,Galio,182,84,98,46.15
Kassadin,Hecarim,105,47,58,44.76
Kassadin,Naafiri,77,45,32,58.44
Kassadin,Janna,88,32,56,36.36
Kassadin,Rakan,86,32,54,37.21
Kassadin,Khazix,143,59,84,41.26
Kassadin,Zac,128,45,83,35.16
Kassadin,TwistedFate,106,47,59,44.34
Kassadin,Zeri,94,38,56,40.43
Kassadin,Seraphine,176,101,75,57.39
Kassadin,Trundle,154,69,85,44.81
Kassadin,Zyra,207,110,97,53.14
Kassadin,Urgot,133,63,70,47.37
Kassadin,Lillia,162,84,78,51.85
Kassadin,Belveth,66,39,27,59.09
Kassadin,MasterYi,315,165,150,52.38
Kassadin,Anivia,118,41,77,34.75
Kassadin,Braum,147,90,57,61.22
Kassadin,AurelionSol,95,59,36,62.11
Kassadin,Blitzcrank,169,78,91,46.15
Kassadin,DrMundo,140,79,61,56.43
Kassadin,Kindred,104,41,63,39.42
Kassadin,Rell,131,46,85,35.11
Kassadin,Olaf,35,20,15,57.14
Kassadin,Cassiopeia,68,36,32,52.94
Kassadin,Smolder,186,111,75,59.68
Kassadin,Ornn,87,52,35,59.77
Kassadin,Sona,78,38,40,48.72
Kassadin,Sion,179,95,84,53.07
Kassadin,Kalista,79,37,42,46.84
Kassadin,Xerath,249,125,124,50.2
Kassadin,Vex,120,57,63,47.5
Kassadin,Kayle,188,101,87,53.72
Kassadin,Rammus,99,56,43,56.57
Kassadin,Nilah,51,17,34,33.33
Kassadin,Annie,104,62,42,59.62
Kassadin,Ivern,46,21,25,45.65
Kassadin,Sejuani,77,33,44,42.86
Kassadin,Talon,139,74,65,53.24
Kassadin,Kennen,41,26,15,63.41
Kassadin,Renata,22,11,11,50
Kassadin,Lissandra,104,60,44,57.69
Kassadin,Zoe,48,22,26,45.83
Heimerdinger,Teemo,922,476,446,51.63
Heimerdinger,Pantheon,800,452,348,56.5
Heimerdinger,Orianna,244,142,102,58.2
Heimerdinger,Tristana,506,281,225,55.53
Heimerdinger,Lux,1652,801,851,48.49
Heimerdinger,Garen,849,456,393,53.71
Heimerdinger,Belveth,133,70,63,52.63
Heimerdinger,Yasuo,1111,512,599,46.08
Heimerdinger,Jhin,1162,617,545,53.1
Heimerdinger,Seraphine,482,258,224,53.53
Heimerdinger,Sett,902,447,455,49.56
Heimerdinger,Shaco,573,294,279,51.31
Heimerdinger,Ziggs,204,115,89,56.37
Heimerdinger,Kaisa,813,433,380,53.26
Heimerdinger,MissFortune,1434,698,736,48.68
Heimerdinger,Kayle,351,205,146,58.4
Heimerdinger,Ekko,543,277,266,51.01
Heimerdinger,Veigar,614,288,326,46.91
Heimerdinger,Nasus,499,242,257,48.5
Heimerdinger,Kindred,236,117,119,49.58
Heimerdinger,Karma,592,321,271,54.22
Heimerdinger,Ashe,1129,580,549,51.37
Heimerdinger,Irelia,492,292,200,59.35
Heimerdinger,DrMundo,322,178,144,55.28
Heimerdinger,Viktor,437,215,222,49.2
Heimerdinger,Twitch,404,210,194,51.98
Heimerdinger,Brand,494,250,244,50.61
Heimerdinger,Ahri,651,367,284,56.37
Heimerdinger,Zeri,191,85,106,44.5
Heimerdinger,Leona,410,215,195,52.44
Heimerdinger,Volibear,619,321,298,51.86
Heimerdinger,Fizz,367,215,152,58.58
Heimerdinger,Bard,119,71,48,59.66
Heimerdinger,Akali,559,286,273,51.16
Heimerdinger,Jinx,1577,818,759,51.87
Heimerdinger,Morgana,726,395,331,54.41
Heimerdinger,Yorick,584,282,302,48.29
Heimerdinger,Sejuani,157,80,77,50.96
Heimerdinger,Yone,1126,619,507,54.97
Heimerdinger,Zac,244,114,130,46.72
Heimerdinger,Trundle,372,181,191,48.66
Heimerdinger,Skarner,119,65,54,54.62
Heimerdinger,Katarina,442,252,190,57.01
Heimerdinger,Viego,732,358,374,48.91
Heimerdinger,Mel,1085,582,503,53.64
Heimerdinger,Senna,413,234,179,56.66
Heimerdinger,Tryndamere,371,176,195,47.44
Heimerdinger,Evelynn,206,106,100,51.46
Heimerdinger,Vladimir,383,186,197,48.56
Heimerdinger,Darius,1188,612,576,51.52
Heimerdinger,Caitlyn,1594,829,765,52.01
Heimerdinger,Amumu,589,307,282,52.12
Heimerdinger,Nautilus,557,321,236,57.63
Heimerdinger,Singed,157,84,73,53.5
Heimerdinger,Nunu,304,176,128,57.89
Heimerdinger,Graves,268,142,126,52.99
Heimerdinger,Swain,592,313,279,52.87
Heimerdinger,JarvanIV,244,125,119,51.23
Heimerdinger,Qiyana,120,65,55,54.17
Heimerdinger,Taliyah,105,56,49,53.33
Heimerdinger,Malphite,618,338,280,54.69
Heimerdinger,Maokai,206,112,94,54.37
Heimerdinger,Gangplank,256,126,130,49.22
Heimerdinger,Rengar,167,80,87,47.9
Heimerdinger,Zilean,208,88,120,42.31
Heimerdinger,Alistar,203,114,89,56.16
Heimerdinger,Lulu,553,281,272,50.81
Heimerdinger,Naafiri,198,102,96,51.52
Heimerdinger,Illaoi,235,141,94,60
Heimerdinger,Velkoz,362,167,195,46.13
Heimerdinger,TahmKench,430,231,199,53.72
Heimerdinger,Khazix,255,153,102,60
Heimerdinger,Lissandra,186,92,94,49.46
Heimerdinger,Thresh,597,301,296,50.42
Heimerdinger,Rumble,172,98,74,56.98
Heimerdinger,Zoe,172,101,71,58.72
Heimerdinger,Vayne,711,402,309,56.54
Heimerdinger,Karthus,188,85,103,45.21
Heimerdinger,Hwei,393,209,184,53.18
Heimerdinger,Lucian,389,206,183,52.96
Heimerdinger,Kennen,144,61,83,42.36
Heimerdinger,Leblanc,291,165,126,56.7
Heimerdinger,Nami,519,280,239,53.95
Heimerdinger,Ezreal,1103,613,490,55.58
Heimerdinger,LeeSin,724,417,307,57.6
Heimerdinger,XinZhao,283,154,129,54.42
Heimerdinger,Vex,326,151,175,46.32
Heimerdinger,Galio,472,230,242,48.73
Heimerdinger,Poppy,296,174,122,58.78
Heimerdinger,Aatrox,460,264,196,57.39
Heimerdinger,Rell,204,100,104,49.02
Heimerdinger,Diana,824,454,370,55.1
Heimerdinger,Riven,161,84,77,52.17
Heimerdinger,Ryze,179,90,89,50.28
Heimerdinger,Malzahar,599,285,314,47.58
Heimerdinger,Udyr,165,101,64,61.21
Heimerdinger,Urgot,266,127,139,47.74
Heimerdinger,Aurora,326,161,165,49.39
Heimerdinger,Samira,468,245,223,52.35
Heimerdinger,Fiora,160,102,58,63.75
Heimerdinger,Briar,399,186,213,46.62
Heimerdinger,Zyra,552,263,289,47.64
Heimerdinger,Milio,247,127,120,51.42
Heimerdinger,Jax,464,271,193,58.41
Heimerdinger,Draven,267,145,122,54.31
Heimerdinger,Renekton,254,140,114,55.12
Heimerdinger,Annie,182,93,89,51.1
Heimerdinger,Blitzcrank,341,185,156,54.25
Heimerdinger,Gragas,236,147,89,62.29
Heimerdinger,Vi,473,214,259,45.24
Heimerdinger,Mordekaiser,733,382,351,52.11
Heimerdinger,Lillia,359,200,159,55.71
Heimerdinger,Kayn,886,477,409,53.84
Heimerdinger,Chogath,626,304,322,48.56
Heimerdinger,Xerath,436,237,199,54.36
Heimerdinger,Sion,431,199,232,46.17
Heimerdinger,Zed,638,335,303,52.51
Heimerdinger,FiddleSticks,244,133,111,54.51
Heimerdinger,Renata,55,23,32,41.82
Heimerdinger,Camille,112,55,57,49.11
Heimerdinger,Aphelios,248,140,108,56.45
Heimerdinger,Shyvana,134,74,60,55.22
Heimerdinger,Warwick,899,466,433,51.84
Heimerdinger,Janna,156,89,67,57.05
Heimerdinger,Kassadin,123,45,78,36.59
Heimerdinger,Sivir,227,132,95,58.15
Heimerdinger,Soraka,283,147,136,51.94
Heimerdinger,Jayce,262,122,140,46.56
Heimerdinger,Ivern,50,22,28,44
Heimerdinger,Sylas,728,470,258,64.56
Heimerdinger,Sona,203,110,93,54.19
Heimerdinger,Nidalee,148,78,70,52.7
Heimerdinger,Kalista,97,68,29,70.1
Heimerdinger,RekSai,61,38,23,62.3
Heimerdinger,Neeko,325,168,157,51.69
Heimerdinger,Elise,263,119,144,45.25
Heimerdinger,Varus,400,228,172,57
Heimerdinger,Smolder,341,210,131,61.58
Heimerdinger,Shen,359,187,172,52.09
Heimerdinger,Yuumi,350,198,152,56.57
Heimerdinger,Gwen,253,124,129,49.01
Heimerdinger,Anivia,191,83,108,43.46
Heimerdinger,Talon,291,176,115,60.48
Heimerdinger,MasterYi,710,375,335,52.82
Heimerdinger,Rakan,206,96,110,46.6
Heimerdinger,Pyke,420,238,182,56.67
Heimerdinger,Quinn,212,111,101,52.36
Heimerdinger,Akshan,177,86,91,48.59
Heimerdinger,Braum,293,134,159,45.73
Heimerdinger,Gnar,168,107,61,63.69
Heimerdinger,Ornn,194,108,86,55.67
Heimerdinger,Nocturne,674,356,318,52.82
Heimerdinger,MonkeyKing,347,133,214,38.33
Heimerdinger,Nilah,158,91,67,57.59
Heimerdinger,Xayah,224,91,133,40.63
Heimerdinger,Rammus,184,88,96,47.83
Heimerdinger,Cassiopeia,151,70,81,46.36
Heimerdinger,Syndra,376,212,164,56.38
Heimerdinger,Corki,185,120,65,64.86
Heimerdinger,Ambessa,267,139,128,52.06
Heimerdinger,Taric,114,57,57,50
Heimerdinger,Azir,163,94,69,57.67
Heimerdinger,AurelionSol,196,113,83,57.65
Heimerdinger,TwistedFate,157,101,56,64.33
Heimerdinger,KogMaw,185,87,98,47.03
Heimerdinger,KSante,176,90,86,51.14
Heimerdinger,Kled,76,39,37,51.32
Heimerdinger,Olaf,120,79,41,65.83
Heimerdinger,Hecarim,170,105,65,61.76
Ryze,Sett,561,250,311,44.56
Ryze,MonkeyKing,266,139,127,52.26
Ryze,Anivia,163,77,86,47.24
Ryze,Corki,202,110,92,54.46
Ryze,Ivern,44,24,20,54.55
Ryze,Yorick,377,190,187,50.4
Ryze,Warwick,570,313,257,54.91
Ryze,Hwei,250,125,125,50
Ryze,Caitlyn,1093,550,543,50.32
Ryze,Seraphine,261,142,119,54.41
Ryze,Darius,815,437,378,53.62
Ryze,Viego,614,327,287,53.26
Ryze,Taliyah,108,51,57,47.22
Ryze,Jinx,1069,512,557,47.9
Ryze,Blitzcrank,333,188,145,56.46
Ryze,Kennen,125,53,72,42.4
Ryze,Talon,258,141,117,54.65
Ryze,Soraka,226,115,111,50.88
Ryze,Draven,239,119,120,49.79
Ryze,Velkoz,234,123,111,52.56
Ryze,Jayce,237,130,107,54.85
Ryze,Diana,700,364,336,52
Ryze,Kaisa,825,497,328,60.24
Ryze,Taric,69,38,31,55.07
Ryze,Malphite,339,181,158,53.39
Ryze,Shaco,391,201,190,51.41
Ryze,Akshan,142,69,73,48.59
Ryze,Aphelios,173,75,98,43.35
Ryze,Swain,369,170,199,46.07
Ryze,Gangplank,208,135,73,64.9
Ryze,LeeSin,837,394,443,47.07
Ryze,Neeko,136,65,71,47.79
Ryze,Ezreal,1068,618,450,57.87
Ryze,Sona,101,41,60,40.59
Ryze,Irelia,398,179,219,44.97
Ryze,Kindred,186,108,78,58.06
Ryze,Morgana,421,241,180,57.24
Ryze,Ashe,824,430,394,52.18
Ryze,Urgot,210,106,104,50.48
Ryze,Lux,793,414,379,52.21
Ryze,Twitch,363,176,187,48.48
Ryze,Lulu,611,255,356,41.73
Ryze,Ambessa,311,189,122,60.77
Ryze,Rengar,116,55,61,47.41
Ryze,Veigar,430,232,198,53.95
Ryze,Gnar,206,115,91,55.83
Ryze,FiddleSticks,183,91,92,49.73
Ryze,Leblanc,266,153,113,57.52
Ryze,Vayne,567,285,282,50.26
Ryze,Rell,228,112,116,49.12
Ryze,Yasuo,777,414,363,53.28
Ryze,Amumu,361,178,183,49.31
Ryze,Pyke,348,174,174,50
Ryze,Trundle,204,103,101,50.49
Ryze,JarvanIV,266,150,116,56.39
Ryze,Varus,393,203,190,51.65
Ryze,Jax,366,178,188,48.63
Ryze,Mel,810,449,361,55.43
Ryze,Braum,273,111,162,40.66
Ryze,Pantheon,621,306,315,49.28
Ryze,Riven,173,73,100,42.2
Ryze,Belveth,120,78,42,65
Ryze,Kalista,153,53,100,34.64
Ryze,Milio,217,128,89,58.99
Ryze,Nasus,298,169,129,56.71
Ryze,Nocturne,583,290,293,49.74
Ryze,MissFortune,867,461,406,53.17
Ryze,Kayle,268,125,143,46.64
Ryze,Teemo,562,253,309,45.02
Ryze,Vladimir,413,204,209,49.39
Ryze,Smolder,236,133,103,56.36
Ryze,Renata,92,42,50,45.65
Ryze,Viktor,416,197,219,47.36
Ryze,TwistedFate,149,85,64,57.05
Ryze,Khazix,197,100,97,50.76
Ryze,Elise,296,144,152,48.65
Ryze,Sejuani,142,78,64,54.93
Ryze,Kassadin,104,57,47,54.81
Ryze,Senna,296,171,125,57.77
Ryze,Akali,451,240,211,53.22
Ryze,Ahri,532,295,237,55.45
Ryze,Briar,325,148,177,45.54
Ryze,Aatrox,401,167,234,41.65
Ryze,AurelionSol,153,71,82,46.41
Ryze,Karma,598,315,283,52.68
Ryze,Ekko,410,206,204,50.24
Ryze,Samira,273,140,133,51.28
Ryze,Chogath,429,191,238,44.52
Ryze,DrMundo,238,138,100,57.98
Ryze,Nautilus,517,257,260,49.71
Ryze,Lillia,177,103,74,58.19
Ryze,Tryndamere,196,106,90,54.08
Ryze,Xerath,392,220,172,56.12
Ryze,Heimerdinger,179,89,90,49.72
Ryze,Leona,391,209,182,53.45
Ryze,Aurora,273,141,132,51.65
Ryze,Singed,121,64,57,52.89
Ryze,Gwen,207,103,104,49.76
Ryze,Xayah,185,113,72,61.08
Ryze,Sylas,760,417,343,54.87
Ryze,Volibear,445,206,239,46.29
Ryze,Olaf,114,66,48,57.89
Ryze,Kayn,524,283,241,54.01
Ryze,Cassiopeia,175,95,80,54.29
Ryze,Qiyana,114,57,57,50
Ryze,Tristana,427,236,191,55.27
Ryze,Zac,210,93,117,44.29
Ryze,TahmKench,264,153,111,57.95
Ryze,Zyra,373,170,203,45.58
Ryze,Renekton,246,122,124,49.59
Ryze,Camille,158,65,93,41.14
Ryze,Malzahar,444,152,292,34.23
Ryze,Jhin,827,391,436,47.28
Ryze,Maokai,185,104,81,56.22
Ryze,Vi,396,218,178,55.05
Ryze,Fizz,207,115,92,55.56
Ryze,Zed,451,245,206,54.32
Ryze,KSante,250,139,111,55.6
Ryze,Poppy,278,171,107,61.51
Ryze,Yone,779,459,320,58.92
Ryze,Brand,255,139,116,54.51
Ryze,Nami,371,192,179,51.75
Ryze,Nunu,183,113,70,61.75
Ryze,Thresh,680,355,325,52.21
Ryze,Gragas,255,158,97,61.96
Ryze,Yuumi,318,182,136,57.23
Ryze,Alistar,167,87,80,52.1
Ryze,Quinn,141,77,64,54.61
Ryze,Zilean,164,83,81,50.61
Ryze,Syndra,215,107,108,49.77
Ryze,Lissandra,130,61,69,46.92
Ryze,KogMaw,142,80,62,56.34
Ryze,Udyr,194,104,90,53.61
Ryze,Ornn,177,107,70,60.45
Ryze,Garen,617,346,271,56.08
Ryze,MasterYi,404,179,225,44.31
Ryze,Graves,279,153,126,54.84
Ryze,Galio,391,195,196,49.87
Ryze,Shen,239,136,103,56.9
Ryze,Ziggs,144,88,56,61.11
Ryze,Rakan,181,96,85,53.04
Ryze,Karthus,116,52,64,44.83
Ryze,XinZhao,277,124,153,44.77
Ryze,Kled,64,30,34,46.88
Ryze,Orianna,177,86,91,48.59
Ryze,Hecarim,165,91,74,55.15
Ryze,Janna,140,58,82,41.43
Ryze,Sivir,205,98,107,47.8
Ryze,Rumble,108,64,44,59.26
Ryze,Zoe,168,77,91,45.83
Ryze,Lucian,285,143,142,50.18
Ryze,Katarina,275,159,116,57.82
Ryze,Naafiri,159,80,79,50.31
Ryze,Rammus,152,71,81,46.71
Ryze,Fiora,151,71,80,47.02
Ryze,Mordekaiser,500,214,286,42.8
Ryze,Sion,265,133,132,50.19
Ryze,Zeri,157,78,79,49.68
Ryze,Evelynn,145,68,77,46.9
Ryze,Illaoi,180,107,73,59.44
Ryze,Skarner,129,76,53,58.91
Ryze,Azir,171,71,100,41.52
Ryze,Nidalee,146,94,52,64.38
Ryze,Nilah,100,47,53,47
Ryze,Annie,115,58,57,50.43
Ryze,Vex,169,83,86,49.11
Ryze,Shyvana,87,51,36,58.62
Ryze,Bard,130,76,54,58.46
Ryze,RekSai,65,32,33,49.23
Taliyah,Aatrox,309,181,128,58.58
Taliyah,Graves,219,126,93,57.53
Taliyah,Ekko,291,149,142,51.2
Taliyah,Ezreal,764,376,388,49.21
Taliyah,Bard,125,74,51,59.2
Taliyah,Vi,319,146,173,45.77
Taliyah,Yasuo,615,310,305,50.41
Taliyah,Jhin,538,272,266,50.56
Taliyah,Velkoz,160,73,87,45.63
Taliyah,Sion,266,158,108,59.4
Taliyah,Udyr,117,59,58,50.43
Taliyah,Ryze,108,57,51,52.78
Taliyah,Kaisa,515,272,243,52.82
Taliyah,Leona,236,127,109,53.81
Taliyah,Volibear,323,182,141,56.35
Taliyah,Ahri,446,197,249,44.17
Taliyah,Teemo,285,125,160,43.86
Taliyah,Yuumi,216,128,88,59.26
Taliyah,Gangplank,138,77,61,55.8
Taliyah,Hecarim,155,77,78,49.68
Taliyah,Fizz,134,77,57,57.46
Taliyah,Lucian,226,119,107,52.65
Taliyah,Blitzcrank,183,108,75,59.02
Taliyah,Darius,500,270,230,54
Taliyah,Yorick,198,90,108,45.45
Taliyah,Annie,143,75,68,52.45
Taliyah,Caitlyn,701,358,343,51.07
Taliyah,Jax,311,176,135,56.59
Taliyah,LeeSin,486,252,234,51.85
Taliyah,Ashe,605,327,278,54.05
Taliyah,Rell,202,107,95,52.97
Taliyah,Urgot,146,58,88,39.73
Taliyah,Khazix,156,105,51,67.31
Taliyah,Veigar,207,110,97,53.14
Taliyah,Mel,590,310,280,52.54
Taliyah,Senna,236,132,104,55.93
Taliyah,Fiora,101,59,42,58.42
Taliyah,Kayn,373,193,180,51.74
Taliyah,Zoe,146,87,59,59.59
Taliyah,Tristana,289,150,139,51.9
Taliyah,Thresh,456,274,182,60.09
Taliyah,Sett,390,195,195,50
Taliyah,FiddleSticks,117,59,58,50.43
Taliyah,Naafiri,117,67,50,57.26
Taliyah,Sona,104,60,44,57.69
Taliyah,Ivern,28,8,20,28.57
Taliyah,Lux,625,293,332,46.88
Taliyah,Twitch,245,134,111,54.69
Taliyah,Lulu,455,233,222,51.21
Taliyah,Ornn,140,61,79,43.57
Taliyah,Yone,500,255,245,51
Taliyah,Jinx,834,383,451,45.92
Taliyah,Zyra,276,118,158,42.75
Taliyah,Karma,475,202,273,42.53
Taliyah,Pantheon,498,256,242,51.41
Taliyah,Heimerdinger,105,49,56,46.67
Taliyah,Galio,213,112,101,52.58
Taliyah,Neeko,118,61,57,51.69
Taliyah,Kassadin,54,34,20,62.96
Taliyah,Riven,139,73,66,52.52
Taliyah,Belveth,107,72,35,67.29
Taliyah,Kalista,133,86,47,64.66
Taliyah,Milio,190,77,113,40.53
Taliyah,Irelia,274,146,128,53.28
Taliyah,Xayah,148,67,81,45.27
Taliyah,Viego,413,201,212,48.67
Taliyah,Jayce,189,110,79,58.2
Taliyah,Vayne,348,191,157,54.89
Taliyah,Diana,471,228,243,48.41
Taliyah,Elise,197,103,94,52.28
Taliyah,Vex,96,52,44,54.17
Taliyah,Azir,116,54,62,46.55
Taliyah,Gnar,108,52,56,48.15
Taliyah,Karthus,124,67,57,54.03
Taliyah,Mordekaiser,327,140,187,42.81
Taliyah,MonkeyKing,205,132,73,64.39
Taliyah,MissFortune,520,302,218,58.08
Taliyah,Renata,53,26,27,49.06
Taliyah,Amumu,277,129,148,46.57
Taliyah,Zed,244,109,135,44.67
Taliyah,Akali,328,184,144,56.1
Taliyah,Xerath,259,98,161,37.84
Taliyah,KSante,174,103,71,59.2
Taliyah,Poppy,190,88,102,46.32
Taliyah,Renekton,185,111,74,60
Taliyah,Aphelios,183,102,81,55.74
Taliyah,Malphite,271,136,135,50.18
Taliyah,Trundle,161,85,76,52.8
Taliyah,Briar,209,110,99,52.63
Taliyah,Cassiopeia,79,39,40,49.37
Taliyah,Rammus,86,44,42,51.16
Taliyah,Garen,469,230,239,49.04
Taliyah,Morgana,275,128,147,46.55
Taliyah,Swain,240,115,125,47.92
Taliyah,Talon,162,93,69,57.41
Taliyah,Nasus,140,75,65,53.57
Taliyah,Brand,162,92,70,56.79
Taliyah,Camille,110,71,39,64.55
Taliyah,Evelynn,84,41,43,48.81
Taliyah,Zeri,145,72,73,49.66
Taliyah,Soraka,156,63,93,40.38
Taliyah,MasterYi,316,170,146,53.8
Taliyah,Gwen,172,86,86,50
Taliyah,Rengar,111,55,56,49.55
Taliyah,Viktor,256,168,88,65.63
Taliyah,Katarina,183,97,86,53.01
Taliyah,Illaoi,123,63,60,51.22
Taliyah,Ambessa,197,105,92,53.3
Taliyah,Sejuani,140,79,61,56.43
Taliyah,Janna,106,57,49,53.77
Taliyah,Malzahar,280,137,143,48.93
Taliyah,Anivia,106,50,56,47.17
Taliyah,Pyke,213,112,101,52.58
Taliyah,TwistedFate,144,94,50,65.28
Taliyah,Shen,170,103,67,60.59
Taliyah,Varus,317,181,136,57.1
Taliyah,Rakan,147,77,70,52.38
Taliyah,Tryndamere,139,73,66,52.52
Taliyah,Hwei,239,118,121,49.37
Taliyah,Kindred,146,94,52,64.38
Taliyah,Samira,179,100,79,55.87
Taliyah,Seraphine,195,113,82,57.95
Taliyah,Warwick,371,193,178,52.02
Taliyah,Nunu,135,79,56,58.52
Taliyah,KogMaw,95,35,60,36.84
Taliyah,Nautilus,292,189,103,64.73
Taliyah,Taric,88,47,41,53.41
Taliyah,DrMundo,168,74,94,44.05
Taliyah,Sylas,500,275,225,55
Taliyah,Aurora,224,137,87,61.16
Taliyah,Singed,78,38,40,48.72
Taliyah,Shaco,253,129,124,50.99
Taliyah,Nami,334,177,157,52.99
Taliyah,Syndra,230,94,136,40.87
Taliyah,Vladimir,161,78,83,48.45
Taliyah,Smolder,148,68,80,45.95
Taliyah,Kayle,180,74,106,41.11
Taliyah,TahmKench,176,77,99,43.75
Taliyah,Nocturne,338,174,164,51.48
Taliyah,XinZhao,211,100,111,47.39
Taliyah,Lillia,156,70,86,44.87
Taliyah,Ziggs,116,60,56,51.72
Taliyah,Rumble,107,68,39,63.55
Taliyah,Olaf,74,42,32,56.76
Taliyah,Alistar,93,45,48,48.39
Taliyah,Orianna,157,82,75,52.23
Taliyah,Qiyana,93,51,42,54.84
Taliyah,Zac,148,65,83,43.92
Taliyah,Chogath,324,159,165,49.07
Taliyah,Nilah,95,52,43,54.74
Taliyah,Nidalee,118,55,63,46.61
Taliyah,Braum,205,106,99,51.71
Taliyah,Corki,140,73,67,52.14
Taliyah,Gragas,163,90,73,55.21
Taliyah,JarvanIV,168,68,100,40.48
Taliyah,Quinn,140,64,76,45.71
Taliyah,Akshan,145,81,64,55.86
Taliyah,AurelionSol,110,59,51,53.64
Taliyah,Draven,134,89,45,66.42
Taliyah,Maokai,124,52,72,41.94
Taliyah,Skarner,107,66,41,61.68
Taliyah,Sivir,151,70,81,46.36
Taliyah,Zilean,91,43,48,47.25
Taliyah,Leblanc,177,88,89,49.72
Taliyah,Lissandra,119,65,54,54.62
Taliyah,Kled,35,17,18,48.57
Taliyah,Kennen,64,32,32,50
Taliyah,RekSai,28,20,8,71.43
Taliyah,Shyvana,52,18,34,34.62
AurelionSol,Yone,733,361,372,49.25
AurelionSol,Samira,321,202,119,62.93
AurelionSol,Yasuo,919,458,461,49.84
AurelionSol,Jhin,947,493,454,52.06
AurelionSol,Varus,366,173,193,47.27
AurelionSol,Singed,129,69,60,53.49
AurelionSol,Diana,622,295,327,47.43
AurelionSol,Viktor,404,224,180,55.45
AurelionSol,MissFortune,1115,559,556,50.13
AurelionSol,Galio,359,193,166,53.76
AurelionSol,Ornn,135,67,68,49.63
AurelionSol,Shaco,449,236,213,52.56
AurelionSol,Aurora,280,145,135,51.79
AurelionSol,Caitlyn,1230,613,617,49.84
AurelionSol,Zilean,132,65,67,49.24
AurelionSol,Trundle,330,156,174,47.27
AurelionSol,Volibear,550,264,286,48
AurelionSol,Naafiri,143,53,90,37.06
AurelionSol,Lux,1177,612,565,52
AurelionSol,Elise,262,119,143,45.42
AurelionSol,Fizz,290,129,161,44.48
AurelionSol,Nautilus,495,231,264,46.67
AurelionSol,Camille,159,89,70,55.97
AurelionSol,XinZhao,247,126,121,51.01
AurelionSol,Mel,1199,659,540,54.96
AurelionSol,Ahri,569,287,282,50.44
AurelionSol,Gragas,235,110,125,46.81
AurelionSol,Kayn,628,313,315,49.84
AurelionSol,Janna,160,93,67,58.13
AurelionSol,Sion,352,178,174,50.57
AurelionSol,Vi,431,204,227,47.33
AurelionSol,Corki,141,69,72,48.94
AurelionSol,Soraka,222,120,102,54.05
AurelionSol,Teemo,523,274,249,52.39
AurelionSol,Mordekaiser,599,255,344,42.57
AurelionSol,Talon,197,105,92,53.3
AurelionSol,Smolder,299,172,127,57.53
AurelionSol,Alistar,169,103,66,60.95
AurelionSol,Poppy,232,125,107,53.88
AurelionSol,Karthus,127,61,66,48.03
AurelionSol,Zeri,164,81,83,49.39
AurelionSol,Lulu,507,281,226,55.42
AurelionSol,Gwen,202,118,84,58.42
AurelionSol,Khazix,186,87,99,46.77
AurelionSol,Ziggs,188,93,95,49.47
AurelionSol,Morgana,563,248,315,44.05
AurelionSol,Viego,649,302,347,46.53
AurelionSol,Irelia,313,142,171,45.37
AurelionSol,Thresh,470,237,233,50.43
AurelionSol,Aatrox,404,205,199,50.74
AurelionSol,Warwick,672,339,333,50.45
AurelionSol,Karma,525,264,261,50.29
AurelionSol,Kalista,107,55,52,51.4
AurelionSol,Braum,274,157,117,57.3
AurelionSol,MonkeyKing,309,172,137,55.66
AurelionSol,Malzahar,701,392,309,55.92
AurelionSol,Sett,657,287,370,43.68
AurelionSol,Veigar,549,299,250,54.46
AurelionSol,Twitch,356,198,158,55.62
AurelionSol,Blitzcrank,364,188,176,51.65
AurelionSol,Garen,684,294,390,42.98
AurelionSol,Katarina,379,170,209,44.85
AurelionSol,Kaisa,638,311,327,48.75
AurelionSol,Sejuani,183,100,83,54.64
AurelionSol,Zed,383,187,196,48.83
AurelionSol,Nilah,137,73,64,53.28
AurelionSol,Seraphine,325,146,179,44.92
AurelionSol,Darius,852,428,424,50.23
AurelionSol,Chogath,569,286,283,50.26
AurelionSol,Akshan,161,87,74,54.04
AurelionSol,Pantheon,624,316,308,50.64
AurelionSol,LeeSin,521,267,254,51.25
AurelionSol,Jax,416,209,207,50.24
AurelionSol,Ezreal,1092,531,561,48.63
AurelionSol,Nami,403,225,178,55.83
AurelionSol,Ekko,445,230,215,51.69
AurelionSol,Akali,380,166,214,43.68
AurelionSol,Ashe,877,437,440,49.83
AurelionSol,Jayce,196,113,83,57.65
AurelionSol,Briar,349,153,196,43.84
AurelionSol,Maokai,193,104,89,53.89
AurelionSol,Nocturne,558,296,262,53.05
AurelionSol,Kayle,283,136,147,48.06
AurelionSol,Rell,234,120,114,51.28
AurelionSol,Riven,203,119,84,58.62
AurelionSol,Skarner,117,68,49,58.12
AurelionSol,Xerath,379,180,199,47.49
AurelionSol,MasterYi,560,269,291,48.04
AurelionSol,Vayne,600,289,311,48.17
AurelionSol,Xayah,184,97,87,52.72
AurelionSol,Rakan,213,97,116,45.54
AurelionSol,TahmKench,341,185,156,54.25
AurelionSol,Quinn,157,67,90,42.68
AurelionSol,Neeko,204,124,80,60.78
AurelionSol,Sivir,262,131,131,50
AurelionSol,Amumu,481,229,252,47.61
AurelionSol,Ryze,153,82,71,53.59
AurelionSol,Evelynn,172,103,69,59.88
AurelionSol,Milio,251,137,114,54.58
AurelionSol,Pyke,370,192,178,51.89
AurelionSol,Yorick,518,259,259,50
AurelionSol,Anivia,180,82,98,45.56
AurelionSol,Brand,341,154,187,45.16
AurelionSol,Velkoz,298,140,158,46.98
AurelionSol,FiddleSticks,239,127,112,53.14
AurelionSol,Sylas,463,250,213,54
AurelionSol,Fiora,146,78,68,53.42
AurelionSol,Senna,336,161,175,47.92
AurelionSol,Vladimir,305,178,127,58.36
AurelionSol,Jinx,1259,623,636,49.48
AurelionSol,Rammus,121,70,51,57.85
AurelionSol,Shen,282,125,157,44.33
AurelionSol,Syndra,317,157,160,49.53
AurelionSol,Lucian,293,159,134,54.27
AurelionSol,Graves,364,198,166,54.4
AurelionSol,Renata,79,38,41,48.1
AurelionSol,Gnar,167,75,92,44.91
AurelionSol,Leona,440,211,229,47.95
AurelionSol,Lillia,268,111,157,41.42
AurelionSol,Rengar,95,37,58,38.95
AurelionSol,Rumble,91,47,44,51.65
AurelionSol,Zoe,145,70,75,48.28
AurelionSol,Hwei,294,157,137,53.4
AurelionSol,Hecarim,218,115,103,52.75
AurelionSol,Ivern,68,43,25,63.24
AurelionSol,Belveth,110,65,45,59.09
AurelionSol,Leblanc,225,84,141,37.33
AurelionSol,Taric,131,54,77,41.22
AurelionSol,Annie,142,57,85,40.14
AurelionSol,Gangplank,184,88,96,47.83
AurelionSol,Nunu,262,144,118,54.96
AurelionSol,Nasus,371,191,180,51.48
AurelionSol,Illaoi,218,134,84,61.47
AurelionSol,Malphite,459,265,194,57.73
AurelionSol,Zyra,399,186,213,46.62
AurelionSol,Lissandra,120,48,72,40
AurelionSol,Ambessa,269,144,125,53.53
AurelionSol,KSante,213,101,112,47.42
AurelionSol,Vex,189,104,85,55.03
AurelionSol,Bard,116,62,54,53.45
AurelionSol,Udyr,184,90,94,48.91
AurelionSol,Orianna,178,94,84,52.81
AurelionSol,Draven,221,106,115,47.96
AurelionSol,Nidalee,121,60,61,49.59
AurelionSol,Tristana,403,203,200,50.37
AurelionSol,DrMundo,252,132,120,52.38
AurelionSol,Kindred,176,86,90,48.86
AurelionSol,Renekton,210,124,86,59.05
AurelionSol,Kassadin,95,36,59,37.89
AurelionSol,Sona,137,82,55,59.85
AurelionSol,Azir,160,91,69,56.88
AurelionSol,Swain,415,209,206,50.36
AurelionSol,Aphelios,233,110,123,47.21
AurelionSol,Taliyah,110,51,59,46.36
AurelionSol,Olaf,95,44,51,46.32
AurelionSol,TwistedFate,151,86,65,56.95
AurelionSol,Heimerdinger,196,83,113,42.35
AurelionSol,Yuumi,338,150,188,44.38
AurelionSol,Kennen,84,33,51,39.29
AurelionSol,Cassiopeia,111,42,69,37.84
AurelionSol,KogMaw,138,99,39,71.74
AurelionSol,Kled,80,33,47,41.25
AurelionSol,Shyvana,85,42,43,49.41
AurelionSol,Zac,176,90,86,51.14
AurelionSol,RekSai,41,22,19,53.66
AurelionSol,JarvanIV,262,136,126,51.91
AurelionSol,Tryndamere,273,133,140,48.72
AurelionSol,Urgot,290,144,146,49.66
AurelionSol,Qiyana,104,48,56,46.15
Nunu,Gnar,277,133,144,48.01
Nunu,MonkeyKing,431,200,231,46.4
Nunu,Yasuo,1222,620,602,50.74
Nunu,Vayne,747,389,358,52.07
Nunu,Bard,158,84,74,53.16
Nunu,Kayn,862,440,422,51.04
Nunu,Rengar,185,93,92,50.27
Nunu,Fizz,353,179,174,50.71
Nunu,KogMaw,162,78,84,48.15
Nunu,Lux,1685,815,870,48.37
Nunu,TahmKench,453,245,208,54.08
Nunu,Ivern,90,32,58,35.56
Nunu,Draven,342,206,136,60.23
Nunu,Milio,350,183,167,52.29
Nunu,Urgot,334,156,178,46.71
Nunu,Amumu,780,342,438,43.85
Nunu,Mel,1309,665,644,50.8
Nunu,Jhin,1309,691,618,52.79
Nunu,Brand,552,280,272,50.72
Nunu,Briar,513,222,291,43.27
Nunu,Zoe,276,169,107,61.23
Nunu,Jinx,1741,830,911,47.67
Nunu,Illaoi,307,147,160,47.88
Nunu,XinZhao,387,181,206,46.77
Nunu,Ahri,745,392,353,52.62
Nunu,Sett,901,409,492,45.39
Nunu,Mordekaiser,905,430,475,47.51
Nunu,Akshan,225,115,110,51.11
Nunu,MissFortune,1593,787,806,49.4
Nunu,Maokai,305,160,145,52.46
Nunu,Garen,1071,538,533,50.23
Nunu,Belveth,137,74,63,54.01
Nunu,Qiyana,170,97,73,57.06
Nunu,Corki,225,115,110,51.11
Nunu,Darius,1238,632,606,51.05
Nunu,JarvanIV,437,193,244,44.16
Nunu,Ekko,701,350,351,49.93
Nunu,Zeri,245,123,122,50.2
Nunu,Lulu,731,359,372,49.11
Nunu,Sylas,899,461,438,51.28
Nunu,Kaisa,1012,495,517,48.91
Nunu,Xayah,267,132,135,49.44
Nunu,Hecarim,294,145,149,49.32
Nunu,Hwei,390,201,189,51.54
Nunu,Morgana,835,411,424,49.22
Nunu,Fiora,227,112,115,49.34
Nunu,Talon,358,162,196,45.25
Nunu,Trundle,387,208,179,53.75
Nunu,Warwick,984,449,535,45.63
Nunu,Diana,955,482,473,50.47
Nunu,Veigar,616,295,321,47.89
Nunu,Seraphine,518,269,249,51.93
Nunu,MasterYi,822,372,450,45.26
Nunu,Kayle,483,238,245,49.28
Nunu,Ashe,1296,584,712,45.06
Nunu,Yorick,728,362,366,49.73
Nunu,Sejuani,271,133,138,49.08
Nunu,Caitlyn,1809,903,906,49.92
Nunu,Zed,623,321,302,51.52
Nunu,Gragas,336,184,152,54.76
Nunu,Irelia,508,238,270,46.85
Nunu,Sivir,358,190,168,53.07
Nunu,Zilean,172,70,102,40.7
Nunu,Heimerdinger,304,128,176,42.11
Nunu,Swain,560,256,304,45.71
Nunu,Lucian,344,180,164,52.33
Nunu,Teemo,878,464,414,52.85
Nunu,Galio,545,220,325,40.37
Nunu,Anivia,220,96,124,43.64
Nunu,Akali,707,358,349,50.64
Nunu,Riven,254,122,132,48.03
Nunu,Vi,579,305,274,52.68
Nunu,Aphelios,265,135,130,50.94
Nunu,LeeSin,812,419,393,51.6
Nunu,Kassadin,173,88,85,50.87
Nunu,Rell,315,169,146,53.65
Nunu,Khazix,271,136,135,50.18
Nunu,Twitch,523,281,242,53.73
Nunu,Janna,257,138,119,53.7
Nunu,Ornn,290,161,129,55.52
Nunu,Nautilus,702,365,337,51.99
Nunu,Tristana,669,329,340,49.18
Nunu,Velkoz,446,213,233,47.76
Nunu,Yone,1150,584,566,50.78
Nunu,Ezreal,1492,822,670,55.09
Nunu,Udyr,266,158,108,59.4
Nunu,Quinn,209,91,118,43.54
Nunu,Annie,247,129,118,52.23
Nunu,Katarina,437,185,252,42.33
Nunu,Senna,418,189,229,45.22
Nunu,Viego,921,475,446,51.57
Nunu,Jax,603,315,288,52.24
Nunu,Graves,360,170,190,47.22
Nunu,Azir,197,92,105,46.7
Nunu,Kindred,330,205,125,62.12
Nunu,Thresh,742,421,321,56.74
Nunu,Chogath,755,386,369,51.13
Nunu,DrMundo,393,185,208,47.07
Nunu,Xerath,581,280,301,48.19
Nunu,Pantheon,923,462,461,50.05
Nunu,Nocturne,826,393,433,47.58
Nunu,Malzahar,722,348,374,48.2
Nunu,Shen,400,205,195,51.25
Nunu,Vex,331,173,158,52.27
Nunu,Poppy,331,156,175,47.13
Nunu,Shaco,616,338,278,54.87
Nunu,Nami,626,321,305,51.28
Nunu,Karthus,189,94,95,49.74
Nunu,Aatrox,442,212,230,47.96
Nunu,Zyra,564,257,307,45.57
Nunu,Braum,338,166,172,49.11
Nunu,Vladimir,375,177,198,47.2
Nunu,Leblanc,305,137,168,44.92
Nunu,Neeko,361,168,193,46.54
Nunu,FiddleSticks,331,176,155,53.17
Nunu,Yuumi,524,298,226,56.87
Nunu,Ziggs,277,141,136,50.9
Nunu,AurelionSol,262,118,144,45.04
Nunu,Sona,179,79,100,44.13
Nunu,Varus,568,313,255,55.11
Nunu,Malphite,607,292,315,48.11
Nunu,TwistedFate,208,123,85,59.13
Nunu,Volibear,735,368,367,50.07
Nunu,Ryze,183,70,113,38.25
Nunu,Sion,521,243,278,46.64
Nunu,Zac,317,168,149,53
Nunu,Karma,718,403,315,56.13
Nunu,Taliyah,135,56,79,41.48
Nunu,Kalista,157,83,74,52.87
Nunu,Viktor,498,282,216,56.63
Nunu,KSante,247,118,129,47.77
Nunu,Soraka,392,173,219,44.13
Nunu,Orianna,255,121,134,47.45
Nunu,Nasus,431,213,218,49.42
Nunu,Samira,452,223,229,49.34
Nunu,Leona,543,245,298,45.12
Nunu,Rakan,219,118,101,53.88
Nunu,Renekton,335,192,143,57.31
Nunu,Aurora,457,262,195,57.33
Nunu,Gwen,275,156,119,56.73
Nunu,Taric,169,62,107,36.69
Nunu,Lillia,376,197,179,52.39
Nunu,Elise,411,203,208,49.39
Nunu,Blitzcrank,442,232,210,52.49
Nunu,Gangplank,269,127,142,47.21
Nunu,Naafiri,237,134,103,56.54
Nunu,Evelynn,212,93,119,43.87
Nunu,Rumble,150,71,79,47.33
Nunu,Ambessa,364,187,177,51.37
Nunu,Pyke,537,297,240,55.31
Nunu,Tryndamere,377,203,174,53.85
Nunu,Smolder,311,134,177,43.09
Nunu,Olaf,147,76,71,51.7
Nunu,Syndra,395,196,199,49.62
Nunu,Camille,202,113,89,55.94
Nunu,Jayce,217,112,105,51.61
Nunu,Singed,218,102,116,46.79
Nunu,Cassiopeia,178,98,80,55.06
Nunu,Kled,60,22,38,36.67
Nunu,Shyvana,145,73,72,50.34
Nunu,Skarner,164,85,79,51.83
Nunu,Nilah,205,107,98,52.2
Nunu,Rammus,150,98,52,65.33
Nunu,Nidalee,134,53,81,39.55
Nunu,Renata,99,62,37,62.63
Nunu,Lissandra,230,100,130,43.48
Nunu,Kennen,133,63,70,47.37
Nunu,Alistar,217,129,88,59.45
Nunu,RekSai,74,44,30,59.46
Olaf,Maokai,158,60,98,37.97
Olaf,MasterYi,336,153,183,45.54
Olaf,Yasuo,494,248,246,50.2
Olaf,Samira,165,87,78,52.73
Olaf,Pyke,238,134,104,56.3
Olaf,Garen,487,218,269,44.76
Olaf,Volibear,315,154,161,48.89
Olaf,Veigar,294,151,143,51.36
Olaf,Smolder,187,91,96,48.66
Olaf,Lux,646,313,333,48.45
Olaf,Kayle,157,71,86,45.22
Olaf,Ekko,279,136,143,48.75
Olaf,Ziggs,102,57,45,55.88
Olaf,Urgot,150,67,83,44.67
Olaf,Lillia,178,72,106,40.45
Olaf,Diana,384,186,198,48.44
Olaf,Aphelios,150,69,81,46
Olaf,Leona,272,135,137,49.63
Olaf,Warwick,380,197,183,51.84
Olaf,Udyr,105,68,37,64.76
Olaf,Vladimir,209,92,117,44.02
Olaf,Jinx,719,375,344,52.16
Olaf,Milio,188,93,95,49.47
Olaf,Teemo,444,245,199,55.18
Olaf,Jax,271,150,121,55.35
Olaf,Swain,222,112,110,50.45
Olaf,Lucian,221,100,121,45.25
Olaf,Nami,256,148,108,57.81
Olaf,Aatrox,211,119,92,56.4
Olaf,Belveth,50,29,21,58
Olaf,Syndra,179,85,94,47.49
Olaf,Lulu,404,233,171,57.67
Olaf,Darius,503,218,285,43.34
Olaf,Brand,190,77,113,40.53
Olaf,Sona,59,26,33,44.07
Olaf,Evelynn,78,40,38,51.28
Olaf,Irelia,166,78,88,46.99
Olaf,Tristana,280,140,140,50
Olaf,Blitzcrank,246,140,106,56.91
Olaf,Rengar,88,59,29,67.05
Olaf,XinZhao,181,93,88,51.38
Olaf,Zoe,114,71,43,62.28
Olaf,Gwen,130,59,71,45.38
Olaf,Amumu,260,136,124,52.31
Olaf,Renata,39,27,12,69.23
Olaf,Kayn,369,179,190,48.51
Olaf,Jhin,564,273,291,48.4
Olaf,Draven,187,82,105,43.85
Olaf,Morgana,388,207,181,53.35
Olaf,Nocturne,367,180,187,49.05
Olaf,Katarina,183,89,94,48.63
Olaf,Viktor,273,143,130,52.38
Olaf,Viego,417,202,215,48.44
Olaf,Sylas,374,210,164,56.15
Olaf,Ashe,596,329,267,55.2
Olaf,Chogath,364,185,179,50.82
Olaf,Akshan,106,67,39,63.21
Olaf,Yorick,230,83,147,36.09
Olaf,Briar,187,94,93,50.27
Olaf,Shyvana,51,20,31,39.22
Olaf,LeeSin,552,311,241,56.34
Olaf,Lissandra,106,51,55,48.11
Olaf,Soraka,132,67,65,50.76
Olaf,Annie,81,26,55,32.1
Olaf,Sejuani,113,58,55,51.33
Olaf,Leblanc,179,76,103,42.46
Olaf,MissFortune,567,250,317,44.09
Olaf,Yone,476,254,222,53.36
Olaf,Zyra,256,121,135,47.27
Olaf,Kaisa,409,222,187,54.28
Olaf,Rell,139,63,76,45.32
Olaf,Karthus,108,53,55,49.07
Olaf,Ezreal,708,367,341,51.84
Olaf,Gnar,133,60,73,45.11
Olaf,Akali,307,111,196,36.16
Olaf,Twitch,193,90,103,46.63
Olaf,Jayce,191,97,94,50.79
Olaf,Ryze,114,48,66,42.11
Olaf,Illaoi,159,67,92,42.14
Olaf,Malzahar,291,150,141,51.55
Olaf,Ambessa,196,102,94,52.04
Olaf,Shen,198,97,101,48.99
Olaf,Orianna,152,76,76,50
Olaf,Kalista,92,37,55,40.22
Olaf,Poppy,207,126,81,60.87
Olaf,Graves,189,75,114,39.68
Olaf,Riven,78,44,34,56.41
Olaf,Kindred,120,48,72,40
Olaf,Nidalee,83,39,44,46.99
Olaf,Ahri,340,170,170,50
Olaf,Sett,377,174,203,46.15
Olaf,Tryndamere,159,71,88,44.65
Olaf,Renekton,114,45,69,39.47
Olaf,Caitlyn,777,361,416,46.46
Olaf,KSante,153,68,85,44.44
Olaf,Vi,314,162,152,51.59
Olaf,Vex,156,80,76,51.28
Olaf,Nilah,103,30,73,29.13
Olaf,Alistar,142,77,65,54.23
Olaf,Zilean,67,23,44,34.33
Olaf,Mordekaiser,582,280,302,48.11
Olaf,Aurora,185,99,86,53.51
Olaf,Karma,337,155,182,45.99
Olaf,Pantheon,444,245,199,55.18
Olaf,Varus,334,169,165,50.6
Olaf,Nautilus,364,165,199,45.33
Olaf,Gragas,173,72,101,41.62
Olaf,TwistedFate,105,50,55,47.62
Olaf,Thresh,369,211,158,57.18
Olaf,Anivia,89,36,53,40.45
Olaf,Yuumi,195,102,93,52.31
Olaf,Trundle,231,113,118,48.92
Olaf,Mel,534,255,279,47.75
Olaf,Naafiri,77,41,36,53.25
Olaf,Braum,159,62,97,38.99
Olaf,TahmKench,182,99,83,54.4
Olaf,Zed,296,149,147,50.34
Olaf,Cassiopeia,109,63,46,57.8
Olaf,Janna,97,33,64,34.02
Olaf,Velkoz,156,75,81,48.08
Olaf,Sion,182,91,91,50
Olaf,Kennen,48,20,28,41.67
Olaf,Zac,116,65,51,56.03
Olaf,Taliyah,74,32,42,43.24
Olaf,Sivir,192,71,121,36.98
Olaf,Azir,84,39,45,46.43
Olaf,Senna,211,78,133,36.97
Olaf,Nasus,160,86,74,53.75
Olaf,Hecarim,98,44,54,44.9
Olaf,Gangplank,125,80,45,64
Olaf,Quinn,58,29,29,50
Olaf,Galio,235,115,120,48.94
Olaf,Kassadin,35,15,20,42.86
Olaf,Nunu,147,68,79,46.26
Olaf,Talon,175,81,94,46.29
Olaf,Seraphine,178,87,91,48.88
Olaf,Fiora,72,46,26,63.89
Olaf,Bard,97,39,58,40.21
Olaf,Ornn,114,75,39,65.79
Olaf,Skarner,91,33,58,36.26
Olaf,Elise,195,97,98,49.74
Olaf,Corki,120,59,61,49.17
Olaf,DrMundo,102,66,36,64.71
Olaf,Xerath,227,125,102,55.07
Olaf,Vayne,326,174,152,53.37
Olaf,Shaco,250,126,124,50.4
Olaf,Xayah,144,62,82,43.06
Olaf,FiddleSticks,178,100,78,56.18
Olaf,MonkeyKing,190,86,104,45.26
Olaf,AurelionSol,95,51,44,53.68
Olaf,Rakan,115,51,64,44.35
Olaf,Qiyana,90,52,38,57.78
Olaf,Ivern,38,23,15,60.53
Olaf,Fizz,137,75,62,54.74
Olaf,Neeko,141,57,84,40.43
Olaf,Zeri,144,81,63,56.25
Olaf,Singed,63,31,32,49.21
Olaf,KogMaw,76,36,40,47.37
Olaf,Hwei,165,83,82,50.3
Olaf,Taric,57,15,42,26.32
Olaf,Rammus,74,39,35,52.7
Olaf,Rumble,157,79,78,50.32
Olaf,Heimerdinger,120,41,79,34.17
Olaf,Malphite,234,150,84,64.1
Olaf,JarvanIV,124,67,57,54.03
Olaf,Kled,49,29,20,59.18
Olaf,Khazix,109,53,56,48.62
Olaf,RekSai,29,14,15,48.28
Olaf,Camille,59,33,26,55.93
Naafiri,Kayle,257,105,152,40.86
Naafiri,Elise,215,106,109,49.3
Naafiri,Swain,341,152,189,44.57
Naafiri,Kalista,73,40,33,54.79
Naafiri,Karma,423,237,186,56.03
Naafiri,Chogath,471,211,260,44.8
Naafiri,Gragas,190,101,89,53.16
Naafiri,Zed,341,158,183,46.33
Naafiri,Vayne,492,254,238,51.63
Naafiri,Senna,261,123,138,47.13
Naafiri,Gwen,166,80,86,48.19
Naafiri,MonkeyKing,265,139,126,52.45
Naafiri,Yasuo,750,328,422,43.73
Naafiri,Kaisa,647,357,290,55.18
Naafiri,Renata,45,26,19,57.78
Naafiri,Volibear,498,238,260,47.79
Naafiri,JarvanIV,199,103,96,51.76
Naafiri,Lucian,231,137,94,59.31
Naafiri,Nami,376,205,171,54.52
Naafiri,Warwick,670,337,333,50.3
Naafiri,Yone,724,339,385,46.82
Naafiri,Mel,842,417,425,49.52
Naafiri,Brand,343,181,162,52.77
Naafiri,Jayce,153,86,67,56.21
Naafiri,Diana,661,352,309,53.25
Naafiri,Anivia,108,53,55,49.07
Naafiri,Ezreal,883,458,425,51.87
Naafiri,TahmKench,314,165,149,52.55
Naafiri,Darius,721,356,365,49.38
Naafiri,Viego,603,301,302,49.92
Naafiri,AurelionSol,143,90,53,62.94
Naafiri,Xayah,177,91,86,51.41
Naafiri,Seraphine,350,161,189,46
Naafiri,Gnar,170,83,87,48.82
Naafiri,FiddleSticks,185,87,98,47.03
Naafiri,Irelia,358,186,172,51.96
Naafiri,Smolder,242,114,128,47.11
Naafiri,Sona,98,43,55,43.88
Naafiri,LeeSin,492,257,235,52.24
Naafiri,Sylas,556,302,254,54.32
Naafiri,Jinx,1045,469,576,44.88
Naafiri,Pyke,343,183,160,53.35
Naafiri,Ambessa,255,125,130,49.02
Naafiri,Jax,322,168,154,52.17
Naafiri,Malzahar,370,184,186,49.73
Naafiri,Jhin,875,467,408,53.37
Naafiri,Nasus,307,143,164,46.58
Naafiri,TwistedFate,114,78,36,68.42
Naafiri,Samira,260,135,125,51.92
Naafiri,Rammus,114,54,60,47.37
Naafiri,Neeko,174,93,81,53.45
Naafiri,Ziggs,136,64,72,47.06
Naafiri,Shaco,351,195,156,55.56
Naafiri,Taliyah,117,50,67,42.74
Naafiri,Renekton,162,76,86,46.91
Naafiri,Kayn,628,330,298,52.55
Naafiri,Veigar,449,183,266,40.76
Naafiri,MissFortune,934,442,492,47.32
Naafiri,Lux,1042,524,518,50.29
Naafiri,Sett,583,324,259,55.57
Naafiri,Leblanc,304,202,102,66.45
Naafiri,Ashe,782,397,385,50.77
Naafiri,Camille,127,83,44,65.35
Naafiri,Annie,115,66,49,57.39
Naafiri,Tristana,421,211,210,50.12
Naafiri,Blitzcrank,267,103,164,38.58
Naafiri,Twitch,319,186,133,58.31
Naafiri,Riven,185,97,88,52.43
Naafiri,Ekko,373,197,176,52.82
Naafiri,Yorick,442,222,220,50.23
Naafiri,Caitlyn,1122,576,546,51.34
Naafiri,Graves,215,128,87,59.53
Naafiri,Aurora,292,126,166,43.15
Naafiri,Sejuani,132,79,53,59.85
Naafiri,Akali,452,229,223,50.66
Naafiri,Quinn,127,71,56,55.91
Naafiri,Orianna,182,90,92,49.45
Naafiri,Garen,638,314,324,49.22
Naafiri,Shyvana,111,40,71,36.04
Naafiri,Milio,207,106,101,51.21
Naafiri,Pantheon,585,320,265,54.7
Naafiri,Hwei,248,128,120,51.61
Naafiri,Thresh,440,201,239,45.68
Naafiri,Hecarim,165,61,104,36.97
Naafiri,Rell,126,66,60,52.38
Naafiri,Varus,342,167,175,48.83
Naafiri,Lulu,499,257,242,51.5
Naafiri,Heimerdinger,198,96,102,48.48
Naafiri,Zyra,370,167,203,45.14
Naafiri,Rakan,152,67,85,44.08
Naafiri,Lillia,205,99,106,48.29
Naafiri,Akshan,151,73,78,48.34
Naafiri,Velkoz,254,137,117,53.94
Naafiri,Ahri,434,241,193,55.53
Naafiri,Kled,57,24,33,42.11
Naafiri,MasterYi,440,191,249,43.41
Naafiri,Fizz,212,112,100,52.83
Naafiri,Aphelios,173,76,97,43.93
Naafiri,Nautilus,388,195,193,50.26
Naafiri,Talon,217,130,87,59.91
Naafiri,Draven,195,100,95,51.28
Naafiri,Yuumi,336,159,177,47.32
Naafiri,Sion,268,110,158,41.04
Naafiri,Vex,241,123,118,51.04
Naafiri,Soraka,215,100,115,46.51
Naafiri,Kennen,105,47,58,44.76
Naafiri,Katarina,276,163,113,59.06
Naafiri,Galio,310,142,168,45.81
Naafiri,Nocturne,512,210,302,41.02
Naafiri,Leona,350,194,156,55.43
Naafiri,Morgana,493,267,226,54.16
Naafiri,Mordekaiser,548,274,274,50
Naafiri,Teemo,549,277,272,50.46
Naafiri,Zilean,133,65,68,48.87
Naafiri,Zeri,132,90,42,68.18
Naafiri,Bard,111,59,52,53.15
Naafiri,Zoe,216,115,101,53.24
Naafiri,Braum,177,73,104,41.24
Naafiri,Aatrox,312,147,165,47.12
Naafiri,Illaoi,170,104,66,61.18
Naafiri,Ornn,111,63,48,56.76
Naafiri,Karthus,103,53,50,51.46
Naafiri,Corki,138,65,73,47.1
Naafiri,Vladimir,248,119,129,47.98
Naafiri,Amumu,417,190,227,45.56
Naafiri,Tryndamere,199,85,114,42.71
Naafiri,Urgot,233,99,134,42.49
Naafiri,Malphite,432,224,208,51.85
Naafiri,Rengar,114,62,52,54.39
Naafiri,Lissandra,150,58,92,38.67
Naafiri,Syndra,233,131,102,56.22
Naafiri,Cassiopeia,106,55,51,51.89
Naafiri,Udyr,141,85,56,60.28
Naafiri,Nilah,124,32,92,25.81
Naafiri,Xerath,335,197,138,58.81
Naafiri,DrMundo,211,104,107,49.29
Naafiri,Nidalee,83,60,23,72.29
Naafiri,Singed,116,45,71,38.79
Naafiri,Skarner,86,42,44,48.84
Naafiri,Trundle,238,123,115,51.68
Naafiri,Sivir,193,106,87,54.92
Naafiri,Kindred,173,76,97,43.93
Naafiri,Kassadin,77,32,45,41.56
Naafiri,Khazix,169,96,73,56.8
Naafiri,Briar,309,159,150,51.46
Naafiri,Vi,342,161,181,47.08
Naafiri,Janna,130,72,58,55.38
Naafiri,Olaf,77,36,41,46.75
Naafiri,Poppy,224,110,114,49.11
Naafiri,Viktor,309,178,131,57.61
Naafiri,Alistar,129,56,73,43.41
Naafiri,Shen,220,107,113,48.64
Naafiri,Maokai,156,69,87,44.23
Naafiri,Gangplank,160,78,82,48.75
Naafiri,Nunu,237,103,134,43.46
Naafiri,Ivern,66,34,32,51.52
Naafiri,Ryze,159,79,80,49.69
Naafiri,Rumble,84,50,34,59.52
Naafiri,Fiora,132,79,53,59.85
Naafiri,Qiyana,93,59,34,63.44
Naafiri,Evelynn,125,77,48,61.6
Naafiri,Zac,164,79,85,48.17
Naafiri,KogMaw,110,56,54,50.91
Naafiri,KSante,163,108,55,66.26
Naafiri,Taric,73,33,40,45.21
Naafiri,XinZhao,236,122,114,51.69
Naafiri,RekSai,23,8,15,34.78
Naafiri,Belveth,67,30,37,44.78
Naafiri,Azir,99,64,35,64.65
Nidalee,Rumble,145,93,52,64.14
Nidalee,FiddleSticks,146,87,59,59.59
Nidalee,Vladimir,265,130,135,49.06
Nidalee,Jhin,672,300,372,44.64
Nidalee,TahmKench,198,97,101,48.99
Nidalee,Darius,561,249,312,44.39
Nidalee,Nocturne,458,211,247,46.07
Nidalee,Fizz,180,77,103,42.78
Nidalee,Samira,220,95,125,43.18
Nidalee,Lux,737,329,408,44.64
Nidalee,Volibear,282,108,174,38.3
Nidalee,Warwick,373,163,210,43.7
Nidalee,Yone,664,298,366,44.88
Nidalee,Mel,563,301,262,53.46
Nidalee,Brand,207,101,106,48.79
Nidalee,Sett,555,256,299,46.13
Nidalee,LeeSin,1094,503,591,45.98
Nidalee,Aurora,255,105,150,41.18
Nidalee,Pyke,269,151,118,56.13
Nidalee,Irelia,330,149,181,45.15
Nidalee,Ezreal,1183,516,667,43.62
Nidalee,Taric,58,29,29,50
Nidalee,Zed,377,169,208,44.83
Nidalee,Aphelios,178,71,107,39.89
Nidalee,Swain,295,128,167,43.39
Nidalee,Kayn,438,169,269,38.58
Nidalee,Neeko,208,112,96,53.85
Nidalee,Nasus,205,84,121,40.98
Nidalee,Viego,609,279,330,45.81
Nidalee,Lissandra,150,60,90,40
Nidalee,Vayne,349,171,178,49
Nidalee,Lulu,487,204,283,41.89
Nidalee,Galio,323,152,171,47.06
Nidalee,Ashe,930,380,550,40.86
Nidalee,Soraka,142,66,76,46.48
Nidalee,Malzahar,272,104,168,38.24
Nidalee,Akali,456,237,219,51.97
Nidalee,Jinx,890,410,480,46.07
Nidalee,Janna,105,44,61,41.9
Nidalee,Chogath,323,144,179,44.58
Nidalee,Elise,323,168,155,52.01
Nidalee,Hwei,264,111,153,42.05
Nidalee,MasterYi,314,136,178,43.31
Nidalee,Katarina,244,100,144,40.98
Nidalee,Lucian,233,105,128,45.06
Nidalee,Seraphine,204,84,120,41.18
Nidalee,Veigar,283,125,158,44.17
Nidalee,Yorick,299,135,164,45.15
Nidalee,Zeri,186,80,106,43.01
Nidalee,Riven,165,75,90,45.45
Nidalee,Lillia,149,83,66,55.7
Nidalee,Caitlyn,905,445,460,49.17
Nidalee,Nami,273,102,171,37.36
Nidalee,Mordekaiser,278,120,158,43.17
Nidalee,Karthus,117,68,49,58.12
Nidalee,Yasuo,655,293,362,44.73
Nidalee,Sivir,191,95,96,49.74
Nidalee,Thresh,543,257,286,47.33
Nidalee,Zac,239,86,153,35.98
Nidalee,Diana,583,227,356,38.94
Nidalee,Kaisa,689,329,360,47.75
Nidalee,Yuumi,292,128,164,43.84
Nidalee,Kassadin,74,20,54,27.03
Nidalee,Draven,155,81,74,52.26
Nidalee,Malphite,363,184,179,50.69
Nidalee,Leblanc,306,172,134,56.21
Nidalee,Senna,249,110,139,44.18
Nidalee,XinZhao,247,106,141,42.91
Nidalee,Olaf,83,44,39,53.01
Nidalee,Graves,338,163,175,48.22
Nidalee,Milio,175,85,90,48.57
Nidalee,Sejuani,127,72,55,56.69
Nidalee,Ekko,293,125,168,42.66
Nidalee,Naafiri,83,23,60,27.71
Nidalee,Shen,199,78,121,39.2
Nidalee,Briar,191,87,104,45.55
Nidalee,Teemo,379,148,231,39.05
Nidalee,Corki,153,72,81,47.06
Nidalee,Qiyana,85,49,36,57.65
Nidalee,Vi,332,131,201,39.46
Nidalee,Trundle,168,93,75,55.36
Nidalee,Varus,324,135,189,41.67
Nidalee,Ambessa,270,141,129,52.22
Nidalee,Skarner,86,60,26,69.77
Nidalee,Smolder,181,84,97,46.41
Nidalee,Heimerdinger,148,70,78,47.3
Nidalee,Rell,185,72,113,38.92
Nidalee,Azir,132,70,62,53.03
Nidalee,Rakan,139,55,84,39.57
Nidalee,Karma,574,262,312,45.64
Nidalee,Sylas,565,258,307,45.66
Nidalee,Braum,215,96,119,44.65
Nidalee,Tristana,389,178,211,45.76
Nidalee,Annie,153,73,80,47.71
Nidalee,Ivern,43,17,26,39.53
Nidalee,Rengar,127,66,61,51.97
Nidalee,AurelionSol,121,61,60,50.41
Nidalee,Pantheon,601,299,302,49.75
Nidalee,Urgot,137,47,90,34.31
Nidalee,JarvanIV,223,93,130,41.7
Nidalee,Aatrox,366,119,247,32.51
Nidalee,Ahri,483,207,276,42.86
Nidalee,Zilean,118,65,53,55.08
Nidalee,MissFortune,698,299,399,42.84
Nidalee,Udyr,140,55,85,39.29
Nidalee,Renekton,223,93,130,41.7
Nidalee,Zyra,443,176,267,39.73
Nidalee,Gangplank,164,93,71,56.71
Nidalee,Tryndamere,173,86,87,49.71
Nidalee,Morgana,320,165,155,51.56
Nidalee,TwistedFate,154,87,67,56.49
Nidalee,Illaoi,151,75,76,49.67
Nidalee,Xayah,161,76,85,47.2
Nidalee,Garen,457,168,289,36.76
Nidalee,Rammus,72,29,43,40.28
Nidalee,Viktor,369,153,216,41.46
Nidalee,Taliyah,118,63,55,53.39
Nidalee,Quinn,128,51,77,39.84
Nidalee,MonkeyKing,251,126,125,50.2
Nidalee,Sion,257,111,146,43.19
Nidalee,Evelynn,114,48,66,42.11
Nidalee,Sona,110,47,63,42.73
Nidalee,Nilah,78,30,48,38.46
Nidalee,Gwen,140,53,87,37.86
Nidalee,Velkoz,205,93,112,45.37
Nidalee,Leona,280,105,175,37.5
Nidalee,Amumu,257,125,132,48.64
Nidalee,Kayle,169,77,92,45.56
Nidalee,Nautilus,382,158,224,41.36
Nidalee,Khazix,264,118,146,44.7
Nidalee,Kled,60,24,36,40
Nidalee,Jax,293,135,158,46.08
Nidalee,Shaco,278,112,166,40.29
Nidalee,Xerath,397,164,233,41.31
Nidalee,Kennen,99,41,58,41.41
Nidalee,Renata,59,35,24,59.32
Nidalee,Singed,72,29,43,40.28
Nidalee,Ryze,146,52,94,35.62
Nidalee,Hecarim,149,67,82,44.97
Nidalee,Ziggs,128,56,72,43.75
Nidalee,Camille,185,73,112,39.46
Nidalee,Kalista,70,40,30,57.14
Nidalee,Orianna,216,111,105,51.39
Nidalee,Twitch,209,97,112,46.41
Nidalee,Talon,257,114,143,44.36
Nidalee,Zoe,145,76,69,52.41
Nidalee,KSante,227,144,83,63.44
Nidalee,RekSai,63,39,24,61.9
Nidalee,Fiora,125,50,75,40
Nidalee,Ornn,148,53,95,35.81
Nidalee,Shyvana,55,22,33,40
Nidalee,Nunu,134,81,53,60.45
Nidalee,Cassiopeia,119,55,64,46.22
Nidalee,Syndra,227,102,125,44.93
Nidalee,Maokai,131,56,75,42.75
Nidalee,Bard,100,42,58,42
Nidalee,DrMundo,169,78,91,46.15
Nidalee,Kindred,163,73,90,44.79
Nidalee,Blitzcrank,264,125,139,47.35
Nidalee,Jayce,249,127,122,51
Nidalee,Gnar,156,79,77,50.64
Nidalee,KogMaw,103,61,42,59.22
Nidalee,Vex,165,74,91,44.85
Nidalee,Anivia,96,34,62,35.42
Nidalee,Poppy,266,148,118,55.64
Nidalee,Gragas,205,103,102,50.24
Nidalee,Belveth,73,39,34,53.42
Nidalee,Akshan,83,28,55,33.73
Nidalee,Alistar,127,61,66,48.03
Udyr,Olaf,105,37,68,35.24
Udyr,Trundle,244,100,144,40.98
Udyr,Vex,210,106,104,50.48
Udyr,Ezreal,1078,542,536,50.28
Udyr,Xerath,394,201,193,51.02
Udyr,Kayle,329,167,162,50.76
Udyr,Volibear,630,339,291,53.81
Udyr,Yasuo,893,442,451,49.5
Udyr,Draven,255,133,122,52.16
Udyr,Thresh,656,357,299,54.42
Udyr,Yorick,476,197,279,41.39
Udyr,Darius,1105,568,537,51.4
Udyr,Syndra,309,128,181,41.42
Udyr,Samira,300,164,136,54.67
Udyr,Pantheon,689,295,394,42.82
Udyr,Riven,231,123,108,53.25
Udyr,Graves,296,140,156,47.3
Udyr,Ekko,446,242,204,54.26
Udyr,Aphelios,199,113,86,56.78
Udyr,TahmKench,361,184,177,50.97
Udyr,Ambessa,304,129,175,42.43
Udyr,Hecarim,239,133,106,55.65
Udyr,Katarina,288,149,139,51.74
Udyr,Veigar,511,221,290,43.25
Udyr,Nami,526,235,291,44.68
Udyr,Viego,714,366,348,51.26
Udyr,Taliyah,117,58,59,49.57
Udyr,Jinx,1326,630,696,47.51
Udyr,Blitzcrank,332,166,166,50
Udyr,Warwick,751,387,364,51.53
Udyr,Skarner,120,76,44,63.33
Udyr,Morgana,569,291,278,51.14
Udyr,Karma,540,270,270,50
Udyr,Shen,288,147,141,51.04
Udyr,Caitlyn,1353,656,697,48.48
Udyr,Zyra,400,207,193,51.75
Udyr,Neeko,210,121,89,57.62
Udyr,Elise,309,150,159,48.54
Udyr,Mel,974,472,502,48.46
Udyr,MissFortune,1004,458,546,45.62
Udyr,Pyke,369,196,173,53.12
Udyr,Rengar,118,46,72,38.98
Udyr,Malzahar,544,237,307,43.57
Udyr,Vayne,587,276,311,47.02
Udyr,Lulu,612,303,309,49.51
Udyr,Nasus,304,129,175,42.43
Udyr,Kindred,231,118,113,51.08
Udyr,Akali,517,246,271,47.58
Udyr,Lillia,298,159,139,53.36
Udyr,Jayce,195,104,91,53.33
Udyr,Sett,748,364,384,48.66
Udyr,LeeSin,619,310,309,50.08
Udyr,Gangplank,182,102,80,56.04
Udyr,Senna,395,167,228,42.28
Udyr,Quinn,203,106,97,52.22
Udyr,Kayn,747,318,429,42.57
Udyr,Ahri,571,296,275,51.84
Udyr,Jhin,923,416,507,45.07
Udyr,Janna,190,84,106,44.21
Udyr,Fizz,270,149,121,55.19
Udyr,Tristana,501,253,248,50.5
Udyr,Swain,512,255,257,49.8
Udyr,Yone,797,393,404,49.31
Udyr,XinZhao,302,127,175,42.05
Udyr,Lucian,368,155,213,42.12
Udyr,Khazix,183,98,85,53.55
Udyr,Sylas,585,292,293,49.91
Udyr,Vladimir,290,136,154,46.9
Udyr,Irelia,378,192,186,50.79
Udyr,Teemo,490,214,276,43.67
Udyr,KSante,248,98,150,39.52
Udyr,Diana,769,357,412,46.42
Udyr,Soraka,273,128,145,46.89
Udyr,Talon,306,155,151,50.65
Udyr,Rell,191,82,109,42.93
Udyr,Poppy,239,110,129,46.03
Udyr,Lissandra,127,64,63,50.39
Udyr,Lux,1047,500,547,47.76
Udyr,Kaisa,761,389,372,51.12
Udyr,Chogath,566,290,276,51.24
Udyr,Galio,410,201,209,49.02
Udyr,Malphite,516,267,249,51.74
Udyr,Zilean,151,95,56,62.91
Udyr,Ashe,926,408,518,44.06
Udyr,Zoe,176,92,84,52.27
Udyr,Velkoz,292,123,169,42.12
Udyr,Garen,716,351,365,49.02
Udyr,Singed,145,98,47,67.59
Udyr,Varus,427,201,226,47.07
Udyr,Nunu,266,108,158,40.6
Udyr,Yuumi,353,173,180,49.01
Udyr,MonkeyKing,334,174,160,52.1
Udyr,Briar,322,166,156,51.55
Udyr,Azir,195,95,100,48.72
Udyr,Nautilus,515,240,275,46.6
Udyr,Jax,410,194,216,47.32
Udyr,Braum,284,151,133,53.17
Udyr,MasterYi,650,330,320,50.77
Udyr,Ziggs,166,99,67,59.64
Udyr,Gnar,228,115,113,50.44
Udyr,Rakan,178,76,102,42.7
Udyr,Tryndamere,310,138,172,44.52
Udyr,Milio,291,138,153,47.42
Udyr,Amumu,472,227,245,48.09
Udyr,Nocturne,619,319,300,51.53
Udyr,Gragas,272,135,137,49.63
Udyr,Vi,427,201,226,47.07
Udyr,Orianna,181,57,124,31.49
Udyr,Heimerdinger,165,64,101,38.79
Udyr,FiddleSticks,225,112,113,49.78
Udyr,Aurora,323,144,179,44.58
Udyr,Mordekaiser,655,324,331,49.47
Udyr,Sejuani,163,77,86,47.24
Udyr,Anivia,130,54,76,41.54
Udyr,Renekton,214,104,110,48.6
Udyr,Viktor,460,205,255,44.57
Udyr,Gwen,305,150,155,49.18
Udyr,Ivern,58,22,36,37.93
Udyr,Renata,66,34,32,51.52
Udyr,Naafiri,141,56,85,39.72
Udyr,TwistedFate,191,102,89,53.4
Udyr,DrMundo,294,168,126,57.14
Udyr,Shaco,462,226,236,48.92
Udyr,Kassadin,82,37,45,45.12
Udyr,Smolder,298,171,127,57.38
Udyr,Aatrox,407,212,195,52.09
Udyr,Zac,247,118,129,47.77
Udyr,Xayah,216,116,100,53.7
Udyr,RekSai,72,46,26,63.89
Udyr,Akshan,183,122,61,66.67
Udyr,Alistar,209,73,136,34.93
Udyr,Illaoi,213,106,107,49.77
Udyr,Qiyana,136,76,60,55.88
Udyr,Corki,201,118,83,58.71
Udyr,Brand,339,166,173,48.97
Udyr,Zed,545,275,270,50.46
Udyr,Ryze,194,90,104,46.39
Udyr,Urgot,278,114,164,41.01
Udyr,Belveth,120,56,64,46.67
Udyr,Shyvana,123,58,65,47.15
Udyr,Annie,132,57,75,43.18
Udyr,Maokai,251,131,120,52.19
Udyr,Seraphine,346,178,168,51.45
Udyr,Evelynn,180,96,84,53.33
Udyr,AurelionSol,184,94,90,51.09
Udyr,Leona,440,212,228,48.18
Udyr,Sivir,235,117,118,49.79
Udyr,Leblanc,219,115,104,52.51
Udyr,Kennen,105,55,50,52.38
Udyr,Zeri,181,104,77,57.46
Udyr,Karthus,108,71,37,65.74
Udyr,Nidalee,140,85,55,60.71
Udyr,Camille,170,96,74,56.47
Udyr,KogMaw,179,69,110,38.55
Udyr,Kled,62,23,39,37.1
Udyr,Sion,402,182,220,45.27
Udyr,Kalista,107,60,47,56.07
Udyr,JarvanIV,297,126,171,42.42
Udyr,Sona,143,91,52,63.64
Udyr,Rammus,94,50,44,53.19
Udyr,Rumble,107,56,51,52.34
Udyr,Fiora,159,77,82,48.43
Udyr,Nilah,158,51,107,32.28
Udyr,Cassiopeia,122,46,76,37.7
Udyr,Twitch,452,265,187,58.63
Udyr,Hwei,348,143,205,41.09
Udyr,Bard,146,89,57,60.96
Udyr,Taric,114,54,60,47.37
Udyr,Ornn,160,75,85,46.88
Taric,Kayle,249,120,129,48.19
Taric,Volibear,324,177,147,54.63
Taric,Yasuo,538,280,258,52.04
Taric,Draven,154,86,68,55.84
Taric,Thresh,405,196,209,48.4
Taric,Ambessa,146,64,82,43.84
Taric,Nocturne,318,159,159,50
Taric,Kassadin,51,26,25,50.98
Taric,Caitlyn,699,360,339,51.5
Taric,Soraka,166,77,89,46.39
Taric,Jax,206,115,91,55.83
Taric,Nidalee,58,29,29,50
Taric,Jinx,777,343,434,44.14
Taric,Pantheon,381,197,184,51.71
Taric,Teemo,281,132,149,46.98
Taric,Ryze,69,31,38,44.93
Taric,Ashe,447,217,230,48.55
Taric,Senna,175,81,94,46.29
Taric,Vladimir,191,101,90,52.88
Taric,Ezreal,511,271,240,53.03
Taric,Sylas,322,186,136,57.76
Taric,Braum,177,97,80,54.8
Taric,Gragas,124,60,64,48.39
Taric,Akali,257,128,129,49.81
Taric,Vayne,418,217,201,51.91
Taric,Lulu,383,186,197,48.56
Taric,Trundle,159,76,83,47.8
Taric,Warwick,402,202,200,50.25
Taric,Diana,420,221,199,52.62
Taric,Veigar,244,108,136,44.26
Taric,Seraphine,138,49,89,35.51
Taric,Renekton,135,69,66,51.11
Taric,FiddleSticks,120,79,41,65.83
Taric,Ahri,304,170,134,55.92
Taric,MissFortune,573,289,284,50.44
Taric,Darius,556,276,280,49.64
Taric,Amumu,294,160,134,54.42
Taric,Aatrox,202,99,103,49.01
Taric,Kayn,420,210,210,50
Taric,DrMundo,181,98,83,54.14
Taric,Shyvana,48,11,37,22.92
Taric,Smolder,154,76,78,49.35
Taric,Nami,218,96,122,44.04
Taric,Shaco,248,131,117,52.82
Taric,Lux,599,275,324,45.91
Taric,Orianna,141,68,73,48.23
Taric,Sett,366,200,166,54.64
Taric,Ivern,39,11,28,28.21
Taric,Yone,430,245,185,56.98
Taric,Twitch,242,153,89,63.22
Taric,Galio,178,86,92,48.31
Taric,Garen,443,226,217,51.02
Taric,MasterYi,350,196,154,56
Taric,Elise,171,95,76,55.56
Taric,Mel,552,284,268,51.45
Taric,TahmKench,235,108,127,45.96
Taric,Karma,274,135,139,49.27
Taric,Fizz,152,67,85,44.08
Taric,Tristana,261,134,127,51.34
Taric,Brand,152,80,72,52.63
Taric,Leblanc,123,72,51,58.54
Taric,Sona,111,55,56,49.55
Taric,Nasus,149,72,77,48.32
Taric,Blitzcrank,194,115,79,59.28
Taric,Irelia,167,82,85,49.1
Taric,Aurora,184,103,81,55.98
Taric,Briar,175,83,92,47.43
Taric,Samira,188,121,67,64.36
Taric,Yuumi,211,139,72,65.88
Taric,Malphite,266,140,126,52.63
Taric,Talon,118,56,62,47.46
Taric,Gangplank,134,76,58,56.72
Taric,Malzahar,302,136,166,45.03
Taric,Xayah,118,53,65,44.92
Taric,Zyra,220,111,109,50.45
Taric,LeeSin,368,176,192,47.83
Taric,Vex,126,56,70,44.44
Taric,Aphelios,138,77,61,55.8
Taric,Tryndamere,171,76,95,44.44
Taric,Kaisa,380,176,204,46.32
Taric,Shen,148,71,77,47.97
Taric,Kalista,79,38,41,48.1
Taric,Rell,126,68,58,53.97
Taric,Riven,158,77,81,48.73
Taric,KogMaw,97,52,45,53.61
Taric,Pyke,207,120,87,57.97
Taric,Poppy,162,102,60,62.96
Taric,Rammus,70,44,26,62.86
Taric,Jhin,482,256,226,53.11
Taric,Zed,320,178,142,55.63
Taric,Evelynn,67,26,41,38.81
Taric,Viktor,222,107,115,48.2
Taric,Fiora,78,44,34,56.41
Taric,Milio,152,82,70,53.95
Taric,Sivir,116,71,45,61.21
Taric,Leona,271,139,132,51.29
Taric,Ekko,249,134,115,53.82
Taric,Chogath,354,164,190,46.33
Taric,Hwei,133,69,64,51.88
Taric,Singed,63,38,25,60.32
Taric,Sejuani,99,61,38,61.62
Taric,AurelionSol,131,77,54,58.78
Taric,Mordekaiser,384,215,169,55.99
Taric,Gwen,138,72,66,52.17
Taric,Lillia,115,45,70,39.13
Taric,Maokai,139,55,84,39.57
Taric,Nautilus,457,264,193,57.77
Taric,Yorick,279,112,167,40.14
Taric,Annie,79,44,35,55.7
Taric,Khazix,140,82,58,58.57
Taric,Syndra,164,65,99,39.63
Taric,Taliyah,88,41,47,46.59
Taric,Ornn,115,57,58,49.57
Taric,KSante,119,62,57,52.1
Taric,JarvanIV,143,74,69,51.75
Taric,Nunu,169,107,62,63.31
Taric,Sion,226,124,102,54.87
Taric,Hecarim,109,64,45,58.72
Taric,Cassiopeia,63,28,35,44.44
Taric,Karthus,62,27,35,43.55
Taric,Ziggs,80,53,27,66.25
Taric,Kennen,68,33,35,48.53
Taric,Rengar,66,31,35,46.97
Taric,Azir,73,42,31,57.53
Taric,Urgot,129,53,76,41.09
Taric,Alistar,124,63,61,50.81
Taric,Morgana,246,132,114,53.66
Taric,Vi,257,152,105,59.14
Taric,Lissandra,89,29,60,32.58
Taric,Zeri,96,64,32,66.67
Taric,Katarina,187,78,109,41.71
Taric,Swain,266,118,148,44.36
Taric,Camille,80,42,38,52.5
Taric,Akshan,94,46,48,48.94
Taric,Zac,116,50,66,43.1
Taric,MonkeyKing,171,73,98,42.69
Taric,Viego,333,142,191,42.64
Taric,Lucian,161,88,73,54.66
Taric,Xerath,195,116,79,59.49
Taric,Kled,56,26,30,46.43
Taric,Quinn,61,31,30,50.82
Taric,Heimerdinger,114,57,57,50
Taric,XinZhao,179,84,95,46.93
Taric,Janna,104,35,69,33.65
Taric,Gnar,101,51,50,50.5
Taric,Skarner,34,27,7,79.41
Taric,Kindred,63,44,19,69.84
Taric,Rakan,85,35,50,41.18
Taric,Varus,216,85,131,39.35
Taric,Illaoi,104,54,50,51.92
Taric,Bard,66,33,33,50
Taric,Naafiri,73,40,33,54.79
Taric,Udyr,114,60,54,52.63
Taric,Renata,51,31,20,60.78
Taric,Velkoz,171,84,87,49.12
Taric,Graves,125,54,71,43.2
Taric,Olaf,57,42,15,73.68
Taric,Rumble,66,40,26,60.61
Taric,Qiyana,65,42,23,64.62
Taric,Nilah,91,33,58,36.26
Taric,Neeko,81,37,44,45.68
Taric,TwistedFate,107,57,50,53.27
Taric,Zilean,56,25,31,44.64
Taric,Belveth,60,15,45,25
Taric,Corki,136,76,60,55.88
Taric,Jayce,72,44,28,61.11
Taric,Anivia,82,44,38,53.66
Taric,Zoe,85,44,41,51.76
Taric,RekSai,25,20,5,80
Kled,Chogath,239,122,117,51.05
Kled,Ekko,192,99,93,51.56
Kled,Malzahar,234,117,117,50
Kled,MissFortune,392,219,173,55.87
Kled,Nami,218,105,113,48.17
Kled,Yorick,194,106,88,54.64
Kled,Volibear,268,130,138,48.51
Kled,Yasuo,416,177,239,42.55
Kled,Ashe,441,246,195,55.78
Kled,Lulu,320,170,150,53.13
Kled,Kayn,324,175,149,54.01
Kled,Katarina,136,75,61,55.15
Kled,Mel,433,227,206,52.42
Kled,Darius,422,185,237,43.84
Kled,Briar,182,102,80,56.04
Kled,Gangplank,122,56,66,45.9
Kled,Singed,82,51,31,62.2
Kled,Graves,160,75,85,46.88
Kled,Viktor,215,91,124,42.33
Kled,Samira,91,44,47,48.35
Kled,Pantheon,319,149,170,46.71
Kled,Kayle,150,85,65,56.67
Kled,Fizz,135,75,60,55.56
Kled,Jinx,605,303,302,50.08
Kled,Nautilus,272,141,131,51.84
Kled,Aatrox,226,109,117,48.23
Kled,Ahri,245,109,136,44.49
Kled,Caitlyn,583,284,299,48.71
Kled,Thresh,277,154,123,55.6
Kled,Shen,172,86,86,50
Kled,Nocturne,290,137,153,47.24
Kled,Neeko,82,41,41,50
Kled,Twitch,170,95,75,55.88
Kled,Yuumi,139,63,76,45.32
Kled,Garen,314,167,147,53.18
Kled,Yone,411,207,204,50.36
Kled,TahmKench,133,77,56,57.89
Kled,Orianna,88,44,44,50
Kled,JarvanIV,139,46,93,33.09
Kled,Lucian,158,86,72,54.43
Kled,Brand,159,89,70,55.97
Kled,Akali,226,115,111,50.88
Kled,Janna,88,39,49,44.32
Kled,Rammus,49,23,26,46.94
Kled,Naafiri,57,33,24,57.89
Kled,Seraphine,137,81,56,59.12
Kled,Amumu,252,120,132,47.62
Kled,Soraka,113,45,68,39.82
Kled,Nasus,156,85,71,54.49
Kled,Sejuani,92,35,57,38.04
Kled,Vayne,308,147,161,47.73
Kled,Lillia,110,75,35,68.18
Kled,Swain,197,84,113,42.64
Kled,Braum,88,22,66,25
Kled,Diana,293,141,152,48.12
Kled,Gwen,103,54,49,52.43
Kled,Veigar,215,116,99,53.95
Kled,Senna,131,66,65,50.38
Kled,Rumble,75,50,25,66.67
Kled,Khazix,97,58,39,59.79
Kled,Illaoi,103,59,44,57.28
Kled,Draven,118,60,58,50.85
Kled,Mordekaiser,244,100,144,40.98
Kled,Aphelios,120,60,60,50
Kled,Morgana,228,117,111,51.32
Kled,Sion,144,68,76,47.22
Kled,Vi,215,129,86,60
Kled,Lux,499,255,244,51.1
Kled,Kennen,43,22,21,51.16
Kled,Warwick,295,138,157,46.78
Kled,Leblanc,160,68,92,42.5
Kled,Leona,214,99,115,46.26
Kled,Gragas,128,76,52,59.38
Kled,Irelia,151,67,84,44.37
Kled,Jax,189,99,90,52.38
Kled,Vex,93,52,41,55.91
Kled,RekSai,27,10,17,37.04
Kled,Smolder,133,74,59,55.64
Kled,Fiora,74,36,38,48.65
Kled,Shaco,166,87,79,52.41
Kled,Ezreal,564,288,276,51.06
Kled,Sona,63,31,32,49.21
Kled,Pyke,171,93,78,54.39
Kled,Talon,120,73,47,60.83
Kled,Hecarim,87,49,38,56.32
Kled,Kassadin,43,24,19,55.81
Kled,MasterYi,227,126,101,55.51
Kled,Jhin,443,228,215,51.47
Kled,Zed,221,116,105,52.49
Kled,Kalista,53,40,13,75.47
Kled,Galio,162,82,80,50.62
Kled,Teemo,226,99,127,43.81
Kled,Renekton,112,61,51,54.46
Kled,FiddleSticks,129,73,56,56.59
Kled,Poppy,154,67,87,43.51
Kled,Elise,174,102,72,58.62
Kled,Vladimir,162,80,82,49.38
Kled,Rengar,88,54,34,61.36
Kled,Kaisa,349,163,186,46.7
Kled,Sylas,304,167,137,54.93
Kled,Aurora,114,46,68,40.35
Kled,Ryze,64,34,30,53.13
Kled,Shyvana,94,36,58,38.3
Kled,KogMaw,79,46,33,58.23
Kled,Rakan,80,42,38,52.5
Kled,Belveth,56,31,25,55.36
Kled,Rell,118,49,69,41.53
Kled,XinZhao,124,57,67,45.97
Kled,Varus,218,92,126,42.2
Kled,Zyra,214,102,112,47.66
Kled,Sivir,95,48,47,50.53
Kled,Xayah,104,60,44,57.69
Kled,Karma,290,127,163,43.79
Kled,Annie,81,51,30,62.96
Kled,Sett,295,125,170,42.37
Kled,Gnar,89,45,44,50.56
Kled,Malphite,187,86,101,45.99
Kled,Blitzcrank,117,65,52,55.56
Kled,Ambessa,115,61,54,53.04
Kled,Qiyana,57,33,24,57.89
Kled,Udyr,62,39,23,62.9
Kled,MonkeyKing,126,61,65,48.41
Kled,Zeri,67,32,35,47.76
Kled,Viego,259,121,138,46.72
Kled,Xerath,192,102,90,53.13
Kled,KSante,128,57,71,44.53
Kled,Milio,112,58,54,51.79
Kled,LeeSin,252,139,113,55.16
Kled,Anivia,70,44,26,62.86
Kled,Quinn,59,32,27,54.24
Kled,Tristana,197,109,88,55.33
Kled,Taric,56,30,26,53.57
Kled,Ziggs,71,23,48,32.39
Kled,Riven,88,67,21,76.14
Kled,Evelynn,65,25,40,38.46
Kled,Zoe,94,45,49,47.87
Kled,Cassiopeia,61,28,33,45.9
Kled,Corki,83,50,33,60.24
Kled,Nidalee,60,36,24,60
Kled,Tryndamere,121,68,53,56.2
Kled,Nunu,60,38,22,63.33
Kled,Zac,113,44,69,38.94
Kled,Velkoz,122,48,74,39.34
Kled,Jayce,96,39,57,40.63
Kled,Maokai,105,40,65,38.1
Kled,Ornn,90,51,39,56.67
Kled,Hwei,145,82,63,56.55
Kled,Azir,89,49,40,55.06
Kled,Urgot,128,61,67,47.66
Kled,Nilah,54,32,22,59.26
Kled,Heimerdinger,76,37,39,48.68
Kled,Trundle,120,61,59,50.83
Kled,DrMundo,121,70,51,57.85
Kled,Renata,36,20,16,55.56
Kled,AurelionSol,80,47,33,58.75
Kled,Kindred,96,53,43,55.21
Kled,Karthus,45,29,16,64.44
Kled,Syndra,154,78,76,50.65
Kled,Olaf,49,20,29,40.82
Kled,Lissandra,65,24,41,36.92
Kled,Skarner,82,42,40,51.22
Kled,TwistedFate,90,49,41,54.44
Kled,Taliyah,35,18,17,51.43
Kled,Camille,70,40,30,57.14
Kled,Ivern,40,24,16,60
Kled,Akshan,60,33,27,55
Kled,Zilean,63,33,30,52.38
Kled,Bard,51,23,28,45.1
Kled,Alistar,75,28,47,37.33
RekSai,Kayle,94,37,57,39.36
RekSai,Vi,111,58,53,52.25
RekSai,Malzahar,99,41,58,41.41
RekSai,Ashe,261,126,135,48.28
RekSai,TahmKench,69,32,37,46.38
RekSai,Camille,32,13,19,40.63
RekSai,Kayn,179,104,75,58.1
RekSai,Yasuo,253,127,126,50.2
RekSai,Caitlyn,294,155,139,52.72
RekSai,Lux,306,145,161,47.39
RekSai,Renekton,75,25,50,33.33
RekSai,Evelynn,25,14,11,56
RekSai,Teemo,127,57,70,44.88
RekSai,Samira,78,30,48,38.46
RekSai,Leona,93,46,47,49.46
RekSai,Yorick,95,36,59,37.89
RekSai,Pantheon,209,110,99,52.63
RekSai,Talon,98,66,32,67.35
RekSai,Twitch,107,54,53,50.47
RekSai,Neeko,62,31,31,50
RekSai,Jax,123,82,41,66.67
RekSai,Rammus,44,24,20,54.55
RekSai,Chogath,161,42,119,26.09
RekSai,Diana,186,66,120,35.48
RekSai,Mordekaiser,165,65,100,39.39
RekSai,Graves,103,47,56,45.63
RekSai,Katarina,122,54,68,44.26
RekSai,Ezreal,438,216,222,49.32
RekSai,Soraka,91,44,47,48.35
RekSai,Warwick,189,69,120,36.51
RekSai,Shaco,150,78,72,52
RekSai,Vladimir,91,40,51,43.96
RekSai,Lulu,176,89,87,50.57
RekSai,Malphite,132,75,57,56.82
RekSai,Nocturne,155,74,81,47.74
RekSai,Kassadin,38,17,21,44.74
RekSai,Xayah,73,31,42,42.47
RekSai,Thresh,163,78,85,47.85
RekSai,Gnar,65,28,37,43.08
RekSai,Aurora,104,29,75,27.88
RekSai,Sion,106,55,51,51.89
RekSai,Galio,139,75,64,53.96
RekSai,Tristana,124,57,67,45.97
RekSai,Morgana,147,61,86,41.5
RekSai,Briar,85,37,48,43.53
RekSai,Jhin,254,150,104,59.06
RekSai,Syndra,101,33,68,32.67
RekSai,Braum,89,52,37,58.43
RekSai,Sett,205,96,109,46.83
RekSai,Zed,152,68,84,44.74
RekSai,Jinx,360,156,204,43.33
RekSai,Trundle,80,40,40,50
RekSai,Sylas,178,78,100,43.82
RekSai,Kalista,34,11,23,32.35
RekSai,Poppy,129,53,76,41.09
RekSai,Swain,96,31,65,32.29
RekSai,Kennen,39,23,16,58.97
RekSai,Smolder,105,59,46,56.19
RekSai,FiddleSticks,78,38,40,48.72
RekSai,Akali,118,76,42,64.41
RekSai,Kaisa,235,97,138,41.28
RekSai,Kled,27,17,10,62.96
RekSai,Ekko,123,46,77,37.4
RekSai,Nilah,45,21,24,46.67
RekSai,Singed,56,31,25,55.36
RekSai,Hwei,97,61,36,62.89
RekSai,Brand,107,55,52,51.4
RekSai,Mel,254,113,141,44.49
RekSai,Nami,154,81,73,52.6
RekSai,Udyr,72,26,46,36.11
RekSai,Akshan,26,10,16,38.46
RekSai,Milio,113,61,52,53.98
RekSai,Xerath,124,54,70,43.55
RekSai,Elise,109,53,56,48.62
RekSai,Tryndamere,54,28,26,51.85
RekSai,Darius,286,134,152,46.85
RekSai,Rakan,55,29,26,52.73
RekSai,Sejuani,73,30,43,41.1
RekSai,Heimerdinger,61,23,38,37.7
RekSai,Alistar,69,29,40,42.03
RekSai,Garen,197,85,112,43.15
RekSai,Varus,132,60,72,45.45
RekSai,Volibear,172,88,84,51.16
RekSai,MasterYi,136,74,62,54.41
RekSai,Lissandra,66,41,25,62.12
RekSai,Kindred,67,25,42,37.31
RekSai,Azir,54,28,26,51.85
RekSai,Fizz,62,30,32,48.39
RekSai,JarvanIV,89,45,44,50.56
RekSai,Leblanc,82,47,35,57.32
RekSai,Yuumi,122,71,51,58.2
RekSai,Shen,109,52,57,47.71
RekSai,Karthus,69,31,38,44.93
RekSai,XinZhao,101,52,49,51.49
RekSai,LeeSin,359,192,167,53.48
RekSai,Orianna,78,46,32,58.97
RekSai,Karma,155,81,74,52.26
RekSai,KSante,107,61,46,57.01
RekSai,Vayne,145,54,91,37.24
RekSai,Sona,72,35,37,48.61
RekSai,Gangplank,79,39,40,49.37
RekSai,Maokai,70,37,33,52.86
RekSai,Irelia,86,40,46,46.51
RekSai,Seraphine,87,47,40,54.02
RekSai,MissFortune,275,139,136,50.55
RekSai,Bard,50,23,27,46
RekSai,Fiora,63,27,36,42.86
RekSai,Ornn,53,26,27,49.06
RekSai,Khazix,36,17,19,47.22
RekSai,Vex,58,32,26,55.17
RekSai,Janna,54,27,27,50
RekSai,Nidalee,63,24,39,38.1
RekSai,Veigar,129,42,87,32.56
RekSai,Corki,70,22,48,31.43
RekSai,Illaoi,46,26,20,56.52
RekSai,Zeri,71,38,33,53.52
RekSai,Shyvana,24,17,7,70.83
RekSai,Zyra,121,45,76,37.19
RekSai,Aphelios,80,52,28,65
RekSai,Zilean,44,24,20,54.55
RekSai,Hecarim,80,57,23,71.25
RekSai,AurelionSol,41,19,22,46.34
RekSai,Ambessa,89,45,44,50.56
RekSai,Cassiopeia,25,6,19,24
RekSai,Senna,78,40,38,51.28
RekSai,Ziggs,41,17,24,41.46
RekSai,Pyke,110,49,61,44.55
RekSai,MonkeyKing,78,52,26,66.67
RekSai,Riven,77,27,50,35.06
RekSai,Viego,226,92,134,40.71
RekSai,Yone,216,108,108,50
RekSai,Annie,53,27,26,50.94
RekSai,Rell,74,34,40,45.95
RekSai,Amumu,133,55,78,41.35
RekSai,Ahri,224,105,119,46.88
RekSai,Lillia,87,51,36,58.62
RekSai,Viktor,127,56,71,44.09
RekSai,Rengar,28,25,3,89.29
RekSai,Nautilus,133,58,75,43.61
RekSai,Aatrox,104,54,50,51.92
RekSai,Urgot,80,29,51,36.25
RekSai,Naafiri,23,15,8,65.22
RekSai,Nasus,80,37,43,46.25
RekSai,TwistedFate,54,23,31,42.59
RekSai,Ryze,65,33,32,50.77
RekSai,Draven,74,25,49,33.78
RekSai,Skarner,34,23,11,67.65
RekSai,Lucian,117,51,66,43.59
RekSai,Gwen,80,49,31,61.25
RekSai,Gragas,79,44,35,55.7
RekSai,Nunu,74,30,44,40.54
RekSai,KogMaw,40,25,15,62.5
RekSai,Sivir,102,47,55,46.08
RekSai,Zac,67,34,33,50.75
RekSai,Velkoz,65,27,38,41.54
RekSai,Anivia,41,24,17,58.54
RekSai,Blitzcrank,106,52,54,49.06
RekSai,Qiyana,28,17,11,60.71
RekSai,Ivern,7,2,5,28.57
RekSai,Olaf,29,15,14,51.72
RekSai,Taliyah,28,8,20,28.57
RekSai,Jayce,86,33,53,38.37
RekSai,Rumble,44,17,27,38.64
RekSai,Quinn,55,24,31,43.64
RekSai,DrMundo,45,18,27,40
RekSai,Renata,22,3,19,13.64
RekSai,Taric,25,5,20,20
RekSai,Belveth,22,8,14,36.36
RekSai,Zoe,81,45,36,55.56
Cassiopeia,Quinn,141,74,67,52.48
Cassiopeia,Evelynn,138,81,57,58.7
Cassiopeia,Yasuo,643,317,326,49.3
Cassiopeia,Jhin,692,335,357,48.41
Cassiopeia,Brand,234,104,130,44.44
Cassiopeia,Rengar,90,44,46,48.89
Cassiopeia,XinZhao,238,109,129,45.8
Cassiopeia,Zoe,107,54,53,50.47
Cassiopeia,Jinx,1006,471,535,46.82
Cassiopeia,Leona,296,149,147,50.34
Cassiopeia,Sett,473,213,260,45.03
Cassiopeia,Warwick,475,240,235,50.53
Cassiopeia,Lissandra,126,58,68,46.03
Cassiopeia,MissFortune,783,389,394,49.68
Cassiopeia,Alistar,146,79,67,54.11
Cassiopeia,Volibear,363,207,156,57.02
Cassiopeia,Kayn,480,238,242,49.58
Cassiopeia,Talon,249,133,116,53.41
Cassiopeia,Vayne,400,207,193,51.75
Cassiopeia,Swain,392,192,200,48.98
Cassiopeia,Kayle,239,112,127,46.86
Cassiopeia,Viego,499,240,259,48.1
Cassiopeia,Yone,636,349,287,54.87
Cassiopeia,Lucian,225,132,93,58.67
Cassiopeia,Pyke,296,152,144,51.35
Cassiopeia,Darius,640,296,344,46.25
Cassiopeia,Graves,180,84,96,46.67
Cassiopeia,Aphelios,201,93,108,46.27
Cassiopeia,Yuumi,281,153,128,54.45
Cassiopeia,Trundle,201,115,86,57.21
Cassiopeia,Diana,651,348,303,53.46
Cassiopeia,Camille,121,59,62,48.76
Cassiopeia,Ekko,341,175,166,51.32
Cassiopeia,Malzahar,358,177,181,49.44
Cassiopeia,Shaco,257,129,128,50.19
Cassiopeia,Zed,399,215,184,53.88
Cassiopeia,Mel,763,420,343,55.05
Cassiopeia,Nami,351,176,175,50.14
Cassiopeia,Galio,295,125,170,42.37
Cassiopeia,Pantheon,534,272,262,50.94
Cassiopeia,Ashe,604,284,320,47.02
Cassiopeia,Lillia,199,101,98,50.75
Cassiopeia,Taliyah,79,40,39,50.63
Cassiopeia,Janna,125,63,62,50.4
Cassiopeia,Illaoi,120,55,65,45.83
Cassiopeia,TahmKench,270,136,134,50.37
Cassiopeia,Yorick,369,163,206,44.17
Cassiopeia,Kindred,153,80,73,52.29
Cassiopeia,Katarina,268,144,124,53.73
Cassiopeia,Nilah,105,54,51,51.43
Cassiopeia,Lux,667,308,359,46.18
Cassiopeia,Garen,483,217,266,44.93
Cassiopeia,Sejuani,183,104,79,56.83
Cassiopeia,Annie,116,54,62,46.55
Cassiopeia,DrMundo,213,108,105,50.7
Cassiopeia,Fiora,114,50,64,43.86
Cassiopeia,Briar,214,99,115,46.26
Cassiopeia,Ziggs,108,54,54,50
Cassiopeia,Thresh,479,237,242,49.48
Cassiopeia,Sion,252,129,123,51.19
Cassiopeia,Kaisa,562,283,279,50.36
Cassiopeia,Teemo,550,239,311,43.45
Cassiopeia,Amumu,368,156,212,42.39
Cassiopeia,Ryze,175,80,95,45.71
Cassiopeia,Milio,152,74,78,48.68
Cassiopeia,Gangplank,155,90,65,58.06
Cassiopeia,LeeSin,419,238,181,56.8
Cassiopeia,Aurora,293,145,148,49.49
Cassiopeia,Caitlyn,854,431,423,50.47
Cassiopeia,Elise,234,89,145,38.03
Cassiopeia,Gnar,113,72,41,63.72
Cassiopeia,Braum,223,112,111,50.22
Cassiopeia,Naafiri,106,51,55,48.11
Cassiopeia,Veigar,370,184,186,49.73
Cassiopeia,Kennen,93,37,56,39.78
Cassiopeia,MasterYi,354,173,181,48.87
Cassiopeia,Bard,118,64,54,54.24
Cassiopeia,Gragas,147,72,75,48.98
Cassiopeia,Ahri,482,238,244,49.38
Cassiopeia,Nautilus,337,178,159,52.82
Cassiopeia,Hecarim,157,77,80,49.04
Cassiopeia,Syndra,312,133,179,42.63
Cassiopeia,Viktor,374,202,172,54.01
Cassiopeia,Zyra,317,158,159,49.84
Cassiopeia,JarvanIV,250,111,139,44.4
Cassiopeia,Orianna,123,53,70,43.09
Cassiopeia,Renekton,175,110,65,62.86
Cassiopeia,Khazix,176,89,87,50.57
Cassiopeia,Qiyana,88,39,49,44.32
Cassiopeia,Blitzcrank,231,121,110,52.38
Cassiopeia,MonkeyKing,278,131,147,47.12
Cassiopeia,Hwei,199,95,104,47.74
Cassiopeia,Rakan,151,81,70,53.64
Cassiopeia,Belveth,102,50,52,49.02
Cassiopeia,Vladimir,256,136,120,53.13
Cassiopeia,Mordekaiser,384,198,186,51.56
Cassiopeia,Jax,254,152,102,59.84
Cassiopeia,Rumble,81,49,32,60.49
Cassiopeia,Samira,253,132,121,52.17
Cassiopeia,Nocturne,341,151,190,44.28
Cassiopeia,Senna,269,133,136,49.44
Cassiopeia,Rammus,102,65,37,63.73
Cassiopeia,Sivir,153,85,68,55.56
Cassiopeia,Ornn,131,56,75,42.75
Cassiopeia,Ezreal,808,424,384,52.48
Cassiopeia,Zeri,177,100,77,56.5
Cassiopeia,Ambessa,184,93,91,50.54
Cassiopeia,Rell,165,85,80,51.52
Cassiopeia,Jayce,176,74,102,42.05
Cassiopeia,Zac,151,85,66,56.29
Cassiopeia,Corki,117,68,49,58.12
Cassiopeia,Aatrox,328,157,171,47.87
Cassiopeia,Sylas,550,313,237,56.91
Cassiopeia,Smolder,191,93,98,48.69
Cassiopeia,Taric,63,35,28,55.56
Cassiopeia,Irelia,300,140,160,46.67
Cassiopeia,Soraka,186,85,101,45.7
Cassiopeia,Tryndamere,217,118,99,54.38
Cassiopeia,Draven,188,105,83,55.85
Cassiopeia,Karma,392,205,187,52.3
Cassiopeia,Urgot,139,76,63,54.68
Cassiopeia,Twitch,311,183,128,58.84
Cassiopeia,Olaf,109,46,63,42.2
Cassiopeia,Lulu,450,208,242,46.22
Cassiopeia,Morgana,424,228,196,53.77
Cassiopeia,Chogath,458,205,253,44.76
Cassiopeia,Gwen,141,61,80,43.26
Cassiopeia,Seraphine,221,111,110,50.23
Cassiopeia,FiddleSticks,154,86,68,55.84
Cassiopeia,Nasus,228,123,105,53.95
Cassiopeia,Vi,323,183,140,56.66
Cassiopeia,Kalista,107,66,41,61.68
Cassiopeia,Zilean,107,47,60,43.93
Cassiopeia,Heimerdinger,151,81,70,53.64
Cassiopeia,Kassadin,68,32,36,47.06
Cassiopeia,Shen,201,102,99,50.75
Cassiopeia,Tristana,347,188,159,54.18
Cassiopeia,Singed,95,56,39,58.95
Cassiopeia,Ivern,41,21,20,51.22
Cassiopeia,Xayah,136,70,66,51.47
Cassiopeia,Varus,309,172,137,55.66
Cassiopeia,Udyr,122,76,46,62.3
Cassiopeia,Maokai,162,72,90,44.44
Cassiopeia,Kled,61,33,28,54.1
Cassiopeia,Nunu,178,80,98,44.94
Cassiopeia,Anivia,136,55,81,40.44
Cassiopeia,KogMaw,94,45,49,47.87
Cassiopeia,Xerath,332,155,177,46.69
Cassiopeia,Neeko,155,83,72,53.55
Cassiopeia,Vex,159,68,91,42.77
Cassiopeia,Malphite,274,137,137,50
Cassiopeia,Akali,297,154,143,51.85
Cassiopeia,Karthus,64,43,21,67.19
Cassiopeia,Riven,136,59,77,43.38
Cassiopeia,Fizz,138,43,95,31.16
Cassiopeia,Velkoz,175,79,96,45.14
Cassiopeia,Poppy,203,104,99,51.23
Cassiopeia,TwistedFate,126,70,56,55.56
Cassiopeia,AurelionSol,111,69,42,62.16
Cassiopeia,Shyvana,82,38,44,46.34
Cassiopeia,Sona,109,30,79,27.52
Cassiopeia,RekSai,25,19,6,76
Cassiopeia,Nidalee,119,64,55,53.78
Cassiopeia,Azir,110,45,65,40.91
Cassiopeia,Akshan,120,72,48,60
Cassiopeia,Renata,55,29,26,52.73
Cassiopeia,KSante,198,117,81,59.09
Cassiopeia,Skarner,62,33,29,53.23
Cassiopeia,Leblanc,141,59,82,41.84
