Name,Opponent,Games,Wins,Losses,WR
Singed,Chogath,406,216,190,53.2
Singed,Viego,464,228,236,49.14
Singed,Galio,328,181,147,55.18
Singed,Sivir,194,128,66,65.98
Singed,Pyke,254,141,113,55.51
Singed,Garen,622,290,332,46.62
Singed,Nocturne,471,219,252,46.5
Singed,Fizz,184,101,83,54.89
Singed,Jinx,1062,511,551,48.12
Singed,Thresh,511,268,243,52.45
Singed,Warwick,520,274,246,52.69
Singed,Tristana,425,185,240,43.53
Singed,Vayne,503,235,268,46.72
Singed,Tryndamere,249,143,106,57.43
Singed,Amumu,317,162,155,51.1
Singed,Vex,193,102,91,52.85
Singed,Mel,761,406,355,53.35
Singed,Rumble,93,61,32,65.59
Singed,Yasuo,716,363,353,50.7
Singed,Lulu,520,251,269,48.27
Singed,Sejuani,171,80,91,46.78
Singed,Ekko,397,189,208,47.61
Singed,Sylas,470,228,242,48.51
Singed,Caitlyn,928,451,477,48.6
Singed,Karma,507,245,262,48.32
Singed,DrMundo,244,115,129,47.13
Singed,Jax,323,157,166,48.61
Singed,AurelionSol,153,75,78,49.02
Singed,Rakan,145,60,85,41.38
Singed,Briar,214,90,124,42.06
Singed,Akali,338,180,158,53.25
Singed,MissFortune,778,446,332,57.33
Singed,TahmKench,247,131,116,53.04
Singed,Yorick,343,149,194,43.44
Singed,Volibear,377,193,184,51.19
Singed,Vladimir,249,131,118,52.61
Singed,Zeri,162,89,73,54.94
Singed,Senna,214,109,105,50.93
Singed,FiddleSticks,176,99,77,56.25
Singed,Katarina,275,155,120,56.36
Singed,Ezreal,798,427,371,53.51
Singed,Nautilus,406,196,210,48.28
Singed,Diana,588,300,288,51.02
Singed,Yone,633,349,284,55.13
Singed,Lux,872,420,452,48.17
Singed,Trundle,228,114,114,50
Singed,Kindred,154,81,73,52.6
Singed,Swain,389,194,195,49.87
Singed,Quinn,161,102,59,63.35
Singed,MonkeyKing,223,118,105,52.91
Singed,Aurora,193,98,95,50.78
Singed,Karthus,118,59,59,50
Singed,Kled,85,34,51,40
Singed,Shaco,305,171,134,56.07
Singed,Zoe,125,69,56,55.2
Singed,Twitch,304,164,140,53.95
Singed,Gangplank,206,96,110,46.6
Singed,Annie,123,47,76,38.21
Singed,Morgana,412,204,208,49.51
Singed,Malphite,340,178,162,52.35
Singed,JarvanIV,225,114,111,50.67
Singed,Malzahar,434,211,223,48.62
Singed,KogMaw,79,35,44,44.3
Singed,Heimerdinger,169,82,87,48.52
Singed,Lucian,292,168,124,57.53
Singed,Teemo,445,217,228,48.76
Singed,Kassadin,84,42,42,50
Singed,Ashe,753,354,399,47.01
Singed,Blitzcrank,195,113,82,57.95
Singed,Nasus,344,164,180,47.67
Singed,Milio,255,137,118,53.73
Singed,Fiora,124,45,79,36.29
Singed,Pantheon,433,205,228,47.34
Singed,Hwei,260,148,112,56.92
Singed,Viktor,327,156,171,47.71
Singed,Jhin,669,338,331,50.52
Singed,Camille,121,74,47,61.16
Singed,Udyr,157,50,107,31.85
Singed,Zed,411,235,176,57.18
Singed,Kaisa,587,293,294,49.91
Singed,Elise,245,114,131,46.53
Singed,Urgot,195,88,107,45.13
Singed,Khazix,184,87,97,47.28
Singed,Alistar,175,95,80,54.29
Singed,Yuumi,314,178,136,56.69
Singed,Ziggs,133,73,60,54.89
Singed,LeeSin,524,288,236,54.96
Singed,Poppy,210,107,103,50.95
Singed,Aatrox,337,197,140,58.46
Singed,Ornn,137,84,53,61.31
Singed,Xerath,350,199,151,56.86
Singed,Gwen,175,115,60,65.71
Singed,Irelia,277,167,110,60.29
Singed,Seraphine,272,159,113,58.46
Singed,Kayn,497,211,286,42.45
Singed,Syndra,221,94,127,42.53
Singed,Kayle,272,110,162,40.44
Singed,Ivern,72,20,52,27.78
Singed,Nami,424,220,204,51.89
Singed,Mordekaiser,504,275,229,54.56
Singed,Anivia,125,60,65,48
Singed,Zilean,131,55,76,41.98
Singed,Skarner,105,74,31,70.48
Singed,Ryze,136,63,73,46.32
Singed,Varus,314,178,136,56.69
Singed,Azir,130,84,46,64.62
Singed,Veigar,337,160,177,47.48
Singed,Draven,179,92,87,51.4
Singed,Rell,194,112,82,57.73
Singed,Orianna,145,76,69,52.41
Singed,Taric,75,31,44,41.33
Singed,Sett,503,259,244,51.49
Singed,Darius,606,304,302,50.17
Singed,Rengar,100,49,51,49
Singed,RekSai,62,28,34,45.16
Singed,Brand,278,153,125,55.04
Singed,Ahri,383,212,171,55.35
Singed,Leona,258,134,124,51.94
Singed,Belveth,97,46,51,47.42
Singed,Kalista,98,60,38,61.22
Singed,Vi,324,187,137,57.72
Singed,Naafiri,116,71,45,61.21
Singed,Corki,131,83,48,63.36
Singed,Illaoi,164,94,70,57.32
Singed,Rammus,117,61,56,52.14
Singed,Shen,236,95,141,40.25
Singed,Ambessa,234,136,98,58.12
Singed,Smolder,232,129,103,55.6
Singed,Soraka,191,106,85,55.5
Singed,Zyra,335,178,157,53.13
Singed,MasterYi,471,253,218,53.72
Singed,TwistedFate,107,65,42,60.75
Singed,Graves,273,172,101,63
Singed,Sona,115,54,61,46.96
Singed,Samira,217,124,93,57.14
Singed,Janna,136,63,73,46.32
Singed,Taliyah,84,46,38,54.76
Singed,Renekton,160,85,75,53.13
Singed,Maokai,117,70,47,59.83
Singed,Velkoz,202,89,113,44.06
Singed,Lillia,188,99,89,52.66
Singed,Neeko,163,78,85,47.85
Singed,Renata,50,21,29,42
Singed,Talon,183,110,73,60.11
Singed,KSante,175,100,75,57.14
Singed,Hecarim,167,92,75,55.09
Singed,Jayce,169,92,77,54.44
Singed,Aphelios,204,102,102,50
Singed,Qiyana,69,35,34,50.72
Singed,Sion,379,213,166,56.2
Singed,XinZhao,212,121,91,57.08
Singed,Bard,106,54,52,50.94
Singed,Evelynn,133,62,71,46.62
Singed,Gnar,141,79,62,56.03
Singed,Leblanc,224,114,110,50.89
Singed,Lissandra,92,48,44,52.17
Singed,Gragas,217,113,104,52.07
Singed,Riven,172,92,80,53.49
Singed,Zac,144,69,75,47.92
Singed,Braum,208,119,89,57.21
Singed,Xayah,160,92,68,57.5
Singed,Cassiopeia,98,42,56,42.86
Singed,Nunu,236,125,111,52.97
Singed,Akshan,120,67,53,55.83
Singed,Shyvana,83,49,34,59.04
Singed,Kennen,76,27,49,35.53
Singed,Nidalee,81,49,32,60.49
Singed,Olaf,69,35,34,50.72
Singed,Nilah,134,60,74,44.78
LeeSin,Chogath,1938,875,1063,45.15
LeeSin,Viego,4221,2037,2184,48.26
LeeSin,Galio,1822,864,958,47.42
LeeSin,Sivir,1102,552,550,50.09
LeeSin,Pyke,1719,886,833,51.54
LeeSin,Aurora,1601,836,765,52.22
LeeSin,Corki,845,438,407,51.83
LeeSin,Orianna,978,472,506,48.26
LeeSin,Xayah,858,411,447,47.9
LeeSin,Nami,1639,759,880,46.31
LeeSin,Mordekaiser,2188,1064,1124,48.63
LeeSin,Kayn,2390,1074,1316,44.94
LeeSin,Talon,1388,669,719,48.2
LeeSin,MissFortune,4191,2083,2108,49.7
LeeSin,Lulu,3248,1558,1690,47.97
LeeSin,Trundle,905,428,477,47.29
LeeSin,Volibear,1729,836,893,48.35
LeeSin,Viktor,2081,1040,1041,49.98
LeeSin,Garen,2963,1397,1566,47.15
LeeSin,Graves,2245,1076,1169,47.93
LeeSin,Malzahar,1786,825,961,46.19
LeeSin,Lucian,1599,859,740,53.72
LeeSin,Lux,4386,2098,2288,47.83
LeeSin,Jax,1925,940,985,48.83
LeeSin,Shaco,1950,1014,936,52
LeeSin,Yone,4158,2093,2065,50.34
LeeSin,KogMaw,530,244,286,46.04
LeeSin,Morgana,2027,948,1079,46.77
LeeSin,Briar,1141,528,613,46.28
LeeSin,Diana,3791,1846,1945,48.69
LeeSin,Veigar,1435,676,759,47.11
LeeSin,Brand,1204,592,612,49.17
LeeSin,Pantheon,3449,1646,1803,47.72
LeeSin,Jhin,4282,2034,2248,47.5
LeeSin,Nocturne,2652,1179,1473,44.46
LeeSin,Velkoz,997,492,505,49.35
LeeSin,Darius,3685,1745,1940,47.35
LeeSin,Lillia,1288,577,711,44.8
LeeSin,Vex,939,412,527,43.88
LeeSin,Kaisa,3976,1974,2002,49.65
LeeSin,Neeko,770,338,432,43.9
LeeSin,Sion,1251,529,722,42.29
LeeSin,Sylas,3923,1962,1961,50.01
LeeSin,Zed,2671,1360,1311,50.92
LeeSin,Tristana,1822,871,951,47.8
LeeSin,Karthus,595,289,306,48.57
LeeSin,Ekko,1898,908,990,47.84
LeeSin,Warwick,2304,1099,1205,47.7
LeeSin,Fizz,901,438,463,48.61
LeeSin,Jinx,5544,2651,2893,47.82
LeeSin,Thresh,3058,1416,1642,46.3
LeeSin,Poppy,1588,689,899,43.39
LeeSin,Evelynn,608,305,303,50.16
LeeSin,Elise,1978,1026,952,51.87
LeeSin,Teemo,2097,975,1122,46.49
LeeSin,Sejuani,1019,512,507,50.25
LeeSin,Yasuo,4020,1845,2175,45.9
LeeSin,Nautilus,2285,1096,1189,47.96
LeeSin,Swain,1725,802,923,46.49
LeeSin,Ashe,4924,2315,2609,47.01
LeeSin,Zyra,2294,1098,1196,47.86
LeeSin,Varus,1951,994,957,50.95
LeeSin,Vladimir,1293,616,677,47.64
LeeSin,Vayne,2271,1055,1216,46.46
LeeSin,FiddleSticks,989,517,472,52.28
LeeSin,Gwen,850,457,393,53.76
LeeSin,Rammus,558,245,313,43.91
LeeSin,Karma,3362,1537,1825,45.72
LeeSin,Malphite,2017,972,1045,48.19
LeeSin,MasterYi,2306,1153,1153,50
LeeSin,Naafiri,537,259,278,48.23
LeeSin,Caitlyn,5131,2548,2583,49.66
LeeSin,Soraka,1028,473,555,46.01
LeeSin,Urgot,777,347,430,44.66
LeeSin,Vi,2592,1236,1356,47.69
LeeSin,KSante,1416,756,660,53.39
LeeSin,Ahri,2566,1238,1328,48.25
LeeSin,Draven,934,451,483,48.29
LeeSin,Leona,1601,749,852,46.78
LeeSin,Shen,1095,564,531,51.51
LeeSin,Riven,889,393,496,44.21
LeeSin,Gangplank,1289,661,628,51.28
LeeSin,Quinn,567,280,287,49.38
LeeSin,Khazix,1176,618,558,52.55
LeeSin,Nidalee,1151,630,521,54.74
LeeSin,Bard,653,260,393,39.82
LeeSin,Tryndamere,931,376,555,40.39
LeeSin,Smolder,1189,638,551,53.66
LeeSin,Yorick,1429,632,797,44.23
LeeSin,Xerath,2235,1091,1144,48.81
LeeSin,Rengar,558,252,306,45.16
LeeSin,Ryze,933,485,448,51.98
LeeSin,Milio,980,434,546,44.29
LeeSin,JarvanIV,1294,592,702,45.75
LeeSin,Sett,2959,1364,1595,46.1
LeeSin,Taliyah,537,255,282,47.49
LeeSin,Akshan,553,280,273,50.63
LeeSin,Ezreal,6833,3324,3509,48.65
LeeSin,Zilean,581,252,329,43.37
LeeSin,Aatrox,2308,1111,1197,48.14
LeeSin,Akali,2397,1202,1195,50.15
LeeSin,Gragas,1390,728,662,52.37
LeeSin,Janna,620,246,374,39.68
LeeSin,Camille,774,407,367,52.58
LeeSin,XinZhao,1805,858,947,47.53
LeeSin,Nilah,398,194,204,48.74
LeeSin,Udyr,673,339,334,50.37
LeeSin,Kayle,894,436,458,48.77
LeeSin,Ambessa,1598,802,796,50.19
LeeSin,Braum,1245,605,640,48.59
LeeSin,Irelia,1776,908,868,51.13
LeeSin,TahmKench,1204,578,626,48.01
LeeSin,Nasus,1259,567,692,45.04
LeeSin,Senna,1148,588,560,51.22
LeeSin,Jayce,1625,822,803,50.58
LeeSin,Twitch,1296,637,659,49.15
LeeSin,Aphelios,1001,492,509,49.15
LeeSin,Gnar,845,399,446,47.22
LeeSin,Annie,779,389,390,49.94
LeeSin,Hecarim,967,511,456,52.84
LeeSin,Renekton,1233,626,607,50.77
LeeSin,Katarina,1453,640,813,44.05
LeeSin,Nunu,875,426,449,48.69
LeeSin,Samira,1138,550,588,48.33
LeeSin,Skarner,542,249,293,45.94
LeeSin,Seraphine,1079,521,558,48.29
LeeSin,Fiora,738,389,349,52.71
LeeSin,Ziggs,550,273,277,49.64
LeeSin,Mel,3963,2007,1956,50.64
LeeSin,Amumu,1634,788,846,48.23
LeeSin,AurelionSol,656,308,348,46.95
LeeSin,Blitzcrank,1719,883,836,51.37
LeeSin,Ornn,863,433,430,50.17
LeeSin,Yuumi,1757,884,873,50.31
LeeSin,Syndra,1183,638,545,53.93
LeeSin,Alistar,959,475,484,49.53
LeeSin,Renata,298,144,154,48.32
LeeSin,TwistedFate,799,382,417,47.81
LeeSin,Singed,524,236,288,45.04
LeeSin,Belveth,414,205,209,49.52
LeeSin,Zeri,1063,549,514,51.65
LeeSin,Olaf,627,295,332,47.05
LeeSin,Leblanc,1841,894,947,48.56
LeeSin,Rumble,749,366,383,48.87
LeeSin,Zac,1191,592,599,49.71
LeeSin,Kassadin,356,159,197,44.66
LeeSin,MonkeyKing,1530,732,798,47.84
LeeSin,Rakan,855,387,468,45.26
LeeSin,Ivern,264,129,135,48.86
LeeSin,Kennen,575,262,313,45.57
LeeSin,Kindred,878,445,433,50.68
LeeSin,Heimerdinger,790,343,447,43.42
LeeSin,Maokai,923,401,522,43.45
LeeSin,Hwei,1358,658,700,48.45
LeeSin,Taric,395,204,191,51.65
LeeSin,Azir,837,414,423,49.46
LeeSin,Rell,921,449,472,48.75
LeeSin,Anivia,649,300,349,46.22
LeeSin,Cassiopeia,485,217,268,44.74
LeeSin,Sona,503,211,292,41.95
LeeSin,Kalista,575,281,294,48.87
LeeSin,Qiyana,489,243,246,49.69
LeeSin,DrMundo,883,412,471,46.66
LeeSin,Lissandra,635,320,315,50.39
LeeSin,Illaoi,797,372,425,46.68
LeeSin,Zoe,824,405,419,49.15
LeeSin,Shyvana,369,190,179,51.49
LeeSin,RekSai,428,203,225,47.43
LeeSin,Kled,279,131,148,46.95
Yasuo,Chogath,3116,1599,1517,51.32
Yasuo,Viego,3709,1853,1856,49.96
Yasuo,Galio,2014,982,1032,48.76
Yasuo,Sivir,1328,719,609,54.14
Yasuo,Pyke,2054,1112,942,54.14
Yasuo,Aurora,1765,907,858,51.39
Yasuo,Corki,987,521,466,52.79
Yasuo,Orianna,937,481,456,51.33
Yasuo,Xayah,1315,630,685,47.91
Yasuo,Nami,2310,1129,1181,48.87
Yasuo,Renekton,1801,828,973,45.97
Yasuo,Nocturne,3278,1466,1812,44.72
Yasuo,Viktor,1944,942,1002,48.46
Yasuo,Tryndamere,1451,698,753,48.1
Yasuo,Lillia,1357,685,672,50.48
Yasuo,Tristana,2481,1289,1192,51.95
Yasuo,Senna,1876,955,921,50.91
Yasuo,Irelia,2413,1243,1170,51.51
Yasuo,Hecarim,999,527,472,52.75
Yasuo,Malzahar,2834,1317,1517,46.47
Yasuo,Vayne,3465,1742,1723,50.27
Yasuo,Pantheon,4382,2091,2291,47.72
Yasuo,MasterYi,3352,1460,1892,43.56
Yasuo,Azir,931,438,493,47.05
Yasuo,Lucian,1794,927,867,51.67
Yasuo,Mel,5396,2811,2585,52.09
Yasuo,Diana,3934,1975,1959,50.2
Yasuo,Gragas,1331,692,639,51.99
Yasuo,Zed,3510,1858,1652,52.93
Yasuo,Caitlyn,7069,3503,3566,49.55
Yasuo,Soraka,1288,646,642,50.16
Yasuo,Zac,1155,601,554,52.03
Yasuo,Khazix,1259,661,598,52.5
Yasuo,Katarina,1944,1027,917,52.83
Yasuo,Samira,1904,952,952,50
Yasuo,Leona,2107,1087,1020,51.59
Yasuo,Singed,716,353,363,49.3
Yasuo,Evelynn,790,404,386,51.14
Yasuo,Yone,6191,3294,2897,53.21
Yasuo,Warwick,3846,1845,2001,47.97
Yasuo,Shen,1478,692,786,46.82
Yasuo,Velkoz,1378,688,690,49.93
Yasuo,Varus,2145,1122,1023,52.31
Yasuo,Rakan,1027,487,540,47.42
Yasuo,Jax,2581,1287,1294,49.86
Yasuo,Rengar,843,484,359,57.41
Yasuo,Camille,884,477,407,53.96
Yasuo,Karma,3091,1507,1584,48.75
Yasuo,Fiora,908,433,475,47.69
Yasuo,Graves,1687,896,791,53.11
Yasuo,Ashe,5122,2508,2614,48.97
Yasuo,Braum,1398,662,736,47.35
Yasuo,Quinn,970,407,563,41.96
Yasuo,Trundle,1575,785,790,49.84
Yasuo,Kassadin,450,237,213,52.67
Yasuo,DrMundo,1394,715,679,51.29
Yasuo,Akali,3183,1557,1626,48.92
Yasuo,Nilah,795,307,488,38.62
Yasuo,Illaoi,1256,610,646,48.57
Yasuo,Leblanc,1484,775,709,52.22
Yasuo,Anivia,798,384,414,48.12
Yasuo,Darius,4952,2374,2578,47.94
Yasuo,Vladimir,1942,955,987,49.18
Yasuo,Jinx,7192,3550,3642,49.36
Yasuo,Morgana,3052,1493,1559,48.92
Yasuo,Volibear,2861,1455,1406,50.86
Yasuo,Veigar,2546,1210,1336,47.53
Yasuo,Lulu,3456,1673,1783,48.41
Yasuo,Ekko,2355,1210,1145,51.38
Yasuo,Jhin,5352,2712,2640,50.67
Yasuo,Nautilus,2735,1374,1361,50.24
Yasuo,Ambessa,1524,802,722,52.62
Yasuo,Taliyah,666,320,346,48.05
Yasuo,Vex,1907,859,1048,45.04
Yasuo,MissFortune,5778,2886,2892,49.95
Yasuo,Elise,1786,903,883,50.56
Yasuo,XinZhao,1619,785,834,48.49
Yasuo,Briar,1841,836,1005,45.41
Yasuo,AurelionSol,1027,512,515,49.85
Yasuo,Twitch,1983,1036,947,52.24
Yasuo,Heimerdinger,1198,641,557,53.51
Yasuo,Renata,380,188,192,49.47
Yasuo,Nunu,1261,626,635,49.64
Yasuo,Sion,1778,869,909,48.88
Yasuo,Sylas,3973,2094,1879,52.71
Yasuo,Olaf,551,267,284,48.46
Yasuo,Shaco,2399,1263,1136,52.65
Yasuo,Lissandra,1121,542,579,48.35
Yasuo,Sett,4130,2014,2116,48.77
Yasuo,Aatrox,2215,1111,1104,50.16
Yasuo,Neeko,1011,513,498,50.74
Yasuo,TahmKench,1941,1075,866,55.38
Yasuo,Teemo,3304,1702,1602,51.51
Yasuo,Lux,6369,3250,3119,51.03
Yasuo,Blitzcrank,1738,877,861,50.46
Yasuo,Udyr,935,472,463,50.48
Yasuo,FiddleSticks,1337,629,708,47.05
Yasuo,Kennen,693,352,341,50.79
Yasuo,Taric,568,264,304,46.48
Yasuo,Mordekaiser,3151,1512,1639,47.98
Yasuo,Yorick,2584,1250,1334,48.37
Yasuo,Syndra,1234,652,582,52.84
Yasuo,Gangplank,1412,714,698,50.57
Yasuo,RekSai,298,144,154,48.32
Yasuo,Xerath,2246,1167,1079,51.96
Yasuo,Riven,1302,610,692,46.85
Yasuo,Zoe,845,460,385,54.44
Yasuo,Vi,2412,1218,1194,50.5
Yasuo,Kayn,3639,1758,1881,48.31
Yasuo,Kaisa,4352,2226,2126,51.15
Yasuo,Cassiopeia,682,344,338,50.44
Yasuo,Naafiri,816,464,352,56.86
Yasuo,Brand,1942,964,978,49.64
Yasuo,LeeSin,4020,2169,1851,53.96
Yasuo,Ezreal,6344,3310,3034,52.18
Yasuo,Amumu,2614,1228,1386,46.98
Yasuo,Talon,1658,866,792,52.23
Yasuo,KSante,1495,830,665,55.52
Yasuo,Ahri,3035,1490,1545,49.09
Yasuo,Sona,732,339,393,46.31
Yasuo,Urgot,1272,614,658,48.27
Yasuo,Sejuani,975,490,485,50.26
Yasuo,Kayle,1645,723,922,43.95
Yasuo,Kled,440,246,194,55.91
Yasuo,Aphelios,1292,683,609,52.86
Yasuo,Zilean,777,409,368,52.64
Yasuo,Swain,2550,1207,1343,47.33
Yasuo,Garen,4486,2210,2276,49.26
Yasuo,Zeri,1065,510,555,47.89
Yasuo,Rumble,765,442,323,57.78
Yasuo,Jayce,1208,655,553,54.22
Yasuo,Hwei,1571,807,764,51.37
Yasuo,Malphite,2990,1430,1560,47.83
Yasuo,Akshan,707,364,343,51.49
Yasuo,Draven,1253,678,575,54.11
Yasuo,Seraphine,1706,948,758,55.57
Yasuo,Poppy,1516,748,768,49.34
Yasuo,Rammus,987,462,525,46.81
Yasuo,Nasus,2060,1019,1041,49.47
Yasuo,Janna,938,453,485,48.29
Yasuo,Thresh,3351,1553,1798,46.34
Yasuo,Kindred,1040,565,475,54.33
Yasuo,Ornn,907,480,427,52.92
Yasuo,Gnar,989,509,480,51.47
Yasuo,Alistar,1041,493,548,47.36
Yasuo,Milio,1345,623,722,46.32
Yasuo,Annie,1033,455,578,44.05
Yasuo,Ryze,834,390,444,46.76
Yasuo,Qiyana,606,321,285,52.97
Yasuo,Zyra,2330,1214,1116,52.1
Yasuo,Gwen,1138,596,542,52.37
Yasuo,Fizz,1505,788,717,52.36
Yasuo,Karthus,744,362,382,48.66
Yasuo,Yuumi,2101,1117,984,53.17
Yasuo,KogMaw,716,369,347,51.54
Yasuo,Smolder,1562,840,722,53.78
Yasuo,Shyvana,568,301,267,52.99
Yasuo,TwistedFate,802,392,410,48.88
Yasuo,Ziggs,805,398,407,49.44
Yasuo,Skarner,551,326,225,59.17
Yasuo,MonkeyKing,1789,860,929,48.07
Yasuo,JarvanIV,1402,686,716,48.93
Yasuo,Rell,1167,551,616,47.22
Yasuo,Nidalee,724,416,308,57.46
Yasuo,Maokai,1114,537,577,48.2
Yasuo,Kalista,550,217,333,39.45
Yasuo,Belveth,558,250,308,44.8
Yasuo,Ivern,338,176,162,52.07
Yasuo,Bard,713,353,360,49.51
Caitlyn,Chogath,4115,1975,2140,48
Caitlyn,Viego,4958,2365,2593,47.7
Caitlyn,Galio,3040,1545,1495,50.82
Caitlyn,Sivir,2123,1043,1080,49.13
Caitlyn,Pyke,2807,1449,1358,51.62
Caitlyn,Darius,6628,3295,3333,49.71
Caitlyn,Rammus,1063,472,591,44.4
Caitlyn,Qiyana,865,478,387,55.26
Caitlyn,Ezreal,10799,5558,5241,51.47
Caitlyn,Swain,3387,1752,1635,51.73
Caitlyn,Shen,2108,1080,1028,51.23
Caitlyn,Belveth,778,408,370,52.44
Caitlyn,Akali,3827,1977,1850,51.66
Caitlyn,Varus,3377,1727,1650,51.14
Caitlyn,Lulu,4523,2326,2197,51.43
Caitlyn,Renekton,1695,858,837,50.62
Caitlyn,Nocturne,4517,2033,2484,45.01
Caitlyn,Viktor,3113,1564,1549,50.24
Caitlyn,Xayah,1593,822,771,51.6
Caitlyn,Tryndamere,2108,1104,1004,52.37
Caitlyn,Lillia,1871,986,885,52.7
Caitlyn,Tristana,3659,1940,1719,53.02
Caitlyn,Senna,2581,1284,1297,49.75
Caitlyn,Irelia,3108,1470,1638,47.3
Caitlyn,MasterYi,4570,2254,2316,49.32
Caitlyn,Azir,1137,571,566,50.22
Caitlyn,Lucian,2437,1246,1191,51.13
Caitlyn,Mel,6806,3546,3260,52.1
Caitlyn,Ambessa,2064,1115,949,54.02
Caitlyn,Ekko,3317,1720,1597,51.85
Caitlyn,Yasuo,7069,3566,3503,50.45
Caitlyn,Veigar,3560,1754,1806,49.27
Caitlyn,Warwick,5366,2627,2739,48.96
Caitlyn,Hecarim,1365,662,703,48.5
Caitlyn,Diana,5633,2653,2980,47.1
Caitlyn,Ziggs,1552,768,784,49.48
Caitlyn,Karma,4453,2189,2264,49.16
Caitlyn,Sett,5298,2503,2795,47.24
Caitlyn,Leblanc,2208,1061,1147,48.05
Caitlyn,Jinx,12343,6053,6290,49.04
Caitlyn,Alistar,1385,691,694,49.89
Caitlyn,Ivern,466,244,222,52.36
Caitlyn,Anivia,1086,556,530,51.2
Caitlyn,Ashe,8382,4201,4181,50.12
Caitlyn,Aatrox,3069,1645,1424,53.6
Caitlyn,Rumble,906,455,451,50.22
Caitlyn,Kayn,5128,2584,2544,50.39
Caitlyn,Akshan,1148,609,539,53.05
Caitlyn,Jhin,9338,4491,4847,48.09
Caitlyn,Yuumi,2733,1438,1295,52.62
Caitlyn,Mordekaiser,4456,2226,2230,49.96
Caitlyn,Skarner,813,444,369,54.61
Caitlyn,MissFortune,10173,4970,5203,48.85
Caitlyn,Lux,9275,4548,4727,49.04
Caitlyn,Vladimir,2387,1260,1127,52.79
Caitlyn,Pantheon,5409,2687,2722,49.68
Caitlyn,Teemo,4506,2209,2297,49.02
Caitlyn,Amumu,3817,1870,1947,48.99
Caitlyn,Khazix,1865,966,899,51.8
Caitlyn,Milio,2080,1003,1077,48.22
Caitlyn,Gragas,1839,985,854,53.56
Caitlyn,Kaisa,5651,2945,2706,52.11
Caitlyn,Nautilus,3933,1909,2024,48.54
Caitlyn,Yone,6447,3492,2955,54.16
Caitlyn,Fizz,2096,1099,997,52.43
Caitlyn,Briar,2458,1170,1288,47.6
Caitlyn,Seraphine,2750,1366,1384,49.67
Caitlyn,Blitzcrank,2588,1310,1278,50.62
Caitlyn,Volibear,4013,1987,2026,49.51
Caitlyn,Yorick,3551,1609,1942,45.31
Caitlyn,Rengar,995,543,452,54.57
Caitlyn,Soraka,1744,821,923,47.08
Caitlyn,Zed,4110,2133,1977,51.9
Caitlyn,Brand,2916,1419,1497,48.66
Caitlyn,Malzahar,3847,1842,2005,47.88
Caitlyn,Vi,3235,1673,1562,51.72
Caitlyn,Ahri,4777,2444,2333,51.16
Caitlyn,Jax,3144,1667,1477,53.02
Caitlyn,Twitch,2849,1518,1331,53.28
Caitlyn,Velkoz,2113,1000,1113,47.33
Caitlyn,Sion,2403,1175,1228,48.9
Caitlyn,Sylas,4917,2477,2440,50.38
Caitlyn,Trundle,2139,1047,1092,48.95
Caitlyn,Draven,1861,956,905,51.37
Caitlyn,Rell,1618,797,821,49.26
Caitlyn,Singed,928,477,451,51.4
Caitlyn,Thresh,4453,2191,2262,49.2
Caitlyn,Aurora,2331,1197,1134,51.35
Caitlyn,Evelynn,1251,666,585,53.24
Caitlyn,TahmKench,2585,1347,1238,52.11
Caitlyn,FiddleSticks,1676,894,782,53.34
Caitlyn,Corki,1217,677,540,55.63
Caitlyn,Elise,2371,1118,1253,47.15
Caitlyn,Gangplank,1796,920,876,51.22
Caitlyn,RekSai,330,151,179,45.76
Caitlyn,Xerath,3426,1681,1745,49.07
Caitlyn,Vayne,4497,2268,2229,50.43
Caitlyn,Nasus,2634,1355,1279,51.44
Caitlyn,Kennen,799,407,392,50.94
Caitlyn,Ryze,1201,573,628,47.71
Caitlyn,Neeko,1534,735,799,47.91
Caitlyn,Syndra,2104,1079,1025,51.28
Caitlyn,Urgot,1859,899,960,48.36
Caitlyn,Zoe,1228,595,633,48.45
Caitlyn,Shaco,3472,1862,1610,53.63
Caitlyn,AurelionSol,1332,644,688,48.35
Caitlyn,Smolder,2218,1178,1040,53.11
Caitlyn,Morgana,4336,2044,2292,47.14
Caitlyn,TwistedFate,1246,642,604,51.52
Caitlyn,KSante,1861,933,928,50.13
Caitlyn,Katarina,2717,1339,1378,49.28
Caitlyn,Leona,2965,1490,1475,50.25
Caitlyn,Talon,1848,975,873,52.76
Caitlyn,Nami,3324,1627,1697,48.95
Caitlyn,Orianna,1465,710,755,48.46
Caitlyn,Illaoi,1601,824,777,51.47
Caitlyn,Zyra,3465,1663,1802,47.99
Caitlyn,Kayle,2404,1169,1235,48.63
Caitlyn,LeeSin,5131,2583,2548,50.34
Caitlyn,Gnar,1375,697,678,50.69
Caitlyn,Taric,747,357,390,47.79
Caitlyn,Udyr,1425,742,683,52.07
Caitlyn,Taliyah,755,361,394,47.81
Caitlyn,Hwei,2360,1093,1267,46.31
Caitlyn,Kalista,799,457,342,57.2
Caitlyn,Poppy,1881,910,971,48.38
Caitlyn,Samira,2501,1238,1263,49.5
Caitlyn,Zilean,1147,566,581,49.35
Caitlyn,Nilah,903,419,484,46.4
Caitlyn,Bard,976,533,443,54.61
Caitlyn,Camille,1187,596,591,50.21
Caitlyn,Gwen,1646,817,829,49.64
Caitlyn,Quinn,1287,582,705,45.22
Caitlyn,MonkeyKing,2484,1240,1244,49.92
Caitlyn,Garen,5836,2853,2983,48.89
Caitlyn,Kassadin,759,420,339,55.34
Caitlyn,Rakan,1142,608,534,53.24
Caitlyn,Fiora,1179,605,574,51.31
Caitlyn,XinZhao,2307,1167,1140,50.59
Caitlyn,Graves,2271,1144,1127,50.37
Caitlyn,Karthus,948,500,448,52.74
Caitlyn,Janna,981,518,463,52.8
Caitlyn,DrMundo,1877,903,974,48.11
Caitlyn,Heimerdinger,1666,795,871,47.72
Caitlyn,Riven,1438,717,721,49.86
Caitlyn,Jayce,1644,891,753,54.2
Caitlyn,Kindred,1472,759,713,51.56
Caitlyn,Annie,1082,534,548,49.35
Caitlyn,Nunu,1887,930,957,49.28
Caitlyn,Aphelios,1921,919,1002,47.84
Caitlyn,Braum,2048,1042,1006,50.88
Caitlyn,JarvanIV,2016,949,1067,47.07
Caitlyn,Kled,622,314,308,50.48
Caitlyn,Vex,1867,852,1015,45.63
Caitlyn,Naafiri,1158,570,588,49.22
Caitlyn,Malphite,3730,1846,1884,49.49
Caitlyn,Maokai,1539,736,803,47.82
Caitlyn,Shyvana,835,417,418,49.94
Caitlyn,Sejuani,1520,792,728,52.11
Caitlyn,Lissandra,1072,541,531,50.47
Caitlyn,Zeri,1229,634,595,51.59
Caitlyn,Sona,1137,512,625,45.03
Caitlyn,Ornn,1399,678,721,48.46
Caitlyn,Nidalee,974,499,475,51.23
Caitlyn,Renata,490,251,239,51.22
Caitlyn,Cassiopeia,881,432,449,49.04
Caitlyn,KogMaw,1061,536,525,50.52
Caitlyn,Olaf,855,449,406,52.51
Caitlyn,Zac,1697,861,836,50.74
Yuumi,Chogath,1195,547,648,45.77
Yuumi,Viego,1495,714,781,47.76
Yuumi,Galio,882,391,491,44.33
Yuumi,Sivir,457,234,223,51.2
Yuumi,Pyke,854,501,353,58.67
Yuumi,Gangplank,598,302,296,50.5
Yuumi,Evelynn,390,188,202,48.21
Yuumi,Mel,2045,1076,969,52.62
Yuumi,Ashe,2233,1072,1161,48.01
Yuumi,Elise,854,387,467,45.32
Yuumi,Gwen,520,278,242,53.46
Yuumi,Skarner,271,154,117,56.83
Yuumi,DrMundo,564,286,278,50.71
Yuumi,Samira,703,305,398,43.39
Yuumi,Malphite,999,500,499,50.05
Yuumi,Mordekaiser,1439,661,778,45.93
Yuumi,Karthus,303,179,124,59.08
Yuumi,Katarina,771,346,425,44.88
Yuumi,Jhin,2177,1106,1071,50.8
Yuumi,Karma,1480,718,762,48.51
Yuumi,Fiora,400,196,204,49
Yuumi,Warwick,1307,591,716,45.22
Yuumi,Zed,1224,607,617,49.59
Yuumi,Swain,945,492,453,52.06
Yuumi,Garen,1673,749,924,44.77
Yuumi,Diana,1661,788,873,47.44
Yuumi,Vladimir,695,389,306,55.97
Yuumi,Caitlyn,2733,1295,1438,47.38
Yuumi,Lulu,1874,932,942,49.73
Yuumi,Renekton,507,232,275,45.76
Yuumi,Aurora,733,370,363,50.48
Yuumi,Corki,443,251,192,56.66
Yuumi,Pantheon,1618,726,892,44.87
Yuumi,Ornn,402,221,181,54.98
Yuumi,Fizz,515,254,261,49.32
Yuumi,Ezreal,2310,1244,1066,53.85
Yuumi,Rakan,357,154,203,43.14
Yuumi,Kayle,654,352,302,53.82
Yuumi,Nasus,764,350,414,45.81
Yuumi,Anivia,392,182,210,46.43
Yuumi,KogMaw,376,196,180,52.13
Yuumi,Nami,1201,619,582,51.54
Yuumi,MonkeyKing,695,300,395,43.17
Yuumi,Kassadin,208,90,118,43.27
Yuumi,Lucian,832,409,423,49.16
Yuumi,Gnar,371,174,197,46.9
Yuumi,Rammus,349,153,196,43.84
Yuumi,Veigar,980,451,529,46.02
Yuumi,Soraka,630,306,324,48.57
Yuumi,Darius,2010,979,1031,48.71
Yuumi,Varus,997,502,495,50.35
Yuumi,Trundle,567,282,285,49.74
Yuumi,Sett,1363,668,695,49.01
Yuumi,Amumu,971,490,481,50.46
Yuumi,Taliyah,267,100,167,37.45
Yuumi,Xayah,515,220,295,42.72
Yuumi,Braum,476,218,258,45.8
Yuumi,Urgot,490,222,268,45.31
Yuumi,Jax,880,391,489,44.43
Yuumi,Teemo,1297,636,661,49.04
Yuumi,Shaco,975,516,459,52.92
Yuumi,Annie,396,209,187,52.78
Yuumi,Yone,1981,990,991,49.97
Yuumi,Kayn,1369,673,696,49.16
Yuumi,Orianna,438,191,247,43.61
Yuumi,Kaisa,1931,947,984,49.04
Yuumi,Bard,326,186,140,57.06
Yuumi,Akali,1138,580,558,50.97
Yuumi,Morgana,1121,546,575,48.71
Yuumi,Tristana,1005,472,533,46.97
Yuumi,Leona,965,452,513,46.84
Yuumi,Ahri,1252,640,612,51.12
Yuumi,Draven,544,240,304,44.12
Yuumi,Quinn,373,186,187,49.87
Yuumi,Talon,731,316,415,43.23
Yuumi,Vayne,1287,611,676,47.47
Yuumi,Lux,2568,1258,1310,48.99
Yuumi,Graves,834,457,377,54.8
Yuumi,Thresh,1455,644,811,44.26
Yuumi,Ambessa,666,322,344,48.35
Yuumi,Rengar,360,195,165,54.17
Yuumi,Gragas,652,267,385,40.95
Yuumi,Sejuani,442,193,249,43.67
Yuumi,Malzahar,1070,486,584,45.42
Yuumi,JarvanIV,650,320,330,49.23
Yuumi,MissFortune,2347,1128,1219,48.06
Yuumi,Seraphine,703,342,361,48.65
Yuumi,MasterYi,1266,579,687,45.73
Yuumi,Nilah,311,145,166,46.62
Yuumi,Zilean,455,245,210,53.85
Yuumi,Kled,157,85,72,54.14
Yuumi,Cassiopeia,311,149,162,47.91
Yuumi,Blitzcrank,700,381,319,54.43
Yuumi,Twitch,856,460,396,53.74
Yuumi,Illaoi,457,233,224,50.98
Yuumi,Yasuo,2101,981,1120,46.69
Yuumi,Zyra,1008,488,520,48.41
Yuumi,Riven,508,239,269,47.05
Yuumi,Brand,763,400,363,52.42
Yuumi,Ekko,966,499,467,51.66
Yuumi,Yorick,942,419,523,44.48
Yuumi,Qiyana,228,128,100,56.14
Yuumi,TwistedFate,375,208,167,55.47
Yuumi,LeeSin,1757,873,884,49.69
Yuumi,Nocturne,1347,675,672,50.11
Yuumi,Sona,337,135,202,40.06
Yuumi,Udyr,380,198,182,52.11
Yuumi,Rell,545,242,303,44.4
Yuumi,Singed,314,136,178,43.31
Yuumi,Neeko,397,195,202,49.12
Yuumi,Milio,647,291,356,44.98
Yuumi,Viktor,953,473,480,49.63
Yuumi,Camille,382,190,192,49.74
Yuumi,Akshan,369,194,175,52.57
Yuumi,Syndra,775,341,434,44
Yuumi,Naafiri,363,189,174,52.07
Yuumi,Smolder,653,384,269,58.81
Yuumi,Irelia,931,446,485,47.91
Yuumi,Zoe,397,191,206,48.11
Yuumi,Velkoz,554,271,283,48.92
Yuumi,Leblanc,710,361,349,50.85
Yuumi,Taric,235,81,154,34.47
Yuumi,Aphelios,616,284,332,46.1
Yuumi,Sylas,1483,705,778,47.54
Yuumi,FiddleSticks,601,317,284,52.75
Yuumi,Kalista,293,130,163,44.37
Yuumi,Azir,411,216,195,52.55
Yuumi,Jinx,2908,1377,1531,47.35
Yuumi,Ziggs,275,140,135,50.91
Yuumi,Xerath,999,488,511,48.85
Yuumi,Briar,764,362,402,47.38
Yuumi,Sion,726,360,366,49.59
Yuumi,TahmKench,649,318,331,49
Yuumi,Volibear,1112,516,596,46.4
Yuumi,Nidalee,346,203,143,58.67
Yuumi,Maokai,442,210,232,47.51
Yuumi,Poppy,624,280,344,44.87
Yuumi,Nautilus,1201,488,713,40.63
Yuumi,Kennen,254,143,111,56.3
Yuumi,Aatrox,1063,543,520,51.08
Yuumi,Belveth,232,93,139,40.09
Yuumi,Vi,1071,499,572,46.59
Yuumi,Nunu,542,229,313,42.25
Yuumi,Hecarim,386,201,185,52.07
Yuumi,Janna,340,149,191,43.82
Yuumi,Tryndamere,622,251,371,40.35
Yuumi,Ryze,351,151,200,43.02
Yuumi,Shyvana,263,131,132,49.81
Yuumi,Vex,545,252,293,46.24
Yuumi,XinZhao,692,335,357,48.41
Yuumi,Heimerdinger,371,167,204,45.01
Yuumi,Olaf,225,108,117,48
Yuumi,Lillia,550,242,308,44
Yuumi,Khazix,465,236,229,50.75
Yuumi,Jayce,541,306,235,56.56
Yuumi,Hwei,711,358,353,50.35
Yuumi,Ivern,174,71,103,40.8
Yuumi,RekSai,155,72,83,46.45
Yuumi,Rumble,252,123,129,48.81
Yuumi,Zac,584,305,279,52.23
Yuumi,Zeri,447,222,225,49.66
Yuumi,Shen,600,294,306,49
Yuumi,KSante,632,316,316,50
Yuumi,Renata,114,66,48,57.89
Yuumi,Alistar,408,207,201,50.74
Yuumi,Lissandra,377,182,195,48.28
Yuumi,Senna,795,429,366,53.96
Yuumi,Kindred,460,233,227,50.65
Yuumi,AurelionSol,392,224,168,57.14
Chogath,Singed,406,190,216,46.8
Chogath,LeeSin,1938,1063,875,54.85
Chogath,Yasuo,3116,1517,1599,48.68
Chogath,Caitlyn,4115,2140,1975,52
Chogath,Yuumi,1195,648,547,54.23
Chogath,Sett,2526,1228,1298,48.61
Chogath,MasterYi,2028,1060,968,52.27
Chogath,Vladimir,1072,585,487,54.57
Chogath,Zilean,506,235,271,46.44
Chogath,Senna,1102,560,542,50.82
Chogath,Darius,2937,1511,1426,51.45
Chogath,Zac,702,352,350,50.14
Chogath,Malzahar,1638,790,848,48.23
Chogath,Ziggs,561,272,289,48.48
Chogath,Sona,480,236,244,49.17
Chogath,Gwen,1000,526,474,52.6
Chogath,Nocturne,2008,931,1077,46.36
Chogath,Veigar,1633,870,763,53.28
Chogath,Jinx,4564,2225,2339,48.75
Chogath,Morgana,1773,878,895,49.52
Chogath,Irelia,1253,637,616,50.84
Chogath,Diana,2369,1236,1133,52.17
Chogath,Fizz,865,432,433,49.94
Chogath,Vayne,2238,1041,1197,46.51
Chogath,Vi,1431,768,663,53.67
Chogath,Ahri,1970,973,997,49.39
Chogath,Jhin,2998,1463,1535,48.8
Chogath,Pyke,1273,664,609,52.16
Chogath,Volibear,1811,940,871,51.91
Chogath,Sejuani,619,311,308,50.24
Chogath,Lux,3646,1851,1795,50.77
Chogath,Nautilus,1676,883,793,52.68
Chogath,Tryndamere,960,483,477,50.31
Chogath,Shyvana,391,217,174,55.5
Chogath,Ambessa,813,450,363,55.35
Chogath,Thresh,1936,998,938,51.55
Chogath,Naafiri,504,272,232,53.97
Chogath,Akali,1536,821,715,53.45
Chogath,Zyra,1350,664,686,49.19
Chogath,Kled,251,120,131,47.81
Chogath,Warwick,2341,1170,1171,49.98
Chogath,Syndra,958,465,493,48.54
Chogath,Ashe,2955,1524,1431,51.57
Chogath,Milio,858,431,427,50.23
Chogath,Mordekaiser,2253,1025,1228,45.49
Chogath,Kayle,1130,571,559,50.53
Chogath,TahmKench,1283,672,611,52.38
Chogath,Rengar,442,214,228,48.42
Chogath,Ezreal,3323,1811,1512,54.5
Chogath,Briar,1103,553,550,50.14
Chogath,Brand,1221,597,624,48.89
Chogath,Pantheon,2164,1161,1003,53.65
Chogath,Leona,1364,636,728,46.63
Chogath,Lillia,922,418,504,45.34
Chogath,Tristana,1581,841,740,53.19
Chogath,Smolder,895,444,451,49.61
Chogath,Lulu,2064,1065,999,51.6
Chogath,Sion,1237,623,614,50.36
Chogath,Talon,857,424,433,49.47
Chogath,Nami,1681,871,810,51.81
Chogath,Graves,1019,496,523,48.68
Chogath,FiddleSticks,803,444,359,55.29
Chogath,Yone,2806,1431,1375,51
Chogath,Sylas,1989,1044,945,52.49
Chogath,Velkoz,946,444,502,46.93
Chogath,Kaisa,2360,1225,1135,51.91
Chogath,Illaoi,796,384,412,48.24
Chogath,Aurora,1002,526,476,52.5
Chogath,Jax,1231,687,544,55.81
Chogath,MissFortune,3648,1885,1763,51.67
Chogath,Garen,2567,1373,1194,53.49
Chogath,Shaco,1393,740,653,53.12
Chogath,Fiora,671,388,283,57.82
Chogath,Viego,2062,1075,987,52.13
Chogath,Braum,887,468,419,52.76
Chogath,Poppy,917,501,416,54.63
Chogath,Karthus,415,229,186,55.18
Chogath,Zeri,595,308,287,51.76
Chogath,Leblanc,876,496,380,56.62
Chogath,Gragas,779,424,355,54.43
Chogath,Janna,495,243,252,49.09
Chogath,Kayn,2174,1108,1066,50.97
Chogath,KogMaw,501,240,261,47.9
Chogath,Yorick,1825,923,902,50.58
Chogath,Orianna,655,336,319,51.3
Chogath,Lucian,978,522,456,53.37
Chogath,DrMundo,1115,507,608,45.47
Chogath,Elise,1069,524,545,49.02
Chogath,Hwei,991,463,528,46.72
Chogath,Zed,1647,884,763,53.67
Chogath,Aphelios,771,421,350,54.6
Chogath,Swain,1553,813,740,52.35
Chogath,Blitzcrank,1019,560,459,54.96
Chogath,Aatrox,1273,632,641,49.65
Chogath,Alistar,660,352,308,53.33
Chogath,Mel,3225,1754,1471,54.39
Chogath,Camille,501,263,238,52.5
Chogath,Galio,1273,653,620,51.3
Chogath,Akshan,573,309,264,53.93
Chogath,Varus,1267,658,609,51.93
Chogath,Khazix,735,433,302,58.91
Chogath,XinZhao,955,473,482,49.53
Chogath,Evelynn,524,293,231,55.92
Chogath,Rakan,606,322,284,53.14
Chogath,Annie,506,276,230,54.55
Chogath,RekSai,179,128,51,71.51
Chogath,Nasus,1104,598,506,54.17
Chogath,Shen,989,515,474,52.07
Chogath,Teemo,2156,1140,1016,52.88
Chogath,Corki,595,332,263,55.8
Chogath,Draven,782,419,363,53.58
Chogath,Soraka,860,455,405,52.91
Chogath,Udyr,578,285,293,49.31
Chogath,Azir,523,278,245,53.15
Chogath,Gnar,600,282,318,47
Chogath,Trundle,930,464,466,49.89
Chogath,Amumu,1756,899,857,51.2
Chogath,Olaf,394,197,197,50
Chogath,AurelionSol,626,316,310,50.48
Chogath,Xerath,1330,690,640,51.88
Chogath,Katarina,1177,688,489,58.45
Chogath,Anivia,532,240,292,45.11
Chogath,Lissandra,473,268,205,56.66
Chogath,Urgot,749,345,404,46.06
Chogath,Sivir,833,413,420,49.58
Chogath,Kassadin,319,159,160,49.84
Chogath,JarvanIV,982,463,519,47.15
Chogath,Jayce,618,320,298,51.78
Chogath,Nidalee,353,194,159,54.96
Chogath,Viktor,1297,653,644,50.35
Chogath,Ekko,1440,696,744,48.33
Chogath,Maokai,716,353,363,49.3
Chogath,Nunu,767,369,398,48.11
Chogath,Ryze,480,268,212,55.83
Chogath,Malphite,1542,838,704,54.35
Chogath,Seraphine,1059,483,576,45.61
Chogath,Zoe,555,263,292,47.39
Chogath,Gangplank,767,430,337,56.06
Chogath,Skarner,337,177,160,52.52
Chogath,Vex,727,396,331,54.47
Chogath,Kindred,624,329,295,52.72
Chogath,Nilah,562,266,296,47.33
Chogath,Karma,1740,870,870,50
Chogath,Xayah,683,346,337,50.66
Chogath,Riven,601,328,273,54.58
Chogath,Ivern,201,95,106,47.26
Chogath,Kennen,398,214,184,53.77
Chogath,Samira,1048,569,479,54.29
Chogath,Rumble,346,168,178,48.55
Chogath,Neeko,638,337,301,52.82
Chogath,Qiyana,333,187,146,56.16
Chogath,Taric,372,196,176,52.69
Chogath,Rammus,474,268,206,56.54
Chogath,Rell,646,338,308,52.32
Chogath,Heimerdinger,662,340,322,51.36
Chogath,KSante,686,370,316,53.94
Chogath,MonkeyKing,959,514,445,53.6
Chogath,Ornn,629,321,308,51.03
Chogath,TwistedFate,509,274,235,53.83
Chogath,Bard,433,195,238,45.03
Chogath,Renekton,663,366,297,55.2
Chogath,Kalista,289,159,130,55.02
Chogath,Quinn,469,242,227,51.6
Chogath,Hecarim,582,297,285,51.03
Chogath,Twitch,1271,677,594,53.27
Chogath,Cassiopeia,476,268,208,56.3
Chogath,Belveth,315,165,150,52.38
Chogath,Taliyah,366,177,189,48.36
Chogath,Renata,230,108,122,46.96
Viego,Singed,464,236,228,50.86
Viego,LeeSin,4221,2184,2037,51.74
Viego,Yasuo,3709,1856,1853,50.04
Viego,Caitlyn,4958,2593,2365,52.3
Viego,Yuumi,1495,781,714,52.24
Viego,Pantheon,3186,1634,1552,51.29
Viego,Belveth,485,277,208,57.11
Viego,Katarina,1555,763,792,49.07
Viego,KogMaw,536,235,301,43.84
Viego,Lux,4289,2135,2154,49.78
Viego,Gwen,842,488,354,57.96
Viego,Khazix,1007,561,446,55.71
Viego,TwistedFate,695,362,333,52.09
Viego,Varus,1687,819,868,48.55
Viego,Thresh,2726,1325,1401,48.61
Viego,Tryndamere,1074,540,534,50.28
Viego,Amumu,1886,911,975,48.3
Viego,Vex,925,460,465,49.73
Viego,Jinx,5371,2642,2729,49.19
Viego,Mel,3717,1943,1774,52.27
Viego,Jax,1751,835,916,47.69
Viego,Warwick,2654,1228,1426,46.27
Viego,Galio,1678,863,815,51.43
Viego,Ezreal,4707,2398,2309,50.95
Viego,Nami,1745,840,905,48.14
Viego,Ambessa,1253,656,597,52.35
Viego,JarvanIV,1087,517,570,47.56
Viego,Sylas,2864,1525,1339,53.25
Viego,Ashe,4035,2052,1983,50.86
Viego,Alistar,917,452,465,49.29
Viego,MonkeyKing,1489,725,764,48.69
Viego,Kaisa,3126,1613,1513,51.6
Viego,Renata,344,193,151,56.1
Viego,Teemo,2118,1000,1118,47.21
Viego,Skarner,440,256,184,58.18
Viego,Yone,3452,1850,1602,53.59
Viego,Blitzcrank,1370,709,661,51.75
Viego,Sion,1442,696,746,48.27
Viego,Udyr,747,363,384,48.59
Viego,Ryze,665,311,354,46.77
Viego,Leona,1579,802,777,50.79
Viego,Anivia,598,312,286,52.17
Viego,MissFortune,4217,2058,2159,48.8
Viego,Velkoz,992,494,498,49.8
Viego,Maokai,844,430,414,50.95
Viego,Ziggs,662,317,345,47.89
Viego,Lucian,1333,697,636,52.29
Viego,Sona,481,230,251,47.82
Viego,Garen,2867,1394,1473,48.62
Viego,Akali,2102,1013,1089,48.19
Viego,Zed,2182,1076,1106,49.31
Viego,Viktor,1762,845,917,47.96
Viego,Urgot,821,411,410,50.06
Viego,Darius,3543,1739,1804,49.08
Viego,Malzahar,1785,880,905,49.3
Viego,Trundle,1061,495,566,46.65
Viego,Volibear,2069,1072,997,51.81
Viego,Naafiri,633,308,325,48.66
Viego,Jhin,3981,1974,2007,49.59
Viego,Veigar,1738,854,884,49.14
Viego,Hwei,1308,667,641,50.99
Viego,Brand,1196,594,602,49.67
Viego,MasterYi,2314,1107,1207,47.84
Viego,Rakan,733,387,346,52.8
Viego,Gragas,1016,537,479,52.85
Viego,Kayn,2820,1327,1493,47.06
Viego,Janna,554,300,254,54.15
Viego,Ekko,1799,932,867,51.81
Viego,Vladimir,1298,699,599,53.85
Viego,Rell,913,405,508,44.36
Viego,Shaco,1711,861,850,50.32
Viego,Chogath,2062,987,1075,47.87
Viego,Diana,3339,1706,1633,51.09
Viego,Xayah,767,388,379,50.59
Viego,TahmKench,1437,745,692,51.84
Viego,Morgana,1849,946,903,51.16
Viego,Mordekaiser,2124,1039,1085,48.92
Viego,Shen,1135,566,569,49.87
Viego,Yorick,1743,763,980,43.78
Viego,Orianna,821,445,376,54.2
Viego,Kennen,528,258,270,48.86
Viego,Braum,1083,464,619,42.84
Viego,Nasus,1309,611,698,46.68
Viego,Fiora,631,315,316,49.92
Viego,Karma,2406,1232,1174,51.21
Viego,Aatrox,1860,872,988,46.88
Viego,Vi,1796,938,858,52.23
Viego,AurelionSol,733,398,335,54.3
Viego,Heimerdinger,771,395,376,51.23
Viego,Lillia,1019,505,514,49.56
Viego,Lulu,2604,1339,1265,51.42
Viego,Sett,2822,1339,1483,47.45
Viego,Rengar,551,282,269,51.18
Viego,Irelia,1587,771,816,48.58
Viego,Corki,840,420,420,50
Viego,Pyke,1548,810,738,52.33
Viego,Briar,1210,609,601,50.33
Viego,Nidalee,657,357,300,54.34
Viego,Illaoi,785,406,379,51.72
Viego,Kindred,854,456,398,53.4
Viego,Gangplank,1008,524,484,51.98
Viego,Sejuani,660,300,360,45.45
Viego,Vayne,2316,1162,1154,50.17
Viego,Ahri,2212,1085,1127,49.05
Viego,Neeko,908,446,462,49.12
Viego,Tristana,1838,915,923,49.78
Viego,Nautilus,2194,1026,1168,46.76
Viego,Kayle,1121,556,565,49.6
Viego,Soraka,917,433,484,47.22
Viego,Cassiopeia,538,280,258,52.04
Viego,Graves,1350,675,675,50
Viego,Aphelios,913,448,465,49.07
Viego,Kassadin,348,183,165,52.59
Viego,Sivir,926,430,496,46.44
Viego,Renekton,1017,504,513,49.56
Viego,Taliyah,437,224,213,51.26
Viego,Senna,1384,691,693,49.93
Viego,Zyra,1739,930,809,53.48
Viego,Twitch,1306,644,662,49.31
Viego,Swain,1710,887,823,51.87
Viego,Annie,600,313,287,52.17
Viego,Smolder,1059,526,533,49.67
Viego,Shyvana,418,199,219,47.61
Viego,Fizz,1053,503,550,47.77
Viego,Olaf,453,239,214,52.76
Viego,Xerath,1796,855,941,47.61
Viego,Zilean,622,322,300,51.77
Viego,Milio,1032,507,525,49.13
Viego,Gnar,724,341,383,47.1
Viego,Elise,1448,704,744,48.62
Viego,XinZhao,1318,664,654,50.38
Viego,Samira,1287,661,626,51.36
Viego,Poppy,1082,488,594,45.1
Viego,Karthus,487,229,258,47.02
Viego,Nocturne,2295,1167,1128,50.85
Viego,Nunu,945,458,487,48.47
Viego,Riven,918,423,495,46.08
Viego,FiddleSticks,900,401,499,44.56
Viego,Aurora,1337,637,700,47.64
Viego,KSante,1039,554,485,53.32
Viego,Syndra,1226,595,631,48.53
Viego,Bard,580,284,296,48.97
Viego,Ornn,749,395,354,52.74
Viego,Evelynn,631,305,326,48.34
Viego,Seraphine,1369,688,681,50.26
Viego,Jayce,1045,563,482,53.88
Viego,Camille,648,367,281,56.64
Viego,Nilah,561,262,299,46.7
Viego,Ivern,287,148,139,51.57
Viego,Talon,1181,633,548,53.6
Viego,Rumble,549,287,262,52.28
Viego,Draven,884,482,402,54.52
Viego,DrMundo,979,523,456,53.42
Viego,Leblanc,1249,578,671,46.28
Viego,Zac,1006,458,548,45.53
Viego,Malphite,1870,924,946,49.41
Viego,Azir,632,390,242,61.71
Viego,Zeri,806,434,372,53.85
Viego,Lissandra,601,331,270,55.07
Viego,Qiyana,522,268,254,51.34
Viego,Kalista,481,232,249,48.23
Viego,Rammus,641,298,343,46.49
Viego,Akshan,724,353,371,48.76
Viego,Hecarim,814,413,401,50.74
Viego,Quinn,684,321,363,46.93
Viego,Kled,286,147,139,51.4
Viego,Taric,336,194,142,57.74
Viego,Zoe,749,376,373,50.2
Viego,RekSai,250,146,104,58.4
Galio,Singed,328,147,181,44.82
Galio,LeeSin,1822,958,864,52.58
Galio,Yasuo,2014,1032,982,51.24
Galio,Caitlyn,3040,1495,1545,49.18
Galio,Yuumi,882,491,391,55.67
Galio,Irelia,949,514,435,54.16
Galio,Hecarim,416,244,172,58.65
Galio,Malzahar,1303,672,631,51.57
Galio,Vayne,1457,684,773,46.95
Galio,Pantheon,1626,868,758,53.38
Galio,Jax,1171,618,553,52.78
Galio,Amumu,1169,531,638,45.42
Galio,Ahri,1784,871,913,48.82
Galio,Lulu,1565,883,682,56.42
Galio,Yorick,1018,514,504,50.49
Galio,Briar,712,348,364,48.88
Galio,Jhin,2315,1137,1178,49.11
Galio,Nautilus,1276,682,594,53.45
Galio,Sett,1750,849,901,48.51
Galio,Nasus,751,350,401,46.6
Galio,Aurora,857,450,407,52.51
Galio,Varus,1094,571,523,52.19
Galio,Mel,2325,1253,1072,53.89
Galio,Vi,1141,589,552,51.62
Galio,Soraka,596,271,325,45.47
Galio,Garen,1907,964,943,50.55
Galio,Graves,778,387,391,49.74
Galio,Diana,2240,1173,1067,52.37
Galio,Shaco,1006,505,501,50.2
Galio,Malphite,1224,639,585,52.21
Galio,Viego,1678,815,863,48.57
Galio,Twitch,854,414,440,48.48
Galio,Sejuani,425,209,216,49.18
Galio,Ekko,1137,584,553,51.36
Galio,Sylas,2310,1251,1059,54.16
Galio,Karma,1537,814,723,52.96
Galio,Volibear,1191,611,580,51.3
Galio,Ezreal,3120,1713,1407,54.9
Galio,Brand,927,485,442,52.32
Galio,Skarner,262,127,135,48.47
Galio,MissFortune,2649,1279,1370,48.28
Galio,Lux,2765,1383,1382,50.02
Galio,DrMundo,621,293,328,47.18
Galio,AurelionSol,425,196,229,46.12
Galio,Rakan,404,222,182,54.95
Galio,Ashe,2474,1256,1218,50.77
Galio,Warwick,1618,876,742,54.14
Galio,Zed,1140,579,561,50.79
Galio,Morgana,1297,682,615,52.58
Galio,Elise,881,490,391,55.62
Galio,Fizz,691,358,333,51.81
Galio,Shen,758,395,363,52.11
Galio,Darius,2126,1090,1036,51.27
Galio,Vladimir,740,335,405,45.27
Galio,Urgot,518,264,254,50.97
Galio,Anivia,365,183,182,50.14
Galio,Jinx,3189,1559,1630,48.89
Galio,Ambessa,806,458,348,56.82
Galio,Rengar,332,197,135,59.34
Galio,Veigar,978,488,490,49.9
Galio,Kaisa,2118,1172,946,55.34
Galio,Swain,1199,589,610,49.12
Galio,Renekton,587,287,300,48.89
Galio,Velkoz,678,331,347,48.82
Galio,Xerath,1112,519,593,46.67
Galio,Teemo,1579,760,819,48.13
Galio,Kayn,1422,681,741,47.89
Galio,Rumble,416,221,195,53.13
Galio,Yone,2169,1102,1067,50.81
Galio,Akali,1565,793,772,50.67
Galio,Ziggs,478,280,198,58.58
Galio,Hwei,824,392,432,47.57
Galio,Chogath,1273,620,653,48.7
Galio,Nocturne,1504,724,780,48.14
Galio,Nilah,286,140,146,48.95
Galio,Braum,527,270,257,51.23
Galio,Nunu,572,337,235,58.92
Galio,Tristana,1122,636,486,56.68
Galio,Zeri,520,280,240,53.85
Galio,Talon,648,335,313,51.7
Galio,Taliyah,243,113,130,46.5
Galio,MasterYi,1446,747,699,51.66
Galio,Janna,324,146,178,45.06
Galio,Xayah,574,300,274,52.26
Galio,Senna,838,395,443,47.14
Galio,Gangplank,610,330,280,54.1
Galio,Camille,463,274,189,59.18
Galio,Udyr,443,227,216,51.24
Galio,Nidalee,362,186,176,51.38
Galio,MonkeyKing,785,356,429,45.35
Galio,Lucian,741,400,341,53.98
Galio,Annie,388,189,199,48.71
Galio,Evelynn,364,198,166,54.4
Galio,Corki,551,308,243,55.9
Galio,Zyra,1192,610,582,51.17
Galio,Vex,511,273,238,53.42
Galio,Samira,686,339,347,49.42
Galio,Taric,190,95,95,50
Galio,Jayce,630,370,260,58.73
Galio,Thresh,1631,791,840,48.5
Galio,FiddleSticks,639,308,331,48.2
Galio,Rammus,392,206,186,52.55
Galio,Gnar,448,227,221,50.67
Galio,Lillia,722,373,349,51.66
Galio,Milio,555,285,270,51.35
Galio,Belveth,299,151,148,50.5
Galio,Rell,535,248,287,46.36
Galio,RekSai,163,76,87,46.63
Galio,Tryndamere,570,243,327,42.63
Galio,Leblanc,846,398,448,47.04
Galio,Aphelios,545,265,280,48.62
Galio,Gragas,651,342,309,52.53
Galio,Cassiopeia,322,188,134,58.39
Galio,KogMaw,300,164,136,54.67
Galio,Nami,1100,544,556,49.45
Galio,Aatrox,1129,588,541,52.08
Galio,TahmKench,735,390,345,53.06
Galio,JarvanIV,706,334,372,47.31
Galio,Draven,564,294,270,52.13
Galio,Viktor,1004,502,502,50
Galio,Fiora,447,188,259,42.06
Galio,Naafiri,355,195,160,54.93
Galio,Gwen,560,299,261,53.39
Galio,Smolder,772,435,337,56.35
Galio,Zoe,491,269,222,54.79
Galio,Heimerdinger,517,266,251,51.45
Galio,Pyke,891,438,453,49.16
Galio,Seraphine,756,392,364,51.85
Galio,Syndra,675,333,342,49.33
Galio,Riven,539,290,249,53.8
Galio,XinZhao,762,352,410,46.19
Galio,Qiyana,214,110,104,51.4
Galio,Sona,367,183,184,49.86
Galio,Katarina,1001,574,427,57.34
Galio,Illaoi,531,271,260,51.04
Galio,Blitzcrank,818,418,400,51.1
Galio,Alistar,525,258,267,49.14
Galio,Kindred,558,283,275,50.72
Galio,Leona,1088,569,519,52.3
Galio,Neeko,515,273,242,53.01
Galio,Khazix,515,288,227,55.92
Galio,Zilean,356,158,198,44.38
Galio,Kassadin,212,110,102,51.89
Galio,Kennen,296,155,141,52.36
Galio,Kayle,730,383,347,52.47
Galio,Kled,168,83,85,49.4
Galio,Trundle,679,276,403,40.65
Galio,Poppy,721,357,364,49.51
Galio,Mordekaiser,1408,719,689,51.07
Galio,Zac,612,297,315,48.53
Galio,Quinn,400,185,215,46.25
Galio,Ornn,477,237,240,49.69
Galio,Ryze,433,217,216,50.12
Galio,Bard,305,159,146,52.13
Galio,Orianna,435,205,230,47.13
Galio,Sivir,625,336,289,53.76
Galio,Sion,871,440,431,50.52
Galio,KSante,705,358,347,50.78
Galio,Akshan,292,146,146,50
Galio,Karthus,367,179,188,48.77
Galio,Azir,414,204,210,49.28
Galio,Olaf,295,144,151,48.81
Galio,Ivern,124,75,49,60.48
Galio,Renata,217,114,103,52.53
Galio,Lissandra,355,155,200,43.66
Galio,TwistedFate,363,206,157,56.75
Galio,Maokai,544,266,278,48.9
Galio,Kalista,253,126,127,49.8
Galio,Shyvana,281,143,138,50.89
Sivir,Singed,194,66,128,34.02
Sivir,LeeSin,1102,550,552,49.91
Sivir,Yasuo,1328,609,719,45.86
Sivir,Caitlyn,2123,1080,1043,50.87
Sivir,Yuumi,457,223,234,48.8
Sivir,Gnar,324,158,166,48.77
Sivir,Zyra,709,315,394,44.43
Sivir,Azir,251,137,114,54.58
Sivir,Varus,634,313,321,49.37
Sivir,Nautilus,764,434,330,56.81
Sivir,Renekton,339,199,140,58.7
Sivir,XinZhao,413,200,213,48.43
Sivir,Kalista,165,65,100,39.39
Sivir,Pantheon,1113,577,536,51.84
Sivir,Teemo,922,426,496,46.2
Sivir,Orianna,272,111,161,40.81
Sivir,Tristana,628,289,339,46.02
Sivir,Lux,1610,794,816,49.32
Sivir,Tryndamere,388,179,209,46.13
Sivir,Shyvana,183,85,98,46.45
Sivir,Ambessa,448,220,228,49.11
Sivir,Jhin,1370,667,703,48.69
Sivir,Thresh,933,479,454,51.34
Sivir,Irelia,609,330,279,54.19
Sivir,Diana,1179,638,541,54.11
Sivir,Katarina,483,212,271,43.89
Sivir,Soraka,396,211,185,53.28
Sivir,Kayle,388,183,205,47.16
Sivir,Nasus,516,245,271,47.48
Sivir,Anivia,240,116,124,48.33
Sivir,KogMaw,201,89,112,44.28
Sivir,Nami,705,314,391,44.54
Sivir,Malphite,753,356,397,47.28
Sivir,Ekko,710,343,367,48.31
Sivir,Mel,1395,709,686,50.82
Sivir,Sejuani,262,137,125,52.29
Sivir,Sylas,1042,538,504,51.63
Sivir,Karma,1005,493,512,49.05
Sivir,Urgot,316,158,158,50
Sivir,Amumu,693,349,344,50.36
Sivir,Brand,526,268,258,50.95
Sivir,Yorick,713,335,378,46.98
Sivir,Trundle,452,212,240,46.9
Sivir,Malzahar,802,383,419,47.76
Sivir,Ezreal,2157,1162,995,53.87
Sivir,Pyke,646,365,281,56.5
Sivir,Garen,1167,623,544,53.38
Sivir,Belveth,117,48,69,41.03
Sivir,Qiyana,173,96,77,55.49
Sivir,Corki,296,153,143,51.69
Sivir,Nocturne,918,437,481,47.6
Sivir,Kassadin,163,71,92,43.56
Sivir,Veigar,730,348,382,47.67
Sivir,Smolder,425,226,199,53.18
Sivir,Ashe,1646,801,845,48.66
Sivir,Mordekaiser,898,468,430,52.12
Sivir,Draven,313,151,162,48.24
Sivir,Jax,692,349,343,50.43
Sivir,Darius,1243,660,583,53.1
Sivir,MissFortune,1687,842,845,49.91
Sivir,TahmKench,476,256,220,53.78
Sivir,Shaco,725,352,373,48.55
Sivir,Morgana,913,456,457,49.95
Sivir,Shen,398,191,207,47.99
Sivir,Seraphine,559,263,296,47.05
Sivir,Ahri,1011,534,477,52.82
Sivir,Kayn,928,470,458,50.65
Sivir,Sett,970,481,489,49.59
Sivir,Rengar,164,89,75,54.27
Sivir,Kaisa,1142,646,496,56.57
Sivir,Janna,251,136,115,54.18
Sivir,Vladimir,498,282,216,56.63
Sivir,FiddleSticks,392,189,203,48.21
Sivir,Xerath,660,346,314,52.42
Sivir,Nunu,370,177,193,47.84
Sivir,Vex,355,168,187,47.32
Sivir,Lucian,453,246,207,54.3
Sivir,Riven,348,179,169,51.44
Sivir,Aatrox,655,317,338,48.4
Sivir,Vi,721,354,367,49.1
Sivir,Gangplank,439,211,228,48.06
Sivir,Warwick,964,447,517,46.37
Sivir,Yone,1168,598,570,51.2
Sivir,Akali,703,356,347,50.64
Sivir,Viego,926,496,430,53.56
Sivir,Twitch,470,261,209,55.53
Sivir,Khazix,328,173,155,52.74
Sivir,Milio,345,162,183,46.96
Sivir,Ornn,255,133,122,52.16
Sivir,Karthus,232,115,117,49.57
Sivir,Viktor,661,350,311,52.95
Sivir,TwistedFate,219,125,94,57.08
Sivir,Blitzcrank,767,457,310,59.58
Sivir,Swain,665,302,363,45.41
Sivir,Gwen,363,211,152,58.13
Sivir,Lulu,890,410,480,46.07
Sivir,Jinx,2011,980,1031,48.73
Sivir,Syndra,405,194,211,47.9
Sivir,Nilah,179,95,84,53.07
Sivir,Volibear,664,309,355,46.54
Sivir,Aphelios,346,191,155,55.2
Sivir,Evelynn,251,156,95,62.15
Sivir,Poppy,382,198,184,51.83
Sivir,Senna,555,262,293,47.21
Sivir,Chogath,833,420,413,50.42
Sivir,Zeri,341,189,152,55.43
Sivir,Aurora,553,271,282,49.01
Sivir,Vayne,828,368,460,44.44
Sivir,Fizz,302,166,136,54.97
Sivir,Kindred,304,152,152,50
Sivir,Akshan,212,116,96,54.72
Sivir,Sona,190,89,101,46.84
Sivir,AurelionSol,286,146,140,51.05
Sivir,Renata,140,81,59,57.86
Sivir,Elise,525,237,288,45.14
Sivir,Nidalee,221,108,113,48.87
Sivir,Samira,420,193,227,45.95
Sivir,MasterYi,799,401,398,50.19
Sivir,Camille,238,101,137,42.44
Sivir,Leona,684,385,299,56.29
Sivir,Fiora,238,105,133,44.12
Sivir,Zed,831,398,433,47.89
Sivir,Jayce,376,158,218,42.02
Sivir,Braum,348,156,192,44.83
Sivir,Briar,500,223,277,44.6
Sivir,Illaoi,317,162,155,51.1
Sivir,Taric,128,51,77,39.84
Sivir,Zoe,242,125,117,51.65
Sivir,Rammus,185,94,91,50.81
Sivir,Lissandra,232,113,119,48.71
Sivir,Rumble,197,111,86,56.35
Sivir,Neeko,297,180,117,60.61
Sivir,JarvanIV,494,263,231,53.24
Sivir,Sion,492,254,238,51.63
Sivir,Zac,356,184,172,51.69
Sivir,Ivern,105,59,46,56.19
Sivir,Gragas,345,191,154,55.36
Sivir,Heimerdinger,257,104,153,40.47
Sivir,MonkeyKing,469,249,220,53.09
Sivir,Naafiri,205,93,112,45.37
Sivir,Rakan,265,139,126,52.45
Sivir,Cassiopeia,171,83,88,48.54
Sivir,Quinn,247,134,113,54.25
Sivir,Zilean,252,127,125,50.4
Sivir,Velkoz,419,217,202,51.79
Sivir,Maokai,274,136,138,49.64
Sivir,Annie,260,139,121,53.46
Sivir,Lillia,396,216,180,54.55
Sivir,Udyr,253,127,126,50.2
Sivir,Galio,625,289,336,46.24
Sivir,KSante,315,172,143,54.6
Sivir,Hecarim,309,159,150,51.46
Sivir,Hwei,386,210,176,54.4
Sivir,Alistar,363,201,162,55.37
Sivir,Kled,110,56,54,50.91
Sivir,Ryze,232,119,113,51.29
Sivir,Olaf,204,127,77,62.25
Sivir,Graves,452,228,224,50.44
Sivir,Ziggs,225,112,113,49.78
Sivir,Rell,285,142,143,49.82
Sivir,Xayah,340,185,155,54.41
Sivir,Skarner,170,96,74,56.47
Sivir,Talon,465,228,237,49.03
Sivir,Leblanc,457,238,219,52.08
Sivir,Bard,195,121,74,62.05
Sivir,DrMundo,279,134,145,48.03
Sivir,Taliyah,172,93,79,54.07
Sivir,Kennen,182,93,89,51.1
Sivir,RekSai,123,64,59,52.03
Pyke,Singed,254,113,141,44.49
Pyke,LeeSin,1719,830,889,48.28
Pyke,Yasuo,2054,941,1113,45.81
Pyke,Caitlyn,2807,1358,1449,48.38
Pyke,Yuumi,854,350,504,40.98
Pyke,Yorick,971,429,542,44.18
Pyke,Warwick,1472,701,771,47.62
Pyke,Veigar,1015,490,525,48.28
Pyke,Tristana,991,462,529,46.62
Pyke,Thresh,1461,640,821,43.81
Pyke,Riven,432,205,227,47.45
Pyke,Sejuani,464,230,234,49.57
Pyke,Sylas,1496,781,715,52.21
Pyke,Lucian,778,346,432,44.47
Pyke,Soraka,583,263,320,45.11
Pyke,Gragas,513,266,247,51.85
Pyke,Pantheon,1775,910,865,51.27
Pyke,Mel,1909,978,931,51.23
Pyke,Darius,1870,945,925,50.53
Pyke,Amumu,999,486,513,48.65
Pyke,Aurora,720,335,385,46.53
Pyke,Lux,2838,1436,1402,50.6
Pyke,Seraphine,651,359,292,55.15
Pyke,Diana,1513,773,740,51.09
Pyke,Zed,1188,616,572,51.85
Pyke,Trundle,605,257,348,42.48
Pyke,Malphite,1143,504,639,44.09
Pyke,Hwei,647,313,334,48.38
Pyke,Twitch,701,342,359,48.79
Pyke,Milio,526,257,269,48.86
Pyke,Sett,1407,685,722,48.69
Pyke,Nocturne,1332,683,649,51.28
Pyke,Azir,330,159,171,48.18
Pyke,Ezreal,2735,1335,1400,48.81
Pyke,Qiyana,271,117,154,43.17
Pyke,Chogath,1273,609,664,47.84
Pyke,Vayne,1254,602,652,48.01
Pyke,Olaf,253,110,143,43.48
Pyke,Shaco,916,465,451,50.76
Pyke,Lissandra,309,143,166,46.28
Pyke,Ashe,2164,1035,1129,47.83
Pyke,Leona,860,447,413,51.98
Pyke,Aatrox,879,382,497,43.46
Pyke,Evelynn,328,175,153,53.35
Pyke,Katarina,801,365,436,45.57
Pyke,Kaisa,1823,861,962,47.23
Pyke,Mordekaiser,1195,608,587,50.88
Pyke,Akali,1252,607,645,48.48
Pyke,Jinx,2871,1429,1442,49.77
Pyke,Irelia,842,402,440,47.74
Pyke,Rammus,350,155,195,44.29
Pyke,Karma,1341,633,708,47.2
Pyke,Jax,1063,532,531,50.05
Pyke,Fizz,544,259,285,47.61
Pyke,Vi,941,465,476,49.42
Pyke,Ekko,911,457,454,50.16
Pyke,Varus,850,446,404,52.47
Pyke,Kayn,1425,650,775,45.61
Pyke,Sivir,646,281,365,43.5
Pyke,Zoe,388,178,210,45.88
Pyke,Maokai,516,225,291,43.6
Pyke,JarvanIV,534,253,281,47.38
Pyke,Ziggs,335,174,161,51.94
Pyke,Sona,304,129,175,42.43
Pyke,Malzahar,1017,471,546,46.31
Pyke,Annie,358,154,204,43.02
Pyke,Teemo,1393,640,753,45.94
Pyke,Brand,755,351,404,46.49
Pyke,MasterYi,1332,651,681,48.87
Pyke,Naafiri,367,169,198,46.05
Pyke,Senna,736,383,353,52.04
Pyke,Ivern,142,76,66,53.52
Pyke,Ahri,1279,664,615,51.92
Pyke,Draven,515,275,240,53.4
Pyke,Quinn,356,169,187,47.47
Pyke,Khazix,558,285,273,51.08
Pyke,Nidalee,302,142,160,47.02
Pyke,Udyr,381,179,202,46.98
Pyke,Vladimir,616,287,329,46.59
Pyke,Poppy,723,325,398,44.95
Pyke,Rell,496,240,256,48.39
Pyke,Leblanc,678,300,378,44.25
Pyke,MonkeyKing,708,328,380,46.33
Pyke,Gangplank,537,291,246,54.19
Pyke,Camille,362,207,155,57.18
Pyke,Swain,990,465,525,46.97
Pyke,Jhin,2020,1008,1012,49.9
Pyke,Ryze,372,189,183,50.81
Pyke,MissFortune,2171,1073,1098,49.42
Pyke,Viego,1548,738,810,47.67
Pyke,Yone,1918,981,937,51.15
Pyke,Neeko,447,217,230,48.55
Pyke,Orianna,422,192,230,45.5
Pyke,Nasus,706,328,378,46.46
Pyke,Lulu,1324,620,704,46.83
Pyke,Shen,668,324,344,48.5
Pyke,Kalista,267,119,148,44.57
Pyke,Samira,710,338,372,47.61
Pyke,Morgana,1167,595,572,50.99
Pyke,Alistar,450,226,224,50.22
Pyke,Kindred,461,247,214,53.58
Pyke,Cassiopeia,311,150,161,48.23
Pyke,Xayah,417,226,191,54.2
Pyke,Fiora,368,165,203,44.84
Pyke,Syndra,572,293,279,51.22
Pyke,Kassadin,188,95,93,50.53
Pyke,Renata,147,67,80,45.58
Pyke,Viktor,836,382,454,45.69
Pyke,Bard,288,134,154,46.53
Pyke,Ornn,368,189,179,51.36
Pyke,Xerath,946,496,450,52.43
Pyke,Kayle,763,337,426,44.17
Pyke,Braum,648,291,357,44.91
Pyke,Illaoi,522,258,264,49.43
Pyke,Graves,704,288,416,40.91
Pyke,Tryndamere,615,330,285,53.66
Pyke,Zilean,329,178,151,54.1
Pyke,TwistedFate,366,177,189,48.36
Pyke,Gnar,387,192,195,49.61
Pyke,Nautilus,1221,562,659,46.03
Pyke,Smolder,654,344,310,52.6
Pyke,KSante,593,296,297,49.92
Pyke,Briar,700,335,365,47.86
Pyke,TahmKench,692,360,332,52.02
Pyke,AurelionSol,403,187,216,46.4
Pyke,Hecarim,415,195,220,46.99
Pyke,Galio,891,453,438,50.84
Pyke,Rengar,371,188,183,50.67
Pyke,Akshan,309,170,139,55.02
Pyke,Velkoz,524,245,279,46.76
Pyke,Kennen,239,129,110,53.97
Pyke,Rakan,450,240,210,53.33
Pyke,Sion,653,327,326,50.08
Pyke,Lillia,510,259,251,50.78
Pyke,Taric,216,93,123,43.06
Pyke,Nami,938,424,514,45.2
Pyke,Garen,1589,716,873,45.06
Pyke,Volibear,1225,555,670,45.31
Pyke,Belveth,215,89,126,41.4
Pyke,Karthus,264,134,130,50.76
Pyke,Rumble,308,147,161,47.73
Pyke,Talon,652,296,356,45.4
Pyke,Zac,483,230,253,47.62
Pyke,Taliyah,225,110,115,48.89
Pyke,KogMaw,273,142,131,52.01
Pyke,Ambessa,587,302,285,51.45
Pyke,FiddleSticks,478,242,236,50.63
Pyke,Aphelios,484,234,250,48.35
Pyke,Kled,180,84,96,46.67
Pyke,Urgot,487,238,249,48.87
Pyke,Shyvana,204,87,117,42.65
Pyke,Renekton,510,244,266,47.84
Pyke,Elise,800,363,437,45.38
Pyke,Blitzcrank,717,387,330,53.97
Pyke,DrMundo,610,273,337,44.75
Pyke,Skarner,204,118,86,57.84
Pyke,Zyra,861,447,414,51.92
Pyke,XinZhao,627,294,333,46.89
Pyke,Corki,452,216,236,47.79
Pyke,Janna,322,148,174,45.96
Pyke,Heimerdinger,441,188,253,42.63
Pyke,Nunu,546,243,303,44.51
Pyke,Anivia,250,134,116,53.6
Pyke,Nilah,290,124,166,42.76
Pyke,Vex,557,294,263,52.78
Pyke,Zeri,425,198,227,46.59
Pyke,Gwen,511,236,275,46.18
Pyke,Jayce,533,273,260,51.22
Pyke,RekSai,122,70,52,57.38
Jax,Gragas,860,439,421,51.05
Jax,Kayn,1688,807,881,47.81
Jax,Mel,2211,1055,1156,47.72
Jax,Jinx,3509,1671,1838,47.62
Jax,Thresh,1507,704,803,46.72
Jax,Mordekaiser,1584,726,858,45.83
Jax,Skarner,311,170,141,54.66
Jax,Galio,1171,553,618,47.22
Jax,MissFortune,2931,1316,1615,44.9
Jax,Lux,3122,1503,1619,48.14
Jax,Kayle,908,443,465,48.79
Jax,Darius,2115,1028,1087,48.61
Jax,Malphite,1239,608,631,49.07
Jax,Ezreal,3018,1624,1394,53.81
Jax,Nami,1095,512,583,46.76
Jax,Gwen,590,310,280,52.54
Jax,Khazix,595,278,317,46.72
Jax,TwistedFate,457,241,216,52.74
Jax,Varus,1089,602,487,55.28
Jax,Riven,556,288,268,51.8
Jax,Ziggs,441,201,240,45.58
Jax,Katarina,866,413,453,47.69
Jax,LeeSin,1925,985,940,51.17
Jax,Renekton,601,269,332,44.76
Jax,XinZhao,814,401,413,49.26
Jax,Yasuo,2581,1294,1287,50.14
Jax,Kalista,342,158,184,46.2
Jax,Pantheon,1772,884,888,49.89
Jax,Gnar,366,198,168,54.1
Jax,Sylas,1811,955,856,52.73
Jax,Ashe,2448,1249,1199,51.02
Jax,Seraphine,854,383,471,44.85
Jax,Viego,1751,916,835,52.31
Jax,Irelia,1210,530,680,43.8
Jax,Twitch,862,428,434,49.65
Jax,Lulu,1702,762,940,44.77
Jax,Talon,617,271,346,43.92
Jax,Caitlyn,3144,1474,1670,46.88
Jax,Alistar,524,249,275,47.52
Jax,Yorick,1137,517,620,45.47
Jax,Nocturne,1703,813,890,47.74
Jax,Zed,1278,621,657,48.59
Jax,Xayah,554,291,263,52.53
Jax,Karma,1410,653,757,46.31
Jax,Gangplank,589,298,291,50.59
Jax,Hecarim,506,230,276,45.45
Jax,Aurora,840,431,409,51.31
Jax,Jhin,2334,1048,1286,44.9
Jax,Brand,885,407,478,45.99
Jax,Singed,323,166,157,51.39
Jax,Diana,2060,1033,1027,50.15
Jax,Viktor,1076,526,550,48.88
Jax,Kennen,287,140,147,48.78
Jax,Ekko,1137,596,541,52.42
Jax,Leblanc,835,384,451,45.99
Jax,Pyke,1063,531,532,49.95
Jax,Yone,2592,1378,1214,53.16
Jax,Ahri,1509,768,741,50.89
Jax,Velkoz,679,309,370,45.51
Jax,Orianna,501,226,275,45.11
Jax,Quinn,384,162,222,42.19
Jax,Evelynn,408,206,202,50.49
Jax,KogMaw,386,196,190,50.78
Jax,Braum,723,365,358,50.48
Jax,Olaf,301,136,165,45.18
Jax,Malzahar,1175,575,600,48.94
Jax,Syndra,741,351,390,47.37
Jax,Kaisa,2031,1014,1017,49.93
Jax,Amumu,1196,560,636,46.82
Jax,Volibear,1375,676,699,49.16
Jax,Xerath,1120,545,575,48.66
Jax,Yuumi,880,489,391,55.57
Jax,KSante,675,348,327,51.56
Jax,Leona,1077,563,514,52.27
Jax,TahmKench,756,381,375,50.4
Jax,Nautilus,1260,614,646,48.73
Jax,Teemo,1460,663,797,45.41
Jax,Graves,911,466,445,51.15
Jax,Samira,783,374,409,47.77
Jax,Elise,896,408,488,45.54
Jax,Taliyah,329,138,191,41.95
Jax,Zyra,1117,515,602,46.11
Jax,FiddleSticks,568,268,300,47.18
Jax,Naafiri,337,163,174,48.37
Jax,Sion,762,382,380,50.13
Jax,Shaco,1068,518,550,48.5
Jax,Soraka,686,317,369,46.21
Jax,Draven,573,280,293,48.87
Jax,Sett,1824,890,934,48.79
Jax,Taric,221,100,121,45.25
Jax,Chogath,1231,544,687,44.19
Jax,Zoe,467,230,237,49.25
Jax,Anivia,386,170,216,44.04
Jax,MasterYi,1996,981,1015,49.15
Jax,Veigar,1203,555,648,46.13
Jax,Senna,847,432,415,51
Jax,Shen,765,390,375,50.98
Jax,Sivir,692,343,349,49.57
Jax,Fizz,727,329,398,45.25
Jax,Morgana,1438,730,708,50.76
Jax,DrMundo,688,330,358,47.97
Jax,Qiyana,278,163,115,58.63
Jax,Sejuani,441,214,227,48.53
Jax,Aatrox,1049,555,494,52.91
Jax,Briar,821,410,411,49.94
Jax,Warwick,2043,966,1077,47.28
Jax,Kassadin,254,144,110,56.69
Jax,Jayce,558,260,298,46.59
Jax,Swain,1227,547,680,44.58
Jax,Tristana,1267,646,621,50.99
Jax,Vladimir,852,396,456,46.48
Jax,JarvanIV,693,367,326,52.96
Jax,Trundle,816,419,397,51.35
Jax,Neeko,569,292,277,51.32
Jax,Blitzcrank,866,445,421,51.39
Jax,Azir,387,198,189,51.16
Jax,Ryze,381,200,181,52.49
Jax,Vayne,1480,710,770,47.97
Jax,Garen,2492,1097,1395,44.02
Jax,RekSai,144,53,91,36.81
Jax,Poppy,756,403,353,53.31
Jax,Lissandra,370,176,194,47.57
Jax,Kindred,523,234,289,44.74
Jax,Bard,391,180,211,46.04
Jax,Illaoi,685,304,381,44.38
Jax,Sona,415,198,217,47.71
Jax,Nasus,718,346,372,48.19
Jax,Aphelios,600,342,258,57
Jax,AurelionSol,464,228,236,49.14
Jax,Rengar,338,190,148,56.21
Jax,Lucian,882,465,417,52.72
Jax,MonkeyKing,796,394,402,49.5
Jax,Udyr,428,222,206,51.87
Jax,Janna,356,152,204,42.7
Jax,Vex,600,329,271,54.83
Jax,Vi,1133,597,536,52.69
Jax,Lillia,662,311,351,46.98
Jax,Maokai,512,262,250,51.17
Jax,Nunu,618,294,324,47.57
Jax,Hwei,713,380,333,53.3
Jax,Camille,481,279,202,58
Jax,Rammus,350,144,206,41.14
Jax,Rumble,304,174,130,57.24
Jax,Zac,638,306,332,47.96
Jax,Ambessa,777,373,404,48.01
Jax,Shyvana,233,104,129,44.64
Jax,Smolder,835,423,412,50.66
Jax,Rakan,495,234,261,47.27
Jax,Akali,1337,670,667,50.11
Jax,Annie,391,195,196,49.87
Jax,Nilah,331,177,154,53.47
Jax,Heimerdinger,488,205,283,42.01
Jax,Kled,204,96,108,47.06
Jax,Karthus,321,165,156,51.4
Jax,Milio,680,320,360,47.06
Jax,Urgot,513,261,252,50.88
Jax,Tryndamere,771,380,391,49.29
Jax,Rell,614,299,315,48.7
Jax,Belveth,215,133,82,61.86
Jax,Fiora,477,212,265,44.44
Jax,Cassiopeia,272,105,167,38.6
Jax,Zeri,538,284,254,52.79
Jax,Corki,473,239,234,50.53
Jax,Ivern,161,71,90,44.1
Jax,Renata,231,128,103,55.41
Jax,Ornn,426,231,195,54.23
Jax,Nidalee,323,167,156,51.7
Jax,Zilean,343,164,179,47.81
Jax,Akshan,397,191,206,48.11
Nocturne,Gragas,854,460,394,53.86
Nocturne,Kayn,2484,1330,1154,53.54
Nocturne,Mel,3241,1906,1335,58.81
Nocturne,Jinx,4687,2370,2317,50.57
Nocturne,Thresh,2248,1161,1087,51.65
Nocturne,Pantheon,2791,1539,1252,55.14
Nocturne,Yasuo,3278,1808,1470,55.16
Nocturne,Caitlyn,4517,2484,2033,54.99
Nocturne,Yorick,1598,857,741,53.63
Nocturne,MasterYi,2331,1131,1200,48.52
Nocturne,Ahri,2250,1213,1037,53.91
Nocturne,Ezreal,4222,2253,1969,53.36
Nocturne,Morgana,1940,1059,881,54.59
Nocturne,Chogath,2008,1077,931,53.64
Nocturne,Kindred,734,374,360,50.95
Nocturne,Katarina,1216,652,564,53.62
Nocturne,Tristana,1754,965,789,55.02
Nocturne,Neeko,680,370,310,54.41
Nocturne,Gwen,901,457,444,50.72
Nocturne,Fizz,988,517,471,52.33
Nocturne,Ivern,242,120,122,49.59
Nocturne,Singed,471,252,219,53.5
Nocturne,Shaco,1896,985,911,51.95
Nocturne,Hwei,1073,506,567,47.16
Nocturne,Jhin,3566,1921,1645,53.87
Nocturne,Janna,513,253,260,49.32
Nocturne,Darius,3251,1739,1512,53.49
Nocturne,Lillia,951,510,441,53.63
Nocturne,Garen,2829,1471,1358,52
Nocturne,Pyke,1332,649,683,48.72
Nocturne,Elise,1257,662,595,52.67
Nocturne,Viktor,1438,754,684,52.43
Nocturne,Corki,739,403,336,54.53
Nocturne,Milio,881,436,445,49.49
Nocturne,Nautilus,1795,989,806,55.1
Nocturne,FiddleSticks,887,456,431,51.41
Nocturne,Vladimir,1077,586,491,54.41
Nocturne,Nasus,1210,588,622,48.6
Nocturne,Sylas,2701,1359,1342,50.31
Nocturne,Kaisa,3008,1643,1365,54.62
Nocturne,Volibear,1995,1061,934,53.18
Nocturne,Khazix,895,496,399,55.42
Nocturne,Lux,4361,2356,2005,54.02
Nocturne,Velkoz,1140,557,583,48.86
Nocturne,Shyvana,500,251,249,50.2
Nocturne,Annie,565,301,264,53.27
Nocturne,Varus,1477,828,649,56.06
Nocturne,Renekton,777,401,376,51.61
Nocturne,Veigar,1583,820,763,51.8
Nocturne,Vayne,2098,1046,1052,49.86
Nocturne,MissFortune,4005,2091,1914,52.21
Nocturne,Diana,2780,1392,1388,50.07
Nocturne,Malzahar,1868,1044,824,55.89
Nocturne,Vi,1694,956,738,56.43
Nocturne,Soraka,920,440,480,47.83
Nocturne,Warwick,2664,1363,1301,51.16
Nocturne,LeeSin,2652,1473,1179,55.54
Nocturne,Kassadin,334,150,184,44.91
Nocturne,Jax,1703,890,813,52.26
Nocturne,Ekko,1714,925,789,53.97
Nocturne,Zeri,748,343,405,45.86
Nocturne,Amumu,1920,912,1008,47.5
Nocturne,Irelia,1464,802,662,54.78
Nocturne,Zed,1982,1042,940,52.57
Nocturne,Xayah,914,483,431,52.84
Nocturne,Nidalee,524,286,238,54.58
Nocturne,Graves,1109,629,480,56.72
Nocturne,Mordekaiser,2136,1139,997,53.32
Nocturne,Syndra,1072,590,482,55.04
Nocturne,Karma,2075,1065,1010,51.33
Nocturne,Teemo,2187,1099,1088,50.25
Nocturne,Ashe,3475,1852,1623,53.29
Nocturne,Lucian,1243,618,625,49.72
Nocturne,Briar,1278,644,634,50.39
Nocturne,Maokai,759,396,363,52.17
Nocturne,Ornn,636,332,304,52.2
Nocturne,Aurora,1172,652,520,55.63
Nocturne,Zilean,613,270,343,44.05
Nocturne,MonkeyKing,1405,728,677,51.81
Nocturne,Poppy,975,551,424,56.51
Nocturne,Vex,935,492,443,52.62
Nocturne,Leona,1511,802,709,53.08
Nocturne,Gnar,744,373,371,50.13
Nocturne,Sivir,918,481,437,52.4
Nocturne,Taric,342,174,168,50.88
Nocturne,Ambessa,1097,671,426,61.17
Nocturne,Sejuani,697,399,298,57.25
Nocturne,Akali,1853,938,915,50.62
Nocturne,Ziggs,651,346,305,53.15
Nocturne,Bard,466,209,257,44.85
Nocturne,Draven,830,424,406,51.08
Nocturne,Gangplank,1028,574,454,55.84
Nocturne,Aphelios,859,472,387,54.95
Nocturne,Jayce,738,404,334,54.74
Nocturne,Rammus,549,302,247,55.01
Nocturne,Shen,1019,568,451,55.74
Nocturne,Rengar,550,297,253,54
Nocturne,Yone,2970,1547,1423,52.09
Nocturne,Illaoi,745,356,389,47.79
Nocturne,DrMundo,914,461,453,50.44
Nocturne,Sett,2546,1311,1235,51.49
Nocturne,Seraphine,1202,651,551,54.16
Nocturne,Malphite,1843,998,845,54.15
Nocturne,Aatrox,1648,926,722,56.19
Nocturne,Camille,594,309,285,52.02
Nocturne,Galio,1504,780,724,51.86
Nocturne,Anivia,507,254,253,50.1
Nocturne,Braum,912,441,471,48.36
Nocturne,Brand,1315,705,610,53.61
Nocturne,KSante,911,498,413,54.67
Nocturne,Nilah,483,251,232,51.97
Nocturne,Swain,1554,740,814,47.62
Nocturne,Twitch,1362,733,629,53.82
Nocturne,Kled,308,165,143,53.57
Nocturne,Trundle,1013,579,434,57.16
Nocturne,Lulu,2244,1197,1047,53.34
Nocturne,Ryze,658,332,326,50.46
Nocturne,TahmKench,1339,723,616,54
Nocturne,Talon,953,464,489,48.69
Nocturne,Zyra,1807,917,890,50.75
Nocturne,Quinn,635,325,310,51.18
Nocturne,RekSai,182,93,89,51.1
Nocturne,Olaf,415,208,207,50.12
Nocturne,Nami,1633,870,763,53.28
Nocturne,Belveth,414,253,161,61.11
Nocturne,Smolder,1044,580,464,55.56
Nocturne,Leblanc,1131,608,523,53.76
Nocturne,Xerath,1621,909,712,56.08
Nocturne,Kennen,440,211,229,47.95
Nocturne,Yuumi,1347,672,675,49.89
Nocturne,Hecarim,685,356,329,51.97
Nocturne,Lissandra,575,320,255,55.65
Nocturne,Senna,1194,675,519,56.53
Nocturne,Sion,1175,641,534,54.55
Nocturne,JarvanIV,1248,626,622,50.16
Nocturne,Rakan,610,312,298,51.15
Nocturne,Zac,828,387,441,46.74
Nocturne,Riven,700,380,320,54.29
Nocturne,AurelionSol,675,307,368,45.48
Nocturne,Fiora,609,317,292,52.05
Nocturne,KogMaw,485,266,219,54.85
Nocturne,Orianna,632,306,326,48.42
Nocturne,Viego,2295,1128,1167,49.15
Nocturne,Rell,826,470,356,56.9
Nocturne,Urgot,866,428,438,49.42
Nocturne,Naafiri,557,326,231,58.53
Nocturne,Udyr,664,324,340,48.8
Nocturne,Blitzcrank,1248,699,549,56.01
Nocturne,Samira,1097,518,579,47.22
Nocturne,Nunu,871,448,423,51.44
Nocturne,Azir,512,296,216,57.81
Nocturne,Rumble,418,226,192,54.07
Nocturne,Sona,515,285,230,55.34
Nocturne,Alistar,674,404,270,59.94
Nocturne,Zoe,641,326,315,50.86
Nocturne,Kalista,431,239,192,55.45
Nocturne,Tryndamere,879,465,414,52.9
Nocturne,Kayle,1059,493,566,46.55
Nocturne,Renata,320,170,150,53.13
Nocturne,Evelynn,655,390,265,59.54
Nocturne,Cassiopeia,368,199,169,54.08
Nocturne,XinZhao,1291,655,636,50.74
Nocturne,Karthus,495,264,231,53.33
Nocturne,Qiyana,403,244,159,60.55
Nocturne,Taliyah,377,173,204,45.89
Nocturne,Akshan,572,327,245,57.17
Nocturne,Skarner,351,195,156,55.56
Nocturne,Heimerdinger,728,351,377,48.21
Nocturne,TwistedFate,584,352,232,60.27
Syndra,Gragas,477,265,212,55.56
Syndra,Kayn,1153,578,575,50.13
Syndra,Mel,1501,801,700,53.36
Syndra,Jinx,2272,1187,1085,52.24
Syndra,Thresh,1084,529,555,48.8
Syndra,Rakan,351,159,192,45.3
Syndra,Ekko,856,436,420,50.93
Syndra,Veigar,807,427,380,52.91
Syndra,Ashe,1546,791,755,51.16
Syndra,Soraka,479,227,252,47.39
Syndra,Pantheon,1261,673,588,53.37
Syndra,Gwen,367,215,152,58.58
Syndra,Fizz,550,255,295,46.36
Syndra,Ivern,123,72,51,58.54
Syndra,Chogath,958,493,465,51.46
Syndra,Malzahar,946,447,499,47.25
Syndra,MissFortune,1679,845,834,50.33
Syndra,Nami,891,389,502,43.66
Syndra,Yasuo,1234,582,652,47.16
Syndra,Udyr,327,196,131,59.94
Syndra,Qiyana,213,114,99,53.52
Syndra,Seraphine,486,236,250,48.56
Syndra,Yone,1340,702,638,52.39
Syndra,Nocturne,1072,482,590,44.96
Syndra,Ahri,1270,679,591,53.46
Syndra,Velkoz,457,219,238,47.92
Syndra,Caitlyn,2104,1025,1079,48.72
Syndra,Khazix,467,232,235,49.68
Syndra,Sejuani,304,162,142,53.29
Syndra,Lux,1889,948,941,50.19
Syndra,Poppy,521,248,273,47.6
Syndra,Gnar,310,175,135,56.45
Syndra,TwistedFate,296,161,135,54.39
Syndra,Jhin,1601,789,812,49.28
Syndra,Karma,1164,565,599,48.54
Syndra,Jax,741,390,351,52.63
Syndra,Vi,802,397,405,49.5
Syndra,Tristana,764,423,341,55.37
Syndra,Riven,424,202,222,47.64
Syndra,FiddleSticks,414,200,214,48.31
Syndra,Neeko,329,156,173,47.42
Syndra,Milio,502,218,284,43.43
Syndra,Olaf,197,103,94,52.28
Syndra,Hwei,703,352,351,50.07
Syndra,Varus,742,407,335,54.85
Syndra,Swain,714,334,380,46.78
Syndra,Renekton,413,235,178,56.9
Syndra,Rengar,273,140,133,51.28
Syndra,Zilean,265,117,148,44.15
Syndra,Lucian,613,298,315,48.61
Syndra,Camille,343,171,172,49.85
Syndra,Aurora,580,323,257,55.69
Syndra,Shaco,784,419,365,53.44
Syndra,Lulu,1320,696,624,52.73
Syndra,Teemo,958,507,451,52.92
Syndra,Zed,906,447,459,49.34
Syndra,Ezreal,1982,1002,980,50.55
Syndra,Annie,327,186,141,56.88
Syndra,MasterYi,914,438,476,47.92
Syndra,Mordekaiser,1006,491,515,48.81
Syndra,Kaisa,1425,699,726,49.05
Syndra,Ornn,325,160,165,49.23
Syndra,JarvanIV,523,269,254,51.43
Syndra,Nautilus,932,467,465,50.11
Syndra,Garen,1302,625,677,48
Syndra,Rammus,229,102,127,44.54
Syndra,Lissandra,268,105,163,39.18
Syndra,Brand,500,257,243,51.4
Syndra,Shen,437,235,202,53.78
Syndra,Warwick,1061,534,527,50.33
Syndra,Akali,689,308,381,44.7
Syndra,Anivia,396,179,217,45.2
Syndra,Tryndamere,476,219,257,46.01
Syndra,Diana,1232,609,623,49.43
Syndra,Orianna,431,221,210,51.28
Syndra,Maokai,382,190,192,49.74
Syndra,Alistar,367,196,171,53.41
Syndra,Yorick,784,374,410,47.7
Syndra,Volibear,814,405,409,49.75
Syndra,Kassadin,183,85,98,46.45
Syndra,Katarina,639,308,331,48.2
Syndra,Pyke,572,279,293,48.78
Syndra,Darius,1577,801,776,50.79
Syndra,Briar,514,265,249,51.56
Syndra,Viktor,1020,533,487,52.25
Syndra,Xayah,366,190,176,51.91
Syndra,Gangplank,393,197,196,50.13
Syndra,Illaoi,339,151,188,44.54
Syndra,Sivir,405,211,194,52.1
Syndra,Jayce,410,207,203,50.49
Syndra,Vayne,1122,567,555,50.53
Syndra,Aatrox,717,408,309,56.9
Syndra,Samira,469,230,239,49.04
Syndra,Blitzcrank,524,282,242,53.82
Syndra,LeeSin,1183,545,638,46.07
Syndra,Leblanc,487,240,247,49.28
Syndra,Aphelios,463,237,226,51.19
Syndra,Trundle,474,247,227,52.11
Syndra,Vladimir,524,289,235,55.15
Syndra,KSante,372,209,163,56.18
Syndra,Urgot,331,142,189,42.9
Syndra,Lillia,409,240,169,58.68
Syndra,Zeri,405,205,200,50.62
Syndra,Akshan,270,139,131,51.48
Syndra,Twitch,743,390,353,52.49
Syndra,Ambessa,510,262,248,51.37
Syndra,Yuumi,775,434,341,56
Syndra,TahmKench,505,257,248,50.89
Syndra,Nasus,513,245,268,47.76
Syndra,Fiora,300,126,174,42
Syndra,Viego,1226,631,595,51.47
Syndra,Xerath,840,378,462,45
Syndra,Singed,221,127,94,57.47
Syndra,Morgana,856,465,391,54.32
Syndra,Irelia,592,270,322,45.61
Syndra,Zyra,767,371,396,48.37
Syndra,Sylas,908,456,452,50.22
Syndra,RekSai,110,77,33,70
Syndra,Galio,675,342,333,50.67
Syndra,Sion,661,317,344,47.96
Syndra,Graves,664,362,302,54.52
Syndra,AurelionSol,362,175,187,48.34
Syndra,Talon,402,217,185,53.98
Syndra,Sona,211,93,118,44.08
Syndra,Evelynn,257,143,114,55.64
Syndra,Naafiri,242,108,134,44.63
Syndra,Elise,678,338,340,49.85
Syndra,Rumble,224,88,136,39.29
Syndra,Corki,335,189,146,56.42
Syndra,Skarner,187,85,102,45.45
Syndra,DrMundo,353,196,157,55.52
Syndra,Zoe,352,172,180,48.86
Syndra,Vex,384,231,153,60.16
Syndra,Bard,293,163,130,55.63
Syndra,Cassiopeia,318,179,139,56.29
Syndra,Sett,1087,552,535,50.78
Syndra,Belveth,194,95,99,48.97
Syndra,Kayle,561,265,296,47.24
Syndra,Janna,330,165,165,50
Syndra,Leona,719,378,341,52.57
Syndra,Kindred,337,177,160,52.52
Syndra,KogMaw,282,157,125,55.67
Syndra,Zac,387,204,183,52.71
Syndra,Ryze,233,114,119,48.93
Syndra,Taric,182,105,77,57.69
Syndra,Draven,516,264,252,51.16
Syndra,Amumu,771,371,400,48.12
Syndra,Braum,472,199,273,42.16
Syndra,Malphite,736,347,389,47.15
Syndra,Kalista,196,97,99,49.49
Syndra,Renata,173,95,78,54.91
Syndra,Nilah,234,108,126,46.15
Syndra,Rell,416,224,192,53.85
Syndra,Taliyah,242,142,100,58.68
Syndra,Smolder,465,245,220,52.69
Syndra,XinZhao,561,327,234,58.29
Syndra,MonkeyKing,549,286,263,52.09
Syndra,Karthus,228,114,114,50
Syndra,Quinn,333,161,172,48.35
Syndra,Kennen,230,103,127,44.78
Syndra,Nunu,413,205,208,49.64
Syndra,Heimerdinger,385,173,212,44.94
Syndra,Senna,521,281,240,53.93
Syndra,Hecarim,388,206,182,53.09
Syndra,Shyvana,157,59,98,37.58
Syndra,Azir,294,144,150,48.98
Syndra,Ziggs,234,122,112,52.14
Syndra,Nidalee,242,137,105,56.61
Syndra,Kled,160,79,81,49.38
Smolder,Gragas,425,188,237,44.24
Smolder,Kayn,1126,543,583,48.22
Smolder,Mel,1646,803,843,48.78
Smolder,Jinx,2376,1106,1270,46.55
Smolder,Thresh,1063,482,581,45.34
Smolder,Olaf,220,114,106,51.82
Smolder,Diana,1355,593,762,43.76
Smolder,Sylas,1025,518,507,50.54
Smolder,Tristana,822,410,412,49.88
Smolder,Kennen,195,129,66,66.15
Smolder,Ornn,310,145,165,46.77
Smolder,Shaco,767,378,389,49.28
Smolder,Aurora,521,266,255,51.06
Smolder,Caitlyn,2218,1040,1178,46.89
Smolder,Zilean,244,99,145,40.57
Smolder,Chogath,895,451,444,50.39
Smolder,Evelynn,207,93,114,44.93
Smolder,Lux,1829,891,938,48.72
Smolder,Twitch,672,298,374,44.35
Smolder,Ashe,1561,716,845,45.87
Smolder,Tryndamere,420,190,230,45.24
Smolder,Volibear,816,403,413,49.39
Smolder,Annie,243,120,123,49.38
Smolder,Samira,517,249,268,48.16
Smolder,Seraphine,508,236,272,46.46
Smolder,TahmKench,596,296,300,49.66
Smolder,Akali,784,380,404,48.47
Smolder,Sona,259,115,144,44.4
Smolder,Neeko,259,138,121,53.28
Smolder,JarvanIV,491,250,241,50.92
Smolder,Yone,1504,754,750,50.13
Smolder,Swain,812,377,435,46.43
Smolder,Irelia,607,238,369,39.21
Smolder,DrMundo,529,258,271,48.77
Smolder,Viktor,800,358,442,44.75
Smolder,Brand,606,265,341,43.73
Smolder,Pantheon,1293,573,720,44.32
Smolder,Hecarim,351,175,176,49.86
Smolder,Naafiri,251,131,120,52.19
Smolder,MissFortune,1799,861,938,47.86
Smolder,Nautilus,888,417,471,46.96
Smolder,Velkoz,456,210,246,46.05
Smolder,Kaisa,1340,709,631,52.91
Smolder,Veigar,838,383,455,45.7
Smolder,Teemo,1018,498,520,48.92
Smolder,Rammus,260,120,140,46.15
Smolder,Ekko,695,353,342,50.79
Smolder,Sivir,425,199,226,46.82
Smolder,Ambessa,413,199,214,48.18
Smolder,Khazix,404,187,217,46.29
Smolder,Malzahar,1168,614,554,52.57
Smolder,Corki,292,127,165,43.49
Smolder,Morgana,902,401,501,44.46
Smolder,Jayce,386,183,203,47.41
Smolder,Yorick,868,397,471,45.74
Smolder,Hwei,496,223,273,44.96
Smolder,Jhin,1745,830,915,47.56
Smolder,Soraka,449,215,234,47.88
Smolder,LeeSin,1189,551,638,46.34
Smolder,Garen,1249,607,642,48.6
Smolder,AurelionSol,356,148,208,41.57
Smolder,Akshan,293,144,149,49.15
Smolder,Ezreal,2077,1032,1045,49.69
Smolder,Shen,564,257,307,45.57
Smolder,Warwick,1086,537,549,49.45
Smolder,Kayle,622,270,352,43.41
Smolder,Sett,1174,570,604,48.55
Smolder,Lissandra,235,87,148,37.02
Smolder,Alistar,361,169,192,46.81
Smolder,KSante,450,233,217,51.78
Smolder,Aatrox,664,276,388,41.57
Smolder,Rakan,354,178,176,50.28
Smolder,Maokai,360,192,168,53.33
Smolder,Lucian,527,250,277,47.44
Smolder,Janna,263,114,149,43.35
Smolder,Sion,619,295,324,47.66
Smolder,Shyvana,237,132,105,55.7
Smolder,Draven,439,213,226,48.52
Smolder,Vladimir,462,232,230,50.22
Smolder,Ahri,981,486,495,49.54
Smolder,Taric,157,81,76,51.59
Smolder,Malphite,918,420,498,45.75
Smolder,Nami,863,395,468,45.77
Smolder,Nocturne,1044,464,580,44.44
Smolder,Talon,439,231,208,52.62
Smolder,Leona,669,315,354,47.09
Smolder,Yasuo,1562,722,840,46.22
Smolder,Viego,1059,533,526,50.33
Smolder,Katarina,587,292,295,49.74
Smolder,Zyra,667,312,355,46.78
Smolder,Urgot,384,152,232,39.58
Smolder,MasterYi,1052,470,582,44.68
Smolder,Senna,546,258,288,47.25
Smolder,Blitzcrank,535,276,259,51.59
Smolder,Vayne,1097,466,631,42.48
Smolder,Karma,1000,462,538,46.2
Smolder,KogMaw,245,108,137,44.08
Smolder,Ryze,254,106,148,41.73
Smolder,Darius,1640,770,870,46.95
Smolder,Briar,551,223,328,40.47
Smolder,Azir,299,130,169,43.48
Smolder,Zac,437,227,210,51.95
Smolder,Zed,882,410,472,46.49
Smolder,Elise,560,277,283,49.46
Smolder,Gwen,384,204,180,53.13
Smolder,Trundle,473,231,242,48.84
Smolder,Vi,730,361,369,49.45
Smolder,Pyke,654,310,344,47.4
Smolder,Nasus,627,273,354,43.54
Smolder,Galio,772,337,435,43.65
Smolder,Leblanc,511,267,244,52.25
Smolder,Qiyana,194,85,109,43.81
Smolder,Renekton,391,181,210,46.29
Smolder,Yuumi,653,269,384,41.19
Smolder,Orianna,290,117,173,40.34
Smolder,Rell,399,184,215,46.12
Smolder,Jax,835,412,423,49.34
Smolder,Karthus,216,110,106,50.93
Smolder,Amumu,874,421,453,48.17
Smolder,Aphelios,445,190,255,42.7
Smolder,Illaoi,382,202,180,52.88
Smolder,RekSai,123,55,68,44.72
Smolder,Mordekaiser,930,431,499,46.34
Smolder,Kled,142,59,83,41.55
Smolder,Nilah,260,99,161,38.08
Smolder,Vex,384,180,204,46.88
Smolder,Anivia,260,127,133,48.85
Smolder,TwistedFate,310,149,161,48.06
Smolder,Udyr,316,139,177,43.99
Smolder,MonkeyKing,605,267,338,44.13
Smolder,Varus,697,364,333,52.22
Smolder,Lulu,1123,482,641,42.92
Smolder,Kalista,227,134,93,59.03
Smolder,Xerath,717,345,372,48.12
Smolder,Singed,232,103,129,44.4
Smolder,Nidalee,208,115,93,55.29
Smolder,Graves,533,260,273,48.78
Smolder,Xayah,343,170,173,49.56
Smolder,Renata,136,67,69,49.26
Smolder,Fiora,242,103,139,42.56
Smolder,Bard,226,104,122,46.02
Smolder,Riven,333,151,182,45.35
Smolder,Sejuani,346,222,124,64.16
Smolder,Gangplank,353,171,182,48.44
Smolder,Heimerdinger,350,134,216,38.29
Smolder,Cassiopeia,209,98,111,46.89
Smolder,Zoe,257,101,156,39.3
Smolder,Rumble,212,111,101,52.36
Smolder,Gnar,273,125,148,45.79
Smolder,Skarner,194,111,83,57.22
Smolder,FiddleSticks,391,183,208,46.8
Smolder,XinZhao,537,232,305,43.2
Smolder,Ivern,130,88,42,67.69
Smolder,Belveth,180,88,92,48.89
Smolder,Syndra,465,220,245,47.31
Smolder,Milio,448,193,255,43.08
Smolder,Taliyah,160,89,71,55.63
Smolder,Kindred,302,146,156,48.34
Smolder,Ziggs,282,125,157,44.33
Smolder,Camille,266,136,130,51.13
Smolder,Braum,420,208,212,49.52
Smolder,Fizz,498,240,258,48.19
Smolder,Nunu,314,180,134,57.32
Smolder,Kassadin,192,78,114,40.63
Smolder,Poppy,382,217,165,56.81
Smolder,Rengar,190,96,94,50.53
Smolder,Quinn,260,118,142,45.38
Smolder,Lillia,457,201,256,43.98
Smolder,Zeri,386,168,218,43.52
Zyra,Gragas,759,443,316,58.37
Zyra,Kayn,1708,852,856,49.88
Zyra,Mel,2427,1208,1219,49.77
Zyra,Jinx,3562,1798,1764,50.48
Zyra,Thresh,1574,818,756,51.97
Zyra,Gangplank,665,360,305,54.14
Zyra,MissFortune,3052,1507,1545,49.38
Zyra,KSante,691,326,365,47.18
Zyra,Hwei,834,422,412,50.6
Zyra,Evelynn,440,234,206,53.18
Zyra,Sivir,709,394,315,55.57
Zyra,Sion,903,444,459,49.17
Zyra,Vi,1200,615,585,51.25
Zyra,Sylas,1806,934,872,51.72
Zyra,Lucian,915,472,443,51.58
Zyra,Pantheon,1978,1035,943,52.33
Zyra,Karma,1799,910,889,50.58
Zyra,Ivern,188,114,74,60.64
Zyra,Anivia,461,215,246,46.64
Zyra,Ashe,2614,1337,1277,51.15
Zyra,Aatrox,1124,606,518,53.91
Zyra,Sett,1871,944,927,50.45
Zyra,Vex,660,327,333,49.55
Zyra,Xerath,1380,659,721,47.75
Zyra,Yone,2170,1153,1017,53.13
Zyra,Teemo,1585,791,794,49.91
Zyra,Fizz,720,338,382,46.94
Zyra,Briar,847,391,456,46.16
Zyra,Seraphine,994,526,468,52.92
Zyra,Volibear,1238,658,580,53.15
Zyra,Sejuani,478,238,240,49.79
Zyra,Lux,3105,1578,1527,50.82
Zyra,Jhin,2780,1410,1370,50.72
Zyra,Nautilus,1223,621,602,50.78
Zyra,Chogath,1350,686,664,50.81
Zyra,Zed,1397,718,679,51.4
Zyra,Vayne,1497,731,766,48.83
Zyra,Senna,968,489,479,50.52
Zyra,Karthus,426,234,192,54.93
Zyra,Ekko,1145,582,563,50.83
Zyra,KogMaw,311,157,154,50.48
Zyra,Lulu,1722,901,821,52.32
Zyra,Ambessa,859,473,386,55.06
Zyra,Hecarim,528,286,242,54.17
Zyra,Katarina,904,488,416,53.98
Zyra,Veigar,1154,630,524,54.59
Zyra,Nami,1271,659,612,51.85
Zyra,LeeSin,2294,1196,1098,52.14
Zyra,Akali,1432,717,715,50.07
Zyra,Soraka,726,369,357,50.83
Zyra,TahmKench,869,492,377,56.62
Zyra,Sona,370,167,203,45.14
Zyra,Neeko,622,332,290,53.38
Zyra,JarvanIV,743,388,355,52.22
Zyra,Swain,1103,590,513,53.49
Zyra,Renekton,558,283,275,50.72
Zyra,Rengar,300,157,143,52.33
Zyra,Zilean,358,186,172,51.96
Zyra,Caitlyn,3465,1802,1663,52.01
Zyra,Garen,1863,902,961,48.42
Zyra,Belveth,261,133,128,50.96
Zyra,Qiyana,285,151,134,52.98
Zyra,Corki,464,270,194,58.19
Zyra,Vladimir,865,455,410,52.6
Zyra,Udyr,424,202,222,47.64
Zyra,Diana,2051,980,1071,47.78
Zyra,Amumu,1208,570,638,47.19
Zyra,Velkoz,652,333,319,51.07
Zyra,Darius,2367,1327,1040,56.06
Zyra,Yorick,1157,555,602,47.97
Zyra,Annie,449,210,239,46.77
Zyra,Jax,1117,602,515,53.89
Zyra,Irelia,1031,525,506,50.92
Zyra,Poppy,698,400,298,57.31
Zyra,Malzahar,1330,664,666,49.92
Zyra,Fiora,397,202,195,50.88
Zyra,Elise,880,493,387,56.02
Zyra,Samira,801,418,383,52.18
Zyra,Aurora,965,456,509,47.25
Zyra,Mordekaiser,1553,822,731,52.93
Zyra,Skarner,272,166,106,61.03
Zyra,Lillia,695,317,378,45.61
Zyra,Draven,560,308,252,55
Zyra,Camille,485,259,226,53.4
Zyra,Ahri,1530,876,654,57.25
Zyra,Milio,642,314,328,48.91
Zyra,Riven,507,239,268,47.14
Zyra,Shen,784,385,399,49.11
Zyra,Maokai,702,375,327,53.42
Zyra,Warwick,1702,770,932,45.24
Zyra,Kalista,294,156,138,53.06
Zyra,Braum,617,313,304,50.73
Zyra,Yasuo,2330,1116,1214,47.9
Zyra,FiddleSticks,666,303,363,45.5
Zyra,Urgot,578,269,309,46.54
Zyra,Khazix,619,320,299,51.7
Zyra,MasterYi,1457,755,702,51.82
Zyra,Taliyah,294,170,124,57.82
Zyra,Rammus,332,152,180,45.78
Zyra,Varus,1176,553,623,47.02
Zyra,XinZhao,829,404,425,48.73
Zyra,Shaco,1264,611,653,48.34
Zyra,Kaisa,1998,1050,948,52.55
Zyra,Rakan,454,246,208,54.19
Zyra,Nasus,741,391,350,52.77
Zyra,Twitch,935,485,450,51.87
Zyra,Ziggs,447,227,220,50.78
Zyra,Leblanc,836,452,384,54.07
Zyra,Nocturne,1807,890,917,49.25
Zyra,Rumble,429,196,233,45.69
Zyra,Ezreal,3229,1750,1479,54.2
Zyra,Viego,1739,809,930,46.52
Zyra,Yuumi,1008,520,488,51.59
Zyra,DrMundo,667,296,371,44.38
Zyra,Graves,840,454,386,54.05
Zyra,Gnar,473,262,211,55.39
Zyra,Galio,1192,582,610,48.83
Zyra,Brand,986,515,471,52.23
Zyra,Tristana,1174,612,562,52.13
Zyra,Zac,637,338,299,53.06
Zyra,Rell,570,328,242,57.54
Zyra,Naafiri,388,203,185,52.32
Zyra,Smolder,667,355,312,53.22
Zyra,Leona,1134,623,511,54.94
Zyra,Aphelios,657,325,332,49.47
Zyra,Morgana,1589,802,787,50.47
Zyra,Lissandra,388,205,183,52.84
Zyra,Zeri,601,288,313,47.92
Zyra,Illaoi,546,295,251,54.03
Zyra,MonkeyKing,895,421,474,47.04
Zyra,Trundle,659,335,324,50.83
Zyra,Blitzcrank,966,525,441,54.35
Zyra,Kennen,319,150,169,47.02
Zyra,Malphite,1244,625,619,50.24
Zyra,Olaf,277,144,133,51.99
Zyra,Syndra,767,396,371,51.63
Zyra,TwistedFate,457,247,210,54.05
Zyra,Viktor,1194,616,578,51.59
Zyra,Kayle,708,333,375,47.03
Zyra,Nunu,597,325,272,54.44
Zyra,Taric,235,121,114,51.49
Zyra,Orianna,472,226,246,47.88
Zyra,Bard,417,213,204,51.08
Zyra,Xayah,441,231,210,52.38
Zyra,Shyvana,288,144,144,50
Zyra,Heimerdinger,582,301,281,51.72
Zyra,Ryze,397,221,176,55.67
Zyra,Gwen,659,355,304,53.87
Zyra,Azir,384,194,190,50.52
Zyra,Tryndamere,570,288,282,50.53
Zyra,Ornn,463,230,233,49.68
Zyra,Alistar,447,230,217,51.45
Zyra,Jayce,688,384,304,55.81
Zyra,Cassiopeia,326,165,161,50.61
Zyra,Talon,711,390,321,54.85
Zyra,Nilah,294,122,172,41.5
Zyra,Singed,335,157,178,46.87
Zyra,AurelionSol,447,231,216,51.68
Zyra,Akshan,344,172,172,50
Zyra,Janna,374,193,181,51.6
Zyra,Pyke,861,414,447,48.08
Zyra,Kassadin,213,97,116,45.54
Zyra,Kled,223,115,108,51.57
Zyra,Nidalee,485,285,200,58.76
Zyra,Kindred,497,248,249,49.9
Zyra,Zoe,447,233,214,52.13
Zyra,Quinn,452,216,236,47.79
Zyra,RekSai,157,100,57,63.69
Zyra,Renata,161,86,75,53.42
Gragas,Jax,860,421,439,48.95
Gragas,Nocturne,854,394,460,46.14
Gragas,Syndra,477,212,265,44.44
Gragas,Smolder,425,237,188,55.76
Gragas,Zyra,759,316,443,41.63
Gragas,Renekton,333,160,173,48.05
Gragas,Viktor,698,312,386,44.7
Gragas,Xayah,324,142,182,43.83
Gragas,Pyke,513,246,267,47.95
Gragas,Ambessa,506,253,253,50
Gragas,Ekko,678,340,338,50.15
Gragas,Yasuo,1331,639,692,48.01
Gragas,Veigar,626,306,320,48.88
Gragas,Warwick,808,395,413,48.89
Gragas,Shen,470,225,245,47.87
Gragas,Velkoz,397,210,187,52.9
Gragas,Varus,629,324,305,51.51
Gragas,Rakan,244,132,112,54.1
Gragas,Quinn,251,119,132,47.41
Gragas,Trundle,411,224,187,54.5
Gragas,Kassadin,192,73,119,38.02
Gragas,Caitlyn,1839,854,985,46.44
Gragas,Senna,504,275,229,54.56
Gragas,Mordekaiser,748,325,423,43.45
Gragas,Talon,439,210,229,47.84
Gragas,Alistar,352,165,187,46.88
Gragas,Naafiri,202,98,104,48.51
Gragas,MasterYi,795,392,403,49.31
Gragas,Akali,745,361,384,48.46
Gragas,Jhin,1369,639,730,46.68
Gragas,Zed,875,424,451,48.46
Gragas,Jinx,2045,954,1091,46.65
Gragas,Soraka,413,169,244,40.92
Gragas,Nasus,433,201,232,46.42
Gragas,Corki,276,147,129,53.26
Gragas,Lux,1450,682,768,47.03
Gragas,Yone,1179,585,594,49.62
Gragas,Kayn,882,436,446,49.43
Gragas,Vladimir,476,215,261,45.17
Gragas,Vayne,897,404,493,45.04
Gragas,Thresh,1022,449,573,43.93
Gragas,KSante,417,238,179,57.07
Gragas,Diana,1129,529,600,46.86
Gragas,Ahri,874,449,425,51.37
Gragas,Lulu,1115,543,572,48.7
Gragas,Teemo,745,328,417,44.03
Gragas,Ashe,1303,650,653,49.88
Gragas,JarvanIV,454,194,260,42.73
Gragas,Brand,498,219,279,43.98
Gragas,Kaisa,1165,637,528,54.68
Gragas,Darius,1262,585,677,46.35
Gragas,Karma,970,463,507,47.73
Gragas,Viego,1016,479,537,47.15
Gragas,AurelionSol,268,137,131,51.12
Gragas,Ezreal,2051,1015,1036,49.49
Gragas,Nami,633,301,332,47.55
Gragas,Sylas,1155,582,573,50.39
Gragas,Xerath,634,301,333,47.48
Gragas,Chogath,779,355,424,45.57
Gragas,LeeSin,1390,662,728,47.63
Gragas,Katarina,579,294,285,50.78
Gragas,Mel,1248,607,641,48.64
Gragas,Qiyana,178,93,85,52.25
Gragas,Shaco,619,303,316,48.95
Gragas,Draven,370,162,208,43.78
Gragas,Yuumi,652,385,267,59.05
Gragas,Aatrox,757,373,384,49.27
Gragas,Taric,133,67,66,50.38
Gragas,Gangplank,396,218,178,55.05
Gragas,Graves,516,232,284,44.96
Gragas,Elise,579,304,275,52.5
Gragas,Nunu,360,158,202,43.89
Gragas,Vex,379,162,217,42.74
Gragas,Lucian,490,260,230,53.06
Gragas,Riven,336,174,162,51.79
Gragas,FiddleSticks,373,175,198,46.92
Gragas,Irelia,486,255,231,52.47
Gragas,Twitch,592,304,288,51.35
Gragas,Milio,401,194,207,48.38
Gragas,Pantheon,1218,617,601,50.66
Gragas,Shyvana,173,99,74,57.23
Gragas,Gnar,329,180,149,54.71
Gragas,Rammus,195,105,90,53.85
Gragas,Morgana,659,297,362,45.07
Gragas,Camille,260,134,126,51.54
Gragas,Kindred,342,139,203,40.64
Gragas,Malzahar,578,269,309,46.54
Gragas,Fizz,365,196,169,53.7
Gragas,Kayle,485,239,246,49.28
Gragas,Sett,1047,527,520,50.33
Gragas,Zac,393,193,200,49.11
Gragas,Braum,391,210,181,53.71
Gragas,Seraphine,391,215,176,54.99
Gragas,Garen,1057,466,591,44.09
Gragas,Hecarim,354,190,164,53.67
Gragas,Ziggs,261,127,134,48.66
Gragas,Rell,359,144,215,40.11
Gragas,TahmKench,505,240,265,47.52
Gragas,Anivia,206,99,107,48.06
Gragas,MissFortune,1362,666,696,48.9
Gragas,Illaoi,287,147,140,51.22
Gragas,Rengar,237,125,112,52.74
Gragas,Nautilus,907,459,448,50.61
Gragas,Galio,651,309,342,47.47
Gragas,Fiora,254,125,129,49.21
Gragas,Aurora,501,282,219,56.29
Gragas,Sona,231,92,139,39.83
Gragas,Volibear,733,366,367,49.93
Gragas,Skarner,191,118,73,61.78
Gragas,Sejuani,257,139,118,54.09
Gragas,Swain,677,316,361,46.68
Gragas,Bard,230,110,120,47.83
Gragas,Sion,502,256,246,51
Gragas,Leona,586,291,295,49.66
Gragas,Malphite,651,277,374,42.55
Gragas,Ornn,297,121,176,40.74
Gragas,Briar,491,270,221,54.99
Gragas,Orianna,300,135,165,45
Gragas,Zilean,214,109,105,50.93
Gragas,Yorick,592,253,339,42.74
Gragas,Blitzcrank,481,235,246,48.86
Gragas,Zoe,280,115,165,41.07
Gragas,Tristana,618,288,330,46.6
Gragas,Zeri,373,172,201,46.11
Gragas,Urgot,287,137,150,47.74
Gragas,Jayce,402,206,196,51.24
Gragas,Udyr,293,143,150,48.81
Gragas,Hwei,439,213,226,48.52
Gragas,TwistedFate,242,120,122,49.59
Gragas,Amumu,667,302,365,45.28
Gragas,DrMundo,317,176,141,55.52
Gragas,MonkeyKing,517,254,263,49.13
Gragas,Vi,795,421,374,52.96
Gragas,Gwen,296,138,158,46.62
Gragas,Aphelios,374,181,193,48.4
Gragas,Tryndamere,372,218,154,58.6
Gragas,Janna,244,121,123,49.59
Gragas,Belveth,178,84,94,47.19
Gragas,Rumble,216,118,98,54.63
Gragas,Khazix,342,151,191,44.15
Gragas,Poppy,422,204,218,48.34
Gragas,Evelynn,194,109,85,56.19
Gragas,Heimerdinger,266,101,165,37.97
Gragas,Kled,137,52,85,37.96
Gragas,Lissandra,258,136,122,52.71
Gragas,Cassiopeia,150,75,75,50
Gragas,Neeko,271,117,154,43.17
Gragas,Sivir,345,154,191,44.64
Gragas,Ryze,273,112,161,41.03
Gragas,Leblanc,524,260,264,49.62
Gragas,KogMaw,204,111,93,54.41
Gragas,Annie,261,121,140,46.36
Gragas,Azir,264,136,128,51.52
Gragas,Samira,516,244,272,47.29
Gragas,Kennen,208,95,113,45.67
Gragas,Maokai,331,127,204,38.37
Gragas,Olaf,185,113,72,61.08
Gragas,XinZhao,426,180,246,42.25
Gragas,Renata,102,52,50,50.98
Gragas,Nilah,186,81,105,43.55
Gragas,Akshan,197,92,105,46.7
Gragas,Kalista,193,114,79,59.07
Gragas,Karthus,195,107,88,54.87
Gragas,Singed,217,104,113,47.93
Gragas,Taliyah,172,79,93,45.93
Gragas,Ivern,96,50,46,52.08
Gragas,Lillia,356,172,184,48.31
Gragas,RekSai,88,35,53,39.77
Gragas,Nidalee,232,120,112,51.72
Kayn,Jax,1688,881,807,52.19
Kayn,Nocturne,2484,1154,1330,46.46
Kayn,Syndra,1153,575,578,49.87
Kayn,Smolder,1126,583,543,51.78
Kayn,Zyra,1708,856,852,50.12
Kayn,Darius,3562,1785,1777,50.11
Kayn,LeeSin,2390,1316,1074,55.06
Kayn,Diana,3146,1643,1503,52.23
Kayn,KogMaw,555,246,309,44.32
Kayn,Thresh,2281,1166,1115,51.12
Kayn,Irelia,1569,812,757,51.75
Kayn,MasterYi,2528,1194,1334,47.23
Kayn,Azir,441,220,221,49.89
Kayn,Lucian,1286,613,673,47.67
Kayn,Mel,3660,1923,1737,52.54
Kayn,Pantheon,2837,1497,1340,52.77
Kayn,Evelynn,648,321,327,49.54
Kayn,Ekko,1862,865,997,46.46
Kayn,Jinx,5266,2520,2746,47.85
Kayn,Khazix,936,483,453,51.6
Kayn,Aurora,1062,535,527,50.38
Kayn,Ashe,3530,1852,1678,52.46
Kayn,Garen,2935,1467,1468,49.98
Kayn,Vladimir,1339,679,660,50.71
Kayn,Caitlyn,5128,2544,2584,49.61
Kayn,Lulu,2382,1162,1220,48.78
Kayn,Zac,808,466,342,57.67
Kayn,Katarina,1342,621,721,46.27
Kayn,Samira,1362,672,690,49.34
Kayn,Leona,1616,815,801,50.43
Kayn,Yone,3364,1847,1517,54.9
Kayn,Warwick,3085,1437,1648,46.58
Kayn,Hwei,1101,579,522,52.59
Kayn,Varus,1480,804,676,54.32
Kayn,Malphite,1891,966,925,51.08
Kayn,Ambessa,1045,575,470,55.02
Kayn,Graves,1225,571,654,46.61
Kayn,Akali,1844,974,870,52.82
Kayn,Anivia,608,280,328,46.05
Kayn,Renekton,836,432,404,51.67
Kayn,Corki,843,498,345,59.07
Kayn,Sion,1350,709,641,52.52
Kayn,Ezreal,4068,2078,1990,51.08
Kayn,Teemo,2360,1087,1273,46.06
Kayn,Mordekaiser,2442,1205,1237,49.34
Kayn,Vi,1688,846,842,50.12
Kayn,Vex,934,467,467,50
Kayn,Seraphine,1340,677,663,50.52
Kayn,Orianna,739,347,392,46.96
Kayn,Tristana,1890,936,954,49.52
Kayn,Lux,4619,2319,2300,50.21
Kayn,Yorick,1940,1022,918,52.68
Kayn,Kindred,912,449,463,49.23
Kayn,Veigar,1926,939,987,48.75
Kayn,Nautilus,1974,1032,942,52.28
Kayn,Blitzcrank,1182,605,577,51.18
Kayn,Zed,2276,1186,1090,52.11
Kayn,Xayah,714,353,361,49.44
Kayn,Karma,2010,973,1037,48.41
Kayn,Nunu,889,437,452,49.16
Kayn,Qiyana,472,286,186,60.59
Kayn,Morgana,2174,1066,1108,49.03
Kayn,Sett,2677,1328,1349,49.61
Kayn,XinZhao,1139,612,527,53.73
Kayn,Fizz,1127,565,562,50.13
Kayn,Vayne,2453,1193,1260,48.63
Kayn,Shen,1143,615,528,53.81
Kayn,Amumu,2030,1007,1023,49.61
Kayn,Jhin,3823,2023,1800,52.92
Kayn,TahmKench,1372,713,659,51.97
Kayn,Sejuani,743,404,339,54.37
Kayn,Sylas,2188,1241,947,56.72
Kayn,Shaco,1757,860,897,48.95
Kayn,Gangplank,896,422,474,47.1
Kayn,RekSai,194,81,113,41.75
Kayn,Xerath,1688,806,882,47.75
Kayn,Gnar,655,325,330,49.62
Kayn,Rammus,515,260,255,50.49
Kayn,Soraka,1021,493,528,48.29
Kayn,Briar,1383,647,736,46.78
Kayn,Yasuo,3639,1881,1758,51.69
Kayn,Trundle,1094,568,526,51.92
Kayn,Malzahar,2002,923,1079,46.1
Kayn,Pyke,1425,775,650,54.39
Kayn,Gragas,882,446,436,50.57
Kayn,Braum,1030,482,548,46.8
Kayn,Nasus,1274,632,642,49.61
Kayn,Ahri,2310,1160,1150,50.22
Kayn,Rell,822,400,422,48.66
Kayn,Swain,1652,795,857,48.12
Kayn,Talon,952,496,456,52.1
Kayn,Ziggs,676,378,298,55.92
Kayn,Zeri,620,311,309,50.16
Kayn,Senna,1390,701,689,50.43
Kayn,Ivern,228,130,98,57.02
Kayn,Kassadin,386,244,142,63.21
Kayn,MissFortune,4435,2255,2180,50.85
Kayn,Shyvana,518,255,263,49.23
Kayn,Milio,1132,474,658,41.87
Kayn,Viego,2820,1493,1327,52.94
Kayn,AurelionSol,667,327,340,49.03
Kayn,Nami,1820,865,955,47.53
Kayn,Ornn,724,344,380,47.51
Kayn,Rumble,496,278,218,56.05
Kayn,Tryndamere,1134,562,572,49.56
Kayn,Yuumi,1369,696,673,50.84
Kayn,Kayle,1205,573,632,47.55
Kayn,Belveth,435,238,197,54.71
Kayn,Camille,598,282,316,47.16
Kayn,Alistar,692,358,334,51.73
Kayn,Nidalee,486,290,196,59.67
Kayn,Draven,906,462,444,50.99
Kayn,Illaoi,883,443,440,50.17
Kayn,Kaisa,2762,1396,1366,50.54
Kayn,Gwen,844,428,416,50.71
Kayn,Taliyah,403,186,217,46.15
Kayn,Poppy,1047,476,571,45.46
Kayn,Rengar,620,328,292,52.9
Kayn,Zoe,624,294,330,47.12
Kayn,Leblanc,987,517,470,52.38
Kayn,Chogath,2174,1066,1108,49.03
Kayn,Aatrox,1571,861,710,54.81
Kayn,Bard,551,273,278,49.55
Kayn,Velkoz,1128,587,541,52.04
Kayn,MonkeyKing,1361,654,707,48.05
Kayn,Naafiri,640,304,336,47.5
Kayn,Sivir,928,458,470,49.35
Kayn,Urgot,954,410,544,42.98
Kayn,Jayce,739,374,365,50.61
Kayn,Udyr,765,438,327,57.25
Kayn,Volibear,2340,1205,1135,51.5
Kayn,JarvanIV,1074,539,535,50.19
Kayn,Quinn,680,296,384,43.53
Kayn,Brand,1405,740,665,52.67
Kayn,Galio,1422,741,681,52.11
Kayn,Kled,339,155,184,45.72
Kayn,FiddleSticks,1069,531,538,49.67
Kayn,Zilean,595,302,293,50.76
Kayn,Annie,584,303,281,51.88
Kayn,Olaf,390,196,194,50.26
Kayn,Kennen,396,195,201,49.24
Kayn,TwistedFate,615,311,304,50.57
Kayn,Hecarim,684,338,346,49.42
Kayn,Cassiopeia,516,254,262,49.22
Kayn,Maokai,806,435,371,53.97
Kayn,Janna,657,293,364,44.6
Kayn,Riven,828,432,396,52.17
Kayn,DrMundo,980,498,482,50.82
Kayn,Taric,435,213,222,48.97
Kayn,Neeko,739,391,348,52.91
Kayn,Skarner,481,285,196,59.25
Kayn,Elise,1223,601,622,49.14
Kayn,Viktor,1491,741,750,49.7
Kayn,Twitch,1552,844,708,54.38
Kayn,Fiora,675,338,337,50.07
Kayn,Lissandra,573,263,310,45.9
Kayn,KSante,854,506,348,59.25
Kayn,Lillia,1003,510,493,50.85
Kayn,Karthus,529,282,247,53.31
Kayn,Rakan,628,354,274,56.37
Kayn,Aphelios,935,489,446,52.3
Kayn,Renata,300,154,146,51.33
Kayn,Singed,497,286,211,57.55
Kayn,Kalista,409,234,175,57.21
Kayn,Ryze,575,271,304,47.13
Kayn,Nilah,596,288,308,48.32
Kayn,Heimerdinger,910,421,489,46.26
Kayn,Akshan,659,298,361,45.22
Kayn,Sona,626,292,334,46.65
Mel,Jax,2211,1156,1055,52.28
Mel,Nocturne,3241,1332,1909,41.1
Mel,Syndra,1501,700,801,46.64
Mel,Smolder,1646,843,803,51.22
Mel,Zyra,2427,1219,1208,50.23
Mel,Renekton,1246,657,589,52.73
Mel,Viktor,2622,1226,1396,46.76
Mel,Xayah,1109,497,612,44.82
Mel,Pyke,1909,931,978,48.77
Mel,Teemo,3409,1546,1863,45.35
Mel,FiddleSticks,1231,612,619,49.72
Mel,Yone,4538,2227,2311,49.07
Mel,Nilah,767,292,475,38.07
Mel,Rell,1293,612,681,47.33
Mel,Garen,4204,1954,2250,46.48
Mel,Sejuani,957,432,525,45.14
Mel,Katarina,2160,979,1181,45.32
Mel,Varus,2244,1137,1107,50.67
Mel,Yuumi,2045,969,1076,47.38
Mel,Ornn,851,429,422,50.41
Mel,Kayn,3660,1737,1923,47.46
Mel,Yasuo,5396,2585,2811,47.91
Mel,Caitlyn,6806,3260,3546,47.9
Mel,Morgana,2979,1414,1565,47.47
Mel,Pantheon,4053,1956,2097,48.26
Mel,Evelynn,851,400,451,47
Mel,Ekko,2560,1253,1307,48.95
Mel,Jinx,7629,3506,4123,45.96
Mel,Zac,1286,652,634,50.7
Mel,Khazix,1243,610,633,49.07
Mel,Samira,1717,912,805,53.12
Mel,Leona,2508,1169,1339,46.61
Mel,Urgot,1203,560,643,46.55
Mel,Talon,1430,673,757,47.06
Mel,Ahri,2431,1182,1249,48.62
Mel,Aphelios,1339,667,672,49.81
Mel,Maokai,1075,519,556,48.28
Mel,Rumble,645,311,334,48.22
Mel,Shaco,2521,1246,1275,49.42
Mel,Veigar,2466,1183,1283,47.97
Mel,Lux,6426,3228,3198,50.23
Mel,Singed,761,355,406,46.65
Mel,Viego,3717,1774,1943,47.73
Mel,Zed,2679,1321,1358,49.31
Mel,Zeri,1024,509,515,49.71
Mel,Milio,1443,566,877,39.22
Mel,Amumu,2630,1183,1447,44.98
Mel,Galio,2325,1072,1253,46.11
Mel,Warwick,3617,1573,2044,43.49
Mel,Shen,1442,726,716,50.35
Mel,Velkoz,1501,722,779,48.1
Mel,Rakan,1115,529,586,47.44
Mel,Fiora,933,403,530,43.19
Mel,Graves,1600,816,784,51
Mel,Azir,1000,475,525,47.5
Mel,Ashe,5107,2457,2650,48.11
Mel,Braum,1336,573,763,42.89
Mel,Skarner,626,304,322,48.56
Mel,Irelia,2174,1123,1051,51.66
Mel,MissFortune,6165,2874,3291,46.62
Mel,Alistar,1202,583,619,48.5
Mel,Yorick,2459,1049,1410,42.66
Mel,Rammus,674,325,349,48.22
Mel,Swain,2386,1160,1226,48.62
Mel,Sett,3877,1760,2117,45.4
Mel,Ziggs,1017,418,599,41.1
Mel,Kaisa,4284,1964,2320,45.85
Mel,Trundle,1506,654,852,43.43
Mel,Vi,2476,1199,1277,48.42
Mel,Fizz,2063,977,1086,47.36
Mel,Sivir,1395,686,709,49.18
Mel,Diana,4474,2045,2429,45.71
Mel,Draven,1343,656,687,48.85
Mel,Aatrox,2233,1061,1172,47.51
Mel,Darius,4720,2181,2539,46.21
Mel,TahmKench,1945,959,986,49.31
Mel,Ivern,296,150,146,50.68
Mel,Nunu,1327,656,671,49.43
Mel,JarvanIV,1475,662,813,44.88
Mel,Twitch,2073,1042,1031,50.27
Mel,Lulu,3445,1590,1855,46.15
Mel,Kayle,1819,894,925,49.15
Mel,Briar,1925,835,1090,43.38
Mel,Malzahar,2909,1389,1520,47.75
Mel,Brand,1838,898,940,48.86
Mel,KogMaw,782,322,460,41.18
Mel,Mordekaiser,3324,1481,1843,44.55
Mel,Lucian,1853,931,922,50.24
Mel,Nami,2274,1077,1197,47.36
Mel,Rengar,889,461,428,51.86
Mel,Akali,2901,1379,1522,47.54
Mel,Jhin,5399,2532,2867,46.9
Mel,Ezreal,6023,2969,3054,49.29
Mel,Sona,812,361,451,44.46
Mel,Naafiri,869,446,423,51.32
Mel,Nidalee,626,289,337,46.17
Mel,Renata,288,133,155,46.18
Mel,Volibear,2867,1450,1417,50.58
Mel,Xerath,2974,1357,1617,45.63
Mel,Illaoi,1168,552,616,47.26
Mel,XinZhao,1727,776,951,44.93
Mel,Sylas,3768,1802,1966,47.82
Mel,Vex,1077,551,526,51.16
Mel,MasterYi,3238,1556,1682,48.05
Mel,Karthus,730,359,371,49.18
Mel,Gangplank,1257,632,625,50.28
Mel,Lillia,1260,576,684,45.71
Mel,Karma,3144,1426,1718,45.36
Mel,DrMundo,1416,662,754,46.75
Mel,AurelionSol,1307,591,716,45.22
Mel,Udyr,998,517,481,51.8
Mel,Vladimir,1850,875,975,47.3
Mel,Poppy,1437,686,751,47.74
Mel,Tristana,2511,1170,1341,46.59
Mel,Thresh,3169,1517,1652,47.87
Mel,Tryndamere,1556,783,773,50.32
Mel,Soraka,1634,732,902,44.8
Mel,Riven,1122,502,620,44.74
Mel,Vayne,3386,1565,1821,46.22
Mel,Taliyah,620,286,334,46.13
Mel,Kalista,637,282,355,44.27
Mel,KSante,1285,618,667,48.09
Mel,Seraphine,1727,817,910,47.31
Mel,Gragas,1248,641,607,51.36
Mel,Janna,853,431,422,50.53
Mel,Gnar,963,461,502,47.87
Mel,Orianna,1432,611,821,42.67
Mel,Gwen,1134,587,547,51.76
Mel,TwistedFate,719,340,379,47.29
Mel,Shyvana,613,320,293,52.2
Mel,Nautilus,2837,1281,1556,45.15
Mel,Corki,952,474,478,49.79
Mel,Zilean,777,364,413,46.85
Mel,Heimerdinger,1178,563,615,47.79
Mel,Kled,454,218,236,48.02
Mel,Kassadin,754,375,379,49.73
Mel,Malphite,2540,1187,1353,46.73
Mel,Ambessa,1459,765,694,52.43
Mel,Chogath,3225,1471,1754,45.61
Mel,Annie,872,406,466,46.56
Mel,Aurora,1713,820,893,47.87
Mel,Kindred,992,432,560,43.55
Mel,Sion,1793,846,947,47.18
Mel,MonkeyKing,1773,816,957,46.02
Mel,Hwei,1620,728,892,44.94
Mel,Nasus,1920,863,1057,44.95
Mel,Anivia,789,371,418,47.02
Mel,Quinn,1005,435,570,43.28
Mel,Jayce,1184,563,621,47.55
Mel,Ryze,870,385,485,44.25
Mel,Blitzcrank,1684,867,817,51.48
Mel,Qiyana,602,291,311,48.34
Mel,Hecarim,1084,549,535,50.65
Mel,Cassiopeia,820,370,450,45.12
Mel,LeeSin,3963,1956,2007,49.36
Mel,Taric,576,283,293,49.13
Mel,Camille,927,453,474,48.87
Mel,Lissandra,787,368,419,46.76
Mel,Zoe,830,402,428,48.43
Mel,Belveth,549,264,285,48.09
Mel,Leblanc,1343,676,667,50.34
Mel,Bard,745,338,407,45.37
Mel,Elise,1607,760,847,47.29
Mel,Senna,1976,922,1054,46.66
Mel,Neeko,1124,550,574,48.93
Mel,Kennen,647,314,333,48.53
Mel,RekSai,299,159,140,53.18
Mel,Olaf,594,309,285,52.02
Mel,Akshan,843,383,460,45.43
Jinx,Jax,3509,1838,1671,52.38
Jinx,Nocturne,4687,2313,2374,49.35
Jinx,Syndra,2272,1085,1187,47.76
Jinx,Smolder,2376,1270,1106,53.45
Jinx,Zyra,3562,1764,1798,49.52
Jinx,Warwick,5473,2649,2824,48.4
Jinx,Khazix,1725,934,791,54.14
Jinx,Yorick,3660,1798,1862,49.13
Jinx,Vayne,5252,2713,2539,51.66
Jinx,Lulu,4949,2606,2343,52.66
Jinx,Darius,7128,3625,3503,50.86
Jinx,Zac,1569,730,839,46.53
Jinx,Malzahar,3952,2032,1920,51.42
Jinx,Ziggs,1387,717,670,51.69
Jinx,Sona,1291,665,626,51.51
Jinx,Volibear,4347,2234,2113,51.39
Jinx,Zoe,1336,663,673,49.63
Jinx,Samira,2815,1471,1344,52.26
Jinx,Pantheon,5632,2991,2641,53.11
Jinx,Gangplank,1896,980,916,51.69
Jinx,Kayn,5266,2746,2520,52.15
Jinx,Mel,7629,4122,3507,54.03
Jinx,MissFortune,10463,5283,5180,50.49
Jinx,Thresh,4891,2498,2393,51.07
Jinx,Chogath,4564,2339,2225,51.25
Jinx,Kindred,1790,913,877,51.01
Jinx,Katarina,2745,1439,1306,52.42
Jinx,Tristana,4046,2059,1987,50.89
Jinx,Neeko,1564,816,748,52.17
Jinx,Azir,1295,703,592,54.29
Jinx,Jhin,8354,4397,3957,52.63
Jinx,Senna,2819,1446,1373,51.29
Jinx,Urgot,1949,943,1006,48.38
Jinx,Briar,2832,1398,1434,49.36
Jinx,Ahri,4748,2510,2238,52.86
Jinx,Caitlyn,12343,6289,6054,50.95
Jinx,Lux,8716,4322,4394,49.59
Jinx,Singed,1062,551,511,51.88
Jinx,Shaco,3426,1820,1606,53.12
Jinx,Hwei,2376,1189,1187,50.04
Jinx,Janna,1286,615,671,47.82
Jinx,FiddleSticks,1890,1014,876,53.65
Jinx,Yone,6719,3614,3105,53.79
Jinx,Varus,3551,1823,1728,51.34
Jinx,Zilean,1167,555,612,47.56
Jinx,Talon,2162,1149,1013,53.15
Jinx,Aphelios,2391,1240,1151,51.86
Jinx,Maokai,1592,798,794,50.13
Jinx,Viego,5371,2729,2642,50.81
Jinx,Zed,4058,2131,1927,52.51
Jinx,Zeri,1725,883,842,51.19
Jinx,Milio,2066,1013,1053,49.03
Jinx,Evelynn,1223,601,622,49.14
Jinx,Nami,4004,2090,1914,52.2
Jinx,Sett,5329,2736,2593,51.34
Jinx,Nasus,2759,1330,1429,48.21
Jinx,Aurora,2576,1385,1191,53.77
Jinx,Lillia,1864,972,892,52.15
Jinx,Renata,702,346,356,49.29
Jinx,Renekton,1840,910,930,49.46
Jinx,Shyvana,865,450,415,52.02
Jinx,Veigar,3844,2000,1844,52.03
Jinx,Yasuo,7192,3641,3551,50.63
Jinx,Xerath,3230,1575,1655,48.76
Jinx,Ekko,3515,1718,1797,48.88
Jinx,Rammus,1244,647,597,52.01
Jinx,Swain,3576,1775,1801,49.64
Jinx,Tryndamere,2298,1141,1157,49.65
Jinx,Poppy,2093,1096,997,52.37
Jinx,Kassadin,741,397,344,53.58
Jinx,Ashe,8996,4560,4436,50.69
Jinx,Soraka,2072,1006,1066,48.55
Jinx,Velkoz,2219,1116,1103,50.29
Jinx,Garen,6051,3100,2951,51.23
Jinx,Irelia,2996,1525,1471,50.9
Jinx,Rengar,1196,606,590,50.67
Jinx,Fizz,2095,1043,1052,49.79
Jinx,KogMaw,1381,631,750,45.69
Jinx,Kaisa,6892,3613,3279,52.42
Jinx,Gragas,2045,1090,955,53.3
Jinx,Quinn,1402,681,721,48.57
Jinx,Vladimir,2565,1274,1291,49.67
Jinx,Ezreal,9677,5124,4553,52.95
Jinx,Brand,2749,1458,1291,53.04
Jinx,Hecarim,1594,870,724,54.58
Jinx,Lissandra,1303,633,670,48.58
Jinx,Lucian,2827,1522,1305,53.84
Jinx,TahmKench,2679,1467,1212,54.76
Jinx,Twitch,3876,1907,1969,49.2
Jinx,Mordekaiser,4876,2346,2530,48.11
Jinx,LeeSin,5544,2892,2652,52.16
Jinx,Nilah,1129,601,528,53.23
Jinx,Braum,1949,949,1000,48.69
Jinx,Diana,6082,3147,2935,51.74
Jinx,Leona,3124,1623,1501,51.95
Jinx,Olaf,800,371,429,46.38
Jinx,Trundle,2154,1176,978,54.6
Jinx,Vex,1903,1021,882,53.65
Jinx,Pyke,2871,1442,1429,50.23
Jinx,Nunu,1810,935,875,51.66
Jinx,Aatrox,3471,1853,1618,53.39
Jinx,Teemo,4450,2317,2133,52.07
Jinx,Sylas,5027,2657,2370,52.85
Jinx,Morgana,4440,2254,2186,50.77
Jinx,Skarner,829,462,367,55.73
Jinx,Blitzcrank,2439,1292,1147,52.97
Jinx,Sion,2673,1349,1324,50.47
Jinx,Udyr,1401,741,660,52.89
Jinx,Ryze,1234,620,614,50.24
Jinx,Anivia,1251,626,625,50.04
Jinx,Gwen,1767,961,806,54.39
Jinx,JarvanIV,2390,1149,1241,48.08
Jinx,Annie,1278,663,615,51.88
Jinx,Riven,1718,926,792,53.9
Jinx,Jayce,1977,958,1019,48.46
Jinx,Gnar,1451,743,708,51.21
Jinx,Ambessa,2160,1199,961,55.51
Jinx,Malphite,3829,1957,1872,51.11
Jinx,MasterYi,4709,2339,2370,49.67
Jinx,Naafiri,1108,609,499,54.96
Jinx,Akali,3806,1859,1947,48.84
Jinx,Seraphine,2734,1356,1378,49.6
Jinx,Orianna,1671,843,828,50.45
Jinx,Sejuani,1494,772,722,51.67
Jinx,Bard,1088,552,536,50.74
Jinx,Taric,825,452,373,54.79
Jinx,Elise,2585,1305,1280,50.48
Jinx,Fiora,1299,720,579,55.43
Jinx,Karthus,1084,570,514,52.58
Jinx,Akshan,1271,628,643,49.41
Jinx,Kayle,2595,1274,1321,49.09
Jinx,Belveth,881,505,376,57.32
Jinx,Shen,2208,1221,987,55.3
Jinx,Heimerdinger,1694,813,881,47.99
Jinx,Xayah,1527,798,729,52.26
Jinx,Kennen,896,419,477,46.76
Jinx,Viktor,3589,1809,1780,50.4
Jinx,MonkeyKing,2626,1343,1283,51.14
Jinx,Rakan,1392,758,634,54.45
Jinx,Cassiopeia,1093,580,513,53.06
Jinx,Draven,2006,1040,966,51.84
Jinx,Rell,1658,860,798,51.87
Jinx,Galio,3189,1630,1559,51.11
Jinx,Karma,4572,2297,2275,50.24
Jinx,KSante,2032,1104,928,54.33
Jinx,Amumu,3833,1883,1950,49.13
Jinx,Leblanc,2226,1148,1078,51.57
Jinx,Qiyana,779,409,370,52.5
Jinx,Illaoi,1652,797,855,48.24
Jinx,Taliyah,879,466,413,53.01
Jinx,Kled,635,315,320,49.61
Jinx,Vi,3560,1856,1704,52.13
Jinx,Rumble,1030,587,443,56.99
Jinx,DrMundo,2177,1139,1038,52.32
Jinx,TwistedFate,1304,731,573,56.06
Jinx,Nautilus,3964,2181,1783,55.02
Jinx,XinZhao,2455,1234,1221,50.26
Jinx,Sivir,2011,1031,980,51.27
Jinx,Ivern,465,232,233,49.89
Jinx,Kalista,844,469,375,55.57
Jinx,Nidalee,995,546,449,54.87
Jinx,Camille,1292,715,577,55.34
Jinx,Graves,2578,1388,1190,53.84
Jinx,Ornn,1521,747,774,49.11
Jinx,Alistar,1544,840,704,54.4
Jinx,Yuumi,2908,1531,1377,52.65
Jinx,AurelionSol,1427,726,701,50.88
Jinx,RekSai,420,243,177,57.86
Jinx,Corki,1468,729,739,49.66
Thresh,Jax,1507,803,704,53.28
Thresh,Nocturne,2248,1087,1161,48.35
Thresh,Syndra,1084,555,529,51.2
Thresh,Smolder,1063,581,482,54.66
Thresh,Zyra,1574,756,818,48.03
Thresh,Garen,2728,1265,1463,46.37
Thresh,Diana,2863,1476,1387,51.55
Thresh,Sylas,2668,1425,1243,53.41
Thresh,Kaisa,3096,1618,1478,52.26
Thresh,Pyke,1461,821,640,56.19
Thresh,Warwick,2490,1230,1260,49.4
Thresh,Briar,1109,577,532,52.03
Thresh,Zed,1994,1058,936,53.06
Thresh,Ziggs,558,246,312,44.09
Thresh,Xerath,1571,791,780,50.35
Thresh,Mordekaiser,2138,1024,1114,47.9
Thresh,Kayn,2281,1115,1166,48.88
Thresh,Talon,1009,565,444,56
Thresh,MissFortune,3765,1831,1934,48.63
Thresh,Lulu,2769,1451,1318,52.4
Thresh,Pantheon,2577,1315,1262,51.03
Thresh,Evelynn,496,258,238,52.02
Thresh,Ekko,1641,803,838,48.93
Thresh,Jinx,4891,2390,2501,48.87
Thresh,Gnar,744,390,354,52.42
Thresh,Azir,634,354,280,55.84
Thresh,Varus,1568,825,743,52.61
Thresh,Nautilus,2163,1165,998,53.86
Thresh,Ornn,633,305,328,48.18
Thresh,Malzahar,1782,845,937,47.42
Thresh,Vayne,2345,1192,1153,50.83
Thresh,Aatrox,1868,977,891,52.3
Thresh,Khazix,867,456,411,52.6
Thresh,Fizz,973,488,485,50.15
Thresh,Lux,4288,2096,2192,48.88
Thresh,Neeko,696,343,353,49.28
Thresh,Singed,511,243,268,47.55
Thresh,Shaco,1506,781,725,51.86
Thresh,Hwei,1152,559,593,48.52
Thresh,Jhin,3503,1795,1708,51.24
Thresh,Janna,582,266,316,45.7
Thresh,Trundle,915,477,438,52.13
Thresh,Volibear,1866,934,932,50.05
Thresh,Viktor,1596,791,805,49.56
Thresh,Xayah,854,412,442,48.24
Thresh,Viego,2726,1401,1325,51.39
Thresh,Aurora,1239,614,625,49.56
Thresh,Yorick,1585,713,872,44.98
Thresh,Elise,1333,665,668,49.89
Thresh,Corki,724,373,351,51.52
Thresh,Milio,1005,498,507,49.55
Thresh,Vi,1608,889,719,55.29
Thresh,Ahri,2122,1079,1043,50.85
Thresh,Sett,2434,1232,1202,50.62
Thresh,MonkeyKing,1312,648,664,49.39
Thresh,Anivia,557,282,275,50.63
Thresh,Ivern,243,150,93,61.73
Thresh,Veigar,1441,683,758,47.4
Thresh,Brand,1178,580,598,49.24
Thresh,Rammus,543,267,276,49.17
Thresh,Swain,1743,787,956,45.15
Thresh,Chogath,1936,938,998,48.45
Thresh,Sivir,933,454,479,48.66
Thresh,Sejuani,804,382,422,47.51
Thresh,Caitlyn,4453,2262,2191,50.8
Thresh,Karma,2422,1204,1218,49.71
Thresh,DrMundo,865,442,423,51.1
Thresh,MasterYi,2010,1021,989,50.8
Thresh,Irelia,1425,749,676,52.56
Thresh,Malphite,1791,912,879,50.92
Thresh,LeeSin,3058,1642,1416,53.7
Thresh,Nilah,454,191,263,42.07
Thresh,Braum,1329,686,643,51.62
Thresh,Udyr,686,317,369,46.21
Thresh,FiddleSticks,891,502,389,56.34
Thresh,Kennen,487,227,260,46.61
Thresh,Taric,462,239,223,51.73
Thresh,Leblanc,1197,603,594,50.38
Thresh,TahmKench,1338,710,628,53.06
Thresh,Qiyana,375,195,180,52
Thresh,Katarina,1326,650,676,49.02
Thresh,Ezreal,4790,2459,2331,51.34
Thresh,Akali,1830,966,864,52.79
Thresh,Zilean,590,272,318,46.1
Thresh,Gragas,1022,573,449,56.07
Thresh,Amumu,1525,690,835,45.25
Thresh,Camille,659,335,324,50.83
Thresh,Nami,1718,860,858,50.06
Thresh,Urgot,776,366,410,47.16
Thresh,Darius,3335,1668,1667,50.01
Thresh,Teemo,1909,961,948,50.34
Thresh,Graves,1391,696,695,50.04
Thresh,Samira,1080,612,468,56.67
Thresh,Shen,1077,491,586,45.59
Thresh,Riven,811,417,394,51.42
Thresh,Fiora,670,351,319,52.39
Thresh,Seraphine,1137,563,574,49.52
Thresh,Velkoz,1031,520,511,50.44
Thresh,JarvanIV,1212,655,557,54.04
Thresh,Zeri,780,414,366,53.08
Thresh,Mel,3169,1649,1520,52.04
Thresh,Jayce,982,499,483,50.81
Thresh,Soraka,915,431,484,47.1
Thresh,Vex,915,463,452,50.6
Thresh,Tryndamere,961,479,482,49.84
Thresh,Taliyah,489,200,289,40.9
Thresh,Yasuo,3351,1798,1553,53.66
Thresh,Poppy,1099,529,570,48.13
Thresh,Tristana,1595,808,787,50.66
Thresh,Leona,1669,848,821,50.81
Thresh,KogMaw,495,237,258,47.88
Thresh,Morgana,2140,1014,1126,47.38
Thresh,Vladimir,1103,571,532,51.77
Thresh,Yone,3247,1759,1488,54.17
Thresh,Yuumi,1455,811,644,55.74
Thresh,Rengar,507,277,230,54.64
Thresh,Belveth,414,197,217,47.58
Thresh,Kayle,1089,529,560,48.58
Thresh,Shyvana,430,178,252,41.4
Thresh,AurelionSol,566,287,279,50.71
Thresh,Ashe,3634,1837,1797,50.55
Thresh,Renata,297,158,139,53.2
Thresh,Blitzcrank,1365,725,640,53.11
Thresh,Illaoi,709,338,371,47.67
Thresh,TwistedFate,678,316,362,46.61
Thresh,Lucian,1218,657,561,53.94
Thresh,Rakan,730,394,336,53.97
Thresh,Kled,289,126,163,43.6
Thresh,Nasus,1080,550,530,50.93
Thresh,Senna,1248,618,630,49.52
Thresh,Orianna,724,414,310,57.18
Thresh,Renekton,917,455,462,49.62
Thresh,Quinn,581,284,297,48.88
Thresh,RekSai,184,94,90,51.09
Thresh,Karthus,531,270,261,50.85
Thresh,Draven,939,487,452,51.86
Thresh,XinZhao,1274,660,614,51.81
Thresh,Gwen,864,461,403,53.36
Thresh,Kassadin,421,228,193,54.16
Thresh,Rell,908,448,460,49.34
Thresh,Twitch,1244,622,622,50
Thresh,Galio,1631,840,791,51.5
Thresh,Lissandra,612,263,349,42.97
Thresh,Maokai,731,331,400,45.28
Thresh,Naafiri,479,251,228,52.4
Thresh,Zoe,659,316,343,47.95
Thresh,Gangplank,887,466,421,52.54
Thresh,Alistar,897,454,443,50.61
Thresh,Kindred,804,402,402,50
Thresh,Ambessa,1091,585,506,53.62
Thresh,Heimerdinger,633,311,322,49.13
Thresh,Zac,904,452,452,50
Thresh,Annie,601,336,265,55.91
Thresh,Skarner,425,223,202,52.47
Thresh,Sona,503,242,261,48.11
Thresh,Nunu,778,339,439,43.57
Thresh,Hecarim,723,366,357,50.62
Thresh,Nidalee,624,325,299,52.08
Thresh,Lillia,905,490,415,54.14
Thresh,Bard,602,290,312,48.17
Thresh,Cassiopeia,509,248,261,48.72
Thresh,KSante,986,522,464,52.94
Thresh,Aphelios,942,465,477,49.36
Thresh,Kalista,423,225,198,53.19
Thresh,Sion,1353,662,691,48.93
Thresh,Ryze,761,358,403,47.04
Thresh,Olaf,405,167,238,41.23
Thresh,Akshan,505,266,239,52.67
Thresh,Rumble,471,258,213,54.78
Garen,Yorick,1996,934,1062,46.79
Garen,Warwick,3116,1578,1538,50.64
Garen,Veigar,2143,1083,1060,50.54
Garen,Tristana,2033,1069,964,52.58
Garen,Thresh,2728,1463,1265,53.63
Garen,Gangplank,1063,581,482,54.66
Garen,Evelynn,632,327,305,51.74
Garen,Mel,4204,2250,1954,53.52
Garen,Ashe,4236,2194,2042,51.79
Garen,Elise,1509,832,677,55.14
Garen,Singed,622,332,290,53.38
Garen,Shaco,1983,1034,949,52.14
Garen,Hwei,1246,598,648,47.99
Garen,Jhin,4296,2276,2020,52.98
Garen,Janna,712,371,341,52.11
Garen,Sion,1527,807,720,52.85
Garen,Vi,2013,1081,932,53.7
Garen,Sylas,2979,1505,1474,50.52
Garen,Lucian,1396,771,625,55.23
Garen,Pantheon,3280,1609,1671,49.05
Garen,Rumble,505,230,275,45.54
Garen,Kayn,2935,1468,1467,50.02
Garen,Akshan,649,300,349,46.22
Garen,Yuumi,1673,924,749,55.23
Garen,Sett,3505,1658,1847,47.3
Garen,Nocturne,2829,1358,1471,48
Garen,Azir,645,335,310,51.94
Garen,Ezreal,5102,2662,2440,52.18
Garen,Qiyana,525,292,233,55.62
Garen,TahmKench,1666,833,833,50
Garen,LeeSin,2963,1566,1397,52.85
Garen,Karma,2566,1280,1286,49.88
Garen,Nasus,1800,982,818,54.56
Garen,Aurora,1400,762,638,54.43
Garen,Varus,1870,1047,823,55.99
Garen,Fiora,733,369,364,50.34
Garen,Graves,1418,775,643,54.65
Garen,Braum,1167,588,579,50.39
Garen,Irelia,1754,924,830,52.68
Garen,MasterYi,2798,1284,1514,45.89
Garen,Galio,1907,943,964,49.45
Garen,Draven,941,479,462,50.9
Garen,Nautilus,2313,1194,1119,51.62
Garen,Heimerdinger,930,435,495,46.77
Garen,Renata,381,208,173,54.59
Garen,Mordekaiser,2914,1314,1600,45.09
Garen,Talon,1168,668,500,57.19
Garen,Lux,5204,2635,2569,50.63
Garen,Jinx,6051,2951,3100,48.77
Garen,Darius,4695,2276,2419,48.48
Garen,Sejuani,748,401,347,53.61
Garen,Yone,3818,2050,1768,53.69
Garen,Milio,1144,561,583,49.04
Garen,Olaf,544,308,236,56.62
Garen,Diana,3492,1687,1805,48.31
Garen,Kennen,431,243,188,56.38
Garen,FiddleSticks,1075,564,511,52.47
Garen,Vladimir,1197,592,605,49.46
Garen,Zed,2541,1392,1149,54.78
Garen,Nilah,652,314,338,48.16
Garen,Fizz,1314,675,639,51.37
Garen,Samira,1352,727,625,53.77
Garen,Ambessa,1187,676,511,56.95
Garen,Hecarim,848,466,382,54.95
Garen,Katarina,1590,802,788,50.44
Garen,Nami,2142,1085,1057,50.65
Garen,Trundle,1370,745,625,54.38
Garen,JarvanIV,1340,671,669,50.07
Garen,Twitch,1616,815,801,50.43
Garen,Lulu,2687,1326,1361,49.35
Garen,Urgot,1106,575,531,51.99
Garen,Briar,1444,712,732,49.31
Garen,Zoe,724,379,345,52.35
Garen,Akali,2291,1182,1109,51.59
Garen,Sona,654,317,337,48.47
Garen,Viego,2867,1473,1394,51.38
Garen,Orianna,910,493,417,54.18
Garen,Illaoi,1052,575,477,54.66
Garen,Nunu,1143,566,577,49.52
Garen,Sivir,1167,544,623,46.62
Garen,Zyra,1863,961,902,51.58
Garen,Neeko,864,442,422,51.16
Garen,Camille,1240,599,641,48.31
Garen,XinZhao,1396,729,667,52.22
Garen,MissFortune,4974,2494,2480,50.14
Garen,Ahri,2635,1298,1337,49.26
Garen,Morgana,2436,1241,1195,50.94
Garen,KogMaw,656,303,353,46.19
Garen,Zilean,704,328,376,46.59
Garen,Vayne,3005,1458,1547,48.52
Garen,Ekko,1891,912,979,48.23
Garen,Yasuo,4486,2276,2210,50.74
Garen,Amumu,2149,1062,1087,49.42
Garen,Poppy,1198,580,618,48.41
Garen,Chogath,2567,1194,1373,46.51
Garen,Bard,591,309,282,52.28
Garen,Teemo,2729,1320,1409,48.37
Garen,Smolder,1249,642,607,51.4
Garen,Alistar,848,405,443,47.76
Garen,Corki,896,482,414,53.79
Garen,Gwen,1118,616,502,55.1
Garen,Khazix,988,539,449,54.55
Garen,Ziggs,754,416,338,55.17
Garen,Caitlyn,5836,2983,2853,51.11
Garen,Malzahar,2295,1138,1157,49.59
Garen,Rammus,654,321,333,49.08
Garen,Aphelios,1076,528,548,49.07
Garen,Volibear,2463,1261,1202,51.2
Garen,Syndra,1302,677,625,52
Garen,Xayah,975,531,444,54.46
Garen,Malphite,1997,1035,962,51.83
Garen,Riven,1014,514,500,50.69
Garen,Viktor,1885,971,914,51.51
Garen,Aatrox,1933,1012,921,52.35
Garen,Anivia,680,353,327,51.91
Garen,Tryndamere,1485,732,753,49.29
Garen,Brand,1617,870,747,53.8
Garen,Lillia,1324,697,627,52.64
Garen,Jax,2492,1395,1097,55.98
Garen,DrMundo,1185,618,567,52.15
Garen,Shyvana,644,358,286,55.59
Garen,MonkeyKing,1504,758,746,50.4
Garen,Blitzcrank,1454,741,713,50.96
Garen,Gnar,828,399,429,48.19
Garen,Karthus,622,345,277,55.47
Garen,Kaisa,3373,1725,1648,51.14
Garen,KSante,1196,706,490,59.03
Garen,AurelionSol,786,432,354,54.96
Garen,Kalista,497,258,239,51.91
Garen,Rell,867,438,429,50.52
Garen,Naafiri,689,360,329,52.25
Garen,Swain,2216,1137,1079,51.31
Garen,Leona,1756,914,842,52.05
Garen,Kayle,1647,754,893,45.78
Garen,Udyr,785,410,375,52.23
Garen,Kled,332,153,179,46.08
Garen,Renekton,1069,618,451,57.81
Garen,Gragas,1057,591,466,55.91
Garen,Taric,458,220,238,48.03
Garen,Seraphine,1466,738,728,50.34
Garen,Zac,980,489,491,49.9
Garen,Leblanc,1259,657,602,52.18
Garen,Ivern,334,180,154,53.89
Garen,Zeri,865,470,395,54.34
Garen,Skarner,482,274,208,56.85
Garen,Vex,985,530,455,53.81
Garen,Rengar,630,299,331,47.46
Garen,Taliyah,499,251,248,50.3
Garen,Rakan,803,417,386,51.93
Garen,Cassiopeia,525,290,235,55.24
Garen,Kindred,1024,506,518,49.41
Garen,Kassadin,413,221,192,53.51
Garen,Senna,1565,783,782,50.03
Garen,Soraka,1152,596,556,51.74
Garen,Xerath,1799,886,913,49.25
Garen,Velkoz,1232,585,647,47.48
Garen,Ornn,867,426,441,49.13
Garen,Shen,1307,651,656,49.81
Garen,Pyke,1589,873,716,54.94
Garen,TwistedFate,789,425,364,53.87
Garen,Lissandra,624,241,383,38.62
Garen,Belveth,447,228,219,51.01
Garen,Quinn,845,432,413,51.12
Garen,Jayce,823,475,348,57.72
Garen,RekSai,215,121,94,56.28
Garen,Ryze,698,307,391,43.98
Garen,Annie,708,374,334,52.82
Garen,Nidalee,514,319,195,62.06
Garen,Maokai,934,446,488,47.75
Diana,Yorick,2072,1043,1029,50.34
Diana,Warwick,3141,1445,1696,46
Diana,Veigar,2165,1119,1046,51.69
Diana,Tristana,1970,1045,925,53.05
Diana,Thresh,2863,1387,1476,48.45
Diana,Darius,4173,2101,2072,50.35
Diana,Zac,1033,530,503,51.31
Diana,Malzahar,2336,1223,1113,52.35
Diana,Ziggs,776,338,438,43.56
Diana,Sona,677,337,340,49.78
Diana,Mordekaiser,2803,1365,1438,48.7
Diana,Karthus,726,387,339,53.31
Diana,Katarina,1663,889,774,53.46
Diana,Jhin,4117,2099,2018,50.98
Diana,Karma,2765,1462,1303,52.88
Diana,Kayn,3146,1503,1643,47.77
Diana,Talon,1318,658,660,49.92
Diana,MissFortune,5145,2580,2565,50.15
Diana,Lulu,3140,1571,1569,50.03
Diana,Ambessa,1380,709,671,51.38
Diana,Ekko,1961,1014,947,51.71
Diana,Yasuo,3934,1959,1975,49.8
Diana,Pyke,1513,740,773,48.91
Diana,Urgot,1089,534,555,49.04
Diana,Vi,1991,1045,946,52.49
Diana,Caitlyn,5633,2980,2653,52.9
Diana,Bard,636,302,334,47.48
Diana,Fiora,738,417,321,56.5
Diana,Zed,2709,1439,1270,53.12
Diana,Swain,1956,975,981,49.85
Diana,Chogath,2369,1133,1236,47.83
Diana,Rumble,632,348,284,55.06
Diana,Akshan,625,324,301,51.84
Diana,Yuumi,1661,873,788,52.56
Diana,JarvanIV,1236,632,604,51.13
Diana,Orianna,913,534,379,58.49
Diana,Nocturne,2780,1388,1392,49.93
Diana,Xerath,1898,953,945,50.21
Diana,Volibear,2292,1143,1149,49.87
Diana,LeeSin,3791,1942,1849,51.23
Diana,Irelia,1647,862,785,52.34
Diana,MasterYi,2922,1440,1482,49.28
Diana,Galio,2240,1067,1173,47.63
Diana,Draven,1001,490,511,48.95
Diana,Nautilus,2320,1211,1109,52.2
Diana,Xayah,992,492,500,49.6
Diana,Velkoz,1200,566,634,47.17
Diana,Akali,2325,1208,1117,51.96
Diana,Lux,5174,2660,2514,51.41
Diana,Sivir,1179,541,638,45.89
Diana,Morgana,2455,1289,1166,52.51
Diana,Garen,3492,1805,1687,51.69
Diana,Smolder,1355,762,593,56.24
Diana,Kennen,630,323,307,51.27
Diana,Ashe,4412,2349,2063,53.24
Diana,Leona,1793,937,856,52.26
Diana,Trundle,1203,550,653,45.72
Diana,Graves,1459,758,701,51.95
Diana,Mel,4474,2429,2045,54.29
Diana,DrMundo,1165,607,558,52.1
Diana,Jax,2060,1027,1033,49.85
Diana,AurelionSol,724,375,349,51.8
Diana,Rakan,762,395,367,51.84
Diana,Olaf,450,225,225,50
Diana,Pantheon,3522,1872,1650,53.15
Diana,Leblanc,1452,758,694,52.2
Diana,Jinx,6082,2935,3147,48.26
Diana,Sett,3282,1560,1722,47.53
Diana,Evelynn,753,405,348,53.78
Diana,Vladimir,1422,754,668,53.02
Diana,Khazix,1027,548,479,53.36
Diana,Sejuani,871,466,405,53.5
Diana,Poppy,1234,664,570,53.81
Diana,TahmKench,1496,786,710,52.54
Diana,Shaco,2043,1094,949,53.55
Diana,Hwei,1290,611,679,47.36
Diana,Gangplank,1167,624,543,53.47
Diana,Kaisa,3651,1905,1746,52.18
Diana,Gragas,1129,600,529,53.14
Diana,Ezreal,5401,2864,2537,53.03
Diana,Annie,658,360,298,54.71
Diana,Illaoi,996,526,470,52.81
Diana,Naafiri,691,324,367,46.89
Diana,Maokai,968,506,462,52.27
Diana,Kayle,1365,726,639,53.19
Diana,Kassadin,452,223,229,49.34
Diana,Teemo,2760,1399,1361,50.69
Diana,Rammus,601,344,257,57.24
Diana,Brand,1610,749,861,46.52
Diana,Shen,1221,587,634,48.08
Diana,Zyra,2051,1071,980,52.22
Diana,Elise,1464,775,689,52.94
Diana,Fizz,1212,639,573,52.72
Diana,Samira,1384,714,670,51.59
Diana,Aatrox,1927,1009,918,52.36
Diana,Ahri,2840,1494,1346,52.61
Diana,Amumu,2348,1113,1235,47.4
Diana,Seraphine,1490,795,695,53.36
Diana,Tryndamere,1077,526,551,48.84
Diana,FiddleSticks,1119,573,546,51.21
Diana,Ryze,772,369,403,47.8
Diana,Senna,1477,718,759,48.61
Diana,Yone,3812,1985,1827,52.07
Diana,Singed,588,288,300,48.98
Diana,Braum,1152,590,562,51.22
Diana,Viego,3339,1633,1706,48.91
Diana,Gnar,810,420,390,51.85
Diana,Viktor,1826,933,893,51.1
Diana,Sylas,3320,1769,1551,53.28
Diana,KSante,1277,683,594,53.48
Diana,Rengar,611,340,271,55.65
Diana,Soraka,1043,562,481,53.88
Diana,Renekton,1051,544,507,51.76
Diana,Quinn,654,311,343,47.55
Diana,Vayne,2615,1274,1341,48.72
Diana,XinZhao,1527,772,755,50.56
Diana,Aurora,1656,817,839,49.34
Diana,Kindred,959,489,470,50.99
Diana,Nami,2171,1059,1112,48.78
Diana,Kalista,502,246,256,49
Diana,Alistar,946,485,461,51.27
Diana,Janna,720,332,388,46.11
Diana,Vex,1149,587,562,51.09
Diana,Nunu,994,488,506,49.09
Diana,Taric,459,214,245,46.62
Diana,Lillia,1203,658,545,54.7
Diana,MonkeyKing,1588,729,859,45.91
Diana,Lucian,1516,831,685,54.82
Diana,Milio,1113,570,543,51.21
Diana,Udyr,817,436,381,53.37
Diana,Syndra,1232,623,609,50.57
Diana,Blitzcrank,1456,747,709,51.3
Diana,RekSai,216,132,84,61.11
Diana,Varus,1884,971,913,51.54
Diana,Qiyana,509,279,230,54.81
Diana,Skarner,465,262,203,56.34
Diana,TwistedFate,755,422,333,55.89
Diana,Gwen,1114,598,516,53.68
Diana,Twitch,1721,860,861,49.97
Diana,Taliyah,504,258,246,51.19
Diana,Camille,767,425,342,55.41
Diana,Cassiopeia,690,321,369,46.52
Diana,Riven,878,469,409,53.42
Diana,Briar,1560,725,835,46.47
Diana,Neeko,934,484,450,51.82
Diana,Zeri,936,470,466,50.21
Diana,Jayce,1100,567,533,51.55
Diana,Nasus,1549,793,756,51.19
Diana,Azir,806,440,366,54.59
Diana,Aphelios,1143,572,571,50.04
Diana,Rell,984,515,469,52.34
Diana,Sion,1504,742,762,49.34
Diana,Zoe,729,354,375,48.56
Diana,Malphite,2034,1036,998,50.93
Diana,Shyvana,538,298,240,55.39
Diana,KogMaw,618,314,304,50.81
Diana,Kled,320,161,159,50.31
Diana,Belveth,447,227,220,50.78
Diana,Heimerdinger,875,397,478,45.37
Diana,Ornn,855,436,419,50.99
Diana,Ivern,290,173,117,59.66
Diana,Zilean,617,320,297,51.86
Diana,Nilah,582,295,287,50.69
Diana,Lissandra,740,338,402,45.68
Diana,Nidalee,658,395,263,60.03
Diana,Renata,328,167,161,50.91
Diana,Corki,813,415,398,51.05
Diana,Hecarim,800,412,388,51.5
Diana,Anivia,696,287,409,41.24
Sylas,Yorick,1399,718,681,51.32
Sylas,Warwick,2592,1236,1356,47.69
Sylas,Veigar,1551,757,794,48.81
Sylas,Tristana,1732,785,947,45.32
Sylas,Thresh,2668,1243,1425,46.59
Sylas,Malphite,2995,1595,1400,53.26
Sylas,Amumu,1854,905,949,48.81
Sylas,Ahri,2859,1443,1416,50.47
Sylas,Kaisa,3562,1742,1820,48.91
Sylas,Pyke,1496,715,781,47.79
Sylas,Garen,2979,1474,1505,49.48
Sylas,Rengar,447,217,230,48.55
Sylas,Lissandra,604,314,290,51.99
Sylas,Zyra,1806,872,934,48.28
Sylas,Riven,791,409,382,51.71
Sylas,Nocturne,2701,1342,1359,49.69
Sylas,Nilah,523,245,278,46.85
Sylas,Renekton,1056,494,562,46.78
Sylas,Shyvana,403,199,204,49.38
Sylas,Vayne,2102,985,1117,46.86
Sylas,MissFortune,4146,1906,2240,45.97
Sylas,Jax,1811,856,955,47.27
Sylas,Skarner,518,259,259,50
Sylas,Irelia,1578,841,737,53.3
Sylas,Alistar,1131,594,537,52.52
Sylas,Kayle,1073,500,573,46.6
Sylas,LeeSin,3923,1961,1962,49.99
Sylas,Yasuo,3973,1879,2094,47.29
Sylas,Caitlyn,4917,2440,2477,49.62
Sylas,Karma,2263,1076,1187,47.55
Sylas,Volibear,1844,900,944,48.81
Sylas,Smolder,1025,507,518,49.46
Sylas,Lux,4092,1889,2203,46.16
Sylas,Singed,470,242,228,51.49
Sylas,Kayn,2188,947,1241,43.28
Sylas,Galio,2310,1059,1251,45.84
Sylas,Sivir,1042,504,538,48.37
Sylas,Teemo,2090,976,1114,46.7
Sylas,Lillia,1038,480,558,46.24
Sylas,Poppy,1017,440,577,43.26
Sylas,Viego,2864,1339,1525,46.75
Sylas,Nami,1545,724,821,46.86
Sylas,Sett,2661,1145,1516,43.03
Sylas,MasterYi,2006,982,1024,48.95
Sylas,Katarina,1336,658,678,49.25
Sylas,Aphelios,856,382,474,44.63
Sylas,Trundle,931,459,472,49.3
Sylas,JarvanIV,1094,580,514,53.02
Sylas,Twitch,1240,566,674,45.65
Sylas,Lulu,2725,1346,1379,49.39
Sylas,Briar,1075,463,612,43.07
Sylas,Malzahar,1632,753,879,46.14
Sylas,Brand,1124,517,607,46
Sylas,Aatrox,1815,894,921,49.26
Sylas,Vi,2014,974,1040,48.36
Sylas,Zoe,703,315,388,44.81
Sylas,Nautilus,2343,1220,1123,52.07
Sylas,Pantheon,3010,1352,1658,44.92
Sylas,Jinx,5027,2370,2657,47.15
Sylas,Leona,1717,814,903,47.41
Sylas,Mordekaiser,2139,977,1162,45.68
Sylas,Akshan,531,251,280,47.27
Sylas,Maokai,956,429,527,44.87
Sylas,Naafiri,595,275,320,46.22
Sylas,Soraka,960,455,505,47.4
Sylas,Chogath,1989,945,1044,47.51
Sylas,Mel,3768,1966,1802,52.18
Sylas,Renata,288,162,126,56.25
Sylas,Illaoi,824,329,495,39.93
Sylas,Draven,892,458,434,51.35
Sylas,Nunu,938,456,482,48.61
Sylas,Shaco,1507,699,808,46.38
Sylas,Fizz,899,506,393,56.28
Sylas,FiddleSticks,1053,530,523,50.33
Sylas,Jhin,3491,1720,1771,49.27
Sylas,Senna,1206,533,673,44.2
Sylas,Yone,4063,1999,2064,49.2
Sylas,Sejuani,919,454,465,49.4
Sylas,Zac,1111,546,565,49.14
Sylas,Darius,3074,1506,1568,48.99
Sylas,Ekko,1749,849,900,48.54
Sylas,Taric,355,154,201,43.38
Sylas,Xayah,951,450,501,47.32
Sylas,Diana,3320,1551,1769,46.72
Sylas,Akali,2683,1353,1330,50.43
Sylas,Leblanc,1308,661,647,50.54
Sylas,Samira,1245,561,684,45.06
Sylas,Gragas,1155,573,582,49.61
Sylas,Morgana,1848,884,964,47.84
Sylas,Bard,522,235,287,45.02
Sylas,Swain,1969,886,1083,45
Sylas,Velkoz,887,419,468,47.24
Sylas,Kindred,825,382,443,46.3
Sylas,Sion,1271,577,694,45.4
Sylas,Seraphine,1312,629,683,47.94
Sylas,Vex,1158,525,633,45.34
Sylas,Hwei,1080,540,540,50
Sylas,Nasus,1172,550,622,46.93
Sylas,Tryndamere,890,466,424,52.36
Sylas,Gnar,825,418,407,50.67
Sylas,Ezreal,5477,2763,2714,50.45
Sylas,Udyr,633,326,307,51.5
Sylas,Ashe,4421,2248,2173,50.85
Sylas,TahmKench,1220,638,582,52.3
Sylas,Rammus,519,245,274,47.21
Sylas,DrMundo,875,464,411,53.03
Sylas,Zed,2334,1225,1109,52.49
Sylas,Talon,1259,632,627,50.2
Sylas,Rakan,844,436,408,51.66
Sylas,Gwen,846,419,427,49.53
Sylas,Vladimir,1251,616,635,49.24
Sylas,Olaf,416,197,219,47.36
Sylas,Ornn,814,386,428,47.42
Sylas,Graves,1328,637,691,47.97
Sylas,Anivia,599,296,303,49.42
Sylas,Blitzcrank,1554,808,746,51.99
Sylas,Sona,515,262,253,50.87
Sylas,Fiora,604,307,297,50.83
Sylas,Rell,871,400,471,45.92
Sylas,Shen,1011,499,512,49.36
Sylas,Ziggs,546,277,269,50.73
Sylas,Corki,765,393,372,51.37
Sylas,Evelynn,573,264,309,46.07
Sylas,Zeri,832,472,360,56.73
Sylas,Xerath,1738,847,891,48.73
Sylas,Urgot,776,382,394,49.23
Sylas,Aurora,1487,722,765,48.55
Sylas,Quinn,579,253,326,43.7
Sylas,Janna,486,220,266,45.27
Sylas,KSante,1206,627,579,51.99
Sylas,Milio,832,405,427,48.68
Sylas,Kennen,588,322,266,54.76
Sylas,Neeko,865,452,413,52.25
Sylas,Karthus,551,238,313,43.19
Sylas,Yuumi,1483,778,705,52.46
Sylas,Orianna,835,417,418,49.94
Sylas,Viktor,1775,914,861,51.49
Sylas,Ivern,251,110,141,43.82
Sylas,AurelionSol,520,246,274,47.31
Sylas,Syndra,908,452,456,49.78
Sylas,Zilean,593,288,305,48.57
Sylas,Gangplank,1098,530,568,48.27
Sylas,Ryze,814,373,441,45.82
Sylas,Kassadin,297,121,176,40.74
Sylas,Hecarim,851,428,423,50.29
Sylas,RekSai,196,106,90,54.08
Sylas,Lucian,1363,710,653,52.09
Sylas,Jayce,1121,517,604,46.12
Sylas,Braum,1089,524,565,48.12
Sylas,Varus,1920,937,983,48.8
Sylas,Azir,788,381,407,48.35
Sylas,Qiyana,460,213,247,46.3
Sylas,Kalista,481,265,216,55.09
Sylas,KogMaw,483,242,241,50.1
Sylas,XinZhao,1292,671,621,51.93
Sylas,Camille,695,370,325,53.24
Sylas,Heimerdinger,764,264,500,34.55
Sylas,TwistedFate,705,328,377,46.52
Sylas,Khazix,904,432,472,47.79
Sylas,MonkeyKing,1346,631,715,46.88
Sylas,Cassiopeia,589,261,328,44.31
Sylas,Taliyah,554,246,308,44.4
Sylas,Nidalee,640,358,282,55.94
Sylas,Ambessa,1275,650,625,50.98
Sylas,Elise,1431,723,708,50.52
Sylas,Rumble,623,294,329,47.19
Sylas,Belveth,362,172,190,47.51
Sylas,Kled,343,155,188,45.19
Sylas,Annie,556,267,289,48.02
Kaisa,Yorick,1867,844,1023,45.21
Kaisa,Warwick,2918,1376,1542,47.16
Kaisa,Veigar,1778,860,918,48.37
Kaisa,Tristana,2057,1003,1054,48.76
Kaisa,Thresh,3096,1478,1618,47.74
Kaisa,Riven,1017,493,524,48.48
Kaisa,Sejuani,901,446,455,49.5
Kaisa,Sylas,3562,1820,1742,51.09
Kaisa,Lucian,1688,783,905,46.39
Kaisa,Soraka,1181,536,645,45.39
Kaisa,Rakan,908,416,492,45.81
Kaisa,Ekko,2024,979,1045,48.37
Kaisa,Ashe,4638,2157,2481,46.51
Kaisa,Kayle,1265,553,712,43.72
Kaisa,Darius,4102,2024,2078,49.34
Kaisa,Malphite,2068,980,1088,47.39
Kaisa,Ezreal,8011,4180,3831,52.18
Kaisa,Nami,2122,1042,1080,49.1
Kaisa,Nocturne,3008,1365,1643,45.38
Kaisa,Nilah,581,258,323,44.41
Kaisa,Lissandra,704,332,372,47.16
Kaisa,Quinn,658,327,331,49.7
Kaisa,Trundle,1188,614,574,51.68
Kaisa,Kassadin,421,190,231,45.13
Kaisa,Caitlyn,5651,2703,2948,47.83
Kaisa,Senna,1549,756,793,48.81
Kaisa,Mordekaiser,2489,1146,1343,46.04
Kaisa,Shaco,2034,1012,1022,49.75
Kaisa,Xerath,1990,1000,990,50.25
Kaisa,Karma,3118,1499,1619,48.08
Kaisa,LeeSin,3976,2002,1974,50.35
Kaisa,Zed,2624,1346,1278,51.3
Kaisa,Lulu,3044,1357,1687,44.58
Kaisa,Heimerdinger,879,428,451,48.69
Kaisa,Kindred,1033,506,527,48.98
Kaisa,Mel,4284,2317,1967,54.08
Kaisa,Jhin,4500,2301,2199,51.13
Kaisa,Ornn,898,403,495,44.88
Kaisa,Jinx,6892,3276,3616,47.53
Kaisa,Sett,3159,1497,1662,47.39
Kaisa,Hecarim,886,440,446,49.66
Kaisa,Graves,1739,876,863,50.37
Kaisa,Irelia,1901,836,1065,43.98
Kaisa,Briar,1275,566,709,44.39
Kaisa,Vayne,3130,1564,1566,49.97
Kaisa,Pyke,1823,962,861,52.77
Kaisa,Yone,4180,2120,2060,50.72
Kaisa,Ahri,2884,1364,1520,47.3
Kaisa,Velkoz,1193,565,628,47.36
Kaisa,Teemo,2429,1137,1292,46.81
Kaisa,Morgana,2254,1104,1150,48.98
Kaisa,KSante,1377,739,638,53.67
Kaisa,Swain,2011,896,1115,44.55
Kaisa,Yasuo,4352,2123,2229,48.78
Kaisa,Lux,4864,2400,2464,49.34
Kaisa,Aatrox,2126,1010,1116,47.51
Kaisa,Viego,3126,1513,1613,48.4
Kaisa,Naafiri,725,326,399,44.97
Kaisa,Brand,1476,761,715,51.56
Kaisa,Milio,1191,547,644,45.93
Kaisa,Talon,1482,731,751,49.33
Kaisa,Malzahar,2154,983,1171,45.64
Kaisa,MissFortune,5026,2384,2642,47.43
Kaisa,Leona,1835,911,924,49.65
Kaisa,Taliyah,578,273,305,47.23
Kaisa,Blitzcrank,1404,770,634,54.84
Kaisa,Jax,2031,1017,1014,50.07
Kaisa,Vi,2178,1090,1088,50.05
Kaisa,Diana,3651,1743,1908,47.74
Kaisa,Renekton,1228,568,660,46.25
Kaisa,Rell,957,460,497,48.07
Kaisa,Volibear,2265,1111,1154,49.05
Kaisa,Sona,625,299,326,47.84
Kaisa,Xayah,1405,617,788,43.91
Kaisa,Chogath,2360,1135,1225,48.09
Kaisa,Smolder,1340,631,709,47.09
Kaisa,Renata,397,220,177,55.42
Kaisa,Amumu,2054,943,1111,45.91
Kaisa,Elise,1823,839,984,46.02
Kaisa,Fizz,1242,622,620,50.08
Kaisa,Nautilus,2275,1118,1157,49.14
Kaisa,Gragas,1165,528,637,45.32
Kaisa,Varus,1962,1049,913,53.47
Kaisa,Bard,698,348,350,49.86
Kaisa,Aurora,1606,751,855,46.76
Kaisa,Sion,1615,785,830,48.61
Kaisa,Shen,1246,611,635,49.04
Kaisa,Twitch,1618,745,873,46.04
Kaisa,Ryze,951,391,560,41.11
Kaisa,Khazix,1147,567,580,49.43
Kaisa,Vladimir,1460,716,744,49.04
Kaisa,Zilean,761,359,402,47.17
Kaisa,Tryndamere,1108,569,539,51.35
Kaisa,Akali,2476,1139,1337,46
Kaisa,Yuumi,1931,984,947,50.96
Kaisa,Nunu,1066,538,528,50.47
Kaisa,Draven,1103,479,624,43.43
Kaisa,DrMundo,1180,601,579,50.93
Kaisa,Vex,1033,517,516,50.05
Kaisa,MasterYi,2587,1221,1366,47.2
Kaisa,Kayn,2762,1366,1396,49.46
Kaisa,Viktor,2070,1021,1049,49.32
Kaisa,Gangplank,1345,640,705,47.58
Kaisa,Evelynn,669,313,356,46.79
Kaisa,Janna,779,380,399,48.78
Kaisa,Syndra,1425,726,699,50.95
Kaisa,Illaoi,953,505,448,52.99
Kaisa,Rengar,686,369,317,53.79
Kaisa,Leblanc,1509,762,747,50.5
Kaisa,Kalista,581,241,340,41.48
Kaisa,XinZhao,1557,730,827,46.89
Kaisa,Galio,2118,946,1172,44.66
Kaisa,Hwei,1389,691,698,49.75
Kaisa,Rumble,629,298,331,47.38
Kaisa,Annie,745,318,427,42.68
Kaisa,Sivir,1142,496,646,43.43
Kaisa,Qiyana,521,231,290,44.34
Kaisa,Samira,1422,737,685,51.83
Kaisa,Zac,1138,554,584,48.68
Kaisa,Katarina,1598,734,864,45.93
Kaisa,TahmKench,1510,745,765,49.34
Kaisa,Aphelios,1154,580,574,50.26
Kaisa,Gnar,891,438,453,49.16
Kaisa,Zyra,1998,948,1050,47.45
Kaisa,JarvanIV,1418,759,659,53.53
Kaisa,Orianna,995,512,483,51.46
Kaisa,Anivia,799,381,418,47.68
Kaisa,Nasus,1436,617,819,42.97
Kaisa,Pantheon,3507,1706,1801,48.65
Kaisa,Corki,926,483,443,52.16
Kaisa,Garen,3373,1648,1725,48.86
Kaisa,Maokai,1017,441,576,43.36
Kaisa,Udyr,803,396,407,49.32
Kaisa,AurelionSol,779,387,392,49.68
Kaisa,Ambessa,1432,744,688,51.96
Kaisa,Gwen,954,490,464,51.36
Kaisa,Poppy,1484,705,779,47.51
Kaisa,Ziggs,753,368,385,48.87
Kaisa,Braum,1330,606,724,45.56
Kaisa,Alistar,1008,467,541,46.33
Kaisa,Karthus,696,295,401,42.39
Kaisa,Skarner,600,329,271,54.83
Kaisa,Singed,587,294,293,50.09
Kaisa,Zeri,1046,531,515,50.76
Kaisa,Neeko,873,426,447,48.8
Kaisa,Fiora,781,359,422,45.97
Kaisa,Lillia,1192,600,592,50.34
Kaisa,KogMaw,630,248,382,39.37
Kaisa,Azir,794,401,393,50.5
Kaisa,Urgot,1043,458,585,43.91
Kaisa,MonkeyKing,1471,634,837,43.1
Kaisa,Ivern,305,128,177,41.97
Kaisa,TwistedFate,830,410,420,49.4
Kaisa,Rammus,644,311,333,48.29
Kaisa,Olaf,475,220,255,46.32
Kaisa,Seraphine,1481,695,786,46.93
Kaisa,FiddleSticks,1085,495,590,45.62
Kaisa,Jayce,1140,572,568,50.18
Kaisa,Camille,836,443,393,52.99
Kaisa,Cassiopeia,610,294,316,48.2
Kaisa,Taric,416,219,197,52.64
Kaisa,Shyvana,536,255,281,47.57
Kaisa,Akshan,630,309,321,49.05
Kaisa,Belveth,523,271,252,51.82
Kaisa,Nidalee,782,405,377,51.79
Kaisa,Kennen,591,267,324,45.18
Kaisa,Zoe,862,437,425,50.7
Kaisa,RekSai,277,162,115,58.48
Kaisa,Kled,376,196,180,52.13
Yorick,Garen,1996,1062,934,53.21
Yorick,Diana,2072,1029,1043,49.66
Yorick,Sylas,1399,681,718,48.68
Yorick,Kaisa,1867,1020,847,54.63
Yorick,Pyke,971,542,429,55.82
Yorick,Teemo,1929,1028,901,53.29
Yorick,MonkeyKing,881,481,400,54.6
Yorick,Katarina,910,464,446,50.99
Yorick,Jinx,3660,1862,1798,50.87
Yorick,Blitzcrank,790,446,344,56.46
Yorick,Nasus,973,537,436,55.19
Yorick,Nocturne,1598,738,860,46.18
Yorick,Vladimir,765,433,332,56.6
Yorick,Jhin,2598,1385,1213,53.31
Yorick,Seraphine,987,544,443,55.12
Yorick,Tryndamere,1110,596,514,53.69
Yorick,Lillia,682,366,316,53.67
Yorick,Viktor,965,511,454,52.95
Yorick,Tristana,1358,780,578,57.44
Yorick,Senna,965,549,416,56.89
Yorick,Renekton,660,368,292,55.76
Yorick,Trundle,885,470,415,53.11
Yorick,Mordekaiser,1939,983,956,50.7
Yorick,Nautilus,1435,785,650,54.7
Yorick,Darius,2442,1339,1103,54.83
Yorick,Lux,3400,1865,1535,54.85
Yorick,Lucian,888,515,373,58
Yorick,Thresh,1585,869,716,54.83
Yorick,Urgot,911,466,445,51.15
Yorick,MasterYi,1765,949,816,53.77
Yorick,Galio,1018,504,514,49.51
Yorick,Varus,1030,573,457,55.63
Yorick,Morgana,1655,881,774,53.23
Yorick,Talon,660,327,333,49.55
Yorick,Ahri,1694,875,819,51.65
Yorick,Aphelios,656,338,318,51.52
Yorick,Maokai,590,354,236,60
Yorick,Shen,856,448,408,52.34
Yorick,Amumu,1506,815,691,54.12
Yorick,Orianna,548,324,224,59.12
Yorick,Caitlyn,3551,1941,1610,54.66
Yorick,Sona,476,260,216,54.62
Yorick,Briar,1019,485,534,47.6
Yorick,Veigar,1497,784,713,52.37
Yorick,MissFortune,3346,1675,1671,50.06
Yorick,Brand,1046,528,518,50.48
Yorick,Kayn,1940,918,1022,47.32
Yorick,Rammus,382,192,190,50.26
Yorick,Xerath,1062,549,513,51.69
Yorick,Vayne,1578,829,749,52.53
Yorick,Nami,1304,690,614,52.91
Yorick,Mel,2459,1409,1050,57.3
Yorick,Poppy,670,343,327,51.19
Yorick,Kassadin,227,101,126,44.49
Yorick,Ashe,2590,1419,1171,54.79
Yorick,Soraka,722,376,346,52.08
Yorick,Jax,1137,620,517,54.53
Yorick,Ekko,1239,676,563,54.56
Yorick,Zeri,436,225,211,51.61
Yorick,Ornn,490,250,240,51.02
Yorick,Gwen,763,421,342,55.18
Yorick,Fizz,740,410,330,55.41
Yorick,Ezreal,2699,1442,1257,53.43
Yorick,Rakan,386,206,180,53.37
Yorick,Yasuo,2584,1334,1250,51.63
Yorick,Udyr,488,291,197,59.63
Yorick,Qiyana,271,142,129,52.4
Yorick,Riven,431,243,188,56.38
Yorick,Graves,679,385,294,56.7
Yorick,TahmKench,953,530,423,55.61
Yorick,Ryze,395,199,196,50.38
Yorick,Neeko,563,299,264,53.11
Yorick,Zoe,417,236,181,56.59
Yorick,Sivir,713,378,335,53.02
Yorick,Volibear,1458,781,677,53.57
Yorick,Annie,452,241,211,53.32
Yorick,Samira,859,507,352,59.02
Yorick,Yone,2441,1364,1077,55.88
Yorick,Malzahar,1473,820,653,55.67
Yorick,Belveth,290,154,136,53.1
Yorick,Corki,461,239,222,51.84
Yorick,Ambessa,588,360,228,61.22
Yorick,Singed,343,194,149,56.56
Yorick,Draven,700,413,287,59
Yorick,Elise,720,387,333,53.75
Yorick,Taliyah,210,111,99,52.86
Yorick,Zyra,1157,602,555,52.03
Yorick,RekSai,101,62,39,61.39
Yorick,Swain,1265,602,663,47.59
Yorick,Kled,200,94,106,47
Yorick,Shaco,1277,706,571,55.29
Yorick,Camille,305,171,134,56.07
Yorick,FiddleSticks,555,285,270,51.35
Yorick,Kennen,282,151,131,53.55
Yorick,Rengar,382,228,154,59.69
Yorick,Smolder,868,471,397,54.26
Yorick,Pantheon,1978,1035,943,52.33
Yorick,TwistedFate,440,257,183,58.41
Yorick,Ziggs,426,224,202,52.58
Yorick,Janna,373,180,193,48.26
Yorick,Warwick,2215,1048,1167,47.31
Yorick,Khazix,612,363,249,59.31
Yorick,Braum,593,292,301,49.24
Yorick,Bard,352,205,147,58.24
Yorick,Akali,1246,656,590,52.65
Yorick,LeeSin,1429,796,633,55.7
Yorick,Velkoz,838,454,384,54.18
Yorick,Sett,1829,943,886,51.56
Yorick,XinZhao,908,456,452,50.22
Yorick,Heimerdinger,605,308,297,50.91
Yorick,Kayle,1015,496,519,48.87
Yorick,Karma,1367,697,670,50.99
Yorick,Akshan,471,259,212,54.99
Yorick,Hecarim,452,269,183,59.51
Yorick,Hwei,770,422,348,54.81
Yorick,Viego,1743,980,763,56.22
Yorick,Chogath,1825,902,923,49.42
Yorick,Sion,1045,535,510,51.2
Yorick,Sejuani,517,255,262,49.32
Yorick,Aatrox,956,527,429,55.13
Yorick,Lissandra,402,211,191,52.49
Yorick,Alistar,504,294,210,58.33
Yorick,Vi,1150,632,518,54.96
Yorick,Malphite,1243,648,595,52.13
Yorick,Kalista,238,134,104,56.3
Yorick,Evelynn,402,207,195,51.49
Yorick,Twitch,1011,497,514,49.16
Yorick,Lulu,1490,747,743,50.13
Yorick,Aurora,759,434,325,57.18
Yorick,Anivia,393,195,198,49.62
Yorick,Zilean,377,191,186,50.66
Yorick,Nunu,749,375,374,50.07
Yorick,Syndra,784,410,374,52.3
Yorick,Azir,365,222,143,60.82
Yorick,Naafiri,457,226,231,49.45
Yorick,Fiora,422,235,187,55.69
Yorick,Vex,668,336,332,50.3
Yorick,Zed,1218,671,547,55.09
Yorick,Yuumi,942,523,419,55.52
Yorick,Irelia,1208,615,593,50.91
Yorick,DrMundo,710,377,333,53.1
Yorick,Leona,1039,519,520,49.95
Yorick,JarvanIV,715,350,365,48.95
Yorick,Karthus,318,192,126,60.38
Yorick,Olaf,257,162,95,63.04
Yorick,Leblanc,665,331,334,49.77
Yorick,KSante,536,338,198,63.06
Yorick,Cassiopeia,372,209,163,56.18
Yorick,Skarner,327,218,109,66.67
Yorick,Nidalee,317,170,147,53.63
Yorick,Gragas,592,339,253,57.26
Yorick,AurelionSol,545,274,271,50.28
Yorick,Nilah,377,193,184,51.19
Yorick,Xayah,534,266,268,49.81
Yorick,Milio,746,360,386,48.26
Yorick,Shyvana,328,195,133,59.45
Yorick,Illaoi,667,404,263,60.57
Yorick,Zac,590,281,309,47.63
Yorick,Gangplank,597,278,319,46.57
Yorick,Gnar,425,224,201,52.71
Yorick,KogMaw,369,186,183,50.41
Yorick,Kindred,563,298,265,52.93
Yorick,Rell,577,322,255,55.81
Yorick,Taric,294,176,118,59.86
Yorick,Jayce,562,287,275,51.07
Yorick,Quinn,467,253,214,54.18
Yorick,Renata,165,89,76,53.94
Yorick,Rumble,238,139,99,58.4
Yorick,Ivern,122,82,40,67.21
Warwick,Garen,3116,1537,1579,49.33
Warwick,Diana,3141,1696,1445,54
Warwick,Sylas,2592,1356,1236,52.31
Warwick,Kaisa,2918,1539,1379,52.74
Warwick,Pyke,1472,768,704,52.17
Warwick,Darius,4062,2088,1974,51.4
Warwick,Rammus,680,345,335,50.74
Warwick,Qiyana,387,235,152,60.72
Warwick,Ezreal,3879,2093,1786,53.96
Warwick,Swain,1875,920,955,49.07
Warwick,Teemo,2573,1328,1245,51.61
Warwick,MonkeyKing,1335,713,622,53.41
Warwick,Katarina,1459,835,624,57.23
Warwick,Jinx,5473,2824,2649,51.6
Warwick,Blitzcrank,1323,702,621,53.06
Warwick,DrMundo,1168,591,577,50.6
Warwick,Rengar,584,327,257,55.99
Warwick,Zilean,533,282,251,52.91
Warwick,Ashe,3736,2053,1683,54.95
Warwick,Thresh,2490,1260,1230,50.6
Warwick,Urgot,1022,473,549,46.28
Warwick,Vi,1848,1028,820,55.63
Warwick,Ekko,1811,921,890,50.86
Warwick,Caitlyn,5366,2739,2627,51.04
Warwick,Bard,496,287,209,57.86
Warwick,Irelia,1464,786,678,53.69
Warwick,Fizz,1170,616,554,52.65
Warwick,Vayne,2559,1363,1196,53.26
Warwick,Yuumi,1307,716,591,54.78
Warwick,Tryndamere,1242,694,548,55.88
Warwick,Kayn,3085,1648,1437,53.42
Warwick,Viktor,1408,727,681,51.63
Warwick,Jhin,3896,1906,1990,48.92
Warwick,Ornn,797,456,341,57.21
Warwick,Singed,520,246,274,47.31
Warwick,Ahri,2457,1306,1151,53.15
Warwick,Sett,2944,1477,1467,50.17
Warwick,Gragas,808,413,395,51.11
Warwick,Yasuo,3846,2001,1845,52.03
Warwick,Kalista,440,237,203,53.86
Warwick,Mel,3617,2044,1573,56.51
Warwick,Sion,1345,637,708,47.36
Warwick,Shaco,1895,999,896,52.72
Warwick,Malzahar,1930,975,955,50.52
Warwick,Milio,1093,550,543,50.32
Warwick,Aatrox,1507,779,728,51.69
Warwick,Graves,1109,557,552,50.23
Warwick,Malphite,1901,947,954,49.82
Warwick,Viego,2654,1426,1228,53.73
Warwick,Twitch,1604,797,807,49.69
Warwick,Lulu,2043,1020,1023,49.93
Warwick,Pantheon,2757,1407,1350,51.03
Warwick,Veigar,1960,1041,919,53.11
Warwick,Nocturne,2664,1301,1363,48.84
Warwick,Velkoz,1128,598,530,53.01
Warwick,Mordekaiser,2917,1556,1361,53.34
Warwick,LeeSin,2304,1205,1099,52.3
Warwick,Zed,2003,1041,962,51.97
Warwick,Nilah,582,283,299,48.63
Warwick,Braum,886,424,462,47.86
Warwick,Olaf,431,207,224,48.03
Warwick,Trundle,1416,750,666,52.97
Warwick,Vex,1052,583,469,55.42
Warwick,Xerath,1607,804,803,50.03
Warwick,Chogath,2341,1171,1170,50.02
Warwick,MissFortune,4825,2463,2362,51.05
Warwick,Nami,1738,807,931,46.43
Warwick,Renekton,890,474,416,53.26
Warwick,Ziggs,724,400,324,55.25
Warwick,Nasus,1437,719,718,50.03
Warwick,Amumu,2338,1174,1164,50.21
Warwick,Ryze,618,284,334,45.95
Warwick,Neeko,816,430,386,52.7
Warwick,Khazix,756,404,352,53.44
Warwick,Maokai,817,465,352,56.92
Warwick,Naafiri,691,342,349,49.49
Warwick,Nidalee,430,237,193,55.12
Warwick,Xayah,796,409,387,51.38
Warwick,Renata,343,184,159,53.64
Warwick,TahmKench,1560,845,715,54.17
Warwick,Akali,2131,1155,976,54.2
Warwick,Sona,644,296,348,45.96
Warwick,Vladimir,1054,561,493,53.23
Warwick,Zeri,732,367,365,50.14
Warwick,Galio,1618,742,876,45.86
Warwick,Udyr,790,385,405,48.73
Warwick,XinZhao,1203,630,573,52.37
Warwick,Lux,4972,2614,2358,52.57
Warwick,Leona,1635,831,804,50.83
Warwick,Akshan,637,320,317,50.24
Warwick,Draven,1030,517,513,50.19
Warwick,Sejuani,789,431,358,54.63
Warwick,Seraphine,1539,798,741,51.85
Warwick,MasterYi,2763,1446,1317,52.33
Warwick,Poppy,1052,581,471,55.23
Warwick,Ambessa,1014,586,428,57.79
Warwick,Aurora,1158,592,566,51.12
Warwick,Yorick,2215,1167,1048,52.69
Warwick,Yone,3444,1953,1491,56.71
Warwick,Varus,1497,807,690,53.91
Warwick,Belveth,446,223,223,50
Warwick,Rell,885,448,437,50.62
Warwick,Riven,830,466,364,56.14
Warwick,Ivern,237,109,128,45.99
Warwick,Smolder,1086,549,537,50.55
Warwick,Morgana,2400,1205,1195,50.21
Warwick,Gangplank,860,445,415,51.74
Warwick,Soraka,1088,569,519,52.3
Warwick,Kayle,1210,635,575,52.48
Warwick,Leblanc,994,541,453,54.43
Warwick,Samira,1438,803,635,55.84
Warwick,Rumble,479,273,206,56.99
Warwick,Karma,1848,955,893,51.68
Warwick,Gnar,760,401,359,52.76
Warwick,Shen,1135,585,550,51.54
Warwick,Cassiopeia,490,247,243,50.41
Warwick,Anivia,602,304,298,50.5
Warwick,KSante,796,399,397,50.13
Warwick,AurelionSol,747,369,378,49.4
Warwick,Zyra,1702,932,770,54.76
Warwick,Evelynn,710,364,346,51.27
Warwick,Syndra,1061,527,534,49.67
Warwick,Brand,1498,705,793,47.06
Warwick,Alistar,751,345,406,45.94
Warwick,Nunu,1017,556,461,54.67
Warwick,Taric,420,209,211,49.76
Warwick,Jax,2043,1074,969,52.57
Warwick,Volibear,2619,1443,1176,55.1
Warwick,FiddleSticks,894,454,440,50.78
Warwick,Gwen,1018,551,467,54.13
Warwick,Fiora,654,337,317,51.53
Warwick,Zoe,551,274,277,49.73
Warwick,Kassadin,325,148,177,45.54
Warwick,Hwei,1190,628,562,52.77
Warwick,Illaoi,921,487,434,52.88
Warwick,Sivir,964,517,447,53.63
Warwick,Kindred,795,400,395,50.31
Warwick,Orianna,702,387,315,55.13
Warwick,Zac,735,332,403,45.17
Warwick,RekSai,204,123,81,60.29
Warwick,Janna,541,267,274,49.35
Warwick,Quinn,709,321,388,45.28
Warwick,Elise,1033,597,436,57.79
Warwick,Nautilus,2002,1085,917,54.2
Warwick,Lucian,1212,651,561,53.71
Warwick,Talon,1126,613,513,54.44
Warwick,Kennen,399,213,186,53.38
Warwick,Senna,1416,732,684,51.69
Warwick,Rakan,682,369,313,54.11
Warwick,Briar,1538,747,791,48.57
Warwick,Jayce,665,332,333,49.92
Warwick,Azir,634,344,290,54.26
Warwick,Aphelios,886,464,422,52.37
Warwick,TwistedFate,647,340,307,52.55
Warwick,Tristana,1955,1055,900,53.96
Warwick,Lillia,1062,567,495,53.39
Warwick,JarvanIV,1054,535,519,50.76
Warwick,Annie,616,289,327,46.92
Warwick,Karthus,536,277,259,51.68
Warwick,KogMaw,598,281,317,46.99
Warwick,Corki,628,356,272,56.69
Warwick,Kled,313,166,147,53.04
Warwick,Camille,645,351,294,54.42
Warwick,Heimerdinger,935,457,478,48.88
Warwick,Lissandra,614,300,314,48.86
Warwick,Taliyah,407,196,211,48.16
Warwick,Shyvana,483,246,237,50.93
Warwick,Hecarim,608,332,276,54.61
Warwick,Skarner,407,258,149,63.39
Veigar,Garen,2143,1060,1083,49.46
Veigar,Diana,2165,1046,1119,48.31
Veigar,Sylas,1551,794,757,51.19
Veigar,Kaisa,1778,915,863,51.46
Veigar,Pyke,1015,525,490,51.72
Veigar,Illaoi,643,350,293,54.43
Veigar,Pantheon,1856,975,881,52.53
Veigar,Syndra,807,380,427,47.09
Veigar,Milio,697,354,343,50.79
Veigar,Gragas,626,320,306,51.12
Veigar,Zed,1378,615,763,44.63
Veigar,Caitlyn,3560,1806,1754,50.73
Veigar,Soraka,759,386,373,50.86
Veigar,Chogath,1633,763,870,46.72
Veigar,Kindred,592,290,302,48.99
Veigar,Katarina,1136,544,592,47.89
Veigar,Tristana,1324,717,607,54.15
Veigar,Neeko,581,305,276,52.5
Veigar,Nautilus,1373,723,650,52.66
Veigar,FiddleSticks,605,307,298,50.74
Veigar,Vladimir,785,402,383,51.21
Veigar,Jhin,2463,1218,1245,49.45
Veigar,Morgana,1779,860,919,48.34
Veigar,Mel,2466,1283,1183,52.03
Veigar,Ezreal,2608,1325,1283,50.81
Veigar,Teemo,1901,961,940,50.55
Veigar,Nasus,1041,512,529,49.18
Veigar,MasterYi,1737,855,882,49.22
Veigar,Sett,2025,1007,1018,49.73
Veigar,Aurora,811,436,375,53.76
Veigar,Varus,1124,580,544,51.6
Veigar,Fiora,375,206,169,54.93
Veigar,Nocturne,1583,763,820,48.2
Veigar,Jinx,3844,1844,2000,47.97
Veigar,Trundle,744,379,365,50.94
Veigar,Shaco,1295,638,657,49.27
Veigar,Yasuo,2546,1336,1210,52.47
Veigar,Yorick,1497,713,784,47.63
Veigar,Volibear,1558,810,748,51.99
Veigar,LeeSin,1435,759,676,52.89
Veigar,Thresh,1441,758,683,52.6
Veigar,Kayn,1926,987,939,51.25
Veigar,Rammus,386,199,187,51.55
Veigar,Xerath,1201,607,594,50.54
Veigar,Vayne,1730,858,872,49.6
Veigar,Nami,1294,653,641,50.46
Veigar,Warwick,1960,919,1041,46.89
Veigar,Kassadin,306,150,156,49.02
Veigar,Quinn,483,254,229,52.59
Veigar,Olaf,333,158,175,47.45
Veigar,Kennen,297,192,105,64.65
Veigar,Lux,3657,1819,1838,49.74
Veigar,Ashe,2635,1340,1295,50.85
Veigar,Leona,1034,541,493,52.32
Veigar,Yone,2267,1185,1082,52.27
Veigar,Fizz,1022,524,498,51.27
Veigar,Draven,690,376,314,54.49
Veigar,Rell,544,299,245,54.96
Veigar,Heimerdinger,638,341,297,53.45
Veigar,Lissandra,333,168,165,50.45
Veigar,TahmKench,1100,569,531,51.73
Veigar,DrMundo,764,380,384,49.74
Veigar,Irelia,927,532,395,57.39
Veigar,MissFortune,3418,1762,1656,51.55
Veigar,Camille,387,210,177,54.26
Veigar,Yuumi,980,529,451,53.98
Veigar,Udyr,529,299,230,56.52
Veigar,Zyra,1154,524,630,45.41
Veigar,Ahri,1801,967,834,53.69
Veigar,Malzahar,1487,729,758,49.02
Veigar,Blitzcrank,933,463,470,49.62
Veigar,Anivia,421,182,239,43.23
Veigar,Gwen,587,312,275,53.15
Veigar,Velkoz,855,430,425,50.29
Veigar,Tryndamere,795,381,414,47.92
Veigar,Annie,423,209,214,49.41
Veigar,Samira,862,475,387,55.1
Veigar,Seraphine,1008,487,521,48.31
Veigar,XinZhao,774,351,423,45.35
Veigar,Khazix,608,300,308,49.34
Veigar,Viego,1738,884,854,50.86
Veigar,Smolder,838,455,383,54.3
Veigar,Renata,170,101,69,59.41
Veigar,Ekko,1276,687,589,53.84
Veigar,Sivir,730,382,348,52.33
Veigar,Brand,1079,532,547,49.3
Veigar,Amumu,1497,764,733,51.04
Veigar,Hwei,849,469,380,55.24
Veigar,Orianna,453,244,209,53.86
Veigar,Lucian,852,429,423,50.35
Veigar,Poppy,697,402,295,57.68
Veigar,Kayle,961,459,502,47.76
Veigar,Darius,2526,1312,1214,51.94
Veigar,Jax,1203,645,558,53.62
Veigar,Rumble,293,168,125,57.34
Veigar,Gangplank,576,286,290,49.65
Veigar,Taliyah,225,109,116,48.44
Veigar,Swain,1280,629,651,49.14
Veigar,Evelynn,528,271,257,51.33
Veigar,Corki,459,252,207,54.9
Veigar,Karthus,362,201,161,55.52
Veigar,Zeri,422,249,173,59
Veigar,Lulu,1493,744,749,49.83
Veigar,Urgot,668,386,282,57.78
Veigar,Karma,1225,599,626,48.9
Veigar,Talon,572,292,280,51.05
Veigar,Akali,1338,736,602,55.01
Veigar,Naafiri,473,281,192,59.41
Veigar,KSante,566,295,271,52.12
Veigar,Kalista,305,187,118,61.31
Veigar,Ryze,463,219,244,47.3
Veigar,Galio,978,490,488,50.1
Veigar,Twitch,971,442,529,45.52
Veigar,Braum,657,347,310,52.82
Veigar,Leblanc,693,321,372,46.32
Veigar,Ambessa,609,302,307,49.59
Veigar,Alistar,474,229,245,48.31
Veigar,Nunu,634,333,301,52.52
Veigar,Taric,259,142,117,54.83
Veigar,AurelionSol,600,271,329,45.17
Veigar,Riven,566,316,250,55.83
Veigar,Sion,940,485,455,51.6
Veigar,Shyvana,334,148,186,44.31
Veigar,Briar,938,441,497,47.01
Veigar,Senna,918,456,462,49.67
Veigar,Malphite,1247,671,576,53.81
Veigar,Maokai,572,266,306,46.5
Veigar,Renekton,578,285,293,49.31
Veigar,Vex,689,321,368,46.59
Veigar,MonkeyKing,876,424,452,48.4
Veigar,Vi,1115,566,549,50.76
Veigar,Zoe,461,226,235,49.02
Veigar,Bard,318,183,135,57.55
Veigar,Viktor,1097,557,540,50.77
Veigar,Xayah,539,289,250,53.62
Veigar,TwistedFate,451,243,208,53.88
Veigar,Mordekaiser,1786,861,925,48.21
Veigar,Ornn,466,260,206,55.79
Veigar,Hecarim,454,272,182,59.91
Veigar,Rengar,386,188,198,48.7
Veigar,Elise,749,346,403,46.19
Veigar,Rakan,430,241,189,56.05
Veigar,Aphelios,650,370,280,56.92
Veigar,Janna,368,205,163,55.71
Veigar,Sejuani,505,275,230,54.46
Veigar,Zac,522,239,283,45.79
Veigar,Zilean,379,180,199,47.49
Veigar,Nidalee,319,185,134,57.99
Veigar,Graves,770,366,404,47.53
Veigar,Jayce,461,239,222,51.84
Veigar,Aatrox,1012,539,473,53.26
Veigar,Azir,329,177,152,53.8
Veigar,Sona,422,231,191,54.74
Veigar,Kled,236,108,128,45.76
Veigar,Belveth,248,141,107,56.85
Veigar,Skarner,275,150,125,54.55
Veigar,Ivern,125,76,49,60.8
Veigar,Singed,337,177,160,52.52
Veigar,Lillia,593,284,309,47.89
Veigar,Ziggs,474,233,241,49.16
Veigar,Shen,753,386,367,51.26
Veigar,Cassiopeia,379,189,190,49.87
Veigar,KogMaw,416,181,235,43.51
Veigar,Akshan,418,222,196,53.11
Veigar,Gnar,496,261,235,52.62
Veigar,JarvanIV,724,365,359,50.41
Veigar,Qiyana,311,132,179,42.44
Veigar,Nilah,373,167,206,44.77
Veigar,RekSai,144,90,54,62.5
Tristana,Garen,2033,961,1072,47.27
Tristana,Diana,1970,925,1045,46.95
Tristana,Sylas,1732,947,785,54.68
Tristana,Kaisa,2057,1054,1003,51.24
Tristana,Pyke,991,529,462,53.38
Tristana,Yorick,1358,578,780,42.56
Tristana,Rammus,401,185,216,46.13
Tristana,Yasuo,2481,1192,1289,48.05
Tristana,Caitlyn,3659,1719,1940,46.98
Tristana,Lulu,1676,851,825,50.78
Tristana,Gwen,688,325,363,47.24
Tristana,Skarner,286,161,125,56.29
Tristana,DrMundo,770,377,393,48.96
Tristana,Samira,817,358,459,43.82
Tristana,Malphite,1343,640,703,47.65
Tristana,Nocturne,1754,789,965,44.98
Tristana,Veigar,1324,607,717,45.85
Tristana,Jinx,4046,1987,2059,49.11
Tristana,Morgana,1538,790,748,51.37
Tristana,Sion,913,480,433,52.57
Tristana,Vi,1164,544,620,46.74
Tristana,Lucian,875,448,427,51.2
Tristana,Pantheon,1846,861,985,46.64
Tristana,Graves,808,382,426,47.28
Tristana,Malzahar,1427,643,784,45.06
Tristana,Lux,3205,1512,1693,47.18
Tristana,Singed,425,240,185,56.47
Tristana,Ahri,1674,861,813,51.43
Tristana,Jhin,2818,1467,1351,52.06
Tristana,Heimerdinger,539,246,293,45.64
Tristana,Kayn,1890,954,936,50.48
Tristana,Sivir,628,339,289,53.98
Tristana,Neeko,601,258,343,42.93
Tristana,Volibear,1483,676,807,45.58
Tristana,Sejuani,524,233,291,44.47
Tristana,Nautilus,1424,684,740,48.03
Tristana,Xerath,1126,526,600,46.71
Tristana,Vayne,1880,905,975,48.14
Tristana,Nami,1154,561,593,48.61
Tristana,Viktor,1031,523,508,50.73
Tristana,Janna,407,191,216,46.93
Tristana,Kayle,937,460,477,49.09
Tristana,LeeSin,1822,948,874,52.03
Tristana,Karma,1522,759,763,49.87
Tristana,Darius,2488,1204,1284,48.39
Tristana,Yone,2259,1153,1106,51.04
Tristana,Ezreal,3103,1567,1536,50.5
Tristana,Milio,739,326,413,44.11
Tristana,Smolder,822,412,410,50.12
Tristana,MasterYi,1737,857,880,49.34
Tristana,Irelia,977,487,490,49.85
Tristana,MissFortune,3665,1718,1947,46.88
Tristana,Azir,438,188,250,42.92
Tristana,TahmKench,996,491,505,49.3
Tristana,Qiyana,329,209,120,63.53
Tristana,Katarina,960,486,474,50.63
Tristana,Sett,1943,890,1053,45.81
Tristana,Aphelios,638,327,311,51.25
Tristana,Poppy,854,383,471,44.85
Tristana,Khazix,647,312,335,48.22
Tristana,Chogath,1581,740,841,46.81
Tristana,Evelynn,427,212,215,49.65
Tristana,Twitch,1158,606,552,52.33
Tristana,Ashe,2696,1430,1266,53.04
Tristana,Mordekaiser,1696,793,903,46.76
Tristana,Talon,673,350,323,52.01
Tristana,Leona,1103,547,556,49.59
Tristana,Syndra,764,341,423,44.63
Tristana,Amumu,1280,580,700,45.31
Tristana,Akshan,509,275,234,54.03
Tristana,Maokai,596,327,269,54.87
Tristana,Teemo,1638,772,866,47.13
Tristana,Swain,1289,638,651,49.5
Tristana,Ekko,1266,606,660,47.87
Tristana,Illaoi,664,368,296,55.42
Tristana,Tryndamere,746,363,383,48.66
Tristana,FiddleSticks,584,295,289,50.51
Tristana,Shaco,1205,561,644,46.56
Tristana,Mel,2511,1341,1170,53.41
Tristana,Braum,754,356,398,47.21
Tristana,Akali,1337,683,654,51.08
Tristana,JarvanIV,808,443,365,54.83
Tristana,Leblanc,701,333,368,47.5
Tristana,Xayah,601,318,283,52.91
Tristana,Yuumi,1005,533,472,53.03
Tristana,Olaf,298,152,146,51.01
Tristana,Shen,806,383,423,47.52
Tristana,Taliyah,316,157,159,49.68
Tristana,Renekton,622,311,311,50
Tristana,Thresh,1595,787,808,49.34
Tristana,Gangplank,679,336,343,49.48
Tristana,Orianna,541,284,257,52.5
Tristana,Urgot,652,329,323,50.46
Tristana,Fiora,453,233,220,51.43
Tristana,Udyr,522,260,262,49.81
Tristana,Kassadin,263,131,132,49.81
Tristana,Aatrox,1106,580,526,52.44
Tristana,Vex,719,331,388,46.04
Tristana,Hwei,787,384,403,48.79
Tristana,Nasus,876,465,411,53.08
Tristana,Senna,874,440,434,50.34
Tristana,Seraphine,956,503,453,52.62
Tristana,Jax,1267,621,646,49.01
Tristana,Naafiri,448,222,226,49.55
Tristana,Riven,551,323,228,58.62
Tristana,Galio,1122,486,636,43.32
Tristana,Anivia,497,226,271,45.47
Tristana,Briar,941,468,473,49.73
Tristana,Annie,390,211,179,54.1
Tristana,Sona,428,162,266,37.85
Tristana,Viego,1838,923,915,50.22
Tristana,MonkeyKing,942,417,525,44.27
Tristana,Blitzcrank,892,456,436,51.12
Tristana,Karthus,330,153,177,46.36
Tristana,Elise,820,434,386,52.93
Tristana,Quinn,515,238,277,46.21
Tristana,Zoe,503,275,228,54.67
Tristana,Velkoz,816,413,403,50.61
Tristana,Rakan,506,243,263,48.02
Tristana,Zed,1430,734,696,51.33
Tristana,Trundle,671,345,326,51.42
Tristana,TwistedFate,459,230,229,50.11
Tristana,Zyra,1174,562,612,47.87
Tristana,Nunu,693,358,335,51.66
Tristana,Fizz,681,366,315,53.74
Tristana,Alistar,513,273,240,53.22
Tristana,RekSai,145,76,69,52.41
Tristana,Vladimir,866,403,463,46.54
Tristana,Varus,1120,580,540,51.79
Tristana,Ivern,187,88,99,47.06
Tristana,Warwick,1955,900,1055,46.04
Tristana,Soraka,717,335,382,46.72
Tristana,Rengar,373,212,161,56.84
Tristana,Taric,282,133,149,47.16
Tristana,Gnar,499,238,261,47.7
Tristana,Kindred,550,261,289,47.45
Tristana,Rumble,362,190,172,52.49
Tristana,Ornn,521,248,273,47.6
Tristana,Draven,598,296,302,49.5
Tristana,Brand,958,478,480,49.9
Tristana,Gragas,618,330,288,53.4
Tristana,KSante,556,283,273,50.9
Tristana,Zac,480,212,268,44.17
Tristana,Jayce,524,275,249,52.48
Tristana,Kalista,308,168,140,54.55
Tristana,Rell,662,335,327,50.6
Tristana,Aurora,901,475,426,52.72
Tristana,Lillia,640,347,293,54.22
Tristana,Zilean,373,159,214,42.63
Tristana,Corki,625,328,297,52.48
Tristana,Ryze,472,215,257,45.55
Tristana,Renata,206,118,88,57.28
Tristana,Lissandra,412,190,222,46.12
Tristana,Ambessa,659,332,327,50.38
Tristana,KogMaw,413,221,192,53.51
Tristana,Nilah,363,167,196,46.01
Tristana,Ziggs,495,258,237,52.12
Tristana,Hecarim,509,251,258,49.31
Tristana,Zeri,417,177,240,42.45
Tristana,Camille,453,223,230,49.23
Tristana,Shyvana,325,155,170,47.69
Tristana,Nidalee,422,226,196,53.55
Tristana,Belveth,341,158,183,46.33
Tristana,AurelionSol,433,221,212,51.04
Tristana,Kennen,317,149,168,47
Tristana,XinZhao,891,463,428,51.96
Tristana,Cassiopeia,365,168,197,46.03
Tristana,Kled,215,97,118,45.12
Tristana,Bard,391,184,207,47.06
Riven,Malphite,656,298,358,45.43
Riven,Amumu,567,258,309,45.5
Riven,Ahri,735,346,389,47.07
Riven,Kaisa,1017,521,496,51.23
Riven,Pyke,432,227,205,52.55
Riven,Jax,556,265,291,47.66
Riven,Shaco,508,240,268,47.24
Riven,Yone,1024,585,439,57.13
Riven,KogMaw,203,102,101,50.25
Riven,Morgana,599,260,339,43.41
Riven,Nasus,367,186,181,50.68
Riven,MasterYi,704,360,344,51.14
Riven,Sylas,791,382,409,48.29
Riven,Neeko,231,119,112,51.52
Riven,Yorick,431,188,243,43.62
Riven,Udyr,255,111,144,43.53
Riven,Malzahar,616,275,341,44.64
Riven,Jhin,1173,597,576,50.9
Riven,TahmKench,396,218,178,55.05
Riven,Ivern,81,61,20,75.31
Riven,Yasuo,1302,692,610,53.15
Riven,Draven,439,204,235,46.47
Riven,Milio,388,203,185,52.32
Riven,Gwen,328,175,153,53.35
Riven,Ekko,619,320,299,51.7
Riven,Syndra,424,222,202,52.36
Riven,Pantheon,827,359,468,43.41
Riven,Renekton,493,234,259,47.46
Riven,Mordekaiser,774,358,416,46.25
Riven,Rell,326,163,163,50
Riven,Aatrox,490,226,264,46.12
Riven,Belveth,116,68,48,58.62
Riven,Jinx,1718,792,926,46.1
Riven,Lulu,895,458,437,51.17
Riven,Illaoi,252,118,134,46.83
Riven,Xerath,515,247,268,47.96
Riven,Ashe,1106,547,559,49.46
Riven,Tryndamere,307,171,136,55.7
Riven,LeeSin,889,496,393,55.79
Riven,MissFortune,1234,587,647,47.57
Riven,Thresh,811,394,417,48.58
Riven,Camille,255,139,116,54.51
Riven,Darius,1250,655,595,52.4
Riven,Warwick,830,364,466,43.86
Riven,Mel,1122,620,502,55.26
Riven,Zyra,507,268,239,52.86
Riven,Gangplank,329,169,160,51.37
Riven,Evelynn,213,98,115,46.01
Riven,Orianna,289,151,138,52.25
Riven,Leona,425,200,225,47.06
Riven,Fiora,292,142,150,48.63
Riven,Kassadin,163,77,86,47.24
Riven,Lux,1209,556,653,45.99
Riven,Garen,1014,500,514,49.31
Riven,Aurora,391,182,209,46.55
Riven,Swain,537,275,262,51.21
Riven,FiddleSticks,309,145,164,46.93
Riven,Zed,764,416,348,54.45
Riven,Caitlyn,1438,721,717,50.14
Riven,Karma,858,411,447,47.9
Riven,Gragas,336,162,174,48.21
Riven,Irelia,510,235,275,46.08
Riven,Sivir,348,169,179,48.56
Riven,Zilean,210,111,99,52.86
Riven,Sejuani,264,136,128,51.52
Riven,Azir,174,74,100,42.53
Riven,Naafiri,194,91,103,46.91
Riven,Tristana,551,228,323,41.38
Riven,Veigar,566,250,316,44.17
Riven,Ambessa,408,236,172,57.84
Riven,Kayn,828,396,432,47.83
Riven,Rakan,270,148,122,54.81
Riven,Katarina,521,257,264,49.33
Riven,Soraka,394,200,194,50.76
Riven,Nunu,263,138,125,52.47
Riven,Hwei,423,196,227,46.34
Riven,Ezreal,1505,788,717,52.36
Riven,Ryze,203,112,91,55.17
Riven,Taliyah,154,72,82,46.75
Riven,Nami,695,338,357,48.63
Riven,Teemo,651,302,349,46.39
Riven,Xayah,229,119,110,51.97
Riven,Senna,433,214,219,49.42
Riven,Corki,265,152,113,57.36
Riven,Quinn,201,99,102,49.25
Riven,Nilah,168,60,108,35.71
Riven,Fizz,340,154,186,45.29
Riven,Yuumi,508,269,239,52.95
Riven,Seraphine,385,195,190,50.65
Riven,Diana,878,409,469,46.58
Riven,Sion,397,197,200,49.62
Riven,Khazix,286,158,128,55.24
Riven,Vladimir,452,244,208,53.98
Riven,Vayne,793,434,359,54.73
Riven,Blitzcrank,445,257,188,57.75
Riven,Elise,472,235,237,49.79
Riven,Urgot,378,174,204,46.03
Riven,Karthus,187,107,80,57.22
Riven,JarvanIV,368,176,192,47.83
Riven,Leblanc,350,172,178,49.14
Riven,Sona,192,105,87,54.69
Riven,Trundle,304,131,173,43.09
Riven,Nocturne,700,320,380,45.71
Riven,Sett,860,400,460,46.51
Riven,Velkoz,358,171,187,47.77
Riven,Qiyana,192,101,91,52.6
Riven,AurelionSol,230,96,134,41.74
Riven,Viktor,541,288,253,53.23
Riven,Vi,540,247,293,45.74
Riven,KSante,314,167,147,53.18
Riven,Graves,409,213,196,52.08
Riven,Ornn,230,95,135,41.3
Riven,Viego,918,495,423,53.92
Riven,Kayle,384,191,193,49.74
Riven,TwistedFate,234,109,125,46.58
Riven,Nautilus,625,328,297,52.48
Riven,Briar,404,193,211,47.77
Riven,Braum,399,192,207,48.12
Riven,Varus,522,263,259,50.38
Riven,Nidalee,186,102,84,54.84
Riven,Akshan,188,89,99,47.34
Riven,Volibear,635,271,364,42.68
Riven,Ziggs,211,107,104,50.71
Riven,Heimerdinger,179,89,90,49.72
Riven,Twitch,486,247,239,50.82
Riven,Brand,397,180,217,45.34
Riven,Lillia,298,144,154,48.32
Riven,Galio,539,249,290,46.2
Riven,Poppy,382,178,204,46.6
Riven,Lucian,423,241,182,56.97
Riven,Vex,263,128,135,48.67
Riven,Jayce,304,142,162,46.71
Riven,Maokai,217,119,98,54.84
Riven,Chogath,601,273,328,45.42
Riven,Taric,170,87,83,51.18
Riven,Rumble,201,93,108,46.27
Riven,Olaf,90,40,50,44.44
Riven,Aphelios,362,156,206,43.09
Riven,Kennen,211,110,101,52.13
Riven,Anivia,189,103,86,54.5
Riven,Skarner,143,85,58,59.44
Riven,MonkeyKing,446,202,244,45.29
Riven,Janna,266,133,133,50
Riven,Talon,375,190,185,50.67
Riven,Zac,246,99,147,40.24
Riven,Rammus,217,83,134,38.25
Riven,Shyvana,152,91,61,59.87
Riven,Shen,412,228,184,55.34
Riven,Zoe,217,128,89,58.99
Riven,Samira,367,201,166,54.77
Riven,Kalista,138,71,67,51.45
Riven,Alistar,280,119,161,42.5
Riven,Lissandra,227,114,113,50.22
Riven,Hecarim,260,131,129,50.38
Riven,Smolder,333,182,151,54.65
Riven,DrMundo,244,107,137,43.85
Riven,Rengar,166,95,71,57.23
Riven,Renata,86,51,35,59.3
Riven,Akali,613,366,247,59.71
Riven,XinZhao,427,168,259,39.34
Riven,Singed,172,80,92,46.51
Riven,Kindred,281,145,136,51.6
Riven,Zeri,286,143,143,50
Riven,Gnar,196,110,86,56.12
Riven,Kled,100,24,76,24
Riven,Annie,201,121,80,60.2
Riven,Bard,217,110,107,50.69
Riven,Cassiopeia,148,83,65,56.08
Riven,RekSai,83,56,27,67.47
Sejuani,Malphite,489,241,248,49.28
Sejuani,Amumu,562,245,317,43.59
Sejuani,Ahri,742,354,388,47.71
Sejuani,Kaisa,901,455,446,50.5
Sejuani,Pyke,464,234,230,50.43
Sejuani,Teemo,597,337,260,56.45
Sejuani,FiddleSticks,280,132,148,47.14
Sejuani,Yone,839,400,439,47.68
Sejuani,Nilah,158,66,92,41.77
Sejuani,Rell,292,129,163,44.18
Sejuani,Gangplank,347,169,178,48.7
Sejuani,Evelynn,168,85,83,50.6
Sejuani,Mel,957,525,432,54.86
Sejuani,Ashe,1084,520,564,47.97
Sejuani,Elise,400,210,190,52.5
Sejuani,Aatrox,545,221,324,40.55
Sejuani,Khazix,204,110,94,53.92
Sejuani,Fizz,335,170,165,50.75
Sejuani,Lux,1153,536,617,46.49
Sejuani,Neeko,190,90,100,47.37
Sejuani,Chogath,619,308,311,49.76
Sejuani,Anivia,214,137,77,64.02
Sejuani,Tristana,524,291,233,55.53
Sejuani,Zyra,478,240,238,50.21
Sejuani,Garen,748,347,401,46.39
Sejuani,MonkeyKing,397,157,240,39.55
Sejuani,Akshan,161,72,89,44.72
Sejuani,Swain,513,228,285,44.44
Sejuani,Singed,171,91,80,53.22
Sejuani,Kayn,743,339,404,45.63
Sejuani,Galio,425,216,209,50.82
Sejuani,Sivir,262,125,137,47.71
Sejuani,Thresh,804,422,382,52.49
Sejuani,Pantheon,833,416,417,49.94
Sejuani,Skarner,159,97,62,61.01
Sejuani,MissFortune,1198,579,619,48.33
Sejuani,Ezreal,1354,659,695,48.67
Sejuani,Volibear,583,258,325,44.25
Sejuani,Rengar,149,72,77,48.32
Sejuani,Malzahar,618,261,357,42.23
Sejuani,Diana,871,405,466,46.5
Sejuani,Syndra,304,142,162,46.71
Sejuani,TahmKench,375,188,187,50.13
Sejuani,Mordekaiser,690,274,416,39.71
Sejuani,LeeSin,1019,507,512,49.75
Sejuani,Katarina,395,201,194,50.89
Sejuani,Darius,1060,492,568,46.42
Sejuani,Yasuo,975,485,490,49.74
Sejuani,Jhin,1084,503,581,46.4
Sejuani,Velkoz,303,127,176,41.91
Sejuani,Nocturne,697,298,399,42.75
Sejuani,Aurora,419,240,179,57.28
Sejuani,Vayne,758,370,388,48.81
Sejuani,Karma,699,286,413,40.92
Sejuani,Poppy,323,154,169,47.68
Sejuani,Warwick,789,358,431,45.37
Sejuani,Irelia,472,226,246,47.88
Sejuani,Jinx,1494,722,772,48.33
Sejuani,TwistedFate,176,91,85,51.7
Sejuani,Ziggs,191,98,93,51.31
Sejuani,Janna,169,89,80,52.66
Sejuani,Heimerdinger,172,89,83,51.74
Sejuani,Rammus,187,92,95,49.2
Sejuani,Sylas,919,465,454,50.6
Sejuani,Morgana,676,329,347,48.67
Sejuani,Gwen,343,159,184,46.36
Sejuani,Briar,304,123,181,40.46
Sejuani,Xayah,291,158,133,54.3
Sejuani,Milio,346,163,183,47.11
Sejuani,Illaoi,216,115,101,53.24
Sejuani,Leblanc,337,165,172,48.96
Sejuani,Nautilus,643,367,276,57.08
Sejuani,Fiora,210,94,116,44.76
Sejuani,Trundle,311,136,175,43.73
Sejuani,Soraka,301,114,187,37.87
Sejuani,Yorick,517,262,255,50.68
Sejuani,Sett,773,371,402,47.99
Sejuani,Kennen,109,51,58,46.79
Sejuani,Sion,366,165,201,45.08
Sejuani,Twitch,353,172,181,48.73
Sejuani,KogMaw,200,105,95,52.5
Sejuani,Gnar,272,148,124,54.41
Sejuani,Jax,441,227,214,51.47
Sejuani,Shaco,440,213,227,48.41
Sejuani,Vladimir,400,169,231,42.25
Sejuani,Draven,280,133,147,47.5
Sejuani,Yuumi,442,249,193,56.33
Sejuani,Senna,357,164,193,45.94
Sejuani,Nunu,286,144,142,50.35
Sejuani,Aphelios,264,126,138,47.73
Sejuani,Urgot,255,110,145,43.14
Sejuani,Viego,660,360,300,54.55
Sejuani,Leona,439,198,241,45.1
Sejuani,Riven,264,128,136,48.48
Sejuani,Nami,446,223,223,50
Sejuani,Zac,290,159,131,54.83
Sejuani,Shen,348,169,179,48.56
Sejuani,Naafiri,150,56,94,37.33
Sejuani,Zed,576,302,274,52.43
Sejuani,Brand,419,193,226,46.06
Sejuani,JarvanIV,337,139,198,41.25
Sejuani,AurelionSol,213,95,118,44.6
Sejuani,Lulu,744,383,361,51.48
Sejuani,XinZhao,410,236,174,57.56
Sejuani,Renata,79,47,32,59.49
Sejuani,MasterYi,641,304,337,47.43
Sejuani,Caitlyn,1520,728,792,47.89
Sejuani,Vi,595,308,287,51.76
Sejuani,Bard,125,54,71,43.2
Sejuani,Annie,198,105,93,53.03
Sejuani,Belveth,90,40,50,44.44
Sejuani,Corki,214,87,127,40.65
Sejuani,Nasus,388,207,181,53.35
Sejuani,Lucian,363,186,177,51.24
Sejuani,Vex,313,152,161,48.56
Sejuani,Zilean,120,44,76,36.67
Sejuani,Orianna,271,124,147,45.76
Sejuani,Samira,340,158,182,46.47
Sejuani,Alistar,276,158,118,57.25
Sejuani,Tryndamere,327,158,169,48.32
Sejuani,Varus,434,249,185,57.37
Sejuani,Viktor,516,297,219,57.56
Sejuani,Hwei,419,223,196,53.22
Sejuani,Kindred,227,115,112,50.66
Sejuani,Jayce,259,137,122,52.9
Sejuani,Ryze,157,73,84,46.5
Sejuani,Gragas,257,118,139,45.91
Sejuani,Veigar,505,230,275,45.54
Sejuani,Cassiopeia,192,79,113,41.15
Sejuani,DrMundo,295,163,132,55.25
Sejuani,Graves,364,196,168,53.85
Sejuani,Olaf,137,61,76,44.53
Sejuani,Talon,305,165,140,54.1
Sejuani,Kled,92,57,35,61.96
Sejuani,Lillia,306,138,168,45.1
Sejuani,Renekton,328,187,141,57.01
Sejuani,Xerath,423,187,236,44.21
Sejuani,Kalista,117,68,49,58.12
Sejuani,Ekko,422,204,218,48.34
Sejuani,Azir,239,97,142,40.59
Sejuani,Zeri,252,126,126,50
Sejuani,Ornn,210,86,124,40.95
Sejuani,Rakan,193,87,106,45.08
Sejuani,Taliyah,161,73,88,45.34
Sejuani,Udyr,172,86,86,50
Sejuani,Shyvana,105,41,64,39.05
Sejuani,Braum,313,138,175,44.09
Sejuani,KSante,344,181,163,52.62
Sejuani,Maokai,251,111,140,44.22
Sejuani,Akali,512,266,246,51.95
Sejuani,Zoe,165,79,86,47.88
Sejuani,Taric,111,47,64,42.34
Sejuani,Lissandra,190,112,78,58.95
Sejuani,Ambessa,293,177,116,60.41
Sejuani,Nidalee,136,61,75,44.85
Sejuani,Quinn,167,85,82,50.9
Sejuani,Blitzcrank,343,197,146,57.43
Sejuani,Kayle,286,137,149,47.9
Sejuani,Karthus,143,56,87,39.16
Sejuani,Camille,211,106,105,50.24
Sejuani,RekSai,79,49,30,62.03
Sejuani,Smolder,346,124,222,35.84
Sejuani,Seraphine,384,193,191,50.26
Sejuani,Rumble,92,48,44,52.17
Sejuani,Sona,166,86,80,51.81
Sejuani,Qiyana,108,46,62,42.59
Sejuani,Hecarim,223,110,113,49.33
Sejuani,Ivern,67,34,33,50.75
Sejuani,Kassadin,83,50,33,60.24
Lucian,Malphite,1015,523,492,51.53
Lucian,Amumu,852,428,424,50.23
Lucian,Ahri,1275,646,629,50.67
Lucian,Kaisa,1688,905,783,53.61
Lucian,Pyke,778,432,346,55.53
Lucian,Ornn,377,205,172,54.38
Lucian,Kayn,1286,673,613,52.33
Lucian,Yasuo,1794,867,927,48.33
Lucian,Caitlyn,2437,1191,1246,48.87
Lucian,Morgana,965,494,471,51.19
Lucian,Garen,1396,625,771,44.77
Lucian,Rengar,302,165,137,54.64
Lucian,Lissandra,330,148,182,44.85
Lucian,Tristana,875,427,448,48.8
Lucian,Zyra,915,443,472,48.42
Lucian,Darius,1812,914,898,50.44
Lucian,Kindred,373,196,177,52.55
Lucian,Yone,1603,841,762,52.46
Lucian,Samira,562,279,283,49.64
Lucian,Rell,452,241,211,53.32
Lucian,Yorick,888,373,515,42
Lucian,Elise,726,356,370,49.04
Lucian,Viktor,870,403,467,46.32
Lucian,Corki,410,210,200,51.22
Lucian,Milio,516,231,285,44.77
Lucian,TahmKench,747,349,398,46.72
Lucian,LeeSin,1599,740,859,46.28
Lucian,Hwei,545,253,292,46.42
Lucian,Karma,1307,630,677,48.2
Lucian,DrMundo,399,160,239,40.1
Lucian,Akali,979,478,501,48.83
Lucian,Nilah,256,75,181,29.3
Lucian,Shen,507,227,280,44.77
Lucian,Poppy,633,332,301,52.45
Lucian,Katarina,671,321,350,47.84
Lucian,Ezreal,2844,1429,1415,50.25
Lucian,Yuumi,832,423,409,50.84
Lucian,Pantheon,1385,612,773,44.19
Lucian,MonkeyKing,770,375,395,48.7
Lucian,Jhin,1996,976,1020,48.9
Lucian,Lux,2266,1085,1181,47.88
Lucian,Urgot,400,191,209,47.75
Lucian,Rammus,285,135,150,47.37
Lucian,Xerath,804,391,413,48.63
Lucian,Jinx,2827,1305,1522,46.16
Lucian,Lulu,1496,699,797,46.72
Lucian,Nocturne,1243,625,618,50.28
Lucian,KogMaw,272,129,143,47.43
Lucian,Braum,546,232,314,42.49
Lucian,KSante,568,317,251,55.81
Lucian,MasterYi,1108,544,564,49.1
Lucian,Naafiri,246,97,149,39.43
Lucian,Twitch,717,363,354,50.63
Lucian,Swain,776,342,434,44.07
Lucian,Olaf,266,145,121,54.51
Lucian,Mel,1853,922,931,49.76
Lucian,Malzahar,939,477,462,50.8
Lucian,Viego,1333,636,697,47.71
Lucian,Illaoi,411,245,166,59.61
Lucian,Syndra,613,315,298,51.39
Lucian,Taliyah,244,116,128,47.54
Lucian,Leblanc,591,287,304,48.56
Lucian,Sona,270,114,156,42.22
Lucian,Renekton,466,229,237,49.14
Lucian,Karthus,334,164,170,49.1
Lucian,Fizz,534,245,289,45.88
Lucian,Vladimir,631,287,344,45.48
Lucian,Veigar,852,423,429,49.65
Lucian,Kayle,613,285,328,46.49
Lucian,Ekko,940,439,501,46.7
Lucian,Orianna,455,248,207,54.51
Lucian,Bard,287,128,159,44.6
Lucian,Fiora,327,135,192,41.28
Lucian,Aurora,674,309,365,45.85
Lucian,Vi,918,488,430,53.16
Lucian,Sett,1189,575,614,48.36
Lucian,Gangplank,557,264,293,47.4
Lucian,Senna,701,315,386,44.94
Lucian,Chogath,978,456,522,46.63
Lucian,Sion,730,326,404,44.66
Lucian,Ambessa,631,300,331,47.54
Lucian,Shyvana,232,134,98,57.76
Lucian,Zoe,328,149,179,45.43
Lucian,Ashe,2045,925,1120,45.23
Lucian,Maokai,386,206,180,53.37
Lucian,Trundle,537,234,303,43.58
Lucian,Shaco,841,422,419,50.18
Lucian,Irelia,722,348,374,48.2
Lucian,Zeri,436,209,227,47.94
Lucian,Janna,329,150,179,45.59
Lucian,Udyr,401,225,176,56.11
Lucian,Aatrox,921,447,474,48.53
Lucian,Gnar,404,215,189,53.22
Lucian,FiddleSticks,469,230,239,49.04
Lucian,Vayne,1352,655,697,48.45
Lucian,Kalista,220,123,97,55.91
Lucian,Thresh,1218,561,657,46.06
Lucian,Camille,361,175,186,48.48
Lucian,Diana,1516,685,831,45.18
Lucian,Annie,313,145,168,46.33
Lucian,Blitzcrank,637,346,291,54.32
Lucian,Zed,1116,520,596,46.59
Lucian,Gragas,490,230,260,46.94
Lucian,Sivir,453,207,246,45.7
Lucian,Zilean,280,94,186,33.57
Lucian,Singed,292,124,168,42.47
Lucian,Nunu,374,176,198,47.06
Lucian,Nautilus,1063,531,532,49.95
Lucian,JarvanIV,521,228,293,43.76
Lucian,MissFortune,2144,1055,1089,49.21
Lucian,Tryndamere,577,257,320,44.54
Lucian,Lillia,489,219,270,44.79
Lucian,Smolder,527,277,250,52.56
Lucian,Volibear,940,433,507,46.06
Lucian,Soraka,517,232,285,44.87
Lucian,Mordekaiser,1137,569,568,50.04
Lucian,Cassiopeia,243,102,141,41.98
Lucian,Xayah,452,252,200,55.75
Lucian,Teemo,1065,545,520,51.17
Lucian,TwistedFate,338,153,185,45.27
Lucian,Talon,585,264,321,45.13
Lucian,Qiyana,233,116,117,49.79
Lucian,Gwen,439,231,208,52.62
Lucian,Warwick,1212,561,651,46.29
Lucian,Belveth,213,102,111,47.89
Lucian,Galio,741,341,400,46.02
Lucian,Nasus,575,287,288,49.91
Lucian,Brand,680,353,327,51.91
Lucian,Briar,541,230,311,42.51
Lucian,Velkoz,505,245,260,48.51
Lucian,Akshan,283,120,163,42.4
Lucian,Sejuani,363,177,186,48.76
Lucian,Kled,176,84,92,47.73
Lucian,Vex,443,209,234,47.18
Lucian,Ziggs,303,174,129,57.43
Lucian,Azir,318,138,180,43.4
Lucian,Jax,882,417,465,47.28
Lucian,Varus,780,408,372,52.31
Lucian,Draven,496,197,299,39.72
Lucian,Aphelios,422,201,221,47.63
Lucian,Heimerdinger,431,195,236,45.24
Lucian,Rakan,362,207,155,57.18
Lucian,Nidalee,284,167,117,58.8
Lucian,Zac,457,195,262,42.67
Lucian,Nami,974,474,500,48.67
Lucian,Hecarim,395,207,188,52.41
Lucian,Khazix,513,255,258,49.71
Lucian,Riven,423,182,241,43.03
Lucian,Anivia,357,166,191,46.5
Lucian,Sylas,1363,653,710,47.91
Lucian,AurelionSol,344,152,192,44.19
Lucian,Alistar,387,191,196,49.35
Lucian,Graves,766,364,402,47.52
Lucian,Rumble,270,110,160,40.74
Lucian,Kennen,237,116,121,48.95
Lucian,Leona,680,297,383,43.68
Lucian,Quinn,292,128,164,43.84
Lucian,Kassadin,220,109,111,49.55
Lucian,XinZhao,664,350,314,52.71
Lucian,Skarner,216,97,119,44.91
Lucian,Renata,149,73,76,48.99
Lucian,Seraphine,551,300,251,54.45
Lucian,Jayce,498,269,229,54.02
Lucian,Ryze,321,160,161,49.84
Lucian,Evelynn,279,147,132,52.69
Lucian,Ivern,101,51,50,50.5
Lucian,Taric,173,79,94,45.66
Lucian,Neeko,386,197,189,51.04
Lucian,RekSai,138,72,66,52.17
Soraka,Malphite,630,310,320,49.21
Soraka,Amumu,675,330,345,48.89
Soraka,Ahri,920,491,429,53.37
Soraka,Kaisa,1181,645,536,54.61
Soraka,Pyke,583,320,263,54.89
Soraka,Illaoi,309,171,138,55.34
Soraka,Pantheon,1103,604,499,54.76
Soraka,Syndra,479,252,227,52.61
Soraka,Milio,537,256,281,47.67
Soraka,Ambessa,415,222,193,53.49
Soraka,Ekko,731,355,376,48.56
Soraka,Yasuo,1288,642,646,49.84
Soraka,Veigar,759,373,386,49.14
Soraka,Darius,1275,632,643,49.57
Soraka,Volibear,881,475,406,53.92
Soraka,Ashe,1450,759,691,52.34
Soraka,Lulu,1211,611,600,50.45
Soraka,Shen,489,237,252,48.47
Soraka,Orianna,327,162,165,49.54
Soraka,Caitlyn,1744,923,821,52.92
Soraka,Sona,220,118,102,53.64
Soraka,Zed,760,396,364,52.11
Soraka,Jhin,1494,814,680,54.48
Soraka,Nautilus,759,424,335,55.86
Soraka,Nocturne,920,480,440,52.17
Soraka,Galio,596,325,271,54.53
Soraka,Morgana,772,394,378,51.04
Soraka,Yorick,722,346,376,47.92
Soraka,Lux,1781,935,846,52.5
Soraka,Jinx,2072,1066,1006,51.45
Soraka,Bard,248,144,104,58.06
Soraka,Akali,781,435,346,55.7
Soraka,JarvanIV,547,277,270,50.64
Soraka,Sivir,396,185,211,46.72
Soraka,Shaco,764,411,353,53.8
Soraka,Gragas,413,244,169,59.08
Soraka,Gangplank,415,231,184,55.66
Soraka,Hecarim,316,158,158,50
Soraka,Aurora,433,253,180,58.43
Soraka,Brand,515,280,235,54.37
Soraka,Camille,277,133,144,48.01
Soraka,Kayn,1021,528,493,51.71
Soraka,Quinn,313,154,159,49.2
Soraka,Yuumi,630,324,306,51.43
Soraka,Gnar,274,142,132,51.82
Soraka,Poppy,374,213,161,56.95
Soraka,TwistedFate,236,119,117,50.42
Soraka,Karma,1028,514,514,50
Soraka,Teemo,877,469,408,53.48
Soraka,Zyra,726,357,369,49.17
Soraka,Tryndamere,446,246,200,55.16
Soraka,Annie,253,111,142,43.87
Soraka,Samira,495,251,244,50.71
Soraka,Seraphine,494,229,265,46.36
Soraka,TahmKench,462,238,224,51.52
Soraka,Talon,397,242,155,60.96
Soraka,Irelia,594,276,318,46.46
Soraka,Ziggs,279,151,128,54.12
Soraka,Kayle,513,251,262,48.93
Soraka,LeeSin,1028,555,473,53.99
Soraka,Sylas,960,505,455,52.6
Soraka,Taric,172,92,80,53.49
Soraka,Khazix,385,221,164,57.4
Soraka,Vex,328,151,177,46.04
Soraka,Jax,686,369,317,53.79
Soraka,Rammus,225,127,98,56.44
Soraka,Ryze,259,120,139,46.33
Soraka,Swain,752,378,374,50.27
Soraka,Aatrox,558,296,262,53.05
Soraka,Rakan,259,136,123,52.51
Soraka,AurelionSol,252,117,135,46.43
Soraka,Graves,437,240,197,54.92
Soraka,Zoe,266,123,143,46.24
Soraka,Anivia,239,103,136,43.1
Soraka,Leona,607,359,248,59.14
Soraka,Kennen,227,93,134,40.97
Soraka,Rengar,210,105,105,50
Soraka,Smolder,449,234,215,52.12
Soraka,Thresh,915,484,431,52.9
Soraka,Yone,1180,676,504,57.29
Soraka,Mel,1634,902,732,55.2
Soraka,Akshan,275,131,144,47.64
Soraka,Aphelios,381,214,167,56.17
Soraka,Xayah,325,170,155,52.31
Soraka,Velkoz,462,245,217,53.03
Soraka,MasterYi,819,372,447,45.42
Soraka,Corki,304,170,134,55.92
Soraka,Mordekaiser,916,459,457,50.11
Soraka,Nasus,547,245,302,44.79
Soraka,Warwick,1088,519,569,47.7
Soraka,Janna,247,111,136,44.94
Soraka,Diana,1043,481,562,46.12
Soraka,Kalista,201,91,110,45.27
Soraka,Sejuani,301,187,114,62.13
Soraka,Nami,996,514,482,51.61
Soraka,MonkeyKing,524,271,253,51.72
Soraka,Neeko,275,157,118,57.09
Soraka,Draven,464,225,239,48.49
Soraka,Qiyana,146,82,64,56.16
Soraka,Ezreal,1602,862,740,53.81
Soraka,Vladimir,494,286,208,57.89
Soraka,Katarina,590,317,273,53.73
Soraka,Varus,626,344,282,54.95
Soraka,Sett,988,520,468,52.63
Soraka,FiddleSticks,344,159,185,46.22
Soraka,Malzahar,781,424,357,54.29
Soraka,Vayne,889,451,438,50.73
Soraka,Udyr,291,151,140,51.89
Soraka,Twitch,607,312,295,51.4
Soraka,MissFortune,1590,784,806,49.31
Soraka,Urgot,310,157,153,50.65
Soraka,Lillia,337,168,169,49.85
Soraka,Riven,394,194,200,49.24
Soraka,Gwen,359,196,163,54.6
Soraka,Lucian,517,285,232,55.13
Soraka,Maokai,248,128,120,51.61
Soraka,Viego,917,484,433,52.78
Soraka,RekSai,103,56,47,54.37
Soraka,DrMundo,347,201,146,57.93
Soraka,Fizz,381,190,191,49.87
Soraka,Chogath,860,405,455,47.09
Soraka,Leblanc,376,193,183,51.33
Soraka,Nidalee,160,82,78,51.25
Soraka,Hwei,435,182,253,41.84
Soraka,Alistar,286,123,163,43.01
Soraka,Trundle,444,198,246,44.59
Soraka,Belveth,217,122,95,56.22
Soraka,Rell,294,135,159,45.92
Soraka,Viktor,658,364,294,55.32
Soraka,Vi,610,347,263,56.89
Soraka,Zilean,250,109,141,43.6
Soraka,Tristana,717,382,335,53.28
Soraka,Blitzcrank,456,218,238,47.81
Soraka,XinZhao,435,270,165,62.07
Soraka,Zac,352,150,202,42.61
Soraka,Briar,579,303,276,52.33
Soraka,Zeri,304,179,125,58.88
Soraka,Olaf,156,77,79,49.36
Soraka,Ornn,275,158,117,57.45
Soraka,Taliyah,165,99,66,60
Soraka,Naafiri,224,124,100,55.36
Soraka,Azir,234,106,128,45.3
Soraka,Braum,343,176,167,51.31
Soraka,Kled,119,68,51,57.14
Soraka,Renekton,355,192,163,54.08
Soraka,Garen,1152,556,596,48.26
Soraka,Skarner,200,119,81,59.5
Soraka,Senna,551,271,280,49.18
Soraka,Rumble,167,70,97,41.92
Soraka,Evelynn,235,115,120,48.94
Soraka,Kassadin,158,95,63,60.13
Soraka,Sion,572,275,297,48.08
Soraka,Lissandra,252,112,140,44.44
Soraka,Xerath,623,369,254,59.23
Soraka,Fiora,292,126,166,43.15
Soraka,Heimerdinger,298,139,159,46.64
Soraka,Karthus,256,128,128,50
Soraka,Singed,191,85,106,44.5
Soraka,Shyvana,172,86,86,50
Soraka,Kindred,318,172,146,54.09
Soraka,Nunu,401,219,182,54.61
Soraka,Nilah,201,78,123,38.81
Soraka,KSante,385,222,163,57.66
Soraka,Cassiopeia,189,104,85,55.03
Soraka,Elise,501,247,254,49.3
Soraka,KogMaw,223,118,105,52.91
Soraka,Renata,109,47,62,43.12
Soraka,Ivern,84,31,53,36.9
Soraka,Jayce,349,171,178,49
Malphite,Riven,656,358,298,54.57
Malphite,Sejuani,489,248,241,50.72
Malphite,Sylas,2995,1400,1595,46.74
Malphite,Lucian,1015,492,523,48.47
Malphite,Soraka,630,320,310,50.79
Malphite,Pantheon,2314,1221,1093,52.77
Malphite,Volibear,1327,650,677,48.98
Malphite,Zed,2111,1210,901,57.32
Malphite,Tristana,1343,703,640,52.35
Malphite,Yuumi,999,499,500,49.95
Malphite,Darius,2371,1112,1259,46.9
Malphite,Khazix,611,328,283,53.68
Malphite,Aphelios,697,374,323,53.66
Malphite,Pyke,1143,639,504,55.91
Malphite,Teemo,2563,1206,1357,47.05
Malphite,Jax,1239,631,608,50.93
Malphite,Fizz,764,376,388,49.21
Malphite,Kaisa,2068,1088,980,52.61
Malphite,Morgana,1764,854,910,48.41
Malphite,Tryndamere,1047,568,479,54.25
Malphite,Kayn,1891,925,966,48.92
Malphite,Viktor,1043,521,522,49.95
Malphite,Jhin,2640,1345,1295,50.95
Malphite,Ornn,576,304,272,52.78
Malphite,Warwick,1901,954,947,50.18
Malphite,Galio,1224,585,639,47.79
Malphite,Ezreal,3386,1616,1770,47.73
Malphite,Nami,1302,627,675,48.16
Malphite,Kayle,983,452,531,45.98
Malphite,Elise,860,449,411,52.21
Malphite,Swain,1335,589,746,44.12
Malphite,Kalista,331,160,171,48.34
Malphite,Karma,1563,717,846,45.87
Malphite,Trundle,806,391,415,48.51
Malphite,Vi,1228,627,601,51.06
Malphite,Sivir,753,397,356,52.72
Malphite,Velkoz,787,389,398,49.43
Malphite,TahmKench,998,489,509,49
Malphite,Ziggs,526,239,287,45.44
Malphite,Twitch,1097,601,496,54.79
Malphite,Thresh,1791,879,912,49.08
Malphite,Gnar,734,367,367,50
Malphite,Poppy,665,333,332,50.08
Malphite,TwistedFate,401,216,185,53.87
Malphite,MissFortune,3275,1584,1691,48.37
Malphite,Ashe,2687,1367,1320,50.87
Malphite,Renekton,612,313,299,51.14
Malphite,Evelynn,417,202,215,48.44
Malphite,Samira,823,410,413,49.82
Malphite,Leona,1170,600,570,51.28
Malphite,Irelia,1128,597,531,52.93
Malphite,DrMundo,767,355,412,46.28
Malphite,Brand,1003,458,545,45.66
Malphite,LeeSin,2017,1045,972,51.81
Malphite,Jinx,3829,1872,1957,48.89
Malphite,Neeko,586,296,290,50.51
Malphite,FiddleSticks,629,296,333,47.06
Malphite,Ahri,1633,858,775,52.54
Malphite,Ryze,399,185,214,46.37
Malphite,Mordekaiser,2051,926,1125,45.15
Malphite,Yasuo,2990,1560,1430,52.17
Malphite,Lillia,717,366,351,51.05
Malphite,Qiyana,374,188,186,50.27
Malphite,Gangplank,707,363,344,51.34
Malphite,Yone,2678,1415,1263,52.84
Malphite,Seraphine,1027,532,495,51.8
Malphite,Xerath,1320,643,677,48.71
Malphite,Lux,3477,1688,1789,48.55
Malphite,Rumble,383,214,169,55.87
Malphite,Kindred,588,324,264,55.1
Malphite,Akali,1277,641,636,50.2
Malphite,KSante,579,266,313,45.94
Malphite,Zilean,415,206,209,49.64
Malphite,Yorick,1243,595,648,47.87
Malphite,Rell,646,291,355,45.05
Malphite,Garen,1997,962,1035,48.17
Malphite,Shen,709,318,391,44.85
Malphite,Nocturne,1843,845,998,45.85
Malphite,Xayah,714,310,404,43.42
Malphite,Rakan,521,248,273,47.6
Malphite,XinZhao,879,439,440,49.94
Malphite,Mel,2540,1353,1187,53.27
Malphite,Singed,340,162,178,47.65
Malphite,JarvanIV,840,414,426,49.29
Malphite,Nasus,1094,518,576,47.35
Malphite,Nautilus,1557,833,724,53.5
Malphite,Heimerdinger,690,304,386,44.06
Malphite,Veigar,1247,576,671,46.19
Malphite,Caitlyn,3730,1884,1846,50.51
Malphite,Gwen,726,367,359,50.55
Malphite,MasterYi,1715,846,869,49.33
Malphite,Quinn,776,388,388,50
Malphite,RekSai,156,66,90,42.31
Malphite,Katarina,1011,519,492,51.34
Malphite,Smolder,918,498,420,54.25
Malphite,Lulu,1807,990,817,54.79
Malphite,Vex,632,319,313,50.47
Malphite,Ekko,1179,546,633,46.31
Malphite,Kassadin,264,107,157,40.53
Malphite,Udyr,540,264,276,48.89
Malphite,Vayne,2173,1138,1035,52.37
Malphite,Amumu,1363,618,745,45.34
Malphite,Shaco,1327,638,689,48.08
Malphite,Annie,434,200,234,46.08
Malphite,Leblanc,753,419,334,55.64
Malphite,Zeri,564,317,247,56.21
Malphite,Draven,710,348,362,49.01
Malphite,Camille,409,223,186,54.52
Malphite,Sett,1978,991,987,50.1
Malphite,Malzahar,1443,709,734,49.13
Malphite,Taliyah,280,144,136,51.43
Malphite,Maokai,581,245,336,42.17
Malphite,MonkeyKing,977,467,510,47.8
Malphite,Lissandra,456,217,239,47.59
Malphite,Milio,771,344,427,44.62
Malphite,Gragas,651,374,277,57.45
Malphite,Zoe,402,214,188,53.23
Malphite,Kennen,342,177,165,51.75
Malphite,Vladimir,733,361,372,49.25
Malphite,Urgot,680,326,354,47.94
Malphite,Fiora,383,247,136,64.49
Malphite,Hecarim,477,204,273,42.77
Malphite,Zyra,1244,619,625,49.76
Malphite,Diana,2034,998,1036,49.07
Malphite,Chogath,1542,704,838,45.65
Malphite,Shyvana,375,189,186,50.4
Malphite,Rengar,418,228,190,54.55
Malphite,Varus,1218,643,575,52.79
Malphite,Jayce,710,338,372,47.61
Malphite,Orianna,464,212,252,45.69
Malphite,Ambessa,678,393,285,57.96
Malphite,Bard,357,169,188,47.34
Malphite,Taric,293,141,152,48.12
Malphite,Braum,697,357,340,51.22
Malphite,Naafiri,459,220,239,47.93
Malphite,Aurora,921,463,458,50.27
Malphite,Nidalee,417,209,208,50.12
Malphite,Briar,946,415,531,43.87
Malphite,Azir,430,196,234,45.58
Malphite,Rammus,392,200,192,51.02
Malphite,Sion,1054,487,567,46.2
Malphite,Hwei,783,381,402,48.66
Malphite,KogMaw,404,211,193,52.23
Malphite,Viego,1870,946,924,50.59
Malphite,Sona,362,176,186,48.62
Malphite,Nunu,637,324,313,50.86
Malphite,Aatrox,1211,589,622,48.64
Malphite,Akshan,541,277,264,51.2
Malphite,Ivern,169,76,93,44.97
Malphite,Blitzcrank,815,389,426,47.73
Malphite,Karthus,354,189,165,53.39
Malphite,AurelionSol,507,215,292,42.41
Malphite,Zac,629,314,315,49.92
Malphite,Janna,370,179,191,48.38
Malphite,Skarner,284,153,131,53.87
Malphite,Syndra,736,389,347,52.85
Malphite,Graves,809,468,341,57.85
Malphite,Talon,804,378,426,47.01
Malphite,Alistar,539,241,298,44.71
Malphite,Senna,994,555,439,55.84
Malphite,Illaoi,618,310,308,50.16
Malphite,Anivia,322,168,154,52.17
Malphite,Nilah,427,206,221,48.24
Malphite,Kled,205,107,98,52.2
Malphite,Corki,498,229,269,45.98
Malphite,Renata,177,80,97,45.2
Malphite,Belveth,322,180,142,55.9
Malphite,Cassiopeia,304,158,146,51.97
Malphite,Olaf,264,99,165,37.5
Amumu,Riven,567,309,258,54.5
Amumu,Sejuani,562,317,245,56.41
Amumu,Sylas,1854,949,905,51.19
Amumu,Lucian,852,424,428,49.77
Amumu,Soraka,675,345,330,51.11
Amumu,Trundle,869,431,438,49.6
Amumu,Briar,1006,547,459,54.37
Amumu,Katarina,974,540,434,55.44
Amumu,Jhin,2722,1339,1383,49.19
Amumu,Pyke,999,513,486,51.35
Amumu,Mordekaiser,1944,970,974,49.9
Amumu,Skarner,335,181,154,54.03
Amumu,Galio,1169,638,531,54.58
Amumu,MissFortune,3166,1655,1511,52.27
Amumu,Lux,3486,1775,1711,50.92
Amumu,Singed,317,155,162,48.9
Amumu,Viego,1886,975,911,51.7
Amumu,Zed,1345,727,618,54.05
Amumu,Zeri,442,215,227,48.64
Amumu,Milio,802,384,418,47.88
Amumu,Evelynn,454,252,202,55.51
Amumu,Yone,2356,1307,1049,55.48
Amumu,Caitlyn,3817,1947,1870,51.01
Amumu,Nami,1247,641,606,51.4
Amumu,Sett,2070,960,1110,46.38
Amumu,Nasus,986,475,511,48.17
Amumu,Aurora,744,412,332,55.38
Amumu,Varus,1102,607,495,55.08
Amumu,Mel,2630,1447,1183,55.02
Amumu,Yorick,1506,691,815,45.88
Amumu,Rengar,368,174,194,47.28
Amumu,Irelia,1060,563,497,53.11
Amumu,Ezreal,2954,1545,1409,52.3
Amumu,Nocturne,1920,1008,912,52.5
Amumu,Xayah,624,335,289,53.69
Amumu,Karma,1429,716,713,50.1
Amumu,Vex,736,359,377,48.78
Amumu,Kayn,2030,1023,1007,50.39
Amumu,Darius,2520,1333,1187,52.9
Amumu,Janna,422,242,180,57.35
Amumu,Warwick,2338,1164,1174,49.79
Amumu,Hwei,801,381,420,47.57
Amumu,Seraphine,1072,528,544,49.25
Amumu,Pantheon,2001,1109,892,55.42
Amumu,Nunu,804,453,351,56.34
Amumu,Viktor,1119,555,564,49.6
Amumu,Sivir,693,344,349,49.64
Amumu,Morgana,1750,918,832,52.46
Amumu,Khazix,598,354,244,59.2
Amumu,Poppy,797,406,391,50.94
Amumu,Yasuo,2614,1386,1228,53.02
Amumu,Volibear,1749,856,893,48.94
Amumu,Ahri,1775,942,833,53.07
Amumu,Teemo,1908,993,915,52.04
Amumu,Yuumi,971,481,490,49.54
Amumu,Jax,1196,636,560,53.18
Amumu,Vi,1091,553,538,50.69
Amumu,Tristana,1280,700,580,54.69
Amumu,Thresh,1525,835,690,54.75
Amumu,DrMundo,757,376,381,49.67
Amumu,Twitch,1113,608,505,54.63
Amumu,Brand,1093,546,547,49.95
Amumu,Kayle,972,507,465,52.16
Amumu,Kaisa,2054,1111,943,54.09
Amumu,Swain,1333,681,652,51.09
Amumu,JarvanIV,842,424,418,50.36
Amumu,Zyra,1208,638,570,52.81
Amumu,Ambessa,697,378,319,54.23
Amumu,TwistedFate,476,264,212,55.46
Amumu,Ziggs,442,217,225,49.1
Amumu,Veigar,1497,733,764,48.96
Amumu,Orianna,531,277,254,52.17
Amumu,Diana,2348,1235,1113,52.6
Amumu,Ashe,2553,1329,1224,52.06
Amumu,Zoe,420,209,211,49.76
Amumu,Kennen,305,169,136,55.41
Amumu,TahmKench,1134,613,521,54.06
Amumu,Urgot,746,363,383,48.66
Amumu,Lulu,1396,721,675,51.65
Amumu,Akali,1352,714,638,52.81
Amumu,Garen,2149,1087,1062,50.58
Amumu,Draven,707,396,311,56.01
Amumu,Blitzcrank,846,415,431,49.05
Amumu,Renekton,685,368,317,53.72
Amumu,Aphelios,665,320,345,48.12
Amumu,Rell,562,287,275,51.07
Amumu,Talon,687,390,297,56.77
Amumu,Jinx,3833,1950,1883,50.87
Amumu,Neeko,627,322,305,51.36
Amumu,Nautilus,1653,936,717,56.62
Amumu,Shaco,1243,670,573,53.9
Amumu,Ryze,388,189,199,48.71
Amumu,Leblanc,697,340,357,48.78
Amumu,Olaf,296,139,157,46.96
Amumu,Qiyana,311,170,141,54.66
Amumu,MasterYi,1849,933,916,50.46
Amumu,Rakan,508,288,220,56.69
Amumu,Lissandra,444,222,222,50
Amumu,Vayne,1610,827,783,51.37
Amumu,Heimerdinger,637,309,328,48.51
Amumu,Rammus,381,248,133,65.09
Amumu,Leona,1262,682,580,54.04
Amumu,Gnar,524,254,270,48.47
Amumu,Samira,942,514,428,54.56
Amumu,Taric,303,140,163,46.2
Amumu,Sion,1034,579,455,56
Amumu,MonkeyKing,825,420,405,50.91
Amumu,Annie,416,226,190,54.33
Amumu,Fiora,455,205,250,45.05
Amumu,Azir,380,218,162,57.37
Amumu,Chogath,1756,857,899,48.8
Amumu,Malphite,1363,745,618,54.66
Amumu,Zilean,430,224,206,52.09
Amumu,Graves,688,361,327,52.47
Amumu,Taliyah,304,163,141,53.62
Amumu,Aatrox,960,501,459,52.19
Amumu,Kindred,618,336,282,54.37
Amumu,LeeSin,1634,846,788,51.77
Amumu,Malzahar,1447,739,708,51.07
Amumu,Shen,877,491,386,55.99
Amumu,Hecarim,533,284,249,53.28
Amumu,Camille,392,195,197,49.74
Amumu,Fizz,807,381,426,47.21
Amumu,Senna,1021,522,499,51.13
Amumu,Ekko,1366,718,648,52.56
Amumu,Belveth,304,157,147,51.64
Amumu,Quinn,452,253,199,55.97
Amumu,KogMaw,438,209,229,47.72
Amumu,Udyr,499,260,239,52.1
Amumu,Kled,273,147,126,53.85
Amumu,AurelionSol,517,270,247,52.22
Amumu,Alistar,543,288,255,53.04
Amumu,Karthus,407,199,208,48.89
Amumu,Gangplank,536,299,237,55.78
Amumu,Sona,379,184,195,48.55
Amumu,Vladimir,820,467,353,56.95
Amumu,Kalista,295,182,113,61.69
Amumu,Ornn,448,205,243,45.76
Amumu,Braum,722,366,356,50.69
Amumu,FiddleSticks,707,302,405,42.72
Amumu,Xerath,1180,597,583,50.59
Amumu,Naafiri,438,245,193,55.94
Amumu,Nilah,434,231,203,53.23
Amumu,Shyvana,410,209,201,50.98
Amumu,Gragas,667,365,302,54.72
Amumu,Smolder,874,453,421,51.83
Amumu,Kassadin,270,156,114,57.78
Amumu,Cassiopeia,377,215,162,57.03
Amumu,Zac,611,288,323,47.14
Amumu,KSante,567,340,227,59.96
Amumu,Illaoi,660,344,316,52.12
Amumu,Jayce,533,267,266,50.09
Amumu,Lillia,773,335,438,43.34
Amumu,Velkoz,861,430,431,49.94
Amumu,Bard,345,182,163,52.75
Amumu,XinZhao,835,401,434,48.02
Amumu,Gwen,687,367,320,53.42
Amumu,Syndra,771,400,371,51.88
Amumu,Rumble,333,148,185,44.44
Amumu,Anivia,420,225,195,53.57
Amumu,Tryndamere,808,464,344,57.43
Amumu,Ivern,141,77,64,54.61
Amumu,Elise,822,423,399,51.46
Amumu,Maokai,576,285,291,49.48
Amumu,Nidalee,284,147,137,51.76
Amumu,Akshan,453,261,192,57.62
Amumu,Corki,471,263,208,55.84
Amumu,RekSai,166,87,79,52.41
Amumu,Renata,170,97,73,57.06
Ahri,Riven,735,389,346,52.93
Ahri,Sejuani,742,388,354,52.29
Ahri,Sylas,2859,1416,1443,49.53
Ahri,Lucian,1275,629,646,49.33
Ahri,Soraka,920,429,491,46.63
Ahri,Nasus,1278,624,654,48.83
Ahri,Nocturne,2250,1037,1213,46.09
Ahri,Vladimir,1085,530,555,48.85
Ahri,Jhin,3399,1680,1719,49.43
Ahri,Seraphine,1292,648,644,50.15
Ahri,Sett,2492,1236,1256,49.6
Ahri,Lillia,943,458,485,48.57
Ahri,Leblanc,1220,617,603,50.57
Ahri,Jinx,4748,2238,2510,47.14
Ahri,Alistar,662,311,351,46.98
Ahri,Mordekaiser,2247,1098,1149,48.87
Ahri,Skarner,412,236,176,57.28
Ahri,Galio,1784,913,871,51.18
Ahri,MissFortune,4161,2048,2113,49.22
Ahri,Lux,4526,2200,2326,48.61
Ahri,Yorick,1694,819,875,48.35
Ahri,JarvanIV,1229,601,628,48.9
Ahri,Mel,2431,1249,1182,51.38
Ahri,Chogath,1970,997,973,50.61
Ahri,Warwick,2457,1151,1306,46.85
Ahri,Tristana,1674,813,861,48.57
Ahri,Vayne,2014,979,1035,48.61
Ahri,Thresh,2122,1043,1079,49.15
Ahri,Shen,1016,487,529,47.93
Ahri,Caitlyn,4777,2333,2444,48.84
Ahri,Morgana,1970,996,974,50.56
Ahri,Jax,1509,741,768,49.11
Ahri,Syndra,1270,591,679,46.54
Ahri,Kaisa,2884,1520,1364,52.7
Ahri,Karma,2225,1140,1085,51.24
Ahri,Poppy,972,429,543,44.14
Ahri,Evelynn,600,324,276,54
Ahri,Zed,1729,906,823,52.4
Ahri,Corki,643,325,318,50.54
Ahri,Elise,1167,563,604,48.24
Ahri,Renekton,852,455,397,53.4
Ahri,Teemo,2007,945,1062,47.09
Ahri,Samira,1006,466,540,46.32
Ahri,Leona,1418,717,701,50.56
Ahri,Aatrox,1621,805,816,49.66
Ahri,Vi,1608,807,801,50.19
Ahri,Veigar,1801,834,967,46.31
Ahri,Rell,761,350,411,45.99
Ahri,Briar,1220,589,631,48.28
Ahri,Maokai,784,379,405,48.34
Ahri,Amumu,1775,833,942,46.93
Ahri,Taliyah,479,267,212,55.74
Ahri,Xayah,724,342,382,47.24
Ahri,Braum,959,451,508,47.03
Ahri,Gangplank,936,442,494,47.22
Ahri,Yasuo,3035,1545,1490,50.91
Ahri,Gragas,874,425,449,48.63
Ahri,Kayn,2310,1150,1160,49.78
Ahri,Hwei,1193,598,595,50.13
Ahri,Milio,974,435,539,44.66
Ahri,KSante,885,435,450,49.15
Ahri,Katarina,1343,635,708,47.28
Ahri,Ashe,3558,1807,1751,50.79
Ahri,Yone,3199,1747,1452,54.61
Ahri,Nunu,763,365,398,47.84
Ahri,Irelia,1306,639,667,48.93
Ahri,Illaoi,782,386,396,49.36
Ahri,Xerath,1544,739,805,47.86
Ahri,Lulu,2353,1189,1164,50.53
Ahri,Graves,1137,535,602,47.05
Ahri,Brand,1333,593,740,44.49
Ahri,TahmKench,1243,619,624,49.8
Ahri,Heimerdinger,684,299,385,43.71
Ahri,LeeSin,2566,1328,1238,51.75
Ahri,Ezreal,4141,2086,2055,50.37
Ahri,Pyke,1279,615,664,48.08
Ahri,Diana,2840,1346,1494,47.39
Ahri,MasterYi,2028,1014,1014,50
Ahri,Garen,2635,1337,1298,50.74
Ahri,DrMundo,978,457,521,46.73
Ahri,AurelionSol,632,300,332,47.47
Ahri,Nami,1606,761,845,47.38
Ahri,Fiora,567,304,263,53.62
Ahri,Shaco,1594,710,884,44.54
Ahri,Swain,1795,827,968,46.07
Ahri,Velkoz,969,461,508,47.57
Ahri,Ekko,1624,796,828,49.01
Ahri,Darius,3201,1566,1635,48.92
Ahri,Zoe,702,328,374,46.72
Ahri,Anivia,520,272,248,52.31
Ahri,MonkeyKing,1203,576,627,47.88
Ahri,Kayle,1066,513,553,48.12
Ahri,Nautilus,1904,961,943,50.47
Ahri,Malphite,1633,775,858,47.46
Ahri,Ziggs,556,279,277,50.18
Ahri,Neeko,744,383,361,51.48
Ahri,Sona,553,252,301,45.57
Ahri,Jayce,903,461,442,51.05
Ahri,Zyra,1530,654,876,42.75
Ahri,Akshan,668,350,318,52.4
Ahri,Zilean,585,291,294,49.74
Ahri,Trundle,918,414,504,45.1
Ahri,Viktor,1423,749,674,52.64
Ahri,Yuumi,1252,612,640,48.88
Ahri,Quinn,542,276,266,50.92
Ahri,Akali,1802,876,926,48.61
Ahri,Sivir,1011,477,534,47.18
Ahri,Aurora,1275,656,619,51.45
Ahri,Azir,634,358,276,56.47
Ahri,Blitzcrank,1259,722,537,57.35
Ahri,Urgot,798,343,455,42.98
Ahri,Hecarim,683,381,302,55.78
Ahri,Udyr,598,284,314,47.49
Ahri,Rumble,469,229,240,48.83
Ahri,FiddleSticks,720,374,346,51.94
Ahri,Pantheon,2649,1317,1332,49.72
Ahri,Rengar,500,254,246,50.8
Ahri,Senna,1329,610,719,45.9
Ahri,Taric,325,155,170,47.69
Ahri,Gnar,708,357,351,50.42
Ahri,Viego,2212,1127,1085,50.95
Ahri,Kassadin,390,204,186,52.31
Ahri,Kennen,449,225,224,50.11
Ahri,Kled,257,142,115,55.25
Ahri,Rammus,498,256,242,51.41
Ahri,Shyvana,421,228,193,54.16
Ahri,Smolder,981,495,486,50.46
Ahri,Annie,627,325,302,51.83
Ahri,Draven,758,370,388,48.81
Ahri,Kindred,759,359,400,47.3
Ahri,Orianna,893,432,461,48.38
Ahri,Malzahar,1833,800,1033,43.64
Ahri,Talon,977,521,456,53.33
Ahri,Bard,550,266,284,48.36
Ahri,Khazix,790,414,376,52.41
Ahri,Nilah,489,258,231,52.76
Ahri,Fizz,929,421,508,45.32
Ahri,Sion,1213,596,617,49.13
Ahri,Varus,1464,736,728,50.27
Ahri,Aphelios,854,441,413,51.64
Ahri,Naafiri,461,211,250,45.77
Ahri,Tryndamere,878,455,423,51.82
Ahri,Ornn,672,326,346,48.51
Ahri,Vex,1013,493,520,48.67
Ahri,Qiyana,399,197,202,49.37
Ahri,Renata,257,139,118,54.09
Ahri,Ryze,592,267,325,45.1
Ahri,Belveth,341,144,197,42.23
Ahri,Rakan,660,321,339,48.64
Ahri,Janna,495,261,234,52.73
Ahri,Volibear,1798,883,915,49.11
Ahri,Ambessa,1020,532,488,52.16
Ahri,Zeri,686,331,355,48.25
Ahri,Twitch,1282,669,613,52.18
Ahri,KogMaw,506,250,256,49.41
Ahri,Kalista,364,210,154,57.69
Ahri,XinZhao,1200,598,602,49.83
Ahri,Gwen,808,432,376,53.47
Ahri,Zac,767,389,378,50.72
Ahri,Olaf,379,191,188,50.4
Ahri,TwistedFate,669,357,312,53.36
Ahri,Cassiopeia,503,250,253,49.7
Ahri,Singed,383,171,212,44.65
Ahri,Camille,620,313,307,50.48
Ahri,Karthus,382,202,180,52.88
Ahri,Lissandra,563,274,289,48.67
Ahri,Nidalee,534,306,228,57.3
Ahri,Ivern,233,98,135,42.06
Ahri,RekSai,239,122,117,51.05
Vladimir,Sion,615,318,297,51.71
Vladimir,MasterYi,1028,482,546,46.89
Vladimir,Annie,326,145,181,44.48
Vladimir,Ezreal,2123,1097,1026,51.67
Vladimir,Lux,1915,966,949,50.44
Vladimir,Poppy,544,280,264,51.47
Vladimir,Zac,473,228,245,48.2
Vladimir,Chogath,1072,487,585,45.43
Vladimir,Xayah,392,206,186,52.55
Vladimir,Nami,936,433,503,46.26
Vladimir,Yorick,765,332,433,43.4
Vladimir,Ahri,1085,555,530,51.15
Vladimir,Morgana,858,423,435,49.3
Vladimir,Rumble,308,135,173,43.83
Vladimir,Kayn,1339,660,679,49.29
Vladimir,Akshan,300,178,122,59.33
Vladimir,Jhin,1858,923,935,49.68
Vladimir,Yuumi,695,306,389,44.03
Vladimir,Renekton,441,250,191,56.69
Vladimir,Evelynn,256,141,115,55.08
Vladimir,Lissandra,348,165,183,47.41
Vladimir,Corki,376,202,174,53.72
Vladimir,Rakan,400,188,212,47
Vladimir,Viktor,708,309,399,43.64
Vladimir,Nocturne,1077,491,586,45.59
Vladimir,Veigar,785,383,402,48.79
Vladimir,Brand,621,296,325,47.67
Vladimir,Shaco,795,378,417,47.55
Vladimir,Caitlyn,2387,1127,1260,47.21
Vladimir,Yasuo,1942,987,955,50.82
Vladimir,Zed,1100,550,550,50
Vladimir,Xerath,667,302,365,45.28
Vladimir,Illaoi,337,174,163,51.63
Vladimir,Briar,512,256,256,50
Vladimir,Katarina,802,439,363,54.74
Vladimir,Seraphine,593,311,282,52.45
Vladimir,Camille,346,198,148,57.23
Vladimir,Jinx,2565,1291,1274,50.33
Vladimir,Urgot,416,179,237,43.03
Vladimir,Rammus,268,115,153,42.91
Vladimir,Lulu,1411,748,663,53.01
Vladimir,Garen,1197,605,592,50.54
Vladimir,Nidalee,292,153,139,52.4
Vladimir,Akali,929,495,434,53.28
Vladimir,Olaf,215,123,92,57.21
Vladimir,Trundle,399,205,194,51.38
Vladimir,Vex,408,235,173,57.6
Vladimir,Talon,570,315,255,55.26
Vladimir,Diana,1422,668,754,46.98
Vladimir,Velkoz,515,258,257,50.1
Vladimir,Ambessa,484,263,221,54.34
Vladimir,Hecarim,380,209,171,55
Vladimir,Gragas,476,261,215,54.83
Vladimir,Fizz,567,315,252,55.56
Vladimir,Varus,675,346,329,51.26
Vladimir,Braum,552,263,289,47.64
Vladimir,Aatrox,698,349,349,50
Vladimir,Rengar,286,166,120,58.04
Vladimir,Neeko,342,183,159,53.51
Vladimir,Swain,857,445,412,51.93
Vladimir,Teemo,1107,558,549,50.41
Vladimir,Darius,1641,760,881,46.31
Vladimir,Sona,283,122,161,43.11
Vladimir,LeeSin,1293,674,619,52.13
Vladimir,Nautilus,908,466,442,51.32
Vladimir,Ashe,1697,822,875,48.44
Vladimir,Warwick,1054,493,561,46.77
Vladimir,Leona,719,345,374,47.98
Vladimir,Karma,1135,607,528,53.48
Vladimir,Shen,557,286,271,51.35
Vladimir,Zyra,865,410,455,47.4
Vladimir,Singed,249,118,131,47.39
Vladimir,MonkeyKing,649,326,323,50.23
Vladimir,Orianna,441,207,234,46.94
Vladimir,Draven,469,239,230,50.96
Vladimir,Pantheon,1403,659,744,46.97
Vladimir,Twitch,714,345,369,48.32
Vladimir,Galio,740,405,335,54.73
Vladimir,Yone,1665,814,851,48.89
Vladimir,Lucian,631,344,287,54.52
Vladimir,Volibear,908,432,476,47.58
Vladimir,Janna,312,157,155,50.32
Vladimir,Elise,676,355,321,52.51
Vladimir,Mel,1850,975,875,52.7
Vladimir,MissFortune,1728,860,868,49.77
Vladimir,Pyke,616,329,287,53.41
Vladimir,Sett,1093,534,559,48.86
Vladimir,Viego,1298,599,699,46.15
Vladimir,Malzahar,994,453,541,45.57
Vladimir,Lillia,441,213,228,48.3
Vladimir,Kaisa,1460,741,719,50.75
Vladimir,Gwen,510,281,229,55.1
Vladimir,JarvanIV,545,268,277,49.17
Vladimir,Ekko,843,383,460,45.43
Vladimir,Aphelios,464,217,247,46.77
Vladimir,Taric,215,99,116,46.05
Vladimir,Nasus,649,308,341,47.46
Vladimir,Irelia,782,380,402,48.59
Vladimir,Kennen,306,152,154,49.67
Vladimir,Thresh,1103,532,571,48.23
Vladimir,Leblanc,578,310,268,53.63
Vladimir,Milio,624,278,346,44.55
Vladimir,Senna,634,301,333,47.48
Vladimir,Vi,791,440,351,55.63
Vladimir,Sejuani,400,231,169,57.75
Vladimir,Sivir,498,216,282,43.37
Vladimir,Soraka,494,208,286,42.11
Vladimir,Heimerdinger,404,200,204,49.5
Vladimir,Qiyana,222,127,95,57.21
Vladimir,Kassadin,252,119,133,47.22
Vladimir,Kindred,407,208,199,51.11
Vladimir,Kayle,667,297,370,44.53
Vladimir,Jax,852,456,396,53.52
Vladimir,Udyr,305,163,142,53.44
Vladimir,Vayne,1303,630,673,48.35
Vladimir,Samira,522,254,268,48.66
Vladimir,Quinn,299,146,153,48.83
Vladimir,Bard,227,129,98,56.83
Vladimir,Smolder,462,230,232,49.78
Vladimir,RekSai,109,66,43,60.55
Vladimir,FiddleSticks,461,225,236,48.81
Vladimir,XinZhao,555,281,274,50.63
Vladimir,Blitzcrank,588,272,316,46.26
Vladimir,Ornn,353,154,199,43.63
Vladimir,Karthus,298,170,128,57.05
Vladimir,KSante,385,229,156,59.48
Vladimir,Renata,114,66,48,57.89
Vladimir,Sylas,1251,635,616,50.76
Vladimir,Gnar,346,174,172,50.29
Vladimir,Mordekaiser,1118,548,570,49.02
Vladimir,TahmKench,578,261,317,45.16
Vladimir,Ziggs,263,148,115,56.27
Vladimir,Riven,452,208,244,46.02
Vladimir,Zoe,329,156,173,47.42
Vladimir,Alistar,377,180,197,47.75
Vladimir,Khazix,471,222,249,47.13
Vladimir,DrMundo,482,230,252,47.72
Vladimir,Aurora,586,277,309,47.27
Vladimir,Graves,573,278,295,48.52
Vladimir,Tristana,866,463,403,53.46
Vladimir,Ryze,434,218,216,50.23
Vladimir,Zilean,301,134,167,44.52
Vladimir,Syndra,524,235,289,44.85
Vladimir,Hwei,513,253,260,49.32
Vladimir,Zeri,364,166,198,45.6
Vladimir,Malphite,733,372,361,50.75
Vladimir,Maokai,379,200,179,52.77
Vladimir,Skarner,213,111,102,52.11
Vladimir,Amumu,820,353,467,43.05
Vladimir,Jayce,455,234,221,51.43
Vladimir,Naafiri,254,129,125,50.79
Vladimir,TwistedFate,253,116,137,45.85
Vladimir,Gangplank,528,261,267,49.43
Vladimir,Azir,289,153,136,52.94
Vladimir,Fiora,350,188,162,53.71
Vladimir,AurelionSol,320,133,187,41.56
Vladimir,Shyvana,253,136,117,53.75
Vladimir,Nunu,387,198,189,51.16
Vladimir,Ivern,103,35,68,33.98
Vladimir,Tryndamere,469,213,256,45.42
Vladimir,Anivia,266,126,140,47.37
Vladimir,Rell,390,174,216,44.62
Vladimir,Cassiopeia,277,132,145,47.65
Vladimir,Belveth,196,115,81,58.67
Vladimir,Nilah,244,95,149,38.93
Vladimir,Kalista,196,93,103,47.45
Vladimir,Taliyah,173,89,84,51.45
Vladimir,Kled,168,85,83,50.6
Vladimir,KogMaw,285,148,137,51.93
Rammus,Sion,261,106,155,40.61
Rammus,MasterYi,1454,811,643,55.78
Rammus,Annie,110,62,48,56.36
Rammus,Ezreal,877,449,428,51.2
Rammus,Lux,963,497,466,51.61
Rammus,Warwick,680,335,345,49.26
Rammus,Vi,335,163,172,48.66
Rammus,Irelia,413,225,188,54.48
Rammus,Caitlyn,1063,591,472,55.6
Rammus,Nautilus,474,267,207,56.33
Rammus,Tryndamere,299,145,154,48.49
Rammus,Lillia,300,144,156,48
Rammus,Viktor,345,189,156,54.78
Rammus,Tristana,401,216,185,53.87
Rammus,Senna,264,143,121,54.17
Rammus,Yorick,382,190,192,49.74
Rammus,Kindred,156,76,80,48.72
Rammus,Veigar,386,187,199,48.45
Rammus,Darius,776,380,396,48.97
Rammus,Mel,674,349,325,51.78
Rammus,Jinx,1244,597,647,47.99
Rammus,Thresh,543,276,267,50.83
Rammus,Gangplank,186,90,96,48.39
Rammus,Hecarim,150,84,66,56
Rammus,Aurora,197,103,94,52.28
Rammus,Jhin,789,363,426,46.01
Rammus,Brand,285,126,159,44.21
Rammus,Lissandra,134,55,79,41.04
Rammus,Volibear,419,213,206,50.84
Rammus,Vladimir,268,153,115,57.09
Rammus,Lucian,285,150,135,52.63
Rammus,Nami,366,185,181,50.55
Rammus,Elise,247,130,117,52.63
Rammus,Anivia,156,85,71,54.49
Rammus,Swain,324,147,177,45.37
Rammus,Pyke,350,195,155,55.71
Rammus,Camille,123,77,46,62.6
Rammus,Kayn,515,255,260,49.51
Rammus,Quinn,129,71,58,55.04
Rammus,Yuumi,349,196,153,56.16
Rammus,Sett,559,280,279,50.09
Rammus,Katarina,320,190,130,59.38
Rammus,Aphelios,188,97,91,51.6
Rammus,Poppy,234,110,124,47.01
Rammus,Ambessa,180,106,74,58.89
Rammus,LeeSin,558,313,245,56.09
Rammus,Varus,352,153,199,43.47
Rammus,Xerath,315,130,185,41.27
Rammus,Malzahar,400,198,202,49.5
Rammus,Draven,209,101,108,48.33
Rammus,Rakan,155,65,90,41.94
Rammus,Illaoi,220,91,129,41.36
Rammus,Shaco,289,125,164,43.25
Rammus,Pantheon,650,335,315,51.54
Rammus,Diana,601,257,344,42.76
Rammus,Smolder,260,140,120,53.85
Rammus,Leona,393,208,185,52.93
Rammus,Kennen,82,49,33,59.76
Rammus,Talon,227,124,103,54.63
Rammus,Soraka,225,98,127,43.56
Rammus,Velkoz,215,87,128,40.47
Rammus,Nocturne,549,247,302,44.99
Rammus,Seraphine,268,105,163,39.18
Rammus,Sejuani,187,95,92,50.8
Rammus,Yone,900,491,409,54.56
Rammus,Yasuo,987,525,462,53.19
Rammus,Zac,143,74,69,51.75
Rammus,Mordekaiser,510,209,301,40.98
Rammus,Naafiri,117,63,54,53.85
Rammus,Garen,654,331,323,50.61
Rammus,MissFortune,922,432,490,46.85
Rammus,Morgana,498,248,250,49.8
Rammus,Syndra,229,125,104,54.59
Rammus,Xayah,158,74,84,46.84
Rammus,Milio,207,100,107,48.31
Rammus,Zyra,332,180,152,54.22
Rammus,Amumu,381,133,248,34.91
Rammus,Zed,539,294,245,54.55
Rammus,Gwen,212,85,127,40.09
Rammus,Ashe,874,457,417,52.29
Rammus,Blitzcrank,274,152,122,55.47
Rammus,RekSai,44,20,24,45.45
Rammus,Gragas,195,90,105,46.15
Rammus,Sylas,519,274,245,52.79
Rammus,Ekko,331,146,185,44.11
Rammus,Renekton,184,97,87,52.72
Rammus,Shen,257,122,135,47.47
Rammus,Neeko,183,100,83,54.64
Rammus,Twitch,316,150,166,47.47
Rammus,Briar,377,202,175,53.58
Rammus,Ahri,498,242,256,48.59
Rammus,DrMundo,206,86,120,41.75
Rammus,Rumble,112,50,62,44.64
Rammus,Galio,392,186,206,47.45
Rammus,Sona,104,60,44,57.69
Rammus,Fiora,151,68,83,45.03
Rammus,Ziggs,129,63,66,48.84
Rammus,Vayne,631,315,316,49.92
Rammus,Lulu,563,290,273,51.51
Rammus,TahmKench,246,129,117,52.44
Rammus,Karma,386,177,209,45.85
Rammus,Teemo,490,250,240,51.02
Rammus,Zeri,119,55,64,46.22
Rammus,Karthus,110,54,56,49.09
Rammus,Samira,305,173,132,56.72
Rammus,Kled,52,26,26,50
Rammus,Fizz,246,134,112,54.47
Rammus,Trundle,313,173,140,55.27
Rammus,Hwei,203,102,101,50.25
Rammus,Taliyah,92,45,47,48.91
Rammus,Rell,172,80,92,46.51
Rammus,FiddleSticks,181,72,109,39.78
Rammus,Jax,350,206,144,58.86
Rammus,Kaisa,644,333,311,51.71
Rammus,Nasus,251,136,115,54.18
Rammus,Orianna,156,72,84,46.15
Rammus,AurelionSol,145,66,79,45.52
Rammus,MonkeyKing,231,93,138,40.26
Rammus,Rengar,112,71,41,63.39
Rammus,TwistedFate,107,54,53,50.47
Rammus,Taric,70,26,44,37.14
Rammus,KSante,206,110,96,53.4
Rammus,XinZhao,257,126,131,49.03
Rammus,Malphite,392,192,200,48.98
Rammus,Chogath,474,206,268,43.46
Rammus,Sivir,185,91,94,49.19
Rammus,Ornn,102,43,59,42.16
Rammus,Aatrox,377,225,152,59.68
Rammus,Singed,117,56,61,47.86
Rammus,Riven,217,134,83,61.75
Rammus,Jayce,140,104,36,74.29
Rammus,Azir,134,84,50,62.69
Rammus,Cassiopeia,111,40,71,36.04
Rammus,Viego,641,343,298,53.51
Rammus,Kalista,110,75,35,68.18
Rammus,Graves,235,120,115,51.06
Rammus,Gnar,125,59,66,47.2
Rammus,Kayle,300,156,144,52
Rammus,Urgot,228,126,102,55.26
Rammus,Qiyana,67,41,26,61.19
Rammus,Renata,63,36,27,57.14
Rammus,Khazix,177,98,79,55.37
Rammus,Janna,173,70,103,40.46
Rammus,Braum,269,133,136,49.44
Rammus,Alistar,170,93,77,54.71
Rammus,Akali,416,197,219,47.36
Rammus,Leblanc,198,97,101,48.99
Rammus,Ryze,164,81,83,49.39
Rammus,Nidalee,78,46,32,58.97
Rammus,Evelynn,99,48,51,48.48
Rammus,Heimerdinger,187,96,91,51.34
Rammus,Maokai,172,80,92,46.51
Rammus,Zilean,70,31,39,44.29
Rammus,JarvanIV,168,94,74,55.95
Rammus,Akshan,130,57,73,43.85
Rammus,Corki,129,68,61,52.71
Rammus,Bard,99,67,32,67.68
Rammus,Udyr,97,47,50,48.45
Rammus,Vex,191,90,101,47.12
Rammus,Kassadin,99,43,56,43.43
Rammus,KogMaw,131,67,64,51.15
Rammus,Nilah,121,69,52,57.02
Rammus,Ivern,38,20,18,52.63
Rammus,Belveth,98,59,39,60.2
Rammus,Nunu,153,52,101,33.99
Rammus,Olaf,77,35,42,45.45
Rammus,Skarner,55,38,17,69.09
Rammus,Zoe,139,79,60,56.83
Rammus,Shyvana,53,32,21,60.38
Katarina,Sion,649,340,309,52.39
Katarina,MasterYi,1208,581,627,48.1
Katarina,Annie,339,189,150,55.75
Katarina,Ezreal,2244,1145,1099,51.02
Katarina,Lux,2504,1237,1267,49.4
Katarina,Darius,1870,926,944,49.52
Katarina,Viego,1555,792,763,50.93
Katarina,Viktor,710,343,367,48.31
Katarina,Draven,545,257,288,47.16
Katarina,Leona,836,412,424,49.28
Katarina,Warwick,1459,624,835,42.77
Katarina,Khazix,478,256,222,53.56
Katarina,Yorick,910,446,464,49.01
Katarina,Vayne,1180,505,675,42.8
Katarina,Lulu,1478,723,755,48.92
Katarina,Gangplank,519,278,241,53.56
Katarina,Evelynn,349,158,191,45.27
Katarina,Mel,2160,1181,979,54.68
Katarina,Ashe,2115,1041,1074,49.22
Katarina,Elise,687,328,359,47.74
Katarina,Amumu,974,434,540,44.56
Katarina,Aurora,657,372,285,56.62
Katarina,Seraphine,700,342,358,48.86
Katarina,Renekton,541,266,275,49.17
Katarina,Diana,1663,774,889,46.54
Katarina,Azir,289,151,138,52.25
Katarina,MissFortune,2224,1041,1183,46.81
Katarina,Yuumi,771,425,346,55.12
Katarina,Gwen,491,266,225,54.18
Katarina,Nocturne,1216,564,652,46.38
Katarina,Veigar,1136,592,544,52.11
Katarina,Jinx,2745,1305,1440,47.54
Katarina,Morgana,1150,586,564,50.96
Katarina,Yasuo,1944,917,1027,47.17
Katarina,Kayn,1342,721,621,53.73
Katarina,Xayah,492,235,257,47.76
Katarina,Rakan,405,195,210,48.15
Katarina,Ambessa,630,348,282,55.24
Katarina,Graves,648,367,281,56.64
Katarina,Akali,1107,537,570,48.51
Katarina,Anivia,371,150,221,40.43
Katarina,Jax,866,453,413,52.31
Katarina,Shaco,1033,504,529,48.79
Katarina,Yone,1837,976,861,53.13
Katarina,KogMaw,307,122,185,39.74
Katarina,Shyvana,243,121,122,49.79
Katarina,Varus,979,505,474,51.58
Katarina,Mordekaiser,1203,558,645,46.38
Katarina,Vi,918,468,450,50.98
Katarina,Vex,509,260,249,51.08
Katarina,Xerath,807,386,421,47.83
Katarina,Karma,1283,662,621,51.6
Katarina,Teemo,1109,536,573,48.33
Katarina,Volibear,1124,542,582,48.22
Katarina,Vladimir,802,363,439,45.26
Katarina,JarvanIV,576,251,325,43.58
Katarina,Sivir,483,271,212,56.11
Katarina,Quinn,399,209,190,52.38
Katarina,Zac,450,189,261,42
Katarina,Brand,712,331,381,46.49
Katarina,Pantheon,1522,722,800,47.44
Katarina,MonkeyKing,695,324,371,46.62
Katarina,Kassadin,233,120,113,51.5
Katarina,Lucian,671,350,321,52.16
Katarina,Nami,1104,490,614,44.38
Katarina,Irelia,809,408,401,50.43
Katarina,Briar,748,346,402,46.26
Katarina,Pyke,801,435,366,54.31
Katarina,Kayle,674,329,345,48.81
Katarina,Malzahar,916,425,491,46.4
Katarina,TahmKench,703,395,308,56.19
Katarina,Camille,337,176,161,52.23
Katarina,Ekko,925,442,483,47.78
Katarina,Tristana,960,474,486,49.38
Katarina,Thresh,1326,676,650,50.98
Katarina,Garen,1590,787,803,49.5
Katarina,Udyr,306,145,161,47.39
Katarina,Jhin,2103,1063,1040,50.55
Katarina,Zyra,904,416,488,46.02
Katarina,Rammus,320,130,190,40.63
Katarina,Zed,1206,627,579,51.99
Katarina,Sylas,1336,678,658,50.75
Katarina,Swain,928,462,466,49.78
Katarina,Zilean,304,139,165,45.72
Katarina,KSante,466,229,237,49.14
Katarina,Trundle,552,274,278,49.64
Katarina,Sejuani,395,194,201,49.11
Katarina,Nautilus,1049,520,529,49.57
Katarina,Ahri,1343,708,635,52.72
Katarina,Caitlyn,2717,1378,1339,50.72
Katarina,Poppy,528,262,266,49.62
Katarina,Fizz,551,267,284,48.46
Katarina,Orianna,401,233,168,58.1
Katarina,Belveth,284,153,131,53.87
Katarina,Qiyana,304,174,130,57.24
Katarina,Corki,472,233,239,49.36
Katarina,Sett,1445,683,762,47.27
Katarina,Rengar,310,181,129,58.39
Katarina,Zoe,375,185,190,49.33
Katarina,Kennen,208,85,123,40.87
Katarina,Singed,275,120,155,43.64
Katarina,Talon,643,348,295,54.12
Katarina,Samira,681,340,341,49.93
Katarina,Akshan,304,137,167,45.07
Katarina,Gragas,579,285,294,49.22
Katarina,Janna,395,209,186,52.91
Katarina,Milio,658,296,362,44.98
Katarina,Ziggs,347,158,189,45.53
Katarina,Heimerdinger,466,199,267,42.7
Katarina,DrMundo,555,278,277,50.09
Katarina,Twitch,796,421,375,52.89
Katarina,Kled,142,61,81,42.96
Katarina,Zeri,409,224,185,54.77
Katarina,Renata,163,85,78,52.15
Katarina,Jayce,507,257,250,50.69
Katarina,Soraka,590,273,317,46.27
Katarina,TwistedFate,323,138,185,42.72
Katarina,Kaisa,1598,864,734,54.07
Katarina,Urgot,477,204,273,42.77
Katarina,Lillia,521,261,260,50.1
Katarina,Riven,521,264,257,50.67
Katarina,RekSai,143,77,66,53.85
Katarina,Fiora,373,201,172,53.89
Katarina,Syndra,639,331,308,51.8
Katarina,Shen,586,270,316,46.08
Katarina,Olaf,204,109,95,53.43
Katarina,LeeSin,1453,813,640,55.95
Katarina,Malphite,1011,492,519,48.66
Katarina,AurelionSol,406,224,182,55.17
Katarina,Smolder,587,295,292,50.26
Katarina,Alistar,400,196,204,49
Katarina,Bard,266,150,116,56.39
Katarina,Chogath,1177,489,688,41.55
Katarina,Rumble,288,156,132,54.17
Katarina,Kalista,244,132,112,54.1
Katarina,Senna,604,314,290,51.99
Katarina,Illaoi,460,233,227,50.65
Katarina,Nasus,663,306,357,46.15
Katarina,Nunu,464,270,194,58.19
Katarina,Hwei,687,330,357,48.03
Katarina,Tryndamere,604,284,320,47.02
Katarina,Cassiopeia,289,130,159,44.98
Katarina,Gnar,367,174,193,47.41
Katarina,Nidalee,274,165,109,60.22
Katarina,Ornn,335,206,129,61.49
Katarina,Sona,267,117,150,43.82
Katarina,Naafiri,294,119,175,40.48
Katarina,Taliyah,198,92,106,46.46
Katarina,Hecarim,416,205,211,49.28
Katarina,Blitzcrank,653,327,326,50.08
Katarina,Leblanc,567,293,274,51.68
Katarina,Velkoz,591,294,297,49.75
Katarina,Maokai,369,191,178,51.76
Katarina,Rell,432,193,239,44.68
Katarina,Aphelios,536,270,266,50.37
Katarina,Aatrox,939,486,453,51.76
Katarina,XinZhao,686,346,340,50.44
Katarina,Galio,1001,427,574,42.66
Katarina,Lissandra,416,220,196,52.88
Katarina,Karthus,320,152,168,47.5
Katarina,Neeko,398,211,187,53.02
Katarina,Kindred,386,169,217,43.78
Katarina,Ivern,158,88,70,55.7
Katarina,FiddleSticks,513,235,278,45.81
Katarina,Skarner,220,120,100,54.55
Katarina,Nilah,319,156,163,48.9
Katarina,Braum,579,284,295,49.05
Katarina,Taric,193,109,84,56.48
Katarina,Ryze,308,122,186,39.61
Draven,Sion,515,241,274,46.8
Draven,MasterYi,800,409,391,51.13
Draven,Annie,240,117,123,48.75
Draven,Ezreal,1497,738,759,49.3
Draven,Lux,1666,848,818,50.9
Draven,Pantheon,945,521,424,55.13
Draven,Belveth,175,86,89,49.14
Draven,Katarina,545,288,257,52.84
Draven,KogMaw,220,133,87,60.45
Draven,Ambessa,346,208,138,60.12
Draven,Graves,474,275,199,58.02
Draven,Akali,546,281,265,51.47
Draven,Anivia,217,92,125,42.4
Draven,Leona,577,261,316,45.23
Draven,Garen,941,462,479,49.1
Draven,Diana,1001,511,490,51.05
Draven,Varus,639,344,295,53.83
Draven,Shaco,669,368,301,55.01
Draven,Trundle,339,141,198,41.59
Draven,Veigar,690,314,376,45.51
Draven,Caitlyn,1861,905,956,48.63
Draven,Mel,1343,687,656,51.15
Draven,Udyr,267,125,142,46.82
Draven,FiddleSticks,290,146,144,50.34
Draven,Kennen,163,78,85,47.85
Draven,Nilah,188,82,106,43.62
Draven,Taric,169,71,98,42.01
Draven,Riven,439,235,204,53.53
Draven,Nunu,357,145,212,40.62
Draven,Zoe,257,113,144,43.97
Draven,XinZhao,440,220,220,50
Draven,TahmKench,495,269,226,54.34
Draven,Rammus,209,108,101,51.67
Draven,Zed,737,409,328,55.5
Draven,Ashe,1443,721,722,49.97
Draven,Yorick,700,287,413,41
Draven,Volibear,815,405,410,49.69
Draven,Vladimir,469,230,239,49.04
Draven,Zeri,243,120,123,49.38
Draven,Senna,440,202,238,45.91
Draven,Warwick,1030,513,517,49.81
Draven,LeeSin,934,483,451,51.71
Draven,Sylas,892,434,458,48.65
Draven,Pyke,515,240,275,46.6
Draven,Talon,396,198,198,50
Draven,Twitch,580,299,281,51.55
Draven,Neeko,286,130,156,45.45
Draven,Jax,573,293,280,51.13
Draven,Ryze,263,138,125,52.47
Draven,Swain,556,260,296,46.76
Draven,Nocturne,830,406,424,48.92
Draven,Aphelios,348,168,180,48.28
Draven,Teemo,810,361,449,44.57
Draven,Kayle,533,244,289,45.78
Draven,Jayce,317,178,139,56.15
Draven,Morgana,696,350,346,50.29
Draven,Amumu,707,311,396,43.99
Draven,Irelia,528,277,251,52.46
Draven,MissFortune,1539,721,818,46.85
Draven,Poppy,357,163,194,45.66
Draven,Mordekaiser,745,377,368,50.6
Draven,Kaisa,1103,624,479,56.57
Draven,Yasuo,1253,575,678,45.89
Draven,Hecarim,322,166,156,51.55
Draven,Jhin,1377,671,706,48.73
Draven,Zyra,560,252,308,45
Draven,Ekko,613,298,315,48.61
Draven,Yone,1118,595,523,53.22
Draven,Lulu,935,507,428,54.22
Draven,Tryndamere,397,182,215,45.84
Draven,Leblanc,374,192,182,51.34
Draven,Sivir,313,162,151,51.76
Draven,Nami,778,376,402,48.33
Draven,Sett,870,347,523,39.89
Draven,Kayn,906,444,462,49.01
Draven,Brand,525,237,288,45.14
Draven,Rengar,202,91,111,45.05
Draven,Jinx,2006,966,1040,48.16
Draven,Yuumi,544,304,240,55.88
Draven,DrMundo,360,174,186,48.33
Draven,Xerath,607,313,294,51.57
Draven,Aatrox,680,384,296,56.47
Draven,Karma,829,423,406,51.03
Draven,Kalista,175,101,74,57.71
Draven,Braum,483,224,259,46.38
Draven,Shen,425,211,214,49.65
Draven,Soraka,464,239,225,51.51
Draven,Gragas,370,208,162,56.22
Draven,Sejuani,280,147,133,52.5
Draven,Malzahar,724,346,378,47.79
Draven,Darius,1262,613,649,48.57
Draven,Seraphine,479,253,226,52.82
Draven,Gangplank,358,157,201,43.85
Draven,Smolder,439,226,213,51.48
Draven,Aurora,455,250,205,54.95
Draven,Olaf,202,114,88,56.44
Draven,Lissandra,225,93,132,41.33
Draven,Rumble,168,77,91,45.83
Draven,Chogath,782,363,419,46.42
Draven,Ahri,758,388,370,51.19
Draven,Janna,263,138,125,52.47
Draven,Thresh,939,452,487,48.14
Draven,Ornn,279,148,131,53.05
Draven,Quinn,235,118,117,50.21
Draven,Kindred,285,123,162,43.16
Draven,Azir,239,126,113,52.72
Draven,Malphite,710,362,348,50.99
Draven,Qiyana,175,95,80,54.29
Draven,MonkeyKing,438,225,213,51.37
Draven,Briar,492,232,260,47.15
Draven,Nasus,439,207,232,47.15
Draven,Illaoi,275,111,164,40.36
Draven,Viktor,604,312,292,51.66
Draven,JarvanIV,511,279,232,54.6
Draven,Shyvana,170,82,88,48.24
Draven,Hwei,450,245,205,54.44
Draven,Corki,284,125,159,44.01
Draven,Orianna,256,134,122,52.34
Draven,Lucian,496,299,197,60.28
Draven,Vi,616,315,301,51.14
Draven,Fizz,362,180,182,49.72
Draven,Rell,282,134,148,47.52
Draven,Urgot,394,186,208,47.21
Draven,Lillia,341,204,137,59.82
Draven,Milio,397,218,179,54.91
Draven,Galio,564,270,294,47.87
Draven,Ziggs,243,104,139,42.8
Draven,Velkoz,441,214,227,48.53
Draven,Kassadin,117,58,59,49.57
Draven,Vayne,935,473,462,50.59
Draven,Gnar,239,123,116,51.46
Draven,Nautilus,706,327,379,46.32
Draven,Karthus,225,128,97,56.89
Draven,Naafiri,210,107,103,50.95
Draven,TwistedFate,323,162,161,50.15
Draven,Gwen,322,155,167,48.14
Draven,Tristana,598,302,296,50.5
Draven,Xayah,321,167,154,52.02
Draven,Alistar,307,130,177,42.35
Draven,Elise,435,230,205,52.87
Draven,Sona,213,95,118,44.6
Draven,Evelynn,216,97,119,44.91
Draven,Fiora,228,84,144,36.84
Draven,Viego,884,402,482,45.48
Draven,Blitzcrank,376,216,160,57.45
Draven,Heimerdinger,291,134,157,46.05
Draven,Nidalee,179,89,90,49.72
Draven,Singed,179,87,92,48.6
Draven,Zilean,172,88,84,51.16
Draven,Kled,121,58,63,47.93
Draven,Renekton,314,186,128,59.24
Draven,Zac,318,169,149,53.14
Draven,Akshan,254,126,128,49.61
Draven,Camille,271,133,138,49.08
Draven,Rakan,247,86,161,34.82
Draven,Khazix,334,160,174,47.9
Draven,Syndra,516,252,264,48.84
Draven,Skarner,142,69,73,48.59
Draven,Cassiopeia,203,86,117,42.36
Draven,Vex,265,111,154,41.89
Draven,AurelionSol,263,139,124,52.85
Draven,Samira,480,227,253,47.29
Draven,Ivern,86,43,43,50
Draven,Bard,195,92,103,47.18
Draven,Taliyah,155,54,101,34.84
Draven,Renata,127,65,62,51.18
Draven,KSante,335,183,152,54.63
Draven,Maokai,244,136,108,55.74
Draven,RekSai,86,55,31,63.95
Senna,Sion,716,344,372,48.04
Senna,MasterYi,1132,555,577,49.03
Senna,Annie,315,158,157,50.16
Senna,Ezreal,2259,1114,1145,49.31
Senna,Lux,2367,1095,1272,46.26
Senna,Poppy,543,258,285,47.51
Senna,Zac,400,195,205,48.75
Senna,Chogath,1102,542,560,49.18
Senna,Xayah,416,220,196,52.88
Senna,Nami,1002,477,525,47.6
Senna,Yorick,965,416,549,43.11
Senna,Rammus,264,121,143,45.83
Senna,Yasuo,1876,921,955,49.09
Senna,Caitlyn,2581,1294,1287,50.14
Senna,Lulu,1483,730,753,49.22
Senna,Pantheon,1443,670,773,46.43
Senna,Gwen,404,213,191,52.72
Senna,Fizz,590,274,316,46.44
Senna,Jinx,2819,1373,1446,48.71
Senna,Ivern,148,64,84,43.24
Senna,Renekton,427,211,216,49.41
Senna,Gragas,504,229,275,45.44
Senna,Kaisa,1549,793,756,51.19
Senna,Nautilus,1150,575,575,50
Senna,Naafiri,267,141,126,52.81
Senna,Akali,964,493,471,51.14
Senna,Jhin,1850,875,975,47.3
Senna,Zyra,968,479,489,49.48
Senna,Kayn,1390,689,701,49.57
Senna,Vi,838,433,405,51.67
Senna,Ekko,926,456,470,49.24
Senna,Pyke,736,353,383,47.96
Senna,Singed,214,105,109,49.07
Senna,MonkeyKing,689,307,382,44.56
Senna,Orianna,380,193,187,50.79
Senna,Draven,440,238,202,54.09
Senna,Teemo,1172,586,586,50
Senna,Azir,292,120,172,41.1
Senna,Karthus,319,147,172,46.08
Senna,Seraphine,809,422,387,52.16
Senna,Jayce,509,257,252,50.49
Senna,Darius,1895,954,941,50.34
Senna,Diana,1477,759,718,51.39
Senna,Taric,181,97,84,53.59
Senna,Sett,1467,723,744,49.28
Senna,Volibear,960,457,503,47.6
Senna,Yone,1725,878,847,50.9
Senna,Sylas,1206,673,533,55.8
Senna,Jax,847,415,432,49
Senna,Rumble,245,119,126,48.57
Senna,Brand,678,302,376,44.54
Senna,Gangplank,412,200,212,48.54
Senna,Taliyah,269,116,153,43.12
Senna,Milio,626,314,312,50.16
Senna,Trundle,547,273,274,49.91
Senna,Kindred,442,205,237,46.38
Senna,Swain,998,482,516,48.3
Senna,Udyr,401,228,173,56.86
Senna,Lucian,701,386,315,55.06
Senna,Morgana,1267,649,618,51.22
Senna,Heimerdinger,446,197,249,44.17
Senna,Lillia,503,271,232,53.88
Senna,Vladimir,634,333,301,52.52
Senna,Illaoi,417,242,175,58.03
Senna,LeeSin,1148,560,588,48.78
Senna,Tristana,874,434,440,49.66
Senna,Janna,378,211,167,55.82
Senna,Aatrox,741,371,370,50.07
Senna,Sejuani,357,193,164,54.06
Senna,Ahri,1329,719,610,54.1
Senna,Kayle,655,310,345,47.33
Senna,Mordekaiser,1194,598,596,50.08
Senna,Blitzcrank,616,321,295,52.11
Senna,Veigar,918,459,459,50
Senna,Thresh,1248,630,618,50.48
Senna,Riven,433,216,217,49.88
Senna,Skarner,190,112,78,58.95
Senna,Galio,838,443,395,52.86
Senna,Viego,1384,693,691,50.07
Senna,Vayne,1164,619,545,53.18
Senna,Braum,535,299,236,55.89
Senna,Aurora,620,361,259,58.23
Senna,Zed,1013,515,498,50.84
Senna,Warwick,1416,681,735,48.09
Senna,Ashe,1846,866,980,46.91
Senna,Zilean,304,142,162,46.71
Senna,Xerath,778,377,401,48.46
Senna,Ambessa,577,313,264,54.25
Senna,Katarina,604,290,314,48.01
Senna,Ornn,434,173,261,39.86
Senna,Kennen,204,74,130,36.27
Senna,Quinn,412,195,217,47.33
Senna,Sivir,555,293,262,52.79
Senna,Rengar,252,114,138,45.24
Senna,Samira,655,317,338,48.4
Senna,Smolder,546,288,258,52.75
Senna,Bard,312,182,130,58.33
Senna,Anivia,323,144,179,44.58
Senna,Nocturne,1194,519,675,43.47
Senna,Karma,1235,611,624,49.47
Senna,Nunu,442,235,207,53.17
Senna,Zeri,395,195,200,49.37
Senna,XinZhao,587,265,322,45.14
Senna,TahmKench,772,388,384,50.26
Senna,Irelia,732,348,384,47.54
Senna,Ziggs,347,161,186,46.4
Senna,Sona,313,159,154,50.8
Senna,Malzahar,1043,473,570,45.35
Senna,Twitch,778,377,401,48.46
Senna,Shen,609,351,258,57.64
Senna,Nasus,591,282,309,47.72
Senna,Amumu,1021,499,522,48.87
Senna,FiddleSticks,438,244,194,55.71
Senna,Tryndamere,561,295,266,52.58
Senna,Ryze,323,143,180,44.27
Senna,Aphelios,521,268,253,51.44
Senna,Graves,583,307,276,52.66
Senna,Velkoz,593,259,334,43.68
Senna,Varus,843,424,419,50.3
Senna,Garen,1565,781,784,49.9
Senna,Corki,361,209,152,57.89
Senna,DrMundo,481,208,273,43.24
Senna,Maokai,405,214,191,52.84
Senna,Mel,1976,1054,922,53.34
Senna,Camille,340,189,151,55.59
Senna,Talon,609,330,279,54.19
Senna,MissFortune,2195,1034,1161,47.11
Senna,Kled,152,68,84,44.74
Senna,Belveth,204,106,98,51.96
Senna,Alistar,329,148,181,44.98
Senna,AurelionSol,366,184,182,50.27
Senna,Kassadin,167,79,88,47.31
Senna,Soraka,551,280,271,50.82
Senna,Viktor,900,466,434,51.78
Senna,Shaco,929,482,447,51.88
Senna,Nidalee,258,148,110,57.36
Senna,Khazix,428,211,217,49.3
Senna,Neeko,408,212,196,51.96
Senna,Urgot,521,228,293,43.76
Senna,Elise,710,353,357,49.72
Senna,Lissandra,269,150,119,55.76
Senna,Evelynn,321,153,168,47.66
Senna,Rell,413,241,172,58.35
Senna,Gnar,417,203,214,48.68
Senna,Qiyana,230,138,92,60
Senna,Fiora,345,167,178,48.41
Senna,Hecarim,387,208,179,53.75
Senna,Cassiopeia,281,139,142,49.47
Senna,Briar,671,293,378,43.67
Senna,Rakan,357,148,209,41.46
Senna,Leona,619,295,324,47.66
Senna,Hwei,655,310,345,47.33
Senna,Kalista,198,94,104,47.47
Senna,Malphite,994,439,555,44.16
Senna,Vex,457,209,248,45.73
Senna,Renata,158,88,70,55.7
Senna,KSante,444,247,197,55.63
Senna,Shyvana,271,136,135,50.18
Senna,Nilah,245,110,135,44.9
Senna,Leblanc,507,283,224,55.82
Senna,Olaf,244,151,93,61.89
Senna,Zoe,350,193,157,55.14
Senna,KogMaw,330,157,173,47.58
Senna,JarvanIV,618,324,294,52.43
Senna,Akshan,307,134,173,43.65
Senna,Syndra,521,240,281,46.07
Senna,TwistedFate,309,137,172,44.34
Senna,Yuumi,795,366,429,46.04
Senna,RekSai,81,38,43,46.91
Sion,Vladimir,615,297,318,48.29
Sion,Rammus,261,155,106,59.39
Sion,Katarina,649,309,340,47.61
Sion,Draven,515,274,241,53.2
Sion,Senna,716,372,344,51.96
Sion,Garen,1527,720,807,47.15
Sion,Rengar,298,177,121,59.4
Sion,Lissandra,295,165,130,55.93
Sion,Tristana,913,433,480,47.43
Sion,Zyra,903,459,444,50.83
Sion,Kayn,1350,641,709,47.48
Sion,Shyvana,222,104,118,46.85
Sion,Annie,296,160,136,54.05
Sion,Varus,868,483,385,55.65
Sion,Lux,2138,1148,990,53.7
Sion,Warwick,1345,708,637,52.64
Sion,Ekko,897,465,432,51.84
Sion,Hwei,592,316,276,53.38
Sion,Jhin,1797,965,832,53.7
Sion,Nami,1025,502,523,48.98
Sion,Kayle,674,327,347,48.52
Sion,LeeSin,1251,722,529,57.71
Sion,Yasuo,1778,909,869,51.12
Sion,Caitlyn,2403,1228,1175,51.1
Sion,Karma,1091,504,587,46.2
Sion,Camille,281,138,143,49.11
Sion,Darius,1824,973,851,53.34
Sion,Viego,1442,746,696,51.73
Sion,Taliyah,269,108,161,40.15
Sion,Jinx,2673,1324,1349,49.53
Sion,Blitzcrank,575,283,292,49.22
Sion,Chogath,1237,614,623,49.64
Sion,Swain,843,387,456,45.91
Sion,Jax,762,380,382,49.87
Sion,Lillia,558,242,316,43.37
Sion,Malzahar,1170,562,608,48.03
Sion,Kaisa,1615,830,785,51.39
Sion,Seraphine,647,369,278,57.03
Sion,Aatrox,752,337,415,44.81
Sion,Rakan,349,175,174,50.14
Sion,Samira,530,312,218,58.87
Sion,AurelionSol,367,180,187,49.05
Sion,KSante,455,252,203,55.38
Sion,Brand,756,402,354,53.17
Sion,MonkeyKing,685,333,352,48.61
Sion,Alistar,441,214,227,48.53
Sion,MasterYi,1074,534,540,49.72
Sion,Corki,419,221,198,52.74
Sion,Mordekaiser,1128,575,553,50.98
Sion,Lulu,1370,646,724,47.15
Sion,DrMundo,474,257,217,54.22
Sion,Hecarim,438,224,214,51.14
Sion,Akali,922,472,450,51.19
Sion,Xerath,759,377,382,49.67
Sion,Yorick,1045,510,535,48.8
Sion,Orianna,388,203,185,52.32
Sion,Lucian,730,404,326,55.34
Sion,Pantheon,1431,784,647,54.79
Sion,Sylas,1271,694,577,54.6
Sion,Sejuani,366,201,165,54.92
Sion,KogMaw,322,150,172,46.58
Sion,Yone,1762,872,890,49.49
Sion,Ezreal,2276,1133,1143,49.78
Sion,Neeko,368,200,168,54.35
Sion,Mel,1793,947,846,52.82
Sion,XinZhao,610,344,266,56.39
Sion,Maokai,410,225,185,54.88
Sion,Gangplank,451,210,241,46.56
Sion,Shaco,893,483,410,54.09
Sion,Veigar,940,455,485,48.4
Sion,Smolder,619,324,295,52.34
Sion,Amumu,1034,455,579,44
Sion,Twitch,783,408,375,52.11
Sion,Janna,355,165,190,46.48
Sion,Nasus,739,368,371,49.8
Sion,Aurora,629,323,306,51.35
Sion,FiddleSticks,536,310,226,57.84
Sion,Sett,1550,816,734,52.65
Sion,Gwen,588,316,272,53.74
Sion,Zed,1155,632,523,54.72
Sion,Sona,279,112,167,40.14
Sion,Trundle,640,285,355,44.53
Sion,Khazix,457,234,223,51.2
Sion,Riven,397,200,197,50.38
Sion,Zoe,333,185,148,55.56
Sion,Renekton,379,210,169,55.41
Sion,Ahri,1213,617,596,50.87
Sion,Fizz,519,273,246,52.6
Sion,Volibear,1059,525,534,49.58
Sion,RekSai,115,57,58,49.57
Sion,MissFortune,2097,1082,1015,51.6
Sion,Kennen,240,107,133,44.58
Sion,Quinn,380,182,198,47.89
Sion,Nautilus,1017,516,501,50.74
Sion,Teemo,1383,675,708,48.81
Sion,Urgot,516,248,268,48.06
Sion,Ashe,1811,958,853,52.9
Sion,Zilean,375,187,188,49.87
Sion,Vayne,1361,637,724,46.8
Sion,Anivia,335,142,193,42.39
Sion,Nocturne,1175,534,641,45.45
Sion,Illaoi,382,192,190,50.26
Sion,Diana,1504,762,742,50.66
Sion,Gnar,342,168,174,49.12
Sion,Ziggs,339,161,178,47.49
Sion,Milio,561,269,292,47.95
Sion,Gragas,502,246,256,49
Sion,Morgana,1056,511,545,48.39
Sion,Zac,456,207,249,45.39
Sion,JarvanIV,545,266,279,48.81
Sion,Naafiri,277,161,116,58.12
Sion,Jayce,390,222,168,56.92
Sion,Tryndamere,529,253,276,47.83
Sion,Elise,701,390,311,55.63
Sion,Irelia,733,368,365,50.2
Sion,Vex,458,234,224,51.09
Sion,Qiyana,249,125,124,50.2
Sion,Syndra,661,344,317,52.04
Sion,Leona,747,414,333,55.42
Sion,Vi,867,442,425,50.98
Sion,Yuumi,726,366,360,50.41
Sion,Cassiopeia,252,123,129,48.81
Sion,Briar,670,314,356,46.87
Sion,Pyke,653,326,327,49.92
Sion,Ivern,119,55,64,46.22
Sion,Shen,682,324,358,47.51
Sion,Viktor,796,385,411,48.37
Sion,Graves,632,278,354,43.99
Sion,Poppy,474,269,205,56.75
Sion,Soraka,572,297,275,51.92
Sion,Evelynn,355,194,161,54.65
Sion,Kled,156,82,74,52.56
Sion,Talon,519,283,236,54.53
Sion,Malphite,1054,567,487,53.8
Sion,Rumble,251,135,116,53.78
Sion,Bard,312,183,129,58.65
Sion,Heimerdinger,467,250,217,53.53
Sion,Sivir,492,238,254,48.37
Sion,Braum,527,260,267,49.34
Sion,Velkoz,547,284,263,51.92
Sion,Thresh,1353,691,662,51.07
Sion,Kindred,447,227,220,50.78
Sion,Nunu,527,275,252,52.18
Sion,Leblanc,481,225,256,46.78
Sion,Nilah,294,125,169,42.52
Sion,TahmKench,635,335,300,52.76
Sion,Taric,232,108,124,46.55
Sion,Belveth,188,86,102,45.74
Sion,TwistedFate,312,203,109,65.06
Sion,Ambessa,592,285,307,48.14
Sion,Zeri,374,218,156,58.29
Sion,Galio,871,431,440,49.48
Sion,Azir,258,155,103,60.08
Sion,Xayah,387,173,214,44.7
Sion,Karthus,250,120,130,48
Sion,Olaf,203,106,97,52.22
Sion,Singed,379,166,213,43.8
Sion,Udyr,408,226,182,55.39
Sion,Fiora,424,194,230,45.75
Sion,Nidalee,275,155,120,56.36
Sion,Ornn,337,175,162,51.93
Sion,Kassadin,188,87,101,46.28
Sion,Ryze,283,141,142,49.82
Sion,Aphelios,581,335,246,57.66
Sion,Renata,144,84,60,58.33
Sion,Skarner,245,144,101,58.78
Sion,Rell,390,212,178,54.36
Sion,Akshan,307,196,111,63.84
Sion,Kalista,221,116,105,52.49
MasterYi,Vladimir,1028,546,482,53.11
MasterYi,Rammus,1454,643,811,44.22
MasterYi,Katarina,1208,627,581,51.9
MasterYi,Draven,800,391,409,48.88
MasterYi,Senna,1132,577,555,50.97
MasterYi,Poppy,834,451,383,54.08
MasterYi,Zac,580,284,296,48.97
MasterYi,Chogath,2028,968,1060,47.73
MasterYi,Xayah,743,379,364,51.01
MasterYi,Nami,1568,775,793,49.43
MasterYi,Nasus,1338,656,682,49.03
MasterYi,Nocturne,2331,1200,1131,51.48
MasterYi,Jhin,3400,1801,1599,52.97
MasterYi,Seraphine,1154,599,555,51.91
MasterYi,Ornn,589,300,289,50.93
MasterYi,Kayn,2528,1334,1194,52.77
MasterYi,Yasuo,3352,1892,1460,56.44
MasterYi,Caitlyn,4570,2313,2257,50.61
MasterYi,Morgana,2011,1047,964,52.06
MasterYi,Malzahar,1763,803,960,45.55
MasterYi,Vayne,2152,1043,1109,48.47
MasterYi,Lulu,1986,1073,913,54.03
MasterYi,Yorick,1765,816,949,46.23
MasterYi,Briar,1261,623,638,49.41
MasterYi,Nautilus,1910,974,936,50.99
MasterYi,Riven,704,341,363,48.44
MasterYi,Veigar,1737,879,858,50.6
MasterYi,Nilah,490,253,237,51.63
MasterYi,Lissandra,598,285,313,47.66
MasterYi,Teemo,2204,1114,1090,50.54
MasterYi,MissFortune,3970,2009,1961,50.6
MasterYi,Blitzcrank,1174,553,621,47.1
MasterYi,Garen,2798,1514,1284,54.11
MasterYi,Graves,1051,515,536,49
MasterYi,Diana,2922,1482,1440,50.72
MasterYi,Varus,1441,761,680,52.81
MasterYi,Shaco,1558,750,808,48.14
MasterYi,Belveth,310,156,154,50.32
MasterYi,Ashe,3380,1712,1668,50.65
MasterYi,Olaf,405,234,171,57.78
MasterYi,Leona,1518,687,831,45.26
MasterYi,Gragas,795,403,392,50.69
MasterYi,Zed,1902,1045,857,54.94
MasterYi,Sett,2337,1103,1234,47.2
MasterYi,Hecarim,582,314,268,53.95
MasterYi,Karma,1883,939,944,49.87
MasterYi,Trundle,929,417,512,44.89
MasterYi,Khazix,879,440,439,50.06
MasterYi,Tristana,1737,880,857,50.66
MasterYi,Thresh,2010,989,1021,49.2
MasterYi,Sylas,2006,1024,982,51.05
MasterYi,Swain,1548,808,740,52.2
MasterYi,JarvanIV,887,467,420,52.65
MasterYi,Twitch,1348,658,690,48.81
MasterYi,Gnar,600,276,324,46
MasterYi,TwistedFate,516,259,257,50.19
MasterYi,Volibear,1918,997,921,51.98
MasterYi,Lucian,1108,564,544,50.9
MasterYi,Ambessa,814,462,352,56.76
MasterYi,Lux,4328,2172,2156,50.18
MasterYi,Kayle,1045,551,494,52.73
MasterYi,LeeSin,2306,1153,1153,50
MasterYi,Jinx,4709,2370,2339,50.33
MasterYi,Pyke,1332,681,651,51.13
MasterYi,Akali,1768,885,883,50.06
MasterYi,TahmKench,1300,650,650,50
MasterYi,Mel,3238,1682,1556,51.95
MasterYi,Bard,423,241,182,56.97
MasterYi,Ekko,1527,753,774,49.31
MasterYi,Elise,1048,493,555,47.04
MasterYi,Aurora,1120,547,573,48.84
MasterYi,Ahri,2028,1014,1014,50
MasterYi,Viego,2314,1207,1107,52.16
MasterYi,Leblanc,867,445,422,51.33
MasterYi,Ivern,169,92,77,54.44
MasterYi,Warwick,2763,1314,1449,47.56
MasterYi,Syndra,914,476,438,52.08
MasterYi,Jax,1996,1015,981,50.85
MasterYi,Illaoi,830,449,381,54.1
MasterYi,Gangplank,726,364,362,50.14
MasterYi,Irelia,1412,731,681,51.77
MasterYi,Kaisa,2587,1366,1221,52.8
MasterYi,Velkoz,1014,513,501,50.59
MasterYi,Yone,3056,1644,1412,53.8
MasterYi,Neeko,796,420,376,52.76
MasterYi,Ziggs,627,298,329,47.53
MasterYi,Viktor,1490,769,721,51.61
MasterYi,Ezreal,3770,1943,1827,51.54
MasterYi,Braum,921,427,494,46.36
MasterYi,Sion,1074,540,534,50.28
MasterYi,Orianna,664,333,331,50.15
MasterYi,Soraka,819,447,372,54.58
MasterYi,MonkeyKing,1139,570,569,50.04
MasterYi,Karthus,469,264,205,56.29
MasterYi,Hwei,1016,493,523,48.52
MasterYi,Rakan,588,304,284,51.7
MasterYi,Xerath,1362,710,652,52.13
MasterYi,Brand,1296,695,601,53.63
MasterYi,Aphelios,752,373,379,49.6
MasterYi,KSante,772,381,391,49.35
MasterYi,Quinn,629,284,345,45.15
MasterYi,Darius,3136,1560,1576,49.74
MasterYi,Amumu,1849,916,933,49.54
MasterYi,Pantheon,2481,1282,1199,51.67
MasterYi,Vi,1580,754,826,47.72
MasterYi,FiddleSticks,801,421,380,52.56
MasterYi,Annie,519,266,253,51.25
MasterYi,Nunu,873,483,390,55.33
MasterYi,Zyra,1457,702,755,48.18
MasterYi,Kindred,690,365,325,52.9
MasterYi,Samira,1147,617,530,53.79
MasterYi,Tryndamere,1054,524,530,49.72
MasterYi,Yuumi,1266,687,579,54.27
MasterYi,Shyvana,387,224,163,57.88
MasterYi,Azir,458,240,218,52.4
MasterYi,Galio,1446,699,747,48.34
MasterYi,Malphite,1715,869,846,50.67
MasterYi,Skarner,355,182,173,51.27
MasterYi,Sejuani,641,337,304,52.57
MasterYi,Milio,798,367,431,45.99
MasterYi,Qiyana,441,206,235,46.71
MasterYi,Renekton,763,373,390,48.89
MasterYi,Taric,398,181,217,45.48
MasterYi,Alistar,692,342,350,49.42
MasterYi,Mordekaiser,2158,1152,1006,53.38
MasterYi,Zilean,503,224,279,44.53
MasterYi,Fiora,538,306,232,56.88
MasterYi,DrMundo,953,464,489,48.69
MasterYi,Shen,912,497,415,54.5
MasterYi,Rengar,523,320,203,61.19
MasterYi,Smolder,1052,582,470,55.32
MasterYi,Anivia,508,266,242,52.36
MasterYi,Corki,569,292,277,51.32
MasterYi,Naafiri,485,267,218,55.05
MasterYi,Zeri,591,291,300,49.24
MasterYi,Rell,648,309,339,47.69
MasterYi,Udyr,677,332,345,49.04
MasterYi,AurelionSol,635,336,299,52.91
MasterYi,Rumble,368,198,170,53.8
MasterYi,Lillia,713,371,342,52.03
MasterYi,Maokai,661,328,333,49.62
MasterYi,Kennen,371,190,181,51.21
MasterYi,Nidalee,368,202,166,54.89
MasterYi,Zoe,655,324,331,49.47
MasterYi,Taliyah,340,164,176,48.24
MasterYi,Sivir,799,398,401,49.81
MasterYi,Aatrox,1424,750,674,52.67
MasterYi,Evelynn,527,285,242,54.08
MasterYi,Urgot,888,393,495,44.26
MasterYi,Talon,810,415,395,51.23
MasterYi,Jayce,705,350,355,49.65
MasterYi,Gwen,787,439,348,55.78
MasterYi,XinZhao,1050,494,556,47.05
MasterYi,KogMaw,416,185,231,44.47
MasterYi,Cassiopeia,366,187,179,51.09
MasterYi,Janna,450,214,236,47.56
MasterYi,Fizz,1055,589,466,55.83
MasterYi,Kled,245,110,135,44.9
MasterYi,Vex,811,444,367,54.75
MasterYi,Singed,471,218,253,46.28
MasterYi,Sona,531,245,286,46.14
MasterYi,RekSai,139,65,74,46.76
MasterYi,Ryze,446,246,200,55.16
MasterYi,Heimerdinger,785,371,414,47.26
MasterYi,Akshan,538,236,302,43.87
MasterYi,Kalista,332,176,156,53.01
MasterYi,Renata,342,201,141,58.77
MasterYi,Camille,554,289,265,52.17
MasterYi,Kassadin,336,159,177,47.32
Annie,Vladimir,326,181,145,55.52
Annie,Rammus,110,48,62,43.64
Annie,Katarina,339,150,189,44.25
Annie,Draven,240,123,117,51.25
Annie,Senna,315,157,158,49.84
Annie,Sion,296,136,160,45.95
Annie,Nocturne,565,264,301,46.73
Annie,Ezreal,1199,575,624,47.96
Annie,Teemo,585,300,285,51.28
Annie,Kayle,300,141,159,47
Annie,Jinx,1278,615,663,48.12
Annie,Diana,658,298,360,45.29
Annie,Orianna,196,124,72,63.27
Annie,Pyke,358,204,154,56.98
Annie,Yorick,452,211,241,46.68
Annie,Elise,279,161,118,57.71
Annie,Veigar,423,214,209,50.59
Annie,Smolder,243,123,120,50.62
Annie,Soraka,253,142,111,56.13
Annie,TahmKench,272,172,100,63.24
Annie,Taliyah,152,68,84,44.74
Annie,Jhin,828,410,418,49.52
Annie,Zyra,449,239,210,53.23
Annie,Ambessa,276,130,146,47.1
Annie,Lillia,209,110,99,52.63
Annie,Syndra,327,141,186,43.12
Annie,Yuumi,396,187,209,47.22
Annie,Mordekaiser,535,256,279,47.85
Annie,Talon,256,138,118,53.91
Annie,Alistar,215,119,96,55.35
Annie,Sett,614,276,338,44.95
Annie,Rengar,127,73,54,57.48
Annie,Yasuo,1033,578,455,55.95
Annie,Kaisa,745,427,318,57.32
Annie,Janna,146,53,93,36.3
Annie,MasterYi,519,253,266,48.75
Annie,Mel,872,466,406,53.44
Annie,Morgana,604,290,314,48.01
Annie,Singed,123,76,47,61.79
Annie,Kayn,584,281,303,48.12
Annie,Aurora,361,189,172,52.35
Annie,Caitlyn,1082,548,534,50.65
Annie,Lulu,657,345,312,52.51
Annie,Poppy,232,126,106,54.31
Annie,Naafiri,118,49,69,41.53
Annie,Lucian,313,168,145,53.67
Annie,Milio,201,92,109,45.77
Annie,Aatrox,379,179,200,47.23
Annie,XinZhao,325,167,158,51.38
Annie,Chogath,506,230,276,45.45
Annie,Tristana,390,179,211,45.9
Annie,Maokai,181,90,91,49.72
Annie,LeeSin,779,390,389,50.06
Annie,Twitch,297,149,148,50.17
Annie,Amumu,416,190,226,45.67
Annie,Ahri,627,302,325,48.17
Annie,MissFortune,985,522,463,52.99
Annie,Akali,501,261,240,52.1
Annie,Graves,308,172,136,55.84
Annie,Quinn,173,96,77,55.49
Annie,Viego,600,287,313,47.83
Annie,Galio,388,199,189,51.29
Annie,Ashe,949,469,480,49.42
Annie,Malphite,434,234,200,53.92
Annie,Karma,570,299,271,52.46
Annie,Darius,778,366,412,47.04
Annie,Sejuani,198,93,105,46.97
Annie,Varus,369,203,166,55.01
Annie,Fizz,208,89,119,42.79
Annie,Skarner,126,60,66,47.62
Annie,Tryndamere,226,141,85,62.39
Annie,Nunu,253,121,132,47.83
Annie,Nautilus,439,224,215,51.03
Annie,Volibear,432,229,203,53.01
Annie,Shyvana,95,39,56,41.05
Annie,Zoe,160,80,80,50
Annie,Thresh,601,265,336,44.09
Annie,Vayne,506,250,256,49.41
Annie,Urgot,209,114,95,54.55
Annie,Xayah,182,115,67,63.19
Annie,Trundle,226,99,127,43.81
Annie,Cassiopeia,116,62,54,53.45
Annie,Warwick,616,327,289,53.08
Annie,Olaf,90,58,32,64.44
Annie,Vi,411,198,213,48.18
Annie,Briar,279,153,126,54.84
Annie,Ekko,383,188,195,49.09
Annie,Kennen,80,47,33,58.75
Annie,Rakan,150,56,94,37.33
Annie,Shen,237,116,121,48.95
Annie,Zeri,188,99,89,52.66
Annie,Hwei,248,143,105,57.66
Annie,Rumble,171,82,89,47.95
Annie,Lux,1084,529,555,48.8
Annie,Jax,391,196,195,50.13
Annie,Xerath,471,252,219,53.5
Annie,Heimerdinger,194,95,99,48.97
Annie,Jayce,225,118,107,52.44
Annie,Zilean,153,86,67,56.21
Annie,Ornn,172,91,81,52.91
Annie,Fiora,173,88,85,50.87
Annie,Gwen,234,106,128,45.3
Annie,Malzahar,465,239,226,51.4
Annie,Aphelios,218,99,119,45.41
Annie,AurelionSol,157,91,66,57.96
Annie,Zac,198,84,114,42.42
Annie,KSante,240,126,114,52.5
Annie,Anivia,134,67,67,50
Annie,Swain,433,203,230,46.88
Annie,Yone,789,416,373,52.72
Annie,Kindred,173,79,94,45.66
Annie,Ivern,65,34,31,52.31
Annie,Ziggs,136,63,73,46.32
Annie,Kalista,98,67,31,68.37
Annie,Leblanc,342,194,148,56.73
Annie,MonkeyKing,245,120,125,48.98
Annie,Taric,85,38,47,44.71
Annie,DrMundo,243,93,150,38.27
Annie,Gragas,261,140,121,53.64
Annie,TwistedFate,175,82,93,46.86
Annie,Illaoi,157,76,81,48.41
Annie,Hecarim,191,88,103,46.07
Annie,Shaco,387,184,203,47.55
Annie,Irelia,338,168,170,49.7
Annie,Zed,534,263,271,49.25
Annie,Renekton,259,151,108,58.3
Annie,JarvanIV,298,138,160,46.31
Annie,Nilah,97,51,46,52.58
Annie,Nami,454,222,232,48.9
Annie,Udyr,144,87,57,60.42
Annie,Sivir,260,121,139,46.54
Annie,Blitzcrank,303,169,134,55.78
Annie,Vex,272,122,150,44.85
Annie,Renata,61,41,20,67.21
Annie,Nidalee,168,89,79,52.98
Annie,Qiyana,94,44,50,46.81
Annie,Braum,249,117,132,46.99
Annie,Garen,708,334,374,47.18
Annie,Akshan,137,72,65,52.55
Annie,Seraphine,280,127,153,45.36
Annie,Gnar,175,107,68,61.14
Annie,Pantheon,657,368,289,56.01
Annie,Nasus,269,135,134,50.19
Annie,Corki,173,89,84,51.45
Annie,Karthus,148,83,65,56.08
Annie,Kled,87,36,51,41.38
Annie,Leona,392,175,217,44.64
Annie,Samira,303,158,145,52.15
Annie,Belveth,124,67,57,54.03
Annie,Azir,118,64,54,54.24
Annie,Brand,239,113,126,47.28
Annie,Sylas,556,289,267,51.98
Annie,FiddleSticks,221,92,129,41.63
Annie,Viktor,435,238,197,54.71
Annie,Velkoz,267,121,146,45.32
Annie,Gangplank,223,114,109,51.12
Annie,Neeko,170,92,78,54.12
Annie,Khazix,203,95,108,46.8
Annie,Kassadin,107,42,65,39.25
Annie,Riven,201,80,121,39.8
Annie,Rell,140,83,57,59.29
Annie,Bard,98,50,48,51.02
Annie,Ryze,133,69,64,51.88
Annie,Sona,144,83,61,57.64
Annie,KogMaw,133,81,52,60.9
Annie,Camille,147,96,51,65.31
Annie,RekSai,56,26,30,46.43
Annie,Lissandra,137,66,71,48.18
Annie,Evelynn,98,44,54,44.9
Ezreal,Vladimir,2123,1026,1097,48.33
Ezreal,Rammus,877,426,451,48.57
Ezreal,Katarina,2244,1099,1145,48.98
Ezreal,Draven,1497,759,738,50.7
Ezreal,Senna,2259,1145,1114,50.69
Ezreal,Warwick,3879,1786,2093,46.04
Ezreal,Vi,3447,1695,1752,49.17
Ezreal,Irelia,2799,1422,1377,50.8
Ezreal,Caitlyn,10799,5239,5560,48.51
Ezreal,Nautilus,3927,1869,2058,47.59
Ezreal,Nasus,2047,976,1071,47.68
Ezreal,Nocturne,4222,1969,2253,46.64
Ezreal,Jhin,7621,3739,3882,49.06
Ezreal,Seraphine,1954,995,959,50.92
Ezreal,Darius,5682,2665,3017,46.9
Ezreal,Lillia,1883,919,964,48.81
Ezreal,Garen,5102,2440,2662,47.82
Ezreal,Pyke,2735,1400,1335,51.19
Ezreal,Teemo,3626,1713,1913,47.24
Ezreal,Jax,3018,1394,1624,46.19
Ezreal,Fizz,1610,823,787,51.12
Ezreal,Kaisa,8011,3829,4182,47.8
Ezreal,Morgana,3393,1620,1773,47.75
Ezreal,Renekton,1697,832,865,49.03
Ezreal,Evelynn,1017,462,555,45.43
Ezreal,Lissandra,1209,556,653,45.99
Ezreal,Corki,1417,703,714,49.61
Ezreal,Rakan,1351,682,669,50.48
Ezreal,FiddleSticks,1637,755,882,46.12
Ezreal,Rumble,1202,665,537,55.32
Ezreal,Shaco,2965,1464,1501,49.38
Ezreal,Veigar,2608,1283,1325,49.19
Ezreal,Lux,7241,3546,3695,48.97
Ezreal,Hwei,2080,1062,1018,51.06
Ezreal,Twitch,2124,1018,1106,47.93
Ezreal,Karma,4662,2361,2301,50.64
Ezreal,Kayn,4068,1990,2078,48.92
Ezreal,Shyvana,732,325,407,44.4
Ezreal,Annie,1199,624,575,52.04
Ezreal,Varus,3399,1756,1643,51.66
Ezreal,Shen,1674,797,877,47.61
Ezreal,Amumu,2954,1409,1545,47.7
Ezreal,Orianna,1518,782,736,51.52
Ezreal,Sona,876,382,494,43.61
Ezreal,Poppy,1701,861,840,50.62
Ezreal,Taliyah,827,406,421,49.09
Ezreal,MissFortune,7730,3709,4021,47.98
Ezreal,Malphite,3386,1770,1616,52.27
Ezreal,Viego,4707,2309,2398,49.05
Ezreal,Lulu,5224,2473,2751,47.34
Ezreal,Ekko,2922,1449,1473,49.59
Ezreal,Vex,1677,847,830,50.51
Ezreal,Neeko,1351,665,686,49.22
Ezreal,Yorick,2699,1257,1442,46.57
Ezreal,Yone,6287,3217,3070,51.17
Ezreal,Xayah,1466,731,735,49.86
Ezreal,Yuumi,2310,1066,1244,46.15
Ezreal,MonkeyKing,2339,1165,1174,49.81
Ezreal,Akshan,974,455,519,46.71
Ezreal,Tristana,3103,1536,1567,49.5
Ezreal,Swain,2718,1257,1461,46.25
Ezreal,Akali,3755,1926,1829,51.29
Ezreal,TahmKench,1964,970,994,49.39
Ezreal,Camille,1285,687,598,53.46
Ezreal,Briar,1936,892,1044,46.07
Ezreal,Jinx,9677,4551,5126,47.03
Ezreal,Pantheon,5467,2739,2728,50.1
Ezreal,Kassadin,634,301,333,47.48
Ezreal,Lucian,2844,1415,1429,49.75
Ezreal,Nami,2975,1356,1619,45.58
Ezreal,Galio,3120,1407,1713,45.1
Ezreal,Malzahar,3024,1367,1657,45.21
Ezreal,Sejuani,1354,695,659,51.33
Ezreal,Milio,1718,749,969,43.6
Ezreal,Udyr,1141,563,578,49.34
Ezreal,Thresh,4790,2331,2459,48.66
Ezreal,Elise,2684,1278,1406,47.62
Ezreal,Gangplank,2014,1002,1012,49.75
Ezreal,Trundle,1644,780,864,47.45
Ezreal,Chogath,3323,1512,1811,45.5
Ezreal,Sivir,2157,995,1162,46.13
Ezreal,Zoe,1291,604,687,46.79
Ezreal,Vayne,4512,2169,2343,48.07
Ezreal,TwistedFate,1213,645,568,53.17
Ezreal,Yasuo,6344,3032,3312,47.79
Ezreal,Anivia,1001,458,543,45.75
Ezreal,Gwen,1552,771,781,49.68
Ezreal,Mel,6023,3054,2969,50.71
Ezreal,Velkoz,1781,870,911,48.85
Ezreal,Urgot,1302,612,690,47
Ezreal,KogMaw,871,412,459,47.3
Ezreal,Kayle,1743,840,903,48.19
Ezreal,Diana,5401,2537,2864,46.97
Ezreal,Illaoi,1261,640,621,50.75
Ezreal,Karthus,1069,543,526,50.8
Ezreal,Naafiri,964,453,511,46.99
Ezreal,Maokai,1509,744,765,49.3
Ezreal,Zeri,1687,797,890,47.24
Ezreal,Gnar,1418,650,768,45.84
Ezreal,Khazix,1681,827,854,49.2
Ezreal,Leona,2867,1400,1467,48.83
Ezreal,Ambessa,2412,1237,1175,51.29
Ezreal,Ziggs,1097,577,520,52.6
Ezreal,Ahri,4141,2055,2086,49.63
Ezreal,Samira,1949,1034,915,53.05
Ezreal,Gragas,2051,1036,1015,50.51
Ezreal,Janna,1068,482,586,45.13
Ezreal,Singed,798,371,427,46.49
Ezreal,Zed,3813,1889,1924,49.54
Ezreal,Graves,2423,1197,1226,49.4
Ezreal,Nidalee,1279,715,564,55.9
Ezreal,Syndra,1982,980,1002,49.45
Ezreal,Mordekaiser,3837,1796,2041,46.81
Ezreal,Skarner,817,424,393,51.9
Ezreal,Rengar,950,486,464,51.16
Ezreal,Ryze,1200,519,681,43.25
Ezreal,Ashe,8017,4090,3927,51.02
Ezreal,LeeSin,6833,3509,3324,51.35
Ezreal,Sett,4440,2072,2368,46.67
Ezreal,Smolder,2077,1045,1032,50.31
Ezreal,MasterYi,3770,1827,1943,48.46
Ezreal,Aphelios,1661,861,800,51.84
Ezreal,Taric,574,273,301,47.56
Ezreal,Viktor,3245,1650,1595,50.85
Ezreal,Volibear,2898,1397,1501,48.21
Ezreal,Kindred,1388,656,732,47.26
Ezreal,Soraka,1602,740,862,46.19
Ezreal,Aurora,2453,1228,1225,50.06
Ezreal,Sion,2276,1143,1133,50.22
Ezreal,Sylas,5477,2714,2763,49.55
Ezreal,Zilean,1050,516,534,49.14
Ezreal,Brand,2125,973,1152,45.79
Ezreal,JarvanIV,2074,986,1088,47.54
Ezreal,Xerath,3531,1694,1837,47.98
Ezreal,Talon,2257,1050,1207,46.52
Ezreal,Rell,1560,687,873,44.04
Ezreal,Tryndamere,1656,803,853,48.49
Ezreal,Aatrox,3239,1524,1715,47.05
Ezreal,Hecarim,1338,675,663,50.45
Ezreal,Zac,1793,878,915,48.97
Ezreal,Riven,1505,717,788,47.64
Ezreal,Leblanc,2582,1287,1295,49.85
Ezreal,RekSai,519,276,243,53.18
Ezreal,Blitzcrank,2774,1421,1353,51.23
Ezreal,Azir,1140,608,532,53.33
Ezreal,Zyra,3229,1479,1750,45.8
Ezreal,Fiora,1177,575,602,48.85
Ezreal,Quinn,1081,502,579,46.44
Ezreal,Belveth,755,383,372,50.73
Ezreal,Braum,1736,828,908,47.7
Ezreal,Kalista,1014,456,558,44.97
Ezreal,XinZhao,2373,1155,1218,48.67
Ezreal,Renata,493,217,276,44.02
Ezreal,Ornn,1271,609,662,47.92
Ezreal,Ivern,494,273,221,55.26
Ezreal,Jayce,2193,1048,1145,47.79
Ezreal,KSante,2029,1006,1023,49.58
Ezreal,AurelionSol,1269,654,615,51.54
Ezreal,Nunu,1546,691,855,44.7
Ezreal,Qiyana,768,433,335,56.38
Ezreal,Alistar,1474,775,699,52.58
Ezreal,Kennen,877,445,432,50.74
Ezreal,Heimerdinger,1202,535,667,44.51
Ezreal,Olaf,807,392,415,48.57
Ezreal,Bard,977,486,491,49.74
Ezreal,DrMundo,1473,669,804,45.42
Ezreal,Nilah,834,385,449,46.16
Ezreal,Kled,594,291,303,48.99
Ezreal,Cassiopeia,886,426,460,48.08
Lux,Vladimir,1915,949,966,49.56
Lux,Rammus,963,464,499,48.18
Lux,Katarina,2504,1267,1237,50.6
Lux,Draven,1666,818,848,49.1
Lux,Senna,2367,1272,1095,53.74
Lux,Darius,6238,3160,3078,50.66
Lux,Viego,4289,2154,2135,50.22
Lux,Viktor,2807,1452,1355,51.73
Lux,Leona,2864,1385,1479,48.36
Lux,Trundle,1976,977,999,49.44
Lux,Briar,2421,1099,1322,45.39
Lux,Jhin,6857,3382,3475,49.32
Lux,Pyke,2838,1399,1439,49.3
Lux,Sett,4725,2362,2363,49.99
Lux,Lillia,1522,806,716,52.96
Lux,Leblanc,2087,1061,1026,50.84
Lux,Jinx,8716,4394,4322,50.41
Lux,Alistar,1159,614,545,52.98
Lux,Malzahar,3645,1740,1905,47.74
Lux,Sejuani,1153,617,536,53.51
Lux,Jayce,1229,645,584,52.48
Lux,Thresh,4288,2192,2096,51.12
Lux,Gangplank,1633,859,774,52.6
Lux,FiddleSticks,1468,760,708,51.77
Lux,Yone,5785,3066,2719,53
Lux,Varus,2772,1437,1335,51.84
Lux,Zilean,985,504,481,51.17
Lux,Jax,3122,1619,1503,51.86
Lux,Amumu,3486,1711,1775,49.08
Lux,Ahri,4526,2326,2200,51.39
Lux,Caitlyn,9275,4727,4548,50.96
Lux,Lulu,3895,1920,1975,49.29
Lux,Gwen,1533,815,718,53.16
Lux,Khazix,1657,936,721,56.49
Lux,TwistedFate,1081,591,490,54.67
Lux,Yorick,3400,1535,1865,45.15
Lux,Elise,2046,1069,977,52.25
Lux,Corki,1161,620,541,53.4
Lux,Milio,1760,842,918,47.84
Lux,TahmKench,2562,1233,1329,48.13
Lux,LeeSin,4386,2288,2098,52.17
Lux,Hwei,2037,1029,1008,50.52
Lux,Tristana,3205,1693,1512,52.82
Lux,Karma,4030,2020,2010,50.12
Lux,Urgot,1685,841,844,49.91
Lux,Talon,1552,849,703,54.7
Lux,Aphelios,1530,852,678,55.69
Lux,Maokai,1433,735,698,51.29
Lux,Pantheon,4724,2370,2354,50.17
Lux,Mel,6426,3198,3228,49.77
Lux,Ezreal,7241,3693,3548,51
Lux,Teemo,4541,2231,2310,49.13
Lux,Shaco,3186,1666,1520,52.29
Lux,KogMaw,983,475,508,48.32
Lux,Morgana,5161,2557,2604,49.54
Lux,Nocturne,4361,2005,2356,45.98
Lux,Twitch,2605,1383,1222,53.09
Lux,Renata,461,240,221,52.06
Lux,Sion,2138,990,1148,46.3
Lux,Fizz,2178,1072,1106,49.22
Lux,Seraphine,3058,1575,1483,51.5
Lux,Heimerdinger,1736,887,849,51.09
Lux,Kayn,4619,2300,2319,49.79
Lux,Sivir,1610,816,794,50.68
Lux,Neeko,1664,875,789,52.58
Lux,Chogath,3646,1795,1851,49.23
Lux,Anivia,975,474,501,48.62
Lux,Zyra,3105,1527,1578,49.18
Lux,Tryndamere,2088,1035,1053,49.57
Lux,Poppy,1606,822,784,51.18
Lux,Kassadin,689,356,333,51.67
Lux,Ashe,6356,3203,3153,50.39
Lux,Soraka,1781,846,935,47.5
Lux,Garen,5204,2569,2635,49.37
Lux,Irelia,2546,1290,1256,50.67
Lux,Nami,3295,1563,1732,47.44
Lux,MissFortune,8088,3868,4220,47.82
Lux,Nunu,1760,897,863,50.97
Lux,Qiyana,705,395,310,56.03
Lux,Diana,5174,2514,2660,48.59
Lux,Vi,2776,1353,1423,48.74
Lux,Velkoz,2330,1070,1260,45.92
Lux,Rengar,989,544,445,55.01
Lux,Aurora,2145,1156,989,53.89
Lux,Bard,774,397,377,51.29
Lux,Quinn,1164,524,640,45.02
Lux,Zac,1297,678,619,52.27
Lux,Brand,2783,1367,1416,49.12
Lux,Olaf,709,372,337,52.47
Lux,Sylas,4092,2203,1889,53.84
Lux,Kennen,765,380,385,49.67
Lux,Nasus,2340,1130,1210,48.29
Lux,Renekton,1488,771,717,51.81
Lux,Veigar,3657,1838,1819,50.26
Lux,Lissandra,934,499,435,53.43
Lux,Aatrox,2654,1369,1285,51.58
Lux,Lucian,2266,1181,1085,52.12
Lux,Ambessa,1820,1000,820,54.95
Lux,Evelynn,1096,538,558,49.09
Lux,Xayah,1450,772,678,53.24
Lux,Ekko,3043,1613,1430,53.01
Lux,Yasuo,6369,3119,3250,48.97
Lux,Rakan,1184,639,545,53.97
Lux,Akali,3455,1747,1708,50.56
Lux,Galio,2765,1382,1383,49.98
Lux,Volibear,3690,1868,1822,50.62
Lux,Swain,3302,1655,1647,50.12
Lux,JarvanIV,1825,874,951,47.89
Lux,RekSai,333,185,148,55.56
Lux,Xerath,3739,1861,1878,49.77
Lux,Vayne,3992,1915,2077,47.97
Lux,Nautilus,3368,1743,1625,51.75
Lux,Gragas,1450,768,682,52.97
Lux,Ziggs,1358,666,692,49.04
Lux,Nidalee,806,447,359,55.46
Lux,Graves,1894,921,973,48.63
Lux,Gnar,1129,575,554,50.93
Lux,Syndra,1889,941,948,49.81
Lux,Zoe,1225,626,599,51.1
Lux,Kaisa,4864,2464,2400,50.66
Lux,Samira,2430,1246,1184,51.28
Lux,Mordekaiser,4157,2042,2115,49.12
Lux,Smolder,1829,938,891,51.28
Lux,Skarner,690,370,320,53.62
Lux,Blitzcrank,2700,1343,1357,49.74
Lux,Kindred,1462,741,721,50.68
Lux,Illaoi,1575,820,755,52.06
Lux,XinZhao,1954,966,988,49.44
Lux,Zed,3781,1929,1852,51.02
Lux,Camille,1081,577,504,53.38
Lux,MasterYi,4328,2156,2172,49.82
Lux,Warwick,4972,2358,2614,47.43
Lux,AurelionSol,1261,601,660,47.66
Lux,Shen,1906,982,924,51.52
Lux,Orianna,1253,647,606,51.64
Lux,Zeri,1122,595,527,53.03
Lux,Rumble,782,388,394,49.62
Lux,Hecarim,1205,601,604,49.88
Lux,Janna,855,445,410,52.05
Lux,Singed,872,452,420,51.83
Lux,Braum,1543,744,799,48.22
Lux,Ornn,1312,633,679,48.25
Lux,MonkeyKing,2188,1099,1089,50.23
Lux,Karthus,949,535,414,56.38
Lux,Malphite,3477,1789,1688,51.45
Lux,Ryze,871,406,465,46.61
Lux,Taliyah,664,353,311,53.16
Lux,KSante,1434,761,673,53.07
Lux,Rell,1426,759,667,53.23
Lux,Naafiri,1087,539,548,49.59
Lux,Yuumi,2568,1310,1258,51.01
Lux,Riven,1209,653,556,54.01
Lux,Sona,1001,525,476,52.45
Lux,DrMundo,1864,938,926,50.32
Lux,Vex,1802,893,909,49.56
Lux,Azir,900,470,430,52.22
Lux,Kayle,2179,1026,1153,47.09
Lux,Belveth,670,338,332,50.45
Lux,Kalista,782,430,352,54.99
Lux,Udyr,1107,583,524,52.66
Lux,Fiora,1064,566,498,53.2
Lux,Taric,614,330,284,53.75
Lux,Nilah,870,421,449,48.39
Lux,Ivern,400,217,183,54.25
Lux,Akshan,1146,557,589,48.6
Lux,Cassiopeia,703,380,323,54.05
Lux,Shyvana,776,357,419,46.01
Lux,Annie,1084,555,529,51.2
Lux,Kled,532,262,270,49.25
Pantheon,Darius,3795,1910,1885,50.33
Pantheon,Viego,3186,1552,1634,48.71
Pantheon,Viktor,1925,999,926,51.9
Pantheon,Draven,945,424,521,44.87
Pantheon,Leona,1790,918,872,51.28
Pantheon,Renekton,1095,510,585,46.58
Pantheon,Nocturne,2791,1252,1539,44.86
Pantheon,Xayah,968,498,470,51.45
Pantheon,Pyke,1775,865,910,48.73
Pantheon,Rakan,813,455,358,55.97
Pantheon,Ekko,1925,990,935,51.43
Pantheon,Veigar,1856,881,975,47.47
Pantheon,Ashe,3968,1927,2041,48.56
Pantheon,Soraka,1103,499,604,45.24
Pantheon,Gwen,942,492,450,52.23
Pantheon,Skarner,516,306,210,59.3
Pantheon,DrMundo,1185,572,613,48.27
Pantheon,Samira,1381,736,645,53.29
Pantheon,Malphite,2314,1093,1221,47.23
Pantheon,Kayle,1242,653,589,52.58
Pantheon,Mordekaiser,2535,1180,1355,46.55
Pantheon,Yasuo,4382,2289,2093,52.24
Pantheon,Varus,1852,967,885,52.21
Pantheon,Galio,1626,758,868,46.62
Pantheon,Trundle,1068,572,496,53.56
Pantheon,Jinx,5632,2639,2993,46.86
Pantheon,Nautilus,2183,1097,1086,50.25
Pantheon,Gangplank,1152,566,586,49.13
Pantheon,Kayn,2837,1340,1497,47.23
Pantheon,Mel,4053,2097,1956,51.74
Pantheon,MissFortune,4580,2302,2278,50.26
Pantheon,Thresh,2577,1262,1315,48.97
Pantheon,Azir,730,357,373,48.9
Pantheon,Syndra,1261,588,673,46.63
Pantheon,Jhin,4030,2082,1948,51.66
Pantheon,Senna,1443,773,670,53.57
Pantheon,Garen,3280,1671,1609,50.95
Pantheon,Rengar,676,386,290,57.1
Pantheon,Lissandra,667,324,343,48.58
Pantheon,Tristana,1846,985,861,53.36
Pantheon,Zyra,1978,943,1035,47.67
Pantheon,Rumble,574,286,288,49.83
Pantheon,Shaco,1863,960,903,51.53
Pantheon,Caitlyn,5409,2722,2687,50.32
Pantheon,Lux,4724,2351,2373,49.77
Pantheon,JarvanIV,1262,587,675,46.51
Pantheon,Orianna,933,411,522,44.05
Pantheon,Yuumi,1618,892,726,55.13
Pantheon,Jax,1772,888,884,50.11
Pantheon,Camille,791,396,395,50.06
Pantheon,Sivir,1113,536,577,48.16
Pantheon,Karma,2536,1234,1302,48.66
Pantheon,Heimerdinger,854,366,488,42.86
Pantheon,Malzahar,2042,925,1117,45.3
Pantheon,Neeko,882,416,466,47.17
Pantheon,Yone,4140,2104,2036,50.82
Pantheon,Zac,1050,566,484,53.9
Pantheon,Anivia,563,236,327,41.92
Pantheon,Blitzcrank,1562,841,721,53.84
Pantheon,Warwick,2757,1347,1410,48.86
Pantheon,LeeSin,3449,1803,1646,52.28
Pantheon,Kassadin,416,208,208,50
Pantheon,Morgana,2334,1222,1112,52.36
Pantheon,Poppy,1289,632,657,49.03
Pantheon,Katarina,1522,800,722,52.56
Pantheon,Ezreal,5467,2728,2739,49.9
Pantheon,Aatrox,1875,927,948,49.44
Pantheon,Lucian,1385,773,612,55.81
Pantheon,Nami,1859,869,990,46.75
Pantheon,TahmKench,1437,724,713,50.38
Pantheon,Ziggs,720,382,338,53.06
Pantheon,Twitch,1560,784,776,50.26
Pantheon,Akali,2187,1077,1110,49.25
Pantheon,Sejuani,833,417,416,50.06
Pantheon,Milio,1153,566,587,49.09
Pantheon,Urgot,1010,467,543,46.24
Pantheon,Lillia,1143,613,530,53.63
Pantheon,Diana,3522,1650,1872,46.85
Pantheon,Aphelios,1004,481,523,47.91
Pantheon,Talon,1313,681,632,51.87
Pantheon,Akshan,681,374,307,54.92
Pantheon,Velkoz,1120,533,587,47.59
Pantheon,Udyr,722,403,319,55.82
Pantheon,Qiyana,494,279,215,56.48
Pantheon,Seraphine,1515,785,730,51.82
Pantheon,Amumu,2001,892,1109,44.58
Pantheon,Brand,1600,764,836,47.75
Pantheon,Vi,1880,959,921,51.01
Pantheon,Vayne,2500,1215,1285,48.6
Pantheon,Rell,995,487,508,48.94
Pantheon,Chogath,2164,1003,1161,46.35
Pantheon,Sylas,3010,1658,1352,55.08
Pantheon,Riven,827,468,359,56.59
Pantheon,FiddleSticks,991,480,511,48.44
Pantheon,Gnar,851,436,415,51.23
Pantheon,Irelia,1495,734,761,49.1
Pantheon,Smolder,1293,720,573,55.68
Pantheon,Sona,591,288,303,48.73
Pantheon,Teemo,2282,1171,1111,51.31
Pantheon,Rammus,650,315,335,48.46
Pantheon,RekSai,239,117,122,48.95
Pantheon,Vladimir,1403,744,659,53.03
Pantheon,Swain,1972,954,1018,48.38
Pantheon,Elise,1562,756,806,48.4
Pantheon,Sett,3121,1488,1633,47.68
Pantheon,Taric,414,196,218,47.34
Pantheon,Zed,2398,1287,1111,53.67
Pantheon,Yorick,1978,943,1035,47.67
Pantheon,Bard,642,326,316,50.78
Pantheon,Hecarim,768,383,385,49.87
Pantheon,Lulu,2668,1301,1367,48.76
Pantheon,Nasus,1378,714,664,51.81
Pantheon,Kindred,848,443,405,52.24
Pantheon,Illaoi,907,478,429,52.7
Pantheon,Hwei,1312,645,667,49.16
Pantheon,Khazix,1022,511,511,50
Pantheon,Leblanc,1374,718,656,52.26
Pantheon,Volibear,2254,1153,1101,51.15
Pantheon,Sion,1431,647,784,45.21
Pantheon,XinZhao,1359,655,704,48.2
Pantheon,Aurora,1504,770,734,51.2
Pantheon,Vex,992,474,518,47.78
Pantheon,KogMaw,552,256,296,46.38
Pantheon,MonkeyKing,1480,742,738,50.14
Pantheon,Kled,337,182,155,54.01
Pantheon,Zoe,735,349,386,47.48
Pantheon,Janna,752,388,364,51.6
Pantheon,KSante,1288,704,584,54.66
Pantheon,Shen,1200,631,569,52.58
Pantheon,Jayce,1017,506,511,49.75
Pantheon,Ahri,2649,1332,1317,50.28
Pantheon,MasterYi,2481,1199,1282,48.33
Pantheon,Ambessa,1284,681,603,53.04
Pantheon,Briar,1416,680,736,48.02
Pantheon,Braum,1097,540,557,49.23
Pantheon,Nilah,596,298,298,50
Pantheon,Graves,1375,684,691,49.75
Pantheon,Taliyah,531,254,277,47.83
Pantheon,Gragas,1218,601,617,49.34
Pantheon,Singed,433,228,205,52.66
Pantheon,TwistedFate,687,366,321,53.28
Pantheon,Ryze,690,363,327,52.61
Pantheon,Corki,820,452,368,55.12
Pantheon,Kaisa,3507,1799,1708,51.3
Pantheon,Kennen,551,265,286,48.09
Pantheon,Naafiri,621,277,344,44.61
Pantheon,Fiora,759,409,350,53.89
Pantheon,AurelionSol,681,335,346,49.19
Pantheon,Quinn,672,293,379,43.6
Pantheon,Kalista,450,242,208,53.78
Pantheon,Zilean,641,324,317,50.55
Pantheon,Cassiopeia,576,283,293,49.13
Pantheon,Fizz,1145,579,566,50.57
Pantheon,Tryndamere,1066,536,530,50.28
Pantheon,Ornn,872,424,448,48.62
Pantheon,Evelynn,652,335,317,51.38
Pantheon,Xerath,1819,845,974,46.45
Pantheon,Nunu,974,488,486,50.1
Pantheon,Shyvana,455,228,227,50.11
Pantheon,Maokai,944,453,491,47.99
Pantheon,Alistar,897,452,445,50.39
Pantheon,Ivern,247,132,115,53.44
Pantheon,Belveth,472,254,218,53.81
Pantheon,Karthus,622,315,307,50.64
Pantheon,Zeri,789,384,405,48.67
Pantheon,Olaf,477,217,260,45.49
Pantheon,Renata,254,106,148,41.73
Pantheon,Annie,657,289,368,43.99
Pantheon,Nidalee,658,335,323,50.91
Belveth,Darius,560,270,290,48.21
Belveth,Viego,485,208,277,42.89
Belveth,Viktor,271,145,126,53.51
Belveth,Draven,175,89,86,50.86
Belveth,Leona,253,120,133,47.43
Belveth,Mordekaiser,388,198,190,51.03
Belveth,Vi,301,151,150,50.17
Belveth,Yone,525,247,278,47.05
Belveth,Caitlyn,778,370,408,47.56
Belveth,Alistar,92,43,49,46.74
Belveth,Heimerdinger,139,66,73,47.48
Belveth,MasterYi,310,154,156,49.68
Belveth,Azir,132,72,60,54.55
Belveth,Varus,302,171,131,56.62
Belveth,Renata,56,29,27,51.79
Belveth,Olaf,53,21,32,39.62
Belveth,Riven,116,48,68,41.38
Belveth,Hwei,223,135,88,60.54
Belveth,Swain,295,136,159,46.1
Belveth,Neeko,93,47,46,50.54
Belveth,JarvanIV,209,80,129,38.28
Belveth,Ashe,593,277,316,46.71
Belveth,Yorick,290,136,154,46.9
Belveth,Nunu,137,63,74,45.99
Belveth,Katarina,284,131,153,46.13
Belveth,Sivir,117,69,48,58.97
Belveth,Zyra,261,128,133,49.04
Belveth,Warwick,446,223,223,50
Belveth,Kayn,435,197,238,45.29
Belveth,Jinx,881,376,505,42.68
Belveth,Lulu,397,189,208,47.61
Belveth,Volibear,278,137,141,49.28
Belveth,Irelia,190,100,90,52.63
Belveth,Jhin,605,285,320,47.11
Belveth,Karma,398,203,195,51.01
Belveth,KSante,172,76,96,44.19
Belveth,Kalista,73,41,32,56.16
Belveth,Fizz,164,61,103,37.2
Belveth,Thresh,414,217,197,52.42
Belveth,Ryze,129,51,78,39.53
Belveth,Lux,670,332,338,49.55
Belveth,Taliyah,110,35,75,31.82
Belveth,Nami,332,152,180,45.78
Belveth,Akali,327,177,150,54.13
Belveth,Nocturne,414,161,253,38.89
Belveth,Talon,182,97,85,53.3
Belveth,Ezreal,755,372,383,49.27
Belveth,XinZhao,227,104,123,45.81
Belveth,Vex,138,57,81,41.3
Belveth,Lucian,213,111,102,52.11
Belveth,Sejuani,90,50,40,55.56
Belveth,Galio,299,148,151,49.5
Belveth,Soraka,217,95,122,43.78
Belveth,Malzahar,295,107,188,36.27
Belveth,Shaco,252,113,139,44.84
Belveth,Ziggs,110,53,57,48.18
Belveth,Nautilus,318,176,142,55.35
Belveth,LeeSin,414,209,205,50.48
Belveth,Vayne,364,186,178,51.1
Belveth,Mel,549,285,264,51.91
Belveth,Poppy,171,59,112,34.5
Belveth,Teemo,377,162,215,42.97
Belveth,Amumu,304,147,157,48.36
Belveth,Ahri,341,197,144,57.77
Belveth,Kayle,225,115,110,51.11
Belveth,Diana,447,220,227,49.22
Belveth,Yasuo,558,308,250,55.2
Belveth,Zeri,145,67,78,46.21
Belveth,MissFortune,654,355,299,54.28
Belveth,Tryndamere,180,94,86,52.22
Belveth,Briar,192,102,90,53.13
Belveth,Zilean,98,41,57,41.84
Belveth,Veigar,248,107,141,43.15
Belveth,Senna,204,98,106,48.04
Belveth,Gragas,178,94,84,52.81
Belveth,Kaisa,523,252,271,48.18
Belveth,Rengar,101,48,53,47.52
Belveth,Lillia,165,73,92,44.24
Belveth,Lissandra,95,49,46,51.58
Belveth,Pyke,215,126,89,58.6
Belveth,TahmKench,228,123,105,53.95
Belveth,KogMaw,66,37,29,56.06
Belveth,Yuumi,232,139,93,59.91
Belveth,AurelionSol,125,57,68,45.6
Belveth,Samira,151,69,82,45.7
Belveth,Rell,166,82,84,49.4
Belveth,Garen,447,219,228,48.99
Belveth,Nasus,230,108,122,46.96
Belveth,Singed,97,51,46,52.58
Belveth,Seraphine,218,104,114,47.71
Belveth,Aatrox,277,137,140,49.46
Belveth,Skarner,82,54,28,65.85
Belveth,Graves,207,125,82,60.39
Belveth,Syndra,194,99,95,51.03
Belveth,Milio,183,95,88,51.91
Belveth,Sett,370,175,195,47.3
Belveth,Cassiopeia,111,52,59,46.85
Belveth,Janna,101,25,76,24.75
Belveth,Jax,215,82,133,38.14
Belveth,Vladimir,196,81,115,41.33
Belveth,Pantheon,472,218,254,46.19
Belveth,Illaoi,142,64,78,45.07
Belveth,Quinn,118,51,67,43.22
Belveth,FiddleSticks,184,91,93,49.46
Belveth,Morgana,303,164,139,54.13
Belveth,Renekton,132,53,79,40.15
Belveth,Xerath,321,164,157,51.09
Belveth,Udyr,123,67,56,54.47
Belveth,Aphelios,126,67,59,53.17
Belveth,Sion,188,102,86,54.26
Belveth,Ekko,246,115,131,46.75
Belveth,MonkeyKing,168,103,65,61.31
Belveth,Ornn,123,60,63,48.78
Belveth,Akshan,107,33,74,30.84
Belveth,Tristana,341,183,158,53.67
Belveth,Leblanc,175,76,99,43.43
Belveth,Evelynn,83,33,50,39.76
Belveth,Smolder,180,92,88,51.11
Belveth,Shen,184,79,105,42.93
Belveth,Sylas,362,190,172,52.49
Belveth,Urgot,163,58,105,35.58
Belveth,Kassadin,72,33,39,45.83
Belveth,Kled,62,31,31,50
Belveth,Kindred,146,75,71,51.37
Belveth,Blitzcrank,198,89,109,44.95
Belveth,Trundle,182,82,100,45.05
Belveth,Karthus,95,51,44,53.68
Belveth,Corki,109,49,60,44.95
Belveth,DrMundo,132,47,85,35.61
Belveth,Gnar,114,66,48,57.89
Belveth,Bard,82,39,43,47.56
Belveth,Chogath,315,150,165,47.62
Belveth,Annie,124,57,67,45.97
Belveth,Rakan,104,56,48,53.85
Belveth,Gwen,154,65,89,42.21
Belveth,Hecarim,138,59,79,42.75
Belveth,Aurora,200,121,79,60.5
Belveth,Elise,218,100,118,45.87
Belveth,Qiyana,79,23,56,29.11
Belveth,Khazix,151,71,80,47.02
Belveth,Twitch,196,73,123,37.24
Belveth,Gangplank,181,89,92,49.17
Belveth,Orianna,163,76,87,46.63
Belveth,Malphite,322,142,180,44.1
Belveth,Brand,238,104,134,43.7
Belveth,Nilah,107,41,66,38.32
Belveth,Jayce,125,66,59,52.8
Belveth,Zed,288,134,154,46.53
Belveth,Fiora,124,54,70,43.55
Belveth,Zoe,99,34,65,34.34
Belveth,Braum,158,61,97,38.61
Belveth,Rumble,94,44,50,46.81
Belveth,Rammus,98,39,59,39.8
Belveth,Xayah,156,74,82,47.44
Belveth,Sona,95,44,51,46.32
Belveth,Ivern,17,10,7,58.82
Belveth,Zac,106,68,38,64.15
Belveth,TwistedFate,81,43,38,53.09
Belveth,Maokai,174,72,102,41.38
Belveth,Kennen,55,23,32,41.82
Belveth,Ambessa,202,113,89,55.94
Belveth,Velkoz,163,92,71,56.44
Belveth,Shyvana,72,38,34,52.78
Belveth,Taric,63,45,18,71.43
Belveth,Naafiri,73,40,33,54.79
Belveth,Camille,86,47,39,54.65
Belveth,Anivia,91,58,33,63.74
Belveth,Nidalee,82,37,45,45.12
Belveth,RekSai,22,14,8,63.64
KogMaw,Darius,799,406,393,50.81
KogMaw,Viego,536,301,235,56.16
KogMaw,Viktor,356,181,175,50.84
KogMaw,Draven,220,87,133,39.55
KogMaw,Leona,290,132,158,45.52
KogMaw,Mordekaiser,516,252,264,48.84
KogMaw,Kayn,555,309,246,55.68
KogMaw,Talon,203,103,100,50.74
KogMaw,MissFortune,860,437,423,50.81
KogMaw,Lulu,608,304,304,50
KogMaw,Trundle,242,122,120,50.41
KogMaw,Volibear,522,274,248,52.49
KogMaw,Xayah,143,59,84,41.26
KogMaw,Riven,203,101,102,49.75
KogMaw,Ziggs,150,83,67,55.33
KogMaw,Katarina,307,185,122,60.26
KogMaw,LeeSin,530,286,244,53.96
KogMaw,Lux,983,508,475,51.68
KogMaw,Yone,668,368,300,55.09
KogMaw,Nunu,180,93,87,51.67
KogMaw,Qiyana,92,43,49,46.74
KogMaw,Jinx,1381,750,631,54.31
KogMaw,Morgana,452,238,214,52.65
KogMaw,Gangplank,250,118,132,47.2
KogMaw,Kindred,176,90,86,51.14
KogMaw,Aurora,284,159,125,55.99
KogMaw,Sivir,201,112,89,55.72
KogMaw,Yuumi,376,180,196,47.87
KogMaw,Camille,126,70,56,55.56
KogMaw,Hwei,248,127,121,51.21
KogMaw,Jhin,767,386,381,50.33
KogMaw,Zyra,311,154,157,49.52
KogMaw,Quinn,152,79,73,51.97
KogMaw,Jax,386,190,196,49.22
KogMaw,Lucian,272,143,129,52.57
KogMaw,Mel,782,460,322,58.82
KogMaw,Briar,329,130,199,39.51
KogMaw,Maokai,203,105,98,51.72
KogMaw,Xerath,323,164,159,50.77
KogMaw,Ezreal,871,459,412,52.7
KogMaw,Garen,656,353,303,53.81
KogMaw,Zed,338,193,145,57.1
KogMaw,Leblanc,241,132,109,54.77
KogMaw,Twitch,436,197,239,45.18
KogMaw,Karma,483,225,258,46.58
KogMaw,Vayne,616,333,283,54.06
KogMaw,XinZhao,273,154,119,56.41
KogMaw,Chogath,501,261,240,52.1
KogMaw,Nilah,81,37,44,45.68
KogMaw,Thresh,495,258,237,52.12
KogMaw,Irelia,312,179,133,57.37
KogMaw,Varus,371,215,156,57.95
KogMaw,Kayle,280,119,161,42.5
KogMaw,Sion,322,172,150,53.42
KogMaw,Sejuani,200,95,105,47.5
KogMaw,Akali,392,241,151,61.48
KogMaw,Pantheon,552,296,256,53.62
KogMaw,Gwen,207,109,98,52.66
KogMaw,Lillia,211,124,87,58.77
KogMaw,Seraphine,285,128,157,44.91
KogMaw,Ornn,131,77,54,58.78
KogMaw,Singed,79,44,35,55.7
KogMaw,TwistedFate,120,75,45,62.5
KogMaw,Ashe,849,469,380,55.24
KogMaw,Shen,252,148,104,58.73
KogMaw,Samira,257,109,148,42.41
KogMaw,TahmKench,290,128,162,44.14
KogMaw,Urgot,169,69,100,40.83
KogMaw,Yasuo,716,347,369,48.46
KogMaw,Nasus,315,153,162,48.57
KogMaw,Aatrox,325,199,126,61.23
KogMaw,Fizz,235,107,128,45.53
KogMaw,Galio,300,136,164,45.33
KogMaw,Smolder,245,137,108,55.92
KogMaw,Milio,271,124,147,45.76
KogMaw,Nocturne,485,219,266,45.15
KogMaw,Kaisa,630,382,248,60.63
KogMaw,Kennen,83,38,45,45.78
KogMaw,Malzahar,435,213,222,48.97
KogMaw,Janna,146,76,70,52.05
KogMaw,DrMundo,235,121,114,51.49
KogMaw,Amumu,438,229,209,52.28
KogMaw,Ekko,365,171,194,46.85
KogMaw,Poppy,224,121,103,54.02
KogMaw,Khazix,188,109,79,57.98
KogMaw,Nautilus,368,226,142,61.41
KogMaw,Teemo,530,269,261,50.75
KogMaw,Vi,368,202,166,54.89
KogMaw,Ahri,506,256,250,50.59
KogMaw,Karthus,145,67,78,46.21
KogMaw,Brand,299,143,156,47.83
KogMaw,Diana,618,304,314,49.19
KogMaw,Warwick,598,317,281,53.01
KogMaw,Evelynn,144,65,79,45.14
KogMaw,Graves,253,107,146,42.29
KogMaw,Aphelios,175,72,103,41.14
KogMaw,Swain,423,223,200,52.72
KogMaw,Zoe,157,84,73,53.5
KogMaw,Nami,433,212,221,48.96
KogMaw,Zilean,140,72,68,51.43
KogMaw,MasterYi,416,231,185,55.53
KogMaw,Anivia,151,85,66,56.29
KogMaw,Braum,248,154,94,62.1
KogMaw,Caitlyn,1061,525,536,49.48
KogMaw,Taric,106,48,58,45.28
KogMaw,Blitzcrank,248,136,112,54.84
KogMaw,Pyke,273,131,142,47.99
KogMaw,Yorick,369,183,186,49.59
KogMaw,Sona,190,101,89,53.16
KogMaw,JarvanIV,270,140,130,51.85
KogMaw,Skarner,93,72,21,77.42
KogMaw,FiddleSticks,252,124,128,49.21
KogMaw,Shaco,302,145,157,48.01
KogMaw,Veigar,416,235,181,56.49
KogMaw,Malphite,404,193,211,47.77
KogMaw,Belveth,66,29,37,43.94
KogMaw,Sylas,483,241,242,49.9
KogMaw,Tristana,413,192,221,46.49
KogMaw,Rell,176,96,80,54.55
KogMaw,Tryndamere,246,108,138,43.9
KogMaw,Kassadin,75,41,34,54.67
KogMaw,Fiora,142,76,66,53.52
KogMaw,Kalista,70,39,31,55.71
KogMaw,Illaoi,190,86,104,45.26
KogMaw,Neeko,172,88,84,51.16
KogMaw,Orianna,168,81,87,48.21
KogMaw,Rengar,90,54,36,60
KogMaw,Syndra,282,125,157,44.33
KogMaw,Jayce,168,97,71,57.74
KogMaw,Taliyah,104,66,38,63.46
KogMaw,Gragas,204,93,111,45.59
KogMaw,Zac,154,65,89,42.21
KogMaw,Elise,293,154,139,52.56
KogMaw,KSante,214,120,94,56.07
KogMaw,Ryze,157,68,89,43.31
KogMaw,Renata,78,50,28,64.1
KogMaw,Kled,79,33,46,41.77
KogMaw,Vladimir,285,137,148,48.07
KogMaw,Soraka,223,105,118,47.09
KogMaw,Rakan,116,52,64,44.83
KogMaw,Rumble,127,75,52,59.06
KogMaw,Udyr,188,119,69,63.3
KogMaw,Sett,609,335,274,55.01
KogMaw,Senna,330,173,157,52.42
KogMaw,Lissandra,138,79,59,57.25
KogMaw,Ivern,75,52,23,69.33
KogMaw,Renekton,193,110,83,56.99
KogMaw,Bard,113,70,43,61.95
KogMaw,Alistar,138,77,61,55.8
KogMaw,MonkeyKing,250,132,118,52.8
KogMaw,Vex,182,79,103,43.41
KogMaw,Cassiopeia,94,49,45,52.13
KogMaw,Rammus,131,64,67,48.85
KogMaw,Naafiri,119,60,59,50.42
KogMaw,Zeri,121,47,74,38.84
KogMaw,Ambessa,274,143,131,52.19
KogMaw,Olaf,79,40,39,50.63
KogMaw,Heimerdinger,188,98,90,52.13
KogMaw,Hecarim,169,84,85,49.7
KogMaw,Gnar,140,63,77,45
KogMaw,AurelionSol,150,42,108,28
KogMaw,Annie,133,52,81,39.1
KogMaw,Azir,117,60,57,51.28
KogMaw,Corki,173,101,72,58.38
KogMaw,Akshan,146,80,66,54.79
KogMaw,Velkoz,239,120,119,50.21
KogMaw,Shyvana,80,49,31,61.25
KogMaw,Nidalee,124,51,73,41.13
KogMaw,RekSai,43,18,25,41.86
Darius,Pantheon,3795,1885,1910,49.67
Darius,Belveth,560,290,270,51.79
Darius,Katarina,1870,944,926,50.48
Darius,KogMaw,799,393,406,49.19
Darius,Lux,6238,3078,3160,49.34
Darius,Warwick,4062,1974,2088,48.6
Darius,Vi,2332,1132,1200,48.54
Darius,Irelia,1820,953,867,52.36
Darius,Caitlyn,6628,3333,3295,50.29
Darius,Nautilus,2763,1389,1374,50.27
Darius,Trundle,1444,667,777,46.19
Darius,Briar,1840,863,977,46.9
Darius,Jhin,5112,2481,2631,48.53
Darius,Pyke,1870,922,948,49.3
Darius,Gnar,1035,484,551,46.76
Darius,Diana,4173,2072,2101,49.65
Darius,Chogath,2937,1426,1511,48.55
Darius,Jinx,7128,3502,3626,49.13
Darius,Nami,2424,1215,1209,50.12
Darius,Mordekaiser,3713,1816,1897,48.91
Darius,Kayn,3562,1777,1785,49.89
Darius,Talon,1386,691,695,49.86
Darius,MissFortune,6011,2890,3121,48.08
Darius,Lulu,3276,1698,1578,51.83
Darius,Malphite,2371,1259,1112,53.1
Darius,Hwei,1685,815,870,48.37
Darius,Twitch,2002,997,1005,49.8
Darius,Milio,1432,696,736,48.6
Darius,Jayce,1094,527,567,48.17
Darius,Kennen,756,426,330,56.35
Darius,Lucian,1812,898,914,49.56
Darius,Elise,1695,820,875,48.38
Darius,Gangplank,1325,670,655,50.57
Darius,FiddleSticks,1289,608,681,47.17
Darius,Yone,4290,2299,1991,53.59
Darius,Varus,2043,1095,948,53.6
Darius,Zilean,779,384,395,49.29
Darius,Sett,4549,2109,2440,46.36
Darius,Nocturne,3251,1512,1739,46.51
Darius,Azir,840,422,418,50.24
Darius,Ezreal,5682,3017,2665,53.1
Darius,Qiyana,593,336,257,56.66
Darius,Teemo,3230,1599,1631,49.5
Darius,Jax,2115,1087,1028,51.39
Darius,Fizz,1513,802,711,53.01
Darius,Kaisa,4102,2078,2024,50.66
Darius,Morgana,2769,1342,1427,48.47
Darius,Yorick,2442,1102,1340,45.13
Darius,Viktor,2077,1027,1050,49.45
Darius,Corki,1016,528,488,51.97
Darius,Seraphine,1808,878,930,48.56
Darius,Yasuo,4952,2575,2377,52
Darius,Zed,2797,1526,1271,54.56
Darius,Xerath,2079,1012,1067,48.68
Darius,Shaco,2309,1195,1114,51.75
Darius,Soraka,1275,643,632,50.43
Darius,Rammus,776,396,380,51.03
Darius,Ekko,2294,1163,1131,50.7
Darius,Swain,2322,1147,1175,49.4
Darius,Karma,2987,1513,1474,50.65
Darius,Samira,1640,831,809,50.67
Darius,Janna,878,437,441,49.77
Darius,MonkeyKing,2049,1008,1041,49.19
Darius,Vayne,3757,1817,1940,48.36
Darius,Bard,726,421,305,57.99
Darius,LeeSin,3685,1940,1745,52.65
Darius,Garen,4695,2419,2276,51.52
Darius,Akshan,882,448,434,50.79
Darius,Tristana,2488,1284,1204,51.61
Darius,Shen,1481,777,704,52.46
Darius,Amumu,2520,1187,1333,47.1
Darius,Akali,2331,1171,1160,50.24
Darius,TahmKench,1869,952,917,50.94
Darius,Kassadin,523,262,261,50.1
Darius,Volibear,3238,1640,1598,50.65
Darius,Rengar,722,391,331,54.16
Darius,Malzahar,2647,1285,1362,48.55
Darius,Udyr,1183,579,604,48.94
Darius,Mel,4720,2539,2181,53.79
Darius,Nidalee,660,363,297,55
Darius,Graves,1677,866,811,51.64
Darius,DrMundo,1458,672,786,46.09
Darius,Lillia,1276,681,595,53.37
Darius,Yuumi,2010,1031,979,51.29
Darius,Maokai,1111,525,586,47.25
Darius,Sion,1824,851,973,46.66
Darius,Ryze,926,441,485,47.62
Darius,Leona,2107,960,1147,45.56
Darius,Alistar,1025,530,495,51.71
Darius,Olaf,560,324,236,57.86
Darius,Vladimir,1641,881,760,53.69
Darius,Renekton,1296,648,648,50
Darius,Viego,3543,1804,1739,50.92
Darius,Thresh,3335,1667,1668,49.99
Darius,Ashe,5160,2640,2520,51.16
Darius,Naafiri,781,389,392,49.81
Darius,Kayle,1789,850,939,47.51
Darius,Sejuani,1060,568,492,53.58
Darius,Xayah,1084,549,535,50.65
Darius,Rakan,946,473,473,50
Darius,Taliyah,581,260,321,44.75
Darius,Zyra,2367,1040,1327,43.94
Darius,Neeko,1127,616,511,54.66
Darius,Gragas,1262,677,585,53.65
Darius,Galio,2126,1036,1090,48.73
Darius,Camille,894,428,466,47.87
Darius,Poppy,1256,635,621,50.56
Darius,Velkoz,1527,737,790,48.26
Darius,Nunu,1307,633,674,48.43
Darius,Ahri,3201,1635,1566,51.08
Darius,Senna,1895,941,954,49.66
Darius,Veigar,2526,1214,1312,48.06
Darius,Ziggs,874,423,451,48.4
Darius,Aurora,1813,899,914,49.59
Darius,Sivir,1243,583,660,46.9
Darius,Riven,1250,595,655,47.6
Darius,Ivern,324,176,148,54.32
Darius,Sylas,3074,1568,1506,51.01
Darius,Braum,1364,680,684,49.85
Darius,Orianna,1030,504,526,48.93
Darius,Skarner,601,336,265,55.91
Darius,Brand,1944,943,1001,48.51
Darius,Gwen,1118,567,551,50.72
Darius,KSante,1369,694,675,50.69
Darius,Karthus,756,390,366,51.59
Darius,Evelynn,773,402,371,52.01
Darius,Nasus,1767,890,877,50.37
Darius,Tryndamere,1532,803,729,52.42
Darius,Kled,452,246,206,54.42
Darius,Urgot,1368,676,692,49.42
Darius,Leblanc,1362,672,690,49.34
Darius,Heimerdinger,1308,627,681,47.94
Darius,MasterYi,3136,1576,1560,50.26
Darius,Rell,1077,489,588,45.4
Darius,Draven,1262,649,613,51.43
Darius,Nilah,724,329,395,45.44
Darius,Taric,592,292,300,49.32
Darius,Blitzcrank,1812,959,853,52.92
Darius,Aatrox,2362,1203,1159,50.93
Darius,Kindred,1138,556,582,48.86
Darius,Shyvana,658,344,314,52.28
Darius,Vex,1107,509,598,45.98
Darius,Cassiopeia,694,365,329,52.59
Darius,Fiora,841,440,401,52.32
Darius,Zeri,907,487,420,53.69
Darius,Quinn,1023,500,523,48.88
Darius,Illaoi,1174,547,627,46.59
Darius,Ornn,1001,503,498,50.25
Darius,Renata,372,204,168,54.84
Darius,Syndra,1577,776,801,49.21
Darius,Ambessa,1444,813,631,56.3
Darius,AurelionSol,984,466,518,47.36
Darius,Khazix,1233,633,600,51.34
Darius,Annie,778,412,366,52.96
Darius,Hecarim,987,545,442,55.22
Darius,Lissandra,808,418,390,51.73
Darius,XinZhao,1689,817,872,48.37
Darius,JarvanIV,1530,790,740,51.63
Darius,Kalista,549,300,249,54.64
Darius,Smolder,1640,870,770,53.05
Darius,Anivia,808,377,431,46.66
Darius,Aphelios,1313,672,641,51.18
Darius,Zac,1034,521,513,50.39
Darius,TwistedFate,803,432,371,53.8
Darius,Sona,784,397,387,50.64
Darius,Rumble,616,353,263,57.31
Darius,Singed,606,302,304,49.83
Darius,RekSai,325,161,164,49.54
Darius,Zoe,869,388,481,44.65
Leona,Pantheon,1790,872,918,48.72
Leona,Belveth,253,133,120,52.57
Leona,Katarina,836,424,412,50.72
Leona,KogMaw,290,158,132,54.48
Leona,Lux,2864,1479,1385,51.64
Leona,Yasuo,2107,1020,1087,48.41
Leona,Kayn,1616,801,815,49.57
Leona,Mel,2508,1339,1169,53.39
Leona,Xayah,573,299,274,52.18
Leona,Rakan,384,180,204,46.88
Leona,Aatrox,974,475,499,48.77
Leona,Draven,577,316,261,54.77
Leona,Blitzcrank,1014,551,463,54.34
Leona,Maokai,510,293,217,57.45
Leona,MasterYi,1518,828,690,54.55
Leona,Samira,766,393,373,51.31
Leona,Pyke,860,413,447,48.02
Leona,Nasus,794,393,401,49.5
Leona,Diana,1793,856,937,47.74
Leona,Renekton,631,325,306,51.51
Leona,Veigar,1034,493,541,47.68
Leona,Seraphine,758,344,414,45.38
Leona,Irelia,1030,495,535,48.06
Leona,Briar,786,353,433,44.91
Leona,Vayne,1531,726,805,47.42
Leona,Olaf,302,152,150,50.33
Leona,Leblanc,626,341,285,54.47
Leona,Jinx,3124,1501,1623,48.05
Leona,Karma,1263,557,706,44.1
Leona,RekSai,105,56,49,53.33
Leona,Ahri,1418,701,717,49.44
Leona,Malphite,1170,570,600,48.72
Leona,Chogath,1364,728,636,53.37
Leona,Sylas,1717,903,814,52.59
Leona,Ashe,2261,1085,1176,47.99
Leona,Morgana,1406,675,731,48.01
Leona,Kaisa,1835,921,914,50.19
Leona,Tristana,1103,556,547,50.41
Leona,Swain,1087,495,592,45.54
Leona,Darius,2107,1147,960,54.44
Leona,Viego,1579,777,802,49.21
Leona,Taliyah,248,115,133,46.37
Leona,Jax,1077,511,566,47.45
Leona,MonkeyKing,755,382,373,50.6
Leona,Caitlyn,2965,1475,1490,49.75
Leona,Poppy,934,463,471,49.57
Leona,Gnar,383,181,202,47.26
Leona,Vladimir,719,374,345,52.02
Leona,Twitch,748,367,381,49.06
Leona,Lulu,1254,626,628,49.92
Leona,Warwick,1635,804,831,49.17
Leona,Skarner,298,161,137,54.03
Leona,Teemo,1401,656,745,46.82
Leona,Nocturne,1511,706,805,46.72
Leona,Ezreal,2867,1467,1400,51.17
Leona,Nami,933,472,461,50.59
Leona,Vi,1043,489,554,46.88
Leona,Kayle,663,280,383,42.23
Leona,TahmKench,869,419,450,48.22
Leona,Mordekaiser,1503,662,841,44.05
Leona,MissFortune,2433,1208,1225,49.65
Leona,Heimerdinger,437,216,221,49.43
Leona,Rammus,393,185,208,47.07
Leona,LeeSin,1601,852,749,53.22
Leona,Karthus,300,147,153,49
Leona,Fizz,704,375,329,53.27
Leona,Jhin,2142,1044,1098,48.74
Leona,Corki,418,198,220,47.37
Leona,Soraka,607,248,359,40.86
Leona,Shaco,967,448,519,46.33
Leona,Zilean,303,131,172,43.23
Leona,Malzahar,1123,509,614,45.33
Leona,Rell,580,277,303,47.76
Leona,JarvanIV,565,271,294,47.96
Leona,Yuumi,965,513,452,53.16
Leona,Evelynn,330,149,181,45.15
Leona,Yone,1996,1037,959,51.95
Leona,Thresh,1669,821,848,49.19
Leona,Cassiopeia,311,150,161,48.23
Leona,Riven,425,225,200,52.94
Leona,Viktor,978,491,487,50.2
Leona,Neeko,469,225,244,47.97
Leona,Gangplank,525,263,262,50.1
Leona,Ekko,1088,564,524,51.84
Leona,Kassadin,203,107,96,52.71
Leona,Varus,956,543,413,56.8
Leona,Sejuani,439,241,198,54.9
Leona,Zed,1174,569,605,48.47
Leona,Illaoi,511,253,258,49.51
Leona,Amumu,1262,580,682,45.96
Leona,Rengar,309,153,156,49.51
Leona,Sett,1652,788,864,47.7
Leona,Brand,871,411,460,47.19
Leona,Elise,703,326,377,46.37
Leona,Nautilus,1334,714,620,53.52
Leona,Smolder,669,354,315,52.91
Leona,Orianna,488,226,262,46.31
Leona,Hwei,652,350,302,53.68
Leona,Garen,1756,842,914,47.95
Leona,Yorick,1039,520,519,50.05
Leona,Quinn,340,180,160,52.94
Leona,Kindred,458,240,218,52.4
Leona,Azir,393,213,180,54.2
Leona,Kalista,210,109,101,51.9
Leona,Sona,297,149,148,50.17
Leona,Zyra,1134,511,623,45.06
Leona,Xerath,997,526,471,52.76
Leona,Khazix,431,207,224,48.03
Leona,Ziggs,342,192,150,56.14
Leona,Braum,776,359,417,46.26
Leona,Volibear,1198,618,580,51.59
Leona,Lillia,679,363,316,53.46
Leona,Gragas,586,295,291,50.34
Leona,Ambessa,633,315,318,49.76
Leona,Bard,292,145,147,49.66
Leona,Akali,1121,581,540,51.83
Leona,Naafiri,353,156,197,44.19
Leona,FiddleSticks,532,274,258,51.5
Leona,Graves,709,362,347,51.06
Leona,Ivern,142,61,81,42.96
Leona,TwistedFate,317,153,164,48.26
Leona,Fiora,404,234,170,57.92
Leona,Ryze,415,191,224,46.02
Leona,Sivir,684,299,385,43.71
Leona,Milio,627,303,324,48.33
Leona,DrMundo,600,311,289,51.83
Leona,Gwen,485,235,250,48.45
Leona,Jayce,519,265,254,51.06
Leona,Sion,747,333,414,44.58
Leona,Velkoz,625,299,326,47.84
Leona,KSante,595,310,285,52.1
Leona,AurelionSol,467,241,226,51.61
Leona,Kled,220,121,99,55
Leona,Trundle,620,308,312,49.68
Leona,XinZhao,781,385,396,49.3
Leona,Taric,283,138,145,48.76
Leona,Aurora,769,385,384,50.07
Leona,Zac,480,219,261,45.63
Leona,Alistar,619,304,315,49.11
Leona,Zoe,372,184,188,49.46
Leona,Galio,1088,519,569,47.7
Leona,Lucian,680,383,297,56.32
Leona,Akshan,370,172,198,46.49
Leona,Hecarim,452,237,215,52.43
Leona,Singed,258,124,134,48.06
Leona,Shen,677,347,330,51.26
Leona,Rumble,327,170,157,51.99
Leona,Ornn,468,205,263,43.8
Leona,Syndra,719,341,378,47.43
Leona,Nunu,555,307,248,55.32
Leona,Anivia,360,191,169,53.06
Leona,Lissandra,363,144,219,39.67
Leona,Camille,361,152,209,42.11
Leona,Urgot,511,224,287,43.84
Leona,Shyvana,305,149,156,48.85
Leona,Renata,154,86,68,55.84
Leona,Udyr,470,243,227,51.7
Leona,Senna,619,321,298,51.86
Leona,Vex,575,314,261,54.61
Leona,Nilah,328,135,193,41.16
Leona,Qiyana,237,104,133,43.88
Leona,Zeri,451,218,233,48.34
Leona,Annie,392,217,175,55.36
Leona,Tryndamere,545,322,223,59.08
Leona,Aphelios,558,264,294,47.31
Leona,Janna,384,175,209,45.57
Leona,Nidalee,316,193,123,61.08
Leona,Talon,576,273,303,47.4
Leona,Kennen,232,103,129,44.4
Qiyana,Warwick,387,152,235,39.28
Qiyana,Vi,223,100,123,44.84
Qiyana,Irelia,285,151,134,52.98
Qiyana,Caitlyn,865,387,478,44.74
Qiyana,Nautilus,332,167,165,50.3
Qiyana,Darius,593,257,336,43.34
Qiyana,Lillia,172,72,100,41.86
Qiyana,Garen,525,233,292,44.38
Qiyana,Pyke,271,154,117,56.83
Qiyana,Kayn,472,186,286,39.41
Qiyana,Rengar,115,59,56,51.3
Qiyana,Fizz,154,73,81,47.4
Qiyana,KogMaw,92,49,43,53.26
Qiyana,Lux,705,310,395,43.97
Qiyana,Sett,392,158,234,40.31
Qiyana,Aurora,267,134,133,50.19
Qiyana,Aphelios,194,86,108,44.33
Qiyana,Bard,116,37,79,31.9
Qiyana,Yorick,271,129,142,47.6
Qiyana,Syndra,213,99,114,46.48
Qiyana,Samira,226,116,110,51.33
Qiyana,Pantheon,494,215,279,43.52
Qiyana,Camille,112,60,52,53.57
Qiyana,Shaco,301,134,167,44.52
Qiyana,Ekko,322,131,191,40.68
Qiyana,Tristana,329,120,209,36.47
Qiyana,Thresh,375,180,195,48
Qiyana,Nunu,176,79,97,44.89
Qiyana,Katarina,304,130,174,42.76
Qiyana,Sivir,173,77,96,44.51
Qiyana,Zyra,285,134,151,47.02
Qiyana,Malphite,374,186,188,49.73
Qiyana,Akali,347,185,162,53.31
Qiyana,Jhin,686,329,357,47.96
Qiyana,Rell,148,57,91,38.51
Qiyana,KSante,185,109,76,58.92
Qiyana,Gragas,178,85,93,47.75
Qiyana,Jax,278,115,163,41.37
Qiyana,Evelynn,104,53,51,50.96
Qiyana,Ashe,654,327,327,50
Qiyana,Yasuo,606,285,321,47.03
Qiyana,Kaisa,521,290,231,55.66
Qiyana,Soraka,146,64,82,43.84
Qiyana,Gwen,143,72,71,50.35
Qiyana,Amumu,311,141,170,45.34
Qiyana,Jinx,779,370,409,47.5
Qiyana,Renata,32,14,18,43.75
Qiyana,Gangplank,114,63,51,55.26
Qiyana,Graves,226,86,140,38.05
Qiyana,Vladimir,222,95,127,42.79
Qiyana,Elise,296,132,164,44.59
Qiyana,JarvanIV,188,64,124,34.04
Qiyana,Yone,538,255,283,47.4
Qiyana,Vayne,406,204,202,50.25
Qiyana,Velkoz,231,107,124,46.32
Qiyana,Rumble,85,34,51,40
Qiyana,Jayce,206,101,105,49.03
Qiyana,Nami,356,156,200,43.82
Qiyana,Heimerdinger,132,61,71,46.21
Qiyana,Diana,509,230,279,45.19
Qiyana,Karma,486,232,254,47.74
Qiyana,Teemo,314,124,190,39.49
Qiyana,Volibear,349,176,173,50.43
Qiyana,Kassadin,82,46,36,56.1
Qiyana,Trundle,158,69,89,43.67
Qiyana,Vex,212,105,107,49.53
Qiyana,Kayle,195,106,89,54.36
Qiyana,Mel,602,311,291,51.66
Qiyana,Lucian,233,117,116,50.21
Qiyana,Illaoi,120,49,71,40.83
Qiyana,MissFortune,652,304,348,46.63
Qiyana,Azir,129,43,86,33.33
Qiyana,Milio,226,113,113,50
Qiyana,Urgot,128,47,81,36.72
Qiyana,MasterYi,441,235,206,53.29
Qiyana,Yuumi,228,100,128,43.86
Qiyana,Ornn,133,44,89,33.08
Qiyana,Zeri,149,73,76,48.99
Qiyana,Zed,438,210,228,47.95
Qiyana,Draven,175,80,95,45.71
Qiyana,Twitch,245,102,143,41.63
Qiyana,Riven,192,91,101,47.4
Qiyana,Skarner,81,36,45,44.44
Qiyana,Ezreal,768,335,433,43.62
Qiyana,Xerath,242,96,146,39.67
Qiyana,Ambessa,212,101,111,47.64
Qiyana,Hwei,195,70,125,35.9
Qiyana,Kindred,141,60,81,42.55
Qiyana,Nilah,87,36,51,41.38
Qiyana,Gnar,127,59,68,46.46
Qiyana,Ahri,399,202,197,50.63
Qiyana,Rakan,91,43,48,47.25
Qiyana,Blitzcrank,222,116,106,52.25
Qiyana,Fiora,157,79,78,50.32
Qiyana,Zac,139,55,84,39.57
Qiyana,Kalista,93,40,53,43.01
Qiyana,Orianna,199,107,92,53.77
Qiyana,Nasus,203,112,91,55.17
Qiyana,Smolder,194,109,85,56.19
Qiyana,Seraphine,197,100,97,50.76
Qiyana,Swain,238,102,136,42.86
Qiyana,Hecarim,132,63,69,47.73
Qiyana,Sion,249,124,125,49.8
Qiyana,Galio,214,104,110,48.6
Qiyana,Poppy,201,104,97,51.74
Qiyana,Ryze,123,63,60,51.22
Qiyana,Zoe,164,59,105,35.98
Qiyana,LeeSin,489,246,243,50.31
Qiyana,Lissandra,119,49,70,41.18
Qiyana,Sylas,460,247,213,53.7
Qiyana,Aatrox,348,165,183,47.41
Qiyana,Shyvana,74,29,45,39.19
Qiyana,Lulu,506,278,228,54.94
Qiyana,Shen,206,98,108,47.57
Qiyana,Chogath,333,146,187,43.84
Qiyana,Renekton,161,78,83,48.45
Qiyana,TahmKench,193,84,109,43.52
Qiyana,Alistar,143,73,70,51.05
Qiyana,Malzahar,274,118,156,43.07
Qiyana,Xayah,158,79,79,50
Qiyana,Cassiopeia,91,49,42,53.85
Qiyana,Viktor,284,127,157,44.72
Qiyana,Nidalee,94,36,58,38.3
Qiyana,Senna,230,92,138,40
Qiyana,Leblanc,164,92,72,56.1
Qiyana,Varus,268,119,149,44.4
Qiyana,DrMundo,137,59,78,43.07
Qiyana,Brand,202,81,121,40.1
Qiyana,Khazix,203,125,78,61.58
Qiyana,Udyr,139,63,76,45.32
Qiyana,Viego,522,254,268,48.66
Qiyana,Karthus,106,53,53,50
Qiyana,Morgana,285,136,149,47.72
Qiyana,FiddleSticks,152,81,71,53.29
Qiyana,Mordekaiser,323,154,169,47.68
Qiyana,Zilean,107,51,56,47.66
Qiyana,Annie,94,50,44,53.19
Qiyana,Neeko,109,43,66,39.45
Qiyana,TwistedFate,96,35,61,36.46
Qiyana,Janna,160,78,82,48.75
Qiyana,Nocturne,403,159,244,39.45
Qiyana,Rammus,67,26,41,38.81
Qiyana,Braum,142,69,73,48.59
Qiyana,XinZhao,204,114,90,55.88
Qiyana,MonkeyKing,212,98,114,46.23
Qiyana,Talon,192,99,93,51.56
Qiyana,Singed,69,34,35,49.28
Qiyana,Leona,237,133,104,56.12
Qiyana,Briar,179,83,96,46.37
Qiyana,Anivia,88,35,53,39.77
Qiyana,Corki,157,76,81,48.41
Qiyana,Taliyah,105,48,57,45.71
Qiyana,Naafiri,93,34,59,36.56
Qiyana,Kled,57,24,33,42.11
Qiyana,Veigar,311,179,132,57.56
Qiyana,Tryndamere,226,108,118,47.79
Qiyana,Akshan,123,57,66,46.34
Qiyana,Sejuani,108,62,46,57.41
Qiyana,Ziggs,99,58,41,58.59
Qiyana,Quinn,85,33,52,38.82
Qiyana,Belveth,79,56,23,70.89
Qiyana,Sona,75,32,43,42.67
Qiyana,Olaf,99,41,58,41.41
Qiyana,Maokai,135,48,87,35.56
Qiyana,Kennen,71,37,34,52.11
Qiyana,Ivern,36,22,14,61.11
Qiyana,Taric,65,23,42,35.38
Qiyana,AurelionSol,110,59,51,53.64
Qiyana,RekSai,31,14,17,45.16
Swain,Warwick,1875,955,920,50.93
Swain,Vi,1129,594,535,52.61
Swain,Irelia,1026,505,521,49.22
Swain,Caitlyn,3387,1635,1752,48.27
Swain,Nautilus,1463,819,644,55.98
Swain,Aurora,844,457,387,54.15
Swain,Corki,432,247,185,57.18
Swain,Orianna,436,241,195,55.28
Swain,Xayah,509,259,250,50.88
Swain,Nami,1101,546,555,49.59
Swain,Diana,1956,981,975,50.15
Swain,Fizz,705,360,345,51.06
Swain,Vayne,1658,791,867,47.71
Swain,Yuumi,945,453,492,47.94
Swain,Darius,2322,1175,1147,50.6
Swain,Mel,2386,1226,1160,51.38
Swain,Jinx,3576,1800,1776,50.34
Swain,Thresh,1743,956,787,54.85
Swain,Malphite,1335,746,589,55.88
Swain,Shyvana,383,181,202,47.26
Swain,Naafiri,365,207,158,56.71
Swain,MissFortune,3158,1618,1540,51.23
Swain,Maokai,551,290,261,52.63
Swain,Sejuani,513,285,228,55.56
Swain,Yone,2140,1093,1047,51.07
Swain,Ezreal,2718,1459,1259,53.68
Swain,Milio,593,282,311,47.55
Swain,Sett,1922,902,1020,46.93
Swain,Hecarim,469,246,223,52.45
Swain,Graves,817,456,361,55.81
Swain,Jhin,2500,1315,1185,52.6
Swain,Karma,1422,714,708,50.21
Swain,Azir,422,219,203,51.9
Swain,Lux,3302,1645,1657,49.82
Swain,Rammus,324,177,147,54.63
Swain,MasterYi,1548,740,808,47.8
Swain,Katarina,928,466,462,50.22
Swain,Aphelios,617,345,272,55.92
Swain,Poppy,636,344,292,54.09
Swain,Aatrox,1125,604,521,53.69
Swain,Evelynn,385,229,156,59.48
Swain,Kaisa,2011,1115,896,55.45
Swain,Zilean,426,205,221,48.12
Swain,Volibear,1503,787,716,52.36
Swain,JarvanIV,707,365,342,51.63
Swain,Zed,1385,727,658,52.49
Swain,Lucian,776,434,342,55.93
Swain,Mordekaiser,1718,827,891,48.14
Swain,Talon,648,288,360,44.44
Swain,Malzahar,1499,720,779,48.03
Swain,Leona,1087,592,495,54.46
Swain,Olaf,255,128,127,50.2
Swain,LeeSin,1725,923,802,53.51
Swain,Nasus,1025,524,501,51.12
Swain,Kindred,641,307,334,47.89
Swain,Ashe,2615,1320,1295,50.48
Swain,Shaco,1262,690,572,54.68
Swain,TahmKench,985,517,468,52.49
Swain,Kayn,1652,857,795,51.88
Swain,Akali,1309,683,626,52.18
Swain,Sona,416,207,209,49.76
Swain,Belveth,295,159,136,53.9
Swain,Syndra,714,378,336,52.94
Swain,Lulu,1578,816,762,51.71
Swain,Camille,349,184,165,52.72
Swain,Lissandra,389,189,200,48.59
Swain,Smolder,812,435,377,53.57
Swain,Zyra,1103,513,590,46.51
Swain,Sion,843,456,387,54.09
Swain,Vladimir,857,412,445,48.07
Swain,Amumu,1333,652,681,48.91
Swain,Tristana,1289,648,641,50.27
Swain,Ambessa,707,396,311,56.01
Swain,Briar,878,417,461,47.49
Swain,Yorick,1265,663,602,52.41
Swain,Pantheon,1972,1018,954,51.62
Swain,Twitch,1017,513,504,50.44
Swain,Neeko,560,307,253,54.82
Swain,Ekko,1080,577,503,53.43
Swain,Ahri,1795,968,827,53.93
Swain,Kennen,320,152,168,47.5
Swain,Soraka,752,374,378,49.73
Swain,Draven,556,296,260,53.24
Swain,Velkoz,738,421,317,57.05
Swain,Gnar,556,280,276,50.36
Swain,Nidalee,319,176,143,55.17
Swain,Yasuo,2550,1342,1208,52.63
Swain,Trundle,776,391,385,50.39
Swain,Ryze,408,223,185,54.66
Swain,Singed,389,195,194,50.13
Swain,Viktor,1037,517,520,49.86
Swain,Veigar,1280,651,629,50.86
Swain,Senna,998,516,482,51.7
Swain,Rumble,271,126,145,46.49
Swain,Seraphine,878,451,427,51.37
Swain,Pyke,990,525,465,53.03
Swain,Sylas,1969,1083,886,55
Swain,Renekton,623,349,274,56.02
Swain,Blitzcrank,870,472,398,54.25
Swain,MonkeyKing,876,455,421,51.94
Swain,Ziggs,449,226,223,50.33
Swain,KSante,635,326,309,51.34
Swain,Kalista,275,131,144,47.64
Swain,Fiora,435,195,240,44.83
Swain,Udyr,536,272,264,50.75
Swain,Kassadin,253,126,127,49.8
Swain,Galio,1199,610,589,50.88
Swain,Rengar,339,186,153,54.87
Swain,Quinn,405,205,200,50.62
Swain,Chogath,1553,740,813,47.65
Swain,Teemo,1665,816,849,49.01
Swain,Riven,537,262,275,48.79
Swain,Elise,771,371,400,48.12
Swain,Brand,1093,546,547,49.95
Swain,Jax,1227,680,547,55.42
Swain,Samira,866,482,384,55.66
Swain,Nunu,584,322,262,55.14
Swain,Nocturne,1554,814,740,52.38
Swain,Heimerdinger,622,291,331,46.78
Swain,Janna,418,203,215,48.56
Swain,Cassiopeia,407,200,207,49.14
Swain,Skarner,289,181,108,62.63
Swain,TwistedFate,373,165,208,44.24
Swain,Hwei,740,349,391,47.16
Swain,Morgana,1552,736,816,47.42
Swain,Gwen,611,336,275,54.99
Swain,Illaoi,563,294,269,52.22
Swain,Karthus,379,172,207,45.38
Swain,Gangplank,546,275,271,50.37
Swain,Rakan,424,220,204,51.89
Swain,Viego,1710,823,887,48.13
Swain,Garen,2216,1077,1139,48.6
Swain,Xerath,1126,576,550,51.15
Swain,Sivir,665,363,302,54.59
Swain,Kayle,888,441,447,49.66
Swain,Tryndamere,691,354,337,51.23
Swain,Anivia,364,187,177,51.37
Swain,Braum,724,332,392,45.86
Swain,Ornn,499,249,250,49.9
Swain,Nilah,446,239,207,53.59
Swain,Gragas,677,361,316,53.32
Swain,Taliyah,270,128,142,47.41
Swain,Vex,626,354,272,56.55
Swain,Kled,203,116,87,57.14
Swain,Varus,1158,587,571,50.69
Swain,Rell,576,329,247,57.12
Swain,Khazix,532,274,258,51.5
Swain,Ivern,162,87,75,53.7
Swain,Shen,802,440,362,54.86
Swain,Renata,198,86,112,43.43
Swain,Qiyana,238,136,102,57.14
Swain,KogMaw,423,200,223,47.28
Swain,Lillia,715,363,352,50.77
Swain,Leblanc,743,404,339,54.37
Swain,Alistar,615,323,292,52.52
Swain,RekSai,123,74,49,60.16
Swain,Zoe,358,207,151,57.82
Swain,Zac,559,333,226,59.57
Swain,DrMundo,687,388,299,56.48
Swain,Bard,266,121,145,45.49
Swain,Annie,433,230,203,53.12
Swain,Zeri,438,241,197,55.02
Swain,Urgot,621,304,317,48.95
Swain,Akshan,427,220,207,51.52
Swain,Taric,290,163,127,56.21
Swain,XinZhao,900,468,432,52
Swain,Jayce,523,287,236,54.88
Swain,AurelionSol,481,236,245,49.06
Swain,FiddleSticks,619,312,307,50.4
Vi,Darius,2332,1200,1132,51.46
Vi,Rammus,335,170,165,50.75
Vi,Qiyana,223,123,100,55.16
Vi,Ezreal,3447,1752,1695,50.83
Vi,Swain,1129,533,596,47.21
Vi,Shen,721,400,321,55.48
Vi,Belveth,301,150,151,49.83
Vi,Akali,1307,726,581,55.55
Vi,Varus,1059,537,522,50.71
Vi,Lulu,1666,850,816,51.02
Vi,Warwick,1848,820,1028,44.37
Vi,Hecarim,525,256,269,48.76
Vi,Diana,1991,946,1045,47.51
Vi,Ziggs,356,169,187,47.47
Vi,Karma,1712,887,825,51.81
Vi,Garen,2013,932,1081,46.3
Vi,Rengar,351,202,149,57.55
Vi,Lissandra,410,182,228,44.39
Vi,Tristana,1164,620,544,53.26
Vi,Zyra,1200,585,615,48.75
Vi,Ivern,168,70,98,41.67
Vi,Anivia,405,194,211,47.9
Vi,Ashe,2638,1234,1404,46.78
Vi,Aatrox,1097,566,531,51.6
Vi,Chogath,1431,663,768,46.33
Vi,Vayne,1631,875,756,53.65
Vi,Thresh,1608,719,889,44.71
Vi,Kayn,1688,842,846,49.88
Vi,Katarina,918,450,468,49.02
Vi,Jhin,2235,1091,1144,48.81
Vi,Blitzcrank,852,408,444,47.89
Vi,Sett,1805,904,901,50.08
Vi,MonkeyKing,1011,528,483,52.23
Vi,Corki,471,243,228,51.59
Vi,Nocturne,1694,738,956,43.57
Vi,Galio,1141,552,589,48.38
Vi,Caitlyn,3235,1562,1673,48.28
Vi,Morgana,1516,748,768,49.34
Vi,Ambessa,842,395,447,46.91
Vi,Taliyah,364,185,179,50.82
Vi,Vex,617,308,309,49.92
Vi,MissFortune,2746,1335,1411,48.62
Vi,Elise,900,422,478,46.89
Vi,Malphite,1228,601,627,48.94
Vi,Ekko,1081,496,585,45.88
Vi,Mel,2476,1277,1199,51.58
Vi,Lux,2776,1423,1353,51.26
Vi,RekSai,129,56,73,43.41
Vi,Yasuo,2412,1194,1218,49.5
Vi,Pyke,941,476,465,50.58
Vi,Pantheon,1880,921,959,48.99
Vi,Ahri,1608,801,807,49.81
Vi,Nami,1247,592,655,47.47
Vi,Irelia,1032,486,546,47.09
Vi,Mordekaiser,1533,757,776,49.38
Vi,Sylas,2014,1040,974,51.64
Vi,Milio,698,323,375,46.28
Vi,Talon,782,369,413,47.19
Vi,Syndra,802,405,397,50.5
Vi,Kaisa,2178,1088,1090,49.95
Vi,Amumu,1091,538,553,49.31
Vi,Leona,1043,554,489,53.12
Vi,Teemo,1408,685,723,48.65
Vi,Graves,827,410,417,49.58
Vi,Brand,869,401,468,46.14
Vi,Samira,744,374,370,50.27
Vi,TahmKench,816,440,376,53.92
Vi,LeeSin,2592,1356,1236,52.31
Vi,Nautilus,1315,657,658,49.96
Vi,Senna,838,405,433,48.33
Vi,Zed,1451,790,661,54.45
Vi,Rakan,489,240,249,49.08
Vi,AurelionSol,473,245,228,51.8
Vi,Lillia,692,343,349,49.57
Vi,Lucian,918,430,488,46.84
Vi,Gangplank,681,324,357,47.58
Vi,Yone,2313,1205,1108,52.1
Vi,Gnar,501,224,277,44.71
Vi,Orianna,534,287,247,53.75
Vi,Trundle,632,308,324,48.73
Vi,Viego,1796,858,938,47.77
Vi,Yorick,1150,517,633,44.96
Vi,Briar,887,392,495,44.19
Vi,Rumble,411,168,243,40.88
Vi,Twitch,871,470,401,53.96
Vi,Vladimir,791,351,440,44.37
Vi,MasterYi,1580,826,754,52.28
Vi,Seraphine,831,419,412,50.42
Vi,XinZhao,1004,489,515,48.71
Vi,Jinx,3560,1703,1857,47.84
Vi,Poppy,834,391,443,46.88
Vi,Xayah,789,378,411,47.91
Vi,Urgot,572,286,286,50
Vi,Sivir,721,367,354,50.9
Vi,Volibear,1396,663,733,47.49
Vi,Fiora,466,237,229,50.86
Vi,Nunu,600,277,323,46.17
Vi,Hwei,765,363,402,47.45
Vi,Nasus,895,495,400,55.31
Vi,Leblanc,851,419,432,49.24
Vi,Shaco,1105,581,524,52.58
Vi,Illaoi,522,263,259,50.38
Vi,KSante,707,369,338,52.19
Vi,Tryndamere,627,302,325,48.17
Vi,Aurora,801,361,440,45.07
Vi,Velkoz,635,300,335,47.24
Vi,Malzahar,1234,638,596,51.7
Vi,Ornn,495,237,258,47.88
Vi,Xerath,1289,628,661,48.72
Vi,Sejuani,595,287,308,48.24
Vi,Veigar,1115,549,566,49.24
Vi,Maokai,467,226,241,48.39
Vi,Viktor,1103,528,575,47.87
Vi,Zac,627,321,306,51.2
Vi,Kalista,290,147,143,50.69
Vi,Kindred,477,236,241,49.48
Vi,Zeri,619,367,252,59.29
Vi,Soraka,610,263,347,43.11
Vi,Azir,420,228,192,54.29
Vi,TwistedFate,463,243,220,52.48
Vi,FiddleSticks,606,299,307,49.34
Vi,Kassadin,282,130,152,46.1
Vi,Draven,616,301,315,48.86
Vi,JarvanIV,817,414,403,50.67
Vi,Karthus,404,194,210,48.02
Vi,Jax,1133,536,597,47.31
Vi,Riven,540,293,247,54.26
Vi,Akshan,390,192,198,49.23
Vi,Kayle,766,328,438,42.82
Vi,Smolder,730,369,361,50.55
Vi,Quinn,460,233,227,50.65
Vi,Neeko,524,225,299,42.94
Vi,Fizz,663,310,353,46.76
Vi,Janna,375,156,219,41.6
Vi,Annie,411,213,198,51.82
Vi,Zilean,377,203,174,53.85
Vi,Camille,401,200,201,49.88
Vi,KogMaw,368,166,202,45.11
Vi,Udyr,448,241,207,53.79
Vi,Sona,346,169,177,48.84
Vi,Gragas,795,374,421,47.04
Vi,Sion,867,425,442,49.02
Vi,Braum,719,324,395,45.06
Vi,Kennen,306,140,166,45.75
Vi,Jayce,723,335,388,46.33
Vi,Ryze,426,184,242,43.19
Vi,Alistar,567,270,297,47.62
Vi,Evelynn,489,262,227,53.58
Vi,Heimerdinger,509,280,229,55.01
Vi,Kled,224,86,138,38.39
Vi,Zoe,520,267,253,51.35
Vi,Bard,317,161,156,50.79
Vi,Khazix,539,242,297,44.9
Vi,Yuumi,1071,572,499,53.41
Vi,DrMundo,642,322,320,50.16
Vi,Renekton,660,291,369,44.09
Vi,Singed,324,137,187,42.28
Vi,Olaf,353,164,189,46.46
Vi,Nidalee,353,207,146,58.64
Vi,Gwen,509,276,233,54.22
Vi,Aphelios,551,262,289,47.55
Vi,Nilah,346,142,204,41.04
Vi,Naafiri,354,193,161,54.52
Vi,Taric,281,111,170,39.5
Vi,Rell,580,279,301,48.1
Vi,Shyvana,307,118,189,38.44
Vi,Skarner,321,179,142,55.76
Vi,Cassiopeia,335,149,186,44.48
Vi,Renata,232,130,102,56.03
Irelia,Darius,1820,867,953,47.64
Irelia,Rammus,413,188,225,45.52
Irelia,Qiyana,285,134,151,47.02
Irelia,Ezreal,2799,1375,1424,49.12
Irelia,Swain,1026,521,505,50.78
Irelia,Kayle,785,373,412,47.52
Irelia,Mordekaiser,1296,647,649,49.92
Irelia,Yasuo,2413,1170,1243,48.49
Irelia,Varus,916,488,428,53.28
Irelia,Galio,949,435,514,45.84
Irelia,Ornn,443,224,219,50.56
Irelia,Kayn,1569,757,812,48.25
Irelia,Caitlyn,3108,1638,1470,52.7
Irelia,Morgana,1122,537,585,47.86
Irelia,Fiora,417,192,225,46.04
Irelia,Warwick,1464,675,789,46.11
Irelia,Zed,1356,685,671,50.52
Irelia,Chogath,1253,616,637,49.16
Irelia,Shen,572,301,271,52.62
Irelia,Amumu,1060,497,563,46.89
Irelia,Orianna,415,219,196,52.77
Irelia,Sona,329,173,156,52.58
Irelia,Gnar,477,265,212,55.56
Irelia,Sylas,1578,737,841,46.7
Irelia,Mel,2174,1051,1123,48.34
Irelia,Ashe,2222,1053,1169,47.39
Irelia,Seraphine,728,357,371,49.04
Irelia,Garen,1754,828,926,47.21
Irelia,Graves,701,331,370,47.22
Irelia,Diana,1647,785,862,47.66
Irelia,Shaco,1010,534,476,52.87
Irelia,Jax,1210,680,530,56.2
Irelia,Nami,1023,506,517,49.46
Irelia,Nocturne,1464,659,805,45.01
Irelia,Nasus,696,329,367,47.27
Irelia,Talon,693,389,304,56.13
Irelia,Lux,2546,1251,1295,49.14
Irelia,Jinx,2996,1471,1525,49.1
Irelia,Akali,1353,636,717,47.01
Irelia,JarvanIV,628,315,313,50.16
Irelia,Sivir,609,279,330,45.81
Irelia,Volibear,1190,568,622,47.73
Irelia,Aurora,744,392,352,52.69
Irelia,Brand,861,468,393,54.36
Irelia,Trundle,613,273,340,44.54
Irelia,Khazix,556,275,281,49.46
Irelia,Veigar,927,395,532,42.61
Irelia,Tristana,977,490,487,50.15
Irelia,Thresh,1425,676,749,47.44
Irelia,Aatrox,1068,594,474,55.62
Irelia,Evelynn,370,188,182,50.81
Irelia,Katarina,809,401,408,49.57
Irelia,Kaisa,1901,1065,836,56.02
Irelia,Leona,1030,535,495,51.94
Irelia,Tryndamere,536,261,275,48.69
Irelia,Elise,799,433,366,54.19
Irelia,Anivia,331,163,168,49.24
Irelia,Pyke,842,440,402,52.26
Irelia,Briar,796,384,412,48.24
Irelia,Vi,1032,544,488,52.71
Irelia,Zoe,402,254,148,63.18
Irelia,Nautilus,1233,646,587,52.39
Irelia,Malzahar,1151,535,616,46.48
Irelia,MissFortune,2561,1262,1299,49.28
Irelia,Kindred,491,254,237,51.73
Irelia,Karma,1445,728,717,50.38
Irelia,Illaoi,519,266,253,51.25
Irelia,XinZhao,721,368,353,51.04
Irelia,Ahri,1306,667,639,51.07
Irelia,Jhin,2292,1119,1173,48.82
Irelia,TahmKench,758,367,391,48.42
Irelia,Soraka,594,318,276,53.54
Irelia,Heimerdinger,519,212,307,40.85
Irelia,Malphite,1128,531,597,47.07
Irelia,Smolder,607,369,238,60.79
Irelia,Pantheon,1495,761,734,50.9
Irelia,Hecarim,457,235,222,51.42
Irelia,Naafiri,370,175,195,47.3
Irelia,Gangplank,659,342,317,51.9
Irelia,Yone,2374,1257,1117,52.95
Irelia,Samira,724,347,377,47.93
Irelia,Neeko,515,281,234,54.56
Irelia,Zyra,1031,506,525,49.08
Irelia,Sett,1766,808,958,45.75
Irelia,Rengar,387,240,147,62.02
Irelia,Velkoz,643,318,325,49.46
Irelia,Sejuani,472,246,226,52.12
Irelia,Bard,339,159,180,46.9
Irelia,Nidalee,354,199,155,56.21
Irelia,Draven,528,251,277,47.54
Irelia,Ambessa,736,402,334,54.62
Irelia,Lillia,648,332,316,51.23
Irelia,Fizz,568,296,272,52.11
Irelia,Lulu,1420,731,689,51.48
Irelia,Rell,528,264,264,50
Irelia,MasterYi,1412,681,731,48.23
Irelia,Olaf,190,106,84,55.79
Irelia,Vayne,1385,722,663,52.13
Irelia,Corki,402,204,198,50.75
Irelia,Ryze,443,237,206,53.5
Irelia,Blitzcrank,800,415,385,51.88
Irelia,DrMundo,499,269,230,53.91
Irelia,Xerath,978,471,507,48.16
Irelia,Teemo,1268,574,694,45.27
Irelia,Vladimir,782,402,380,51.41
Irelia,Belveth,190,90,100,47.37
Irelia,Kennen,332,173,159,52.11
Irelia,MonkeyKing,721,330,391,45.77
Irelia,KogMaw,312,133,179,42.63
Irelia,Braum,558,251,307,44.98
Irelia,AurelionSol,328,180,148,54.88
Irelia,LeeSin,1776,868,908,48.87
Irelia,Xayah,491,213,278,43.38
Irelia,Rakan,430,195,235,45.35
Irelia,Lucian,722,374,348,51.8
Irelia,Viego,1587,816,771,51.42
Irelia,Aphelios,572,301,271,52.62
Irelia,FiddleSticks,540,311,229,57.59
Irelia,Camille,340,175,165,51.47
Irelia,Udyr,384,186,198,48.44
Irelia,Nunu,523,282,241,53.92
Irelia,Vex,609,310,299,50.9
Irelia,Riven,510,275,235,53.92
Irelia,Janna,338,175,163,51.78
Irelia,Gragas,486,231,255,47.53
Irelia,Ekko,1068,592,476,55.43
Irelia,Leblanc,695,316,379,45.47
Irelia,Skarner,267,141,126,52.81
Irelia,Taliyah,298,137,161,45.97
Irelia,Poppy,686,317,369,46.21
Irelia,Twitch,772,402,370,52.07
Irelia,Kassadin,180,118,62,65.56
Irelia,Renata,175,96,79,54.86
Irelia,Zilean,342,167,175,48.83
Irelia,Yorick,1208,593,615,49.09
Irelia,Ziggs,335,158,177,47.16
Irelia,Milio,615,261,354,42.44
Irelia,Ivern,130,76,54,58.46
Irelia,Azir,378,186,192,49.21
Irelia,Senna,732,384,348,52.46
Irelia,Akshan,342,196,146,57.31
Irelia,Jayce,627,339,288,54.07
Irelia,Singed,277,110,167,39.71
Irelia,KSante,617,302,315,48.95
Irelia,Alistar,482,233,249,48.34
Irelia,Hwei,662,365,297,55.14
Irelia,Yuumi,931,485,446,52.09
Irelia,Sion,733,365,368,49.8
Irelia,Taric,185,91,94,49.19
Irelia,Syndra,592,320,272,54.05
Irelia,Shyvana,278,133,145,47.84
Irelia,Maokai,493,258,235,52.33
Irelia,Nilah,271,133,138,49.08
Irelia,Gwen,443,250,193,56.43
Irelia,Rumble,372,211,161,56.72
Irelia,Kalista,300,146,154,48.67
Irelia,Renekton,484,226,258,46.69
Irelia,Kled,160,90,70,56.25
Irelia,TwistedFate,348,202,146,58.05
Irelia,Karthus,312,159,153,50.96
Irelia,Urgot,497,213,284,42.86
Irelia,Viktor,996,528,468,53.01
Irelia,Zeri,398,231,167,58.04
Irelia,Lissandra,423,186,237,43.97
Irelia,Annie,338,170,168,50.3
Irelia,Cassiopeia,324,172,152,53.09
Irelia,Zac,516,229,287,44.38
Irelia,Quinn,352,176,176,50
Irelia,RekSai,101,58,43,57.43
Nautilus,Darius,2763,1374,1389,49.73
Nautilus,Rammus,474,207,267,43.67
Nautilus,Qiyana,332,165,167,49.7
Nautilus,Ezreal,3927,2058,1869,52.41
Nautilus,Swain,1463,644,819,44.02
Nautilus,Volibear,1476,712,764,48.24
Nautilus,Yorick,1435,650,785,45.3
Nautilus,Zoe,571,318,253,55.69
Nautilus,Samira,717,341,376,47.56
Nautilus,Pantheon,2183,1086,1097,49.75
Nautilus,KSante,820,446,374,54.39
Nautilus,Hwei,943,457,486,48.46
Nautilus,Evelynn,479,242,237,50.52
Nautilus,Sivir,764,330,434,43.19
Nautilus,Thresh,2163,998,1165,46.14
Nautilus,Urgot,692,300,392,43.35
Nautilus,MasterYi,1910,936,974,49.01
Nautilus,Galio,1276,594,682,46.55
Nautilus,Varus,1174,581,593,49.49
Nautilus,Morgana,1639,780,859,47.59
Nautilus,Viktor,1378,645,733,46.81
Nautilus,Nocturne,1795,806,989,44.9
Nautilus,Veigar,1373,650,723,47.34
Nautilus,Brand,1085,495,590,45.62
Nautilus,Quinn,377,177,200,46.95
Nautilus,Trundle,775,363,412,46.84
Nautilus,Kassadin,302,140,162,46.36
Nautilus,Caitlyn,3933,2024,1909,51.46
Nautilus,Senna,1150,575,575,50
Nautilus,Gangplank,720,345,375,47.92
Nautilus,Chogath,1676,793,883,47.32
Nautilus,Anivia,458,207,251,45.2
Nautilus,Tristana,1424,740,684,51.97
Nautilus,Zyra,1223,602,621,49.22
Nautilus,Yasuo,2735,1361,1374,49.76
Nautilus,Talon,810,443,367,54.69
Nautilus,Soraka,759,335,424,44.14
Nautilus,Kayn,1974,942,1032,47.72
Nautilus,Xerath,1430,701,729,49.02
Nautilus,Vayne,2049,996,1053,48.61
Nautilus,Nami,1360,635,725,46.69
Nautilus,Ekko,1255,584,671,46.53
Nautilus,MissFortune,3230,1425,1805,44.12
Nautilus,Garen,2313,1119,1194,48.38
Nautilus,Graves,1028,532,496,51.75
Nautilus,Diana,2320,1109,1211,47.8
Nautilus,Shaco,1265,606,659,47.91
Nautilus,Camille,503,274,229,54.47
Nautilus,Lux,3368,1625,1743,48.25
Nautilus,Irelia,1233,587,646,47.61
Nautilus,Mordekaiser,1683,816,867,48.48
Nautilus,Sylas,2343,1123,1220,47.93
Nautilus,Ashe,3027,1561,1466,51.57
Nautilus,Milio,757,338,419,44.65
Nautilus,Ornn,586,255,331,43.52
Nautilus,Aurora,1001,503,498,50.25
Nautilus,Zilean,414,164,250,39.61
Nautilus,LeeSin,2285,1189,1096,52.04
Nautilus,Katarina,1049,529,520,50.43
Nautilus,Vladimir,908,442,466,48.68
Nautilus,FiddleSticks,712,356,356,50
Nautilus,Illaoi,692,357,335,51.59
Nautilus,Jax,1260,646,614,51.27
Nautilus,Lulu,2020,998,1022,49.41
Nautilus,Yone,2673,1379,1294,51.59
Nautilus,Gnar,586,279,307,47.61
Nautilus,Smolder,888,471,417,53.04
Nautilus,Sona,346,173,173,50
Nautilus,Vi,1315,658,657,50.04
Nautilus,AurelionSol,546,279,267,51.1
Nautilus,Kaisa,2275,1157,1118,50.86
Nautilus,Jhin,2781,1365,1416,49.08
Nautilus,Velkoz,871,396,475,45.46
Nautilus,Seraphine,996,466,530,46.79
Nautilus,Singed,406,210,196,51.72
Nautilus,Zed,1560,811,749,51.99
Nautilus,Ahri,1904,943,961,49.53
Nautilus,Sett,2105,1026,1079,48.74
Nautilus,XinZhao,957,508,449,53.08
Nautilus,Neeko,583,276,307,47.34
Nautilus,Ziggs,564,296,268,52.48
Nautilus,Karma,1838,958,880,52.12
Nautilus,Teemo,1722,770,952,44.72
Nautilus,Blitzcrank,1092,598,494,54.76
Nautilus,Sejuani,643,276,367,42.92
Nautilus,JarvanIV,841,421,420,50.06
Nautilus,Syndra,932,465,467,49.89
Nautilus,Renekton,780,378,402,48.46
Nautilus,Mel,2837,1556,1281,54.85
Nautilus,Braum,1286,590,696,45.88
Nautilus,Shen,899,424,475,47.16
Nautilus,Amumu,1653,717,936,43.38
Nautilus,Kalista,343,157,186,45.77
Nautilus,Kled,287,140,147,48.78
Nautilus,Nasus,970,454,516,46.8
Nautilus,Lissandra,480,251,229,52.29
Nautilus,Heimerdinger,599,257,342,42.9
Nautilus,Lucian,1063,532,531,50.05
Nautilus,MonkeyKing,967,432,535,44.67
Nautilus,Viego,2194,1168,1026,53.24
Nautilus,Malphite,1557,724,833,46.5
Nautilus,TahmKench,1190,621,569,52.18
Nautilus,Xayah,837,356,481,42.53
Nautilus,Janna,448,214,234,47.77
Nautilus,Warwick,2002,917,1085,45.8
Nautilus,Jinx,3964,1783,2181,44.98
Nautilus,Leona,1334,620,714,46.48
Nautilus,Zac,750,352,398,46.93
Nautilus,Maokai,642,299,343,46.57
Nautilus,Malzahar,1480,689,791,46.55
Nautilus,Twitch,1012,504,508,49.8
Nautilus,Renata,325,154,171,47.38
Nautilus,Ambessa,903,481,422,53.27
Nautilus,DrMundo,717,350,367,48.81
Nautilus,Vex,803,410,393,51.06
Nautilus,Kindred,705,326,379,46.24
Nautilus,Jayce,724,370,354,51.1
Nautilus,Gwen,712,350,362,49.16
Nautilus,Nunu,717,343,374,47.84
Nautilus,Fizz,821,422,399,51.4
Nautilus,Alistar,840,424,416,50.48
Nautilus,Sion,1017,501,516,49.26
Nautilus,Leblanc,930,496,434,53.33
Nautilus,Khazix,651,317,334,48.69
Nautilus,Akali,1456,714,742,49.04
Nautilus,Aphelios,751,362,389,48.2
Nautilus,Lillia,754,380,374,50.4
Nautilus,Gragas,907,448,459,49.39
Nautilus,Annie,439,215,224,48.97
Nautilus,Rell,725,337,388,46.48
Nautilus,Belveth,318,142,176,44.65
Nautilus,Orianna,655,318,337,48.55
Nautilus,Poppy,962,435,527,45.22
Nautilus,Udyr,539,287,252,53.25
Nautilus,Bard,357,187,170,52.38
Nautilus,Rakan,553,240,313,43.4
Nautilus,Zeri,672,345,327,51.34
Nautilus,Naafiri,415,217,198,52.29
Nautilus,Draven,706,379,327,53.68
Nautilus,Pyke,1221,659,562,53.97
Nautilus,Riven,625,297,328,47.52
Nautilus,Rumble,385,187,198,48.57
Nautilus,Fiora,545,252,293,46.24
Nautilus,Rengar,397,194,203,48.87
Nautilus,Azir,489,211,278,43.15
Nautilus,KogMaw,368,142,226,38.59
Nautilus,Ryze,574,281,293,48.95
Nautilus,Kayle,781,355,426,45.45
Nautilus,Aatrox,1265,617,648,48.77
Nautilus,Elise,1002,456,546,45.51
Nautilus,Briar,925,426,499,46.05
Nautilus,Shyvana,342,145,197,42.4
Nautilus,Tryndamere,815,407,408,49.94
Nautilus,Akshan,415,214,201,51.57
Nautilus,Corki,557,279,278,50.09
Nautilus,Yuumi,1201,713,488,59.37
Nautilus,Cassiopeia,349,162,187,46.42
Nautilus,Skarner,416,187,229,44.95
Nautilus,Nilah,425,176,249,41.41
Nautilus,Taliyah,313,109,204,34.82
Nautilus,Taric,484,196,288,40.5
Nautilus,Kennen,339,161,178,47.49
Nautilus,Olaf,406,220,186,54.19
Nautilus,Ivern,158,77,81,48.73
Nautilus,Hecarim,581,299,282,51.46
Nautilus,Karthus,422,233,189,55.21
Nautilus,TwistedFate,486,272,214,55.97
Nautilus,Nidalee,430,254,176,59.07
Nautilus,RekSai,148,81,67,54.73
Aurora,Alistar,392,188,204,47.96
Aurora,LeeSin,1601,765,836,47.78
Aurora,Yasuo,1765,858,907,48.61
Aurora,Hwei,671,298,373,44.41
Aurora,Swain,844,387,457,45.85
Aurora,Trundle,525,245,280,46.67
Aurora,Briar,551,221,330,40.11
Aurora,Katarina,657,285,372,43.38
Aurora,Jhin,1760,891,869,50.63
Aurora,Pyke,720,385,335,53.47
Aurora,Ornn,379,168,211,44.33
Aurora,Kayn,1062,527,535,49.62
Aurora,Malzahar,900,396,504,44
Aurora,Vayne,1192,599,593,50.25
Aurora,Lulu,1422,715,707,50.28
Aurora,Gwen,421,211,210,50.12
Aurora,Khazix,498,213,285,42.77
Aurora,TwistedFate,371,184,187,49.6
Aurora,Varus,814,392,422,48.16
Aurora,Thresh,1239,625,614,50.44
Aurora,JarvanIV,610,274,336,44.92
Aurora,Orianna,374,184,190,49.2
Aurora,Yuumi,733,363,370,49.52
Aurora,Garen,1400,638,762,45.57
Aurora,Amumu,744,332,412,44.62
Aurora,Veigar,811,375,436,46.24
Aurora,Jinx,2576,1191,1385,46.23
Aurora,Galio,857,407,450,47.49
Aurora,Gnar,407,197,210,48.4
Aurora,MonkeyKing,656,361,295,55.03
Aurora,Bard,305,147,158,48.2
Aurora,Sett,1259,617,642,49.01
Aurora,XinZhao,569,290,279,50.97
Aurora,Fizz,446,220,226,49.33
Aurora,Karma,1318,666,652,50.53
Aurora,Kayle,570,262,308,45.96
Aurora,Nasus,582,294,288,50.52
Aurora,Anivia,308,146,162,47.4
Aurora,KogMaw,284,125,159,44.01
Aurora,Nami,899,440,459,48.94
Aurora,Gangplank,536,269,267,50.19
Aurora,Qiyana,267,133,134,49.81
Aurora,Xerath,819,404,415,49.33
Aurora,Twitch,727,373,354,51.31
Aurora,Lux,2145,989,1156,46.11
Aurora,Jax,840,409,431,48.69
Aurora,Rammus,197,94,103,47.72
Aurora,Viktor,964,476,488,49.38
Aurora,Soraka,433,180,253,41.57
Aurora,Teemo,1100,535,565,48.64
Aurora,Lillia,471,232,239,49.26
Aurora,Irelia,744,352,392,47.31
Aurora,Caitlyn,2331,1134,1197,48.65
Aurora,Kennen,265,98,167,36.98
Aurora,Ekko,792,345,447,43.56
Aurora,Leblanc,615,306,309,49.76
Aurora,MissFortune,2023,936,1087,46.27
Aurora,Yone,1806,951,855,52.66
Aurora,Nocturne,1172,520,652,44.37
Aurora,AurelionSol,325,162,163,49.85
Aurora,Smolder,521,255,266,48.94
Aurora,Nautilus,1001,498,503,49.75
Aurora,Ambessa,557,274,283,49.19
Aurora,Kassadin,156,85,71,54.49
Aurora,Sejuani,419,179,240,42.72
Aurora,Akali,1042,474,568,45.49
Aurora,Ziggs,300,141,159,47
Aurora,Quinn,351,182,169,51.85
Aurora,Chogath,1002,476,526,47.5
Aurora,Kaisa,1606,855,751,53.24
Aurora,Nidalee,291,168,123,57.73
Aurora,Aatrox,866,415,451,47.92
Aurora,MasterYi,1120,573,547,51.16
Aurora,Syndra,580,257,323,44.31
Aurora,Seraphine,597,305,292,51.09
Aurora,KSante,476,224,252,47.06
Aurora,Zyra,965,509,456,52.75
Aurora,Warwick,1158,566,592,48.88
Aurora,Nilah,249,131,118,52.61
Aurora,Blitzcrank,667,377,290,56.52
Aurora,Shaco,774,388,386,50.13
Aurora,Lucian,674,365,309,54.15
Aurora,Darius,1813,914,899,50.41
Aurora,Zilean,315,167,148,53.02
Aurora,Singed,193,95,98,49.22
Aurora,Ahri,1275,619,656,48.55
Aurora,Mordekaiser,1018,500,518,49.12
Aurora,Pantheon,1504,734,770,48.8
Aurora,Diana,1656,839,817,50.66
Aurora,Rengar,276,134,142,48.55
Aurora,Janna,286,107,179,37.41
Aurora,Riven,391,209,182,53.45
Aurora,Elise,698,345,353,49.43
Aurora,Ezreal,2453,1225,1228,49.94
Aurora,Yorick,759,325,434,42.82
Aurora,Zed,972,506,466,52.06
Aurora,Illaoi,432,235,197,54.4
Aurora,Kindred,409,167,242,40.83
Aurora,Velkoz,496,248,248,50
Aurora,Annie,361,172,189,47.65
Aurora,Mel,1713,893,820,52.13
Aurora,Morgana,925,475,450,51.35
Aurora,Samira,544,308,236,56.62
Aurora,Rakan,384,181,203,47.14
Aurora,Poppy,530,257,273,48.49
Aurora,Brand,586,275,311,46.93
Aurora,Aphelios,470,242,228,51.49
Aurora,Talon,579,254,325,43.87
Aurora,Naafiri,307,172,135,56.03
Aurora,Vex,486,229,257,47.12
Aurora,Draven,455,205,250,45.05
Aurora,Renekton,507,258,249,50.89
Aurora,Sion,629,306,323,48.65
Aurora,Vi,801,440,361,54.93
Aurora,Milio,533,232,301,43.53
Aurora,Ashe,2028,987,1041,48.67
Aurora,Senna,620,259,361,41.77
Aurora,RekSai,116,81,35,69.83
Aurora,Xayah,419,217,202,51.79
Aurora,Vladimir,586,309,277,52.73
Aurora,Neeko,432,203,229,46.99
Aurora,Shyvana,232,127,105,54.74
Aurora,Evelynn,329,166,163,50.46
Aurora,Lissandra,300,144,156,48
Aurora,Gragas,501,219,282,43.71
Aurora,Braum,467,218,249,46.68
Aurora,FiddleSticks,460,229,231,49.78
Aurora,Zac,478,235,243,49.16
Aurora,Sivir,553,282,271,50.99
Aurora,Fiora,349,157,192,44.99
Aurora,TahmKench,604,286,318,47.35
Aurora,Karthus,320,169,151,52.81
Aurora,Zoe,372,206,166,55.38
Aurora,Sona,290,109,181,37.59
Aurora,Sylas,1487,765,722,51.45
Aurora,Viego,1337,700,637,52.36
Aurora,Zeri,415,178,237,42.89
Aurora,Akshan,379,186,193,49.08
Aurora,Corki,365,182,183,49.86
Aurora,Volibear,914,491,423,53.72
Aurora,Taric,199,87,112,43.72
Aurora,Renata,179,77,102,43.02
Aurora,Ryze,327,156,171,47.71
Aurora,Tristana,901,426,475,47.28
Aurora,Rumble,271,146,125,53.87
Aurora,Heimerdinger,350,189,161,54
Aurora,Camille,348,179,169,51.44
Aurora,Udyr,338,188,150,55.62
Aurora,Cassiopeia,314,157,157,50
Aurora,Malphite,921,458,463,49.73
Aurora,Urgot,423,193,230,45.63
Aurora,Jayce,552,252,300,45.65
Aurora,DrMundo,467,231,236,49.46
Aurora,Graves,606,284,322,46.86
Aurora,Leona,769,384,385,49.93
Aurora,Shen,561,290,271,51.69
Aurora,Rell,415,204,211,49.16
Aurora,Tryndamere,444,181,263,40.77
Aurora,Olaf,200,95,105,47.5
Aurora,Taliyah,242,90,152,37.19
Aurora,Nunu,472,204,268,43.22
Aurora,Kalista,156,72,84,46.15
Aurora,Maokai,408,168,240,41.18
Aurora,Kled,123,77,46,62.6
Aurora,Skarner,238,146,92,61.34
Aurora,Azir,315,157,158,49.84
Aurora,Hecarim,394,217,177,55.08
Aurora,Belveth,200,79,121,39.5
Aurora,Ivern,122,63,59,51.64
Corki,Alistar,260,131,129,50.38
Corki,LeeSin,845,407,438,48.17
Corki,Yasuo,987,466,521,47.21
Corki,Hwei,313,154,159,49.2
Corki,Swain,432,185,247,42.82
Corki,Darius,1016,488,528,48.03
Corki,Nocturne,739,336,403,45.47
Corki,Lux,1161,541,620,46.6
Corki,Lucian,410,200,210,48.78
Corki,Thresh,724,351,373,48.48
Corki,Ambessa,387,195,192,50.39
Corki,XinZhao,353,165,188,46.74
Corki,Vladimir,376,174,202,46.28
Corki,Ezreal,1417,714,703,50.39
Corki,Karma,693,352,341,50.79
Corki,Kayn,843,345,498,40.93
Corki,JarvanIV,397,206,191,51.89
Corki,Orianna,269,119,150,44.24
Corki,Jhin,1007,488,519,48.46
Corki,Yuumi,443,192,251,43.34
Corki,Urgot,236,82,154,34.75
Corki,Vi,471,228,243,48.41
Corki,Ryze,241,113,128,46.89
Corki,MissFortune,1083,510,573,47.09
Corki,TahmKench,298,135,163,45.3
Corki,Briar,279,139,140,49.82
Corki,Malzahar,501,237,264,47.31
Corki,Caitlyn,1217,540,677,44.37
Corki,Rakan,247,118,129,47.77
Corki,Renekton,268,128,140,47.76
Corki,Gragas,276,129,147,46.74
Corki,Ziggs,157,70,87,44.59
Corki,Milio,335,136,199,40.6
Corki,Gnar,213,85,128,39.91
Corki,Poppy,396,178,218,44.95
Corki,TwistedFate,220,91,129,41.36
Corki,Ahri,643,318,325,49.46
Corki,Varus,501,199,302,39.72
Corki,Renata,101,52,49,51.49
Corki,Yorick,461,222,239,48.16
Corki,Nunu,237,113,124,47.68
Corki,Katarina,472,239,233,50.64
Corki,Sivir,296,143,153,48.31
Corki,Zyra,464,194,270,41.81
Corki,Aatrox,507,248,259,48.92
Corki,Samira,377,209,168,55.44
Corki,AurelionSol,162,78,84,48.15
Corki,Smolder,292,165,127,56.51
Corki,Zed,553,297,256,53.71
Corki,Graves,381,209,172,54.86
Corki,Zoe,247,126,121,51.01
Corki,Anivia,169,67,102,39.64
Corki,Leona,418,220,198,52.63
Corki,Shen,345,178,167,51.59
Corki,Xerath,419,196,223,46.78
Corki,Sion,419,198,221,47.26
Corki,Garen,896,414,482,46.21
Corki,Soraka,304,134,170,44.08
Corki,FiddleSticks,248,111,137,44.76
Corki,Irelia,402,198,204,49.25
Corki,Veigar,459,207,252,45.1
Corki,Leblanc,429,219,210,51.05
Corki,KSante,349,169,180,48.42
Corki,Mel,952,478,474,50.21
Corki,Braum,372,181,191,48.66
Corki,Viego,840,420,420,50
Corki,Yone,898,430,468,47.88
Corki,Neeko,224,112,112,50
Corki,Vayne,708,370,338,52.26
Corki,Morgana,508,251,257,49.41
Corki,Kassadin,144,46,98,31.94
Corki,Ashe,1257,584,673,46.46
Corki,Blitzcrank,364,168,196,46.15
Corki,Kennen,170,52,118,30.59
Corki,Viktor,492,246,246,50
Corki,Gwen,304,140,164,46.05
Corki,Ekko,508,261,247,51.38
Corki,Nami,652,334,318,51.23
Corki,Teemo,572,247,325,43.18
Corki,Volibear,500,235,265,47
Corki,Chogath,595,263,332,44.2
Corki,Pantheon,820,368,452,44.88
Corki,Shaco,496,236,260,47.58
Corki,Kaisa,926,443,483,47.84
Corki,Riven,265,113,152,42.64
Corki,Jayce,321,164,157,51.09
Corki,Lulu,937,426,511,45.46
Corki,Brand,324,162,162,50
Corki,Akali,522,252,270,48.28
Corki,Talon,333,149,184,44.74
Corki,Karthus,187,77,110,41.18
Corki,Galio,551,243,308,44.1
Corki,Hecarim,283,143,140,50.53
Corki,Twitch,509,220,289,43.22
Corki,Sejuani,214,127,87,59.35
Corki,Ornn,204,98,106,48.04
Corki,Sylas,765,372,393,48.63
Corki,Draven,284,159,125,55.99
Corki,MasterYi,569,277,292,48.68
Corki,Khazix,274,103,171,37.59
Corki,Camille,227,117,110,51.54
Corki,Rengar,214,114,100,53.27
Corki,Skarner,116,60,56,51.72
Corki,Trundle,244,118,126,48.36
Corki,Quinn,230,110,120,47.83
Corki,Fiora,182,105,77,57.69
Corki,Aurora,365,183,182,50.14
Corki,Gangplank,291,148,143,50.86
Corki,Elise,428,215,213,50.23
Corki,Senna,361,152,209,42.11
Corki,Aphelios,291,131,160,45.02
Corki,Tryndamere,326,167,159,51.23
Corki,Akshan,197,82,115,41.62
Corki,DrMundo,231,110,121,47.62
Corki,Mordekaiser,492,239,253,48.58
Corki,Naafiri,150,79,71,52.67
Corki,Tristana,625,297,328,47.52
Corki,Warwick,628,272,356,43.31
Corki,Nautilus,557,278,279,49.91
Corki,Sett,696,324,372,46.55
Corki,Lissandra,178,86,92,48.31
Corki,Syndra,335,146,189,43.58
Corki,Janna,204,75,129,36.76
Corki,Singed,131,48,83,36.64
Corki,Nidalee,177,90,87,50.85
Corki,Diana,813,398,415,48.95
Corki,Illaoi,224,101,123,45.09
Corki,Udyr,207,83,124,40.1
Corki,Velkoz,346,148,198,42.77
Corki,Cassiopeia,126,52,74,41.27
Corki,Maokai,237,110,127,46.41
Corki,Nilah,192,90,102,46.88
Corki,Jax,473,234,239,49.47
Corki,Nasus,310,161,149,51.94
Corki,Ivern,83,40,43,48.19
Corki,Pyke,452,236,216,52.21
Corki,Zeri,244,113,131,46.31
Corki,Sona,129,72,57,55.81
Corki,Seraphine,317,136,181,42.9
Corki,Annie,173,84,89,48.55
Corki,Jinx,1468,739,729,50.34
Corki,Shyvana,125,66,59,52.8
Corki,Belveth,109,60,49,55.05
Corki,Kayle,373,171,202,45.84
Corki,Qiyana,157,81,76,51.59
Corki,Xayah,236,113,123,47.88
Corki,Malphite,498,269,229,54.02
Corki,Taliyah,152,70,82,46.05
Corki,Rell,355,176,179,49.58
Corki,Zilean,175,81,94,46.29
Corki,Heimerdinger,191,65,126,34.03
Corki,Vex,243,96,147,39.51
Corki,Olaf,135,73,62,54.07
Corki,Rammus,129,61,68,47.29
Corki,Lillia,258,130,128,50.39
Corki,Fizz,268,111,157,41.42
Corki,MonkeyKing,365,167,198,45.75
Corki,Bard,190,97,93,51.05
Corki,Kled,86,36,50,41.86
Corki,Zac,334,192,142,57.49
Corki,Kindred,252,125,127,49.6
Corki,Evelynn,164,68,96,41.46
Corki,Azir,168,86,82,51.19
Corki,RekSai,85,60,25,70.59
Corki,Amumu,471,208,263,44.16
Corki,KogMaw,173,72,101,41.62
Corki,Kalista,146,61,85,41.78
Corki,Taric,148,72,76,48.65
Corki,Rumble,174,89,85,51.15
Orianna,Alistar,262,129,133,49.24
Orianna,LeeSin,978,506,472,51.74
Orianna,Yasuo,937,456,481,48.67
Orianna,Hwei,361,189,172,52.35
Orianna,Swain,436,195,241,44.72
Orianna,Renekton,302,132,170,43.71
Orianna,Diana,913,379,534,41.51
Orianna,Aurora,374,190,184,50.8
Orianna,Corki,269,150,119,55.76
Orianna,Pantheon,933,522,411,55.95
Orianna,Heimerdinger,259,108,151,41.7
Orianna,Kayn,739,392,347,53.04
Orianna,Malzahar,643,283,360,44.01
Orianna,Sivir,272,161,111,59.19
Orianna,Neeko,224,125,99,55.8
Orianna,Yorick,548,224,324,40.88
Orianna,Rengar,186,74,112,39.78
Orianna,Irelia,415,196,219,47.23
Orianna,Ezreal,1518,736,782,48.48
Orianna,Soraka,327,165,162,50.46
Orianna,Teemo,640,293,347,45.78
Orianna,Jax,501,275,226,54.89
Orianna,Zed,537,264,273,49.16
Orianna,MissFortune,1240,637,603,51.37
Orianna,Ashe,1134,571,563,50.35
Orianna,Sett,677,318,359,46.97
Orianna,Annie,196,72,124,36.73
Orianna,Garen,910,417,493,45.82
Orianna,Katarina,401,168,233,41.9
Orianna,Caitlyn,1465,755,710,51.54
Orianna,Volibear,589,294,295,49.92
Orianna,Vladimir,441,234,207,53.06
Orianna,Zeri,219,101,118,46.12
Orianna,Senna,380,187,193,49.21
Orianna,Amumu,531,254,277,47.83
Orianna,Veigar,453,209,244,46.14
Orianna,Jinx,1671,828,843,49.55
Orianna,Lux,1253,606,647,48.36
Orianna,Tryndamere,234,114,120,48.72
Orianna,Akali,580,294,286,50.69
Orianna,Lucian,455,207,248,45.49
Orianna,Yuumi,438,247,191,56.39
Orianna,Darius,1030,526,504,51.07
Orianna,MasterYi,664,331,333,49.85
Orianna,Mordekaiser,609,306,303,50.25
Orianna,Lulu,829,380,449,45.84
Orianna,Gangplank,349,186,163,53.3
Orianna,Vi,534,247,287,46.25
Orianna,Mel,1432,821,611,57.33
Orianna,Poppy,377,168,209,44.56
Orianna,Riven,289,138,151,47.75
Orianna,Viktor,641,296,345,46.18
Orianna,Tristana,541,257,284,47.5
Orianna,Viego,821,376,445,45.8
Orianna,Chogath,655,319,336,48.7
Orianna,Sion,388,185,203,47.68
Orianna,Yone,915,422,493,46.12
Orianna,XinZhao,392,196,196,50
Orianna,Pyke,422,230,192,54.5
Orianna,Brand,307,163,144,53.09
Orianna,Braum,316,168,148,53.16
Orianna,Syndra,431,210,221,48.72
Orianna,Shen,363,185,178,50.96
Orianna,Shaco,522,261,261,50
Orianna,Kaisa,995,483,512,48.54
Orianna,Nami,565,254,311,44.96
Orianna,DrMundo,264,118,146,44.7
Orianna,Warwick,702,315,387,44.87
Orianna,Trundle,287,135,152,47.04
Orianna,Vex,273,137,136,50.18
Orianna,Thresh,724,310,414,42.82
Orianna,FiddleSticks,341,155,186,45.45
Orianna,Ahri,893,461,432,51.62
Orianna,KSante,313,158,155,50.48
Orianna,Graves,353,183,170,51.84
Orianna,Leblanc,404,216,188,53.47
Orianna,Twitch,450,223,227,49.56
Orianna,Taric,159,82,77,51.57
Orianna,Kennen,179,93,86,51.96
Orianna,Naafiri,197,92,105,46.7
Orianna,Leona,488,262,226,53.69
Orianna,Kindred,243,95,148,39.09
Orianna,Kled,91,47,44,51.65
Orianna,Morgana,661,344,317,52.04
Orianna,Vayne,744,330,414,44.35
Orianna,Ekko,498,239,259,47.99
Orianna,Ziggs,182,77,105,42.31
Orianna,Aatrox,526,283,243,53.8
Orianna,Sejuani,271,147,124,54.24
Orianna,Azir,191,109,82,57.07
Orianna,Varus,531,282,249,53.11
Orianna,Xerath,565,263,302,46.55
Orianna,Rell,278,162,116,58.27
Orianna,TahmKench,356,177,179,49.72
Orianna,Nautilus,655,337,318,51.45
Orianna,Draven,256,122,134,47.66
Orianna,Nocturne,632,326,306,51.58
Orianna,Karma,776,362,414,46.65
Orianna,Lillia,274,137,137,50
Orianna,Zilean,214,108,106,50.47
Orianna,Gragas,300,165,135,55
Orianna,Seraphine,380,203,177,53.42
Orianna,Illaoi,272,142,130,52.21
Orianna,Qiyana,199,92,107,46.23
Orianna,Rammus,156,84,72,53.85
Orianna,Samira,288,160,128,55.56
Orianna,Briar,348,167,181,47.99
Orianna,Fizz,262,120,142,45.8
Orianna,Malphite,464,252,212,54.31
Orianna,Smolder,290,173,117,59.66
Orianna,Camille,213,123,90,57.75
Orianna,Udyr,187,127,60,67.91
Orianna,Sylas,835,418,417,50.06
Orianna,Xayah,235,93,142,39.57
Orianna,Sona,141,65,76,46.1
Orianna,Kayle,299,145,154,48.49
Orianna,Khazix,293,161,132,54.95
Orianna,Jhin,1004,463,541,46.12
Orianna,Zyra,472,246,226,52.12
Orianna,Zoe,183,87,96,47.54
Orianna,Rakan,199,90,109,45.23
Orianna,Gnar,271,131,140,48.34
Orianna,Lissandra,187,78,109,41.71
Orianna,Olaf,161,82,79,50.93
Orianna,Nilah,159,86,73,54.09
Orianna,Bard,230,113,117,49.13
Orianna,Rumble,168,110,58,65.48
Orianna,Skarner,163,77,86,47.24
Orianna,Singed,145,69,76,47.59
Orianna,Fiora,158,91,67,57.59
Orianna,MonkeyKing,401,189,212,47.13
Orianna,Cassiopeia,141,79,62,56.03
Orianna,Kassadin,117,58,59,49.57
Orianna,Nasus,354,208,146,58.76
Orianna,Evelynn,161,74,87,45.96
Orianna,Aphelios,293,159,134,54.27
Orianna,KogMaw,168,87,81,51.79
Orianna,Kalista,172,103,69,59.88
Orianna,Karthus,168,98,70,58.33
Orianna,Nunu,258,134,124,51.94
Orianna,Velkoz,307,141,166,45.93
Orianna,Elise,453,212,241,46.8
Orianna,Milio,352,158,194,44.89
Orianna,Galio,435,230,205,52.87
Orianna,Quinn,191,106,85,55.5
Orianna,AurelionSol,196,87,109,44.39
Orianna,Hecarim,239,134,105,56.07
Orianna,Jayce,372,179,193,48.12
Orianna,Ryze,195,103,92,52.82
Orianna,Ambessa,435,229,206,52.64
Orianna,Ivern,98,50,48,51.02
Orianna,RekSai,93,41,52,44.09
Orianna,Maokai,275,138,137,50.18
Orianna,Ornn,256,152,104,59.38
Orianna,Taliyah,175,81,94,46.29
Orianna,Urgot,279,130,149,46.59
Orianna,TwistedFate,200,92,108,46
Orianna,Renata,103,56,47,54.37
Orianna,Blitzcrank,399,203,196,50.88
Orianna,JarvanIV,374,169,205,45.19
Orianna,Gwen,244,125,119,51.23
Orianna,Talon,329,178,151,54.1
Orianna,Zac,263,125,138,47.53
Orianna,Belveth,163,87,76,53.37
Orianna,Akshan,181,87,94,48.07
Orianna,Nidalee,219,108,111,49.32
Orianna,Janna,192,79,113,41.15
Orianna,Anivia,207,64,143,30.92
Orianna,Shyvana,121,52,69,42.98
Xayah,Alistar,311,152,159,48.87
Xayah,LeeSin,858,447,411,52.1
Xayah,Yasuo,1315,685,630,52.09
Xayah,Hwei,337,167,170,49.55
Xayah,Swain,509,250,259,49.12
Xayah,Gragas,324,182,142,56.17
Xayah,Pantheon,968,470,498,48.55
Xayah,Caitlyn,1593,771,822,48.4
Xayah,Mel,1109,612,497,55.18
Xayah,Sett,923,431,492,46.7
Xayah,MasterYi,743,364,379,48.99
Xayah,Vladimir,392,186,206,47.45
Xayah,Zilean,159,85,74,53.46
Xayah,Senna,416,196,220,47.12
Xayah,Gwen,275,155,120,56.36
Xayah,Akali,625,302,323,48.32
Xayah,KogMaw,143,84,59,58.74
Xayah,Thresh,854,442,412,51.76
Xayah,Zac,360,166,194,46.11
Xayah,Khazix,241,119,122,49.38
Xayah,Katarina,492,257,235,52.24
Xayah,Samira,500,264,236,52.8
Xayah,Leona,573,274,299,47.82
Xayah,Jax,554,263,291,47.47
Xayah,Kayn,714,361,353,50.56
Xayah,Ekko,554,268,286,48.38
Xayah,Zeri,304,171,133,56.25
Xayah,Amumu,624,289,335,46.31
Xayah,Nocturne,914,431,483,47.16
Xayah,Diana,992,500,492,50.4
Xayah,Nasus,408,209,199,51.23
Xayah,Ashe,1224,598,626,48.86
Xayah,Ornn,261,125,136,47.89
Xayah,Fizz,362,172,190,47.51
Xayah,Ezreal,1466,735,731,50.14
Xayah,Rakan,249,124,125,49.8
Xayah,Tryndamere,282,120,162,42.55
Xayah,Rengar,266,140,126,52.63
Xayah,Viktor,487,246,241,50.51
Xayah,Lux,1450,678,772,46.76
Xayah,Aatrox,527,257,270,48.77
Xayah,Neeko,232,115,117,49.57
Xayah,Volibear,630,319,311,50.63
Xayah,Ahri,724,382,342,52.76
Xayah,Teemo,649,319,330,49.15
Xayah,Yuumi,515,295,220,57.28
Xayah,Warwick,796,387,409,48.62
Xayah,Yone,1105,497,608,44.98
Xayah,Brand,388,191,197,49.23
Xayah,Illaoi,255,143,112,56.08
Xayah,Shaco,531,258,273,48.59
Xayah,Trundle,332,141,191,42.47
Xayah,Naafiri,186,95,91,51.08
Xayah,Jhin,1112,556,556,50
Xayah,Evelynn,232,122,110,52.59
Xayah,Darius,1084,535,549,49.35
Xayah,Kaisa,1405,788,617,56.09
Xayah,Camille,266,136,130,51.13
Xayah,XinZhao,443,217,226,48.98
Xayah,MissFortune,1297,637,660,49.11
Xayah,Viego,767,379,388,49.41
Xayah,Maokai,278,164,114,58.99
Xayah,Kindred,225,105,120,46.67
Xayah,Jinx,1527,729,798,47.74
Xayah,Morgana,666,347,319,52.1
Xayah,Soraka,325,155,170,47.69
Xayah,Gnar,260,128,132,49.23
Xayah,Skarner,162,97,65,59.88
Xayah,Tristana,601,283,318,47.09
Xayah,Urgot,240,116,124,48.33
Xayah,Sylas,951,501,450,52.68
Xayah,Karma,672,293,379,43.6
Xayah,Sejuani,291,133,158,45.7
Xayah,Zed,747,361,386,48.33
Xayah,Seraphine,363,148,215,40.77
Xayah,Nunu,285,144,141,50.53
Xayah,Varus,483,243,240,50.31
Xayah,Garen,975,444,531,45.54
Xayah,Rammus,158,84,74,53.16
Xayah,Lissandra,227,119,108,52.42
Xayah,Mordekaiser,727,361,366,49.66
Xayah,Irelia,491,278,213,56.62
Xayah,Malphite,714,404,310,56.58
Xayah,Renata,98,53,45,54.08
Xayah,Vi,789,411,378,52.09
Xayah,Blitzcrank,477,271,206,56.81
Xayah,Kayle,405,202,203,49.88
Xayah,Lucian,452,200,252,44.25
Xayah,Pyke,417,191,226,45.8
Xayah,Poppy,379,169,210,44.59
Xayah,Quinn,191,99,92,51.83
Xayah,RekSai,73,42,31,57.53
Xayah,Nautilus,837,481,356,57.47
Xayah,Riven,229,110,119,48.03
Xayah,Taliyah,157,87,70,55.41
Xayah,Galio,574,274,300,47.74
Xayah,Shyvana,132,58,74,43.94
Xayah,Nami,535,253,282,47.29
Xayah,Vex,299,161,138,53.85
Xayah,Gangplank,302,156,146,51.66
Xayah,Syndra,366,176,190,48.09
Xayah,Kennen,171,81,90,47.37
Xayah,Aurora,419,202,217,48.21
Xayah,Vayne,782,394,388,50.38
Xayah,Bard,156,77,79,49.36
Xayah,DrMundo,314,177,137,56.37
Xayah,TwistedFate,202,107,95,52.97
Xayah,Veigar,539,250,289,46.38
Xayah,Lulu,806,426,380,52.85
Xayah,Renekton,297,147,150,49.49
Xayah,Elise,437,199,238,45.54
Xayah,Leblanc,388,193,195,49.74
Xayah,Karthus,182,93,89,51.1
Xayah,Annie,182,67,115,36.81
Xayah,Xerath,507,274,233,54.04
Xayah,AurelionSol,214,96,118,44.86
Xayah,Kassadin,100,56,44,56
Xayah,Lillia,286,143,143,50
Xayah,Draven,321,154,167,47.98
Xayah,Janna,183,77,106,42.08
Xayah,KSante,294,169,125,57.48
Xayah,Anivia,226,86,140,38.05
Xayah,Briar,383,184,199,48.04
Xayah,Yorick,534,268,266,50.19
Xayah,Orianna,235,142,93,60.43
Xayah,Taric,124,68,56,54.84
Xayah,Ryze,200,87,113,43.5
Xayah,Nilah,274,143,131,52.19
Xayah,Zyra,441,210,231,47.62
Xayah,Jayce,258,141,117,54.65
Xayah,JarvanIV,337,156,181,46.29
Xayah,Rell,319,185,134,57.99
Xayah,Chogath,683,337,346,49.34
Xayah,Ivern,91,38,53,41.76
Xayah,Talon,397,207,190,52.14
Xayah,TahmKench,390,189,201,48.46
Xayah,FiddleSticks,337,181,156,53.71
Xayah,Qiyana,158,79,79,50
Xayah,Sona,147,79,68,53.74
Xayah,Udyr,222,103,119,46.4
Xayah,Milio,283,126,157,44.52
Xayah,Hecarim,247,105,142,42.51
Xayah,Kalista,168,79,89,47.02
Xayah,MonkeyKing,461,223,238,48.37
Xayah,Braum,312,149,163,47.76
Xayah,Smolder,343,173,170,50.44
Xayah,Aphelios,256,109,147,42.58
Xayah,Ziggs,177,78,99,44.07
Xayah,Malzahar,647,321,326,49.61
Xayah,Fiora,163,77,86,47.24
Xayah,Twitch,442,224,218,50.68
Xayah,Sion,387,214,173,55.3
Xayah,Shen,423,217,206,51.3
Xayah,Zoe,167,91,76,54.49
Xayah,Kled,110,50,60,45.45
Xayah,Nidalee,170,91,79,53.53
Xayah,Heimerdinger,236,145,91,61.44
Xayah,Corki,236,123,113,52.12
Xayah,Sivir,340,155,185,45.59
Xayah,Akshan,127,79,48,62.2
Xayah,Azir,208,86,122,41.35
Xayah,Singed,160,68,92,42.5
Xayah,Rumble,209,135,74,64.59
Xayah,Cassiopeia,148,72,76,48.65
Xayah,Velkoz,323,129,194,39.94
Xayah,Ambessa,359,178,181,49.58
Xayah,Olaf,165,85,80,51.52
Xayah,Graves,329,185,144,56.23
Xayah,Belveth,156,82,74,52.56
Nami,Alistar,479,260,219,54.28
Nami,LeeSin,1639,880,759,53.69
Nami,Yasuo,2310,1181,1129,51.13
Nami,Hwei,848,441,407,52
Nami,Swain,1101,555,546,50.41
Nami,Sett,1699,796,903,46.85
Nami,MasterYi,1568,793,775,50.57
Nami,Vladimir,936,503,433,53.74
Nami,Zilean,529,256,273,48.39
Nami,Senna,1002,524,478,52.3
Nami,Darius,2424,1209,1215,49.88
Nami,Zac,557,266,291,47.76
Nami,Malzahar,1450,727,723,50.14
Nami,Ziggs,416,196,220,47.12
Nami,Sona,555,255,300,45.95
Nami,Teemo,1467,758,709,51.67
Nami,Jax,1095,583,512,53.24
Nami,Fizz,749,411,338,54.87
Nami,Kaisa,2122,1080,1042,50.9
Nami,Morgana,1279,681,598,53.24
Nami,Rumble,318,165,153,51.89
Nami,Amumu,1247,606,641,48.6
Nami,Jinx,4004,1914,2090,47.8
Nami,Lulu,2754,1446,1308,52.51
Nami,Yorick,1304,614,690,47.09
Nami,Kindred,627,322,305,51.36
Nami,Veigar,1294,641,653,49.54
Nami,Tristana,1154,593,561,51.39
Nami,Nautilus,1360,725,635,53.31
Nami,Sion,1025,523,502,51.02
Nami,Shaco,1196,617,579,51.59
Nami,Milio,1129,499,630,44.2
Nami,Malphite,1302,675,627,51.84
Nami,Viego,1745,905,840,51.86
Nami,Irelia,1023,517,506,50.54
Nami,Twitch,1231,613,618,49.8
Nami,Mordekaiser,1554,772,782,49.68
Nami,Talon,753,351,402,46.61
Nami,Lux,3295,1730,1565,52.5
Nami,Ashe,2409,1244,1165,51.64
Nami,Gangplank,759,399,360,52.57
Nami,Aurora,899,459,440,51.06
Nami,Sivir,705,391,314,55.46
Nami,Yuumi,1201,582,619,48.46
Nami,Poppy,644,322,322,50
Nami,Katarina,1104,613,491,55.53
Nami,Ezreal,2975,1619,1356,54.42
Nami,Pantheon,1859,990,869,53.25
Nami,MonkeyKing,942,526,416,55.84
Nami,Jhin,2792,1504,1288,53.87
Nami,Urgot,690,306,384,44.35
Nami,Rammus,366,181,185,49.45
Nami,Xerath,1112,551,561,49.55
Nami,Kled,233,116,117,49.79
Nami,Warwick,1738,930,808,53.51
Nami,Syndra,891,502,389,56.34
Nami,Ambessa,759,421,338,55.47
Nami,JarvanIV,988,530,458,53.64
Nami,Sylas,1545,821,724,53.14
Nami,Garen,2142,1057,1085,49.35
Nami,Udyr,556,300,256,53.96
Nami,Zyra,1271,612,659,48.15
Nami,Aatrox,1342,687,655,51.19
Nami,Vi,1247,655,592,52.53
Nami,Vayne,1671,836,835,50.03
Nami,Rell,591,279,312,47.21
Nami,KSante,671,389,282,57.97
Nami,Naafiri,403,184,219,45.66
Nami,Olaf,289,129,160,44.64
Nami,Mel,2274,1197,1077,52.64
Nami,TahmKench,931,499,432,53.6
Nami,Rengar,564,334,230,59.22
Nami,Akali,1226,659,567,53.75
Nami,Brand,853,444,409,52.05
Nami,Camille,538,261,277,48.51
Nami,Chogath,1681,810,871,48.19
Nami,Caitlyn,3324,1695,1629,50.99
Nami,Gnar,611,296,315,48.45
Nami,MissFortune,2729,1463,1266,53.61
Nami,Thresh,1718,858,860,49.94
Nami,Khazix,693,341,352,49.21
Nami,Leona,933,461,472,49.41
Nami,FiddleSticks,705,343,362,48.65
Nami,Varus,1097,565,532,51.5
Nami,Briar,741,376,365,50.74
Nami,Bard,483,216,267,44.72
Nami,Ekko,1253,636,617,50.76
Nami,Elise,1105,548,557,49.59
Nami,XinZhao,902,465,437,51.55
Nami,Ahri,1606,845,761,52.62
Nami,Zoe,438,216,222,49.32
Nami,Kennen,307,168,139,54.72
Nami,Volibear,1433,808,625,56.39
Nami,Gragas,633,332,301,52.45
Nami,Kayn,1820,955,865,52.47
Nami,Janna,637,365,272,57.3
Nami,Kayle,964,504,460,52.28
Nami,Fiora,517,227,290,43.91
Nami,Braum,821,420,401,51.16
Nami,Draven,778,402,376,51.67
Nami,Samira,789,403,386,51.08
Nami,Kalista,296,174,122,58.78
Nami,Karma,2257,1229,1028,54.45
Nami,Trundle,640,315,325,49.22
Nami,TwistedFate,497,277,220,55.73
Nami,Soraka,996,482,514,48.39
Nami,Diana,2171,1112,1059,51.22
Nami,Maokai,514,255,259,49.61
Nami,Quinn,461,221,240,47.94
Nami,Zeri,552,310,242,56.16
Nami,Leblanc,785,390,395,49.68
Nami,Seraphine,914,492,422,53.83
Nami,Renekton,665,374,291,56.24
Nami,Zed,1494,802,692,53.68
Nami,Hecarim,626,357,269,57.03
Nami,Azir,444,214,230,48.2
Nami,Sejuani,446,223,223,50
Nami,Evelynn,477,258,219,54.09
Nami,Qiyana,356,200,156,56.18
Nami,Vex,572,296,276,51.75
Nami,Orianna,565,311,254,55.04
Nami,Corki,652,318,334,48.77
Nami,Taric,230,125,105,54.35
Nami,Riven,695,357,338,51.37
Nami,Belveth,332,180,152,54.22
Nami,Karthus,397,218,179,54.91
Nami,Shen,740,391,349,52.84
Nami,Gwen,713,407,306,57.08
Nami,Nocturne,1633,763,870,46.72
Nami,Smolder,863,468,395,54.23
Nami,Yone,2042,1082,960,52.99
Nami,Xayah,535,282,253,52.71
Nami,Rakan,492,281,211,57.11
Nami,Viktor,1214,648,566,53.38
Nami,Cassiopeia,363,181,182,49.86
Nami,Tryndamere,740,384,356,51.89
Nami,Blitzcrank,716,389,327,54.33
Nami,Akshan,527,270,257,51.23
Nami,Jayce,514,233,281,45.33
Nami,AurelionSol,454,202,252,44.49
Nami,Illaoi,552,313,239,56.7
Nami,Velkoz,759,382,377,50.33
Nami,Kassadin,335,159,176,47.46
Nami,Galio,1100,556,544,50.55
Nami,Lillia,601,314,287,52.25
Nami,Heimerdinger,546,257,289,47.07
Nami,Ornn,593,329,264,55.48
Nami,Nidalee,327,210,117,64.22
Nami,Singed,424,204,220,48.11
Nami,Graves,904,508,396,56.19
Nami,Lucian,974,500,474,51.33
Nami,Nasus,758,403,355,53.17
Nami,Skarner,314,177,137,56.37
Nami,Nunu,653,323,330,49.46
Nami,Anivia,500,241,259,48.2
Nami,KogMaw,433,221,212,51.04
Nami,Lissandra,487,251,236,51.54
Nami,Aphelios,756,406,350,53.7
Nami,Pyke,938,514,424,54.8
Nami,Shyvana,324,202,122,62.35
Nami,Renata,250,134,116,53.6
Nami,RekSai,178,85,93,47.75
Nami,Nilah,437,223,214,51.03
Nami,Ryze,437,215,222,49.2
Nami,DrMundo,708,330,378,46.61
Nami,Ivern,245,121,124,49.39
Nami,Neeko,521,278,243,53.36
Nami,Annie,454,232,222,51.1
Nami,Taliyah,364,166,198,45.6
Alistar,Aurora,392,204,188,52.04
Alistar,Corki,260,129,131,49.62
Alistar,Orianna,262,133,129,50.76
Alistar,Xayah,311,159,152,51.13
Alistar,Nami,479,219,260,45.72
Alistar,Shen,315,154,161,48.89
Alistar,Belveth,92,49,43,53.26
Alistar,Akali,543,315,228,58.01
Alistar,Varus,424,230,194,54.25
Alistar,Lulu,782,393,389,50.26
Alistar,Urgot,249,121,128,48.59
Alistar,Briar,340,136,204,40
Alistar,Ahri,662,351,311,53.02
Alistar,Caitlyn,1385,694,691,50.11
Alistar,Lux,1159,545,614,47.02
Alistar,Gnar,274,154,120,56.2
Alistar,Sylas,1131,537,594,47.48
Alistar,Mel,1202,619,583,51.5
Alistar,Ashe,1116,568,548,50.9
Alistar,Seraphine,293,147,146,50.17
Alistar,Jax,524,275,249,52.48
Alistar,Gragas,352,187,165,53.13
Alistar,Zed,654,362,292,55.35
Alistar,Twitch,383,166,217,43.34
Alistar,Poppy,390,215,175,55.13
Alistar,Viego,917,465,452,50.71
Alistar,Vayne,830,416,414,50.12
Alistar,Darius,1025,495,530,48.29
Alistar,Fizz,316,160,156,50.63
Alistar,Sion,441,227,214,51.47
Alistar,Evelynn,185,102,83,55.14
Alistar,Braum,366,187,179,51.09
Alistar,Garen,848,443,405,52.24
Alistar,Kayn,692,334,358,48.27
Alistar,AurelionSol,211,87,124,41.23
Alistar,Annie,215,96,119,44.65
Alistar,Yasuo,1041,548,493,52.64
Alistar,Yorick,504,210,294,41.67
Alistar,Cassiopeia,164,79,85,48.17
Alistar,Smolder,361,192,169,53.19
Alistar,Anivia,154,74,80,48.05
Alistar,Diana,946,461,485,48.73
Alistar,Milio,286,128,158,44.76
Alistar,Chogath,660,308,352,46.67
Alistar,Samira,524,298,226,56.87
Alistar,Mordekaiser,693,311,382,44.88
Alistar,Trundle,292,147,145,50.34
Alistar,Warwick,751,406,345,54.06
Alistar,Veigar,474,245,229,51.69
Alistar,Sett,793,372,421,46.91
Alistar,Syndra,367,171,196,46.59
Alistar,Pyke,450,224,226,49.78
Alistar,Yone,956,505,451,52.82
Alistar,Ambessa,388,174,214,44.85
Alistar,Rengar,177,101,76,57.06
Alistar,Katarina,400,204,196,51
Alistar,Ziggs,172,84,88,48.84
Alistar,Soraka,286,163,123,56.99
Alistar,MasterYi,692,350,342,50.58
Alistar,Vladimir,377,197,180,52.25
Alistar,Kaisa,1008,541,467,53.67
Alistar,Heimerdinger,218,95,123,43.58
Alistar,Thresh,897,443,454,49.39
Alistar,Teemo,630,295,335,46.83
Alistar,Tristana,513,240,273,46.78
Alistar,Nautilus,840,416,424,49.52
Alistar,Graves,451,222,229,49.22
Alistar,Singed,175,80,95,45.71
Alistar,Aatrox,576,306,270,53.13
Alistar,Sejuani,276,118,158,42.75
Alistar,Azir,211,110,101,52.13
Alistar,Xerath,454,233,221,51.32
Alistar,LeeSin,959,484,475,50.47
Alistar,MissFortune,1087,510,577,46.92
Alistar,FiddleSticks,275,116,159,42.18
Alistar,Zac,349,184,165,52.72
Alistar,Jhin,1024,539,485,52.64
Alistar,Morgana,415,188,227,45.3
Alistar,Lillia,286,141,145,49.3
Alistar,Nasus,367,151,216,41.14
Alistar,Vex,271,122,149,45.02
Alistar,Ezreal,1474,699,775,47.42
Alistar,Camille,240,129,111,53.75
Alistar,Amumu,543,255,288,46.96
Alistar,Fiora,164,90,74,54.88
Alistar,Kassadin,112,54,58,48.21
Alistar,Irelia,482,249,233,51.66
Alistar,Shaco,489,251,238,51.33
Alistar,Leblanc,431,209,222,48.49
Alistar,Draven,307,177,130,57.65
Alistar,Nilah,177,91,86,51.41
Alistar,Jinx,1544,704,840,45.6
Alistar,Kennen,183,95,88,51.91
Alistar,Velkoz,241,126,115,52.28
Alistar,Neeko,210,94,116,44.76
Alistar,JarvanIV,398,170,228,42.71
Alistar,Rumble,175,105,70,60
Alistar,Ornn,235,130,105,55.32
Alistar,Senna,329,181,148,55.02
Alistar,Jayce,280,124,156,44.29
Alistar,Malzahar,555,235,320,42.34
Alistar,KSante,298,162,136,54.36
Alistar,Swain,615,292,323,47.48
Alistar,Aphelios,214,109,105,50.93
Alistar,Lucian,387,196,191,50.65
Alistar,Nocturne,674,270,404,40.06
Alistar,DrMundo,239,133,106,55.65
Alistar,Vi,567,297,270,52.38
Alistar,Pantheon,897,445,452,49.61
Alistar,Galio,525,267,258,50.86
Alistar,Leona,619,315,304,50.89
Alistar,Lissandra,232,118,114,50.86
Alistar,Blitzcrank,597,285,312,47.74
Alistar,Tryndamere,274,137,137,50
Alistar,XinZhao,405,212,193,52.35
Alistar,Zyra,447,217,230,48.55
Alistar,Khazix,209,104,105,49.76
Alistar,TahmKench,449,237,212,52.78
Alistar,Gangplank,314,124,190,39.49
Alistar,Qiyana,143,70,73,48.95
Alistar,Elise,396,210,186,53.03
Alistar,Volibear,557,290,267,52.06
Alistar,Renekton,279,132,147,47.31
Alistar,MonkeyKing,412,175,237,42.48
Alistar,Olaf,169,77,92,45.56
Alistar,Talon,336,173,163,51.49
Alistar,Ekko,545,282,263,51.74
Alistar,Udyr,224,139,85,62.05
Alistar,Hwei,335,167,168,49.85
Alistar,Ivern,93,49,44,52.69
Alistar,Kalista,165,80,85,48.48
Alistar,Ryze,200,98,102,49
Alistar,Riven,280,161,119,57.5
Alistar,TwistedFate,184,107,77,58.15
Alistar,Karthus,174,81,93,46.55
Alistar,RekSai,78,46,32,58.97
Alistar,Brand,347,173,174,49.86
Alistar,Renata,132,66,66,50
Alistar,Karma,633,279,354,44.08
Alistar,Rell,424,214,210,50.47
Alistar,Malphite,539,298,241,55.29
Alistar,Taric,133,67,66,50.38
Alistar,Hecarim,201,119,82,59.2
Alistar,Janna,218,107,111,49.08
Alistar,Gwen,218,117,101,53.67
Alistar,Illaoi,256,103,153,40.23
Alistar,Naafiri,144,82,62,56.94
Alistar,Quinn,156,91,65,58.33
Alistar,Sivir,363,162,201,44.63
Alistar,Viktor,541,256,285,47.32
Alistar,Zilean,180,82,98,45.56
Alistar,Rakan,194,111,83,57.22
Alistar,Rammus,170,77,93,45.29
Alistar,Kayle,280,120,160,42.86
Alistar,Zoe,167,79,88,47.31
Alistar,Taliyah,117,57,60,48.72
Alistar,Zeri,288,150,138,52.08
Alistar,Skarner,128,81,47,63.28
Alistar,Akshan,132,70,62,53.03
Alistar,Kindred,235,137,98,58.3
Alistar,Shyvana,156,84,72,53.85
Alistar,Yuumi,408,201,207,49.26
Alistar,Bard,129,78,51,60.47
Alistar,KogMaw,138,61,77,44.2
Alistar,Sona,141,50,91,35.46
Alistar,Nunu,226,91,135,40.27
Alistar,Maokai,280,137,143,48.93
Alistar,Kled,78,47,31,60.26
Alistar,Nidalee,142,78,64,54.93
Hwei,Aurora,671,373,298,55.59
Hwei,Corki,313,159,154,50.8
Hwei,Orianna,361,172,189,47.65
Hwei,Xayah,337,170,167,50.45
Hwei,Nami,848,407,441,48
Hwei,Gnar,323,167,156,51.7
Hwei,Zyra,834,412,422,49.4
Hwei,Azir,299,134,165,44.82
Hwei,Varus,760,388,372,51.05
Hwei,Nautilus,943,486,457,51.54
Hwei,Darius,1685,870,815,51.63
Hwei,Khazix,477,243,234,50.94
Hwei,Zed,826,390,436,47.22
Hwei,Aphelios,521,249,272,47.79
Hwei,Pyke,647,334,313,51.62
Hwei,Garen,1246,648,598,52.01
Hwei,Nocturne,1073,567,506,52.84
Hwei,Fizz,472,218,254,46.19
Hwei,Jinx,2376,1187,1189,49.96
Hwei,Thresh,1152,593,559,51.48
Hwei,Graves,521,254,267,48.75
Hwei,Malzahar,944,476,468,50.42
Hwei,Lucian,545,292,253,53.58
Hwei,Lux,2037,1008,1029,49.48
Hwei,Tryndamere,412,199,213,48.3
Hwei,Kayn,1101,522,579,47.41
Hwei,Viktor,1055,495,560,46.92
Hwei,Jhin,1824,848,976,46.49
Hwei,Ornn,345,183,162,53.04
Hwei,Volibear,896,465,431,51.9
Hwei,Ezreal,2080,1018,1062,48.94
Hwei,Velkoz,489,236,253,48.26
Hwei,Sion,592,276,316,46.62
Hwei,Shaco,770,387,383,50.26
Hwei,Milio,484,259,225,53.51
Hwei,Karthus,225,119,106,52.89
Hwei,Ekko,845,369,476,43.67
Hwei,KogMaw,248,121,127,48.79
Hwei,Lulu,1236,642,594,51.94
Hwei,Nasus,542,241,301,44.46
Hwei,Amumu,801,420,381,52.43
Hwei,Ryze,268,131,137,48.88
Hwei,Ashe,1770,910,860,51.41
Hwei,Neeko,382,204,178,53.4
Hwei,Akali,787,390,397,49.56
Hwei,Diana,1290,679,611,52.64
Hwei,Talon,467,222,245,47.54
Hwei,Vayne,1033,533,500,51.6
Hwei,Zilean,318,141,177,44.34
Hwei,Renekton,413,231,182,55.93
Hwei,Mordekaiser,1076,527,549,48.98
Hwei,Ahri,1193,595,598,49.87
Hwei,Rell,398,180,218,45.23
Hwei,Aatrox,788,405,383,51.4
Hwei,Belveth,223,88,135,39.46
Hwei,Syndra,703,351,352,49.93
Hwei,Ambessa,490,227,263,46.33
Hwei,Viego,1308,641,667,49.01
Hwei,TwistedFate,330,160,170,48.48
Hwei,Ziggs,332,183,149,55.12
Hwei,Veigar,849,380,469,44.76
Hwei,Shyvana,181,93,88,51.38
Hwei,Sett,1194,563,631,47.15
Hwei,Xerath,976,482,494,49.39
Hwei,Caitlyn,2360,1267,1093,53.69
Hwei,Kennen,224,119,105,53.13
Hwei,Rengar,268,156,112,58.21
Hwei,Yasuo,1571,764,807,48.63
Hwei,Smolder,496,273,223,55.04
Hwei,Kayle,575,306,269,53.22
Hwei,Pantheon,1312,667,645,50.84
Hwei,Samira,518,282,236,54.44
Hwei,TahmKench,630,324,306,51.43
Hwei,MasterYi,1016,523,493,51.48
Hwei,Yorick,770,348,422,45.19
Hwei,Nunu,414,195,219,47.1
Hwei,Sylas,1080,540,540,50
Hwei,Tristana,787,403,384,51.21
Hwei,Yone,1440,768,672,53.33
Hwei,Kaisa,1389,698,691,50.25
Hwei,Quinn,320,153,167,47.81
Hwei,Lissandra,226,138,88,61.06
Hwei,Chogath,991,528,463,53.28
Hwei,Teemo,918,463,455,50.44
Hwei,Mel,1620,892,728,55.06
Hwei,Gwen,427,231,196,54.1
Hwei,Galio,824,432,392,52.43
Hwei,Brand,660,370,290,56.06
Hwei,Shen,497,278,219,55.94
Hwei,Kalista,201,118,83,58.71
Hwei,MissFortune,1830,904,926,49.4
Hwei,Hecarim,336,168,168,50
Hwei,Vex,411,214,197,52.07
Hwei,Warwick,1190,562,628,47.23
Hwei,Riven,423,227,196,53.66
Hwei,Vi,765,402,363,52.55
Hwei,Swain,740,391,349,52.84
Hwei,Singed,260,112,148,43.08
Hwei,Bard,216,90,126,41.67
Hwei,Soraka,435,253,182,58.16
Hwei,Gangplank,435,240,195,55.17
Hwei,Leona,652,302,350,46.32
Hwei,Naafiri,272,132,140,48.53
Hwei,Briar,560,280,280,50
Hwei,Blitzcrank,627,344,283,54.86
Hwei,Illaoi,365,179,186,49.04
Hwei,Draven,450,205,245,45.56
Hwei,Sejuani,419,196,223,46.78
Hwei,Trundle,488,247,241,50.61
Hwei,Janna,292,131,161,44.86
Hwei,Vladimir,513,260,253,50.68
Hwei,Rammus,203,101,102,49.75
Hwei,Karma,1173,570,603,48.59
Hwei,Morgana,920,455,465,49.46
Hwei,Lillia,409,223,186,54.52
Hwei,Katarina,687,357,330,51.97
Hwei,Elise,680,314,366,46.18
Hwei,Qiyana,195,125,70,64.1
Hwei,Heimerdinger,414,187,227,45.17
Hwei,DrMundo,403,205,198,50.87
Hwei,Nidalee,288,162,126,56.25
Hwei,Zoe,321,173,148,53.89
Hwei,Jax,713,333,380,46.7
Hwei,Kassadin,212,110,102,51.89
Hwei,Irelia,662,297,365,44.86
Hwei,FiddleSticks,394,228,166,57.87
Hwei,KSante,454,225,229,49.56
Hwei,Rakan,316,144,172,45.57
Hwei,LeeSin,1358,700,658,51.55
Hwei,Gragas,439,226,213,51.48
Hwei,Annie,248,105,143,42.34
Hwei,Anivia,260,145,115,55.77
Hwei,Twitch,627,297,330,47.37
Hwei,Kindred,359,182,177,50.7
Hwei,Seraphine,589,306,283,51.95
Hwei,Urgot,440,201,239,45.68
Hwei,Zac,424,227,197,53.54
Hwei,Skarner,243,109,134,44.86
Hwei,Nilah,260,137,123,52.69
Hwei,Taric,136,67,69,49.26
Hwei,AurelionSol,327,152,175,46.48
Hwei,Malphite,783,402,381,51.34
Hwei,Rumble,266,125,141,46.99
Hwei,RekSai,124,48,76,38.71
Hwei,Maokai,414,237,177,57.25
Hwei,Jayce,411,226,185,54.99
Hwei,Braum,478,239,239,50
Hwei,Cassiopeia,232,116,116,50
Hwei,XinZhao,575,265,310,46.09
Hwei,Camille,285,149,136,52.28
Hwei,Alistar,335,168,167,50.15
Hwei,Taliyah,248,127,121,51.21
Hwei,MonkeyKing,645,322,323,49.92
Hwei,Poppy,485,262,223,54.02
Hwei,Ivern,114,60,54,52.63
Hwei,Akshan,272,111,161,40.81
Hwei,Renata,107,42,65,39.25
Hwei,Senna,655,345,310,52.67
Hwei,JarvanIV,487,243,244,49.9
Hwei,Yuumi,711,353,358,49.65
Hwei,Fiora,331,157,174,47.43
Hwei,Leblanc,545,269,276,49.36
Hwei,Sivir,386,176,210,45.6
Hwei,Sona,279,129,150,46.24
Hwei,Evelynn,245,120,125,48.98
Hwei,Zeri,383,225,158,58.75
Hwei,Udyr,366,214,152,58.47
Hwei,Kled,148,66,82,44.59
Hwei,Olaf,198,103,95,52.02
Mordekaiser,Shen,1155,593,562,51.34
Mordekaiser,Belveth,388,190,198,48.97
Mordekaiser,Akali,2018,1095,923,54.26
Mordekaiser,Varus,1425,705,720,49.47
Mordekaiser,Lulu,1960,1084,876,55.31
Mordekaiser,Irelia,1296,649,647,50.08
Mordekaiser,Hecarim,635,352,283,55.43
Mordekaiser,Malzahar,1774,883,891,49.77
Mordekaiser,Vayne,2281,1092,1189,47.87
Mordekaiser,Pantheon,2535,1355,1180,53.45
Mordekaiser,Renekton,839,504,335,60.07
Mordekaiser,Diana,2803,1438,1365,51.3
Mordekaiser,Azir,521,277,244,53.17
Mordekaiser,MissFortune,4385,2308,2077,52.63
Mordekaiser,Yuumi,1439,778,661,54.07
Mordekaiser,Darius,3713,1897,1816,51.09
Mordekaiser,LeeSin,2188,1124,1064,51.37
Mordekaiser,KogMaw,516,264,252,51.16
Mordekaiser,Thresh,2138,1114,1024,52.1
Mordekaiser,Volibear,2432,1281,1151,52.67
Mordekaiser,Yorick,1939,956,983,49.3
Mordekaiser,Zoe,578,281,297,48.62
Mordekaiser,Samira,1300,707,593,54.38
Mordekaiser,Jax,1584,858,726,54.17
Mordekaiser,Amumu,1944,974,970,50.1
Mordekaiser,Ahri,2247,1149,1098,51.13
Mordekaiser,Caitlyn,4456,2230,2226,50.04
Mordekaiser,Aatrox,1538,749,789,48.7
Mordekaiser,Kayn,2442,1237,1205,50.66
Mordekaiser,Katarina,1203,645,558,53.62
Mordekaiser,Jhin,3323,1777,1546,53.48
Mordekaiser,Blitzcrank,1100,584,516,53.09
Mordekaiser,Ekko,1554,818,736,52.64
Mordekaiser,Kaisa,2489,1343,1146,53.96
Mordekaiser,Gragas,748,423,325,56.55
Mordekaiser,Zed,1827,972,855,53.2
Mordekaiser,Twitch,1380,744,636,53.91
Mordekaiser,Garen,2914,1600,1314,54.91
Mordekaiser,Lillia,937,474,463,50.59
Mordekaiser,Nami,1554,782,772,50.32
Mordekaiser,Vex,834,461,373,55.28
Mordekaiser,Neeko,746,370,376,49.6
Mordekaiser,Sett,2852,1438,1414,50.42
Mordekaiser,XinZhao,1098,610,488,55.56
Mordekaiser,Fizz,985,563,422,57.16
Mordekaiser,Karma,1884,942,942,50
Mordekaiser,Warwick,2917,1361,1556,46.66
Mordekaiser,Jinx,4876,2530,2346,51.89
Mordekaiser,Yasuo,3151,1639,1512,52.02
Mordekaiser,Chogath,2253,1228,1025,54.51
Mordekaiser,Pyke,1195,587,608,49.12
Mordekaiser,Yone,3015,1630,1385,54.06
Mordekaiser,Nocturne,2136,997,1139,46.68
Mordekaiser,Velkoz,947,426,521,44.98
Mordekaiser,Shaco,1636,898,738,54.89
Mordekaiser,Vi,1533,776,757,50.62
Mordekaiser,Nautilus,1683,867,816,51.52
Mordekaiser,Evelynn,544,276,268,50.74
Mordekaiser,Lux,4157,2115,2042,50.88
Mordekaiser,Ashe,3303,1704,1599,51.59
Mordekaiser,Mel,3324,1843,1481,55.45
Mordekaiser,Tristana,1696,903,793,53.24
Mordekaiser,Swain,1718,891,827,51.86
Mordekaiser,Teemo,2112,1092,1020,51.7
Mordekaiser,Sejuani,690,416,274,60.29
Mordekaiser,Urgot,826,412,414,49.88
Mordekaiser,Riven,774,416,358,53.75
Mordekaiser,Hwei,1076,549,527,51.02
Mordekaiser,Milio,937,477,460,50.91
Mordekaiser,KSante,986,512,474,51.93
Mordekaiser,Nunu,944,499,445,52.86
Mordekaiser,Sylas,2139,1162,977,54.32
Mordekaiser,Ziggs,628,356,272,56.69
Mordekaiser,Zeri,636,344,292,54.09
Mordekaiser,Leona,1503,841,662,55.95
Mordekaiser,Ambessa,885,456,429,51.53
Mordekaiser,Graves,999,499,500,49.95
Mordekaiser,Anivia,586,308,278,52.56
Mordekaiser,Kayle,1154,516,638,44.71
Mordekaiser,Jayce,580,305,275,52.59
Mordekaiser,Morgana,2004,1046,958,52.2
Mordekaiser,Trundle,1098,575,523,52.37
Mordekaiser,Draven,745,368,377,49.4
Mordekaiser,Rell,713,384,329,53.86
Mordekaiser,Ezreal,3837,2041,1796,53.19
Mordekaiser,Zyra,1553,731,822,47.07
Mordekaiser,Malphite,2051,1125,926,54.85
Mordekaiser,Akshan,494,263,231,53.24
Mordekaiser,Aphelios,906,440,466,48.57
Mordekaiser,Zilean,463,233,230,50.32
Mordekaiser,Tryndamere,979,454,525,46.37
Mordekaiser,Leblanc,946,513,433,54.23
Mordekaiser,Sivir,898,430,468,47.88
Mordekaiser,AurelionSol,659,386,273,58.57
Mordekaiser,Annie,535,279,256,52.15
Mordekaiser,Rammus,510,301,209,59.02
Mordekaiser,Sion,1128,553,575,49.02
Mordekaiser,Orianna,609,303,306,49.75
Mordekaiser,Soraka,916,457,459,49.89
Mordekaiser,MonkeyKing,1191,607,584,50.97
Mordekaiser,Karthus,442,224,218,50.68
Mordekaiser,Rakan,576,271,305,47.05
Mordekaiser,Ornn,726,405,321,55.79
Mordekaiser,Syndra,1006,515,491,51.19
Mordekaiser,Aurora,1018,518,500,50.88
Mordekaiser,Gangplank,773,433,340,56.02
Mordekaiser,Viego,2124,1085,1039,51.08
Mordekaiser,Kennen,330,164,166,49.7
Mordekaiser,Braum,918,475,443,51.74
Mordekaiser,Briar,1294,596,698,46.06
Mordekaiser,Seraphine,1249,691,558,55.32
Mordekaiser,JarvanIV,964,510,454,52.9
Mordekaiser,Xayah,727,366,361,50.34
Mordekaiser,Alistar,693,382,311,55.12
Mordekaiser,Illaoi,1071,597,474,55.74
Mordekaiser,Brand,1271,631,640,49.65
Mordekaiser,Quinn,491,217,274,44.2
Mordekaiser,Camille,569,311,258,54.66
Mordekaiser,Poppy,893,452,441,50.62
Mordekaiser,Viktor,1288,667,621,51.79
Mordekaiser,Senna,1194,596,598,49.92
Mordekaiser,Gnar,530,265,265,50
Mordekaiser,Kindred,721,418,303,57.98
Mordekaiser,RekSai,201,124,77,61.69
Mordekaiser,Lucian,1137,568,569,49.96
Mordekaiser,Lissandra,514,210,304,40.86
Mordekaiser,Nasus,1359,674,685,49.6
Mordekaiser,TahmKench,1518,801,717,52.77
Mordekaiser,Rengar,531,311,220,58.57
Mordekaiser,Gwen,725,400,325,55.17
Mordekaiser,Vladimir,1118,570,548,50.98
Mordekaiser,Taliyah,357,202,155,56.58
Mordekaiser,MasterYi,2158,1006,1152,46.62
Mordekaiser,Veigar,1786,925,861,51.79
Mordekaiser,FiddleSticks,761,384,377,50.46
Mordekaiser,Rumble,432,255,177,59.03
Mordekaiser,Sona,449,222,227,49.44
Mordekaiser,Zac,650,310,340,47.69
Mordekaiser,Naafiri,563,283,280,50.27
Mordekaiser,Kassadin,366,181,185,49.45
Mordekaiser,Nidalee,317,182,135,57.41
Mordekaiser,DrMundo,994,484,510,48.69
Mordekaiser,Singed,504,229,275,45.44
Mordekaiser,Shyvana,416,216,200,51.92
Mordekaiser,Maokai,774,393,381,50.78
Mordekaiser,Khazix,801,423,378,52.81
Mordekaiser,Corki,492,253,239,51.42
Mordekaiser,Skarner,391,209,182,53.45
Mordekaiser,Ivern,205,102,103,49.76
Mordekaiser,Udyr,685,355,330,51.82
Mordekaiser,Xerath,1402,700,702,49.93
Mordekaiser,Talon,848,495,353,58.37
Mordekaiser,Kled,265,153,112,57.74
Mordekaiser,Heimerdinger,787,384,403,48.79
Mordekaiser,Smolder,930,499,431,53.66
Mordekaiser,Taric,405,178,227,43.95
Mordekaiser,Fiora,704,323,381,45.88
Mordekaiser,Kalista,377,193,184,51.19
Mordekaiser,Janna,493,249,244,50.51
Mordekaiser,Nilah,444,216,228,48.65
Mordekaiser,TwistedFate,510,242,268,47.45
Mordekaiser,Cassiopeia,414,204,210,49.28
Mordekaiser,Olaf,675,338,337,50.07
Mordekaiser,Galio,1408,689,719,48.93
Mordekaiser,Qiyana,323,169,154,52.32
Mordekaiser,Bard,468,239,229,51.07
Mordekaiser,Elise,953,524,429,54.98
Mordekaiser,Renata,263,135,128,51.33
Mordekaiser,Ryze,548,304,244,55.47
Yone,Shen,1426,701,725,49.16
Yone,Belveth,525,278,247,52.95
Yone,Akali,3380,1579,1801,46.72
Yone,Varus,2059,1057,1002,51.34
Yone,Lulu,3068,1386,1682,45.18
Yone,Mel,4538,2311,2227,50.93
Yone,Trundle,1465,686,779,46.83
Yone,Zed,2676,1322,1354,49.4
Yone,Vayne,2756,1222,1534,44.34
Yone,Sejuani,839,439,400,52.32
Yone,Jayce,1270,562,708,44.25
Yone,Talon,1424,757,667,53.16
Yone,Kennen,620,286,334,46.13
Yone,Lucian,1603,762,841,47.54
Yone,Elise,1663,847,816,50.93
Yone,Darius,4290,1991,2299,46.41
Yone,Volibear,2603,1203,1400,46.22
Yone,Jinx,6719,3104,3615,46.2
Yone,Lux,5785,2719,3066,47
Yone,Tryndamere,1290,618,672,47.91
Yone,Kayn,3364,1517,1847,45.1
Yone,Viktor,2194,1039,1155,47.36
Yone,Jhin,4910,2378,2532,48.43
Yone,Ornn,831,407,424,48.98
Yone,Riven,1024,439,585,42.87
Yone,Ziggs,784,373,411,47.58
Yone,Katarina,1837,861,976,46.87
Yone,LeeSin,4158,2065,2093,49.66
Yone,Rumble,723,369,354,51.04
Yone,Amumu,2356,1049,1307,44.52
Yone,Yasuo,6191,2893,3298,46.73
Yone,Caitlyn,6447,2955,3492,45.84
Yone,Zyra,2170,1017,1153,46.87
Yone,XinZhao,1615,745,870,46.13
Yone,Briar,1748,743,1005,42.51
Yone,AurelionSol,778,399,379,51.29
Yone,Ashe,4772,2318,2454,48.58
Yone,Pantheon,4140,2036,2104,49.18
Yone,Rengar,731,322,409,44.05
Yone,Fizz,1264,530,734,41.93
Yone,KogMaw,668,300,368,44.91
Yone,Gwen,1101,527,574,47.87
Yone,Ezreal,6287,3070,3217,48.83
Yone,Rakan,955,431,524,45.13
Yone,Garen,3818,1768,2050,46.31
Yone,MonkeyKing,1699,771,928,45.38
Yone,Akshan,729,356,373,48.83
Yone,Tristana,2259,1106,1153,48.96
Yone,Swain,2140,1047,1093,48.93
Yone,Graves,1608,769,839,47.82
Yone,Veigar,2267,1082,1185,47.73
Yone,Jax,2592,1214,1378,46.84
Yone,Mordekaiser,3015,1385,1630,45.94
Yone,Syndra,1340,638,702,47.61
Yone,Kaisa,4180,2060,2120,49.28
Yone,Karma,2882,1385,1497,48.06
Yone,Shaco,2224,1098,1126,49.37
Yone,Aurora,1806,855,951,47.34
Yone,Zilean,718,356,362,49.58
Yone,Gragas,1179,594,585,50.38
Yone,Braum,1219,551,668,45.2
Yone,Gnar,939,466,473,49.63
Yone,Viego,3452,1602,1850,46.41
Yone,TwistedFate,812,468,344,57.64
Yone,Naafiri,754,403,351,53.45
Yone,Nidalee,718,390,328,54.32
Yone,Xayah,1105,608,497,55.02
Yone,Renata,382,190,192,49.74
Yone,Illaoi,1096,534,562,48.72
Yone,Ahri,3199,1452,1747,45.39
Yone,TahmKench,1688,801,887,47.45
Yone,Camille,734,357,377,48.64
Yone,Lissandra,748,344,404,45.99
Yone,Smolder,1504,750,754,49.87
Yone,Yorick,2441,1077,1364,44.12
Yone,Khazix,1147,547,600,47.69
Yone,Vex,1386,681,705,49.13
Yone,Nautilus,2673,1294,1379,48.41
Yone,Chogath,2806,1375,1431,49
Yone,Sett,3723,1612,2111,43.3
Yone,Irelia,2374,1117,1257,47.05
Yone,Aatrox,2441,1173,1268,48.05
Yone,Vladimir,1665,848,817,50.93
Yone,Renekton,1506,638,868,42.36
Yone,Lillia,1285,639,646,49.73
Yone,Yuumi,1981,991,990,50.03
Yone,Warwick,3444,1491,1953,43.29
Yone,Diana,3812,1824,1988,47.85
Yone,Soraka,1180,504,676,42.71
Yone,Singed,633,284,349,44.87
Yone,Teemo,2672,1186,1486,44.39
Yone,Skarner,627,314,313,50.08
Yone,Senna,1725,847,878,49.1
Yone,Draven,1118,523,595,46.78
Yone,Bard,613,298,315,48.61
Yone,Sylas,4063,2064,1999,50.8
Yone,MissFortune,5667,2710,2957,47.82
Yone,Neeko,1117,520,597,46.55
Yone,Brand,1741,797,944,45.78
Yone,Heimerdinger,1183,537,646,45.39
Yone,Rammus,900,409,491,45.44
Yone,Morgana,2663,1273,1390,47.8
Yone,Malzahar,2325,1102,1223,47.4
Yone,Vi,2313,1108,1205,47.9
Yone,Rell,1063,518,545,48.73
Yone,MasterYi,3056,1412,1644,46.2
Yone,Seraphine,1640,832,808,50.73
Yone,Kayle,1418,712,706,50.21
Yone,Malphite,2678,1263,1415,47.16
Yone,Leona,1996,959,1037,48.05
Yone,Leblanc,1569,737,832,46.97
Yone,Urgot,989,411,578,41.56
Yone,Samira,1629,715,914,43.89
Yone,Thresh,3247,1488,1759,45.83
Yone,Quinn,822,388,434,47.2
Yone,Janna,707,345,362,48.8
Yone,KSante,1366,736,630,53.88
Yone,Nocturne,2970,1423,1547,47.91
Yone,Hwei,1440,672,768,46.67
Yone,Kalista,549,250,299,45.54
Yone,Galio,2169,1067,1102,49.19
Yone,Sion,1762,890,872,50.51
Yone,Corki,898,468,430,52.12
Yone,Pyke,1918,937,981,48.85
Yone,Udyr,824,416,408,50.49
Yone,Orianna,915,493,422,53.88
Yone,Qiyana,538,283,255,52.6
Yone,Nasus,1708,855,853,50.06
Yone,Taliyah,530,257,273,48.49
Yone,FiddleSticks,1142,529,613,46.32
Yone,Azir,755,369,386,48.87
Yone,Maokai,1076,557,519,51.77
Yone,Fiora,864,378,486,43.75
Yone,Nilah,667,273,394,40.93
Yone,Blitzcrank,1895,941,954,49.66
Yone,Gangplank,1225,615,610,50.2
Yone,JarvanIV,1375,654,721,47.56
Yone,Velkoz,1341,578,763,43.1
Yone,Sivir,1168,570,598,48.8
Yone,Cassiopeia,687,308,379,44.83
Yone,Kindred,1014,454,560,44.77
Yone,Alistar,956,451,505,47.18
Yone,Ekko,2051,953,1098,46.47
Yone,Twitch,1676,810,866,48.33
Yone,Shyvana,537,261,276,48.6
Yone,Nami,2042,960,1082,47.01
Yone,DrMundo,1252,640,612,51.12
Yone,Taric,436,188,248,43.12
Yone,Kled,450,231,219,51.33
Yone,Evelynn,828,399,429,48.19
Yone,Sona,693,295,398,42.57
Yone,Xerath,2176,1016,1160,46.69
Yone,Nunu,1189,587,602,49.37
Yone,Aphelios,1163,539,624,46.35
Yone,Milio,1258,564,694,44.83
Yone,Karthus,711,338,373,47.54
Yone,Zeri,976,452,524,46.31
Yone,Ivern,333,178,155,53.45
Yone,Ambessa,1449,690,759,47.62
Yone,Kassadin,423,196,227,46.34
Yone,Olaf,515,246,269,47.77
Yone,Poppy,1420,623,797,43.87
Yone,Hecarim,874,459,415,52.52
Yone,Zoe,954,446,508,46.75
Yone,Ryze,863,362,501,41.95
Yone,Annie,789,373,416,47.28
Yone,Zac,1194,525,669,43.97
Yone,Anivia,605,287,318,47.44
Yone,RekSai,255,132,123,51.76
Shen,Mordekaiser,1155,562,593,48.66
Shen,Vi,721,321,400,44.52
Shen,Yone,1426,725,701,50.84
Shen,Caitlyn,2108,1028,1080,48.77
Shen,Alistar,315,161,154,51.11
Shen,Sett,1284,604,680,47.04
Shen,Gragas,470,245,225,52.13
Shen,Yasuo,1478,786,692,53.18
Shen,Kalista,151,93,58,61.59
Shen,Mel,1442,716,726,49.65
Shen,Khazix,347,182,165,52.45
Shen,Lissandra,279,122,157,43.73
Shen,Lucian,507,280,227,55.23
Shen,Rell,403,175,228,43.42
Shen,Yorick,856,408,448,47.66
Shen,Rengar,287,146,141,50.87
Shen,Irelia,572,271,301,47.38
Shen,Ezreal,1674,877,797,52.39
Shen,Soraka,489,252,237,51.53
Shen,Talon,401,198,203,49.38
Shen,Viktor,717,352,365,49.09
Shen,Malzahar,780,337,443,43.21
Shen,Ahri,1016,529,487,52.07
Shen,Varus,701,334,367,47.65
Shen,Vex,394,182,212,46.19
Shen,Kayn,1143,528,615,46.19
Shen,Darius,1481,701,780,47.33
Shen,Janna,294,129,165,43.88
Shen,Vladimir,557,271,286,48.65
Shen,Udyr,300,144,156,48
Shen,Diana,1221,634,587,51.92
Shen,Jhin,1558,751,807,48.2
Shen,Lux,1906,924,982,48.48
Shen,TahmKench,591,336,255,56.85
Shen,Evelynn,253,131,122,51.78
Shen,Kassadin,176,101,75,57.39
Shen,MissFortune,1933,912,1021,47.18
Shen,Thresh,1077,586,491,54.41
Shen,LeeSin,1095,528,567,48.22
Shen,Galio,758,363,395,47.89
Shen,Akali,735,331,404,45.03
Shen,Ekko,765,389,376,50.85
Shen,Kaisa,1246,635,611,50.96
Shen,Jax,765,375,390,49.02
Shen,Nasus,536,258,278,48.13
Shen,Kindred,354,192,162,54.24
Shen,Jinx,2208,987,1221,44.7
Shen,Morgana,945,409,536,43.28
Shen,Ornn,317,172,145,54.26
Shen,Velkoz,505,254,251,50.3
Shen,Corki,345,167,178,48.41
Shen,Shaco,780,409,371,52.44
Shen,Smolder,564,307,257,54.43
Shen,Fiora,279,139,140,49.82
Shen,Zoe,273,143,130,52.38
Shen,Tristana,806,423,383,52.48
Shen,KSante,380,203,177,53.42
Shen,Sivir,398,207,191,52.01
Shen,Aatrox,692,306,386,44.22
Shen,Bard,248,115,133,46.37
Shen,Viego,1135,569,566,50.13
Shen,Ziggs,235,132,103,56.17
Shen,Samira,549,277,272,50.46
Shen,Warwick,1135,550,585,48.46
Shen,Zyra,784,399,385,50.89
Shen,Nocturne,1019,451,568,44.26
Shen,Braum,430,208,222,48.37
Shen,Neeko,364,166,198,45.6
Shen,Draven,425,214,211,50.35
Shen,Nautilus,899,475,424,52.84
Shen,Rumble,192,89,103,46.35
Shen,Twitch,609,320,289,52.55
Shen,Brand,588,256,332,43.54
Shen,Malphite,709,391,318,55.15
Shen,Zed,874,416,458,47.6
Shen,Syndra,437,202,235,46.22
Shen,Pantheon,1200,569,631,47.42
Shen,Ambessa,525,287,238,54.67
Shen,Lillia,422,216,206,51.18
Shen,MonkeyKing,543,281,262,51.75
Shen,Hwei,497,219,278,44.06
Shen,Pyke,668,344,324,51.5
Shen,Tryndamere,477,224,253,46.96
Shen,Orianna,363,178,185,49.04
Shen,Ashe,1540,763,777,49.55
Shen,Vayne,1143,522,621,45.67
Shen,Rammus,257,135,122,52.53
Shen,Zilean,286,139,147,48.6
Shen,Kled,175,86,89,49.14
Shen,Illaoi,386,167,219,43.26
Shen,KogMaw,252,104,148,41.27
Shen,Chogath,989,474,515,47.93
Shen,Sejuani,348,179,169,51.44
Shen,Katarina,586,316,270,53.92
Shen,Nami,740,349,391,47.16
Shen,Karma,908,459,449,50.55
Shen,Renekton,319,174,145,54.55
Shen,Fizz,499,268,231,53.71
Shen,MasterYi,912,415,497,45.5
Shen,Akshan,238,137,101,57.56
Shen,Amumu,877,386,491,44.01
Shen,Sylas,1011,512,499,50.64
Shen,Blitzcrank,616,282,334,45.78
Shen,Graves,524,245,279,46.76
Shen,Senna,609,258,351,42.36
Shen,Gangplank,433,170,263,39.26
Shen,Aphelios,410,230,180,56.1
Shen,Skarner,144,80,64,55.56
Shen,Camille,292,140,152,47.95
Shen,Elise,555,273,282,49.19
Shen,Seraphine,521,261,260,50.1
Shen,JarvanIV,565,267,298,47.26
Shen,Swain,802,362,440,45.14
Shen,Shyvana,224,111,113,49.55
Shen,Nunu,415,195,220,46.99
Shen,Teemo,1001,526,475,52.55
Shen,Annie,237,121,116,51.05
Shen,Leblanc,472,218,254,46.19
Shen,Xerath,636,312,324,49.06
Shen,Garen,1307,656,651,50.19
Shen,AurelionSol,315,169,146,53.65
Shen,Milio,390,189,201,48.46
Shen,Volibear,868,420,448,48.39
Shen,Sion,682,358,324,52.49
Shen,Briar,529,252,277,47.64
Shen,Olaf,228,113,115,49.56
Shen,Taric,163,77,86,47.24
Shen,Anivia,251,133,118,52.99
Shen,Maokai,360,170,190,47.22
Shen,Aurora,561,271,290,48.31
Shen,Qiyana,206,108,98,52.43
Shen,Nilah,285,142,143,49.82
Shen,Veigar,753,367,386,48.74
Shen,Kayle,557,230,327,41.29
Shen,TwistedFate,248,139,109,56.05
Shen,Urgot,365,179,186,49.04
Shen,Leona,677,330,347,48.74
Shen,Taliyah,182,73,109,40.11
Shen,Nidalee,220,133,87,60.45
Shen,Ivern,110,55,55,50
Shen,Singed,236,141,95,59.75
Shen,Renata,114,63,51,55.26
Shen,Zac,345,200,145,57.97
Shen,Azir,268,139,129,51.87
Shen,Poppy,438,216,222,49.32
Shen,Riven,412,184,228,44.66
Shen,Rakan,276,154,122,55.8
Shen,DrMundo,431,179,252,41.53
Shen,Hecarim,316,157,159,49.68
Shen,XinZhao,485,294,191,60.62
Shen,Sona,254,108,146,42.52
Shen,Trundle,466,237,229,50.86
Shen,Heimerdinger,386,190,196,49.22
Shen,Gnar,313,170,143,54.31
Shen,Lulu,1116,531,585,47.58
Shen,Ryze,263,112,151,42.59
Shen,FiddleSticks,381,216,165,56.69
Shen,Belveth,184,105,79,57.07
Shen,Quinn,259,117,142,45.17
Shen,Xayah,423,206,217,48.7
Shen,RekSai,121,60,61,49.59
Shen,Jayce,330,146,184,44.24
Shen,Naafiri,232,119,113,51.29
Shen,Karthus,191,104,87,54.45
Shen,Yuumi,600,303,297,50.5
Shen,Cassiopeia,213,102,111,47.89
Shen,Kennen,182,106,76,58.24
Shen,Zeri,298,123,175,41.28
Shen,Gwen,472,229,243,48.52
Akali,Mordekaiser,2018,923,1095,45.74
Akali,Vi,1307,581,726,44.45
Akali,Yone,3380,1801,1579,53.28
Akali,Caitlyn,3827,1847,1980,48.26
Akali,Alistar,543,228,315,41.99
Akali,Trundle,816,389,427,47.67
Akali,Volibear,1606,767,839,47.76
Akali,Viktor,1319,702,617,53.22
Akali,Xayah,625,323,302,51.68
Akali,Lulu,1869,914,955,48.9
Akali,Gangplank,697,346,351,49.64
Akali,FiddleSticks,710,341,369,48.03
Akali,Varus,1201,605,596,50.37
Akali,Zilean,365,162,203,44.38
Akali,Aatrox,1221,631,590,51.68
Akali,Kayn,1844,870,974,47.18
Akali,Katarina,1107,570,537,51.49
Akali,Draven,546,265,281,48.53
Akali,Blitzcrank,1050,593,457,56.48
Akali,Yasuo,3183,1623,1560,50.99
Akali,Khazix,674,331,343,49.11
Akali,Lissandra,530,299,231,56.42
Akali,Lucian,979,501,478,51.17
Akali,Rell,664,314,350,47.29
Akali,Irelia,1353,717,636,52.99
Akali,Diana,2325,1117,1208,48.04
Akali,Soraka,781,346,435,44.3
Akali,Vex,892,372,520,41.7
Akali,Darius,2331,1160,1171,49.76
Akali,Ezreal,3755,1829,1926,48.71
Akali,Janna,405,174,231,42.96
Akali,Chogath,1536,715,821,46.55
Akali,Gragas,745,384,361,51.54
Akali,Zed,1788,871,917,48.71
Akali,Vayne,1837,830,1007,45.18
Akali,Senna,964,471,493,48.86
Akali,Rumble,409,189,220,46.21
Akali,Vladimir,929,434,495,46.72
Akali,Jhin,2892,1469,1423,50.8
Akali,TahmKench,976,535,441,54.82
Akali,Pantheon,2187,1110,1077,50.75
Akali,Skarner,346,204,142,58.96
Akali,MissFortune,3599,1745,1854,48.49
Akali,Lux,3455,1705,1750,49.35
Akali,Ekko,1312,655,657,49.92
Akali,Pyke,1252,642,610,51.28
Akali,Renekton,723,345,378,47.72
Akali,Ziggs,553,299,254,54.07
Akali,Milio,717,354,363,49.37
Akali,Shaco,1350,724,626,53.63
Akali,Leblanc,909,455,454,50.06
Akali,Hwei,787,397,390,50.44
Akali,Thresh,1830,864,966,47.21
Akali,Illaoi,634,344,290,54.26
Akali,Briar,950,492,458,51.79
Akali,Mel,2901,1522,1379,52.46
Akali,Nami,1226,567,659,46.25
Akali,Teemo,1779,836,943,46.99
Akali,Ashe,3038,1478,1560,48.65
Akali,Zyra,1432,715,717,49.93
Akali,Warwick,2131,976,1155,45.8
Akali,Garen,2291,1109,1182,48.41
Akali,Smolder,784,404,380,51.53
Akali,Swain,1309,626,683,47.82
Akali,Gnar,509,264,245,51.87
Akali,Viego,2102,1089,1013,51.81
Akali,Twitch,918,497,421,54.14
Akali,Sona,415,207,208,49.88
Akali,Singed,338,158,180,46.75
Akali,MasterYi,1768,883,885,49.94
Akali,Neeko,651,330,321,50.69
Akali,Jinx,3806,1947,1859,51.16
Akali,Braum,702,310,392,44.16
Akali,Nocturne,1853,915,938,49.38
Akali,Aurora,1042,568,474,54.51
Akali,Karma,1855,949,906,51.16
Akali,Graves,889,405,484,45.56
Akali,Amumu,1352,638,714,47.19
Akali,Malzahar,1203,590,613,49.04
Akali,Shen,735,401,334,54.56
Akali,Orianna,580,286,294,49.31
Akali,Kaisa,2476,1337,1139,54
Akali,Bard,350,175,175,50
Akali,Hecarim,512,268,244,52.34
Akali,Yorick,1246,590,656,47.35
Akali,Yuumi,1138,558,580,49.03
Akali,Udyr,529,274,255,51.8
Akali,Heimerdinger,595,291,304,48.91
Akali,Lillia,799,386,413,48.31
Akali,Qiyana,347,162,185,46.69
Akali,Sett,2086,997,1089,47.79
Akali,XinZhao,958,507,451,52.92
Akali,Morgana,1708,793,915,46.43
Akali,Brand,1043,538,505,51.58
Akali,Kayle,866,424,442,48.96
Akali,Tristana,1337,651,686,48.69
Akali,Sylas,2683,1330,1353,49.57
Akali,Ornn,534,269,265,50.37
Akali,Evelynn,452,246,206,54.42
Akali,Velkoz,705,347,358,49.22
Akali,LeeSin,2397,1195,1202,49.85
Akali,Ahri,1802,926,876,51.39
Akali,Sion,922,447,475,48.48
Akali,Veigar,1338,602,736,44.99
Akali,Fizz,790,397,393,50.25
Akali,Urgot,671,291,380,43.37
Akali,Malphite,1277,636,641,49.8
Akali,Maokai,567,279,288,49.21
Akali,KogMaw,392,151,241,38.52
Akali,Syndra,689,381,308,55.3
Akali,Taric,272,141,131,51.84
Akali,Ambessa,881,461,420,52.33
Akali,Galio,1565,772,793,49.33
Akali,Kindred,542,289,253,53.32
Akali,KSante,816,446,370,54.66
Akali,Nilah,358,166,192,46.37
Akali,Zoe,491,245,246,49.9
Akali,Aphelios,628,295,333,46.97
Akali,Tryndamere,752,387,365,51.46
Akali,Nunu,731,361,370,49.38
Akali,Kassadin,279,158,121,56.63
Akali,Sivir,703,347,356,49.36
Akali,Renata,240,124,116,51.67
Akali,Belveth,327,150,177,45.87
Akali,Corki,522,270,252,51.72
Akali,Poppy,865,401,464,46.36
Akali,Naafiri,464,229,235,49.35
Akali,Nasus,872,422,450,48.39
Akali,Annie,501,240,261,47.9
Akali,Azir,468,250,218,53.42
Akali,Taliyah,361,159,202,44.04
Akali,Jayce,711,356,355,50.07
Akali,Nautilus,1456,742,714,50.96
Akali,Gwen,698,412,286,59.03
Akali,TwistedFate,479,265,214,55.32
Akali,Samira,859,417,442,48.54
Akali,MonkeyKing,954,449,505,47.06
Akali,Shyvana,372,174,198,46.77
Akali,Kled,238,117,121,49.16
Akali,Nidalee,495,243,252,49.09
Akali,AurelionSol,398,217,181,54.52
Akali,Karthus,440,201,239,45.68
Akali,Zac,705,317,388,44.96
Akali,Quinn,496,253,243,51.01
Akali,Kennen,376,191,185,50.8
Akali,Ryze,484,223,261,46.07
Akali,Rakan,561,270,291,48.13
Akali,Seraphine,1060,504,556,47.55
Akali,Leona,1121,540,581,48.17
Akali,Rengar,393,216,177,54.96
Akali,Olaf,328,202,126,61.59
Akali,Jax,1337,667,670,49.89
Akali,JarvanIV,742,380,362,51.21
Akali,Elise,981,471,510,48.01
Akali,Sejuani,512,246,266,48.05
Akali,Fiora,478,247,231,51.67
Akali,Talon,892,471,421,52.8
Akali,Zeri,604,320,284,52.98
Akali,RekSai,136,54,82,39.71
Akali,Xerath,1268,641,627,50.55
Akali,Kalista,400,205,195,51.25
Akali,Camille,462,197,265,42.64
Akali,Ivern,169,80,89,47.34
Akali,Anivia,383,177,206,46.21
Akali,Akshan,451,190,261,42.13
Akali,Riven,613,247,366,40.29
Akali,Rammus,416,219,197,52.64
Akali,DrMundo,734,385,349,52.45
Akali,Cassiopeia,309,149,160,48.22
Varus,Mordekaiser,1425,720,705,50.53
Varus,Vi,1059,522,537,49.29
Varus,Yone,2059,1002,1057,48.66
Varus,Caitlyn,3377,1647,1730,48.77
Varus,Alistar,424,194,230,45.75
Varus,Gangplank,538,276,262,51.3
Varus,Evelynn,342,177,165,51.75
Varus,Mel,2244,1107,1137,49.33
Varus,Ashe,2794,1347,1447,48.21
Varus,Elise,921,469,452,50.92
Varus,Irelia,916,428,488,46.72
Varus,Hecarim,526,245,281,46.58
Varus,Malzahar,1178,554,624,47.03
Varus,Vayne,1409,685,724,48.62
Varus,Pantheon,1852,885,967,47.79
Varus,KSante,711,379,332,53.31
Varus,Hwei,760,372,388,48.95
Varus,Sivir,634,321,313,50.63
Varus,Thresh,1568,743,825,47.39
Varus,Darius,2043,948,1095,46.4
Varus,Volibear,1324,588,736,44.41
Varus,Akali,1201,596,605,49.63
Varus,Jinx,3551,1728,1823,48.66
Varus,Lux,2772,1332,1440,48.05
Varus,Jax,1089,487,602,44.72
Varus,Viego,1687,868,819,51.45
Varus,Aurora,814,422,392,51.84
Varus,Yorick,1030,457,573,44.37
Varus,Briar,725,324,401,44.69
Varus,Jhin,2502,1232,1270,49.24
Varus,Nautilus,1174,593,581,50.51
Varus,Tryndamere,632,332,300,52.53
Varus,Kayn,1480,676,804,45.68
Varus,Viktor,1020,485,535,47.55
Varus,Ornn,522,275,247,52.68
Varus,Garen,1870,823,1047,44.01
Varus,Amumu,1102,495,607,44.92
Varus,Veigar,1124,544,580,48.4
Varus,Galio,1094,523,571,47.81
Varus,Sett,1715,782,933,45.6
Varus,Gragas,629,305,324,48.49
Varus,Yasuo,2145,1023,1122,47.69
Varus,Kalista,334,169,165,50.6
Varus,Sion,868,382,486,44.01
Varus,Nocturne,1477,649,828,43.94
Varus,Katarina,979,474,505,48.42
Varus,Ezreal,3399,1643,1756,48.34
Varus,Teemo,1322,614,708,46.44
Varus,Renekton,565,311,254,55.04
Varus,Shyvana,269,116,153,43.12
Varus,MissFortune,2730,1260,1470,46.15
Varus,Aatrox,1135,567,568,49.96
Varus,Blitzcrank,834,420,414,50.36
Varus,Shen,701,367,334,52.35
Varus,Morgana,1333,654,679,49.06
Varus,MasterYi,1441,680,761,47.19
Varus,Draven,639,295,344,46.17
Varus,XinZhao,792,371,421,46.84
Varus,AurelionSol,402,217,185,53.98
Varus,Belveth,302,131,171,43.38
Varus,Seraphine,837,424,413,50.66
Varus,JarvanIV,761,367,394,48.23
Varus,Fizz,617,294,323,47.65
Varus,Karma,1612,724,888,44.91
Varus,DrMundo,605,279,326,46.12
Varus,Lillia,590,321,269,54.41
Varus,Yuumi,997,495,502,49.65
Varus,Rengar,405,219,186,54.07
Varus,Pyke,850,404,446,47.53
Varus,Poppy,708,407,301,57.49
Varus,Zed,1302,610,692,46.85
Varus,Corki,501,302,199,60.28
Varus,Vladimir,675,329,346,48.74
Varus,Gnar,543,273,270,50.28
Varus,TwistedFate,392,204,188,52.04
Varus,Syndra,742,335,407,45.15
Varus,Lulu,1644,808,836,49.15
Varus,LeeSin,1951,957,994,49.05
Varus,Graves,846,421,425,49.76
Varus,FiddleSticks,507,270,237,53.25
Varus,Gwen,569,268,301,47.1
Varus,Rammus,352,199,153,56.53
Varus,Nami,1097,532,565,48.5
Varus,Vex,618,329,289,53.24
Varus,Kaisa,1962,913,1049,46.53
Varus,Rakan,435,228,207,52.41
Varus,Warwick,1497,690,807,46.09
Varus,Ekko,1108,512,596,46.21
Varus,Aphelios,615,319,296,51.87
Varus,Velkoz,638,314,324,49.22
Varus,Xayah,483,240,243,49.69
Varus,Leona,956,413,543,43.2
Varus,Kennen,328,145,183,44.21
Varus,MonkeyKing,807,385,422,47.71
Varus,KogMaw,371,156,215,42.05
Varus,Braum,641,295,346,46.02
Varus,Nasus,774,397,377,51.29
Varus,Soraka,626,282,344,45.05
Varus,Zyra,1176,623,553,52.98
Varus,Chogath,1267,609,658,48.07
Varus,Shaco,1002,507,495,50.6
Varus,Trundle,607,283,324,46.62
Varus,Ryze,426,208,218,48.83
Varus,Twitch,895,444,451,49.61
Varus,Milio,640,303,337,47.34
Varus,Kindred,467,214,253,45.82
Varus,Diana,1884,913,971,48.46
Varus,Zac,725,349,376,48.14
Varus,Maokai,527,268,259,50.85
Varus,Talon,726,367,359,50.55
Varus,Skarner,289,159,130,55.02
Varus,Kayle,726,347,379,47.8
Varus,Annie,369,166,203,44.99
Varus,Neeko,485,248,237,51.13
Varus,Tristana,1120,540,580,48.21
Varus,Camille,480,244,236,50.83
Varus,Udyr,445,229,216,51.46
Varus,TahmKench,860,437,423,50.81
Varus,Ahri,1464,728,736,49.73
Varus,Naafiri,351,181,170,51.57
Varus,Anivia,354,153,201,43.22
Varus,Orianna,531,249,282,46.89
Varus,Samira,719,369,350,51.32
Varus,Fiora,387,205,182,52.97
Varus,Sejuani,434,185,249,42.63
Varus,Lucian,780,372,408,47.69
Varus,Ambessa,781,397,384,50.83
Varus,Zoe,429,226,203,52.68
Varus,Karthus,345,153,192,44.35
Varus,Sona,349,162,187,46.42
Varus,Ziggs,414,171,243,41.3
Varus,Zeri,541,280,261,51.76
Varus,Azir,423,247,176,58.39
Varus,Riven,522,259,263,49.62
Varus,Urgot,450,179,271,39.78
Varus,Senna,843,419,424,49.7
Varus,Brand,750,389,361,51.87
Varus,Swain,1158,571,587,49.31
Varus,Bard,326,158,168,48.47
Varus,Malphite,1218,575,643,47.21
Varus,Rell,533,259,274,48.59
Varus,Singed,314,136,178,43.31
Varus,Sylas,1920,983,937,51.2
Varus,Illaoi,518,241,277,46.53
Varus,Zilean,367,149,218,40.6
Varus,Nunu,589,267,322,45.33
Varus,Kassadin,240,110,130,45.83
Varus,Smolder,697,333,364,47.78
Varus,Jayce,745,359,386,48.19
Varus,Taliyah,332,148,184,44.58
Varus,Rumble,363,186,177,51.24
Varus,Qiyana,268,149,119,55.6
Varus,Nidalee,351,201,150,57.26
Varus,Leblanc,753,382,371,50.73
Varus,Janna,388,169,219,43.56
Varus,Heimerdinger,421,187,234,44.42
Varus,Ivern,148,67,81,45.27
Varus,Olaf,367,174,193,47.41
Varus,Xerath,1142,514,628,45.01
Varus,Lissandra,370,163,207,44.05
Varus,RekSai,150,84,66,56
Varus,Khazix,613,292,321,47.63
Varus,Nilah,262,117,145,44.66
Varus,Kled,227,126,101,55.51
Varus,Quinn,405,184,221,45.43
Varus,Renata,153,70,83,45.75
Varus,Cassiopeia,318,137,181,43.08
Varus,Taric,225,140,85,62.22
Varus,Akshan,410,206,204,50.24
Lulu,Mordekaiser,1960,876,1084,44.69
Lulu,Vi,1666,814,852,48.86
Lulu,Yone,3068,1682,1386,54.82
Lulu,Caitlyn,4523,2197,2326,48.57
Lulu,Alistar,782,389,393,49.74
Lulu,Teemo,1853,920,933,49.65
Lulu,MonkeyKing,1364,736,628,53.96
Lulu,Katarina,1478,755,723,51.08
Lulu,Jinx,4949,2343,2606,47.34
Lulu,Blitzcrank,1404,654,750,46.58
Lulu,Tryndamere,931,465,466,49.95
Lulu,Lillia,964,443,521,45.95
Lulu,Viktor,1884,857,1027,45.49
Lulu,Tristana,1676,825,851,49.22
Lulu,Senna,1483,753,730,50.78
Lulu,Darius,3276,1578,1698,48.17
Lulu,LeeSin,3248,1687,1561,51.94
Lulu,Diana,3140,1566,1574,49.87
Lulu,KogMaw,608,304,304,50
Lulu,Thresh,2769,1318,1451,47.6
Lulu,MasterYi,1986,913,1073,45.97
Lulu,Khazix,950,485,465,51.05
Lulu,Aurora,1422,707,715,49.72
Lulu,Ashe,3736,1730,2006,46.31
Lulu,Gwen,825,426,399,51.64
Lulu,Akali,1869,952,917,50.94
Lulu,Rumble,573,273,300,47.64
Lulu,Kayn,2382,1220,1162,51.22
Lulu,Akshan,512,270,242,52.73
Lulu,Jhin,3841,1929,1912,50.22
Lulu,Yuumi,1874,942,932,50.27
Lulu,Skarner,480,279,201,58.13
Lulu,Galio,1565,682,883,43.58
Lulu,MissFortune,3631,1813,1818,49.93
Lulu,Lux,3895,1973,1922,50.65
Lulu,Singed,520,269,251,51.73
Lulu,Evelynn,624,326,298,52.24
Lulu,Nami,2754,1308,1446,47.49
Lulu,Trundle,806,367,439,45.53
Lulu,Shaco,1639,813,826,49.6
Lulu,Yasuo,3456,1780,1676,51.5
Lulu,Soraka,1211,600,611,49.55
Lulu,Jax,1702,940,762,55.23
Lulu,Warwick,2043,1023,1020,50.07
Lulu,Ezreal,5224,2749,2475,52.62
Lulu,Xerath,1581,725,856,45.86
Lulu,Karma,3167,1557,1610,49.16
Lulu,Talon,1260,644,616,51.11
Lulu,Vex,721,380,341,52.7
Lulu,Kaisa,3044,1687,1357,55.42
Lulu,Neeko,691,372,319,53.84
Lulu,Quinn,577,257,320,44.54
Lulu,Zed,2035,1046,989,51.4
Lulu,Camille,767,397,370,51.76
Lulu,Hwei,1236,594,642,48.06
Lulu,Zyra,1722,821,901,47.68
Lulu,Lissandra,706,341,365,48.3
Lulu,Volibear,1690,819,871,48.46
Lulu,Vladimir,1411,660,751,46.78
Lulu,Lucian,1496,797,699,53.28
Lulu,TahmKench,966,523,443,54.14
Lulu,Ziggs,610,290,320,47.54
Lulu,Twitch,1497,724,773,48.36
Lulu,Kayle,1172,546,626,46.59
Lulu,Malzahar,1831,889,942,48.55
Lulu,Garen,2687,1356,1331,50.47
Lulu,Sylas,2725,1379,1346,50.61
Lulu,Mel,3445,1855,1590,53.85
Lulu,Zilean,778,401,377,51.54
Lulu,Chogath,2064,999,1065,48.4
Lulu,Gangplank,1043,483,560,46.31
Lulu,Gragas,1115,572,543,51.3
Lulu,Olaf,476,216,260,45.38
Lulu,Riven,895,437,458,48.83
Lulu,Varus,1644,836,808,50.85
Lulu,Swain,1578,759,819,48.1
Lulu,Leona,1254,628,626,50.08
Lulu,Nautilus,2020,1022,998,50.59
Lulu,Ahri,2353,1164,1189,49.47
Lulu,Kled,344,168,176,48.84
Lulu,Ekko,1603,738,865,46.04
Lulu,Aphelios,1087,542,545,49.86
Lulu,Aatrox,1808,925,883,51.16
Lulu,Syndra,1320,622,698,47.12
Lulu,Seraphine,1323,594,729,44.9
Lulu,Renekton,914,515,399,56.35
Lulu,Nunu,782,387,395,49.49
Lulu,Graves,1388,699,689,50.36
Lulu,Amumu,1396,675,721,48.35
Lulu,Ornn,780,393,387,50.38
Lulu,FiddleSticks,988,484,504,48.99
Lulu,Milio,1525,746,779,48.92
Lulu,Draven,935,428,507,45.78
Lulu,Bard,562,273,289,48.58
Lulu,Udyr,690,354,336,51.3
Lulu,Irelia,1420,689,731,48.52
Lulu,Belveth,397,208,189,52.39
Lulu,Pantheon,2668,1367,1301,51.24
Lulu,Sion,1370,724,646,52.85
Lulu,Orianna,829,449,380,54.16
Lulu,AurelionSol,603,274,329,45.44
Lulu,Veigar,1493,749,744,50.17
Lulu,Brand,1176,601,575,51.11
Lulu,Elise,1427,694,733,48.63
Lulu,Ryze,704,395,309,56.11
Lulu,Taliyah,515,249,266,48.35
Lulu,Vayne,2077,1002,1075,48.24
Lulu,XinZhao,1311,669,642,51.03
Lulu,Nilah,463,209,254,45.14
Lulu,Kennen,521,236,285,45.3
Lulu,Braum,1107,514,593,46.43
Lulu,Nasus,1176,570,606,48.47
Lulu,Rengar,628,316,312,50.32
Lulu,Viego,2604,1265,1339,48.58
Lulu,Yorick,1490,743,747,49.87
Lulu,JarvanIV,1213,504,709,41.55
Lulu,Karthus,548,289,259,52.74
Lulu,Samira,1046,564,482,53.92
Lulu,Taric,434,218,216,50.23
Lulu,Gnar,795,402,393,50.57
Lulu,Nidalee,568,322,246,56.69
Lulu,Pyke,1324,704,620,53.17
Lulu,Kindred,875,402,473,45.94
Lulu,Annie,657,312,345,47.49
Lulu,Morgana,1815,898,917,49.48
Lulu,TwistedFate,716,350,366,48.88
Lulu,Maokai,805,358,447,44.47
Lulu,Janna,772,383,389,49.61
Lulu,DrMundo,761,374,387,49.15
Lulu,Illaoi,694,342,352,49.28
Lulu,Zac,954,481,473,50.42
Lulu,Anivia,573,290,283,50.61
Lulu,RekSai,212,102,110,48.11
Lulu,Nocturne,2244,1047,1197,46.66
Lulu,Azir,735,397,338,54.01
Lulu,Malphite,1807,817,990,45.21
Lulu,Corki,937,511,426,54.54
Lulu,Kassadin,342,173,169,50.58
Lulu,Renata,353,179,174,50.71
Lulu,Sejuani,744,361,383,48.52
Lulu,Sona,614,319,295,51.95
Lulu,Fizz,873,454,419,52
Lulu,Sivir,890,480,410,53.93
Lulu,Kalista,475,245,230,51.58
Lulu,Briar,1170,586,584,50.09
Lulu,Rammus,563,273,290,48.49
Lulu,Xayah,806,380,426,47.15
Lulu,Hecarim,861,394,467,45.76
Lulu,Rell,816,393,423,48.16
Lulu,Heimerdinger,622,320,302,51.45
Lulu,Naafiri,532,260,272,48.87
Lulu,Ambessa,1328,708,620,53.31
Lulu,Jayce,1099,483,616,43.95
Lulu,KSante,1184,638,546,53.89
Lulu,Ivern,317,154,163,48.58
Lulu,Rakan,657,344,313,52.36
Lulu,Urgot,901,458,443,50.83
Lulu,Poppy,982,500,482,50.92
Lulu,Zeri,804,422,382,52.49
Lulu,Sett,2282,1155,1127,50.61
Lulu,Fiora,696,393,303,56.47
Lulu,Shyvana,422,225,197,53.32
Lulu,Leblanc,1165,581,584,49.87
Lulu,Zoe,675,344,331,50.96
Lulu,Velkoz,1003,496,507,49.45
Lulu,Qiyana,506,228,278,45.06
Lulu,Smolder,1123,641,482,57.08
Lulu,Shen,1116,585,531,52.42
Lulu,Cassiopeia,492,263,229,53.46
Renekton,Gragas,333,173,160,51.95
Renekton,Pantheon,1095,585,510,53.42
Renekton,Yasuo,1801,973,828,54.03
Renekton,Caitlyn,1695,837,858,49.38
Renekton,Mel,1246,589,657,47.27
Renekton,Mordekaiser,839,335,504,39.93
Renekton,Karthus,189,108,81,57.14
Renekton,Katarina,541,275,266,50.83
Renekton,Jhin,1376,690,686,50.15
Renekton,Karma,926,453,473,48.92
Renekton,Volibear,683,277,406,40.56
Renekton,Yorick,660,292,368,44.24
Renekton,Zoe,278,108,170,38.85
Renekton,Samira,477,237,240,49.69
Renekton,Ambessa,674,368,306,54.6
Renekton,XinZhao,445,228,217,51.24
Renekton,Vladimir,441,191,250,43.31
Renekton,Ezreal,1697,865,832,50.97
Renekton,Kayn,836,404,432,48.33
Renekton,JarvanIV,458,208,250,45.41
Renekton,Orianna,302,170,132,56.29
Renekton,Yuumi,507,275,232,54.24
Renekton,Jax,601,332,269,55.24
Renekton,Rengar,201,112,89,55.72
Renekton,Camille,293,127,166,43.34
Renekton,Sivir,339,140,199,41.3
Renekton,Quinn,234,92,142,39.32
Renekton,Trundle,377,196,181,51.99
Renekton,Kassadin,142,72,70,50.7
Renekton,Senna,427,216,211,50.59
Renekton,Fiora,248,126,122,50.81
Renekton,Nocturne,777,376,401,48.39
Renekton,Sylas,1056,562,494,53.22
Renekton,Jinx,1840,930,910,50.54
Renekton,Varus,565,254,311,44.96
Renekton,Kennen,135,55,80,40.74
Renekton,Lux,1488,717,771,48.19
Renekton,Ashe,1559,734,825,47.08
Renekton,Leona,631,306,325,48.49
Renekton,Nasus,475,210,265,44.21
Renekton,Warwick,890,416,474,46.74
Renekton,Akali,723,378,345,52.28
Renekton,Corki,268,140,128,52.24
Renekton,RekSai,87,53,34,60.92
Renekton,Ahri,852,397,455,46.6
Renekton,Malphite,612,299,313,48.86
Renekton,Riven,493,259,234,52.54
Renekton,Kaisa,1228,660,568,53.75
Renekton,Hwei,413,182,231,44.07
Renekton,Milio,355,162,193,45.63
Renekton,Illaoi,338,153,185,45.27
Renekton,Darius,1296,648,648,50
Renekton,Syndra,413,178,235,43.1
Renekton,Zyra,558,275,283,49.28
Renekton,Briar,406,194,212,47.78
Renekton,Lucian,466,237,229,50.86
Renekton,Aatrox,803,450,353,56.04
Renekton,Elise,557,263,294,47.22
Renekton,Yone,1506,868,638,57.64
Renekton,MissFortune,1414,686,728,48.51
Renekton,Zilean,195,103,92,52.82
Renekton,Ekko,651,336,315,51.61
Renekton,Zeri,309,133,176,43.04
Renekton,Lulu,914,399,515,43.65
Renekton,Gangplank,277,122,155,44.04
Renekton,Kalista,176,88,88,50
Renekton,Poppy,448,224,224,50
Renekton,Diana,1051,507,544,48.24
Renekton,Zed,746,385,361,51.61
Renekton,Tristana,622,311,311,50
Renekton,Sett,1197,587,610,49.04
Renekton,Amumu,685,317,368,46.28
Renekton,Blitzcrank,499,240,259,48.1
Renekton,Gnar,280,144,136,51.43
Renekton,Leblanc,364,171,193,46.98
Renekton,Gwen,296,149,147,50.34
Renekton,Naafiri,168,89,79,52.98
Renekton,Swain,623,274,349,43.98
Renekton,Twitch,533,261,272,48.97
Renekton,Nautilus,780,402,378,51.54
Renekton,Shaco,627,301,326,48.01
Renekton,Ziggs,218,104,114,47.71
Renekton,Brand,367,188,179,51.23
Renekton,Galio,587,300,287,51.11
Renekton,Taric,147,72,75,48.98
Renekton,TwistedFate,219,116,103,52.97
Renekton,Vayne,716,318,398,44.41
Renekton,Nami,665,291,374,43.76
Renekton,Janna,213,116,97,54.46
Renekton,Rammus,184,87,97,47.28
Renekton,Neeko,271,121,150,44.65
Renekton,LeeSin,1233,607,626,49.23
Renekton,Aurora,507,249,258,49.11
Renekton,Thresh,917,462,455,50.38
Renekton,Viego,1017,513,504,50.44
Renekton,Jayce,372,186,186,50
Renekton,Veigar,578,293,285,50.69
Renekton,Kayle,349,189,160,54.15
Renekton,Braum,374,162,212,43.32
Renekton,Garen,1069,451,618,42.19
Renekton,MasterYi,763,390,373,51.11
Renekton,MonkeyKing,465,239,226,51.4
Renekton,Viktor,587,277,310,47.19
Renekton,Sion,379,169,210,44.59
Renekton,Shen,319,145,174,45.45
Renekton,KSante,438,244,194,55.71
Renekton,Lillia,392,197,195,50.26
Renekton,Xayah,297,150,147,50.51
Renekton,Rakan,223,94,129,42.15
Renekton,Taliyah,197,86,111,43.65
Renekton,Malzahar,568,293,275,51.58
Renekton,Maokai,284,170,114,59.86
Renekton,Shyvana,130,69,61,53.08
Renekton,Xerath,607,317,290,52.22
Renekton,FiddleSticks,302,143,159,47.35
Renekton,Graves,453,184,269,40.62
Renekton,Velkoz,374,159,215,42.51
Renekton,Teemo,605,253,352,41.82
Renekton,Talon,444,229,215,51.58
Renekton,Smolder,391,210,181,53.71
Renekton,Soraka,355,163,192,45.92
Renekton,Lissandra,264,120,144,45.45
Renekton,Ornn,247,114,133,46.15
Renekton,Azir,237,108,129,45.57
Renekton,Renata,114,51,63,44.74
Renekton,Sejuani,328,141,187,42.99
Renekton,DrMundo,255,113,142,44.31
Renekton,TahmKench,433,243,190,56.12
Renekton,Irelia,484,258,226,53.31
Renekton,Udyr,235,122,113,51.91
Renekton,Ryze,276,136,140,49.28
Renekton,Heimerdinger,278,126,152,45.32
Renekton,Sona,253,130,123,51.38
Renekton,Draven,314,128,186,40.76
Renekton,Rell,329,191,138,58.05
Renekton,Zac,382,229,153,59.95
Renekton,Qiyana,161,83,78,51.55
Renekton,Khazix,284,119,165,41.9
Renekton,Chogath,663,297,366,44.8
Renekton,Vi,660,369,291,55.91
Renekton,Pyke,510,266,244,52.16
Renekton,Olaf,135,75,60,55.56
Renekton,Kindred,242,127,115,52.48
Renekton,Morgana,729,339,390,46.5
Renekton,Cassiopeia,181,68,113,37.57
Renekton,Evelynn,208,92,116,44.23
Renekton,Alistar,279,147,132,52.69
Renekton,Seraphine,437,229,208,52.4
Renekton,Kled,118,54,64,45.76
Renekton,Fizz,390,201,189,51.54
Renekton,Belveth,132,79,53,59.85
Renekton,Nunu,344,152,192,44.19
Renekton,Annie,259,108,151,41.7
Renekton,Singed,160,75,85,46.88
Renekton,Hecarim,270,143,127,52.96
Renekton,Skarner,185,105,80,56.76
Renekton,Urgot,296,153,143,51.69
Renekton,Vex,386,193,193,50
Renekton,AurelionSol,225,89,136,39.56
Renekton,Nidalee,235,133,102,56.6
Renekton,Anivia,192,89,103,46.35
Renekton,Akshan,209,105,104,50.24
Renekton,KogMaw,193,83,110,43.01
Renekton,Rumble,141,57,84,40.43
Renekton,Aphelios,325,157,168,48.31
Renekton,Tryndamere,255,120,135,47.06
Renekton,Bard,211,107,104,50.71
Renekton,Ivern,93,41,52,44.09
Renekton,Nilah,161,80,81,49.69
Viktor,Pantheon,1925,926,999,48.1
Viktor,Belveth,271,126,145,46.49
Viktor,Katarina,710,366,344,51.55
Viktor,KogMaw,356,175,181,49.16
Viktor,Lux,2807,1355,1452,48.27
Viktor,Gragas,698,386,312,55.3
Viktor,Yasuo,1944,1002,942,51.54
Viktor,Caitlyn,3113,1549,1564,49.76
Viktor,Mel,2622,1396,1226,53.24
Viktor,Yorick,965,454,511,47.05
Viktor,Rammus,345,156,189,45.22
Viktor,Lulu,1884,1027,857,54.51
Viktor,Gwen,669,347,322,51.87
Viktor,LeeSin,2081,1041,1040,50.02
Viktor,Akali,1319,614,705,46.55
Viktor,Thresh,1596,805,791,50.44
Viktor,Darius,2077,1050,1027,50.55
Viktor,Nocturne,1438,684,754,47.57
Viktor,Lucian,870,467,403,53.68
Viktor,Nautilus,1378,733,645,53.19
Viktor,FiddleSticks,570,282,288,49.47
Viktor,Vladimir,708,399,309,56.36
Viktor,Jhin,2479,1178,1301,47.52
Viktor,Morgana,1262,628,634,49.76
Viktor,Yone,2194,1155,1039,52.64
Viktor,Warwick,1408,680,728,48.3
Viktor,Hwei,1055,560,495,53.08
Viktor,Varus,1020,532,488,52.16
Viktor,Malphite,1043,522,521,50.05
Viktor,Shen,717,365,352,50.91
Viktor,Ekko,1257,600,657,47.73
Viktor,Zed,1180,605,575,51.27
Viktor,Zac,607,296,311,48.76
Viktor,Anivia,414,181,233,43.72
Viktor,Tristana,1031,508,523,49.27
Viktor,Blitzcrank,838,428,410,51.07
Viktor,Gangplank,708,283,425,39.97
Viktor,Hecarim,554,251,303,45.31
Viktor,Aurora,964,488,476,50.62
Viktor,Brand,768,370,398,48.18
Viktor,Ambessa,824,397,427,48.18
Viktor,Evelynn,410,179,231,43.66
Viktor,Xayah,487,241,246,49.49
Viktor,Velkoz,737,347,390,47.08
Viktor,DrMundo,576,299,277,51.91
Viktor,Jax,1076,550,526,51.12
Viktor,AurelionSol,464,219,245,47.2
Viktor,Rakan,447,224,223,50.11
Viktor,Urgot,617,292,325,47.33
Viktor,Amumu,1119,564,555,50.4
Viktor,Gnar,516,253,263,49.03
Viktor,Viego,1762,917,845,52.04
Viktor,Twitch,918,466,452,50.76
Viktor,Heimerdinger,476,252,224,52.94
Viktor,Smolder,800,442,358,55.25
Viktor,Kayle,729,368,361,50.48
Viktor,Aatrox,1120,551,569,49.2
Viktor,Samira,693,368,325,53.1
Viktor,Illaoi,454,236,218,51.98
Viktor,Kaisa,2070,1049,1021,50.68
Viktor,MasterYi,1490,721,769,48.39
Viktor,Diana,1826,893,933,48.9
Viktor,Ashe,2510,1202,1308,47.89
Viktor,TahmKench,771,391,380,50.71
Viktor,Shaco,1034,561,473,54.26
Viktor,Trundle,589,274,315,46.52
Viktor,Kindred,438,193,245,44.06
Viktor,Ezreal,3245,1595,1650,49.15
Viktor,Swain,1037,520,517,50.14
Viktor,Ahri,1423,674,749,47.36
Viktor,Jinx,3589,1780,1809,49.6
Viktor,Seraphine,773,388,385,50.19
Viktor,Orianna,641,345,296,53.82
Viktor,Leona,978,487,491,49.8
Viktor,Xerath,1212,599,613,49.42
Viktor,Garen,1885,914,971,48.49
Viktor,Kled,233,127,106,54.51
Viktor,Zoe,436,210,226,48.17
Viktor,KSante,728,408,320,56.04
Viktor,MissFortune,2350,1207,1143,51.36
Viktor,Nasus,780,394,386,50.51
Viktor,Mordekaiser,1288,621,667,48.21
Viktor,Vayne,1577,814,763,51.62
Viktor,Maokai,635,305,330,48.03
Viktor,Graves,843,393,450,46.62
Viktor,Corki,492,246,246,50
Viktor,Volibear,1174,616,558,52.47
Viktor,Pyke,836,454,382,54.31
Viktor,Karma,1729,834,895,48.24
Viktor,Teemo,1310,653,657,49.85
Viktor,Singed,327,171,156,52.29
Viktor,Ziggs,393,185,208,47.07
Viktor,Sivir,661,311,350,47.05
Viktor,Nami,1214,566,648,46.62
Viktor,Syndra,1020,487,533,47.75
Viktor,Kayn,1491,750,741,50.3
Viktor,Rell,561,277,284,49.38
Viktor,Olaf,333,160,173,48.05
Viktor,Malzahar,1427,726,701,50.88
Viktor,Veigar,1097,540,557,49.23
Viktor,Fiora,480,210,270,43.75
Viktor,Elise,943,428,515,45.39
Viktor,Lissandra,400,207,193,51.75
Viktor,Vi,1103,575,528,52.13
Viktor,MonkeyKing,930,490,440,52.69
Viktor,Poppy,778,384,394,49.36
Viktor,Renekton,587,310,277,52.81
Viktor,Aphelios,619,331,288,53.47
Viktor,Soraka,658,294,364,44.68
Viktor,Tryndamere,625,331,294,52.96
Viktor,Kassadin,262,104,158,39.69
Viktor,Draven,604,292,312,48.34
Viktor,JarvanIV,793,390,403,49.18
Viktor,Yuumi,953,480,473,50.37
Viktor,Janna,421,205,216,48.69
Viktor,Sejuani,516,219,297,42.44
Viktor,Ryze,473,246,227,52.01
Viktor,XinZhao,844,433,411,51.3
Viktor,Leblanc,800,444,356,55.5
Viktor,Rumble,333,162,171,48.65
Viktor,Kennen,345,177,168,51.3
Viktor,Riven,541,253,288,46.77
Viktor,Lillia,728,380,348,52.2
Viktor,Chogath,1297,644,653,49.65
Viktor,Sett,1574,757,817,48.09
Viktor,Ivern,159,74,85,46.54
Viktor,Galio,1004,502,502,50
Viktor,Braum,709,374,335,52.75
Viktor,Ornn,503,242,261,48.11
Viktor,Taliyah,277,100,177,36.1
Viktor,Jayce,659,344,315,52.2
Viktor,Khazix,595,277,318,46.55
Viktor,Bard,359,188,171,52.37
Viktor,Sylas,1775,861,914,48.51
Viktor,Sona,360,194,166,53.89
Viktor,TwistedFate,492,289,203,58.74
Viktor,Rengar,341,173,168,50.73
Viktor,Briar,723,369,354,51.04
Viktor,Zilean,421,205,216,48.69
Viktor,Zyra,1194,578,616,48.41
Viktor,Talon,787,373,414,47.4
Viktor,Camille,506,208,298,41.11
Viktor,Senna,900,433,467,48.11
Viktor,Udyr,481,270,211,56.13
Viktor,Sion,796,411,385,51.63
Viktor,Taric,261,127,134,48.66
Viktor,Renata,227,129,98,56.83
Viktor,Irelia,996,468,528,46.99
Viktor,Cassiopeia,395,184,211,46.58
Viktor,Skarner,319,192,127,60.19
Viktor,Kalista,284,137,147,48.24
Viktor,Neeko,471,239,232,50.74
Viktor,Qiyana,284,157,127,55.28
Viktor,Nunu,534,222,312,41.57
Viktor,Quinn,424,199,225,46.93
Viktor,Azir,494,282,212,57.09
Viktor,Naafiri,339,146,193,43.07
Viktor,Zeri,545,302,243,55.41
Viktor,Alistar,541,285,256,52.68
Viktor,Milio,688,316,372,45.93
Viktor,Fizz,580,287,293,49.48
Viktor,Vex,577,285,292,49.39
Viktor,Nidalee,411,246,165,59.85
Viktor,Annie,435,197,238,45.29
Viktor,Karthus,338,159,179,47.04
Viktor,Akshan,380,203,177,53.42
Viktor,Nilah,273,107,166,39.19
Viktor,Shyvana,288,156,132,54.17
Viktor,RekSai,142,83,59,58.45
Poppy,Sett,1097,513,584,46.76
Poppy,MasterYi,834,383,451,45.92
Poppy,Vladimir,544,264,280,48.53
Poppy,Zilean,240,105,135,43.75
Poppy,Senna,543,285,258,52.49
Poppy,Aatrox,598,296,302,49.5
Poppy,Graves,482,247,235,51.24
Poppy,Ekko,691,366,325,52.97
Poppy,Ezreal,1701,840,861,49.38
Poppy,Bard,259,126,133,48.65
Poppy,Volibear,809,408,401,50.43
Poppy,Yorick,670,327,343,48.81
Poppy,Lux,1606,784,822,48.82
Poppy,Jinx,2093,997,1096,47.63
Poppy,Pantheon,1289,657,632,50.97
Poppy,MonkeyKing,513,220,293,42.88
Poppy,Kassadin,173,84,89,48.55
Poppy,Lucian,633,301,332,47.55
Poppy,Nami,644,322,322,50
Poppy,Ambessa,488,289,199,59.22
Poppy,JarvanIV,486,247,239,50.82
Poppy,Sylas,1017,577,440,56.74
Poppy,Ashe,1597,818,779,51.22
Poppy,Alistar,390,175,215,44.87
Poppy,Rammus,234,124,110,52.99
Poppy,Zed,865,439,426,50.75
Poppy,Tristana,854,471,383,55.15
Poppy,Swain,636,292,344,45.91
Poppy,Diana,1234,570,664,46.19
Poppy,Amumu,797,391,406,49.06
Poppy,Syndra,521,273,248,52.4
Poppy,TahmKench,569,298,271,52.37
Poppy,Malphite,665,332,333,49.92
Poppy,Corki,396,218,178,55.05
Poppy,Soraka,374,161,213,43.05
Poppy,Gnar,380,201,179,52.89
Poppy,LeeSin,1588,899,689,56.61
Poppy,Ahri,972,543,429,55.86
Poppy,Varus,708,301,407,42.51
Poppy,Renata,182,98,84,53.85
Poppy,Maokai,401,202,199,50.37
Poppy,Ziggs,255,139,116,54.51
Poppy,Sona,212,99,113,46.7
Poppy,KSante,530,307,223,57.92
Poppy,Nocturne,975,424,551,43.49
Poppy,Katarina,528,266,262,50.38
Poppy,Leona,934,471,463,50.43
Poppy,Khazix,391,198,193,50.64
Poppy,Caitlyn,1881,971,910,51.62
Poppy,Zyra,698,298,400,42.69
Poppy,Darius,1256,621,635,49.44
Poppy,Sejuani,323,169,154,52.32
Poppy,Malzahar,747,341,406,45.65
Poppy,Morgana,761,405,356,53.22
Poppy,Neeko,300,162,138,54
Poppy,Elise,558,281,277,50.36
Poppy,Mel,1437,751,686,52.26
Poppy,MissFortune,1569,797,772,50.8
Poppy,Pyke,723,398,325,55.05
Poppy,Ivern,95,60,35,63.16
Poppy,TwistedFate,313,158,155,50.48
Poppy,Jhin,1397,708,689,50.68
Poppy,Kayle,479,272,207,56.78
Poppy,Jayce,458,227,231,49.56
Poppy,Garen,1198,618,580,51.59
Poppy,Warwick,1052,471,581,44.77
Poppy,Veigar,697,295,402,42.32
Poppy,Draven,357,194,163,54.34
Poppy,Teemo,780,391,389,50.13
Poppy,Yasuo,1516,768,748,50.66
Poppy,Rell,462,240,222,51.95
Poppy,Fiora,262,146,116,55.73
Poppy,Kayn,1047,571,476,54.54
Poppy,Zoe,284,154,130,54.23
Poppy,Thresh,1099,570,529,51.87
Poppy,Renekton,448,224,224,50
Poppy,Gwen,382,207,175,54.19
Poppy,Akshan,230,117,113,50.87
Poppy,Chogath,917,416,501,45.37
Poppy,Trundle,437,247,190,56.52
Poppy,AurelionSol,259,125,134,48.26
Poppy,Brand,461,237,224,51.41
Poppy,Orianna,377,209,168,55.44
Poppy,Briar,477,227,250,47.59
Poppy,Nasus,522,250,272,47.89
Poppy,Braum,512,241,271,47.07
Poppy,Camille,258,126,132,48.84
Poppy,Annie,232,106,126,45.69
Poppy,Blitzcrank,539,311,228,57.7
Poppy,Vi,834,443,391,53.12
Poppy,Velkoz,376,169,207,44.95
Poppy,Mordekaiser,893,441,452,49.38
Poppy,Vayne,1121,553,568,49.33
Poppy,Fizz,412,228,184,55.34
Poppy,Twitch,544,274,270,50.37
Poppy,Ornn,326,180,146,55.21
Poppy,Aurora,530,273,257,51.51
Poppy,Xayah,379,210,169,55.41
Poppy,Azir,238,130,108,54.62
Poppy,Aphelios,404,184,220,45.54
Poppy,Kalista,252,148,104,58.73
Poppy,Milio,376,157,219,41.76
Poppy,Jax,756,353,403,46.69
Poppy,Udyr,245,129,116,52.65
Poppy,Karthus,234,112,122,47.86
Poppy,Irelia,686,369,317,53.79
Poppy,Akali,865,464,401,53.64
Poppy,Talon,496,290,206,58.47
Poppy,Vex,354,189,165,53.39
Poppy,Kaisa,1484,779,705,52.49
Poppy,Viktor,778,394,384,50.64
Poppy,Taliyah,199,105,94,52.76
Poppy,Skarner,192,119,73,61.98
Poppy,Leblanc,581,294,287,50.6
Poppy,Sivir,382,184,198,48.17
Poppy,DrMundo,357,172,185,48.18
Poppy,Nautilus,962,527,435,54.78
Poppy,Singed,210,103,107,49.05
Poppy,Belveth,171,112,59,65.5
Poppy,Tryndamere,365,193,172,52.88
Poppy,Viego,1082,594,488,54.9
Poppy,Illaoi,364,181,183,49.73
Poppy,KogMaw,224,103,121,45.98
Poppy,Lulu,982,482,500,49.08
Poppy,Heimerdinger,311,131,180,42.12
Poppy,Seraphine,501,238,263,47.5
Poppy,Xerath,627,304,323,48.48
Poppy,Gangplank,403,174,229,43.18
Poppy,Nunu,346,181,165,52.31
Poppy,Karma,905,452,453,49.94
Poppy,Yone,1420,797,623,56.13
Poppy,Anivia,259,122,137,47.1
Poppy,Qiyana,201,97,104,48.26
Poppy,Riven,382,204,178,53.4
Poppy,Urgot,312,158,154,50.64
Poppy,FiddleSticks,341,167,174,48.97
Poppy,RekSai,144,85,59,59.03
Poppy,Shaco,637,325,312,51.02
Poppy,Sion,474,205,269,43.25
Poppy,Nilah,165,89,76,53.94
Poppy,Taric,168,60,108,35.71
Poppy,Gragas,422,218,204,51.66
Poppy,Samira,528,308,220,58.33
Poppy,Olaf,222,84,138,37.84
Poppy,Evelynn,238,104,134,43.7
Poppy,Hecarim,302,135,167,44.7
Poppy,Yuumi,624,344,280,55.13
Poppy,Lissandra,235,106,129,45.11
Poppy,Kennen,194,82,112,42.27
Poppy,Zac,505,294,211,58.22
Poppy,Rumble,268,135,133,50.37
Poppy,Ryze,290,110,180,37.93
Poppy,XinZhao,585,294,291,50.26
Poppy,Hwei,485,223,262,45.98
Poppy,Shen,438,222,216,50.68
Poppy,Kled,166,96,70,57.83
Poppy,Galio,721,364,357,50.49
Poppy,Kindred,351,159,192,45.3
Poppy,Lillia,510,275,235,53.92
Poppy,Rakan,427,220,207,51.52
Poppy,Janna,271,158,113,58.3
Poppy,Naafiri,245,132,113,53.88
Poppy,Rengar,270,139,131,51.48
Poppy,Zeri,393,238,155,60.56
Poppy,Smolder,382,165,217,43.19
Poppy,Quinn,218,85,133,38.99
Poppy,Shyvana,173,77,96,44.51
Poppy,Cassiopeia,215,105,110,48.84
Poppy,Nidalee,284,133,151,46.83
Zac,Sett,945,474,471,50.16
Zac,MasterYi,580,296,284,51.03
Zac,Vladimir,473,245,228,51.8
Zac,Zilean,232,128,104,55.17
Zac,Senna,400,205,195,51.25
Zac,Gnar,280,142,138,50.71
Zac,Diana,1033,503,530,48.69
Zac,Chogath,702,350,352,49.86
Zac,Jinx,1569,839,730,53.47
Zac,Nami,557,291,266,52.24
Zac,Yasuo,1155,554,601,47.97
Zac,Kayn,808,342,466,42.33
Zac,Mel,1286,634,652,49.3
Zac,Xayah,360,194,166,53.89
Zac,Rakan,237,122,115,51.48
Zac,Pantheon,1050,484,566,46.1
Zac,Viktor,607,311,296,51.24
Zac,Samira,423,232,191,54.85
Zac,Janna,258,131,127,50.78
Zac,Camille,253,149,104,58.89
Zac,Briar,422,223,199,52.84
Zac,Katarina,450,261,189,58
Zac,Lux,1297,619,678,47.73
Zac,Heimerdinger,253,133,120,52.57
Zac,Rammus,143,69,74,48.25
Zac,Sylas,1111,565,546,50.86
Zac,Vayne,805,419,386,52.05
Zac,Morgana,636,332,304,52.2
Zac,Nasus,415,234,181,56.39
Zac,Kaisa,1138,581,557,51.05
Zac,JarvanIV,388,197,191,50.77
Zac,Ezreal,1793,915,878,51.03
Zac,Bard,162,87,75,53.7
Zac,Gangplank,332,150,182,45.18
Zac,Sejuani,290,131,159,45.17
Zac,Ekko,620,303,317,48.87
Zac,Lulu,954,473,481,49.58
Zac,Warwick,735,403,332,54.83
Zac,Shaco,567,301,266,53.09
Zac,Twitch,411,200,211,48.66
Zac,Ivern,77,46,31,59.74
Zac,Zed,666,345,321,51.8
Zac,MissFortune,1212,582,630,48.02
Zac,Neeko,215,132,83,61.4
Zac,MonkeyKing,517,287,230,55.51
Zac,Varus,725,376,349,51.86
Zac,Nautilus,750,398,352,53.07
Zac,KSante,465,227,238,48.82
Zac,Gragas,393,200,193,50.89
Zac,Illaoi,264,138,126,52.27
Zac,Graves,491,247,244,50.31
Zac,TahmKench,378,202,176,53.44
Zac,Azir,341,179,162,52.49
Zac,Ambessa,403,216,187,53.6
Zac,Vi,627,306,321,48.8
Zac,Fiora,258,141,117,54.65
Zac,Karthus,206,115,91,55.83
Zac,TwistedFate,234,122,112,52.14
Zac,Jhin,1208,644,564,53.31
Zac,Zyra,637,299,338,46.94
Zac,Garen,980,491,489,50.1
Zac,Ziggs,215,98,117,45.58
Zac,Ashe,1429,741,688,51.85
Zac,Karma,900,464,436,51.56
Zac,Aurora,478,243,235,50.84
Zac,Alistar,349,165,184,47.28
Zac,Trundle,268,141,127,52.61
Zac,Khazix,263,138,125,52.47
Zac,Lissandra,200,107,93,53.5
Zac,Thresh,904,449,455,49.67
Zac,Nocturne,828,438,390,52.9
Zac,Talon,378,199,179,52.65
Zac,Smolder,437,210,227,48.05
Zac,Soraka,352,202,150,57.39
Zac,Akali,705,388,317,55.04
Zac,LeeSin,1191,599,592,50.29
Zac,Elise,513,241,272,46.98
Zac,Leblanc,455,225,230,49.45
Zac,Zeri,316,148,168,46.84
Zac,Sion,456,249,207,54.61
Zac,Mordekaiser,650,340,310,52.31
Zac,Lillia,411,198,213,48.18
Zac,Veigar,522,283,239,54.21
Zac,Sona,191,100,91,52.36
Zac,Volibear,685,315,370,45.99
Zac,Qiyana,139,84,55,60.43
Zac,Lucian,457,262,195,57.33
Zac,Rell,335,181,154,54.03
Zac,Renata,112,48,64,42.86
Zac,Darius,1034,513,521,49.61
Zac,Tristana,480,268,212,55.83
Zac,Jax,638,332,306,52.04
Zac,Teemo,709,349,360,49.22
Zac,Fizz,318,140,178,44.03
Zac,Tryndamere,238,117,121,49.16
Zac,Amumu,611,323,288,52.86
Zac,Ryze,228,123,105,53.95
Zac,Blitzcrank,456,249,207,54.61
Zac,Yorick,590,309,281,52.37
Zac,Nidalee,254,162,92,63.78
Zac,Ahri,767,378,389,49.28
Zac,Braum,349,165,184,47.28
Zac,Hwei,424,197,227,46.46
Zac,Swain,559,226,333,40.43
Zac,Malzahar,605,283,322,46.78
Zac,Leona,480,261,219,54.38
Zac,Poppy,505,211,294,41.78
Zac,Pyke,483,253,230,52.38
Zac,Aatrox,659,323,336,49.01
Zac,Shyvana,177,99,78,55.93
Zac,DrMundo,278,122,156,43.88
Zac,Rengar,197,101,96,51.27
Zac,Ornn,298,149,149,50
Zac,Viego,1006,548,458,54.47
Zac,Milio,301,147,154,48.84
Zac,Renekton,382,153,229,40.05
Zac,Draven,318,149,169,46.86
Zac,Sivir,356,172,184,48.31
Zac,Annie,198,114,84,57.58
Zac,Udyr,256,132,124,51.56
Zac,Caitlyn,1697,836,861,49.26
Zac,Riven,246,147,99,59.76
Zac,Xerath,616,310,306,50.32
Zac,Shen,345,145,200,42.03
Zac,Brand,463,201,262,43.41
Zac,Nunu,335,155,180,46.27
Zac,Syndra,387,183,204,47.29
Zac,KogMaw,154,89,65,57.79
Zac,Cassiopeia,157,66,91,42.04
Zac,Maokai,258,114,144,44.19
Zac,Malphite,629,315,314,50.08
Zac,Galio,612,315,297,51.47
Zac,Rumble,220,90,130,40.91
Zac,Yone,1194,669,525,56.03
Zac,Aphelios,337,172,165,51.04
Zac,Velkoz,334,168,166,50.3
Zac,Evelynn,211,101,110,47.87
Zac,Akshan,216,90,126,41.67
Zac,Quinn,186,82,104,44.09
Zac,Nilah,187,87,100,46.52
Zac,Jayce,339,190,149,56.05
Zac,FiddleSticks,363,162,201,44.63
Zac,Kassadin,134,83,51,61.94
Zac,Hecarim,261,141,120,54.02
Zac,Kalista,121,63,58,52.07
Zac,Yuumi,584,279,305,47.77
Zac,Irelia,516,287,229,55.62
Zac,Skarner,217,111,106,51.15
Zac,Olaf,122,51,71,41.8
Zac,Taliyah,154,83,71,53.9
Zac,XinZhao,487,262,225,53.8
Zac,Seraphine,408,207,201,50.74
Zac,Taric,125,66,59,52.8
Zac,Singed,144,75,69,52.08
Zac,Gwen,365,193,172,52.88
Zac,Orianna,263,138,125,52.47
Zac,Naafiri,173,88,85,50.87
Zac,Corki,334,142,192,42.51
Zac,Kled,119,72,47,60.5
Zac,Kayle,352,191,161,54.26
Zac,Kennen,181,102,79,56.35
Zac,Zoe,226,106,120,46.9
Zac,AurelionSol,200,92,108,46
Zac,Anivia,198,84,114,42.42
Zac,Belveth,106,38,68,35.85
Zac,Vex,283,134,149,47.35
Zac,Urgot,246,123,123,50
Zac,Kindred,283,133,150,47
Zac,RekSai,82,45,37,54.88
Sett,Poppy,1097,584,513,53.24
Sett,Zac,945,471,474,49.84
Sett,Chogath,2526,1298,1228,51.39
Sett,Xayah,923,492,431,53.3
Sett,Nami,1699,903,796,53.15
Sett,Urgot,1118,554,564,49.55
Sett,Briar,1258,616,642,48.97
Sett,Ahri,2492,1256,1236,50.4
Sett,Caitlyn,5298,2795,2503,52.76
Sett,Lux,4725,2363,2362,50.01
Sett,Darius,4549,2440,2109,53.64
Sett,Lillia,1005,545,460,54.23
Sett,Garen,3505,1847,1658,52.7
Sett,Pyke,1407,722,685,51.31
Sett,Gnar,692,347,345,50.14
Sett,Volibear,2554,1238,1316,48.47
Sett,Fizz,1083,589,494,54.39
Sett,Aphelios,929,515,414,55.44
Sett,Zyra,1871,927,944,49.55
Sett,Amumu,2070,1110,960,53.62
Sett,Veigar,2025,1018,1007,50.27
Sett,Jinx,5329,2593,2736,48.66
Sett,Galio,1750,901,849,51.49
Sett,Warwick,2944,1467,1477,49.83
Sett,Shen,1284,680,604,52.96
Sett,Velkoz,1164,637,527,54.73
Sett,Varus,1715,933,782,54.4
Sett,Rakan,643,318,325,49.46
Sett,Vi,1805,901,904,49.92
Sett,Ryze,615,332,283,53.98
Sett,MissFortune,4633,2308,2325,49.82
Sett,Thresh,2434,1202,1232,49.38
Sett,Mordekaiser,2852,1414,1438,49.58
Sett,Kayn,2677,1349,1328,50.39
Sett,Aurora,1259,642,617,50.99
Sett,Morgana,2398,1233,1165,51.42
Sett,Heimerdinger,950,470,480,49.47
Sett,Kindred,822,413,409,50.24
Sett,Mel,3877,2117,1760,54.6
Sett,Jhin,3829,2046,1783,53.43
Sett,Ornn,814,414,400,50.86
Sett,Gangplank,853,460,393,53.93
Sett,Qiyana,392,234,158,59.69
Sett,Xerath,1771,931,840,52.57
Sett,Twitch,1554,855,699,55.02
Sett,Swain,1922,1020,902,53.07
Sett,MasterYi,2337,1234,1103,52.8
Sett,Yasuo,4130,2116,2014,51.23
Sett,Kaisa,3159,1662,1497,52.61
Sett,Talon,1119,645,474,57.64
Sett,Diana,3282,1722,1560,52.47
Sett,Akshan,630,346,284,54.92
Sett,Rammus,559,279,280,49.91
Sett,Zed,2044,1035,1009,50.64
Sett,Sylas,2661,1516,1145,56.97
Sett,Tristana,1943,1053,890,54.19
Sett,Aatrox,1981,951,1030,48.01
Sett,Vayne,2357,1135,1222,48.15
Sett,Rell,920,466,454,50.65
Sett,Ashe,3986,2093,1893,52.51
Sett,Teemo,2068,1036,1032,50.1
Sett,Yuumi,1363,695,668,50.99
Sett,Kayle,1310,625,685,47.71
Sett,Orianna,677,359,318,53.03
Sett,Malzahar,2068,970,1098,46.91
Sett,KSante,1163,626,537,53.83
Sett,Nunu,934,510,424,54.6
Sett,Yone,3723,2111,1612,56.7
Sett,Samira,1528,757,771,49.54
Sett,Neeko,844,438,406,51.9
Sett,Hwei,1194,631,563,52.85
Sett,Kalista,478,268,210,56.07
Sett,Blitzcrank,1516,844,672,55.67
Sett,Quinn,582,283,299,48.63
Sett,Khazix,874,508,366,58.12
Sett,Nidalee,591,317,274,53.64
Sett,Nasus,1273,630,643,49.49
Sett,Karma,2028,1071,957,52.81
Sett,Irelia,1766,958,808,54.25
Sett,Elise,1266,634,632,50.08
Sett,Katarina,1445,762,683,52.73
Sett,Jax,1824,934,890,51.21
Sett,Pantheon,3121,1633,1488,52.32
Sett,Vladimir,1093,559,534,51.14
Sett,Skarner,471,278,193,59.02
Sett,Senna,1467,744,723,50.72
Sett,DrMundo,1076,565,511,52.51
Sett,Ekko,1773,920,853,51.89
Sett,Akali,2086,1089,997,52.21
Sett,Yorick,1829,886,943,48.44
Sett,Nautilus,2105,1079,1026,51.26
Sett,Draven,870,523,347,60.11
Sett,LeeSin,2959,1595,1364,53.9
Sett,Ezreal,4440,2368,2072,53.33
Sett,Zilean,476,227,249,47.69
Sett,MonkeyKing,1408,681,727,48.37
Sett,Karthus,531,289,242,54.43
Sett,Renekton,1197,610,587,50.96
Sett,Shaco,1764,830,934,47.05
Sett,Taliyah,423,213,210,50.35
Sett,Seraphine,1475,767,708,52
Sett,Udyr,772,390,382,50.52
Sett,Lucian,1189,614,575,51.64
Sett,Sejuani,773,402,371,52.01
Sett,TahmKench,1541,849,692,55.09
Sett,Cassiopeia,497,278,219,55.94
Sett,Smolder,1174,604,570,51.45
Sett,Anivia,545,265,280,48.62
Sett,Ziggs,687,345,342,50.22
Sett,JarvanIV,981,535,446,54.54
Sett,Braum,952,474,478,49.79
Sett,Trundle,1114,558,556,50.09
Sett,Naafiri,601,268,333,44.59
Sett,Nocturne,2546,1235,1311,48.51
Sett,Ambessa,1215,659,556,54.24
Sett,Viego,2822,1483,1339,52.55
Sett,Annie,614,338,276,55.05
Sett,Sivir,970,489,481,50.41
Sett,Renata,293,162,131,55.29
Sett,Jayce,790,374,416,47.34
Sett,Bard,462,241,221,52.16
Sett,FiddleSticks,920,514,406,55.87
Sett,Soraka,988,468,520,47.37
Sett,Brand,1402,769,633,54.85
Sett,Illaoi,1050,530,520,50.48
Sett,Fiora,687,398,289,57.93
Sett,AurelionSol,723,397,326,54.91
Sett,Leona,1652,864,788,52.3
Sett,Maokai,884,440,444,49.77
Sett,Alistar,793,421,372,53.09
Sett,TwistedFate,619,318,301,51.37
Sett,Kassadin,305,127,178,41.64
Sett,Janna,504,212,292,42.06
Sett,Gragas,1047,520,527,49.67
Sett,Milio,942,468,474,49.68
Sett,Sion,1550,734,816,47.35
Sett,Graves,1178,623,555,52.89
Sett,Leblanc,1248,640,608,51.28
Sett,Taric,396,175,221,44.19
Sett,Shyvana,469,261,208,55.65
Sett,Zoe,706,349,357,49.43
Sett,Tryndamere,1044,532,512,50.96
Sett,Hecarim,747,427,320,57.16
Sett,XinZhao,1263,683,580,54.08
Sett,Malphite,1978,987,991,49.9
Sett,Lissandra,591,317,274,53.64
Sett,Kennen,464,242,222,52.16
Sett,Vex,907,481,426,53.03
Sett,Rengar,521,313,208,60.08
Sett,Riven,860,460,400,53.49
Sett,Gwen,928,518,410,55.82
Sett,Sona,517,251,266,48.55
Sett,Viktor,1574,817,757,51.91
Sett,Lulu,2282,1127,1155,49.39
Sett,Azir,552,296,256,53.62
Sett,Nilah,626,272,354,43.45
Sett,Ivern,231,110,121,47.62
Sett,Rumble,539,276,263,51.21
Sett,RekSai,241,133,108,55.19
Sett,Evelynn,641,313,328,48.83
Sett,Corki,696,372,324,53.45
Sett,Zeri,679,368,311,54.2
Sett,Singed,503,244,259,48.51
Sett,Olaf,428,221,207,51.64
Sett,Camille,691,365,326,52.82
Sett,Syndra,1087,535,552,49.22
Sett,Belveth,370,195,175,52.7
Sett,Kled,316,179,137,56.65
Sett,KogMaw,609,274,335,44.99
Zilean,Poppy,240,135,105,56.25
Zilean,Zac,232,104,128,44.83
Zilean,Chogath,506,271,235,53.56
Zilean,Xayah,159,74,85,46.54
Zilean,Nami,529,273,256,51.61
Zilean,Warwick,533,251,282,47.09
Zilean,Briar,316,153,163,48.42
Zilean,Zed,556,292,264,52.52
Zilean,Ziggs,148,78,70,52.7
Zilean,Xerath,381,187,194,49.08
Zilean,Darius,779,395,384,50.71
Zilean,Volibear,472,233,239,49.36
Zilean,Akali,365,203,162,55.62
Zilean,Jinx,1167,612,555,52.44
Zilean,Lux,985,481,504,48.83
Zilean,Fiora,181,89,92,49.17
Zilean,Graves,348,182,166,52.3
Zilean,Azir,168,93,75,55.36
Zilean,Ashe,910,411,499,45.16
Zilean,Braum,246,150,96,60.98
Zilean,Trundle,206,122,84,59.22
Zilean,JarvanIV,324,146,178,45.06
Zilean,Katarina,304,165,139,54.28
Zilean,Twitch,370,219,151,59.19
Zilean,Lulu,778,377,401,48.46
Zilean,Teemo,544,268,276,49.26
Zilean,Morgana,509,266,243,52.26
Zilean,KSante,230,137,93,59.57
Zilean,Swain,426,221,205,51.88
Zilean,Yone,718,362,356,50.42
Zilean,Nocturne,613,343,270,55.95
Zilean,AurelionSol,174,94,80,54.02
Zilean,Smolder,244,145,99,59.43
Zilean,Nautilus,414,250,164,60.39
Zilean,TahmKench,260,142,118,54.62
Zilean,Shaco,427,236,191,55.27
Zilean,Leblanc,216,113,103,52.31
Zilean,Hwei,318,177,141,55.66
Zilean,Thresh,590,318,272,53.9
Zilean,Illaoi,152,73,79,48.03
Zilean,Syndra,265,148,117,55.85
Zilean,Jhin,875,441,434,50.4
Zilean,Zyra,358,172,186,48.04
Zilean,Garen,704,376,328,53.41
Zilean,Karma,627,309,318,49.28
Zilean,Renekton,195,92,103,47.18
Zilean,Lillia,208,106,102,50.96
Zilean,Yasuo,777,368,409,47.36
Zilean,Caitlyn,1147,581,566,50.65
Zilean,Ambessa,261,128,133,49.04
Zilean,Kaisa,761,402,359,52.83
Zilean,Neeko,171,113,58,66.08
Zilean,Hecarim,161,101,60,62.73
Zilean,Mordekaiser,463,230,233,49.68
Zilean,Talon,293,143,150,48.81
Zilean,Aurora,315,148,167,46.98
Zilean,Samira,245,106,139,43.27
Zilean,Leona,303,172,131,56.77
Zilean,Vayne,512,273,239,53.32
Zilean,LeeSin,581,329,252,56.63
Zilean,Sett,476,249,227,52.31
Zilean,Ahri,585,294,291,50.26
Zilean,Aatrox,420,220,200,52.38
Zilean,Ekko,417,202,215,48.44
Zilean,Bard,194,106,88,54.64
Zilean,Mel,777,413,364,53.15
Zilean,Malphite,415,209,206,50.36
Zilean,Sona,184,106,78,57.61
Zilean,Yorick,377,186,191,49.34
Zilean,Kayn,595,293,302,49.24
Zilean,Ezreal,1050,534,516,50.86
Zilean,Velkoz,273,139,134,50.92
Zilean,Nunu,187,108,79,57.75
Zilean,Vex,185,103,82,55.68
Zilean,Lucian,280,186,94,66.43
Zilean,Riven,210,99,111,47.14
Zilean,Anivia,142,81,61,57.04
Zilean,Aphelios,235,110,125,46.81
Zilean,Gangplank,232,123,109,53.02
Zilean,Kindred,168,101,67,60.12
Zilean,Shen,286,147,139,51.4
Zilean,Yuumi,455,210,245,46.15
Zilean,Shyvana,88,54,34,61.36
Zilean,TwistedFate,154,91,63,59.09
Zilean,Udyr,160,59,101,36.88
Zilean,Rakan,189,88,101,46.56
Zilean,MissFortune,929,482,447,51.88
Zilean,Senna,304,162,142,53.29
Zilean,Gnar,187,97,90,51.87
Zilean,Amumu,430,206,224,47.91
Zilean,Irelia,342,175,167,51.17
Zilean,DrMundo,205,99,106,48.29
Zilean,MasterYi,503,279,224,55.47
Zilean,Heimerdinger,217,120,97,55.3
Zilean,Viego,622,300,322,48.23
Zilean,Brand,307,145,162,47.23
Zilean,Pantheon,641,317,324,49.45
Zilean,Kennen,121,88,33,72.73
Zilean,Sejuani,120,76,44,63.33
Zilean,Soraka,250,141,109,56.4
Zilean,Sion,375,188,187,50.13
Zilean,Vladimir,301,167,134,55.48
Zilean,Renata,71,36,35,50.7
Zilean,Pyke,329,151,178,45.9
Zilean,Evelynn,137,83,54,60.58
Zilean,Tryndamere,215,136,79,63.26
Zilean,Jayce,286,142,144,49.65
Zilean,Orianna,214,106,108,49.53
Zilean,Malzahar,454,245,209,53.96
Zilean,Janna,169,80,89,47.34
Zilean,Veigar,379,199,180,52.51
Zilean,Gragas,214,105,109,49.07
Zilean,Seraphine,233,110,123,47.21
Zilean,Nasus,340,162,178,47.65
Zilean,Kassadin,99,58,41,58.59
Zilean,Vi,377,174,203,46.15
Zilean,Zoe,177,90,87,50.85
Zilean,Naafiri,154,86,68,55.84
Zilean,Singed,131,76,55,58.02
Zilean,Belveth,98,57,41,58.16
Zilean,Viktor,421,216,205,51.31
Zilean,Gwen,182,74,108,40.66
Zilean,Kayle,318,174,144,54.72
Zilean,Sylas,593,305,288,51.43
Zilean,Tristana,373,214,159,57.37
Zilean,MonkeyKing,289,123,166,42.56
Zilean,Diana,617,297,320,48.14
Zilean,KogMaw,140,68,72,48.57
Zilean,Annie,153,67,86,43.79
Zilean,Draven,172,84,88,48.84
Zilean,Blitzcrank,252,140,112,55.56
Zilean,Urgot,215,123,92,57.21
Zilean,Zeri,188,104,84,55.32
Zilean,Varus,367,218,149,59.4
Zilean,Rumble,121,81,40,66.94
Zilean,Lissandra,151,80,71,52.98
Zilean,Kalista,89,47,42,52.81
Zilean,Milio,229,104,125,45.41
Zilean,Olaf,76,50,26,65.79
Zilean,Rengar,148,89,59,60.14
Zilean,Galio,356,198,158,55.62
Zilean,Khazix,196,104,92,53.06
Zilean,Ryze,170,84,86,49.41
Zilean,Sivir,252,125,127,49.6
Zilean,Rell,171,85,86,49.71
Zilean,Maokai,222,114,108,51.35
Zilean,Qiyana,107,56,51,52.34
Zilean,Nilah,153,74,79,48.37
Zilean,FiddleSticks,246,117,129,47.56
Zilean,Ornn,227,108,119,47.58
Zilean,Alistar,180,98,82,54.44
Zilean,Karthus,122,52,70,42.62
Zilean,Nidalee,139,71,68,51.08
Zilean,Cassiopeia,113,66,47,58.41
Zilean,Elise,285,171,114,60
Zilean,Rammus,70,39,31,55.71
Zilean,Corki,175,94,81,53.71
Zilean,XinZhao,265,135,130,50.94
Zilean,Akshan,140,60,80,42.86
Zilean,Skarner,77,35,42,45.45
Zilean,Jax,343,179,164,52.19
Zilean,Quinn,154,63,91,40.91
Zilean,Taliyah,100,48,52,48
Zilean,Fizz,211,92,119,43.6
Zilean,RekSai,53,29,24,54.72
Zilean,Camille,161,84,77,52.17
Zilean,Taric,59,31,28,52.54
Zilean,Kled,69,33,36,47.83
Zilean,Ivern,35,24,11,68.57
Teemo,Warwick,2573,1245,1328,48.39
Teemo,Khazix,695,368,327,52.95
Teemo,Yorick,1929,901,1028,46.71
Teemo,Vayne,2093,1129,964,53.94
Teemo,Lulu,1853,933,920,50.35
Teemo,Mel,3409,1863,1546,54.65
Teemo,Trundle,931,446,485,47.91
Teemo,Zed,1859,1032,827,55.51
Teemo,Sejuani,597,260,337,43.55
Teemo,Kayle,980,512,468,52.24
Teemo,Darius,3230,1631,1599,50.5
Teemo,Malphite,2563,1357,1206,52.95
Teemo,Ezreal,3626,1913,1713,52.76
Teemo,Nami,1467,709,758,48.33
Teemo,Rumble,493,269,224,54.56
Teemo,Shaco,1747,875,872,50.09
Teemo,Veigar,1901,940,961,49.45
Teemo,Caitlyn,4506,2295,2211,50.93
Teemo,Lux,4541,2308,2233,50.83
Teemo,Volibear,1855,992,863,53.48
Teemo,Velkoz,1042,538,504,51.63
Teemo,Gangplank,815,387,428,47.48
Teemo,Lillia,830,449,381,54.1
Teemo,Renata,271,114,157,42.07
Teemo,Kayn,2360,1273,1087,53.94
Teemo,Shyvana,406,204,202,50.25
Teemo,Annie,585,285,300,48.72
Teemo,Varus,1322,708,614,53.56
Teemo,Kennen,452,238,214,52.65
Teemo,Zyra,1585,794,791,50.09
Teemo,Heimerdinger,979,479,500,48.93
Teemo,Malzahar,1956,973,983,49.74
Teemo,Sivir,922,496,426,53.8
Teemo,Neeko,850,460,390,54.12
Teemo,Illaoi,670,379,291,56.57
Teemo,MasterYi,2204,1090,1114,49.46
Teemo,Leblanc,959,478,481,49.84
Teemo,Anivia,493,237,256,48.07
Teemo,Briar,1173,621,552,52.94
Teemo,Katarina,1109,573,536,51.67
Teemo,Jhin,3145,1548,1597,49.22
Teemo,Seraphine,1332,668,664,50.15
Teemo,Sylas,2090,1114,976,53.3
Teemo,Aurora,1100,565,535,51.36
Teemo,Brand,1359,701,658,51.58
Teemo,Ekko,1505,756,749,50.23
Teemo,Yasuo,3304,1602,1702,48.49
Teemo,Nocturne,2187,1088,1099,49.75
Teemo,Orianna,640,347,293,54.22
Teemo,Kalista,318,179,139,56.29
Teemo,Aatrox,1451,755,696,52.03
Teemo,Evelynn,543,315,228,58.01
Teemo,Kaisa,2429,1292,1137,53.19
Teemo,Zilean,544,276,268,50.74
Teemo,RekSai,151,79,72,52.32
Teemo,Ahri,2007,1062,945,52.91
Teemo,Jinx,4450,2133,2317,47.93
Teemo,Mordekaiser,2112,1020,1092,48.3
Teemo,LeeSin,2097,1122,975,53.51
Teemo,Gnar,581,277,304,47.68
Teemo,Viego,2118,1118,1000,52.79
Teemo,TwistedFate,520,307,213,59.04
Teemo,Olaf,468,211,257,45.09
Teemo,Sett,2068,1032,1036,49.9
Teemo,Amumu,1908,915,993,47.96
Teemo,Taliyah,300,166,134,55.33
Teemo,Xayah,649,330,319,50.85
Teemo,Braum,813,414,399,50.92
Teemo,Gragas,745,417,328,55.97
Teemo,Akali,1779,943,836,53.01
Teemo,Soraka,877,408,469,46.52
Teemo,Vladimir,1107,549,558,49.59
Teemo,Twitch,1255,655,600,52.19
Teemo,Pyke,1393,753,640,54.06
Teemo,Graves,895,504,391,56.31
Teemo,FiddleSticks,858,364,494,42.42
Teemo,Leona,1401,745,656,53.18
Teemo,Lissandra,490,253,237,51.63
Teemo,Tristana,1638,866,772,52.87
Teemo,Jax,1460,797,663,54.59
Teemo,Vi,1408,723,685,51.35
Teemo,Ashe,3269,1654,1615,50.6
Teemo,Thresh,1909,948,961,49.66
Teemo,Pantheon,2282,1111,1171,48.69
Teemo,Diana,2760,1361,1399,49.31
Teemo,Smolder,1018,520,498,51.08
Teemo,Elise,985,556,429,56.45
Teemo,Zeri,601,316,285,52.58
Teemo,Senna,1172,586,586,50
Teemo,Ambessa,763,410,353,53.74
Teemo,Ziggs,706,380,326,53.82
Teemo,Xerath,1432,697,735,48.67
Teemo,Milio,791,405,386,51.2
Teemo,Zoe,461,278,183,60.3
Teemo,TahmKench,1181,622,559,52.67
Teemo,Syndra,958,451,507,47.08
Teemo,Draven,810,449,361,55.43
Teemo,Yuumi,1297,661,636,50.96
Teemo,Jayce,766,435,331,56.79
Teemo,Taric,329,173,156,52.58
Teemo,Nilah,510,268,242,52.55
Teemo,Blitzcrank,1112,580,532,52.16
Teemo,Fiora,444,245,199,55.18
Teemo,Yone,2672,1486,1186,55.61
Teemo,MissFortune,4136,2091,2045,50.56
Teemo,Maokai,764,401,363,52.49
Teemo,Tryndamere,985,508,477,51.57
Teemo,Garen,2729,1409,1320,51.63
Teemo,AurelionSol,589,279,310,47.37
Teemo,Poppy,780,389,391,49.87
Teemo,Nautilus,1722,952,770,55.28
Teemo,Camille,474,264,210,55.7
Teemo,Rengar,484,267,217,55.17
Teemo,Nasus,1335,637,698,47.72
Teemo,Irelia,1268,694,574,54.73
Teemo,Galio,1579,819,760,51.87
Teemo,Hwei,918,455,463,49.56
Teemo,Aphelios,796,449,347,56.41
Teemo,Swain,1665,849,816,50.99
Teemo,Kassadin,278,136,142,48.92
Teemo,Udyr,520,297,223,57.12
Teemo,Singed,445,228,217,51.24
Teemo,Nunu,905,435,470,48.07
Teemo,DrMundo,965,452,513,46.84
Teemo,Karma,1755,856,899,48.77
Teemo,MonkeyKing,1066,506,560,47.47
Teemo,Morgana,2154,1089,1065,50.56
Teemo,Corki,572,325,247,56.82
Teemo,Qiyana,314,190,124,60.51
Teemo,Akshan,581,286,295,49.23
Teemo,Lucian,1065,520,545,48.83
Teemo,Chogath,2156,1016,1140,47.12
Teemo,Riven,651,349,302,53.61
Teemo,Skarner,405,215,190,53.09
Teemo,Fizz,1014,508,506,50.1
Teemo,Gwen,562,336,226,59.79
Teemo,Viktor,1310,657,653,50.15
Teemo,Vex,937,464,473,49.52
Teemo,Kindred,671,347,324,51.71
Teemo,Bard,371,204,167,54.99
Teemo,JarvanIV,855,393,462,45.96
Teemo,Sona,517,235,282,45.45
Teemo,Urgot,841,429,412,51.01
Teemo,Ivern,217,120,97,55.3
Teemo,Alistar,630,335,295,53.17
Teemo,Ryze,607,324,283,53.38
Teemo,XinZhao,897,460,437,51.28
Teemo,Sion,1383,708,675,51.19
Teemo,Ornn,574,274,300,47.74
Teemo,Hecarim,597,325,272,54.44
Teemo,Rammus,490,240,250,48.98
Teemo,Samira,1257,641,616,50.99
Teemo,Rell,646,352,294,54.49
Teemo,Belveth,377,215,162,57.03
Teemo,Karthus,530,273,257,51.51
Teemo,Renekton,605,352,253,58.18
Teemo,KogMaw,530,261,269,49.25
Teemo,Rakan,489,227,262,46.42
Teemo,Naafiri,561,279,282,49.73
Teemo,Talon,898,500,398,55.68
Teemo,Shen,1001,475,526,47.45
Teemo,Zac,709,360,349,50.78
Teemo,Quinn,688,375,313,54.51
Teemo,Cassiopeia,577,323,254,55.98
Teemo,Nidalee,433,264,169,60.97
Teemo,Janna,363,200,163,55.1
Teemo,KSante,503,283,220,56.26
Teemo,Kled,247,136,111,55.06
Teemo,Azir,453,242,211,53.42
MonkeyKing,Warwick,1335,622,713,46.59
MonkeyKing,Khazix,448,248,200,55.36
MonkeyKing,Yorick,881,400,481,45.4
MonkeyKing,Vayne,1227,607,620,49.47
MonkeyKing,Lulu,1364,628,736,46.04
MonkeyKing,Urgot,479,257,222,53.65
MonkeyKing,Vi,1011,483,528,47.77
MonkeyKing,Ryze,311,148,163,47.59
MonkeyKing,MissFortune,2066,1039,1027,50.29
MonkeyKing,Thresh,1312,664,648,50.61
MonkeyKing,Darius,2049,1041,1008,50.81
MonkeyKing,Braum,548,270,278,49.27
MonkeyKing,Aurora,656,295,361,44.97
MonkeyKing,Ashe,1825,934,891,51.18
MonkeyKing,Nunu,458,249,209,54.37
MonkeyKing,Sejuani,397,240,157,60.45
MonkeyKing,Yone,1699,928,771,54.62
MonkeyKing,Ezreal,2339,1174,1165,50.19
MonkeyKing,Milio,500,222,278,44.4
MonkeyKing,Poppy,513,293,220,57.12
MonkeyKing,Katarina,695,371,324,53.38
MonkeyKing,Yuumi,695,395,300,56.83
MonkeyKing,Aatrox,796,388,408,48.74
MonkeyKing,Shaco,829,427,402,51.51
MonkeyKing,Neeko,378,209,169,55.29
MonkeyKing,Lucian,770,395,375,51.3
MonkeyKing,Nami,942,416,526,44.16
MonkeyKing,Viego,1489,764,725,51.31
MonkeyKing,Naafiri,292,147,145,50.34
MonkeyKing,Nilah,279,138,141,49.46
MonkeyKing,Brand,670,295,375,44.03
MonkeyKing,KSante,491,286,205,58.25
MonkeyKing,Nocturne,1405,677,728,48.19
MonkeyKing,Leona,755,373,382,49.4
MonkeyKing,Volibear,1121,525,596,46.83
MonkeyKing,Vladimir,649,323,326,49.77
MonkeyKing,Zeri,358,159,199,44.41
MonkeyKing,Senna,689,382,307,55.44
MonkeyKing,Sion,685,352,333,51.39
MonkeyKing,Evelynn,290,151,139,52.07
MonkeyKing,Ahri,1203,627,576,52.12
MonkeyKing,Sett,1408,727,681,51.63
MonkeyKing,MasterYi,1139,569,570,49.96
MonkeyKing,Mordekaiser,1191,584,607,49.03
MonkeyKing,Jinx,2626,1283,1343,48.86
MonkeyKing,Lux,2188,1089,1099,49.77
MonkeyKing,Singed,223,105,118,47.09
MonkeyKing,Caitlyn,2484,1244,1240,50.08
MonkeyKing,Pyke,708,380,328,53.67
MonkeyKing,Kayn,1361,707,654,51.95
MonkeyKing,Fizz,574,312,262,54.36
MonkeyKing,Karma,1303,626,677,48.04
MonkeyKing,Talon,527,315,212,59.77
MonkeyKing,Swain,876,421,455,48.06
MonkeyKing,Irelia,721,391,330,54.23
MonkeyKing,Varus,807,422,385,52.29
MonkeyKing,Nasus,675,321,354,47.56
MonkeyKing,Tryndamere,517,251,266,48.55
MonkeyKing,Soraka,524,253,271,48.28
MonkeyKing,Malzahar,985,498,487,50.56
MonkeyKing,Pantheon,1480,738,742,49.86
MonkeyKing,AurelionSol,339,152,187,44.84
MonkeyKing,Twitch,785,434,351,55.29
MonkeyKing,Graves,702,353,349,50.28
MonkeyKing,Leblanc,575,298,277,51.83
MonkeyKing,Diana,1588,859,729,54.09
MonkeyKing,Kindred,447,206,241,46.09
MonkeyKing,Mel,1773,957,816,53.98
MonkeyKing,Shen,543,262,281,48.25
MonkeyKing,Kalista,212,116,96,54.72
MonkeyKing,Ekko,867,479,388,55.25
MonkeyKing,Jayce,512,253,259,49.41
MonkeyKing,Jhin,1899,1031,868,54.29
MonkeyKing,Nautilus,967,535,432,55.33
MonkeyKing,Teemo,1066,560,506,52.53
MonkeyKing,Garen,1504,746,758,49.6
MonkeyKing,Amumu,825,405,420,49.09
MonkeyKing,Tristana,942,525,417,55.73
MonkeyKing,Zac,517,230,287,44.49
MonkeyKing,Maokai,380,191,189,50.26
MonkeyKing,Galio,785,429,356,54.65
MonkeyKing,DrMundo,438,218,220,49.77
MonkeyKing,Veigar,876,452,424,51.6
MonkeyKing,Gnar,328,143,185,43.6
MonkeyKing,Ziggs,320,161,159,50.31
MonkeyKing,Taliyah,226,76,150,33.63
MonkeyKing,Gangplank,540,230,310,42.59
MonkeyKing,Zed,959,559,400,58.29
MonkeyKing,Renekton,465,226,239,48.6
MonkeyKing,Viktor,930,440,490,47.31
MonkeyKing,JarvanIV,699,344,355,49.21
MonkeyKing,Sona,260,123,137,47.31
MonkeyKing,Yasuo,1789,929,860,51.93
MonkeyKing,Draven,438,213,225,48.63
MonkeyKing,Morgana,956,477,479,49.9
MonkeyKing,Malphite,977,510,467,52.2
MonkeyKing,Akali,954,505,449,52.94
MonkeyKing,TahmKench,657,340,317,51.75
MonkeyKing,Ivern,115,61,54,53.04
MonkeyKing,Zoe,332,144,188,43.37
MonkeyKing,Udyr,352,172,180,48.86
MonkeyKing,FiddleSticks,443,212,231,47.86
MonkeyKing,Jax,796,402,394,50.5
MonkeyKing,Trundle,493,261,232,52.94
MonkeyKing,Zyra,895,474,421,52.96
MonkeyKing,Ambessa,567,317,250,55.91
MonkeyKing,LeeSin,1530,798,732,52.16
MonkeyKing,Kaisa,1471,837,634,56.9
MonkeyKing,Fiora,356,175,181,49.16
MonkeyKing,Kassadin,185,92,93,49.73
MonkeyKing,Seraphine,586,289,297,49.32
MonkeyKing,Kennen,242,110,132,45.45
MonkeyKing,TwistedFate,297,138,159,46.46
MonkeyKing,Gragas,517,263,254,50.87
MonkeyKing,Rammus,231,138,93,59.74
MonkeyKing,Zilean,289,166,123,57.44
MonkeyKing,Akshan,299,146,153,48.83
MonkeyKing,Samira,593,335,258,56.49
MonkeyKing,Xerath,772,378,394,48.96
MonkeyKing,XinZhao,652,409,243,62.73
MonkeyKing,Lillia,510,242,268,47.45
MonkeyKing,Rell,382,197,185,51.57
MonkeyKing,Orianna,401,212,189,52.87
MonkeyKing,Karthus,228,116,112,50.88
MonkeyKing,Chogath,959,445,514,46.4
MonkeyKing,Kayle,550,266,284,48.36
MonkeyKing,Elise,566,248,318,43.82
MonkeyKing,Camille,360,191,169,53.06
MonkeyKing,Velkoz,559,267,292,47.76
MonkeyKing,Azir,382,193,189,50.52
MonkeyKing,Smolder,605,338,267,55.87
MonkeyKing,Alistar,412,237,175,57.52
MonkeyKing,Hecarim,336,212,124,63.1
MonkeyKing,Riven,446,244,202,54.71
MonkeyKing,Cassiopeia,284,153,131,53.87
MonkeyKing,Sivir,469,220,249,46.91
MonkeyKing,Bard,271,145,126,53.51
MonkeyKing,Hwei,645,323,322,50.08
MonkeyKing,Xayah,461,238,223,51.63
MonkeyKing,Gwen,455,223,232,49.01
MonkeyKing,Annie,245,125,120,51.02
MonkeyKing,Sylas,1346,715,631,53.12
MonkeyKing,Aphelios,457,253,204,55.36
MonkeyKing,Briar,587,306,281,52.13
MonkeyKing,Ornn,351,166,185,47.29
MonkeyKing,Belveth,168,65,103,38.69
MonkeyKing,Janna,321,178,143,55.45
MonkeyKing,Rengar,264,161,103,60.98
MonkeyKing,Rakan,378,201,177,53.17
MonkeyKing,Illaoi,422,194,228,45.97
MonkeyKing,Qiyana,212,114,98,53.77
MonkeyKing,Syndra,549,263,286,47.91
MonkeyKing,Shyvana,198,90,108,45.45
MonkeyKing,Blitzcrank,648,359,289,55.4
MonkeyKing,Lissandra,342,160,182,46.78
MonkeyKing,Heimerdinger,374,220,154,58.82
MonkeyKing,Quinn,345,184,161,53.33
MonkeyKing,Vex,402,184,218,45.77
MonkeyKing,Nidalee,272,146,126,53.68
MonkeyKing,Kled,132,68,64,51.52
MonkeyKing,Taric,189,107,82,56.61
MonkeyKing,Corki,365,198,167,54.25
MonkeyKing,Renata,163,89,74,54.6
MonkeyKing,Olaf,232,125,107,53.88
MonkeyKing,KogMaw,250,118,132,47.2
MonkeyKing,Skarner,258,134,124,51.94
MonkeyKing,Rumble,231,131,100,56.71
MonkeyKing,Anivia,306,159,147,51.96
MonkeyKing,RekSai,93,35,58,37.63
Blitzcrank,Warwick,1323,621,702,46.94
Blitzcrank,Khazix,467,217,250,46.47
Blitzcrank,Yorick,790,344,446,43.54
Blitzcrank,Vayne,1109,552,557,49.77
Blitzcrank,Lulu,1404,750,654,53.42
Blitzcrank,Ambessa,608,342,266,56.25
Blitzcrank,Graves,648,293,355,45.22
Blitzcrank,Akali,1050,457,593,43.52
Blitzcrank,Anivia,273,139,134,50.92
Blitzcrank,Leona,1014,463,551,45.66
Blitzcrank,Mordekaiser,1100,516,584,46.91
Blitzcrank,Vi,852,444,408,52.11
Blitzcrank,Vex,564,261,303,46.28
Blitzcrank,Varus,834,414,420,49.64
Blitzcrank,Seraphine,650,335,315,51.54
Blitzcrank,Illaoi,436,216,220,49.54
Blitzcrank,MasterYi,1174,621,553,52.9
Blitzcrank,Leblanc,683,347,336,50.81
Blitzcrank,Caitlyn,2588,1278,1310,49.38
Blitzcrank,Pantheon,1562,721,841,46.16
Blitzcrank,Kayn,1182,577,605,48.82
Blitzcrank,Viktor,838,410,428,48.93
Blitzcrank,Samira,647,294,353,45.44
Blitzcrank,Janna,303,149,154,49.17
Blitzcrank,Malzahar,834,417,417,50
Blitzcrank,Ekko,858,422,436,49.18
Blitzcrank,Yasuo,1738,861,877,49.54
Blitzcrank,Urgot,424,241,183,56.84
Blitzcrank,Veigar,933,470,463,50.38
Blitzcrank,Maokai,393,180,213,45.8
Blitzcrank,Jhin,1851,963,888,52.03
Blitzcrank,Gnar,334,151,183,45.21
Blitzcrank,Viego,1370,661,709,48.25
Blitzcrank,TwistedFate,336,169,167,50.3
Blitzcrank,Jinx,2439,1147,1292,47.03
Blitzcrank,Lux,2700,1357,1343,50.26
Blitzcrank,Sion,575,292,283,50.78
Blitzcrank,Udyr,350,169,181,48.29
Blitzcrank,Ryze,351,148,203,42.17
Blitzcrank,Kaisa,1404,634,770,45.16
Blitzcrank,KSante,530,269,261,50.75
Blitzcrank,Taliyah,207,87,120,42.03
Blitzcrank,Sona,246,146,100,59.35
Blitzcrank,Shyvana,222,103,119,46.4
Blitzcrank,Sett,1516,672,844,44.33
Blitzcrank,Xerath,1018,468,550,45.97
Blitzcrank,Milio,444,206,238,46.4
Blitzcrank,Teemo,1112,532,580,47.84
Blitzcrank,Aurora,667,290,377,43.48
Blitzcrank,Velkoz,583,271,312,46.48
Blitzcrank,DrMundo,494,249,245,50.4
Blitzcrank,MissFortune,2225,1112,1113,49.98
Blitzcrank,Karma,1239,582,657,46.97
Blitzcrank,Olaf,267,118,149,44.19
Blitzcrank,Amumu,846,431,415,50.95
Blitzcrank,Nautilus,1092,494,598,45.24
Blitzcrank,Renekton,499,259,240,51.9
Blitzcrank,Volibear,1029,495,534,48.1
Blitzcrank,Irelia,800,385,415,48.13
Blitzcrank,Ahri,1259,537,722,42.65
Blitzcrank,Kayle,513,256,257,49.9
Blitzcrank,Kindred,447,192,255,42.95
Blitzcrank,Swain,870,398,472,45.75
Blitzcrank,Chogath,1019,459,560,45.04
Blitzcrank,Thresh,1365,640,725,46.89
Blitzcrank,Poppy,539,228,311,42.3
Blitzcrank,Naafiri,285,173,112,60.7
Blitzcrank,Lucian,637,291,346,45.68
Blitzcrank,Fiora,268,103,165,38.43
Blitzcrank,AurelionSol,418,206,212,49.28
Blitzcrank,Darius,1812,853,959,47.08
Blitzcrank,Rammus,274,122,152,44.53
Blitzcrank,Jax,866,421,445,48.61
Blitzcrank,Lillia,541,255,286,47.13
Blitzcrank,Diana,1456,709,747,48.7
Blitzcrank,Twitch,665,346,319,52.03
Blitzcrank,Shaco,898,431,467,48
Blitzcrank,Singed,195,82,113,42.05
Blitzcrank,Corki,364,196,168,53.85
Blitzcrank,Neeko,384,199,185,51.82
Blitzcrank,Kennen,269,135,134,50.19
Blitzcrank,FiddleSticks,430,218,212,50.7
Blitzcrank,Ziggs,366,186,180,50.82
Blitzcrank,TahmKench,714,376,338,52.66
Blitzcrank,Yone,1895,954,941,50.34
Blitzcrank,Briar,653,233,420,35.68
Blitzcrank,Xayah,477,206,271,43.19
Blitzcrank,Senna,616,295,321,47.89
Blitzcrank,Ezreal,2774,1353,1421,48.77
Blitzcrank,Garen,1454,713,741,49.04
Blitzcrank,Mel,1684,817,867,48.52
Blitzcrank,Tristana,892,436,456,48.88
Blitzcrank,Aphelios,491,265,226,53.97
Blitzcrank,Yuumi,700,319,381,45.57
Blitzcrank,Vladimir,588,316,272,53.74
Blitzcrank,Ivern,96,66,30,68.75
Blitzcrank,Zed,1080,527,553,48.8
Blitzcrank,Aatrox,991,458,533,46.22
Blitzcrank,Braum,607,257,350,42.34
Blitzcrank,Nasus,653,357,296,54.67
Blitzcrank,Sivir,767,310,457,40.42
Blitzcrank,Fizz,461,233,228,50.54
Blitzcrank,Elise,647,331,316,51.16
Blitzcrank,Lissandra,259,126,133,48.65
Blitzcrank,LeeSin,1719,836,883,48.63
Blitzcrank,Talon,496,252,244,50.81
Blitzcrank,Nami,716,327,389,45.67
Blitzcrank,Sylas,1554,746,808,48.01
Blitzcrank,Riven,445,188,257,42.25
Blitzcrank,Quinn,320,173,147,54.06
Blitzcrank,Syndra,524,242,282,46.18
Blitzcrank,Hwei,627,283,344,45.14
Blitzcrank,Soraka,456,238,218,52.19
Blitzcrank,Shen,616,334,282,54.22
Blitzcrank,Smolder,535,259,276,48.41
Blitzcrank,Camille,319,148,171,46.39
Blitzcrank,Trundle,515,243,272,47.18
Blitzcrank,Zyra,966,441,525,45.65
Blitzcrank,Skarner,260,154,106,59.23
Blitzcrank,Qiyana,222,106,116,47.75
Blitzcrank,Katarina,653,326,327,49.92
Blitzcrank,Ashe,2080,1063,1017,51.11
Blitzcrank,Brand,633,307,326,48.5
Blitzcrank,Morgana,1145,564,581,49.26
Blitzcrank,Nocturne,1248,549,699,43.99
Blitzcrank,Gragas,481,246,235,51.14
Blitzcrank,Taric,206,91,115,44.17
Blitzcrank,Tryndamere,525,283,242,53.9
Blitzcrank,Rumble,292,146,146,50
Blitzcrank,Draven,376,160,216,42.55
Blitzcrank,Zac,456,207,249,45.39
Blitzcrank,Heimerdinger,365,171,194,46.85
Blitzcrank,Jayce,527,236,291,44.78
Blitzcrank,Zilean,252,112,140,44.44
Blitzcrank,KogMaw,248,112,136,45.16
Blitzcrank,Galio,818,400,418,48.9
Blitzcrank,Gwen,430,202,228,46.98
Blitzcrank,XinZhao,600,288,312,48
Blitzcrank,Rell,400,187,213,46.75
Blitzcrank,Alistar,597,312,285,52.26
Blitzcrank,Gangplank,515,270,245,52.43
Blitzcrank,Cassiopeia,246,119,127,48.37
Blitzcrank,Kalista,232,118,114,50.86
Blitzcrank,Sejuani,343,146,197,42.57
Blitzcrank,Rengar,246,138,108,56.1
Blitzcrank,Azir,354,169,185,47.74
Blitzcrank,Evelynn,318,168,150,52.83
Blitzcrank,Renata,116,61,55,52.59
Blitzcrank,Malphite,815,426,389,52.27
Blitzcrank,Rakan,315,135,180,42.86
Blitzcrank,Pyke,717,330,387,46.03
Blitzcrank,Karthus,319,167,152,52.35
Blitzcrank,Annie,303,134,169,44.22
Blitzcrank,Akshan,286,137,149,47.9
Blitzcrank,Nunu,478,231,247,48.33
Blitzcrank,Ornn,398,189,209,47.49
Blitzcrank,Belveth,198,109,89,55.05
Blitzcrank,MonkeyKing,648,289,359,44.6
Blitzcrank,Kassadin,169,91,78,53.85
Blitzcrank,Kled,132,58,74,43.94
Blitzcrank,Bard,218,126,92,57.8
Blitzcrank,Orianna,399,196,203,49.12
Blitzcrank,Zeri,416,205,211,49.28
Blitzcrank,JarvanIV,519,224,295,43.16
Blitzcrank,Hecarim,372,216,156,58.06
Blitzcrank,Zoe,354,171,183,48.31
Blitzcrank,Nilah,221,104,117,47.06
Blitzcrank,Nidalee,294,160,134,54.42
Blitzcrank,RekSai,118,60,58,50.85
Khazix,Teemo,695,327,368,47.05
Khazix,MonkeyKing,448,200,248,44.64
Khazix,Katarina,478,221,257,46.23
Khazix,Jinx,1725,791,934,45.86
Khazix,Blitzcrank,467,250,217,53.53
Khazix,Trundle,306,131,175,42.81
Khazix,Malphite,611,283,328,46.32
Khazix,Hwei,477,234,243,49.06
Khazix,Twitch,519,251,268,48.36
Khazix,Milio,360,188,172,52.22
Khazix,Ornn,264,106,158,40.15
Khazix,Kayn,936,453,483,48.4
Khazix,Malzahar,651,299,352,45.93
Khazix,Vayne,836,405,431,48.44
Khazix,Lulu,950,465,485,48.95
Khazix,Sejuani,204,94,110,46.08
Khazix,Jayce,302,143,159,47.35
Khazix,Jhin,1273,600,673,47.13
Khazix,Thresh,867,411,456,47.4
Khazix,Yasuo,1259,597,662,47.42
Khazix,Mel,1243,633,610,50.93
Khazix,Xayah,241,122,119,50.62
Khazix,Rakan,256,157,99,61.33
Khazix,Jax,595,317,278,53.28
Khazix,Viego,1007,446,561,44.29
Khazix,Aurora,498,285,213,57.23
Khazix,Lux,1657,721,936,43.51
Khazix,Nocturne,895,399,496,44.58
Khazix,Karma,1003,462,541,46.06
Khazix,Gangplank,347,197,150,56.77
Khazix,Lillia,319,172,147,53.92
Khazix,Caitlyn,1865,899,966,48.2
Khazix,Renata,99,45,54,45.45
Khazix,DrMundo,362,170,192,46.96
Khazix,Rengar,369,201,168,54.47
Khazix,Akali,674,343,331,50.89
Khazix,Nilah,185,69,116,37.3
Khazix,Shen,347,165,182,47.55
Khazix,MasterYi,879,439,440,49.94
Khazix,Irelia,556,281,275,50.54
Khazix,MissFortune,1405,646,759,45.98
Khazix,Diana,1027,479,548,46.64
Khazix,Amumu,598,244,354,40.8
Khazix,Syndra,467,235,232,50.32
Khazix,Tristana,647,335,312,51.78
Khazix,TahmKench,418,229,189,54.78
Khazix,Morgana,700,367,333,52.43
Khazix,Warwick,756,352,404,46.56
Khazix,Ekko,611,294,317,48.12
Khazix,Yone,1147,600,547,52.31
Khazix,Veigar,608,308,300,50.66
Khazix,Ezreal,1681,854,827,50.8
Khazix,Nami,693,352,341,50.79
Khazix,Ashe,1315,580,735,44.11
Khazix,Soraka,385,164,221,42.6
Khazix,Poppy,391,193,198,49.36
Khazix,Sett,874,366,508,41.88
Khazix,LeeSin,1176,558,618,47.45
Khazix,Pyke,558,273,285,48.92
Khazix,Smolder,404,217,187,53.71
Khazix,Zed,807,407,400,50.43
Khazix,Ambessa,378,187,191,49.47
Khazix,Kaisa,1147,580,567,50.57
Khazix,Neeko,262,132,130,50.38
Khazix,Yorick,612,249,363,40.69
Khazix,Rumble,196,89,107,45.41
Khazix,Brand,541,253,288,46.77
Khazix,Pantheon,1022,511,511,50
Khazix,Taliyah,171,57,114,33.33
Khazix,Kindred,285,124,161,43.51
Khazix,Evelynn,258,117,141,45.35
Khazix,Velkoz,347,186,161,53.6
Khazix,Garen,988,449,539,45.45
Khazix,AurelionSol,216,117,99,54.17
Khazix,Seraphine,527,275,252,52.18
Khazix,Briar,434,180,254,41.47
Khazix,Shyvana,128,65,63,50.78
Khazix,Zoe,225,107,118,47.56
Khazix,Maokai,220,110,110,50
Khazix,FiddleSticks,374,192,182,51.34
Khazix,Zyra,619,299,320,48.3
Khazix,Udyr,204,94,110,46.08
Khazix,Chogath,735,302,433,41.09
Khazix,Talon,510,280,230,54.9
Khazix,Nasus,432,207,225,47.92
Khazix,Sivir,328,155,173,47.26
Khazix,Sion,457,223,234,48.8
Khazix,Nunu,280,138,142,49.29
Khazix,Riven,286,128,158,44.76
Khazix,Xerath,650,297,353,45.69
Khazix,Darius,1233,600,633,48.66
Khazix,Ahri,790,376,414,47.59
Khazix,Elise,498,246,252,49.4
Khazix,Vladimir,471,249,222,52.87
Khazix,Braum,323,116,207,35.91
Khazix,Illaoi,251,125,126,49.8
Khazix,KSante,351,201,150,57.26
Khazix,Shaco,651,330,321,50.69
Khazix,Graves,597,311,286,52.09
Khazix,Vex,333,143,190,42.94
Khazix,Camille,264,166,98,62.88
Khazix,Singed,184,97,87,52.72
Khazix,Ziggs,236,117,119,49.58
Khazix,Nautilus,651,334,317,51.31
Khazix,Fizz,327,132,195,40.37
Khazix,Akshan,246,106,140,43.09
Khazix,Heimerdinger,294,117,177,39.8
Khazix,Zac,263,125,138,47.53
Khazix,Aphelios,407,176,231,43.24
Khazix,Leona,431,224,207,51.97
Khazix,Kayle,386,153,233,39.64
Khazix,Corki,274,171,103,62.41
Khazix,Aatrox,667,314,353,47.08
Khazix,XinZhao,426,200,226,46.95
Khazix,Ryze,251,121,130,48.21
Khazix,Quinn,271,128,143,47.23
Khazix,Karthus,220,130,90,59.09
Khazix,Skarner,142,48,94,33.8
Khazix,Azir,265,118,147,44.53
Khazix,KogMaw,188,79,109,42.02
Khazix,JarvanIV,369,176,193,47.7
Khazix,Swain,532,258,274,48.5
Khazix,Anivia,196,93,103,47.45
Khazix,Ivern,88,48,40,54.55
Khazix,Viktor,595,318,277,53.45
Khazix,Leblanc,418,215,203,51.44
Khazix,Lucian,513,258,255,50.29
Khazix,Rell,314,169,145,53.82
Khazix,Mordekaiser,801,378,423,47.19
Khazix,Orianna,293,132,161,45.05
Khazix,Kled,112,51,61,45.54
Khazix,Gragas,342,190,152,55.56
Khazix,Kennen,197,95,102,48.22
Khazix,Hecarim,305,155,150,50.82
Khazix,Lissandra,238,103,135,43.28
Khazix,Senna,428,217,211,50.7
Khazix,Fiora,229,105,124,45.85
Khazix,Vi,539,297,242,55.1
Khazix,Renekton,284,165,119,58.1
Khazix,Alistar,209,105,104,50.24
Khazix,Cassiopeia,188,90,98,47.87
Khazix,Samira,401,172,229,42.89
Khazix,Galio,515,227,288,44.08
Khazix,Sona,223,91,132,40.81
Khazix,Draven,334,174,160,52.1
Khazix,Volibear,669,283,386,42.3
Khazix,Sylas,904,472,432,52.21
Khazix,Qiyana,203,78,125,38.42
Khazix,Zilean,196,92,104,46.94
Khazix,Urgot,328,138,190,42.07
Khazix,Taric,149,61,88,40.94
Khazix,Gwen,304,152,152,50
Khazix,Varus,613,321,292,52.37
Khazix,Kassadin,146,87,59,59.59
Khazix,Naafiri,178,76,102,42.7
Khazix,Tryndamere,303,169,134,55.78
Khazix,Yuumi,465,229,236,49.25
Khazix,Gnar,246,121,125,49.19
Khazix,Rammus,177,79,98,44.63
Khazix,Janna,227,128,99,56.39
Khazix,Kalista,157,67,90,42.68
Khazix,Zeri,309,136,173,44.01
Khazix,Nidalee,288,161,127,55.9
Khazix,Belveth,151,80,71,52.98
Khazix,Annie,203,108,95,53.2
Khazix,RekSai,48,31,17,64.58
Khazix,TwistedFate,265,137,128,51.7
Khazix,Olaf,139,74,65,53.24
Khazix,Bard,173,67,106,38.73
Vayne,Teemo,2093,964,1129,46.06
Vayne,MonkeyKing,1227,620,607,50.53
Vayne,Katarina,1180,675,505,57.2
Vayne,Jinx,5252,2539,2713,48.34
Vayne,Blitzcrank,1109,557,552,50.23
Vayne,FiddleSticks,810,363,447,44.81
Vayne,Yone,2756,1534,1222,55.66
Vayne,Nilah,498,268,230,53.82
Vayne,Rell,790,363,427,45.95
Vayne,Kayle,1183,585,598,49.45
Vayne,Mordekaiser,2281,1189,1092,52.13
Vayne,Yasuo,3465,1720,1745,49.64
Vayne,Varus,1409,724,685,51.38
Vayne,Galio,1457,773,684,53.05
Vayne,MasterYi,2152,1109,1043,51.53
Vayne,Khazix,836,431,405,51.56
Vayne,Aurora,1192,593,599,49.75
Vayne,Ashe,3229,1620,1609,50.17
Vayne,Thresh,2345,1153,1192,49.17
Vayne,Fiora,524,306,218,58.4
Vayne,Warwick,2559,1196,1363,46.74
Vayne,Zed,1961,1010,951,51.5
Vayne,Swain,1658,867,791,52.29
Vayne,Chogath,2238,1197,1041,53.49
Vayne,Gwen,745,393,352,52.75
Vayne,TwistedFate,561,293,268,52.23
Vayne,Singed,503,268,235,53.28
Vayne,Vi,1631,756,875,46.35
Vayne,Ahri,2014,1035,979,51.39
Vayne,Jhin,3514,1885,1629,53.64
Vayne,Pyke,1254,649,605,51.75
Vayne,Nocturne,2098,1052,1046,50.14
Vayne,Sylas,2102,1117,985,53.14
Vayne,Yorick,1578,749,829,47.47
Vayne,Kindred,684,374,310,54.68
Vayne,Veigar,1730,872,858,50.4
Vayne,Tristana,1880,975,905,51.86
Vayne,Nautilus,2049,1053,996,51.39
Vayne,Darius,3757,1940,1817,51.64
Vayne,Braum,966,480,486,49.69
Vayne,Nunu,768,370,398,48.18
Vayne,Kayn,2453,1260,1193,51.37
Vayne,Morgana,1902,983,919,51.68
Vayne,Naafiri,513,244,269,47.56
Vayne,Akali,1837,1007,830,54.82
Vayne,Zyra,1497,766,731,51.17
Vayne,Aatrox,1473,764,709,51.87
Vayne,Evelynn,525,266,259,50.67
Vayne,Kaisa,3130,1566,1564,50.03
Vayne,Leona,1531,805,726,52.58
Vayne,Volibear,1906,1009,897,52.94
Vayne,Rengar,568,336,232,59.15
Vayne,Malzahar,1752,838,914,47.83
Vayne,TahmKench,1518,834,684,54.94
Vayne,Ambessa,1018,575,443,56.48
Vayne,JarvanIV,996,491,505,49.3
Vayne,Alistar,830,414,416,49.88
Vayne,Camille,594,299,295,50.34
Vayne,Caitlyn,4497,2229,2268,49.57
Vayne,Lux,3992,2077,1915,52.03
Vayne,Fizz,1057,543,514,51.37
Vayne,Samira,1324,692,632,52.27
Vayne,Ekko,1681,814,867,48.42
Vayne,Sett,2357,1222,1135,51.85
Vayne,Pantheon,2500,1285,1215,51.4
Vayne,MissFortune,4057,2052,2005,50.58
Vayne,Nami,1671,835,836,49.97
Vayne,Shaco,1596,813,783,50.94
Vayne,Leblanc,943,516,427,54.72
Vayne,Hwei,1033,500,533,48.4
Vayne,Gragas,897,493,404,54.96
Vayne,Ezreal,4512,2343,2169,51.93
Vayne,LeeSin,2271,1216,1055,53.54
Vayne,Sejuani,758,388,370,51.19
Vayne,Ziggs,555,290,265,52.25
Vayne,Bard,417,198,219,47.48
Vayne,Garen,3005,1547,1458,51.48
Vayne,Vex,850,421,429,49.53
Vayne,Zilean,512,239,273,46.68
Vayne,Udyr,611,332,279,54.34
Vayne,Akshan,673,338,335,50.22
Vayne,Zac,805,386,419,47.95
Vayne,Mel,3386,1821,1565,53.78
Vayne,Irelia,1385,663,722,47.87
Vayne,Sona,541,237,304,43.81
Vayne,KogMaw,616,283,333,45.94
Vayne,Lulu,2077,1075,1002,51.76
Vayne,Diana,2615,1341,1274,51.28
Vayne,Yuumi,1287,676,611,52.53
Vayne,Ornn,715,371,344,51.89
Vayne,Rakan,619,316,303,51.05
Vayne,Ryze,642,318,324,49.53
Vayne,Karma,1971,1051,920,53.32
Vayne,Gnar,645,315,330,48.84
Vayne,Tryndamere,924,496,428,53.68
Vayne,Taric,436,210,226,48.17
Vayne,Lucian,1352,697,655,51.55
Vayne,Briar,1092,551,541,50.46
Vayne,Qiyana,406,202,204,49.75
Vayne,Corki,708,338,370,47.74
Vayne,Amumu,1610,783,827,48.63
Vayne,Nidalee,409,208,201,50.86
Vayne,Nasus,1304,674,630,51.69
Vayne,Soraka,889,438,451,49.27
Vayne,Vladimir,1303,673,630,51.65
Vayne,Viego,2316,1154,1162,49.83
Vayne,Renekton,716,398,318,55.59
Vayne,Poppy,1121,568,553,50.67
Vayne,Viktor,1577,763,814,48.38
Vayne,Twitch,1464,730,734,49.86
Vayne,Kennen,439,234,205,53.3
Vayne,Shen,1143,618,525,54.07
Vayne,Maokai,807,419,388,51.92
Vayne,Cassiopeia,430,211,219,49.07
Vayne,Jax,1480,770,710,52.03
Vayne,Gangplank,854,403,451,47.19
Vayne,Neeko,726,380,346,52.34
Vayne,Hecarim,738,402,336,54.47
Vayne,Taliyah,372,160,212,43.01
Vayne,Senna,1164,545,619,46.82
Vayne,Talon,916,532,384,58.08
Vayne,Kassadin,411,201,210,48.91
Vayne,Renata,253,132,121,52.17
Vayne,Quinn,643,324,319,50.39
Vayne,Xayah,782,388,394,49.62
Vayne,Malphite,2173,1035,1138,47.63
Vayne,Jayce,662,340,322,51.36
Vayne,Rumble,417,197,220,47.24
Vayne,Kalista,440,265,175,60.23
Vayne,XinZhao,1121,593,528,52.9
Vayne,Orianna,744,414,330,55.65
Vayne,Lillia,900,481,419,53.44
Vayne,Milio,942,450,492,47.77
Vayne,Syndra,1122,555,567,49.47
Vayne,Rammus,631,316,315,50.08
Vayne,Riven,793,359,434,45.27
Vayne,Elise,1154,569,585,49.31
Vayne,Graves,1009,522,487,51.73
Vayne,Shyvana,488,272,216,55.74
Vayne,Azir,485,244,241,50.31
Vayne,Smolder,1097,631,466,57.52
Vayne,Sion,1361,724,637,53.2
Vayne,Janna,608,301,307,49.51
Vayne,Brand,1221,642,579,52.58
Vayne,Belveth,364,178,186,48.9
Vayne,Annie,506,256,250,50.59
Vayne,Aphelios,835,392,443,46.95
Vayne,Heimerdinger,777,354,423,45.56
Vayne,Sivir,828,460,368,55.56
Vayne,AurelionSol,672,353,319,52.53
Vayne,Karthus,503,275,228,54.67
Vayne,Xerath,1436,732,704,50.97
Vayne,Draven,935,462,473,49.41
Vayne,Trundle,925,456,469,49.3
Vayne,Anivia,459,201,258,43.79
Vayne,Kled,314,161,153,51.27
Vayne,Seraphine,1077,547,530,50.79
Vayne,Ivern,225,97,128,43.11
Vayne,Urgot,799,404,395,50.56
Vayne,KSante,929,564,365,60.71
Vayne,Illaoi,761,374,387,49.15
Vayne,Zoe,598,321,277,53.68
Vayne,Skarner,502,268,234,53.39
Vayne,Lissandra,647,292,355,45.13
Vayne,Zeri,708,399,309,56.36
Vayne,DrMundo,996,479,517,48.09
Vayne,Velkoz,1029,509,520,49.47
Vayne,RekSai,172,109,63,63.37
Vayne,Olaf,371,170,201,45.82
Morgana,Nasus,1133,557,576,49.16
Morgana,Nocturne,1940,881,1059,45.41
Morgana,Vladimir,858,435,423,50.7
Morgana,Jhin,3065,1520,1545,49.59
Morgana,Seraphine,1373,655,718,47.71
Morgana,Irelia,1122,585,537,52.14
Morgana,MasterYi,2011,964,1047,47.94
Morgana,Azir,462,212,250,45.89
Morgana,Lucian,965,471,494,48.81
Morgana,Mel,2979,1565,1414,52.53
Morgana,Chogath,1773,895,878,50.48
Morgana,Kindred,713,336,377,47.12
Morgana,Katarina,1150,564,586,49.04
Morgana,Tristana,1538,748,790,48.63
Morgana,Neeko,734,310,424,42.23
Morgana,Kayle,1153,561,592,48.66
Morgana,Darius,2769,1427,1342,51.53
Morgana,Malphite,1764,910,854,51.59
Morgana,Ezreal,3393,1773,1620,52.25
Morgana,Nami,1279,598,681,46.76
Morgana,Yorick,1655,774,881,46.77
Morgana,Briar,1139,555,584,48.73
Morgana,Malzahar,1623,794,829,48.92
Morgana,Nautilus,1639,859,780,52.41
Morgana,Viktor,1262,634,628,50.24
Morgana,Veigar,1779,919,860,51.66
Morgana,Brand,1406,720,686,51.21
Morgana,Riven,599,339,260,56.59
Morgana,Ziggs,693,367,326,52.96
Morgana,LeeSin,2027,1079,948,53.23
Morgana,Lux,5161,2604,2557,50.46
Morgana,Yasuo,3052,1559,1493,51.08
Morgana,Zed,1690,926,764,54.79
Morgana,Xerath,1502,768,734,51.13
Morgana,Vi,1516,768,748,50.66
Morgana,Ahri,1970,974,996,49.44
Morgana,Varus,1333,679,654,50.94
Morgana,Soraka,772,378,394,48.96
Morgana,Aatrox,1245,601,644,48.27
Morgana,Graves,910,440,470,48.35
Morgana,Ekko,1374,738,636,53.71
Morgana,Bard,341,179,162,52.49
Morgana,Pantheon,2334,1112,1222,47.64
Morgana,Velkoz,964,440,524,45.64
Morgana,Kayn,2174,1108,1066,50.97
Morgana,Rengar,423,228,195,53.9
Morgana,Fizz,965,480,485,49.74
Morgana,KogMaw,452,214,238,47.35
Morgana,Diana,2455,1166,1289,47.49
Morgana,Sett,2398,1165,1233,48.58
Morgana,XinZhao,1057,537,520,50.8
Morgana,Vayne,1902,919,983,48.32
Morgana,Karma,1816,832,984,45.81
Morgana,Hecarim,538,307,231,57.06
Morgana,Rumble,385,220,165,57.14
Morgana,FiddleSticks,774,348,426,44.96
Morgana,TahmKench,1213,664,549,54.74
Morgana,Aphelios,741,342,399,46.15
Morgana,Urgot,732,371,361,50.68
Morgana,Amumu,1750,832,918,47.54
Morgana,Evelynn,534,258,276,48.31
Morgana,Kaisa,2254,1150,1104,51.02
Morgana,Zilean,509,243,266,47.74
Morgana,Quinn,590,246,344,41.69
Morgana,Khazix,700,333,367,47.57
Morgana,Maokai,722,399,323,55.26
Morgana,Jinx,4440,2186,2254,49.23
Morgana,Leona,1406,731,675,51.99
Morgana,Caitlyn,4336,2292,2044,52.86
Morgana,Zeri,567,291,276,51.32
Morgana,Galio,1297,615,682,47.42
Morgana,Udyr,596,299,297,50.17
Morgana,Vex,887,461,426,51.97
Morgana,Elise,960,461,499,48.02
Morgana,Ashe,3163,1700,1463,53.75
Morgana,Garen,2436,1195,1241,49.06
Morgana,Leblanc,871,429,442,49.25
Morgana,Twitch,1164,547,617,46.99
Morgana,Poppy,761,356,405,46.78
Morgana,Smolder,902,501,401,55.54
Morgana,Mordekaiser,2004,958,1046,47.8
Morgana,Draven,696,346,350,49.71
Morgana,Sona,544,268,276,49.26
Morgana,Viego,1849,903,946,48.84
Morgana,Yuumi,1121,575,546,51.29
Morgana,Shen,945,536,409,56.72
Morgana,Heimerdinger,762,340,422,44.62
Morgana,Xayah,666,319,347,47.9
Morgana,Akali,1708,915,793,53.57
Morgana,Sejuani,676,347,329,51.33
Morgana,Yone,2663,1390,1273,52.2
Morgana,Zac,636,304,332,47.8
Morgana,Warwick,2400,1195,1205,49.79
Morgana,Sivir,913,457,456,50.05
Morgana,Ryze,445,198,247,44.49
Morgana,Zoe,543,266,277,48.99
Morgana,AurelionSol,608,336,272,55.26
Morgana,Volibear,1793,967,826,53.93
Morgana,Sylas,1848,964,884,52.16
Morgana,Nunu,859,442,417,51.46
Morgana,Shaco,1496,797,699,53.28
Morgana,Thresh,2140,1126,1014,52.62
Morgana,Fiora,496,250,246,50.4
Morgana,Talon,826,420,406,50.85
Morgana,Jax,1438,708,730,49.24
Morgana,Karthus,390,182,208,46.67
Morgana,MissFortune,3851,1917,1934,49.78
Morgana,Senna,1267,618,649,48.78
Morgana,Trundle,928,456,472,49.14
Morgana,Samira,1060,589,471,55.57
Morgana,Rammus,498,250,248,50.2
Morgana,Kassadin,347,177,170,51.01
Morgana,Milio,839,410,429,48.87
Morgana,Annie,604,314,290,51.99
Morgana,Corki,508,257,251,50.59
Morgana,Singed,412,208,204,50.49
Morgana,Aurora,925,450,475,48.65
Morgana,Lulu,1815,917,898,50.52
Morgana,JarvanIV,790,372,418,47.09
Morgana,Gnar,530,270,260,50.94
Morgana,Pyke,1167,572,595,49.01
Morgana,Lillia,887,464,423,52.31
Morgana,Anivia,534,271,263,50.75
Morgana,Gragas,659,362,297,54.93
Morgana,Teemo,2154,1065,1089,49.44
Morgana,Tryndamere,939,474,465,50.48
Morgana,Swain,1552,816,736,52.58
Morgana,Skarner,337,199,138,59.05
Morgana,Olaf,412,199,213,48.3
Morgana,Lissandra,479,226,253,47.18
Morgana,Camille,420,241,179,57.38
Morgana,Gwen,698,391,307,56.02
Morgana,Orianna,661,317,344,47.96
Morgana,DrMundo,999,501,498,50.15
Morgana,MonkeyKing,956,479,477,50.1
Morgana,RekSai,156,86,70,55.13
Morgana,Zyra,1589,787,802,49.53
Morgana,Alistar,415,227,188,54.7
Morgana,Hwei,920,465,455,50.54
Morgana,Braum,709,361,348,50.92
Morgana,Rakan,567,308,259,54.32
Morgana,Taliyah,293,156,137,53.24
Morgana,Sion,1056,545,511,51.61
Morgana,Renata,187,108,79,57.75
Morgana,Naafiri,508,229,279,45.08
Morgana,Blitzcrank,1145,581,564,50.74
Morgana,Syndra,856,391,465,45.68
Morgana,Kalista,348,169,179,48.56
Morgana,Gangplank,781,364,417,46.61
Morgana,Illaoi,838,423,415,50.48
Morgana,Ivern,163,68,95,41.72
Morgana,KSante,659,363,296,55.08
Morgana,Janna,390,194,196,49.74
Morgana,Kled,240,117,123,48.75
Morgana,Rell,685,368,317,53.72
Morgana,Ornn,571,314,257,54.99
Morgana,Renekton,729,390,339,53.5
Morgana,Kennen,319,159,160,49.84
Morgana,Belveth,303,139,164,45.87
Morgana,Jayce,586,309,277,52.73
Morgana,Qiyana,285,149,136,52.28
Morgana,TwistedFate,451,237,214,52.55
Morgana,Ambessa,753,380,373,50.46
Morgana,Taric,249,117,132,46.99
Morgana,Akshan,512,239,273,46.68
Morgana,Cassiopeia,433,199,234,45.96
Morgana,Nilah,499,244,255,48.9
Morgana,Shyvana,373,219,154,58.71
Morgana,Nidalee,329,155,174,47.11
Nasus,Yorick,973,436,537,44.81
Nasus,MasterYi,1338,682,656,50.97
Nasus,Ahri,1278,654,624,51.17
Nasus,Ezreal,2047,1071,976,52.32
Nasus,Morgana,1133,576,557,50.84
Nasus,Riven,367,181,186,49.32
Nasus,Nocturne,1210,622,588,51.4
Nasus,Veigar,1041,529,512,50.82
Nasus,Nilah,288,139,149,48.26
Nasus,Lissandra,306,164,142,53.59
Nasus,Garen,1800,818,982,45.44
Nasus,Amumu,986,511,475,51.83
Nasus,Jinx,2759,1428,1331,51.76
Nasus,Galio,751,401,350,53.4
Nasus,Irelia,696,364,332,52.3
Nasus,Zed,963,523,440,54.31
Nasus,Xayah,408,199,209,48.77
Nasus,Velkoz,473,210,263,44.4
Nasus,Gangplank,393,193,200,49.11
Nasus,Kindred,391,219,172,56.01
Nasus,Aurora,582,288,294,49.48
Nasus,Sivir,516,271,245,52.52
Nasus,Yuumi,764,414,350,54.19
Nasus,Kennen,291,168,123,57.73
Nasus,Volibear,1189,601,588,50.55
Nasus,Lux,2340,1210,1130,51.71
Nasus,Ashe,1863,993,870,53.3
Nasus,Leona,794,401,393,50.5
Nasus,Renekton,475,265,210,55.79
Nasus,Gragas,433,232,201,53.58
Nasus,Ziggs,340,169,171,49.71
Nasus,Caitlyn,2634,1279,1355,48.56
Nasus,Milio,456,235,221,51.54
Nasus,Warwick,1437,718,719,49.97
Nasus,Hwei,542,301,241,55.54
Nasus,Seraphine,731,380,351,51.98
Nasus,Swain,1025,501,524,48.88
Nasus,Kayn,1274,642,632,50.39
Nasus,Heimerdinger,535,272,263,50.84
Nasus,Lillia,508,246,262,48.43
Nasus,Naafiri,319,167,152,52.35
Nasus,Karma,1051,522,529,49.67
Nasus,Fiora,321,155,166,48.29
Nasus,Sett,1273,643,630,50.51
Nasus,Shen,536,278,258,51.87
Nasus,Udyr,325,187,138,57.54
Nasus,Pantheon,1378,661,717,47.97
Nasus,Graves,558,293,265,52.51
Nasus,Yasuo,2060,1041,1019,50.53
Nasus,Soraka,547,302,245,55.21
Nasus,Teemo,1335,698,637,52.28
Nasus,Shaco,865,480,385,55.49
Nasus,Vladimir,649,341,308,52.54
Nasus,Brand,816,368,448,45.1
Nasus,Kayle,790,440,350,55.7
Nasus,Viego,1309,698,611,53.32
Nasus,Varus,774,377,397,48.71
Nasus,Lulu,1176,606,570,51.53
Nasus,Fizz,573,326,247,56.89
Nasus,Darius,1767,877,890,49.63
Nasus,MonkeyKing,675,354,321,52.44
Nasus,Sylas,1172,622,550,53.07
Nasus,Rakan,281,134,147,47.69
Nasus,Aatrox,794,426,368,53.65
Nasus,Evelynn,331,147,184,44.41
Nasus,Jhin,1810,919,891,50.77
Nasus,Poppy,522,272,250,52.11
Nasus,Illaoi,524,262,262,50
Nasus,LeeSin,1259,692,567,54.96
Nasus,Tristana,876,411,465,46.92
Nasus,Janna,315,145,170,46.03
Nasus,Yone,1708,853,855,49.94
Nasus,Nidalee,220,133,87,60.45
Nasus,MissFortune,2378,1227,1151,51.6
Nasus,Pyke,706,374,332,52.97
Nasus,Vayne,1304,630,674,48.31
Nasus,Viktor,780,386,394,49.49
Nasus,Zac,415,181,234,43.61
Nasus,Trundle,679,366,313,53.9
Nasus,Mel,1920,1057,863,55.05
Nasus,Anivia,334,140,194,41.92
Nasus,Nautilus,970,516,454,53.2
Nasus,Singed,344,180,164,52.33
Nasus,TahmKench,724,365,359,50.41
Nasus,Urgot,553,266,287,48.1
Nasus,Chogath,1104,506,598,45.83
Nasus,Malphite,1094,576,518,52.65
Nasus,Zyra,741,350,391,47.23
Nasus,Thresh,1080,530,550,49.07
Nasus,Vi,895,400,495,44.69
Nasus,Neeko,395,240,155,60.76
Nasus,Ryze,334,147,187,44.01
Nasus,Kaisa,1436,819,617,57.03
Nasus,Mordekaiser,1359,685,674,50.4
Nasus,Twitch,639,340,299,53.21
Nasus,Tryndamere,586,337,249,57.51
Nasus,Khazix,432,224,208,51.85
Nasus,Malzahar,983,506,477,51.48
Nasus,Ekko,769,400,369,52.02
Nasus,Sion,739,371,368,50.2
Nasus,Akali,872,450,422,51.61
Nasus,Quinn,309,162,147,52.43
Nasus,KogMaw,315,162,153,51.43
Nasus,Blitzcrank,653,296,357,45.33
Nasus,Talon,440,219,221,49.77
Nasus,Lucian,575,288,287,50.09
Nasus,Karthus,208,115,93,55.29
Nasus,TwistedFate,294,149,145,50.68
Nasus,Ornn,331,190,141,57.4
Nasus,Sejuani,388,181,207,46.65
Nasus,Jax,718,372,346,51.81
Nasus,Katarina,663,357,306,53.85
Nasus,Samira,658,361,297,54.86
Nasus,Draven,439,232,207,52.85
Nasus,Diana,1549,756,793,48.81
Nasus,Braum,470,266,204,56.6
Nasus,Zeri,387,211,176,54.52
Nasus,Rell,388,203,185,52.32
Nasus,Camille,333,171,162,51.35
Nasus,Rengar,270,161,109,59.63
Nasus,Ivern,125,60,65,48
Nasus,Senna,591,309,282,52.28
Nasus,Alistar,367,216,151,58.86
Nasus,Leblanc,475,268,207,56.42
Nasus,Gwen,469,252,217,53.73
Nasus,Smolder,627,354,273,56.46
Nasus,Zoe,228,126,102,55.26
Nasus,Skarner,178,91,87,51.12
Nasus,Taliyah,155,68,87,43.87
Nasus,Sona,314,124,190,39.49
Nasus,Briar,732,379,353,51.78
Nasus,Ambessa,418,224,194,53.59
Nasus,Kled,171,83,88,48.54
Nasus,Syndra,513,268,245,52.24
Nasus,Zilean,340,178,162,52.35
Nasus,Rammus,251,115,136,45.82
Nasus,Qiyana,203,91,112,44.83
Nasus,Nami,758,355,403,46.83
Nasus,Kalista,207,101,106,48.79
Nasus,Taric,179,89,90,49.72
Nasus,FiddleSticks,494,236,258,47.77
Nasus,Vex,489,254,235,51.94
Nasus,Aphelios,463,235,228,50.76
Nasus,Hecarim,430,221,209,51.4
Nasus,DrMundo,527,290,237,55.03
Nasus,KSante,448,262,186,58.48
Nasus,Belveth,230,122,108,53.04
Nasus,Kassadin,193,117,76,60.62
Nasus,Xerath,745,401,344,53.83
Nasus,AurelionSol,404,195,209,48.27
Nasus,Rumble,227,112,115,49.34
Nasus,Orianna,354,146,208,41.24
Nasus,Nunu,446,230,216,51.57
Nasus,XinZhao,547,289,258,52.83
Nasus,Renata,176,79,97,44.89
Nasus,Gnar,291,160,131,54.98
Nasus,Maokai,406,212,194,52.22
Nasus,Corki,310,149,161,48.06
Nasus,Elise,533,264,269,49.53
Nasus,Annie,269,134,135,49.81
Nasus,Cassiopeia,237,111,126,46.84
Nasus,Olaf,184,80,104,43.48
Nasus,Bard,265,136,129,51.32
Nasus,Azir,262,122,140,46.56
Nasus,JarvanIV,529,280,249,52.93
Nasus,Shyvana,208,93,115,44.71
Nasus,Akshan,281,154,127,54.8
Nasus,Jayce,322,194,128,60.25
Nasus,RekSai,92,49,43,53.26
Jhin,Yorick,2598,1213,1385,46.69
Jhin,MasterYi,3400,1599,1801,47.03
Jhin,Ahri,3399,1719,1680,50.57
Jhin,Ezreal,7621,3882,3739,50.94
Jhin,Morgana,3065,1545,1520,50.41
Jhin,Darius,5112,2628,2484,51.41
Jhin,Amumu,2722,1383,1339,50.81
Jhin,Aurora,1760,869,891,49.38
Jhin,Lux,6857,3472,3385,50.63
Jhin,Seraphine,1949,997,952,51.15
Jhin,Renekton,1376,686,690,49.85
Jhin,Diana,4117,2018,2099,49.02
Jhin,Azir,864,457,407,52.89
Jhin,MissFortune,6888,3357,3531,48.74
Jhin,Yuumi,2177,1068,1109,49.06
Jhin,Pantheon,4030,1948,2082,48.34
Jhin,Gwen,1186,553,633,46.63
Jhin,Fizz,1532,714,818,46.61
Jhin,Jinx,8354,3957,4397,47.37
Jhin,Ivern,382,212,170,55.5
Jhin,Aatrox,2403,1158,1245,48.19
Jhin,Khazix,1273,673,600,52.87
Jhin,Neeko,1083,566,517,52.26
Jhin,Garen,4296,2019,2277,47
Jhin,Nocturne,3566,1645,1921,46.13
Jhin,Thresh,3503,1708,1795,48.76
Jhin,Vladimir,1858,935,923,50.32
Jhin,Caitlyn,9338,4847,4491,51.91
Jhin,Lulu,3841,1912,1929,49.78
Jhin,Urgot,1363,657,706,48.2
Jhin,Galio,2315,1178,1137,50.89
Jhin,Varus,2502,1270,1232,50.76
Jhin,Viktor,2479,1300,1179,52.44
Jhin,Veigar,2463,1245,1218,50.55
Jhin,Brand,1918,996,922,51.93
Jhin,Yone,4910,2532,2378,51.57
Jhin,Warwick,3896,1987,1909,51
Jhin,Hwei,1824,976,848,53.51
Jhin,Malphite,2640,1295,1345,49.05
Jhin,Chogath,2998,1535,1463,51.2
Jhin,Tristana,2818,1351,1467,47.94
Jhin,Vayne,3514,1626,1888,46.27
Jhin,Corki,1007,519,488,51.54
Jhin,Mordekaiser,3323,1546,1777,46.52
Jhin,Vi,2235,1144,1091,51.19
Jhin,Vex,1394,688,706,49.35
Jhin,Gangplank,1444,726,718,50.28
Jhin,Anivia,859,384,475,44.7
Jhin,Zyra,2780,1370,1410,49.28
Jhin,Yasuo,5352,2637,2715,49.27
Jhin,Talon,1532,776,756,50.65
Jhin,Soraka,1494,680,814,45.52
Jhin,Sion,1797,832,965,46.3
Jhin,Shaco,2495,1259,1236,50.46
Jhin,Malzahar,2853,1448,1405,50.75
Jhin,Milio,1515,750,765,49.5
Jhin,Ambessa,1561,840,721,53.81
Jhin,Taliyah,586,284,302,48.46
Jhin,Elise,1807,934,873,51.69
Jhin,Zed,3124,1568,1556,50.19
Jhin,Sivir,1370,703,667,51.31
Jhin,Teemo,3145,1597,1548,50.78
Jhin,Volibear,2902,1479,1423,50.96
Jhin,Ashe,6018,3045,2973,50.6
Jhin,Xerath,2582,1307,1275,50.62
Jhin,XinZhao,1698,804,894,47.35
Jhin,Briar,1939,904,1035,46.62
Jhin,AurelionSol,1037,508,529,48.99
Jhin,LeeSin,4282,2245,2037,52.43
Jhin,Kassadin,522,261,261,50
Jhin,Heimerdinger,1219,566,653,46.43
Jhin,Renata,437,210,227,48.05
Jhin,Sett,3829,1783,2046,46.57
Jhin,Ziggs,933,474,459,50.8
Jhin,Kaisa,4500,2199,2301,48.87
Jhin,Kayn,3823,1800,2023,47.08
Jhin,Janna,813,406,407,49.94
Jhin,Gragas,1369,730,639,53.32
Jhin,Senna,1850,975,875,52.7
Jhin,Karthus,859,400,459,46.57
Jhin,Ekko,2484,1200,1284,48.31
Jhin,KogMaw,767,381,386,49.67
Jhin,Jax,2334,1286,1048,55.1
Jhin,Rammus,789,426,363,53.99
Jhin,Swain,2500,1185,1315,47.4
Jhin,Kayle,1825,889,936,48.71
Jhin,Lucian,1996,1020,976,51.1
Jhin,Nami,2792,1287,1505,46.1
Jhin,Nidalee,747,420,327,56.22
Jhin,Akali,2892,1420,1472,49.1
Jhin,Skarner,614,346,268,56.35
Jhin,Riven,1173,576,597,49.1
Jhin,Graves,1891,919,972,48.6
Jhin,Aphelios,1437,752,685,52.33
Jhin,TahmKench,1839,928,911,50.46
Jhin,Nunu,1360,645,715,47.43
Jhin,Hecarim,1103,640,463,58.02
Jhin,Katarina,2103,1040,1063,49.45
Jhin,Syndra,1601,812,789,50.72
Jhin,Cassiopeia,731,369,362,50.48
Jhin,Samira,1684,854,830,50.71
Jhin,Blitzcrank,1851,888,963,47.97
Jhin,Illaoi,1176,555,621,47.19
Jhin,Mel,5399,2867,2532,53.1
Jhin,FiddleSticks,1335,679,656,50.86
Jhin,Irelia,2292,1170,1122,51.05
Jhin,Camille,911,463,448,50.82
Jhin,Rengar,868,496,372,57.14
Jhin,Zilean,875,434,441,49.6
Jhin,Viego,3981,2007,1974,50.41
Jhin,Xayah,1112,556,556,50
Jhin,KSante,1363,736,627,54
Jhin,Karma,3469,1647,1822,47.48
Jhin,Shen,1558,807,751,51.8
Jhin,Sejuani,1084,581,503,53.6
Jhin,Nautilus,2781,1416,1365,50.92
Jhin,Annie,828,418,410,50.48
Jhin,Leona,2142,1095,1047,51.12
Jhin,Naafiri,908,426,482,46.92
Jhin,Quinn,1014,467,547,46.06
Jhin,Poppy,1397,689,708,49.32
Jhin,Kennen,718,375,343,52.23
Jhin,Smolder,1745,915,830,52.44
Jhin,Lillia,1428,681,747,47.69
Jhin,Draven,1377,706,671,51.27
Jhin,Sylas,3491,1771,1720,50.73
Jhin,Qiyana,686,357,329,52.04
Jhin,Ornn,1026,484,542,47.17
Jhin,Velkoz,1553,792,761,51
Jhin,Pyke,2020,1012,1008,50.1
Jhin,Belveth,605,320,285,52.89
Jhin,Jayce,1321,673,648,50.95
Jhin,Udyr,965,546,419,56.58
Jhin,Sona,872,432,440,49.54
Jhin,DrMundo,1511,764,747,50.56
Jhin,Rell,1128,557,571,49.38
Jhin,Nasus,1810,888,922,49.06
Jhin,Braum,1415,619,796,43.75
Jhin,Twitch,2088,1108,980,53.07
Jhin,Olaf,627,330,297,52.63
Jhin,Trundle,1503,749,754,49.83
Jhin,Gnar,1115,546,569,48.97
Jhin,MonkeyKing,1899,868,1031,45.71
Jhin,Rakan,1023,486,537,47.51
Jhin,Maokai,1093,485,608,44.37
Jhin,Kalista,641,327,314,51.01
Jhin,Singed,669,331,338,49.48
Jhin,Shyvana,686,341,345,49.71
Jhin,Tryndamere,1464,712,752,48.63
Jhin,Bard,786,382,404,48.6
Jhin,Zoe,973,447,526,45.94
Jhin,Zac,1208,564,644,46.69
Jhin,Leblanc,1678,835,843,49.76
Jhin,JarvanIV,1613,716,897,44.39
Jhin,Akshan,875,465,410,53.14
Jhin,Alistar,1024,485,539,47.36
Jhin,RekSai,296,122,174,41.22
Jhin,Rumble,790,399,391,50.51
Jhin,Kindred,1130,606,524,53.63
Jhin,Evelynn,823,409,414,49.7
Jhin,Zeri,1014,501,513,49.41
Jhin,Orianna,1004,541,463,53.88
Jhin,Nilah,724,349,375,48.2
Jhin,Fiora,972,471,501,48.46
Jhin,Ryze,881,460,421,52.21
Jhin,Taric,515,253,262,49.13
Jhin,Lissandra,896,451,445,50.33
Jhin,Kled,464,221,243,47.63
Jhin,TwistedFate,1034,597,437,57.74
Seraphine,Yorick,987,443,544,44.88
Seraphine,MasterYi,1154,555,599,48.09
Seraphine,Ahri,1292,644,648,49.85
Seraphine,Ezreal,1954,959,995,49.08
Seraphine,Morgana,1373,718,655,52.29
Seraphine,Trundle,558,283,275,50.72
Seraphine,Briar,746,351,395,47.05
Seraphine,Katarina,700,358,342,51.14
Seraphine,Jhin,1949,952,997,48.85
Seraphine,Pyke,651,292,359,44.85
Seraphine,Aatrox,784,403,381,51.4
Seraphine,Kayn,1340,663,677,49.48
Seraphine,Blitzcrank,650,315,335,48.46
Seraphine,Kennen,219,113,106,51.6
Seraphine,Darius,1808,930,878,51.44
Seraphine,Lux,3058,1483,1575,48.5
Seraphine,Caitlyn,2750,1384,1366,50.33
Seraphine,Zyra,994,468,526,47.08
Seraphine,Jax,854,471,383,55.15
Seraphine,Skarner,199,120,79,60.3
Seraphine,Irelia,728,371,357,50.96
Seraphine,MissFortune,2378,1109,1269,46.64
Seraphine,Alistar,293,146,147,49.83
Seraphine,Teemo,1332,664,668,49.85
Seraphine,Volibear,1229,589,640,47.93
Seraphine,Vladimir,593,282,311,47.55
Seraphine,Ashe,1824,933,891,51.15
Seraphine,Xerath,788,366,422,46.45
Seraphine,Heimerdinger,497,233,264,46.88
Seraphine,Azir,292,165,127,56.51
Seraphine,Varus,837,413,424,49.34
Seraphine,Renata,152,74,78,48.68
Seraphine,Leona,758,414,344,54.62
Seraphine,TahmKench,674,395,279,58.61
Seraphine,Syndra,486,250,236,51.44
Seraphine,Samira,669,312,357,46.64
Seraphine,Pantheon,1515,730,785,48.18
Seraphine,Nasus,731,351,380,48.02
Seraphine,Amumu,1072,544,528,50.75
Seraphine,Ryze,291,134,157,46.05
Seraphine,Neeko,525,279,246,53.14
Seraphine,Elise,603,288,315,47.76
Seraphine,Veigar,1008,521,487,51.69
Seraphine,Smolder,508,272,236,53.54
Seraphine,Soraka,494,265,229,53.64
Seraphine,Naafiri,368,189,179,51.36
Seraphine,Jinx,2734,1378,1356,50.4
Seraphine,Nautilus,996,530,466,53.21
Seraphine,Diana,1490,695,795,46.64
Seraphine,Karma,1239,596,643,48.1
Seraphine,Aurora,597,292,305,48.91
Seraphine,Shaco,918,471,447,51.31
Seraphine,Lulu,1323,729,594,55.1
Seraphine,Ekko,847,434,413,51.24
Seraphine,Thresh,1137,574,563,50.48
Seraphine,Sion,647,278,369,42.97
Seraphine,Gangplank,446,196,250,43.95
Seraphine,Aphelios,486,242,244,49.79
Seraphine,Warwick,1539,741,798,48.15
Seraphine,Ambessa,433,217,216,50.12
Seraphine,Ivern,122,71,51,58.2
Seraphine,TwistedFate,346,180,166,52.02
Seraphine,Senna,809,387,422,47.84
Seraphine,Yasuo,1706,758,948,44.43
Seraphine,Rammus,268,163,105,60.82
Seraphine,Velkoz,636,304,332,47.8
Seraphine,Gwen,452,222,230,49.12
Seraphine,Yone,1640,808,832,49.27
Seraphine,Xayah,363,215,148,59.23
Seraphine,Milio,527,239,288,45.35
Seraphine,KSante,422,229,193,54.27
Seraphine,Rengar,268,133,135,49.63
Seraphine,Malzahar,1123,566,557,50.4
Seraphine,Sivir,559,296,263,52.95
Seraphine,Malphite,1027,495,532,48.2
Seraphine,Viktor,773,385,388,49.81
Seraphine,Sett,1475,708,767,48
Seraphine,FiddleSticks,513,224,289,43.66
Seraphine,Mel,1727,910,817,52.69
Seraphine,Sona,394,163,231,41.37
Seraphine,Khazix,527,252,275,47.82
Seraphine,Ziggs,364,199,165,54.67
Seraphine,Camille,350,172,178,49.14
Seraphine,Swain,878,427,451,48.63
Seraphine,DrMundo,538,292,246,54.28
Seraphine,XinZhao,650,293,357,45.08
Seraphine,Sylas,1312,683,629,52.06
Seraphine,Twitch,794,403,391,50.76
Seraphine,Mordekaiser,1249,558,691,44.68
Seraphine,Nocturne,1202,551,651,45.84
Seraphine,Braum,409,184,225,44.99
Seraphine,Lillia,510,253,257,49.61
Seraphine,Zed,960,506,454,52.71
Seraphine,Nami,914,422,492,46.17
Seraphine,Nunu,524,252,272,48.09
Seraphine,Taric,144,92,52,63.89
Seraphine,Urgot,588,294,294,50
Seraphine,KogMaw,285,157,128,55.09
Seraphine,Vi,831,412,419,49.58
Seraphine,Draven,479,226,253,47.18
Seraphine,Tristana,956,453,503,47.38
Seraphine,Yuumi,703,361,342,51.35
Seraphine,Kayle,720,364,356,50.56
Seraphine,JarvanIV,531,259,272,48.78
Seraphine,Vex,524,282,242,53.82
Seraphine,Tryndamere,499,244,255,48.9
Seraphine,Riven,385,190,195,49.35
Seraphine,AurelionSol,343,185,158,53.94
Seraphine,LeeSin,1079,558,521,51.71
Seraphine,Brand,817,360,457,44.06
Seraphine,Gragas,391,176,215,45.01
Seraphine,Gnar,338,178,160,52.66
Seraphine,Anivia,313,148,165,47.28
Seraphine,Garen,1466,728,738,49.66
Seraphine,Illaoi,438,197,241,44.98
Seraphine,Kled,143,56,87,39.16
Seraphine,Fizz,614,314,300,51.14
Seraphine,Singed,272,113,159,41.54
Seraphine,Akali,1060,556,504,52.45
Seraphine,Nidalee,228,126,102,55.26
Seraphine,Zoe,322,155,167,48.14
Seraphine,Ornn,381,203,178,53.28
Seraphine,Orianna,380,177,203,46.58
Seraphine,Zilean,233,123,110,52.79
Seraphine,Shen,521,260,261,49.9
Seraphine,Talon,488,206,282,42.21
Seraphine,Chogath,1059,576,483,54.39
Seraphine,Qiyana,197,97,100,49.24
Seraphine,Poppy,501,263,238,52.5
Seraphine,Galio,756,364,392,48.15
Seraphine,Vayne,1077,530,547,49.21
Seraphine,MonkeyKing,586,297,289,50.68
Seraphine,Viego,1369,681,688,49.74
Seraphine,Jayce,390,208,182,53.33
Seraphine,Kaisa,1481,786,695,53.07
Seraphine,Evelynn,323,181,142,56.04
Seraphine,Akshan,337,185,152,54.9
Seraphine,Leblanc,524,237,287,45.23
Seraphine,Rakan,311,170,141,54.66
Seraphine,Kalista,221,97,124,43.89
Seraphine,Hwei,589,283,306,48.05
Seraphine,Nilah,333,187,146,56.16
Seraphine,Bard,242,117,125,48.35
Seraphine,Belveth,218,114,104,52.29
Seraphine,Karthus,258,126,132,48.84
Seraphine,Taliyah,210,88,122,41.9
Seraphine,Lissandra,271,131,140,48.34
Seraphine,Kindred,393,204,189,51.91
Seraphine,Renekton,437,208,229,47.6
Seraphine,Zeri,366,188,178,51.37
Seraphine,Janna,293,144,149,49.15
Seraphine,Hecarim,350,197,153,56.29
Seraphine,Sejuani,384,191,193,49.74
Seraphine,Udyr,349,171,178,49
Seraphine,Annie,280,153,127,54.64
Seraphine,Graves,486,224,262,46.09
Seraphine,Lucian,551,251,300,45.55
Seraphine,Rumble,185,98,87,52.97
Seraphine,Kassadin,188,84,104,44.68
Seraphine,Quinn,394,204,190,51.78
Seraphine,Rell,390,179,211,45.9
Seraphine,Corki,317,181,136,57.1
Seraphine,Fiora,324,153,171,47.22
Seraphine,Maokai,412,180,232,43.69
Seraphine,Cassiopeia,224,113,111,50.45
Seraphine,Zac,408,201,207,49.26
Seraphine,Olaf,199,103,96,51.76
Seraphine,RekSai,99,46,53,46.46
Seraphine,Shyvana,218,111,107,50.92
Illaoi,Rakan,221,118,103,53.39
Illaoi,Ekko,555,286,269,51.53
Illaoi,Veigar,643,293,350,45.57
Illaoi,Ashe,1276,648,628,50.78
Illaoi,Soraka,309,138,171,44.66
Illaoi,Teemo,670,291,379,43.43
Illaoi,Briar,432,203,229,46.99
Illaoi,Yasuo,1256,645,611,51.35
Illaoi,MissFortune,1677,794,883,47.35
Illaoi,Blitzcrank,436,220,216,50.46
Illaoi,Volibear,855,407,448,47.6
Illaoi,Vladimir,337,163,174,48.37
Illaoi,Xerath,530,259,271,48.87
Illaoi,TahmKench,509,260,249,51.08
Illaoi,Rengar,153,89,64,58.17
Illaoi,Akali,634,290,344,45.74
Illaoi,Jhin,1176,621,555,52.81
Illaoi,Brand,487,218,269,44.76
Illaoi,Yone,1096,562,534,51.28
Illaoi,Nunu,313,163,150,52.08
Illaoi,Irelia,519,253,266,48.75
Illaoi,Mel,1168,616,552,52.74
Illaoi,Lux,1575,755,820,47.94
Illaoi,Jayce,231,114,117,49.35
Illaoi,Diana,996,470,526,47.19
Illaoi,Anivia,177,57,120,32.2
Illaoi,Ezreal,1261,621,640,49.25
Illaoi,Renekton,338,185,153,54.73
Illaoi,Zilean,152,79,73,51.97
Illaoi,Lucian,411,166,245,40.39
Illaoi,Riven,252,134,118,53.17
Illaoi,Nautilus,692,335,357,48.41
Illaoi,Ahri,782,396,386,50.64
Illaoi,Caitlyn,1601,777,824,48.53
Illaoi,Garen,1052,477,575,45.34
Illaoi,Rammus,220,129,91,58.64
Illaoi,Malzahar,638,301,337,47.18
Illaoi,Xayah,255,112,143,43.92
Illaoi,Chogath,796,412,384,51.76
Illaoi,Sylas,824,495,329,60.07
Illaoi,Tristana,664,296,368,44.58
Illaoi,MasterYi,830,381,449,45.9
Illaoi,Vex,272,120,152,44.12
Illaoi,Kayle,416,173,243,41.59
Illaoi,Pantheon,907,429,478,47.3
Illaoi,Samira,458,238,220,51.97
Illaoi,Kayn,883,440,443,49.83
Illaoi,Viktor,454,218,236,48.02
Illaoi,Sejuani,216,101,115,46.76
Illaoi,Kaisa,953,448,505,47.01
Illaoi,JarvanIV,324,156,168,48.15
Illaoi,Nocturne,745,389,356,52.21
Illaoi,Nasus,524,262,262,50
Illaoi,Senna,417,175,242,41.97
Illaoi,Mordekaiser,1071,474,597,44.26
Illaoi,Jinx,1652,854,798,51.69
Illaoi,Thresh,709,371,338,52.33
Illaoi,Viego,785,379,406,48.28
Illaoi,Aurora,432,197,235,45.6
Illaoi,Sett,1050,520,530,49.52
Illaoi,Leona,511,258,253,50.49
Illaoi,Warwick,921,434,487,47.12
Illaoi,Shen,386,219,167,56.74
Illaoi,Twitch,433,232,201,53.58
Illaoi,Lulu,694,352,342,50.72
Illaoi,Vi,522,259,263,49.62
Illaoi,Zed,679,301,378,44.33
Illaoi,Kalista,140,72,68,51.43
Illaoi,Milio,318,162,156,50.94
Illaoi,Swain,563,269,294,47.78
Illaoi,Darius,1174,627,547,53.41
Illaoi,Qiyana,120,71,49,59.17
Illaoi,Yuumi,457,224,233,49.02
Illaoi,Zac,264,126,138,47.73
Illaoi,Shaco,584,291,293,49.83
Illaoi,Jax,685,381,304,55.62
Illaoi,Katarina,460,227,233,49.35
Illaoi,Khazix,251,126,125,50.2
Illaoi,Syndra,339,188,151,55.46
Illaoi,Nilah,180,105,75,58.33
Illaoi,Ziggs,194,106,88,54.64
Illaoi,Lissandra,208,110,98,52.88
Illaoi,Lillia,294,146,148,49.66
Illaoi,Pyke,522,264,258,50.57
Illaoi,Gragas,287,140,147,48.78
Illaoi,Seraphine,438,241,197,55.02
Illaoi,Ornn,249,119,130,47.79
Illaoi,Heimerdinger,253,103,150,40.71
Illaoi,Nami,552,239,313,43.3
Illaoi,Kassadin,96,37,59,38.54
Illaoi,Draven,275,164,111,59.64
Illaoi,Karma,566,248,318,43.82
Illaoi,DrMundo,391,196,195,50.13
Illaoi,Hwei,365,186,179,50.96
Illaoi,Sion,382,190,192,49.74
Illaoi,TwistedFate,217,117,100,53.92
Illaoi,Zyra,546,251,295,45.97
Illaoi,Gangplank,231,127,104,54.98
Illaoi,Elise,388,168,220,43.3
Illaoi,Ambessa,316,183,133,57.91
Illaoi,Poppy,364,183,181,50.27
Illaoi,Cassiopeia,129,65,64,50.39
Illaoi,Kindred,241,114,127,47.3
Illaoi,Velkoz,345,147,198,42.61
Illaoi,Shyvana,169,104,65,61.54
Illaoi,Zoe,158,78,80,49.37
Illaoi,Orianna,272,130,142,47.79
Illaoi,Leblanc,354,191,163,53.95
Illaoi,Taliyah,132,60,72,45.45
Illaoi,Quinn,165,77,88,46.67
Illaoi,Maokai,317,178,139,56.15
Illaoi,Naafiri,176,69,107,39.2
Illaoi,Graves,325,128,197,39.38
Illaoi,Morgana,838,415,423,49.52
Illaoi,Olaf,171,95,76,55.56
Illaoi,Aphelios,290,112,178,38.62
Illaoi,Yorick,667,263,404,39.43
Illaoi,Urgot,266,143,123,53.76
Illaoi,Tryndamere,377,207,170,54.91
Illaoi,Rell,256,152,104,59.38
Illaoi,Trundle,444,219,225,49.32
Illaoi,Galio,531,260,271,48.96
Illaoi,Braum,272,130,142,47.79
Illaoi,Kled,106,44,62,41.51
Illaoi,Amumu,660,316,344,47.88
Illaoi,Azir,220,127,93,57.73
Illaoi,Sivir,317,155,162,48.9
Illaoi,Smolder,382,180,202,47.12
Illaoi,Hecarim,188,111,77,59.04
Illaoi,Varus,518,277,241,53.47
Illaoi,Vayne,761,387,374,50.85
Illaoi,Skarner,142,84,58,59.15
Illaoi,Gnar,191,112,79,58.64
Illaoi,Sona,165,82,83,49.7
Illaoi,Aatrox,489,247,242,50.51
Illaoi,XinZhao,362,161,201,44.48
Illaoi,Singed,164,70,94,42.68
Illaoi,LeeSin,797,425,372,53.32
Illaoi,Fizz,312,176,136,56.41
Illaoi,KogMaw,190,104,86,54.74
Illaoi,Ivern,50,21,29,42
Illaoi,Talon,267,155,112,58.05
Illaoi,Belveth,142,78,64,54.93
Illaoi,Camille,205,112,93,54.63
Illaoi,Udyr,222,107,115,48.2
Illaoi,Karthus,167,97,70,58.08
Illaoi,Corki,224,123,101,54.91
Illaoi,AurelionSol,230,90,140,39.13
Illaoi,KSante,292,162,130,55.48
Illaoi,Annie,157,81,76,51.59
Illaoi,Malphite,618,308,310,49.84
Illaoi,Fiora,187,97,90,51.87
Illaoi,MonkeyKing,422,228,194,54.03
Illaoi,Alistar,256,153,103,59.77
Illaoi,Evelynn,185,92,93,49.73
Illaoi,FiddleSticks,290,156,134,53.79
Illaoi,Nidalee,169,88,81,52.07
Illaoi,Renata,86,31,55,36.05
Illaoi,Akshan,177,67,110,37.85
Illaoi,Janna,171,71,100,41.52
Illaoi,Ryze,186,76,110,40.86
Illaoi,Neeko,279,172,107,61.65
Illaoi,Kennen,100,46,54,46
Illaoi,Gwen,281,140,141,49.82
Illaoi,Taric,110,53,57,48.18
Illaoi,Zeri,196,93,103,47.45
Illaoi,RekSai,49,20,29,40.82
Illaoi,Bard,153,78,75,50.98
Illaoi,Rumble,158,65,93,41.14
Milio,Rakan,244,112,132,45.9
Milio,Ekko,798,420,378,52.63
Milio,Veigar,697,343,354,49.21
Milio,Ashe,1538,836,702,54.36
Milio,Soraka,537,281,256,52.33
Milio,Darius,1432,736,696,51.4
Milio,Khazix,360,172,188,47.78
Milio,Zed,838,469,369,55.97
Milio,Aphelios,449,233,216,51.89
Milio,Pyke,526,269,257,51.14
Milio,Nocturne,881,445,436,50.51
Milio,Lux,1760,918,842,52.16
Milio,Lucian,516,285,231,55.23
Milio,Thresh,1005,507,498,50.45
Milio,Tryndamere,485,241,244,49.69
Milio,Amumu,802,418,384,52.12
Milio,Vex,357,205,152,57.42
Milio,Jinx,2066,1053,1013,50.97
Milio,Mel,1443,877,566,60.78
Milio,Gangplank,462,247,215,53.46
Milio,Lillia,444,231,213,52.03
Milio,Caitlyn,2080,1077,1003,51.78
Milio,Renata,144,66,78,45.83
Milio,Warwick,1093,543,550,49.68
Milio,Hwei,484,225,259,46.49
Milio,Jhin,1515,765,750,50.5
Milio,Nami,1129,630,499,55.8
Milio,Shyvana,162,109,53,67.28
Milio,Ambessa,418,226,192,54.07
Milio,Garen,1144,583,561,50.96
Milio,MonkeyKing,500,278,222,55.6
Milio,Akshan,255,150,105,58.82
Milio,Tristana,739,413,326,55.89
Milio,Swain,593,311,282,52.45
Milio,TahmKench,480,281,199,58.54
Milio,Briar,454,235,219,51.76
Milio,Malzahar,900,459,441,51
Milio,Pantheon,1153,585,568,50.74
Milio,Skarner,181,97,84,53.59
Milio,MissFortune,1496,794,702,53.07
Milio,Ezreal,1718,967,751,56.29
Milio,Olaf,194,98,96,50.52
Milio,Trundle,415,210,205,50.6
Milio,Xerath,652,309,343,47.39
Milio,Chogath,858,427,431,49.77
Milio,Nasus,456,221,235,48.46
Milio,Akali,717,363,354,50.63
Milio,Corki,335,199,136,59.4
Milio,Riven,388,185,203,47.68
Milio,Nunu,371,176,195,47.44
Milio,Nilah,183,107,76,58.47
Milio,Zoe,284,137,147,48.24
Milio,Aatrox,699,391,308,55.94
Milio,Vi,698,375,323,53.72
Milio,Kaisa,1191,644,547,54.07
Milio,Nautilus,757,419,338,55.35
Milio,Anivia,255,127,128,49.8
Milio,Gwen,393,193,200,49.11
Milio,Velkoz,388,199,189,51.29
Milio,Syndra,502,284,218,56.57
Milio,Renekton,355,193,162,54.37
Milio,Mordekaiser,937,460,477,49.09
Milio,Ahri,974,539,435,55.34
Milio,Rell,339,171,168,50.44
Milio,Teemo,791,386,405,48.8
Milio,Kayn,1132,658,474,58.13
Milio,Kalista,173,94,79,54.34
Milio,Blitzcrank,444,238,206,53.6
Milio,Zeri,286,104,182,36.36
Milio,Camille,297,158,139,53.2
Milio,Lulu,1525,779,746,51.08
Milio,DrMundo,379,207,172,54.62
Milio,Shaco,754,437,317,57.96
Milio,LeeSin,980,546,434,55.71
Milio,Neeko,285,161,124,56.49
Milio,Sona,309,144,165,46.6
Milio,Jayce,333,202,131,60.66
Milio,Zyra,642,328,314,51.09
Milio,Urgot,381,201,180,52.76
Milio,Senna,626,312,314,49.84
Milio,Sejuani,346,183,163,52.89
Milio,Seraphine,527,288,239,54.65
Milio,Evelynn,251,141,110,56.18
Milio,Katarina,658,362,296,55.02
Milio,Karma,1070,529,541,49.44
Milio,Ornn,303,134,169,44.22
Milio,JarvanIV,429,212,217,49.42
Milio,Yasuo,1345,722,623,53.68
Milio,Volibear,830,458,372,55.18
Milio,Vladimir,624,346,278,55.45
Milio,Rammus,207,107,100,51.69
Milio,Lissandra,268,121,147,45.15
Milio,Brand,492,266,226,54.07
Milio,Alistar,286,158,128,55.24
Milio,Rengar,308,154,154,50
Milio,Kassadin,180,87,93,48.33
Milio,Morgana,839,429,410,51.13
Milio,Diana,1113,543,570,48.79
Milio,Annie,201,109,92,54.23
Milio,Singed,255,118,137,46.27
Milio,Gragas,401,207,194,51.62
Milio,Varus,640,337,303,52.66
Milio,Kindred,326,191,135,58.59
Milio,Ryze,229,98,131,42.79
Milio,Taliyah,205,122,83,59.51
Milio,Illaoi,318,156,162,49.06
Milio,Poppy,376,219,157,58.24
Milio,Talon,462,266,196,57.58
Milio,Sivir,345,183,162,53.04
Milio,Twitch,716,351,365,49.02
Milio,Kayle,495,251,244,50.71
Milio,Aurora,533,301,232,56.47
Milio,Samira,531,294,237,55.37
Milio,Sett,942,474,468,50.32
Milio,Qiyana,226,113,113,50
Milio,Kennen,171,84,87,49.12
Milio,MasterYi,798,431,367,54.01
Milio,Hecarim,371,201,170,54.18
Milio,Naafiri,213,104,109,48.83
Milio,Vayne,942,492,450,52.23
Milio,Galio,555,270,285,48.65
Milio,KSante,395,231,164,58.48
Milio,Irelia,615,354,261,57.56
Milio,Ziggs,236,133,103,56.36
Milio,Yone,1258,694,564,55.17
Milio,Yuumi,647,356,291,55.02
Milio,Viego,1032,525,507,50.87
Milio,KogMaw,271,147,124,54.24
Milio,Braum,427,200,227,46.84
Milio,Draven,397,179,218,45.09
Milio,Rumble,179,95,84,53.07
Milio,Malphite,771,427,344,55.38
Milio,Sion,561,292,269,52.05
Milio,Udyr,300,159,141,53
Milio,AurelionSol,275,123,152,44.73
Milio,Sylas,832,427,405,51.32
Milio,FiddleSticks,404,204,200,50.5
Milio,Elise,572,296,276,51.75
Milio,Leblanc,425,220,205,51.76
Milio,Yorick,746,386,360,51.74
Milio,Leona,627,324,303,51.67
Milio,Shen,390,201,189,51.54
Milio,Cassiopeia,161,87,74,54.04
Milio,Graves,484,248,236,51.24
Milio,Fizz,413,229,184,55.45
Milio,Heimerdinger,262,132,130,50.38
Milio,Karthus,222,137,85,61.71
Milio,Azir,246,131,115,53.25
Milio,XinZhao,437,248,189,56.75
Milio,Taric,161,76,85,47.2
Milio,Maokai,298,173,125,58.05
Milio,Fiora,282,152,130,53.9
Milio,Nidalee,193,105,88,54.4
Milio,TwistedFate,296,191,105,64.53
Milio,Zac,301,154,147,51.16
Milio,Ivern,130,67,63,51.54
Milio,Zilean,229,125,104,54.59
Milio,Jax,680,360,320,52.94
Milio,Belveth,183,88,95,48.09
Milio,Xayah,283,157,126,55.48
Milio,RekSai,116,52,64,44.83
Milio,Janna,350,178,172,50.86
Milio,Gnar,332,188,144,56.63
Milio,Bard,224,131,93,58.48
Milio,Orianna,352,194,158,55.11
Milio,Smolder,448,255,193,56.92
Milio,Quinn,258,121,137,46.9
Milio,Viktor,688,372,316,54.07
Milio,Kled,118,55,63,46.61
Rakan,Illaoi,221,103,118,46.61
Rakan,Pantheon,813,358,455,44.03
Rakan,Syndra,351,192,159,54.7
Rakan,Kaisa,908,492,416,54.19
Rakan,Milio,244,132,112,54.1
Rakan,Zac,237,115,122,48.52
Rakan,Khazix,256,99,157,38.67
Rakan,Katarina,405,210,195,51.85
Rakan,Samira,298,160,138,53.69
Rakan,Leona,384,204,180,53.13
Rakan,Ambessa,286,173,113,60.49
Rakan,XinZhao,334,146,188,43.71
Rakan,Vladimir,400,212,188,53
Rakan,Ezreal,1351,669,682,49.52
Rakan,Karma,653,343,310,52.53
Rakan,Sett,643,325,318,50.54
Rakan,Gragas,244,112,132,45.9
Rakan,Yasuo,1027,540,487,52.58
Rakan,Kalista,106,59,47,55.66
Rakan,Mel,1115,586,529,52.56
Rakan,Yorick,386,180,206,46.63
Rakan,Lillia,280,163,117,58.21
Rakan,Yone,955,524,431,54.87
Rakan,Xayah,249,125,124,50.2
Rakan,Yuumi,357,203,154,56.86
Rakan,Evelynn,187,114,73,60.96
Rakan,Lux,1184,545,639,46.03
Rakan,Corki,247,129,118,52.23
Rakan,Singed,145,85,60,58.62
Rakan,Diana,762,367,395,48.16
Rakan,Viktor,447,223,224,49.89
Rakan,MissFortune,1042,501,541,48.08
Rakan,Galio,404,182,222,45.05
Rakan,TahmKench,311,181,130,58.2
Rakan,Rammus,155,90,65,58.06
Rakan,Zed,570,277,293,48.6
Rakan,Ashe,1077,543,534,50.42
Rakan,Shaco,423,196,227,46.34
Rakan,Darius,946,473,473,50
Rakan,Malzahar,461,229,232,49.67
Rakan,Viego,733,346,387,47.2
Rakan,Varus,435,207,228,47.59
Rakan,Sion,349,174,175,49.86
Rakan,Vi,489,249,240,50.92
Rakan,Soraka,259,123,136,47.49
Rakan,MasterYi,588,284,304,48.3
Rakan,Mordekaiser,576,305,271,52.95
Rakan,Jinx,1392,634,758,45.55
Rakan,Gwen,220,94,126,42.73
Rakan,Tryndamere,261,134,127,51.34
Rakan,Caitlyn,1142,534,608,46.76
Rakan,Nasus,281,147,134,52.31
Rakan,Vayne,619,303,316,48.95
Rakan,Irelia,430,235,195,54.65
Rakan,Malphite,521,273,248,52.4
Rakan,Amumu,508,220,288,43.31
Rakan,Brand,260,147,113,56.54
Rakan,Akshan,175,85,90,48.57
Rakan,Braum,388,213,175,54.9
Rakan,Skarner,106,49,57,46.23
Rakan,Aurora,384,203,181,52.86
Rakan,Smolder,354,176,178,49.72
Rakan,Chogath,606,284,322,46.86
Rakan,JarvanIV,286,134,152,46.85
Rakan,Bard,188,91,97,48.4
Rakan,Riven,270,122,148,45.19
Rakan,DrMundo,254,110,144,43.31
Rakan,Jhin,1023,537,486,52.49
Rakan,Zyra,454,208,246,45.81
Rakan,Fizz,218,127,91,58.26
Rakan,Thresh,730,336,394,46.03
Rakan,Shyvana,141,80,61,56.74
Rakan,Sylas,844,408,436,48.34
Rakan,Nami,492,211,281,42.89
Rakan,Volibear,466,255,211,54.72
Rakan,Swain,424,204,220,48.11
Rakan,Zilean,189,101,88,53.44
Rakan,Warwick,682,313,369,45.89
Rakan,Urgot,216,93,123,43.06
Rakan,Tristana,506,263,243,51.98
Rakan,Velkoz,290,153,137,52.76
Rakan,Naafiri,161,91,70,56.52
Rakan,Ivern,70,37,33,52.86
Rakan,Leblanc,320,148,172,46.25
Rakan,Renekton,223,129,94,57.85
Rakan,Lissandra,153,59,94,38.56
Rakan,Elise,473,218,255,46.09
Rakan,Rumble,153,80,73,52.29
Rakan,Nocturne,610,298,312,48.85
Rakan,Aphelios,286,151,135,52.8
Rakan,Anivia,157,86,71,54.78
Rakan,Nautilus,553,313,240,56.6
Rakan,Morgana,567,259,308,45.68
Rakan,AurelionSol,231,116,115,50.22
Rakan,Kayn,628,274,354,43.63
Rakan,Veigar,430,189,241,43.95
Rakan,Gangplank,246,108,138,43.9
Rakan,LeeSin,855,468,387,54.74
Rakan,Udyr,181,105,76,58.01
Rakan,Qiyana,91,48,43,52.75
Rakan,Lucian,362,155,207,42.82
Rakan,Renata,102,34,68,33.33
Rakan,Garen,803,386,417,48.07
Rakan,Akali,561,291,270,51.87
Rakan,Ahri,660,339,321,51.36
Rakan,Lulu,657,313,344,47.64
Rakan,Teemo,489,262,227,53.58
Rakan,Vex,234,111,123,47.44
Rakan,Briar,361,174,187,48.2
Rakan,Annie,150,94,56,62.67
Rakan,Pyke,450,210,240,46.67
Rakan,Hwei,316,172,144,54.43
Rakan,Jax,495,261,234,52.73
Rakan,Karthus,158,73,85,46.2
Rakan,Sejuani,193,106,87,54.92
Rakan,Nilah,110,60,50,54.55
Rakan,Neeko,217,94,123,43.32
Rakan,Hecarim,216,102,114,47.22
Rakan,Orianna,199,109,90,54.77
Rakan,Maokai,250,149,101,59.6
Rakan,Kayle,290,127,163,43.79
Rakan,Seraphine,311,141,170,45.34
Rakan,Camille,178,96,82,53.93
Rakan,Trundle,292,129,163,44.18
Rakan,Fiora,189,104,85,55.03
Rakan,Sona,157,75,82,47.77
Rakan,Ekko,493,250,243,50.71
Rakan,Rell,270,124,146,45.93
Rakan,Rengar,171,108,63,63.16
Rakan,Azir,155,79,76,50.97
Rakan,Gnar,162,68,94,41.98
Rakan,Graves,407,197,210,48.4
Rakan,Aatrox,488,226,262,46.31
Rakan,Quinn,161,89,72,55.28
Rakan,Cassiopeia,154,70,84,45.45
Rakan,Jayce,316,145,171,45.89
Rakan,Taliyah,150,70,80,46.67
Rakan,Zeri,205,102,103,49.76
Rakan,Draven,247,161,86,65.18
Rakan,Sivir,265,126,139,47.55
Rakan,Xerath,400,185,215,46.25
Rakan,RekSai,58,29,29,50
Rakan,Ziggs,198,107,91,54.04
Rakan,Twitch,358,197,161,55.03
Rakan,Shen,276,122,154,44.2
Rakan,Blitzcrank,315,180,135,57.14
Rakan,Nidalee,145,90,55,62.07
Rakan,Senna,357,209,148,58.54
Rakan,Janna,166,76,90,45.78
Rakan,Nunu,228,110,118,48.25
Rakan,Kassadin,89,57,32,64.04
Rakan,MonkeyKing,378,177,201,46.83
Rakan,Poppy,427,207,220,48.48
Rakan,Heimerdinger,215,116,99,53.95
Rakan,Ryze,202,91,111,45.05
Rakan,Kled,80,38,42,47.5
Rakan,Kindred,186,96,90,51.61
Rakan,KogMaw,116,64,52,55.17
Rakan,Alistar,194,83,111,42.78
Rakan,Zoe,193,103,90,53.37
Rakan,Kennen,120,60,60,50
Rakan,FiddleSticks,242,105,137,43.39
Rakan,Ornn,206,104,102,50.49
Rakan,TwistedFate,168,93,75,55.36
Rakan,Talon,283,150,133,53
Rakan,Belveth,104,48,56,46.15
Rakan,KSante,314,162,152,51.59
Rakan,Olaf,127,67,60,52.76
Rakan,Taric,85,50,35,58.82
Ekko,Illaoi,555,269,286,48.47
Ekko,Pantheon,1925,935,990,48.57
Ekko,Syndra,856,420,436,49.07
Ekko,Kaisa,2024,1045,979,51.63
Ekko,Milio,798,378,420,47.37
Ekko,Gangplank,665,320,345,48.12
Ekko,Kayn,1862,997,865,53.54
Ekko,Mel,2560,1307,1253,51.05
Ekko,MissFortune,2775,1340,1435,48.29
Ekko,Thresh,1641,838,803,51.07
Ekko,Diana,1961,947,1014,48.29
Ekko,Gragas,678,338,340,49.85
Ekko,Zed,1741,941,800,54.05
Ekko,Caitlyn,3317,1597,1720,48.15
Ekko,Soraka,731,376,355,51.44
Ekko,Warwick,1811,890,921,49.14
Ekko,Hecarim,525,268,257,51.05
Ekko,Ziggs,450,213,237,47.33
Ekko,Karma,1504,713,791,47.41
Ekko,Yasuo,2355,1145,1210,48.62
Ekko,Talon,769,353,416,45.9
Ekko,Viktor,1257,657,600,52.27
Ekko,Sion,897,432,465,48.16
Ekko,Shaco,1244,614,630,49.36
Ekko,Malzahar,1347,689,658,51.15
Ekko,Jinx,3515,1797,1718,51.12
Ekko,Poppy,691,325,366,47.03
Ekko,Taliyah,318,160,158,50.31
Ekko,Morgana,1374,636,738,46.29
Ekko,Darius,2294,1131,1163,49.3
Ekko,Nautilus,1255,671,584,53.47
Ekko,Ambessa,723,373,350,51.59
Ekko,Vex,519,232,287,44.7
Ekko,Elise,1076,569,507,52.88
Ekko,Mordekaiser,1554,736,818,47.36
Ekko,Xerath,1077,579,498,53.76
Ekko,Ezreal,2922,1473,1449,50.41
Ekko,Yorick,1239,563,676,45.44
Ekko,Nocturne,1714,789,925,46.03
Ekko,Xayah,554,286,268,51.62
Ekko,Trundle,697,323,374,46.34
Ekko,Vi,1081,585,496,54.12
Ekko,Fizz,777,386,391,49.68
Ekko,Sivir,710,367,343,51.69
Ekko,Velkoz,759,377,382,49.67
Ekko,Camille,447,232,215,51.9
Ekko,LeeSin,1898,990,908,52.16
Ekko,Hwei,845,476,369,56.33
Ekko,Jhin,2484,1284,1200,51.69
Ekko,Zyra,1145,563,582,49.17
Ekko,Singed,397,208,189,52.39
Ekko,Galio,1137,553,584,48.64
Ekko,Heimerdinger,567,275,292,48.5
Ekko,Olaf,312,155,157,49.68
Ekko,Lissandra,452,217,235,48.01
Ekko,TahmKench,956,496,460,51.88
Ekko,Teemo,1505,749,756,49.77
Ekko,Lux,3043,1430,1613,46.99
Ekko,Blitzcrank,858,436,422,50.82
Ekko,Kled,192,93,99,48.44
Ekko,Ashe,2484,1229,1255,49.48
Ekko,Akali,1312,657,655,50.08
Ekko,Jax,1137,541,596,47.58
Ekko,Aurora,792,447,345,56.44
Ekko,Udyr,455,210,245,46.15
Ekko,Qiyana,322,191,131,59.32
Ekko,Katarina,925,483,442,52.22
Ekko,Vayne,1681,867,814,51.58
Ekko,Rengar,450,214,236,47.56
Ekko,Pyke,911,454,457,49.84
Ekko,Riven,619,299,320,48.3
Ekko,FiddleSticks,619,316,303,51.05
Ekko,Neeko,494,235,259,47.57
Ekko,Khazix,611,317,294,51.88
Ekko,Veigar,1276,589,687,46.16
Ekko,Smolder,695,342,353,49.21
Ekko,Senna,926,470,456,50.76
Ekko,Ivern,150,62,88,41.33
Ekko,Tristana,1266,660,606,52.13
Ekko,Volibear,1337,681,656,50.93
Ekko,Lulu,1603,865,738,53.96
Ekko,Nami,1253,617,636,49.24
Ekko,MasterYi,1527,774,753,50.69
Ekko,DrMundo,648,364,284,56.17
Ekko,Jayce,509,233,276,45.78
Ekko,Fiora,455,219,236,48.13
Ekko,Swain,1080,503,577,46.57
Ekko,Seraphine,847,413,434,48.76
Ekko,Renekton,651,315,336,48.39
Ekko,Nunu,701,351,350,50.07
Ekko,Ornn,470,223,247,47.45
Ekko,Garen,1891,979,912,51.77
Ekko,Ahri,1624,828,796,50.99
Ekko,Shen,765,376,389,49.15
Ekko,Viego,1799,867,932,48.19
Ekko,Twitch,977,509,468,52.1
Ekko,Lucian,940,501,439,53.3
Ekko,TwistedFate,398,202,196,50.75
Ekko,Draven,613,315,298,51.39
Ekko,Bard,397,227,170,57.18
Ekko,Sett,1773,853,920,48.11
Ekko,Varus,1108,596,512,53.79
Ekko,Kennen,309,173,136,55.99
Ekko,Vladimir,843,460,383,54.57
Ekko,Sylas,1749,900,849,51.46
Ekko,Braum,718,355,363,49.44
Ekko,KSante,677,343,334,50.66
Ekko,Zilean,417,215,202,51.56
Ekko,Brand,870,367,503,42.18
Ekko,Gwen,594,300,294,50.51
Ekko,Tryndamere,725,372,353,51.31
Ekko,Leona,1088,524,564,48.16
Ekko,Kayle,869,421,448,48.45
Ekko,Kindred,575,254,321,44.17
Ekko,Renata,186,100,86,53.76
Ekko,Shyvana,351,177,174,50.43
Ekko,Zoe,410,216,194,52.68
Ekko,Maokai,562,258,304,45.91
Ekko,Urgot,670,303,367,45.22
Ekko,JarvanIV,737,388,349,52.65
Ekko,Gnar,444,254,190,57.21
Ekko,MonkeyKing,867,388,479,44.75
Ekko,Irelia,1068,476,592,44.57
Ekko,Rammus,331,185,146,55.89
Ekko,Corki,508,247,261,48.62
Ekko,Zac,620,317,303,51.13
Ekko,Anivia,403,200,203,49.63
Ekko,Aphelios,695,330,365,47.48
Ekko,Briar,898,413,485,45.99
Ekko,Naafiri,391,188,203,48.08
Ekko,Aatrox,1088,622,466,57.17
Ekko,Akshan,454,232,222,51.1
Ekko,Yone,2051,1098,953,53.53
Ekko,Nasus,769,369,400,47.98
Ekko,Graves,796,440,356,55.28
Ekko,Cassiopeia,356,169,187,47.47
Ekko,Lillia,690,317,373,45.94
Ekko,Yuumi,966,467,499,48.34
Ekko,Malphite,1179,633,546,53.69
Ekko,Rell,499,234,265,46.89
Ekko,XinZhao,846,413,433,48.82
Ekko,Orianna,498,259,239,52.01
Ekko,Samira,905,445,460,49.17
Ekko,AurelionSol,502,257,245,51.2
Ekko,Karthus,366,203,163,55.46
Ekko,Rumble,320,171,149,53.44
Ekko,Amumu,1366,648,718,47.44
Ekko,Quinn,421,199,222,47.27
Ekko,KogMaw,365,194,171,53.15
Ekko,Skarner,290,152,138,52.41
Ekko,Kassadin,291,126,165,43.3
Ekko,Chogath,1440,744,696,51.67
Ekko,Annie,383,195,188,50.91
Ekko,Ryze,458,225,233,49.13
Ekko,Sejuani,422,218,204,51.66
Ekko,Nilah,309,155,154,50.16
Ekko,Azir,385,196,189,50.91
Ekko,Evelynn,456,224,232,49.12
Ekko,Sona,383,176,207,45.95
Ekko,Taric,276,133,143,48.19
Ekko,Rakan,493,243,250,49.29
Ekko,RekSai,150,92,58,61.33
Ekko,Leblanc,705,314,391,44.54
Ekko,Nidalee,329,186,143,56.53
Ekko,Alistar,545,263,282,48.26
Ekko,Kalista,325,138,187,42.46
Ekko,Zeri,516,240,276,46.51
Ekko,Belveth,246,131,115,53.25
Ekko,Janna,400,219,181,54.75
Ashe,Illaoi,1276,628,648,49.22
Ashe,Pantheon,3968,2041,1927,51.44
Ashe,Syndra,1546,755,791,48.84
Ashe,Kaisa,4638,2481,2157,53.49
Ashe,Milio,1538,702,836,45.64
Ashe,Garen,4236,2042,2194,48.21
Ashe,Sejuani,1084,564,520,52.03
Ashe,Katarina,2115,1074,1041,50.78
Ashe,Varus,2794,1447,1347,51.79
Ashe,Yuumi,2233,1161,1072,51.99
Ashe,Warwick,3736,1683,2053,45.05
Ashe,Briar,1775,829,946,46.7
Ashe,Zed,2940,1560,1380,53.06
Ashe,Ziggs,1010,544,466,53.86
Ashe,Xerath,2534,1244,1290,49.09
Ashe,Ornn,1069,539,530,50.42
Ashe,Kayn,3530,1678,1852,47.54
Ashe,Malzahar,2722,1319,1403,48.46
Ashe,Vayne,3229,1609,1620,49.83
Ashe,Lulu,3736,2006,1730,53.69
Ashe,Tryndamere,1397,725,672,51.9
Ashe,Vi,2638,1404,1234,53.22
Ashe,Caitlyn,8382,4181,4201,49.88
Ashe,Zyra,2614,1277,1337,48.85
Ashe,Volibear,2925,1437,1488,49.13
Ashe,Yasuo,5122,2614,2508,51.03
Ashe,Mel,5107,2650,2457,51.89
Ashe,Zilean,910,499,411,54.84
Ashe,Trundle,1544,732,812,47.41
Ashe,Shaco,2509,1260,1249,50.22
Ashe,Soraka,1450,691,759,47.66
Ashe,Jax,2448,1199,1249,48.98
Ashe,Skarner,682,364,318,53.37
Ashe,Irelia,2222,1169,1053,52.61
Ashe,MissFortune,7139,3497,3642,48.98
Ashe,Alistar,1116,548,568,49.1
Ashe,Yorick,2590,1171,1419,45.21
Ashe,Lux,6356,3153,3203,49.61
Ashe,Jinx,8996,4436,4560,49.31
Ashe,Bard,771,390,381,50.58
Ashe,Jhin,6018,2973,3045,49.4
Ashe,Seraphine,1824,891,933,48.85
Ashe,Yone,4772,2454,2318,51.42
Ashe,Samira,1602,768,834,47.94
Ashe,MasterYi,3380,1668,1712,49.35
Ashe,Xayah,1224,626,598,51.14
Ashe,Velkoz,1399,657,742,46.96
Ashe,Lillia,1547,770,777,49.77
Ashe,Nami,2409,1165,1244,48.36
Ashe,Gnar,1020,533,487,52.25
Ashe,MonkeyKing,1825,891,934,48.82
Ashe,Maokai,1189,563,626,47.35
Ashe,Pyke,2164,1129,1035,52.17
Ashe,Nasus,1863,870,993,46.7
Ashe,Diana,4412,2063,2349,46.76
Ashe,Renekton,1559,825,734,52.92
Ashe,Veigar,2635,1295,1340,49.15
Ashe,Chogath,2955,1431,1524,48.43
Ashe,Ekko,2484,1255,1229,50.52
Ashe,Talon,1546,766,780,49.55
Ashe,Akshan,837,432,405,51.61
Ashe,RekSai,306,159,147,51.96
Ashe,Poppy,1597,779,818,48.78
Ashe,Viego,4035,1983,2052,49.14
Ashe,Hwei,1770,860,910,48.59
Ashe,Malphite,2687,1320,1367,49.13
Ashe,Nocturne,3475,1623,1852,46.71
Ashe,Orianna,1134,563,571,49.65
Ashe,Kalista,686,342,344,49.85
Ashe,Brand,2017,877,1140,43.48
Ashe,Kayle,1486,720,766,48.45
Ashe,Aatrox,2704,1342,1362,49.63
Ashe,Zoe,1133,588,545,51.9
Ashe,Nautilus,3027,1466,1561,48.43
Ashe,Sett,3986,1893,2093,47.49
Ashe,Leona,2261,1176,1085,52.01
Ashe,Mordekaiser,3303,1599,1704,48.41
Ashe,Tristana,2696,1266,1430,46.96
Ashe,Smolder,1561,845,716,54.13
Ashe,Swain,2615,1295,1320,49.52
Ashe,Heimerdinger,1216,594,622,48.85
Ashe,Gwen,1136,624,512,54.93
Ashe,Gragas,1303,653,650,50.12
Ashe,LeeSin,4924,2609,2315,52.99
Ashe,Akali,3038,1560,1478,51.35
Ashe,Ahri,3558,1751,1807,49.21
Ashe,Camille,974,497,477,51.03
Ashe,Belveth,593,316,277,53.29
Ashe,Lissandra,846,411,435,48.58
Ashe,Vladimir,1697,875,822,51.56
Ashe,Zeri,1187,578,609,48.69
Ashe,Galio,2474,1218,1256,49.23
Ashe,Riven,1106,559,547,50.54
Ashe,Darius,5160,2520,2640,48.84
Ashe,Draven,1443,722,721,50.03
Ashe,Rakan,1077,534,543,49.58
Ashe,Teemo,3269,1615,1654,49.4
Ashe,Graves,1899,983,916,51.76
Ashe,TahmKench,1878,897,981,47.76
Ashe,Khazix,1315,735,580,55.89
Ashe,Vex,1440,734,706,50.97
Ashe,Sivir,1646,845,801,51.34
Ashe,Morgana,3163,1463,1700,46.25
Ashe,Kled,501,237,264,47.31
Ashe,Aphelios,1283,648,635,50.51
Ashe,Fiora,1065,530,535,49.77
Ashe,Amumu,2553,1224,1329,47.94
Ashe,Jayce,1537,798,739,51.92
Ashe,Taric,492,242,250,49.19
Ashe,Sona,770,356,414,46.23
Ashe,TwistedFate,918,491,427,53.49
Ashe,Rumble,736,405,331,55.03
Ashe,Gangplank,1421,692,729,48.7
Ashe,Neeko,1227,632,595,51.51
Ashe,Ezreal,8017,3927,4090,48.98
Ashe,Taliyah,665,311,354,46.77
Ashe,Viktor,2510,1308,1202,52.11
Ashe,Ryze,941,460,481,48.88
Ashe,Evelynn,893,440,453,49.27
Ashe,Leblanc,1927,1002,925,52
Ashe,Quinn,1003,469,534,46.76
Ashe,Karma,3676,1805,1871,49.1
Ashe,JarvanIV,1586,760,826,47.92
Ashe,Thresh,3634,1797,1837,49.45
Ashe,Naafiri,857,421,436,49.12
Ashe,DrMundo,1422,669,753,47.05
Ashe,Qiyana,654,327,327,50
Ashe,Urgot,1195,529,666,44.27
Ashe,Lucian,2045,1120,925,54.77
Ashe,Braum,1370,630,740,45.99
Ashe,Elise,1918,992,926,51.72
Ashe,Kassadin,508,228,280,44.88
Ashe,Nunu,1380,763,617,55.29
Ashe,KogMaw,849,380,469,44.76
Ashe,Sylas,4421,2173,2248,49.15
Ashe,XinZhao,1836,866,970,47.17
Ashe,Shen,1540,777,763,50.45
Ashe,Rammus,874,417,457,47.71
Ashe,Twitch,2047,1019,1028,49.78
Ashe,FiddleSticks,1430,695,735,48.6
Ashe,Singed,753,399,354,52.99
Ashe,Corki,1257,673,584,53.54
Ashe,Anivia,826,395,431,47.82
Ashe,Ambessa,1739,873,866,50.2
Ashe,Kennen,663,348,315,52.49
Ashe,Kindred,1170,594,576,50.77
Ashe,Aurora,2028,1041,987,51.33
Ashe,Nilah,691,355,336,51.37
Ashe,Nidalee,1035,613,422,59.23
Ashe,Annie,949,480,469,50.58
Ashe,Udyr,998,539,459,54.01
Ashe,Senna,1846,980,866,53.09
Ashe,Olaf,701,321,380,45.79
Ashe,KSante,1688,886,802,52.49
Ashe,Shyvana,667,314,353,47.08
Ashe,Karthus,820,400,420,48.78
Ashe,Zac,1429,688,741,48.15
Ashe,Cassiopeia,646,341,305,52.79
Ashe,Rell,1255,627,628,49.96
Ashe,Sion,1811,853,958,47.1
Ashe,AurelionSol,1000,476,524,47.6
Ashe,Rengar,711,379,332,53.31
Ashe,Fizz,1472,702,770,47.69
Ashe,Janna,869,424,445,48.79
Ashe,Blitzcrank,2080,1017,1063,48.89
Ashe,Hecarim,1057,554,503,52.41
Ashe,Renata,436,231,205,52.98
Ashe,Azir,965,491,474,50.88
Ashe,Ivern,330,164,166,49.7
Tryndamere,Yorick,1110,514,596,46.31
Tryndamere,Rammus,299,154,145,51.51
Tryndamere,Yasuo,1451,753,698,51.9
Tryndamere,Caitlyn,2108,1004,1104,47.63
Tryndamere,Lulu,931,466,465,50.05
Tryndamere,Karma,723,373,350,51.59
Tryndamere,Ivern,94,43,51,45.74
Tryndamere,Anivia,259,120,139,46.33
Tryndamere,Ashe,1397,672,725,48.1
Tryndamere,Aatrox,555,264,291,47.57
Tryndamere,Yone,1290,672,618,52.09
Tryndamere,Warwick,1242,548,694,44.12
Tryndamere,Hwei,412,213,199,51.7
Tryndamere,Varus,632,300,332,47.47
Tryndamere,Malphite,1047,479,568,45.75
Tryndamere,Singed,249,106,143,42.57
Tryndamere,Viego,1074,534,540,49.72
Tryndamere,Zed,799,413,386,51.69
Tryndamere,Zeri,265,126,139,47.55
Tryndamere,Milio,485,244,241,50.31
Tryndamere,Volibear,978,458,520,46.83
Tryndamere,Lux,2088,1053,1035,50.43
Tryndamere,Jinx,2298,1157,1141,50.35
Tryndamere,Bard,185,73,112,39.46
Tryndamere,Chogath,960,477,483,49.69
Tryndamere,Shaco,707,372,335,52.62
Tryndamere,Sivir,388,209,179,53.87
Tryndamere,Ambessa,432,245,187,56.71
Tryndamere,Evelynn,223,118,105,52.91
Tryndamere,Xayah,282,162,120,57.45
Tryndamere,Velkoz,427,211,216,49.41
Tryndamere,Irelia,536,275,261,51.31
Tryndamere,Elise,352,165,187,46.88
Tryndamere,Veigar,795,414,381,52.08
Tryndamere,Smolder,420,230,190,54.76
Tryndamere,Soraka,446,200,246,44.84
Tryndamere,Riven,307,136,171,44.3
Tryndamere,Neeko,346,158,188,45.66
Tryndamere,FiddleSticks,372,181,191,48.66
Tryndamere,Diana,1077,551,526,51.16
Tryndamere,Tristana,746,383,363,51.34
Tryndamere,Kayn,1134,572,562,50.44
Tryndamere,Orianna,234,120,114,51.28
Tryndamere,Kaisa,1108,539,569,48.65
Tryndamere,LeeSin,931,555,376,59.61
Tryndamere,Mel,1556,773,783,49.68
Tryndamere,Mordekaiser,979,525,454,53.63
Tryndamere,Teemo,985,477,508,48.43
Tryndamere,Draven,397,215,182,54.16
Tryndamere,Thresh,961,482,479,50.16
Tryndamere,Gangplank,408,210,198,51.47
Tryndamere,Ekko,725,353,372,48.69
Tryndamere,Kassadin,168,82,86,48.81
Tryndamere,Rakan,261,127,134,48.66
Tryndamere,Darius,1532,729,803,47.58
Tryndamere,MonkeyKing,517,266,251,51.45
Tryndamere,Sylas,890,424,466,47.64
Tryndamere,Vex,393,163,230,41.48
Tryndamere,MissFortune,1766,873,893,49.43
Tryndamere,Heimerdinger,392,204,188,52.04
Tryndamere,Vayne,924,428,496,46.32
Tryndamere,MasterYi,1054,530,524,50.28
Tryndamere,Akali,752,365,387,48.54
Tryndamere,Garen,1485,753,732,50.71
Tryndamere,Syndra,476,257,219,53.99
Tryndamere,Ezreal,1656,853,803,51.51
Tryndamere,Shen,477,253,224,53.04
Tryndamere,Hecarim,292,167,125,57.19
Tryndamere,Lucian,577,320,257,55.46
Tryndamere,Rengar,254,126,128,49.61
Tryndamere,Aphelios,340,169,171,49.71
Tryndamere,Morgana,939,465,474,49.52
Tryndamere,Nasus,586,249,337,42.49
Tryndamere,Seraphine,499,255,244,51.1
Tryndamere,Vi,627,325,302,51.83
Tryndamere,Camille,241,130,111,53.94
Tryndamere,Malzahar,816,384,432,47.06
Tryndamere,Jhin,1464,752,712,51.37
Tryndamere,TahmKench,618,287,331,46.44
Tryndamere,Azir,226,140,86,61.95
Tryndamere,Nami,740,356,384,48.11
Tryndamere,Sett,1044,512,532,49.04
Tryndamere,Rell,304,148,156,48.68
Tryndamere,Galio,570,327,243,57.37
Tryndamere,Viktor,625,294,331,47.04
Tryndamere,Samira,540,277,263,51.3
Tryndamere,Quinn,267,127,140,47.57
Tryndamere,Annie,226,85,141,37.61
Tryndamere,Sejuani,327,169,158,51.68
Tryndamere,Pyke,615,285,330,46.34
Tryndamere,Swain,691,337,354,48.77
Tryndamere,Braum,425,202,223,47.53
Tryndamere,Gwen,350,194,156,55.43
Tryndamere,Poppy,365,172,193,47.12
Tryndamere,Ahri,878,423,455,48.18
Tryndamere,Zilean,215,79,136,36.74
Tryndamere,Kindred,366,174,192,47.54
Tryndamere,Katarina,604,320,284,52.98
Tryndamere,Nilah,263,121,142,46.01
Tryndamere,Senna,561,266,295,47.42
Tryndamere,Akshan,265,128,137,48.3
Tryndamere,Gnar,252,116,136,46.03
Tryndamere,Pantheon,1066,530,536,49.72
Tryndamere,Ziggs,239,122,117,51.05
Tryndamere,Udyr,322,178,144,55.28
Tryndamere,Sion,529,276,253,52.17
Tryndamere,Corki,326,159,167,48.77
Tryndamere,TwistedFate,238,124,114,52.1
Tryndamere,Briar,491,231,260,47.05
Tryndamere,Karthus,185,95,90,51.35
Tryndamere,Ryze,223,102,121,45.74
Tryndamere,Blitzcrank,525,242,283,46.1
Tryndamere,Belveth,180,86,94,47.78
Tryndamere,Jayce,323,149,174,46.13
Tryndamere,Janna,195,124,71,63.59
Tryndamere,Nautilus,815,408,407,50.06
Tryndamere,Naafiri,205,114,91,55.61
Tryndamere,Xerath,621,313,308,50.4
Tryndamere,Zac,238,121,117,50.84
Tryndamere,Taric,174,95,79,54.6
Tryndamere,Illaoi,377,170,207,45.09
Tryndamere,Vladimir,469,256,213,54.58
Tryndamere,Gragas,372,154,218,41.4
Tryndamere,Talon,364,197,167,54.12
Tryndamere,Twitch,566,287,279,50.71
Tryndamere,Maokai,264,157,107,59.47
Tryndamere,Leblanc,424,192,232,45.28
Tryndamere,Kalista,155,72,83,46.45
Tryndamere,Rumble,136,88,48,64.71
Tryndamere,Nocturne,879,414,465,47.1
Tryndamere,Aurora,444,263,181,59.23
Tryndamere,Fizz,533,266,267,49.91
Tryndamere,Zyra,570,282,288,49.47
Tryndamere,Olaf,177,94,83,53.11
Tryndamere,Alistar,274,137,137,50
Tryndamere,XinZhao,491,257,234,52.34
Tryndamere,KogMaw,246,138,108,56.1
Tryndamere,Trundle,482,248,234,51.45
Tryndamere,Jax,771,391,380,50.71
Tryndamere,Kennen,155,76,79,49.03
Tryndamere,Yuumi,622,371,251,59.65
Tryndamere,RekSai,63,29,34,46.03
Tryndamere,Taliyah,151,69,82,45.7
Tryndamere,Graves,470,227,243,48.3
Tryndamere,JarvanIV,414,211,203,50.97
Tryndamere,Urgot,406,190,216,46.8
Tryndamere,Zoe,309,136,173,44.01
Tryndamere,DrMundo,434,218,216,50.23
Tryndamere,Sona,253,118,135,46.64
Tryndamere,Fiora,233,86,147,36.91
Tryndamere,Cassiopeia,238,108,130,45.38
Tryndamere,Kayle,540,237,303,43.89
Tryndamere,Khazix,303,134,169,44.22
Tryndamere,Amumu,808,344,464,42.57
Tryndamere,Lillia,378,192,186,50.79
Tryndamere,Nidalee,197,105,92,53.3
Tryndamere,Leona,545,223,322,40.92
Tryndamere,Nunu,383,180,203,47
Tryndamere,Brand,669,341,328,50.97
Tryndamere,Qiyana,226,118,108,52.21
Tryndamere,Ornn,258,131,127,50.78
Tryndamere,Shyvana,154,71,83,46.1
Tryndamere,KSante,285,138,147,48.42
Tryndamere,Skarner,120,68,52,56.67
Tryndamere,Kled,133,62,71,46.62
Tryndamere,Lissandra,215,91,124,42.33
Tryndamere,Renekton,255,135,120,52.94
Tryndamere,Renata,133,73,60,54.89
Tryndamere,AurelionSol,291,146,145,50.17
Lillia,Yorick,682,316,366,46.33
Lillia,Rammus,300,156,144,52
Lillia,Yasuo,1357,672,685,49.52
Lillia,Caitlyn,1871,885,986,47.3
Lillia,Lulu,964,521,443,54.05
Lillia,Urgot,336,188,148,55.95
Lillia,Briar,508,233,275,45.87
Lillia,Ahri,943,485,458,51.43
Lillia,Lux,1522,716,806,47.04
Lillia,Sett,1005,460,545,45.77
Lillia,Nocturne,951,441,510,46.37
Lillia,Azir,225,118,107,52.44
Lillia,Ezreal,1883,964,919,51.19
Lillia,Qiyana,172,100,72,58.14
Lillia,Teemo,830,381,449,45.9
Lillia,Khazix,319,147,172,46.08
Lillia,Jinx,1864,892,972,47.85
Lillia,Milio,444,213,231,47.97
Lillia,Mordekaiser,937,463,474,49.41
Lillia,Talon,390,194,196,49.74
Lillia,Ashe,1547,777,770,50.23
Lillia,LeeSin,1288,711,577,55.2
Lillia,Zed,667,329,338,49.33
Lillia,Ornn,276,157,119,56.88
Lillia,Gwen,309,143,166,46.28
Lillia,Fizz,384,198,186,51.56
Lillia,Rakan,280,117,163,41.79
Lillia,Sylas,1038,558,480,53.76
Lillia,Volibear,764,381,383,49.87
Lillia,Aurora,471,239,232,50.74
Lillia,Brand,486,255,231,52.47
Lillia,Olaf,193,115,78,59.59
Lillia,Pantheon,1143,530,613,46.37
Lillia,Leblanc,448,183,265,40.85
Lillia,Karma,897,440,457,49.05
Lillia,Darius,1276,595,681,46.63
Lillia,Elise,441,184,257,41.72
Lillia,Gangplank,318,156,162,49.06
Lillia,Varus,590,269,321,45.59
Lillia,Trundle,411,179,232,43.55
Lillia,Chogath,922,504,418,54.66
Lillia,Evelynn,239,130,109,54.39
Lillia,Twitch,557,294,263,52.78
Lillia,Nasus,508,262,246,51.57
Lillia,TwistedFate,210,117,93,55.71
Lillia,Samira,455,258,197,56.7
Lillia,Mel,1260,684,576,54.29
Lillia,Sion,558,316,242,56.63
Lillia,Shaco,645,319,326,49.46
Lillia,Aatrox,624,280,344,44.87
Lillia,Yone,1285,646,639,50.27
Lillia,MissFortune,1640,812,828,49.51
Lillia,Zilean,208,102,106,49.04
Lillia,FiddleSticks,372,192,180,51.61
Lillia,Annie,209,99,110,47.37
Lillia,Irelia,648,316,332,48.77
Lillia,Vladimir,441,228,213,51.7
Lillia,Hecarim,357,168,189,47.06
Lillia,Jhin,1428,747,681,52.31
Lillia,Zyra,695,378,317,54.39
Lillia,Malphite,717,351,366,48.95
Lillia,Vi,692,349,343,50.43
Lillia,Akali,799,413,386,51.69
Lillia,Rell,400,195,205,48.75
Lillia,Camille,230,69,161,30
Lillia,Udyr,313,151,162,48.24
Lillia,Viego,1019,514,505,50.44
Lillia,Senna,503,232,271,46.12
Lillia,Seraphine,510,257,253,50.39
Lillia,Ambessa,451,245,206,54.32
Lillia,KogMaw,211,87,124,41.23
Lillia,Shen,422,206,216,48.82
Lillia,Diana,1203,545,658,45.3
Lillia,Aphelios,410,200,210,48.78
Lillia,Morgana,887,423,464,47.69
Lillia,Blitzcrank,541,286,255,52.87
Lillia,Garen,1324,627,697,47.36
Lillia,Vex,438,234,204,53.42
Lillia,Lucian,489,270,219,55.21
Lillia,Katarina,521,260,261,49.9
Lillia,Soraka,337,169,168,50.15
Lillia,Ekko,690,373,317,54.06
Lillia,Vayne,900,419,481,46.56
Lillia,Galio,722,349,373,48.34
Lillia,Kayn,1003,493,510,49.15
Lillia,Anivia,207,93,114,44.93
Lillia,Illaoi,294,148,146,50.34
Lillia,Renekton,392,195,197,49.74
Lillia,Shyvana,178,90,88,50.56
Lillia,Lissandra,263,105,158,39.92
Lillia,Warwick,1062,495,567,46.61
Lillia,Naafiri,220,115,105,52.27
Lillia,Nautilus,754,374,380,49.6
Lillia,DrMundo,445,259,186,58.2
Lillia,Malzahar,699,371,328,53.08
Lillia,Syndra,409,169,240,41.32
Lillia,Draven,341,137,204,40.18
Lillia,Kaisa,1192,592,600,49.66
Lillia,TahmKench,520,265,255,50.96
Lillia,Cassiopeia,205,101,104,49.27
Lillia,Bard,243,106,137,43.62
Lillia,Zeri,294,174,120,59.18
Lillia,Orianna,274,137,137,50
Lillia,Alistar,286,145,141,50.7
Lillia,Nami,601,287,314,47.75
Lillia,Kayle,516,228,288,44.19
Lillia,Graves,488,245,243,50.2
Lillia,Hwei,409,186,223,45.48
Lillia,Viktor,728,348,380,47.8
Lillia,Ivern,76,46,30,60.53
Lillia,Jax,662,351,311,53.02
Lillia,Leona,679,316,363,46.54
Lillia,MasterYi,713,342,371,47.97
Lillia,Xayah,286,143,143,50
Lillia,Zac,411,213,198,51.82
Lillia,Sejuani,306,168,138,54.9
Lillia,Nidalee,176,90,86,51.14
Lillia,Akshan,212,105,107,49.53
Lillia,Karthus,248,134,114,54.03
Lillia,Kled,119,35,84,29.41
Lillia,Nilah,251,132,119,52.59
Lillia,Thresh,905,415,490,45.86
Lillia,Ryze,198,83,115,41.92
Lillia,Riven,298,154,144,51.68
Lillia,Fiora,247,133,114,53.85
Lillia,Ziggs,228,106,122,46.49
Lillia,Swain,715,352,363,49.23
Lillia,Tristana,640,293,347,45.78
Lillia,Pyke,510,251,259,49.22
Lillia,Jayce,402,168,234,41.79
Lillia,Velkoz,363,154,209,42.42
Lillia,Veigar,593,309,284,52.11
Lillia,Renata,74,47,27,63.51
Lillia,Belveth,165,92,73,55.76
Lillia,AurelionSol,292,172,120,58.9
Lillia,MonkeyKing,510,268,242,52.55
Lillia,Heimerdinger,389,174,215,44.73
Lillia,Amumu,773,438,335,56.66
Lillia,Taric,127,76,51,59.84
Lillia,Gnar,255,126,129,49.41
Lillia,Kindred,319,148,171,46.39
Lillia,Zoe,280,147,133,52.5
Lillia,KSante,428,259,169,60.51
Lillia,Janna,212,125,87,58.96
Lillia,Nunu,376,179,197,47.61
Lillia,Poppy,510,235,275,46.08
Lillia,Sivir,396,180,216,45.45
Lillia,Yuumi,550,308,242,56
Lillia,Quinn,248,111,137,44.76
Lillia,Singed,188,89,99,47.34
Lillia,Maokai,347,184,163,53.03
Lillia,Kassadin,168,81,87,48.21
Lillia,Sona,225,95,130,42.22
Lillia,Taliyah,162,89,73,54.94
Lillia,Tryndamere,378,186,192,49.21
Lillia,XinZhao,463,215,248,46.44
Lillia,Kennen,171,75,96,43.86
Lillia,Kalista,141,91,50,64.54
Lillia,Corki,258,128,130,49.61
Lillia,Smolder,457,256,201,56.02
Lillia,Neeko,326,181,145,55.52
Lillia,Gragas,356,184,172,51.69
Lillia,Rengar,192,117,75,60.94
Lillia,Rumble,192,81,111,42.19
Lillia,Xerath,568,271,297,47.71
Lillia,Skarner,241,138,103,57.26
Lillia,Braum,377,184,193,48.81
Lillia,JarvanIV,382,170,212,44.5
Lillia,RekSai,93,42,51,45.16
FiddleSticks,Mel,1231,619,612,50.28
FiddleSticks,Trundle,359,202,157,56.27
FiddleSticks,Zed,776,409,367,52.71
FiddleSticks,Vayne,810,447,363,55.19
FiddleSticks,Sejuani,280,148,132,52.86
FiddleSticks,Darius,1289,681,608,52.83
FiddleSticks,Volibear,713,330,383,46.28
FiddleSticks,Akali,710,369,341,51.97
FiddleSticks,Jinx,1890,876,1014,46.35
FiddleSticks,Lux,1468,708,760,48.23
FiddleSticks,Viktor,570,288,282,50.53
FiddleSticks,Nocturne,887,431,456,48.59
FiddleSticks,Veigar,605,298,307,49.26
FiddleSticks,Ezreal,1637,882,755,53.88
FiddleSticks,Brand,448,198,250,44.2
FiddleSticks,Garen,1075,511,564,47.53
FiddleSticks,Nidalee,167,71,96,42.51
FiddleSticks,Caitlyn,1676,782,894,46.66
FiddleSticks,Morgana,774,426,348,55.04
FiddleSticks,Kayle,407,192,215,47.17
FiddleSticks,Yasuo,1337,708,629,52.95
FiddleSticks,Draven,290,144,146,49.66
FiddleSticks,Thresh,891,389,502,43.66
FiddleSticks,Gwen,272,146,126,53.68
FiddleSticks,Ekko,619,303,316,48.95
FiddleSticks,Syndra,414,214,200,51.69
FiddleSticks,Jhin,1335,656,679,49.14
FiddleSticks,Pantheon,991,511,480,51.56
FiddleSticks,Teemo,858,494,364,57.58
FiddleSticks,LeeSin,989,472,517,47.72
FiddleSticks,Chogath,803,359,444,44.71
FiddleSticks,Varus,507,237,270,46.75
FiddleSticks,Nautilus,712,356,356,50
FiddleSticks,Hecarim,290,143,147,49.31
FiddleSticks,Naafiri,194,101,93,52.06
FiddleSticks,MissFortune,1505,770,735,51.16
FiddleSticks,Elise,497,251,246,50.5
FiddleSticks,Nami,705,362,343,51.35
FiddleSticks,Ambessa,401,200,201,49.88
FiddleSticks,Jax,568,300,268,52.82
FiddleSticks,Malzahar,616,235,381,38.15
FiddleSticks,Karma,892,420,472,47.09
FiddleSticks,Malphite,629,333,296,52.94
FiddleSticks,Tryndamere,372,191,181,51.34
FiddleSticks,Yorick,555,270,285,48.65
FiddleSticks,Singed,176,77,99,43.75
FiddleSticks,Diana,1119,546,573,48.79
FiddleSticks,Tristana,584,289,295,49.49
FiddleSticks,Zeri,297,154,143,51.85
FiddleSticks,Lillia,372,180,192,48.39
FiddleSticks,Camille,257,137,120,53.31
FiddleSticks,Lulu,988,504,484,51.01
FiddleSticks,Sylas,1053,523,530,49.67
FiddleSticks,Shaco,691,320,371,46.31
FiddleSticks,Corki,248,137,111,55.24
FiddleSticks,Taliyah,129,64,65,49.61
FiddleSticks,Seraphine,513,289,224,56.34
FiddleSticks,Aatrox,627,287,340,45.77
FiddleSticks,XinZhao,490,243,247,49.59
FiddleSticks,Twitch,564,272,292,48.23
FiddleSticks,Ryze,213,116,97,54.46
FiddleSticks,Evelynn,144,81,63,56.25
FiddleSticks,Riven,309,164,145,53.07
FiddleSticks,Kayn,1069,538,531,50.33
FiddleSticks,Ahri,720,346,374,48.06
FiddleSticks,Zyra,666,363,303,54.5
FiddleSticks,Graves,478,244,234,51.05
FiddleSticks,Lucian,469,239,230,50.96
FiddleSticks,Sett,920,406,514,44.13
FiddleSticks,MasterYi,801,380,421,47.44
FiddleSticks,Urgot,293,152,141,51.88
FiddleSticks,Khazix,374,182,192,48.66
FiddleSticks,Sivir,392,203,189,51.79
FiddleSticks,Warwick,894,440,454,49.22
FiddleSticks,Briar,415,160,255,38.55
FiddleSticks,Yone,1142,613,529,53.68
FiddleSticks,Taric,126,44,82,34.92
FiddleSticks,Irelia,540,229,311,42.41
FiddleSticks,Nilah,195,101,94,51.79
FiddleSticks,Soraka,344,185,159,53.78
FiddleSticks,Gragas,373,198,175,53.08
FiddleSticks,Ashe,1430,735,695,51.4
FiddleSticks,Blitzcrank,430,212,218,49.3
FiddleSticks,Talon,355,186,169,52.39
FiddleSticks,Vladimir,461,236,225,51.19
FiddleSticks,Kindred,280,141,139,50.36
FiddleSticks,Orianna,341,186,155,54.55
FiddleSticks,Samira,389,222,167,57.07
FiddleSticks,Leblanc,413,203,210,49.15
FiddleSticks,Sion,536,226,310,42.16
FiddleSticks,TahmKench,473,258,215,54.55
FiddleSticks,Galio,639,331,308,51.8
FiddleSticks,Kennen,172,75,97,43.6
FiddleSticks,Quinn,250,130,120,52
FiddleSticks,Mordekaiser,761,377,384,49.54
FiddleSticks,Aurora,460,231,229,50.22
FiddleSticks,Alistar,275,159,116,57.82
FiddleSticks,Gangplank,314,170,144,54.14
FiddleSticks,MonkeyKing,443,231,212,52.14
FiddleSticks,Rell,269,119,150,44.24
FiddleSticks,Vi,606,307,299,50.66
FiddleSticks,Fizz,380,218,162,57.37
FiddleSticks,Senna,438,194,244,44.29
FiddleSticks,Ornn,295,133,162,45.08
FiddleSticks,Viego,900,499,401,55.44
FiddleSticks,Gnar,262,130,132,49.62
FiddleSticks,Xerath,616,313,303,50.81
FiddleSticks,Renekton,302,159,143,52.65
FiddleSticks,TwistedFate,225,132,93,58.67
FiddleSticks,Sona,213,110,103,51.64
FiddleSticks,Rammus,181,109,72,60.22
FiddleSticks,Anivia,201,112,89,55.72
FiddleSticks,Maokai,296,145,151,48.99
FiddleSticks,Leona,532,258,274,48.5
FiddleSticks,Ziggs,204,96,108,47.06
FiddleSticks,Milio,404,200,204,49.5
FiddleSticks,DrMundo,381,194,187,50.92
FiddleSticks,Kassadin,170,83,87,48.82
FiddleSticks,Hwei,394,166,228,42.13
FiddleSticks,Yuumi,601,284,317,47.25
FiddleSticks,Kaisa,1085,590,495,54.38
FiddleSticks,Nasus,494,258,236,52.23
FiddleSticks,AurelionSol,251,118,133,47.01
FiddleSticks,Bard,204,107,97,52.45
FiddleSticks,Amumu,707,405,302,57.28
FiddleSticks,Rengar,181,104,77,57.46
FiddleSticks,Udyr,246,125,121,50.81
FiddleSticks,Poppy,341,174,167,51.03
FiddleSticks,KSante,405,233,172,57.53
FiddleSticks,Karthus,225,126,99,56
FiddleSticks,RekSai,87,43,44,49.43
FiddleSticks,KogMaw,252,128,124,50.79
FiddleSticks,Braum,406,195,211,48.03
FiddleSticks,Heimerdinger,274,117,157,42.7
FiddleSticks,Janna,263,140,123,53.23
FiddleSticks,Xayah,337,156,181,46.29
FiddleSticks,Pyke,478,236,242,49.37
FiddleSticks,Nunu,346,167,179,48.27
FiddleSticks,Lissandra,217,94,123,43.32
FiddleSticks,Katarina,513,278,235,54.19
FiddleSticks,Belveth,184,93,91,50.54
FiddleSticks,Velkoz,354,181,173,51.13
FiddleSticks,Kled,132,56,76,42.42
FiddleSticks,Neeko,260,143,117,55
FiddleSticks,Zoe,233,132,101,56.65
FiddleSticks,Qiyana,152,71,81,46.71
FiddleSticks,Fiora,214,110,104,51.4
FiddleSticks,Zac,363,201,162,55.37
FiddleSticks,Smolder,391,208,183,53.2
FiddleSticks,Shen,381,165,216,43.31
FiddleSticks,Azir,208,109,99,52.4
FiddleSticks,Zilean,246,129,117,52.44
FiddleSticks,Akshan,195,117,78,60
FiddleSticks,Skarner,185,99,86,53.51
FiddleSticks,Vex,329,156,173,47.42
FiddleSticks,Cassiopeia,178,86,92,48.31
FiddleSticks,Illaoi,290,134,156,46.21
FiddleSticks,Rakan,242,137,105,56.61
FiddleSticks,Shyvana,164,67,97,40.85
FiddleSticks,JarvanIV,430,231,199,53.72
FiddleSticks,Aphelios,360,180,180,50
FiddleSticks,Swain,619,307,312,49.6
FiddleSticks,Annie,221,129,92,58.37
FiddleSticks,Olaf,202,87,115,43.07
FiddleSticks,Rumble,175,108,67,61.71
FiddleSticks,Jayce,343,165,178,48.1
FiddleSticks,Kalista,127,81,46,63.78
FiddleSticks,Ivern,75,36,39,48
FiddleSticks,Renata,109,54,55,49.54
Nilah,Mel,767,475,292,61.93
Nilah,Trundle,187,79,108,42.25
Nilah,Zed,401,221,180,55.11
Nilah,Vayne,498,230,268,46.18
Nilah,Sejuani,158,92,66,58.23
Nilah,Nasus,288,149,139,51.74
Nilah,MasterYi,490,237,253,48.37
Nilah,Sylas,523,278,245,53.15
Nilah,Kaisa,581,323,258,55.59
Nilah,Neeko,184,106,78,57.61
Nilah,Yasuo,795,488,307,61.38
Nilah,Khazix,185,116,69,62.7
Nilah,Lissandra,145,78,67,53.79
Nilah,Lucian,256,181,75,70.7
Nilah,Rell,174,90,84,51.72
Nilah,Garen,652,338,314,51.84
Nilah,Warwick,582,299,283,51.37
Nilah,Fizz,216,116,100,53.7
Nilah,Jinx,1129,528,601,46.77
Nilah,Thresh,454,263,191,57.93
Nilah,Kayle,282,160,122,56.74
Nilah,Volibear,479,258,221,53.86
Nilah,Draven,188,106,82,56.38
Nilah,TahmKench,298,156,142,52.35
Nilah,Ivern,60,33,27,55
Nilah,Milio,183,76,107,41.53
Nilah,Gwen,196,111,85,56.63
Nilah,MonkeyKing,279,141,138,50.54
Nilah,Renata,97,47,50,48.45
Nilah,Ambessa,215,133,82,61.86
Nilah,Teemo,510,242,268,47.45
Nilah,Aurora,249,118,131,47.39
Nilah,Caitlyn,903,484,419,53.6
Nilah,Velkoz,275,144,131,52.36
Nilah,LeeSin,398,204,194,51.26
Nilah,Leblanc,188,108,80,57.45
Nilah,KogMaw,81,44,37,54.32
Nilah,Lulu,463,254,209,54.86
Nilah,FiddleSticks,195,94,101,48.21
Nilah,Camille,127,66,61,51.97
Nilah,Malzahar,453,203,250,44.81
Nilah,Galio,286,146,140,51.05
Nilah,Darius,724,395,329,54.56
Nilah,Nocturne,483,232,251,48.03
Nilah,Akali,358,192,166,53.63
Nilah,Pantheon,596,298,298,50
Nilah,Yone,667,394,273,59.07
Nilah,Zeri,135,77,58,57.04
Nilah,Yuumi,311,166,145,53.38
Nilah,Riven,168,108,60,64.29
Nilah,Ziggs,142,64,78,45.07
Nilah,Lux,870,449,421,51.61
Nilah,JarvanIV,224,128,96,57.14
Nilah,AurelionSol,143,70,73,48.95
Nilah,Ashe,691,336,355,48.63
Nilah,Illaoi,180,75,105,41.67
Nilah,Ahri,489,231,258,47.24
Nilah,Sivir,179,84,95,46.93
Nilah,Tryndamere,263,142,121,53.99
Nilah,Shaco,381,194,187,50.92
Nilah,Qiyana,87,51,36,58.62
Nilah,Cassiopeia,108,51,57,47.22
Nilah,Swain,446,207,239,46.41
Nilah,Yorick,377,184,193,48.81
Nilah,Lillia,251,119,132,47.41
Nilah,Twitch,349,184,165,52.72
Nilah,Alistar,177,86,91,48.59
Nilah,Sett,626,354,272,56.55
Nilah,Viego,561,299,262,53.3
Nilah,Kalista,79,55,24,69.62
Nilah,Braum,192,98,94,51.04
Nilah,Chogath,562,296,266,52.67
Nilah,Ekko,309,154,155,49.84
Nilah,Irelia,271,138,133,50.92
Nilah,Jhin,724,375,349,51.8
Nilah,Rakan,110,50,60,45.45
Nilah,Amumu,434,203,231,46.77
Nilah,Xayah,274,131,143,47.81
Nilah,Jax,331,154,177,46.53
Nilah,Diana,582,287,295,49.31
Nilah,Xerath,275,143,132,52
Nilah,Ezreal,834,449,385,53.84
Nilah,Kayn,596,308,288,51.68
Nilah,Sona,119,43,76,36.13
Nilah,Poppy,165,76,89,46.06
Nilah,Orianna,159,73,86,45.91
Nilah,MissFortune,1032,575,457,55.72
Nilah,Elise,255,143,112,56.08
Nilah,Shen,285,143,142,50.18
Nilah,Hwei,260,123,137,47.31
Nilah,Aatrox,303,151,152,49.83
Nilah,RekSai,45,24,21,53.33
Nilah,Smolder,260,161,99,61.92
Nilah,Seraphine,333,146,187,43.84
Nilah,Naafiri,130,95,35,73.08
Nilah,TwistedFate,135,76,59,56.3
Nilah,DrMundo,225,121,104,53.78
Nilah,Tristana,363,196,167,53.99
Nilah,Zoe,127,77,50,60.63
Nilah,Evelynn,127,64,63,50.39
Nilah,Karma,356,179,177,50.28
Nilah,Brand,329,156,173,47.42
Nilah,XinZhao,227,132,95,58.15
Nilah,Mordekaiser,444,228,216,51.35
Nilah,Samira,424,256,168,60.38
Nilah,Olaf,115,76,39,66.09
Nilah,Talon,167,106,61,63.47
Nilah,Nautilus,425,249,176,58.59
Nilah,Nami,437,214,223,48.97
Nilah,Sion,294,169,125,57.48
Nilah,Vladimir,244,149,95,61.07
Nilah,Zyra,294,172,122,58.5
Nilah,Vi,346,204,142,58.96
Nilah,Soraka,201,123,78,61.19
Nilah,Katarina,319,163,156,51.1
Nilah,Annie,97,46,51,47.42
Nilah,Zac,187,100,87,53.48
Nilah,Corki,192,102,90,53.13
Nilah,Vex,213,101,112,47.42
Nilah,Zilean,153,79,74,51.63
Nilah,Syndra,234,126,108,53.85
Nilah,Bard,127,51,76,40.16
Nilah,Akshan,138,81,57,58.7
Nilah,Maokai,198,97,101,48.99
Nilah,Anivia,112,33,79,29.46
Nilah,Azir,122,60,62,49.18
Nilah,Leona,328,193,135,58.84
Nilah,Varus,262,145,117,55.34
Nilah,Fiora,133,66,67,49.62
Nilah,Gragas,186,105,81,56.45
Nilah,Morgana,499,255,244,51.1
Nilah,Gnar,110,72,38,65.45
Nilah,Malphite,427,221,206,51.76
Nilah,Aphelios,236,114,122,48.31
Nilah,Senna,245,135,110,55.1
Nilah,Heimerdinger,164,67,97,40.85
Nilah,Gangplank,212,114,98,53.77
Nilah,Taliyah,98,46,52,46.94
Nilah,Ornn,143,68,75,47.55
Nilah,Kindred,162,91,71,56.17
Nilah,Pyke,290,166,124,57.24
Nilah,Urgot,209,104,105,49.76
Nilah,Karthus,129,67,62,51.94
Nilah,Nidalee,78,48,30,61.54
Nilah,Veigar,373,206,167,55.23
Nilah,Udyr,158,107,51,67.72
Nilah,Jayce,137,96,41,70.07
Nilah,Skarner,79,49,30,62.03
Nilah,Rengar,162,100,62,61.73
Nilah,Janna,157,73,84,46.5
Nilah,Graves,196,111,85,56.63
Nilah,Kassadin,51,34,17,66.67
Nilah,Rammus,121,52,69,42.98
Nilah,KSante,173,96,77,55.49
Nilah,Briar,285,136,149,47.72
Nilah,Quinn,132,50,82,37.88
Nilah,Nunu,208,98,110,47.12
Nilah,Belveth,107,66,41,61.68
Nilah,Ryze,106,56,50,52.83
Nilah,Kennen,75,32,43,42.67
Nilah,Singed,134,74,60,55.22
Nilah,Kled,57,25,32,43.86
Nilah,Viktor,273,166,107,60.81
Nilah,Renekton,161,81,80,50.31
Nilah,Taric,103,64,39,62.14
Nilah,Blitzcrank,221,117,104,52.94
Nilah,Shyvana,101,53,48,52.48
Nilah,Hecarim,122,50,72,40.98
Nilah,Rumble,55,26,29,47.27
Rell,Mel,1293,681,612,52.67
Rell,Trundle,295,132,163,44.75
Rell,Zed,616,301,315,48.86
Rell,Vayne,790,427,363,54.05
Rell,Sejuani,292,163,129,55.82
Rell,Jayce,347,155,192,44.67
Rell,Talon,338,176,162,52.07
Rell,Kennen,121,61,60,50.41
Rell,Lucian,452,211,241,46.68
Rell,Elise,477,253,224,53.04
Rell,DrMundo,312,154,158,49.36
Rell,Rengar,186,85,101,45.7
Rell,Akali,664,350,314,52.71
Rell,Nilah,174,84,90,48.28
Rell,Shen,403,228,175,56.58
Rell,Graves,423,200,223,47.28
Rell,Veigar,544,245,299,45.04
Rell,Caitlyn,1618,821,797,50.74
Rell,Sett,920,454,466,49.35
Rell,Pantheon,995,508,487,51.06
Rell,Ahri,761,411,350,54.01
Rell,MissFortune,1250,596,654,47.68
Rell,Nami,591,312,279,52.79
Rell,Riven,326,163,163,50
Rell,Kayn,822,422,400,51.34
Rell,Kaisa,957,497,460,51.93
Rell,Hwei,398,218,180,54.77
Rell,Milio,339,168,171,49.56
Rell,Viego,913,508,405,55.64
Rell,Malzahar,692,330,362,47.69
Rell,Twitch,495,296,199,59.8
Rell,Pyke,496,256,240,51.61
Rell,Mordekaiser,713,329,384,46.14
Rell,TwistedFate,213,131,82,61.5
Rell,Ziggs,215,100,115,46.51
Rell,Janna,306,145,161,47.39
Rell,Irelia,528,264,264,50
Rell,Lillia,400,205,195,51.25
Rell,Qiyana,148,91,57,61.49
Rell,Warwick,885,437,448,49.38
Rell,Taliyah,205,95,110,46.34
Rell,Poppy,462,222,240,48.05
Rell,Gangplank,292,137,155,46.92
Rell,Yone,1063,545,518,51.27
Rell,Leona,580,303,277,52.24
Rell,Vex,294,139,155,47.28
Rell,Jinx,1658,798,860,48.13
Rell,Lux,1426,667,759,46.77
Rell,Malphite,646,355,291,54.95
Rell,Amumu,562,275,287,48.93
Rell,Jhin,1128,571,557,50.62
Rell,Brand,390,180,210,46.15
Rell,Ambessa,353,202,151,57.22
Rell,Ryze,255,128,127,50.2
Rell,Karma,736,362,374,49.18
Rell,Darius,1077,588,489,54.6
Rell,Volibear,658,346,312,52.58
Rell,Neeko,271,147,124,54.24
Rell,Udyr,200,109,91,54.5
Rell,Ezreal,1560,873,687,55.96
Rell,Garen,867,429,438,49.48
Rell,Briar,382,187,195,48.95
Rell,Ekko,499,265,234,53.11
Rell,Viktor,561,284,277,50.62
Rell,Nunu,324,152,172,46.91
Rell,Thresh,908,460,448,50.66
Rell,Galio,535,287,248,53.64
Rell,Soraka,294,159,135,54.08
Rell,Tryndamere,304,156,148,51.32
Rell,Zyra,570,242,328,42.46
Rell,Gragas,359,215,144,59.89
Rell,Naafiri,135,60,75,44.44
Rell,Lulu,816,423,393,51.84
Rell,Sylas,871,471,400,54.08
Rell,Ashe,1255,628,627,50.04
Rell,Yuumi,545,303,242,55.6
Rell,Yasuo,1167,616,551,52.78
Rell,Nautilus,725,388,337,53.52
Rell,Nasus,388,185,203,47.68
Rell,Orianna,278,116,162,41.73
Rell,Aatrox,665,357,308,53.68
Rell,FiddleSticks,269,150,119,55.76
Rell,Teemo,646,294,352,45.51
Rell,Diana,984,469,515,47.66
Rell,AurelionSol,243,117,126,48.15
Rell,Draven,282,148,134,52.48
Rell,Maokai,297,144,153,48.48
Rell,Nocturne,826,356,470,43.1
Rell,Lissandra,219,115,104,52.51
Rell,MasterYi,648,339,309,52.31
Rell,Quinn,256,141,115,55.08
Rell,Rammus,172,92,80,53.49
Rell,Zoe,232,123,109,53.02
Rell,Aphelios,375,187,188,49.87
Rell,Zac,335,154,181,45.97
Rell,Swain,576,247,329,42.88
Rell,Shyvana,140,79,61,56.43
Rell,Ornn,250,122,128,48.8
Rell,Olaf,157,85,72,54.14
Rell,Evelynn,186,98,88,52.69
Rell,Heimerdinger,219,110,109,50.23
Rell,Tristana,662,327,335,49.4
Rell,Khazix,314,145,169,46.18
Rell,Katarina,432,239,193,55.32
Rell,JarvanIV,372,196,176,52.69
Rell,Smolder,399,215,184,53.88
Rell,Velkoz,400,174,226,43.5
Rell,LeeSin,921,472,449,51.25
Rell,Varus,533,274,259,51.41
Rell,TahmKench,510,265,245,51.96
Rell,Kindred,250,139,111,55.6
Rell,Illaoi,256,104,152,40.63
Rell,Karthus,216,102,114,47.22
Rell,Xayah,319,134,185,42.01
Rell,Leblanc,354,179,175,50.56
Rell,Taric,135,67,68,49.63
Rell,Singed,194,82,112,42.27
Rell,XinZhao,407,224,183,55.04
Rell,Zeri,263,133,130,50.57
Rell,MonkeyKing,382,185,197,48.43
Rell,Morgana,685,317,368,46.28
Rell,Samira,380,197,183,51.84
Rell,Aurora,415,211,204,50.84
Rell,Braum,411,197,214,47.93
Rell,Renekton,329,138,191,41.95
Rell,Fizz,294,139,155,47.28
Rell,Yorick,577,255,322,44.19
Rell,Rakan,270,146,124,54.07
Rell,Chogath,646,308,338,47.68
Rell,Blitzcrank,400,213,187,53.25
Rell,Renata,108,61,47,56.48
Rell,Belveth,166,84,82,50.6
Rell,Fiora,199,109,90,54.77
Rell,KogMaw,176,80,96,45.45
Rell,Shaco,476,242,234,50.84
Rell,Vladimir,390,216,174,55.38
Rell,Jax,614,315,299,51.3
Rell,Senna,413,172,241,41.65
Rell,Camille,224,121,103,54.02
Rell,Xerath,507,251,256,49.51
Rell,Nidalee,191,119,72,62.3
Rell,Cassiopeia,165,80,85,48.48
Rell,Zilean,171,86,85,50.29
Rell,Gnar,247,120,127,48.58
Rell,KSante,433,230,203,53.12
Rell,Azir,247,140,107,56.68
Rell,Alistar,424,210,214,49.53
Rell,Kayle,364,160,204,43.96
Rell,Syndra,416,192,224,46.15
Rell,Urgot,295,165,130,55.93
Rell,Sona,190,102,88,53.68
Rell,Akshan,183,86,97,46.99
Rell,Vi,580,301,279,51.9
Rell,Seraphine,390,211,179,54.1
Rell,Kled,136,72,64,52.94
Rell,Kalista,106,53,53,50
Rell,Ivern,89,45,44,50.56
Rell,Sivir,285,143,142,50.18
Rell,Kassadin,146,88,58,60.27
Rell,Corki,355,179,176,50.42
Rell,Skarner,171,106,65,61.99
Rell,Anivia,221,113,108,51.13
Rell,Gwen,320,166,154,51.88
Rell,Bard,185,106,79,57.3
Rell,Sion,390,178,212,45.64
Rell,Annie,140,57,83,40.71
Rell,Hecarim,273,116,157,42.49
Rell,RekSai,86,49,37,56.98
Rell,Rumble,208,116,92,55.77
Trundle,Teemo,931,485,446,52.09
Trundle,FiddleSticks,359,157,202,43.73
Trundle,Yone,1465,779,686,53.17
Trundle,Nilah,187,108,79,57.75
Trundle,Rell,295,163,132,55.25
Trundle,Darius,1444,777,667,53.81
Trundle,Amumu,869,438,431,50.4
Trundle,Aurora,525,280,245,53.33
Trundle,Lux,1976,999,977,50.56
Trundle,Seraphine,558,275,283,49.28
Trundle,Volibear,1086,613,473,56.45
Trundle,Yorick,885,415,470,46.89
Trundle,Zoe,255,116,139,45.49
Trundle,Samira,539,293,246,54.36
Trundle,Pantheon,1068,496,572,46.44
Trundle,Khazix,306,175,131,57.19
Trundle,Zed,720,378,342,52.5
Trundle,Aphelios,328,181,147,55.18
Trundle,Pyke,605,348,257,57.52
Trundle,Gwen,394,201,193,51.02
Trundle,LeeSin,905,477,428,52.71
Trundle,Akali,816,427,389,52.33
Trundle,KogMaw,242,120,122,49.59
Trundle,Thresh,915,438,477,47.87
Trundle,Renekton,377,181,196,48.01
Trundle,Gragas,411,187,224,45.5
Trundle,Yasuo,1575,790,785,50.16
Trundle,Kaisa,1188,574,614,48.32
Trundle,Nautilus,775,412,363,53.16
Trundle,Veigar,744,365,379,49.06
Trundle,Ashe,1544,812,732,52.59
Trundle,Lulu,806,439,367,54.47
Trundle,Malphite,806,415,391,51.49
Trundle,Ekko,697,374,323,53.66
Trundle,Mel,1506,852,654,56.57
Trundle,Caitlyn,2139,1092,1047,51.05
Trundle,Diana,1203,653,550,54.28
Trundle,Fizz,438,210,228,47.95
Trundle,Draven,339,198,141,58.41
Trundle,DrMundo,484,286,198,59.09
Trundle,MasterYi,929,512,417,55.11
Trundle,Irelia,613,340,273,55.46
Trundle,MissFortune,1905,984,921,51.65
Trundle,Warwick,1416,666,750,47.03
Trundle,Udyr,253,144,109,56.92
Trundle,Vladimir,399,194,205,48.62
Trundle,Jinx,2154,978,1176,45.4
Trundle,Milio,415,205,210,49.4
Trundle,Lillia,411,232,179,56.45
Trundle,Ezreal,1644,864,780,52.55
Trundle,Yuumi,567,285,282,50.26
Trundle,Garen,1370,625,745,45.62
Trundle,Sylas,931,472,459,50.7
Trundle,Zilean,206,84,122,40.78
Trundle,Kayn,1094,526,568,48.08
Trundle,Katarina,552,278,274,50.36
Trundle,Sivir,452,240,212,53.1
Trundle,Aatrox,555,290,265,52.25
Trundle,Rengar,184,109,75,59.24
Trundle,Neeko,323,161,162,49.85
Trundle,Viego,1061,566,495,53.35
Trundle,AurelionSol,345,180,165,52.17
Trundle,Xayah,332,191,141,57.53
Trundle,Swain,776,385,391,49.61
Trundle,Mordekaiser,1098,523,575,47.63
Trundle,XinZhao,518,276,242,53.28
Trundle,Singed,228,114,114,50
Trundle,Graves,411,197,214,47.93
Trundle,Viktor,589,315,274,53.48
Trundle,Senna,547,274,273,50.09
Trundle,Poppy,437,190,247,43.48
Trundle,Karthus,177,92,85,51.98
Trundle,Ahri,918,504,414,54.9
Trundle,Zeri,299,153,146,51.17
Trundle,Shaco,782,426,356,54.48
Trundle,Kayle,444,219,225,49.32
Trundle,Sejuani,311,175,136,56.27
Trundle,Nami,640,325,315,50.78
Trundle,Heimerdinger,390,200,190,51.28
Trundle,Karma,839,422,417,50.3
Trundle,Brand,650,336,314,51.69
Trundle,Vi,632,324,308,51.27
Trundle,Morgana,928,472,456,50.86
Trundle,Sett,1114,556,558,49.91
Trundle,Leblanc,412,217,195,52.67
Trundle,Lucian,537,303,234,56.42
Trundle,Alistar,292,145,147,49.66
Trundle,Nunu,399,182,217,45.61
Trundle,Ryze,225,110,115,48.89
Trundle,Taric,165,83,82,50.3
Trundle,Urgot,409,216,193,52.81
Trundle,Elise,405,210,195,51.85
Trundle,Nasus,679,313,366,46.1
Trundle,Renata,89,50,39,56.18
Trundle,Jhin,1503,754,749,50.17
Trundle,Gnar,258,120,138,46.51
Trundle,Jax,816,397,419,48.65
Trundle,JarvanIV,373,203,170,54.42
Trundle,Varus,607,324,283,53.38
Trundle,Ambessa,363,194,169,53.44
Trundle,Nocturne,1013,434,579,42.84
Trundle,Qiyana,158,89,69,56.33
Trundle,Orianna,287,152,135,52.96
Trundle,Cassiopeia,222,101,121,45.5
Trundle,Velkoz,393,182,211,46.31
Trundle,Chogath,930,466,464,50.11
Trundle,Xerath,729,349,380,47.87
Trundle,Tristana,671,326,345,48.58
Trundle,Soraka,444,246,198,55.41
Trundle,Sion,640,355,285,55.47
Trundle,Evelynn,257,134,123,52.14
Trundle,Zac,268,127,141,47.39
Trundle,Syndra,474,227,247,47.89
Trundle,Vex,375,174,201,46.4
Trundle,Ziggs,296,141,155,47.64
Trundle,Hwei,488,241,247,49.39
Trundle,Riven,304,173,131,56.91
Trundle,MonkeyKing,493,232,261,47.06
Trundle,Taliyah,164,76,88,46.34
Trundle,Janna,173,78,95,45.09
Trundle,Rammus,313,140,173,44.73
Trundle,Lissandra,314,153,161,48.73
Trundle,Malzahar,899,461,438,51.28
Trundle,Anivia,245,114,131,46.53
Trundle,TahmKench,708,348,360,49.15
Trundle,Corki,244,126,118,51.64
Trundle,Zyra,659,324,335,49.17
Trundle,Annie,226,127,99,56.19
Trundle,Blitzcrank,515,272,243,52.82
Trundle,Smolder,473,242,231,51.16
Trundle,Vayne,925,469,456,50.7
Trundle,Gangplank,369,214,155,57.99
Trundle,Fiora,233,102,131,43.78
Trundle,Ornn,331,175,156,52.87
Trundle,Briar,595,279,316,46.89
Trundle,RekSai,83,40,43,48.19
Trundle,Twitch,613,340,273,55.46
Trundle,Illaoi,444,225,219,50.68
Trundle,Kennen,144,69,75,47.92
Trundle,Leona,620,312,308,50.32
Trundle,Rumble,136,61,75,44.85
Trundle,Rakan,292,163,129,55.82
Trundle,Tryndamere,482,234,248,48.55
Trundle,Bard,190,106,84,55.79
Trundle,Naafiri,244,115,129,47.13
Trundle,Camille,202,67,135,33.17
Trundle,Kalista,181,84,97,46.41
Trundle,Nidalee,180,81,99,45
Trundle,Galio,679,403,276,59.35
Trundle,Braum,393,201,192,51.15
Trundle,Hecarim,319,177,142,55.49
Trundle,Kindred,355,182,173,51.27
Trundle,Shen,466,229,237,49.14
Trundle,Shyvana,170,80,90,47.06
Trundle,Azir,275,132,143,48
Trundle,KSante,354,222,132,62.71
Trundle,TwistedFate,284,144,140,50.7
Trundle,Olaf,252,127,125,50.4
Trundle,Kassadin,154,85,69,55.19
Trundle,Maokai,318,157,161,49.37
Trundle,Skarner,178,91,87,51.12
Trundle,Talon,394,160,234,40.61
Trundle,Akshan,254,158,96,62.2
Trundle,Belveth,182,100,82,54.95
Trundle,Jayce,257,127,130,49.42
Trundle,Quinn,188,104,84,55.32
Trundle,Ivern,108,60,48,55.56
Trundle,Sona,228,96,132,42.11
Trundle,Kled,132,65,67,49.24
Zed,Teemo,1859,827,1032,44.49
Zed,FiddleSticks,776,367,409,47.29
Zed,Yone,2676,1354,1322,50.6
Zed,Nilah,401,180,221,44.89
Zed,Rell,616,315,301,51.14
Zed,Gwen,666,354,312,53.15
Zed,Skarner,317,183,134,57.73
Zed,DrMundo,756,365,391,48.28
Zed,Samira,1054,527,527,50
Zed,Malphite,2111,901,1210,42.68
Zed,Rengar,460,224,236,48.7
Zed,Zilean,556,264,292,47.48
Zed,Ashe,2940,1380,1560,46.94
Zed,Thresh,1994,936,1058,46.94
Zed,Ambessa,992,517,475,52.12
Zed,Ekko,1741,800,941,45.95
Zed,Yasuo,3510,1652,1858,47.07
Zed,Veigar,1378,763,615,55.37
Zed,Pyke,1188,572,616,48.15
Zed,Trundle,720,342,378,47.5
Zed,Hwei,826,436,390,52.78
Zed,Twitch,1207,548,659,45.4
Zed,Milio,838,369,469,44.03
Zed,Irelia,1356,671,685,49.48
Zed,Diana,2709,1270,1439,46.88
Zed,Fizz,1048,525,523,50.1
Zed,Vayne,1961,951,1010,48.5
Zed,Yuumi,1224,617,607,50.41
Zed,Tryndamere,799,386,413,48.31
Zed,Amumu,1345,618,727,45.95
Zed,Vex,735,361,374,49.12
Zed,Jinx,4058,1927,2131,47.49
Zed,Mel,2679,1358,1321,50.69
Zed,Darius,2797,1271,1526,45.44
Zed,Vladimir,1100,550,550,50
Zed,Morgana,1690,764,926,45.21
Zed,Talon,1024,491,533,47.95
Zed,Viktor,1180,575,605,48.73
Zed,Caitlyn,4110,1975,2135,48.05
Zed,Soraka,760,364,396,47.89
Zed,Shyvana,307,148,159,48.21
Zed,Jhin,3124,1556,1568,49.81
Zed,Mordekaiser,1827,855,972,46.8
Zed,Alistar,654,292,362,44.65
Zed,Jax,1278,657,621,51.41
Zed,Kayn,2276,1090,1186,47.89
Zed,Zeri,608,342,266,56.25
Zed,Nocturne,1982,940,1042,47.43
Zed,Nasus,963,440,523,45.69
Zed,Lillia,667,338,329,50.67
Zed,Kaisa,2624,1278,1346,48.7
Zed,Neeko,567,260,307,45.86
Zed,Kayle,905,414,491,45.75
Zed,LeeSin,2671,1311,1360,49.08
Zed,Karma,1923,917,1006,47.69
Zed,Naafiri,365,190,175,52.05
Zed,MasterYi,1902,857,1045,45.06
Zed,Akali,1788,917,871,51.29
Zed,Zyra,1397,679,718,48.6
Zed,Shaco,1491,762,729,51.11
Zed,Gragas,875,451,424,51.54
Zed,Lulu,2035,989,1046,48.6
Zed,Garen,2541,1149,1392,45.22
Zed,Warwick,2003,962,1041,48.03
Zed,Sett,2044,1009,1035,49.36
Zed,Katarina,1206,579,627,48.01
Zed,Aphelios,672,292,380,43.45
Zed,Poppy,865,426,439,49.25
Zed,Gnar,586,288,298,49.15
Zed,Ahri,1729,823,906,47.6
Zed,Varus,1302,692,610,53.15
Zed,Renata,256,137,119,53.52
Zed,Orianna,537,273,264,50.84
Zed,Kalista,389,188,201,48.33
Zed,Brand,1049,554,495,52.81
Zed,KSante,855,428,427,50.06
Zed,Swain,1385,658,727,47.51
Zed,TahmKench,1129,559,570,49.51
Zed,Ziggs,528,286,242,54.17
Zed,Lux,3781,1850,1931,48.93
Zed,Galio,1140,561,579,49.21
Zed,Viego,2182,1106,1076,50.69
Zed,Malzahar,1783,879,904,49.3
Zed,Draven,737,328,409,44.5
Zed,Rakan,570,293,277,51.4
Zed,Vi,1451,661,790,45.55
Zed,Ezreal,3813,1924,1889,50.46
Zed,Nautilus,1560,749,811,48.01
Zed,KogMaw,338,145,193,42.9
Zed,Khazix,807,400,407,49.57
Zed,Corki,553,256,297,46.29
Zed,Nidalee,431,229,202,53.13
Zed,Ornn,616,277,339,44.97
Zed,Syndra,906,459,447,50.66
Zed,Pantheon,2398,1111,1287,46.33
Zed,Jayce,713,340,373,47.69
Zed,MissFortune,3267,1490,1777,45.61
Zed,JarvanIV,868,385,483,44.35
Zed,Briar,1012,492,520,48.62
Zed,Xayah,747,386,361,51.67
Zed,Renekton,746,361,385,48.39
Zed,Evelynn,484,239,245,49.38
Zed,Quinn,582,268,314,46.05
Zed,Lissandra,821,351,470,42.75
Zed,Chogath,1647,763,884,46.33
Zed,Shen,874,458,416,52.4
Zed,Riven,764,348,416,45.55
Zed,Aurora,972,466,506,47.94
Zed,Seraphine,960,454,506,47.29
Zed,Volibear,1633,841,792,51.5
Zed,Urgot,606,303,303,50
Zed,Leona,1174,605,569,51.53
Zed,Xerath,1265,659,606,52.09
Zed,Nunu,656,320,336,48.78
Zed,Lucian,1116,596,520,53.41
Zed,Rammus,539,245,294,45.45
Zed,TwistedFate,548,259,289,47.26
Zed,Nami,1494,692,802,46.32
Zed,Hecarim,732,342,390,46.72
Zed,Sylas,2334,1109,1225,47.51
Zed,Kindred,610,272,338,44.59
Zed,Leblanc,1043,518,525,49.66
Zed,Maokai,676,322,354,47.63
Zed,Illaoi,679,378,301,55.67
Zed,Kennen,428,236,192,55.14
Zed,XinZhao,1064,488,576,45.86
Zed,Zac,666,321,345,48.2
Zed,Blitzcrank,1080,553,527,51.2
Zed,Sion,1155,523,632,45.28
Zed,Sejuani,576,274,302,47.57
Zed,AurelionSol,461,238,223,51.63
Zed,Senna,1013,498,515,49.16
Zed,Graves,1011,505,506,49.95
Zed,Yorick,1218,547,671,44.91
Zed,Zoe,478,224,254,46.86
Zed,Velkoz,829,437,392,52.71
Zed,Cassiopeia,411,190,221,46.23
Zed,Tristana,1430,696,734,48.67
Zed,Taliyah,262,141,121,53.82
Zed,MonkeyKing,959,400,559,41.71
Zed,Gangplank,821,356,465,43.36
Zed,Azir,454,233,221,51.32
Zed,Qiyana,438,228,210,52.05
Zed,Janna,474,212,262,44.73
Zed,Aatrox,1384,661,723,47.76
Zed,Singed,411,176,235,42.82
Zed,Karthus,392,192,200,48.98
Zed,Elise,1115,566,549,50.76
Zed,Smolder,882,472,410,53.51
Zed,Rumble,411,226,185,54.99
Zed,Anivia,509,237,272,46.56
Zed,Braum,827,383,444,46.31
Zed,RekSai,182,99,83,54.4
Zed,Sivir,831,433,398,52.11
Zed,Taric,338,151,187,44.67
Zed,Camille,568,288,280,50.7
Zed,Ryze,508,239,269,47.05
Zed,Fiora,535,255,280,47.66
Zed,Sona,391,173,218,44.25
Zed,Heimerdinger,662,315,347,47.58
Zed,Ivern,230,124,106,53.91
Zed,Bard,369,178,191,48.24
Zed,Kassadin,189,107,82,56.61
Zed,Kled,233,108,125,46.35
Zed,Udyr,587,285,302,48.55
Zed,Annie,534,271,263,50.75
Zed,Olaf,329,162,167,49.24
Zed,Akshan,532,229,303,43.05
Zed,Belveth,288,154,134,53.47
Gangplank,Garen,1063,482,581,45.34
Gangplank,Sejuani,347,178,169,51.3
Gangplank,Katarina,519,241,278,46.44
Gangplank,Varus,538,262,276,48.7
Gangplank,Yuumi,598,296,302,49.5
Gangplank,Pantheon,1152,586,566,50.87
Gangplank,Evelynn,211,111,100,52.61
Gangplank,Ekko,665,345,320,51.88
Gangplank,Jinx,1896,916,980,48.31
Gangplank,Zyra,665,305,360,45.86
Gangplank,Darius,1325,655,670,49.43
Gangplank,Volibear,645,326,319,50.54
Gangplank,Akali,697,351,346,50.36
Gangplank,Lux,1633,774,859,47.4
Gangplank,Teemo,815,428,387,52.52
Gangplank,Khazix,347,150,197,43.23
Gangplank,Milio,462,215,247,46.54
Gangplank,Jhin,1444,715,729,49.52
Gangplank,Nautilus,720,375,345,52.08
Gangplank,Kayle,512,225,287,43.95
Gangplank,Nasus,393,200,193,50.89
Gangplank,Anivia,259,112,147,43.24
Gangplank,KogMaw,250,132,118,52.8
Gangplank,Nami,759,360,399,47.43
Gangplank,Sett,853,393,460,46.07
Gangplank,Rengar,266,111,155,41.73
Gangplank,Aurora,536,267,269,49.81
Gangplank,Aphelios,425,197,228,46.35
Gangplank,Bard,225,126,99,56
Gangplank,Jax,589,291,298,49.41
Gangplank,Rammus,186,96,90,51.61
Gangplank,Viktor,708,425,283,60.03
Gangplank,Soraka,415,184,231,44.34
Gangplank,Camille,235,143,92,60.85
Gangplank,Kayn,896,474,422,52.9
Gangplank,Yasuo,1412,695,717,49.22
Gangplank,Caitlyn,1796,876,920,48.78
Gangplank,DrMundo,360,171,189,47.5
Gangplank,Lillia,318,162,156,50.94
Gangplank,Ezreal,2014,1012,1002,50.25
Gangplank,KSante,400,217,183,54.25
Gangplank,Diana,1167,540,627,46.27
Gangplank,Ahri,936,494,442,52.78
Gangplank,Lulu,1043,560,483,53.69
Gangplank,Taliyah,162,79,83,48.77
Gangplank,Leblanc,466,218,248,46.78
Gangplank,Sona,226,104,122,46.02
Gangplank,Shaco,632,322,310,50.95
Gangplank,Irelia,659,317,342,48.1
Gangplank,Karma,1007,508,499,50.45
Gangplank,LeeSin,1289,628,661,48.72
Gangplank,TwistedFate,337,154,183,45.7
Gangplank,Samira,362,184,178,50.83
Gangplank,Mel,1257,625,632,49.72
Gangplank,Ornn,298,154,144,51.68
Gangplank,Nocturne,1028,451,577,43.87
Gangplank,MissFortune,1367,669,698,48.94
Gangplank,Seraphine,446,250,196,56.05
Gangplank,Ambessa,446,248,198,55.61
Gangplank,Velkoz,361,183,178,50.69
Gangplank,Ryze,289,109,180,37.72
Gangplank,Ashe,1421,729,692,51.3
Gangplank,Malphite,707,344,363,48.66
Gangplank,MasterYi,726,362,364,49.86
Gangplank,Fizz,411,189,222,45.99
Gangplank,Malzahar,759,324,435,42.69
Gangplank,Vi,681,357,324,52.42
Gangplank,Renekton,277,155,122,55.96
Gangplank,Rell,292,155,137,53.08
Gangplank,Urgot,350,161,189,46
Gangplank,Veigar,576,290,286,50.35
Gangplank,Senna,412,212,200,51.46
Gangplank,Warwick,860,415,445,48.26
Gangplank,Kennen,200,111,89,55.5
Gangplank,Kaisa,1345,705,640,52.42
Gangplank,Janna,252,101,151,40.08
Gangplank,Gnar,316,158,158,50
Gangplank,Orianna,349,163,186,46.7
Gangplank,Riven,329,160,169,48.63
Gangplank,Mordekaiser,773,340,433,43.98
Gangplank,Tristana,679,343,336,50.52
Gangplank,Rumble,210,102,108,48.57
Gangplank,Pyke,537,246,291,45.81
Gangplank,Udyr,209,95,114,45.45
Gangplank,Lucian,557,293,264,52.6
Gangplank,Gwen,329,169,160,51.37
Gangplank,Tryndamere,408,198,210,48.53
Gangplank,Leona,525,262,263,49.9
Gangplank,Kled,140,72,68,51.43
Gangplank,Karthus,247,131,116,53.04
Gangplank,Qiyana,114,51,63,44.74
Gangplank,Gragas,396,178,218,44.95
Gangplank,Singed,206,110,96,53.4
Gangplank,Viego,1008,484,524,48.02
Gangplank,TahmKench,430,216,214,50.23
Gangplank,Talon,434,238,196,54.84
Gangplank,Maokai,314,167,147,53.18
Gangplank,Zilean,232,109,123,46.98
Gangplank,Braum,391,180,211,46.04
Gangplank,Yone,1225,610,615,49.8
Gangplank,Kindred,325,162,163,49.85
Gangplank,Vayne,854,451,403,52.81
Gangplank,Sion,451,241,210,53.44
Gangplank,Shyvana,166,83,83,50
Gangplank,Draven,358,201,157,56.15
Gangplank,Zac,332,182,150,54.82
Gangplank,Vex,319,174,145,54.55
Gangplank,Sivir,439,228,211,51.94
Gangplank,Quinn,305,163,142,53.44
Gangplank,Galio,610,280,330,45.9
Gangplank,Swain,546,271,275,49.63
Gangplank,Xayah,302,146,156,48.34
Gangplank,Neeko,313,156,157,49.84
Gangplank,Hwei,435,195,240,44.83
Gangplank,Xerath,623,315,308,50.56
Gangplank,MonkeyKing,540,310,230,57.41
Gangplank,Syndra,393,196,197,49.87
Gangplank,Heimerdinger,286,139,147,48.6
Gangplank,Zed,821,465,356,56.64
Gangplank,Thresh,887,421,466,47.46
Gangplank,Brand,418,184,234,44.02
Gangplank,Ziggs,230,107,123,46.52
Gangplank,JarvanIV,501,249,252,49.7
Gangplank,Elise,584,277,307,47.43
Gangplank,Aatrox,1046,503,543,48.09
Gangplank,FiddleSticks,314,144,170,45.86
Gangplank,Illaoi,231,104,127,45.02
Gangplank,Ivern,102,52,50,50.98
Gangplank,Shen,433,263,170,60.74
Gangplank,Rakan,246,138,108,56.1
Gangplank,Twitch,541,265,276,48.98
Gangplank,Trundle,369,155,214,42.01
Gangplank,Corki,291,143,148,49.14
Gangplank,Amumu,536,237,299,44.22
Gangplank,Morgana,781,417,364,53.39
Gangplank,Poppy,403,229,174,56.82
Gangplank,Chogath,767,337,430,43.94
Gangplank,Taric,164,76,88,46.34
Gangplank,Vladimir,528,264,264,50
Gangplank,Sylas,1098,568,530,51.73
Gangplank,Cassiopeia,182,74,108,40.66
Gangplank,XinZhao,536,220,316,41.04
Gangplank,Akshan,248,116,132,46.77
Gangplank,Kassadin,135,80,55,59.26
Gangplank,Graves,568,288,280,50.7
Gangplank,Yorick,597,319,278,53.43
Gangplank,Briar,446,262,184,58.74
Gangplank,Fiora,250,120,130,48
Gangplank,AurelionSol,262,126,136,48.09
Gangplank,Jayce,475,265,210,55.79
Gangplank,Alistar,314,190,124,60.51
Gangplank,Blitzcrank,515,245,270,47.57
Gangplank,Zeri,332,150,182,45.18
Gangplank,Smolder,353,182,171,51.56
Gangplank,Kalista,148,58,90,39.19
Gangplank,Skarner,188,99,89,52.66
Gangplank,Nunu,293,154,139,52.56
Gangplank,Renata,107,47,60,43.93
Gangplank,Azir,278,133,145,47.84
Gangplank,Naafiri,187,94,93,50.27
Gangplank,Hecarim,339,173,166,51.03
Gangplank,Nidalee,206,95,111,46.12
Gangplank,RekSai,106,58,48,54.72
Gangplank,Nilah,212,98,114,46.23
Gangplank,Olaf,170,69,101,40.59
Gangplank,Annie,223,109,114,48.88
Gangplank,Belveth,181,92,89,50.83
Gangplank,Zoe,280,125,155,44.64
Gangplank,Lissandra,212,116,96,54.72
Evelynn,Garen,632,302,330,47.78
Evelynn,Sejuani,168,83,85,49.4
Evelynn,Katarina,349,191,158,54.73
Evelynn,Varus,342,165,177,48.25
Evelynn,Yuumi,390,202,188,51.79
Evelynn,Gangplank,211,100,111,47.39
Evelynn,Kayn,648,327,321,50.46
Evelynn,Mel,851,451,400,53
Evelynn,MissFortune,1051,506,545,48.14
Evelynn,Thresh,496,238,258,47.98
Evelynn,Gnar,221,94,127,42.53
Evelynn,Zyra,440,206,234,46.82
Evelynn,Azir,131,57,74,43.51
Evelynn,Nautilus,479,237,242,49.48
Evelynn,Ambessa,304,159,145,52.3
Evelynn,XinZhao,241,118,123,48.96
Evelynn,Vladimir,256,115,141,44.92
Evelynn,Ezreal,1017,555,462,54.57
Evelynn,Karma,540,296,244,54.81
Evelynn,Volibear,539,271,268,50.28
Evelynn,Fizz,278,118,160,42.45
Evelynn,Aphelios,268,117,151,43.66
Evelynn,Rumble,141,94,47,66.67
Evelynn,Amumu,454,202,252,44.49
Evelynn,Yasuo,790,386,404,48.86
Evelynn,Jinx,1223,622,601,50.86
Evelynn,Lulu,624,298,326,47.76
Evelynn,Irelia,370,182,188,49.19
Evelynn,Briar,309,173,136,55.99
Evelynn,Vayne,525,259,266,49.33
Evelynn,Pyke,328,153,175,46.65
Evelynn,Tryndamere,223,105,118,47.09
Evelynn,Rengar,146,93,53,63.7
Evelynn,Viktor,410,231,179,56.34
Evelynn,Caitlyn,1251,585,666,46.76
Evelynn,Lux,1096,555,541,50.64
Evelynn,TahmKench,385,220,165,57.14
Evelynn,Malzahar,436,200,236,45.87
Evelynn,Rakan,187,73,114,39.04
Evelynn,Talon,248,113,135,45.56
Evelynn,Diana,753,348,405,46.22
Evelynn,Akshan,149,77,72,51.68
Evelynn,Velkoz,282,149,133,52.84
Evelynn,LeeSin,608,300,308,49.34
Evelynn,Ahri,600,276,324,46
Evelynn,Renata,59,28,31,47.46
Evelynn,Teemo,543,228,315,41.99
Evelynn,Morgana,534,276,258,51.69
Evelynn,KSante,217,118,99,54.38
Evelynn,Swain,385,153,232,39.74
Evelynn,RekSai,25,11,14,44
Evelynn,Malphite,417,215,202,51.56
Evelynn,Aatrox,393,205,188,52.16
Evelynn,Jax,408,202,206,49.51
Evelynn,Cassiopeia,141,57,84,40.43
Evelynn,Samira,316,166,150,52.53
Evelynn,Mordekaiser,544,268,276,49.26
Evelynn,Lillia,239,109,130,45.61
Evelynn,Tristana,427,215,212,50.35
Evelynn,Smolder,207,114,93,55.07
Evelynn,Kayle,329,145,184,44.07
Evelynn,Kassadin,90,43,47,47.78
Evelynn,Xayah,232,110,122,47.41
Evelynn,Shen,253,122,131,48.22
Evelynn,Brand,356,165,191,46.35
Evelynn,MonkeyKing,290,139,151,47.93
Evelynn,Alistar,185,83,102,44.86
Evelynn,Olaf,84,38,46,45.24
Evelynn,Veigar,528,257,271,48.67
Evelynn,Kaisa,669,356,313,53.21
Evelynn,Camille,140,84,56,60
Evelynn,Khazix,258,141,117,54.65
Evelynn,Akali,452,203,249,44.91
Evelynn,Ashe,893,453,440,50.73
Evelynn,Zed,484,245,239,50.62
Evelynn,Leona,330,181,149,54.85
Evelynn,Riven,213,115,98,53.99
Evelynn,Milio,251,110,141,43.82
Evelynn,Darius,773,371,402,47.99
Evelynn,Xerath,370,198,172,53.51
Evelynn,Sona,130,61,69,46.92
Evelynn,Nasus,331,181,150,54.68
Evelynn,Warwick,710,343,367,48.31
Evelynn,Braum,273,145,128,53.11
Evelynn,DrMundo,284,123,161,43.31
Evelynn,Qiyana,104,51,53,49.04
Evelynn,Yorick,402,195,207,48.51
Evelynn,FiddleSticks,144,63,81,43.75
Evelynn,Vex,260,118,142,45.38
Evelynn,Heimerdinger,221,103,118,46.61
Evelynn,Chogath,524,231,293,44.08
Evelynn,Nami,477,219,258,45.91
Evelynn,Maokai,187,105,82,56.15
Evelynn,Karthus,117,51,66,43.59
Evelynn,Galio,364,166,198,45.6
Evelynn,Yone,828,429,399,51.81
Evelynn,Ziggs,154,59,95,38.31
Evelynn,Trundle,257,123,134,47.86
Evelynn,Lissandra,143,67,76,46.85
Evelynn,Aurora,329,163,166,49.54
Evelynn,Sivir,251,95,156,37.85
Evelynn,Zilean,137,54,83,39.42
Evelynn,Sylas,573,309,264,53.93
Evelynn,Shaco,436,275,161,63.07
Evelynn,Taliyah,90,46,44,51.11
Evelynn,Jhin,823,414,409,50.3
Evelynn,Viego,631,326,305,51.66
Evelynn,AurelionSol,175,72,103,41.14
Evelynn,Pantheon,652,317,335,48.62
Evelynn,Twitch,393,164,229,41.73
Evelynn,Rell,186,88,98,47.31
Evelynn,MasterYi,527,242,285,45.92
Evelynn,KogMaw,144,79,65,54.86
Evelynn,Seraphine,323,142,181,43.96
Evelynn,Draven,216,119,97,55.09
Evelynn,Gwen,234,98,136,41.88
Evelynn,Kennen,105,63,42,60
Evelynn,Fiora,158,82,76,51.9
Evelynn,Leblanc,284,147,137,51.76
Evelynn,Soraka,235,120,115,51.06
Evelynn,Sett,641,328,313,51.17
Evelynn,Kindred,189,93,96,49.21
Evelynn,Gragas,194,85,109,43.81
Evelynn,Ekko,456,232,224,50.88
Evelynn,Poppy,238,134,104,56.3
Evelynn,Taric,67,41,26,61.19
Evelynn,Sion,355,161,194,45.35
Evelynn,Syndra,257,114,143,44.36
Evelynn,Vi,489,227,262,46.42
Evelynn,Nilah,127,63,64,49.61
Evelynn,Nocturne,655,265,390,40.46
Evelynn,Senna,321,168,153,52.34
Evelynn,Renekton,208,116,92,55.77
Evelynn,Kalista,130,68,62,52.31
Evelynn,Blitzcrank,318,150,168,47.17
Evelynn,Orianna,161,87,74,54.04
Evelynn,Jayce,209,99,110,47.37
Evelynn,Graves,275,154,121,56
Evelynn,Neeko,181,97,84,53.59
Evelynn,JarvanIV,260,140,120,53.85
Evelynn,Zac,211,110,101,52.13
Evelynn,Janna,140,49,91,35
Evelynn,Udyr,195,93,102,47.69
Evelynn,Quinn,143,71,72,49.65
Evelynn,Belveth,83,50,33,60.24
Evelynn,Elise,362,185,177,51.1
Evelynn,Anivia,131,66,65,50.38
Evelynn,Hecarim,140,79,61,56.43
Evelynn,Illaoi,185,93,92,50.27
Evelynn,Singed,133,71,62,53.38
Evelynn,Hwei,245,125,120,51.02
Evelynn,Shyvana,106,55,51,51.89
Evelynn,Nunu,221,122,99,55.2
Evelynn,TwistedFate,171,80,91,46.78
Evelynn,Lucian,279,132,147,47.31
Evelynn,Naafiri,128,51,77,39.84
Evelynn,Rammus,99,51,48,51.52
Evelynn,Bard,126,44,82,34.92
Evelynn,Nidalee,120,69,51,57.5
Evelynn,Urgot,214,81,133,37.85
Evelynn,Kled,68,43,25,63.24
Evelynn,Ryze,166,80,86,48.19
Evelynn,Skarner,104,52,52,50
Evelynn,Zoe,156,83,73,53.21
Evelynn,Corki,164,96,68,58.54
Evelynn,Ivern,78,42,36,53.85
Evelynn,Ornn,140,65,75,46.43
Evelynn,Zeri,161,87,74,54.04
Evelynn,Annie,98,54,44,55.1
Elise,Garen,1509,677,832,44.86
Elise,Sejuani,400,190,210,47.5
Elise,Katarina,687,359,328,52.26
Elise,Varus,921,452,469,49.08
Elise,Yuumi,854,467,387,54.68
Elise,Darius,1695,875,820,51.62
Elise,Kindred,458,234,224,51.09
Elise,Yone,1663,816,847,49.07
Elise,Samira,515,265,250,51.46
Elise,Rell,477,224,253,46.96
Elise,Nocturne,1257,595,662,47.33
Elise,Lux,2046,974,1072,47.61
Elise,Lucian,726,370,356,50.96
Elise,Thresh,1333,668,665,50.11
Elise,Vi,900,478,422,53.11
Elise,Ekko,1076,507,569,47.12
Elise,Yasuo,1786,883,903,49.44
Elise,Jhin,1807,873,934,48.31
Elise,Velkoz,499,190,309,38.08
Elise,Malphite,860,411,449,47.79
Elise,Shyvana,189,85,104,44.97
Elise,Naafiri,224,118,106,52.68
Elise,MissFortune,1874,831,1043,44.34
Elise,Maokai,464,217,247,46.77
Elise,Irelia,799,366,433,45.81
Elise,Rammus,247,117,130,47.37
Elise,Caitlyn,2371,1250,1121,52.72
Elise,Karma,1371,663,708,48.36
Elise,DrMundo,433,225,208,51.96
Elise,Lillia,441,257,184,58.28
Elise,Ezreal,2684,1406,1278,52.38
Elise,Gnar,407,213,194,52.33
Elise,LeeSin,1978,952,1026,48.13
Elise,Ahri,1167,604,563,51.76
Elise,Renata,139,76,63,54.68
Elise,Tryndamere,352,187,165,53.13
Elise,Volibear,767,386,381,50.33
Elise,Annie,279,118,161,42.29
Elise,Seraphine,603,315,288,52.24
Elise,Teemo,985,429,556,43.55
Elise,FiddleSticks,497,246,251,49.5
Elise,Morgana,960,499,461,51.98
Elise,Anivia,347,172,175,49.57
Elise,Diana,1464,689,775,47.06
Elise,AurelionSol,295,161,134,54.58
Elise,Kaisa,1823,984,839,53.98
Elise,Galio,881,391,490,44.38
Elise,Yorick,720,333,387,46.25
Elise,Jax,896,488,408,54.46
Elise,Nami,1105,557,548,50.41
Elise,MasterYi,1048,555,493,52.96
Elise,Vex,421,216,205,51.31
Elise,Sett,1266,632,634,49.92
Elise,Rengar,404,208,196,51.49
Elise,Pantheon,1562,806,756,51.6
Elise,Zyra,880,387,493,43.98
Elise,Renekton,557,294,263,52.78
Elise,Udyr,333,174,159,52.25
Elise,Vladimir,676,321,355,47.49
Elise,Jinx,2585,1280,1305,49.52
Elise,Poppy,558,277,281,49.64
Elise,Camille,438,213,225,48.63
Elise,TahmKench,631,279,352,44.22
Elise,Urgot,395,202,193,51.14
Elise,Ivern,188,88,100,46.81
Elise,Twitch,685,336,349,49.05
Elise,Lulu,1427,733,694,51.37
Elise,Chogath,1069,545,524,50.98
Elise,Rumble,312,162,150,51.92
Elise,Aurora,698,353,345,50.57
Elise,Ashe,1918,926,992,48.28
Elise,Swain,771,400,371,51.88
Elise,Qiyana,296,164,132,55.41
Elise,Gragas,579,275,304,47.5
Elise,Trundle,405,195,210,48.15
Elise,Tristana,820,386,434,47.07
Elise,Warwick,1033,436,597,42.21
Elise,Leona,703,377,326,53.63
Elise,KSante,581,301,280,51.81
Elise,Kayn,1223,622,601,50.86
Elise,Taliyah,221,106,115,47.96
Elise,Gwen,455,201,254,44.18
Elise,Viktor,943,512,431,54.29
Elise,Blitzcrank,647,316,331,48.84
Elise,Khazix,498,252,246,50.6
Elise,Taric,201,88,113,43.78
Elise,Vayne,1154,585,569,50.69
Elise,Riven,472,237,235,50.21
Elise,Malzahar,876,389,487,44.41
Elise,Singed,245,131,114,53.47
Elise,Xayah,437,238,199,54.46
Elise,Rakan,473,255,218,53.91
Elise,Kayle,466,245,221,52.58
Elise,Zed,1115,549,566,49.24
Elise,Janna,369,186,183,50.41
Elise,Gangplank,584,307,277,52.57
Elise,Illaoi,388,220,168,56.7
Elise,Ornn,390,195,195,50
Elise,Zoe,460,238,222,51.74
Elise,Viego,1448,744,704,51.38
Elise,Ryze,323,158,165,48.92
Elise,Smolder,560,283,277,50.54
Elise,Ziggs,235,105,130,44.68
Elise,Zac,513,272,241,53.02
Elise,Nidalee,362,182,180,50.28
Elise,Kassadin,207,101,106,48.79
Elise,Ambessa,652,373,279,57.21
Elise,Hwei,680,366,314,53.82
Elise,Veigar,749,403,346,53.81
Elise,Mel,1607,847,760,52.71
Elise,Shen,555,282,273,50.81
Elise,JarvanIV,627,313,314,49.92
Elise,Sivir,525,288,237,54.86
Elise,Skarner,256,150,106,58.59
Elise,Corki,428,213,215,49.77
Elise,Braum,617,279,338,45.22
Elise,Sion,701,308,393,43.94
Elise,Draven,435,205,230,47.13
Elise,Milio,572,276,296,48.25
Elise,Shaco,905,441,464,48.73
Elise,Hecarim,436,230,206,52.75
Elise,Brand,618,340,278,55.02
Elise,Aphelios,455,205,250,45.05
Elise,Nautilus,1002,546,456,54.49
Elise,Bard,307,173,134,56.35
Elise,Cassiopeia,249,148,101,59.44
Elise,XinZhao,688,317,371,46.08
Elise,Sona,230,97,133,42.17
Elise,Akali,981,510,471,51.99
Elise,Syndra,678,340,338,50.15
Elise,Nilah,255,112,143,43.92
Elise,TwistedFate,315,181,134,57.46
Elise,Senna,710,357,353,50.28
Elise,Kennen,323,170,153,52.63
Elise,Aatrox,974,510,464,52.36
Elise,Karthus,327,157,170,48.01
Elise,MonkeyKing,566,318,248,56.18
Elise,Alistar,396,186,210,46.97
Elise,Fiora,337,145,192,43.03
Elise,RekSai,142,68,74,47.89
Elise,Pyke,800,437,363,54.63
Elise,Fizz,514,253,261,49.22
Elise,Lissandra,330,131,199,39.7
Elise,KogMaw,293,139,154,47.44
Elise,Xerath,981,501,480,51.07
Elise,Heimerdinger,284,153,131,53.87
Elise,Sylas,1431,708,723,49.48
Elise,Kled,180,75,105,41.67
Elise,Kalista,296,179,117,60.47
Elise,Mordekaiser,953,429,524,45.02
Elise,Orianna,453,241,212,53.2
Elise,Nunu,435,211,224,48.51
Elise,Soraka,501,254,247,50.7
Elise,Neeko,392,203,189,51.79
Elise,Nasus,533,269,264,50.47
Elise,Evelynn,362,177,185,48.9
Elise,Jayce,548,293,255,53.47
Elise,Briar,570,282,288,49.47
Elise,Azir,346,168,178,48.55
Elise,Leblanc,684,378,306,55.26
Elise,Amumu,822,399,423,48.54
Elise,Quinn,319,166,153,52.04
Elise,Zilean,285,114,171,40
Elise,Talon,655,337,318,51.45
Elise,Olaf,210,101,109,48.1
Elise,Graves,678,316,362,46.61
Elise,Belveth,218,118,100,54.13
Elise,Akshan,300,155,145,51.67
Elise,Zeri,389,203,186,52.19
Gwen,Pantheon,942,450,492,47.77
Gwen,Volibear,739,342,397,46.28
Gwen,Zed,666,312,354,46.85
Gwen,Tristana,688,363,325,52.76
Gwen,Yuumi,520,242,278,46.54
Gwen,Chogath,1000,474,526,47.4
Gwen,Kindred,265,136,129,51.32
Gwen,Katarina,491,225,266,45.82
Gwen,Neeko,285,151,134,52.98
Gwen,Azir,180,100,80,55.56
Gwen,Nocturne,901,444,457,49.28
Gwen,Syndra,367,152,215,41.42
Gwen,Jhin,1186,633,553,53.37
Gwen,Senna,404,191,213,47.28
Gwen,Trundle,394,193,201,48.98
Gwen,Viktor,669,322,347,48.13
Gwen,Xayah,275,120,155,43.64
Gwen,Lulu,825,399,426,48.36
Gwen,Jax,590,280,310,47.46
Gwen,Viego,842,354,488,42.04
Gwen,Aurora,421,210,211,49.88
Gwen,Vayne,745,352,393,47.25
Gwen,Lux,1533,718,815,46.84
Gwen,Yorick,763,342,421,44.82
Gwen,Lillia,309,166,143,53.72
Gwen,Yone,1101,574,527,52.13
Gwen,Aatrox,572,308,264,53.85
Gwen,Naafiri,181,92,89,50.83
Gwen,Nilah,196,85,111,43.37
Gwen,Brand,363,177,186,48.76
Gwen,Ezreal,1552,781,771,50.32
Gwen,Veigar,587,275,312,46.85
Gwen,Jinx,1767,806,961,45.61
Gwen,Milio,393,200,193,50.89
Gwen,Riven,328,153,175,46.65
Gwen,FiddleSticks,272,126,146,46.32
Gwen,Ashe,1136,512,624,45.07
Gwen,Ambessa,346,183,163,52.89
Gwen,LeeSin,850,393,457,46.24
Gwen,Lissandra,213,110,103,51.64
Gwen,Varus,569,301,268,52.9
Gwen,Xerath,515,280,235,54.37
Gwen,Vladimir,510,229,281,44.9
Gwen,Aphelios,364,192,172,52.75
Gwen,Velkoz,414,192,222,46.38
Gwen,Gnar,244,95,149,38.93
Gwen,Kayn,844,416,428,49.29
Gwen,MissFortune,1541,656,885,42.57
Gwen,TahmKench,565,283,282,50.09
Gwen,Fiora,293,165,128,56.31
Gwen,Kalista,135,91,44,67.41
Gwen,Poppy,382,175,207,45.81
Gwen,Darius,1118,551,567,49.28
Gwen,Sejuani,343,184,159,53.64
Gwen,Caitlyn,1646,829,817,50.36
Gwen,Seraphine,452,230,222,50.88
Gwen,Garen,1118,502,616,44.9
Gwen,AurelionSol,223,90,133,40.36
Gwen,Mel,1134,547,587,48.24
Gwen,Gangplank,329,160,169,48.63
Gwen,Ekko,594,294,300,49.49
Gwen,Kassadin,152,73,79,48.03
Gwen,Rakan,220,126,94,57.27
Gwen,Renekton,296,147,149,49.66
Gwen,Olaf,136,71,65,52.21
Gwen,Qiyana,143,71,72,49.65
Gwen,Urgot,290,133,157,45.86
Gwen,Yasuo,1138,542,596,47.63
Gwen,KogMaw,207,98,109,47.34
Gwen,Warwick,1018,467,551,45.87
Gwen,Ziggs,244,146,98,59.84
Gwen,Hwei,427,196,231,45.9
Gwen,Rammus,212,127,85,59.91
Gwen,Corki,304,164,140,53.95
Gwen,Soraka,359,163,196,45.4
Gwen,Malphite,726,359,367,49.45
Gwen,Skarner,192,113,79,58.85
Gwen,Diana,1114,516,598,46.32
Gwen,Swain,611,275,336,45.01
Gwen,Lucian,439,208,231,47.38
Gwen,Nami,713,306,407,42.92
Gwen,Mordekaiser,725,325,400,44.83
Gwen,TwistedFate,185,89,96,48.11
Gwen,Sion,588,272,316,46.26
Gwen,Thresh,864,403,461,46.64
Gwen,Teemo,562,226,336,40.21
Gwen,Sylas,846,427,419,50.47
Gwen,Fizz,342,170,172,49.71
Gwen,Kaisa,954,464,490,48.64
Gwen,Morgana,698,307,391,43.98
Gwen,Sivir,363,152,211,41.87
Gwen,Elise,455,254,201,55.82
Gwen,Nautilus,712,362,350,50.84
Gwen,Talon,326,154,172,47.24
Gwen,Sona,243,112,131,46.09
Gwen,Briar,430,193,237,44.88
Gwen,Akali,698,286,412,40.97
Gwen,Anivia,209,107,102,51.2
Gwen,Karma,752,305,447,40.56
Gwen,Smolder,384,180,204,46.88
Gwen,Tryndamere,350,156,194,44.57
Gwen,Nasus,469,217,252,46.27
Gwen,Sett,928,410,518,44.18
Gwen,Janna,240,105,135,43.75
Gwen,Singed,175,60,115,34.29
Gwen,DrMundo,502,281,221,55.98
Gwen,Ornn,395,215,180,54.43
Gwen,Taliyah,184,89,95,48.37
Gwen,Draven,322,167,155,51.86
Gwen,KSante,432,238,194,55.09
Gwen,Shyvana,195,93,102,47.69
Gwen,Galio,560,261,299,46.61
Gwen,Leblanc,343,166,177,48.4
Gwen,Rengar,242,123,119,50.83
Gwen,Karthus,169,75,94,44.38
Gwen,Zilean,182,108,74,59.34
Gwen,Kled,115,58,57,50.43
Gwen,MasterYi,787,348,439,44.22
Gwen,Irelia,443,193,250,43.57
Gwen,Kayle,410,191,219,46.59
Gwen,Evelynn,234,136,98,58.12
Gwen,Ryze,216,110,106,50.93
Gwen,Twitch,506,261,245,51.58
Gwen,Leona,485,250,235,51.55
Gwen,Gragas,296,158,138,53.38
Gwen,Ahri,808,376,432,46.53
Gwen,Camille,221,106,115,47.96
Gwen,Zyra,659,304,355,46.13
Gwen,Graves,397,203,194,51.13
Gwen,Vex,337,146,191,43.32
Gwen,Zoe,261,157,104,60.15
Gwen,Blitzcrank,430,228,202,53.02
Gwen,Udyr,308,155,153,50.32
Gwen,Annie,234,128,106,54.7
Gwen,Taric,144,69,75,47.92
Gwen,Hecarim,247,128,119,51.82
Gwen,Bard,219,103,116,47.03
Gwen,Kennen,110,50,60,45.45
Gwen,Jayce,231,120,111,51.95
Gwen,XinZhao,424,222,202,52.36
Gwen,Shaco,511,239,272,46.77
Gwen,Vi,509,233,276,45.78
Gwen,Ivern,138,69,69,50
Gwen,MonkeyKing,455,232,223,50.99
Gwen,Khazix,304,152,152,50
Gwen,Amumu,687,320,367,46.58
Gwen,Nunu,287,125,162,43.55
Gwen,Heimerdinger,268,138,130,51.49
Gwen,Malzahar,690,300,390,43.48
Gwen,Alistar,218,101,117,46.33
Gwen,Samira,475,214,261,45.05
Gwen,Cassiopeia,147,83,64,56.46
Gwen,Maokai,287,131,156,45.64
Gwen,Quinn,217,93,124,42.86
Gwen,Akshan,191,84,107,43.98
Gwen,Braum,312,132,180,42.31
Gwen,Belveth,154,89,65,57.79
Gwen,Rumble,148,77,71,52.03
Gwen,Orianna,244,119,125,48.77
Gwen,Pyke,511,275,236,53.82
Gwen,Nidalee,161,99,62,61.49
Gwen,JarvanIV,379,159,220,41.95
Gwen,Zeri,240,95,145,39.58
Gwen,Zac,365,172,193,47.12
Gwen,Rell,320,154,166,48.13
Gwen,Illaoi,281,141,140,50.18
Gwen,Shen,472,243,229,51.48
Gwen,Renata,107,60,47,56.07
Gwen,RekSai,95,40,55,42.11
Skarner,Pantheon,516,210,306,40.7
Skarner,Volibear,344,156,188,45.35
Skarner,Zed,317,134,183,42.27
Skarner,Tristana,286,125,161,43.71
Skarner,Yuumi,271,117,154,43.17
Skarner,Jax,311,141,170,45.34
Skarner,Amumu,335,154,181,45.97
Skarner,Ahri,412,176,236,42.72
Skarner,Caitlyn,813,369,444,45.39
Skarner,Lulu,480,201,279,41.88
Skarner,Gnar,122,56,66,45.9
Skarner,Sylas,518,259,259,50
Skarner,Mel,626,322,304,51.44
Skarner,Ashe,682,318,364,46.63
Skarner,Seraphine,199,79,120,39.7
Skarner,Akali,346,142,204,41.04
Skarner,Sejuani,159,62,97,38.99
Skarner,Galio,262,135,127,51.53
Skarner,Jhin,614,268,346,43.65
Skarner,Milio,181,84,97,46.41
Skarner,Viego,440,184,256,41.82
Skarner,TwistedFate,115,51,64,44.35
Skarner,Jinx,829,367,462,44.27
Skarner,Lux,690,320,370,46.38
Skarner,Udyr,123,44,79,35.77
Skarner,XinZhao,253,75,178,29.64
Skarner,Leona,298,137,161,45.97
Skarner,Sett,471,193,278,40.98
Skarner,Yone,627,313,314,49.92
Skarner,Ezreal,817,393,424,48.1
Skarner,Zyra,272,106,166,38.97
Skarner,Darius,601,265,336,44.09
Skarner,JarvanIV,194,82,112,42.27
Skarner,Leblanc,220,93,127,42.27
Skarner,Xayah,162,65,97,40.12
Skarner,Heimerdinger,125,54,71,43.2
Skarner,DrMundo,189,112,77,59.26
Skarner,Karma,421,199,222,47.27
Skarner,Fiora,129,46,83,35.66
Skarner,Kassadin,49,20,29,40.82
Skarner,Aatrox,283,155,128,54.77
Skarner,Malzahar,369,155,214,42.01
Skarner,Samira,197,96,101,48.73
Skarner,Rakan,106,57,49,53.77
Skarner,Diana,465,203,262,43.66
Skarner,Swain,289,108,181,37.37
Skarner,Gwen,192,79,113,41.15
Skarner,MasterYi,355,173,182,48.73
Skarner,Morgana,337,138,199,40.95
Skarner,Kayn,481,196,285,40.75
Skarner,Teemo,405,190,215,46.91
Skarner,Irelia,267,126,141,47.19
Skarner,Senna,190,78,112,41.05
Skarner,LeeSin,542,293,249,54.06
Skarner,Varus,289,130,159,44.98
Skarner,Yasuo,551,225,326,40.83
Skarner,Janna,81,32,49,39.51
Skarner,Kaisa,600,271,329,45.17
Skarner,Shaco,277,118,159,42.6
Skarner,Annie,126,66,60,52.38
Skarner,Poppy,192,73,119,38.02
Skarner,Thresh,425,202,223,47.53
Skarner,Quinn,110,65,45,59.09
Skarner,Qiyana,81,45,36,55.56
Skarner,AurelionSol,138,61,77,44.2
Skarner,Corki,116,56,60,48.28
Skarner,Gragas,191,73,118,38.22
Skarner,Garen,482,208,274,43.15
Skarner,Ekko,290,138,152,47.59
Skarner,Karthus,110,59,51,53.64
Skarner,Shen,144,64,80,44.44
Skarner,Ziggs,113,53,60,46.9
Skarner,Brand,224,81,143,36.16
Skarner,Ornn,129,46,83,35.66
Skarner,Nasus,178,87,91,48.88
Skarner,Khazix,142,94,48,66.2
Skarner,Yorick,327,109,218,33.33
Skarner,Blitzcrank,260,106,154,40.77
Skarner,Kindred,153,81,72,52.94
Skarner,TahmKench,207,103,104,49.76
Skarner,Elise,256,106,150,41.41
Skarner,Nami,314,137,177,43.63
Skarner,Chogath,337,160,177,47.48
Skarner,Talon,172,79,93,45.93
Skarner,Vladimir,213,102,111,47.89
Skarner,Soraka,200,81,119,40.5
Skarner,Singed,105,31,74,29.52
Skarner,Mordekaiser,391,182,209,46.55
Skarner,Veigar,275,125,150,45.45
Skarner,Bard,72,30,42,41.67
Skarner,Anivia,89,38,51,42.7
Skarner,Illaoi,142,58,84,40.85
Skarner,Hwei,243,134,109,55.14
Skarner,Maokai,158,83,75,52.53
Skarner,Vayne,502,234,268,46.61
Skarner,Sona,124,51,73,41.13
Skarner,Orianna,163,86,77,52.76
Skarner,Twitch,259,106,153,40.93
Skarner,Syndra,187,102,85,54.55
Skarner,KogMaw,93,21,72,22.58
Skarner,Braum,221,109,112,49.32
Skarner,Riven,143,58,85,40.56
Skarner,Viktor,319,127,192,39.81
Skarner,Belveth,82,28,54,34.15
Skarner,Naafiri,89,47,42,52.81
Skarner,Nautilus,416,229,187,55.05
Skarner,MissFortune,707,302,405,42.72
Skarner,Urgot,125,41,84,32.8
Skarner,Camille,127,71,56,55.91
Skarner,Kalista,92,50,42,54.35
Skarner,Nidalee,95,32,63,33.68
Skarner,Lucian,216,119,97,55.09
Skarner,Briar,167,80,87,47.9
Skarner,Katarina,220,100,120,45.45
Skarner,Malphite,284,131,153,46.13
Skarner,Azir,125,56,69,44.8
Skarner,Draven,142,73,69,51.41
Skarner,Pyke,204,86,118,42.16
Skarner,Smolder,194,83,111,42.78
Skarner,Rumble,96,41,55,42.71
Skarner,Graves,210,87,123,41.43
Skarner,Trundle,178,87,91,48.88
Skarner,Aurora,238,92,146,38.66
Skarner,Renekton,185,80,105,43.24
Skarner,Aphelios,181,95,86,52.49
Skarner,Ivern,47,22,25,46.81
Skarner,Nocturne,351,156,195,44.44
Skarner,Gangplank,188,89,99,47.34
Skarner,Vi,321,142,179,44.24
Skarner,FiddleSticks,185,86,99,46.49
Skarner,Zac,217,106,111,48.85
Skarner,Rengar,110,57,53,51.82
Skarner,Velkoz,171,84,87,49.12
Skarner,Warwick,407,149,258,36.61
Skarner,KSante,222,93,129,41.89
Skarner,Alistar,128,47,81,36.72
Skarner,Kayle,233,108,125,46.35
Skarner,Sivir,170,74,96,43.53
Skarner,Olaf,106,67,39,63.21
Skarner,Vex,129,83,46,64.34
Skarner,Zeri,140,60,80,42.86
Skarner,Rell,171,65,106,38.01
Skarner,Fizz,135,41,94,30.37
Skarner,Hecarim,114,57,57,50
Skarner,Zilean,77,42,35,54.55
Skarner,Tryndamere,120,52,68,43.33
Skarner,Sion,245,101,144,41.22
Skarner,Evelynn,104,52,52,50
Skarner,Nilah,79,30,49,37.97
Skarner,MonkeyKing,258,124,134,48.06
Skarner,Ryze,135,59,76,43.7
Skarner,Taric,40,13,27,32.5
Skarner,Renata,55,28,27,50.91
Skarner,Nunu,170,82,88,48.24
Skarner,Kennen,90,41,49,45.56
Skarner,Taliyah,113,44,69,38.94
Skarner,Shyvana,79,35,44,44.3
Skarner,Xerath,312,178,134,57.05
Skarner,Neeko,159,80,79,50.31
Skarner,Lillia,241,103,138,42.74
Skarner,Ambessa,207,85,122,41.06
Skarner,Rammus,55,17,38,30.91
Skarner,Akshan,125,64,61,51.2
Skarner,Lissandra,95,45,50,47.37
Skarner,Zoe,106,46,60,43.4
Skarner,Cassiopeia,71,32,39,45.07
Skarner,Kled,85,43,42,50.59
Skarner,RekSai,46,20,26,43.48
Skarner,Jayce,144,53,91,36.81
DrMundo,Pantheon,1185,613,572,51.73
DrMundo,Volibear,888,477,411,53.72
DrMundo,Zed,756,391,365,51.72
DrMundo,Tristana,770,393,377,51.04
DrMundo,Yuumi,564,278,286,49.29
DrMundo,Warwick,1168,577,591,49.4
DrMundo,Briar,513,265,248,51.66
DrMundo,Ziggs,245,111,134,45.31
DrMundo,Xerath,621,334,287,53.78
DrMundo,Yasuo,1394,679,715,48.71
DrMundo,Khazix,362,192,170,53.04
DrMundo,Lissandra,199,85,114,42.71
DrMundo,Lucian,399,239,160,59.9
DrMundo,Rell,312,158,154,50.64
DrMundo,Trundle,484,198,286,40.91
DrMundo,Veigar,764,384,380,50.26
DrMundo,Thresh,865,423,442,48.9
DrMundo,Singed,244,129,115,52.87
DrMundo,Diana,1165,558,607,47.9
DrMundo,Viktor,576,277,299,48.09
DrMundo,MissFortune,1691,880,811,52.04
DrMundo,Galio,621,328,293,52.82
DrMundo,Darius,1458,786,672,53.91
DrMundo,Elise,433,208,225,48.04
DrMundo,Gangplank,360,189,171,52.5
DrMundo,Varus,605,326,279,53.88
DrMundo,Heimerdinger,325,147,178,45.23
DrMundo,Amumu,757,381,376,50.33
DrMundo,Malphite,767,412,355,53.72
DrMundo,Smolder,529,271,258,51.23
DrMundo,Kayle,396,206,190,52.02
DrMundo,Bard,200,108,92,54
DrMundo,Ekko,648,284,364,43.83
DrMundo,Camille,230,129,101,56.09
DrMundo,XinZhao,397,199,198,50.13
DrMundo,Mel,1416,751,665,53.04
DrMundo,Ahri,978,521,457,53.27
DrMundo,Fiora,223,101,122,45.29
DrMundo,Karthus,206,109,97,52.91
DrMundo,Malzahar,780,417,363,53.46
DrMundo,Kaisa,1180,579,601,49.07
DrMundo,Milio,379,172,207,45.38
DrMundo,Sett,1076,511,565,47.49
DrMundo,Twitch,593,326,267,54.97
DrMundo,Blitzcrank,494,245,249,49.6
DrMundo,Irelia,499,230,269,46.09
DrMundo,Shaco,680,365,315,53.68
DrMundo,Sion,474,217,257,45.78
DrMundo,Draven,360,186,174,51.67
DrMundo,Skarner,189,77,112,40.74
DrMundo,Katarina,555,277,278,49.91
DrMundo,Seraphine,538,246,292,45.72
DrMundo,Nocturne,914,452,462,49.45
DrMundo,Chogath,1115,608,507,54.53
DrMundo,Jhin,1511,747,764,49.44
DrMundo,Rumble,205,110,95,53.66
DrMundo,Jax,688,358,330,52.03
DrMundo,Evelynn,284,161,123,56.69
DrMundo,Lux,1864,926,938,49.68
DrMundo,Caitlyn,1877,974,903,51.89
DrMundo,Ashe,1422,753,669,52.95
DrMundo,Ambessa,325,152,173,46.77
DrMundo,Kayn,980,482,498,49.18
DrMundo,Jinx,2177,1035,1142,47.54
DrMundo,Rakan,254,144,110,56.69
DrMundo,Shyvana,181,86,95,47.51
DrMundo,Lulu,761,387,374,50.85
DrMundo,Teemo,965,513,452,53.16
DrMundo,Sylas,875,411,464,46.97
DrMundo,TahmKench,541,301,240,55.64
DrMundo,Garen,1185,567,618,47.85
DrMundo,Taric,184,86,98,46.74
DrMundo,Rammus,206,120,86,58.25
DrMundo,Orianna,264,146,118,55.3
DrMundo,Soraka,347,146,201,42.07
DrMundo,Leblanc,406,197,209,48.52
DrMundo,Zoe,258,130,128,50.39
DrMundo,Nautilus,717,367,350,51.19
DrMundo,KSante,330,180,150,54.55
DrMundo,Graves,402,185,217,46.02
DrMundo,MonkeyKing,438,220,218,50.23
DrMundo,Zyra,667,371,296,55.62
DrMundo,Yone,1252,611,641,48.8
DrMundo,Yorick,710,330,380,46.48
DrMundo,Zilean,205,106,99,51.71
DrMundo,Xayah,314,137,177,43.63
DrMundo,Vladimir,482,252,230,52.28
DrMundo,Morgana,999,498,501,49.85
DrMundo,Fizz,418,218,200,52.15
DrMundo,MasterYi,953,489,464,51.31
DrMundo,Karma,817,442,375,54.1
DrMundo,Aatrox,700,336,364,48
DrMundo,Lillia,445,186,259,41.8
DrMundo,Illaoi,391,194,197,49.62
DrMundo,Velkoz,424,204,220,48.11
DrMundo,Poppy,357,185,172,51.82
DrMundo,Samira,478,247,231,51.67
DrMundo,Quinn,296,140,156,47.3
DrMundo,KogMaw,235,114,121,48.51
DrMundo,Gwen,502,221,281,44.02
DrMundo,Sejuani,295,132,163,44.75
DrMundo,Hwei,403,198,205,49.13
DrMundo,Brand,620,335,285,54.03
DrMundo,Nunu,402,211,191,52.49
DrMundo,Ryze,247,106,141,42.91
DrMundo,Senna,481,273,208,56.76
DrMundo,Mordekaiser,994,510,484,51.31
DrMundo,FiddleSticks,381,187,194,49.08
DrMundo,Ezreal,1473,804,669,54.58
DrMundo,Corki,231,121,110,52.38
DrMundo,Renekton,255,142,113,55.69
DrMundo,Cassiopeia,225,117,108,52
DrMundo,Leona,600,289,311,48.17
DrMundo,JarvanIV,352,168,184,47.73
DrMundo,Rengar,211,113,98,53.55
DrMundo,Gragas,317,141,176,44.48
DrMundo,Aurora,467,236,231,50.54
DrMundo,Viego,979,456,523,46.58
DrMundo,Alistar,239,106,133,44.35
DrMundo,Nasus,527,237,290,44.97
DrMundo,Janna,198,106,92,53.54
DrMundo,Zac,278,153,125,55.04
DrMundo,LeeSin,883,471,412,53.34
DrMundo,Syndra,353,157,196,44.48
DrMundo,Swain,687,298,389,43.38
DrMundo,Neeko,311,152,159,48.87
DrMundo,Vayne,996,517,479,51.91
DrMundo,Vi,642,320,322,49.84
DrMundo,Udyr,303,132,171,43.56
DrMundo,Nilah,225,104,121,46.22
DrMundo,Ornn,273,138,135,50.55
DrMundo,Naafiri,223,116,107,52.02
DrMundo,TwistedFate,200,135,65,67.5
DrMundo,Akshan,246,121,125,49.19
DrMundo,Braum,331,142,189,42.9
DrMundo,Kennen,195,121,74,62.05
DrMundo,Gnar,268,132,136,49.25
DrMundo,Kindred,310,185,125,59.68
DrMundo,Qiyana,137,78,59,56.93
DrMundo,Nami,708,378,330,53.39
DrMundo,Hecarim,250,120,130,48
DrMundo,Aphelios,350,178,172,50.86
DrMundo,Shen,431,252,179,58.47
DrMundo,Annie,243,150,93,61.73
DrMundo,Taliyah,174,94,80,54.02
DrMundo,Tryndamere,434,216,218,49.77
DrMundo,Vex,376,199,177,52.93
DrMundo,Pyke,610,337,273,55.25
DrMundo,Renata,93,63,30,67.74
DrMundo,Urgot,405,228,177,56.3
DrMundo,Sona,233,121,112,51.93
DrMundo,Riven,244,137,107,56.15
DrMundo,AurelionSol,267,126,141,47.19
DrMundo,Belveth,132,85,47,64.39
DrMundo,Akali,734,349,385,47.55
DrMundo,Jayce,308,171,137,55.52
DrMundo,Kassadin,146,67,79,45.89
DrMundo,Maokai,314,156,158,49.68
DrMundo,Azir,211,100,111,47.39
DrMundo,Olaf,111,39,72,35.14
DrMundo,Kalista,171,82,89,47.95
DrMundo,Talon,334,181,153,54.19
DrMundo,Zeri,254,138,116,54.33
DrMundo,Ivern,89,44,45,49.44
DrMundo,Sivir,279,145,134,51.97
DrMundo,Kled,133,57,76,42.86
DrMundo,Anivia,280,125,155,44.64
DrMundo,Nidalee,181,100,81,55.25
DrMundo,RekSai,45,27,18,60
Samira,Pantheon,1381,645,736,46.71
Samira,Volibear,990,510,480,51.52
Samira,Zed,1054,527,527,50
Samira,Tristana,817,459,358,56.18
Samira,Yuumi,703,398,305,56.61
Samira,Renekton,477,240,237,50.31
Samira,Trundle,539,246,293,45.64
Samira,Mordekaiser,1300,593,707,45.62
Samira,Jinx,2815,1344,1471,47.74
Samira,Nautilus,717,376,341,52.44
Samira,Jayce,360,159,201,44.17
Samira,Talon,451,245,206,54.32
Samira,Kennen,241,119,122,49.38
Samira,Lucian,562,283,279,50.36
Samira,Elise,515,250,265,48.54
Samira,Yasuo,1904,952,952,50
Samira,Kayn,1362,690,672,50.66
Samira,Mel,1717,805,912,46.88
Samira,Xayah,500,236,264,47.2
Samira,Rakan,298,138,160,46.31
Samira,XinZhao,522,281,241,53.83
Samira,Briar,627,299,328,47.69
Samira,AurelionSol,351,131,220,37.32
Samira,Ashe,1602,834,768,52.06
Samira,Darius,1640,809,831,49.33
Samira,Zac,423,191,232,45.15
Samira,Anivia,295,139,156,47.12
Samira,Blitzcrank,647,353,294,54.56
Samira,Olaf,171,81,90,47.37
Samira,Shaco,864,407,457,47.11
Samira,Lissandra,241,114,127,47.3
Samira,Leona,766,373,393,48.69
Samira,Udyr,312,142,170,45.51
Samira,Qiyana,226,110,116,48.67
Samira,Seraphine,669,357,312,53.36
Samira,Garen,1352,625,727,46.23
Samira,Nidalee,229,131,98,57.21
Samira,Graves,565,290,275,51.33
Samira,Vayne,1324,632,692,47.73
Samira,Lux,2430,1184,1246,48.72
Samira,RekSai,87,54,33,62.07
Samira,Ahri,1006,540,466,53.68
Samira,Malphite,823,413,410,50.18
Samira,Quinn,323,143,180,44.27
Samira,Evelynn,316,150,166,47.47
Samira,Jhin,1684,830,854,49.29
Samira,Brand,724,347,377,47.93
Samira,Yorick,859,352,507,40.98
Samira,Veigar,862,387,475,44.9
Samira,Smolder,517,268,249,51.84
Samira,Soraka,495,244,251,49.29
Samira,Jax,783,409,374,52.23
Samira,Vi,744,370,374,49.73
Samira,Thresh,1080,468,612,43.33
Samira,Diana,1384,670,714,48.41
Samira,Velkoz,561,246,315,43.85
Samira,Sett,1528,771,757,50.46
Samira,Irelia,724,377,347,52.07
Samira,Ezreal,1949,915,1034,46.95
Samira,Karma,898,430,468,47.88
Samira,Gangplank,362,178,184,49.17
Samira,Lillia,455,197,258,43.3
Samira,Naafiri,266,128,138,48.12
Samira,Caitlyn,2501,1263,1238,50.5
Samira,Rengar,287,168,119,58.54
Samira,Zyra,801,383,418,47.82
Samira,Sion,530,218,312,41.13
Samira,Viktor,693,325,368,46.9
Samira,Corki,377,168,209,44.56
Samira,TwistedFate,258,131,127,50.78
Samira,Ziggs,270,129,141,47.78
Samira,Janna,286,148,138,51.75
Samira,Katarina,681,341,340,50.07
Samira,Zilean,245,139,106,56.73
Samira,Illaoi,458,220,238,48.03
Samira,Hwei,518,236,282,45.56
Samira,Nami,789,386,403,48.92
Samira,Sylas,1245,684,561,54.94
Samira,Warwick,1438,635,803,44.16
Samira,Xerath,790,336,454,42.53
Samira,Shen,549,272,277,49.54
Samira,Vex,416,218,198,52.4
Samira,Urgot,470,222,248,47.23
Samira,Yone,1629,914,715,56.11
Samira,Aatrox,748,390,358,52.14
Samira,Morgana,1060,471,589,44.43
Samira,Kled,94,47,47,50
Samira,Zoe,290,162,128,55.86
Samira,Twitch,667,368,299,55.17
Samira,Lulu,1046,482,564,46.08
Samira,Kaisa,1422,685,737,48.17
Samira,Alistar,524,226,298,43.13
Samira,Swain,866,384,482,44.34
Samira,Pyke,710,372,338,52.39
Samira,Vladimir,522,268,254,51.34
Samira,Skarner,197,101,96,51.27
Samira,Aurora,544,236,308,43.38
Samira,MissFortune,2364,1124,1240,47.55
Samira,MasterYi,1147,530,617,46.21
Samira,Amumu,942,428,514,45.44
Samira,KogMaw,257,148,109,57.59
Samira,Leblanc,543,277,266,51.01
Samira,FiddleSticks,389,167,222,42.93
Samira,Milio,531,237,294,44.63
Samira,LeeSin,1138,588,550,51.67
Samira,Sona,268,120,148,44.78
Samira,Galio,686,347,339,50.58
Samira,Malzahar,904,404,500,44.69
Samira,Kayle,604,273,331,45.2
Samira,Ekko,905,460,445,50.83
Samira,Nasus,658,297,361,45.14
Samira,Syndra,469,239,230,50.96
Samira,Sejuani,340,182,158,53.53
Samira,Azir,267,154,113,57.68
Samira,Varus,719,350,369,48.68
Samira,Tryndamere,540,263,277,48.7
Samira,Senna,655,338,317,51.6
Samira,Akali,859,442,417,51.46
Samira,DrMundo,478,231,247,48.33
Samira,Rammus,305,132,173,43.28
Samira,Teemo,1257,616,641,49.01
Samira,Viego,1287,626,661,48.64
Samira,Renata,147,81,66,55.1
Samira,Ornn,311,144,167,46.3
Samira,Fiora,294,148,146,50.34
Samira,Kassadin,168,86,82,51.19
Samira,Ryze,282,139,143,49.29
Samira,Hecarim,350,165,185,47.14
Samira,Nocturne,1097,579,518,52.78
Samira,Sivir,420,227,193,54.05
Samira,Camille,272,158,114,58.09
Samira,Orianna,288,128,160,44.44
Samira,Gnar,302,155,147,51.32
Samira,Taric,197,76,121,38.58
Samira,Shyvana,229,92,137,40.17
Samira,TahmKench,655,383,272,58.47
Samira,Heimerdinger,486,232,254,47.74
Samira,MonkeyKing,593,258,335,43.51
Samira,Fizz,490,247,243,50.41
Samira,Poppy,528,220,308,41.67
Samira,Chogath,1048,479,569,45.71
Samira,Rell,380,183,197,48.16
Samira,Aphelios,376,197,179,52.39
Samira,Ambessa,436,234,202,53.67
Samira,Belveth,151,82,69,54.3
Samira,Maokai,457,247,210,54.05
Samira,Karthus,221,122,99,55.2
Samira,Nilah,424,168,256,39.62
Samira,Khazix,401,229,172,57.11
Samira,Akshan,301,165,136,54.82
Samira,Rumble,207,100,107,48.31
Samira,Cassiopeia,259,124,135,47.88
Samira,Bard,243,148,95,60.91
Samira,Taliyah,188,82,106,43.62
Samira,Braum,470,238,232,50.64
Samira,Riven,367,166,201,45.23
Samira,Zeri,347,199,148,57.35
Samira,Nunu,461,235,226,50.98
Samira,KSante,419,254,165,60.62
Samira,Gragas,516,272,244,52.71
Samira,Singed,217,93,124,42.86
Samira,JarvanIV,361,193,168,53.46
Samira,Neeko,423,183,240,43.26
Samira,Gwen,475,261,214,54.95
Samira,Kalista,186,100,86,53.76
Samira,Ivern,105,49,56,46.67
Samira,Draven,480,253,227,52.71
Samira,Annie,303,145,158,47.85
Samira,Kindred,367,190,177,51.77
Volibear,Gwen,739,397,342,53.72
Volibear,Skarner,344,188,156,54.65
Volibear,DrMundo,888,411,477,46.28
Volibear,Samira,990,480,510,48.48
Volibear,Malphite,1327,677,650,51.02
Volibear,Renekton,683,406,277,59.44
Volibear,Trundle,1086,473,613,43.55
Volibear,Mordekaiser,2432,1151,1281,47.33
Volibear,Jinx,4347,2113,2234,48.61
Volibear,Nautilus,1476,764,712,51.76
Volibear,LeeSin,1729,892,837,51.59
Volibear,Akali,1606,839,767,52.24
Volibear,KogMaw,522,248,274,47.51
Volibear,Thresh,1866,932,934,49.95
Volibear,Gangplank,645,319,326,49.46
Volibear,FiddleSticks,713,383,330,53.72
Volibear,Yone,2603,1400,1203,53.78
Volibear,Varus,1324,736,588,55.59
Volibear,Zilean,472,239,233,50.64
Volibear,Sett,2554,1316,1238,51.53
Volibear,Evelynn,539,268,271,49.72
Volibear,Vex,742,331,411,44.61
Volibear,MissFortune,3628,1760,1868,48.51
Volibear,Xerath,1285,699,586,54.4
Volibear,Teemo,1855,863,992,46.52
Volibear,Nocturne,1995,934,1061,46.82
Volibear,Hwei,896,431,465,48.1
Volibear,Twitch,1217,611,606,50.21
Volibear,Karma,1540,761,779,49.42
Volibear,Fiora,470,229,241,48.72
Volibear,Graves,813,398,415,48.95
Volibear,Azir,472,256,216,54.24
Volibear,Ashe,2925,1488,1437,50.87
Volibear,Braum,814,431,383,52.95
Volibear,Shaco,1321,726,595,54.96
Volibear,Yasuo,2861,1406,1455,49.14
Volibear,Caitlyn,4013,2025,1988,50.46
Volibear,Soraka,881,406,475,46.08
Volibear,Chogath,1811,871,940,48.09
Volibear,Anivia,459,203,256,44.23
Volibear,Tristana,1483,807,676,54.42
Volibear,Zyra,1238,580,658,46.85
Volibear,Briar,1089,534,555,49.04
Volibear,Diana,2292,1149,1143,50.13
Volibear,Veigar,1558,748,810,48.01
Volibear,Brand,1237,594,643,48.02
Volibear,Tryndamere,978,520,458,53.17
Volibear,Poppy,809,401,408,49.57
Volibear,Kassadin,287,169,118,58.89
Volibear,Illaoi,855,448,407,52.4
Volibear,Katarina,1124,582,542,51.78
Volibear,Jhin,2902,1423,1479,49.04
Volibear,Seraphine,1229,640,589,52.07
Volibear,Olaf,333,170,163,51.05
Volibear,Sylas,1844,944,900,51.19
Volibear,Kennen,326,174,152,53.37
Volibear,Nasus,1189,588,601,49.45
Volibear,Lillia,764,383,381,50.13
Volibear,Irelia,1190,622,568,52.27
Volibear,Galio,1191,580,611,48.7
Volibear,Urgot,935,430,505,45.99
Volibear,Rammus,419,206,213,49.16
Volibear,Lulu,1690,871,819,51.54
Volibear,Udyr,642,297,345,46.26
Volibear,Nilah,479,221,258,46.14
Volibear,Taric,348,159,189,45.69
Volibear,Darius,3238,1597,1641,49.32
Volibear,Sejuani,583,325,258,55.75
Volibear,Vayne,1906,897,1009,47.06
Volibear,Lux,3690,1822,1868,49.38
Volibear,KSante,609,339,270,55.67
Volibear,MasterYi,1918,921,997,48.02
Volibear,Naafiri,519,275,244,52.99
Volibear,Swain,1503,716,787,47.64
Volibear,Amumu,1749,893,856,51.06
Volibear,Taliyah,341,147,194,43.11
Volibear,Xayah,630,311,319,49.37
Volibear,Nidalee,309,186,123,60.19
Volibear,Renata,230,125,105,54.35
Volibear,Jax,1375,699,676,50.84
Volibear,Mel,2867,1416,1451,49.39
Volibear,Yorick,1458,677,781,46.43
Volibear,Elise,767,381,386,49.67
Volibear,Smolder,816,413,403,50.61
Volibear,Viego,2069,997,1072,48.19
Volibear,AurelionSol,616,304,312,49.35
Volibear,Kaisa,2265,1154,1111,50.95
Volibear,Singed,377,184,193,48.81
Volibear,MonkeyKing,1121,596,525,53.17
Volibear,Orianna,589,295,294,50.08
Volibear,Draven,815,410,405,50.31
Volibear,Kled,280,141,139,50.36
Volibear,Ekko,1337,656,681,49.07
Volibear,Aphelios,741,358,383,48.31
Volibear,Vladimir,908,476,432,52.42
Volibear,Jayce,569,295,274,51.85
Volibear,Heimerdinger,649,310,339,47.77
Volibear,Nami,1433,625,808,43.61
Volibear,Gnar,575,268,307,46.61
Volibear,Senna,960,503,457,52.4
Volibear,Kayle,1040,513,527,49.33
Volibear,Rengar,462,211,251,45.67
Volibear,Malzahar,1486,698,788,46.97
Volibear,Aatrox,1196,638,558,53.34
Volibear,Blitzcrank,1029,534,495,51.9
Volibear,Morgana,1793,826,967,46.07
Volibear,Pantheon,2254,1101,1153,48.85
Volibear,Neeko,643,345,298,53.65
Volibear,Belveth,278,141,137,50.72
Volibear,Talon,713,367,346,51.47
Volibear,Ornn,519,259,260,49.9
Volibear,JarvanIV,906,447,459,49.34
Volibear,Kayn,2340,1135,1205,48.5
Volibear,Ezreal,2898,1501,1397,51.79
Volibear,Leblanc,822,448,374,54.5
Volibear,Milio,830,372,458,44.82
Volibear,Garen,2463,1202,1261,48.8
Volibear,Lissandra,443,210,233,47.4
Volibear,TahmKench,1138,599,539,52.64
Volibear,Zed,1633,792,841,48.5
Volibear,Warwick,2619,1176,1443,44.9
Volibear,Rell,658,312,346,47.42
Volibear,Fizz,860,477,383,55.47
Volibear,XinZhao,954,483,471,50.63
Volibear,Cassiopeia,375,156,219,41.6
Volibear,Vi,1396,732,664,52.44
Volibear,Lucian,940,507,433,53.94
Volibear,Syndra,814,409,405,50.25
Volibear,Corki,500,265,235,53
Volibear,Qiyana,349,173,176,49.57
Volibear,Viktor,1174,558,616,47.53
Volibear,Bard,437,210,227,48.05
Volibear,TwistedFate,481,227,254,47.19
Volibear,Rakan,466,211,255,45.28
Volibear,Zoe,441,236,205,53.51
Volibear,Hecarim,516,290,226,56.2
Volibear,Rumble,295,144,151,48.81
Volibear,Sion,1059,534,525,50.42
Volibear,Sivir,664,355,309,53.46
Volibear,Velkoz,916,444,472,48.47
Volibear,Ziggs,552,276,276,50
Volibear,Maokai,716,340,376,47.49
Volibear,Annie,432,203,229,46.99
Volibear,Zeri,525,283,242,53.9
Volibear,Leona,1198,580,618,48.41
Volibear,Gragas,733,367,366,50.07
Volibear,Zac,685,370,315,54.01
Volibear,Ahri,1798,915,883,50.89
Volibear,Kalista,314,172,142,54.78
Volibear,Ambessa,756,399,357,52.78
Volibear,Aurora,914,423,491,46.28
Volibear,Shyvana,434,196,238,45.16
Volibear,Riven,635,364,271,57.32
Volibear,Kindred,599,268,331,44.74
Volibear,Ryze,490,272,218,55.51
Volibear,Camille,485,262,223,54.02
Volibear,Shen,868,448,420,51.61
Volibear,Yuumi,1112,596,516,53.6
Volibear,Pyke,1225,670,555,54.69
Volibear,Janna,455,231,224,50.77
Volibear,Karthus,395,172,223,43.54
Volibear,Akshan,500,235,265,47
Volibear,Alistar,557,267,290,47.94
Volibear,Quinn,517,248,269,47.97
Volibear,Nunu,756,382,374,50.53
Volibear,Khazix,669,386,283,57.7
Volibear,RekSai,187,96,91,51.34
Volibear,Ivern,247,115,132,46.56
Volibear,Sona,480,198,282,41.25
Briar,Darius,1840,977,863,53.1
Briar,Amumu,1006,459,547,45.63
Briar,Aurora,551,330,221,59.89
Briar,Lux,2421,1322,1099,54.61
Briar,Seraphine,746,395,351,52.95
Briar,DrMundo,513,248,265,48.34
Briar,Rengar,285,163,122,57.19
Briar,Zilean,316,163,153,51.58
Briar,Ashe,1775,946,829,53.3
Briar,Thresh,1109,532,577,47.97
Briar,Sett,1258,642,616,51.03
Briar,Lillia,508,275,233,54.13
Briar,Leblanc,556,320,236,57.55
Briar,Jinx,2832,1434,1398,50.64
Briar,Alistar,340,204,136,60
Briar,Urgot,502,291,211,57.97
Briar,MasterYi,1261,638,623,50.59
Briar,Galio,712,364,348,51.12
Briar,Varus,725,401,324,55.31
Briar,Morgana,1139,584,555,51.27
Briar,Kennen,222,135,87,60.81
Briar,Caitlyn,2458,1288,1170,52.4
Briar,Zyra,847,456,391,53.84
Briar,Illaoi,432,229,203,53.01
Briar,Anivia,257,135,122,52.53
Briar,Yorick,1019,534,485,52.4
Briar,Volibear,1089,555,534,50.96
Briar,LeeSin,1141,613,528,53.72
Briar,Teemo,1173,552,621,47.06
Briar,Vladimir,512,256,256,50
Briar,Xerath,754,423,331,56.1
Briar,Yone,1748,1005,743,57.49
Briar,Samira,627,328,299,52.31
Briar,Yasuo,1841,1005,836,54.59
Briar,Jhin,1939,1035,904,53.38
Briar,Quinn,301,129,172,42.86
Briar,Zac,422,199,223,47.16
Briar,Ezreal,1936,1044,892,53.93
Briar,Brand,718,358,360,49.86
Briar,Aatrox,761,413,348,54.27
Briar,Evelynn,309,136,173,44.01
Briar,Katarina,748,402,346,53.74
Briar,Kaisa,1275,709,566,55.61
Briar,Leona,786,433,353,55.09
Briar,Corki,279,140,139,50.18
Briar,Milio,454,219,235,48.24
Briar,Garen,1444,732,712,50.69
Briar,Nunu,537,309,228,57.54
Briar,Irelia,796,412,384,51.76
Briar,Kayn,1383,736,647,53.22
Briar,Shaco,883,469,414,53.11
Briar,Chogath,1103,550,553,49.86
Briar,Sylas,1075,612,463,56.93
Briar,Mel,1925,1090,835,56.62
Briar,MissFortune,2300,1239,1061,53.87
Briar,Nocturne,1278,634,644,49.61
Briar,Ahri,1220,631,589,51.72
Briar,KogMaw,329,199,130,60.49
Briar,Braum,423,203,220,47.99
Briar,TahmKench,702,362,340,51.57
Briar,Akali,950,458,492,48.21
Briar,Singed,214,124,90,57.94
Briar,Neeko,373,185,188,49.6
Briar,Renekton,406,212,194,52.22
Briar,Karthus,281,173,108,61.57
Briar,Fizz,519,255,264,49.13
Briar,Swain,878,461,417,52.51
Briar,Nami,741,365,376,49.26
Briar,Vex,520,312,208,60
Briar,Sejuani,304,181,123,59.54
Briar,Zed,1012,520,492,51.38
Briar,Gnar,308,177,131,57.47
Briar,Khazix,434,254,180,58.53
Briar,Malzahar,984,454,530,46.14
Briar,Poppy,477,250,227,52.41
Briar,Kindred,380,239,141,62.89
Briar,Vi,887,495,392,55.81
Briar,Mordekaiser,1294,698,596,53.94
Briar,Kled,191,86,105,45.03
Briar,Viego,1210,601,609,49.67
Briar,JarvanIV,534,296,238,55.43
Briar,Jax,821,411,410,50.06
Briar,Vayne,1092,541,551,49.54
Briar,Pantheon,1416,736,680,51.98
Briar,Kayle,620,338,282,54.52
Briar,FiddleSticks,415,255,160,61.45
Briar,TwistedFate,306,169,137,55.23
Briar,Graves,522,285,237,54.6
Briar,Tristana,941,473,468,50.27
Briar,Ornn,357,195,162,54.62
Briar,Blitzcrank,653,420,233,64.32
Briar,Rammus,377,175,202,46.42
Briar,Azir,289,162,127,56.06
Briar,Ekko,898,485,413,54.01
Briar,Veigar,938,497,441,52.99
Briar,Kalista,189,113,76,59.79
Briar,Rell,382,195,187,51.05
Briar,Syndra,514,249,265,48.44
Briar,Lucian,541,311,230,57.49
Briar,Jayce,330,195,135,59.09
Briar,Lulu,1170,584,586,49.91
Briar,Diana,1560,835,725,53.53
Briar,Lissandra,293,157,136,53.58
Briar,Draven,492,260,232,52.85
Briar,Warwick,1538,791,747,51.43
Briar,Hwei,560,280,280,50
Briar,Gwen,430,237,193,55.12
Briar,Olaf,196,96,100,48.98
Briar,RekSai,103,60,43,58.25
Briar,Udyr,328,156,172,47.56
Briar,Smolder,551,328,223,59.53
Briar,Bard,226,99,127,43.81
Briar,Ambessa,500,271,229,54.2
Briar,Talon,432,254,178,58.8
Briar,Soraka,579,276,303,47.67
Briar,AurelionSol,370,208,162,56.22
Briar,Renata,131,56,75,42.75
Briar,Taliyah,224,105,119,46.88
Briar,Janna,306,157,149,51.31
Briar,KSante,444,241,203,54.28
Briar,Ryze,355,201,154,56.62
Briar,Nasus,732,353,379,48.22
Briar,Riven,404,211,193,52.23
Briar,Karma,1088,607,481,55.79
Briar,Twitch,725,335,390,46.21
Briar,Pyke,700,365,335,52.14
Briar,Annie,279,126,153,45.16
Briar,Gragas,491,221,270,45.01
Briar,Kassadin,168,90,78,53.57
Briar,Trundle,595,316,279,53.11
Briar,Tryndamere,491,260,231,52.95
Briar,Orianna,348,181,167,52.01
Briar,Taric,184,95,89,51.63
Briar,Xayah,383,199,184,51.96
Briar,Rakan,361,187,174,51.8
Briar,Ziggs,327,187,140,57.19
Briar,Belveth,192,90,102,46.88
Briar,Viktor,723,354,369,48.96
Briar,Nautilus,925,499,426,53.95
Briar,Heimerdinger,411,222,189,54.01
Briar,Cassiopeia,217,115,102,53
Briar,Akshan,317,150,167,47.32
Briar,Yuumi,764,402,362,52.62
Briar,Sion,670,356,314,53.13
Briar,Shen,529,277,252,52.36
Briar,Sivir,500,277,223,55.4
Briar,Ivern,103,58,45,56.31
Briar,Malphite,946,531,415,56.13
Briar,Gangplank,446,184,262,41.26
Briar,Zoe,265,119,146,44.91
Briar,Velkoz,575,288,287,50.09
Briar,Hecarim,339,216,123,63.72
Briar,Nidalee,203,113,90,55.67
Briar,Maokai,394,221,173,56.09
Briar,Sona,259,146,113,56.37
Briar,Aphelios,461,257,204,55.75
Briar,Skarner,167,87,80,52.1
Briar,MonkeyKing,587,281,306,47.87
Briar,Senna,671,378,293,56.33
Briar,Camille,328,184,144,56.1
Briar,Zeri,340,180,160,52.94
Briar,Fiora,330,160,170,48.48
Briar,Naafiri,315,156,159,49.52
Briar,Elise,570,288,282,50.53
Briar,XinZhao,593,345,248,58.18
Briar,Qiyana,179,96,83,53.63
Briar,Rumble,221,124,97,56.11
Briar,Nilah,285,149,136,52.28
Briar,Shyvana,197,109,88,55.33
Rengar,Warwick,584,257,327,44.01
Rengar,Briar,285,122,163,42.81
Rengar,Zed,460,236,224,51.3
Rengar,Ziggs,117,48,69,41.03
Rengar,Xerath,291,136,155,46.74
Rengar,Sion,298,121,177,40.6
Rengar,Vi,351,149,202,42.45
Rengar,Sylas,447,230,217,51.45
Rengar,Lucian,302,137,165,45.36
Rengar,Pantheon,676,290,386,42.9
Rengar,Renekton,201,89,112,44.28
Rengar,XinZhao,195,91,104,46.67
Rengar,Yasuo,843,359,484,42.59
Rengar,Kalista,121,56,65,46.28
Rengar,Khazix,369,168,201,45.53
Rengar,Lissandra,157,75,82,47.77
Rengar,Rell,186,101,85,54.3
Rengar,Shen,287,141,146,49.13
Rengar,Amumu,368,194,174,52.72
Rengar,Orianna,186,112,74,60.22
Rengar,Caitlyn,995,450,545,45.23
Rengar,Sona,139,56,83,40.29
Rengar,Yone,731,409,322,55.95
Rengar,Nunu,188,92,96,48.94
Rengar,Qiyana,115,56,59,48.7
Rengar,Jinx,1196,590,606,49.33
Rengar,Morgana,423,195,228,46.1
Rengar,Gangplank,266,155,111,58.27
Rengar,Twitch,358,199,159,55.59
Rengar,Lux,989,443,546,44.79
Rengar,Ambessa,212,111,101,52.36
Rengar,Evelynn,146,53,93,36.3
Rengar,Xayah,266,126,140,47.37
Rengar,Velkoz,266,115,151,43.23
Rengar,Darius,722,331,391,45.84
Rengar,Sejuani,149,77,72,51.68
Rengar,Azir,144,67,77,46.53
Rengar,Vayne,568,232,336,40.85
Rengar,Chogath,442,228,214,51.58
Rengar,Ekko,450,236,214,52.44
Rengar,Varus,405,186,219,45.93
Rengar,Vladimir,286,120,166,41.96
Rengar,TwistedFate,123,43,80,34.96
Rengar,Trundle,184,75,109,40.76
Rengar,Illaoi,153,64,89,41.83
Rengar,Mel,889,428,461,48.14
Rengar,Nami,564,230,334,40.78
Rengar,Syndra,273,133,140,48.72
Rengar,Jhin,868,372,496,42.86
Rengar,Zyra,300,143,157,47.67
Rengar,Irelia,387,147,240,37.98
Rengar,Elise,404,196,208,48.51
Rengar,Katarina,310,129,181,41.61
Rengar,Samira,287,119,168,41.46
Rengar,Karma,538,202,336,37.55
Rengar,Jayce,166,92,74,55.42
Rengar,Yorick,382,154,228,40.31
Rengar,Hwei,268,112,156,41.79
Rengar,Soraka,210,105,105,50
Rengar,Udyr,118,72,46,61.02
Rengar,Volibear,462,251,211,54.33
Rengar,Akshan,156,78,78,50
Rengar,LeeSin,558,306,252,54.84
Rengar,Neeko,162,70,92,43.21
Rengar,Ezreal,950,464,486,48.84
Rengar,Urgot,260,99,161,38.08
Rengar,Diana,611,271,340,44.35
Rengar,Seraphine,268,135,133,50.37
Rengar,Olaf,100,35,65,35
Rengar,Kayn,620,292,328,47.1
Rengar,Cassiopeia,90,46,44,51.11
Rengar,Draven,202,111,91,54.95
Rengar,Teemo,484,217,267,44.83
Rengar,Kaisa,686,317,369,46.21
Rengar,JarvanIV,267,110,157,41.2
Rengar,KSante,259,113,146,43.63
Rengar,Fizz,271,129,142,47.6
Rengar,Thresh,507,230,277,45.36
Rengar,Nocturne,550,253,297,46
Rengar,Braum,246,92,154,37.4
Rengar,Ryze,125,64,61,51.2
Rengar,Galio,332,135,197,40.66
Rengar,Yuumi,360,165,195,45.83
Rengar,Swain,339,153,186,45.13
Rengar,Lulu,628,312,316,49.68
Rengar,Aurora,276,142,134,51.45
Rengar,Viego,551,269,282,48.82
Rengar,Annie,127,54,73,42.52
Rengar,Sivir,164,75,89,45.73
Rengar,Renata,81,30,51,37.04
Rengar,Quinn,154,62,92,40.26
Rengar,Hecarim,239,96,143,40.17
Rengar,Ahri,500,246,254,49.2
Rengar,Milio,308,154,154,50
Rengar,MissFortune,842,383,459,45.49
Rengar,Leona,309,156,153,50.49
Rengar,Aatrox,324,129,195,39.81
Rengar,Tryndamere,254,128,126,50.39
Rengar,Mordekaiser,531,220,311,41.43
Rengar,Anivia,125,47,78,37.6
Rengar,Shyvana,82,31,51,37.8
Rengar,Alistar,177,76,101,42.94
Rengar,Heimerdinger,173,87,86,50.29
Rengar,Veigar,386,198,188,51.3
Rengar,Gragas,237,112,125,47.26
Rengar,Tristana,373,161,212,43.16
Rengar,Sett,521,208,313,39.92
Rengar,Jax,338,148,190,43.79
Rengar,MasterYi,523,203,320,38.81
Rengar,Senna,252,138,114,54.76
Rengar,Ashe,711,332,379,46.69
Rengar,Gnar,181,72,109,39.78
Rengar,Corki,214,100,114,46.73
Rengar,Nasus,270,109,161,40.37
Rengar,Garen,630,331,299,52.54
Rengar,Camille,158,80,78,50.63
Rengar,Zeri,188,94,94,50
Rengar,Ornn,198,94,104,47.47
Rengar,Taliyah,120,62,58,51.67
Rengar,Nautilus,397,203,194,51.13
Rengar,Shaco,407,195,212,47.91
Rengar,Gwen,242,119,123,49.17
Rengar,Akali,393,177,216,45.04
Rengar,Ivern,77,30,47,38.96
Rengar,Pyke,371,183,188,49.33
Rengar,Malphite,418,190,228,45.45
Rengar,Viktor,341,168,173,49.27
Rengar,DrMundo,211,98,113,46.45
Rengar,FiddleSticks,181,77,104,42.54
Rengar,Vex,237,103,134,43.46
Rengar,Fiora,124,50,74,40.32
Rengar,Kassadin,96,50,46,52.08
Rengar,Rammus,112,41,71,36.61
Rengar,Leblanc,285,152,133,53.33
Rengar,Janna,140,77,63,55
Rengar,Naafiri,117,50,67,42.74
Rengar,Belveth,101,53,48,52.48
Rengar,AurelionSol,101,58,43,57.43
Rengar,Brand,324,144,180,44.44
Rengar,Zac,197,96,101,48.73
Rengar,Rakan,171,63,108,36.84
Rengar,Rumble,108,56,52,51.85
Rengar,Talon,214,116,98,54.21
Rengar,Singed,100,51,49,51
Rengar,Malzahar,430,184,246,42.79
Rengar,Blitzcrank,246,108,138,43.9
Rengar,Zilean,148,59,89,39.86
Rengar,Kennen,101,50,51,49.5
Rengar,KogMaw,90,36,54,40
Rengar,Taric,69,38,31,55.07
Rengar,MonkeyKing,264,103,161,39.02
Rengar,Kled,88,34,54,38.64
Rengar,Kindred,178,59,119,33.15
Rengar,Nidalee,130,61,69,46.92
Rengar,Kayle,298,144,154,48.32
Rengar,TahmKench,279,139,140,49.82
Rengar,Riven,166,71,95,42.77
Rengar,Karthus,153,56,97,36.6
Rengar,Skarner,110,53,57,48.18
Rengar,Aphelios,187,89,98,47.59
Rengar,Poppy,270,131,139,48.52
Rengar,Graves,283,113,170,39.93
Rengar,Zoe,170,96,74,56.47
Rengar,Smolder,190,94,96,49.47
Rengar,Bard,108,60,48,55.56
Rengar,Nilah,162,62,100,38.27
Rengar,Lillia,192,75,117,39.06
Rengar,Maokai,165,69,96,41.82
Rengar,RekSai,34,6,28,17.65
Ziggs,DrMundo,245,134,111,54.69
Ziggs,Rengar,117,69,48,58.97
Ziggs,Zilean,148,70,78,47.3
Ziggs,Ashe,1010,466,544,46.14
Ziggs,Thresh,558,312,246,55.91
Ziggs,Gnar,180,83,97,46.11
Ziggs,Diana,776,438,338,56.44
Ziggs,Chogath,561,289,272,51.52
Ziggs,Jinx,1387,670,717,48.31
Ziggs,Nami,416,220,196,52.88
Ziggs,Urgot,234,127,107,54.27
Ziggs,Vi,356,187,169,52.53
Ziggs,Ekko,450,237,213,52.67
Ziggs,Caitlyn,1552,781,771,50.32
Ziggs,Bard,109,48,61,44.04
Ziggs,Jax,441,240,201,54.42
Ziggs,Shaco,473,224,249,47.36
Ziggs,Yone,784,411,373,52.42
Ziggs,KogMaw,150,67,83,44.67
Ziggs,Morgana,693,326,367,47.04
Ziggs,Heimerdinger,213,98,115,46.01
Ziggs,Kindred,200,90,110,45
Ziggs,Mel,1017,599,418,58.9
Ziggs,Jhin,933,459,474,49.2
Ziggs,Ornn,226,119,107,52.65
Ziggs,Olaf,105,45,60,42.86
Ziggs,Lissandra,159,82,77,51.57
Ziggs,TahmKench,342,171,171,50
Ziggs,Malphite,526,287,239,54.56
Ziggs,Pantheon,720,338,382,46.94
Ziggs,Lulu,610,320,290,52.46
Ziggs,Nasus,340,171,169,50.29
Ziggs,Warwick,724,321,403,44.34
Ziggs,Akali,553,251,302,45.39
Ziggs,Corki,157,87,70,55.41
Ziggs,Lux,1358,692,666,50.96
Ziggs,Poppy,255,116,139,45.49
Ziggs,Viego,662,345,317,52.11
Ziggs,Pyke,335,161,174,48.06
Ziggs,Kayn,676,298,378,44.08
Ziggs,Zed,528,242,286,45.83
Ziggs,Soraka,279,128,151,45.88
Ziggs,Mordekaiser,628,272,356,43.31
Ziggs,MissFortune,1184,652,532,55.07
Ziggs,Teemo,706,326,380,46.18
Ziggs,Amumu,442,225,217,50.9
Ziggs,Hwei,332,149,183,44.88
Ziggs,Ezreal,1097,520,577,47.4
Ziggs,Brand,340,172,168,50.59
Ziggs,Nocturne,651,305,346,46.85
Ziggs,Aurora,300,159,141,53
Ziggs,Vayne,555,265,290,47.75
Ziggs,Karma,592,298,294,50.34
Ziggs,Yorick,426,202,224,47.42
Ziggs,Sejuani,191,93,98,48.69
Ziggs,Samira,270,141,129,52.22
Ziggs,Rell,215,115,100,53.49
Ziggs,Kayle,262,127,135,48.47
Ziggs,Darius,874,451,423,51.6
Ziggs,Ahri,556,277,279,49.82
Ziggs,MasterYi,627,329,298,52.47
Ziggs,Naafiri,139,75,64,53.96
Ziggs,Nautilus,564,268,296,47.52
Ziggs,Aatrox,478,238,240,49.79
Ziggs,Garen,754,335,419,44.43
Ziggs,AurelionSol,197,98,99,49.75
Ziggs,Seraphine,364,165,199,45.33
Ziggs,Shen,235,103,132,43.83
Ziggs,Vex,216,111,105,51.39
Ziggs,Sett,687,342,345,49.78
Ziggs,Talon,243,129,114,53.09
Ziggs,Katarina,347,189,158,54.47
Ziggs,Swain,449,220,229,49
Ziggs,Renekton,218,114,104,52.29
Ziggs,Fizz,306,154,152,50.33
Ziggs,Gwen,244,98,146,40.16
Ziggs,Galio,478,198,280,41.42
Ziggs,Graves,320,180,140,56.25
Ziggs,Blitzcrank,366,180,186,49.18
Ziggs,Leblanc,235,103,132,43.83
Ziggs,Zyra,447,220,227,49.22
Ziggs,Quinn,160,92,68,57.5
Ziggs,Nilah,142,78,64,54.93
Ziggs,Viktor,393,208,185,52.93
Ziggs,MonkeyKing,320,159,161,49.69
Ziggs,Alistar,172,88,84,51.16
Ziggs,LeeSin,550,274,276,49.82
Ziggs,Vladimir,263,115,148,43.73
Ziggs,Kaisa,753,385,368,51.13
Ziggs,Yasuo,805,407,398,50.56
Ziggs,Rammus,129,66,63,51.16
Ziggs,Malzahar,540,252,288,46.67
Ziggs,Twitch,344,145,199,42.15
Ziggs,Orianna,182,105,77,57.69
Ziggs,Gragas,261,134,127,51.34
Ziggs,XinZhao,311,156,155,50.16
Ziggs,Irelia,335,177,158,52.84
Ziggs,Evelynn,154,95,59,61.69
Ziggs,Zeri,186,98,88,52.69
Ziggs,Illaoi,194,88,106,45.36
Ziggs,Zac,215,117,98,54.42
Ziggs,Milio,236,103,133,43.64
Ziggs,Khazix,236,119,117,50.42
Ziggs,Gangplank,230,123,107,53.48
Ziggs,Lucian,303,129,174,42.57
Ziggs,Sona,159,68,91,42.77
Ziggs,Volibear,552,276,276,50
Ziggs,Sylas,546,269,277,49.27
Ziggs,Trundle,296,155,141,52.36
Ziggs,JarvanIV,257,119,138,46.3
Ziggs,Singed,133,60,73,45.11
Ziggs,Belveth,110,57,53,51.82
Ziggs,Leona,342,147,195,42.98
Ziggs,Senna,347,186,161,53.6
Ziggs,Udyr,187,76,111,40.64
Ziggs,Velkoz,305,174,131,57.05
Ziggs,Draven,243,139,104,57.2
Ziggs,Elise,235,130,105,55.32
Ziggs,Rumble,127,78,49,61.42
Ziggs,Sion,339,178,161,52.51
Ziggs,Tryndamere,239,117,122,48.95
Ziggs,Skarner,113,60,53,53.1
Ziggs,Varus,414,243,171,58.7
Ziggs,FiddleSticks,204,108,96,52.94
Ziggs,Riven,211,101,110,47.87
Ziggs,Briar,327,140,187,42.81
Ziggs,TwistedFate,171,84,87,49.12
Ziggs,Maokai,189,95,94,50.26
Ziggs,Yuumi,275,135,140,49.09
Ziggs,Lillia,228,122,106,53.51
Ziggs,Cassiopeia,120,57,63,47.5
Ziggs,KSante,238,112,126,47.06
Ziggs,Kassadin,104,60,44,57.69
Ziggs,Fiora,183,93,90,50.82
Ziggs,Veigar,474,238,236,50.21
Ziggs,Ambessa,265,168,97,63.4
Ziggs,Aphelios,191,111,80,58.12
Ziggs,Kalista,114,55,59,48.25
Ziggs,Renata,78,48,30,61.54
Ziggs,Zoe,203,94,109,46.31
Ziggs,Nunu,292,139,153,47.6
Ziggs,Anivia,171,87,84,50.88
Ziggs,Tristana,495,237,258,47.88
Ziggs,Jayce,200,101,99,50.5
Ziggs,Annie,136,73,63,53.68
Ziggs,Braum,200,108,92,54
Ziggs,Xayah,177,99,78,55.93
Ziggs,Rakan,198,91,107,45.96
Ziggs,Camille,175,94,81,53.71
Ziggs,Neeko,143,79,64,55.24
Ziggs,Taric,83,30,53,36.14
Ziggs,Ryze,165,65,100,39.39
Ziggs,Janna,151,76,75,50.33
Ziggs,Hecarim,181,90,91,49.72
Ziggs,Smolder,282,157,125,55.67
Ziggs,Azir,117,77,40,65.81
Ziggs,Taliyah,125,56,69,44.8
Ziggs,Akshan,147,72,75,48.98
Ziggs,Xerath,433,250,183,57.74
Ziggs,Sivir,225,113,112,50.22
Ziggs,Kled,77,54,23,70.13
Ziggs,Ivern,59,22,37,37.29
Ziggs,Qiyana,99,41,58,41.41
Ziggs,Kennen,125,61,64,48.8
Ziggs,Karthus,123,60,63,48.78
Ziggs,Shyvana,107,51,56,47.66
Ziggs,Nidalee,140,75,65,53.57
Ziggs,Syndra,234,112,122,47.86
Ziggs,RekSai,44,27,17,61.36
Xerath,DrMundo,621,287,334,46.22
Xerath,Rengar,291,153,138,52.58
Xerath,Zilean,381,194,187,50.92
Xerath,Ashe,2534,1290,1244,50.91
Xerath,Thresh,1571,780,791,49.65
Xerath,Gnar,525,252,273,48
Xerath,Volibear,1285,586,699,45.6
Xerath,Fizz,741,376,365,50.74
Xerath,Aphelios,562,292,270,51.96
Xerath,Zyra,1380,721,659,52.25
Xerath,Darius,2079,1067,1012,51.32
Xerath,Diana,1898,945,953,49.79
Xerath,Vladimir,667,365,302,54.72
Xerath,Jinx,3230,1653,1577,51.18
Xerath,Morgana,1502,734,768,48.87
Xerath,Yorick,1062,513,549,48.31
Xerath,Kindred,451,261,190,57.87
Xerath,Veigar,1201,594,607,49.46
Xerath,Tristana,1126,600,526,53.29
Xerath,Nautilus,1430,729,701,50.98
Xerath,Ekko,1077,498,579,46.24
Xerath,Katarina,807,421,386,52.17
Xerath,Kaisa,1990,988,1002,49.65
Xerath,Lulu,1581,856,725,54.14
Xerath,Illaoi,530,271,259,51.13
Xerath,Briar,754,331,423,43.9
Xerath,Jhin,2582,1272,1310,49.26
Xerath,Seraphine,788,422,366,53.55
Xerath,Sett,1771,840,931,47.43
Xerath,Aurora,819,415,404,50.67
Xerath,Bard,357,157,200,43.98
Xerath,Lissandra,418,263,155,62.92
Xerath,Lucian,804,413,391,51.37
Xerath,Nami,1112,559,553,50.27
Xerath,Warwick,1607,803,804,49.97
Xerath,Udyr,406,205,201,50.49
Xerath,Milio,652,341,311,52.3
Xerath,Camille,450,234,216,52
Xerath,Kayn,1688,882,806,52.25
Xerath,Yasuo,2246,1077,1169,47.95
Xerath,Caitlyn,3426,1745,1681,50.93
Xerath,Lux,3739,1878,1861,50.23
Xerath,Urgot,588,289,299,49.15
Xerath,Jax,1120,575,545,51.34
Xerath,Mel,2974,1617,1357,54.37
Xerath,KogMaw,323,159,164,49.23
Xerath,Karma,1811,890,921,49.14
Xerath,Gwen,515,235,280,45.63
Xerath,Rammus,315,185,130,58.73
Xerath,Riven,515,268,247,52.04
Xerath,Ahri,1544,805,739,52.14
Xerath,Teemo,1432,733,699,51.19
Xerath,Hwei,976,494,482,50.61
Xerath,Kalista,267,154,113,57.68
Xerath,Blitzcrank,1018,550,468,54.03
Xerath,Ornn,479,205,274,42.8
Xerath,LeeSin,2235,1144,1091,51.19
Xerath,Velkoz,840,430,410,51.19
Xerath,Corki,419,223,196,53.22
Xerath,Malphite,1320,677,643,51.29
Xerath,MasterYi,1362,652,710,47.87
Xerath,Leblanc,879,426,453,48.46
Xerath,Samira,790,454,336,57.47
Xerath,Gragas,634,333,301,52.52
Xerath,TahmKench,767,379,388,49.41
Xerath,Irelia,978,504,474,51.53
Xerath,Shaco,1040,506,534,48.65
Xerath,Sion,759,382,377,50.33
Xerath,Draven,607,294,313,48.43
Xerath,Viktor,1212,613,599,50.58
Xerath,KSante,765,446,319,58.3
Xerath,Evelynn,370,169,201,45.68
Xerath,Galio,1112,593,519,53.33
Xerath,Zed,1265,604,661,47.75
Xerath,Sivir,660,314,346,47.58
Xerath,Zoe,466,240,226,51.5
Xerath,Ezreal,3531,1835,1696,51.97
Xerath,Maokai,524,277,247,52.86
Xerath,Janna,363,159,204,43.8
Xerath,Ambessa,758,430,328,56.73
Xerath,Vi,1289,661,628,51.28
Xerath,Pyke,946,447,499,47.25
Xerath,Swain,1126,550,576,48.85
Xerath,Trundle,729,380,349,52.13
Xerath,Azir,471,247,224,52.44
Xerath,Chogath,1330,640,690,48.12
Xerath,Akshan,357,186,171,52.1
Xerath,Khazix,650,353,297,54.31
Xerath,Viego,1796,941,855,52.39
Xerath,MissFortune,2661,1366,1295,51.33
Xerath,Gangplank,623,308,315,49.44
Xerath,Nocturne,1621,712,909,43.92
Xerath,Taliyah,274,167,107,60.95
Xerath,Senna,778,401,377,51.54
Xerath,Yone,2176,1160,1016,53.31
Xerath,Orianna,565,302,263,53.45
Xerath,Alistar,454,221,233,48.68
Xerath,Aatrox,1231,617,614,50.12
Xerath,Hecarim,519,267,252,51.45
Xerath,Leona,997,471,526,47.24
Xerath,Renekton,607,290,317,47.78
Xerath,Singed,350,151,199,43.14
Xerath,Xayah,507,233,274,45.96
Xerath,Quinn,448,221,227,49.33
Xerath,Qiyana,242,146,96,60.33
Xerath,AurelionSol,427,220,207,51.52
Xerath,Vayne,1436,704,732,49.03
Xerath,Sylas,1738,891,847,51.27
Xerath,FiddleSticks,616,303,313,49.19
Xerath,Syndra,840,462,378,55
Xerath,Poppy,627,323,304,51.52
Xerath,Malzahar,1326,659,667,49.7
Xerath,Pantheon,1819,971,848,53.38
Xerath,Karthus,379,207,172,54.62
Xerath,Ryze,422,190,232,45.02
Xerath,Sejuani,423,236,187,55.79
Xerath,TwistedFate,443,243,200,54.85
Xerath,Nunu,599,307,292,51.25
Xerath,Braum,513,248,265,48.34
Xerath,Amumu,1180,583,597,49.41
Xerath,Shen,636,324,312,50.94
Xerath,Garen,1799,913,886,50.75
Xerath,Yuumi,999,511,488,51.15
Xerath,Tryndamere,621,308,313,49.6
Xerath,Mordekaiser,1402,702,700,50.07
Xerath,Annie,471,219,252,46.5
Xerath,Nilah,275,132,143,48
Xerath,Fiora,428,213,215,49.77
Xerath,MonkeyKing,772,394,378,51.04
Xerath,Anivia,370,154,216,41.62
Xerath,Jayce,685,365,320,53.28
Xerath,Soraka,623,254,369,40.77
Xerath,Akali,1268,627,641,49.45
Xerath,Rumble,348,210,138,60.34
Xerath,Heimerdinger,478,217,261,45.4
Xerath,Naafiri,347,144,203,41.5
Xerath,Nasus,745,344,401,46.17
Xerath,Ivern,163,82,81,50.31
Xerath,Shyvana,267,146,121,54.68
Xerath,Smolder,717,372,345,51.88
Xerath,Vex,661,327,334,49.47
Xerath,RekSai,133,73,60,54.89
Xerath,Rakan,400,215,185,53.75
Xerath,Twitch,814,407,407,50
Xerath,Zac,616,306,310,49.68
Xerath,Rell,507,256,251,50.49
Xerath,JarvanIV,738,337,401,45.66
Xerath,Graves,926,442,484,47.73
Xerath,Talon,669,349,320,52.17
Xerath,Belveth,321,157,164,48.91
Xerath,Elise,981,480,501,48.93
Xerath,Varus,1142,628,514,54.99
Xerath,Kayle,772,409,363,52.98
Xerath,Zeri,496,259,237,52.22
Xerath,Neeko,526,307,219,58.37
Xerath,XinZhao,799,366,433,45.81
Xerath,Sona,355,174,181,49.01
Xerath,Ziggs,433,183,250,42.26
Xerath,Kled,210,96,114,45.71
Xerath,Taric,201,85,116,42.29
Xerath,Brand,914,481,433,52.63
Xerath,Kassadin,252,124,128,49.21
Xerath,Olaf,254,120,134,47.24
Xerath,Nidalee,439,266,173,60.59
Xerath,Cassiopeia,347,183,164,52.74
Xerath,Renata,182,106,76,58.24
Xerath,Kennen,289,136,153,47.06
Xerath,Skarner,312,134,178,42.95
Xerath,Lillia,568,297,271,52.29
Malzahar,Gnar,570,287,283,50.35
Malzahar,Diana,2336,1113,1223,47.65
Malzahar,Chogath,1638,848,790,51.77
Malzahar,Jinx,3952,1918,2034,48.53
Malzahar,Nami,1450,723,727,49.86
Malzahar,Kayle,1051,512,539,48.72
Malzahar,Mordekaiser,1774,891,883,50.23
Malzahar,Yasuo,2834,1515,1319,53.46
Malzahar,Varus,1178,624,554,52.97
Malzahar,Galio,1303,631,672,48.43
Malzahar,MasterYi,1763,960,803,54.45
Malzahar,Khazix,651,352,299,54.07
Malzahar,Aurora,900,504,396,56
Malzahar,Ashe,2722,1403,1319,51.54
Malzahar,Thresh,1782,937,845,52.58
Malzahar,Aatrox,1207,652,555,54.02
Malzahar,Fizz,892,468,424,52.47
Malzahar,Lux,3645,1905,1740,52.26
Malzahar,Neeko,551,316,235,57.35
Malzahar,Karma,1767,859,908,48.61
Malzahar,Ivern,166,77,89,46.39
Malzahar,Anivia,468,245,223,52.35
Malzahar,TahmKench,1103,615,488,55.76
Malzahar,LeeSin,1786,961,825,53.81
Malzahar,Hwei,944,468,476,49.58
Malzahar,Tristana,1427,784,643,54.94
Malzahar,Urgot,667,314,353,47.08
Malzahar,Morgana,1623,829,794,51.08
Malzahar,Teemo,1956,983,973,50.26
Malzahar,Pantheon,2042,1117,925,54.7
Malzahar,Orianna,643,360,283,55.99
Malzahar,Warwick,1930,955,975,49.48
Malzahar,Ekko,1347,658,689,48.85
Malzahar,Jhin,2853,1405,1448,49.25
Malzahar,Shen,780,443,337,56.79
Malzahar,Nocturne,1868,824,1044,44.11
Malzahar,Caitlyn,3847,2005,1842,52.12
Malzahar,MissFortune,3449,1776,1673,51.49
Malzahar,Blitzcrank,834,417,417,50
Malzahar,Ezreal,3024,1657,1367,54.79
Malzahar,Evelynn,436,236,200,54.13
Malzahar,Corki,501,264,237,52.69
Malzahar,Milio,900,439,461,48.78
Malzahar,Darius,2647,1362,1285,51.45
Malzahar,Sejuani,618,357,261,57.77
Malzahar,Azir,424,224,200,52.83
Malzahar,Vayne,1752,914,838,52.17
Malzahar,Kled,243,123,120,50.62
Malzahar,Syndra,946,499,447,52.75
Malzahar,RekSai,117,64,53,54.7
Malzahar,Katarina,916,491,425,53.6
Malzahar,Lulu,1831,942,889,51.45
Malzahar,Riven,616,341,275,55.36
Malzahar,Graves,853,424,429,49.71
Malzahar,Aphelios,755,374,381,49.54
Malzahar,Sylas,1632,879,753,53.86
Malzahar,Mel,2909,1520,1389,52.25
Malzahar,Veigar,1487,758,729,50.98
Malzahar,Maokai,583,251,332,43.05
Malzahar,Kayn,2002,1079,923,53.9
Malzahar,Sivir,802,419,383,52.24
Malzahar,Zoe,464,251,213,54.09
Malzahar,Irelia,1151,616,535,53.52
Malzahar,Kaisa,2154,1169,985,54.27
Malzahar,Swain,1499,779,720,51.97
Malzahar,Jax,1175,600,575,51.06
Malzahar,Lucian,939,462,477,49.2
Malzahar,Pyke,1017,546,471,53.69
Malzahar,Ambessa,700,377,323,53.86
Malzahar,Yorick,1473,653,820,44.33
Malzahar,Viego,1785,905,880,50.7
Malzahar,Rammus,400,202,198,50.5
Malzahar,Zed,1783,904,879,50.7
Malzahar,Shaco,1452,758,694,52.2
Malzahar,Illaoi,638,337,301,52.82
Malzahar,Sett,2068,1098,970,53.09
Malzahar,Vex,671,359,312,53.5
Malzahar,FiddleSticks,616,381,235,61.85
Malzahar,Naafiri,409,201,208,49.14
Malzahar,Zyra,1330,666,664,50.08
Malzahar,Rakan,461,232,229,50.33
Malzahar,Sion,1170,608,562,51.97
Malzahar,Poppy,747,406,341,54.35
Malzahar,Smolder,1168,554,614,47.43
Malzahar,Akali,1203,613,590,50.96
Malzahar,Vladimir,994,541,453,54.43
Malzahar,Rell,692,362,330,52.31
Malzahar,XinZhao,930,476,454,51.18
Malzahar,DrMundo,780,363,417,46.54
Malzahar,Udyr,580,322,258,55.52
Malzahar,Volibear,1486,788,698,53.03
Malzahar,Akshan,503,269,234,53.48
Malzahar,Gangplank,759,435,324,57.31
Malzahar,Yone,2325,1223,1102,52.6
Malzahar,Leona,1123,614,509,54.67
Malzahar,Kalista,351,229,122,65.24
Malzahar,Seraphine,1123,557,566,49.6
Malzahar,Garen,2295,1157,1138,50.41
Malzahar,Briar,984,530,454,53.86
Malzahar,MonkeyKing,985,487,498,49.44
Malzahar,Talon,767,423,344,55.15
Malzahar,AurelionSol,791,354,437,44.75
Malzahar,Twitch,1155,585,570,50.65
Malzahar,Draven,724,378,346,52.21
Malzahar,Yuumi,1070,584,486,54.58
Malzahar,JarvanIV,926,512,414,55.29
Malzahar,Ornn,579,280,299,48.36
Malzahar,Singed,434,223,211,51.38
Malzahar,TwistedFate,577,290,287,50.26
Malzahar,Nilah,453,250,203,55.19
Malzahar,Soraka,781,357,424,45.71
Malzahar,Braum,720,392,328,54.44
Malzahar,Skarner,369,214,155,57.99
Malzahar,KSante,696,382,314,54.89
Malzahar,Hecarim,588,295,293,50.17
Malzahar,Shyvana,383,203,180,53
Malzahar,Gragas,578,309,269,53.46
Malzahar,Kennen,347,185,162,53.31
Malzahar,Nasus,983,477,506,48.52
Malzahar,Ahri,1833,1033,800,56.36
Malzahar,Leblanc,893,471,422,52.74
Malzahar,Vi,1234,596,638,48.3
Malzahar,Nautilus,1480,791,689,53.45
Malzahar,Tryndamere,816,432,384,52.94
Malzahar,Cassiopeia,394,202,192,51.27
Malzahar,Bard,362,181,181,50
Malzahar,Viktor,1427,701,726,49.12
Malzahar,Fiora,465,254,211,54.62
Malzahar,Samira,904,500,404,55.31
Malzahar,Ziggs,540,288,252,53.33
Malzahar,Sona,463,215,248,46.44
Malzahar,Amumu,1447,708,739,48.93
Malzahar,Malphite,1443,734,709,50.87
Malzahar,Elise,876,487,389,55.59
Malzahar,Kassadin,269,129,140,47.96
Malzahar,Renekton,568,275,293,48.42
Malzahar,Lillia,699,328,371,46.92
Malzahar,Nidalee,302,189,113,62.58
Malzahar,Belveth,295,188,107,63.73
Malzahar,Velkoz,874,451,423,51.6
Malzahar,Trundle,899,438,461,48.72
Malzahar,Zeri,489,285,204,58.28
Malzahar,Karthus,390,232,158,59.49
Malzahar,KogMaw,435,222,213,51.03
Malzahar,Senna,1043,570,473,54.65
Malzahar,Zilean,454,209,245,46.04
Malzahar,Janna,421,200,221,47.51
Malzahar,Xerath,1326,667,659,50.3
Malzahar,Nunu,764,398,366,52.09
Malzahar,Brand,1088,570,518,52.39
Malzahar,Heimerdinger,650,341,309,52.46
Malzahar,Kindred,619,351,268,56.7
Malzahar,Taric,326,175,151,53.68
Malzahar,Alistar,555,320,235,57.66
Malzahar,Olaf,342,162,180,47.37
Malzahar,Taliyah,319,158,161,49.53
Malzahar,Ryze,513,328,185,63.94
Malzahar,Jayce,524,271,253,51.72
Malzahar,Zac,605,322,283,53.22
Malzahar,Rumble,334,180,154,53.89
Malzahar,Annie,465,226,239,48.6
Malzahar,Qiyana,274,156,118,56.93
Malzahar,Rengar,430,246,184,57.21
Malzahar,Lissandra,424,212,212,50
Malzahar,Xayah,647,326,321,50.39
Malzahar,Camille,444,198,246,44.59
Malzahar,Quinn,410,193,217,47.07
Malzahar,Gwen,690,390,300,56.52
Malzahar,Renata,199,102,97,51.26
Sona,Gnar,109,48,61,44.04
Sona,Diana,677,340,337,50.22
Sona,Chogath,480,244,236,50.83
Sona,Jinx,1291,626,665,48.49
Sona,Nami,555,300,255,54.05
Sona,Yorick,476,216,260,45.38
Sona,Rengar,139,83,56,59.71
Sona,Irelia,329,156,173,47.42
Sona,Ezreal,876,494,382,56.39
Sona,Soraka,220,102,118,46.36
Sona,Poppy,212,113,99,53.3
Sona,Viego,481,251,230,52.18
Sona,Mel,812,451,361,55.54
Sona,Pyke,304,175,129,57.57
Sona,Warwick,644,348,296,54.04
Sona,Garen,654,337,317,51.53
Sona,Smolder,259,144,115,55.6
Sona,Swain,416,209,207,50.24
Sona,Zyra,370,203,167,54.86
Sona,Olaf,74,45,29,60.81
Sona,Shaco,369,210,159,56.91
Sona,Vladimir,283,161,122,56.89
Sona,Twitch,316,139,177,43.99
Sona,Pantheon,591,303,288,51.27
Sona,Hecarim,184,83,101,45.11
Sona,Naafiri,107,58,49,54.21
Sona,MissFortune,928,451,477,48.6
Sona,Nautilus,346,173,173,50
Sona,Yasuo,732,393,339,53.69
Sona,Akali,415,208,207,50.12
Sona,Kaisa,625,326,299,52.16
Sona,Gangplank,226,122,104,53.98
Sona,Fizz,263,169,94,64.26
Sona,Lucian,270,156,114,57.78
Sona,Blitzcrank,246,100,146,40.65
Sona,Kayle,306,150,156,49.02
Sona,Jayce,155,91,64,58.71
Sona,Ashe,770,414,356,53.77
Sona,Morgana,544,276,268,50.74
Sona,Ahri,553,301,252,54.43
Sona,Ryze,107,63,44,58.88
Sona,Milio,309,165,144,53.4
Sona,Vayne,541,304,237,56.19
Sona,Taliyah,107,47,60,43.93
Sona,Seraphine,394,231,163,58.63
Sona,KSante,193,102,91,52.85
Sona,Evelynn,130,69,61,53.08
Sona,Lux,1001,476,525,47.55
Sona,Jhin,872,440,432,50.46
Sona,Zilean,184,78,106,42.39
Sona,Kindred,175,85,90,48.57
Sona,Aatrox,311,163,148,52.41
Sona,XinZhao,261,117,144,44.83
Sona,Tristana,428,266,162,62.15
Sona,Maokai,140,75,65,53.57
Sona,Sion,279,167,112,59.86
Sona,Graves,237,122,115,51.48
Sona,Samira,268,148,120,55.22
Sona,Lulu,614,295,319,48.05
Sona,Rammus,104,44,60,42.31
Sona,Yone,693,398,295,57.43
Sona,Gwen,243,131,112,53.91
Sona,Malzahar,463,248,215,53.56
Sona,Ornn,197,104,93,52.79
Sona,Jax,415,217,198,52.29
Sona,Teemo,517,282,235,54.55
Sona,Urgot,250,92,158,36.8
Sona,MonkeyKing,260,137,123,52.69
Sona,Velkoz,224,117,107,52.23
Sona,Ivern,80,51,29,63.75
Sona,Sylas,515,253,262,49.13
Sona,JarvanIV,279,149,130,53.41
Sona,Karthus,132,64,68,48.48
Sona,Leona,297,148,149,49.83
Sona,Ziggs,159,91,68,57.23
Sona,Yuumi,337,202,135,59.94
Sona,Gragas,231,139,92,60.17
Sona,Senna,313,154,159,49.2
Sona,Riven,192,87,105,45.31
Sona,Aphelios,192,92,100,47.92
Sona,Aurora,290,181,109,62.41
Sona,Varus,349,187,162,53.58
Sona,Janna,194,126,68,64.95
Sona,Sett,517,266,251,51.45
Sona,Akshan,135,74,61,54.81
Sona,Caitlyn,1137,625,512,54.97
Sona,Mordekaiser,449,227,222,50.56
Sona,Sivir,190,101,89,53.16
Sona,Thresh,503,261,242,51.89
Sona,Nasus,314,190,124,60.51
Sona,FiddleSticks,213,103,110,48.36
Sona,Katarina,267,150,117,56.18
Sona,Zac,191,91,100,47.64
Sona,Taric,120,56,64,46.67
Sona,Amumu,379,195,184,51.45
Sona,Draven,213,118,95,55.4
Sona,Vi,346,177,169,51.16
Sona,Orianna,141,76,65,53.9
Sona,Viktor,360,166,194,46.11
Sona,Veigar,422,191,231,45.26
Sona,LeeSin,503,292,211,58.05
Sona,Elise,230,133,97,57.83
Sona,Darius,784,387,397,49.36
Sona,Syndra,211,118,93,55.92
Sona,Galio,367,184,183,50.14
Sona,Nocturne,515,230,285,44.66
Sona,Nilah,119,76,43,63.87
Sona,Bard,110,76,34,69.09
Sona,Kennen,98,46,52,46.94
Sona,Renekton,253,123,130,48.62
Sona,Ekko,383,207,176,54.05
Sona,Zed,391,218,173,55.75
Sona,Rakan,157,82,75,52.23
Sona,Zoe,130,80,50,61.54
Sona,Skarner,124,73,51,58.87
Sona,KogMaw,190,89,101,46.84
Sona,Anivia,123,54,69,43.9
Sona,Ambessa,217,124,93,57.14
Sona,TahmKench,287,145,142,50.52
Sona,Kled,66,35,31,53.03
Sona,Illaoi,165,83,82,50.3
Sona,Brand,317,183,134,57.73
Sona,Nunu,185,100,85,54.05
Sona,Malphite,362,186,176,51.38
Sona,Kalista,82,34,48,41.46
Sona,Xayah,147,68,79,46.26
Sona,Azir,178,102,76,57.3
Sona,Briar,259,113,146,43.63
Sona,Khazix,223,132,91,59.19
Sona,Leblanc,253,136,117,53.75
Sona,Heimerdinger,215,96,119,44.65
Sona,Karma,527,310,217,58.82
Sona,MasterYi,531,286,245,53.86
Sona,Shen,254,146,108,57.48
Sona,Tryndamere,253,135,118,53.36
Sona,TwistedFate,160,79,81,49.38
Sona,Singed,115,61,54,53.04
Sona,Talon,213,115,98,53.99
Sona,Zeri,148,90,58,60.81
Sona,Kayn,626,334,292,53.35
Sona,Fiora,147,73,74,49.66
Sona,Camille,143,97,46,67.83
Sona,Quinn,150,77,73,51.33
Sona,DrMundo,233,112,121,48.07
Sona,Rell,190,88,102,46.32
Sona,Volibear,480,282,198,58.75
Sona,Lillia,225,130,95,57.78
Sona,Corki,129,57,72,44.19
Sona,Hwei,279,150,129,53.76
Sona,Braum,139,60,79,43.17
Sona,Xerath,355,181,174,50.99
Sona,RekSai,78,43,35,55.13
Sona,Renata,85,54,31,63.53
Sona,Lissandra,97,42,55,43.3
Sona,Neeko,178,73,105,41.01
Sona,AurelionSol,152,58,94,38.16
Sona,Sejuani,166,80,86,48.19
Sona,Nidalee,116,66,50,56.9
Sona,Udyr,143,52,91,36.36
Sona,Kassadin,78,40,38,51.28
Sona,Alistar,141,91,50,64.54
Sona,Qiyana,75,43,32,57.33
Sona,Shyvana,97,59,38,60.82
Sona,Vex,183,101,82,55.19
Sona,Trundle,228,132,96,57.89
Sona,Annie,144,61,83,42.36
Sona,Belveth,95,51,44,53.68
Sona,Cassiopeia,115,79,36,68.7
Sona,Rumble,107,59,48,55.14
Gnar,Darius,1035,551,484,53.24
Gnar,Zac,280,138,142,49.29
Gnar,Malzahar,570,283,287,49.65
Gnar,Ziggs,180,97,83,53.89
Gnar,Sona,109,61,48,55.96
Gnar,KSante,395,206,189,52.15
Gnar,Hwei,323,156,167,48.3
Gnar,Evelynn,221,127,94,57.47
Gnar,Sivir,324,166,158,51.23
Gnar,Thresh,744,354,390,47.58
Gnar,Sett,692,345,347,49.86
Gnar,Vex,286,136,150,47.55
Gnar,MissFortune,1161,537,624,46.25
Gnar,Xerath,525,273,252,52
Gnar,Jax,366,168,198,45.9
Gnar,Skarner,122,66,56,54.1
Gnar,Irelia,477,212,265,44.44
Gnar,Alistar,274,120,154,43.8
Gnar,Braum,323,160,163,49.54
Gnar,Aurora,407,210,197,51.6
Gnar,Ashe,1020,487,533,47.75
Gnar,Nunu,292,156,136,53.42
Gnar,Camille,193,99,94,51.3
Gnar,Kayn,655,330,325,50.38
Gnar,Lux,1129,554,575,49.07
Gnar,Quinn,213,96,117,45.07
Gnar,Yuumi,371,197,174,53.1
Gnar,Malphite,734,367,367,50
Gnar,MasterYi,600,324,276,54
Gnar,Syndra,310,135,175,43.55
Gnar,Corki,213,128,85,60.09
Gnar,Soraka,274,132,142,48.18
Gnar,Poppy,380,179,201,47.11
Gnar,Zed,586,298,288,50.85
Gnar,Elise,407,194,213,47.67
Gnar,Teemo,581,304,277,52.32
Gnar,Yone,939,473,466,50.37
Gnar,Varus,543,270,273,49.72
Gnar,Blitzcrank,334,183,151,54.79
Gnar,Jinx,1451,708,743,48.79
Gnar,Nami,611,315,296,51.55
Gnar,Akali,509,245,264,48.13
Gnar,Viktor,516,263,253,50.97
Gnar,Ezreal,1418,768,650,54.16
Gnar,Leona,383,202,181,52.74
Gnar,Pantheon,851,415,436,48.77
Gnar,Hecarim,175,55,120,31.43
Gnar,Naafiri,179,93,86,51.96
Gnar,Nautilus,586,307,279,52.39
Gnar,Ambessa,325,149,176,45.85
Gnar,Nocturne,744,371,373,49.87
Gnar,Kassadin,127,51,76,40.16
Gnar,Caitlyn,1375,678,697,49.31
Gnar,Volibear,575,307,268,53.39
Gnar,Aphelios,242,113,129,46.69
Gnar,Swain,556,276,280,49.64
Gnar,Gwen,244,149,95,61.07
Gnar,Diana,810,390,420,48.15
Gnar,JarvanIV,295,143,152,48.47
Gnar,Leblanc,327,147,180,44.95
Gnar,Xayah,260,132,128,50.77
Gnar,Gangplank,316,158,158,50
Gnar,Vi,501,277,224,55.29
Gnar,Mel,963,502,461,52.13
Gnar,Renekton,280,136,144,48.57
Gnar,Warwick,760,359,401,47.24
Gnar,Briar,308,131,177,42.53
Gnar,Kennen,154,52,102,33.77
Gnar,Yasuo,989,480,509,48.53
Gnar,Urgot,269,118,151,43.87
Gnar,Talon,291,157,134,53.95
Gnar,Sejuani,272,124,148,45.59
Gnar,Ryze,221,103,118,46.61
Gnar,Karma,668,322,346,48.2
Gnar,Vayne,645,330,315,51.16
Gnar,Sylas,825,407,418,49.33
Gnar,Shaco,493,245,248,49.7
Gnar,Lulu,795,393,402,49.43
Gnar,Aatrox,505,238,267,47.13
Gnar,Lucian,404,189,215,46.78
Gnar,Amumu,524,270,254,51.53
Gnar,Ahri,708,351,357,49.58
Gnar,Twitch,396,182,214,45.96
Gnar,Trundle,258,138,120,53.49
Gnar,LeeSin,845,446,399,52.78
Gnar,Neeko,222,97,125,43.69
Gnar,Morgana,530,260,270,49.06
Gnar,Fizz,283,127,156,44.88
Gnar,Kaisa,891,453,438,50.84
Gnar,Ekko,444,190,254,42.79
Gnar,Jayce,299,158,141,52.84
Gnar,Jhin,1115,569,546,51.03
Gnar,Mordekaiser,530,265,265,50
Gnar,Gragas,329,149,180,45.29
Gnar,Garen,828,429,399,51.81
Gnar,Chogath,600,318,282,53
Gnar,RekSai,71,40,31,56.34
Gnar,Vladimir,346,172,174,49.71
Gnar,Taliyah,117,62,55,52.99
Gnar,Zyra,473,211,262,44.61
Gnar,MonkeyKing,328,185,143,56.4
Gnar,Zilean,187,90,97,48.13
Gnar,Galio,448,221,227,49.33
Gnar,Seraphine,338,160,178,47.34
Gnar,Anivia,207,123,84,59.42
Gnar,Viego,724,383,341,52.9
Gnar,Tristana,499,261,238,52.3
Gnar,Rengar,181,109,72,60.22
Gnar,Rumble,181,103,78,56.91
Gnar,Sion,342,174,168,50.88
Gnar,Draven,239,116,123,48.54
Gnar,Pyke,387,195,192,50.39
Gnar,Udyr,228,113,115,49.56
Gnar,Qiyana,127,68,59,53.54
Gnar,Renata,121,56,65,46.28
Gnar,Tryndamere,252,136,116,53.97
Gnar,FiddleSticks,262,132,130,50.38
Gnar,Katarina,367,193,174,52.59
Gnar,Shyvana,136,80,56,58.82
Gnar,Maokai,246,120,126,48.78
Gnar,Olaf,142,76,66,53.52
Gnar,Samira,302,147,155,48.68
Gnar,Orianna,271,140,131,51.66
Gnar,Brand,387,222,165,57.36
Gnar,AurelionSol,191,104,87,54.45
Gnar,Bard,165,67,98,40.61
Gnar,Yorick,425,201,224,47.29
Gnar,Zeri,239,116,123,48.54
Gnar,Cassiopeia,131,50,81,38.17
Gnar,Illaoi,191,79,112,41.36
Gnar,Velkoz,275,125,150,45.45
Gnar,Rakan,162,94,68,58.02
Gnar,Senna,417,214,203,51.32
Gnar,DrMundo,268,136,132,50.75
Gnar,Lillia,255,129,126,50.59
Gnar,Kayle,307,166,141,54.07
Gnar,Azir,193,125,68,64.77
Gnar,Milio,332,144,188,43.37
Gnar,Veigar,496,235,261,47.38
Gnar,Rell,247,127,120,51.42
Gnar,Rammus,125,66,59,52.8
Gnar,TwistedFate,202,96,106,47.52
Gnar,Shen,313,143,170,45.69
Gnar,Karthus,174,88,86,50.57
Gnar,Smolder,273,148,125,54.21
Gnar,Graves,374,180,194,48.13
Gnar,XinZhao,367,166,201,45.23
Gnar,Kalista,133,70,63,52.63
Gnar,Ornn,201,96,105,47.76
Gnar,Kindred,212,98,114,46.23
Gnar,Nasus,291,131,160,45.02
Gnar,Annie,175,68,107,38.86
Gnar,Khazix,246,125,121,50.81
Gnar,TahmKench,416,185,231,44.47
Gnar,Heimerdinger,180,64,116,35.56
Gnar,Singed,141,62,79,43.97
Gnar,Belveth,114,48,66,42.11
Gnar,Nilah,110,38,72,34.55
Gnar,Kled,95,50,45,52.63
Gnar,Lissandra,232,101,131,43.53
Gnar,Zoe,191,95,96,49.74
Gnar,Riven,196,86,110,43.88
Gnar,Janna,176,100,76,56.82
Gnar,Taric,104,53,51,50.96
Gnar,Akshan,170,81,89,47.65
Gnar,KogMaw,140,77,63,55
Gnar,Ivern,63,39,24,61.9
Gnar,Fiora,166,68,98,40.96
Gnar,Nidalee,174,86,88,49.43
Hecarim,Kayle,375,177,198,47.2
Hecarim,Mordekaiser,635,283,352,44.57
Hecarim,Yasuo,999,472,527,47.25
Hecarim,Varus,526,281,245,53.42
Hecarim,Galio,416,172,244,41.35
Hecarim,Urgot,236,106,130,44.92
Hecarim,Vi,525,269,256,51.24
Hecarim,Ekko,525,257,268,48.95
Hecarim,Caitlyn,1365,703,662,51.5
Hecarim,Bard,237,120,117,50.63
Hecarim,Jax,506,276,230,54.55
Hecarim,Rammus,150,66,84,44
Hecarim,Viktor,554,303,251,54.69
Hecarim,Jinx,1594,724,870,45.42
Hecarim,Soraka,316,158,158,50
Hecarim,Swain,469,223,246,47.55
Hecarim,MasterYi,582,268,314,46.05
Hecarim,Kaisa,886,446,440,50.34
Hecarim,Morgana,538,231,307,42.94
Hecarim,Garen,848,382,466,45.05
Hecarim,Udyr,257,109,148,42.41
Hecarim,Vladimir,380,171,209,45
Hecarim,Jhin,1103,462,641,41.89
Hecarim,Zyra,528,242,286,45.83
Hecarim,Gnar,175,120,55,68.57
Hecarim,FiddleSticks,290,147,143,50.69
Hecarim,Irelia,457,222,235,48.58
Hecarim,Smolder,351,176,175,50.14
Hecarim,Sona,184,101,83,54.89
Hecarim,KSante,319,170,149,53.29
Hecarim,Taliyah,158,78,80,49.37
Hecarim,Leblanc,329,139,190,42.25
Hecarim,Lux,1205,604,601,50.12
Hecarim,Lillia,357,189,168,52.94
Hecarim,Akali,512,244,268,47.66
Hecarim,Pantheon,768,385,383,50.13
Hecarim,Draven,322,156,166,48.45
Hecarim,Zilean,161,60,101,37.27
Hecarim,Shaco,520,258,262,49.62
Hecarim,Sion,438,214,224,48.86
Hecarim,Yorick,452,183,269,40.49
Hecarim,Nunu,309,152,157,49.19
Hecarim,Ahri,683,302,381,44.22
Hecarim,Camille,209,98,111,46.89
Hecarim,Rengar,239,143,96,59.83
Hecarim,Aatrox,450,233,217,51.78
Hecarim,Malzahar,588,293,295,49.83
Hecarim,Nami,626,269,357,42.97
Hecarim,Tryndamere,292,125,167,42.81
Hecarim,Zed,732,390,342,53.28
Hecarim,Ezreal,1338,663,675,49.55
Hecarim,Hwei,336,168,168,50
Hecarim,Rumble,161,74,87,45.96
Hecarim,Kayn,684,346,338,50.58
Hecarim,Jayce,279,122,157,43.73
Hecarim,Vayne,738,336,402,45.53
Hecarim,LeeSin,967,456,511,47.16
Hecarim,Ornn,231,128,103,55.41
Hecarim,Twitch,433,211,222,48.73
Hecarim,Renata,84,36,48,42.86
Hecarim,Shyvana,168,69,99,41.07
Hecarim,Mel,1084,535,549,49.35
Hecarim,Milio,371,170,201,45.82
Hecarim,Volibear,516,226,290,43.8
Hecarim,Corki,283,140,143,49.47
Hecarim,Sett,747,320,427,42.84
Hecarim,Veigar,454,182,272,40.09
Hecarim,Darius,987,442,545,44.78
Hecarim,Gragas,354,164,190,46.33
Hecarim,Naafiri,171,110,61,64.33
Hecarim,MissFortune,1055,524,531,49.67
Hecarim,Lulu,861,467,394,54.24
Hecarim,Teemo,597,272,325,45.56
Hecarim,Maokai,247,104,143,42.11
Hecarim,Neeko,230,124,106,53.91
Hecarim,Nocturne,685,329,356,48.03
Hecarim,Amumu,533,249,284,46.72
Hecarim,Xerath,519,252,267,48.55
Hecarim,Ambessa,383,209,174,54.57
Hecarim,Karma,726,328,398,45.18
Hecarim,Malphite,477,273,204,57.23
Hecarim,Katarina,416,210,206,50.48
Hecarim,Samira,350,185,165,52.86
Hecarim,Pyke,415,220,195,53.01
Hecarim,Thresh,723,357,366,49.38
Hecarim,Lucian,395,188,207,47.59
Hecarim,Elise,436,206,230,47.25
Hecarim,Janna,215,92,123,42.79
Hecarim,Quinn,173,89,84,51.45
Hecarim,JarvanIV,362,184,178,50.83
Hecarim,Qiyana,132,69,63,52.27
Hecarim,Ashe,1057,503,554,47.59
Hecarim,TahmKench,371,181,190,48.79
Hecarim,XinZhao,319,147,172,46.08
Hecarim,Rakan,216,114,102,52.78
Hecarim,Graves,338,173,165,51.18
Hecarim,Sylas,851,423,428,49.71
Hecarim,Nasus,430,209,221,48.6
Hecarim,Yone,874,415,459,47.48
Hecarim,Illaoi,188,77,111,40.96
Hecarim,Khazix,305,150,155,49.18
Hecarim,Poppy,302,167,135,55.3
Hecarim,Fiora,187,91,96,48.66
Hecarim,Brand,376,158,218,42.02
Hecarim,Anivia,181,68,113,37.57
Hecarim,AurelionSol,242,109,133,45.04
Hecarim,Gwen,247,119,128,48.18
Hecarim,Leona,452,215,237,47.57
Hecarim,Cassiopeia,163,83,80,50.92
Hecarim,Tristana,509,258,251,50.69
Hecarim,Yuumi,386,185,201,47.93
Hecarim,Kled,93,38,55,40.86
Hecarim,MonkeyKing,336,124,212,36.9
Hecarim,Karthus,163,98,65,60.12
Hecarim,Briar,339,123,216,36.28
Hecarim,Xayah,247,142,105,57.49
Hecarim,DrMundo,250,130,120,52
Hecarim,Senna,387,178,209,45.99
Hecarim,Diana,800,388,412,48.5
Hecarim,Shen,316,159,157,50.32
Hecarim,Annie,191,103,88,53.93
Hecarim,Trundle,319,142,177,44.51
Hecarim,Riven,260,129,131,49.62
Hecarim,Velkoz,378,164,214,43.39
Hecarim,Seraphine,350,153,197,43.71
Hecarim,Vex,255,116,139,45.49
Hecarim,Kassadin,114,67,47,58.77
Hecarim,Lissandra,180,86,94,47.78
Hecarim,Taric,112,48,64,42.86
Hecarim,Alistar,201,82,119,40.8
Hecarim,Zeri,251,117,134,46.61
Hecarim,Talon,339,173,166,51.03
Hecarim,Ziggs,181,91,90,50.28
Hecarim,Renekton,270,127,143,47.04
Hecarim,Warwick,608,275,333,45.23
Hecarim,Chogath,582,285,297,48.97
Hecarim,Orianna,239,105,134,43.93
Hecarim,Aphelios,297,161,136,54.21
Hecarim,Akshan,189,105,84,55.56
Hecarim,Singed,167,75,92,44.91
Hecarim,Sivir,309,150,159,48.54
Hecarim,Viego,814,401,413,49.26
Hecarim,Zac,261,120,141,45.98
Hecarim,Nautilus,581,282,299,48.54
Hecarim,Evelynn,140,61,79,43.57
Hecarim,Kennen,134,79,55,58.96
Hecarim,Braum,316,180,136,56.96
Hecarim,Ryze,177,80,97,45.2
Hecarim,Fizz,269,136,133,50.56
Hecarim,TwistedFate,205,114,91,55.61
Hecarim,Gangplank,339,166,173,48.97
Hecarim,Kindred,286,148,138,51.75
Hecarim,Olaf,110,63,47,57.27
Hecarim,Aurora,394,177,217,44.92
Hecarim,Zoe,150,77,73,51.33
Hecarim,Ivern,82,46,36,56.1
Hecarim,Sejuani,223,113,110,50.67
Hecarim,Belveth,138,79,59,57.25
Hecarim,Azir,186,114,72,61.29
Hecarim,Skarner,114,57,57,50
Hecarim,Kalista,146,60,86,41.1
Hecarim,Nidalee,164,91,73,55.49
Hecarim,Blitzcrank,372,156,216,41.94
Hecarim,Syndra,388,182,206,46.91
Hecarim,KogMaw,169,85,84,50.3
Hecarim,RekSai,89,26,63,29.21
Hecarim,Rell,273,157,116,57.51
Hecarim,Heimerdinger,179,68,111,37.99
Hecarim,Nilah,122,72,50,59.02
Kayle,Irelia,785,412,373,52.48
Kayle,Hecarim,375,198,177,52.8
Kayle,Malzahar,1051,539,512,51.28
Kayle,Vayne,1183,598,585,50.55
Kayle,Pantheon,1242,589,653,47.42
Kayle,Teemo,980,466,514,47.55
Kayle,Jax,908,465,443,51.21
Kayle,Fizz,548,282,266,51.46
Kayle,Kaisa,1265,712,553,56.28
Kayle,Morgana,1153,592,561,51.34
Kayle,Gangplank,512,287,225,56.05
Kayle,Kindred,437,253,184,57.89
Kayle,Aurora,570,308,262,54.04
Kayle,Sivir,388,205,183,52.84
Kayle,Yuumi,654,302,352,46.18
Kayle,Sion,674,347,327,51.48
Kayle,Sylas,1073,573,500,53.4
Kayle,Zed,905,489,416,54.03
Kayle,Tristana,937,477,460,50.91
Kayle,Velkoz,554,307,247,55.42
Kayle,Malphite,983,531,452,54.02
Kayle,Shyvana,197,91,106,46.19
Kayle,Naafiri,269,158,111,58.74
Kayle,MissFortune,1989,1007,982,50.63
Kayle,Maokai,420,210,210,50
Kayle,Heimerdinger,375,158,217,42.13
Kayle,Olaf,160,89,71,55.63
Kayle,Lissandra,287,164,123,57.14
Kayle,Jhin,1825,936,889,51.29
Kayle,TahmKench,595,319,276,53.61
Kayle,Udyr,338,168,170,49.7
Kayle,FiddleSticks,407,215,192,52.83
Kayle,Kennen,200,107,93,53.5
Kayle,Nilah,282,122,160,43.26
Kayle,Taric,255,135,120,52.94
Kayle,Chogath,1130,559,571,49.47
Kayle,RekSai,94,57,37,60.64
Kayle,Katarina,674,344,330,51.04
Kayle,Lulu,1172,626,546,53.41
Kayle,Mel,1819,925,894,50.85
Kayle,Ashe,1486,766,720,51.55
Kayle,Sett,1310,685,625,52.29
Kayle,Ezreal,1743,901,842,51.69
Kayle,Annie,300,159,141,53
Kayle,DrMundo,396,190,206,47.98
Kayle,Viktor,729,361,368,49.52
Kayle,Twitch,783,423,360,54.02
Kayle,Brand,683,353,330,51.68
Kayle,Diana,1365,639,726,46.81
Kayle,Evelynn,329,184,145,55.93
Kayle,Darius,1789,939,850,52.49
Kayle,MasterYi,1045,494,551,47.27
Kayle,Caitlyn,2404,1235,1169,51.37
Kayle,Soraka,513,262,251,51.07
Kayle,Aatrox,718,403,315,56.13
Kayle,Amumu,972,465,507,47.84
Kayle,Leona,663,383,280,57.77
Kayle,Yasuo,1645,921,724,55.99
Kayle,Graves,606,311,295,51.32
Kayle,Lucian,613,328,285,53.51
Kayle,Nami,964,458,506,47.51
Kayle,Mordekaiser,1154,638,516,55.29
Kayle,Poppy,479,207,272,43.22
Kayle,Draven,533,289,244,54.22
Kayle,Sona,306,156,150,50.98
Kayle,Ahri,1066,553,513,51.88
Kayle,Braum,515,271,244,52.62
Kayle,Kayn,1205,632,573,52.45
Kayle,Veigar,961,502,459,52.24
Kayle,Ziggs,262,135,127,51.53
Kayle,Volibear,1040,527,513,50.67
Kayle,Akshan,320,148,172,46.25
Kayle,Jinx,2595,1321,1274,50.91
Kayle,Illaoi,416,243,173,58.41
Kayle,Hwei,575,269,306,46.78
Kayle,Yorick,1015,519,496,51.13
Kayle,Akali,866,442,424,51.04
Kayle,Yone,1418,706,712,49.79
Kayle,Warwick,1210,575,635,47.52
Kayle,Smolder,622,352,270,56.59
Kayle,Fiora,306,184,122,60.13
Kayle,Trundle,444,225,219,50.68
Kayle,TwistedFate,334,193,141,57.78
Kayle,Ekko,869,448,421,51.55
Kayle,Blitzcrank,513,257,256,50.1
Kayle,LeeSin,894,458,436,51.23
Kayle,Nasus,790,349,441,44.18
Kayle,KogMaw,280,161,119,57.5
Kayle,Thresh,1089,560,529,51.42
Kayle,Shaco,811,418,393,51.54
Kayle,Briar,620,282,338,45.48
Kayle,Quinn,332,148,184,44.58
Kayle,Nunu,489,251,238,51.33
Kayle,Kled,153,65,88,42.48
Kayle,Vladimir,667,370,297,55.47
Kayle,Senna,655,345,310,52.67
Kayle,Vex,459,224,235,48.8
Kayle,KSante,455,255,200,56.04
Kayle,Aphelios,468,293,175,62.61
Kayle,Viego,1121,565,556,50.4
Kayle,Seraphine,720,356,364,49.44
Kayle,Cassiopeia,251,139,112,55.38
Kayle,Xayah,405,203,202,50.12
Kayle,Lux,2179,1153,1026,52.91
Kayle,Urgot,544,265,279,48.71
Kayle,Gragas,485,245,240,50.52
Kayle,Qiyana,195,89,106,45.64
Kayle,Milio,495,244,251,49.29
Kayle,XinZhao,533,244,289,45.78
Kayle,Renekton,349,160,189,45.85
Kayle,Ryze,280,152,128,54.29
Kayle,Varus,726,379,347,52.2
Kayle,Pyke,763,426,337,55.83
Kayle,Garen,1647,893,754,54.22
Kayle,Samira,604,331,273,54.8
Kayle,Ornn,359,167,192,46.52
Kayle,Swain,888,447,441,50.34
Kayle,Talon,474,250,224,52.74
Kayle,Elise,466,221,245,47.42
Kayle,Neeko,329,185,144,56.23
Kayle,Khazix,386,233,153,60.36
Kayle,AurelionSol,304,165,139,54.28
Kayle,JarvanIV,580,300,280,51.72
Kayle,Lillia,516,288,228,55.81
Kayle,Karma,998,574,424,57.52
Kayle,Riven,384,193,191,50.26
Kayle,Vi,766,438,328,57.18
Kayle,Azir,271,121,150,44.65
Kayle,Singed,272,162,110,59.56
Kayle,Zeri,288,144,144,50
Kayle,Bard,253,134,119,52.96
Kayle,Zoe,273,123,150,45.05
Kayle,Leblanc,430,218,212,50.7
Kayle,Nautilus,781,426,355,54.55
Kayle,Belveth,225,110,115,48.89
Kayle,Orianna,299,154,145,51.51
Kayle,Zyra,708,375,333,52.97
Kayle,Gwen,410,219,191,53.41
Kayle,Zilean,318,144,174,45.28
Kayle,Ambessa,436,233,203,53.44
Kayle,Rakan,290,163,127,56.21
Kayle,Anivia,333,174,159,52.25
Kayle,Nocturne,1059,566,493,53.45
Kayle,Shen,557,327,230,58.71
Kayle,MonkeyKing,550,284,266,51.64
Kayle,Syndra,561,296,265,52.76
Kayle,Sejuani,286,149,137,52.1
Kayle,Galio,730,347,383,47.53
Kayle,Gnar,307,141,166,45.93
Kayle,Karthus,252,131,121,51.98
Kayle,Rumble,193,112,81,58.03
Kayle,Tryndamere,540,303,237,56.11
Kayle,Rammus,300,144,156,48
Kayle,Xerath,772,363,409,47.02
Kayle,Rell,364,204,160,56.04
Kayle,Janna,298,169,129,56.71
Kayle,Kalista,235,125,110,53.19
Kayle,Taliyah,198,118,80,59.6
Kayle,Rengar,298,152,146,51.01
Kayle,Alistar,280,160,120,57.14
Kayle,Corki,373,202,171,54.16
Kayle,Renata,118,52,66,44.07
Kayle,Skarner,233,125,108,53.65
Kayle,Ivern,114,65,49,57.02
Kayle,Jayce,289,164,125,56.75
Kayle,Camille,239,129,110,53.97
Kayle,Nidalee,187,98,89,52.41
Kayle,Kassadin,194,90,104,46.39
Kayle,Zac,352,161,191,45.74
Azir,Mordekaiser,521,244,277,46.83
Azir,Karthus,181,87,94,48.07
Azir,Katarina,289,138,151,47.75
Azir,Jhin,864,407,457,47.11
Azir,Karma,629,248,381,39.43
Azir,Ornn,192,82,110,42.71
Azir,Kayn,441,221,220,50.11
Azir,Yasuo,931,490,441,52.63
Azir,Caitlyn,1137,566,571,49.78
Azir,Morgana,462,250,212,54.11
Azir,KSante,309,161,148,52.1
Azir,Hwei,299,165,134,55.18
Azir,Evelynn,131,74,57,56.49
Azir,Sivir,251,114,137,45.42
Azir,Thresh,634,280,354,44.16
Azir,Pantheon,730,373,357,51.1
Azir,Gwen,180,80,100,44.44
Azir,Fizz,192,98,94,51.04
Azir,Jinx,1295,592,703,45.71
Azir,Ivern,74,39,35,52.7
Azir,Darius,840,418,422,49.76
Azir,Lillia,225,107,118,47.56
Azir,Garen,645,310,335,48.06
Azir,Pyke,330,171,159,51.82
Azir,Volibear,472,216,256,45.76
Azir,Mel,1000,525,475,52.5
Azir,Zilean,168,75,93,44.64
Azir,Belveth,132,60,72,45.45
Azir,Seraphine,292,127,165,43.49
Azir,Rengar,144,77,67,53.47
Azir,Malzahar,424,200,224,47.17
Azir,Tristana,438,250,188,57.08
Azir,Swain,422,203,219,48.1
Azir,Ambessa,286,144,142,50.35
Azir,TwistedFate,183,93,90,50.82
Azir,Senna,292,172,120,58.9
Azir,Rumble,116,48,68,41.38
Azir,Ahri,634,276,358,43.53
Azir,MissFortune,884,431,453,48.76
Azir,Riven,174,100,74,57.47
Azir,Jax,387,189,198,48.84
Azir,Yone,755,386,369,51.13
Azir,Nami,444,230,214,51.8
Azir,Yorick,365,143,222,39.18
Azir,Briar,289,127,162,43.94
Azir,Lux,900,430,470,47.78
Azir,Poppy,238,108,130,45.38
Azir,MasterYi,458,218,240,47.6
Azir,Brand,241,108,133,44.81
Azir,Ezreal,1140,532,608,46.67
Azir,Lulu,735,338,397,45.99
Azir,Chogath,523,245,278,46.85
Azir,XinZhao,327,166,161,50.76
Azir,Qiyana,129,86,43,66.67
Azir,Taliyah,128,68,60,53.13
Azir,Lissandra,117,65,52,55.56
Azir,Amumu,380,162,218,42.63
Azir,Xerath,471,224,247,47.56
Azir,Tryndamere,226,86,140,38.05
Azir,Zac,341,162,179,47.51
Azir,Akali,468,218,250,46.58
Azir,Zed,454,221,233,48.68
Azir,Draven,239,113,126,47.28
Azir,Leona,393,177,216,45.04
Azir,Warwick,634,290,344,45.74
Azir,Orianna,191,82,109,42.93
Azir,Samira,267,113,154,42.32
Azir,Alistar,211,101,110,47.87
Azir,Diana,806,366,440,45.41
Azir,Lucian,318,180,138,56.6
Azir,Vayne,485,241,244,49.69
Azir,Irelia,378,189,189,50
Azir,Vi,420,192,228,45.71
Azir,Zoe,173,83,90,47.98
Azir,Kalista,133,57,76,42.86
Azir,Udyr,207,109,98,52.66
Azir,Smolder,299,169,130,56.52
Azir,Bard,99,41,58,41.41
Azir,Kaisa,794,393,401,49.5
Azir,Kayle,271,150,121,55.35
Azir,Shaco,350,194,156,55.43
Azir,Varus,423,176,247,41.61
Azir,Soraka,234,128,106,54.7
Azir,Nunu,197,105,92,53.3
Azir,Khazix,265,147,118,55.47
Azir,Nautilus,489,278,211,56.85
Azir,Aatrox,451,234,217,51.88
Azir,JarvanIV,262,153,109,58.4
Azir,Renekton,237,129,108,54.43
Azir,Sett,552,256,296,46.38
Azir,Nocturne,512,216,296,42.19
Azir,Sejuani,239,142,97,59.41
Azir,Camille,188,85,103,45.21
Azir,Ekko,385,189,196,49.09
Azir,Veigar,329,152,177,46.2
Azir,Vladimir,289,136,153,47.06
Azir,Yuumi,411,195,216,47.45
Azir,LeeSin,837,423,414,50.54
Azir,TahmKench,292,162,130,55.48
Azir,Kindred,200,105,95,52.5
Azir,Twitch,369,152,217,41.19
Azir,Kassadin,86,43,43,50
Azir,Ashe,965,474,491,49.12
Azir,Braum,305,133,172,43.61
Azir,Shyvana,71,46,25,64.79
Azir,Singed,130,46,84,35.38
Azir,Aphelios,238,100,138,42.02
Azir,Milio,246,115,131,46.75
Azir,Quinn,165,96,69,58.18
Azir,Leblanc,344,180,164,52.33
Azir,Illaoi,220,93,127,42.27
Azir,Sylas,788,407,381,51.65
Azir,Zyra,384,190,194,49.48
Azir,Fiora,206,109,97,52.91
Azir,Malphite,430,234,196,54.42
Azir,Rakan,155,76,79,49.03
Azir,Velkoz,245,118,127,48.16
Azir,Viego,632,242,390,38.29
Azir,MonkeyKing,382,189,193,49.48
Azir,Sona,178,76,102,42.7
Azir,Jayce,271,157,114,57.93
Azir,Blitzcrank,354,185,169,52.26
Azir,Shen,268,129,139,48.13
Azir,Gnar,193,68,125,35.23
Azir,Rammus,134,50,84,37.31
Azir,Nidalee,147,68,79,46.26
Azir,Skarner,125,69,56,55.2
Azir,Gragas,264,128,136,48.48
Azir,Vex,186,81,105,43.55
Azir,Teemo,453,211,242,46.58
Azir,Rell,247,107,140,43.32
Azir,Trundle,275,143,132,52
Azir,Taric,85,37,48,43.53
Azir,FiddleSticks,208,99,109,47.6
Azir,Viktor,494,212,282,42.91
Azir,Sion,258,103,155,39.92
Azir,Nilah,122,62,60,50.82
Azir,RekSai,66,32,34,48.48
Azir,Maokai,205,103,102,50.24
Azir,Elise,346,178,168,51.45
Azir,Ziggs,117,40,77,34.19
Azir,Janna,133,69,64,51.88
Azir,Gangplank,278,142,136,51.08
Azir,Olaf,90,51,39,56.67
Azir,Aurora,315,158,157,50.16
Azir,Kennen,103,46,57,44.66
Azir,AurelionSol,181,81,100,44.75
Azir,Nasus,262,140,122,53.44
Azir,Renata,78,41,37,52.56
Azir,Xayah,208,122,86,58.65
Azir,Akshan,156,76,80,48.72
Azir,Galio,414,210,204,50.72
Azir,DrMundo,211,111,100,52.61
Azir,Annie,118,54,64,45.76
Azir,Zeri,201,79,122,39.3
Azir,Heimerdinger,181,78,103,43.09
Azir,Urgot,184,77,107,41.85
Azir,Hecarim,186,72,114,38.71
Azir,Ryze,192,112,80,58.33
Azir,Graves,318,156,162,49.06
Azir,Corki,168,82,86,48.81
Azir,Kled,92,40,52,43.48
Azir,Syndra,294,150,144,51.02
Azir,KogMaw,117,57,60,48.72
Azir,Talon,311,111,200,35.69
Azir,Neeko,135,72,63,53.33
Azir,Cassiopeia,119,68,51,57.14
Azir,Naafiri,111,41,70,36.94
Azir,Anivia,108,43,65,39.81
MissFortune,Mordekaiser,4385,2077,2308,47.37
MissFortune,Karthus,828,456,372,55.07
MissFortune,Katarina,2224,1182,1042,53.15
MissFortune,Jhin,6888,3527,3361,51.2
MissFortune,Karma,3138,1540,1598,49.08
MissFortune,Darius,6011,3121,2890,51.92
MissFortune,LeeSin,4191,2108,2083,50.3
MissFortune,Diana,5145,2565,2580,49.85
MissFortune,KogMaw,860,423,437,49.19
MissFortune,Thresh,3765,1934,1831,51.37
MissFortune,Pantheon,4580,2275,2305,49.67
MissFortune,Evelynn,1051,542,509,51.57
MissFortune,Ekko,2775,1435,1340,51.71
MissFortune,Jinx,10463,5179,5284,49.5
MissFortune,Zyra,3052,1545,1507,50.62
MissFortune,Jax,2931,1615,1316,55.1
MissFortune,Amumu,3166,1511,1655,47.73
MissFortune,Ahri,4161,2113,2048,50.78
MissFortune,Caitlyn,10173,5203,4970,51.15
MissFortune,Lulu,3631,1818,1813,50.07
MissFortune,Gnar,1161,624,537,53.75
MissFortune,Volibear,3628,1868,1760,51.49
MissFortune,Fizz,2000,1084,916,54.2
MissFortune,Aphelios,1387,710,677,51.19
MissFortune,Fiora,1000,495,505,49.5
MissFortune,Nocturne,4005,1914,2091,47.79
MissFortune,Sylas,4146,2240,1906,54.03
MissFortune,Varus,2730,1470,1260,53.85
MissFortune,Illaoi,1677,883,794,52.65
MissFortune,MasterYi,3970,1961,2009,49.4
MissFortune,Leblanc,1835,975,860,53.13
MissFortune,Anivia,926,455,471,49.14
MissFortune,Sett,4633,2325,2308,50.18
MissFortune,MonkeyKing,2066,1027,1039,49.71
MissFortune,Corki,1083,573,510,52.91
MissFortune,Ivern,361,211,150,58.45
MissFortune,Mel,6165,3291,2874,53.38
MissFortune,Ashe,7139,3642,3497,51.02
MissFortune,Seraphine,2378,1269,1109,53.36
MissFortune,Yorick,3346,1671,1675,49.94
MissFortune,Aatrox,2462,1259,1203,51.14
MissFortune,Graves,1893,896,997,47.33
MissFortune,Ezreal,7730,4021,3709,52.02
MissFortune,Bard,760,361,399,47.5
MissFortune,Nautilus,3230,1805,1425,55.88
MissFortune,Vi,2746,1411,1335,51.38
MissFortune,Yasuo,5778,2891,2887,50.03
MissFortune,Velkoz,1871,872,999,46.61
MissFortune,Talon,1658,853,805,51.45
MissFortune,Lux,8088,4220,3868,52.18
MissFortune,Kayle,1989,982,1007,49.37
MissFortune,Elise,1874,1043,831,55.66
MissFortune,Swain,3158,1540,1618,48.77
MissFortune,Kalista,700,399,301,57
MissFortune,Heimerdinger,1536,778,758,50.65
MissFortune,Kindred,1336,658,678,49.25
MissFortune,Ornn,1137,554,583,48.72
MissFortune,Trundle,1905,921,984,48.35
MissFortune,Khazix,1405,759,646,54.02
MissFortune,Veigar,3418,1656,1762,48.45
MissFortune,Tristana,3665,1947,1718,53.12
MissFortune,Malzahar,3449,1673,1776,48.51
MissFortune,Akali,3599,1854,1745,51.51
MissFortune,Sejuani,1198,619,579,51.67
MissFortune,Galio,2649,1370,1279,51.72
MissFortune,Milio,1496,702,794,46.93
MissFortune,DrMundo,1691,810,881,47.9
MissFortune,AurelionSol,1196,586,610,49
MissFortune,Rakan,1042,541,501,51.92
MissFortune,Kled,422,188,234,44.55
MissFortune,Warwick,4825,2361,2464,48.93
MissFortune,Syndra,1679,834,845,49.67
MissFortune,Aurora,2023,1087,936,53.73
MissFortune,Malphite,3275,1691,1584,51.63
MissFortune,Orianna,1240,603,637,48.63
MissFortune,Brand,2621,1233,1388,47.04
MissFortune,Briar,2300,1061,1239,46.13
MissFortune,Vayne,4057,2005,2052,49.42
MissFortune,Rell,1250,654,596,52.32
MissFortune,Irelia,2561,1296,1265,50.61
MissFortune,Kaisa,5026,2642,2384,52.57
MissFortune,Viego,4217,2159,2058,51.2
MissFortune,Camille,945,481,464,50.9
MissFortune,Nami,2729,1266,1463,46.39
MissFortune,Vex,1620,793,827,48.95
MissFortune,KSante,1497,837,660,55.91
MissFortune,Nunu,1656,842,814,50.85
MissFortune,FiddleSticks,1505,735,770,48.84
MissFortune,Smolder,1799,938,861,52.14
MissFortune,Sona,928,477,451,51.4
MissFortune,Ziggs,1184,532,652,44.93
MissFortune,Zeri,1136,565,571,49.74
MissFortune,Leona,2433,1225,1208,50.35
MissFortune,Singed,778,332,446,42.67
MissFortune,Neeko,1575,833,742,52.89
MissFortune,Braum,1788,879,909,49.16
MissFortune,Shen,1933,1021,912,52.82
MissFortune,Kayn,4435,2180,2255,49.15
MissFortune,Riven,1234,647,587,52.43
MissFortune,Garen,4974,2480,2494,49.86
MissFortune,Xayah,1297,660,637,50.89
MissFortune,Zoe,1083,624,459,57.62
MissFortune,Kennen,778,407,371,52.31
MissFortune,TahmKench,2386,1280,1106,53.65
MissFortune,Shaco,2798,1439,1359,51.43
MissFortune,Renekton,1414,728,686,51.49
MissFortune,Lillia,1640,828,812,50.49
MissFortune,Udyr,1055,567,488,53.74
MissFortune,Vladimir,1728,868,860,50.23
MissFortune,Poppy,1569,772,797,49.2
MissFortune,Gangplank,1367,698,669,51.06
MissFortune,Draven,1539,818,721,53.15
MissFortune,Chogath,3648,1763,1885,48.33
MissFortune,Teemo,4136,2045,2091,49.44
MissFortune,Zed,3267,1777,1490,54.39
MissFortune,Twitch,2373,1231,1142,51.88
MissFortune,Blitzcrank,2225,1113,1112,50.02
MissFortune,Yone,5667,2957,2710,52.18
MissFortune,Sivir,1687,845,842,50.09
MissFortune,Gwen,1541,885,656,57.43
MissFortune,Azir,884,453,431,51.24
MissFortune,JarvanIV,1699,890,809,52.38
MissFortune,Naafiri,991,513,478,51.77
MissFortune,Cassiopeia,813,412,401,50.68
MissFortune,Morgana,3851,1934,1917,50.22
MissFortune,Maokai,1341,689,652,51.38
MissFortune,Rammus,922,490,432,53.15
MissFortune,Ambessa,1550,828,722,53.42
MissFortune,Tryndamere,1766,893,873,50.57
MissFortune,Jayce,1239,662,577,53.43
MissFortune,Pyke,2171,1095,1076,50.44
MissFortune,Urgot,1679,833,846,49.61
MissFortune,Viktor,2350,1143,1207,48.64
MissFortune,Kassadin,598,263,335,43.98
MissFortune,Nasus,2378,1151,1227,48.4
MissFortune,Lissandra,933,478,455,51.23
MissFortune,Taric,627,314,313,50.08
MissFortune,Yuumi,2347,1219,1128,51.94
MissFortune,Rengar,842,459,383,54.51
MissFortune,Samira,2364,1240,1124,52.45
MissFortune,Hwei,1830,926,904,50.6
MissFortune,Lucian,2144,1089,1055,50.79
MissFortune,Soraka,1590,806,784,50.69
MissFortune,XinZhao,2010,947,1063,47.11
MissFortune,Ryze,948,460,488,48.52
MissFortune,Annie,985,463,522,47.01
MissFortune,Zac,1212,630,582,51.98
MissFortune,Qiyana,652,348,304,53.37
MissFortune,Zilean,929,447,482,48.12
MissFortune,Taliyah,565,230,335,40.71
MissFortune,Xerath,2661,1295,1366,48.67
MissFortune,Hecarim,1055,531,524,50.33
MissFortune,Sion,2097,1015,1082,48.4
MissFortune,Gragas,1362,696,666,51.1
MissFortune,Alistar,1087,577,510,53.08
MissFortune,Janna,884,419,465,47.4
MissFortune,Rumble,766,366,400,47.78
MissFortune,Olaf,642,365,277,56.85
MissFortune,Shyvana,817,438,379,53.61
MissFortune,Belveth,654,299,355,45.72
MissFortune,Senna,2195,1160,1035,52.85
MissFortune,Nilah,1032,457,575,44.28
MissFortune,Renata,423,206,217,48.7
MissFortune,TwistedFate,971,529,442,54.48
MissFortune,Skarner,707,405,302,57.28
MissFortune,Akshan,1048,524,524,50
MissFortune,Quinn,1042,514,528,49.33
MissFortune,Nidalee,770,447,323,58.05
MissFortune,RekSai,311,157,154,50.48
Karthus,Renekton,189,81,108,42.86
Karthus,Diana,726,339,387,46.69
Karthus,Azir,181,94,87,51.93
Karthus,MissFortune,828,372,456,44.93
Karthus,Yuumi,303,124,179,40.92
Karthus,Camille,155,81,74,52.26
Karthus,LeeSin,595,306,289,51.43
Karthus,Hwei,225,106,119,47.11
Karthus,Jhin,859,459,400,53.43
Karthus,Zyra,426,192,234,45.07
Karthus,Jayce,231,134,97,58.01
Karthus,Anivia,177,56,121,31.64
Karthus,Ezreal,1069,526,543,49.2
Karthus,TahmKench,248,111,137,44.76
Karthus,Ambessa,306,147,159,48.04
Karthus,Briar,281,108,173,38.43
Karthus,Mel,730,371,359,50.82
Karthus,Lucian,334,170,164,50.9
Karthus,Leona,300,153,147,51
Karthus,Ivern,68,34,34,50
Karthus,TwistedFate,164,67,97,40.85
Karthus,Senna,319,172,147,53.92
Karthus,DrMundo,206,97,109,47.09
Karthus,Shaco,437,191,246,43.71
Karthus,Vex,219,113,106,51.6
Karthus,Jinx,1084,514,570,47.42
Karthus,Chogath,415,186,229,44.82
Karthus,Trundle,177,85,92,48.02
Karthus,AurelionSol,145,78,67,53.79
Karthus,Veigar,362,161,201,44.48
Karthus,Brand,245,134,111,54.69
Karthus,Sett,531,242,289,45.57
Karthus,MasterYi,469,205,264,43.71
Karthus,Mordekaiser,442,218,224,49.32
Karthus,Lux,949,414,535,43.62
Karthus,Darius,756,366,390,48.41
Karthus,Singed,118,59,59,50
Karthus,Caitlyn,948,448,500,47.26
Karthus,Morgana,390,208,182,53.33
Karthus,Gangplank,247,116,131,46.96
Karthus,Lulu,548,259,289,47.26
Karthus,Garen,622,277,345,44.53
Karthus,Twitch,303,129,174,42.57
Karthus,Nami,397,179,218,45.09
Karthus,Yasuo,744,382,362,51.34
Karthus,Tristana,330,177,153,53.64
Karthus,Swain,379,207,172,54.62
Karthus,Poppy,234,122,112,52.14
Karthus,Vladimir,298,128,170,42.95
Karthus,Sivir,232,117,115,50.43
Karthus,Thresh,531,261,270,49.15
Karthus,Evelynn,117,66,51,56.41
Karthus,Taliyah,139,69,70,49.64
Karthus,Corki,187,110,77,58.82
Karthus,Kaisa,696,401,295,57.61
Karthus,Braum,198,99,99,50
Karthus,Nasus,208,93,115,44.71
Karthus,Zac,206,91,115,44.17
Karthus,Yorick,318,126,192,39.62
Karthus,Zed,392,200,192,51.02
Karthus,Ashe,820,420,400,51.22
Karthus,Sona,132,68,64,51.52
Karthus,Kayn,529,247,282,46.69
Karthus,Yone,711,373,338,52.46
Karthus,Rammus,110,56,54,50.91
Karthus,Riven,187,80,107,42.78
Karthus,Ekko,366,163,203,44.54
Karthus,Akali,440,239,201,54.32
Karthus,Heimerdinger,212,121,91,57.08
Karthus,Viego,487,258,229,52.98
Karthus,Malzahar,390,158,232,40.51
Karthus,Xayah,182,89,93,48.9
Karthus,Lissandra,111,35,76,31.53
Karthus,Aatrox,384,158,226,41.15
Karthus,Khazix,220,90,130,40.91
Karthus,Aurora,320,151,169,47.19
Karthus,Teemo,530,257,273,48.49
Karthus,Vi,404,210,194,51.98
Karthus,Varus,345,192,153,55.65
Karthus,Vayne,503,228,275,45.33
Karthus,Skarner,110,51,59,46.36
Karthus,Draven,225,97,128,43.11
Karthus,Warwick,536,259,277,48.32
Karthus,Amumu,407,208,199,51.11
Karthus,Lillia,248,114,134,45.97
Karthus,Nidalee,132,52,80,39.39
Karthus,Olaf,117,58,59,49.57
Karthus,Maokai,196,77,119,39.29
Karthus,KogMaw,145,78,67,53.79
Karthus,Bard,142,78,64,54.93
Karthus,Tryndamere,185,90,95,48.65
Karthus,Xerath,379,172,207,45.38
Karthus,Renata,49,33,16,67.35
Karthus,Sylas,551,313,238,56.81
Karthus,Karma,577,259,318,44.89
Karthus,Gwen,169,94,75,55.62
Karthus,Nunu,198,98,100,49.49
Karthus,Smolder,216,106,110,49.07
Karthus,Rakan,158,85,73,53.8
Karthus,Talon,280,152,128,54.29
Karthus,Naafiri,121,59,62,48.76
Karthus,Urgot,179,88,91,49.16
Karthus,JarvanIV,214,132,82,61.68
Karthus,Rell,216,114,102,52.78
Karthus,Aphelios,200,91,109,45.5
Karthus,Milio,222,85,137,38.29
Karthus,FiddleSticks,225,99,126,44
Karthus,Kennen,152,96,56,63.16
Karthus,Pyke,264,130,134,49.24
Karthus,Volibear,395,223,172,56.46
Karthus,Neeko,193,122,71,63.21
Karthus,MonkeyKing,228,112,116,49.12
Karthus,Irelia,312,153,159,49.04
Karthus,Zoe,166,79,87,47.59
Karthus,Elise,327,170,157,51.99
Karthus,Jax,321,156,165,48.6
Karthus,Katarina,320,168,152,52.5
Karthus,Ahri,382,180,202,47.12
Karthus,Samira,221,99,122,44.8
Karthus,Velkoz,197,94,103,47.72
Karthus,Kassadin,95,42,53,44.21
Karthus,Hecarim,163,65,98,39.88
Karthus,Akshan,120,66,54,55
Karthus,Seraphine,258,132,126,51.16
Karthus,Pantheon,622,307,315,49.36
Karthus,Sejuani,143,87,56,60.84
Karthus,Soraka,256,128,128,50
Karthus,Fizz,135,73,62,54.07
Karthus,Kindred,180,99,81,55
Karthus,Illaoi,167,70,97,41.92
Karthus,Orianna,168,70,98,41.67
Karthus,Kayle,252,121,131,48.02
Karthus,Zeri,176,91,85,51.7
Karthus,Leblanc,265,116,149,43.77
Karthus,Janna,138,81,57,58.7
Karthus,Qiyana,106,53,53,50
Karthus,Alistar,174,93,81,53.45
Karthus,Malphite,354,165,189,46.61
Karthus,Blitzcrank,319,152,167,47.65
Karthus,KSante,197,107,90,54.31
Karthus,Nocturne,495,231,264,46.67
Karthus,Gnar,174,86,88,49.43
Karthus,Kalista,70,33,37,47.14
Karthus,Taric,62,35,27,56.45
Karthus,Rumble,140,80,60,57.14
Karthus,Shyvana,58,36,22,62.07
Karthus,Quinn,160,80,80,50
Karthus,Ryze,125,67,58,53.6
Karthus,Sion,250,130,120,52
Karthus,XinZhao,278,140,138,50.36
Karthus,RekSai,78,44,34,56.41
Karthus,Rengar,153,97,56,63.4
Karthus,Belveth,95,44,51,46.32
Karthus,Annie,148,65,83,43.92
Karthus,Zilean,122,70,52,57.38
Karthus,Fiora,154,87,67,56.49
Karthus,Graves,300,180,120,60
Karthus,Syndra,228,114,114,50
Karthus,Nautilus,422,189,233,44.79
Karthus,Udyr,114,40,74,35.09
Karthus,Shen,191,87,104,45.55
Karthus,Gragas,195,88,107,45.13
Karthus,Galio,367,188,179,51.23
Karthus,Nilah,129,62,67,48.06
Karthus,Viktor,338,179,159,52.96
Karthus,Ziggs,123,63,60,51.22
Karthus,Cassiopeia,70,21,49,30
Karthus,Ornn,131,62,69,47.33
Karthus,Kled,51,16,35,31.37
Karma,Renekton,926,473,453,51.08
Karma,Diana,2765,1303,1462,47.12
Karma,Azir,629,381,248,60.57
Karma,MissFortune,3138,1598,1540,50.92
Karma,Yuumi,1480,762,718,51.49
Karma,Urgot,828,412,416,49.76
Karma,Vi,1712,825,887,48.19
Karma,Ekko,1504,791,713,52.59
Karma,Caitlyn,4453,2264,2189,50.84
Karma,Bard,595,266,329,44.71
Karma,Tryndamere,723,350,373,48.41
Karma,Malzahar,1767,908,859,51.39
Karma,Zyra,1799,889,910,49.42
Karma,Garen,2566,1286,1280,50.12
Karma,Graves,1296,676,620,52.16
Karma,Lucian,1307,677,630,51.8
Karma,Lux,4030,2010,2020,49.88
Karma,Evelynn,540,244,296,45.19
Karma,Lissandra,624,366,258,58.65
Karma,Corki,693,341,352,49.21
Karma,Rakan,653,310,343,47.47
Karma,Volibear,1540,779,761,50.58
Karma,Khazix,1003,541,462,53.94
Karma,Ezreal,4662,2301,2361,49.36
Karma,Velkoz,988,493,495,49.9
Karma,XinZhao,1205,680,525,56.43
Karma,Yasuo,3091,1584,1507,51.25
Karma,Kalista,455,244,211,53.63
Karma,Pantheon,2536,1302,1234,51.34
Karma,Darius,2987,1474,1513,49.35
Karma,Katarina,1283,621,662,48.4
Karma,Kaisa,3118,1619,1499,51.92
Karma,Lulu,3167,1610,1557,50.84
Karma,Jax,1410,757,653,53.69
Karma,Kayn,2010,1037,973,51.59
Karma,Zeri,861,462,399,53.66
Karma,Amumu,1429,713,716,49.9
Karma,Mordekaiser,1884,942,942,50
Karma,Aurora,1318,652,666,49.47
Karma,Varus,1612,888,724,55.09
Karma,Morgana,1816,984,832,54.19
Karma,Sion,1091,587,504,53.8
Karma,Sylas,2263,1187,1076,52.45
Karma,Zed,1923,1006,917,52.31
Karma,Tristana,1522,763,759,50.13
Karma,Malphite,1563,846,717,54.13
Karma,Shyvana,348,179,169,51.44
Karma,Naafiri,462,204,258,44.16
Karma,Maokai,753,383,370,50.86
Karma,Swain,1422,708,714,49.79
Karma,MasterYi,1883,944,939,50.13
Karma,Singed,507,262,245,51.68
Karma,Galio,1537,723,814,47.04
Karma,Sivir,1005,512,493,50.95
Karma,Thresh,2422,1218,1204,50.29
Karma,Lillia,897,457,440,50.95
Karma,Aphelios,833,475,358,57.02
Karma,Leona,1263,706,557,55.9
Karma,Elise,1371,708,663,51.64
Karma,Anivia,608,302,306,49.67
Karma,Pyke,1341,708,633,52.8
Karma,Yone,2882,1497,1385,51.94
Karma,Nocturne,2075,1010,1065,48.67
Karma,Ahri,2225,1085,1140,48.76
Karma,Syndra,1164,599,565,51.46
Karma,Soraka,1028,514,514,50
Karma,Xerath,1811,921,890,50.86
Karma,Irelia,1445,717,728,49.62
Karma,Heimerdinger,679,316,363,46.54
Karma,Ambessa,1221,644,577,52.74
Karma,LeeSin,3362,1825,1537,54.28
Karma,Vladimir,1135,528,607,46.52
Karma,Udyr,585,294,291,50.26
Karma,Jhin,3469,1822,1647,52.52
Karma,Gangplank,1007,499,508,49.55
Karma,Samira,898,468,430,52.12
Karma,Neeko,671,313,358,46.65
Karma,FiddleSticks,892,472,420,52.91
Karma,Gragas,970,507,463,52.27
Karma,Sejuani,699,413,286,59.08
Karma,Akali,1855,906,949,48.84
Karma,Ziggs,592,294,298,49.66
Karma,Nasus,1051,529,522,50.33
Karma,TwistedFate,574,302,272,52.61
Karma,Mel,3144,1718,1426,54.64
Karma,Fiora,649,353,296,54.39
Karma,Sett,2028,957,1071,47.19
Karma,Seraphine,1239,643,596,51.9
Karma,Rengar,538,336,202,62.45
Karma,TahmKench,1072,562,510,52.43
Karma,KogMaw,483,258,225,53.42
Karma,Zilean,627,318,309,50.72
Karma,Twitch,1219,577,642,47.33
Karma,Blitzcrank,1239,657,582,53.03
Karma,Nautilus,1838,880,958,47.88
Karma,Yorick,1367,670,697,49.01
Karma,Akshan,535,295,240,55.14
Karma,Veigar,1225,626,599,51.1
Karma,Xayah,672,379,293,56.4
Karma,Warwick,1848,893,955,48.32
Karma,Leblanc,1237,643,594,51.98
Karma,MonkeyKing,1303,677,626,51.96
Karma,Milio,1070,541,529,50.56
Karma,Belveth,398,195,203,48.99
Karma,Ashe,3676,1871,1805,50.9
Karma,Nami,2257,1028,1229,45.55
Karma,Trundle,839,417,422,49.7
Karma,Skarner,421,222,199,52.73
Karma,Viego,2406,1174,1232,48.79
Karma,Jinx,4572,2275,2297,49.76
Karma,Quinn,599,308,291,51.42
Karma,Janna,660,315,345,47.73
Karma,Shaco,1568,785,783,50.06
Karma,Brand,1003,523,480,52.14
Karma,KSante,1138,630,508,55.36
Karma,AurelionSol,597,294,303,49.25
Karma,Draven,829,406,423,48.97
Karma,Gnar,668,346,322,51.8
Karma,Vayne,1971,920,1051,46.68
Karma,Rell,736,374,362,50.82
Karma,Camille,739,401,338,54.26
Karma,Riven,858,447,411,52.1
Karma,Taliyah,505,288,217,57.03
Karma,Teemo,1755,899,856,51.23
Karma,JarvanIV,1051,501,550,47.67
Karma,Qiyana,486,254,232,52.26
Karma,Aatrox,1591,813,778,51.1
Karma,Ornn,653,345,308,52.83
Karma,Viktor,1729,895,834,51.76
Karma,Renata,343,184,159,53.64
Karma,Annie,570,271,299,47.54
Karma,Shen,908,449,459,49.45
Karma,Taric,301,160,141,53.16
Karma,DrMundo,817,375,442,45.9
Karma,Rammus,386,209,177,54.15
Karma,Illaoi,566,318,248,56.18
Karma,Braum,962,483,479,50.21
Karma,Zac,900,436,464,48.44
Karma,Smolder,1000,538,462,53.8
Karma,Gwen,752,447,305,59.44
Karma,Senna,1235,624,611,50.53
Karma,Rumble,609,333,276,54.68
Karma,Zoe,665,316,349,47.52
Karma,Orianna,776,414,362,53.35
Karma,Hwei,1173,603,570,51.41
Karma,Hecarim,726,398,328,54.82
Karma,Vex,784,401,383,51.15
Karma,Kassadin,358,163,195,45.53
Karma,Kayle,998,424,574,42.48
Karma,Kennen,464,230,234,49.57
Karma,Briar,1088,481,607,44.21
Karma,Ryze,694,334,360,48.13
Karma,Jayce,1148,583,565,50.78
Karma,Talon,1110,521,589,46.94
Karma,Poppy,905,453,452,50.06
Karma,Fizz,831,426,405,51.26
Karma,Karthus,577,318,259,55.11
Karma,Chogath,1740,870,870,50
Karma,Nilah,356,177,179,49.72
Karma,Olaf,388,203,185,52.32
Karma,Sona,527,217,310,41.18
Karma,Nunu,745,327,418,43.89
Karma,Kindred,696,365,331,52.44
Karma,Nidalee,628,339,289,53.98
Karma,Alistar,633,354,279,55.92
Karma,Ivern,245,127,118,51.84
Karma,Cassiopeia,434,208,226,47.93
Karma,RekSai,206,107,99,51.94
Karma,Kled,311,172,139,55.31
Talon,Darius,1386,695,691,50.14
Talon,LeeSin,1388,719,669,51.8
Talon,Diana,1318,660,658,50.08
Talon,KogMaw,203,100,103,49.26
Talon,Thresh,1009,444,565,44
Talon,Kindred,336,160,176,47.62
Talon,Yone,1424,667,757,46.84
Talon,Samira,451,206,245,45.68
Talon,Rell,338,162,176,47.93
Talon,Yorick,660,333,327,50.45
Talon,JarvanIV,437,217,220,49.66
Talon,Mel,1430,757,673,52.94
Talon,Jinx,2162,1013,1149,46.85
Talon,Lux,1552,703,849,45.3
Talon,Shen,401,203,198,50.62
Talon,Ekko,769,416,353,54.1
Talon,Zed,1024,533,491,52.05
Talon,Jhin,1532,753,779,49.15
Talon,Nautilus,810,367,443,45.31
Talon,Jax,617,346,271,56.08
Talon,Gragas,439,229,210,52.16
Talon,Twitch,571,271,300,47.46
Talon,Lulu,1260,616,644,48.89
Talon,Garen,1168,500,668,42.81
Talon,Lillia,390,196,194,50.26
Talon,Irelia,693,304,389,43.87
Talon,Nami,753,402,351,53.39
Talon,MissFortune,1658,805,853,48.55
Talon,Sett,1119,474,645,42.36
Talon,Evelynn,248,135,113,54.44
Talon,Vladimir,570,255,315,44.74
Talon,Ashe,1546,780,766,50.45
Talon,Pantheon,1313,632,681,48.13
Talon,TahmKench,514,224,290,43.58
Talon,Shaco,729,331,398,45.4
Talon,Leblanc,561,281,280,50.09
Talon,Hwei,467,245,222,52.46
Talon,Kaisa,1482,751,731,50.67
Talon,Tristana,673,323,350,47.99
Talon,Swain,648,360,288,55.56
Talon,Vi,782,413,369,52.81
Talon,Yasuo,1658,792,866,47.77
Talon,Kayn,952,456,496,47.9
Talon,Caitlyn,1848,873,975,47.24
Talon,Soraka,397,155,242,39.04
Talon,Camille,362,172,190,47.51
Talon,Chogath,857,433,424,50.53
Talon,RekSai,104,32,72,30.77
Talon,Draven,396,198,198,50
Talon,Rammus,227,103,124,45.37
Talon,Ryze,285,132,153,46.32
Talon,Katarina,643,295,348,45.88
Talon,Zilean,293,150,143,51.19
Talon,AurelionSol,221,98,123,44.34
Talon,Annie,256,118,138,46.09
Talon,Veigar,572,280,292,48.95
Talon,Yuumi,731,415,316,56.77
Talon,Nunu,379,208,171,54.88
Talon,Aphelios,384,180,204,46.88
Talon,Morgana,826,406,420,49.15
Talon,Volibear,713,346,367,48.53
Talon,MonkeyKing,527,212,315,40.23
Talon,Ziggs,243,114,129,46.91
Talon,Gnar,291,134,157,46.05
Talon,Amumu,687,297,390,43.23
Talon,Malzahar,767,344,423,44.85
Talon,Braum,376,168,208,44.68
Talon,Urgot,313,147,166,46.96
Talon,Graves,675,377,298,55.85
Talon,Gangplank,434,196,238,45.16
Talon,Udyr,315,157,158,49.84
Talon,Ezreal,2257,1207,1050,53.48
Talon,Cassiopeia,258,116,142,44.96
Talon,Galio,648,313,335,48.3
Talon,Sylas,1259,627,632,49.8
Talon,Fiora,300,115,185,38.33
Talon,Khazix,510,230,280,45.1
Talon,Aurora,579,325,254,56.13
Talon,Lucian,585,321,264,54.87
Talon,Milio,462,196,266,42.42
Talon,Nocturne,953,486,467,51
Talon,Rumble,280,150,130,53.57
Talon,FiddleSticks,355,169,186,47.61
Talon,Belveth,182,85,97,46.7
Talon,Corki,333,184,149,55.26
Talon,Smolder,439,208,231,47.38
Talon,Poppy,496,206,290,41.53
Talon,Aatrox,699,391,308,55.94
Talon,Vayne,916,384,532,41.92
Talon,KSante,499,254,245,50.9
Talon,Varus,726,359,367,49.45
Talon,Renata,109,36,73,33.03
Talon,Warwick,1126,513,613,45.56
Talon,Ahri,977,456,521,46.67
Talon,Nasus,440,221,219,50.23
Talon,Brand,476,250,226,52.52
Talon,Gwen,326,172,154,52.76
Talon,Blitzcrank,496,244,252,49.19
Talon,Kayle,474,224,250,47.26
Talon,Janna,291,137,154,47.08
Talon,Zac,378,179,199,47.35
Talon,Briar,432,178,254,41.2
Talon,Velkoz,366,160,206,43.72
Talon,Ambessa,468,251,217,53.63
Talon,Taliyah,168,69,99,41.07
Talon,Naafiri,232,99,133,42.67
Talon,TwistedFate,279,140,139,50.18
Talon,Sejuani,305,140,165,45.9
Talon,Quinn,263,106,157,40.3
Talon,Seraphine,488,282,206,57.79
Talon,Renekton,444,215,229,48.42
Talon,Teemo,898,398,500,44.32
Talon,Skarner,172,93,79,54.07
Talon,Karma,1110,589,521,53.06
Talon,MasterYi,810,395,415,48.77
Talon,Taric,121,62,59,51.24
Talon,Akshan,259,150,109,57.92
Talon,Viego,1181,548,633,46.4
Talon,Karthus,280,128,152,45.71
Talon,Senna,609,279,330,45.81
Talon,Viktor,787,414,373,52.6
Talon,Mordekaiser,848,353,495,41.63
Talon,Syndra,402,185,217,46.02
Talon,Tryndamere,364,167,197,45.88
Talon,Anivia,329,161,168,48.94
Talon,Sion,519,236,283,45.47
Talon,Xayah,397,190,207,47.86
Talon,Pyke,652,356,296,54.6
Talon,Akali,892,421,471,47.2
Talon,Kennen,214,117,97,54.67
Talon,Rengar,214,98,116,45.79
Talon,Zoe,289,141,148,48.79
Talon,Kled,126,50,76,39.68
Talon,Riven,375,185,190,49.33
Talon,Vex,367,168,199,45.78
Talon,Nilah,167,61,106,36.53
Talon,Alistar,336,163,173,48.51
Talon,Zyra,711,321,390,45.15
Talon,Illaoi,267,112,155,41.95
Talon,Shyvana,227,99,128,43.61
Talon,Xerath,669,320,349,47.83
Talon,Sona,213,98,115,46.01
Talon,Bard,238,113,125,47.48
Talon,Heimerdinger,318,127,191,39.94
Talon,Malphite,804,426,378,52.99
Talon,Lissandra,296,136,160,45.95
Talon,Hecarim,339,166,173,48.97
Talon,Neeko,326,201,125,61.66
Talon,Jayce,472,239,233,50.64
Talon,Maokai,385,191,194,49.61
Talon,Singed,183,73,110,39.89
Talon,Zeri,372,191,181,51.34
Talon,Trundle,394,234,160,59.39
Talon,Qiyana,192,93,99,48.44
Talon,XinZhao,584,247,337,42.29
Talon,Rakan,283,133,150,47
Talon,Olaf,184,100,84,54.35
Talon,Elise,655,318,337,48.55
Talon,Sivir,465,237,228,50.97
Talon,Fizz,403,198,205,49.13
Talon,Orianna,329,151,178,45.9
Talon,Ornn,302,146,156,48.34
Talon,DrMundo,334,153,181,45.81
Talon,Leona,576,303,273,52.6
Talon,Kalista,167,75,92,44.91
Talon,Ivern,101,60,41,59.41
Talon,Nidalee,272,146,126,53.68
Talon,Kassadin,148,71,77,47.97
Talon,Azir,311,197,114,63.34
Ornn,Irelia,443,219,224,49.44
Ornn,MasterYi,589,289,300,49.07
Ornn,Azir,192,110,82,57.29
Ornn,Lucian,377,172,205,45.62
Ornn,Mel,851,422,429,49.59
Ornn,Khazix,264,158,106,59.85
Ornn,Aurora,379,211,168,55.67
Ornn,Ashe,1069,530,539,49.58
Ornn,Thresh,633,328,305,51.82
Ornn,Yone,831,424,407,51.02
Ornn,Warwick,797,341,456,42.79
Ornn,Hwei,345,162,183,46.96
Ornn,Varus,522,247,275,47.32
Ornn,Malphite,576,272,304,47.22
Ornn,Yorick,490,240,250,48.98
Ornn,Lillia,276,119,157,43.12
Ornn,Xayah,261,136,125,52.11
Ornn,Yuumi,402,181,221,45.02
Ornn,Sett,814,400,414,49.14
Ornn,Shaco,401,192,209,47.88
Ornn,Ziggs,226,107,119,47.35
Ornn,Kaisa,898,495,403,55.12
Ornn,MissFortune,1137,583,554,51.28
Ornn,Nocturne,636,304,332,47.8
Ornn,AurelionSol,159,77,82,48.43
Ornn,Smolder,310,165,145,53.23
Ornn,Nautilus,586,331,255,56.48
Ornn,Gangplank,298,144,154,48.32
Ornn,Kayn,724,380,344,52.49
Ornn,Ekko,470,247,223,52.55
Ornn,Aphelios,317,153,164,48.26
Ornn,Zeri,209,91,118,43.54
Ornn,Zed,616,339,277,55.03
Ornn,Camille,202,102,100,50.5
Ornn,Lulu,780,387,393,49.62
Ornn,Shen,317,145,172,45.74
Ornn,Xerath,479,274,205,57.2
Ornn,Jhin,1026,542,484,52.83
Ornn,Lux,1312,679,633,51.75
Ornn,Akali,534,265,269,49.63
Ornn,TahmKench,309,169,140,54.69
Ornn,Mordekaiser,726,321,405,44.21
Ornn,Yasuo,907,427,480,47.08
Ornn,Volibear,519,260,259,50.1
Ornn,Graves,304,140,164,46.05
Ornn,Syndra,325,165,160,50.77
Ornn,Vayne,715,344,371,48.11
Ornn,Milio,303,169,134,55.78
Ornn,KSante,369,179,190,48.51
Ornn,Taliyah,158,82,76,51.9
Ornn,JarvanIV,323,146,177,45.2
Ornn,Malzahar,579,299,280,51.64
Ornn,KogMaw,131,54,77,41.22
Ornn,Briar,357,162,195,45.38
Ornn,Poppy,326,146,180,44.79
Ornn,Vladimir,353,199,154,56.37
Ornn,Sivir,255,122,133,47.84
Ornn,Darius,1001,498,503,49.75
Ornn,Hecarim,231,103,128,44.59
Ornn,Karma,653,308,345,47.17
Ornn,Vi,495,258,237,52.12
Ornn,Draven,279,131,148,46.95
Ornn,Pyke,368,179,189,48.64
Ornn,Ezreal,1271,662,609,52.08
Ornn,Sona,197,93,104,47.21
Ornn,LeeSin,863,430,433,49.83
Ornn,Corki,204,106,98,51.96
Ornn,Nasus,331,141,190,42.6
Ornn,Nunu,299,135,164,45.15
Ornn,Qiyana,133,89,44,66.92
Ornn,Veigar,466,206,260,44.21
Ornn,Janna,155,70,85,45.16
Ornn,Kayle,359,192,167,53.48
Ornn,Sylas,814,428,386,52.58
Ornn,Senna,434,261,173,60.14
Ornn,Illaoi,249,130,119,52.21
Ornn,Velkoz,309,150,159,48.54
Ornn,Teemo,574,300,274,52.26
Ornn,Shyvana,121,66,55,54.55
Ornn,Twitch,438,227,211,51.83
Ornn,Maokai,238,126,112,52.94
Ornn,Renata,90,55,35,61.11
Ornn,Aatrox,478,260,218,54.39
Ornn,Elise,390,195,195,50
Ornn,Fizz,294,134,160,45.58
Ornn,Singed,137,53,84,38.69
Ornn,Ahri,672,346,326,51.49
Ornn,Swain,499,250,249,50.1
Ornn,Riven,230,135,95,58.7
Ornn,FiddleSticks,295,162,133,54.92
Ornn,Samira,311,167,144,53.7
Ornn,Skarner,129,83,46,64.34
Ornn,Katarina,335,129,206,38.51
Ornn,Caitlyn,1399,721,678,51.54
Ornn,Soraka,275,117,158,42.55
Ornn,Gwen,395,180,215,45.57
Ornn,Rengar,198,104,94,52.53
Ornn,Viktor,503,261,242,51.89
Ornn,Tristana,521,273,248,52.4
Ornn,Nami,593,264,329,44.52
Ornn,Gragas,297,176,121,59.26
Ornn,Seraphine,381,178,203,46.72
Ornn,Viego,749,354,395,47.26
Ornn,Pantheon,872,448,424,51.38
Ornn,Trundle,331,156,175,47.13
Ornn,Jinx,1521,774,747,50.89
Ornn,Renekton,247,133,114,53.85
Ornn,Rell,250,128,122,51.2
Ornn,Diana,855,419,436,49.01
Ornn,Amumu,448,243,205,54.24
Ornn,Naafiri,114,51,63,44.74
Ornn,Sejuani,210,124,86,59.05
Ornn,Alistar,235,105,130,44.68
Ornn,Garen,867,441,426,50.87
Ornn,Anivia,161,73,88,45.34
Ornn,Annie,172,81,91,47.09
Ornn,Fiora,260,123,137,47.31
Ornn,TwistedFate,169,99,70,58.58
Ornn,Zac,298,149,149,50
Ornn,Morgana,571,257,314,45.01
Ornn,DrMundo,273,135,138,49.45
Ornn,Zyra,463,233,230,50.32
Ornn,Brand,315,151,164,47.94
Ornn,Rammus,102,59,43,57.84
Ornn,Chogath,629,308,321,48.97
Ornn,Neeko,205,118,87,57.56
Ornn,Kalista,96,53,43,55.21
Ornn,Leona,468,263,205,56.2
Ornn,Cassiopeia,137,75,62,54.74
Ornn,Leblanc,319,191,128,59.87
Ornn,Taric,118,61,57,51.69
Ornn,MonkeyKing,351,185,166,52.71
Ornn,Ryze,189,82,107,43.39
Ornn,Belveth,123,63,60,51.22
Ornn,Galio,477,240,237,50.31
Ornn,Vex,301,160,141,53.16
Ornn,Gnar,201,105,96,52.24
Ornn,Rumble,117,60,57,51.28
Ornn,Bard,159,79,80,49.69
Ornn,Zilean,227,119,108,52.42
Ornn,Blitzcrank,398,209,189,52.51
Ornn,Akshan,173,101,72,58.38
Ornn,Kindred,245,131,114,53.47
Ornn,Orianna,256,104,152,40.63
Ornn,Rakan,206,102,104,49.51
Ornn,Heimerdinger,209,95,114,45.45
Ornn,Braum,284,135,149,47.54
Ornn,Jax,426,195,231,45.77
Ornn,Nilah,143,75,68,52.45
Ornn,Kassadin,87,35,52,40.23
Ornn,Olaf,123,42,81,34.15
Ornn,Sion,337,162,175,48.07
Ornn,Tryndamere,258,127,131,49.22
Ornn,Quinn,178,84,94,47.19
Ornn,Lissandra,150,87,63,58
Ornn,Talon,302,156,146,51.66
Ornn,Urgot,262,142,120,54.2
Ornn,Kennen,120,73,47,60.83
Ornn,RekSai,65,30,35,46.15
Ornn,Jayce,225,117,108,52
Ornn,Kled,90,39,51,43.33
Ornn,XinZhao,323,175,148,54.18
Ornn,Nidalee,151,98,53,64.9
Ornn,Ambessa,326,162,164,49.69
Ornn,Karthus,131,69,62,52.67
Ornn,Evelynn,140,75,65,53.57
Ornn,Ivern,72,41,31,56.94
Ornn,Zoe,189,97,92,51.32
Ornn,Udyr,160,85,75,53.13
Zoe,Renekton,278,170,108,61.15
Zoe,Trundle,255,139,116,54.51
Zoe,Mordekaiser,578,297,281,51.38
Zoe,Jinx,1336,673,663,50.37
Zoe,Nautilus,571,253,318,44.31
Zoe,TahmKench,298,147,151,49.33
Zoe,Ivern,61,30,31,49.18
Zoe,Yasuo,845,385,460,45.56
Zoe,Draven,257,144,113,56.03
Zoe,Milio,284,147,137,51.76
Zoe,Garen,724,345,379,47.65
Zoe,Nunu,282,110,172,39.01
Zoe,Yorick,417,181,236,43.41
Zoe,Caitlyn,1228,633,595,51.55
Zoe,Lux,1225,599,626,48.9
Zoe,Irelia,402,148,254,36.82
Zoe,Sylas,703,388,315,55.19
Zoe,Ashe,1133,545,588,48.1
Zoe,Malzahar,464,213,251,45.91
Zoe,Ezreal,1291,687,604,53.21
Zoe,Pyke,388,210,178,54.12
Zoe,Teemo,461,183,278,39.7
Zoe,Amumu,420,211,209,50.24
Zoe,Katarina,375,190,185,50.67
Zoe,MissFortune,1083,459,624,42.38
Zoe,Nami,438,222,216,50.68
Zoe,Jax,467,237,230,50.75
Zoe,Ahri,702,374,328,53.28
Zoe,Corki,247,121,126,48.99
Zoe,Soraka,266,143,123,53.76
Zoe,Shen,273,130,143,47.62
Zoe,Graves,368,174,194,47.28
Zoe,Taliyah,149,62,87,41.61
Zoe,Poppy,284,130,154,45.77
Zoe,Olaf,123,43,80,34.96
Zoe,Kayn,624,330,294,52.88
Zoe,Cassiopeia,113,56,57,49.56
Zoe,Morgana,543,277,266,51.01
Zoe,Fiora,209,87,122,41.63
Zoe,Khazix,225,118,107,52.44
Zoe,Ekko,410,194,216,47.32
Zoe,Lucian,328,179,149,54.57
Zoe,Braum,294,129,165,43.88
Zoe,Singed,125,56,69,44.8
Zoe,Viktor,436,226,210,51.83
Zoe,Samira,290,128,162,44.14
Zoe,Pantheon,735,386,349,52.52
Zoe,Shaco,385,184,201,47.79
Zoe,Akali,491,246,245,50.1
Zoe,Xerath,466,226,240,48.5
Zoe,XinZhao,272,94,178,34.56
Zoe,Warwick,551,277,274,50.27
Zoe,DrMundo,258,128,130,49.61
Zoe,Volibear,441,205,236,46.49
Zoe,Zed,478,254,224,53.14
Zoe,Udyr,185,90,95,48.65
Zoe,Veigar,461,235,226,50.98
Zoe,Tristana,503,228,275,45.33
Zoe,Sett,706,357,349,50.57
Zoe,Sion,333,148,185,44.44
Zoe,Vladimir,329,173,156,52.58
Zoe,Jhin,973,526,447,54.06
Zoe,Thresh,659,343,316,52.05
Zoe,Heimerdinger,175,74,101,42.29
Zoe,Karma,665,349,316,52.48
Zoe,Twitch,407,223,184,54.79
Zoe,Annie,160,80,80,50
Zoe,MonkeyKing,332,188,144,56.63
Zoe,Azir,173,90,83,52.02
Zoe,Aatrox,465,216,249,46.45
Zoe,Elise,460,222,238,48.26
Zoe,Fizz,270,107,163,39.63
Zoe,Varus,429,203,226,47.32
Zoe,Mel,830,428,402,51.57
Zoe,Aurora,372,166,206,44.62
Zoe,Malphite,402,188,214,46.77
Zoe,Hwei,321,148,173,46.11
Zoe,MasterYi,655,331,324,50.53
Zoe,Seraphine,322,167,155,51.86
Zoe,Nasus,228,102,126,44.74
Zoe,Shyvana,105,47,58,44.76
Zoe,Illaoi,158,80,78,50.63
Zoe,Diana,729,375,354,51.44
Zoe,Rell,232,109,123,46.98
Zoe,KSante,280,181,99,64.64
Zoe,Galio,491,222,269,45.21
Zoe,Leblanc,391,191,200,48.85
Zoe,Zilean,177,87,90,49.15
Zoe,Kayle,273,150,123,54.95
Zoe,Naafiri,225,104,121,46.22
Zoe,Yuumi,397,206,191,51.89
Zoe,Chogath,555,292,263,52.61
Zoe,Gragas,280,165,115,58.93
Zoe,Ambessa,291,137,154,47.08
Zoe,TwistedFate,220,105,115,47.73
Zoe,Lulu,675,328,347,48.59
Zoe,Orianna,183,96,87,52.46
Zoe,KogMaw,157,73,84,46.5
Zoe,Qiyana,164,105,59,64.02
Zoe,Urgot,176,58,118,32.95
Zoe,Vi,520,253,267,48.65
Zoe,Swain,358,151,207,42.18
Zoe,Sejuani,165,86,79,52.12
Zoe,Nocturne,641,315,326,49.14
Zoe,Yone,954,505,449,52.94
Zoe,Kaisa,862,422,440,48.96
Zoe,Gwen,261,104,157,39.85
Zoe,Brand,332,163,169,49.1
Zoe,Vayne,598,277,321,46.32
Zoe,Sona,130,50,80,38.46
Zoe,Briar,265,146,119,55.09
Zoe,AurelionSol,154,75,79,48.7
Zoe,Sivir,242,117,125,48.35
Zoe,Maokai,242,113,129,46.69
Zoe,Anivia,181,101,80,55.8
Zoe,Syndra,352,180,172,51.14
Zoe,Leona,372,188,184,50.54
Zoe,Neeko,207,121,86,58.45
Zoe,Karthus,166,87,79,52.41
Zoe,Vex,251,115,136,45.82
Zoe,Kalista,83,44,39,53.01
Zoe,Renata,84,43,41,51.19
Zoe,Talon,289,148,141,51.21
Zoe,Quinn,173,78,95,45.09
Zoe,Nilah,127,50,77,39.37
Zoe,Ziggs,203,109,94,53.69
Zoe,LeeSin,824,416,408,50.49
Zoe,Camille,200,107,93,53.5
Zoe,Lissandra,144,67,77,46.53
Zoe,Riven,217,89,128,41.01
Zoe,Tryndamere,309,173,136,55.99
Zoe,Lillia,280,133,147,47.5
Zoe,FiddleSticks,233,101,132,43.35
Zoe,Velkoz,284,120,164,42.25
Zoe,Smolder,257,156,101,60.7
Zoe,Bard,157,84,73,53.5
Zoe,Rumble,170,94,76,55.29
Zoe,Darius,869,481,388,55.35
Zoe,Xayah,167,76,91,45.51
Zoe,Rakan,193,90,103,46.63
Zoe,Aphelios,243,123,120,50.62
Zoe,Alistar,167,88,79,52.69
Zoe,Ryze,177,94,83,53.11
Zoe,Gnar,191,96,95,50.26
Zoe,Kennen,127,62,65,48.82
Zoe,Senna,350,157,193,44.86
Zoe,Viego,749,373,376,49.8
Zoe,Janna,151,75,76,49.67
Zoe,Hecarim,150,73,77,48.67
Zoe,Jayce,247,135,112,54.66
Zoe,Rengar,170,74,96,43.53
Zoe,Kled,94,49,45,52.13
Zoe,Zyra,447,214,233,47.87
Zoe,Evelynn,156,73,83,46.79
Zoe,Gangplank,280,152,128,54.29
Zoe,Nidalee,163,81,82,49.69
Zoe,Belveth,99,65,34,65.66
Zoe,Blitzcrank,354,183,171,51.69
Zoe,Kindred,172,85,87,49.42
Zoe,Zac,226,120,106,53.1
Zoe,Skarner,106,60,46,56.6
Zoe,Rammus,139,60,79,43.17
Zoe,Zeri,216,125,91,57.87
Zoe,Akshan,220,102,118,46.36
Zoe,JarvanIV,300,144,156,48
Zoe,Ornn,189,92,97,48.68
Zoe,Taric,91,44,47,48.35
Zoe,Kassadin,48,26,22,54.17
Zoe,RekSai,93,36,57,38.71
Ambessa,Diana,1380,671,709,48.62
Ambessa,Gragas,506,253,253,50
Ambessa,Zed,992,475,517,47.88
Ambessa,Caitlyn,2064,949,1115,45.98
Ambessa,Soraka,415,193,222,46.51
Ambessa,Renekton,674,306,368,45.4
Ambessa,Evelynn,304,145,159,47.7
Ambessa,Lissandra,235,93,142,39.57
Ambessa,Corki,387,192,195,49.61
Ambessa,Rakan,286,113,173,39.51
Ambessa,Aatrox,769,395,374,51.37
Ambessa,Kayn,1045,470,575,44.98
Ambessa,Katarina,630,282,348,44.76
Ambessa,Draven,346,138,208,39.88
Ambessa,Blitzcrank,608,266,342,43.75
Ambessa,Vi,842,447,395,53.09
Ambessa,Ekko,723,350,373,48.41
Ambessa,Yasuo,1524,722,802,47.38
Ambessa,Jhin,1561,721,840,46.19
Ambessa,Velkoz,448,192,256,42.86
Ambessa,Chogath,813,363,450,44.65
Ambessa,Shaco,704,348,356,49.43
Ambessa,Sivir,448,228,220,50.89
Ambessa,Milio,418,192,226,45.93
Ambessa,Tryndamere,432,187,245,43.29
Ambessa,Rengar,212,101,111,47.64
Ambessa,Viktor,824,427,397,51.82
Ambessa,Lux,1820,820,1000,45.05
Ambessa,Poppy,488,199,289,40.78
Ambessa,Viego,1253,597,656,47.65
Ambessa,Vayne,1018,443,575,43.52
Ambessa,Nami,759,338,421,44.53
Ambessa,Garen,1187,511,676,43.05
Ambessa,Udyr,328,190,138,57.93
Ambessa,Vladimir,484,221,263,45.66
Ambessa,Zyra,859,386,473,44.94
Ambessa,Camille,481,232,249,48.23
Ambessa,MasterYi,814,352,462,43.24
Ambessa,Malzahar,700,323,377,46.14
Ambessa,Jinx,2160,961,1199,44.49
Ambessa,Gwen,346,163,183,47.11
Ambessa,Rammus,180,74,106,41.11
Ambessa,Karma,1221,577,644,47.26
Ambessa,Gnar,325,176,149,54.15
Ambessa,Yorick,588,228,360,38.78
Ambessa,Aurora,557,283,274,50.81
Ambessa,Taric,149,85,64,57.05
Ambessa,Teemo,763,353,410,46.26
Ambessa,Amumu,697,319,378,45.77
Ambessa,Hwei,490,263,227,53.67
Ambessa,Ezreal,2412,1175,1237,48.71
Ambessa,Brand,521,254,267,48.75
Ambessa,Karthus,306,159,147,51.96
Ambessa,Fizz,430,188,242,43.72
Ambessa,Swain,707,311,396,43.99
Ambessa,FiddleSticks,401,201,200,50.12
Ambessa,Naafiri,270,142,128,52.59
Ambessa,Mordekaiser,885,429,456,48.47
Ambessa,Nocturne,1097,426,671,38.83
Ambessa,Smolder,413,214,199,51.82
Ambessa,Azir,286,142,144,49.65
Ambessa,Seraphine,433,216,217,49.88
Ambessa,Annie,276,146,130,52.9
Ambessa,Irelia,736,334,402,45.38
Ambessa,Khazix,378,191,187,50.53
Ambessa,Zilean,261,133,128,50.96
Ambessa,Gangplank,446,198,248,44.39
Ambessa,Warwick,1014,428,586,42.21
Ambessa,Nilah,215,82,133,38.14
Ambessa,Urgot,379,194,185,51.19
Ambessa,Ryze,329,128,201,38.91
Ambessa,Galio,806,348,458,43.18
Ambessa,Twitch,591,260,331,43.99
Ambessa,Yuumi,666,344,322,51.65
Ambessa,Sett,1215,556,659,45.76
Ambessa,LeeSin,1598,796,802,49.81
Ambessa,Vex,412,171,241,41.5
Ambessa,MissFortune,1550,722,828,46.58
Ambessa,Leblanc,612,269,343,43.95
Ambessa,Rell,353,151,202,42.78
Ambessa,Fiora,283,126,157,44.52
Ambessa,Lucian,631,331,300,52.46
Ambessa,Braum,457,210,247,45.95
Ambessa,Shen,525,238,287,45.33
Ambessa,Veigar,609,307,302,50.41
Ambessa,Pantheon,1284,603,681,46.96
Ambessa,Akali,881,420,461,47.67
Ambessa,Mel,1459,694,765,47.57
Ambessa,Lillia,451,206,245,45.68
Ambessa,Quinn,310,131,179,42.26
Ambessa,Ashe,1739,866,873,49.8
Ambessa,Riven,408,172,236,42.16
Ambessa,DrMundo,325,173,152,53.23
Ambessa,Trundle,363,169,194,46.56
Ambessa,Xerath,758,328,430,43.27
Ambessa,Kaisa,1432,688,744,48.04
Ambessa,Nautilus,903,422,481,46.73
Ambessa,Darius,1444,631,813,43.7
Ambessa,Graves,553,294,259,53.16
Ambessa,Alistar,388,214,174,55.15
Ambessa,Rumble,217,115,102,53
Ambessa,Zac,403,187,216,46.4
Ambessa,Kalista,214,105,109,49.07
Ambessa,Senna,577,264,313,45.75
Ambessa,Thresh,1091,506,585,46.38
Ambessa,JarvanIV,469,212,257,45.2
Ambessa,Kindred,299,169,130,56.52
Ambessa,TwistedFate,279,123,156,44.09
Ambessa,Varus,781,384,397,49.17
Ambessa,Briar,500,229,271,45.8
Ambessa,Illaoi,316,133,183,42.09
Ambessa,Hecarim,383,174,209,45.43
Ambessa,Lulu,1328,620,708,46.69
Ambessa,Elise,652,279,373,42.79
Ambessa,Qiyana,212,111,101,52.36
Ambessa,MonkeyKing,567,250,317,44.09
Ambessa,Syndra,510,248,262,48.63
Ambessa,Talon,468,217,251,46.37
Ambessa,Nasus,418,194,224,46.41
Ambessa,Yone,1449,759,690,52.38
Ambessa,Bard,250,142,108,56.8
Ambessa,Janna,313,156,157,49.84
Ambessa,Leona,633,318,315,50.24
Ambessa,Kassadin,179,86,93,48.04
Ambessa,Volibear,756,357,399,47.22
Ambessa,Ahri,1020,488,532,47.84
Ambessa,Jax,777,404,373,51.99
Ambessa,Malphite,678,285,393,42.04
Ambessa,Kayle,436,203,233,46.56
Ambessa,Renata,135,51,84,37.78
Ambessa,Zoe,291,154,137,52.92
Ambessa,Aphelios,426,180,246,42.25
Ambessa,Taliyah,218,101,117,46.33
Ambessa,TahmKench,474,230,244,48.52
Ambessa,Olaf,211,97,114,45.97
Ambessa,Ziggs,265,97,168,36.6
Ambessa,Zeri,386,187,199,48.45
Ambessa,Jayce,601,281,320,46.76
Ambessa,Pyke,587,285,302,48.55
Ambessa,Tristana,659,327,332,49.62
Ambessa,Sona,217,93,124,42.86
Ambessa,Sejuani,293,116,177,39.59
Ambessa,Samira,436,202,234,46.33
Ambessa,Maokai,391,159,232,40.66
Ambessa,Singed,234,98,136,41.88
Ambessa,Nidalee,288,144,144,50
Ambessa,Cassiopeia,196,91,105,46.43
Ambessa,Morgana,753,373,380,49.54
Ambessa,Sylas,1275,625,650,49.02
Ambessa,Neeko,365,171,194,46.85
Ambessa,AurelionSol,293,140,153,47.78
Ambessa,Sion,592,307,285,51.86
Ambessa,Orianna,435,206,229,47.36
Ambessa,XinZhao,613,252,361,41.11
Ambessa,Kennen,223,98,125,43.95
Ambessa,Ivern,127,66,61,51.97
Ambessa,Nunu,373,183,190,49.06
Ambessa,Kled,121,57,64,47.11
Ambessa,KSante,616,302,314,49.03
Ambessa,Shyvana,190,96,94,50.53
Ambessa,Heimerdinger,273,131,142,47.99
Ambessa,Akshan,276,143,133,51.81
Ambessa,Xayah,359,181,178,50.42
Ambessa,Anivia,273,128,145,46.89
Ambessa,KogMaw,274,131,143,47.81
Ambessa,Skarner,207,122,85,58.94
Ambessa,RekSai,113,50,63,44.25
Ambessa,Ornn,326,164,162,50.31
Ambessa,Belveth,202,89,113,44.06
KSante,Gnar,395,189,206,47.85
KSante,Zyra,691,365,326,52.82
KSante,Azir,309,148,161,47.9
KSante,Varus,711,332,379,46.69
KSante,Nautilus,820,374,446,45.61
KSante,Aatrox,864,438,426,50.69
KSante,Evelynn,217,99,118,45.62
KSante,Katarina,466,237,229,50.86
KSante,Kaisa,1377,638,739,46.33
KSante,Zilean,230,93,137,40.43
KSante,Volibear,609,270,339,44.33
KSante,JarvanIV,431,177,254,41.07
KSante,Zed,855,427,428,49.94
KSante,Lucian,568,251,317,44.19
KSante,Nami,671,282,389,42.03
KSante,Gangplank,400,183,217,45.75
KSante,Jax,675,327,348,48.44
KSante,Yasuo,1495,665,830,44.48
KSante,Gragas,417,179,238,42.93
KSante,MonkeyKing,491,205,286,41.75
KSante,Ahri,885,450,435,50.85
KSante,Caitlyn,1861,928,933,49.87
KSante,Poppy,530,223,307,42.08
KSante,Sett,1163,537,626,46.17
KSante,Mordekaiser,986,474,512,48.07
KSante,Akshan,164,61,103,37.2
KSante,MissFortune,1497,660,837,44.09
KSante,Maokai,353,165,188,46.74
KSante,LeeSin,1416,660,756,46.61
KSante,Jhin,1363,627,736,46
KSante,Hecarim,319,149,170,46.71
KSante,Fizz,342,185,157,54.09
KSante,Blitzcrank,530,261,269,49.25
KSante,Sion,455,203,252,44.62
KSante,Aurora,476,252,224,52.94
KSante,Shen,380,177,203,46.58
KSante,Diana,1277,594,683,46.52
KSante,Mel,1285,667,618,51.91
KSante,Kalista,183,109,74,59.56
KSante,Seraphine,422,193,229,45.73
KSante,Darius,1369,675,694,49.31
KSante,Ekko,677,334,343,49.34
KSante,Qiyana,185,76,109,41.08
KSante,Lux,1434,673,761,46.93
KSante,Rengar,259,146,113,56.37
KSante,Belveth,172,96,76,55.81
KSante,Veigar,566,271,295,47.88
KSante,Swain,635,309,326,48.66
KSante,Yone,1366,630,736,46.12
KSante,Corki,349,180,169,51.58
KSante,Warwick,796,397,399,49.87
KSante,Karma,1138,508,630,44.64
KSante,Braum,434,180,254,41.47
KSante,Malphite,579,313,266,54.06
KSante,Xerath,765,319,446,41.7
KSante,Smolder,450,217,233,48.22
KSante,Sona,193,91,102,47.15
KSante,Ornn,369,190,179,51.49
KSante,MasterYi,772,391,381,50.65
KSante,Jinx,2032,928,1104,45.67
KSante,Renata,87,47,40,54.02
KSante,Urgot,296,149,147,50.34
KSante,Pantheon,1288,584,704,45.34
KSante,Viktor,728,320,408,43.96
KSante,TahmKench,454,246,208,54.19
KSante,Kayle,455,200,255,43.96
KSante,TwistedFate,235,99,136,42.13
KSante,Nocturne,911,413,498,45.33
KSante,Akali,816,370,446,45.34
KSante,Udyr,254,156,98,61.42
KSante,Malzahar,696,314,382,45.11
KSante,Vi,707,338,369,47.81
KSante,Elise,581,280,301,48.19
KSante,Zac,465,238,227,51.18
KSante,Vladimir,385,156,229,40.52
KSante,Garen,1196,490,706,40.97
KSante,Talon,499,245,254,49.1
KSante,DrMundo,330,150,180,45.45
KSante,Orianna,313,155,158,49.52
KSante,Ivern,116,37,79,31.9
KSante,Leblanc,525,261,264,49.71
KSante,Velkoz,347,173,174,49.86
KSante,Shaco,651,313,338,48.08
KSante,Taliyah,207,89,118,43
KSante,Milio,395,164,231,41.52
KSante,Kayn,854,348,506,40.75
KSante,Ashe,1688,802,886,47.51
KSante,Khazix,351,150,201,42.74
KSante,Ezreal,2029,1023,1006,50.42
KSante,Renekton,438,194,244,44.29
KSante,Shyvana,159,83,76,52.2
KSante,Lissandra,242,118,124,48.76
KSante,Janna,265,144,121,54.34
KSante,Syndra,372,163,209,43.82
KSante,Aphelios,383,199,184,51.96
KSante,Yorick,536,198,338,36.94
KSante,Vex,333,155,178,46.55
KSante,Riven,314,147,167,46.82
KSante,Kassadin,147,60,87,40.82
KSante,Lulu,1184,546,638,46.11
KSante,Viego,1039,485,554,46.68
KSante,Briar,444,203,241,45.72
KSante,Sylas,1206,579,627,48.01
KSante,Irelia,617,315,302,51.05
KSante,Twitch,521,248,273,47.6
KSante,Pyke,593,297,296,50.08
KSante,Gwen,432,194,238,44.91
KSante,Zoe,280,99,181,35.36
KSante,Jayce,464,194,270,41.81
KSante,Xayah,294,125,169,42.52
KSante,Tristana,556,273,283,49.1
KSante,Anivia,227,111,116,48.9
KSante,Hwei,454,229,225,50.44
KSante,Vayne,929,365,564,39.29
KSante,Alistar,298,136,162,45.64
KSante,Sejuani,344,163,181,47.38
KSante,Leona,595,285,310,47.9
KSante,Amumu,567,227,340,40.04
KSante,Morgana,659,296,363,44.92
KSante,FiddleSticks,405,172,233,42.47
KSante,Thresh,986,464,522,47.06
KSante,Ziggs,238,126,112,52.94
KSante,Rammus,206,96,110,46.6
KSante,Nasus,448,186,262,41.52
KSante,Ryze,283,123,160,43.46
KSante,Fiora,294,129,165,43.88
KSante,Chogath,686,316,370,46.06
KSante,Olaf,189,112,77,59.26
KSante,Kindred,358,141,217,39.39
KSante,Annie,240,114,126,47.5
KSante,Teemo,503,220,283,43.74
KSante,Brand,422,175,247,41.47
KSante,Illaoi,292,130,162,44.52
KSante,Nunu,280,138,142,49.29
KSante,Rell,433,203,230,46.88
KSante,Taric,128,60,68,46.88
KSante,KogMaw,214,94,120,43.93
KSante,Lillia,428,169,259,39.49
KSante,Samira,419,165,254,39.38
KSante,Karthus,197,90,107,45.69
KSante,Soraka,385,163,222,42.34
KSante,Graves,536,291,245,54.29
KSante,AurelionSol,246,124,122,50.41
KSante,Trundle,354,132,222,37.29
KSante,Kennen,128,46,82,35.94
KSante,Singed,175,75,100,42.86
KSante,Sivir,315,143,172,45.4
KSante,Senna,444,197,247,44.37
KSante,Neeko,328,186,142,56.71
KSante,Galio,705,347,358,49.22
KSante,RekSai,131,58,73,44.27
KSante,Skarner,222,129,93,58.11
KSante,Yuumi,632,316,316,50
KSante,Ambessa,616,314,302,50.97
KSante,Kled,137,77,60,56.2
KSante,Quinn,178,84,94,47.19
KSante,XinZhao,521,260,261,49.9
KSante,Rakan,314,152,162,48.41
KSante,Tryndamere,285,147,138,51.58
KSante,Camille,268,134,134,50
KSante,Nilah,173,77,96,44.51
KSante,Nidalee,260,110,150,42.31
KSante,Heimerdinger,203,92,111,45.32
KSante,Bard,176,82,94,46.59
KSante,Naafiri,187,67,120,35.83
KSante,Draven,335,152,183,45.37
KSante,Zeri,357,156,201,43.7
KSante,Rumble,250,139,111,55.6
KSante,Cassiopeia,225,93,132,41.33
Urgot,Warwick,1022,549,473,53.72
Urgot,Hecarim,236,130,106,55.08
Urgot,Diana,1089,555,534,50.96
Urgot,Ziggs,234,107,127,45.73
Urgot,Karma,828,416,412,50.24
Urgot,Sett,1118,564,554,50.45
Urgot,Lillia,336,148,188,44.05
Urgot,Leblanc,338,190,148,56.21
Urgot,Jinx,1949,1006,943,51.62
Urgot,Alistar,249,128,121,51.41
Urgot,Yorick,911,445,466,48.85
Urgot,Briar,502,211,291,42.03
Urgot,Malzahar,667,353,314,52.92
Urgot,Jhin,1363,706,657,51.8
Urgot,Nautilus,692,392,300,56.65
Urgot,JarvanIV,340,181,159,53.24
Urgot,Mel,1203,643,560,53.45
Urgot,Lux,1685,844,841,50.09
Urgot,MonkeyKing,479,222,257,46.35
Urgot,Anivia,202,93,109,46.04
Urgot,Corki,236,154,82,65.25
Urgot,Ivern,97,45,52,46.39
Urgot,Lissandra,231,129,102,55.84
Urgot,Volibear,935,505,430,54.01
Urgot,Vladimir,416,237,179,56.97
Urgot,Lucian,400,209,191,52.25
Urgot,Nami,690,384,306,55.65
Urgot,Olaf,162,86,76,53.09
Urgot,Pantheon,1010,543,467,53.76
Urgot,Nunu,337,181,156,53.71
Urgot,Viktor,617,325,292,52.67
Urgot,Sivir,316,158,158,50
Urgot,Morgana,732,361,371,49.32
Urgot,Garen,1106,531,575,48.01
Urgot,Caitlyn,1859,960,899,51.64
Urgot,Blitzcrank,424,183,241,43.16
Urgot,Mordekaiser,826,414,412,50.12
Urgot,Xerath,588,299,289,50.85
Urgot,Ezreal,1302,690,612,53
Urgot,Yuumi,490,268,222,54.69
Urgot,Viego,821,410,411,49.94
Urgot,Thresh,776,410,366,52.84
Urgot,Aatrox,602,332,270,55.15
Urgot,LeeSin,777,430,347,55.34
Urgot,Yasuo,1272,658,614,51.73
Urgot,Graves,386,161,225,41.71
Urgot,Amumu,746,383,363,51.34
Urgot,Gangplank,350,189,161,54
Urgot,Taliyah,161,97,64,60.25
Urgot,Milio,381,180,201,47.24
Urgot,Rengar,260,161,99,61.92
Urgot,Veigar,668,282,386,42.22
Urgot,Xayah,240,124,116,51.67
Urgot,Quinn,215,113,102,52.56
Urgot,Elise,395,193,202,48.86
Urgot,Ryze,219,107,112,48.86
Urgot,Ahri,798,455,343,57.02
Urgot,Ambessa,379,185,194,48.81
Urgot,Akali,671,380,291,56.63
Urgot,Samira,470,248,222,52.77
Urgot,Yone,989,578,411,58.44
Urgot,Kayn,954,544,410,57.02
Urgot,Tristana,652,323,329,49.54
Urgot,Fiora,207,108,99,52.17
Urgot,Galio,518,254,264,49.03
Urgot,Gnar,269,151,118,56.13
Urgot,Ashe,1195,666,529,55.73
Urgot,Braum,401,176,225,43.89
Urgot,Darius,1368,692,676,50.58
Urgot,Talon,313,166,147,53.04
Urgot,Twitch,617,316,301,51.22
Urgot,Brand,527,284,243,53.89
Urgot,KSante,296,147,149,49.66
Urgot,MissFortune,1679,846,833,50.39
Urgot,Trundle,409,193,216,47.19
Urgot,FiddleSticks,293,141,152,48.12
Urgot,Ekko,670,367,303,54.78
Urgot,Zyra,578,309,269,53.46
Urgot,Gwen,290,157,133,54.14
Urgot,Zed,606,303,303,50
Urgot,Seraphine,588,294,294,50
Urgot,Sejuani,255,145,110,56.86
Urgot,Kennen,192,96,96,50
Urgot,TahmKench,566,296,270,52.3
Urgot,Vi,572,286,286,50
Urgot,Katarina,477,273,204,57.23
Urgot,Nasus,553,287,266,51.9
Urgot,Soraka,310,153,157,49.35
Urgot,Kayle,544,279,265,51.29
Urgot,XinZhao,362,231,131,63.81
Urgot,KogMaw,169,100,69,59.17
Urgot,Renata,112,61,51,54.46
Urgot,Qiyana,128,81,47,63.28
Urgot,Rakan,216,123,93,56.94
Urgot,Teemo,841,412,429,48.99
Urgot,Sona,250,158,92,63.2
Urgot,Singed,195,107,88,54.87
Urgot,Chogath,749,404,345,53.94
Urgot,Sion,516,268,248,51.94
Urgot,Riven,378,204,174,53.97
Urgot,Smolder,384,232,152,60.42
Urgot,Bard,213,121,92,56.81
Urgot,Syndra,331,189,142,57.1
Urgot,Draven,394,208,186,52.79
Urgot,Camille,219,146,73,66.67
Urgot,Annie,209,95,114,45.45
Urgot,Kaisa,1043,585,458,56.09
Urgot,Nocturne,866,438,428,50.58
Urgot,Sylas,776,394,382,50.77
Urgot,Malphite,680,354,326,52.06
Urgot,Varus,450,271,179,60.22
Urgot,Lulu,901,443,458,49.17
Urgot,Gragas,287,150,137,52.26
Urgot,MasterYi,888,495,393,55.74
Urgot,Heimerdinger,284,151,133,53.17
Urgot,Fizz,411,187,224,45.5
Urgot,Vayne,799,395,404,49.44
Urgot,Neeko,282,173,109,61.35
Urgot,Naafiri,245,137,108,55.92
Urgot,Zeri,249,136,113,54.62
Urgot,Poppy,312,154,158,49.36
Urgot,Illaoi,266,123,143,46.24
Urgot,Karthus,179,91,88,50.84
Urgot,Aurora,423,230,193,54.37
Urgot,Zoe,176,118,58,67.05
Urgot,Hwei,440,239,201,54.32
Urgot,Zilean,215,92,123,42.79
Urgot,Kalista,132,66,66,50
Urgot,Senna,521,293,228,56.24
Urgot,Pyke,487,249,238,51.13
Urgot,Shen,365,186,179,50.96
Urgot,Jax,513,252,261,49.12
Urgot,Irelia,497,284,213,57.14
Urgot,Shaco,596,281,315,47.15
Urgot,Skarner,125,84,41,67.2
Urgot,Jayce,239,136,103,56.9
Urgot,TwistedFate,236,117,119,49.58
Urgot,Kindred,273,136,137,49.82
Urgot,Khazix,328,190,138,57.93
Urgot,Tryndamere,406,216,190,53.2
Urgot,Velkoz,432,235,197,54.4
Urgot,Udyr,284,164,120,57.75
Urgot,Vex,318,149,169,46.86
Urgot,Leona,511,287,224,56.16
Urgot,Cassiopeia,145,66,79,45.52
Urgot,Rumble,149,91,58,61.07
Urgot,Rell,295,130,165,44.07
Urgot,Taric,129,76,53,58.91
Urgot,DrMundo,405,177,228,43.7
Urgot,Rammus,228,102,126,44.74
Urgot,Swain,621,317,304,51.05
Urgot,Maokai,289,162,127,56.06
Urgot,Kassadin,139,73,66,52.52
Urgot,Akshan,222,124,98,55.86
Urgot,Belveth,163,105,58,64.42
Urgot,Shyvana,191,127,64,66.49
Urgot,Renekton,296,143,153,48.31
Urgot,Nidalee,143,96,47,67.13
Urgot,Janna,247,136,111,55.06
Urgot,Orianna,279,149,130,53.41
Urgot,Nilah,209,105,104,50.24
Urgot,Evelynn,214,133,81,62.15
Urgot,Azir,184,107,77,58.15
Urgot,Ornn,262,120,142,45.8
Urgot,Aphelios,345,183,162,53.04
Urgot,Kled,134,73,61,54.48
Urgot,AurelionSol,314,167,147,53.18
Urgot,Zac,246,123,123,50
Urgot,RekSai,83,51,32,61.45
Bard,Warwick,496,209,287,42.14
Bard,Hecarim,237,117,120,49.37
Bard,Diana,636,334,302,52.52
Bard,Ziggs,109,61,48,55.96
Bard,Karma,595,329,266,55.29
Bard,Poppy,259,133,126,51.35
Bard,Taliyah,128,51,77,39.84
Bard,MissFortune,760,399,361,52.5
Bard,Morgana,341,162,179,47.51
Bard,Tryndamere,185,112,73,60.54
Bard,Kassadin,102,53,49,51.96
Bard,Ashe,771,381,390,49.42
Bard,Soraka,248,104,144,41.94
Bard,Darius,726,305,421,42.01
Bard,Braum,268,161,107,60.07
Bard,Aurora,305,158,147,51.8
Bard,Nunu,170,77,93,45.29
Bard,Gangplank,225,99,126,44
Bard,Qiyana,116,79,37,68.1
Bard,Xerath,357,200,157,56.02
Bard,Twitch,342,174,168,50.88
Bard,Lux,774,377,397,48.71
Bard,Nami,483,267,216,55.28
Bard,MasterYi,423,182,241,43.03
Bard,Vex,171,67,104,39.18
Bard,Kaisa,698,350,348,50.14
Bard,DrMundo,200,92,108,46
Bard,Jayce,260,135,125,51.92
Bard,Nocturne,466,257,209,55.15
Bard,Heimerdinger,131,51,80,38.93
Bard,Vayne,417,219,198,52.52
Bard,Irelia,339,180,159,53.1
Bard,Jinx,1088,536,552,49.26
Bard,Velkoz,229,124,105,54.15
Bard,LeeSin,653,393,260,60.18
Bard,Akali,350,175,175,50
Bard,Lucian,287,159,128,55.4
Bard,Yuumi,326,140,186,42.94
Bard,Garen,591,282,309,47.72
Bard,Shaco,344,183,161,53.2
Bard,Fizz,211,83,128,39.34
Bard,Caitlyn,976,443,533,45.39
Bard,Pantheon,642,316,326,49.22
Bard,Yorick,352,147,205,41.76
Bard,Ekko,397,170,227,42.82
Bard,Yone,613,315,298,51.39
Bard,Lulu,562,289,273,51.42
Bard,Shen,248,133,115,53.63
Bard,Kayn,551,278,273,50.45
Bard,Sylas,522,287,235,54.98
Bard,Zilean,194,88,106,45.36
Bard,Sett,462,221,241,47.84
Bard,Camille,194,107,87,55.15
Bard,Zac,162,75,87,46.3
Bard,Vladimir,227,98,129,43.17
Bard,Rakan,188,97,91,51.6
Bard,Volibear,437,227,210,51.95
Bard,Jax,391,211,180,53.96
Bard,Hwei,216,126,90,58.33
Bard,Pyke,288,154,134,53.47
Bard,Malzahar,362,181,181,50
Bard,Jhin,786,404,382,51.4
Bard,Aatrox,327,156,171,47.71
Bard,Xayah,156,79,77,50.64
Bard,TahmKench,239,116,123,48.54
Bard,Teemo,371,167,204,45.01
Bard,Sejuani,125,71,54,56.8
Bard,Katarina,266,116,150,43.61
Bard,Veigar,318,135,183,42.45
Bard,Ahri,550,284,266,51.64
Bard,Urgot,213,92,121,43.19
Bard,Senna,312,130,182,41.67
Bard,Briar,226,127,99,56.19
Bard,Azir,99,58,41,58.59
Bard,Nautilus,357,170,187,47.62
Bard,Lillia,243,137,106,56.38
Bard,Janna,194,73,121,37.63
Bard,Gragas,230,120,110,52.17
Bard,Kindred,142,39,103,27.46
Bard,Mel,745,407,338,54.63
Bard,Ambessa,250,108,142,43.2
Bard,Leona,292,147,145,50.34
Bard,Fiora,174,74,100,42.53
Bard,Viego,580,296,284,51.03
Bard,Kayle,253,119,134,47.04
Bard,Naafiri,117,55,62,47.01
Bard,Varus,326,168,158,51.53
Bard,Karthus,142,64,78,45.07
Bard,Ezreal,977,491,486,50.26
Bard,Brand,255,127,128,49.8
Bard,Viktor,359,171,188,47.63
Bard,Malphite,357,188,169,52.66
Bard,Elise,307,134,173,43.65
Bard,FiddleSticks,204,97,107,47.55
Bard,Zyra,417,204,213,48.92
Bard,Thresh,602,312,290,51.83
Bard,Skarner,72,42,30,58.33
Bard,Ivern,78,33,45,42.31
Bard,Sona,110,34,76,30.91
Bard,Gnar,165,98,67,59.39
Bard,JarvanIV,251,115,136,45.82
Bard,Orianna,230,117,113,50.87
Bard,Aphelios,193,99,94,51.3
Bard,Neeko,133,75,58,56.39
Bard,Vi,317,156,161,49.21
Bard,Sion,312,129,183,41.35
Bard,Graves,233,160,73,68.67
Bard,Swain,266,145,121,54.51
Bard,Seraphine,242,125,117,51.65
Bard,Cassiopeia,136,57,79,41.91
Bard,Gwen,219,116,103,52.97
Bard,Zed,369,191,178,51.76
Bard,Amumu,345,163,182,47.25
Bard,Syndra,293,130,163,44.37
Bard,Chogath,433,238,195,54.97
Bard,Trundle,190,84,106,44.21
Bard,MonkeyKing,271,126,145,46.49
Bard,Yasuo,713,360,353,50.49
Bard,Samira,243,95,148,39.09
Bard,Smolder,226,122,104,53.98
Bard,Mordekaiser,468,229,239,48.93
Bard,Talon,238,125,113,52.52
Bard,Zoe,157,73,84,46.5
Bard,Galio,305,146,159,47.87
Bard,Milio,224,93,131,41.52
Bard,Maokai,218,98,120,44.95
Bard,Zeri,177,89,88,50.28
Bard,AurelionSol,122,57,65,46.72
Bard,Renata,73,40,33,54.79
Bard,Ornn,159,80,79,50.31
Bard,Nilah,127,76,51,59.84
Bard,Singed,106,52,54,49.06
Bard,Belveth,82,43,39,52.44
Bard,TwistedFate,134,63,71,47.01
Bard,Nasus,265,129,136,48.68
Bard,Rumble,127,81,46,63.78
Bard,Kalista,106,61,45,57.55
Bard,Blitzcrank,218,92,126,42.2
Bard,Draven,195,103,92,52.82
Bard,Evelynn,126,82,44,65.08
Bard,Olaf,103,61,42,59.22
Bard,Leblanc,252,141,111,55.95
Bard,Rammus,99,32,67,32.32
Bard,Anivia,123,56,67,45.53
Bard,Sivir,195,74,121,37.95
Bard,Corki,190,93,97,48.95
Bard,Alistar,129,51,78,39.53
Bard,Rengar,108,48,60,44.44
Bard,Lissandra,126,37,89,29.37
Bard,KogMaw,113,43,70,38.05
Bard,Quinn,148,81,67,54.73
Bard,RekSai,53,27,26,50.94
Bard,Tristana,391,207,184,52.94
Bard,Rell,185,79,106,42.7
Bard,Riven,217,107,110,49.31
Bard,KSante,176,94,82,53.41
Bard,Udyr,152,57,95,37.5
Bard,Shyvana,102,56,46,54.9
Bard,Annie,98,48,50,48.98
Bard,Renekton,211,104,107,49.29
Bard,Taric,69,33,36,47.83
Bard,XinZhao,241,108,133,44.81
Bard,Illaoi,153,75,78,49.02
Bard,Kennen,93,58,35,62.37
Bard,Nidalee,109,61,48,55.96
Bard,Akshan,157,78,79,49.68
Bard,Khazix,173,106,67,61.27
Bard,Ryze,154,66,88,42.86
Bard,Kled,51,28,23,54.9
Kindred,Gwen,265,129,136,48.68
Kindred,Nocturne,734,360,374,49.05
Kindred,Veigar,592,302,290,51.01
Kindred,Jinx,1790,877,913,48.99
Kindred,Morgana,713,377,336,52.88
Kindred,Jayce,283,157,126,55.48
Kindred,Talon,336,176,160,52.38
Kindred,Kennen,134,60,74,44.78
Kindred,Lucian,373,177,196,47.45
Kindred,Elise,458,224,234,48.91
Kindred,Kayn,912,463,449,50.77
Kindred,Rammus,156,80,76,51.28
Kindred,Xerath,451,190,261,42.13
Kindred,Vayne,684,310,374,45.32
Kindred,Nami,627,305,322,48.64
Kindred,Kayle,437,184,253,42.11
Kindred,Nasus,391,172,219,43.99
Kindred,Anivia,154,80,74,51.95
Kindred,KogMaw,176,86,90,48.86
Kindred,Sett,822,409,413,49.76
Kindred,Shaco,588,277,311,47.11
Kindred,Ziggs,200,110,90,55
Kindred,Kaisa,1033,527,506,51.02
Kindred,MissFortune,1336,678,658,50.75
Kindred,Swain,641,334,307,52.11
Kindred,Irelia,491,237,254,48.27
Kindred,Heimerdinger,242,125,117,51.65
Kindred,Lux,1462,721,741,49.32
Kindred,Shen,354,162,192,45.76
Kindred,Udyr,237,119,118,50.21
Kindred,Xayah,225,120,105,53.33
Kindred,Pantheon,848,405,443,47.76
Kindred,Singed,154,73,81,47.4
Kindred,Graves,474,206,268,43.46
Kindred,Viktor,438,245,193,55.94
Kindred,Senna,442,237,205,53.62
Kindred,Ryze,192,81,111,42.19
Kindred,Khazix,285,161,124,56.49
Kindred,Yasuo,1040,475,565,45.67
Kindred,Ekko,575,321,254,55.83
Kindred,Sylas,825,443,382,53.7
Kindred,Blitzcrank,447,255,192,57.05
Kindred,Malphite,588,264,324,44.9
Kindred,Briar,380,141,239,37.11
Kindred,Diana,959,470,489,49.01
Kindred,Ezreal,1388,732,656,52.74
Kindred,Maokai,257,133,124,51.75
Kindred,Vladimir,407,199,208,48.89
Kindred,Viego,854,398,456,46.6
Kindred,Aurora,409,242,167,59.17
Kindred,Brand,428,185,243,43.22
Kindred,Caitlyn,1472,713,759,48.44
Kindred,Lulu,875,473,402,54.06
Kindred,MasterYi,690,325,365,47.1
Kindred,Mel,992,560,432,56.45
Kindred,Akali,542,253,289,46.68
Kindred,MonkeyKing,447,241,206,53.91
Kindred,Fizz,346,179,167,51.73
Kindred,Sona,175,90,85,51.43
Kindred,Gangplank,325,163,162,50.15
Kindred,Darius,1138,582,556,51.14
Kindred,TwistedFate,194,91,103,46.91
Kindred,Varus,467,253,214,54.18
Kindred,Zilean,168,67,101,39.88
Kindred,Mordekaiser,721,303,418,42.02
Kindred,Zed,610,338,272,55.41
Kindred,Pyke,461,214,247,46.42
Kindred,Gragas,342,203,139,59.36
Kindred,Warwick,795,395,400,49.69
Kindred,Yone,1014,560,454,55.23
Kindred,Milio,326,135,191,41.41
Kindred,FiddleSticks,280,139,141,49.64
Kindred,Jax,523,289,234,55.26
Kindred,Ahri,759,400,359,52.7
Kindred,Ashe,1170,576,594,49.23
Kindred,Teemo,671,324,347,48.29
Kindred,TahmKench,387,178,209,45.99
Kindred,Orianna,243,148,95,60.91
Kindred,Nautilus,705,379,326,53.76
Kindred,Amumu,618,282,336,45.63
Kindred,Draven,285,162,123,56.84
Kindred,Leona,458,218,240,47.6
Kindred,Vi,477,241,236,50.52
Kindred,Thresh,804,402,402,50
Kindred,Ambessa,299,130,169,43.48
Kindred,Sejuani,227,112,115,49.34
Kindred,Tristana,550,289,261,52.55
Kindred,Tryndamere,366,192,174,52.46
Kindred,Qiyana,141,81,60,57.45
Kindred,Cassiopeia,168,79,89,47.02
Kindred,Illaoi,241,127,114,52.7
Kindred,Bard,142,103,39,72.54
Kindred,Jhin,1130,524,606,46.37
Kindred,Sivir,304,152,152,50
Kindred,LeeSin,878,433,445,49.32
Kindred,Janna,181,74,107,40.88
Kindred,Skarner,153,72,81,47.06
Kindred,Leblanc,423,213,210,50.35
Kindred,Garen,1024,518,506,50.59
Kindred,Nunu,336,125,211,37.2
Kindred,Chogath,624,295,329,47.28
Kindred,Kalista,138,71,67,51.45
Kindred,Braum,297,128,169,43.1
Kindred,Volibear,599,331,268,55.26
Kindred,Malzahar,619,268,351,43.3
Kindred,XinZhao,362,171,191,47.24
Kindred,Aatrox,515,262,253,50.87
Kindred,Azir,200,95,105,47.5
Kindred,Rell,250,111,139,44.4
Kindred,JarvanIV,386,190,196,49.22
Kindred,Evelynn,189,96,93,50.79
Kindred,Hwei,359,177,182,49.3
Kindred,Yorick,563,265,298,47.07
Kindred,Olaf,141,81,60,57.45
Kindred,Galio,558,275,283,49.28
Kindred,Akshan,186,101,85,54.3
Kindred,Velkoz,320,162,158,50.63
Kindred,Katarina,386,217,169,56.22
Kindred,Renekton,242,115,127,47.52
Kindred,Rumble,165,94,71,56.97
Kindred,KSante,358,217,141,60.61
Kindred,Annie,173,94,79,54.34
Kindred,Urgot,273,137,136,50.18
Kindred,Twitch,483,240,243,49.69
Kindred,Sion,447,220,227,49.22
Kindred,Taliyah,149,52,97,34.9
Kindred,DrMundo,310,125,185,40.32
Kindred,Lillia,319,171,148,53.61
Kindred,Camille,198,99,99,50
Kindred,Neeko,255,132,123,51.76
Kindred,Seraphine,393,189,204,48.09
Kindred,Syndra,337,160,177,47.48
Kindred,Karthus,180,81,99,45
Kindred,Karma,696,331,365,47.56
Kindred,Soraka,318,146,172,45.91
Kindred,Poppy,351,192,159,54.7
Kindred,Trundle,355,173,182,48.73
Kindred,Naafiri,191,106,85,55.5
Kindred,Gnar,212,114,98,53.77
Kindred,Quinn,199,105,94,52.76
Kindred,Smolder,302,156,146,51.66
Kindred,Rengar,178,119,59,66.85
Kindred,RekSai,85,54,31,63.53
Kindred,Rakan,186,90,96,48.39
Kindred,Belveth,146,71,75,48.63
Kindred,Aphelios,313,156,157,49.84
Kindred,Ornn,245,114,131,46.53
Kindred,Zeri,240,143,97,59.58
Kindred,AurelionSol,188,96,92,51.06
Kindred,Hecarim,286,138,148,48.25
Kindred,Kassadin,107,66,41,61.68
Kindred,Fiora,195,113,82,57.95
Kindred,Nilah,162,71,91,43.83
Kindred,Riven,281,136,145,48.4
Kindred,Alistar,235,98,137,41.7
Kindred,Vex,302,148,154,49.01
Kindred,Zyra,497,249,248,50.1
Kindred,Renata,97,61,36,62.89
Kindred,Lissandra,163,77,86,47.24
Kindred,Corki,252,127,125,50.4
Kindred,Ivern,103,50,53,48.54
Kindred,Yuumi,460,227,233,49.35
Kindred,Taric,69,25,44,36.23
Kindred,Samira,367,177,190,48.23
Kindred,Shyvana,142,82,60,57.75
Kindred,Zoe,172,87,85,50.58
Kindred,Kled,105,49,56,46.67
Kindred,Zac,283,150,133,53
Kindred,Nidalee,178,102,76,57.3
Neeko,Gwen,285,134,151,47.02
Neeko,Nocturne,680,310,370,45.59
Neeko,Veigar,581,276,305,47.5
Neeko,Jinx,1564,748,816,47.83
Neeko,Morgana,734,424,310,57.77
Neeko,Malzahar,551,235,316,42.65
Neeko,Sejuani,190,100,90,52.63
Neeko,Jayce,304,192,112,63.16
Neeko,Jhin,1083,517,566,47.74
Neeko,Thresh,696,353,343,50.72
Neeko,Riven,231,112,119,48.48
Neeko,Nilah,184,78,106,42.39
Neeko,Lissandra,263,127,136,48.29
Neeko,Teemo,850,390,460,45.88
Neeko,Pantheon,882,466,416,52.83
Neeko,Orianna,224,99,125,44.2
Neeko,Tristana,601,343,258,57.07
Neeko,Lux,1664,789,875,47.42
Neeko,Mordekaiser,746,376,370,50.4
Neeko,LeeSin,770,432,338,56.1
Neeko,Zed,567,307,260,54.14
Neeko,Ezreal,1351,686,665,50.78
Neeko,Lulu,691,319,372,46.16
Neeko,MonkeyKing,378,169,209,44.71
Neeko,Yasuo,1011,498,513,49.26
Neeko,Yorick,563,264,299,46.89
Neeko,Warwick,816,386,430,47.3
Neeko,Hwei,382,178,204,46.6
Neeko,Caitlyn,1534,799,735,52.09
Neeko,Seraphine,525,246,279,46.86
Neeko,Vladimir,342,159,183,46.49
Neeko,TwistedFate,181,82,99,45.3
Neeko,Xayah,232,117,115,50.43
Neeko,Trundle,323,162,161,50.15
Neeko,Ekko,494,259,235,52.43
Neeko,Syndra,329,173,156,52.58
Neeko,Camille,175,83,92,47.43
Neeko,Belveth,93,46,47,49.46
Neeko,Smolder,259,121,138,46.72
Neeko,Zyra,622,290,332,46.62
Neeko,Garen,864,422,442,48.84
Neeko,Briar,373,188,185,50.4
Neeko,Akali,651,321,330,49.31
Neeko,MissFortune,1575,742,833,47.11
Neeko,TahmKench,420,205,215,48.81
Neeko,Sett,844,406,438,48.1
Neeko,Shaco,538,279,259,51.86
Neeko,Irelia,515,234,281,45.44
Neeko,Karma,671,358,313,53.35
Neeko,RekSai,71,37,34,52.11
Neeko,Darius,1127,511,616,45.34
Neeko,Draven,286,156,130,54.55
Neeko,Swain,560,253,307,45.18
Neeko,Malphite,586,290,296,49.49
Neeko,Tryndamere,346,188,158,54.34
Neeko,Udyr,213,89,124,41.78
Neeko,Poppy,300,138,162,46
Neeko,Khazix,262,130,132,49.62
Neeko,Zilean,171,58,113,33.92
Neeko,Ahri,744,361,383,48.52
Neeko,Rengar,162,92,70,56.79
Neeko,Ryze,151,83,68,54.97
Neeko,Ashe,1227,595,632,48.49
Neeko,Milio,285,124,161,43.51
Neeko,Yone,1117,597,520,53.45
Neeko,Nidalee,220,102,118,46.36
Neeko,MasterYi,796,376,420,47.24
Neeko,Naafiri,180,84,96,46.67
Neeko,Nautilus,583,307,276,52.66
Neeko,Volibear,643,298,345,46.35
Neeko,Leona,469,244,225,52.03
Neeko,Brand,523,257,266,49.14
Neeko,Shen,364,198,166,54.4
Neeko,Amumu,627,305,322,48.64
Neeko,Kalista,130,54,76,41.54
Neeko,Soraka,275,118,157,42.91
Neeko,Sion,368,168,200,45.65
Neeko,Corki,224,112,112,50
Neeko,Pyke,447,230,217,51.45
Neeko,Rell,271,124,147,45.76
Neeko,Gnar,222,125,97,56.31
Neeko,Jax,569,277,292,48.68
Neeko,Viego,908,462,446,50.88
Neeko,Kassadin,115,68,47,59.13
Neeko,Blitzcrank,384,185,199,48.18
Neeko,Taliyah,127,57,70,44.88
Neeko,Renekton,271,150,121,55.35
Neeko,Velkoz,308,128,180,41.56
Neeko,Rammus,183,83,100,45.36
Neeko,Vayne,726,346,380,47.66
Neeko,Kled,91,50,41,54.95
Neeko,Nasus,395,155,240,39.24
Neeko,Kayn,739,348,391,47.09
Neeko,Leblanc,349,176,173,50.43
Neeko,Zac,215,83,132,38.6
Neeko,Maokai,301,151,150,50.17
Neeko,Vex,333,155,178,46.55
Neeko,Gangplank,313,157,156,50.16
Neeko,Varus,485,237,248,48.87
Neeko,Janna,194,91,103,46.91
Neeko,Aurora,432,229,203,53.01
Neeko,Diana,934,450,484,48.18
Neeko,Hecarim,230,106,124,46.09
Neeko,Aphelios,237,128,109,54.01
Neeko,Yuumi,397,202,195,50.88
Neeko,Kayle,329,144,185,43.77
Neeko,Kaisa,873,447,426,51.2
Neeko,Vi,524,299,225,57.06
Neeko,AurelionSol,222,92,130,41.44
Neeko,Fiora,162,85,77,52.47
Neeko,Sylas,865,413,452,47.75
Neeko,Anivia,175,80,95,45.71
Neeko,Alistar,210,116,94,55.24
Neeko,Urgot,282,109,173,38.65
Neeko,Fizz,362,168,194,46.41
Neeko,Rakan,217,123,94,56.68
Neeko,Bard,133,58,75,43.61
Neeko,Chogath,638,301,337,47.18
Neeko,Mel,1124,574,550,51.07
Neeko,Kennen,180,63,117,35
Neeko,DrMundo,311,159,152,51.13
Neeko,Karthus,193,71,122,36.79
Neeko,Senna,408,196,212,48.04
Neeko,Nunu,379,202,177,53.3
Neeko,Zoe,207,86,121,41.55
Neeko,Katarina,398,187,211,46.98
Neeko,Ornn,205,87,118,42.44
Neeko,Galio,515,242,273,46.99
Neeko,Sivir,297,117,180,39.39
Neeko,Gragas,271,154,117,56.83
Neeko,Aatrox,455,216,239,47.47
Neeko,Viktor,471,232,239,49.26
Neeko,Braum,265,120,145,45.28
Neeko,KogMaw,172,84,88,48.84
Neeko,Kindred,255,123,132,48.24
Neeko,Ziggs,143,64,79,44.76
Neeko,Shyvana,132,71,61,53.79
Neeko,FiddleSticks,260,117,143,45
Neeko,Evelynn,181,84,97,46.41
Neeko,Nami,521,243,278,46.64
Neeko,Heimerdinger,337,160,177,47.48
Neeko,JarvanIV,249,121,128,48.59
Neeko,Twitch,417,198,219,47.48
Neeko,Ambessa,365,194,171,53.15
Neeko,Elise,392,189,203,48.21
Neeko,Xerath,526,219,307,41.63
Neeko,Qiyana,109,66,43,60.55
Neeko,Talon,326,125,201,38.34
Neeko,Samira,423,240,183,56.74
Neeko,Quinn,181,93,88,51.38
Neeko,Singed,163,85,78,52.15
Neeko,KSante,328,142,186,43.29
Neeko,Rumble,116,76,40,65.52
Neeko,Ivern,70,32,38,45.71
Neeko,Akshan,198,102,96,51.52
Neeko,Sona,178,105,73,58.99
Neeko,Lucian,386,189,197,48.96
Neeko,Annie,170,78,92,45.88
Neeko,Graves,322,176,146,54.66
Neeko,Lillia,326,145,181,44.48
Neeko,Cassiopeia,158,72,86,45.57
Neeko,Olaf,150,87,63,58
Neeko,Illaoi,279,107,172,38.35
Neeko,Renata,103,58,45,56.31
Neeko,Zeri,209,105,104,50.24
Neeko,Skarner,159,79,80,49.69
Neeko,Azir,135,63,72,46.67
Neeko,XinZhao,355,177,178,49.86
Neeko,Taric,87,47,40,54.02
Twitch,Darius,2002,1005,997,50.2
Twitch,Khazix,519,268,251,51.64
Twitch,Zed,1207,659,548,54.6
Twitch,Aphelios,487,251,236,51.54
Twitch,Pyke,701,359,342,51.21
Twitch,Volibear,1217,606,611,49.79
Twitch,Lux,2605,1220,1385,46.83
Twitch,Ezreal,2124,1104,1020,51.98
Twitch,Velkoz,626,301,325,48.08
Twitch,Jax,862,434,428,50.35
Twitch,Warwick,1604,807,797,50.31
Twitch,Galio,854,440,414,51.52
Twitch,Nami,1231,618,613,50.2
Twitch,Mordekaiser,1380,636,744,46.09
Twitch,Talon,571,300,271,52.54
Twitch,Yasuo,1983,947,1036,47.76
Twitch,Caitlyn,2849,1331,1518,46.72
Twitch,Alistar,383,217,166,56.66
Twitch,Sett,1554,699,855,44.98
Twitch,Rengar,358,159,199,44.41
Twitch,Aurora,727,354,373,48.69
Twitch,Bard,342,168,174,49.12
Twitch,Malphite,1097,496,601,45.21
Twitch,Shaco,1041,501,540,48.13
Twitch,Pantheon,1560,776,784,49.74
Twitch,Jinx,3876,1969,1907,50.8
Twitch,Lulu,1497,767,730,51.24
Twitch,Garen,1616,799,817,49.44
Twitch,MasterYi,1348,690,658,51.19
Twitch,Sylas,1240,674,566,54.35
Twitch,Mel,2073,1031,1042,49.73
Twitch,Zilean,370,151,219,40.81
Twitch,JarvanIV,673,268,405,39.82
Twitch,Lucian,717,354,363,49.37
Twitch,Lillia,557,263,294,47.22
Twitch,Tristana,1158,549,609,47.41
Twitch,Smolder,672,374,298,55.65
Twitch,Teemo,1255,600,655,47.81
Twitch,Brand,758,367,391,48.42
Twitch,Sona,316,177,139,56.01
Twitch,Akali,918,421,497,45.86
Twitch,Viktor,918,452,466,49.24
Twitch,Leona,748,381,367,50.94
Twitch,Heimerdinger,434,209,225,48.16
Twitch,Amumu,1113,505,608,45.37
Twitch,Kayle,783,360,423,45.98
Twitch,RekSai,131,65,66,49.62
Twitch,Vladimir,714,369,345,51.68
Twitch,Draven,580,281,299,48.45
Twitch,Swain,1017,504,513,49.56
Twitch,TahmKench,797,381,416,47.8
Twitch,Morgana,1164,617,547,53.01
Twitch,KogMaw,436,239,197,54.82
Twitch,Ekko,977,468,509,47.9
Twitch,Kaisa,1618,870,748,53.77
Twitch,Rell,495,199,296,40.2
Twitch,DrMundo,593,267,326,45.03
Twitch,MissFortune,2373,1142,1231,48.12
Twitch,Karma,1219,642,577,52.67
Twitch,Quinn,376,194,182,51.6
Twitch,Elise,685,349,336,50.95
Twitch,Ryze,378,196,182,51.85
Twitch,Taliyah,260,123,137,47.31
Twitch,Katarina,796,375,421,47.11
Twitch,Sejuani,353,181,172,51.27
Twitch,Shyvana,275,151,124,54.91
Twitch,Renekton,533,272,261,51.03
Twitch,FiddleSticks,564,292,272,51.77
Twitch,Seraphine,794,391,403,49.24
Twitch,Ambessa,591,331,260,56.01
Twitch,Veigar,971,529,442,54.48
Twitch,Yorick,1011,514,497,50.84
Twitch,Vex,511,271,240,53.03
Twitch,Shen,609,289,320,47.45
Twitch,Vi,871,399,472,45.81
Twitch,Leblanc,592,287,305,48.48
Twitch,MonkeyKing,785,351,434,44.71
Twitch,Malzahar,1155,570,585,49.35
Twitch,Jhin,2088,980,1108,46.93
Twitch,Urgot,617,301,316,48.78
Twitch,Graves,646,299,347,46.28
Twitch,Singed,304,140,164,46.05
Twitch,Samira,667,299,368,44.83
Twitch,LeeSin,1296,656,640,50.62
Twitch,Braum,555,255,300,45.95
Twitch,Fiora,399,229,170,57.39
Twitch,Naafiri,322,136,186,42.24
Twitch,AurelionSol,386,179,207,46.37
Twitch,Gnar,396,214,182,54.04
Twitch,Vayne,1464,734,730,50.14
Twitch,Maokai,425,198,227,46.59
Twitch,Ashe,2047,1028,1019,50.22
Twitch,Blitzcrank,665,319,346,47.97
Twitch,Poppy,544,270,274,49.63
Twitch,Nocturne,1362,629,733,46.18
Twitch,Fizz,653,309,344,47.32
Twitch,Soraka,607,295,312,48.6
Twitch,Gragas,592,288,304,48.65
Twitch,Varus,895,451,444,50.39
Twitch,Rammus,316,166,150,52.53
Twitch,Kled,173,78,95,45.09
Twitch,Illaoi,433,201,232,46.42
Twitch,Zyra,935,450,485,48.13
Twitch,Sion,783,375,408,47.89
Twitch,Zac,411,211,200,51.34
Twitch,Nasus,639,299,340,46.79
Twitch,Annie,297,148,149,49.83
Twitch,Karthus,303,174,129,57.43
Twitch,Sivir,470,209,261,44.47
Twitch,Yuumi,856,396,460,46.26
Twitch,Yone,1676,863,813,51.49
Twitch,Milio,716,365,351,50.98
Twitch,Diana,1721,861,860,50.03
Twitch,Irelia,772,370,402,47.93
Twitch,Viego,1306,662,644,50.69
Twitch,Hecarim,433,222,211,51.27
Twitch,Nautilus,1012,508,504,50.2
Twitch,Orianna,450,227,223,50.44
Twitch,Ivern,124,64,60,51.61
Twitch,Kassadin,240,129,111,53.75
Twitch,Taric,245,92,153,37.55
Twitch,Corki,509,289,220,56.78
Twitch,Thresh,1244,622,622,50
Twitch,Kayn,1552,708,844,45.62
Twitch,Nunu,535,248,287,46.36
Twitch,Ziggs,344,196,148,56.98
Twitch,Qiyana,245,143,102,58.37
Twitch,Jayce,299,170,129,56.86
Twitch,Ornn,438,211,227,48.17
Twitch,Zoe,407,184,223,45.21
Twitch,Syndra,743,351,392,47.24
Twitch,Senna,778,401,377,51.54
Twitch,TwistedFate,399,208,191,52.13
Twitch,Gangplank,541,273,268,50.46
Twitch,KSante,521,273,248,52.4
Twitch,Briar,725,390,335,53.79
Twitch,Evelynn,393,226,167,57.51
Twitch,Ahri,1282,613,669,47.82
Twitch,Nilah,349,165,184,47.28
Twitch,Olaf,211,118,93,55.92
Twitch,Kennen,311,160,151,51.45
Twitch,Aatrox,884,436,448,49.32
Twitch,Renata,197,80,117,40.61
Twitch,Riven,486,239,247,49.18
Twitch,Camille,430,223,207,51.86
Twitch,Azir,369,217,152,58.81
Twitch,Gwen,506,245,261,48.42
Twitch,Tryndamere,566,279,287,49.29
Twitch,Anivia,344,173,171,50.29
Twitch,Janna,385,184,201,47.79
Twitch,Trundle,613,273,340,44.54
Twitch,Hwei,627,330,297,52.63
Twitch,XinZhao,633,306,327,48.34
Twitch,Rumble,241,110,131,45.64
Twitch,Skarner,259,153,106,59.07
Twitch,Kindred,483,243,240,50.31
Twitch,Xerath,814,407,407,50
Twitch,Lissandra,379,188,191,49.6
Twitch,Rakan,358,161,197,44.97
Twitch,Neeko,417,219,198,52.52
Twitch,Cassiopeia,338,137,201,40.53
Twitch,Xayah,442,218,224,49.32
Twitch,Chogath,1271,594,677,46.73
Twitch,Zeri,363,191,172,52.62
Twitch,Kalista,197,107,90,54.31
Twitch,Akshan,339,167,172,49.26
Twitch,Belveth,196,123,73,62.76
Twitch,Udyr,455,190,265,41.76
Twitch,Nidalee,233,133,100,57.08
Aphelios,Trundle,328,147,181,44.82
Aphelios,Malphite,697,323,374,46.34
Aphelios,Hwei,521,272,249,52.21
Aphelios,Twitch,487,236,251,48.46
Aphelios,Milio,449,216,233,48.11
Aphelios,Yorick,656,318,338,48.48
Aphelios,JarvanIV,384,184,200,47.92
Aphelios,Mel,1339,672,667,50.19
Aphelios,Jinx,2391,1151,1240,48.14
Aphelios,Lux,1530,678,852,44.31
Aphelios,Sett,929,414,515,44.56
Aphelios,Evelynn,268,151,117,56.34
Aphelios,Vex,332,142,190,42.77
Aphelios,MissFortune,1387,677,710,48.81
Aphelios,Xerath,562,270,292,48.04
Aphelios,Gangplank,425,228,197,53.65
Aphelios,Qiyana,194,108,86,55.67
Aphelios,Olaf,165,90,75,54.55
Aphelios,Pantheon,1004,523,481,52.09
Aphelios,Leblanc,417,181,236,43.41
Aphelios,Karma,833,358,475,42.98
Aphelios,Udyr,214,92,122,42.99
Aphelios,Malzahar,755,381,374,50.46
Aphelios,Jhin,1437,685,752,47.67
Aphelios,Morgana,741,399,342,53.85
Aphelios,Rammus,188,91,97,48.4
Aphelios,Zed,672,380,292,56.55
Aphelios,Sylas,856,474,382,55.37
Aphelios,Tristana,638,311,327,48.75
Aphelios,Swain,617,272,345,44.08
Aphelios,Volibear,741,383,358,51.69
Aphelios,Yasuo,1292,609,683,47.14
Aphelios,Ashe,1283,635,648,49.49
Aphelios,Lulu,1087,545,542,50.14
Aphelios,Gnar,242,129,113,53.31
Aphelios,Nidalee,190,113,77,59.47
Aphelios,Draven,348,180,168,51.72
Aphelios,Ornn,317,164,153,51.74
Aphelios,Nocturne,859,387,472,45.05
Aphelios,Seraphine,486,244,242,50.21
Aphelios,Ryze,188,107,81,56.91
Aphelios,Mordekaiser,906,466,440,51.43
Aphelios,Soraka,381,167,214,43.83
Aphelios,Gwen,364,172,192,47.25
Aphelios,Varus,615,296,319,48.13
Aphelios,Vladimir,464,247,217,53.23
Aphelios,Ezreal,1661,800,861,48.16
Aphelios,Braum,416,212,204,50.96
Aphelios,Fiora,266,137,129,51.5
Aphelios,Amumu,665,345,320,51.88
Aphelios,Talon,384,204,180,53.13
Aphelios,MasterYi,752,379,373,50.4
Aphelios,Garen,1076,548,528,50.93
Aphelios,Quinn,215,111,104,51.63
Aphelios,Shaco,607,314,293,51.73
Aphelios,Lissandra,231,103,128,44.59
Aphelios,Chogath,771,350,421,45.4
Aphelios,Teemo,796,347,449,43.59
Aphelios,Aatrox,583,314,269,53.86
Aphelios,Lillia,410,210,200,51.22
Aphelios,Irelia,572,271,301,47.38
Aphelios,Sejuani,264,138,126,52.27
Aphelios,Caitlyn,1921,1002,919,52.16
Aphelios,Brand,467,252,215,53.96
Aphelios,Zilean,235,125,110,53.19
Aphelios,Kayle,468,175,293,37.39
Aphelios,LeeSin,1001,509,492,50.85
Aphelios,Akali,628,333,295,53.03
Aphelios,Kaisa,1154,574,580,49.74
Aphelios,Ekko,695,365,330,52.52
Aphelios,Tryndamere,340,171,169,50.29
Aphelios,Nunu,289,145,144,50.17
Aphelios,Aurora,470,228,242,48.51
Aphelios,Viego,913,465,448,50.93
Aphelios,Cassiopeia,204,111,93,54.41
Aphelios,Blitzcrank,491,226,265,46.03
Aphelios,Poppy,404,220,184,54.46
Aphelios,Shyvana,148,77,71,52.03
Aphelios,Jax,600,258,342,43
Aphelios,Viktor,619,288,331,46.53
Aphelios,Sivir,346,155,191,44.8
Aphelios,Velkoz,398,191,207,47.99
Aphelios,Warwick,886,422,464,47.63
Aphelios,Syndra,463,226,237,48.81
Aphelios,Galio,545,280,265,51.38
Aphelios,Yone,1163,624,539,53.65
Aphelios,Nautilus,751,389,362,51.8
Aphelios,Taliyah,201,87,114,43.28
Aphelios,Maokai,273,130,143,47.62
Aphelios,Zyra,657,332,325,50.53
Aphelios,Neeko,237,109,128,45.99
Aphelios,Ahri,854,413,441,48.36
Aphelios,Khazix,407,231,176,56.76
Aphelios,Diana,1143,571,572,49.96
Aphelios,Rakan,286,135,151,47.2
Aphelios,Sona,192,100,92,52.08
Aphelios,KSante,383,184,199,48.04
Aphelios,Lucian,422,221,201,52.37
Aphelios,Vayne,835,443,392,53.05
Aphelios,Naafiri,185,106,79,57.3
Aphelios,Kassadin,107,66,41,61.68
Aphelios,Senna,521,253,268,48.56
Aphelios,Shen,410,180,230,43.9
Aphelios,Kayn,935,446,489,47.7
Aphelios,Veigar,650,280,370,43.08
Aphelios,Rell,375,188,187,50.13
Aphelios,Graves,469,239,230,50.96
Aphelios,Corki,291,160,131,54.98
Aphelios,Darius,1313,641,672,48.82
Aphelios,Elise,455,250,205,54.95
Aphelios,Yuumi,616,332,284,53.9
Aphelios,Katarina,536,266,270,49.63
Aphelios,KogMaw,175,103,72,58.86
Aphelios,Ambessa,426,246,180,57.75
Aphelios,TwistedFate,241,101,140,41.91
Aphelios,Gragas,374,193,181,51.6
Aphelios,Taric,144,61,83,42.36
Aphelios,Illaoi,290,178,112,61.38
Aphelios,Nasus,463,228,235,49.24
Aphelios,Karthus,200,109,91,54.5
Aphelios,Azir,238,138,100,57.98
Aphelios,Alistar,214,105,109,49.07
Aphelios,Nami,756,350,406,46.3
Aphelios,Anivia,261,146,115,55.94
Aphelios,Smolder,445,255,190,57.3
Aphelios,Kled,135,66,69,48.89
Aphelios,Thresh,942,477,465,50.64
Aphelios,Bard,193,94,99,48.7
Aphelios,Ziggs,191,80,111,41.88
Aphelios,TahmKench,480,268,212,55.83
Aphelios,Kalista,165,94,71,56.97
Aphelios,XinZhao,466,266,200,57.08
Aphelios,Samira,376,179,197,47.61
Aphelios,Riven,362,206,156,56.91
Aphelios,Heimerdinger,275,123,152,44.73
Aphelios,Camille,214,111,103,51.87
Aphelios,Annie,218,119,99,54.59
Aphelios,Pyke,484,250,234,51.65
Aphelios,Vi,551,289,262,52.45
Aphelios,Orianna,293,134,159,45.73
Aphelios,Xayah,256,147,109,57.42
Aphelios,Briar,461,204,257,44.25
Aphelios,DrMundo,350,172,178,49.14
Aphelios,MonkeyKing,457,204,253,44.64
Aphelios,Belveth,126,59,67,46.83
Aphelios,Zac,337,165,172,48.96
Aphelios,Akshan,258,123,135,47.67
Aphelios,Hecarim,297,136,161,45.79
Aphelios,Singed,204,102,102,50
Aphelios,Kennen,163,91,72,55.83
Aphelios,Skarner,181,86,95,47.51
Aphelios,Kindred,313,157,156,50.16
Aphelios,Zoe,243,120,123,49.38
Aphelios,Nilah,236,122,114,51.69
Aphelios,Rengar,187,98,89,52.41
Aphelios,Janna,238,130,108,54.62
Aphelios,Rumble,171,72,99,42.11
Aphelios,Zeri,363,196,167,53.99
Aphelios,FiddleSticks,360,180,180,50
Aphelios,Leona,558,294,264,52.69
Aphelios,Fizz,337,179,158,53.12
Aphelios,AurelionSol,269,138,131,51.3
Aphelios,Sion,581,246,335,42.34
Aphelios,Urgot,345,162,183,46.96
Aphelios,Renekton,325,168,157,51.69
Aphelios,Ivern,105,40,65,38.1
Aphelios,RekSai,98,28,70,28.57
Aphelios,Jayce,288,123,165,42.71
Aphelios,Renata,126,79,47,62.7
Fizz,Azir,192,94,98,48.96
Fizz,Nocturne,988,471,517,47.67
Fizz,Syndra,550,295,255,53.64
Fizz,Jhin,1532,818,714,53.39
Fizz,Senna,590,316,274,53.56
Fizz,Malzahar,892,424,468,47.53
Fizz,Sejuani,335,165,170,49.25
Fizz,Jayce,299,123,176,41.14
Fizz,Thresh,973,485,488,49.85
Fizz,Singed,184,83,101,45.11
Fizz,Shaco,775,386,389,49.81
Fizz,Hwei,472,254,218,53.81
Fizz,Janna,232,122,110,52.59
Fizz,Fiora,245,120,125,48.98
Fizz,Warwick,1170,554,616,47.35
Fizz,Zed,1048,523,525,49.9
Fizz,Swain,705,345,360,48.94
Fizz,Chogath,865,433,432,50.06
Fizz,Kayle,548,266,282,48.54
Fizz,Darius,1513,711,802,46.99
Fizz,Malphite,764,388,376,50.79
Fizz,Ezreal,1610,787,823,48.88
Fizz,Nami,749,338,411,45.13
Fizz,Sett,1083,494,589,45.61
Fizz,Evelynn,278,160,118,57.55
Fizz,Vex,378,191,187,50.53
Fizz,MissFortune,2000,916,1084,45.8
Fizz,Xerath,741,365,376,49.26
Fizz,Kennen,174,80,94,45.98
Fizz,Lux,2178,1106,1072,50.78
Fizz,Caitlyn,2096,997,1099,47.57
Fizz,Zyra,720,382,338,53.06
Fizz,Yone,1264,734,530,58.07
Fizz,Nunu,368,186,182,50.54
Fizz,Qiyana,154,81,73,52.6
Fizz,Jinx,2095,1052,1043,50.21
Fizz,Morgana,965,485,480,50.26
Fizz,Yorick,740,330,410,44.59
Fizz,Lillia,384,186,198,48.44
Fizz,Xayah,362,190,172,52.49
Fizz,Yuumi,515,261,254,50.68
Fizz,Mordekaiser,985,422,563,42.84
Fizz,Kayn,1127,562,565,49.87
Fizz,Aurora,446,226,220,50.67
Fizz,Varus,617,323,294,52.35
Fizz,Ekko,777,391,386,50.32
Fizz,Mel,2063,1086,977,52.64
Fizz,Trundle,438,228,210,52.05
Fizz,Graves,495,252,243,50.91
Fizz,Veigar,1022,498,524,48.73
Fizz,LeeSin,901,463,438,51.39
Fizz,Nilah,216,100,116,46.3
Fizz,Braum,363,143,220,39.39
Fizz,Garen,1314,639,675,48.63
Fizz,Nidalee,195,106,89,54.36
Fizz,Vayne,1057,514,543,48.63
Fizz,Leblanc,437,217,220,49.66
Fizz,Pyke,544,285,259,52.39
Fizz,Vladimir,567,252,315,44.44
Fizz,Katarina,551,284,267,51.54
Fizz,Alistar,316,156,160,49.37
Fizz,Anivia,238,105,133,44.12
Fizz,Diana,1212,573,639,47.28
Fizz,AurelionSol,317,170,147,53.63
Fizz,Kaisa,1242,620,622,49.92
Fizz,Galio,691,333,358,48.19
Fizz,KSante,342,157,185,45.91
Fizz,Taliyah,143,60,83,41.96
Fizz,Sona,263,94,169,35.74
Fizz,TahmKench,579,267,312,46.11
Fizz,Kassadin,196,89,107,45.41
Fizz,Ambessa,430,242,188,56.28
Fizz,Briar,519,264,255,50.87
Fizz,Lucian,534,289,245,54.12
Fizz,Leona,704,329,375,46.73
Fizz,Heimerdinger,379,161,218,42.48
Fizz,Sylas,899,393,506,43.72
Fizz,Irelia,568,272,296,47.89
Fizz,Bard,211,128,83,60.66
Fizz,Gangplank,411,222,189,54.01
Fizz,Jax,727,398,329,54.75
Fizz,Velkoz,523,260,263,49.71
Fizz,MonkeyKing,574,262,312,45.64
Fizz,Akali,790,393,397,49.75
Fizz,Rengar,271,142,129,52.4
Fizz,Belveth,164,103,61,62.8
Fizz,Nasus,573,247,326,43.11
Fizz,Ziggs,306,152,154,49.67
Fizz,Brand,698,388,310,55.59
Fizz,Udyr,279,124,155,44.44
Fizz,Kled,144,66,78,45.83
Fizz,Volibear,860,383,477,44.53
Fizz,Kindred,346,167,179,48.27
Fizz,Poppy,412,184,228,44.66
Fizz,JarvanIV,494,268,226,54.25
Fizz,Gnar,283,156,127,55.12
Fizz,Twitch,653,344,309,52.68
Fizz,Yasuo,1505,717,788,47.64
Fizz,Rakan,218,91,127,41.74
Fizz,Gragas,365,169,196,46.3
Fizz,Teemo,1014,506,508,49.9
Fizz,Soraka,381,191,190,50.13
Fizz,Riven,340,186,154,54.71
Fizz,Gwen,342,172,170,50.29
Fizz,Viego,1053,550,503,52.23
Fizz,KogMaw,235,128,107,54.47
Fizz,Blitzcrank,461,228,233,49.46
Fizz,Lulu,873,419,454,48
Fizz,Ahri,929,508,421,54.68
Fizz,Tristana,681,315,366,46.26
Fizz,Nautilus,821,399,422,48.6
Fizz,DrMundo,418,200,218,47.85
Fizz,Sion,519,246,273,47.4
Fizz,Annie,208,119,89,57.21
Fizz,Khazix,327,195,132,59.63
Fizz,Shen,499,231,268,46.29
Fizz,Maokai,290,152,138,52.41
Fizz,Taric,155,88,67,56.77
Fizz,Ornn,294,160,134,54.42
Fizz,Zoe,270,163,107,60.37
Fizz,FiddleSticks,380,162,218,42.63
Fizz,Draven,362,182,180,50.28
Fizz,Rammus,246,112,134,45.53
Fizz,Naafiri,221,103,118,46.61
Fizz,Ashe,1472,770,702,52.31
Fizz,Seraphine,614,300,314,48.86
Fizz,Sivir,302,136,166,45.03
Fizz,Aatrox,648,393,255,60.65
Fizz,Amumu,807,426,381,52.79
Fizz,Pantheon,1145,566,579,49.43
Fizz,Vi,663,353,310,53.24
Fizz,TwistedFate,273,143,130,52.38
Fizz,Ivern,74,51,23,68.92
Fizz,Camille,229,132,97,57.64
Fizz,Orianna,262,142,120,54.2
Fizz,Karma,831,405,426,48.74
Fizz,Urgot,411,224,187,54.5
Fizz,Zac,318,178,140,55.97
Fizz,Rumble,169,73,96,43.2
Fizz,Neeko,362,194,168,53.59
Fizz,Akshan,237,118,119,49.79
Fizz,Samira,490,243,247,49.59
Fizz,Milio,413,184,229,44.55
Fizz,Ryze,237,113,124,47.68
Fizz,Rell,294,155,139,52.72
Fizz,Tryndamere,533,267,266,50.09
Fizz,Lissandra,321,125,196,38.94
Fizz,MasterYi,1055,466,589,44.17
Fizz,Illaoi,312,136,176,43.59
Fizz,Karthus,135,62,73,45.93
Fizz,Elise,514,261,253,50.78
Fizz,Renekton,390,189,201,48.46
Fizz,XinZhao,519,245,274,47.21
Fizz,RekSai,68,35,33,51.47
Fizz,Zeri,281,117,164,41.64
Fizz,Hecarim,269,133,136,49.44
Fizz,Viktor,580,293,287,50.52
Fizz,Smolder,498,258,240,51.81
Fizz,Talon,403,205,198,50.87
Fizz,Shyvana,175,80,95,45.71
Fizz,Corki,268,157,111,58.58
Fizz,Quinn,285,157,128,55.09
Fizz,Aphelios,337,158,179,46.88
Fizz,Skarner,135,94,41,69.63
Fizz,Olaf,146,65,81,44.52
Fizz,Kalista,173,71,102,41.04
Fizz,Cassiopeia,147,95,52,64.63
Fizz,Zilean,211,119,92,56.4
Fizz,Renata,100,42,58,42
Ivern,Azir,74,35,39,47.3
Ivern,Nocturne,242,122,120,50.41
Ivern,Syndra,123,51,72,41.46
Ivern,Jhin,382,170,212,44.5
Ivern,Senna,148,84,64,56.76
Ivern,Tryndamere,94,51,43,54.26
Ivern,Vi,168,98,70,58.33
Ivern,Malzahar,166,89,77,53.61
Ivern,Caitlyn,466,222,244,47.64
Ivern,Zyra,188,74,114,39.36
Ivern,Urgot,97,52,45,53.61
Ivern,Ryze,59,23,36,38.98
Ivern,MissFortune,361,150,211,41.55
Ivern,Thresh,243,93,150,38.27
Ivern,Riven,81,20,61,24.69
Ivern,Nunu,96,61,35,63.54
Ivern,Mel,296,146,150,49.32
Ivern,Nilah,60,27,33,45
Ivern,Zoe,61,31,30,50.82
Ivern,Kayn,228,98,130,42.98
Ivern,Ekko,150,88,62,58.67
Ivern,Pyke,142,66,76,46.48
Ivern,Poppy,95,35,60,36.84
Ivern,MasterYi,169,77,92,45.56
Ivern,Karthus,68,34,34,50
Ivern,Seraphine,122,51,71,41.8
Ivern,Darius,324,148,176,45.68
Ivern,Warwick,237,128,109,54.01
Ivern,Quinn,66,28,38,42.42
Ivern,Elise,188,100,88,53.19
Ivern,Taliyah,37,20,17,54.05
Ivern,Kennen,36,17,19,47.22
Ivern,XinZhao,70,24,46,34.29
Ivern,Zac,77,31,46,40.26
Ivern,Blitzcrank,96,30,66,31.25
Ivern,KSante,116,79,37,68.1
Ivern,Graves,170,95,75,55.88
Ivern,Leblanc,109,43,66,39.45
Ivern,Twitch,124,60,64,48.39
Ivern,Taric,39,28,11,71.79
Ivern,Teemo,217,97,120,44.7
Ivern,JarvanIV,147,82,65,55.78
Ivern,Lux,400,183,217,45.75
Ivern,Ezreal,494,221,273,44.74
Ivern,Sona,80,29,51,36.25
Ivern,Irelia,130,54,76,41.54
Ivern,Tristana,187,99,88,52.94
Ivern,Jinx,465,233,232,50.11
Ivern,Rakan,70,33,37,47.14
Ivern,Garen,334,154,180,46.11
Ivern,MonkeyKing,115,54,61,46.96
Ivern,Gangplank,102,50,52,49.02
Ivern,Nasus,125,65,60,52
Ivern,Lillia,76,30,46,39.47
Ivern,Yone,333,155,178,46.55
Ivern,LeeSin,264,135,129,51.14
Ivern,Kaisa,305,177,128,58.03
Ivern,Lulu,317,163,154,51.42
Ivern,Viktor,159,85,74,53.46
Ivern,Singed,72,52,20,72.22
Ivern,Fizz,74,23,51,31.08
Ivern,Zeri,81,33,48,40.74
Ivern,Khazix,88,40,48,45.45
Ivern,Swain,162,75,87,46.3
Ivern,Rengar,77,47,30,61.04
Ivern,Akshan,66,30,36,45.45
Ivern,Vayne,225,128,97,56.89
Ivern,Leona,142,81,61,57.04
Ivern,Sett,231,121,110,52.38
Ivern,Viego,287,139,148,48.43
Ivern,Sylas,251,141,110,56.18
Ivern,Shaco,147,70,77,47.62
Ivern,TwistedFate,53,32,21,60.38
Ivern,Mordekaiser,205,103,102,50.24
Ivern,Diana,290,117,173,40.34
Ivern,Veigar,125,49,76,39.2
Ivern,Ashe,330,166,164,50.3
Ivern,Bard,78,45,33,57.69
Ivern,Sion,119,64,55,53.78
Ivern,Morgana,163,95,68,58.28
Ivern,Vladimir,103,68,35,66.02
Ivern,Briar,103,45,58,43.69
Ivern,Chogath,201,106,95,52.74
Ivern,Xayah,91,53,38,58.24
Ivern,Jayce,101,62,39,61.39
Ivern,Yasuo,338,162,176,47.93
Ivern,Udyr,58,36,22,62.07
Ivern,Pantheon,247,115,132,46.56
Ivern,AurelionSol,71,25,46,35.21
Ivern,Milio,130,63,67,48.46
Ivern,Zed,230,106,124,46.09
Ivern,Camille,79,35,44,44.3
Ivern,Sivir,105,46,59,43.81
Ivern,Xerath,163,81,82,49.69
Ivern,Katarina,158,70,88,44.3
Ivern,Shen,110,55,55,50
Ivern,Heimerdinger,53,28,25,52.83
Ivern,Shyvana,42,21,21,50
Ivern,Vex,86,39,47,45.35
Ivern,Illaoi,50,29,21,58
Ivern,Annie,65,31,34,47.69
Ivern,Alistar,93,44,49,47.31
Ivern,Malphite,169,93,76,55.03
Ivern,Gwen,138,69,69,50
Ivern,Hwei,114,54,60,47.37
Ivern,Nami,245,124,121,50.61
Ivern,Aatrox,155,63,92,40.65
Ivern,Varus,148,81,67,54.73
Ivern,Karma,245,118,127,48.16
Ivern,Lissandra,48,26,22,54.17
Ivern,Nidalee,58,29,29,50
Ivern,Smolder,130,42,88,32.31
Ivern,Anivia,69,33,36,47.83
Ivern,Volibear,247,132,115,53.44
Ivern,Corki,83,43,40,51.81
Ivern,Nautilus,158,81,77,51.27
Ivern,Janna,57,39,18,68.42
Ivern,Yuumi,174,103,71,59.2
Ivern,Akali,169,89,80,52.66
Ivern,TahmKench,101,36,65,35.64
Ivern,Jax,161,90,71,55.9
Ivern,Amumu,141,64,77,45.39
Ivern,Orianna,98,48,50,48.98
Ivern,Ambessa,127,61,66,48.03
Ivern,Skarner,47,25,22,53.19
Ivern,Samira,105,56,49,53.33
Ivern,Rell,89,44,45,49.44
Ivern,Brand,102,56,46,54.9
Ivern,Neeko,70,38,32,54.29
Ivern,Naafiri,66,32,34,48.48
Ivern,Kayle,114,49,65,42.98
Ivern,Draven,86,43,43,50
Ivern,Rumble,42,17,25,40.48
Ivern,Galio,124,49,75,39.52
Ivern,Lucian,101,50,51,49.5
Ivern,Ahri,233,135,98,57.94
Ivern,Gragas,96,46,50,47.92
Ivern,Hecarim,82,36,46,43.9
Ivern,KogMaw,75,23,52,30.67
Ivern,Cassiopeia,41,20,21,48.78
Ivern,Fiora,62,28,34,45.16
Ivern,Ziggs,59,37,22,62.71
Ivern,Soraka,84,53,31,63.1
Ivern,Trundle,108,48,60,44.44
Ivern,Sejuani,67,33,34,49.25
Ivern,Velkoz,79,28,51,35.44
Ivern,Kassadin,49,28,21,57.14
Ivern,Olaf,50,18,32,36
Ivern,Kindred,103,53,50,51.46
Ivern,Aphelios,105,65,40,61.9
Ivern,Braum,91,41,50,45.05
Ivern,Yorick,122,40,82,32.79
Ivern,Talon,101,41,60,40.59
Ivern,DrMundo,89,45,44,50.56
Ivern,Rammus,38,18,20,47.37
Ivern,Gnar,63,24,39,38.1
Ivern,Kalista,34,27,7,79.41
Ivern,Renekton,93,52,41,55.91
Ivern,Qiyana,36,14,22,38.89
Ivern,Evelynn,78,36,42,46.15
Ivern,FiddleSticks,75,39,36,52
Ivern,Aurora,122,59,63,48.36
Ivern,Belveth,17,7,10,41.18
Ivern,Ornn,72,31,41,43.06
Ivern,Renata,48,24,24,50
Ivern,Maokai,88,37,51,42.05
Ivern,Kled,40,16,24,40
Ivern,RekSai,13,11,2,84.62
Ivern,Zilean,35,11,24,31.43
Leblanc,Urgot,338,148,190,43.79
Leblanc,Briar,556,236,320,42.45
Leblanc,Ahri,1220,603,617,49.43
Leblanc,Caitlyn,2208,1146,1062,51.9
Leblanc,Lux,2087,1026,1061,49.16
Leblanc,Teemo,959,481,478,50.16
Leblanc,Yasuo,1484,705,779,47.51
Leblanc,MissFortune,1835,860,975,46.87
Leblanc,Blitzcrank,683,336,347,49.19
Leblanc,Lillia,448,265,183,59.15
Leblanc,Diana,1452,694,758,47.8
Leblanc,Aphelios,417,236,181,56.59
Leblanc,Leona,626,282,344,45.05
Leblanc,Jax,835,451,384,54.01
Leblanc,Fizz,437,220,217,50.34
Leblanc,Aurora,615,309,306,50.24
Leblanc,Thresh,1197,591,606,49.37
Leblanc,Akali,909,454,455,49.94
Leblanc,Talon,561,277,284,49.38
Leblanc,Vayne,943,427,516,45.28
Leblanc,Zilean,216,103,113,47.69
Leblanc,Gangplank,466,245,221,52.58
Leblanc,Hecarim,329,190,139,57.75
Leblanc,Lucian,591,304,287,51.44
Leblanc,TahmKench,452,223,229,49.34
Leblanc,MasterYi,867,422,445,48.67
Leblanc,Morgana,871,442,429,50.75
Leblanc,KogMaw,241,109,132,45.23
Leblanc,Mordekaiser,946,433,513,45.77
Leblanc,Draven,374,182,192,48.66
Leblanc,Gnar,327,180,147,55.05
Leblanc,Skarner,220,127,93,57.73
Leblanc,Tristana,701,368,333,52.5
Leblanc,Sylas,1308,647,661,49.46
Leblanc,Warwick,994,453,541,45.57
Leblanc,Xerath,879,453,426,51.54
Leblanc,Ashe,1927,925,1002,48
Leblanc,Chogath,876,380,496,43.38
Leblanc,Kayn,987,470,517,47.62
Leblanc,Pyke,678,378,300,55.75
Leblanc,Rumble,261,110,151,42.15
Leblanc,Pantheon,1374,656,718,47.74
Leblanc,Karma,1237,594,643,48.02
Leblanc,XinZhao,619,315,304,50.89
Leblanc,Nilah,188,80,108,42.55
Leblanc,Sejuani,337,172,165,51.04
Leblanc,Yone,1569,832,737,53.03
Leblanc,Kaisa,1509,744,765,49.3
Leblanc,JarvanIV,474,219,255,46.2
Leblanc,Renekton,364,193,171,53.02
Leblanc,Corki,429,210,219,48.95
Leblanc,Quinn,288,129,159,44.79
Leblanc,Trundle,412,195,217,47.33
Leblanc,Naafiri,319,108,211,33.86
Leblanc,Volibear,822,374,448,45.5
Leblanc,Vladimir,578,268,310,46.37
Leblanc,Velkoz,441,201,240,45.58
Leblanc,Ambessa,612,343,269,56.05
Leblanc,Ryze,299,125,174,41.81
Leblanc,Jinx,2226,1078,1148,48.43
Leblanc,Twitch,592,305,287,51.52
Leblanc,Brand,544,253,291,46.51
Leblanc,Amumu,697,357,340,51.22
Leblanc,Jayce,568,258,310,45.42
Leblanc,Veigar,693,372,321,53.68
Leblanc,Darius,1362,689,673,50.59
Leblanc,MonkeyKing,575,277,298,48.17
Leblanc,Aatrox,942,412,530,43.74
Leblanc,Nami,785,395,390,50.32
Leblanc,Ezreal,2582,1295,1287,50.15
Leblanc,Vi,851,431,420,50.65
Leblanc,Zed,1043,525,518,50.34
Leblanc,Neeko,349,173,176,49.57
Leblanc,Ziggs,235,132,103,56.17
Leblanc,Irelia,695,376,319,54.1
Leblanc,Zyra,836,384,452,45.93
Leblanc,Samira,543,266,277,48.99
Leblanc,Akshan,220,123,97,55.91
Leblanc,FiddleSticks,413,210,203,50.85
Leblanc,DrMundo,406,206,200,50.74
Leblanc,Malzahar,893,422,471,47.26
Leblanc,Soraka,376,183,193,48.67
Leblanc,Nocturne,1131,520,611,45.98
Leblanc,Orianna,404,188,216,46.53
Leblanc,Sett,1248,608,640,48.72
Leblanc,Ivern,109,66,43,60.55
Leblanc,KSante,525,264,261,50.29
Leblanc,Braum,486,212,274,43.62
Leblanc,Graves,700,331,369,47.29
Leblanc,Malphite,753,334,419,44.36
Leblanc,Jhin,1678,843,835,50.24
Leblanc,Garen,1259,602,657,47.82
Leblanc,Poppy,581,287,294,49.4
Leblanc,Nautilus,930,434,496,46.67
Leblanc,Syndra,487,247,240,50.72
Leblanc,Galio,846,448,398,52.96
Leblanc,Rakan,320,172,148,53.75
Leblanc,Anivia,274,143,131,52.19
Leblanc,Yorick,665,334,331,50.23
Leblanc,Riven,350,178,172,50.86
Leblanc,LeeSin,1841,946,895,51.39
Leblanc,Lissandra,438,199,239,45.43
Leblanc,Camille,329,123,206,37.39
Leblanc,Viktor,800,356,444,44.5
Leblanc,Xayah,388,195,193,50.26
Leblanc,Shaco,815,383,432,46.99
Leblanc,Mel,1343,666,677,49.59
Leblanc,Nasus,475,206,269,43.37
Leblanc,Zac,455,230,225,50.55
Leblanc,Heimerdinger,315,141,174,44.76
Leblanc,Olaf,206,115,91,55.83
Leblanc,Gwen,343,177,166,51.6
Leblanc,Smolder,511,244,267,47.75
Leblanc,Zoe,391,200,191,51.15
Leblanc,Kindred,423,210,213,49.65
Leblanc,Illaoi,354,163,191,46.05
Leblanc,Alistar,431,222,209,51.51
Leblanc,Katarina,567,273,294,48.15
Leblanc,Taric,129,51,78,39.53
Leblanc,Maokai,440,205,235,46.59
Leblanc,Kayle,430,212,218,49.3
Leblanc,Milio,425,205,220,48.24
Leblanc,Yuumi,710,349,361,49.15
Leblanc,Khazix,418,203,215,48.56
Leblanc,Janna,288,132,156,45.83
Leblanc,Lulu,1165,584,581,50.13
Leblanc,Shen,472,254,218,53.81
Leblanc,TwistedFate,266,146,120,54.89
Leblanc,Swain,743,339,404,45.63
Leblanc,Seraphine,524,287,237,54.77
Leblanc,Evelynn,284,137,147,48.24
Leblanc,Kassadin,212,100,112,47.17
Leblanc,Kalista,223,133,90,59.64
Leblanc,Rell,354,175,179,49.44
Leblanc,Rengar,285,133,152,46.67
Leblanc,Azir,344,164,180,47.67
Leblanc,Tryndamere,424,232,192,54.72
Leblanc,Nidalee,321,140,181,43.61
Leblanc,Kled,181,98,83,54.14
Leblanc,Viego,1249,671,578,53.72
Leblanc,Zeri,373,184,189,49.33
Leblanc,Nunu,338,180,158,53.25
Leblanc,AurelionSol,267,159,108,59.55
Leblanc,Ekko,705,391,314,55.46
Leblanc,Sona,253,117,136,46.25
Leblanc,Qiyana,164,72,92,43.9
Leblanc,Sion,481,256,225,53.22
Leblanc,Annie,342,148,194,43.27
Leblanc,Gragas,524,263,261,50.19
Leblanc,Vex,744,370,374,49.73
Leblanc,Varus,753,371,382,49.27
Leblanc,Ornn,319,128,191,40.13
Leblanc,Karthus,265,149,116,56.23
Leblanc,Shyvana,153,83,70,54.25
Leblanc,Belveth,175,99,76,56.57
Leblanc,Udyr,240,113,127,47.08
Leblanc,Hwei,545,276,269,50.64
Leblanc,RekSai,94,44,50,46.81
Leblanc,Singed,224,110,114,49.11
Leblanc,Rammus,198,101,97,51.01
Leblanc,Senna,507,224,283,44.18
Leblanc,Elise,684,306,378,44.74
Leblanc,Bard,252,111,141,44.05
Leblanc,Sivir,457,219,238,47.92
Leblanc,Renata,128,69,59,53.91
Leblanc,Fiora,306,140,166,45.75
Leblanc,Taliyah,198,95,103,47.98
Leblanc,Kennen,239,140,99,58.58
Leblanc,Cassiopeia,156,91,65,58.33
Aatrox,Malzahar,1207,555,652,45.98
Aatrox,Sejuani,545,324,221,59.45
Aatrox,Jayce,812,444,368,54.68
Aatrox,Jhin,2403,1245,1158,51.81
Aatrox,Thresh,1868,891,977,47.7
Aatrox,Tryndamere,555,291,264,52.43
Aatrox,Vi,1097,531,566,48.4
Aatrox,Caitlyn,3069,1424,1645,46.4
Aatrox,Zyra,1124,518,606,46.09
Aatrox,Ambessa,769,374,395,48.63
Aatrox,Graves,959,502,457,52.35
Aatrox,Akali,1221,590,631,48.32
Aatrox,Anivia,383,181,202,47.26
Aatrox,Leona,974,499,475,51.23
Aatrox,Mordekaiser,1538,789,749,51.3
Aatrox,Vex,624,356,268,57.05
Aatrox,Varus,1135,568,567,50.04
Aatrox,Seraphine,784,381,403,48.6
Aatrox,Poppy,598,302,296,50.5
Aatrox,Warwick,1507,728,779,48.31
Aatrox,Taliyah,336,143,193,42.56
Aatrox,MissFortune,2462,1202,1260,48.82
Aatrox,Morgana,1245,644,601,51.73
Aatrox,Pantheon,1875,948,927,50.56
Aatrox,MonkeyKing,796,408,388,51.26
Aatrox,Yasuo,2215,1104,1111,49.84
Aatrox,Lux,2654,1285,1369,48.42
Aatrox,Irelia,1068,474,594,44.38
Aatrox,Briar,761,348,413,45.73
Aatrox,Mel,2233,1172,1061,52.49
Aatrox,Vayne,1473,709,764,48.13
Aatrox,Pyke,879,497,382,56.54
Aatrox,Teemo,1451,696,755,47.97
Aatrox,KSante,864,426,438,49.31
Aatrox,Jinx,3471,1618,1853,46.61
Aatrox,Swain,1125,520,605,46.22
Aatrox,Quinn,368,198,170,53.8
Aatrox,Evelynn,393,188,205,47.84
Aatrox,Brand,791,379,412,47.91
Aatrox,Sett,1981,1030,951,51.99
Aatrox,Ahri,1621,816,805,50.34
Aatrox,Nami,1342,655,687,48.81
Aatrox,Gwen,572,264,308,46.15
Aatrox,Kaisa,2126,1116,1010,52.49
Aatrox,Renata,192,105,87,54.69
Aatrox,Sylas,1815,921,894,50.74
Aatrox,Ashe,2704,1362,1342,50.37
Aatrox,Milio,699,308,391,44.06
Aatrox,Vladimir,698,349,349,50
Aatrox,TwistedFate,478,253,225,52.93
Aatrox,Xayah,527,270,257,51.23
Aatrox,Trundle,555,265,290,47.75
Aatrox,Olaf,283,143,140,50.53
Aatrox,Riven,490,264,226,53.88
Aatrox,Hwei,788,383,405,48.6
Aatrox,Kayle,718,315,403,43.87
Aatrox,Urgot,602,270,332,44.85
Aatrox,Diana,1927,918,1009,47.64
Aatrox,Yone,2441,1267,1174,51.9
Aatrox,Aurora,866,451,415,52.08
Aatrox,Shaco,1081,551,530,50.97
Aatrox,Lulu,1808,883,925,48.84
Aatrox,Renekton,803,353,450,43.96
Aatrox,Lillia,624,344,280,55.13
Aatrox,Sion,752,415,337,55.19
Aatrox,Viktor,1120,569,551,50.8
Aatrox,Corki,507,259,248,51.08
Aatrox,Soraka,558,262,296,46.95
Aatrox,TahmKench,809,414,395,51.17
Aatrox,Volibear,1196,558,638,46.66
Aatrox,LeeSin,2308,1197,1111,51.86
Aatrox,Ziggs,478,240,238,50.21
Aatrox,Shen,692,386,306,55.78
Aatrox,Kayn,1571,710,861,45.19
Aatrox,Zilean,420,200,220,47.62
Aatrox,Yorick,956,429,527,44.87
Aatrox,FiddleSticks,627,340,287,54.23
Aatrox,Viego,1860,988,872,53.12
Aatrox,Samira,748,358,390,47.86
Aatrox,Tristana,1106,526,580,47.56
Aatrox,AurelionSol,485,232,253,47.84
Aatrox,Draven,680,296,384,43.53
Aatrox,Nasus,794,368,426,46.35
Aatrox,Braum,672,335,337,49.85
Aatrox,Chogath,1273,641,632,50.35
Aatrox,Jax,1049,494,555,47.09
Aatrox,Gragas,757,384,373,50.73
Aatrox,XinZhao,904,465,439,51.44
Aatrox,Lucian,921,474,447,51.47
Aatrox,Gnar,505,267,238,52.87
Aatrox,Leblanc,942,530,412,56.26
Aatrox,Senna,741,370,371,49.93
Aatrox,Aphelios,583,269,314,46.14
Aatrox,Garen,1933,921,1012,47.65
Aatrox,Nocturne,1648,721,927,43.75
Aatrox,Skarner,283,128,155,45.23
Aatrox,Smolder,664,388,276,58.43
Aatrox,Hecarim,450,217,233,48.22
Aatrox,Rengar,324,195,129,60.19
Aatrox,Ezreal,3239,1715,1524,52.95
Aatrox,Darius,2362,1159,1203,49.07
Aatrox,Annie,379,200,179,52.77
Aatrox,Sona,311,148,163,47.59
Aatrox,Sivir,655,338,317,51.6
Aatrox,Kled,238,117,121,49.16
Aatrox,Taric,244,121,123,49.59
Aatrox,Ekko,1088,466,622,42.83
Aatrox,Karma,1591,778,813,48.9
Aatrox,Velkoz,623,302,321,48.48
Aatrox,Blitzcrank,991,533,458,53.78
Aatrox,Talon,699,308,391,44.06
Aatrox,KogMaw,325,126,199,38.77
Aatrox,Bard,327,171,156,52.29
Aatrox,Amumu,960,459,501,47.81
Aatrox,Lissandra,406,186,220,45.81
Aatrox,Zed,1384,723,661,52.24
Aatrox,Syndra,717,309,408,43.1
Aatrox,Orianna,526,243,283,46.2
Aatrox,Alistar,576,270,306,46.88
Aatrox,Xerath,1231,614,617,49.88
Aatrox,DrMundo,700,364,336,52
Aatrox,Gangplank,1046,543,503,51.91
Aatrox,Galio,1129,541,588,47.92
Aatrox,Rell,665,308,357,46.32
Aatrox,Khazix,667,353,314,52.92
Aatrox,Ornn,478,218,260,45.61
Aatrox,Zoe,465,249,216,53.55
Aatrox,Kassadin,242,123,119,50.83
Aatrox,Singed,337,140,197,41.54
Aatrox,Fizz,648,255,393,39.35
Aatrox,Karthus,384,226,158,58.85
Aatrox,Ryze,485,270,215,55.67
Aatrox,Azir,451,217,234,48.12
Aatrox,Akshan,425,207,218,48.71
Aatrox,MasterYi,1424,674,750,47.33
Aatrox,Twitch,884,448,436,50.68
Aatrox,Heimerdinger,490,202,288,41.22
Aatrox,Naafiri,339,183,156,53.98
Aatrox,Nautilus,1265,648,617,51.23
Aatrox,Nunu,457,239,218,52.3
Aatrox,Veigar,1012,473,539,46.74
Aatrox,Katarina,939,453,486,48.24
Aatrox,Camille,474,227,247,47.89
Aatrox,Rumble,429,186,243,43.36
Aatrox,Kindred,515,253,262,49.13
Aatrox,Fiora,530,292,238,55.09
Aatrox,Zeri,557,276,281,49.55
Aatrox,Zac,659,336,323,50.99
Aatrox,Qiyana,348,183,165,52.59
Aatrox,Yuumi,1063,520,543,48.92
Aatrox,Nilah,303,152,151,50.17
Aatrox,Elise,974,464,510,47.64
Aatrox,Illaoi,489,241,248,49.28
Aatrox,Maokai,511,253,258,49.51
Aatrox,Rammus,377,152,225,40.32
Aatrox,Belveth,277,140,137,50.54
Aatrox,Malphite,1211,622,589,51.36
Aatrox,Udyr,485,222,263,45.77
Aatrox,Neeko,455,239,216,52.53
Aatrox,Rakan,488,262,226,53.69
Aatrox,Kalista,341,159,182,46.63
Aatrox,Cassiopeia,352,183,169,51.99
Aatrox,JarvanIV,794,389,405,48.99
Aatrox,Ivern,155,92,63,59.35
Aatrox,Janna,388,185,203,47.68
Aatrox,Kennen,397,194,203,48.87
Aatrox,Nidalee,423,277,146,65.48
Aatrox,Shyvana,231,114,117,49.35
Aatrox,RekSai,131,68,63,51.91
Jayce,Aatrox,812,368,444,45.32
Jayce,Khazix,302,159,143,52.65
Jayce,Fizz,299,176,123,58.86
Jayce,Lux,1229,584,645,47.52
Jayce,Neeko,304,112,192,36.84
Jayce,Darius,1094,567,527,51.83
Jayce,Kindred,283,126,157,44.52
Jayce,Yone,1270,708,562,55.75
Jayce,Samira,360,201,159,55.83
Jayce,Rell,347,192,155,55.33
Jayce,Illaoi,231,117,114,50.65
Jayce,Karthus,231,97,134,41.99
Jayce,Naafiri,162,73,89,45.06
Jayce,Jinx,1977,1019,958,51.54
Jayce,Maokai,259,117,142,45.17
Jayce,Volibear,569,274,295,48.15
Jayce,Ekko,509,276,233,54.22
Jayce,Ashe,1537,739,798,48.08
Jayce,Bard,260,125,135,48.08
Jayce,Teemo,766,331,435,43.21
Jayce,Nocturne,738,334,404,45.26
Jayce,Ryze,258,113,145,43.8
Jayce,Senna,509,252,257,49.51
Jayce,Kennen,238,103,135,43.28
Jayce,Rengar,166,74,92,44.58
Jayce,Yasuo,1208,553,655,45.78
Jayce,Smolder,386,203,183,52.59
Jayce,Thresh,982,483,499,49.19
Jayce,Mordekaiser,580,275,305,47.41
Jayce,Poppy,458,231,227,50.44
Jayce,Zed,713,373,340,52.31
Jayce,Draven,317,139,178,43.85
Jayce,Sona,155,64,91,41.29
Jayce,Camille,332,156,176,46.99
Jayce,Udyr,204,94,110,46.08
Jayce,Ahri,903,442,461,48.95
Jayce,Milio,333,131,202,39.34
Jayce,Quinn,250,104,146,41.6
Jayce,Kayn,739,365,374,49.39
Jayce,Jhin,1321,648,673,49.05
Jayce,Janna,243,118,125,48.56
Jayce,Sett,790,416,374,52.66
Jayce,Shaco,568,313,255,55.11
Jayce,MissFortune,1239,576,663,46.49
Jayce,Leblanc,568,310,258,54.58
Jayce,Pantheon,1017,511,506,50.25
Jayce,Katarina,507,250,257,49.31
Jayce,Caitlyn,1644,753,891,45.8
Jayce,Jax,558,298,260,53.41
Jayce,LeeSin,1625,803,822,49.42
Jayce,Qiyana,206,105,101,50.97
Jayce,Hecarim,279,156,123,55.91
Jayce,Braum,427,231,196,54.1
Jayce,Gnar,299,141,158,47.16
Jayce,MonkeyKing,512,259,253,50.59
Jayce,Mel,1184,621,563,52.45
Jayce,Renekton,372,186,186,50
Jayce,Taliyah,213,85,128,39.91
Jayce,Corki,321,157,164,48.91
Jayce,Galio,630,260,370,41.27
Jayce,Vayne,662,322,340,48.64
Jayce,Nautilus,724,354,370,48.9
Jayce,Briar,330,135,195,40.91
Jayce,Syndra,410,203,207,49.51
Jayce,TahmKench,344,179,165,52.03
Jayce,Graves,639,346,293,54.15
Jayce,Akali,711,355,356,49.93
Jayce,Ezreal,2193,1145,1048,52.21
Jayce,Nami,514,280,234,54.47
Jayce,Warwick,665,333,332,50.08
Jayce,Diana,1100,533,567,48.45
Jayce,Twitch,299,129,170,43.14
Jayce,Anivia,225,100,125,44.44
Jayce,AurelionSol,223,92,131,41.26
Jayce,Renata,109,42,67,38.53
Jayce,Sejuani,259,122,137,47.1
Jayce,Chogath,618,298,320,48.22
Jayce,Zeri,399,219,180,54.89
Jayce,Zilean,286,144,142,50.35
Jayce,Brand,373,176,197,47.18
Jayce,Irelia,627,288,339,45.93
Jayce,Lulu,1099,616,483,56.05
Jayce,KSante,464,270,194,58.19
Jayce,Sion,390,168,222,43.08
Jayce,Karma,1148,565,583,49.22
Jayce,Veigar,461,222,239,48.16
Jayce,Malphite,710,372,338,52.39
Jayce,Viego,1045,482,563,46.12
Jayce,Viktor,659,314,345,47.65
Jayce,Seraphine,390,182,208,46.67
Jayce,Gragas,402,196,206,48.76
Jayce,MasterYi,705,355,350,50.35
Jayce,Tristana,524,249,275,47.52
Jayce,Vladimir,455,221,234,48.57
Jayce,Kaisa,1140,568,572,49.82
Jayce,Tryndamere,323,174,149,53.87
Jayce,Alistar,280,156,124,55.71
Jayce,Olaf,218,106,112,48.62
Jayce,Xayah,258,117,141,45.35
Jayce,Leona,519,254,265,48.94
Jayce,Lillia,402,234,168,58.21
Jayce,Sylas,1121,604,517,53.88
Jayce,Riven,304,162,142,53.29
Jayce,Sivir,376,218,158,57.98
Jayce,Vi,723,388,335,53.67
Jayce,Aurora,552,300,252,54.35
Jayce,Malzahar,524,253,271,48.28
Jayce,Amumu,533,266,267,49.91
Jayce,Annie,225,107,118,47.56
Jayce,Blitzcrank,527,291,236,55.22
Jayce,Ambessa,601,320,281,53.24
Jayce,Ivern,101,39,62,38.61
Jayce,Xerath,685,320,365,46.72
Jayce,Gangplank,475,210,265,44.21
Jayce,Zyra,688,304,384,44.19
Jayce,Hwei,411,185,226,45.01
Jayce,Kassadin,161,90,71,55.9
Jayce,Azir,271,114,157,42.07
Jayce,Varus,745,386,359,51.81
Jayce,Rakan,316,171,145,54.11
Jayce,Urgot,239,103,136,43.1
Jayce,Gwen,231,111,120,48.05
Jayce,Rumble,279,150,129,53.76
Jayce,Heimerdinger,274,149,125,54.38
Jayce,TwistedFate,240,125,115,52.08
Jayce,Ziggs,200,99,101,49.5
Jayce,Garen,823,347,476,42.16
Jayce,Rammus,140,36,104,25.71
Jayce,Evelynn,209,110,99,52.63
Jayce,KogMaw,168,71,97,42.26
Jayce,Morgana,586,277,309,47.27
Jayce,Cassiopeia,182,102,80,56.04
Jayce,Yorick,562,275,287,48.93
Jayce,Zac,339,149,190,43.95
Jayce,Talon,472,233,239,49.36
Jayce,Lucian,498,229,269,45.98
Jayce,Akshan,227,128,99,56.39
Jayce,Yuumi,541,235,306,43.44
Jayce,Elise,548,255,293,46.53
Jayce,Singed,169,77,92,45.56
Jayce,Orianna,372,193,179,51.88
Jayce,Trundle,257,130,127,50.58
Jayce,Shen,330,184,146,55.76
Jayce,DrMundo,308,137,171,44.48
Jayce,Swain,523,236,287,45.12
Jayce,Velkoz,336,149,187,44.35
Jayce,Kayle,289,125,164,43.25
Jayce,Lissandra,211,86,125,40.76
Jayce,Fiora,215,111,104,51.63
Jayce,Nunu,241,117,124,48.55
Jayce,Zoe,247,112,135,45.34
Jayce,JarvanIV,395,159,236,40.25
Jayce,Kalista,168,77,91,45.83
Jayce,Shyvana,110,55,55,50
Jayce,Nilah,137,41,96,29.93
Jayce,Pyke,533,260,273,48.78
Jayce,FiddleSticks,343,178,165,51.9
Jayce,Soraka,349,178,171,51
Jayce,Ornn,225,108,117,48
Jayce,Vex,308,144,164,46.75
Jayce,Belveth,125,59,66,47.2
Jayce,Kled,105,57,48,54.29
Jayce,Nasus,322,128,194,39.75
Jayce,XinZhao,484,254,230,52.48
Jayce,Aphelios,288,165,123,57.29
Jayce,Nidalee,288,146,142,50.69
Jayce,Taric,75,28,47,37.33
Jayce,Skarner,144,91,53,63.19
Jayce,RekSai,101,65,36,64.36
Shaco,Garen,1983,949,1034,47.86
Shaco,Nocturne,1896,911,985,48.05
Shaco,Fizz,775,389,386,50.19
Shaco,Jinx,3426,1606,1820,46.88
Shaco,Thresh,1506,725,781,48.14
Shaco,Vladimir,795,417,378,52.45
Shaco,Pantheon,1863,903,960,48.47
Shaco,Mel,2521,1275,1246,50.58
Shaco,Ezreal,2965,1501,1464,50.62
Shaco,Teemo,1747,872,875,49.91
Shaco,Riven,508,268,240,52.76
Shaco,Ziggs,473,249,224,52.64
Shaco,Katarina,1033,529,504,51.21
Shaco,LeeSin,1950,936,1014,48
Shaco,Lux,3186,1520,1666,47.71
Shaco,Darius,2309,1114,1195,48.25
Shaco,Volibear,1321,595,726,45.04
Shaco,Veigar,1295,657,638,50.73
Shaco,Ashe,2509,1249,1260,49.78
Shaco,Lulu,1639,826,813,50.4
Shaco,Warwick,1895,896,999,47.28
Shaco,Ekko,1244,630,614,50.64
Shaco,Hwei,770,383,387,49.74
Shaco,Jhin,2495,1236,1259,49.54
Shaco,Nami,1196,579,617,48.41
Shaco,Tryndamere,707,335,372,47.38
Shaco,Shyvana,322,169,153,52.48
Shaco,Ambessa,704,356,348,50.57
Shaco,Irelia,1010,476,534,47.13
Shaco,MasterYi,1558,808,750,51.86
Shaco,Galio,1006,501,505,49.8
Shaco,Draven,669,301,368,44.99
Shaco,Nautilus,1265,659,606,52.09
Shaco,Kaisa,2034,1022,1012,50.25
Shaco,Maokai,560,272,288,48.57
Shaco,Yasuo,2399,1136,1263,47.35
Shaco,Samira,864,457,407,52.89
Shaco,Pyke,916,451,465,49.24
Shaco,Heimerdinger,612,303,309,49.51
Shaco,Kindred,588,311,277,52.89
Shaco,Ornn,401,209,192,52.12
Shaco,Quinn,415,202,213,48.67
Shaco,Zed,1491,729,762,48.89
Shaco,Soraka,764,353,411,46.2
Shaco,MonkeyKing,829,402,427,48.49
Shaco,TahmKench,858,491,367,57.23
Shaco,Kayn,1757,897,860,51.05
Shaco,Twitch,1041,540,501,51.87
Shaco,Qiyana,301,167,134,55.48
Shaco,Mordekaiser,1636,738,898,45.11
Shaco,Briar,883,414,469,46.89
Shaco,Caitlyn,3472,1610,1862,46.37
Shaco,Yone,2224,1126,1098,50.63
Shaco,AurelionSol,497,231,266,46.48
Shaco,Smolder,767,389,378,50.72
Shaco,Akali,1350,626,724,46.37
Shaco,Diana,2043,949,1094,46.45
Shaco,Talon,729,398,331,54.6
Shaco,Vayne,1596,783,813,49.06
Shaco,Zilean,427,191,236,44.73
Shaco,Swain,1262,572,690,45.32
Shaco,Brand,980,461,519,47.04
Shaco,Sona,369,159,210,43.09
Shaco,Malzahar,1452,694,758,47.8
Shaco,Rakan,423,227,196,53.66
Shaco,Rammus,289,164,125,56.75
Shaco,Xayah,531,273,258,51.41
Shaco,Gangplank,632,310,322,49.05
Shaco,Neeko,538,259,279,48.14
Shaco,Yorick,1277,571,706,44.71
Shaco,Aatrox,1081,530,551,49.03
Shaco,Syndra,784,365,419,46.56
Shaco,Seraphine,918,447,471,48.69
Shaco,Ahri,1594,884,710,55.46
Shaco,MissFortune,2798,1359,1439,48.57
Shaco,Jax,1068,550,518,51.5
Shaco,Lillia,645,326,319,50.54
Shaco,Tristana,1205,644,561,53.44
Shaco,Yuumi,975,459,516,47.08
Shaco,Chogath,1393,653,740,46.88
Shaco,Sylas,1507,808,699,53.62
Shaco,Bard,344,161,183,46.8
Shaco,Fiora,455,228,227,50.11
Shaco,Karthus,437,246,191,56.29
Shaco,Milio,754,317,437,42.04
Shaco,Viego,1711,850,861,49.68
Shaco,Aurora,774,386,388,49.87
Shaco,Braum,599,278,321,46.41
Shaco,Ryze,418,208,210,49.76
Shaco,Leona,967,519,448,53.67
Shaco,Vex,673,329,344,48.89
Shaco,Shen,780,371,409,47.56
Shaco,Viktor,1034,473,561,45.74
Shaco,Sivir,725,373,352,51.45
Shaco,Velkoz,721,325,396,45.08
Shaco,FiddleSticks,691,371,320,53.69
Shaco,Sett,1764,934,830,52.95
Shaco,Naafiri,372,171,201,45.97
Shaco,DrMundo,680,315,365,46.32
Shaco,Hecarim,520,262,258,50.38
Shaco,Xerath,1040,534,506,51.35
Shaco,Trundle,782,356,426,45.52
Shaco,Morgana,1496,699,797,46.72
Shaco,Nasus,865,385,480,44.51
Shaco,Kayle,811,393,418,48.46
Shaco,Renekton,627,326,301,51.99
Shaco,Karma,1568,783,785,49.94
Shaco,Lissandra,403,213,190,52.85
Shaco,Aphelios,607,293,314,48.27
Shaco,Amumu,1243,573,670,46.1
Shaco,Jayce,568,255,313,44.89
Shaco,Singed,305,134,171,43.93
Shaco,Graves,895,416,479,46.48
Shaco,Gragas,619,316,303,51.05
Shaco,Sejuani,440,227,213,51.59
Shaco,Lucian,841,419,422,49.82
Shaco,Gnar,493,248,245,50.3
Shaco,Akshan,430,218,212,50.7
Shaco,Varus,1002,495,507,49.4
Shaco,Zoe,385,201,184,52.21
Shaco,Zyra,1264,653,611,51.66
Shaco,Blitzcrank,898,467,431,52
Shaco,Sion,893,410,483,45.91
Shaco,Orianna,522,261,261,50
Shaco,Zac,567,266,301,46.91
Shaco,RekSai,165,81,84,49.09
Shaco,Vi,1105,524,581,47.42
Shaco,Corki,496,260,236,52.42
Shaco,Zeri,487,234,253,48.05
Shaco,Taric,263,123,140,46.77
Shaco,Illaoi,584,293,291,50.17
Shaco,Cassiopeia,275,140,135,50.91
Shaco,Malphite,1327,689,638,51.92
Shaco,KSante,651,338,313,51.92
Shaco,Skarner,277,159,118,57.4
Shaco,Khazix,651,321,330,49.31
Shaco,JarvanIV,692,313,379,45.23
Shaco,Belveth,252,139,113,55.16
Shaco,Kassadin,229,92,137,40.17
Shaco,Janna,345,176,169,51.01
Shaco,Anivia,389,194,195,49.87
Shaco,XinZhao,729,380,349,52.13
Shaco,Leblanc,815,432,383,53.01
Shaco,Evelynn,436,161,275,36.93
Shaco,Nilah,381,187,194,49.08
Shaco,Kennen,273,120,153,43.96
Shaco,Azir,350,156,194,44.57
Shaco,Rengar,407,212,195,52.09
Shaco,Alistar,489,238,251,48.67
Shaco,Elise,905,464,441,51.27
Shaco,Nunu,631,290,341,45.96
Shaco,Rumble,382,182,200,47.64
Shaco,Ivern,147,77,70,52.38
Shaco,Camille,432,235,197,54.4
Shaco,Poppy,637,312,325,48.98
Shaco,Renata,171,74,97,43.27
Shaco,Senna,929,447,482,48.12
Shaco,TwistedFate,445,223,222,50.11
Shaco,Kled,172,82,90,47.67
Shaco,KogMaw,302,157,145,51.99
Shaco,Udyr,477,248,229,51.99
Shaco,Rell,476,234,242,49.16
Shaco,Urgot,596,315,281,52.85
Shaco,Gwen,511,272,239,53.23
Shaco,Kalista,222,132,90,59.46
Shaco,Annie,387,203,184,52.45
Shaco,Taliyah,277,136,141,49.1
Shaco,Olaf,280,139,141,49.64
Shaco,Nidalee,314,181,133,57.64
Janna,Garen,712,341,371,47.89
Janna,Nocturne,513,260,253,50.68
Janna,Fizz,232,110,122,47.41
Janna,Jinx,1286,671,615,52.18
Janna,Thresh,582,316,266,54.3
Janna,Darius,878,441,437,50.23
Janna,Zac,258,127,131,49.22
Janna,Anivia,193,87,106,45.08
Janna,Tristana,407,216,191,53.07
Janna,Blitzcrank,303,154,149,50.83
Janna,Shen,294,165,129,56.12
Janna,Amumu,422,180,242,42.65
Janna,Akali,405,231,174,57.04
Janna,Jhin,813,407,406,50.06
Janna,TahmKench,336,151,185,44.94
Janna,Vladimir,312,155,157,49.68
Janna,Viego,554,254,300,45.85
Janna,AurelionSol,169,73,96,43.2
Janna,Ezreal,1068,586,482,54.87
Janna,Nami,637,272,365,42.7
Janna,Yorick,373,193,180,51.74
Janna,Sejuani,169,80,89,47.34
Janna,Lux,855,410,445,47.95
Janna,Samira,286,138,148,48.25
Janna,Rell,306,161,145,52.61
Janna,Gangplank,252,151,101,59.92
Janna,Graves,303,145,158,47.85
Janna,Yasuo,938,485,453,51.71
Janna,Soraka,247,136,111,55.06
Janna,Chogath,495,252,243,50.91
Janna,LeeSin,620,374,246,60.32
Janna,Katarina,395,186,209,47.09
Janna,Kaisa,779,399,380,51.22
Janna,Mel,853,422,431,49.47
Janna,Jayce,243,125,118,51.44
Janna,Udyr,196,109,87,55.61
Janna,Yone,707,362,345,51.2
Janna,Caitlyn,981,463,518,47.2
Janna,Karma,660,345,315,52.27
Janna,Aurora,286,179,107,62.59
Janna,Annie,146,93,53,63.7
Janna,Sivir,251,115,136,45.82
Janna,Renata,92,35,57,38.04
Janna,Pantheon,752,364,388,48.4
Janna,Diana,720,388,332,53.89
Janna,Nasus,315,170,145,53.97
Janna,Lucian,329,179,150,54.41
Janna,Senna,378,167,211,44.18
Janna,Renekton,213,97,116,45.54
Janna,Irelia,338,163,175,48.22
Janna,Swain,418,215,203,51.44
Janna,Kayn,657,364,293,55.4
Janna,Xerath,363,204,159,56.2
Janna,Smolder,263,149,114,56.65
Janna,Lulu,772,389,383,50.39
Janna,Sion,355,190,165,53.52
Janna,Warwick,541,274,267,50.65
Janna,Galio,324,178,146,54.94
Janna,Sett,504,292,212,57.94
Janna,Draven,263,125,138,47.53
Janna,Nautilus,448,234,214,52.23
Janna,Brand,254,130,124,51.18
Janna,Nunu,260,119,141,45.77
Janna,Skarner,81,49,32,60.49
Janna,Neeko,194,103,91,53.09
Janna,Ornn,155,85,70,54.84
Janna,Zeri,179,92,87,51.4
Janna,Zed,474,262,212,55.27
Janna,Talon,291,154,137,52.92
Janna,Elise,369,183,186,49.59
Janna,KSante,265,121,144,45.66
Janna,MissFortune,884,465,419,52.6
Janna,Kled,88,49,39,55.68
Janna,Nidalee,111,61,50,54.95
Janna,Viktor,421,216,205,51.31
Janna,Vayne,608,307,301,50.49
Janna,Jax,356,204,152,57.3
Janna,Shaco,345,169,176,48.99
Janna,Hwei,292,161,131,55.14
Janna,Trundle,173,95,78,54.91
Janna,Briar,306,149,157,48.69
Janna,Cassiopeia,137,74,63,54.01
Janna,Bard,194,121,73,62.37
Janna,JarvanIV,303,156,147,51.49
Janna,Malzahar,421,221,200,52.49
Janna,Sona,194,68,126,35.05
Janna,Gwen,240,135,105,56.25
Janna,Veigar,368,163,205,44.29
Janna,KogMaw,146,70,76,47.95
Janna,Kindred,181,107,74,59.12
Janna,Ahri,495,234,261,47.27
Janna,Ashe,869,445,424,51.21
Janna,Zilean,169,89,80,52.66
Janna,Ambessa,313,157,156,50.16
Janna,Vi,375,219,156,58.4
Janna,Sylas,486,266,220,54.73
Janna,Xayah,183,106,77,57.92
Janna,Hecarim,215,123,92,57.21
Janna,Leblanc,288,156,132,54.17
Janna,Tryndamere,195,71,124,36.41
Janna,Gragas,244,123,121,50.41
Janna,Twitch,385,201,184,52.21
Janna,Rengar,140,63,77,45
Janna,Taliyah,115,52,63,45.22
Janna,Velkoz,251,124,127,49.4
Janna,Morgana,390,196,194,50.26
Janna,DrMundo,198,92,106,46.46
Janna,Volibear,455,224,231,49.23
Janna,Corki,204,129,75,63.24
Janna,FiddleSticks,263,123,140,46.77
Janna,Heimerdinger,171,76,95,44.44
Janna,MasterYi,450,236,214,52.44
Janna,Mordekaiser,493,244,249,49.49
Janna,Riven,266,133,133,50
Janna,Yuumi,340,191,149,56.18
Janna,Belveth,101,76,25,75.25
Janna,Syndra,330,165,165,50
Janna,Teemo,363,163,200,44.9
Janna,Milio,350,172,178,49.14
Janna,Karthus,138,57,81,41.3
Janna,Seraphine,293,149,144,50.85
Janna,Varus,388,219,169,56.44
Janna,Malphite,370,191,179,51.62
Janna,Braum,232,112,120,48.28
Janna,Lillia,212,87,125,41.04
Janna,Rakan,166,90,76,54.22
Janna,Lissandra,173,92,81,53.18
Janna,Zyra,374,181,193,48.4
Janna,Singed,136,73,63,53.68
Janna,Ekko,400,181,219,45.25
Janna,Kassadin,94,59,35,62.77
Janna,Kayle,298,129,169,43.29
Janna,MonkeyKing,321,143,178,44.55
Janna,Evelynn,140,91,49,65
Janna,Poppy,271,113,158,41.7
Janna,Ziggs,151,75,76,49.67
Janna,Aatrox,388,203,185,52.32
Janna,Naafiri,139,61,78,43.88
Janna,Alistar,218,111,107,50.92
Janna,Camille,206,117,89,56.8
Janna,Qiyana,160,82,78,51.25
Janna,Maokai,193,87,106,45.08
Janna,Kennen,157,84,73,53.5
Janna,Ivern,57,18,39,31.58
Janna,Olaf,115,73,42,63.48
Janna,Pyke,322,174,148,54.04
Janna,Rammus,173,103,70,59.54
Janna,Khazix,227,99,128,43.61
Janna,Ryze,161,97,64,60.25
Janna,Azir,133,64,69,48.12
Janna,Urgot,247,111,136,44.94
Janna,Aphelios,238,108,130,45.38
Janna,Fiora,151,68,83,45.03
Janna,XinZhao,274,142,132,51.82
Janna,Zoe,151,76,75,50.33
Janna,Kalista,113,59,54,52.21
Janna,Vex,186,104,82,55.91
Janna,TwistedFate,143,77,66,53.85
Janna,Leona,384,209,175,54.43
Janna,Gnar,176,76,100,43.18
Janna,Illaoi,171,100,71,58.48
Janna,Nilah,157,84,73,53.5
Janna,Taric,113,75,38,66.37
Janna,Shyvana,122,76,46,62.3
Janna,RekSai,60,27,33,45
Janna,Quinn,173,93,80,53.76
Janna,Akshan,175,107,68,61.14
Janna,Orianna,192,113,79,58.85
Janna,Rumble,121,75,46,61.98
Lissandra,Sion,295,130,165,44.07
Lissandra,Vi,410,228,182,55.61
Lissandra,Sylas,604,290,314,48.01
Lissandra,Lucian,330,182,148,55.15
Lissandra,Pantheon,667,343,324,51.42
Lissandra,Ambessa,235,142,93,60.43
Lissandra,XinZhao,246,119,127,48.37
Lissandra,Vladimir,348,183,165,52.59
Lissandra,Ezreal,1209,653,556,54.01
Lissandra,Karma,624,258,366,41.35
Lissandra,Nasus,306,142,164,46.41
Lissandra,MasterYi,598,313,285,52.34
Lissandra,Kaisa,704,372,332,52.84
Lissandra,Neeko,263,136,127,51.71
Lissandra,DrMundo,199,114,85,57.29
Lissandra,Rengar,157,82,75,52.23
Lissandra,Akali,530,231,299,43.58
Lissandra,Nilah,145,67,78,46.21
Lissandra,Shen,279,157,122,56.27
Lissandra,Maokai,176,91,85,51.7
Lissandra,Yasuo,1121,579,542,51.65
Lissandra,Samira,241,127,114,52.7
Lissandra,Pyke,309,166,143,53.72
Lissandra,Kayle,287,123,164,42.86
Lissandra,Ekko,452,235,217,51.99
Lissandra,Veigar,333,165,168,49.55
Lissandra,Ziggs,159,77,82,48.43
Lissandra,Lux,934,435,499,46.57
Lissandra,Urgot,231,102,129,44.16
Lissandra,Rammus,134,79,55,58.96
Lissandra,Xerath,418,155,263,37.08
Lissandra,Jinx,1303,670,633,51.42
Lissandra,Lulu,706,365,341,51.7
Lissandra,JarvanIV,263,124,139,47.15
Lissandra,Yone,748,404,344,54.01
Lissandra,Ashe,846,435,411,51.42
Lissandra,Swain,389,200,189,51.41
Lissandra,Gwen,213,103,110,48.36
Lissandra,Teemo,490,237,253,48.37
Lissandra,Yorick,402,191,211,47.51
Lissandra,Cassiopeia,132,71,61,53.79
Lissandra,Smolder,235,148,87,62.98
Lissandra,Anivia,182,101,81,55.49
Lissandra,Volibear,443,233,210,52.6
Lissandra,Shaco,403,190,213,47.15
Lissandra,Syndra,268,163,105,60.82
Lissandra,Xayah,227,108,119,47.58
Lissandra,Milio,268,147,121,54.85
Lissandra,Hwei,226,88,138,38.94
Lissandra,Zed,821,470,351,57.25
Lissandra,Aphelios,231,128,103,55.41
Lissandra,Amumu,444,222,222,50
Lissandra,Nidalee,162,99,63,61.11
Lissandra,MissFortune,933,455,478,48.77
Lissandra,Nautilus,480,229,251,47.71
Lissandra,Mordekaiser,514,304,210,59.14
Lissandra,Kalista,139,73,66,52.52
Lissandra,Jax,370,194,176,52.43
Lissandra,Udyr,133,63,70,47.37
Lissandra,Draven,225,132,93,58.67
Lissandra,Morgana,479,253,226,52.82
Lissandra,Vex,163,72,91,44.17
Lissandra,Azir,117,52,65,44.44
Lissandra,Kayn,573,310,263,54.1
Lissandra,Viktor,400,193,207,48.25
Lissandra,Blitzcrank,259,133,126,51.35
Lissandra,Thresh,612,349,263,57.03
Lissandra,Aatrox,406,220,186,54.19
Lissandra,Chogath,473,205,268,43.34
Lissandra,Briar,293,136,157,46.42
Lissandra,Darius,808,390,418,48.27
Lissandra,Evelynn,143,76,67,53.15
Lissandra,Sett,591,274,317,46.36
Lissandra,Illaoi,208,98,110,47.12
Lissandra,Mel,787,419,368,53.24
Lissandra,KSante,242,124,118,51.24
Lissandra,Lillia,263,158,105,60.08
Lissandra,Aurora,300,156,144,52
Lissandra,Rakan,153,94,59,61.44
Lissandra,Zyra,388,183,205,47.16
Lissandra,Heimerdinger,210,100,110,47.62
Lissandra,Zac,200,93,107,46.5
Lissandra,Nocturne,575,255,320,44.35
Lissandra,Trundle,314,161,153,51.27
Lissandra,Olaf,118,64,54,54.24
Lissandra,Leblanc,438,239,199,54.57
Lissandra,Caitlyn,1072,531,541,49.53
Lissandra,Malphite,456,239,217,52.41
Lissandra,Karthus,111,76,35,68.47
Lissandra,Rell,219,104,115,47.49
Lissandra,Renekton,264,144,120,54.55
Lissandra,Nami,487,236,251,48.46
Lissandra,Diana,740,402,338,54.32
Lissandra,Orianna,187,109,78,58.29
Lissandra,Graves,344,171,173,49.71
Lissandra,Braum,300,133,167,44.33
Lissandra,Naafiri,162,98,64,60.49
Lissandra,Belveth,95,46,49,48.42
Lissandra,Soraka,252,140,112,55.56
Lissandra,Corki,178,92,86,51.69
Lissandra,Tristana,412,222,190,53.88
Lissandra,Poppy,235,129,106,54.89
Lissandra,Qiyana,119,70,49,58.82
Lissandra,Jhin,896,445,451,49.67
Lissandra,Vayne,647,355,292,54.87
Lissandra,Khazix,238,135,103,56.72
Lissandra,Katarina,416,196,220,47.12
Lissandra,Zilean,151,71,80,47.02
Lissandra,Sivir,232,119,113,51.29
Lissandra,Alistar,232,114,118,49.14
Lissandra,Gragas,258,122,136,47.29
Lissandra,Garen,624,383,241,61.38
Lissandra,Sejuani,190,78,112,41.05
Lissandra,Senna,269,119,150,44.24
Lissandra,Fizz,321,196,125,61.06
Lissandra,LeeSin,635,315,320,49.61
Lissandra,Renata,88,52,36,59.09
Lissandra,Warwick,614,314,300,51.14
Lissandra,Malzahar,424,212,212,50
Lissandra,Seraphine,271,140,131,51.66
Lissandra,FiddleSticks,217,123,94,56.68
Lissandra,Irelia,423,237,186,56.03
Lissandra,Twitch,379,191,188,50.4
Lissandra,Viego,601,270,331,44.93
Lissandra,Zoe,144,77,67,53.47
Lissandra,Brand,289,154,135,53.29
Lissandra,Riven,227,113,114,49.78
Lissandra,Ahri,563,289,274,51.33
Lissandra,Elise,330,199,131,60.3
Lissandra,Ryze,145,84,61,57.93
Lissandra,Janna,173,81,92,46.82
Lissandra,Hecarim,180,94,86,52.22
Lissandra,AurelionSol,135,84,51,62.22
Lissandra,Varus,370,207,163,55.95
Lissandra,Leona,363,219,144,60.33
Lissandra,RekSai,75,34,41,45.33
Lissandra,Ivern,48,22,26,45.83
Lissandra,Talon,296,160,136,54.05
Lissandra,Taric,101,66,35,65.35
Lissandra,Kennen,122,45,77,36.89
Lissandra,TahmKench,275,133,142,48.36
Lissandra,Fiora,135,71,64,52.59
Lissandra,Quinn,156,55,101,35.26
Lissandra,Singed,92,44,48,47.83
Lissandra,Gnar,232,131,101,56.47
Lissandra,MonkeyKing,342,182,160,53.22
Lissandra,Sona,97,55,42,56.7
Lissandra,KogMaw,138,59,79,42.75
Lissandra,Jayce,211,125,86,59.24
Lissandra,Ornn,150,63,87,42
Lissandra,Yuumi,377,195,182,51.72
Lissandra,Galio,355,200,155,56.34
Lissandra,Bard,126,89,37,70.63
Lissandra,Velkoz,216,104,112,48.15
Lissandra,Kindred,163,86,77,52.76
Lissandra,Tryndamere,215,124,91,57.67
Lissandra,Shyvana,107,59,48,55.14
Lissandra,Rumble,115,62,53,53.91
Lissandra,Gangplank,212,96,116,45.28
Lissandra,TwistedFate,166,95,71,57.23
Lissandra,Zeri,179,95,84,53.07
Lissandra,Nunu,239,133,106,55.65
Lissandra,Skarner,95,50,45,52.63
Lissandra,Akshan,144,73,71,50.69
Lissandra,Taliyah,134,60,74,44.78
Lissandra,Kled,71,47,24,66.2
Lissandra,Camille,126,67,59,53.17
Lissandra,Annie,137,71,66,51.82
Lissandra,Kassadin,107,44,63,41.12
Anivia,Tryndamere,259,139,120,53.67
Anivia,Vi,405,211,194,52.1
Anivia,Malzahar,468,223,245,47.65
Anivia,Caitlyn,1086,530,556,48.8
Anivia,Zyra,461,246,215,53.36
Anivia,Aatrox,383,202,181,52.74
Anivia,Kayn,608,328,280,53.95
Anivia,Katarina,371,221,150,59.57
Anivia,Draven,217,125,92,57.6
Anivia,Blitzcrank,273,134,139,49.08
Anivia,Teemo,493,256,237,51.93
Anivia,Briar,257,122,135,47.47
Anivia,Yasuo,798,414,384,51.88
Anivia,MissFortune,926,471,455,50.86
Anivia,Volibear,459,256,203,55.77
Anivia,Sejuani,214,77,137,35.98
Anivia,Lux,975,501,474,51.38
Anivia,Jhin,859,475,384,55.3
Anivia,Nautilus,458,251,207,54.8
Anivia,Urgot,202,109,93,53.96
Anivia,Ryze,193,98,95,50.78
Anivia,Thresh,557,275,282,49.37
Anivia,Pantheon,563,327,236,58.08
Anivia,Viktor,414,233,181,56.28
Anivia,Samira,295,156,139,52.88
Anivia,Janna,193,106,87,54.92
Anivia,Gangplank,259,147,112,56.76
Anivia,Kindred,154,74,80,48.05
Anivia,Aurora,308,162,146,52.6
Anivia,Sivir,240,124,116,51.67
Anivia,Yuumi,392,210,182,53.57
Anivia,Irelia,331,168,163,50.76
Anivia,Rammus,156,71,85,45.51
Anivia,Karma,608,306,302,50.33
Anivia,Ezreal,1001,543,458,54.25
Anivia,Viego,598,286,312,47.83
Anivia,Veigar,421,239,182,56.77
Anivia,Jinx,1251,625,626,49.96
Anivia,Milio,255,128,127,50.2
Anivia,Illaoi,177,120,57,67.8
Anivia,Karthus,177,121,56,68.36
Anivia,Naafiri,129,64,65,49.61
Anivia,Maokai,232,139,93,59.91
Anivia,Elise,347,175,172,50.43
Anivia,Fizz,238,133,105,55.88
Anivia,Mordekaiser,586,278,308,47.44
Anivia,Jax,386,216,170,55.96
Anivia,Ahri,520,248,272,47.69
Anivia,Corki,169,102,67,60.36
Anivia,Soraka,239,136,103,56.9
Anivia,Sett,545,280,265,51.38
Anivia,Warwick,602,298,304,49.5
Anivia,Lissandra,182,81,101,44.51
Anivia,Alistar,154,80,74,51.95
Anivia,Fiora,132,61,71,46.21
Anivia,JarvanIV,245,131,114,53.47
Anivia,Galio,365,182,183,49.86
Anivia,Yorick,393,198,195,50.38
Anivia,Syndra,396,217,179,54.8
Anivia,Velkoz,289,153,136,52.94
Anivia,Nasus,334,194,140,58.08
Anivia,Garen,680,327,353,48.09
Anivia,Renata,85,41,44,48.24
Anivia,Nocturne,507,253,254,49.9
Anivia,Zilean,142,61,81,42.96
Anivia,Mel,789,418,371,52.98
Anivia,Nunu,229,127,102,55.46
Anivia,Tristana,497,271,226,54.53
Anivia,Ashe,826,431,395,52.18
Anivia,Morgana,534,263,271,49.25
Anivia,Ekko,403,203,200,50.37
Anivia,Kaisa,799,418,381,52.32
Anivia,Lulu,573,283,290,49.39
Anivia,Rengar,125,78,47,62.4
Anivia,Chogath,532,292,240,54.89
Anivia,Graves,321,199,122,61.99
Anivia,Seraphine,313,165,148,52.72
Anivia,Lillia,207,114,93,55.07
Anivia,Sylas,599,303,296,50.58
Anivia,TahmKench,315,173,142,54.92
Anivia,Gragas,206,107,99,51.94
Anivia,Jayce,225,125,100,55.56
Anivia,Varus,354,201,153,56.78
Anivia,Gwen,209,102,107,48.8
Anivia,MasterYi,508,242,266,47.64
Anivia,Leblanc,274,131,143,47.81
Anivia,Senna,323,179,144,55.42
Anivia,Sion,335,193,142,57.61
Anivia,Gnar,207,84,123,40.58
Anivia,Shaco,389,195,194,50.13
Anivia,Rakan,157,71,86,45.22
Anivia,Swain,364,177,187,48.63
Anivia,Darius,808,431,377,53.34
Anivia,Braum,269,132,137,49.07
Anivia,Trundle,245,131,114,53.47
Anivia,Vex,166,91,75,54.82
Anivia,FiddleSticks,201,89,112,44.28
Anivia,Vayne,459,258,201,56.21
Anivia,Zed,509,272,237,53.44
Anivia,AurelionSol,201,110,91,54.73
Anivia,Khazix,196,103,93,52.55
Anivia,Xayah,226,140,86,61.95
Anivia,Singed,125,65,60,52
Anivia,Shyvana,112,59,53,52.68
Anivia,Neeko,175,95,80,54.29
Anivia,KSante,227,116,111,51.1
Anivia,Nami,500,259,241,51.8
Anivia,Rumble,121,78,43,64.46
Anivia,Poppy,259,137,122,52.9
Anivia,Lucian,357,191,166,53.5
Anivia,Ornn,161,88,73,54.66
Anivia,LeeSin,649,349,300,53.78
Anivia,Udyr,148,85,63,57.43
Anivia,KogMaw,151,66,85,43.71
Anivia,Vladimir,266,140,126,52.63
Anivia,Talon,329,168,161,51.06
Anivia,Twitch,344,171,173,49.71
Anivia,Shen,251,118,133,47.01
Anivia,Taliyah,121,68,53,56.2
Anivia,Aphelios,261,115,146,44.06
Anivia,Hwei,260,115,145,44.23
Anivia,Xerath,370,216,154,58.38
Anivia,Skarner,89,51,38,57.3
Anivia,Hecarim,181,113,68,62.43
Anivia,Zeri,165,84,81,50.91
Anivia,Sona,123,69,54,56.1
Anivia,Kayle,333,159,174,47.75
Anivia,Zoe,181,80,101,44.2
Anivia,Riven,189,86,103,45.5
Anivia,XinZhao,269,124,145,46.1
Anivia,Ziggs,171,84,87,49.12
Anivia,Smolder,260,133,127,51.15
Anivia,Annie,134,67,67,50
Anivia,Kalista,105,52,53,49.52
Anivia,Diana,696,409,287,58.76
Anivia,Leona,360,169,191,46.94
Anivia,Olaf,107,62,45,57.94
Anivia,Heimerdinger,212,114,98,53.77
Anivia,Camille,158,96,62,60.76
Anivia,Ivern,69,36,33,52.17
Anivia,Evelynn,131,65,66,49.62
Anivia,Brand,281,151,130,53.74
Anivia,Amumu,420,195,225,46.43
Anivia,Yone,605,318,287,52.56
Anivia,Nilah,112,79,33,70.54
Anivia,Akali,383,206,177,53.79
Anivia,Malphite,322,154,168,47.83
Anivia,Qiyana,88,53,35,60.23
Anivia,Kassadin,124,77,47,62.1
Anivia,Pyke,250,116,134,46.4
Anivia,Renekton,192,103,89,53.65
Anivia,Kled,82,38,44,46.34
Anivia,Bard,123,67,56,54.47
Anivia,Kennen,118,46,72,38.98
Anivia,Rell,221,108,113,48.87
Anivia,Cassiopeia,151,90,61,59.6
Anivia,Ambessa,273,145,128,53.11
Anivia,TwistedFate,178,95,83,53.37
Anivia,Quinn,114,62,52,54.39
Anivia,MonkeyKing,306,147,159,48.04
Anivia,Orianna,207,143,64,69.08
Anivia,Akshan,151,76,75,50.33
Anivia,DrMundo,280,155,125,55.36
Anivia,Zac,198,114,84,57.58
Anivia,Nidalee,111,68,43,61.26
Anivia,Belveth,91,33,58,36.26
Anivia,RekSai,50,20,30,40
Anivia,Taric,91,44,47,48.35
Anivia,Azir,108,65,43,60.19
Kennen,Darius,756,330,426,43.65
Kennen,Kindred,134,74,60,55.22
Kennen,Yone,620,334,286,53.87
Kennen,Samira,241,122,119,50.62
Kennen,Rell,121,60,61,49.59
Kennen,Teemo,452,214,238,47.35
Kennen,Fizz,174,94,80,54.02
Kennen,Briar,222,87,135,39.19
Kennen,Seraphine,219,106,113,48.4
Kennen,Garen,431,188,243,43.62
Kennen,Volibear,326,152,174,46.63
Kennen,Veigar,297,105,192,35.35
Kennen,Smolder,195,66,129,33.85
Kennen,Lux,765,382,383,49.93
Kennen,Nasus,291,123,168,42.27
Kennen,Diana,630,307,323,48.73
Kennen,Renekton,135,80,55,59.26
Kennen,Kayle,200,93,107,46.5
Kennen,Yasuo,693,341,352,49.21
Kennen,Draven,163,85,78,52.15
Kennen,Thresh,487,260,227,53.39
Kennen,Jax,287,147,140,51.22
Kennen,Aurora,265,167,98,63.02
Kennen,Caitlyn,799,389,410,48.69
Kennen,Amumu,305,136,169,44.59
Kennen,Katarina,208,123,85,59.13
Kennen,MissFortune,778,371,407,47.69
Kennen,Nami,307,139,168,45.28
Kennen,Rammus,82,33,49,40.24
Kennen,Ryze,131,75,56,57.25
Kennen,Swain,320,168,152,52.5
Kennen,Jayce,238,135,103,56.72
Kennen,Yorick,282,131,151,46.45
Kennen,Hwei,224,105,119,46.88
Kennen,Jhin,718,343,375,47.77
Kennen,Soraka,227,134,93,59.03
Kennen,Rumble,108,65,43,60.19
Kennen,Ekko,309,136,173,44.01
Kennen,Brand,242,116,126,47.93
Kennen,Gangplank,200,89,111,44.5
Kennen,Graves,219,132,87,60.27
Kennen,Jinx,896,477,419,53.24
Kennen,Gnar,154,102,52,66.23
Kennen,Sejuani,109,58,51,53.21
Kennen,Vladimir,306,154,152,50.33
Kennen,TahmKench,254,130,124,51.18
Kennen,Mordekaiser,330,166,164,50.3
Kennen,Viego,528,270,258,51.14
Kennen,Irelia,332,159,173,47.89
Kennen,Varus,328,183,145,55.79
Kennen,Lulu,521,285,236,54.7
Kennen,Kayn,396,201,195,50.76
Kennen,Vayne,439,205,234,46.7
Kennen,Urgot,192,96,96,50
Kennen,Ahri,449,224,225,49.89
Kennen,Blitzcrank,269,134,135,49.81
Kennen,Corki,170,118,52,69.41
Kennen,Malzahar,347,162,185,46.69
Kennen,Ashe,663,315,348,47.51
Kennen,Ivern,36,19,17,52.78
Kennen,Zed,428,192,236,44.86
Kennen,Pantheon,551,286,265,51.91
Kennen,Warwick,399,186,213,46.62
Kennen,Orianna,179,86,93,48.04
Kennen,Xayah,171,90,81,52.63
Kennen,Milio,171,87,84,50.88
Kennen,Sett,464,222,242,47.84
Kennen,Nocturne,440,229,211,52.05
Kennen,Zilean,121,33,88,27.27
Kennen,FiddleSticks,172,97,75,56.4
Kennen,Sion,240,130,110,54.17
Kennen,Senna,204,130,74,63.73
Kennen,Viktor,345,165,180,47.83
Kennen,KogMaw,83,45,38,54.22
Kennen,Akali,376,185,191,49.2
Kennen,Malphite,342,165,177,48.25
Kennen,Heimerdinger,156,89,67,57.05
Kennen,MasterYi,371,181,190,48.79
Kennen,Ezreal,877,432,445,49.26
Kennen,LeeSin,575,313,262,54.43
Kennen,Shaco,273,153,120,56.04
Kennen,Karma,464,234,230,50.43
Kennen,Naafiri,111,58,53,52.25
Kennen,Zyra,319,169,150,52.98
Kennen,Sylas,588,266,322,45.24
Kennen,Alistar,183,88,95,48.09
Kennen,Twitch,311,151,160,48.55
Kennen,Annie,80,33,47,41.25
Kennen,Pyke,239,110,129,46.03
Kennen,Renata,66,27,39,40.91
Kennen,MonkeyKing,242,132,110,54.55
Kennen,Vex,109,53,56,48.62
Kennen,Evelynn,105,42,63,40
Kennen,Vi,306,166,140,54.25
Kennen,Trundle,144,75,69,52.08
Kennen,Sona,98,52,46,53.06
Kennen,Khazix,197,102,95,51.78
Kennen,Chogath,398,184,214,46.23
Kennen,Karthus,152,56,96,36.84
Kennen,Kled,46,21,25,45.65
Kennen,Kaisa,591,324,267,54.82
Kennen,JarvanIV,222,103,119,46.4
Kennen,Maokai,161,67,94,41.61
Kennen,RekSai,45,16,29,35.56
Kennen,Lucian,237,121,116,51.05
Kennen,Talon,214,97,117,45.33
Kennen,Poppy,194,112,82,57.73
Kennen,Neeko,180,117,63,65
Kennen,Yuumi,254,111,143,43.7
Kennen,Riven,211,101,110,47.87
Kennen,Mel,647,333,314,51.47
Kennen,Cassiopeia,99,59,40,59.6
Kennen,Elise,323,153,170,47.37
Kennen,Tryndamere,155,79,76,50.97
Kennen,TwistedFate,84,52,32,61.9
Kennen,Morgana,319,160,159,50.16
Kennen,Gwen,110,60,50,54.55
Kennen,Rengar,101,51,50,50.5
Kennen,Galio,296,141,155,47.64
Kennen,DrMundo,195,74,121,37.95
Kennen,Nautilus,339,178,161,52.51
Kennen,Gragas,208,113,95,54.33
Kennen,XinZhao,212,119,93,56.13
Kennen,Taric,71,38,33,53.52
Kennen,KSante,128,82,46,64.06
Kennen,Lissandra,122,77,45,63.11
Kennen,Janna,157,73,84,46.5
Kennen,Aatrox,397,203,194,51.13
Kennen,Udyr,114,53,61,46.49
Kennen,Aphelios,163,72,91,44.17
Kennen,Tristana,317,168,149,53
Kennen,Ambessa,223,125,98,56.05
Kennen,Hecarim,134,55,79,41.04
Kennen,Olaf,60,28,32,46.67
Kennen,Lillia,171,96,75,56.14
Kennen,Zeri,124,64,60,51.61
Kennen,Rakan,120,60,60,50
Kennen,Azir,103,57,46,55.34
Kennen,Zoe,127,65,62,51.18
Kennen,Syndra,230,127,103,55.22
Kennen,Braum,199,89,110,44.72
Kennen,Shen,182,76,106,41.76
Kennen,Anivia,118,72,46,61.02
Kennen,Ziggs,125,64,61,51.2
Kennen,Quinn,115,54,61,46.96
Kennen,Camille,89,48,41,53.93
Kennen,Nidalee,108,67,41,62.04
Kennen,Singed,76,49,27,64.47
Kennen,Ornn,120,47,73,39.17
Kennen,Skarner,90,49,41,54.44
Kennen,Xerath,289,153,136,52.94
Kennen,Illaoi,100,54,46,54
Kennen,Zac,181,79,102,43.65
Kennen,Nilah,75,43,32,57.33
Kennen,Velkoz,155,73,82,47.1
Kennen,AurelionSol,96,57,39,59.38
Kennen,Qiyana,71,34,37,47.89
Kennen,Kassadin,41,15,26,36.59
Kennen,Kalista,89,52,37,58.43
Kennen,Leona,232,129,103,55.6
Kennen,Leblanc,239,99,140,41.42
Kennen,Bard,93,35,58,37.63
Kennen,Nunu,148,76,72,51.35
Kennen,Belveth,55,32,23,58.18
Kennen,Sivir,182,89,93,48.9
Kennen,Shyvana,81,37,44,45.68
Kennen,Akshan,98,43,55,43.88
Kennen,Fiora,96,44,52,45.83
Kennen,Taliyah,73,32,41,43.84
Fiora,Irelia,417,225,192,53.96
Fiora,Diana,738,321,417,43.5
Fiora,Fizz,245,125,120,51.02
Fiora,Vayne,524,218,306,41.6
Fiora,Yuumi,400,204,196,51
Fiora,Garen,733,364,369,49.66
Fiora,Volibear,470,241,229,51.28
Fiora,Yasuo,908,475,433,52.31
Fiora,Mel,933,530,403,56.81
Fiora,Zilean,181,92,89,50.83
Fiora,Renekton,248,122,126,49.19
Fiora,Shyvana,111,65,46,58.56
Fiora,Veigar,375,169,206,45.07
Fiora,MissFortune,1000,505,495,50.5
Fiora,Nasus,321,166,155,51.71
Fiora,Zyra,397,195,202,49.12
Fiora,Ashe,1065,535,530,50.23
Fiora,Karma,649,296,353,45.61
Fiora,Ekko,455,236,219,51.87
Fiora,Ahri,567,263,304,46.38
Fiora,Thresh,670,319,351,47.61
Fiora,DrMundo,223,122,101,54.71
Fiora,Shaco,455,227,228,49.89
Fiora,Vex,182,80,102,43.96
Fiora,Jinx,1299,579,720,44.57
Fiora,Teemo,444,199,245,44.82
Fiora,Chogath,671,283,388,42.18
Fiora,Lucian,327,192,135,58.72
Fiora,Nami,517,290,227,56.09
Fiora,Shen,279,140,139,50.18
Fiora,Graves,331,150,181,45.32
Fiora,Taliyah,110,48,62,43.64
Fiora,Poppy,262,116,146,44.27
Fiora,Gwen,293,128,165,43.69
Fiora,Akshan,177,87,90,49.15
Fiora,Nunu,245,121,124,49.39
Fiora,Aphelios,266,129,137,48.5
Fiora,Morgana,496,246,250,49.6
Fiora,Kayle,306,122,184,39.87
Fiora,Sejuani,210,116,94,55.24
Fiora,Caitlyn,1179,574,605,48.69
Fiora,Urgot,207,99,108,47.83
Fiora,Viego,631,316,315,50.08
Fiora,Anivia,132,71,61,53.79
Fiora,Riven,292,150,142,51.37
Fiora,Skarner,129,83,46,64.34
Fiora,Tristana,453,220,233,48.57
Fiora,Swain,435,240,195,55.17
Fiora,Ambessa,283,157,126,55.48
Fiora,Zoe,209,122,87,58.37
Fiora,Maokai,207,126,81,60.87
Fiora,Sett,687,289,398,42.07
Fiora,Warwick,654,317,337,48.47
Fiora,Twitch,399,170,229,42.61
Fiora,Blitzcrank,268,165,103,61.57
Fiora,Yone,864,486,378,56.25
Fiora,Zeri,203,105,98,51.72
Fiora,Singed,124,79,45,63.71
Fiora,Vi,466,229,237,49.14
Fiora,Talon,300,185,115,61.67
Fiora,Katarina,373,172,201,46.11
Fiora,Pyke,368,203,165,55.16
Fiora,Yorick,422,187,235,44.31
Fiora,Ezreal,1177,602,575,51.15
Fiora,Darius,841,401,440,47.68
Fiora,Lux,1064,498,566,46.8
Fiora,Amumu,455,250,205,54.95
Fiora,LeeSin,738,349,389,47.29
Fiora,Kayn,675,337,338,49.93
Fiora,Viktor,480,270,210,56.25
Fiora,Pantheon,759,350,409,46.11
Fiora,Malzahar,465,211,254,45.38
Fiora,Rammus,151,83,68,54.97
Fiora,MasterYi,538,232,306,43.12
Fiora,Zac,258,117,141,45.35
Fiora,Gragas,254,129,125,50.79
Fiora,Varus,387,182,205,47.03
Fiora,Sylas,604,297,307,49.17
Fiora,Nocturne,609,292,317,47.95
Fiora,Aurora,349,192,157,55.01
Fiora,Kaisa,781,422,359,54.03
Fiora,TahmKench,351,193,158,54.99
Fiora,Velkoz,284,130,154,45.77
Fiora,Nautilus,545,293,252,53.76
Fiora,Trundle,233,131,102,56.22
Fiora,Neeko,162,77,85,47.53
Fiora,Galio,447,259,188,57.94
Fiora,MonkeyKing,356,181,175,50.84
Fiora,Samira,294,146,148,49.66
Fiora,Alistar,164,74,90,45.12
Fiora,Qiyana,157,78,79,49.68
Fiora,Malphite,383,136,247,35.51
Fiora,Syndra,300,174,126,58
Fiora,Corki,182,77,105,42.31
Fiora,Bard,174,100,74,57.47
Fiora,Braum,341,172,169,50.44
Fiora,Leona,404,170,234,42.08
Fiora,Lulu,696,303,393,43.53
Fiora,Draven,228,144,84,63.16
Fiora,Camille,256,142,114,55.47
Fiora,TwistedFate,149,96,53,64.43
Fiora,Lillia,247,114,133,46.15
Fiora,AurelionSol,158,71,87,44.94
Fiora,Heimerdinger,175,64,111,36.57
Fiora,Cassiopeia,123,64,59,52.03
Fiora,Jhin,972,501,471,51.54
Fiora,Vladimir,350,162,188,46.29
Fiora,Sivir,238,133,105,55.88
Fiora,Rengar,124,74,50,59.68
Fiora,Aatrox,530,238,292,44.91
Fiora,Evelynn,158,76,82,48.1
Fiora,Kassadin,66,40,26,60.61
Fiora,Xerath,428,215,213,50.23
Fiora,Brand,297,135,162,45.45
Fiora,Ornn,260,137,123,52.69
Fiora,Hecarim,187,96,91,51.34
Fiora,Taric,87,43,44,49.43
Fiora,Azir,206,97,109,47.09
Fiora,Kalista,100,59,41,59
Fiora,Akali,478,231,247,48.33
Fiora,Ziggs,183,90,93,49.18
Fiora,Milio,282,130,152,46.1
Fiora,Gangplank,250,130,120,52
Fiora,Zed,535,280,255,52.34
Fiora,Rakan,189,85,104,44.97
Fiora,Kled,74,38,36,51.35
Fiora,Khazix,229,124,105,54.15
Fiora,Orianna,158,67,91,42.41
Fiora,Soraka,292,166,126,56.85
Fiora,KSante,294,165,129,56.12
Fiora,Rell,199,90,109,45.23
Fiora,Annie,173,85,88,49.13
Fiora,Mordekaiser,704,381,323,54.12
Fiora,Elise,337,192,145,56.97
Fiora,KogMaw,142,66,76,46.48
Fiora,Jax,477,265,212,55.56
Fiora,Senna,345,178,167,51.59
Fiora,XinZhao,252,106,146,42.06
Fiora,Smolder,242,139,103,57.44
Fiora,Tryndamere,233,147,86,63.09
Fiora,FiddleSticks,214,104,110,48.6
Fiora,Xayah,163,86,77,52.76
Fiora,Briar,330,170,160,51.52
Fiora,Sona,147,74,73,50.34
Fiora,Hwei,331,174,157,52.57
Fiora,Illaoi,187,90,97,48.13
Fiora,Renata,90,49,41,54.44
Fiora,Lissandra,135,64,71,47.41
Fiora,Seraphine,324,171,153,52.78
Fiora,Nilah,133,67,66,50.38
Fiora,JarvanIV,221,132,89,59.73
Fiora,Karthus,154,67,87,43.51
Fiora,Naafiri,144,59,85,40.97
Fiora,Ryze,175,92,83,52.57
Fiora,Kindred,195,82,113,42.05
Fiora,Janna,151,83,68,54.97
Fiora,Sion,424,230,194,54.25
Fiora,Olaf,75,26,49,34.67
Fiora,Jayce,215,104,111,48.37
Fiora,Ivern,62,34,28,54.84
Fiora,Udyr,162,85,77,52.47
Fiora,Quinn,126,48,78,38.1
Fiora,RekSai,72,42,30,58.33
Fiora,Belveth,124,70,54,56.45
Fiora,Rumble,153,82,71,53.59
Fiora,Nidalee,140,84,56,60
Fiora,Leblanc,306,166,140,54.25
Fiora,Gnar,166,98,68,59.04
Fiora,Kennen,96,52,44,54.17
Rumble,Garen,505,275,230,54.46
Rumble,Diana,632,284,348,44.94
Rumble,Vladimir,308,173,135,56.17
Rumble,Caitlyn,906,451,455,49.78
Rumble,Lulu,573,300,273,52.36
Rumble,Pantheon,574,288,286,50.17
Rumble,Mel,645,334,311,51.78
Rumble,Ezreal,1202,537,665,44.68
Rumble,Teemo,493,224,269,45.44
Rumble,Singed,93,32,61,34.41
Rumble,Evelynn,141,47,94,33.33
Rumble,Yone,723,354,369,48.96
Rumble,Nami,318,153,165,48.11
Rumble,Nidalee,163,58,105,35.58
Rumble,Akali,409,220,189,53.79
Rumble,Morgana,385,165,220,42.86
Rumble,Yasuo,765,323,442,42.22
Rumble,Kayn,496,218,278,43.95
Rumble,Lux,782,394,388,50.38
Rumble,Kennen,108,43,65,39.81
Rumble,Khazix,196,107,89,54.59
Rumble,Veigar,293,125,168,42.66
Rumble,Ashe,736,331,405,44.97
Rumble,Senna,245,126,119,51.43
Rumble,Azir,116,68,48,58.62
Rumble,Warwick,479,206,273,43.01
Rumble,Leblanc,261,151,110,57.85
Rumble,Malphite,383,169,214,44.13
Rumble,Gangplank,210,108,102,51.43
Rumble,Camille,93,41,52,44.09
Rumble,Swain,271,145,126,53.51
Rumble,DrMundo,205,95,110,46.34
Rumble,Ahri,469,240,229,51.17
Rumble,Elise,312,150,162,48.08
Rumble,Shen,192,103,89,53.65
Rumble,Vi,411,243,168,59.12
Rumble,Kaisa,629,331,298,52.62
Rumble,Galio,416,195,221,46.88
Rumble,Qiyana,85,51,34,60
Rumble,Hecarim,161,87,74,54.04
Rumble,Jinx,1030,443,587,43.01
Rumble,Braum,228,94,134,41.23
Rumble,Talon,280,130,150,46.43
Rumble,Draven,168,91,77,54.17
Rumble,Zyra,429,233,196,54.31
Rumble,Volibear,295,151,144,51.19
Rumble,Graves,278,131,147,47.12
Rumble,Rammus,112,62,50,55.36
Rumble,Ambessa,217,102,115,47
Rumble,Katarina,288,132,156,45.83
Rumble,Vayne,417,220,197,52.76
Rumble,Heimerdinger,187,77,110,41.18
Rumble,Jhin,790,391,399,49.49
Rumble,Karma,609,276,333,45.32
Rumble,Rakan,153,73,80,47.71
Rumble,Mordekaiser,432,177,255,40.97
Rumble,LeeSin,749,383,366,51.13
Rumble,Viktor,333,171,162,51.35
Rumble,Velkoz,199,84,115,42.21
Rumble,Ekko,320,149,171,46.56
Rumble,Zed,411,185,226,45.01
Rumble,Tristana,362,172,190,47.51
Rumble,Gnar,181,78,103,43.09
Rumble,MasterYi,368,170,198,46.2
Rumble,Ziggs,127,49,78,38.58
Rumble,Milio,179,84,95,46.93
Rumble,MissFortune,766,400,366,52.22
Rumble,Nautilus,385,198,187,51.43
Rumble,Jax,304,130,174,42.76
Rumble,Shaco,382,200,182,52.36
Rumble,Brand,222,115,107,51.8
Rumble,Maokai,173,80,93,46.24
Rumble,Sett,539,263,276,48.79
Rumble,Fizz,169,96,73,56.8
Rumble,Alistar,175,70,105,40
Rumble,Irelia,372,161,211,43.28
Rumble,Annie,171,89,82,52.05
Rumble,Blitzcrank,292,146,146,50
Rumble,Aatrox,429,243,186,56.64
Rumble,Viego,549,262,287,47.72
Rumble,Aurora,271,125,146,46.13
Rumble,TahmKench,268,139,129,51.87
Rumble,Nocturne,418,192,226,45.93
Rumble,Kassadin,74,35,39,47.3
Rumble,Anivia,121,43,78,35.54
Rumble,Soraka,167,97,70,58.08
Rumble,Kled,84,25,59,29.76
Rumble,Gragas,216,98,118,45.37
Rumble,Riven,201,108,93,53.73
Rumble,Chogath,346,178,168,51.45
Rumble,Trundle,136,75,61,55.15
Rumble,Tryndamere,136,48,88,35.29
Rumble,AurelionSol,94,44,50,46.81
Rumble,Lucian,270,160,110,59.26
Rumble,Pyke,308,161,147,52.27
Rumble,Syndra,224,136,88,60.71
Rumble,Orianna,168,58,110,34.52
Rumble,Twitch,241,131,110,54.36
Rumble,Zilean,121,40,81,33.06
Rumble,Malzahar,334,154,180,46.11
Rumble,Rengar,108,52,56,48.15
Rumble,Poppy,268,133,135,49.63
Rumble,Darius,616,263,353,42.69
Rumble,Hwei,266,141,125,53.01
Rumble,Sivir,197,86,111,43.65
Rumble,Sion,251,116,135,46.22
Rumble,Xerath,348,138,210,39.66
Rumble,Quinn,98,43,55,43.88
Rumble,Nasus,227,115,112,50.66
Rumble,Kindred,165,71,94,43.03
Rumble,Jayce,279,129,150,46.24
Rumble,Leona,327,157,170,48.01
Rumble,Akshan,88,45,43,51.14
Rumble,Samira,207,107,100,51.69
Rumble,Cassiopeia,84,35,49,41.67
Rumble,Varus,363,177,186,48.76
Rumble,Zac,220,130,90,59.09
Rumble,Sejuani,92,44,48,47.83
Rumble,Kayle,193,81,112,41.97
Rumble,Smolder,212,101,111,47.64
Rumble,Sylas,623,329,294,52.81
Rumble,Ornn,117,57,60,48.72
Rumble,Zoe,170,76,94,44.71
Rumble,Amumu,333,185,148,55.56
Rumble,Urgot,149,58,91,38.93
Rumble,Skarner,96,55,41,57.29
Rumble,Seraphine,185,87,98,47.03
Rumble,Karthus,140,60,80,42.86
Rumble,Yuumi,252,129,123,51.19
Rumble,KogMaw,127,52,75,40.94
Rumble,Thresh,471,213,258,45.22
Rumble,JarvanIV,269,107,162,39.78
Rumble,Neeko,116,40,76,34.48
Rumble,Yorick,238,99,139,41.6
Rumble,Taliyah,110,39,71,35.45
Rumble,Ryze,126,50,76,39.68
Rumble,Naafiri,87,37,50,42.53
Rumble,Zeri,170,91,79,53.53
Rumble,Nunu,150,79,71,52.67
Rumble,Ivern,42,25,17,59.52
Rumble,Aphelios,171,99,72,57.89
Rumble,Bard,127,46,81,36.22
Rumble,XinZhao,261,130,131,49.81
Rumble,Gwen,148,71,77,47.97
Rumble,Xayah,209,74,135,35.41
Rumble,Udyr,122,63,59,51.64
Rumble,Renekton,141,84,57,59.57
Rumble,FiddleSticks,175,67,108,38.29
Rumble,MonkeyKing,231,100,131,43.29
Rumble,Briar,221,97,124,43.89
Rumble,Vex,160,66,94,41.25
Rumble,Lillia,192,111,81,57.81
Rumble,Lissandra,115,53,62,46.09
Rumble,Shyvana,98,52,46,53.06
Rumble,Belveth,94,50,44,53.19
Rumble,Renata,53,23,30,43.4
Rumble,Fiora,153,71,82,46.41
Rumble,Janna,121,46,75,38.02
Rumble,Taric,75,29,46,38.67
Rumble,TwistedFate,139,70,69,50.36
Rumble,Olaf,166,84,82,50.6
Rumble,KSante,250,111,139,44.4
Rumble,Kalista,91,43,48,47.25
Rumble,Illaoi,158,93,65,58.86
Rumble,Sona,107,48,59,44.86
Rumble,Corki,174,85,89,48.85
Rumble,Nilah,55,29,26,52.73
Rumble,Rell,208,92,116,44.23
Rumble,RekSai,53,33,20,62.26
Akshan,Garen,649,349,300,53.78
Akshan,Diana,625,301,324,48.16
Akshan,Vladimir,300,122,178,40.67
Akshan,Caitlyn,1148,539,609,46.95
Akshan,Lulu,512,242,270,47.27
Akshan,Darius,882,434,448,49.21
Akshan,Sejuani,161,89,72,55.28
Akshan,Yone,729,373,356,51.17
Akshan,Ezreal,974,519,455,53.29
Akshan,Milio,255,105,150,41.18
Akshan,Sett,630,284,346,45.08
Akshan,Evelynn,149,72,77,48.32
Akshan,Ashe,837,405,432,48.39
Akshan,Pantheon,681,307,374,45.08
Akshan,KSante,164,103,61,62.8
Akshan,Nunu,231,113,118,48.92
Akshan,Sylas,531,280,251,52.73
Akshan,Tristana,509,234,275,45.97
Akshan,Warwick,637,317,320,49.76
Akshan,Ryze,154,85,69,55.19
Akshan,Mordekaiser,494,231,263,46.76
Akshan,Yasuo,707,343,364,48.51
Akshan,Jinx,1271,643,628,50.59
Akshan,Soraka,275,144,131,52.36
Akshan,Kayle,320,172,148,53.75
Akshan,Rengar,156,78,78,50
Akshan,Malzahar,503,234,269,46.52
Akshan,Vayne,673,335,338,49.78
Akshan,LeeSin,553,273,280,49.37
Akshan,Ahri,668,318,350,47.6
Akshan,Smolder,293,149,144,50.85
Akshan,Karma,535,240,295,44.86
Akshan,Fiora,177,90,87,50.85
Akshan,Yorick,471,212,259,45.01
Akshan,Katarina,304,167,137,54.93
Akshan,Kalista,99,64,35,64.65
Akshan,Poppy,230,113,117,49.13
Akshan,Chogath,573,264,309,46.07
Akshan,Shaco,430,212,218,49.3
Akshan,Rakan,175,90,85,51.43
Akshan,Teemo,581,295,286,50.77
Akshan,Ekko,454,222,232,48.9
Akshan,TwistedFate,163,83,80,50.92
Akshan,Leblanc,220,97,123,44.09
Akshan,Brand,325,144,181,44.31
Akshan,Olaf,121,42,79,34.71
Akshan,AurelionSol,176,77,99,43.75
Akshan,Xerath,357,171,186,47.9
Akshan,Lucian,283,163,120,57.6
Akshan,Nami,527,257,270,48.77
Akshan,Khazix,246,140,106,56.91
Akshan,Jhin,875,410,465,46.86
Akshan,Shen,238,101,137,42.44
Akshan,Naafiri,154,81,73,52.6
Akshan,Lux,1146,589,557,51.4
Akshan,Irelia,342,146,196,42.69
Akshan,Syndra,270,131,139,48.52
Akshan,Yuumi,369,175,194,47.43
Akshan,Tryndamere,265,137,128,51.7
Akshan,Vi,390,198,192,50.77
Akshan,Sivir,212,96,116,45.28
Akshan,Sona,135,61,74,45.19
Akshan,Riven,188,99,89,52.66
Akshan,Lillia,212,107,105,50.47
Akshan,Aurora,379,193,186,50.92
Akshan,Aatrox,425,218,207,51.29
Akshan,Ivern,66,36,30,54.55
Akshan,Corki,197,115,82,58.38
Akshan,Pyke,309,139,170,44.98
Akshan,JarvanIV,269,119,150,44.24
Akshan,Vex,251,105,146,41.83
Akshan,Talon,259,109,150,42.08
Akshan,Kassadin,85,47,38,55.29
Akshan,Briar,317,167,150,52.68
Akshan,Seraphine,337,152,185,45.1
Akshan,Gangplank,248,132,116,53.23
Akshan,MonkeyKing,299,153,146,51.17
Akshan,Fizz,237,119,118,50.21
Akshan,Kaisa,630,321,309,50.95
Akshan,Nautilus,415,201,214,48.43
Akshan,Volibear,500,265,235,53
Akshan,Kindred,186,85,101,45.7
Akshan,Draven,254,128,126,50.39
Akshan,Leona,370,198,172,53.51
Akshan,Malphite,541,264,277,48.8
Akshan,MissFortune,1048,524,524,50
Akshan,DrMundo,246,125,121,50.81
Akshan,Karthus,120,54,66,45
Akshan,RekSai,29,19,10,65.52
Akshan,Samira,301,136,165,45.18
Akshan,Rumble,88,43,45,48.86
Akshan,Udyr,183,61,122,33.33
Akshan,Veigar,418,196,222,46.89
Akshan,Hwei,272,161,111,59.19
Akshan,Zyra,344,172,172,50
Akshan,Zac,216,126,90,58.33
Akshan,Graves,290,142,148,48.97
Akshan,Kayn,659,361,298,54.78
Akshan,TahmKench,349,198,151,56.73
Akshan,Thresh,505,239,266,47.33
Akshan,Belveth,107,74,33,69.16
Akshan,Annie,137,65,72,47.45
Akshan,Blitzcrank,286,149,137,52.1
Akshan,MasterYi,538,302,236,56.13
Akshan,Morgana,512,273,239,53.32
Akshan,Viego,724,371,353,51.24
Akshan,Aphelios,258,135,123,52.33
Akshan,Jayce,227,99,128,43.61
Akshan,Hecarim,189,84,105,44.44
Akshan,Nilah,138,57,81,41.3
Akshan,Rell,183,97,86,53.01
Akshan,Urgot,222,98,124,44.14
Akshan,FiddleSticks,195,78,117,40
Akshan,Mel,843,460,383,54.57
Akshan,Heimerdinger,180,91,89,50.56
Akshan,Velkoz,249,145,104,58.23
Akshan,Ornn,173,72,101,41.62
Akshan,Akali,451,261,190,57.87
Akshan,Trundle,254,96,158,37.8
Akshan,Maokai,175,88,87,50.29
Akshan,Nocturne,572,245,327,42.83
Akshan,Swain,427,207,220,48.48
Akshan,Gragas,197,105,92,53.3
Akshan,Neeko,198,96,102,48.48
Akshan,Zeri,193,108,85,55.96
Akshan,Taric,97,51,46,52.58
Akshan,Gwen,191,107,84,56.02
Akshan,Ziggs,147,75,72,51.02
Akshan,Galio,292,146,146,50
Akshan,Xayah,127,48,79,37.8
Akshan,Alistar,132,62,70,46.97
Akshan,Illaoi,177,110,67,62.15
Akshan,Azir,156,80,76,51.28
Akshan,Zed,532,303,229,56.95
Akshan,Renekton,209,104,105,49.76
Akshan,Qiyana,123,66,57,53.66
Akshan,Senna,307,173,134,56.35
Akshan,Renata,91,39,52,42.86
Akshan,Rammus,130,73,57,56.15
Akshan,Singed,120,53,67,44.17
Akshan,Twitch,339,172,167,50.74
Akshan,Ambessa,276,133,143,48.19
Akshan,Zilean,140,80,60,57.14
Akshan,Taliyah,151,70,81,46.36
Akshan,Nasus,281,127,154,45.2
Akshan,Orianna,181,94,87,51.93
Akshan,Sion,307,111,196,36.16
Akshan,Elise,300,145,155,48.33
Akshan,Quinn,156,92,64,58.97
Akshan,Gnar,170,89,81,52.35
Akshan,Janna,175,68,107,38.86
Akshan,Varus,410,204,206,49.76
Akshan,Viktor,380,177,203,46.58
Akshan,Amumu,453,192,261,42.38
Akshan,Shyvana,101,60,41,59.41
Akshan,Camille,125,56,69,44.8
Akshan,Jax,397,206,191,51.89
Akshan,Anivia,151,75,76,49.67
Akshan,Skarner,125,61,64,48.8
Akshan,Lissandra,144,71,73,49.31
Akshan,Braum,274,121,153,44.16
Akshan,XinZhao,259,108,151,41.7
Akshan,Cassiopeia,120,48,72,40
Akshan,Bard,157,79,78,50.32
Akshan,KogMaw,146,66,80,45.21
Akshan,Zoe,220,118,102,53.64
Akshan,Kennen,98,55,43,56.12
Akshan,Kled,63,27,36,42.86
Akshan,Nidalee,101,64,37,63.37
TwistedFate,Jax,457,216,241,47.26
TwistedFate,Viego,695,333,362,47.91
TwistedFate,Aurora,371,187,184,50.4
TwistedFate,Vayne,561,268,293,47.77
TwistedFate,Lux,1081,490,591,45.33
TwistedFate,Malphite,401,185,216,46.13
TwistedFate,MasterYi,516,257,259,49.81
TwistedFate,Syndra,296,135,161,45.61
TwistedFate,Corki,220,129,91,58.64
TwistedFate,Soraka,236,117,119,49.58
TwistedFate,Aatrox,478,225,253,47.07
TwistedFate,Rengar,123,80,43,65.04
TwistedFate,Ezreal,1213,568,645,46.83
TwistedFate,Caitlyn,1246,604,642,48.48
TwistedFate,Neeko,181,99,82,54.7
TwistedFate,Teemo,520,213,307,40.96
TwistedFate,Skarner,115,64,51,55.65
TwistedFate,Yone,812,344,468,42.36
TwistedFate,Varus,392,188,204,47.96
TwistedFate,Blitzcrank,336,167,169,49.7
TwistedFate,Amumu,476,212,264,44.54
TwistedFate,Hwei,330,170,160,51.52
TwistedFate,Brand,346,192,154,55.49
TwistedFate,Gangplank,337,183,154,54.3
TwistedFate,Lillia,210,93,117,44.29
TwistedFate,Naafiri,120,42,78,35
TwistedFate,Karma,574,272,302,47.39
TwistedFate,Poppy,313,155,158,49.52
TwistedFate,Azir,183,90,93,49.18
TwistedFate,Karthus,164,97,67,59.15
TwistedFate,Seraphine,346,166,180,47.98
TwistedFate,Yorick,440,183,257,41.59
TwistedFate,Sejuani,176,85,91,48.3
TwistedFate,Samira,258,127,131,49.22
TwistedFate,Rell,213,82,131,38.5
TwistedFate,Ekko,398,196,202,49.25
TwistedFate,Ashe,918,427,491,46.51
TwistedFate,Maokai,156,79,77,50.64
TwistedFate,Kayle,334,141,193,42.22
TwistedFate,Mel,719,379,340,52.71
TwistedFate,Nami,497,220,277,44.27
TwistedFate,JarvanIV,323,156,167,48.3
TwistedFate,Malzahar,577,287,290,49.74
TwistedFate,KogMaw,120,45,75,37.5
TwistedFate,Thresh,678,362,316,53.39
TwistedFate,KSante,235,136,99,57.87
TwistedFate,Kayn,615,304,311,49.43
TwistedFate,Katarina,323,185,138,57.28
TwistedFate,Lulu,716,366,350,51.12
TwistedFate,Renekton,219,103,116,47.03
TwistedFate,Briar,306,137,169,44.77
TwistedFate,Zed,548,289,259,52.74
TwistedFate,Kindred,194,103,91,53.09
TwistedFate,Sett,619,301,318,48.63
TwistedFate,Pantheon,687,321,366,46.72
TwistedFate,Diana,755,333,422,44.11
TwistedFate,Jinx,1304,573,731,43.94
TwistedFate,Swain,373,208,165,55.76
TwistedFate,Shyvana,118,68,50,57.63
TwistedFate,Akshan,163,80,83,49.08
TwistedFate,Lucian,338,185,153,54.73
TwistedFate,Gwen,185,96,89,51.89
TwistedFate,Volibear,481,254,227,52.81
TwistedFate,Yasuo,802,410,392,51.12
TwistedFate,Sivir,219,94,125,42.92
TwistedFate,Zilean,154,63,91,40.91
TwistedFate,Xayah,202,95,107,47.03
TwistedFate,Yuumi,375,167,208,44.53
TwistedFate,Nasus,294,145,149,49.32
TwistedFate,Veigar,451,208,243,46.12
TwistedFate,Tristana,459,229,230,49.89
TwistedFate,Zac,234,112,122,47.86
TwistedFate,Akali,479,214,265,44.68
TwistedFate,Warwick,647,307,340,47.45
TwistedFate,Illaoi,217,100,117,46.08
TwistedFate,LeeSin,799,417,382,52.19
TwistedFate,Ambessa,279,156,123,55.91
TwistedFate,Vi,463,220,243,47.52
TwistedFate,Ryze,164,67,97,40.85
TwistedFate,Pyke,366,189,177,51.64
TwistedFate,Twitch,399,191,208,47.87
TwistedFate,Riven,234,125,109,53.42
TwistedFate,FiddleSticks,225,93,132,41.33
TwistedFate,Kaisa,830,420,410,50.6
TwistedFate,Talon,279,139,140,49.82
TwistedFate,Fizz,273,130,143,47.62
TwistedFate,Draven,323,161,162,49.85
TwistedFate,Tryndamere,238,114,124,47.9
TwistedFate,Leona,317,164,153,51.74
TwistedFate,Xerath,443,200,243,45.15
TwistedFate,Kalista,107,61,46,57.01
TwistedFate,Ziggs,171,87,84,50.88
TwistedFate,Darius,803,371,432,46.2
TwistedFate,XinZhao,301,132,169,43.85
TwistedFate,Viktor,492,203,289,41.26
TwistedFate,Ivern,53,21,32,39.62
TwistedFate,Zyra,457,210,247,45.95
TwistedFate,Renata,90,39,51,43.33
TwistedFate,Vladimir,253,137,116,54.15
TwistedFate,MonkeyKing,297,159,138,53.54
TwistedFate,Fiora,149,53,96,35.57
TwistedFate,Leblanc,266,120,146,45.11
TwistedFate,Gragas,242,122,120,50.41
TwistedFate,Zoe,220,115,105,52.27
TwistedFate,Aphelios,241,140,101,58.09
TwistedFate,Camille,183,100,83,54.64
TwistedFate,Rammus,107,53,54,49.53
TwistedFate,Garen,789,364,425,46.13
TwistedFate,Elise,315,134,181,42.54
TwistedFate,Shaco,445,222,223,49.89
TwistedFate,Ornn,169,70,99,41.42
TwistedFate,Milio,296,105,191,35.47
TwistedFate,Irelia,348,146,202,41.95
TwistedFate,Udyr,200,92,108,46
TwistedFate,Nilah,135,59,76,43.7
TwistedFate,Shen,248,109,139,43.95
TwistedFate,Ahri,669,312,357,46.64
TwistedFate,Chogath,509,235,274,46.17
TwistedFate,Graves,403,209,194,51.86
TwistedFate,Smolder,310,161,149,51.94
TwistedFate,TahmKench,367,179,188,48.77
TwistedFate,Nunu,223,88,135,39.46
TwistedFate,MissFortune,971,442,529,45.52
TwistedFate,Taliyah,159,56,103,35.22
TwistedFate,Kennen,84,32,52,38.1
TwistedFate,DrMundo,200,65,135,32.5
TwistedFate,Urgot,236,119,117,50.42
TwistedFate,Mordekaiser,510,268,242,52.55
TwistedFate,Jayce,240,115,125,47.92
TwistedFate,Sylas,705,377,328,53.48
TwistedFate,Braum,256,141,115,55.08
TwistedFate,Alistar,184,77,107,41.85
TwistedFate,Annie,175,93,82,53.14
TwistedFate,Singed,107,42,65,39.25
TwistedFate,Morgana,451,214,237,47.45
TwistedFate,Jhin,1034,437,597,42.26
TwistedFate,Sona,160,81,79,50.63
TwistedFate,Gnar,202,106,96,52.48
TwistedFate,Olaf,108,55,53,50.93
TwistedFate,Sion,312,109,203,34.94
TwistedFate,Trundle,284,140,144,49.3
TwistedFate,Kassadin,109,59,50,54.13
TwistedFate,Velkoz,238,95,143,39.92
TwistedFate,Qiyana,96,61,35,63.54
TwistedFate,Zeri,219,91,128,41.55
TwistedFate,Hecarim,205,91,114,44.39
TwistedFate,Nidalee,163,70,93,42.94
TwistedFate,Nautilus,486,214,272,44.03
TwistedFate,Evelynn,171,91,80,53.22
TwistedFate,Bard,134,71,63,52.99
TwistedFate,Vex,168,80,88,47.62
TwistedFate,Rakan,168,75,93,44.64
TwistedFate,Orianna,200,108,92,54
TwistedFate,Nocturne,584,232,352,39.73
TwistedFate,Janna,143,66,77,46.15
TwistedFate,Quinn,240,142,98,59.17
TwistedFate,Senna,309,172,137,55.66
TwistedFate,Anivia,178,83,95,46.63
TwistedFate,Galio,363,157,206,43.25
TwistedFate,AurelionSol,175,83,92,47.43
TwistedFate,Heimerdinger,166,56,110,33.73
TwistedFate,Cassiopeia,126,56,70,44.44
TwistedFate,Lissandra,166,71,95,42.77
TwistedFate,Rumble,139,69,70,49.64
TwistedFate,Belveth,81,38,43,46.91
TwistedFate,Taric,122,56,66,45.9
TwistedFate,Khazix,265,128,137,48.3
TwistedFate,Kled,105,44,61,41.9
TwistedFate,RekSai,60,37,23,61.67
TahmKench,Garen,1666,833,833,50
TahmKench,Graves,564,276,288,48.94
TahmKench,Malzahar,1103,488,615,44.24
TahmKench,Lucian,747,398,349,53.28
TahmKench,Lux,2562,1329,1233,51.87
TahmKench,Vex,415,196,219,47.23
TahmKench,Kayn,1372,659,713,48.03
TahmKench,Darius,1869,917,952,49.06
TahmKench,Ezreal,1964,994,970,50.61
TahmKench,Janna,336,185,151,55.06
TahmKench,Kayle,595,276,319,46.39
TahmKench,Ekko,956,460,496,48.12
TahmKench,Veigar,1100,531,569,48.27
TahmKench,Ziggs,342,171,171,50
TahmKench,Malphite,998,509,489,51
TahmKench,Shaco,858,367,491,42.77
TahmKench,Pantheon,1437,713,724,49.62
TahmKench,Jinx,2679,1212,1467,45.24
TahmKench,Lulu,966,443,523,45.86
TahmKench,Yasuo,1941,863,1078,44.46
TahmKench,Caitlyn,2585,1238,1347,47.89
TahmKench,Seraphine,674,279,395,41.39
TahmKench,Nidalee,204,104,100,50.98
TahmKench,Akali,976,441,535,45.18
TahmKench,Morgana,1213,549,664,45.26
TahmKench,Evelynn,385,165,220,42.86
TahmKench,Corki,298,163,135,54.7
TahmKench,Milio,480,199,281,41.46
TahmKench,Chogath,1283,611,672,47.62
TahmKench,RekSai,81,40,41,49.38
TahmKench,Katarina,703,308,395,43.81
TahmKench,Vayne,1518,684,834,45.06
TahmKench,Yorick,953,423,530,44.39
TahmKench,Udyr,379,192,187,50.66
TahmKench,Jhin,1839,911,928,49.54
TahmKench,Camille,302,154,148,50.99
TahmKench,Tristana,996,505,491,50.7
TahmKench,Thresh,1338,628,710,46.94
TahmKench,Riven,396,178,218,44.95
TahmKench,Nunu,483,223,260,46.17
TahmKench,Mel,1945,986,959,50.69
TahmKench,Nilah,298,142,156,47.65
TahmKench,Zoe,298,151,147,50.67
TahmKench,Khazix,418,189,229,45.22
TahmKench,Sejuani,375,187,188,49.87
TahmKench,Poppy,569,271,298,47.63
TahmKench,Diana,1496,710,786,47.46
TahmKench,Talon,514,287,227,55.84
TahmKench,Zilean,260,118,142,45.38
TahmKench,Illaoi,509,249,260,48.92
TahmKench,Briar,702,340,362,48.43
TahmKench,Nami,931,432,499,46.4
TahmKench,Yone,1688,887,801,52.55
TahmKench,Irelia,758,388,370,51.19
TahmKench,Warwick,1560,715,845,45.83
TahmKench,Smolder,596,300,296,50.34
TahmKench,Swain,985,468,517,47.51
TahmKench,Zyra,869,377,492,43.38
TahmKench,Jax,756,375,381,49.6
TahmKench,Zed,1129,570,559,50.49
TahmKench,Soraka,462,224,238,48.48
TahmKench,Karthus,248,137,111,55.24
TahmKench,Naafiri,329,149,180,45.29
TahmKench,Maokai,422,207,215,49.05
TahmKench,Draven,495,226,269,45.66
TahmKench,Rakan,311,130,181,41.8
TahmKench,Vi,816,376,440,46.08
TahmKench,Ahri,1243,624,619,50.2
TahmKench,Ashe,1878,981,897,52.24
TahmKench,Zeri,339,148,191,43.66
TahmKench,Leona,869,447,422,51.44
TahmKench,Singed,247,116,131,46.96
TahmKench,MasterYi,1300,650,650,50
TahmKench,Neeko,420,215,205,51.19
TahmKench,Braum,524,263,261,50.19
TahmKench,Shen,591,255,336,43.15
TahmKench,Fizz,579,312,267,53.89
TahmKench,Annie,272,100,172,36.76
TahmKench,Teemo,1181,559,622,47.33
TahmKench,Amumu,1134,521,613,45.94
TahmKench,MissFortune,2386,1106,1280,46.35
TahmKench,Leblanc,452,229,223,50.66
TahmKench,Twitch,797,416,381,52.2
TahmKench,Karma,1072,510,562,47.57
TahmKench,Aatrox,809,395,414,48.83
TahmKench,Viego,1437,692,745,48.16
TahmKench,Elise,631,352,279,55.78
TahmKench,Hwei,630,306,324,48.57
TahmKench,Gwen,565,282,283,49.91
TahmKench,Viktor,771,380,391,49.29
TahmKench,Sivir,476,220,256,46.22
TahmKench,Velkoz,594,296,298,49.83
TahmKench,Ornn,309,140,169,45.31
TahmKench,Xerath,767,388,379,50.59
TahmKench,Quinn,291,117,174,40.21
TahmKench,Sett,1541,692,849,44.91
TahmKench,Kennen,254,124,130,48.82
TahmKench,KSante,454,208,246,45.81
TahmKench,LeeSin,1204,626,578,51.99
TahmKench,Volibear,1138,539,599,47.36
TahmKench,Sylas,1220,582,638,47.7
TahmKench,Gangplank,430,211,219,49.07
TahmKench,Kaisa,1510,765,745,50.66
TahmKench,Urgot,566,270,296,47.7
TahmKench,Blitzcrank,714,338,376,47.34
TahmKench,Nasus,724,359,365,49.59
TahmKench,Nautilus,1190,569,621,47.82
TahmKench,DrMundo,541,240,301,44.36
TahmKench,Mordekaiser,1518,717,801,47.23
TahmKench,Nocturne,1339,616,723,46
TahmKench,FiddleSticks,473,215,258,45.45
TahmKench,KogMaw,290,162,128,55.86
TahmKench,XinZhao,510,235,275,46.08
TahmKench,Bard,239,123,116,51.46
TahmKench,Vladimir,578,317,261,54.84
TahmKench,Kindred,387,209,178,54.01
TahmKench,Kled,142,62,80,43.66
TahmKench,Tryndamere,618,331,287,53.56
TahmKench,Zac,378,176,202,46.56
TahmKench,Jayce,344,165,179,47.97
TahmKench,Gragas,505,265,240,52.48
TahmKench,Anivia,315,142,173,45.08
TahmKench,Varus,860,423,437,49.19
TahmKench,Taric,244,130,114,53.28
TahmKench,Rammus,246,117,129,47.56
TahmKench,Heimerdinger,448,208,240,46.43
TahmKench,Orianna,356,179,177,50.28
TahmKench,MonkeyKing,657,317,340,48.25
TahmKench,Senna,772,384,388,49.74
TahmKench,Fiora,351,158,193,45.01
TahmKench,Lillia,520,255,265,49.04
TahmKench,Galio,735,345,390,46.94
TahmKench,Aurora,604,318,286,52.65
TahmKench,Trundle,708,360,348,50.85
TahmKench,Cassiopeia,279,137,142,49.1
TahmKench,AurelionSol,368,174,194,47.28
TahmKench,Syndra,505,248,257,49.11
TahmKench,Skarner,207,104,103,50.24
TahmKench,Pyke,692,332,360,47.98
TahmKench,Renekton,433,190,243,43.88
TahmKench,Hecarim,371,190,181,51.21
TahmKench,Samira,655,272,383,41.53
TahmKench,Azir,292,130,162,44.52
TahmKench,Rell,510,245,265,48.04
TahmKench,Rumble,268,129,139,48.13
TahmKench,Ambessa,474,244,230,51.48
TahmKench,Kassadin,169,86,83,50.89
TahmKench,Yuumi,649,331,318,51
TahmKench,Ryze,276,120,156,43.48
TahmKench,Aphelios,480,212,268,44.17
TahmKench,Xayah,390,201,189,51.54
TahmKench,Sona,287,142,145,49.48
TahmKench,Belveth,228,105,123,46.05
TahmKench,Qiyana,193,109,84,56.48
TahmKench,Shyvana,215,117,98,54.42
TahmKench,Alistar,449,212,237,47.22
TahmKench,TwistedFate,367,188,179,51.23
TahmKench,Brand,846,363,483,42.91
TahmKench,Sion,635,300,335,47.24
TahmKench,Akshan,349,151,198,43.27
TahmKench,Kalista,199,121,78,60.8
TahmKench,Lissandra,275,142,133,51.64
TahmKench,Olaf,209,95,114,45.45
TahmKench,Ivern,101,65,36,64.36
TahmKench,Taliyah,185,105,80,56.76
TahmKench,Rengar,279,140,139,50.18
TahmKench,Gnar,416,231,185,55.53
TahmKench,JarvanIV,495,247,248,49.9
TahmKench,Renata,142,69,73,48.59
Graves,TahmKench,564,288,276,51.06
Graves,LeeSin,2245,1169,1076,52.07
Graves,Hwei,521,267,254,51.25
Graves,Tristana,808,426,382,52.72
Graves,Karma,1296,620,676,47.84
Graves,Aatrox,959,457,502,47.65
Graves,Kayn,1225,654,571,53.39
Graves,Katarina,648,281,367,43.36
Graves,Draven,474,199,275,41.98
Graves,Blitzcrank,648,355,293,54.78
Graves,Garen,1418,643,775,45.35
Graves,Volibear,813,415,398,51.05
Graves,Yasuo,1687,791,896,46.89
Graves,Mel,1600,784,816,49
Graves,Zilean,348,166,182,47.7
Graves,Poppy,482,235,247,48.76
Graves,Warwick,1109,552,557,49.77
Graves,Taliyah,255,105,150,41.18
Graves,MissFortune,1893,997,896,52.67
Graves,Morgana,910,470,440,51.65
Graves,Irelia,701,370,331,52.78
Graves,MasterYi,1051,536,515,51
Graves,Galio,778,391,387,50.26
Graves,Nautilus,1028,496,532,48.25
Graves,Yone,1608,839,769,52.18
Graves,Diana,1459,701,758,48.05
Graves,Fizz,495,243,252,49.09
Graves,Rell,423,223,200,52.72
Graves,Swain,817,361,456,44.19
Graves,Kaisa,1739,863,876,49.63
Graves,Darius,1677,811,866,48.36
Graves,Nocturne,1109,480,629,43.28
Graves,Samira,565,275,290,48.67
Graves,Lux,1894,973,921,51.37
Graves,Yorick,679,294,385,43.3
Graves,Udyr,308,159,149,51.62
Graves,Malzahar,853,429,424,50.29
Graves,Jhin,1891,972,919,51.4
Graves,Teemo,895,391,504,43.69
Graves,Chogath,1019,523,496,51.32
Graves,Varus,846,425,421,50.24
Graves,Jax,911,445,466,48.85
Graves,Vi,827,417,410,50.42
Graves,Ahri,1137,602,535,52.95
Graves,Ashe,1899,916,983,48.24
Graves,Thresh,1391,695,696,49.96
Graves,Urgot,386,225,161,58.29
Graves,Lulu,1388,689,699,49.64
Graves,Kayle,606,294,312,48.51
Graves,Ezreal,2423,1226,1197,50.6
Graves,Akali,889,484,405,54.44
Graves,Mordekaiser,999,500,499,50.05
Graves,Corki,381,172,209,45.14
Graves,Soraka,437,197,240,45.08
Graves,Trundle,411,214,197,52.07
Graves,Kindred,474,268,206,56.54
Graves,Nasus,558,265,293,47.49
Graves,Kennen,219,87,132,39.73
Graves,Janna,303,158,145,52.15
Graves,Fiora,331,181,150,54.68
Graves,Zoe,368,194,174,52.72
Graves,Yuumi,834,377,457,45.2
Graves,Ornn,304,164,140,53.95
Graves,JarvanIV,572,307,265,53.67
Graves,Caitlyn,2271,1127,1144,49.63
Graves,MonkeyKing,702,349,353,49.72
Graves,Talon,675,298,377,44.15
Graves,Twitch,646,347,299,53.72
Graves,Brand,563,295,268,52.4
Graves,Kled,163,85,78,52.15
Graves,Shaco,895,479,416,53.52
Graves,FiddleSticks,478,234,244,48.95
Graves,Kassadin,208,114,94,54.81
Graves,Qiyana,226,140,86,61.95
Graves,Gragas,516,284,232,55.04
Graves,Briar,522,237,285,45.4
Graves,Heimerdinger,319,159,160,49.84
Graves,Pantheon,1375,691,684,50.25
Graves,Viktor,843,450,393,53.38
Graves,Ziggs,320,140,180,43.75
Graves,RekSai,127,68,59,53.54
Graves,Viego,1350,675,675,50
Graves,Cassiopeia,198,111,87,56.06
Graves,Naafiri,233,90,143,38.63
Graves,Vex,421,229,192,54.39
Graves,Ekko,796,356,440,44.72
Graves,Renata,140,63,77,45
Graves,Annie,308,136,172,44.16
Graves,Braum,485,219,266,45.15
Graves,DrMundo,402,217,185,53.98
Graves,Orianna,353,170,183,48.16
Graves,Sett,1178,555,623,47.11
Graves,Ivern,170,75,95,44.12
Graves,Zac,491,244,247,49.69
Graves,Zyra,840,386,454,45.95
Graves,Ambessa,553,259,294,46.84
Graves,Zed,1011,506,505,50.05
Graves,Sona,237,115,122,48.52
Graves,Rumble,278,147,131,52.88
Graves,Amumu,688,327,361,47.53
Graves,Leblanc,700,368,332,52.57
Graves,Vladimir,573,295,278,51.48
Graves,Anivia,321,122,199,38.01
Graves,Sylas,1328,691,637,52.03
Graves,Jayce,639,293,346,45.85
Graves,Khazix,597,285,312,47.74
Graves,Kalista,230,120,110,52.17
Graves,Vayne,1009,487,522,48.27
Graves,Alistar,451,229,222,50.78
Graves,Pyke,704,415,289,58.95
Graves,Shen,524,279,245,53.24
Graves,Lillia,488,243,245,49.8
Graves,Riven,409,196,213,47.92
Graves,Jinx,2578,1189,1389,46.12
Graves,Renekton,453,269,184,59.38
Graves,Sejuani,364,168,196,46.15
Graves,Aphelios,469,230,239,49.04
Graves,Senna,583,276,307,47.34
Graves,Nunu,396,211,185,53.28
Graves,Nami,904,396,508,43.81
Graves,Camille,426,230,196,53.99
Graves,Veigar,770,404,366,52.47
Graves,Maokai,359,176,183,49.03
Graves,Leona,709,347,362,48.94
Graves,Illaoi,325,197,128,60.62
Graves,KogMaw,253,146,107,57.71
Graves,Hecarim,338,165,173,48.82
Graves,Syndra,664,302,362,45.48
Graves,Velkoz,464,199,265,42.89
Graves,Milio,484,236,248,48.76
Graves,Sion,632,354,278,56.01
Graves,Shyvana,256,110,146,42.97
Graves,AurelionSol,433,190,243,43.88
Graves,Lissandra,344,173,171,50.29
Graves,Gangplank,568,280,288,49.3
Graves,Aurora,606,322,284,53.14
Graves,Lucian,766,402,364,52.48
Graves,Gwen,397,194,203,48.87
Graves,Olaf,201,117,84,58.21
Graves,Nidalee,404,217,187,53.71
Graves,Bard,233,73,160,31.33
Graves,TwistedFate,403,194,209,48.14
Graves,Rakan,407,210,197,51.6
Graves,Belveth,207,82,125,39.61
Graves,XinZhao,739,349,390,47.23
Graves,Zeri,380,176,204,46.32
Graves,Xerath,926,484,442,52.27
Graves,Tryndamere,470,243,227,51.7
Graves,Smolder,533,273,260,51.22
Graves,Evelynn,275,121,154,44
Graves,Singed,273,101,172,37
Graves,Rammus,235,115,120,48.94
Graves,Malphite,809,341,468,42.15
Graves,Akshan,290,148,142,51.03
Graves,KSante,536,245,291,45.71
Graves,Ryze,339,156,183,46.02
Graves,Gnar,374,194,180,51.87
Graves,Skarner,210,123,87,58.57
Graves,Seraphine,486,262,224,53.91
Graves,Karthus,300,120,180,40
Graves,Sivir,452,224,228,49.56
Graves,Quinn,296,141,155,47.64
Graves,Rengar,283,170,113,60.07
Graves,Elise,678,362,316,53.39
Graves,Neeko,322,146,176,45.34
Graves,Xayah,329,144,185,43.77
Graves,Nilah,196,85,111,43.37
Graves,Azir,318,162,156,50.94
Graves,Taric,155,80,75,51.61
XinZhao,Renekton,445,217,228,48.76
XinZhao,Evelynn,241,123,118,51.04
XinZhao,Lissandra,246,127,119,51.63
XinZhao,Corki,353,188,165,53.26
XinZhao,Rakan,334,188,146,56.29
XinZhao,Jax,814,413,401,50.74
XinZhao,Rengar,195,104,91,53.33
XinZhao,Camille,351,180,171,51.28
XinZhao,Sivir,413,213,200,51.57
XinZhao,Karma,1205,525,680,43.57
XinZhao,Yone,1615,870,745,53.87
XinZhao,Samira,522,241,281,46.17
XinZhao,Yasuo,1619,834,785,51.51
XinZhao,Jhin,1698,894,804,52.65
XinZhao,Varus,792,421,371,53.16
XinZhao,Mordekaiser,1098,488,610,44.44
XinZhao,Kayn,1139,527,612,46.27
XinZhao,Aurora,569,279,290,49.03
XinZhao,Morgana,1057,520,537,49.2
XinZhao,Nunu,408,215,193,52.7
XinZhao,Irelia,721,353,368,48.96
XinZhao,Mel,1727,951,776,55.07
XinZhao,Lux,1954,988,966,50.56
XinZhao,Warwick,1203,573,630,47.63
XinZhao,Skarner,253,178,75,70.36
XinZhao,Veigar,774,423,351,54.65
XinZhao,Draven,440,220,220,50
XinZhao,Garen,1396,667,729,47.78
XinZhao,DrMundo,397,198,199,49.87
XinZhao,AurelionSol,310,154,156,49.68
XinZhao,Xayah,443,226,217,51.02
XinZhao,Nami,902,437,465,48.45
XinZhao,Trundle,518,242,276,46.72
XinZhao,Malzahar,930,452,478,48.6
XinZhao,Akali,958,448,510,46.76
XinZhao,Yorick,908,452,456,49.78
XinZhao,Nautilus,957,449,508,46.92
XinZhao,Olaf,223,115,108,51.57
XinZhao,Cassiopeia,256,138,118,53.91
XinZhao,LeeSin,1805,944,861,52.3
XinZhao,Leblanc,619,304,315,49.11
XinZhao,KogMaw,273,119,154,43.59
XinZhao,Lulu,1311,642,669,48.97
XinZhao,Pantheon,1359,702,657,51.66
XinZhao,Diana,1527,755,772,49.44
XinZhao,Caitlyn,2307,1140,1167,49.41
XinZhao,FiddleSticks,490,247,243,50.41
XinZhao,Kaisa,1557,827,730,53.11
XinZhao,Seraphine,650,357,293,54.92
XinZhao,Malphite,879,440,439,50.06
XinZhao,Udyr,323,184,139,56.97
XinZhao,Orianna,392,196,196,50
XinZhao,Aatrox,904,439,465,48.56
XinZhao,Chogath,955,482,473,50.47
XinZhao,Ashe,1836,970,866,52.83
XinZhao,Zyra,829,425,404,51.27
XinZhao,Volibear,954,471,483,49.37
XinZhao,Vi,1004,515,489,51.29
XinZhao,Zoe,272,178,94,65.44
XinZhao,Velkoz,492,260,232,52.85
XinZhao,Sion,610,266,344,43.61
XinZhao,Annie,325,158,167,48.62
XinZhao,MissFortune,2010,1063,947,52.89
XinZhao,Sona,261,144,117,55.17
XinZhao,Vladimir,555,274,281,49.37
XinZhao,Ivern,70,46,24,65.71
XinZhao,Zed,1064,576,488,54.14
XinZhao,TahmKench,510,275,235,53.92
XinZhao,Azir,327,161,166,49.24
XinZhao,Jinx,2455,1221,1234,49.74
XinZhao,Kayle,533,289,244,54.22
XinZhao,Belveth,227,123,104,54.19
XinZhao,Ezreal,2373,1216,1157,51.24
XinZhao,Thresh,1274,614,660,48.19
XinZhao,Urgot,362,131,231,36.19
XinZhao,Sejuani,410,174,236,42.44
XinZhao,Vayne,1121,525,596,46.83
XinZhao,Ekko,846,433,413,51.18
XinZhao,Ziggs,311,155,156,49.84
XinZhao,Brand,644,354,290,54.97
XinZhao,Sett,1263,580,683,45.92
XinZhao,Teemo,897,437,460,48.72
XinZhao,Darius,1689,869,820,51.45
XinZhao,Kassadin,158,85,73,53.8
XinZhao,Senna,587,322,265,54.86
XinZhao,Khazix,426,226,200,53.05
XinZhao,Soraka,435,165,270,37.93
XinZhao,Viego,1318,654,664,49.62
XinZhao,Viktor,844,411,433,48.7
XinZhao,Shaco,729,349,380,47.87
XinZhao,JarvanIV,656,317,339,48.32
XinZhao,Heimerdinger,313,144,169,46.01
XinZhao,TwistedFate,301,169,132,56.15
XinZhao,Kindred,362,191,171,52.76
XinZhao,MasterYi,1050,556,494,52.95
XinZhao,Ahri,1200,602,598,50.17
XinZhao,Hecarim,319,172,147,53.92
XinZhao,Galio,762,410,352,53.81
XinZhao,Gangplank,536,316,220,58.96
XinZhao,Elise,688,371,317,53.92
XinZhao,Katarina,686,340,346,49.56
XinZhao,Rell,407,183,224,44.96
XinZhao,Twitch,633,327,306,51.66
XinZhao,MonkeyKing,652,243,409,37.27
XinZhao,Milio,437,189,248,43.25
XinZhao,Leona,781,396,385,50.7
XinZhao,Rammus,257,131,126,50.97
XinZhao,Nidalee,277,159,118,57.4
XinZhao,Aphelios,466,200,266,42.92
XinZhao,Blitzcrank,600,312,288,52
XinZhao,Illaoi,362,201,161,55.52
XinZhao,Nilah,227,95,132,41.85
XinZhao,Alistar,405,193,212,47.65
XinZhao,Tryndamere,491,234,257,47.66
XinZhao,Braum,516,264,252,51.16
XinZhao,Anivia,269,145,124,53.9
XinZhao,Shyvana,185,97,88,52.43
XinZhao,Amumu,835,434,401,51.98
XinZhao,Lucian,664,314,350,47.29
XinZhao,Sylas,1292,621,671,48.07
XinZhao,Hwei,575,310,265,53.91
XinZhao,Poppy,585,291,294,49.74
XinZhao,Graves,739,390,349,52.77
XinZhao,Gwen,424,202,222,47.64
XinZhao,Nocturne,1291,636,655,49.26
XinZhao,Fizz,519,274,245,52.79
XinZhao,Shen,485,191,294,39.38
XinZhao,Fiora,252,146,106,57.94
XinZhao,Nasus,547,258,289,47.17
XinZhao,Yuumi,692,354,338,51.16
XinZhao,Kennen,212,93,119,43.87
XinZhao,Gnar,367,201,166,54.77
XinZhao,Smolder,537,305,232,56.8
XinZhao,Pyke,627,333,294,53.11
XinZhao,Xerath,799,431,368,53.94
XinZhao,Ryze,307,168,139,54.72
XinZhao,Karthus,278,138,140,49.64
XinZhao,Gragas,426,246,180,57.75
XinZhao,Briar,593,248,345,41.82
XinZhao,Syndra,561,234,327,41.71
XinZhao,Kled,139,68,71,48.92
XinZhao,RekSai,116,55,61,47.41
XinZhao,Qiyana,204,90,114,44.12
XinZhao,Taliyah,232,120,112,51.72
XinZhao,Quinn,237,138,99,58.23
XinZhao,Ambessa,613,361,252,58.89
XinZhao,Tristana,891,428,463,48.04
XinZhao,Singed,212,91,121,42.92
XinZhao,Lillia,463,248,215,53.56
XinZhao,Zeri,371,208,163,56.06
XinZhao,Swain,900,432,468,48
XinZhao,Maokai,398,198,200,49.75
XinZhao,Riven,427,259,168,60.66
XinZhao,Zac,487,225,262,46.2
XinZhao,Talon,584,337,247,57.71
XinZhao,Janna,274,132,142,48.18
XinZhao,Rumble,261,131,130,50.19
XinZhao,KSante,521,261,260,50.1
XinZhao,Zilean,265,130,135,49.06
XinZhao,Vex,483,246,237,50.93
XinZhao,Taric,191,98,93,51.31
XinZhao,Kalista,243,125,118,51.44
XinZhao,Bard,241,133,108,55.19
XinZhao,Jayce,484,230,254,47.52
XinZhao,Ornn,323,148,175,45.82
XinZhao,Neeko,355,178,177,50.14
XinZhao,Akshan,259,151,108,58.3
XinZhao,Naafiri,260,126,134,48.46
XinZhao,Renata,120,84,36,70
Maokai,Yorick,590,236,354,40
Maokai,JarvanIV,293,148,145,50.51
Maokai,Mel,1075,556,519,51.72
Maokai,Jinx,1592,794,798,49.87
Maokai,Lux,1433,698,735,48.71
Maokai,Olaf,167,104,63,62.28
Maokai,Shaco,560,288,272,51.43
Maokai,Lissandra,176,85,91,48.3
Maokai,Ashe,1189,626,563,52.65
Maokai,Leona,510,217,293,42.55
Maokai,Kayle,420,210,210,50
Maokai,Elise,464,247,217,53.23
Maokai,Swain,551,261,290,47.37
Maokai,Kalista,148,71,77,47.97
Maokai,Karma,753,370,383,49.14
Maokai,Darius,1111,586,525,52.75
Maokai,Nocturne,759,363,396,47.83
Maokai,Ahri,784,405,379,51.66
Maokai,KogMaw,203,98,105,48.28
Maokai,Braum,319,142,177,44.51
Maokai,Morgana,722,323,399,44.74
Maokai,Warwick,817,352,465,43.08
Maokai,Malzahar,583,332,251,56.95
Maokai,Blitzcrank,393,213,180,54.2
Maokai,Poppy,401,199,202,49.63
Maokai,Viego,844,414,430,49.05
Maokai,Pyke,516,291,225,56.4
Maokai,Jayce,259,142,117,54.83
Maokai,Diana,968,462,506,47.73
Maokai,Anivia,232,93,139,40.09
Maokai,Ezreal,1509,765,744,50.7
Maokai,TahmKench,422,215,207,50.95
Maokai,KSante,353,188,165,53.26
Maokai,Nunu,314,151,163,48.09
Maokai,Sylas,956,527,429,55.13
Maokai,Tristana,596,269,327,45.13
Maokai,Teemo,764,363,401,47.51
Maokai,TwistedFate,156,77,79,49.36
Maokai,Xayah,278,114,164,41.01
Maokai,Zyra,702,327,375,46.58
Maokai,Kindred,257,124,133,48.25
Maokai,Akali,567,288,279,50.79
Maokai,MissFortune,1341,652,689,48.62
Maokai,Nami,514,259,255,50.39
Maokai,Fiora,207,81,126,39.13
Maokai,Khazix,220,110,110,50
Maokai,Ekko,562,304,258,54.09
Maokai,Lucian,386,180,206,46.63
Maokai,Viktor,635,330,305,51.97
Maokai,Twitch,425,227,198,53.41
Maokai,Yone,1076,519,557,48.23
Maokai,Kassadin,112,47,65,41.96
Maokai,Sett,884,444,440,50.23
Maokai,Syndra,382,192,190,50.26
Maokai,Vayne,807,388,419,48.08
Maokai,Sion,410,185,225,45.12
Maokai,Evelynn,187,82,105,43.85
Maokai,Annie,181,91,90,50.28
Maokai,Sona,140,65,75,46.43
Maokai,Gangplank,314,147,167,46.82
Maokai,Kayn,806,371,435,46.03
Maokai,Xerath,524,247,277,47.14
Maokai,Smolder,360,168,192,46.67
Maokai,Lulu,805,447,358,55.53
Maokai,Jhin,1093,608,485,55.63
Maokai,Soraka,248,120,128,48.39
Maokai,Heimerdinger,215,103,112,47.91
Maokai,Zed,676,354,322,52.37
Maokai,Veigar,572,306,266,53.5
Maokai,Caitlyn,1539,803,736,52.18
Maokai,Neeko,301,150,151,49.83
Maokai,MonkeyKing,380,189,191,49.74
Maokai,Varus,527,259,268,49.15
Maokai,Kaisa,1017,576,441,56.64
Maokai,Nautilus,642,343,299,53.43
Maokai,Vi,467,241,226,51.61
Maokai,Thresh,731,400,331,54.72
Maokai,Renekton,284,114,170,40.14
Maokai,Fizz,290,138,152,47.59
Maokai,Aphelios,273,143,130,52.38
Maokai,Malphite,581,336,245,57.83
Maokai,Ornn,238,112,126,47.06
Maokai,Hecarim,247,143,104,57.89
Maokai,Volibear,716,376,340,52.51
Maokai,AurelionSol,214,95,119,44.39
Maokai,Renata,122,65,57,53.28
Maokai,Zeri,267,156,111,58.43
Maokai,Rell,297,153,144,51.52
Maokai,Jax,512,250,262,48.83
Maokai,MasterYi,661,333,328,50.38
Maokai,Vex,283,141,142,49.82
Maokai,Vladimir,379,179,200,47.23
Maokai,FiddleSticks,296,151,145,51.01
Maokai,LeeSin,923,522,401,56.55
Maokai,Chogath,716,363,353,50.7
Maokai,Graves,359,183,176,50.97
Maokai,Gnar,246,126,120,51.22
Maokai,Leblanc,440,235,205,53.41
Maokai,Senna,405,191,214,47.16
Maokai,Illaoi,317,139,178,43.85
Maokai,Yasuo,1114,577,537,51.8
Maokai,Karthus,196,119,77,60.71
Maokai,Brand,440,210,230,47.73
Maokai,Katarina,369,178,191,48.24
Maokai,Mordekaiser,774,381,393,49.22
Maokai,Irelia,493,235,258,47.67
Maokai,Rumble,173,93,80,53.76
Maokai,Ziggs,189,94,95,49.74
Maokai,Camille,195,112,83,57.44
Maokai,Pantheon,944,491,453,52.01
Maokai,Riven,217,98,119,45.16
Maokai,Rakan,250,101,149,40.4
Maokai,Ryze,200,87,113,43.5
Maokai,Tryndamere,264,107,157,40.53
Maokai,Shen,360,190,170,52.78
Maokai,Sejuani,251,140,111,55.78
Maokai,Yuumi,442,232,210,52.49
Maokai,Milio,298,125,173,41.95
Maokai,Skarner,158,75,83,47.47
Maokai,Kennen,161,94,67,58.39
Maokai,Zoe,242,129,113,53.31
Maokai,Samira,457,210,247,45.95
Maokai,Taric,148,90,58,60.81
Maokai,Ambessa,391,232,159,59.34
Maokai,Aatrox,511,258,253,50.49
Maokai,Hwei,414,177,237,42.75
Maokai,Briar,394,173,221,43.91
Maokai,Zac,258,144,114,55.81
Maokai,Corki,237,127,110,53.59
Maokai,Zilean,222,108,114,48.65
Maokai,Gragas,331,204,127,61.63
Maokai,Shyvana,163,86,77,52.76
Maokai,Sivir,274,138,136,50.36
Maokai,Aurora,408,240,168,58.82
Maokai,Udyr,263,126,137,47.91
Maokai,Bard,218,120,98,55.05
Maokai,Nasus,406,194,212,47.78
Maokai,Quinn,204,94,110,46.08
Maokai,Singed,117,47,70,40.17
Maokai,Trundle,318,161,157,50.63
Maokai,Urgot,289,127,162,43.94
Maokai,Janna,193,106,87,54.92
Maokai,Talon,385,194,191,50.39
Maokai,Nilah,198,101,97,51.01
Maokai,Lillia,347,163,184,46.97
Maokai,Azir,205,102,103,49.76
Maokai,Akshan,175,87,88,49.71
Maokai,Seraphine,412,232,180,56.31
Maokai,Gwen,287,156,131,54.36
Maokai,Naafiri,165,90,75,54.55
Maokai,Orianna,275,137,138,49.82
Maokai,Velkoz,322,178,144,55.28
Maokai,XinZhao,398,200,198,50.25
Maokai,RekSai,85,36,49,42.35
Maokai,Amumu,576,291,285,50.52
Maokai,Garen,934,488,446,52.25
Maokai,Rammus,172,92,80,53.49
Maokai,DrMundo,314,158,156,50.32
Maokai,Cassiopeia,171,90,81,52.63
Maokai,Taliyah,130,75,55,57.69
Maokai,Kled,108,68,40,62.96
Maokai,Qiyana,135,87,48,64.44
Maokai,Draven,244,108,136,44.26
Maokai,Rengar,165,96,69,58.18
Maokai,Galio,544,278,266,51.1
Maokai,Nidalee,152,81,71,53.29
Maokai,Belveth,174,102,72,58.62
Maokai,Ivern,88,51,37,57.95
Maokai,Alistar,280,143,137,51.07
JarvanIV,Urgot,340,159,181,46.76
JarvanIV,Talon,437,220,217,50.34
JarvanIV,Ahri,1229,628,601,51.1
JarvanIV,Aphelios,384,200,184,52.08
JarvanIV,Maokai,293,145,148,49.49
JarvanIV,Renekton,458,250,208,54.59
JarvanIV,Diana,1236,604,632,48.87
JarvanIV,Aurora,610,336,274,55.08
JarvanIV,Corki,397,191,206,48.11
JarvanIV,Pantheon,1262,675,587,53.49
JarvanIV,Irelia,628,313,315,49.84
JarvanIV,Katarina,576,325,251,56.42
JarvanIV,Varus,761,394,367,51.77
JarvanIV,Soraka,547,270,277,49.36
JarvanIV,Poppy,486,239,247,49.18
JarvanIV,Viego,1087,570,517,52.44
JarvanIV,Lux,1825,951,874,52.11
JarvanIV,Vayne,996,505,491,50.7
JarvanIV,Nami,988,458,530,46.36
JarvanIV,Garen,1340,669,671,49.93
JarvanIV,MasterYi,887,420,467,47.35
JarvanIV,Sylas,1094,514,580,46.98
JarvanIV,Mel,1475,813,662,55.12
JarvanIV,Zilean,324,178,146,54.94
JarvanIV,KSante,431,254,177,58.93
JarvanIV,Naafiri,220,108,112,49.09
JarvanIV,Twitch,673,405,268,60.18
JarvanIV,Swain,707,341,366,48.23
JarvanIV,Jinx,2390,1241,1149,51.92
JarvanIV,Pyke,534,281,253,52.62
JarvanIV,Camille,279,149,130,53.41
JarvanIV,Belveth,209,129,80,61.72
JarvanIV,Lissandra,263,139,124,52.85
JarvanIV,Smolder,491,241,250,49.08
JarvanIV,Zyra,743,355,388,47.78
JarvanIV,Gragas,454,260,194,57.27
JarvanIV,Amumu,842,418,424,49.64
JarvanIV,Velkoz,451,229,222,50.78
JarvanIV,Nunu,464,256,208,55.17
JarvanIV,Thresh,1212,557,655,45.96
JarvanIV,LeeSin,1294,702,592,54.25
JarvanIV,Vladimir,545,277,268,50.83
JarvanIV,Zed,868,483,385,55.65
JarvanIV,Gnar,295,152,143,51.53
JarvanIV,Skarner,194,112,82,57.73
JarvanIV,Tristana,808,365,443,45.17
JarvanIV,Leona,565,294,271,52.04
JarvanIV,Illaoi,324,167,157,51.54
JarvanIV,Rengar,267,157,110,58.8
JarvanIV,Leblanc,474,255,219,53.8
JarvanIV,MissFortune,1699,808,891,47.56
JarvanIV,Nautilus,841,420,421,49.94
JarvanIV,Volibear,906,459,447,50.66
JarvanIV,Graves,572,265,307,46.33
JarvanIV,Syndra,523,254,269,48.57
JarvanIV,Milio,429,217,212,50.58
JarvanIV,Anivia,245,114,131,46.53
JarvanIV,Ashe,1586,826,760,52.08
JarvanIV,Sett,981,446,535,45.46
JarvanIV,Kayn,1074,535,539,49.81
JarvanIV,Mordekaiser,964,454,510,47.1
JarvanIV,Lulu,1213,709,504,58.45
JarvanIV,Malzahar,926,414,512,44.71
JarvanIV,Ezreal,2074,1088,986,52.46
JarvanIV,Briar,534,238,296,44.57
JarvanIV,Qiyana,188,124,64,65.96
JarvanIV,Ornn,323,177,146,54.8
JarvanIV,Singed,225,111,114,49.33
JarvanIV,TwistedFate,323,167,156,51.7
JarvanIV,Morgana,790,418,372,52.91
JarvanIV,Jax,693,326,367,47.04
JarvanIV,Malphite,840,426,414,50.71
JarvanIV,Yuumi,650,330,320,50.77
JarvanIV,Ekko,737,349,388,47.35
JarvanIV,Fizz,494,226,268,45.75
JarvanIV,Lucian,521,293,228,56.24
JarvanIV,Trundle,373,170,203,45.58
JarvanIV,Ryze,311,134,177,43.09
JarvanIV,Caitlyn,2016,1067,949,52.93
JarvanIV,Zac,388,191,197,49.23
JarvanIV,Kaisa,1418,659,759,46.47
JarvanIV,Rakan,286,152,134,53.15
JarvanIV,Heimerdinger,277,134,143,48.38
JarvanIV,Yone,1375,720,655,52.36
JarvanIV,Karma,1051,550,501,52.33
JarvanIV,Seraphine,531,272,259,51.22
JarvanIV,Sejuani,337,198,139,58.75
JarvanIV,Nilah,224,96,128,42.86
JarvanIV,Teemo,855,462,393,54.04
JarvanIV,Jhin,1613,897,716,55.61
JarvanIV,MonkeyKing,699,355,344,50.79
JarvanIV,Ivern,147,65,82,44.22
JarvanIV,Yasuo,1402,716,686,51.07
JarvanIV,Kled,151,102,49,67.55
JarvanIV,Yorick,715,365,350,51.05
JarvanIV,Shaco,692,379,313,54.77
JarvanIV,Sona,279,130,149,46.59
JarvanIV,Draven,511,232,279,45.4
JarvanIV,Braum,493,240,253,48.68
JarvanIV,Gangplank,501,252,249,50.3
JarvanIV,Darius,1530,740,790,48.37
JarvanIV,Viktor,793,403,390,50.82
JarvanIV,Nocturne,1248,621,627,49.76
JarvanIV,Ziggs,257,138,119,53.7
JarvanIV,Ambessa,469,257,212,54.8
JarvanIV,Warwick,1054,519,535,49.24
JarvanIV,Riven,368,192,176,52.17
JarvanIV,Chogath,982,519,463,52.85
JarvanIV,Galio,706,372,334,52.69
JarvanIV,Kayle,580,280,300,48.28
JarvanIV,Vi,817,403,414,49.33
JarvanIV,Janna,303,147,156,48.51
JarvanIV,Sion,545,279,266,51.19
JarvanIV,XinZhao,656,339,317,51.68
JarvanIV,Vex,348,146,202,41.95
JarvanIV,Shen,565,298,267,52.74
JarvanIV,Elise,627,314,313,50.08
JarvanIV,Khazix,369,193,176,52.3
JarvanIV,Azir,262,109,153,41.6
JarvanIV,Alistar,398,228,170,57.29
JarvanIV,Rell,372,176,196,47.31
JarvanIV,Akshan,269,150,119,55.76
JarvanIV,Hecarim,362,178,184,49.17
JarvanIV,Kassadin,140,76,64,54.29
JarvanIV,Brand,585,286,299,48.89
JarvanIV,DrMundo,352,184,168,52.27
JarvanIV,Shyvana,222,121,101,54.5
JarvanIV,Karthus,214,82,132,38.32
JarvanIV,Xayah,337,181,156,53.71
JarvanIV,Kindred,386,196,190,50.78
JarvanIV,Akali,742,362,380,48.79
JarvanIV,Bard,251,136,115,54.18
JarvanIV,Kennen,222,119,103,53.6
JarvanIV,KogMaw,270,130,140,48.15
JarvanIV,Sivir,494,231,263,46.76
JarvanIV,Cassiopeia,268,148,120,55.22
JarvanIV,Xerath,738,401,337,54.34
JarvanIV,Tryndamere,414,203,211,49.03
JarvanIV,Taric,164,81,83,49.39
JarvanIV,Aatrox,794,405,389,51.01
JarvanIV,Neeko,249,128,121,51.41
JarvanIV,Evelynn,260,120,140,46.15
JarvanIV,Kalista,207,91,116,43.96
JarvanIV,Annie,298,160,138,53.69
JarvanIV,Samira,361,168,193,46.54
JarvanIV,Zeri,347,195,152,56.2
JarvanIV,Hwei,487,244,243,50.1
JarvanIV,Veigar,724,359,365,49.59
JarvanIV,RekSai,104,53,51,50.96
JarvanIV,Rumble,269,162,107,60.22
JarvanIV,Fiora,221,89,132,40.27
JarvanIV,Nidalee,256,157,99,61.33
JarvanIV,TahmKench,495,248,247,50.1
JarvanIV,Quinn,280,143,137,51.07
JarvanIV,FiddleSticks,430,199,231,46.28
JarvanIV,Senna,618,294,324,47.57
JarvanIV,Nasus,529,249,280,47.07
JarvanIV,Rammus,168,74,94,44.05
JarvanIV,Udyr,324,192,132,59.26
JarvanIV,Orianna,374,205,169,54.81
JarvanIV,Taliyah,186,106,80,56.99
JarvanIV,Gwen,379,220,159,58.05
JarvanIV,Jayce,395,236,159,59.75
JarvanIV,Blitzcrank,519,295,224,56.84
JarvanIV,Lillia,382,212,170,55.5
JarvanIV,AurelionSol,298,135,163,45.3
JarvanIV,Renata,147,51,96,34.69
JarvanIV,Olaf,172,90,82,52.33
JarvanIV,Zoe,300,156,144,52
Brand,Nautilus,1085,590,495,54.38
Brand,FiddleSticks,448,250,198,55.8
Brand,Vladimir,621,325,296,52.33
Brand,Jhin,1918,922,996,48.07
Brand,Morgana,1406,686,720,48.79
Brand,Yorick,1046,518,528,49.52
Brand,Volibear,1237,643,594,51.98
Brand,LeeSin,1204,612,592,50.83
Brand,Caitlyn,2916,1497,1419,51.34
Brand,Thresh,1178,598,580,50.76
Brand,Camille,316,154,162,48.73
Brand,Briar,718,360,358,50.14
Brand,Katarina,712,381,331,53.51
Brand,Jinx,2749,1291,1458,46.96
Brand,Lux,2783,1416,1367,50.88
Brand,Jax,885,478,407,54.01
Brand,Rammus,285,159,126,55.79
Brand,Viktor,768,398,370,51.82
Brand,Soraka,515,235,280,45.63
Brand,Teemo,1359,658,701,48.42
Brand,Lillia,486,231,255,47.53
Brand,Irelia,861,393,468,45.64
Brand,Galio,927,442,485,47.68
Brand,Pantheon,1600,836,764,52.25
Brand,Nunu,567,278,289,49.03
Brand,Sivir,526,258,268,49.05
Brand,Zed,1049,495,554,47.19
Brand,MissFortune,2621,1388,1233,52.96
Brand,Ashe,2017,1140,877,56.52
Brand,Chogath,1221,624,597,51.11
Brand,Sylas,1124,607,517,54
Brand,Mel,1838,940,898,51.14
Brand,Aatrox,791,412,379,52.09
Brand,Cassiopeia,252,139,113,55.16
Brand,Samira,724,377,347,52.07
Brand,Gwen,363,186,177,51.24
Brand,MonkeyKing,670,375,295,55.97
Brand,Yasuo,1942,978,964,50.36
Brand,Kaisa,1476,715,761,48.44
Brand,Renata,139,87,52,62.59
Brand,Illaoi,487,269,218,55.24
Brand,Nami,853,409,444,47.95
Brand,Naafiri,349,165,184,47.28
Brand,Nidalee,225,112,113,49.78
Brand,Xayah,388,197,191,50.77
Brand,Olaf,205,122,83,59.51
Brand,Shaco,980,519,461,52.96
Brand,Twitch,758,391,367,51.58
Brand,Pyke,755,404,351,53.51
Brand,Heimerdinger,530,265,265,50
Brand,Amumu,1093,547,546,50.05
Brand,Malphite,1003,545,458,54.34
Brand,Smolder,606,341,265,56.27
Brand,Kayle,683,330,353,48.32
Brand,Vi,869,468,401,53.86
Brand,Ahri,1333,740,593,55.51
Brand,Diana,1610,861,749,53.48
Brand,Veigar,1079,547,532,50.7
Brand,Gragas,498,279,219,56.02
Brand,Velkoz,672,338,334,50.3
Brand,Ambessa,521,267,254,51.25
Brand,Viego,1196,602,594,50.33
Brand,TwistedFate,346,154,192,44.51
Brand,Ziggs,340,168,172,49.41
Brand,Sion,756,354,402,46.83
Brand,Evelynn,356,191,165,53.65
Brand,Braum,478,241,237,50.42
Brand,Kennen,242,126,116,52.07
Brand,Khazix,541,288,253,53.23
Brand,Senna,678,376,302,55.46
Brand,Yone,1741,944,797,54.22
Brand,Akali,1043,505,538,48.42
Brand,Draven,525,288,237,54.86
Brand,Darius,1944,1001,943,51.49
Brand,Poppy,461,224,237,48.59
Brand,Karthus,245,111,134,45.31
Brand,Zeri,290,143,147,49.31
Brand,Lulu,1176,575,601,48.89
Brand,Nasus,816,448,368,54.9
Brand,Ekko,870,503,367,57.82
Brand,Trundle,650,314,336,48.31
Brand,Neeko,523,266,257,50.86
Brand,Renekton,367,179,188,48.77
Brand,MasterYi,1296,601,695,46.37
Brand,Fizz,698,310,388,44.41
Brand,Karma,1003,480,523,47.86
Brand,Kayn,1405,665,740,47.33
Brand,Rell,390,210,180,53.85
Brand,Syndra,500,243,257,48.6
Brand,Milio,492,226,266,45.93
Brand,Shen,588,332,256,56.46
Brand,Leblanc,544,291,253,53.49
Brand,Urgot,527,243,284,46.11
Brand,Graves,563,268,295,47.6
Brand,Swain,1093,547,546,50.05
Brand,Warwick,1498,793,705,52.94
Brand,Mordekaiser,1271,640,631,50.35
Brand,Ezreal,2125,1152,973,54.21
Brand,Rakan,260,113,147,43.46
Brand,Kindred,428,243,185,56.78
Brand,Sett,1402,633,769,45.15
Brand,Aphelios,467,215,252,46.04
Brand,Hwei,660,290,370,43.94
Brand,Nocturne,1315,610,705,46.39
Brand,Orianna,307,144,163,46.91
Brand,Garen,1617,747,870,46.2
Brand,Aurora,586,311,275,53.07
Brand,Leona,871,460,411,52.81
Brand,Azir,241,133,108,55.19
Brand,Akshan,325,181,144,55.69
Brand,Corki,324,162,162,50
Brand,Quinn,313,170,143,54.31
Brand,Kalista,242,125,117,51.65
Brand,Yuumi,763,363,400,47.58
Brand,Sejuani,419,226,193,53.94
Brand,Shyvana,285,133,152,46.67
Brand,Zyra,986,471,515,47.77
Brand,Janna,254,124,130,48.82
Brand,Talon,476,226,250,47.48
Brand,Lucian,680,327,353,48.09
Brand,Seraphine,817,457,360,55.94
Brand,XinZhao,644,290,354,45.03
Brand,Gangplank,418,234,184,55.98
Brand,Kled,168,79,89,47.02
Brand,Zilean,307,162,145,52.77
Brand,Taric,155,75,80,48.39
Brand,Vayne,1221,579,642,47.42
Brand,Jayce,373,197,176,52.82
Brand,Skarner,224,143,81,63.84
Brand,Taliyah,192,91,101,47.4
Brand,Tristana,958,480,478,50.1
Brand,Blitzcrank,633,326,307,51.5
Brand,DrMundo,620,285,335,45.97
Brand,Varus,750,361,389,48.13
Brand,AurelionSol,392,208,184,53.06
Brand,Maokai,440,230,210,52.27
Brand,KogMaw,299,156,143,52.17
Brand,Bard,255,128,127,50.2
Brand,Elise,618,278,340,44.98
Brand,Rumble,222,107,115,48.2
Brand,Malzahar,1088,518,570,47.61
Brand,Riven,397,217,180,54.66
Brand,JarvanIV,585,299,286,51.11
Brand,Gnar,387,165,222,42.64
Brand,Fiora,297,162,135,54.55
Brand,Rengar,324,180,144,55.56
Brand,Kassadin,203,91,112,44.83
Brand,Hecarim,376,218,158,57.98
Brand,Zoe,332,169,163,50.9
Brand,Vex,459,242,217,52.72
Brand,RekSai,113,52,61,46.02
Brand,Ryze,282,128,154,45.39
Brand,Singed,278,125,153,44.96
Brand,Ornn,315,164,151,52.06
Brand,Nilah,329,173,156,52.58
Brand,Sona,317,134,183,42.27
Brand,TahmKench,846,483,363,57.09
Brand,Zac,463,262,201,56.59
Brand,Qiyana,202,121,81,59.9
Brand,Lissandra,289,135,154,46.71
Brand,KSante,422,247,175,58.53
Brand,Udyr,342,176,166,51.46
Brand,Alistar,347,174,173,50.14
Brand,Anivia,281,130,151,46.26
Brand,Ivern,102,46,56,45.1
Brand,Tryndamere,669,328,341,49.03
Brand,Annie,239,126,113,52.72
Brand,Xerath,914,433,481,47.37
Brand,Belveth,238,134,104,56.3
Vex,Gnar,286,150,136,52.45
Vex,Volibear,742,411,331,55.39
Vex,Fizz,378,187,191,49.47
Vex,Aphelios,332,190,142,57.23
Vex,Zyra,660,333,327,50.45
Vex,Singed,193,91,102,47.15
Vex,Viego,925,465,460,50.27
Vex,Zed,735,374,361,50.88
Vex,Zeri,249,113,136,45.38
Vex,Milio,357,152,205,42.58
Vex,Aatrox,624,268,356,42.95
Vex,Kayn,934,467,467,50
Vex,Katarina,509,249,260,48.92
Vex,Jhin,1394,706,688,50.65
Vex,Blitzcrank,564,303,261,53.72
Vex,Vi,617,309,308,50.08
Vex,Ekko,519,287,232,55.3
Vex,Yasuo,1907,1048,859,54.96
Vex,Velkoz,372,174,198,46.77
Vex,Mordekaiser,834,373,461,44.72
Vex,LeeSin,939,527,412,56.12
Vex,Ezreal,1677,830,847,49.49
Vex,Lulu,721,341,380,47.3
Vex,Shen,394,212,182,53.81
Vex,Amumu,736,377,359,51.22
Vex,Akali,892,520,372,58.3
Vex,TahmKench,415,219,196,52.77
Vex,Warwick,1052,469,583,44.58
Vex,Udyr,222,107,115,48.2
Vex,Vladimir,408,173,235,42.4
Vex,Jinx,1903,882,1021,46.35
Vex,Nocturne,935,443,492,47.38
Vex,Yone,1386,705,681,50.87
Vex,MissFortune,1620,827,793,51.05
Vex,Morgana,887,426,461,48.03
Vex,Mel,1077,526,551,48.84
Vex,Malzahar,671,312,359,46.5
Vex,Ashe,1440,706,734,49.03
Vex,Soraka,328,177,151,53.96
Vex,Varus,618,289,329,46.76
Vex,Briar,520,208,312,40
Vex,Bard,171,104,67,60.82
Vex,Elise,421,205,216,48.69
Vex,Fiora,182,102,80,56.04
Vex,Karthus,219,106,113,48.4
Vex,Kaisa,1033,516,517,49.95
Vex,Illaoi,272,152,120,55.88
Vex,Shaco,673,344,329,51.11
Vex,Vayne,850,429,421,50.47
Vex,Thresh,915,452,463,49.4
Vex,Ziggs,216,105,111,48.61
Vex,Samira,416,198,218,47.6
Vex,Rell,294,155,139,52.72
Vex,Sylas,1158,633,525,54.66
Vex,Tristana,719,388,331,53.96
Vex,Pantheon,992,518,474,52.22
Vex,Ambessa,412,241,171,58.5
Vex,Braum,394,206,188,52.28
Vex,Tryndamere,393,230,163,58.52
Vex,Evelynn,260,142,118,54.62
Vex,Twitch,511,240,271,46.97
Vex,Lux,1802,909,893,50.44
Vex,Diana,1149,562,587,48.91
Vex,Kayle,459,235,224,51.2
Vex,Gragas,379,217,162,57.26
Vex,Irelia,609,299,310,49.1
Vex,Sivir,355,187,168,52.68
Vex,Zilean,185,82,103,44.32
Vex,Lillia,438,204,234,46.58
Vex,Hwei,411,197,214,47.93
Vex,Nami,572,276,296,48.25
Vex,Gangplank,319,145,174,45.45
Vex,Caitlyn,1867,1015,852,54.37
Vex,Darius,1107,598,509,54.02
Vex,Graves,421,192,229,45.61
Vex,Aurora,486,257,229,52.88
Vex,Seraphine,524,242,282,46.18
Vex,Qiyana,212,107,105,50.47
Vex,Orianna,273,136,137,49.82
Vex,Yorick,668,332,336,49.7
Vex,Veigar,689,368,321,53.41
Vex,Poppy,354,165,189,46.61
Vex,Belveth,138,81,57,58.7
Vex,Taliyah,108,50,58,46.3
Vex,Lissandra,163,91,72,55.83
Vex,Malphite,632,313,319,49.53
Vex,Xayah,299,138,161,46.15
Vex,Neeko,333,178,155,53.45
Vex,Teemo,937,473,464,50.48
Vex,Nautilus,803,393,410,48.94
Vex,Galio,511,238,273,46.58
Vex,Khazix,333,190,143,57.06
Vex,Kalista,154,71,83,46.1
Vex,Sejuani,313,161,152,51.44
Vex,Sett,907,426,481,46.97
Vex,Lucian,443,234,209,52.82
Vex,Trundle,375,201,174,53.6
Vex,KSante,333,178,155,53.45
Vex,Anivia,166,75,91,45.18
Vex,Garen,985,455,530,46.19
Vex,Karma,784,383,401,48.85
Vex,Jax,600,271,329,45.17
Vex,Ahri,1013,520,493,51.33
Vex,Alistar,271,149,122,54.98
Vex,Maokai,283,142,141,50.18
Vex,Camille,251,132,119,52.59
Vex,Naafiri,247,124,123,50.2
Vex,JarvanIV,348,202,146,58.05
Vex,Heimerdinger,344,181,163,52.62
Vex,Swain,626,272,354,43.45
Vex,Rakan,234,123,111,52.56
Vex,Shyvana,170,92,78,54.12
Vex,Chogath,727,331,396,45.53
Vex,Nunu,343,164,179,47.81
Vex,Akshan,251,146,105,58.17
Vex,Kennen,109,56,53,51.38
Vex,Nasus,489,235,254,48.06
Vex,Taric,129,73,56,56.59
Vex,Sion,458,224,234,48.91
Vex,Rengar,237,134,103,56.54
Vex,Riven,263,135,128,51.33
Vex,Gwen,337,191,146,56.68
Vex,Kled,102,41,61,40.2
Vex,Syndra,384,153,231,39.84
Vex,Brand,459,217,242,47.28
Vex,Zoe,251,136,115,54.18
Vex,Smolder,384,204,180,53.13
Vex,Olaf,189,91,98,48.15
Vex,Talon,367,199,168,54.22
Vex,Xerath,661,334,327,50.53
Vex,Ivern,86,47,39,54.65
Vex,MasterYi,811,367,444,45.25
Vex,Leblanc,744,374,370,50.27
Vex,Azir,186,105,81,56.45
Vex,Yuumi,545,293,252,53.76
Vex,DrMundo,376,177,199,47.07
Vex,Hecarim,255,139,116,54.51
Vex,Urgot,318,169,149,53.14
Vex,Renata,103,60,43,58.25
Vex,Quinn,232,132,100,56.9
Vex,Annie,272,150,122,55.15
Vex,Ornn,301,141,160,46.84
Vex,Nilah,213,112,101,52.58
Vex,AurelionSol,210,94,116,44.76
Vex,Draven,265,154,111,58.11
Vex,Leona,575,261,314,45.39
Vex,Senna,457,248,209,54.27
Vex,Renekton,386,193,193,50
Vex,FiddleSticks,329,173,156,52.58
Vex,Viktor,577,292,285,50.61
Vex,TwistedFate,168,88,80,52.38
Vex,MonkeyKing,402,218,184,54.23
Vex,Pyke,557,263,294,47.22
Vex,Janna,186,82,104,44.09
Vex,Corki,243,147,96,60.49
Vex,Skarner,129,46,83,35.66
Vex,XinZhao,483,237,246,49.07
Vex,Kindred,302,154,148,50.99
Vex,Rammus,191,101,90,52.88
Vex,Kassadin,129,69,60,53.49
Vex,KogMaw,182,103,79,56.59
Vex,Cassiopeia,177,103,74,58.19
Vex,Rumble,160,94,66,58.75
Vex,RekSai,67,35,32,52.24
Vex,Jayce,308,164,144,53.25
Vex,Sona,183,82,101,44.81
Vex,Ryze,190,101,89,53.16
Vex,Zac,283,149,134,52.65
Vex,Nidalee,183,100,83,54.64
Zeri,Tryndamere,265,139,126,52.45
Zeri,Amumu,442,227,215,51.36
Zeri,Vex,249,136,113,54.62
Zeri,Jinx,1725,842,883,48.81
Zeri,Mel,1024,515,509,50.29
Zeri,Yorick,436,211,225,48.39
Zeri,Nocturne,748,405,343,54.14
Zeri,Zed,608,266,342,43.75
Zeri,Xayah,304,133,171,43.75
Zeri,Karma,861,399,462,46.34
Zeri,Ashe,1187,609,578,51.31
Zeri,Warwick,732,365,367,49.86
Zeri,Ezreal,1687,890,797,52.76
Zeri,Morgana,567,276,291,48.68
Zeri,TahmKench,339,191,148,56.34
Zeri,Kayn,620,309,311,49.84
Zeri,Mordekaiser,636,292,344,45.91
Zeri,MissFortune,1136,571,565,50.26
Zeri,Heimerdinger,200,115,85,57.5
Zeri,Singed,162,73,89,45.06
Zeri,MonkeyKing,358,199,159,55.59
Zeri,Orianna,219,118,101,53.88
Zeri,Draven,243,123,120,50.62
Zeri,Teemo,601,285,316,47.42
Zeri,Renekton,309,176,133,56.96
Zeri,Nunu,260,134,126,51.54
Zeri,Lux,1122,527,595,46.97
Zeri,Thresh,780,366,414,46.92
Zeri,Ornn,209,118,91,56.46
Zeri,FiddleSticks,297,143,154,48.15
Zeri,Yasuo,1065,555,510,52.11
Zeri,Milio,286,182,104,63.64
Zeri,Chogath,595,287,308,48.24
Zeri,Trundle,299,146,153,48.83
Zeri,AurelionSol,188,92,96,48.94
Zeri,Veigar,422,173,249,41
Zeri,Brand,290,147,143,50.69
Zeri,Katarina,409,185,224,45.23
Zeri,Lucian,436,227,209,52.06
Zeri,Nami,552,242,310,43.84
Zeri,Fiora,203,98,105,48.28
Zeri,Galio,520,240,280,46.15
Zeri,Nilah,135,58,77,42.96
Zeri,Darius,907,420,487,46.31
Zeri,Shaco,487,253,234,51.95
Zeri,Malphite,564,247,317,43.79
Zeri,Qiyana,149,76,73,51.01
Zeri,Janna,179,87,92,48.6
Zeri,Diana,936,466,470,49.79
Zeri,Ziggs,186,88,98,47.31
Zeri,Vi,619,252,367,40.71
Zeri,Rammus,119,64,55,53.78
Zeri,Kaisa,1046,515,531,49.24
Zeri,Zyra,601,313,288,52.08
Zeri,Nasus,387,176,211,45.48
Zeri,Sivir,341,152,189,44.57
Zeri,Senna,395,200,195,50.63
Zeri,Yone,976,524,452,53.69
Zeri,Volibear,525,242,283,46.1
Zeri,Maokai,267,111,156,41.57
Zeri,Vladimir,364,198,166,54.4
Zeri,LeeSin,1063,514,549,48.35
Zeri,Syndra,405,200,205,49.38
Zeri,Garen,865,395,470,45.66
Zeri,Lillia,294,120,174,40.82
Zeri,Malzahar,489,204,285,41.72
Zeri,Soraka,304,125,179,41.12
Zeri,Jayce,399,180,219,45.11
Zeri,MasterYi,591,300,291,50.76
Zeri,Nautilus,672,327,345,48.66
Zeri,Zac,316,168,148,53.16
Zeri,Sylas,832,360,472,43.27
Zeri,Caitlyn,1229,595,634,48.41
Zeri,Rengar,188,94,94,50
Zeri,Taliyah,163,73,90,44.79
Zeri,Jhin,1014,513,501,50.59
Zeri,Aurora,415,237,178,57.11
Zeri,Varus,541,261,280,48.24
Zeri,Nidalee,210,118,92,56.19
Zeri,Kayle,288,144,144,50
Zeri,Ivern,81,48,33,59.26
Zeri,Naafiri,147,51,96,34.69
Zeri,Ahri,686,355,331,51.75
Zeri,Lulu,804,382,422,47.51
Zeri,Gragas,373,201,172,53.89
Zeri,Annie,188,89,99,47.34
Zeri,Quinn,144,67,77,46.53
Zeri,Belveth,145,78,67,53.79
Zeri,Sejuani,252,126,126,50
Zeri,Urgot,249,113,136,45.38
Zeri,Aatrox,557,281,276,50.45
Zeri,Rell,263,130,133,49.43
Zeri,Ambessa,386,199,187,51.55
Zeri,Zilean,188,84,104,44.68
Zeri,Akali,604,284,320,47.02
Zeri,Gnar,239,123,116,51.46
Zeri,Leblanc,373,189,184,50.67
Zeri,Anivia,165,81,84,49.09
Zeri,Sett,679,311,368,45.8
Zeri,Vayne,708,309,399,43.64
Zeri,Renata,72,36,36,50
Zeri,Viego,806,372,434,46.15
Zeri,Gangplank,332,182,150,54.82
Zeri,Graves,380,204,176,53.68
Zeri,Rakan,205,103,102,50.24
Zeri,Irelia,398,167,231,41.96
Zeri,Tristana,417,240,177,57.55
Zeri,Swain,438,197,241,44.98
Zeri,Pantheon,789,405,384,51.33
Zeri,Karthus,176,85,91,48.3
Zeri,Samira,347,148,199,42.65
Zeri,Seraphine,366,178,188,48.63
Zeri,Camille,211,90,121,42.65
Zeri,Cassiopeia,189,86,103,45.5
Zeri,Ekko,516,276,240,53.49
Zeri,Sona,148,58,90,39.19
Zeri,Jax,538,254,284,47.21
Zeri,Briar,340,160,180,47.06
Zeri,Xerath,496,237,259,47.78
Zeri,Bard,177,88,89,49.72
Zeri,JarvanIV,347,152,195,43.8
Zeri,Hecarim,251,134,117,53.39
Zeri,Kassadin,106,62,44,58.49
Zeri,Sion,374,156,218,41.71
Zeri,Kalista,127,61,66,48.03
Zeri,Taric,108,35,73,32.41
Zeri,Talon,372,181,191,48.66
Zeri,Viktor,545,243,302,44.59
Zeri,Corki,244,131,113,53.69
Zeri,Twitch,363,172,191,47.38
Zeri,TwistedFate,219,128,91,58.45
Zeri,Kindred,240,97,143,40.42
Zeri,Fizz,281,164,117,58.36
Zeri,Leona,451,233,218,51.66
Zeri,Velkoz,291,147,144,50.52
Zeri,Yuumi,447,225,222,50.34
Zeri,XinZhao,371,163,208,43.94
Zeri,Kennen,124,60,64,48.39
Zeri,Udyr,187,77,110,41.18
Zeri,Shyvana,131,73,58,55.73
Zeri,Alistar,288,138,150,47.92
Zeri,Akshan,193,85,108,44.04
Zeri,Rumble,170,79,91,46.47
Zeri,Riven,286,143,143,50
Zeri,Kled,82,38,44,46.34
Zeri,Aphelios,363,167,196,46.01
Zeri,Khazix,309,173,136,55.99
Zeri,Hwei,383,158,225,41.25
Zeri,Pyke,425,227,198,53.41
Zeri,Azir,201,122,79,60.7
Zeri,Poppy,393,155,238,39.44
Zeri,Skarner,140,80,60,57.14
Zeri,Gwen,240,145,95,60.42
Zeri,Blitzcrank,416,211,205,50.72
Zeri,Ryze,178,88,90,49.44
Zeri,Shen,298,175,123,58.72
Zeri,KogMaw,121,74,47,61.16
Zeri,Olaf,156,66,90,42.31
Zeri,DrMundo,254,116,138,45.67
Zeri,Smolder,386,218,168,56.48
Zeri,Neeko,209,104,105,49.76
Zeri,Illaoi,196,103,93,52.55
Zeri,RekSai,80,36,44,45
Zeri,KSante,357,201,156,56.3
Zeri,Lissandra,179,84,95,46.93
Zeri,Braum,273,160,113,58.61
Zeri,Zoe,216,91,125,42.13
Zeri,Elise,389,186,203,47.81
Zeri,Evelynn,161,74,87,45.96
Velkoz,Teemo,1042,504,538,48.37
Velkoz,Nocturne,1140,583,557,51.14
Velkoz,Hwei,489,253,236,51.74
Velkoz,Twitch,626,325,301,51.92
Velkoz,Karma,988,495,493,50.1
Velkoz,Sett,1164,527,637,45.27
Velkoz,Gragas,397,187,210,47.1
Velkoz,Yasuo,1378,690,688,50.07
Velkoz,Kalista,146,82,64,56.16
Velkoz,Mel,1501,779,722,51.9
Velkoz,Ambessa,448,256,192,57.14
Velkoz,Taliyah,169,87,82,51.48
Velkoz,Vex,372,198,174,53.23
Velkoz,MissFortune,1871,999,872,53.39
Velkoz,Elise,499,309,190,61.92
Velkoz,Warwick,1128,530,598,46.99
Velkoz,LeeSin,997,505,492,50.65
Velkoz,Kassadin,155,89,66,57.42
Velkoz,Jinx,2219,1103,1116,49.71
Velkoz,Morgana,964,524,440,54.36
Velkoz,Diana,1200,634,566,52.83
Velkoz,Nasus,473,263,210,55.6
Velkoz,Caitlyn,2113,1113,1000,52.67
Velkoz,Ashe,1399,742,657,53.04
Velkoz,Kayle,554,247,307,44.58
Velkoz,Malphite,787,398,389,50.57
Velkoz,Ekko,759,382,377,50.33
Velkoz,Lux,2330,1260,1070,54.08
Velkoz,Tryndamere,427,216,211,50.59
Velkoz,Rengar,266,151,115,56.77
Velkoz,Viktor,737,390,347,52.92
Velkoz,Evelynn,282,133,149,47.16
Velkoz,Vladimir,515,257,258,49.9
Velkoz,Pantheon,1120,587,533,52.41
Velkoz,Jax,679,370,309,54.49
Velkoz,Mordekaiser,947,521,426,55.02
Velkoz,Syndra,457,238,219,52.08
Velkoz,Kaisa,1193,628,565,52.64
Velkoz,Ezreal,1781,911,870,51.15
Velkoz,Viego,992,498,494,50.2
Velkoz,Veigar,855,425,430,49.71
Velkoz,Milio,388,189,199,48.71
Velkoz,Chogath,946,502,444,53.07
Velkoz,Smolder,456,246,210,53.95
Velkoz,Renata,95,52,43,54.74
Velkoz,JarvanIV,451,222,229,49.22
Velkoz,Brand,672,334,338,49.7
Velkoz,Zyra,652,319,333,48.93
Velkoz,Sejuani,303,176,127,58.09
Velkoz,Samira,561,315,246,56.15
Velkoz,Nautilus,871,475,396,54.54
Velkoz,Irelia,643,325,318,50.54
Velkoz,Ahri,969,508,461,52.43
Velkoz,Thresh,1031,511,520,49.56
Velkoz,Darius,1527,790,737,51.74
Velkoz,Bard,229,105,124,45.85
Velkoz,Rammus,215,128,87,59.53
Velkoz,Ryze,255,123,132,48.24
Velkoz,Swain,738,317,421,42.95
Velkoz,Gangplank,361,178,183,49.31
Velkoz,Nilah,275,131,144,47.64
Velkoz,Blitzcrank,583,312,271,53.52
Velkoz,Shen,505,251,254,49.7
Velkoz,Yorick,838,384,454,45.82
Velkoz,Xerath,840,410,430,48.81
Velkoz,Jhin,1553,761,792,49
Velkoz,Seraphine,636,332,304,52.2
Velkoz,Gwen,414,222,192,53.62
Velkoz,Varus,638,324,314,50.78
Velkoz,MasterYi,1014,501,513,49.41
Velkoz,Fizz,523,263,260,50.29
Velkoz,Soraka,462,217,245,46.97
Velkoz,TahmKench,594,298,296,50.17
Velkoz,Shaco,721,396,325,54.92
Velkoz,Camille,273,112,161,41.03
Velkoz,Khazix,347,161,186,46.4
Velkoz,Akali,705,358,347,50.78
Velkoz,Kayn,1128,541,587,47.96
Velkoz,Sylas,887,468,419,52.76
Velkoz,Leblanc,441,240,201,54.42
Velkoz,Galio,678,347,331,51.18
Velkoz,Anivia,289,136,153,47.06
Velkoz,Zilean,273,134,139,49.08
Velkoz,Aurora,496,248,248,50
Velkoz,Qiyana,231,124,107,53.68
Velkoz,XinZhao,492,232,260,47.15
Velkoz,Poppy,376,207,169,55.05
Velkoz,Yone,1341,763,578,56.9
Velkoz,Neeko,308,180,128,58.44
Velkoz,Aatrox,623,321,302,51.52
Velkoz,Vi,635,335,300,52.76
Velkoz,Trundle,393,211,182,53.69
Velkoz,KSante,347,174,173,50.14
Velkoz,Zed,829,392,437,47.29
Velkoz,Udyr,292,169,123,57.88
Velkoz,Tristana,816,403,413,49.39
Velkoz,Lucian,505,260,245,51.49
Velkoz,Sona,224,107,117,47.77
Velkoz,Volibear,916,472,444,51.53
Velkoz,Aphelios,398,207,191,52.01
Velkoz,Nunu,452,239,213,52.88
Velkoz,Rakan,290,137,153,47.24
Velkoz,Ornn,309,159,150,51.46
Velkoz,Heimerdinger,374,201,173,53.74
Velkoz,Nami,759,377,382,49.67
Velkoz,DrMundo,424,220,204,51.89
Velkoz,Naafiri,266,123,143,46.24
Velkoz,Malzahar,874,423,451,48.4
Velkoz,Rumble,199,115,84,57.79
Velkoz,Riven,358,187,171,52.23
Velkoz,Ziggs,305,131,174,42.95
Velkoz,Fiora,284,154,130,54.23
Velkoz,Talon,366,206,160,56.28
Velkoz,Draven,441,227,214,51.47
Velkoz,Illaoi,345,198,147,57.39
Velkoz,Renekton,374,215,159,57.49
Velkoz,Senna,593,334,259,56.32
Velkoz,Katarina,591,297,294,50.25
Velkoz,Yuumi,554,283,271,51.08
Velkoz,Pyke,524,279,245,53.24
Velkoz,Alistar,241,115,126,47.72
Velkoz,AurelionSol,319,167,152,52.35
Velkoz,Rell,400,226,174,56.5
Velkoz,Garen,1232,647,585,52.52
Velkoz,Lulu,1003,507,496,50.55
Velkoz,Lillia,363,209,154,57.58
Velkoz,Graves,464,265,199,57.11
Velkoz,Leona,625,326,299,52.16
Velkoz,Janna,251,127,124,50.6
Velkoz,Briar,575,287,288,49.91
Velkoz,Amumu,861,431,430,50.06
Velkoz,Vayne,1029,520,509,50.53
Velkoz,Azir,245,127,118,51.84
Velkoz,Gnar,275,150,125,54.55
Velkoz,Kindred,320,158,162,49.38
Velkoz,Karthus,197,103,94,52.28
Velkoz,Sion,547,263,284,48.08
Velkoz,MonkeyKing,559,292,267,52.24
Velkoz,Quinn,331,172,159,51.96
Velkoz,FiddleSticks,354,173,181,48.87
Velkoz,Urgot,432,197,235,45.6
Velkoz,Corki,346,198,148,57.23
Velkoz,Hecarim,378,214,164,56.61
Velkoz,Zoe,284,164,120,57.75
Velkoz,Zac,334,166,168,49.7
Velkoz,Sivir,419,202,217,48.21
Velkoz,Orianna,307,166,141,54.07
Velkoz,TwistedFate,238,143,95,60.08
Velkoz,Braum,383,207,176,54.05
Velkoz,Singed,202,113,89,55.94
Velkoz,Olaf,168,87,81,51.79
Velkoz,Akshan,249,104,145,41.77
Velkoz,Zeri,291,144,147,49.48
Velkoz,Skarner,171,87,84,50.88
Velkoz,Maokai,322,144,178,44.72
Velkoz,Jayce,336,187,149,55.65
Velkoz,Nidalee,232,121,111,52.16
Velkoz,Xayah,323,194,129,60.06
Velkoz,Annie,267,146,121,54.68
Velkoz,Lissandra,216,112,104,51.85
Velkoz,Ivern,79,51,28,64.56
Velkoz,Kled,128,80,48,62.5
Velkoz,Kennen,155,82,73,52.9
Velkoz,Cassiopeia,181,96,85,53.04
Velkoz,Taric,177,93,84,52.54
Velkoz,Shyvana,179,102,77,56.98
Velkoz,Belveth,163,71,92,43.56
Velkoz,KogMaw,239,119,120,49.79
Velkoz,RekSai,77,47,30,61.04
Renata,Teemo,271,157,114,57.93
Renata,Khazix,99,54,45,54.55
Renata,Lux,461,221,240,47.94
Renata,Jinx,702,356,346,50.71
Renata,Milio,144,78,66,54.17
Renata,Garen,381,173,208,45.41
Renata,Belveth,56,27,29,48.21
Renata,Yasuo,380,192,188,50.53
Renata,Jhin,437,227,210,51.95
Renata,Seraphine,152,78,74,51.32
Renata,Poppy,182,84,98,46.15
Renata,Evelynn,59,31,28,52.54
Renata,Zed,256,119,137,46.48
Renata,Corki,101,49,52,48.51
Renata,Elise,139,63,76,45.32
Renata,Aatrox,192,87,105,45.31
Renata,Viego,344,151,193,43.9
Renata,Naafiri,45,19,26,42.22
Renata,Nilah,97,50,47,51.55
Renata,Brand,139,52,87,37.41
Renata,Volibear,230,105,125,45.65
Renata,Warwick,343,159,184,46.36
Renata,Yone,382,192,190,50.26
Renata,Mel,288,155,133,53.82
Renata,Sylas,288,126,162,43.75
Renata,Velkoz,95,43,52,45.26
Renata,Kaisa,397,177,220,44.58
Renata,Veigar,170,69,101,40.59
Renata,KSante,87,40,47,45.98
Renata,Ekko,186,86,100,46.24
Renata,Thresh,297,139,158,46.8
Renata,Sett,293,131,162,44.71
Renata,Rengar,81,51,30,62.96
Renata,Janna,92,57,35,61.96
Renata,Olaf,45,18,27,40
Renata,Qiyana,32,18,14,56.25
Renata,Katarina,163,78,85,47.85
Renata,Trundle,89,39,50,43.82
Renata,Xayah,98,45,53,45.92
Renata,Anivia,85,44,41,51.76
Renata,Akali,240,116,124,48.33
Renata,Pyke,147,80,67,54.42
Renata,Vladimir,114,48,66,42.11
Renata,Graves,140,77,63,55
Renata,Irelia,175,79,96,45.14
Renata,Vayne,253,121,132,47.83
Renata,Lulu,353,174,179,49.29
Renata,Darius,372,168,204,45.16
Renata,Hecarim,84,48,36,57.14
Renata,Karma,343,159,184,46.36
Renata,Nautilus,325,171,154,52.62
Renata,Talon,109,73,36,66.97
Renata,Urgot,112,51,61,45.54
Renata,Sejuani,79,32,47,40.51
Renata,Taliyah,53,27,26,50.94
Renata,Ezreal,493,276,217,55.98
Renata,Ornn,90,35,55,38.89
Renata,LeeSin,298,154,144,51.68
Renata,Ryze,98,56,42,57.14
Renata,Zilean,71,35,36,49.3
Renata,Jayce,109,67,42,61.47
Renata,Briar,131,75,56,57.25
Renata,Maokai,122,57,65,46.72
Renata,Gnar,121,65,56,53.72
Renata,Kayn,300,146,154,48.67
Renata,Ahri,257,118,139,45.91
Renata,Samira,147,66,81,44.9
Renata,Rakan,102,68,34,66.67
Renata,Sivir,140,59,81,42.14
Renata,Morgana,187,79,108,42.25
Renata,Renekton,114,63,51,55.26
Renata,Karthus,49,16,33,32.65
Renata,Zac,112,64,48,57.14
Renata,Caitlyn,490,239,251,48.78
Renata,Swain,198,112,86,56.57
Renata,Aurora,179,102,77,56.98
Renata,Twitch,197,117,80,59.39
Renata,Kennen,66,39,27,59.09
Renata,TwistedFate,90,51,39,56.67
Renata,Ashe,436,205,231,47.02
Renata,Ambessa,135,84,51,62.22
Renata,Tristana,206,88,118,42.72
Renata,Shaco,171,97,74,56.73
Renata,AurelionSol,91,50,41,54.95
Renata,Lillia,74,27,47,36.49
Renata,Viktor,227,98,129,43.17
Renata,Kalista,69,37,32,53.62
Renata,Udyr,66,32,34,48.48
Renata,Zeri,72,36,36,50
Renata,Rell,108,47,61,43.52
Renata,Heimerdinger,67,35,32,52.24
Renata,Ziggs,78,30,48,38.46
Renata,Zoe,84,41,43,48.81
Renata,Nocturne,320,150,170,46.88
Renata,MissFortune,423,217,206,51.3
Renata,Diana,328,161,167,49.09
Renata,Lissandra,88,36,52,40.91
Renata,Nami,250,116,134,46.4
Renata,Shen,114,51,63,44.74
Renata,Blitzcrank,116,55,61,47.41
Renata,Smolder,136,69,67,50.74
Renata,KogMaw,78,28,50,35.9
Renata,Vex,103,43,60,41.75
Renata,Alistar,132,66,66,50
Renata,Lucian,149,76,73,51.01
Renata,Nasus,176,97,79,55.11
Renata,DrMundo,93,30,63,32.26
Renata,Annie,61,20,41,32.79
Renata,Syndra,173,78,95,45.09
Renata,Pantheon,254,148,106,58.27
Renata,Mordekaiser,263,128,135,48.67
Renata,Bard,73,33,40,45.21
Renata,Leona,154,68,86,44.16
Renata,Hwei,107,65,42,60.75
Renata,MasterYi,342,141,201,41.23
Renata,Singed,50,29,21,58
Renata,Senna,158,70,88,44.3
Renata,Rammus,63,27,36,42.86
Renata,Braum,100,61,39,61
Renata,Fiora,90,41,49,45.56
Renata,Gragas,102,50,52,49.02
Renata,Yorick,165,76,89,46.06
Renata,Riven,86,35,51,40.7
Renata,Gangplank,107,60,47,56.07
Renata,Sona,85,31,54,36.47
Renata,Jax,231,103,128,44.59
Renata,Camille,87,33,54,37.93
Renata,Kayle,118,66,52,55.93
Renata,Yuumi,114,48,66,42.11
Renata,Soraka,109,62,47,56.88
Renata,Illaoi,86,55,31,63.95
Renata,Orianna,103,47,56,45.63
Renata,Azir,78,37,41,47.44
Renata,Akshan,91,52,39,57.14
Renata,Galio,217,103,114,47.47
Renata,Chogath,230,122,108,53.04
Renata,Varus,153,83,70,54.25
Renata,Vi,232,102,130,43.97
Renata,Quinn,65,26,39,40
Renata,Sion,144,60,84,41.67
Renata,MonkeyKing,163,74,89,45.4
Renata,Malphite,177,97,80,54.8
Renata,Kindred,97,36,61,37.11
Renata,Nidalee,65,30,35,46.15
Renata,Leblanc,128,59,69,46.09
Renata,Xerath,182,76,106,41.76
Renata,Skarner,55,27,28,49.09
Renata,Draven,127,62,65,48.82
Renata,Neeko,103,45,58,43.69
Renata,Rumble,53,30,23,56.6
Renata,Malzahar,199,97,102,48.74
Renata,Taric,54,23,31,42.59
Renata,Tryndamere,133,60,73,45.11
Renata,Kled,36,16,20,44.44
Renata,Fizz,100,58,42,58
Renata,Nunu,102,37,65,36.27
Renata,TahmKench,142,73,69,51.41
Renata,JarvanIV,147,96,51,65.31
Renata,Cassiopeia,58,29,29,50
Renata,Zyra,161,75,86,46.58
Renata,Ivern,48,24,24,50
Renata,Kassadin,28,14,14,50
Renata,Aphelios,126,47,79,37.3
Renata,Amumu,170,73,97,42.94
Renata,XinZhao,120,36,84,30
Renata,Shyvana,39,25,14,64.1
Renata,Gwen,107,47,60,43.93
Renata,FiddleSticks,109,55,54,50.46
Renata,RekSai,22,19,3,86.36
Kalista,Warwick,440,203,237,46.14
Kalista,Shen,151,58,93,38.41
Kalista,Velkoz,146,64,82,43.84
Kalista,Varus,334,165,169,49.4
Kalista,Rakan,106,47,59,44.34
Kalista,Jax,342,184,158,53.8
Kalista,Rengar,121,65,56,53.72
Kalista,Camille,144,74,70,51.39
Kalista,Sivir,165,100,65,60.61
Kalista,Karma,455,211,244,46.37
Kalista,Malphite,331,171,160,51.66
Kalista,Shyvana,76,44,32,57.89
Kalista,Naafiri,76,33,43,43.42
Kalista,MissFortune,700,301,399,43
Kalista,Maokai,148,77,71,52.03
Kalista,Teemo,318,139,179,43.71
Kalista,Zed,389,201,188,51.67
Kalista,Ashe,686,344,342,50.15
Kalista,Sett,478,210,268,43.93
Kalista,Xerath,267,113,154,42.32
Kalista,Caitlyn,799,342,457,42.8
Kalista,Milio,173,79,94,45.66
Kalista,Renekton,176,88,88,50
Kalista,Gwen,135,44,91,32.59
Kalista,Akshan,99,35,64,35.35
Kalista,Mel,637,355,282,55.73
Kalista,Nami,296,122,174,41.22
Kalista,KSante,183,74,109,40.44
Kalista,Malzahar,351,122,229,34.76
Kalista,Soraka,201,110,91,54.73
Kalista,Belveth,73,32,41,43.84
Kalista,Kaisa,581,340,241,58.52
Kalista,Veigar,305,118,187,38.69
Kalista,Swain,275,144,131,52.36
Kalista,Diana,502,256,246,51
Kalista,AurelionSol,113,52,61,46.02
Kalista,Draven,175,74,101,42.29
Kalista,Zyra,294,138,156,46.94
Kalista,Yorick,238,104,134,43.7
Kalista,Neeko,130,76,54,58.46
Kalista,Yone,549,299,250,54.46
Kalista,Nautilus,343,186,157,54.23
Kalista,MonkeyKing,212,96,116,45.28
Kalista,Hwei,201,83,118,41.29
Kalista,Lucian,220,97,123,44.09
Kalista,Pyke,267,148,119,55.43
Kalista,Quinn,96,26,70,27.08
Kalista,Ryze,159,103,56,64.78
Kalista,Lux,782,352,430,45.01
Kalista,Taliyah,148,59,89,39.86
Kalista,Illaoi,140,68,72,48.57
Kalista,Poppy,252,104,148,41.27
Kalista,Lissandra,139,66,73,47.48
Kalista,Jhin,641,314,327,48.99
Kalista,Garen,497,239,258,48.09
Kalista,Briar,189,76,113,40.21
Kalista,Ezreal,1014,558,456,55.03
Kalista,Brand,242,117,125,48.35
Kalista,Ambessa,214,109,105,50.93
Kalista,Vi,290,143,147,49.31
Kalista,Katarina,244,112,132,45.9
Kalista,Vayne,440,175,265,39.77
Kalista,Lulu,475,230,245,48.42
Kalista,Pantheon,450,208,242,46.22
Kalista,Leona,210,101,109,48.1
Kalista,Graves,230,110,120,47.83
Kalista,Vex,154,83,71,53.9
Kalista,Darius,549,249,300,45.36
Kalista,Jinx,844,375,469,44.43
Kalista,Azir,133,76,57,57.14
Kalista,Volibear,314,142,172,45.22
Kalista,Qiyana,93,53,40,56.99
Kalista,Nasus,207,106,101,51.21
Kalista,Morgana,348,179,169,51.44
Kalista,Sejuani,117,49,68,41.88
Kalista,Ahri,364,154,210,42.31
Kalista,TwistedFate,107,46,61,42.99
Kalista,Yasuo,550,333,217,60.55
Kalista,Amumu,295,113,182,38.31
Kalista,Tristana,308,140,168,45.45
Kalista,Kindred,138,67,71,48.55
Kalista,Nilah,79,24,55,30.38
Kalista,Yuumi,293,163,130,55.63
Kalista,Kayn,409,175,234,42.79
Kalista,Braum,158,70,88,44.3
Kalista,RekSai,43,23,20,53.49
Kalista,Irelia,300,154,146,51.33
Kalista,Olaf,101,58,43,57.43
Kalista,Leblanc,223,90,133,40.36
Kalista,Taric,79,41,38,51.9
Kalista,Tryndamere,155,83,72,53.55
Kalista,Seraphine,221,124,97,56.11
Kalista,Fiora,100,41,59,41
Kalista,LeeSin,575,294,281,51.13
Kalista,Thresh,423,198,225,46.81
Kalista,Sylas,481,216,265,44.91
Kalista,Aphelios,165,71,94,43.03
Kalista,Renata,69,32,37,46.38
Kalista,Urgot,132,66,66,50
Kalista,Nocturne,431,192,239,44.55
Kalista,Zilean,89,42,47,47.19
Kalista,Akali,400,195,205,48.75
Kalista,Ziggs,114,59,55,51.75
Kalista,Zoe,83,39,44,46.99
Kalista,Mordekaiser,377,184,193,48.81
Kalista,Singed,98,38,60,38.78
Kalista,Viktor,284,147,137,51.76
Kalista,Sona,82,48,34,58.54
Kalista,Chogath,289,130,159,44.98
Kalista,Evelynn,130,62,68,47.69
Kalista,Smolder,227,93,134,40.97
Kalista,Blitzcrank,232,114,118,49.14
Kalista,Trundle,181,97,84,53.59
Kalista,Skarner,92,42,50,45.65
Kalista,Ornn,96,43,53,44.79
Kalista,KogMaw,70,31,39,44.29
Kalista,Aatrox,341,182,159,53.37
Kalista,Xayah,168,89,79,52.98
Kalista,Shaco,222,90,132,40.54
Kalista,Annie,98,31,67,31.63
Kalista,Alistar,165,85,80,51.52
Kalista,Kled,59,13,46,22.03
Kalista,Ekko,325,187,138,57.54
Kalista,Orianna,172,69,103,40.12
Kalista,Anivia,105,53,52,50.48
Kalista,Nunu,166,80,86,48.19
Kalista,Riven,138,67,71,48.55
Kalista,Viego,481,249,232,51.77
Kalista,Vladimir,196,103,93,52.55
Kalista,Heimerdinger,106,29,77,27.36
Kalista,JarvanIV,207,116,91,56.04
Kalista,Rammus,110,35,75,31.82
Kalista,Aurora,156,84,72,53.85
Kalista,Elise,296,117,179,39.53
Kalista,Karthus,70,37,33,52.86
Kalista,Gnar,133,63,70,47.37
Kalista,Syndra,196,99,97,50.51
Kalista,Gangplank,148,90,58,60.81
Kalista,Senna,198,104,94,52.53
Kalista,TahmKench,199,78,121,39.2
Kalista,MasterYi,332,156,176,46.99
Kalista,Zeri,127,66,61,51.97
Kalista,Samira,186,86,100,46.24
Kalista,Kayle,235,110,125,46.81
Kalista,Zac,121,58,63,47.93
Kalista,Rell,106,53,53,50
Kalista,Twitch,197,90,107,45.69
Kalista,Gragas,193,79,114,40.93
Kalista,Cassiopeia,113,44,69,38.94
Kalista,Khazix,157,90,67,57.32
Kalista,Udyr,116,56,60,48.28
Kalista,Bard,106,45,61,42.45
Kalista,Lillia,141,50,91,35.46
Kalista,Janna,113,54,59,47.79
Kalista,DrMundo,171,89,82,52.05
Kalista,Kassadin,82,45,37,54.88
Kalista,Jayce,168,91,77,54.17
Kalista,XinZhao,243,118,125,48.56
Kalista,Talon,167,92,75,55.09
Kalista,FiddleSticks,127,46,81,36.22
Kalista,Hecarim,146,86,60,58.9
Kalista,Fizz,173,102,71,58.96
Kalista,Nidalee,76,33,43,43.42
Kalista,Sion,221,105,116,47.51
Kalista,Ivern,34,7,27,20.59
Kalista,Kennen,89,37,52,41.57
Kalista,Galio,253,127,126,50.2
Kalista,Corki,146,85,61,58.22
Kalista,Rumble,91,48,43,52.75
Shyvana,Sion,222,118,104,53.15
Shyvana,Nocturne,500,249,251,49.8
Shyvana,Katarina,243,122,121,50.21
Shyvana,Ezreal,732,407,325,55.6
Shyvana,Teemo,406,202,204,49.75
Shyvana,Fiora,111,46,65,41.44
Shyvana,Sylas,403,204,199,50.62
Shyvana,Jinx,865,415,450,47.98
Shyvana,Varus,269,153,116,56.88
Shyvana,Chogath,391,174,217,44.5
Shyvana,Shaco,322,153,169,47.52
Shyvana,Zed,307,159,148,51.79
Shyvana,Sivir,183,98,85,53.55
Shyvana,Milio,162,53,109,32.72
Shyvana,Kayle,197,106,91,53.81
Shyvana,Elise,189,104,85,55.03
Shyvana,Swain,383,202,181,52.74
Shyvana,Kalista,76,32,44,42.11
Shyvana,Karma,348,169,179,48.56
Shyvana,Kayn,518,263,255,50.77
Shyvana,Hwei,181,88,93,48.62
Shyvana,Blitzcrank,222,119,103,53.6
Shyvana,Mel,613,293,320,47.8
Shyvana,Twitch,275,124,151,45.09
Shyvana,Thresh,430,252,178,58.6
Shyvana,Khazix,128,63,65,49.22
Shyvana,Ekko,351,174,177,49.57
Shyvana,Lucian,232,98,134,42.24
Shyvana,Braum,202,102,100,50.5
Shyvana,Gragas,173,74,99,42.77
Shyvana,MasterYi,387,163,224,42.12
Shyvana,Malzahar,383,180,203,47
Shyvana,DrMundo,181,95,86,52.49
Shyvana,Gangplank,166,83,83,50
Shyvana,Veigar,334,186,148,55.69
Shyvana,Smolder,237,105,132,44.3
Shyvana,Garen,644,286,358,44.41
Shyvana,Ahri,421,193,228,45.84
Shyvana,Taric,48,37,11,77.08
Shyvana,TwistedFate,118,50,68,42.37
Shyvana,Darius,658,314,344,47.72
Shyvana,Caitlyn,835,418,417,50.06
Shyvana,Yone,537,276,261,51.4
Shyvana,Xayah,132,74,58,56.06
Shyvana,Rakan,141,61,80,43.26
Shyvana,Rengar,82,51,31,62.2
Shyvana,Kassadin,58,23,35,39.66
Shyvana,Jhin,686,345,341,50.29
Shyvana,Yasuo,568,267,301,47.01
Shyvana,Viego,418,219,199,52.39
Shyvana,Zilean,88,34,54,38.64
Shyvana,Sett,469,208,261,44.35
Shyvana,Hecarim,168,99,69,58.93
Shyvana,Brand,285,152,133,53.33
Shyvana,Aphelios,148,71,77,47.97
Shyvana,Naafiri,123,77,46,62.6
Shyvana,Aurora,232,105,127,45.26
Shyvana,Ashe,667,353,314,52.92
Shyvana,KSante,159,76,83,47.8
Shyvana,Lillia,178,88,90,49.44
Shyvana,Ornn,121,55,66,45.45
Shyvana,Vayne,488,216,272,44.26
Shyvana,Olaf,66,40,26,60.61
Shyvana,Renekton,130,61,69,46.92
Shyvana,Akali,372,198,174,53.23
Shyvana,Draven,170,88,82,51.76
Shyvana,Annie,95,56,39,58.95
Shyvana,Illaoi,169,65,104,38.46
Shyvana,Zoe,105,58,47,55.24
Shyvana,Gnar,136,56,80,41.18
Shyvana,Gwen,195,102,93,52.31
Shyvana,Rell,140,61,79,43.57
Shyvana,Malphite,375,186,189,49.6
Shyvana,Diana,538,240,298,44.61
Shyvana,Mordekaiser,416,200,216,48.08
Shyvana,Volibear,434,238,196,54.84
Shyvana,Anivia,112,53,59,47.32
Shyvana,Lux,776,419,357,53.99
Shyvana,MissFortune,817,379,438,46.39
Shyvana,Lulu,422,197,225,46.68
Shyvana,Shen,224,113,111,50.45
Shyvana,Irelia,278,145,133,52.16
Shyvana,Vex,170,78,92,45.88
Shyvana,Jax,233,129,104,55.36
Shyvana,JarvanIV,222,101,121,45.5
Shyvana,Samira,229,137,92,59.83
Shyvana,Pantheon,455,227,228,49.89
Shyvana,Yorick,328,133,195,40.55
Shyvana,Amumu,410,201,209,49.02
Shyvana,Nautilus,342,197,145,57.6
Shyvana,Vladimir,253,117,136,46.25
Shyvana,Zyra,288,144,144,50
Shyvana,Sejuani,105,64,41,60.95
Shyvana,Azir,71,25,46,35.21
Shyvana,Kaisa,536,281,255,52.43
Shyvana,Graves,256,146,110,57.03
Shyvana,Zac,177,78,99,44.07
Shyvana,Qiyana,74,45,29,60.81
Shyvana,Nami,324,122,202,37.65
Shyvana,Heimerdinger,143,60,83,41.96
Shyvana,TahmKench,215,98,117,45.58
Shyvana,XinZhao,185,88,97,47.57
Shyvana,Pyke,204,117,87,57.35
Shyvana,Xerath,267,121,146,45.32
Shyvana,Riven,152,61,91,40.13
Shyvana,Ivern,42,21,21,50
Shyvana,Talon,227,128,99,56.39
Shyvana,Soraka,172,86,86,50
Shyvana,Warwick,483,237,246,49.07
Shyvana,Neeko,132,61,71,46.21
Shyvana,Leblanc,153,70,83,45.75
Shyvana,Yuumi,263,132,131,50.19
Shyvana,Udyr,129,68,61,52.71
Shyvana,Trundle,170,90,80,52.94
Shyvana,Tristana,325,170,155,52.31
Shyvana,Maokai,163,77,86,47.24
Shyvana,Leona,305,156,149,51.15
Shyvana,Karthus,58,22,36,37.93
Shyvana,Kled,103,64,39,62.14
Shyvana,LeeSin,369,179,190,48.51
Shyvana,Urgot,191,64,127,33.51
Shyvana,Vi,307,189,118,61.56
Shyvana,Corki,125,59,66,47.2
Shyvana,Senna,271,135,136,49.82
Shyvana,Evelynn,106,51,55,48.11
Shyvana,Morgana,373,154,219,41.29
Shyvana,MonkeyKing,198,108,90,54.55
Shyvana,Zeri,131,58,73,44.27
Shyvana,Aatrox,231,117,114,50.65
Shyvana,FiddleSticks,164,97,67,59.15
Shyvana,Ambessa,190,94,96,49.47
Shyvana,Tryndamere,154,83,71,53.9
Shyvana,Fizz,175,95,80,54.29
Shyvana,Alistar,156,72,84,46.15
Shyvana,Nasus,208,115,93,55.29
Shyvana,Jayce,110,55,55,50
Shyvana,Poppy,173,96,77,55.49
Shyvana,Singed,83,34,49,40.96
Shyvana,Janna,122,46,76,37.7
Shyvana,Quinn,118,62,56,52.54
Shyvana,Sona,97,38,59,39.18
Shyvana,Nunu,151,75,76,49.67
Shyvana,Lissandra,107,48,59,44.86
Shyvana,Ziggs,107,56,51,52.34
Shyvana,Camille,136,72,64,52.94
Shyvana,Skarner,79,44,35,55.7
Shyvana,Syndra,157,98,59,62.42
Shyvana,Kindred,142,60,82,42.25
Shyvana,Rumble,98,46,52,46.94
Shyvana,Akshan,101,41,60,40.59
Shyvana,Bard,102,46,56,45.1
Shyvana,Viktor,288,132,156,45.83
Shyvana,Briar,197,88,109,44.67
Shyvana,Orianna,121,69,52,57.02
Shyvana,Ryze,99,48,51,48.48
Shyvana,AurelionSol,100,49,51,49
Shyvana,Nidalee,70,36,34,51.43
Shyvana,Seraphine,218,107,111,49.08
Shyvana,RekSai,24,7,17,29.17
Shyvana,Velkoz,179,77,102,43.02
Shyvana,Cassiopeia,91,47,44,51.65
Shyvana,Nilah,101,48,53,47.52
Shyvana,Belveth,72,34,38,47.22
Shyvana,Kennen,81,44,37,54.32
Shyvana,KogMaw,80,31,49,38.75
Shyvana,Renata,39,14,25,35.9
Shyvana,Galio,281,138,143,49.11
Shyvana,Rammus,53,21,32,39.62
Shyvana,Taliyah,61,40,21,65.57
Camille,Renekton,293,166,127,56.66
Camille,XinZhao,351,171,180,48.72
Camille,Yasuo,884,407,477,46.04
Camille,Kalista,144,70,74,48.61
Camille,Pantheon,791,395,396,49.94
Camille,Quinn,189,82,107,43.39
Camille,Zac,253,104,149,41.11
Camille,Vladimir,346,148,198,42.77
Camille,Ezreal,1285,598,687,46.54
Camille,Brand,316,162,154,51.27
Camille,Sion,281,143,138,50.89
Camille,Karthus,155,74,81,47.74
Camille,Ekko,447,215,232,48.1
Camille,KogMaw,126,56,70,44.44
Camille,Lulu,767,370,397,48.24
Camille,Gangplank,235,92,143,39.15
Camille,RekSai,53,31,22,58.49
Camille,Xerath,450,216,234,48
Camille,Vayne,594,295,299,49.66
Camille,Nautilus,503,229,274,45.53
Camille,TahmKench,302,148,154,49.01
Camille,Qiyana,112,52,60,46.43
Camille,Katarina,337,161,176,47.77
Camille,Gnar,193,94,99,48.7
Camille,Rammus,123,46,77,37.4
Camille,Veigar,387,177,210,45.74
Camille,Soraka,277,144,133,51.99
Camille,Neeko,175,92,83,52.57
Camille,JarvanIV,279,130,149,46.59
Camille,Yone,734,377,357,51.36
Camille,Ashe,974,477,497,48.97
Camille,Swain,349,162,187,46.42
Camille,Talon,362,190,172,52.49
Camille,Jhin,911,448,463,49.18
Camille,Nami,538,277,261,51.49
Camille,Ambessa,481,249,232,51.77
Camille,Lux,1081,504,577,46.62
Camille,MissFortune,945,464,481,49.1
Camille,Thresh,659,324,335,49.17
Camille,Darius,894,466,428,52.13
Camille,Yorick,305,134,171,43.93
Camille,Syndra,343,172,171,50.15
Camille,Garen,1240,638,602,51.45
Camille,DrMundo,230,101,129,43.91
Camille,AurelionSol,192,91,101,47.4
Camille,Xayah,266,130,136,48.87
Camille,Ornn,202,100,102,49.5
Camille,FiddleSticks,257,120,137,46.69
Camille,Milio,297,139,158,46.8
Camille,Kayn,598,316,282,52.84
Camille,Elise,438,225,213,51.37
Camille,Riven,255,116,139,45.49
Camille,Lillia,230,161,69,70
Camille,Jayce,332,176,156,53.01
Camille,Caitlyn,1187,591,596,49.79
Camille,Zyra,485,226,259,46.6
Camille,Evelynn,140,56,84,40
Camille,Teemo,474,210,264,44.3
Camille,Velkoz,273,161,112,58.97
Camille,Rumble,93,52,41,55.91
Camille,LeeSin,774,364,410,47.03
Camille,Seraphine,350,178,172,50.86
Camille,Pyke,362,155,207,42.82
Camille,Hecarim,209,111,98,53.11
Camille,Karma,739,338,401,45.74
Camille,Chogath,501,238,263,47.5
Camille,Nocturne,594,285,309,47.98
Camille,Irelia,340,165,175,48.53
Camille,Nilah,127,61,66,48.03
Camille,Mordekaiser,569,258,311,45.34
Camille,Poppy,258,132,126,51.16
Camille,Naafiri,136,47,89,34.56
Camille,Lucian,361,186,175,51.52
Camille,Bard,194,87,107,44.85
Camille,Gragas,260,126,134,48.46
Camille,Morgana,420,179,241,42.62
Camille,Galio,463,189,274,40.82
Camille,Diana,767,342,425,44.59
Camille,Tryndamere,241,111,130,46.06
Camille,Cassiopeia,142,71,71,50
Camille,Malphite,409,186,223,45.48
Camille,Mel,927,474,453,51.13
Camille,Khazix,264,98,166,37.12
Camille,Singed,121,47,74,38.84
Camille,Varus,480,236,244,49.17
Camille,Amumu,392,197,195,50.26
Camille,Kassadin,111,68,43,61.26
Camille,Yuumi,382,192,190,50.26
Camille,Leblanc,329,206,123,62.61
Camille,Jinx,1292,577,715,44.66
Camille,Blitzcrank,319,171,148,53.61
Camille,Corki,227,110,117,48.46
Camille,Nasus,333,162,171,48.65
Camille,Urgot,219,73,146,33.33
Camille,Shen,292,152,140,52.05
Camille,Vex,251,119,132,47.41
Camille,Alistar,240,111,129,46.25
Camille,Jax,481,202,279,42
Camille,Rengar,158,78,80,49.37
Camille,Taliyah,125,45,80,36
Camille,Graves,426,196,230,46.01
Camille,Fizz,229,97,132,42.36
Camille,Vi,401,201,200,50.12
Camille,Samira,272,114,158,41.91
Camille,Viego,648,281,367,43.36
Camille,Orianna,213,90,123,42.25
Camille,Senna,340,151,189,44.41
Camille,Maokai,195,83,112,42.56
Camille,Fiora,256,114,142,44.53
Camille,Azir,188,103,85,54.79
Camille,Sivir,238,137,101,57.56
Camille,Shaco,432,197,235,45.6
Camille,Twitch,430,204,226,47.44
Camille,Braum,276,130,146,47.1
Camille,Aatrox,474,247,227,52.11
Camille,TwistedFate,183,83,100,45.36
Camille,Volibear,485,223,262,45.98
Camille,Aurora,348,169,179,48.56
Camille,Gwen,221,115,106,52.04
Camille,Kaisa,836,393,443,47.01
Camille,Viktor,506,298,208,58.89
Camille,Ryze,167,102,65,61.08
Camille,Zed,568,280,288,49.3
Camille,Rakan,178,82,96,46.07
Camille,Heimerdinger,130,63,67,48.46
Camille,Warwick,645,294,351,45.58
Camille,Aphelios,214,103,111,48.13
Camille,Ahri,620,307,313,49.52
Camille,Ivern,79,44,35,55.7
Camille,Sett,691,326,365,47.18
Camille,MonkeyKing,360,169,191,46.94
Camille,Draven,271,138,133,50.92
Camille,Trundle,202,135,67,66.83
Camille,Skarner,127,56,71,44.09
Camille,Sylas,695,325,370,46.76
Camille,Hwei,285,136,149,47.72
Camille,Rell,224,103,121,45.98
Camille,Illaoi,205,93,112,45.37
Camille,Kindred,198,99,99,50
Camille,Zoe,200,93,107,46.5
Camille,Ziggs,175,81,94,46.29
Camille,Sejuani,211,105,106,49.76
Camille,Tristana,453,230,223,50.77
Camille,Zeri,211,121,90,57.35
Camille,Akali,462,262,200,56.71
Camille,Malzahar,444,246,198,55.41
Camille,Leona,361,209,152,57.89
Camille,Briar,328,144,184,43.9
Camille,Anivia,158,62,96,39.24
Camille,Sona,143,46,97,32.17
Camille,Janna,206,89,117,43.2
Camille,MasterYi,554,265,289,47.83
Camille,Smolder,266,130,136,48.87
Camille,Taric,83,41,42,49.4
Camille,Udyr,176,77,99,43.75
Camille,Renata,87,54,33,62.07
Camille,Nunu,220,104,116,47.27
Camille,Kayle,239,110,129,46.03
Camille,Kennen,89,41,48,46.07
Camille,KSante,268,134,134,50
Camille,Shyvana,136,64,72,47.06
Camille,Nidalee,209,136,73,65.07
Camille,Akshan,125,69,56,55.2
Camille,Annie,147,51,96,34.69
Camille,Zilean,161,77,84,47.83
Camille,Lissandra,126,59,67,46.83
Camille,Belveth,86,39,47,45.35
Camille,Kled,76,30,46,39.47
Camille,Olaf,77,32,45,41.56
Braum,Garen,1167,579,588,49.61
Braum,Volibear,814,383,431,47.05
Braum,Yasuo,1398,736,662,52.65
Braum,Mel,1336,763,573,57.11
Braum,Zilean,246,96,150,39.02
Braum,Gnar,323,163,160,50.46
Braum,MonkeyKing,548,278,270,50.73
Braum,Vayne,966,486,480,50.31
Braum,Bard,268,107,161,39.93
Braum,Warwick,886,462,424,52.14
Braum,Fizz,363,220,143,60.61
Braum,Jinx,1949,1000,949,51.31
Braum,Thresh,1329,643,686,48.38
Braum,Jax,723,358,365,49.52
Braum,Lucian,546,314,232,57.51
Braum,Briar,423,220,203,52.01
Braum,Maokai,319,177,142,55.49
Braum,Yone,1219,668,551,54.8
Braum,Kayn,1030,548,482,53.2
Braum,Vladimir,552,289,263,52.36
Braum,Ahri,959,508,451,52.97
Braum,Teemo,813,399,414,49.08
Braum,Yuumi,476,258,218,54.2
Braum,Akali,702,392,310,55.84
Braum,MissFortune,1788,909,879,50.84
Braum,TahmKench,524,261,263,49.81
Braum,Brand,478,237,241,49.58
Braum,Kayle,515,244,271,47.38
Braum,Tristana,754,398,356,52.79
Braum,Alistar,366,179,187,48.91
Braum,Shaco,599,321,278,53.59
Braum,Chogath,887,419,468,47.24
Braum,Nami,821,401,420,48.84
Braum,Yorick,593,301,292,50.76
Braum,Diana,1152,562,590,48.78
Braum,Lux,1543,799,744,51.78
Braum,Darius,1364,684,680,50.15
Braum,MasterYi,921,494,427,53.64
Braum,Ekko,718,363,355,50.56
Braum,Aphelios,416,204,212,49.04
Braum,Taric,183,86,97,46.99
Braum,Mordekaiser,918,443,475,48.26
Braum,Viego,1083,619,464,57.16
Braum,Irelia,558,307,251,55.02
Braum,Varus,641,346,295,53.98
Braum,Lulu,1107,593,514,53.57
Braum,Shen,430,222,208,51.63
Braum,Rengar,246,154,92,62.6
Braum,Corki,372,191,181,51.34
Braum,KSante,434,254,180,58.53
Braum,AurelionSol,298,120,178,40.27
Braum,Draven,483,259,224,53.62
Braum,Zyra,617,304,313,49.27
Braum,Sett,952,478,474,50.21
Braum,Nautilus,1286,696,590,54.12
Braum,Aatrox,672,337,335,50.15
Braum,Evelynn,273,128,145,46.89
Braum,Veigar,657,310,347,47.18
Braum,Jhin,1415,796,619,56.25
Braum,Poppy,512,271,241,52.93
Braum,LeeSin,1245,640,605,51.41
Braum,Vex,394,188,206,47.72
Braum,Seraphine,409,225,184,55.01
Braum,Urgot,401,225,176,56.11
Braum,Talon,376,208,168,55.32
Braum,Ambessa,457,247,210,54.05
Braum,Shyvana,202,100,102,49.5
Braum,Zoe,294,165,129,56.12
Braum,Ashe,1370,740,630,54.01
Braum,Malzahar,720,328,392,45.56
Braum,Caitlyn,2048,1006,1042,49.12
Braum,Rakan,388,175,213,45.1
Braum,Nocturne,912,471,441,51.64
Braum,Pantheon,1097,557,540,50.77
Braum,Orianna,316,148,168,46.84
Braum,Twitch,555,300,255,54.05
Braum,Galio,527,257,270,48.77
Braum,Rumble,228,134,94,58.77
Braum,Jayce,427,196,231,45.9
Braum,Gangplank,391,211,180,53.96
Braum,Ryze,321,186,135,57.94
Braum,Ezreal,1736,908,828,52.3
Braum,Gragas,391,181,210,46.29
Braum,Senna,535,236,299,44.11
Braum,Blitzcrank,607,350,257,57.66
Braum,Graves,485,266,219,54.85
Braum,Quinn,243,138,105,56.79
Braum,Renekton,374,212,162,56.68
Braum,Pyke,648,357,291,55.09
Braum,Leblanc,486,274,212,56.38
Braum,Kaisa,1330,724,606,54.44
Braum,Khazix,323,207,116,64.09
Braum,Karthus,198,99,99,50
Braum,Aurora,467,249,218,53.32
Braum,JarvanIV,493,253,240,51.32
Braum,Karma,962,479,483,49.79
Braum,Nasus,470,204,266,43.4
Braum,Milio,427,227,200,53.16
Braum,Udyr,287,136,151,47.39
Braum,Leona,776,417,359,53.74
Braum,Tryndamere,425,223,202,52.47
Braum,Anivia,269,137,132,50.93
Braum,Swain,724,392,332,54.14
Braum,Morgana,709,348,361,49.08
Braum,Viktor,709,335,374,47.25
Braum,Riven,399,207,192,51.88
Braum,Soraka,343,167,176,48.69
Braum,Elise,617,338,279,54.78
Braum,Fiora,341,169,172,49.56
Braum,Naafiri,195,113,82,57.95
Braum,Xerath,513,265,248,51.66
Braum,Kled,91,66,25,72.53
Braum,Zed,827,444,383,53.69
Braum,Kindred,297,169,128,56.9
Braum,Nilah,192,94,98,48.96
Braum,Amumu,722,356,366,49.31
Braum,Malphite,697,340,357,48.78
Braum,Camille,276,146,130,52.9
Braum,RekSai,101,46,55,45.54
Braum,Kalista,158,88,70,55.7
Braum,Nunu,353,181,172,51.27
Braum,Azir,305,172,133,56.39
Braum,Vi,719,395,324,54.94
Braum,Sejuani,313,175,138,55.91
Braum,Sylas,1089,565,524,51.88
Braum,Sivir,348,192,156,55.17
Braum,KogMaw,248,94,154,37.9
Braum,Lissandra,300,167,133,55.67
Braum,Illaoi,272,142,130,52.21
Braum,Zac,349,184,165,52.72
Braum,Rell,411,214,197,52.07
Braum,Cassiopeia,241,117,124,48.55
Braum,Skarner,221,112,109,50.68
Braum,FiddleSticks,406,211,195,51.97
Braum,XinZhao,516,252,264,48.84
Braum,Sion,527,267,260,50.66
Braum,Hwei,478,239,239,50
Braum,Neeko,265,145,120,54.72
Braum,DrMundo,331,189,142,57.1
Braum,Samira,470,232,238,49.36
Braum,Xayah,312,163,149,52.24
Braum,Ziggs,200,92,108,46
Braum,TwistedFate,256,115,141,44.92
Braum,Trundle,393,192,201,48.85
Braum,Nidalee,239,131,108,54.81
Braum,Janna,232,120,112,51.72
Braum,Syndra,472,273,199,57.84
Braum,Annie,249,132,117,53.01
Braum,Katarina,579,295,284,50.95
Braum,Olaf,171,103,68,60.23
Braum,Velkoz,383,176,207,45.95
Braum,Qiyana,142,73,69,51.41
Braum,Renata,100,39,61,39
Braum,Sona,139,79,60,56.83
Braum,Hecarim,316,136,180,43.04
Braum,Rammus,269,136,133,50.56
Braum,Heimerdinger,302,162,140,53.64
Braum,Kassadin,156,63,93,40.38
Braum,Gwen,312,180,132,57.69
Braum,Ornn,284,149,135,52.46
Braum,Taliyah,220,105,115,47.73
Braum,Smolder,420,212,208,50.48
Braum,Singed,208,89,119,42.79
Braum,Kennen,199,110,89,55.28
Braum,Ivern,91,50,41,54.95
Braum,Belveth,158,97,61,61.39
Braum,Lillia,377,193,184,51.19
Braum,Zeri,273,113,160,41.39
Braum,Akshan,274,153,121,55.84
Quinn,Renekton,234,142,92,60.68
Quinn,Gragas,251,132,119,52.59
Quinn,Yasuo,970,563,407,58.04
Quinn,Kaisa,658,331,327,50.3
Quinn,Nautilus,377,200,177,53.05
Quinn,Shaco,415,213,202,51.33
Quinn,Veigar,483,229,254,47.41
Quinn,Lulu,577,320,257,55.46
Quinn,Camille,189,107,82,56.61
Quinn,Briar,301,172,129,57.14
Quinn,Katarina,399,190,209,47.62
Quinn,Jinx,1402,721,681,51.43
Quinn,Lux,1164,640,524,54.98
Quinn,Gnar,213,117,96,54.93
Quinn,Rammus,129,58,71,44.96
Quinn,KogMaw,152,73,79,48.03
Quinn,Soraka,313,159,154,50.8
Quinn,Aatrox,368,170,198,46.2
Quinn,Jax,384,222,162,57.81
Quinn,Cassiopeia,141,67,74,47.52
Quinn,Samira,323,180,143,55.73
Quinn,Morgana,590,344,246,58.31
Quinn,Sett,582,299,283,51.37
Quinn,LeeSin,567,286,281,50.44
Quinn,Aurora,351,169,182,48.15
Quinn,Jhin,1014,547,467,53.94
Quinn,Pyke,356,187,169,52.53
Quinn,Singed,161,59,102,36.65
Quinn,Ahri,542,266,276,49.08
Quinn,Caitlyn,1287,704,583,54.7
Quinn,Urgot,215,102,113,47.44
Quinn,Ivern,66,38,28,57.58
Quinn,Twitch,376,182,194,48.4
Quinn,TahmKench,291,174,117,59.79
Quinn,Diana,654,343,311,52.45
Quinn,Ashe,1003,534,469,53.24
Quinn,Yuumi,373,187,186,50.13
Quinn,Jayce,250,146,104,58.4
Quinn,Udyr,209,97,112,46.41
Quinn,Yone,822,434,388,52.8
Quinn,Karma,599,291,308,48.58
Quinn,Kayn,680,384,296,56.47
Quinn,Leblanc,288,159,129,55.21
Quinn,Nami,461,240,221,52.06
Quinn,Hwei,320,167,153,52.19
Quinn,MasterYi,629,345,284,54.85
Quinn,Zed,582,314,268,53.95
Quinn,Aphelios,215,104,111,48.37
Quinn,Swain,405,200,205,49.38
Quinn,Rengar,154,92,62,59.74
Quinn,Mordekaiser,491,274,217,55.8
Quinn,Kayle,332,184,148,55.42
Quinn,Ambessa,310,179,131,57.74
Quinn,Vladimir,299,153,146,51.17
Quinn,Kalista,96,70,26,72.92
Quinn,Mel,1005,569,436,56.62
Quinn,Malphite,776,388,388,50
Quinn,Nocturne,635,310,325,48.82
Quinn,Kassadin,83,47,36,56.63
Quinn,Xayah,191,92,99,48.17
Quinn,Thresh,581,297,284,51.12
Quinn,Darius,1023,522,501,51.03
Quinn,Ezreal,1081,579,502,53.56
Quinn,Gangplank,305,142,163,46.56
Quinn,Brand,313,143,170,45.69
Quinn,Warwick,709,388,321,54.72
Quinn,Riven,201,102,99,50.75
Quinn,Ziggs,160,68,92,42.5
Quinn,Nasus,309,147,162,47.57
Quinn,Naafiri,136,62,74,45.59
Quinn,Annie,173,77,96,44.51
Quinn,Tristana,515,277,238,53.79
Quinn,Braum,243,105,138,43.21
Quinn,Vayne,643,319,324,49.61
Quinn,Pantheon,672,379,293,56.4
Quinn,Draven,235,117,118,49.79
Quinn,Leona,340,160,180,47.06
Quinn,FiddleSticks,250,120,130,48
Quinn,Sion,380,198,182,52.11
Quinn,Senna,412,217,195,52.67
Quinn,Blitzcrank,320,147,173,45.94
Quinn,Tryndamere,267,140,127,52.43
Quinn,Nunu,209,118,91,56.46
Quinn,Skarner,110,45,65,40.91
Quinn,Xerath,448,227,221,50.67
Quinn,Khazix,271,143,128,52.77
Quinn,Corki,230,120,110,52.17
Quinn,Akali,496,243,253,48.99
Quinn,Rell,256,115,141,44.92
Quinn,DrMundo,296,156,140,52.7
Quinn,Amumu,452,199,253,44.03
Quinn,Ekko,421,222,199,52.73
Quinn,Vi,460,226,234,49.13
Quinn,AurelionSol,175,96,79,54.86
Quinn,Sylas,579,326,253,56.3
Quinn,Talon,263,157,106,59.7
Quinn,Illaoi,165,88,77,53.33
Quinn,Teemo,688,313,375,45.49
Quinn,Zeri,144,77,67,53.47
Quinn,Hecarim,173,84,89,48.55
Quinn,Azir,165,69,96,41.82
Quinn,Garen,845,413,432,48.88
Quinn,Zoe,173,95,78,54.91
Quinn,Rumble,98,55,43,56.12
Quinn,Lucian,292,164,128,56.16
Quinn,Sejuani,167,82,85,49.1
Quinn,Volibear,517,269,248,52.03
Quinn,Rakan,161,72,89,44.72
Quinn,Ryze,150,70,80,46.67
Quinn,Belveth,118,67,51,56.78
Quinn,Velkoz,331,159,172,48.04
Quinn,Sivir,247,113,134,45.75
Quinn,Galio,400,215,185,53.75
Quinn,MissFortune,1042,528,514,50.67
Quinn,Vex,232,100,132,43.1
Quinn,Chogath,469,227,242,48.4
Quinn,Malzahar,410,217,193,52.93
Quinn,Zac,186,104,82,55.91
Quinn,Yorick,467,214,253,45.82
Quinn,Viktor,424,225,199,53.07
Quinn,Orianna,191,85,106,44.5
Quinn,Evelynn,143,72,71,50.35
Quinn,Sona,150,73,77,48.67
Quinn,Kindred,199,94,105,47.24
Quinn,Maokai,204,110,94,53.92
Quinn,Karthus,160,80,80,50
Quinn,Shen,259,142,117,54.83
Quinn,Lillia,248,137,111,55.24
Quinn,Neeko,181,88,93,48.62
Quinn,Seraphine,394,190,204,48.22
Quinn,Heimerdinger,224,104,120,46.43
Quinn,XinZhao,237,99,138,41.77
Quinn,Alistar,156,65,91,41.67
Quinn,Milio,258,137,121,53.1
Quinn,Lissandra,156,101,55,64.74
Quinn,Gwen,217,124,93,57.14
Quinn,MonkeyKing,345,161,184,46.67
Quinn,Elise,319,153,166,47.96
Quinn,Syndra,333,172,161,51.65
Quinn,Nidalee,146,86,60,58.9
Quinn,Irelia,352,176,176,50
Quinn,JarvanIV,280,137,143,48.93
Quinn,Viego,684,363,321,53.07
Quinn,Olaf,67,29,38,43.28
Quinn,Graves,296,155,141,52.36
Quinn,Varus,405,221,184,54.57
Quinn,KSante,178,94,84,52.81
Quinn,Kled,62,27,35,43.55
Quinn,Trundle,188,84,104,44.68
Quinn,TwistedFate,240,98,142,40.83
Quinn,Ornn,178,94,84,52.81
Quinn,Fizz,285,128,157,44.91
Quinn,Taliyah,146,79,67,54.11
Quinn,Taric,61,30,31,49.18
Quinn,Poppy,218,133,85,61.01
Quinn,Qiyana,85,52,33,61.18
Quinn,Renata,65,39,26,60
Quinn,Fiora,126,78,48,61.9
Quinn,Kennen,115,61,54,53.04
Quinn,Smolder,260,142,118,54.62
Quinn,Bard,148,67,81,45.27
Quinn,Zilean,154,91,63,59.09
Quinn,Shyvana,118,56,62,47.46
Quinn,Anivia,114,52,62,45.61
Quinn,Nilah,132,82,50,62.12
Quinn,Zyra,452,236,216,52.21
Quinn,Akshan,156,64,92,41.03
Quinn,Janna,173,80,93,46.24
Quinn,RekSai,61,34,27,55.74
Kassadin,Renekton,142,70,72,49.3
Kassadin,Gragas,192,119,73,61.98
Kassadin,Yasuo,450,213,237,47.33
Kassadin,Kaisa,421,231,190,54.87
Kassadin,Nautilus,302,162,140,53.64
Kassadin,Volibear,287,118,169,41.11
Kassadin,Yorick,227,126,101,55.51
Kassadin,Lux,689,333,356,48.33
Kassadin,Jinx,741,344,397,46.42
Kassadin,Bard,102,49,53,48.04
Kassadin,Pantheon,416,208,208,50
Kassadin,Jhin,522,261,261,50
Kassadin,Veigar,306,156,150,50.98
Kassadin,Nocturne,334,184,150,55.09
Kassadin,Velkoz,155,66,89,42.58
Kassadin,Poppy,173,89,84,51.45
Kassadin,Darius,523,261,262,49.9
Kassadin,Katarina,233,113,120,48.5
Kassadin,Ezreal,634,333,301,52.52
Kassadin,Yuumi,208,118,90,56.73
Kassadin,Diana,452,229,223,50.66
Kassadin,Evelynn,90,47,43,52.22
Kassadin,Gnar,127,76,51,59.84
Kassadin,Aurora,156,71,85,45.51
Kassadin,Sivir,163,92,71,56.44
Kassadin,Taric,51,25,26,49.02
Kassadin,Shen,176,75,101,42.61
Kassadin,Kayn,386,142,244,36.79
Kassadin,Fizz,196,107,89,54.59
Kassadin,Gwen,152,79,73,51.97
Kassadin,Tryndamere,168,86,82,51.19
Kassadin,Caitlyn,759,339,420,44.66
Kassadin,Leona,203,96,107,47.29
Kassadin,Riven,163,86,77,52.76
Kassadin,Skarner,49,29,20,59.18
Kassadin,Tristana,263,132,131,50.19
Kassadin,Swain,253,127,126,50.2
Kassadin,Teemo,278,142,136,51.08
Kassadin,Graves,208,94,114,45.19
Kassadin,Mel,754,379,375,50.27
Kassadin,MissFortune,598,335,263,56.02
Kassadin,Morgana,347,170,177,48.99
Kassadin,Jax,254,110,144,43.31
Kassadin,Vladimir,252,133,119,52.78
Kassadin,Ashe,508,280,228,55.12
Kassadin,Milio,180,93,87,51.67
Kassadin,Singed,84,42,42,50
Kassadin,Warwick,325,177,148,54.46
Kassadin,Ahri,390,186,204,47.69
Kassadin,Corki,144,98,46,68.06
Kassadin,Neeko,115,47,68,40.87
Kassadin,Maokai,112,65,47,58.04
Kassadin,Sett,305,178,127,58.36
Kassadin,Taliyah,57,20,37,35.09
Kassadin,Syndra,183,98,85,53.55
Kassadin,Qiyana,82,36,46,43.9
Kassadin,Akali,279,121,158,43.37
Kassadin,Viego,348,165,183,47.41
Kassadin,Pyke,188,93,95,49.47
Kassadin,Quinn,83,36,47,43.37
Kassadin,RekSai,41,24,17,58.54
Kassadin,Irelia,180,62,118,34.44
Kassadin,Vayne,411,210,201,51.09
Kassadin,Lulu,342,169,173,49.42
Kassadin,Shyvana,58,35,23,60.34
Kassadin,Malphite,264,157,107,59.47
Kassadin,Nunu,179,91,88,50.84
Kassadin,Twitch,240,111,129,46.25
Kassadin,Thresh,421,193,228,45.84
Kassadin,Malzahar,269,140,129,52.04
Kassadin,Illaoi,96,59,37,61.46
Kassadin,XinZhao,158,73,85,46.2
Kassadin,Viktor,262,158,104,60.31
Kassadin,Nami,335,176,159,52.54
Kassadin,Chogath,319,160,159,50.16
Kassadin,Shaco,229,137,92,59.83
Kassadin,Camille,111,43,68,38.74
Kassadin,Aatrox,242,119,123,49.17
Kassadin,Vi,282,152,130,53.9
Kassadin,LeeSin,356,197,159,55.34
Kassadin,Elise,207,106,101,51.21
Kassadin,Ryze,110,47,63,42.73
Kassadin,Aphelios,107,41,66,38.32
Kassadin,Draven,117,59,58,50.43
Kassadin,KSante,147,87,60,59.18
Kassadin,Xayah,100,44,56,44
Kassadin,Karma,358,195,163,54.47
Kassadin,Hwei,212,102,110,48.11
Kassadin,Ambessa,179,93,86,51.96
Kassadin,MonkeyKing,185,93,92,50.27
Kassadin,Ekko,291,165,126,56.7
Kassadin,Samira,168,82,86,48.81
Kassadin,Alistar,112,58,54,51.79
Kassadin,Garen,413,192,221,46.49
Kassadin,Zilean,99,41,58,41.41
Kassadin,Mordekaiser,366,185,181,50.55
Kassadin,Yone,423,227,196,53.66
Kassadin,Briar,168,78,90,46.43
Kassadin,FiddleSticks,170,87,83,51.18
Kassadin,Akshan,85,38,47,44.71
Kassadin,JarvanIV,140,64,76,45.71
Kassadin,Sylas,297,176,121,59.26
Kassadin,Rumble,74,39,35,52.7
Kassadin,Senna,167,88,79,52.69
Kassadin,TahmKench,169,83,86,49.11
Kassadin,Amumu,270,114,156,42.22
Kassadin,Azir,86,43,43,50
Kassadin,Rengar,96,46,50,47.92
Kassadin,Fiora,66,26,40,39.39
Kassadin,Leblanc,212,112,100,52.83
Kassadin,Soraka,158,63,95,39.87
Kassadin,Gangplank,135,55,80,40.74
Kassadin,Nidalee,86,57,29,66.28
Kassadin,Ziggs,104,44,60,42.31
Kassadin,Brand,203,112,91,55.17
Kassadin,KogMaw,75,34,41,45.33
Kassadin,Heimerdinger,123,78,45,63.41
Kassadin,Nasus,193,76,117,39.38
Kassadin,Udyr,85,45,40,52.94
Kassadin,Varus,240,130,110,54.17
Kassadin,Lucian,220,111,109,50.45
Kassadin,Karthus,95,53,42,55.79
Kassadin,Orianna,117,59,58,50.43
Kassadin,Jayce,161,71,90,44.1
Kassadin,Kled,46,22,24,47.83
Kassadin,Zed,189,82,107,43.39
Kassadin,Galio,212,102,110,48.11
Kassadin,Hecarim,114,47,67,41.23
Kassadin,Naafiri,77,45,32,58.44
Kassadin,Janna,94,35,59,37.23
Kassadin,Rakan,89,32,57,35.96
Kassadin,Khazix,146,59,87,40.41
Kassadin,Zac,134,51,83,38.06
Kassadin,TwistedFate,109,50,59,45.87
Kassadin,Zeri,106,44,62,41.51
Kassadin,Seraphine,188,104,84,55.32
Kassadin,Trundle,154,69,85,44.81
Kassadin,Zyra,213,116,97,54.46
Kassadin,Urgot,139,66,73,47.48
Kassadin,Lillia,168,87,81,51.79
Kassadin,Belveth,72,39,33,54.17
Kassadin,MasterYi,336,177,159,52.68
Kassadin,Anivia,124,47,77,37.9
Kassadin,Braum,156,93,63,59.62
Kassadin,AurelionSol,110,65,45,59.09
Kassadin,Blitzcrank,169,78,91,46.15
Kassadin,DrMundo,146,79,67,54.11
Kassadin,Kindred,107,41,66,38.32
Kassadin,Rell,146,58,88,39.73
Kassadin,Olaf,38,23,15,60.53
Kassadin,Cassiopeia,68,36,32,52.94
Kassadin,Smolder,192,114,78,59.38
Kassadin,Ornn,87,52,35,59.77
Kassadin,Sona,78,38,40,48.72
Kassadin,Sion,188,101,87,53.72
Kassadin,Kalista,82,37,45,45.12
Kassadin,Xerath,252,128,124,50.79
Kassadin,Vex,129,60,69,46.51
Kassadin,Kayle,194,104,90,53.61
Kassadin,Rammus,99,56,43,56.57
Kassadin,Nilah,51,17,34,33.33
Kassadin,Annie,107,65,42,60.75
Kassadin,Ivern,49,21,28,42.86
Kassadin,Sejuani,83,33,50,39.76
Kassadin,Talon,148,77,71,52.03
Kassadin,Kennen,41,26,15,63.41
Kassadin,Renata,28,14,14,50
Kassadin,Lissandra,107,63,44,58.88
Kassadin,Zoe,48,22,26,45.83
Heimerdinger,Teemo,979,500,479,51.07
Heimerdinger,Pantheon,854,488,366,57.14
Heimerdinger,Orianna,259,151,108,58.3
Heimerdinger,Tristana,539,293,246,54.36
Heimerdinger,Lux,1736,849,887,48.91
Heimerdinger,Garen,930,495,435,53.23
Heimerdinger,Belveth,139,73,66,52.52
Heimerdinger,Yasuo,1198,557,641,46.49
Heimerdinger,Jhin,1219,653,566,53.57
Heimerdinger,Seraphine,497,264,233,53.12
Heimerdinger,Sett,950,480,470,50.53
Heimerdinger,Shaco,612,309,303,50.49
Heimerdinger,Ziggs,213,115,98,53.99
Heimerdinger,Kaisa,879,451,428,51.31
Heimerdinger,MissFortune,1536,758,778,49.35
Heimerdinger,Kayle,375,217,158,57.87
Heimerdinger,Ekko,567,292,275,51.5
Heimerdinger,Veigar,638,297,341,46.55
Heimerdinger,Nasus,535,263,272,49.16
Heimerdinger,Kindred,242,117,125,48.35
Heimerdinger,Karma,679,363,316,53.46
Heimerdinger,Ashe,1216,622,594,51.15
Heimerdinger,Irelia,519,307,212,59.15
Heimerdinger,DrMundo,325,178,147,54.77
Heimerdinger,Viktor,476,224,252,47.06
Heimerdinger,Twitch,434,225,209,51.84
Heimerdinger,Brand,530,265,265,50
Heimerdinger,Ahri,684,385,299,56.29
Heimerdinger,Zeri,200,85,115,42.5
Heimerdinger,Leona,437,221,216,50.57
Heimerdinger,Volibear,649,339,310,52.23
Heimerdinger,Fizz,379,218,161,57.52
Heimerdinger,Bard,131,80,51,61.07
Heimerdinger,Akali,595,304,291,51.09
Heimerdinger,Jinx,1694,881,813,52.01
Heimerdinger,Morgana,762,422,340,55.38
Heimerdinger,Yorick,605,297,308,49.09
Heimerdinger,Sejuani,172,83,89,48.26
Heimerdinger,Yone,1183,646,537,54.61
Heimerdinger,Zac,253,120,133,47.43
Heimerdinger,Trundle,390,190,200,48.72
Heimerdinger,Skarner,125,71,54,56.8
Heimerdinger,Katarina,466,267,199,57.3
Heimerdinger,Viego,771,376,395,48.77
Heimerdinger,Mel,1178,615,563,52.21
Heimerdinger,Senna,446,249,197,55.83
Heimerdinger,Tryndamere,392,188,204,47.96
Heimerdinger,Evelynn,221,118,103,53.39
Heimerdinger,Vladimir,404,204,200,50.5
Heimerdinger,Darius,1308,681,627,52.06
Heimerdinger,Caitlyn,1666,871,795,52.28
Heimerdinger,Amumu,637,328,309,51.49
Heimerdinger,Nautilus,599,342,257,57.1
Heimerdinger,Singed,169,87,82,51.48
Heimerdinger,Nunu,313,179,134,57.19
Heimerdinger,Graves,319,160,159,50.16
Heimerdinger,Swain,622,331,291,53.22
Heimerdinger,JarvanIV,277,143,134,51.62
Heimerdinger,Qiyana,132,71,61,53.79
Heimerdinger,Taliyah,108,56,52,51.85
Heimerdinger,Malphite,690,386,304,55.94
Heimerdinger,Maokai,215,112,103,52.09
Heimerdinger,Gangplank,286,147,139,51.4
Heimerdinger,Rengar,173,86,87,49.71
Heimerdinger,Zilean,217,97,120,44.7
Heimerdinger,Alistar,218,123,95,56.42
Heimerdinger,Lulu,622,302,320,48.55
Heimerdinger,Naafiri,198,102,96,51.52
Heimerdinger,Illaoi,253,150,103,59.29
Heimerdinger,Velkoz,374,173,201,46.26
Heimerdinger,TahmKench,448,240,208,53.57
Heimerdinger,Khazix,294,177,117,60.2
Heimerdinger,Lissandra,210,110,100,52.38
Heimerdinger,Thresh,633,322,311,50.87
Heimerdinger,Rumble,187,110,77,58.82
Heimerdinger,Zoe,175,101,74,57.71
Heimerdinger,Vayne,777,423,354,54.44
Heimerdinger,Karthus,212,91,121,42.92
Heimerdinger,Hwei,414,227,187,54.83
Heimerdinger,Lucian,431,236,195,54.76
Heimerdinger,Kennen,156,67,89,42.95
Heimerdinger,Leblanc,315,174,141,55.24
Heimerdinger,Nami,546,289,257,52.93
Heimerdinger,Ezreal,1202,667,535,55.49
Heimerdinger,LeeSin,790,447,343,56.58
Heimerdinger,XinZhao,313,169,144,53.99
Heimerdinger,Vex,344,163,181,47.38
Heimerdinger,Galio,517,251,266,48.55
Heimerdinger,Poppy,311,180,131,57.88
Heimerdinger,Aatrox,490,288,202,58.78
Heimerdinger,Rell,219,109,110,49.77
Heimerdinger,Diana,875,478,397,54.63
Heimerdinger,Riven,179,90,89,50.28
Heimerdinger,Ryze,191,93,98,48.69
Heimerdinger,Malzahar,650,309,341,47.54
Heimerdinger,Udyr,174,107,67,61.49
Heimerdinger,Urgot,284,133,151,46.83
Heimerdinger,Aurora,350,161,189,46
Heimerdinger,Samira,486,254,232,52.26
Heimerdinger,Fiora,175,111,64,63.43
Heimerdinger,Briar,411,189,222,45.99
Heimerdinger,Zyra,582,281,301,48.28
Heimerdinger,Milio,262,130,132,49.62
Heimerdinger,Jax,488,283,205,57.99
Heimerdinger,Draven,291,157,134,53.95
Heimerdinger,Renekton,278,152,126,54.68
Heimerdinger,Annie,194,99,95,51.03
Heimerdinger,Blitzcrank,365,194,171,53.15
Heimerdinger,Gragas,266,165,101,62.03
Heimerdinger,Vi,509,229,280,44.99
Heimerdinger,Mordekaiser,787,403,384,51.21
Heimerdinger,Lillia,389,215,174,55.27
Heimerdinger,Kayn,910,489,421,53.74
Heimerdinger,Chogath,662,322,340,48.64
Heimerdinger,Xerath,478,261,217,54.6
Heimerdinger,Sion,467,217,250,46.47
Heimerdinger,Zed,662,347,315,52.42
Heimerdinger,FiddleSticks,274,157,117,57.3
Heimerdinger,Renata,67,32,35,47.76
Heimerdinger,Camille,130,67,63,51.54
Heimerdinger,Aphelios,275,152,123,55.27
Heimerdinger,Shyvana,143,83,60,58.04
Heimerdinger,Warwick,935,478,457,51.12
Heimerdinger,Janna,171,95,76,55.56
Heimerdinger,Kassadin,123,45,78,36.59
Heimerdinger,Sivir,257,153,104,59.53
Heimerdinger,Soraka,298,159,139,53.36
Heimerdinger,Jayce,274,125,149,45.62
Heimerdinger,Ivern,53,25,28,47.17
Heimerdinger,Sylas,764,500,264,65.45
Heimerdinger,Sona,215,119,96,55.35
Heimerdinger,Nidalee,154,81,73,52.6
Heimerdinger,Kalista,106,77,29,72.64
Heimerdinger,RekSai,67,38,29,56.72
Heimerdinger,Neeko,337,177,160,52.52
Heimerdinger,Elise,284,131,153,46.13
Heimerdinger,Varus,421,234,187,55.58
Heimerdinger,Smolder,350,216,134,61.71
Heimerdinger,Shen,386,196,190,50.78
Heimerdinger,Yuumi,371,204,167,54.99
Heimerdinger,Gwen,268,130,138,48.51
Heimerdinger,Anivia,212,98,114,46.23
Heimerdinger,Talon,318,191,127,60.06
Heimerdinger,MasterYi,785,414,371,52.74
Heimerdinger,Rakan,215,99,116,46.05
Heimerdinger,Pyke,441,253,188,57.37
Heimerdinger,Quinn,224,120,104,53.57
Heimerdinger,Akshan,180,89,91,49.44
Heimerdinger,Braum,302,140,162,46.36
Heimerdinger,Gnar,180,116,64,64.44
Heimerdinger,Ornn,209,114,95,54.55
Heimerdinger,Nocturne,728,377,351,51.79
Heimerdinger,MonkeyKing,374,154,220,41.18
Heimerdinger,Nilah,164,97,67,59.15
Heimerdinger,Xayah,236,91,145,38.56
Heimerdinger,Rammus,187,91,96,48.66
Heimerdinger,Cassiopeia,160,76,84,47.5
Heimerdinger,Syndra,385,212,173,55.06
Heimerdinger,Corki,191,126,65,65.97
Heimerdinger,Ambessa,273,142,131,52.01
Heimerdinger,Taric,123,60,63,48.78
Heimerdinger,Azir,181,103,78,56.91
Heimerdinger,AurelionSol,220,128,92,58.18
Heimerdinger,TwistedFate,166,110,56,66.27
Heimerdinger,KogMaw,188,90,98,47.87
Heimerdinger,KSante,203,111,92,54.68
Heimerdinger,Kled,85,45,40,52.94
Heimerdinger,Olaf,135,91,44,67.41
Heimerdinger,Hecarim,179,111,68,62.01
Ryze,Sett,615,283,332,46.02
Ryze,MonkeyKing,311,163,148,52.41
Ryze,Anivia,193,95,98,49.22
Ryze,Corki,241,128,113,53.11
Ryze,Ivern,59,36,23,61.02
Ryze,Yorick,395,196,199,49.62
Ryze,Warwick,618,334,284,54.05
Ryze,Hwei,268,137,131,51.12
Ryze,Caitlyn,1201,628,573,52.29
Ryze,Seraphine,291,157,134,53.95
Ryze,Darius,926,485,441,52.38
Ryze,Viego,665,354,311,53.23
Ryze,Taliyah,120,57,63,47.5
Ryze,Jinx,1234,614,620,49.76
Ryze,Blitzcrank,351,203,148,57.83
Ryze,Kennen,131,56,75,42.75
Ryze,Talon,285,153,132,53.68
Ryze,Soraka,259,139,120,53.67
Ryze,Draven,263,125,138,47.53
Ryze,Velkoz,255,132,123,51.76
Ryze,Jayce,258,145,113,56.2
Ryze,Diana,772,403,369,52.2
Ryze,Kaisa,951,560,391,58.89
Ryze,Taric,81,44,37,54.32
Ryze,Malphite,399,214,185,53.63
Ryze,Shaco,418,210,208,50.24
Ryze,Akshan,154,69,85,44.81
Ryze,Aphelios,188,81,107,43.09
Ryze,Swain,408,185,223,45.34
Ryze,Gangplank,289,180,109,62.28
Ryze,LeeSin,933,448,485,48.02
Ryze,Neeko,151,68,83,45.03
Ryze,Ezreal,1200,681,519,56.75
Ryze,Sona,107,44,63,41.12
Ryze,Irelia,443,206,237,46.5
Ryze,Kindred,192,111,81,57.81
Ryze,Morgana,445,247,198,55.51
Ryze,Ashe,941,481,460,51.12
Ryze,Urgot,219,112,107,51.14
Ryze,Lux,871,465,406,53.39
Ryze,Twitch,378,182,196,48.15
Ryze,Lulu,704,309,395,43.89
Ryze,Ambessa,329,201,128,61.09
Ryze,Rengar,125,61,64,48.8
Ryze,Veigar,463,244,219,52.7
Ryze,Gnar,221,118,103,53.39
Ryze,FiddleSticks,213,97,116,45.54
Ryze,Leblanc,299,174,125,58.19
Ryze,Vayne,642,324,318,50.47
Ryze,Rell,255,127,128,49.8
Ryze,Yasuo,834,444,390,53.24
Ryze,Amumu,388,199,189,51.29
Ryze,Pyke,372,183,189,49.19
Ryze,Trundle,225,115,110,51.11
Ryze,JarvanIV,311,177,134,56.91
Ryze,Varus,426,218,208,51.17
Ryze,Jax,381,181,200,47.51
Ryze,Mel,870,485,385,55.75
Ryze,Braum,321,135,186,42.06
Ryze,Pantheon,690,327,363,47.39
Ryze,Riven,203,91,112,44.83
Ryze,Belveth,129,78,51,60.47
Ryze,Kalista,159,56,103,35.22
Ryze,Milio,229,131,98,57.21
Ryze,Nasus,334,187,147,55.99
Ryze,Nocturne,658,326,332,49.54
Ryze,MissFortune,948,488,460,51.48
Ryze,Kayle,280,128,152,45.71
Ryze,Teemo,607,283,324,46.62
Ryze,Vladimir,434,216,218,49.77
Ryze,Smolder,254,148,106,58.27
Ryze,Renata,98,42,56,42.86
Ryze,Viktor,473,227,246,47.99
Ryze,TwistedFate,164,97,67,59.15
Ryze,Khazix,251,130,121,51.79
Ryze,Elise,323,165,158,51.08
Ryze,Sejuani,157,84,73,53.5
Ryze,Kassadin,110,63,47,57.27
Ryze,Senna,323,180,143,55.73
Ryze,Akali,484,261,223,53.93
Ryze,Ahri,592,325,267,54.9
Ryze,Briar,355,154,201,43.38
Ryze,Aatrox,485,215,270,44.33
Ryze,AurelionSol,174,77,97,44.25
Ryze,Karma,694,360,334,51.87
Ryze,Ekko,458,233,225,50.87
Ryze,Samira,282,143,139,50.71
Ryze,Chogath,480,212,268,44.17
Ryze,DrMundo,247,141,106,57.09
Ryze,Nautilus,574,293,281,51.05
Ryze,Lillia,198,115,83,58.08
Ryze,Tryndamere,223,121,102,54.26
Ryze,Xerath,422,232,190,54.98
Ryze,Heimerdinger,191,98,93,51.31
Ryze,Leona,415,224,191,53.98
Ryze,Aurora,327,171,156,52.29
Ryze,Singed,136,73,63,53.68
Ryze,Gwen,216,106,110,49.07
Ryze,Xayah,200,113,87,56.5
Ryze,Sylas,814,441,373,54.18
Ryze,Volibear,490,218,272,44.49
Ryze,Olaf,129,75,54,58.14
Ryze,Kayn,575,304,271,52.87
Ryze,Cassiopeia,193,98,95,50.78
Ryze,Qiyana,123,60,63,48.78
Ryze,Tristana,472,257,215,54.45
Ryze,Zac,228,105,123,46.05
Ryze,TahmKench,276,156,120,56.52
Ryze,Zyra,397,176,221,44.33
Ryze,Renekton,276,140,136,50.72
Ryze,Camille,167,65,102,38.92
Ryze,Malzahar,513,185,328,36.06
Ryze,Jhin,881,421,460,47.79
Ryze,Maokai,200,113,87,56.5
Ryze,Vi,426,242,184,56.81
Ryze,Fizz,237,124,113,52.32
Ryze,Zed,508,269,239,52.95
Ryze,KSante,283,160,123,56.54
Ryze,Poppy,290,180,110,62.07
Ryze,Yone,863,501,362,58.05
Ryze,Brand,282,154,128,54.61
Ryze,Nami,437,222,215,50.8
Ryze,Nunu,210,134,76,63.81
Ryze,Thresh,761,403,358,52.96
Ryze,Gragas,273,161,112,58.97
Ryze,Yuumi,351,200,151,56.98
Ryze,Alistar,200,102,98,51
Ryze,Quinn,150,80,70,53.33
Ryze,Zilean,170,86,84,50.59
Ryze,Syndra,233,119,114,51.07
Ryze,Lissandra,145,61,84,42.07
Ryze,KogMaw,157,89,68,56.69
Ryze,Udyr,200,110,90,55
Ryze,Ornn,189,107,82,56.61
Ryze,Garen,698,391,307,56.02
Ryze,MasterYi,446,200,246,44.84
Ryze,Graves,339,183,156,53.98
Ryze,Galio,433,216,217,49.88
Ryze,Shen,263,151,112,57.41
Ryze,Ziggs,165,100,65,60.61
Ryze,Rakan,202,111,91,54.95
Ryze,Karthus,125,58,67,46.4
Ryze,XinZhao,307,139,168,45.28
Ryze,Kled,73,36,37,49.32
Ryze,Orianna,195,92,103,47.18
Ryze,Hecarim,177,97,80,54.8
Ryze,Janna,161,64,97,39.75
Ryze,Sivir,232,113,119,48.71
Ryze,Rumble,126,76,50,60.32
Ryze,Zoe,177,83,94,46.89
Ryze,Lucian,321,161,160,50.16
Ryze,Katarina,308,186,122,60.39
Ryze,Naafiri,177,89,88,50.28
Ryze,Rammus,164,83,81,50.61
Ryze,Fiora,175,83,92,47.43
Ryze,Mordekaiser,548,244,304,44.53
Ryze,Sion,283,142,141,50.18
Ryze,Zeri,178,90,88,50.56
Ryze,Evelynn,166,86,80,51.81
Ryze,Illaoi,186,110,76,59.14
Ryze,Skarner,135,76,59,56.3
Ryze,Azir,192,80,112,41.67
Ryze,Nidalee,149,97,52,65.1
Ryze,Nilah,106,50,56,47.17
Ryze,Annie,133,64,69,48.12
Ryze,Vex,190,89,101,46.84
Ryze,Shyvana,99,51,48,51.52
Ryze,Bard,154,88,66,57.14
Ryze,RekSai,83,41,42,49.4
Taliyah,Aatrox,336,193,143,57.44
Taliyah,Graves,255,150,105,58.82
Taliyah,Ekko,318,158,160,49.69
Taliyah,Ezreal,827,421,406,50.91
Taliyah,Bard,128,77,51,60.16
Taliyah,Vi,364,179,185,49.18
Taliyah,Yasuo,666,346,320,51.95
Taliyah,Jhin,586,302,284,51.54
Taliyah,Velkoz,169,82,87,48.52
Taliyah,Sion,269,161,108,59.85
Taliyah,Udyr,117,59,58,50.43
Taliyah,Ryze,120,63,57,52.5
Taliyah,Kaisa,578,305,273,52.77
Taliyah,Leona,248,133,115,53.63
Taliyah,Volibear,341,194,147,56.89
Taliyah,Ahri,479,212,267,44.26
Taliyah,Teemo,300,134,166,44.67
Taliyah,Yuumi,267,167,100,62.55
Taliyah,Gangplank,162,83,79,51.23
Taliyah,Hecarim,158,80,78,50.63
Taliyah,Fizz,143,83,60,58.04
Taliyah,Lucian,244,128,116,52.46
Taliyah,Blitzcrank,207,120,87,57.97
Taliyah,Darius,581,321,260,55.25
Taliyah,Yorick,210,99,111,47.14
Taliyah,Annie,152,84,68,55.26
Taliyah,Caitlyn,755,394,361,52.19
Taliyah,Jax,329,191,138,58.05
Taliyah,LeeSin,537,282,255,52.51
Taliyah,Ashe,665,354,311,53.23
Taliyah,Rell,205,110,95,53.66
Taliyah,Urgot,161,64,97,39.75
Taliyah,Khazix,171,114,57,66.67
Taliyah,Veigar,225,116,109,51.56
Taliyah,Mel,620,334,286,53.87
Taliyah,Senna,269,153,116,56.88
Taliyah,Fiora,110,62,48,56.36
Taliyah,Kayn,403,217,186,53.85
Taliyah,Zoe,149,87,62,58.39
Taliyah,Tristana,316,159,157,50.32
Taliyah,Thresh,489,289,200,59.1
Taliyah,Sett,423,210,213,49.65
Taliyah,FiddleSticks,129,65,64,50.39
Taliyah,Naafiri,117,67,50,57.26
Taliyah,Sona,107,60,47,56.07
Taliyah,Ivern,37,17,20,45.95
Taliyah,Lux,664,311,353,46.84
Taliyah,Twitch,260,137,123,52.69
Taliyah,Lulu,515,266,249,51.65
Taliyah,Ornn,158,76,82,48.1
Taliyah,Yone,530,273,257,51.51
Taliyah,Jinx,879,413,466,46.99
Taliyah,Zyra,294,124,170,42.18
Taliyah,Karma,505,217,288,42.97
Taliyah,Pantheon,531,277,254,52.17
Taliyah,Heimerdinger,108,52,56,48.15
Taliyah,Galio,243,130,113,53.5
Taliyah,Neeko,127,70,57,55.12
Taliyah,Kassadin,57,37,20,64.91
Taliyah,Riven,154,82,72,53.25
Taliyah,Belveth,110,75,35,68.18
Taliyah,Kalista,148,89,59,60.14
Taliyah,Milio,205,83,122,40.49
Taliyah,Irelia,298,161,137,54.03
Taliyah,Xayah,157,70,87,44.59
Taliyah,Viego,437,213,224,48.74
Taliyah,Jayce,213,128,85,60.09
Taliyah,Vayne,372,212,160,56.99
Taliyah,Diana,504,246,258,48.81
Taliyah,Elise,221,115,106,52.04
Taliyah,Vex,108,58,50,53.7
Taliyah,Azir,128,60,68,46.88
Taliyah,Gnar,117,55,62,47.01
Taliyah,Karthus,139,70,69,50.36
Taliyah,Mordekaiser,357,155,202,43.42
Taliyah,MonkeyKing,226,150,76,66.37
Taliyah,MissFortune,565,335,230,59.29
Taliyah,Renata,53,26,27,49.06
Taliyah,Amumu,304,141,163,46.38
Taliyah,Zed,262,121,141,46.18
Taliyah,Akali,361,202,159,55.96
Taliyah,Xerath,274,107,167,39.05
Taliyah,KSante,207,118,89,57
Taliyah,Poppy,199,94,105,47.24
Taliyah,Renekton,197,111,86,56.35
Taliyah,Aphelios,201,114,87,56.72
Taliyah,Malphite,280,136,144,48.57
Taliyah,Trundle,164,88,76,53.66
Taliyah,Briar,224,119,105,53.13
Taliyah,Cassiopeia,85,42,43,49.41
Taliyah,Rammus,92,47,45,51.09
Taliyah,Garen,499,248,251,49.7
Taliyah,Morgana,293,137,156,46.76
Taliyah,Swain,270,142,128,52.59
Taliyah,Talon,168,99,69,58.93
Taliyah,Nasus,155,87,68,56.13
Taliyah,Brand,192,101,91,52.6
Taliyah,Camille,125,80,45,64
Taliyah,Evelynn,90,44,46,48.89
Taliyah,Zeri,163,90,73,55.21
Taliyah,Soraka,165,66,99,40
Taliyah,MasterYi,340,176,164,51.76
Taliyah,Gwen,184,95,89,51.63
Taliyah,Rengar,120,58,62,48.33
Taliyah,Viktor,277,177,100,63.9
Taliyah,Katarina,198,106,92,53.54
Taliyah,Illaoi,132,72,60,54.55
Taliyah,Ambessa,218,117,101,53.67
Taliyah,Sejuani,161,88,73,54.66
Taliyah,Janna,115,63,52,54.78
Taliyah,Malzahar,319,161,158,50.47
Taliyah,Anivia,121,53,68,43.8
Taliyah,Pyke,225,115,110,51.11
Taliyah,TwistedFate,159,103,56,64.78
Taliyah,Shen,182,109,73,59.89
Taliyah,Varus,332,184,148,55.42
Taliyah,Rakan,150,80,70,53.33
Taliyah,Tryndamere,151,82,69,54.3
Taliyah,Hwei,248,121,127,48.79
Taliyah,Kindred,149,97,52,65.1
Taliyah,Samira,188,106,82,56.38
Taliyah,Seraphine,210,122,88,58.1
Taliyah,Warwick,407,211,196,51.84
Taliyah,Nunu,138,82,56,59.42
Taliyah,KogMaw,104,38,66,36.54
Taliyah,Nautilus,313,204,109,65.18
Taliyah,Taric,91,47,44,51.65
Taliyah,DrMundo,174,80,94,45.98
Taliyah,Sylas,554,308,246,55.6
Taliyah,Aurora,242,152,90,62.81
Taliyah,Singed,84,38,46,45.24
Taliyah,Shaco,277,141,136,50.9
Taliyah,Nami,364,198,166,54.4
Taliyah,Syndra,242,100,142,41.32
Taliyah,Vladimir,173,84,89,48.55
Taliyah,Smolder,160,71,89,44.38
Taliyah,Kayle,198,80,118,40.4
Taliyah,TahmKench,185,80,105,43.24
Taliyah,Nocturne,377,204,173,54.11
Taliyah,XinZhao,232,112,120,48.28
Taliyah,Lillia,162,73,89,45.06
Taliyah,Ziggs,125,69,56,55.2
Taliyah,Rumble,110,71,39,64.55
Taliyah,Olaf,86,54,32,62.79
Taliyah,Alistar,117,60,57,51.28
Taliyah,Orianna,175,94,81,53.71
Taliyah,Qiyana,105,57,48,54.29
Taliyah,Zac,154,71,83,46.1
Taliyah,Chogath,366,189,177,51.64
Taliyah,Nilah,98,52,46,53.06
Taliyah,Nidalee,127,58,69,45.67
Taliyah,Braum,220,115,105,52.27
Taliyah,Corki,152,82,70,53.95
Taliyah,Gragas,172,93,79,54.07
Taliyah,JarvanIV,186,80,106,43.01
Taliyah,Quinn,146,67,79,45.89
Taliyah,Akshan,151,81,70,53.64
Taliyah,AurelionSol,116,59,57,50.86
Taliyah,Draven,155,101,54,65.16
Taliyah,Maokai,130,55,75,42.31
Taliyah,Skarner,113,69,44,61.06
Taliyah,Sivir,172,79,93,45.93
Taliyah,Zilean,100,52,48,52
Taliyah,Leblanc,198,103,95,52.02
Taliyah,Lissandra,134,74,60,55.22
Taliyah,Kled,35,17,18,48.57
Taliyah,Kennen,73,41,32,56.16
Taliyah,RekSai,37,29,8,78.38
Taliyah,Shyvana,61,21,40,34.43
AurelionSol,Yone,778,379,399,48.71
AurelionSol,Samira,351,220,131,62.68
AurelionSol,Yasuo,1027,515,512,50.15
AurelionSol,Jhin,1037,529,508,51.01
AurelionSol,Varus,402,185,217,46.02
AurelionSol,Singed,153,78,75,50.98
AurelionSol,Diana,724,349,375,48.2
AurelionSol,Viktor,464,245,219,52.8
AurelionSol,MissFortune,1196,610,586,51
AurelionSol,Galio,425,229,196,53.88
AurelionSol,Ornn,159,82,77,51.57
AurelionSol,Shaco,497,266,231,53.52
AurelionSol,Aurora,325,163,162,50.15
AurelionSol,Caitlyn,1332,688,644,51.65
AurelionSol,Zilean,174,80,94,45.98
AurelionSol,Trundle,345,165,180,47.83
AurelionSol,Volibear,616,312,304,50.65
AurelionSol,Naafiri,152,59,93,38.82
AurelionSol,Lux,1261,660,601,52.34
AurelionSol,Elise,295,134,161,45.42
AurelionSol,Fizz,317,147,170,46.37
AurelionSol,Nautilus,546,267,279,48.9
AurelionSol,Camille,192,101,91,52.6
AurelionSol,XinZhao,310,156,154,50.32
AurelionSol,Mel,1307,716,591,54.78
AurelionSol,Ahri,632,332,300,52.53
AurelionSol,Gragas,268,131,137,48.88
AurelionSol,Kayn,667,340,327,50.97
AurelionSol,Janna,169,96,73,56.8
AurelionSol,Sion,367,187,180,50.95
AurelionSol,Vi,473,228,245,48.2
AurelionSol,Corki,162,84,78,51.85
AurelionSol,Soraka,252,135,117,53.57
AurelionSol,Teemo,589,310,279,52.63
AurelionSol,Mordekaiser,659,273,386,41.43
AurelionSol,Talon,221,123,98,55.66
AurelionSol,Smolder,356,208,148,58.43
AurelionSol,Alistar,211,124,87,58.77
AurelionSol,Poppy,259,134,125,51.74
AurelionSol,Karthus,145,67,78,46.21
AurelionSol,Zeri,188,96,92,51.06
AurelionSol,Lulu,603,329,274,54.56
AurelionSol,Gwen,223,133,90,59.64
AurelionSol,Khazix,216,99,117,45.83
AurelionSol,Ziggs,197,99,98,50.25
AurelionSol,Morgana,608,272,336,44.74
AurelionSol,Viego,733,335,398,45.7
AurelionSol,Irelia,328,148,180,45.12
AurelionSol,Thresh,566,279,287,49.29
AurelionSol,Aatrox,485,253,232,52.16
AurelionSol,Warwick,747,378,369,50.6
AurelionSol,Karma,597,303,294,50.75
AurelionSol,Kalista,113,61,52,53.98
AurelionSol,Braum,298,178,120,59.73
AurelionSol,MonkeyKing,339,187,152,55.16
AurelionSol,Malzahar,791,437,354,55.25
AurelionSol,Sett,723,326,397,45.09
AurelionSol,Veigar,600,329,271,54.83
AurelionSol,Twitch,386,207,179,53.63
AurelionSol,Blitzcrank,418,212,206,50.72
AurelionSol,Garen,786,354,432,45.04
AurelionSol,Katarina,406,182,224,44.83
AurelionSol,Kaisa,779,392,387,50.32
AurelionSol,Sejuani,213,118,95,55.4
AurelionSol,Zed,461,223,238,48.37
AurelionSol,Nilah,143,73,70,51.05
AurelionSol,Seraphine,343,158,185,46.06
AurelionSol,Darius,984,518,466,52.64
AurelionSol,Chogath,626,310,316,49.52
AurelionSol,Akshan,176,99,77,56.25
AurelionSol,Pantheon,681,346,335,50.81
AurelionSol,LeeSin,656,348,308,53.05
AurelionSol,Jax,464,236,228,50.86
AurelionSol,Ezreal,1269,615,654,48.46
AurelionSol,Nami,454,252,202,55.51
AurelionSol,Ekko,502,245,257,48.8
AurelionSol,Akali,398,181,217,45.48
AurelionSol,Ashe,1000,524,476,52.4
AurelionSol,Jayce,223,131,92,58.74
AurelionSol,Briar,370,162,208,43.78
AurelionSol,Maokai,214,119,95,55.61
AurelionSol,Nocturne,675,368,307,54.52
AurelionSol,Kayle,304,139,165,45.72
AurelionSol,Rell,243,126,117,51.85
AurelionSol,Riven,230,134,96,58.26
AurelionSol,Skarner,138,77,61,55.8
AurelionSol,Xerath,427,207,220,48.48
AurelionSol,MasterYi,635,299,336,47.09
AurelionSol,Vayne,672,319,353,47.47
AurelionSol,Xayah,214,118,96,55.14
AurelionSol,Rakan,231,115,116,49.78
AurelionSol,TahmKench,368,194,174,52.72
AurelionSol,Quinn,175,79,96,45.14
AurelionSol,Neeko,222,130,92,58.56
AurelionSol,Sivir,286,140,146,48.95
AurelionSol,Amumu,517,247,270,47.78
AurelionSol,Ryze,174,97,77,55.75
AurelionSol,Evelynn,175,103,72,58.86
AurelionSol,Milio,275,152,123,55.27
AurelionSol,Pyke,403,216,187,53.6
AurelionSol,Yorick,545,271,274,49.72
AurelionSol,Anivia,201,91,110,45.27
AurelionSol,Brand,392,184,208,46.94
AurelionSol,Velkoz,319,152,167,47.65
AurelionSol,FiddleSticks,251,133,118,52.99
AurelionSol,Sylas,520,274,246,52.69
AurelionSol,Fiora,158,87,71,55.06
AurelionSol,Senna,366,182,184,49.73
AurelionSol,Vladimir,320,187,133,58.44
AurelionSol,Jinx,1427,701,726,49.12
AurelionSol,Rammus,145,79,66,54.48
AurelionSol,Shen,315,146,169,46.35
AurelionSol,Syndra,362,187,175,51.66
AurelionSol,Lucian,344,192,152,55.81
AurelionSol,Graves,433,243,190,56.12
AurelionSol,Renata,91,41,50,45.05
AurelionSol,Gnar,191,87,104,45.55
AurelionSol,Leona,467,226,241,48.39
AurelionSol,Lillia,292,120,172,41.1
AurelionSol,Rengar,101,43,58,42.57
AurelionSol,Rumble,94,50,44,53.19
AurelionSol,Zoe,154,79,75,51.3
AurelionSol,Hwei,327,175,152,53.52
AurelionSol,Hecarim,242,133,109,54.96
AurelionSol,Ivern,71,46,25,64.79
AurelionSol,Belveth,125,68,57,54.4
AurelionSol,Leblanc,267,108,159,40.45
AurelionSol,Taric,134,54,80,40.3
AurelionSol,Annie,157,66,91,42.04
AurelionSol,Gangplank,262,136,126,51.91
AurelionSol,Nunu,292,156,136,53.42
AurelionSol,Nasus,404,209,195,51.73
AurelionSol,Illaoi,230,140,90,60.87
AurelionSol,Malphite,507,292,215,57.59
AurelionSol,Zyra,447,216,231,48.32
AurelionSol,Lissandra,135,51,84,37.78
AurelionSol,Ambessa,293,153,140,52.22
AurelionSol,KSante,246,122,124,49.59
AurelionSol,Vex,210,116,94,55.24
AurelionSol,Bard,122,65,57,53.28
AurelionSol,Udyr,196,93,103,47.45
AurelionSol,Orianna,196,109,87,55.61
AurelionSol,Draven,263,124,139,47.15
AurelionSol,Nidalee,148,72,76,48.65
AurelionSol,Tristana,433,212,221,48.96
AurelionSol,DrMundo,267,141,126,52.81
AurelionSol,Kindred,188,92,96,48.94
AurelionSol,Renekton,225,136,89,60.44
AurelionSol,Kassadin,110,45,65,40.91
AurelionSol,Sona,152,94,58,61.84
AurelionSol,Azir,181,100,81,55.25
AurelionSol,Swain,481,245,236,50.94
AurelionSol,Aphelios,269,131,138,48.7
AurelionSol,Taliyah,116,57,59,49.14
AurelionSol,Olaf,116,56,60,48.28
AurelionSol,TwistedFate,175,92,83,52.57
AurelionSol,Heimerdinger,220,92,128,41.82
AurelionSol,Yuumi,392,168,224,42.86
AurelionSol,Kennen,96,39,57,40.63
AurelionSol,Cassiopeia,123,51,72,41.46
AurelionSol,KogMaw,150,108,42,72
AurelionSol,Kled,83,33,50,39.76
AurelionSol,Shyvana,100,51,49,51
AurelionSol,Zac,200,108,92,54
AurelionSol,RekSai,47,25,22,53.19
AurelionSol,JarvanIV,298,163,135,54.7
AurelionSol,Tryndamere,291,145,146,49.83
AurelionSol,Urgot,314,147,167,46.82
AurelionSol,Qiyana,110,51,59,46.36
Nunu,Gnar,292,136,156,46.58
Nunu,MonkeyKing,458,209,249,45.63
Nunu,Yasuo,1261,635,626,50.36
Nunu,Vayne,768,398,370,51.82
Nunu,Bard,170,93,77,54.71
Nunu,Kayn,889,452,437,50.84
Nunu,Rengar,188,96,92,51.06
Nunu,Fizz,368,182,186,49.46
Nunu,KogMaw,180,87,93,48.33
Nunu,Lux,1760,860,900,48.86
Nunu,TahmKench,483,260,223,53.83
Nunu,Ivern,96,35,61,36.46
Nunu,Draven,357,212,145,59.38
Nunu,Milio,371,195,176,52.56
Nunu,Urgot,337,156,181,46.29
Nunu,Amumu,804,351,453,43.66
Nunu,Mel,1327,671,656,50.57
Nunu,Jhin,1360,715,645,52.57
Nunu,Brand,567,289,278,50.97
Nunu,Briar,537,228,309,42.46
Nunu,Zoe,282,172,110,60.99
Nunu,Jinx,1810,875,935,48.34
Nunu,Illaoi,313,150,163,47.92
Nunu,XinZhao,408,193,215,47.3
Nunu,Ahri,763,398,365,52.16
Nunu,Sett,934,424,510,45.4
Nunu,Mordekaiser,944,445,499,47.14
Nunu,Akshan,231,118,113,51.08
Nunu,MissFortune,1656,814,842,49.15
Nunu,Maokai,314,163,151,51.91
Nunu,Garen,1143,577,566,50.48
Nunu,Belveth,137,74,63,54.01
Nunu,Qiyana,176,97,79,55.11
Nunu,Corki,237,124,113,52.32
Nunu,Darius,1307,674,633,51.57
Nunu,JarvanIV,464,208,256,44.83
Nunu,Ekko,701,350,351,49.93
Nunu,Zeri,260,126,134,48.46
Nunu,Lulu,782,395,387,50.51
Nunu,Sylas,938,482,456,51.39
Nunu,Kaisa,1066,528,538,49.53
Nunu,Xayah,285,141,144,49.47
Nunu,Hecarim,309,157,152,50.81
Nunu,Hwei,414,219,195,52.9
Nunu,Morgana,859,417,442,48.54
Nunu,Fiora,245,124,121,50.61
Nunu,Talon,379,171,208,45.12
Nunu,Trundle,399,217,182,54.39
Nunu,Warwick,1017,461,556,45.33
Nunu,Diana,994,506,488,50.91
Nunu,Veigar,634,301,333,47.48
Nunu,Seraphine,524,272,252,51.91
Nunu,MasterYi,873,390,483,44.67
Nunu,Kayle,489,238,251,48.67
Nunu,Ashe,1380,617,763,44.71
Nunu,Yorick,749,374,375,49.93
Nunu,Sejuani,286,142,144,49.65
Nunu,Caitlyn,1887,954,933,50.56
Nunu,Zed,656,336,320,51.22
Nunu,Gragas,360,202,158,56.11
Nunu,Irelia,523,241,282,46.08
Nunu,Sivir,370,193,177,52.16
Nunu,Zilean,187,79,108,42.25
Nunu,Heimerdinger,313,134,179,42.81
Nunu,Swain,584,262,322,44.86
Nunu,Lucian,374,198,176,52.94
Nunu,Teemo,905,470,435,51.93
Nunu,Galio,572,235,337,41.08
Nunu,Anivia,229,102,127,44.54
Nunu,Akali,731,370,361,50.62
Nunu,Riven,263,125,138,47.53
Nunu,Vi,600,323,277,53.83
Nunu,Aphelios,289,144,145,49.83
Nunu,LeeSin,875,449,426,51.31
Nunu,Kassadin,179,88,91,49.16
Nunu,Rell,324,172,152,53.09
Nunu,Khazix,280,142,138,50.71
Nunu,Twitch,535,287,248,53.64
Nunu,Janna,260,141,119,54.23
Nunu,Ornn,299,164,135,54.85
Nunu,Nautilus,717,374,343,52.16
Nunu,Tristana,693,335,358,48.34
Nunu,Velkoz,452,213,239,47.12
Nunu,Yone,1189,602,587,50.63
Nunu,Ezreal,1546,855,691,55.3
Nunu,Udyr,269,161,108,59.85
Nunu,Quinn,209,91,118,43.54
Nunu,Annie,253,132,121,52.17
Nunu,Katarina,464,194,270,41.81
Nunu,Senna,442,207,235,46.83
Nunu,Viego,945,487,458,51.53
Nunu,Jax,618,324,294,52.43
Nunu,Graves,396,185,211,46.72
Nunu,Azir,197,92,105,46.7
Nunu,Kindred,336,211,125,62.8
Nunu,Thresh,778,439,339,56.43
Nunu,Chogath,767,398,369,51.89
Nunu,DrMundo,402,191,211,47.51
Nunu,Xerath,599,292,307,48.75
Nunu,Pantheon,974,486,488,49.9
Nunu,Nocturne,871,423,448,48.56
Nunu,Malzahar,764,366,398,47.91
Nunu,Shen,415,220,195,53.01
Nunu,Vex,343,179,164,52.19
Nunu,Poppy,346,165,181,47.69
Nunu,Shaco,631,341,290,54.04
Nunu,Nami,653,330,323,50.54
Nunu,Karthus,198,100,98,50.51
Nunu,Aatrox,457,218,239,47.7
Nunu,Zyra,597,272,325,45.56
Nunu,Braum,353,172,181,48.73
Nunu,Vladimir,387,189,198,48.84
Nunu,Leblanc,338,158,180,46.75
Nunu,Neeko,379,177,202,46.7
Nunu,FiddleSticks,346,179,167,51.73
Nunu,Yuumi,542,313,229,57.75
Nunu,Ziggs,292,153,139,52.4
Nunu,AurelionSol,292,136,156,46.58
Nunu,Sona,185,85,100,45.95
Nunu,Varus,589,322,267,54.67
Nunu,Malphite,637,313,324,49.14
Nunu,TwistedFate,223,135,88,60.54
Nunu,Volibear,756,374,382,49.47
Nunu,Ryze,210,76,134,36.19
Nunu,Sion,527,249,278,47.25
Nunu,Zac,335,180,155,53.73
Nunu,Karma,745,418,327,56.11
Nunu,Taliyah,138,56,82,40.58
Nunu,Kalista,166,86,80,51.81
Nunu,Viktor,534,309,225,57.87
Nunu,KSante,280,142,138,50.71
Nunu,Soraka,401,182,219,45.39
Nunu,Orianna,258,124,134,48.06
Nunu,Nasus,446,216,230,48.43
Nunu,Samira,461,226,235,49.02
Nunu,Leona,555,248,307,44.68
Nunu,Rakan,228,118,110,51.75
Nunu,Renekton,344,192,152,55.81
Nunu,Aurora,472,268,204,56.78
Nunu,Gwen,287,162,125,56.45
Nunu,Taric,172,65,107,37.79
Nunu,Lillia,376,197,179,52.39
Nunu,Elise,435,224,211,51.49
Nunu,Blitzcrank,478,247,231,51.67
Nunu,Gangplank,293,139,154,47.44
Nunu,Naafiri,243,137,106,56.38
Nunu,Evelynn,221,99,122,44.8
Nunu,Rumble,150,71,79,47.33
Nunu,Ambessa,373,190,183,50.94
Nunu,Pyke,546,303,243,55.49
Nunu,Tryndamere,383,203,180,53
Nunu,Smolder,314,134,180,42.68
Nunu,Olaf,150,79,71,52.67
Nunu,Syndra,413,208,205,50.36
Nunu,Camille,220,116,104,52.73
Nunu,Jayce,241,124,117,51.45
Nunu,Singed,236,111,125,47.03
Nunu,Cassiopeia,193,101,92,52.33
Nunu,Kled,63,25,38,39.68
Nunu,Shyvana,151,76,75,50.33
Nunu,Skarner,170,88,82,51.76
Nunu,Nilah,208,110,98,52.88
Nunu,Rammus,153,101,52,66.01
Nunu,Nidalee,143,56,87,39.16
Nunu,Renata,102,65,37,63.73
Nunu,Lissandra,239,106,133,44.35
Nunu,Kennen,148,72,76,48.65
Nunu,Alistar,226,135,91,59.73
Nunu,RekSai,83,47,36,56.63
Olaf,Maokai,167,63,104,37.72
Olaf,MasterYi,405,171,234,42.22
Olaf,Yasuo,551,284,267,51.54
Olaf,Samira,171,90,81,52.63
Olaf,Pyke,253,143,110,56.52
Olaf,Garen,544,236,308,43.38
Olaf,Volibear,333,163,170,48.95
Olaf,Veigar,333,175,158,52.55
Olaf,Smolder,220,106,114,48.18
Olaf,Lux,709,337,372,47.53
Olaf,Kayle,160,71,89,44.38
Olaf,Ekko,312,157,155,50.32
Olaf,Ziggs,105,60,45,57.14
Olaf,Urgot,162,76,86,46.91
Olaf,Lillia,193,78,115,40.41
Olaf,Diana,450,225,225,50
Olaf,Aphelios,165,75,90,45.45
Olaf,Leona,302,150,152,49.67
Olaf,Warwick,431,224,207,51.97
Olaf,Udyr,111,71,40,63.96
Olaf,Vladimir,215,92,123,42.79
Olaf,Jinx,800,429,371,53.63
Olaf,Milio,194,96,98,49.48
Olaf,Teemo,468,257,211,54.91
Olaf,Jax,301,165,136,54.82
Olaf,Swain,255,127,128,49.8
Olaf,Lucian,266,121,145,45.49
Olaf,Nami,289,160,129,55.36
Olaf,Aatrox,283,140,143,49.47
Olaf,Belveth,53,32,21,60.38
Olaf,Syndra,197,94,103,47.72
Olaf,Lulu,476,260,216,54.62
Olaf,Darius,560,236,324,42.14
Olaf,Brand,205,83,122,40.49
Olaf,Sona,74,29,45,39.19
Olaf,Evelynn,84,46,38,54.76
Olaf,Irelia,190,84,106,44.21
Olaf,Tristana,298,146,152,48.99
Olaf,Blitzcrank,267,149,118,55.81
Olaf,Rengar,100,65,35,65
Olaf,XinZhao,223,108,115,48.43
Olaf,Zoe,123,80,43,65.04
Olaf,Gwen,136,65,71,47.79
Olaf,Amumu,296,157,139,53.04
Olaf,Renata,45,27,18,60
Olaf,Kayn,390,194,196,49.74
Olaf,Jhin,627,297,330,47.37
Olaf,Draven,202,88,114,43.56
Olaf,Morgana,412,213,199,51.7
Olaf,Nocturne,415,207,208,49.88
Olaf,Katarina,204,95,109,46.57
Olaf,Viktor,333,173,160,51.95
Olaf,Viego,453,214,239,47.24
Olaf,Sylas,416,219,197,52.64
Olaf,Ashe,701,380,321,54.21
Olaf,Chogath,394,197,197,50
Olaf,Akshan,121,79,42,65.29
Olaf,Yorick,257,95,162,36.96
Olaf,Briar,196,100,96,51.02
Olaf,Shyvana,66,26,40,39.39
Olaf,LeeSin,627,332,295,52.95
Olaf,Lissandra,118,54,64,45.76
Olaf,Soraka,156,79,77,50.64
Olaf,Annie,90,32,58,35.56
Olaf,Sejuani,137,76,61,55.47
Olaf,Leblanc,206,91,115,44.17
Olaf,MissFortune,642,277,365,43.15
Olaf,Yone,515,269,246,52.23
Olaf,Zyra,277,133,144,48.01
Olaf,Kaisa,475,255,220,53.68
Olaf,Rell,157,72,85,45.86
Olaf,Karthus,117,59,58,50.43
Olaf,Ezreal,807,415,392,51.43
Olaf,Gnar,142,66,76,46.48
Olaf,Akali,328,123,205,37.5
Olaf,Twitch,211,93,118,44.08
Olaf,Jayce,218,112,106,51.38
Olaf,Ryze,129,54,75,41.86
Olaf,Illaoi,171,76,95,44.44
Olaf,Malzahar,342,180,162,52.63
Olaf,Ambessa,211,114,97,54.03
Olaf,Shen,228,115,113,50.44
Olaf,Orianna,161,79,82,49.07
Olaf,Kalista,101,43,58,42.57
Olaf,Poppy,222,138,84,62.16
Olaf,Graves,201,84,117,41.79
Olaf,Riven,90,50,40,55.56
Olaf,Kindred,141,60,81,42.55
Olaf,Nidalee,92,45,47,48.91
Olaf,Ahri,379,188,191,49.6
Olaf,Sett,428,207,221,48.36
Olaf,Tryndamere,177,83,94,46.89
Olaf,Renekton,135,60,75,44.44
Olaf,Caitlyn,855,406,449,47.49
Olaf,KSante,189,77,112,40.74
Olaf,Vi,353,189,164,53.54
Olaf,Vex,189,98,91,51.85
Olaf,Nilah,115,39,76,33.91
Olaf,Alistar,169,92,77,54.44
Olaf,Zilean,76,26,50,34.21
Olaf,Mordekaiser,675,337,338,49.93
Olaf,Aurora,200,105,95,52.5
Olaf,Karma,388,185,203,47.68
Olaf,Pantheon,477,260,217,54.51
Olaf,Varus,367,190,177,51.77
Olaf,Nautilus,406,186,220,45.81
Olaf,Gragas,185,72,113,38.92
Olaf,TwistedFate,108,53,55,49.07
Olaf,Thresh,405,238,167,58.77
Olaf,Anivia,107,45,62,42.06
Olaf,Yuumi,225,117,108,52
Olaf,Trundle,252,125,127,49.6
Olaf,Mel,594,285,309,47.98
Olaf,Naafiri,83,44,39,53.01
Olaf,Braum,171,68,103,39.77
Olaf,TahmKench,209,114,95,54.55
Olaf,Zed,329,167,162,50.76
Olaf,Cassiopeia,115,66,49,57.39
Olaf,Janna,115,42,73,36.52
Olaf,Velkoz,168,81,87,48.21
Olaf,Sion,203,97,106,47.78
Olaf,Kennen,60,29,31,48.33
Olaf,Zac,122,71,51,58.2
Olaf,Taliyah,86,32,54,37.21
Olaf,Sivir,204,77,127,37.75
Olaf,Azir,90,39,51,43.33
Olaf,Senna,244,93,151,38.11
Olaf,Nasus,184,104,80,56.52
Olaf,Hecarim,110,47,63,42.73
Olaf,Gangplank,170,101,69,59.41
Olaf,Quinn,67,38,29,56.72
Olaf,Galio,295,151,144,51.19
Olaf,Kassadin,38,15,23,39.47
Olaf,Nunu,150,68,82,45.33
Olaf,Talon,184,84,100,45.65
Olaf,Seraphine,199,96,103,48.24
Olaf,Fiora,75,49,26,65.33
Olaf,Bard,103,42,61,40.78
Olaf,Ornn,123,81,42,65.85
Olaf,Skarner,106,39,67,36.79
Olaf,Elise,210,106,104,50.48
Olaf,Corki,135,62,73,45.93
Olaf,DrMundo,111,72,39,64.86
Olaf,Xerath,254,134,120,52.76
Olaf,Vayne,371,201,170,54.18
Olaf,Shaco,280,141,139,50.36
Olaf,Xayah,165,80,85,48.48
Olaf,FiddleSticks,202,115,87,56.93
Olaf,MonkeyKing,232,107,125,46.12
Olaf,AurelionSol,116,60,56,51.72
Olaf,Rakan,127,60,67,47.24
Olaf,Qiyana,99,58,41,58.59
Olaf,Ivern,50,32,18,64
Olaf,Fizz,146,81,65,55.48
Olaf,Neeko,150,63,87,42
Olaf,Zeri,156,90,66,57.69
Olaf,Singed,69,34,35,49.28
Olaf,KogMaw,79,39,40,49.37
Olaf,Hwei,198,95,103,47.98
Olaf,Taric,60,18,42,30
Olaf,Rammus,77,42,35,54.55
Olaf,Rumble,166,82,84,49.4
Olaf,Heimerdinger,135,44,91,32.59
Olaf,Malphite,264,165,99,62.5
Olaf,JarvanIV,172,82,90,47.67
Olaf,Kled,55,29,26,52.73
Olaf,Khazix,139,65,74,46.76
Olaf,RekSai,29,14,15,48.28
Olaf,Camille,77,45,32,58.44
Naafiri,Kayle,269,111,158,41.26
Naafiri,Elise,224,106,118,47.32
Naafiri,Swain,365,158,207,43.29
Naafiri,Kalista,76,43,33,56.58
Naafiri,Karma,462,258,204,55.84
Naafiri,Chogath,504,232,272,46.03
Naafiri,Gragas,202,104,98,51.49
Naafiri,Zed,365,173,192,47.4
Naafiri,Vayne,513,269,244,52.44
Naafiri,Senna,267,126,141,47.19
Naafiri,Gwen,181,89,92,49.17
Naafiri,MonkeyKing,292,145,147,49.66
Naafiri,Yasuo,816,352,464,43.14
Naafiri,Kaisa,725,399,326,55.03
Naafiri,Renata,45,26,19,57.78
Naafiri,Volibear,519,244,275,47.01
Naafiri,JarvanIV,220,112,108,50.91
Naafiri,Lucian,246,149,97,60.57
Naafiri,Nami,403,217,186,53.85
Naafiri,Warwick,691,349,342,50.51
Naafiri,Yone,754,351,403,46.55
Naafiri,Mel,869,420,449,48.33
Naafiri,Brand,349,184,165,52.72
Naafiri,Jayce,162,89,73,54.94
Naafiri,Diana,691,367,324,53.11
Naafiri,Anivia,129,65,64,50.39
Naafiri,Ezreal,964,509,455,52.8
Naafiri,TahmKench,329,180,149,54.71
Naafiri,Darius,781,392,389,50.19
Naafiri,Viego,633,325,308,51.34
Naafiri,AurelionSol,152,93,59,61.18
Naafiri,Xayah,186,91,95,48.92
Naafiri,Seraphine,368,179,189,48.64
Naafiri,Gnar,179,86,93,48.04
Naafiri,FiddleSticks,194,93,101,47.94
Naafiri,Irelia,370,195,175,52.7
Naafiri,Smolder,251,120,131,47.81
Naafiri,Sona,107,49,58,45.79
Naafiri,LeeSin,537,278,259,51.77
Naafiri,Sylas,595,320,275,53.78
Naafiri,Jinx,1108,496,612,44.77
Naafiri,Pyke,367,198,169,53.95
Naafiri,Ambessa,270,128,142,47.41
Naafiri,Jax,337,174,163,51.63
Naafiri,Malzahar,409,208,201,50.86
Naafiri,Jhin,908,482,426,53.08
Naafiri,Nasus,319,152,167,47.65
Naafiri,TwistedFate,120,78,42,65
Naafiri,Samira,266,138,128,51.88
Naafiri,Rammus,117,54,63,46.15
Naafiri,Neeko,180,96,84,53.33
Naafiri,Ziggs,139,64,75,46.04
Naafiri,Shaco,372,201,171,54.03
Naafiri,Taliyah,117,50,67,42.74
Naafiri,Renekton,168,79,89,47.02
Naafiri,Kayn,640,336,304,52.5
Naafiri,Veigar,473,192,281,40.59
Naafiri,MissFortune,991,478,513,48.23
Naafiri,Lux,1087,548,539,50.41
Naafiri,Sett,601,333,268,55.41
Naafiri,Leblanc,319,208,111,65.2
Naafiri,Ashe,857,436,421,50.88
Naafiri,Camille,136,89,47,65.44
Naafiri,Annie,118,69,49,58.47
Naafiri,Tristana,448,226,222,50.45
Naafiri,Blitzcrank,285,112,173,39.3
Naafiri,Twitch,322,186,136,57.76
Naafiri,Riven,194,103,91,53.09
Naafiri,Ekko,391,203,188,51.92
Naafiri,Yorick,457,228,229,49.89
Naafiri,Caitlyn,1158,588,570,50.78
Naafiri,Graves,233,143,90,61.37
Naafiri,Aurora,307,135,172,43.97
Naafiri,Sejuani,150,94,56,62.67
Naafiri,Akali,464,235,229,50.65
Naafiri,Quinn,136,74,62,54.41
Naafiri,Orianna,197,105,92,53.3
Naafiri,Garen,689,329,360,47.75
Naafiri,Shyvana,123,46,77,37.4
Naafiri,Milio,213,109,104,51.17
Naafiri,Pantheon,621,344,277,55.39
Naafiri,Hwei,272,140,132,51.47
Naafiri,Thresh,479,228,251,47.6
Naafiri,Hecarim,171,61,110,35.67
Naafiri,Rell,135,75,60,55.56
Naafiri,Varus,351,170,181,48.43
Naafiri,Lulu,532,272,260,51.13
Naafiri,Heimerdinger,198,96,102,48.48
Naafiri,Zyra,388,185,203,47.68
Naafiri,Rakan,161,70,91,43.48
Naafiri,Lillia,220,105,115,47.73
Naafiri,Akshan,154,73,81,47.4
Naafiri,Velkoz,266,143,123,53.76
Naafiri,Ahri,461,250,211,54.23
Naafiri,Kled,60,24,36,40
Naafiri,MasterYi,485,218,267,44.95
Naafiri,Fizz,221,118,103,53.39
Naafiri,Aphelios,185,79,106,42.7
Naafiri,Nautilus,415,198,217,47.71
Naafiri,Talon,232,133,99,57.33
Naafiri,Draven,210,103,107,49.05
Naafiri,Yuumi,363,174,189,47.93
Naafiri,Sion,277,116,161,41.88
Naafiri,Vex,247,123,124,49.8
Naafiri,Soraka,224,100,124,44.64
Naafiri,Kennen,111,53,58,47.75
Naafiri,Katarina,294,175,119,59.52
Naafiri,Galio,355,160,195,45.07
Naafiri,Nocturne,557,231,326,41.47
Naafiri,Leona,353,197,156,55.81
Naafiri,Morgana,508,279,229,54.92
Naafiri,Mordekaiser,563,280,283,49.73
Naafiri,Teemo,561,280,281,49.91
Naafiri,Zilean,154,68,86,44.16
Naafiri,Zeri,147,96,51,65.31
Naafiri,Bard,117,62,55,52.99
Naafiri,Zoe,225,121,104,53.78
Naafiri,Braum,195,82,113,42.05
Naafiri,Aatrox,339,156,183,46.02
Naafiri,Illaoi,176,107,69,60.8
Naafiri,Ornn,114,63,51,55.26
Naafiri,Karthus,121,62,59,51.24
Naafiri,Corki,150,71,79,47.33
Naafiri,Vladimir,254,125,129,49.21
Naafiri,Amumu,438,193,245,44.06
Naafiri,Tryndamere,205,91,114,44.39
Naafiri,Urgot,245,108,137,44.08
Naafiri,Malphite,459,239,220,52.07
Naafiri,Rengar,117,65,52,55.56
Naafiri,Lissandra,162,64,98,39.51
Naafiri,Syndra,242,134,108,55.37
Naafiri,Cassiopeia,109,55,54,50.46
Naafiri,Udyr,144,85,59,59.03
Naafiri,Nilah,130,35,95,26.92
Naafiri,Xerath,347,203,144,58.5
Naafiri,DrMundo,223,107,116,47.98
Naafiri,Nidalee,104,72,32,69.23
Naafiri,Singed,116,45,71,38.79
Naafiri,Skarner,89,42,47,47.19
Naafiri,Trundle,244,129,115,52.87
Naafiri,Sivir,205,112,93,54.63
Naafiri,Kindred,191,85,106,44.5
Naafiri,Kassadin,77,32,45,41.56
Naafiri,Khazix,178,102,76,57.3
Naafiri,Briar,315,159,156,50.48
Naafiri,Vi,354,161,193,45.48
Naafiri,Janna,139,78,61,56.12
Naafiri,Olaf,83,39,44,46.99
Naafiri,Poppy,245,113,132,46.12
Naafiri,Viktor,339,193,146,56.93
Naafiri,Alistar,144,62,82,43.06
Naafiri,Shen,232,113,119,48.71
Naafiri,Maokai,165,75,90,45.45
Naafiri,Gangplank,187,93,94,49.73
Naafiri,Nunu,243,106,137,43.62
Naafiri,Ivern,66,34,32,51.52
Naafiri,Ryze,177,88,89,49.72
Naafiri,Rumble,87,50,37,57.47
Naafiri,Fiora,144,85,59,59.03
Naafiri,Qiyana,93,59,34,63.44
Naafiri,Evelynn,128,77,51,60.16
Naafiri,Zac,173,82,91,47.4
Naafiri,KogMaw,119,59,60,49.58
Naafiri,KSante,187,120,67,64.17
Naafiri,Taric,85,39,46,45.88
Naafiri,XinZhao,260,134,126,51.54
Naafiri,RekSai,23,8,15,34.78
Naafiri,Belveth,73,33,40,45.21
Naafiri,Azir,111,70,41,63.06
Nidalee,Rumble,163,105,58,64.42
Nidalee,FiddleSticks,167,96,71,57.49
Nidalee,Vladimir,292,139,153,47.6
Nidalee,Jhin,747,327,420,43.78
Nidalee,TahmKench,204,100,104,49.02
Nidalee,Darius,660,297,363,45
Nidalee,Nocturne,524,238,286,45.42
Nidalee,Fizz,195,89,106,45.64
Nidalee,Samira,229,98,131,42.79
Nidalee,Lux,806,359,447,44.54
Nidalee,Volibear,309,123,186,39.81
Nidalee,Warwick,430,193,237,44.88
Nidalee,Yone,718,328,390,45.68
Nidalee,Mel,626,337,289,53.83
Nidalee,Brand,225,113,112,50.22
Nidalee,Sett,591,274,317,46.36
Nidalee,LeeSin,1151,521,630,45.26
Nidalee,Aurora,291,123,168,42.27
Nidalee,Pyke,302,160,142,52.98
Nidalee,Irelia,354,155,199,43.79
Nidalee,Ezreal,1279,564,715,44.1
Nidalee,Taric,61,32,29,52.46
Nidalee,Zed,431,202,229,46.87
Nidalee,Aphelios,190,77,113,40.53
Nidalee,Swain,319,143,176,44.83
Nidalee,Kayn,486,196,290,40.33
Nidalee,Neeko,220,118,102,53.64
Nidalee,Nasus,220,87,133,39.55
Nidalee,Viego,657,300,357,45.66
Nidalee,Lissandra,162,63,99,38.89
Nidalee,Vayne,409,201,208,49.14
Nidalee,Lulu,568,246,322,43.31
Nidalee,Galio,362,176,186,48.62
Nidalee,Ashe,1035,422,613,40.77
Nidalee,Soraka,160,78,82,48.75
Nidalee,Malzahar,302,113,189,37.42
Nidalee,Akali,495,252,243,50.91
Nidalee,Jinx,995,449,546,45.13
Nidalee,Janna,111,50,61,45.05
Nidalee,Chogath,353,159,194,45.04
Nidalee,Elise,362,180,182,49.72
Nidalee,Hwei,288,126,162,43.75
Nidalee,MasterYi,368,166,202,45.11
Nidalee,Katarina,274,109,165,39.78
Nidalee,Lucian,284,117,167,41.2
Nidalee,Seraphine,228,102,126,44.74
Nidalee,Veigar,319,134,185,42.01
Nidalee,Yorick,317,147,170,46.37
Nidalee,Zeri,210,92,118,43.81
Nidalee,Riven,186,84,102,45.16
Nidalee,Lillia,176,86,90,48.86
Nidalee,Caitlyn,974,475,499,48.77
Nidalee,Nami,327,117,210,35.78
Nidalee,Mordekaiser,317,135,182,42.59
Nidalee,Karthus,132,80,52,60.61
Nidalee,Yasuo,724,308,416,42.54
Nidalee,Sivir,221,113,108,51.13
Nidalee,Thresh,624,299,325,47.92
Nidalee,Zac,254,92,162,36.22
Nidalee,Diana,658,263,395,39.97
Nidalee,Kaisa,782,377,405,48.21
Nidalee,Yuumi,346,143,203,41.33
Nidalee,Kassadin,86,29,57,33.72
Nidalee,Draven,179,90,89,50.28
Nidalee,Malphite,417,208,209,49.88
Nidalee,Leblanc,321,181,140,56.39
Nidalee,Senna,258,110,148,42.64
Nidalee,XinZhao,277,118,159,42.6
Nidalee,Olaf,92,47,45,51.09
Nidalee,Graves,404,187,217,46.29
Nidalee,Milio,193,88,105,45.6
Nidalee,Sejuani,136,75,61,55.15
Nidalee,Ekko,329,143,186,43.47
Nidalee,Naafiri,104,32,72,30.77
Nidalee,Shen,220,87,133,39.55
Nidalee,Briar,203,90,113,44.33
Nidalee,Teemo,433,169,264,39.03
Nidalee,Corki,177,87,90,49.15
Nidalee,Qiyana,94,58,36,61.7
Nidalee,Vi,353,146,207,41.36
Nidalee,Trundle,180,99,81,55
Nidalee,Varus,351,150,201,42.74
Nidalee,Ambessa,288,144,144,50
Nidalee,Skarner,95,63,32,66.32
Nidalee,Smolder,208,93,115,44.71
Nidalee,Heimerdinger,154,73,81,47.4
Nidalee,Rell,191,72,119,37.7
Nidalee,Azir,147,79,68,53.74
Nidalee,Rakan,145,55,90,37.93
Nidalee,Karma,628,289,339,46.02
Nidalee,Sylas,640,282,358,44.06
Nidalee,Braum,239,108,131,45.19
Nidalee,Tristana,422,196,226,46.45
Nidalee,Annie,168,79,89,47.02
Nidalee,Ivern,58,29,29,50
Nidalee,Rengar,130,69,61,53.08
Nidalee,AurelionSol,148,76,72,51.35
Nidalee,Pantheon,658,323,335,49.09
Nidalee,Urgot,143,47,96,32.87
Nidalee,JarvanIV,256,99,157,38.67
Nidalee,Aatrox,423,146,277,34.52
Nidalee,Ahri,534,228,306,42.7
Nidalee,Zilean,139,68,71,48.92
Nidalee,MissFortune,770,323,447,41.95
Nidalee,Udyr,152,61,91,40.13
Nidalee,Renekton,235,102,133,43.4
Nidalee,Zyra,485,200,285,41.24
Nidalee,Gangplank,206,111,95,53.88
Nidalee,Tryndamere,197,92,105,46.7
Nidalee,Morgana,329,174,155,52.89
Nidalee,TwistedFate,163,93,70,57.06
Nidalee,Illaoi,169,81,88,47.93
Nidalee,Xayah,170,79,91,46.47
Nidalee,Garen,514,195,319,37.94
Nidalee,Rammus,78,32,46,41.03
Nidalee,Viktor,411,165,246,40.15
Nidalee,Taliyah,127,69,58,54.33
Nidalee,Quinn,146,60,86,41.1
Nidalee,MonkeyKing,272,126,146,46.32
Nidalee,Sion,275,120,155,43.64
Nidalee,Evelynn,120,51,69,42.5
Nidalee,Sona,116,50,66,43.1
Nidalee,Nilah,78,30,48,38.46
Nidalee,Gwen,161,62,99,38.51
Nidalee,Velkoz,232,111,121,47.84
Nidalee,Leona,316,123,193,38.92
Nidalee,Amumu,284,137,147,48.24
Nidalee,Kayle,187,89,98,47.59
Nidalee,Nautilus,430,176,254,40.93
Nidalee,Khazix,288,127,161,44.1
Nidalee,Kled,66,27,39,40.91
Nidalee,Jax,323,156,167,48.3
Nidalee,Shaco,314,133,181,42.36
Nidalee,Xerath,439,173,266,39.41
Nidalee,Kennen,108,41,67,37.96
Nidalee,Renata,65,35,30,53.85
Nidalee,Singed,81,32,49,39.51
Nidalee,Ryze,149,52,97,34.9
Nidalee,Hecarim,164,73,91,44.51
Nidalee,Ziggs,140,65,75,46.43
Nidalee,Camille,209,73,136,34.93
Nidalee,Kalista,76,43,33,56.58
Nidalee,Orianna,219,111,108,50.68
Nidalee,Twitch,233,100,133,42.92
Nidalee,Talon,272,126,146,46.32
Nidalee,Zoe,163,82,81,50.31
Nidalee,KSante,260,150,110,57.69
Nidalee,RekSai,81,48,33,59.26
Nidalee,Fiora,140,56,84,40
Nidalee,Ornn,151,53,98,35.1
Nidalee,Shyvana,70,34,36,48.57
Nidalee,Nunu,143,87,56,60.84
Nidalee,Cassiopeia,125,58,67,46.4
Nidalee,Syndra,242,105,137,43.39
Nidalee,Maokai,152,71,81,46.71
Nidalee,Bard,109,48,61,44.04
Nidalee,DrMundo,181,81,100,44.75
Nidalee,Kindred,178,76,102,42.7
Nidalee,Blitzcrank,294,134,160,45.58
Nidalee,Jayce,288,142,146,49.31
Nidalee,Gnar,174,88,86,50.57
Nidalee,KogMaw,124,73,51,58.87
Nidalee,Vex,183,83,100,45.36
Nidalee,Anivia,111,43,68,38.74
Nidalee,Poppy,284,151,133,53.17
Nidalee,Gragas,232,112,120,48.28
Nidalee,Belveth,82,45,37,54.88
Nidalee,Akshan,101,37,64,36.63
Nidalee,Alistar,142,64,78,45.07
Udyr,Olaf,111,40,71,36.04
Udyr,Trundle,253,109,144,43.08
Udyr,Vex,222,115,107,51.8
Udyr,Ezreal,1141,578,563,50.66
Udyr,Xerath,406,201,205,49.51
Udyr,Kayle,338,170,168,50.3
Udyr,Volibear,642,345,297,53.74
Udyr,Yasuo,935,463,472,49.52
Udyr,Draven,267,142,125,53.18
Udyr,Thresh,686,369,317,53.79
Udyr,Yorick,488,197,291,40.37
Udyr,Darius,1183,604,579,51.06
Udyr,Syndra,327,131,196,40.06
Udyr,Samira,312,170,142,54.49
Udyr,Pantheon,722,319,403,44.18
Udyr,Riven,255,144,111,56.47
Udyr,Graves,308,149,159,48.38
Udyr,Ekko,455,245,210,53.85
Udyr,Aphelios,214,122,92,57.01
Udyr,TahmKench,379,187,192,49.34
Udyr,Ambessa,328,138,190,42.07
Udyr,Hecarim,257,148,109,57.59
Udyr,Katarina,306,161,145,52.61
Udyr,Veigar,529,230,299,43.48
Udyr,Nami,556,256,300,46.04
Udyr,Viego,747,384,363,51.41
Udyr,Taliyah,117,58,59,49.57
Udyr,Jinx,1401,660,741,47.11
Udyr,Blitzcrank,350,181,169,51.71
Udyr,Warwick,790,405,385,51.27
Udyr,Skarner,123,79,44,64.23
Udyr,Morgana,596,297,299,49.83
Udyr,Karma,585,291,294,49.74
Udyr,Shen,300,156,144,52
Udyr,Caitlyn,1425,683,742,47.93
Udyr,Zyra,424,222,202,52.36
Udyr,Neeko,213,124,89,58.22
Udyr,Elise,333,159,174,47.75
Udyr,Mel,998,481,517,48.2
Udyr,MissFortune,1055,488,567,46.26
Udyr,Pyke,381,202,179,53.02
Udyr,Rengar,118,46,72,38.98
Udyr,Malzahar,580,258,322,44.48
Udyr,Vayne,611,279,332,45.66
Udyr,Lulu,690,336,354,48.7
Udyr,Nasus,325,138,187,42.46
Udyr,Kindred,237,118,119,49.79
Udyr,Akali,529,255,274,48.2
Udyr,Lillia,313,162,151,51.76
Udyr,Jayce,204,110,94,53.92
Udyr,Sett,772,382,390,49.48
Udyr,LeeSin,673,334,339,49.63
Udyr,Gangplank,209,114,95,54.55
Udyr,Senna,401,173,228,43.14
Udyr,Quinn,209,112,97,53.59
Udyr,Kayn,765,327,438,42.75
Udyr,Ahri,598,314,284,52.51
Udyr,Jhin,965,419,546,43.42
Udyr,Janna,196,87,109,44.39
Udyr,Fizz,279,155,124,55.56
Udyr,Tristana,522,262,260,50.19
Udyr,Swain,536,264,272,49.25
Udyr,Yone,824,408,416,49.51
Udyr,XinZhao,323,139,184,43.03
Udyr,Lucian,401,176,225,43.89
Udyr,Khazix,204,110,94,53.92
Udyr,Sylas,633,307,326,48.5
Udyr,Vladimir,305,142,163,46.56
Udyr,Irelia,384,198,186,51.56
Udyr,Teemo,520,223,297,42.88
Udyr,KSante,254,98,156,38.58
Udyr,Diana,817,381,436,46.63
Udyr,Soraka,291,140,151,48.11
Udyr,Talon,315,158,157,50.16
Udyr,Rell,200,91,109,45.5
Udyr,Poppy,245,116,129,47.35
Udyr,Lissandra,133,70,63,52.63
Udyr,Lux,1107,524,583,47.34
Udyr,Kaisa,803,407,396,50.68
Udyr,Chogath,578,293,285,50.69
Udyr,Galio,443,216,227,48.76
Udyr,Malphite,540,276,264,51.11
Udyr,Zilean,160,101,59,63.13
Udyr,Ashe,998,459,539,45.99
Udyr,Zoe,185,95,90,51.35
Udyr,Velkoz,292,123,169,42.12
Udyr,Garen,785,375,410,47.77
Udyr,Singed,157,107,50,68.15
Udyr,Varus,445,216,229,48.54
Udyr,Nunu,269,108,161,40.15
Udyr,Yuumi,380,182,198,47.89
Udyr,MonkeyKing,352,180,172,51.14
Udyr,Briar,328,172,156,52.44
Udyr,Azir,207,98,109,47.34
Udyr,Nautilus,539,252,287,46.75
Udyr,Jax,428,206,222,48.13
Udyr,Braum,287,151,136,52.61
Udyr,MasterYi,677,345,332,50.96
Udyr,Ziggs,187,111,76,59.36
Udyr,Gnar,228,115,113,50.44
Udyr,Rakan,181,76,105,41.99
Udyr,Tryndamere,322,144,178,44.72
Udyr,Milio,300,141,159,47
Udyr,Amumu,499,239,260,47.9
Udyr,Nocturne,664,340,324,51.2
Udyr,Gragas,293,150,143,51.19
Udyr,Vi,448,207,241,46.21
Udyr,Orianna,187,60,127,32.09
Udyr,Heimerdinger,174,67,107,38.51
Udyr,FiddleSticks,246,121,125,49.19
Udyr,Aurora,338,150,188,44.38
Udyr,Mordekaiser,685,330,355,48.18
Udyr,Sejuani,172,86,86,50
Udyr,Anivia,148,63,85,42.57
Udyr,Renekton,235,113,122,48.09
Udyr,Viktor,481,211,270,43.87
Udyr,Gwen,308,153,155,49.68
Udyr,Ivern,58,22,36,37.93
Udyr,Renata,66,34,32,51.52
Udyr,Naafiri,144,59,85,40.97
Udyr,TwistedFate,200,108,92,54
Udyr,DrMundo,303,171,132,56.44
Udyr,Shaco,477,229,248,48.01
Udyr,Kassadin,85,40,45,47.06
Udyr,Smolder,316,177,139,56.01
Udyr,Aatrox,485,263,222,54.23
Udyr,Zac,256,124,132,48.44
Udyr,Xayah,222,119,103,53.6
Udyr,RekSai,75,46,29,61.33
Udyr,Akshan,183,122,61,66.67
Udyr,Alistar,224,85,139,37.95
Udyr,Illaoi,222,115,107,51.8
Udyr,Qiyana,139,76,63,54.68
Udyr,Corki,207,124,83,59.9
Udyr,Brand,342,166,176,48.54
Udyr,Zed,587,302,285,51.45
Udyr,Ryze,200,90,110,45
Udyr,Urgot,284,120,164,42.25
Udyr,Belveth,123,56,67,45.53
Udyr,Shyvana,129,61,68,47.29
Udyr,Annie,144,57,87,39.58
Udyr,Maokai,263,137,126,52.09
Udyr,Seraphine,349,178,171,51
Udyr,Evelynn,195,102,93,52.31
Udyr,AurelionSol,196,103,93,52.55
Udyr,Leona,470,227,243,48.3
Udyr,Sivir,253,126,127,49.8
Udyr,Leblanc,240,127,113,52.92
Udyr,Kennen,114,61,53,53.51
Udyr,Zeri,187,110,77,58.82
Udyr,Karthus,114,74,40,64.91
Udyr,Nidalee,152,91,61,59.87
Udyr,Camille,176,99,77,56.25
Udyr,KogMaw,188,69,119,36.7
Udyr,Kled,65,23,42,35.38
Udyr,Sion,408,182,226,44.61
Udyr,Kalista,116,60,56,51.72
Udyr,JarvanIV,324,132,192,40.74
Udyr,Sona,143,91,52,63.64
Udyr,Rammus,97,50,47,51.55
Udyr,Rumble,122,59,63,48.36
Udyr,Fiora,162,77,85,47.53
Udyr,Nilah,158,51,107,32.28
Udyr,Cassiopeia,125,46,79,36.8
Udyr,Twitch,455,265,190,58.24
Udyr,Hwei,366,152,214,41.53
Udyr,Bard,152,95,57,62.5
Udyr,Taric,114,54,60,47.37
Udyr,Ornn,160,75,85,46.88
Taric,Kayle,255,120,135,47.06
Taric,Volibear,348,189,159,54.31
Taric,Yasuo,568,304,264,53.52
Taric,Draven,169,98,71,57.99
Taric,Thresh,462,223,239,48.27
Taric,Ambessa,149,64,85,42.95
Taric,Nocturne,342,168,174,49.12
Taric,Kassadin,51,26,25,50.98
Taric,Caitlyn,747,390,357,52.21
Taric,Soraka,172,80,92,46.51
Taric,Jax,221,121,100,54.75
Taric,Nidalee,61,29,32,47.54
Taric,Jinx,825,373,452,45.21
Taric,Pantheon,414,218,196,52.66
Taric,Teemo,329,156,173,47.42
Taric,Ryze,81,37,44,45.68
Taric,Ashe,492,250,242,50.81
Taric,Senna,181,84,97,46.41
Taric,Vladimir,215,116,99,53.95
Taric,Ezreal,574,301,273,52.44
Taric,Sylas,355,201,154,56.62
Taric,Braum,183,97,86,53.01
Taric,Gragas,133,66,67,49.62
Taric,Akali,272,131,141,48.16
Taric,Vayne,436,226,210,51.83
Taric,Lulu,434,216,218,49.77
Taric,Trundle,165,82,83,49.7
Taric,Warwick,420,211,209,50.24
Taric,Diana,459,245,214,53.38
Taric,Veigar,259,117,142,45.17
Taric,Seraphine,144,52,92,36.11
Taric,Renekton,147,75,72,51.02
Taric,FiddleSticks,126,82,44,65.08
Taric,Ahri,325,170,155,52.31
Taric,MissFortune,627,313,314,49.92
Taric,Darius,592,300,292,50.68
Taric,Amumu,303,163,140,53.8
Taric,Aatrox,244,123,121,50.41
Taric,Kayn,435,222,213,51.03
Taric,DrMundo,184,98,86,53.26
Taric,Shyvana,48,11,37,22.92
Taric,Smolder,157,76,81,48.41
Taric,Nami,230,105,125,45.65
Taric,Shaco,263,140,123,53.23
Taric,Lux,614,284,330,46.25
Taric,Orianna,159,77,82,48.43
Taric,Sett,396,221,175,55.81
Taric,Ivern,39,11,28,28.21
Taric,Yone,436,248,188,56.88
Taric,Twitch,245,153,92,62.45
Taric,Galio,190,95,95,50
Taric,Garen,458,238,220,51.97
Taric,MasterYi,398,217,181,54.52
Taric,Elise,201,113,88,56.22
Taric,Mel,576,293,283,50.87
Taric,TahmKench,244,114,130,46.72
Taric,Karma,301,141,160,46.84
Taric,Fizz,155,67,88,43.23
Taric,Tristana,282,149,133,52.84
Taric,Brand,155,80,75,51.61
Taric,Leblanc,129,78,51,60.47
Taric,Sona,120,64,56,53.33
Taric,Nasus,179,90,89,50.28
Taric,Blitzcrank,206,115,91,55.83
Taric,Irelia,185,94,91,50.81
Taric,Aurora,199,112,87,56.28
Taric,Briar,184,89,95,48.37
Taric,Samira,197,121,76,61.42
Taric,Yuumi,235,154,81,65.53
Taric,Malphite,293,152,141,51.88
Taric,Talon,121,59,62,48.76
Taric,Gangplank,164,88,76,53.66
Taric,Malzahar,326,151,175,46.32
Taric,Xayah,124,56,68,45.16
Taric,Zyra,235,114,121,48.51
Taric,LeeSin,395,191,204,48.35
Taric,Vex,129,56,73,43.41
Taric,Aphelios,144,83,61,57.64
Taric,Tryndamere,174,79,95,45.4
Taric,Kaisa,416,197,219,47.36
Taric,Shen,163,86,77,52.76
Taric,Kalista,79,38,41,48.1
Taric,Rell,135,68,67,50.37
Taric,Riven,170,83,87,48.82
Taric,KogMaw,106,58,48,54.72
Taric,Pyke,216,123,93,56.94
Taric,Poppy,168,108,60,64.29
Taric,Rammus,70,44,26,62.86
Taric,Jhin,515,262,253,50.87
Taric,Zed,338,187,151,55.33
Taric,Evelynn,67,26,41,38.81
Taric,Viktor,261,134,127,51.34
Taric,Fiora,87,44,43,50.57
Taric,Milio,161,85,76,52.8
Taric,Sivir,128,77,51,60.16
Taric,Leona,283,145,138,51.24
Taric,Ekko,276,143,133,51.81
Taric,Chogath,372,176,196,47.31
Taric,Hwei,136,69,67,50.74
Taric,Singed,75,44,31,58.67
Taric,Sejuani,111,64,47,57.66
Taric,AurelionSol,134,80,54,59.7
Taric,Mordekaiser,405,227,178,56.05
Taric,Gwen,144,75,69,52.08
Taric,Lillia,127,51,76,40.16
Taric,Maokai,148,58,90,39.19
Taric,Nautilus,484,288,196,59.5
Taric,Yorick,294,118,176,40.14
Taric,Annie,85,47,38,55.29
Taric,Khazix,149,88,61,59.06
Taric,Syndra,182,77,105,42.31
Taric,Taliyah,91,44,47,48.35
Taric,Ornn,118,57,61,48.31
Taric,KSante,128,68,60,53.13
Taric,JarvanIV,164,83,81,50.61
Taric,Nunu,172,107,65,62.21
Taric,Sion,232,124,108,53.45
Taric,Hecarim,112,64,48,57.14
Taric,Cassiopeia,66,31,35,46.97
Taric,Karthus,62,27,35,43.55
Taric,Ziggs,83,53,30,63.86
Taric,Kennen,71,33,38,46.48
Taric,Rengar,69,31,38,44.93
Taric,Azir,85,48,37,56.47
Taric,Urgot,129,53,76,41.09
Taric,Alistar,133,66,67,49.62
Taric,Morgana,249,132,117,53.01
Taric,Vi,281,170,111,60.5
Taric,Lissandra,101,35,66,34.65
Taric,Zeri,108,73,35,67.59
Taric,Katarina,193,84,109,43.52
Taric,Swain,290,127,163,43.79
Taric,Camille,83,42,41,50.6
Taric,Akshan,97,46,51,47.42
Taric,Zac,125,59,66,47.2
Taric,MonkeyKing,189,82,107,43.39
Taric,Viego,336,142,194,42.26
Taric,Lucian,173,94,79,54.34
Taric,Xerath,201,116,85,57.71
Taric,Kled,59,26,33,44.07
Taric,Quinn,61,31,30,50.82
Taric,Heimerdinger,123,63,60,51.22
Taric,XinZhao,191,93,98,48.69
Taric,Janna,113,38,75,33.63
Taric,Gnar,104,51,53,49.04
Taric,Skarner,40,27,13,67.5
Taric,Kindred,69,44,25,63.77
Taric,Rakan,85,35,50,41.18
Taric,Varus,225,85,140,37.78
Taric,Illaoi,110,57,53,51.82
Taric,Bard,69,36,33,52.17
Taric,Naafiri,85,46,39,54.12
Taric,Udyr,114,60,54,52.63
Taric,Renata,54,31,23,57.41
Taric,Velkoz,177,84,93,47.46
Taric,Graves,155,75,80,48.39
Taric,Olaf,60,42,18,70
Taric,Rumble,75,46,29,61.33
Taric,Qiyana,65,42,23,64.62
Taric,Nilah,103,39,64,37.86
Taric,Neeko,87,40,47,45.98
Taric,TwistedFate,122,66,56,54.1
Taric,Zilean,59,28,31,47.46
Taric,Belveth,63,18,45,28.57
Taric,Corki,148,76,72,51.35
Taric,Jayce,75,47,28,62.67
Taric,Anivia,91,47,44,51.65
Taric,Zoe,91,47,44,51.65
Taric,RekSai,31,23,8,74.19
Kled,Chogath,251,131,120,52.19
Kled,Ekko,192,99,93,51.56
Kled,Malzahar,243,120,123,49.38
Kled,MissFortune,422,234,188,55.45
Kled,Nami,233,117,116,50.21
Kled,Yorick,200,106,94,53
Kled,Volibear,280,139,141,49.64
Kled,Yasuo,440,192,248,43.64
Kled,Ashe,501,264,237,52.69
Kled,Lulu,344,176,168,51.16
Kled,Kayn,339,184,155,54.28
Kled,Katarina,142,81,61,57.04
Kled,Mel,454,236,218,51.98
Kled,Darius,452,206,246,45.58
Kled,Briar,191,105,86,54.97
Kled,Gangplank,140,68,72,48.57
Kled,Singed,85,51,34,60
Kled,Graves,163,78,85,47.85
Kled,Viktor,233,106,127,45.49
Kled,Samira,94,47,47,50
Kled,Pantheon,337,155,182,45.99
Kled,Kayle,153,88,65,57.52
Kled,Fizz,144,78,66,54.17
Kled,Jinx,635,318,317,50.08
Kled,Nautilus,287,147,140,51.22
Kled,Aatrox,238,121,117,50.84
Kled,Ahri,257,115,142,44.75
Kled,Caitlyn,622,308,314,49.52
Kled,Thresh,289,163,126,56.4
Kled,Shen,175,89,86,50.86
Kled,Nocturne,308,143,165,46.43
Kled,Neeko,91,41,50,45.05
Kled,Twitch,173,95,78,54.91
Kled,Yuumi,157,72,85,45.86
Kled,Garen,332,179,153,53.92
Kled,Yone,450,219,231,48.67
Kled,TahmKench,142,80,62,56.34
Kled,Orianna,91,44,47,48.35
Kled,JarvanIV,151,49,102,32.45
Kled,Lucian,176,92,84,52.27
Kled,Brand,168,89,79,52.98
Kled,Akali,238,121,117,50.84
Kled,Janna,88,39,49,44.32
Kled,Rammus,52,26,26,50
Kled,Naafiri,60,36,24,60
Kled,Seraphine,143,87,56,60.84
Kled,Amumu,273,126,147,46.15
Kled,Soraka,119,51,68,42.86
Kled,Nasus,171,88,83,51.46
Kled,Sejuani,92,35,57,38.04
Kled,Vayne,314,153,161,48.73
Kled,Lillia,119,84,35,70.59
Kled,Swain,203,87,116,42.86
Kled,Braum,91,25,66,27.47
Kled,Diana,320,159,161,49.69
Kled,Gwen,115,57,58,49.57
Kled,Veigar,236,128,108,54.24
Kled,Senna,152,84,68,55.26
Kled,Rumble,84,59,25,70.24
Kled,Khazix,112,61,51,54.46
Kled,Illaoi,106,62,44,58.49
Kled,Draven,121,63,58,52.07
Kled,Mordekaiser,265,112,153,42.26
Kled,Aphelios,135,69,66,51.11
Kled,Morgana,240,123,117,51.25
Kled,Sion,156,74,82,47.44
Kled,Vi,224,138,86,61.61
Kled,Lux,532,270,262,50.75
Kled,Kennen,46,25,21,54.35
Kled,Warwick,313,147,166,46.96
Kled,Leblanc,181,83,98,45.86
Kled,Leona,220,99,121,45
Kled,Gragas,137,85,52,62.04
Kled,Irelia,160,70,90,43.75
Kled,Jax,204,108,96,52.94
Kled,Vex,102,61,41,59.8
Kled,RekSai,30,10,20,33.33
Kled,Smolder,142,83,59,58.45
Kled,Fiora,74,36,38,48.65
Kled,Shaco,172,90,82,52.33
Kled,Ezreal,594,303,291,51.01
Kled,Sona,66,31,35,46.97
Kled,Pyke,180,96,84,53.33
Kled,Talon,126,76,50,60.32
Kled,Hecarim,93,55,38,59.14
Kled,Kassadin,46,24,22,52.17
Kled,MasterYi,245,135,110,55.1
Kled,Jhin,464,243,221,52.37
Kled,Zed,233,125,108,53.65
Kled,Kalista,59,46,13,77.97
Kled,Galio,168,85,83,50.6
Kled,Teemo,247,111,136,44.94
Kled,Renekton,118,64,54,54.24
Kled,FiddleSticks,132,76,56,57.58
Kled,Poppy,166,70,96,42.17
Kled,Elise,180,105,75,58.33
Kled,Vladimir,168,83,85,49.4
Kled,Rengar,88,54,34,61.36
Kled,Kaisa,376,178,198,47.34
Kled,Sylas,343,188,155,54.81
Kled,Aurora,123,46,77,37.4
Kled,Ryze,73,37,36,50.68
Kled,Shyvana,103,39,64,37.86
Kled,KogMaw,79,46,33,58.23
Kled,Rakan,80,42,38,52.5
Kled,Belveth,62,31,31,50
Kled,Rell,136,64,72,47.06
Kled,XinZhao,139,69,70,49.64
Kled,Varus,227,101,126,44.49
Kled,Zyra,223,108,115,48.43
Kled,Sivir,110,54,56,49.09
Kled,Xayah,110,60,50,54.55
Kled,Karma,311,139,172,44.69
Kled,Annie,87,51,36,58.62
Kled,Sett,316,137,179,43.35
Kled,Gnar,95,45,50,47.37
Kled,Malphite,205,98,107,47.8
Kled,Blitzcrank,132,74,58,56.06
Kled,Ambessa,121,64,57,52.89
Kled,Qiyana,57,33,24,57.89
Kled,Udyr,65,42,23,64.62
Kled,MonkeyKing,132,64,68,48.48
Kled,Zeri,82,44,38,53.66
Kled,Viego,286,139,147,48.6
Kled,Xerath,210,114,96,54.29
Kled,KSante,137,60,77,43.8
Kled,Milio,118,61,57,51.69
Kled,LeeSin,279,148,131,53.05
Kled,Anivia,82,44,38,53.66
Kled,Quinn,62,35,27,56.45
Kled,Tristana,215,118,97,54.88
Kled,Taric,59,33,26,55.93
Kled,Ziggs,77,23,54,29.87
Kled,Riven,100,76,24,76
Kled,Evelynn,68,25,43,36.76
Kled,Zoe,94,45,49,47.87
Kled,Cassiopeia,64,28,36,43.75
Kled,Corki,86,50,36,58.14
Kled,Nidalee,66,39,27,59.09
Kled,Tryndamere,133,71,62,53.38
Kled,Nunu,63,38,25,60.32
Kled,Zac,119,47,72,39.5
Kled,Velkoz,128,48,80,37.5
Kled,Jayce,105,48,57,45.71
Kled,Maokai,108,40,68,37.04
Kled,Ornn,90,51,39,56.67
Kled,Hwei,148,82,66,55.41
Kled,Azir,92,52,40,56.52
Kled,Urgot,134,61,73,45.52
Kled,Nilah,57,32,25,56.14
Kled,Heimerdinger,85,40,45,47.06
Kled,Trundle,132,67,65,50.76
Kled,DrMundo,133,76,57,57.14
Kled,Renata,36,20,16,55.56
Kled,AurelionSol,83,50,33,60.24
Kled,Kindred,105,56,49,53.33
Kled,Karthus,51,35,16,68.63
Kled,Syndra,160,81,79,50.63
Kled,Olaf,55,26,29,47.27
Kled,Lissandra,71,24,47,33.8
Kled,Skarner,85,42,43,49.41
Kled,TwistedFate,105,61,44,58.1
Kled,Taliyah,35,18,17,51.43
Kled,Camille,76,46,30,60.53
Kled,Ivern,40,24,16,60
Kled,Akshan,63,36,27,57.14
Kled,Zilean,69,36,33,52.17
Kled,Bard,51,23,28,45.1
Kled,Alistar,78,31,47,39.74
RekSai,Kayle,94,37,57,39.36
RekSai,Vi,129,73,56,56.59
RekSai,Malzahar,117,53,64,45.3
RekSai,Ashe,306,147,159,48.04
RekSai,TahmKench,81,41,40,50.62
RekSai,Camille,53,22,31,41.51
RekSai,Kayn,194,113,81,58.25
RekSai,Yasuo,298,154,144,51.68
RekSai,Caitlyn,330,179,151,54.24
RekSai,Lux,333,148,185,44.44
RekSai,Renekton,87,34,53,39.08
RekSai,Evelynn,25,14,11,56
RekSai,Teemo,151,72,79,47.68
RekSai,Samira,87,33,54,37.93
RekSai,Leona,105,49,56,46.67
RekSai,Yorick,101,39,62,38.61
RekSai,Pantheon,239,122,117,51.05
RekSai,Talon,104,72,32,69.23
RekSai,Twitch,131,66,65,50.38
RekSai,Neeko,71,34,37,47.89
RekSai,Jax,144,91,53,63.19
RekSai,Rammus,44,24,20,54.55
RekSai,Chogath,179,51,128,28.49
RekSai,Diana,216,84,132,38.89
RekSai,Mordekaiser,201,77,124,38.31
RekSai,Graves,127,59,68,46.46
RekSai,Katarina,143,66,77,46.15
RekSai,Ezreal,519,243,276,46.82
RekSai,Soraka,103,47,56,45.63
RekSai,Warwick,204,81,123,39.71
RekSai,Shaco,165,84,81,50.91
RekSai,Vladimir,109,43,66,39.45
RekSai,Lulu,212,110,102,51.89
RekSai,Malphite,156,90,66,57.69
RekSai,Nocturne,182,89,93,48.9
RekSai,Kassadin,41,17,24,41.46
RekSai,Xayah,73,31,42,42.47
RekSai,Thresh,184,90,94,48.91
RekSai,Gnar,71,31,40,43.66
RekSai,Aurora,116,35,81,30.17
RekSai,Sion,115,58,57,50.43
RekSai,Galio,163,87,76,53.37
RekSai,Tristana,145,69,76,47.59
RekSai,Morgana,156,70,86,44.87
RekSai,Briar,103,43,60,41.75
RekSai,Jhin,296,174,122,58.78
RekSai,Syndra,110,33,77,30
RekSai,Braum,101,55,46,54.46
RekSai,Sett,241,108,133,44.81
RekSai,Zed,182,83,99,45.6
RekSai,Jinx,420,177,243,42.14
RekSai,Trundle,83,43,40,51.81
RekSai,Sylas,196,90,106,45.92
RekSai,Kalista,43,20,23,46.51
RekSai,Poppy,144,59,85,40.97
RekSai,Swain,123,49,74,39.84
RekSai,Kennen,45,29,16,64.44
RekSai,Smolder,123,68,55,55.28
RekSai,FiddleSticks,87,44,43,50.57
RekSai,Akali,136,82,54,60.29
RekSai,Kaisa,277,115,162,41.52
RekSai,Kled,30,20,10,66.67
RekSai,Ekko,150,58,92,38.67
RekSai,Nilah,45,21,24,46.67
RekSai,Singed,62,34,28,54.84
RekSai,Hwei,124,76,48,61.29
RekSai,Brand,113,61,52,53.98
RekSai,Mel,299,140,159,46.82
RekSai,Nami,178,93,85,52.25
RekSai,Udyr,75,29,46,38.67
RekSai,Akshan,29,10,19,34.48
RekSai,Milio,116,64,52,55.17
RekSai,Xerath,133,60,73,45.11
RekSai,Elise,142,74,68,52.11
RekSai,Tryndamere,63,34,29,53.97
RekSai,Darius,325,164,161,50.46
RekSai,Rakan,58,29,29,50
RekSai,Sejuani,79,30,49,37.97
RekSai,Heimerdinger,67,29,38,43.28
RekSai,Alistar,78,32,46,41.03
RekSai,Garen,215,94,121,43.72
RekSai,Varus,150,66,84,44
RekSai,Volibear,187,91,96,48.66
RekSai,MasterYi,139,74,65,53.24
RekSai,Lissandra,75,41,34,54.67
RekSai,Kindred,85,31,54,36.47
RekSai,Azir,66,34,32,51.52
RekSai,Fizz,68,33,35,48.53
RekSai,JarvanIV,104,51,53,49.04
RekSai,Leblanc,94,50,44,53.19
RekSai,Yuumi,155,83,72,53.55
RekSai,Shen,121,61,60,50.41
RekSai,Karthus,78,34,44,43.59
RekSai,XinZhao,116,61,55,52.59
RekSai,LeeSin,428,225,203,52.57
RekSai,Orianna,93,52,41,55.91
RekSai,Karma,206,99,107,48.06
RekSai,KSante,131,73,58,55.73
RekSai,Vayne,172,63,109,36.63
RekSai,Sona,78,35,43,44.87
RekSai,Gangplank,106,48,58,45.28
RekSai,Maokai,85,49,36,57.65
RekSai,Irelia,101,43,58,42.57
RekSai,Seraphine,99,53,46,53.54
RekSai,MissFortune,311,154,157,49.52
RekSai,Bard,53,26,27,49.06
RekSai,Fiora,72,30,42,41.67
RekSai,Ornn,65,35,30,53.85
RekSai,Khazix,48,17,31,35.42
RekSai,Vex,67,32,35,47.76
RekSai,Janna,60,33,27,55
RekSai,Nidalee,81,33,48,40.74
RekSai,Veigar,144,54,90,37.5
RekSai,Corki,85,25,60,29.41
RekSai,Illaoi,49,29,20,59.18
RekSai,Zeri,80,44,36,55
RekSai,Shyvana,24,17,7,70.83
RekSai,Zyra,157,57,100,36.31
RekSai,Aphelios,98,70,28,71.43
RekSai,Zilean,53,24,29,45.28
RekSai,Hecarim,89,63,26,70.79
RekSai,AurelionSol,47,22,25,46.81
RekSai,Ambessa,113,63,50,55.75
RekSai,Cassiopeia,31,9,22,29.03
RekSai,Senna,81,43,38,53.09
RekSai,Ziggs,44,17,27,38.64
RekSai,Pyke,122,52,70,42.62
RekSai,MonkeyKing,93,58,35,62.37
RekSai,Riven,83,27,56,32.53
RekSai,Viego,250,104,146,41.6
RekSai,Yone,255,123,132,48.24
RekSai,Annie,56,30,26,53.57
RekSai,Rell,86,37,49,43.02
RekSai,Amumu,166,79,87,47.59
RekSai,Ahri,239,117,122,48.95
RekSai,Lillia,93,51,42,54.84
RekSai,Viktor,142,59,83,41.55
RekSai,Rengar,34,28,6,82.35
RekSai,Nautilus,148,67,81,45.27
RekSai,Aatrox,131,63,68,48.09
RekSai,Urgot,83,32,51,38.55
RekSai,Naafiri,23,15,8,65.22
RekSai,Nasus,92,43,49,46.74
RekSai,TwistedFate,60,23,37,38.33
RekSai,Ryze,83,42,41,50.6
RekSai,Draven,86,31,55,36.05
RekSai,Skarner,46,26,20,56.52
RekSai,Lucian,138,66,72,47.83
RekSai,Gwen,95,55,40,57.89
RekSai,Gragas,88,53,35,60.23
RekSai,Nunu,83,36,47,43.37
RekSai,KogMaw,43,25,18,58.14
RekSai,Sivir,123,59,64,47.97
RekSai,Zac,82,37,45,45.12
RekSai,Velkoz,77,30,47,38.96
RekSai,Anivia,50,30,20,60
RekSai,Blitzcrank,118,58,60,49.15
RekSai,Qiyana,31,17,14,54.84
RekSai,Ivern,13,2,11,15.38
RekSai,Olaf,29,15,14,51.72
RekSai,Taliyah,37,8,29,21.62
RekSai,Jayce,101,36,65,35.64
RekSai,Rumble,53,20,33,37.74
RekSai,Quinn,61,27,34,44.26
RekSai,DrMundo,45,18,27,40
RekSai,Renata,22,3,19,13.64
RekSai,Taric,31,8,23,25.81
RekSai,Belveth,22,8,14,36.36
RekSai,Zoe,93,57,36,61.29
Cassiopeia,Quinn,141,74,67,52.48
Cassiopeia,Evelynn,141,84,57,59.57
Cassiopeia,Yasuo,682,338,344,49.56
Cassiopeia,Jhin,731,362,369,49.52
Cassiopeia,Brand,252,113,139,44.84
Cassiopeia,Rengar,90,44,46,48.89
Cassiopeia,XinZhao,256,118,138,46.09
Cassiopeia,Zoe,113,57,56,50.44
Cassiopeia,Jinx,1093,513,580,46.94
Cassiopeia,Leona,311,161,150,51.77
Cassiopeia,Sett,497,219,278,44.06
Cassiopeia,Warwick,490,243,247,49.59
Cassiopeia,Lissandra,132,61,71,46.21
Cassiopeia,MissFortune,813,401,412,49.32
Cassiopeia,Alistar,164,85,79,51.83
Cassiopeia,Volibear,375,219,156,58.4
Cassiopeia,Kayn,516,262,254,50.78
Cassiopeia,Talon,258,142,116,55.04
Cassiopeia,Vayne,430,219,211,50.93
Cassiopeia,Swain,407,207,200,50.86
Cassiopeia,Kayle,251,112,139,44.62
Cassiopeia,Viego,538,258,280,47.96
Cassiopeia,Yone,687,379,308,55.17
Cassiopeia,Lucian,243,141,102,58.02
Cassiopeia,Pyke,311,161,150,51.77
Cassiopeia,Darius,694,329,365,47.41
Cassiopeia,Graves,198,87,111,43.94
Cassiopeia,Aphelios,204,93,111,45.59
Cassiopeia,Yuumi,311,162,149,52.09
Cassiopeia,Trundle,222,121,101,54.5
Cassiopeia,Diana,690,369,321,53.48
Cassiopeia,Camille,142,71,71,50
Cassiopeia,Ekko,356,187,169,52.53
Cassiopeia,Malzahar,394,192,202,48.73
Cassiopeia,Shaco,275,135,140,49.09
Cassiopeia,Zed,411,221,190,53.77
Cassiopeia,Mel,820,450,370,54.88
Cassiopeia,Nami,363,182,181,50.14
Cassiopeia,Galio,322,134,188,41.61
Cassiopeia,Pantheon,576,293,283,50.87
Cassiopeia,Ashe,646,305,341,47.21
Cassiopeia,Lillia,205,104,101,50.73
Cassiopeia,Taliyah,85,43,42,50.59
Cassiopeia,Janna,137,63,74,45.99
Cassiopeia,Illaoi,129,64,65,49.61
Cassiopeia,TahmKench,279,142,137,50.9
Cassiopeia,Yorick,372,163,209,43.82
Cassiopeia,Kindred,168,89,79,52.98
Cassiopeia,Katarina,289,159,130,55.02
Cassiopeia,Nilah,108,57,51,52.78
Cassiopeia,Lux,703,323,380,45.95
Cassiopeia,Garen,525,235,290,44.76
Cassiopeia,Sejuani,192,113,79,58.85
Cassiopeia,Annie,116,54,62,46.55
Cassiopeia,DrMundo,225,108,117,48
Cassiopeia,Fiora,123,59,64,47.97
Cassiopeia,Briar,217,102,115,47
Cassiopeia,Ziggs,120,63,57,52.5
Cassiopeia,Thresh,509,261,248,51.28
Cassiopeia,Sion,252,129,123,51.19
Cassiopeia,Kaisa,610,316,294,51.8
Cassiopeia,Teemo,577,254,323,44.02
Cassiopeia,Amumu,377,162,215,42.97
Cassiopeia,Ryze,193,95,98,49.22
Cassiopeia,Milio,161,74,87,45.96
Cassiopeia,Gangplank,182,108,74,59.34
Cassiopeia,LeeSin,485,268,217,55.26
Cassiopeia,Aurora,314,157,157,50
Cassiopeia,Caitlyn,881,449,432,50.96
Cassiopeia,Elise,249,101,148,40.56
Cassiopeia,Gnar,131,81,50,61.83
Cassiopeia,Braum,241,124,117,51.45
Cassiopeia,Naafiri,109,54,55,49.54
Cassiopeia,Veigar,379,190,189,50.13
Cassiopeia,Kennen,99,40,59,40.4
Cassiopeia,MasterYi,366,179,187,48.91
Cassiopeia,Bard,136,79,57,58.09
Cassiopeia,Gragas,150,75,75,50
Cassiopeia,Ahri,503,253,250,50.3
Cassiopeia,Nautilus,349,187,162,53.58
Cassiopeia,Hecarim,163,80,83,49.08
Cassiopeia,Syndra,318,139,179,43.71
Cassiopeia,Viktor,395,211,184,53.42
Cassiopeia,Zyra,326,161,165,49.39
Cassiopeia,JarvanIV,268,120,148,44.78
Cassiopeia,Orianna,141,62,79,43.97
Cassiopeia,Renekton,181,113,68,62.43
Cassiopeia,Khazix,188,98,90,52.13
Cassiopeia,Qiyana,91,42,49,46.15
Cassiopeia,Blitzcrank,246,127,119,51.63
Cassiopeia,MonkeyKing,284,131,153,46.13
Cassiopeia,Hwei,232,116,116,50
Cassiopeia,Rakan,154,84,70,54.55
Cassiopeia,Belveth,111,59,52,53.15
Cassiopeia,Vladimir,277,145,132,52.35
Cassiopeia,Mordekaiser,414,210,204,50.72
Cassiopeia,Jax,272,167,105,61.4
Cassiopeia,Rumble,84,49,35,58.33
Cassiopeia,Samira,259,135,124,52.12
Cassiopeia,Nocturne,368,169,199,45.92
Cassiopeia,Senna,281,142,139,50.53
Cassiopeia,Rammus,111,71,40,63.96
Cassiopeia,Sivir,171,88,83,51.46
Cassiopeia,Ornn,137,62,75,45.26
Cassiopeia,Ezreal,886,460,426,51.92
Cassiopeia,Zeri,189,103,86,54.5
Cassiopeia,Ambessa,196,105,91,53.57
Cassiopeia,Rell,165,85,80,51.52
Cassiopeia,Jayce,182,80,102,43.96
Cassiopeia,Zac,157,91,66,57.96
Cassiopeia,Corki,126,74,52,58.73
Cassiopeia,Aatrox,352,169,183,48.01
Cassiopeia,Sylas,589,328,261,55.69
Cassiopeia,Smolder,209,111,98,53.11
Cassiopeia,Taric,66,35,31,53.03
Cassiopeia,Irelia,324,152,172,46.91
Cassiopeia,Soraka,189,85,104,44.97
Cassiopeia,Tryndamere,238,130,108,54.62
Cassiopeia,Draven,203,117,86,57.64
Cassiopeia,Karma,434,226,208,52.07
Cassiopeia,Urgot,145,79,66,54.48
Cassiopeia,Twitch,338,201,137,59.47
Cassiopeia,Olaf,115,49,66,42.61
Cassiopeia,Lulu,492,229,263,46.54
Cassiopeia,Morgana,433,234,199,54.04
Cassiopeia,Chogath,476,208,268,43.7
Cassiopeia,Gwen,147,64,83,43.54
Cassiopeia,Seraphine,224,111,113,49.55
Cassiopeia,FiddleSticks,178,92,86,51.69
Cassiopeia,Nasus,237,126,111,53.16
Cassiopeia,Vi,335,186,149,55.52
Cassiopeia,Kalista,113,69,44,61.06
Cassiopeia,Zilean,113,47,66,41.59
Cassiopeia,Heimerdinger,160,84,76,52.5
Cassiopeia,Kassadin,68,32,36,47.06
Cassiopeia,Shen,213,111,102,52.11
Cassiopeia,Tristana,365,197,168,53.97
Cassiopeia,Singed,98,56,42,57.14
Cassiopeia,Ivern,41,21,20,51.22
Cassiopeia,Xayah,148,76,72,51.35
Cassiopeia,Varus,318,181,137,56.92
Cassiopeia,Udyr,125,79,46,63.2
Cassiopeia,Maokai,171,81,90,47.37
Cassiopeia,Kled,64,36,28,56.25
Cassiopeia,Nunu,193,92,101,47.67
Cassiopeia,Anivia,151,61,90,40.4
Cassiopeia,KogMaw,94,45,49,47.87
Cassiopeia,Xerath,347,164,183,47.26
Cassiopeia,Neeko,158,86,72,54.43
Cassiopeia,Vex,177,74,103,41.81
Cassiopeia,Malphite,304,146,158,48.03
Cassiopeia,Akali,309,160,149,51.78
Cassiopeia,Karthus,70,49,21,70
Cassiopeia,Riven,148,65,83,43.92
Cassiopeia,Fizz,147,52,95,35.37
Cassiopeia,Velkoz,181,85,96,46.96
Cassiopeia,Poppy,215,110,105,51.16
Cassiopeia,TwistedFate,126,70,56,55.56
Cassiopeia,AurelionSol,123,72,51,58.54
Cassiopeia,Shyvana,91,44,47,48.35
Cassiopeia,Sona,115,36,79,31.3
Cassiopeia,RekSai,31,22,9,70.97
Cassiopeia,Nidalee,125,67,58,53.6
Cassiopeia,Azir,119,51,68,42.86
Cassiopeia,Akshan,120,72,48,60
Cassiopeia,Renata,58,29,29,50
Cassiopeia,KSante,225,132,93,58.67
Cassiopeia,Skarner,71,39,32,54.93
Cassiopeia,Leblanc,156,65,91,41.67
