Name,Games,Wins,Losses,Bans,EffectiveBans,WR
Nocturne,44269,23364,20905,90913,85555,52.78
Blitzcrank,24269,11735,12534,79347,74825,48.35
Mel,65753,31182,34571,318207,259145,47.42
Karma,43060,21887,21173,35191,33635,50.83
Warwick,48436,25222,23214,81703,76668,52.07
Vladimir,22539,11168,11371,18418,18062,49.55
Lulu,46625,23215,23410,81447,75644,49.79
Aphelios,17401,8643,8758,4088,4074,49.67
Darius,64016,32080,31936,115985,108003,50.11
Viktor,30678,15299,15379,33565,32816,49.87
Singed,9344,4814,4530,2386,2375,51.52
LeeSin,52997,25605,27392,56143,51798,48.31
Yasuo,66319,33183,33136,101496,94827,50.04
Caitlyn,91571,45795,45776,112834,104171,50.01
Yuumi,27201,13226,13975,28725,27473,48.62
Chogath,39361,20217,19144,20121,19727,51.36
Viego,48498,24267,24231,44980,43629,50.04
Galio,30073,15331,14742,20904,20559,50.98
Sivir,18284,9200,9084,3917,3912,50.32
Pyke,26486,12826,13660,76454,72457,48.43
Ambessa,20644,9694,10950,48504,46722,46.96
Fizz,19529,9694,9835,30602,29858,49.64
Amumu,34138,17726,16412,33199,32070,51.92
Brand,24956,12659,12297,19534,19171,50.73
Morgana,39124,19690,19434,97868,91172,50.33
Irelia,28102,14046,14056,52906,50669,49.98
Ahri,43563,21482,22081,19992,19707,49.31
Jax,31429,15356,16073,19947,19643,48.86
Syndra,20961,10581,10380,14889,14649,50.48
Smolder,20721,9821,10900,4822,4778,47.4
Zyra,32114,16434,15680,28199,27575,51.17
Gragas,18150,8790,9360,6094,6054,48.43
Kayn,46905,23687,23218,38249,37274,50.5
Jinx,96562,49618,46944,47058,45674,51.38
Thresh,45055,22790,22265,20753,20452,50.58
Neeko,14628,7147,7481,5664,5641,48.86
Teemo,41390,21239,20151,82557,77298,51.31
Malzahar,35732,18519,17213,55383,53168,51.83
Samira,22504,11039,11465,37035,35875,49.05
Garen,54554,27880,26674,42002,40847,51.11
Diana,55114,28113,27001,49916,48257,51.01
Sylas,48527,23542,24985,45018,43445,48.51
Kaisa,56913,27592,29321,7541,7497,48.48
Yorick,32608,17341,15267,56209,53728,53.18
Veigar,32754,16648,16106,14602,14351,50.83
Tristana,33329,16405,16924,9111,9028,49.22
Poppy,19722,9972,9750,13798,13565,50.56
Shaco,31692,15591,16101,138533,125352,49.2
Lux,81918,41270,40648,80431,74992,50.38
Braum,18948,9796,9152,9125,9042,51.7
Mordekaiser,42992,22257,20735,79211,74565,51.77
Alistar,14441,7182,7259,4520,4516,49.73
Riven,15396,7631,7765,6302,6264,49.56
Sejuani,13838,6743,7095,1997,1997,48.73
Lucian,24193,11706,12487,4215,4200,48.39
Soraka,18568,9610,8958,7438,7376,51.76
Malphite,35066,17454,17612,28963,28477,49.77
Elise,24159,12065,12094,36291,34048,49.94
Nautilus,37235,18172,19063,47111,45776,48.8
Sett,49346,25535,23811,22640,22278,51.75
Aatrox,31170,15431,15739,38471,37398,49.51
Velkoz,19782,10183,9599,6414,6379,51.48
Rammus,10370,5239,5131,21086,20724,50.52
Katarina,25597,12674,12923,23852,23384,49.51
Draven,17227,8551,8676,51895,49366,49.64
Senna,24397,12100,12297,5417,5395,49.6
Sion,24300,12370,11930,8305,8170,50.91
MasterYi,42106,21387,20719,87433,82383,50.79
Annie,11309,5695,5614,3815,3785,50.36
Ezreal,84605,41192,43413,35820,34779,48.69
Briar,23285,12279,11006,28856,28230,52.73
Kayle,22224,11507,10717,10730,10642,51.78
Pantheon,52226,26056,26170,19465,19232,49.89
Belveth,7652,3702,3950,7671,7570,48.38
KogMaw,10271,5302,4969,4735,4715,51.62
Leona,28600,14193,14407,33494,32773,49.63
Kassadin,6987,3506,3481,4580,4545,50.18
Qiyana,8157,3824,4333,1431,1418,46.88
Swain,32119,16524,15595,18510,18258,51.45
Vi,31999,15758,16241,8902,8841,49.25
MonkeyKing,23930,12204,11726,12269,12149,51
Gangplank,18037,8942,9095,8905,8803,49.58
Jayce,16838,8285,8553,11751,11514,49.2
Azir,11488,5559,5929,1852,1850,48.39
Skarner,8268,3725,4543,14229,14019,45.05
Aurora,23560,11500,12060,27618,27090,48.81
Corki,13747,6540,7207,5924,5846,47.57
Orianna,14488,7170,7318,2845,2830,49.49
Xayah,15395,7681,7714,2404,2402,49.89
Nami,33578,17311,16267,4728,4708,51.55
Hwei,21760,10950,10810,15724,15557,50.32
Vex,17352,8747,8605,20706,20441,50.41
Yone,61351,29150,32201,41710,40645,47.51
Shen,20344,9998,10346,2557,2551,49.14
Akali,36314,17992,18322,47093,45684,49.55
Varus,30148,14582,15566,5319,5306,48.37
Zed,38511,18622,19889,73223,69851,48.36
None,0,0,0,174631,142748,NaN
Renekton,17256,8478,8778,11930,11808,49.13
Janna,11260,5766,5494,2257,2246,51.21
Karthus,10140,4956,5184,8506,8234,48.88
Zac,16328,8263,8065,6548,6512,50.61
Zilean,10974,5671,5303,3132,3117,51.68
XinZhao,22751,11466,11285,5566,5532,50.4
Khazix,16784,8102,8682,10005,9912,48.27
Vayne,43735,22327,21408,28313,27785,51.05
Nasus,23771,12167,11604,21179,20881,51.18
Jhin,68932,34342,34590,20009,19658,49.82
Seraphine,24160,11985,12175,7353,7295,49.61
Leblanc,21552,10598,10954,59935,55958,49.17
Illaoi,15394,7614,7780,49811,47765,49.46
Milio,19158,10093,9065,7676,7602,52.68
Rakan,12855,6412,6443,1556,1553,49.88
Ekko,31928,15959,15969,7425,7392,49.98
Ashe,69941,34803,35138,29572,28842,49.76
Volibear,37432,18677,18755,21833,21513,49.9
Tryndamere,19090,9479,9611,12207,12107,49.65
Lillia,18314,9086,9228,15999,15849,49.61
FiddleSticks,16993,8535,8458,6416,6391,50.23
Nilah,9801,5172,4629,14819,14659,52.77
Rell,15738,7956,7782,7552,7509,50.55
Trundle,19331,9850,9481,8185,8124,50.95
Evelynn,11307,5575,5732,9585,9509,49.31
Gwen,16370,7866,8504,10670,10491,48.05
DrMundo,18226,9219,9007,13833,13661,50.58
Fiora,12093,6047,6046,13024,12897,50
Rengar,10518,4864,5654,6496,6426,46.24
Ziggs,12026,6016,6010,3292,3280,50.02
Xerath,31176,15765,15411,37563,36035,50.57
Sona,10440,5479,4961,844,844,52.48
Gnar,13513,6716,6797,4221,4203,49.7
Hecarim,13906,6710,7196,7833,7710,48.25
MissFortune,78258,39745,38513,64042,60605,50.79
Talon,19815,9630,10185,6910,6863,48.6
Ornn,13448,6764,6684,2651,2648,50.3
Zoe,12391,6137,6254,6009,5978,49.53
Udyr,12886,6290,6596,6842,6804,48.81
Nunu,17044,8535,8509,5223,5193,50.08
KSante,18521,8657,9864,16378,16171,46.74
Urgot,16745,8766,7979,9870,9782,52.35
Bard,9870,4896,4974,1602,1602,49.6
Kindred,14873,7423,7450,8474,8326,49.91
Lissandra,11417,5871,5546,5032,4999,51.42
Twitch,26608,13136,13472,31804,30947,49.37
Ivern,4572,2230,2342,1585,1580,48.78
Anivia,11051,5776,5275,7510,7444,52.27
Cassiopeia,9348,4710,4638,9447,9384,50.39
Kennen,8678,4337,4341,3763,3757,49.98
Rumble,9500,4561,4939,2922,2916,48.01
Akshan,11243,5561,5682,9456,9379,49.46
TwistedFate,11923,5691,6232,692,692,47.73
Heimerdinger,14985,7865,7120,18757,18424,52.49
TahmKench,24474,11825,12649,35337,34314,48.32
Graves,23068,11426,11642,17509,17179,49.53
Maokai,15169,7656,7513,3061,3052,50.47
JarvanIV,20581,10492,10089,4540,4499,50.98
Zeri,14109,6911,7198,1847,1841,48.98
Renata,5474,2665,2809,1181,1181,48.68
Kalista,8188,3926,4262,3165,3159,47.95
Shyvana,8303,4100,4203,2063,2061,49.38
Camille,12301,5946,6355,5674,5639,48.34
Quinn,12004,6208,5796,6047,6016,51.72
Ryze,11960,6171,5789,1706,1706,51.6
Taliyah,8253,4312,3941,1317,1315,52.25
AurelionSol,12877,6531,6346,5434,5400,50.72
Olaf,8151,4034,4117,4244,4232,49.49
Naafiri,10598,5329,5269,6157,6127,50.28
Nidalee,10114,4572,5542,4500,4449,45.2
Taric,7143,3644,3499,1607,1604,51.01
Kled,5834,2955,2879,2501,2493,50.65
RekSai,4098,1955,2143,1833,1830,47.71
