Name,Games,Wins,Losses,Bans,WR
Nautilus,16162,7840,8322,19149,48.51
MasterYi,15714,8029,7685,31882,51.09
Darius,27964,14020,13944,46965,50.14
Sylas,14296,7168,7128,11313,50.14
Shaco,14231,6900,7331,56586,48.49
Vayne,15321,7785,7536,14790,50.81
Fizz,7860,4032,3828,16606,51.3
Chogath,20025,10164,9861,9424,50.76
Mel,32877,16121,16756,129085,49.03
Ashe,26131,12905,13226,12809,49.39
Sett,25295,13193,12102,12408,52.16
Warwick,24235,12652,11583,58810,52.21
Shen,10051,5172,4879,1103,51.46
Tristana,13716,7013,6703,5580,51.13
Blitzcrank,11648,5569,6079,37741,47.81
Malphite,11886,6225,5661,9004,52.37
Ekko,11968,5919,6049,4119,49.46
Hwei,11371,5687,5684,6710,50.01
Lucian,8541,4111,4430,1892,48.13
Maokai,6662,3529,3133,1576,52.97
Leblanc,5682,2659,3023,10346,46.8
None,0,0,0,55378,NaN
LeeSin,14431,6656,7775,7788,46.12
Yorick,13761,7798,5963,22464,56.67
Volibear,16843,8678,8165,9658,51.52
Diana,20064,10072,9992,13828,50.2
Rammus,4644,2445,2199,9384,52.65
Yone,28908,14008,14900,21011,48.46
Yasuo,29274,14706,14568,39248,50.24
Jhin,26832,13598,13234,12810,50.68
Lux,40902,20613,20289,52953,50.4
Mordekaiser,23425,12288,11137,33182,52.46
Qiyana,5382,2424,2958,743,45.04
Irelia,13634,6625,7009,14250,48.59
Ezreal,25408,11869,13539,10442,46.71
Rell,8082,3960,4122,2915,49
Caitlyn,35848,18228,17620,62531,50.85
Morgana,20269,10518,9751,60381,51.89
Kalista,7131,3243,3888,2603,45.48
Shyvana,4185,2274,1911,1230,54.34
Sejuani,5458,2812,2646,903,51.52
Pantheon,25012,12474,12538,9771,49.87
Singed,4160,2285,1875,1701,54.93
Zed,14446,6664,7782,31678,46.13
Teemo,21074,11384,9690,49761,54.02
Lulu,11564,5650,5914,18141,48.86
Sion,12084,6309,5775,2297,52.21
Urgot,7153,3856,3297,5915,53.91
Amumu,14546,7987,6559,16968,54.91
Zac,5339,2667,2672,2809,49.95
Poppy,9128,4605,4523,4311,50.45
Twitch,12643,6410,6233,17452,50.7
Fiora,7280,3371,3909,9339,46.3
Katarina,13265,5959,7306,12103,44.92
Viktor,10056,5023,5033,10920,49.95
Braum,6974,3535,3439,2949,50.69
Brand,10599,5298,5301,11868,49.99
Karma,10098,5050,5048,4381,50.01
Jayce,6106,2758,3348,2065,45.17
Kaisa,20850,9757,11093,4347,46.8
Pyke,17486,7924,9562,43336,45.32
Renekton,6909,3510,3399,4296,50.8
Kayn,24071,12000,12071,19797,49.85
Draven,8548,4116,4432,33016,48.15
Yuumi,14342,7224,7118,11719,50.37
Zoe,7082,2988,4094,3927,42.19
Taric,3335,1839,1496,1204,55.14
Akali,15883,7593,8290,20207,47.81
Gragas,9206,4263,4943,3099,46.31
Zyra,9709,5280,4429,13141,54.38
Aurora,14543,7039,7504,13066,48.4
Khazix,9430,4368,5062,6579,46.32
Nocturne,12745,6592,6153,25703,51.72
Gangplank,6327,3052,3275,1855,48.24
Gwen,9695,4432,5263,5833,45.71
Vi,12824,6490,6334,3541,50.61
Soraka,9459,4881,4578,4808,51.6
Samira,14860,7250,7610,21129,48.79
Illaoi,7553,3993,3560,30424,52.87
Jax,12562,6386,6176,7590,50.84
XinZhao,8250,4332,3918,1804,52.51
Kennen,5577,2546,3031,2342,45.65
Vladimir,8230,4172,4058,6623,50.69
Viego,18311,9258,9053,18368,50.56
Velkoz,9564,5070,4494,3908,53.01
Tryndamere,8906,4356,4550,7733,48.91
Aatrox,14726,6914,7812,13867,46.95
Varus,12009,6035,5974,2638,50.25
Kindred,8361,3795,4566,3421,45.39
Milio,8270,4298,3972,3380,51.97
KogMaw,5155,2723,2432,3646,52.82
Ambessa,9021,4402,4619,19370,48.8
Graves,7881,3706,4175,3600,47.02
Ahri,20743,10104,10639,10774,48.71
Nilah,8744,4392,4352,11171,50.23
Belveth,4311,2154,2157,4370,49.97
Sona,5827,3034,2793,694,52.07
Renata,3783,1880,1903,605,49.7
Ivern,3302,1526,1776,1110,46.21
Veigar,17339,9073,8266,11027,52.33
Jinx,30579,15706,14873,19758,51.36
Seraphine,16696,8317,8379,6917,49.81
Rakan,8139,4175,3964,959,51.3
Vex,8925,4470,4455,8758,50.08
Corki,4903,2242,2661,3008,45.73
Lillia,10097,5041,5056,8119,49.93
Zeri,6658,3207,3451,977,48.17
Briar,15401,7944,7457,19617,51.58
Nunu,12937,6431,6506,4125,49.71
Swain,16339,8755,7584,11528,53.58
Nami,14133,7197,6936,2394,50.92
Orianna,6781,3297,3484,1904,48.62
Kayle,11451,5891,5560,5471,51.45
Leona,11295,5887,5408,14829,52.12
Talon,9314,4282,5032,2227,45.97
Alistar,4815,2348,2467,1788,48.76
DrMundo,9698,5280,4418,7215,54.44
Garen,22176,11584,10592,17799,52.24
Heimerdinger,8380,4456,3924,14051,53.17
MissFortune,32424,16606,15818,23693,51.22
Ryze,4383,2186,2197,579,49.87
TwistedFate,5357,2507,2850,335,46.8
Udyr,5738,2855,2883,3153,49.76
Quinn,5231,2589,2642,2877,49.49
MonkeyKing,7461,3857,3604,5202,51.7
Azir,5461,2627,2834,1465,48.1
Neeko,11507,5462,6045,3718,47.47
FiddleSticks,7734,3938,3796,0,50.92
Smolder,11936,5811,6125,3568,48.68
TahmKench,16731,8227,8504,22672,49.17
Aphelios,10757,5352,5405,3142,49.75
Malzahar,11566,6411,5155,25478,55.43
Evelynn,8311,3863,4448,5127,46.48
Trundle,8442,4544,3898,4487,53.83
Sivir,7216,3773,3443,1602,52.29
Rengar,6876,2760,4116,3306,40.14
Lissandra,3795,1920,1875,1661,50.59
Nasus,11846,6176,5670,8194,52.14
Naafiri,7038,3506,3532,4221,49.82
Senna,13487,6944,6543,3691,51.49
Galio,10459,5590,4869,7298,53.45
Gnar,6237,2881,3356,1559,46.19
Riven,6710,2835,3875,2823,42.25
Hecarim,5603,2696,2907,3364,48.12
AurelionSol,7090,3776,3314,2741,53.26
Ornn,6453,3413,3040,1264,52.89
Kassadin,3261,1701,1560,1981,52.16
Nidalee,3821,1598,2223,600,41.82
Fiddlesticks,0,0,0,2631,NaN
JarvanIV,5556,2976,2580,1839,53.56
Xayah,9934,4960,4974,1734,49.93
Ziggs,6717,3531,3186,2853,52.57
Taliyah,4207,2036,2171,692,48.4
Cassiopeia,6013,2935,3078,6168,48.81
Kled,3112,1572,1540,1650,50.51
Thresh,19610,9599,10011,7297,48.95
RekSai,2087,1028,1059,630,49.26
Karthus,3815,1782,2033,1147,46.71
Skarner,4826,2243,2583,6759,46.48
KSante,5584,2533,3051,5759,45.36
Syndra,8337,4308,4029,6769,51.67
Zilean,4246,2113,2133,1428,49.76
Bard,4953,2470,2483,1137,49.87
Xerath,10156,5229,4927,8642,51.49
Anivia,4691,2304,2387,3094,49.12
Elise,9127,4158,4969,5314,45.56
Janna,4750,2464,2286,1132,51.87
Akshan,5883,3047,2836,4540,51.79
Olaf,3338,1639,1699,1989,49.1
Annie,4484,2124,2360,1673,47.37
Camille,5112,2339,2773,2294,45.76
Rumble,2741,1306,1435,787,47.65
