Name,Opponent,Games,Wins,Losses,WR
Sett,Malphite,803,367,436,45.7
Sett,Ekko,832,448,384,53.85
Sett,Hwei,754,433,321,57.43
Sett,Lucian,631,350,281,55.47
Sett,Maokai,555,275,280,49.55
Sett,Yorick,832,372,460,44.71
Sett,Viego,1299,734,565,56.51
Sett,Diana,1351,684,667,50.63
Sett,Seraphine,1121,618,503,55.13
Sett,Rakan,554,273,281,49.28
Sett,Gwen,731,442,289,60.47
Sett,JarvanIV,389,204,185,52.44
Sett,Yone,2263,1184,1079,52.32
Sett,Zyra,610,308,302,50.49
Sett,Kayle,766,400,366,52.22
Sett,MonkeyKing,464,236,228,50.86
Sett,RekSai,93,67,26,72.04
Sett,Warwick,1746,853,893,48.85
Sett,Briar,1011,548,463,54.2
Sett,Yasuo,2019,980,1039,48.54
Sett,Irelia,913,501,412,54.87
Sett,Lux,2858,1457,1401,50.98
Sett,Pantheon,1705,883,822,51.79
Sett,Kayn,1596,899,697,56.33
Sett,Leblanc,305,144,161,47.21
Sett,Sivir,440,169,271,38.41
Sett,Pyke,1186,667,519,56.24
Sett,Braum,446,211,235,47.31
Sett,XinZhao,571,255,316,44.66
Sett,Chogath,1512,888,624,58.73
Sett,Taliyah,263,130,133,49.43
Sett,Darius,2150,1126,1024,52.37
Sett,Volibear,1147,530,617,46.21
Sett,Ezreal,1587,890,697,56.08
Sett,Brand,689,352,337,51.09
Sett,Singed,264,148,116,56.06
Sett,Ryze,271,137,134,50.55
Sett,Samira,1033,576,457,55.76
Sett,Soraka,542,284,258,52.4
Sett,KSante,399,238,161,59.65
Sett,Azir,411,216,195,52.55
Sett,Aphelios,607,351,256,57.83
Sett,Gnar,480,249,231,51.88
Sett,Nunu,834,474,360,56.83
Sett,Jhin,1775,931,844,52.45
Sett,Shaco,1073,558,515,52
Sett,Ahri,1543,807,736,52.3
Sett,Ashe,1814,937,877,51.65
Sett,Poppy,617,319,298,51.7
Sett,Nami,1015,528,487,52.02
Sett,Fiora,494,279,215,56.48
Sett,Malzahar,809,364,445,44.99
Sett,Zilean,308,175,133,56.82
Sett,Mel,2083,1096,987,52.62
Sett,Tristana,1004,526,478,52.39
Sett,Camille,358,172,186,48.04
Sett,MasterYi,1215,642,573,52.84
Sett,LeeSin,959,518,441,54.01
Sett,Riven,483,260,223,53.83
Sett,Jax,866,474,392,54.73
Sett,Naafiri,476,249,227,52.31
Sett,MissFortune,2310,1133,1177,49.05
Sett,Nocturne,918,449,469,48.91
Sett,Aatrox,1068,562,506,52.62
Sett,Swain,1048,440,608,41.98
Sett,Jinx,2117,1072,1045,50.64
Sett,Ambessa,643,356,287,55.37
Sett,Nilah,556,327,229,58.81
Sett,Kled,213,133,80,62.44
Sett,Leona,866,437,429,50.46
Sett,Nasus,773,330,443,42.69
Sett,Kindred,661,392,269,59.3
Sett,Nautilus,1093,597,496,54.62
Sett,Elise,618,353,265,57.12
Sett,Garen,1470,659,811,44.83
Sett,Senna,817,445,372,54.47
Sett,Illaoi,589,284,305,48.22
Sett,Sylas,1004,530,474,52.79
Sett,Cassiopeia,371,204,167,54.99
Sett,Caitlyn,2426,1333,1093,54.95
Sett,Teemo,1280,643,637,50.23
Sett,Mordekaiser,1871,857,1014,45.8
Sett,Sejuani,402,215,187,53.48
Sett,Alistar,362,167,195,46.13
Sett,Lulu,775,413,362,53.29
Sett,DrMundo,777,348,429,44.79
Sett,Viktor,724,338,386,46.69
Sett,Rammus,287,139,148,48.43
Sett,Fizz,461,233,228,50.54
Sett,TahmKench,1097,575,522,52.42
Sett,Jayce,368,215,153,58.42
Sett,Skarner,331,162,169,48.94
Sett,Veigar,1037,507,530,48.89
Sett,Karma,668,332,336,49.7
Sett,AurelionSol,461,207,254,44.9
Sett,Kalista,452,243,209,53.76
Sett,Talon,613,349,264,56.93
Sett,Evelynn,498,260,238,52.21
Sett,Graves,581,308,273,53.01
Sett,Twitch,815,463,352,56.81
Sett,Kaisa,1354,696,658,51.4
Sett,Taric,220,100,120,45.45
Sett,Aurora,909,539,370,59.3
Sett,Zeri,441,238,203,53.97
Sett,Vayne,1007,459,548,45.58
Sett,Draven,562,304,258,54.09
Sett,Vex,640,300,340,46.88
Sett,Gragas,606,349,257,57.59
Sett,Annie,357,227,130,63.59
Sett,Ornn,409,218,191,53.3
Sett,Zed,979,586,393,59.86
Sett,Ivern,240,113,127,47.08
Sett,Yuumi,1035,561,474,54.2
Sett,Rumble,203,105,98,51.72
Sett,Akshan,289,162,127,56.06
Sett,Sona,376,185,191,49.2
Sett,Morgana,1324,631,693,47.66
Sett,Ziggs,460,244,216,53.04
Sett,Akali,1052,585,467,55.61
Sett,Shen,692,359,333,51.88
Sett,Khazix,594,317,277,53.37
Sett,Varus,883,448,435,50.74
Sett,Thresh,1224,681,543,55.64
Sett,Blitzcrank,777,412,365,53.02
Sett,Urgot,543,269,274,49.54
Sett,Anivia,405,200,205,49.38
Sett,Gangplank,388,249,139,64.18
Sett,Bard,354,173,181,48.87
Sett,Kennen,420,244,176,58.1
Sett,TwistedFate,353,205,148,58.07
Sett,Qiyana,377,252,125,66.84
Sett,Zoe,403,251,152,62.28
Sett,Milio,490,247,243,50.41
Sett,Rell,642,327,315,50.93
Sett,Vladimir,533,295,238,55.35
Sett,FiddleSticks,586,288,298,49.15
Sett,Hecarim,309,175,134,56.63
Sett,Shyvana,274,147,127,53.65
Sett,Smolder,809,475,334,58.71
Sett,Neeko,742,443,299,59.7
Sett,Heimerdinger,613,295,318,48.12
Sett,Zac,301,159,142,52.82
Sett,Katarina,1031,584,447,56.64
Sett,Syndra,519,258,261,49.71
Sett,Udyr,367,185,182,50.41
Sett,Xayah,719,402,317,55.91
Sett,Vi,941,458,483,48.67
Sett,Tryndamere,547,293,254,53.56
Sett,Orianna,393,201,192,51.15
Sett,Kassadin,208,75,133,36.06
Sett,Karthus,280,146,134,52.14
Sett,Galio,738,336,402,45.53
Sett,Sion,803,413,390,51.43
Sett,Rengar,446,280,166,62.78
Sett,Corki,283,177,106,62.54
Sett,Renekton,547,328,219,59.96
Sett,Xerath,787,406,381,51.59
Sett,Trundle,577,258,319,44.71
Sett,Lillia,629,300,329,47.69
Sett,Quinn,376,219,157,58.24
Sett,Amumu,1041,440,601,42.27
Sett,Lissandra,226,108,118,47.79
Sett,Olaf,231,132,99,57.14
Sett,Nidalee,209,108,101,51.67
Sett,Renata,174,119,55,68.39
Sett,Janna,248,143,105,57.66
Sett,Velkoz,622,323,299,51.93
Sett,KogMaw,333,158,175,47.45
Sett,Belveth,324,201,123,62.04
Warwick,Malphite,757,368,389,48.61
Warwick,Ekko,814,404,410,49.63
Warwick,Hwei,640,294,346,45.94
Warwick,Lucian,520,281,239,54.04
Warwick,Maokai,390,205,185,52.56
Warwick,Aatrox,924,517,407,55.95
Warwick,Sylas,962,515,447,53.53
Warwick,Diana,1360,821,539,60.37
Warwick,Varus,788,450,338,57.11
Warwick,Blitzcrank,684,451,233,65.94
Warwick,Vladimir,447,243,204,54.36
Warwick,Darius,1988,1033,955,51.96
Warwick,Lux,2591,1283,1308,49.52
Warwick,KogMaw,349,169,180,48.42
Warwick,Yuumi,864,434,430,50.23
Warwick,Mordekaiser,1754,881,873,50.23
Warwick,Viego,1240,638,602,51.45
Warwick,Irelia,882,483,399,54.76
Warwick,Jhin,1913,968,945,50.6
Warwick,MonkeyKing,538,288,250,53.53
Warwick,Kayn,1669,950,719,56.92
Warwick,Yasuo,1933,956,977,49.46
Warwick,Kaisa,1308,707,601,54.05
Warwick,Milio,551,260,291,47.19
Warwick,Illaoi,531,318,213,59.89
Warwick,Yone,1904,1059,845,55.62
Warwick,Tristana,956,488,468,51.05
Warwick,Morgana,1496,735,761,49.13
Warwick,Yorick,1049,464,585,44.23
Warwick,LeeSin,1035,563,472,54.4
Warwick,MissFortune,2343,1221,1122,52.11
Warwick,Mel,2135,1144,991,53.58
Warwick,Shaco,927,479,448,51.67
Warwick,AurelionSol,405,149,256,36.79
Warwick,Ashe,1647,845,802,51.31
Warwick,Velkoz,533,273,260,51.22
Warwick,Teemo,1329,622,707,46.8
Warwick,Hecarim,379,198,181,52.24
Warwick,Veigar,1168,607,561,51.97
Warwick,Thresh,1262,736,526,58.32
Warwick,Sett,1746,893,853,51.15
Warwick,Amumu,1125,534,591,47.47
Warwick,Caitlyn,2325,1127,1198,48.47
Warwick,Poppy,550,280,270,50.91
Warwick,Zed,949,514,435,54.16
Warwick,MasterYi,1221,627,594,51.35
Warwick,Rell,559,249,310,44.54
Warwick,Jax,781,409,372,52.37
Warwick,Briar,1090,498,592,45.69
Warwick,Ahri,1410,782,628,55.46
Warwick,Zeri,439,251,188,57.18
Warwick,Leblanc,359,226,133,62.95
Warwick,Ezreal,1468,817,651,55.65
Warwick,Kindred,534,306,228,57.3
Warwick,Aphelios,768,442,326,57.55
Warwick,Pyke,1125,604,521,53.69
Warwick,Vi,893,474,419,53.08
Warwick,Azir,369,209,160,56.64
Warwick,Nautilus,1095,581,514,53.06
Warwick,Gangplank,316,204,112,64.56
Warwick,Annie,262,128,134,48.85
Warwick,Gwen,716,395,321,55.17
Warwick,Aurora,843,396,447,46.98
Warwick,Karma,611,333,278,54.5
Warwick,Garen,1372,737,635,53.72
Warwick,Gnar,412,234,178,56.8
Warwick,Nunu,816,429,387,52.57
Warwick,Elise,509,291,218,57.17
Warwick,Twitch,818,404,414,49.39
Warwick,Heimerdinger,550,254,296,46.18
Warwick,Trundle,613,288,325,46.98
Warwick,Gragas,670,365,305,54.48
Warwick,Vex,551,263,288,47.73
Warwick,FiddleSticks,482,235,247,48.76
Warwick,Soraka,547,240,307,43.88
Warwick,KSante,293,152,141,51.88
Warwick,Lulu,761,403,358,52.96
Warwick,Corki,244,143,101,58.61
Warwick,Pantheon,1557,834,723,53.56
Warwick,Karthus,258,150,108,58.14
Warwick,Nilah,573,277,296,48.34
Warwick,Braum,349,172,177,49.28
Warwick,Akali,1028,595,433,57.88
Warwick,Nasus,971,476,495,49.02
Warwick,Renata,197,90,107,45.69
Warwick,Lillia,603,288,315,47.76
Warwick,Chogath,1344,706,638,52.53
Warwick,Alistar,282,133,149,47.16
Warwick,Samira,1003,553,450,55.13
Warwick,Olaf,237,121,116,51.05
Warwick,Katarina,772,493,279,63.86
Warwick,Smolder,740,436,304,58.92
Warwick,Udyr,321,170,151,52.96
Warwick,Galio,708,339,369,47.88
Warwick,Fizz,604,319,285,52.81
Warwick,Taric,202,75,127,37.13
Warwick,Evelynn,576,336,240,58.33
Warwick,Kayle,757,395,362,52.18
Warwick,Volibear,1234,583,651,47.24
Warwick,Rengar,353,172,181,48.73
Warwick,Vayne,960,477,483,49.69
Warwick,Senna,861,421,440,48.9
Warwick,Zilean,201,103,98,51.24
Warwick,Fiora,423,244,179,57.68
Warwick,Sivir,422,262,160,62.09
Warwick,Xerath,686,316,370,46.06
Warwick,Leona,796,423,373,53.14
Warwick,Singed,208,100,108,48.08
Warwick,Belveth,272,140,132,51.47
Warwick,Neeko,758,390,368,51.45
Warwick,Tryndamere,639,357,282,55.87
Warwick,Nocturne,891,480,411,53.87
Warwick,Seraphine,1184,601,583,50.76
Warwick,Ivern,185,104,81,56.22
Warwick,Draven,532,288,244,54.14
Warwick,Ryze,352,157,195,44.6
Warwick,Nami,845,413,432,48.88
Warwick,Ornn,463,232,231,50.11
Warwick,Zoe,393,261,132,66.41
Warwick,Jinx,2077,995,1082,47.91
Warwick,Graves,505,274,231,54.26
Warwick,Syndra,493,227,266,46.04
Warwick,Urgot,532,238,294,44.74
Warwick,Qiyana,298,193,105,64.77
Warwick,Quinn,329,170,159,51.67
Warwick,Kalista,427,248,179,58.08
Warwick,Akshan,354,210,144,59.32
Warwick,Skarner,313,181,132,57.83
Warwick,Swain,1138,641,497,56.33
Warwick,Khazix,645,373,272,57.83
Warwick,Ziggs,414,184,230,44.44
Warwick,TahmKench,1031,521,510,50.53
Warwick,Kassadin,199,97,102,48.74
Warwick,Riven,349,201,148,57.59
Warwick,Zac,352,170,182,48.3
Warwick,Anivia,319,146,173,45.77
Warwick,Rumble,201,122,79,60.7
Warwick,Sejuani,330,150,180,45.45
Warwick,Sona,398,199,199,50
Warwick,Bard,272,168,104,61.76
Warwick,Sion,795,436,359,54.84
Warwick,Ambessa,541,261,280,48.24
Warwick,Camille,333,183,150,54.95
Warwick,Xayah,557,253,304,45.42
Warwick,DrMundo,575,290,285,50.43
Warwick,Kled,210,84,126,40
Warwick,Malzahar,714,352,362,49.3
Warwick,Brand,704,403,301,57.24
Warwick,JarvanIV,338,125,213,36.98
Warwick,Shyvana,254,125,129,49.21
Warwick,XinZhao,538,256,282,47.58
Warwick,Janna,283,144,139,50.88
Warwick,Jayce,379,200,179,52.77
Warwick,Talon,569,323,246,56.77
Warwick,Rakan,495,262,233,52.93
Warwick,Shen,559,318,241,56.89
Warwick,Viktor,562,292,270,51.96
Warwick,Rammus,375,186,189,49.6
Warwick,Kennen,351,148,203,42.17
Warwick,Cassiopeia,423,233,190,55.08
Warwick,Naafiri,487,258,229,52.98
Warwick,Renekton,436,199,237,45.64
Warwick,RekSai,100,48,52,48
Warwick,Taliyah,215,106,109,49.3
Warwick,Zyra,747,360,387,48.19
Warwick,Orianna,482,264,218,54.77
Warwick,Nidalee,232,146,86,62.93
Warwick,Lissandra,239,157,82,65.69
Warwick,TwistedFate,289,166,123,57.44
Shen,Malphite,284,139,145,48.94
Shen,Ekko,293,161,132,54.95
Shen,Hwei,274,155,119,56.57
Shen,Lucian,262,102,160,38.93
Shen,Maokai,185,86,99,46.49
Shen,Annie,72,43,29,59.72
Shen,Kayn,709,365,344,51.48
Shen,Aatrox,361,213,148,59
Shen,MissFortune,832,409,423,49.16
Shen,Pyke,473,275,198,58.14
Shen,Riven,176,103,73,58.52
Shen,Ivern,93,43,50,46.24
Shen,Yasuo,850,401,449,47.18
Shen,Swain,487,258,229,52.98
Shen,Nami,365,131,234,35.89
Shen,Gangplank,240,131,109,54.58
Shen,Taliyah,116,62,54,53.45
Shen,Sivir,194,98,96,50.52
Shen,Soraka,294,147,147,50
Shen,Mordekaiser,550,270,280,49.09
Shen,Diana,575,303,272,52.7
Shen,Ezreal,701,404,297,57.63
Shen,Thresh,623,293,330,47.03
Shen,Samira,364,202,162,55.49
Shen,MasterYi,409,192,217,46.94
Shen,Orianna,253,102,151,40.32
Shen,Nautilus,426,218,208,51.17
Shen,Lillia,286,141,145,49.3
Shen,Ashe,704,373,331,52.98
Shen,Velkoz,291,141,150,48.45
Shen,Jax,362,177,185,48.9
Shen,Katarina,343,209,134,60.93
Shen,Jhin,722,380,342,52.63
Shen,Ambessa,281,199,82,70.82
Shen,Rammus,109,57,52,52.29
Shen,Aurora,413,247,166,59.81
Shen,Caitlyn,927,547,380,59.01
Shen,Talon,227,131,96,57.71
Shen,LeeSin,358,192,166,53.63
Shen,Garen,760,350,410,46.05
Shen,Senna,420,232,188,55.24
Shen,Kayle,286,154,132,53.85
Shen,Morgana,600,275,325,45.83
Shen,Yorick,295,115,180,38.98
Shen,Volibear,442,231,211,52.26
Shen,Blitzcrank,343,195,148,56.85
Shen,Malzahar,361,190,171,52.63
Shen,Viego,487,260,227,53.39
Shen,Galio,281,148,133,52.67
Shen,Vayne,432,211,221,48.84
Shen,Sylas,350,211,139,60.29
Shen,Renekton,141,67,74,47.52
Shen,Leona,258,133,125,51.55
Shen,Sett,692,333,359,48.12
Shen,Rengar,200,126,74,63
Shen,Kalista,191,109,82,57.07
Shen,DrMundo,177,59,118,33.33
Shen,Darius,776,378,398,48.71
Shen,Viktor,253,95,158,37.55
Shen,Lulu,299,147,152,49.16
Shen,Chogath,498,243,255,48.8
Shen,Ryze,157,94,63,59.87
Shen,Janna,109,77,32,70.64
Shen,Zoe,155,98,57,63.23
Shen,Gragas,321,173,148,53.89
Shen,Pantheon,641,385,256,60.06
Shen,Kaisa,713,411,302,57.64
Shen,XinZhao,206,95,111,46.12
Shen,Hecarim,158,78,80,49.37
Shen,Braum,192,108,84,56.25
Shen,Urgot,156,67,89,42.95
Shen,Tristana,344,155,189,45.06
Shen,Zyra,221,123,98,55.66
Shen,Illaoi,217,105,112,48.39
Shen,Lux,1179,598,581,50.72
Shen,Camille,185,111,74,60
Shen,Khazix,280,150,130,53.57
Shen,Heimerdinger,241,115,126,47.72
Shen,Mel,821,398,423,48.48
Shen,MonkeyKing,213,106,107,49.77
Shen,Vladimir,168,83,85,49.4
Shen,Shaco,439,230,209,52.39
Shen,Jinx,862,411,451,47.68
Shen,Nunu,285,142,143,49.82
Shen,Twitch,365,198,167,54.25
Shen,Karma,370,161,209,43.51
Shen,Skarner,149,55,94,36.91
Shen,Yuumi,420,199,221,47.38
Shen,Singed,186,70,116,37.63
Shen,Bard,172,107,65,62.21
Shen,Evelynn,202,93,109,46.04
Shen,Zeri,200,124,76,62
Shen,Ziggs,236,105,131,44.49
Shen,Brand,342,164,178,47.95
Shen,Seraphine,405,208,197,51.36
Shen,Sejuani,156,72,84,46.15
Shen,Poppy,314,167,147,53.18
Shen,Irelia,402,233,169,57.96
Shen,Leblanc,204,102,102,50
Shen,Vi,356,179,177,50.28
Shen,FiddleSticks,186,84,102,45.16
Shen,Nasus,308,164,144,53.25
Shen,Ahri,536,262,274,48.88
Shen,Trundle,232,104,128,44.83
Shen,Briar,432,225,207,52.08
Shen,KSante,181,99,82,54.7
Shen,Vex,225,141,84,62.67
Shen,Fiora,212,101,111,47.64
Shen,Elise,250,144,106,57.6
Shen,Draven,233,131,102,56.22
Shen,Kled,130,55,75,42.31
Shen,Syndra,211,112,99,53.08
Shen,Teemo,467,261,206,55.89
Shen,Amumu,373,172,201,46.11
Shen,Gnar,184,106,78,57.61
Shen,Smolder,329,167,162,50.76
Shen,Warwick,559,241,318,43.11
Shen,Ornn,187,96,91,51.34
Shen,Tryndamere,213,121,92,56.81
Shen,Yone,803,488,315,60.77
Shen,Varus,353,172,181,48.73
Shen,Neeko,241,144,97,59.75
Shen,Nidalee,109,66,43,60.55
Shen,Azir,184,77,107,41.85
Shen,Alistar,138,61,77,44.2
Shen,Akshan,169,76,93,44.97
Shen,Rell,232,99,133,42.67
Shen,Xayah,268,126,142,47.01
Shen,Sona,155,75,80,48.39
Shen,Udyr,222,131,91,59.01
Shen,Aphelios,265,128,137,48.3
Shen,Veigar,533,209,324,39.21
Shen,Zed,454,226,228,49.78
Shen,Lissandra,132,62,70,46.97
Shen,AurelionSol,200,79,121,39.5
Shen,Sion,410,228,182,55.61
Shen,Qiyana,155,102,53,65.81
Shen,Karthus,95,42,53,44.21
Shen,Nocturne,273,143,130,52.38
Shen,Naafiri,230,133,97,57.83
Shen,Xerath,303,143,160,47.19
Shen,Rumble,126,67,59,53.17
Shen,Corki,143,95,48,66.43
Shen,Nilah,202,73,129,36.14
Shen,Rakan,228,118,110,51.75
Shen,Renata,126,73,53,57.94
Shen,TahmKench,419,226,193,53.94
Shen,Belveth,120,70,50,58.33
Shen,Graves,227,133,94,58.59
Shen,Gwen,318,179,139,56.29
Shen,KogMaw,171,74,97,43.27
Shen,Anivia,117,71,46,60.68
Shen,Quinn,88,33,55,37.5
Shen,JarvanIV,189,112,77,59.26
Shen,Shyvana,121,74,47,61.16
Shen,Akali,352,201,151,57.1
Shen,Milio,200,110,90,55
Shen,Cassiopeia,83,45,38,54.22
Shen,Zac,137,38,99,27.74
Shen,Kassadin,72,45,27,62.5
Shen,Zilean,146,103,43,70.55
Shen,Fizz,195,120,75,61.54
Shen,Kindred,221,127,94,57.47
Shen,Jayce,131,94,37,71.76
Shen,TwistedFate,101,51,50,50.5
Shen,Taric,97,30,67,30.93
Shen,Kennen,131,68,63,51.91
Shen,Olaf,126,54,72,42.86
Shen,RekSai,63,33,30,52.38
Tristana,Malphite,444,195,249,43.92
Tristana,Ekko,446,217,229,48.65
Tristana,Hwei,375,190,185,50.67
Tristana,Lucian,272,158,114,58.09
Tristana,Maokai,155,72,83,46.45
Tristana,Renekton,250,125,125,50
Tristana,Kayn,819,426,393,52.01
Tristana,Katarina,485,303,182,62.47
Tristana,Draven,333,168,165,50.45
Tristana,Yuumi,542,262,280,48.34
Tristana,Vladimir,281,112,169,39.86
Tristana,Darius,951,446,505,46.9
Tristana,Lux,1534,804,730,52.41
Tristana,KogMaw,147,68,79,46.26
Tristana,Ambessa,325,133,192,40.92
Tristana,Rammus,231,118,113,51.08
Tristana,Mel,1126,564,562,50.09
Tristana,Blitzcrank,475,260,215,54.74
Tristana,Mordekaiser,853,433,420,50.76
Tristana,Qiyana,194,106,88,54.64
Tristana,Warwick,956,468,488,48.95
Tristana,Nautilus,576,259,317,44.97
Tristana,Yasuo,1207,587,620,48.63
Tristana,Sylas,545,279,266,51.19
Tristana,Zed,550,284,266,51.64
Tristana,Sivir,213,116,97,54.46
Tristana,Gwen,395,205,190,51.9
Tristana,Skarner,184,108,76,58.7
Tristana,Yone,1138,537,601,47.19
Tristana,Kaisa,786,421,365,53.56
Tristana,Seraphine,575,319,256,55.48
Tristana,Garen,758,398,360,52.51
Tristana,Rakan,273,155,118,56.78
Tristana,Volibear,662,336,326,50.76
Tristana,AurelionSol,285,156,129,54.74
Tristana,Caitlyn,1386,704,682,50.79
Tristana,TahmKench,643,333,310,51.79
Tristana,Heimerdinger,320,144,176,45
Tristana,LeeSin,576,295,281,51.22
Tristana,Veigar,663,327,336,49.32
Tristana,Irelia,534,266,268,49.81
Tristana,Gragas,320,174,146,54.38
Tristana,XinZhao,319,189,130,59.25
Tristana,Velkoz,344,182,162,52.91
Tristana,Sett,1004,478,526,47.61
Tristana,Elise,329,179,150,54.41
Tristana,Galio,352,152,200,43.18
Tristana,Twitch,444,212,232,47.75
Tristana,Soraka,340,120,220,35.29
Tristana,Trundle,230,103,127,44.78
Tristana,Amumu,504,239,265,47.42
Tristana,Fizz,276,154,122,55.8
Tristana,Pantheon,974,508,466,52.16
Tristana,Nunu,390,162,228,41.54
Tristana,Vex,395,176,219,44.56
Tristana,Jinx,1143,613,530,53.63
Tristana,Riven,266,164,102,61.65
Tristana,JarvanIV,222,111,111,50
Tristana,Taliyah,153,64,89,41.83
Tristana,Thresh,715,387,328,54.13
Tristana,Jax,493,245,248,49.7
Tristana,Diana,791,429,362,54.24
Tristana,Ahri,769,426,343,55.4
Tristana,Aphelios,359,172,187,47.91
Tristana,Senna,504,235,269,46.63
Tristana,Aurora,542,298,244,54.98
Tristana,FiddleSticks,324,180,144,55.56
Tristana,Jhin,1092,597,495,54.67
Tristana,Akali,585,285,300,48.72
Tristana,Samira,573,280,293,48.87
Tristana,Neeko,365,173,192,47.4
Tristana,Kindred,300,131,169,43.67
Tristana,Corki,192,118,74,61.46
Tristana,Sion,459,192,267,41.83
Tristana,Ezreal,1053,534,519,50.71
Tristana,Zilean,130,81,49,62.31
Tristana,Nocturne,506,248,258,49.01
Tristana,Aatrox,544,321,223,59.01
Tristana,Swain,644,305,339,47.36
Tristana,Ryze,157,85,72,54.14
Tristana,Nami,430,231,199,53.72
Tristana,Nilah,310,180,130,58.06
Tristana,Quinn,199,82,117,41.21
Tristana,Talon,346,210,136,60.69
Tristana,Syndra,244,102,142,41.8
Tristana,Olaf,126,63,63,50
Tristana,Smolder,453,232,221,51.21
Tristana,Braum,292,151,141,51.71
Tristana,Karma,365,200,165,54.79
Tristana,Vayne,545,281,264,51.56
Tristana,Brand,429,201,228,46.85
Tristana,TwistedFate,177,73,104,41.24
Tristana,Teemo,775,346,429,44.65
Tristana,Khazix,359,167,192,46.52
Tristana,Varus,425,242,183,56.94
Tristana,Sejuani,140,67,73,47.86
Tristana,Ashe,1050,591,459,56.29
Tristana,Malzahar,388,166,222,42.78
Tristana,Yorick,491,177,314,36.05
Tristana,Lulu,362,163,199,45.03
Tristana,Naafiri,208,135,73,64.9
Tristana,Morgana,761,357,404,46.91
Tristana,KSante,201,110,91,54.73
Tristana,Nidalee,109,69,40,63.3
Tristana,MasterYi,641,339,302,52.89
Tristana,Pyke,733,417,316,56.89
Tristana,Akshan,174,87,87,50
Tristana,Zyra,323,149,174,46.13
Tristana,Graves,285,133,152,46.67
Tristana,Vi,469,248,221,52.88
Tristana,Fiora,275,188,87,68.36
Tristana,Xerath,338,243,95,71.89
Tristana,DrMundo,377,158,219,41.91
Tristana,Poppy,276,112,164,40.58
Tristana,Nasus,356,170,186,47.75
Tristana,Briar,482,259,223,53.73
Tristana,Shyvana,185,106,79,57.3
Tristana,Viktor,378,175,203,46.3
Tristana,Janna,195,73,122,37.44
Tristana,Kalista,302,172,130,56.95
Tristana,Rell,320,142,178,44.38
Tristana,Evelynn,377,213,164,56.5
Tristana,Kassadin,111,58,53,52.25
Tristana,Ziggs,164,67,97,40.85
Tristana,Gnar,217,125,92,57.6
Tristana,Shen,344,189,155,54.94
Tristana,Rumble,95,54,41,56.84
Tristana,Shaco,577,297,280,51.47
Tristana,MissFortune,1511,717,794,47.45
Tristana,Zeri,259,152,107,58.69
Tristana,Kayle,396,235,161,59.34
Tristana,Viego,648,333,315,51.39
Tristana,Zac,167,79,88,47.31
Tristana,Ornn,289,124,165,42.91
Tristana,Udyr,214,129,85,60.28
Tristana,Leblanc,191,81,110,42.41
Tristana,Tryndamere,370,178,192,48.11
Tristana,Milio,250,105,145,42
Tristana,Lillia,369,157,212,42.55
Tristana,Anivia,213,114,99,53.52
Tristana,Illaoi,267,141,126,52.81
Tristana,Jayce,192,82,110,42.71
Tristana,Leona,444,186,258,41.89
Tristana,Azir,251,131,120,52.19
Tristana,Belveth,126,64,62,50.79
Tristana,Chogath,742,399,343,53.77
Tristana,Rengar,198,108,90,54.55
Tristana,Sona,168,65,103,38.69
Tristana,Karthus,183,104,79,56.83
Tristana,Alistar,196,81,115,41.33
Tristana,MonkeyKing,255,153,102,60
Tristana,Xayah,274,154,120,56.2
Tristana,Kennen,236,126,110,53.39
Tristana,Taric,117,81,36,69.23
Tristana,Lissandra,153,86,67,56.21
Tristana,Camille,182,85,97,46.7
Tristana,Urgot,216,106,110,49.07
Tristana,Zoe,219,161,58,73.52
Tristana,Gangplank,291,185,106,63.57
Tristana,Hecarim,190,114,76,60
Tristana,Singed,143,47,96,32.87
Tristana,Bard,190,88,102,46.32
Tristana,Kled,165,94,71,56.97
Tristana,Orianna,231,96,135,41.56
Tristana,Annie,170,95,75,55.88
Tristana,Cassiopeia,277,147,130,53.07
Tristana,RekSai,76,53,23,69.74
Tristana,Ivern,105,63,42,60
Tristana,Renata,147,72,75,48.98
Blitzcrank,Malphite,406,210,196,51.72
Blitzcrank,Ekko,317,169,148,53.31
Blitzcrank,Hwei,354,143,211,40.4
Blitzcrank,Lucian,312,136,176,43.59
Blitzcrank,Maokai,249,65,184,26.1
Blitzcrank,Kennen,187,84,103,44.92
Blitzcrank,Warwick,684,233,451,34.06
Blitzcrank,Yasuo,909,446,463,49.06
Blitzcrank,Kindred,240,108,132,45
Blitzcrank,Lux,1613,771,842,47.8
Blitzcrank,Talon,278,149,129,53.6
Blitzcrank,Aurora,435,182,253,41.84
Blitzcrank,Tristana,475,215,260,45.26
Blitzcrank,Alistar,142,65,77,45.77
Blitzcrank,Teemo,666,281,385,42.19
Blitzcrank,TahmKench,544,248,296,45.59
Blitzcrank,Jinx,1029,450,579,43.73
Blitzcrank,Zoe,245,131,114,53.47
Blitzcrank,Nami,427,243,184,56.91
Blitzcrank,Evelynn,280,145,135,51.79
Blitzcrank,Irelia,462,256,206,55.41
Blitzcrank,Thresh,739,357,382,48.31
Blitzcrank,Pantheon,973,460,513,47.28
Blitzcrank,Kayn,792,365,427,46.09
Blitzcrank,Leblanc,178,66,112,37.08
Blitzcrank,Sivir,307,159,148,51.79
Blitzcrank,Pyke,583,315,268,54.03
Blitzcrank,Volibear,448,208,240,46.43
Blitzcrank,Akshan,179,71,108,39.66
Blitzcrank,Katarina,447,264,183,59.06
Blitzcrank,Khazix,295,153,142,51.86
Blitzcrank,Akali,540,255,285,47.22
Blitzcrank,Draven,224,84,140,37.5
Blitzcrank,Mel,968,406,562,41.94
Blitzcrank,Viego,583,343,240,58.83
Blitzcrank,Yone,886,413,473,46.61
Blitzcrank,Nocturne,465,187,278,40.22
Blitzcrank,Aatrox,490,251,239,51.22
Blitzcrank,Swain,619,241,378,38.93
Blitzcrank,Cassiopeia,236,157,79,66.53
Blitzcrank,Shaco,404,224,180,55.45
Blitzcrank,Riven,202,119,83,58.91
Blitzcrank,Caitlyn,1095,517,578,47.21
Blitzcrank,Senna,461,198,263,42.95
Blitzcrank,MasterYi,488,245,243,50.2
Blitzcrank,Azir,192,114,78,59.38
Blitzcrank,Rengar,222,122,100,54.95
Blitzcrank,Gragas,267,115,152,43.07
Blitzcrank,Zed,397,186,211,46.85
Blitzcrank,MissFortune,956,448,508,46.86
Blitzcrank,Poppy,206,81,125,39.32
Blitzcrank,Leona,500,230,270,46
Blitzcrank,Janna,168,97,71,57.74
Blitzcrank,Shen,343,148,195,43.15
Blitzcrank,MonkeyKing,220,107,113,48.64
Blitzcrank,Naafiri,238,109,129,45.8
Blitzcrank,Mordekaiser,772,383,389,49.61
Blitzcrank,Samira,463,209,254,45.14
Blitzcrank,Neeko,333,104,229,31.23
Blitzcrank,Olaf,125,76,49,60.8
Blitzcrank,Diana,586,289,297,49.32
Blitzcrank,Ashe,816,374,442,45.83
Blitzcrank,LeeSin,556,267,289,48.02
Blitzcrank,Varus,394,211,183,53.55
Blitzcrank,Tryndamere,247,143,104,57.89
Blitzcrank,Elise,247,110,137,44.53
Blitzcrank,Nautilus,532,224,308,42.11
Blitzcrank,Rakan,251,91,160,36.25
Blitzcrank,Rumble,44,15,29,34.09
Blitzcrank,Qiyana,141,73,68,51.77
Blitzcrank,Kled,94,67,27,71.28
Blitzcrank,Taliyah,161,85,76,52.8
Blitzcrank,Ezreal,783,397,386,50.7
Blitzcrank,Yorick,356,114,242,32.02
Blitzcrank,Illaoi,298,112,186,37.58
Blitzcrank,Fizz,278,150,128,53.96
Blitzcrank,Kaisa,657,368,289,56.01
Blitzcrank,Sion,406,179,227,44.09
Blitzcrank,Jayce,154,75,79,48.7
Blitzcrank,KogMaw,134,61,73,45.52
Blitzcrank,XinZhao,300,166,134,55.33
Blitzcrank,Hecarim,159,80,79,50.31
Blitzcrank,Jhin,699,340,359,48.64
Blitzcrank,Velkoz,269,104,165,38.66
Blitzcrank,Sett,777,365,412,46.98
Blitzcrank,Zilean,143,49,94,34.27
Blitzcrank,AurelionSol,217,95,122,43.78
Blitzcrank,Xayah,331,134,197,40.48
Blitzcrank,Singed,148,67,81,45.27
Blitzcrank,Orianna,252,128,124,50.79
Blitzcrank,Trundle,304,112,192,36.84
Blitzcrank,Ivern,89,57,32,64.04
Blitzcrank,Darius,844,396,448,46.92
Blitzcrank,FiddleSticks,247,140,107,56.68
Blitzcrank,Chogath,624,278,346,44.55
Blitzcrank,Renekton,225,109,116,48.44
Blitzcrank,Seraphine,517,305,212,58.99
Blitzcrank,Gwen,295,154,141,52.2
Blitzcrank,Zeri,201,103,98,51.24
Blitzcrank,Zyra,320,151,169,47.19
Blitzcrank,Heimerdinger,321,151,170,47.04
Blitzcrank,DrMundo,279,179,100,64.16
Blitzcrank,Soraka,306,114,192,37.25
Blitzcrank,Ahri,661,314,347,47.5
Blitzcrank,Sylas,474,237,237,50
Blitzcrank,Nunu,419,251,168,59.9
Blitzcrank,Twitch,356,199,157,55.9
Blitzcrank,Karma,241,118,123,48.96
Blitzcrank,Milio,227,106,121,46.7
Blitzcrank,KSante,194,118,76,60.82
Blitzcrank,Karthus,108,44,64,40.74
Blitzcrank,Morgana,729,342,387,46.91
Blitzcrank,Xerath,291,142,149,48.8
Blitzcrank,Nidalee,102,59,43,57.84
Blitzcrank,Amumu,452,206,246,45.58
Blitzcrank,Renata,81,45,36,55.56
Blitzcrank,Gangplank,246,134,112,54.47
Blitzcrank,Kayle,322,148,174,45.96
Blitzcrank,Sejuani,177,101,76,57.06
Blitzcrank,Nasus,362,153,209,42.27
Blitzcrank,Rell,299,165,134,55.18
Blitzcrank,Ryze,130,90,40,69.23
Blitzcrank,Viktor,326,123,203,37.73
Blitzcrank,Vladimir,222,97,125,43.69
Blitzcrank,Yuumi,447,273,174,61.07
Blitzcrank,Brand,340,206,134,60.59
Blitzcrank,Malzahar,413,146,267,35.35
Blitzcrank,Smolder,352,171,181,48.58
Blitzcrank,Garen,652,260,392,39.88
Blitzcrank,JarvanIV,196,78,118,39.8
Blitzcrank,Galio,258,126,132,48.84
Blitzcrank,Ziggs,229,112,117,48.91
Blitzcrank,Sona,118,53,65,44.92
Blitzcrank,Camille,165,99,66,60
Blitzcrank,Veigar,543,260,283,47.88
Blitzcrank,Vex,237,137,100,57.81
Blitzcrank,Fiora,241,122,119,50.62
Blitzcrank,Nilah,241,88,153,36.51
Blitzcrank,Jax,356,166,190,46.63
Blitzcrank,Lulu,355,169,186,47.61
Blitzcrank,Syndra,257,122,135,47.47
Blitzcrank,Gnar,196,81,115,41.33
Blitzcrank,Vi,302,141,161,46.69
Blitzcrank,Udyr,163,84,79,51.53
Blitzcrank,Braum,227,99,128,43.61
Blitzcrank,Kassadin,103,46,57,44.66
Blitzcrank,Lissandra,112,53,59,47.32
Blitzcrank,Vayne,482,223,259,46.27
Blitzcrank,Ambessa,336,156,180,46.43
Blitzcrank,Kalista,247,179,68,72.47
Blitzcrank,Corki,165,95,70,57.58
Blitzcrank,Lillia,384,184,200,47.92
Blitzcrank,Shyvana,157,60,97,38.22
Blitzcrank,Graves,273,134,139,49.08
Blitzcrank,TwistedFate,181,104,77,57.46
Blitzcrank,Zac,188,79,109,42.02
Blitzcrank,Aphelios,275,152,123,55.27
Blitzcrank,Urgot,187,111,76,59.36
Blitzcrank,Briar,459,174,285,37.91
Blitzcrank,Ornn,185,78,107,42.16
Blitzcrank,Skarner,144,77,67,53.47
Blitzcrank,Taric,86,34,52,39.53
Blitzcrank,Annie,127,70,57,55.12
Blitzcrank,Rammus,143,82,61,57.34
Blitzcrank,RekSai,73,41,32,56.16
Blitzcrank,Quinn,165,103,62,62.42
Blitzcrank,Anivia,110,68,42,61.82
Blitzcrank,Bard,128,79,49,61.72
Blitzcrank,Belveth,113,54,59,47.79
Malphite,Sett,803,436,367,54.3
Malphite,Warwick,757,389,368,51.39
Malphite,Shen,284,145,139,51.06
Malphite,Tristana,444,249,195,56.08
Malphite,Blitzcrank,406,196,210,48.28
Malphite,Pantheon,849,484,365,57.01
Malphite,MasterYi,495,235,260,47.47
Malphite,Sylas,610,253,357,41.48
Malphite,Ashe,947,487,460,51.43
Malphite,Karma,367,187,180,50.95
Malphite,Gangplank,234,133,101,56.84
Malphite,Brand,330,159,171,48.18
Malphite,Irelia,565,334,231,59.12
Malphite,Malzahar,385,190,195,49.35
Malphite,Pyke,575,358,217,62.26
Malphite,Yasuo,993,518,475,52.17
Malphite,Zed,651,367,284,56.37
Malphite,Sivir,294,135,159,45.92
Malphite,FiddleSticks,278,127,151,45.68
Malphite,Shaco,457,246,211,53.83
Malphite,Syndra,255,126,129,49.41
Malphite,Kalista,274,177,97,64.6
Malphite,Thresh,670,387,283,57.76
Malphite,DrMundo,235,96,139,40.85
Malphite,Belveth,149,109,40,73.15
Malphite,Leblanc,178,98,80,55.06
Malphite,Briar,515,301,214,58.45
Malphite,Anivia,146,49,97,33.56
Malphite,Akali,496,258,238,52.02
Malphite,Rammus,164,71,93,43.29
Malphite,Jinx,966,497,469,51.45
Malphite,Zyra,252,114,138,45.24
Malphite,Fiora,212,135,77,63.68
Malphite,Kayn,937,449,488,47.92
Malphite,Aphelios,355,193,162,54.37
Malphite,Zilean,192,84,108,43.75
Malphite,KSante,200,98,102,49
Malphite,Viego,657,327,330,49.77
Malphite,Vex,287,153,134,53.31
Malphite,Senna,459,236,223,51.42
Malphite,Jax,298,148,150,49.66
Malphite,Evelynn,207,128,79,61.84
Malphite,Mel,936,440,496,47.01
Malphite,Renata,172,107,65,62.21
Malphite,Heimerdinger,186,92,94,49.46
Malphite,Katarina,379,209,170,55.15
Malphite,Caitlyn,1080,586,494,54.26
Malphite,Zac,156,97,59,62.18
Malphite,Nunu,341,178,163,52.2
Malphite,Veigar,582,271,311,46.56
Malphite,Kaisa,663,355,308,53.54
Malphite,Nasus,405,217,188,53.58
Malphite,Vi,410,194,216,47.32
Malphite,Lux,1369,747,622,54.57
Malphite,Alistar,154,90,64,58.44
Malphite,Samira,496,269,227,54.23
Malphite,Chogath,545,229,316,42.02
Malphite,Lillia,361,162,199,44.88
Malphite,Jhin,843,487,356,57.77
Malphite,Janna,129,39,90,30.23
Malphite,Yorick,385,141,244,36.62
Malphite,Kindred,288,148,140,51.39
Malphite,Lulu,363,197,166,54.27
Malphite,TahmKench,579,276,303,47.67
Malphite,Diana,587,299,288,50.94
Malphite,Darius,865,477,388,55.14
Malphite,Twitch,366,192,174,52.46
Malphite,Teemo,936,486,450,51.92
Malphite,Bard,122,73,49,59.84
Malphite,Mordekaiser,772,326,446,42.23
Malphite,Swain,449,203,246,45.21
Malphite,Tryndamere,404,220,184,54.46
Malphite,Elise,291,161,130,55.33
Malphite,Nautilus,494,258,236,52.23
Malphite,Varus,330,180,150,54.55
Malphite,Rakan,278,141,137,50.72
Malphite,Quinn,271,153,118,56.46
Malphite,Aatrox,595,304,291,51.09
Malphite,Rengar,190,116,74,61.05
Malphite,Galio,390,180,210,46.15
Malphite,Sona,245,120,125,48.98
Malphite,Kennen,206,110,96,53.4
Malphite,MissFortune,1116,550,566,49.28
Malphite,Morgana,578,257,321,44.46
Malphite,Viktor,353,168,185,47.59
Malphite,Volibear,524,264,260,50.38
Malphite,Azir,168,101,67,60.12
Malphite,Xayah,349,164,185,46.99
Malphite,Garen,759,362,397,47.69
Malphite,Singed,116,36,80,31.03
Malphite,Smolder,400,219,181,54.75
Malphite,Skarner,120,62,58,51.67
Malphite,Aurora,388,222,166,57.22
Malphite,Ryze,151,66,85,43.71
Malphite,Illaoi,252,120,132,47.62
Malphite,Yone,1004,565,439,56.27
Malphite,Akshan,228,123,105,53.95
Malphite,Yuumi,561,311,250,55.44
Malphite,Amumu,446,217,229,48.65
Malphite,Ivern,95,52,43,54.74
Malphite,Soraka,249,126,123,50.6
Malphite,Kayle,428,236,192,55.14
Malphite,Seraphine,504,286,218,56.75
Malphite,JarvanIV,221,102,119,46.15
Malphite,Draven,265,160,105,60.38
Malphite,Gnar,346,199,147,57.51
Malphite,Zoe,269,180,89,66.91
Malphite,Ezreal,914,514,400,56.24
Malphite,Hwei,400,218,182,54.5
Malphite,Graves,273,165,108,60.44
Malphite,Orianna,182,107,75,58.79
Malphite,Neeko,325,155,170,47.69
Malphite,Ornn,152,53,99,34.87
Malphite,Ekko,408,219,189,53.68
Malphite,Renekton,190,116,74,61.05
Malphite,Kassadin,88,57,31,64.77
Malphite,Gwen,346,187,159,54.05
Malphite,Nami,553,247,306,44.67
Malphite,Poppy,285,150,135,52.63
Malphite,AurelionSol,192,123,69,64.06
Malphite,Nilah,289,145,144,50.17
Malphite,Ziggs,256,90,166,35.16
Malphite,Leona,490,230,260,46.94
Malphite,Riven,262,192,70,73.28
Malphite,Khazix,270,158,112,58.52
Malphite,Qiyana,169,114,55,67.46
Malphite,Gragas,269,162,107,60.22
Malphite,Velkoz,305,145,160,47.54
Malphite,Nocturne,424,209,215,49.29
Malphite,Udyr,174,95,79,54.6
Malphite,Sion,316,163,153,51.58
Malphite,Trundle,248,136,112,54.84
Malphite,Sejuani,182,115,67,63.19
Malphite,Ahri,676,345,331,51.04
Malphite,Vayne,609,310,299,50.9
Malphite,Xerath,288,124,164,43.06
Malphite,Camille,145,72,73,49.66
Malphite,Naafiri,203,119,84,58.62
Malphite,Taliyah,145,91,54,62.76
Malphite,Lucian,266,151,115,56.77
Malphite,Talon,336,193,143,57.44
Malphite,Annie,122,46,76,37.7
Malphite,Cassiopeia,188,113,75,60.11
Malphite,Milio,278,168,110,60.43
Malphite,XinZhao,269,119,150,44.24
Malphite,Vladimir,283,150,133,53
Malphite,Rell,212,104,108,49.06
Malphite,LeeSin,502,311,191,61.95
Malphite,Shyvana,123,55,68,44.72
Malphite,Urgot,175,82,93,46.86
Malphite,Zeri,211,112,99,53.08
Malphite,Hecarim,186,111,75,59.68
Malphite,Nidalee,136,95,41,69.85
Malphite,Karthus,115,76,39,66.09
Malphite,Maokai,156,87,69,55.77
Malphite,MonkeyKing,211,83,128,39.34
Malphite,Braum,262,159,103,60.69
Malphite,Fizz,208,88,120,42.31
Malphite,Lissandra,131,61,70,46.56
Malphite,Jayce,210,129,81,61.43
Malphite,KogMaw,148,71,77,47.97
Malphite,TwistedFate,174,105,69,60.34
Malphite,Olaf,129,54,75,41.86
Malphite,Kled,79,58,21,73.42
Malphite,Ambessa,321,214,107,66.67
Malphite,Corki,140,77,63,55
Malphite,RekSai,63,32,31,50.79
Malphite,Taric,80,47,33,58.75
Malphite,Rumble,137,88,49,64.23
Ekko,Sett,832,384,448,46.15
Ekko,Warwick,814,410,404,50.37
Ekko,Shen,293,132,161,45.05
Ekko,Tristana,446,229,217,51.35
Ekko,Blitzcrank,317,148,169,46.69
Ekko,Mordekaiser,713,374,339,52.45
Ekko,Viego,554,275,279,49.64
Ekko,Kindred,320,159,161,49.69
Ekko,Jhin,907,450,457,49.61
Ekko,TahmKench,576,319,257,55.38
Ekko,Darius,920,452,468,49.13
Ekko,Rengar,227,152,75,66.96
Ekko,Syndra,232,108,124,46.55
Ekko,Caitlyn,1189,545,644,45.84
Ekko,Lux,1311,682,629,52.02
Ekko,Renekton,245,124,121,50.61
Ekko,Kayn,774,369,405,47.67
Ekko,Vex,323,151,172,46.75
Ekko,Samira,551,248,303,45.01
Ekko,Lulu,403,233,170,57.82
Ekko,Karma,311,146,165,46.95
Ekko,Rammus,165,81,84,49.09
Ekko,Yone,931,483,448,51.88
Ekko,Nocturne,430,221,209,51.4
Ekko,Lissandra,141,63,78,44.68
Ekko,Pantheon,790,415,375,52.53
Ekko,Ryze,143,63,80,44.06
Ekko,Jinx,973,441,532,45.32
Ekko,Nami,434,184,250,42.4
Ekko,Aatrox,480,250,230,52.08
Ekko,Shaco,502,288,214,57.37
Ekko,Leblanc,157,80,77,50.96
Ekko,Draven,310,127,183,40.97
Ekko,Hwei,313,160,153,51.12
Ekko,Nasus,394,171,223,43.4
Ekko,Zoe,314,177,137,56.37
Ekko,Ashe,863,373,490,43.22
Ekko,Senna,377,178,199,47.21
Ekko,Mel,937,458,479,48.88
Ekko,Lucian,279,160,119,57.35
Ekko,Thresh,572,281,291,49.13
Ekko,RekSai,68,16,52,23.53
Ekko,Braum,204,90,114,44.12
Ekko,Illaoi,236,118,118,50
Ekko,MonkeyKing,249,118,131,47.39
Ekko,Vayne,510,263,247,51.57
Ekko,Morgana,620,334,286,53.87
Ekko,XinZhao,318,147,171,46.23
Ekko,Irelia,431,256,175,59.4
Ekko,Soraka,336,167,169,49.7
Ekko,Teemo,634,268,366,42.27
Ekko,Khazix,300,167,133,55.67
Ekko,Vladimir,212,95,117,44.81
Ekko,Corki,121,71,50,58.68
Ekko,Pyke,667,375,292,56.22
Ekko,Singed,140,80,60,57.14
Ekko,Yasuo,960,530,430,55.21
Ekko,Alistar,243,108,135,44.44
Ekko,Nautilus,509,257,252,50.49
Ekko,Lillia,363,206,157,56.75
Ekko,FiddleSticks,295,111,184,37.63
Ekko,Akali,554,299,255,53.97
Ekko,Evelynn,287,155,132,54.01
Ekko,Ahri,652,319,333,48.93
Ekko,Chogath,689,305,384,44.27
Ekko,Velkoz,281,106,175,37.72
Ekko,Trundle,326,116,210,35.58
Ekko,Leona,428,173,255,40.42
Ekko,Heimerdinger,271,135,136,49.82
Ekko,Varus,348,186,162,53.45
Ekko,Maokai,208,106,102,50.96
Ekko,MasterYi,560,277,283,49.46
Ekko,Swain,488,232,256,47.54
Ekko,MissFortune,998,481,517,48.2
Ekko,Sion,375,172,203,45.87
Ekko,Twitch,542,284,258,52.4
Ekko,Rell,236,130,106,55.08
Ekko,Kayle,351,165,186,47.01
Ekko,Shyvana,109,42,67,38.53
Ekko,Galio,371,178,193,47.98
Ekko,Seraphine,548,267,281,48.72
Ekko,Sona,225,107,118,47.56
Ekko,Ezreal,857,489,368,57.06
Ekko,Garen,736,361,375,49.05
Ekko,Tryndamere,222,113,109,50.9
Ekko,Ivern,117,78,39,66.67
Ekko,Graves,249,139,110,55.82
Ekko,Katarina,398,252,146,63.32
Ekko,Annie,112,49,63,43.75
Ekko,Veigar,539,261,278,48.42
Ekko,Gangplank,217,110,107,50.69
Ekko,Volibear,518,211,307,40.73
Ekko,Qiyana,188,105,83,55.85
Ekko,Taliyah,136,55,81,40.44
Ekko,Urgot,191,73,118,38.22
Ekko,Xerath,363,211,152,58.13
Ekko,Poppy,293,127,166,43.34
Ekko,Talon,353,163,190,46.18
Ekko,AurelionSol,159,82,77,51.57
Ekko,KSante,177,89,88,50.28
Ekko,Fiora,264,173,91,65.53
Ekko,Aurora,453,207,246,45.7
Ekko,LeeSin,519,254,265,48.94
Ekko,Xayah,274,148,126,54.01
Ekko,DrMundo,286,160,126,55.94
Ekko,JarvanIV,146,67,79,45.89
Ekko,Hecarim,176,89,87,50.57
Ekko,Orianna,201,107,94,53.23
Ekko,Zyra,328,111,217,33.84
Ekko,Sejuani,159,55,104,34.59
Ekko,Bard,170,93,77,54.71
Ekko,Nilah,262,136,126,51.91
Ekko,Viktor,299,142,157,47.49
Ekko,Zeri,207,83,124,40.1
Ekko,Brand,342,173,169,50.58
Ekko,Diana,719,328,391,45.62
Ekko,Ziggs,190,96,94,50.53
Ekko,Riven,343,200,143,58.31
Ekko,Briar,514,262,252,50.97
Ekko,Kaisa,568,288,280,50.7
Ekko,Jax,363,153,210,42.15
Ekko,Sylas,464,233,231,50.22
Ekko,Yuumi,461,237,224,51.41
Ekko,Aphelios,312,196,116,62.82
Ekko,Zed,571,255,316,44.66
Ekko,Ornn,192,80,112,41.67
Ekko,Zac,161,67,94,41.61
Ekko,Belveth,86,28,58,32.56
Ekko,Naafiri,206,104,102,50.49
Ekko,Amumu,421,193,228,45.84
Ekko,Renata,99,51,48,51.52
Ekko,Zilean,150,74,76,49.33
Ekko,Rumble,72,29,43,40.28
Ekko,Smolder,402,208,194,51.74
Ekko,Janna,122,54,68,44.26
Ekko,Neeko,316,176,140,55.7
Ekko,Kassadin,137,49,88,35.77
Ekko,Karthus,72,37,35,51.39
Ekko,Azir,205,98,107,47.8
Ekko,Sivir,177,86,91,48.59
Ekko,Malphite,408,189,219,46.32
Ekko,Milio,212,86,126,40.57
Ekko,Nunu,361,194,167,53.74
Ekko,Fizz,229,91,138,39.74
Ekko,Vi,408,209,199,51.23
Ekko,Gragas,307,163,144,53.09
Ekko,Malzahar,325,139,186,42.77
Ekko,Kennen,161,74,87,45.96
Ekko,Kalista,159,109,50,68.55
Ekko,Udyr,177,103,74,58.19
Ekko,Gwen,353,171,182,48.44
Ekko,Kled,111,46,65,41.44
Ekko,Camille,149,80,69,53.69
Ekko,Gnar,179,109,70,60.89
Ekko,TwistedFate,189,82,107,43.39
Ekko,Anivia,93,50,43,53.76
Ekko,Yorick,406,155,251,38.18
Ekko,Elise,293,125,168,42.66
Ekko,KogMaw,137,91,46,66.42
Ekko,Nidalee,104,60,44,57.69
Ekko,Skarner,154,88,66,57.14
Ekko,Rakan,266,111,155,41.73
Ekko,Quinn,163,98,65,60.12
Ekko,Olaf,121,77,44,63.64
Ekko,Cassiopeia,177,122,55,68.93
Ekko,Ambessa,336,181,155,53.87
Ekko,Taric,101,42,59,41.58
Ekko,Akshan,168,74,94,44.05
Ekko,Jayce,163,87,76,53.37
Hwei,Sett,754,321,433,42.57
Hwei,Warwick,640,346,294,54.06
Hwei,Shen,274,119,155,43.43
Hwei,Tristana,375,185,190,49.33
Hwei,Blitzcrank,354,211,143,59.6
Hwei,Mordekaiser,718,375,343,52.23
Hwei,Sejuani,149,74,75,49.66
Hwei,Yasuo,816,419,397,51.35
Hwei,Lucian,264,154,110,58.33
Hwei,Pantheon,803,422,381,52.55
Hwei,Fiora,240,84,156,35
Hwei,Katarina,410,234,176,57.07
Hwei,Mel,1017,523,494,51.43
Hwei,Viktor,412,185,227,44.9
Hwei,Gwen,304,165,139,54.28
Hwei,Vi,440,198,242,45
Hwei,Zed,528,233,295,44.13
Hwei,Jhin,887,435,452,49.04
Hwei,Soraka,305,133,172,43.61
Hwei,Irelia,478,205,273,42.89
Hwei,Kassadin,78,26,52,33.33
Hwei,Yuumi,460,216,244,46.96
Hwei,Akali,507,270,237,53.25
Hwei,Velkoz,292,118,174,40.41
Hwei,Yorick,415,181,234,43.61
Hwei,Samira,493,260,233,52.74
Hwei,Nami,521,246,275,47.22
Hwei,Volibear,519,264,255,50.87
Hwei,LeeSin,481,302,179,62.79
Hwei,Malzahar,374,179,195,47.86
Hwei,Caitlyn,1082,594,488,54.9
Hwei,Pyke,634,329,305,51.89
Hwei,Teemo,646,340,306,52.63
Hwei,Khazix,353,204,149,57.79
Hwei,Smolder,341,155,186,45.45
Hwei,MissFortune,949,452,497,47.63
Hwei,Rell,235,109,126,46.38
Hwei,Ekko,313,153,160,48.88
Hwei,TahmKench,515,258,257,50.1
Hwei,Gangplank,153,70,83,45.75
Hwei,Diana,617,317,300,51.38
Hwei,Aphelios,359,171,188,47.63
Hwei,Leona,366,182,184,49.73
Hwei,Illaoi,179,93,86,51.96
Hwei,Nocturne,401,170,231,42.39
Hwei,Seraphine,529,308,221,58.22
Hwei,Amumu,408,213,195,52.21
Hwei,Lissandra,109,81,28,74.31
Hwei,Kayn,662,332,330,50.15
Hwei,Ezreal,768,448,320,58.33
Hwei,Yone,838,425,413,50.72
Hwei,Darius,977,561,416,57.42
Hwei,Ahri,751,397,354,52.86
Hwei,Jinx,867,389,478,44.87
Hwei,Karma,280,122,158,43.57
Hwei,Ambessa,261,149,112,57.09
Hwei,Ashe,886,512,374,57.79
Hwei,Varus,375,137,238,36.53
Hwei,Graves,238,132,106,55.46
Hwei,Neeko,363,188,175,51.79
Hwei,Rengar,197,114,83,57.87
Hwei,Syndra,265,113,152,42.64
Hwei,Xayah,312,170,142,54.49
Hwei,Thresh,604,310,294,51.32
Hwei,Sion,376,187,189,49.73
Hwei,Xerath,330,171,159,51.82
Hwei,Lulu,440,234,206,53.18
Hwei,Nidalee,112,79,33,70.54
Hwei,KogMaw,136,43,93,31.62
Hwei,Nautilus,437,229,208,52.4
Hwei,Veigar,562,304,258,54.09
Hwei,FiddleSticks,265,104,161,39.25
Hwei,Gnar,199,119,80,59.8
Hwei,AurelionSol,229,119,110,51.97
Hwei,Poppy,242,96,146,39.67
Hwei,Ryze,137,82,55,59.85
Hwei,Udyr,143,66,77,46.15
Hwei,Briar,505,250,255,49.5
Hwei,Renekton,185,100,85,54.05
Hwei,Kaisa,562,293,269,52.14
Hwei,Heimerdinger,195,94,101,48.21
Hwei,Braum,188,105,83,55.85
Hwei,Jax,434,208,226,47.93
Hwei,Zeri,220,115,105,52.27
Hwei,Naafiri,153,63,90,41.18
Hwei,Lux,1314,692,622,52.66
Hwei,Bard,139,55,84,39.57
Hwei,Evelynn,302,132,170,43.71
Hwei,Viego,492,235,257,47.76
Hwei,Qiyana,157,63,94,40.13
Hwei,Taric,87,30,57,34.48
Hwei,Vex,305,172,133,56.39
Hwei,Sona,128,69,59,53.91
Hwei,DrMundo,245,107,138,43.67
Hwei,Kayle,374,196,178,52.41
Hwei,Draven,291,131,160,45.02
Hwei,Tryndamere,328,201,127,61.28
Hwei,MonkeyKing,216,94,122,43.52
Hwei,Elise,336,149,187,44.35
Hwei,Aurora,411,250,161,60.83
Hwei,Quinn,126,41,85,32.54
Hwei,Galio,380,162,218,42.63
Hwei,Kennen,202,106,96,52.48
Hwei,Belveth,123,54,69,43.9
Hwei,Brand,350,149,201,42.57
Hwei,Gragas,248,92,156,37.1
Hwei,Morgana,607,294,313,48.43
Hwei,Swain,561,237,324,42.25
Hwei,Shaco,441,205,236,46.49
Hwei,Zyra,282,140,142,49.65
Hwei,Zoe,266,143,123,53.76
Hwei,Kindred,247,163,84,65.99
Hwei,Chogath,569,306,263,53.78
Hwei,Malphite,400,182,218,45.5
Hwei,Vladimir,285,122,163,42.81
Hwei,Nunu,407,232,175,57
Hwei,Cassiopeia,178,92,86,51.69
Hwei,Ornn,175,79,96,45.14
Hwei,Twitch,362,162,200,44.75
Hwei,Vayne,513,243,270,47.37
Hwei,Maokai,153,66,87,43.14
Hwei,Sivir,232,129,103,55.6
Hwei,Anivia,111,75,36,67.57
Hwei,Trundle,216,105,111,48.61
Hwei,JarvanIV,174,56,118,32.18
Hwei,Aatrox,464,251,213,54.09
Hwei,Milio,278,133,145,47.84
Hwei,Ziggs,223,120,103,53.81
Hwei,Leblanc,197,108,89,54.82
Hwei,Senna,375,154,221,41.07
Hwei,Karthus,139,71,68,51.08
Hwei,Akshan,210,65,145,30.95
Hwei,Kalista,242,148,94,61.16
Hwei,Garen,649,325,324,50.08
Hwei,MasterYi,449,213,236,47.44
Hwei,Nilah,285,109,176,38.25
Hwei,Lillia,279,126,153,45.16
Hwei,Fizz,235,116,119,49.36
Hwei,Nasus,325,171,154,52.62
Hwei,Orianna,171,61,110,35.67
Hwei,Jayce,162,85,77,52.47
Hwei,Camille,132,67,65,50.76
Hwei,Urgot,215,111,104,51.63
Hwei,Talon,291,154,137,52.92
Hwei,Sylas,406,222,184,54.68
Hwei,Hecarim,180,84,96,46.67
Hwei,Riven,183,105,78,57.38
Hwei,KSante,179,111,68,62.01
Hwei,XinZhao,183,86,97,46.99
Hwei,TwistedFate,142,67,75,47.18
Hwei,Ivern,103,70,33,67.96
Hwei,Taliyah,145,54,91,37.24
Hwei,Alistar,114,58,56,50.88
Hwei,Rakan,239,126,113,52.72
Hwei,Singed,113,63,50,55.75
Hwei,Annie,106,47,59,44.34
Hwei,RekSai,65,32,33,49.23
Hwei,Skarner,116,59,57,50.86
Hwei,Janna,134,64,70,47.76
Hwei,Rammus,144,83,61,57.64
Hwei,Corki,155,84,71,54.19
Hwei,Zac,141,85,56,60.28
Hwei,Renata,99,62,37,62.63
Hwei,Azir,180,91,89,50.56
Hwei,Olaf,116,52,64,44.83
Hwei,Shyvana,125,51,74,40.8
Hwei,Zilean,99,46,53,46.46
Hwei,Kled,83,31,52,37.35
Hwei,Rumble,55,26,29,47.27
Lucian,Sett,631,281,350,44.53
Lucian,Warwick,520,239,281,45.96
Lucian,Shen,262,160,102,61.07
Lucian,Tristana,272,114,158,41.91
Lucian,Blitzcrank,312,176,136,56.41
Lucian,Singed,96,43,53,44.79
Lucian,Shaco,252,105,147,41.67
Lucian,Zed,315,161,154,51.11
Lucian,Hwei,264,110,154,41.67
Lucian,Lux,960,464,496,48.33
Lucian,DrMundo,201,76,125,37.81
Lucian,Lillia,201,75,126,37.31
Lucian,Viktor,273,143,130,52.38
Lucian,Jhin,704,332,372,47.16
Lucian,Pyke,435,262,173,60.23
Lucian,Jax,253,130,123,51.38
Lucian,Elise,226,113,113,50
Lucian,Naafiri,153,68,85,44.44
Lucian,Lulu,346,198,148,57.23
Lucian,Gwen,290,143,147,49.31
Lucian,Tryndamere,186,70,116,37.63
Lucian,Velkoz,216,97,119,44.91
Lucian,Zeri,231,122,109,52.81
Lucian,Thresh,500,246,254,49.2
Lucian,Brand,214,132,82,61.68
Lucian,Twitch,349,176,173,50.43
Lucian,Morgana,379,165,214,43.54
Lucian,Riven,203,96,107,47.29
Lucian,LeeSin,362,186,176,51.38
Lucian,Mel,816,371,445,45.47
Lucian,Zac,141,57,84,40.43
Lucian,Volibear,340,185,155,54.41
Lucian,Syndra,217,90,127,41.47
Lucian,Jinx,727,338,389,46.49
Lucian,FiddleSticks,176,92,84,52.27
Lucian,Akali,329,155,174,47.11
Lucian,Ambessa,188,85,103,45.21
Lucian,Yuumi,352,166,186,47.16
Lucian,Qiyana,82,59,23,71.95
Lucian,Caitlyn,820,396,424,48.29
Lucian,Illaoi,183,98,85,53.55
Lucian,Ekko,279,119,160,42.65
Lucian,Leona,225,107,118,47.56
Lucian,Ashe,706,325,381,46.03
Lucian,MasterYi,345,158,187,45.8
Lucian,AurelionSol,210,76,134,36.19
Lucian,Ezreal,690,395,295,57.25
Lucian,Seraphine,365,157,208,43.01
Lucian,Teemo,437,223,214,51.03
Lucian,Rammus,82,15,67,18.29
Lucian,Fizz,211,92,119,43.6
Lucian,TahmKench,396,150,246,37.88
Lucian,Briar,350,155,195,44.29
Lucian,Fiora,152,66,86,43.42
Lucian,Cassiopeia,100,59,41,59
Lucian,MonkeyKing,164,52,112,31.71
Lucian,Nilah,224,131,93,58.48
Lucian,Evelynn,142,80,62,56.34
Lucian,Ahri,479,240,239,50.1
Lucian,Chogath,433,229,204,52.89
Lucian,Nocturne,335,164,171,48.96
Lucian,Irelia,282,150,132,53.19
Lucian,Gnar,132,68,64,51.52
Lucian,Kayn,566,286,280,50.53
Lucian,Katarina,318,146,172,45.91
Lucian,Renekton,119,69,50,57.98
Lucian,Leblanc,127,69,58,54.33
Lucian,Aphelios,301,157,144,52.16
Lucian,Graves,214,110,104,51.4
Lucian,Zoe,143,81,62,56.64
Lucian,Yasuo,830,419,411,50.48
Lucian,Trundle,181,74,107,40.88
Lucian,Kayle,219,107,112,48.86
Lucian,Milio,192,96,96,50
Lucian,Sylas,361,183,178,50.69
Lucian,Mordekaiser,508,260,248,51.18
Lucian,Talon,269,118,151,43.87
Lucian,Yone,642,342,300,53.27
Lucian,Varus,291,146,145,50.17
Lucian,Sejuani,152,70,82,46.05
Lucian,Azir,166,86,80,51.81
Lucian,Yorick,289,136,153,47.06
Lucian,Ivern,84,47,37,55.95
Lucian,Aatrox,395,194,201,49.11
Lucian,Aurora,379,170,209,44.85
Lucian,MissFortune,664,277,387,41.72
Lucian,Braum,141,51,90,36.17
Lucian,Galio,252,76,176,30.16
Lucian,Sona,138,70,68,50.72
Lucian,Soraka,233,120,113,51.5
Lucian,Sion,284,163,121,57.39
Lucian,Diana,462,232,230,50.22
Lucian,Orianna,163,80,83,49.08
Lucian,Kaisa,583,290,293,49.74
Lucian,Nami,361,156,205,43.21
Lucian,Garen,531,214,317,40.3
Lucian,JarvanIV,147,76,71,51.7
Lucian,XinZhao,214,66,148,30.84
Lucian,Ziggs,143,66,77,46.15
Lucian,Xayah,250,128,122,51.2
Lucian,Akshan,155,109,46,70.32
Lucian,Camille,132,62,70,46.97
Lucian,Nautilus,320,147,173,45.94
Lucian,KSante,154,69,85,44.81
Lucian,Skarner,120,70,50,58.33
Lucian,Nunu,289,177,112,61.25
Lucian,Urgot,176,65,111,36.93
Lucian,Kassadin,43,17,26,39.53
Lucian,Senna,283,126,157,44.52
Lucian,Darius,749,331,418,44.19
Lucian,Heimerdinger,180,89,91,49.44
Lucian,Draven,163,70,93,42.94
Lucian,Smolder,242,131,111,54.13
Lucian,Pantheon,625,303,322,48.48
Lucian,Gragas,246,118,128,47.97
Lucian,Amumu,353,177,176,50.14
Lucian,Nasus,307,180,127,58.63
Lucian,Rell,156,74,82,47.44
Lucian,Neeko,257,120,137,46.69
Lucian,Vayne,361,166,195,45.98
Lucian,Kennen,142,71,71,50
Lucian,Vi,424,191,233,45.05
Lucian,Lissandra,73,45,28,61.64
Lucian,Zilean,138,68,70,49.28
Lucian,Khazix,193,86,107,44.56
Lucian,Rengar,147,83,64,56.46
Lucian,Rakan,250,138,112,55.2
Lucian,Kled,75,41,34,54.67
Lucian,Vladimir,164,79,85,48.17
Lucian,Karma,241,100,141,41.49
Lucian,Corki,88,46,42,52.27
Lucian,Sivir,196,55,141,28.06
Lucian,Hecarim,130,50,80,38.46
Lucian,Renata,61,43,18,70.49
Lucian,Viego,413,215,198,52.06
Lucian,Kindred,174,80,94,45.98
Lucian,Malzahar,263,116,147,44.11
Lucian,Ryze,133,74,59,55.64
Lucian,Poppy,232,83,149,35.78
Lucian,Zyra,230,89,141,38.7
Lucian,Karthus,57,25,32,43.86
Lucian,Anivia,97,58,39,59.79
Lucian,Malphite,266,115,151,43.23
Lucian,Samira,306,155,151,50.65
Lucian,Taliyah,102,53,49,51.96
Lucian,Vex,253,118,135,46.64
Lucian,Shyvana,102,77,25,75.49
Lucian,Gangplank,192,80,112,41.67
Lucian,Alistar,122,67,55,54.92
Lucian,Olaf,76,28,48,36.84
Lucian,Xerath,215,97,118,45.12
Lucian,Janna,138,63,75,45.65
Lucian,Quinn,91,36,55,39.56
Lucian,Taric,58,20,38,34.48
Lucian,Udyr,138,77,61,55.8
Lucian,Bard,92,53,39,57.61
Lucian,Ornn,166,86,80,51.81
Lucian,Nidalee,134,75,59,55.97
Lucian,Swain,289,126,163,43.6
Lucian,Maokai,155,89,66,57.42
Lucian,Veigar,402,156,246,38.81
Lucian,RekSai,51,22,29,43.14
Lucian,TwistedFate,145,78,67,53.79
Lucian,KogMaw,118,64,54,54.24
Lucian,Belveth,82,18,64,21.95
Lucian,Kalista,192,91,101,47.4
Lucian,Jayce,145,76,69,52.41
Lucian,Annie,90,42,48,46.67
Lucian,Rumble,85,44,41,51.76
Maokai,Sett,555,280,275,50.45
Maokai,Warwick,390,185,205,47.44
Maokai,Shen,185,99,86,53.51
Maokai,Tristana,155,83,72,53.55
Maokai,Blitzcrank,249,184,65,73.9
Maokai,Pantheon,448,218,230,48.66
Maokai,MasterYi,275,154,121,56
Maokai,Sylas,266,138,128,51.88
Maokai,Ashe,424,237,187,55.9
Maokai,Karma,164,108,56,65.85
Maokai,Darius,596,316,280,53.02
Maokai,Rengar,122,68,54,55.74
Maokai,Syndra,105,48,57,45.71
Maokai,Caitlyn,682,360,322,52.79
Maokai,Lux,691,327,364,47.32
Maokai,Kayn,528,263,265,49.81
Maokai,Akali,263,120,143,45.63
Maokai,Akshan,132,65,67,49.24
Maokai,TahmKench,264,151,113,57.2
Maokai,Ivern,75,28,47,37.33
Maokai,Katarina,277,142,135,51.26
Maokai,Ezreal,494,301,193,60.93
Maokai,Kled,59,27,32,45.76
Maokai,Ambessa,184,93,91,50.54
Maokai,Diana,344,162,182,47.09
Maokai,Nilah,251,107,144,42.63
Maokai,Leona,210,91,119,43.33
Maokai,Rammus,71,55,16,77.46
Maokai,Aurora,245,143,102,58.37
Maokai,Swain,328,124,204,37.8
Maokai,Chogath,351,168,183,47.86
Maokai,Yasuo,505,279,226,55.25
Maokai,Kaisa,365,205,160,56.16
Maokai,Yuumi,300,152,148,50.67
Maokai,Kennen,75,53,22,70.67
Maokai,TwistedFate,115,64,51,55.65
Maokai,Cassiopeia,92,58,34,63.04
Maokai,Smolder,210,105,105,50
Maokai,Milio,179,118,61,65.92
Maokai,Mordekaiser,407,189,218,46.44
Maokai,Veigar,262,130,132,49.62
Maokai,Thresh,355,185,170,52.11
Maokai,XinZhao,142,87,55,61.27
Maokai,MissFortune,539,284,255,52.69
Maokai,Garen,390,251,139,64.36
Maokai,Nocturne,226,115,111,50.88
Maokai,Vladimir,132,66,66,50
Maokai,Ekko,208,102,106,49.04
Maokai,Singed,85,47,38,55.29
Maokai,Kindred,170,88,82,51.76
Maokai,Morgana,437,226,211,51.72
Maokai,Lillia,169,98,71,57.99
Maokai,Pyke,321,168,153,52.34
Maokai,Ahri,320,165,155,51.56
Maokai,Viego,352,170,182,48.3
Maokai,Aatrox,272,159,113,58.46
Maokai,Renata,81,38,43,46.91
Maokai,Yorick,304,163,141,53.62
Maokai,Azir,103,53,50,51.46
Maokai,Twitch,192,97,95,50.52
Maokai,Lulu,221,105,116,47.51
Maokai,Heimerdinger,132,54,78,40.91
Maokai,Briar,253,136,117,53.75
Maokai,Jinx,499,279,220,55.91
Maokai,Nasus,220,117,103,53.18
Maokai,Shaco,196,86,110,43.88
Maokai,Sona,50,35,15,70
Maokai,Urgot,137,65,72,47.45
Maokai,Seraphine,342,145,197,42.4
Maokai,Jax,223,98,125,43.95
Maokai,Jhin,445,237,208,53.26
Maokai,Braum,104,71,33,68.27
Maokai,Irelia,291,152,139,52.23
Maokai,Velkoz,194,105,89,54.12
Maokai,Renekton,127,56,71,44.09
Maokai,Nautilus,329,233,96,70.82
Maokai,Zyra,159,90,69,56.6
Maokai,Yone,491,273,218,55.6
Maokai,Amumu,271,164,107,60.52
Maokai,Zed,246,127,119,51.63
Maokai,Draven,193,104,89,53.89
Maokai,LeeSin,285,206,79,72.28
Maokai,Vex,122,63,59,51.64
Maokai,FiddleSticks,112,60,52,53.57
Maokai,Volibear,286,124,162,43.36
Maokai,Rumble,40,33,7,82.5
Maokai,Xayah,127,69,58,54.33
Maokai,Fiora,109,51,58,46.79
Maokai,Vayne,409,206,203,50.37
Maokai,Khazix,156,88,68,56.41
Maokai,Qiyana,140,76,64,54.29
Maokai,RekSai,15,9,6,60
Maokai,Poppy,160,86,74,53.75
Maokai,Teemo,388,212,176,54.64
Maokai,Mel,642,361,281,56.23
Maokai,Gnar,76,28,48,36.84
Maokai,Hwei,153,87,66,56.86
Maokai,Aphelios,190,80,110,42.11
Maokai,Nami,178,91,87,51.12
Maokai,Orianna,147,82,65,55.78
Maokai,Udyr,130,92,38,70.77
Maokai,Annie,63,32,31,50.79
Maokai,Neeko,250,113,137,45.2
Maokai,Kassadin,77,34,43,44.16
Maokai,Riven,126,92,34,73.02
Maokai,Malzahar,219,129,90,58.9
Maokai,Zoe,105,86,19,81.9
Maokai,Sivir,126,76,50,60.32
Maokai,Viktor,246,113,133,45.93
Maokai,Camille,52,19,33,36.54
Maokai,Soraka,158,70,88,44.3
Maokai,Samira,278,138,140,49.64
Maokai,MonkeyKing,135,95,40,70.37
Maokai,Graves,152,73,79,48.03
Maokai,Tryndamere,124,58,66,46.77
Maokai,Ziggs,86,43,43,50
Maokai,Senna,281,162,119,57.65
Maokai,Kayle,220,125,95,56.82
Maokai,Sion,255,111,144,43.53
Maokai,Gwen,134,84,50,62.69
Maokai,Nunu,241,116,125,48.13
Maokai,Fizz,141,61,80,43.26
Maokai,Lucian,155,66,89,42.58
Maokai,Janna,95,60,35,63.16
Maokai,Hecarim,86,33,53,38.37
Maokai,Zeri,111,58,53,52.25
Maokai,Brand,218,116,102,53.21
Maokai,Varus,263,123,140,46.77
Maokai,Taric,82,39,43,47.56
Maokai,Vi,187,71,116,37.97
Maokai,Jayce,137,115,22,83.94
Maokai,Gragas,207,139,68,67.15
Maokai,Xerath,167,90,77,53.89
Maokai,Shyvana,59,48,11,81.36
Maokai,Malphite,156,69,87,44.23
Maokai,Ryze,86,52,34,60.47
Maokai,Galio,120,64,56,53.33
Maokai,Talon,166,109,57,65.66
Maokai,JarvanIV,123,48,75,39.02
Maokai,KSante,139,85,54,61.15
Maokai,Illaoi,117,49,68,41.88
Maokai,Rakan,120,55,65,45.83
Maokai,Zac,96,44,52,45.83
Maokai,DrMundo,188,109,79,57.98
Maokai,KogMaw,104,26,78,25
Maokai,Naafiri,108,63,45,58.33
Maokai,Leblanc,107,78,29,72.9
Maokai,Elise,174,113,61,64.94
Maokai,Gangplank,95,35,60,36.84
Maokai,Bard,86,63,23,73.26
Maokai,Lissandra,60,40,20,66.67
Maokai,Rell,180,89,91,49.44
Maokai,Belveth,50,27,23,54
Maokai,Olaf,65,31,34,47.69
Maokai,Nidalee,87,52,35,59.77
Maokai,Sejuani,103,42,61,40.78
Maokai,Corki,78,39,39,50
Maokai,Quinn,79,37,42,46.84
Maokai,Evelynn,142,78,64,54.93
Maokai,Ornn,104,62,42,59.62
Maokai,Alistar,95,45,50,47.37
Maokai,Trundle,155,95,60,61.29
Maokai,Karthus,74,38,36,51.35
Maokai,Kalista,113,86,27,76.11
Maokai,Zilean,74,28,46,37.84
Maokai,Skarner,53,21,32,39.62
Maokai,AurelionSol,135,74,61,54.81
Maokai,Anivia,71,25,46,35.21
Maokai,Taliyah,87,40,47,45.98
Yone,Mordekaiser,2004,1075,929,53.64
Yone,Qiyana,364,178,186,48.9
Yone,Irelia,1178,554,624,47.03
Yone,Ezreal,1988,992,996,49.9
Yone,Rell,584,299,285,51.2
Yone,Renekton,546,217,329,39.74
Yone,Kayn,2048,1044,1004,50.98
Yone,Katarina,1033,581,452,56.24
Yone,Draven,676,335,341,49.56
Yone,Yuumi,1148,588,560,51.22
Yone,Kayle,788,390,398,49.49
Yone,Sylas,1221,513,708,42.01
Yone,Caitlyn,2827,1423,1404,50.34
Yone,Renata,283,118,165,41.7
Yone,Warwick,1904,845,1059,44.38
Yone,Mel,2604,1348,1256,51.77
Yone,Nautilus,1291,683,608,52.9
Yone,Gangplank,476,245,231,51.47
Yone,Akali,1447,657,790,45.4
Yone,Sona,449,193,256,42.98
Yone,Aatrox,1320,662,658,50.15
Yone,Sejuani,427,158,269,37
Yone,Yasuo,2926,1503,1423,51.37
Yone,Jinx,2340,1050,1290,44.87
Yone,Pyke,1457,766,691,52.57
Yone,Heimerdinger,674,294,380,43.62
Yone,Neeko,926,456,470,49.24
Yone,Leona,732,336,396,45.9
Yone,Jax,1027,474,553,46.15
Yone,Nidalee,291,160,131,54.98
Yone,Ahri,1623,756,867,46.58
Yone,Jhin,2077,993,1084,47.81
Yone,Senna,1029,408,621,39.65
Yone,Sett,2263,1079,1184,47.68
Yone,Taliyah,281,148,133,52.67
Yone,Cassiopeia,523,264,259,50.48
Yone,Kaisa,1878,970,908,51.65
Yone,Teemo,1663,716,947,43.05
Yone,Hecarim,437,177,260,40.5
Yone,Veigar,1369,655,714,47.85
Yone,Ashe,2093,1012,1081,48.35
Yone,Thresh,1544,746,798,48.32
Yone,Morgana,1657,752,905,45.38
Yone,Viego,1364,706,658,51.76
Yone,Kindred,659,350,309,53.11
Yone,TahmKench,1315,662,653,50.34
Yone,Diana,1485,751,734,50.57
Yone,Lux,3319,1609,1710,48.48
Yone,Tristana,1138,601,537,52.81
Yone,Vladimir,707,329,378,46.53
Yone,Zac,356,160,196,44.94
Yone,Amumu,1158,456,702,39.38
Yone,Xayah,736,341,395,46.33
Yone,Darius,2199,1042,1157,47.39
Yone,AurelionSol,521,251,270,48.18
Yone,MissFortune,2620,1151,1469,43.93
Yone,Talon,728,343,385,47.12
Yone,Leblanc,352,178,174,50.57
Yone,Soraka,647,318,329,49.15
Yone,Naafiri,674,401,273,59.5
Yone,Nunu,1132,548,584,48.41
Yone,Malzahar,812,369,443,45.44
Yone,Zeri,528,254,274,48.11
Yone,Ekko,931,448,483,48.12
Yone,Riven,529,256,273,48.39
Yone,Ivern,204,105,99,51.47
Yone,Swain,1252,578,674,46.17
Yone,Nami,1010,498,512,49.31
Yone,Sivir,569,289,280,50.79
Yone,Trundle,640,296,344,46.25
Yone,Gragas,709,394,315,55.57
Yone,Vex,862,419,443,48.61
Yone,Kennen,359,185,174,51.53
Yone,Rammus,504,171,333,33.93
Yone,Nasus,997,438,559,43.93
Yone,Smolder,947,504,443,53.22
Yone,Sion,946,465,481,49.15
Yone,Rengar,546,325,221,59.52
Yone,Anivia,324,167,157,51.54
Yone,Poppy,847,427,420,50.41
Yone,Illaoi,697,272,425,39.02
Yone,Aurora,1307,644,663,49.27
Yone,Tryndamere,716,349,367,48.74
Yone,Zyra,808,337,471,41.71
Yone,Nilah,539,222,317,41.19
Yone,FiddleSticks,618,263,355,42.56
Yone,Blitzcrank,886,473,413,53.39
Yone,Zed,1120,576,544,51.43
Yone,Rakan,640,359,281,56.09
Yone,Evelynn,674,347,327,51.48
Yone,Lissandra,329,158,171,48.02
Yone,XinZhao,658,283,375,43.01
Yone,Vayne,1087,545,542,50.14
Yone,Brand,879,426,453,48.46
Yone,Pantheon,2176,1051,1125,48.3
Yone,Braum,413,170,243,41.16
Yone,Gnar,483,243,240,50.31
Yone,Shaco,1195,646,549,54.06
Yone,Seraphine,1274,622,652,48.82
Yone,Nocturne,947,455,492,48.05
Yone,Orianna,485,257,228,52.99
Yone,LeeSin,1216,655,561,53.87
Yone,Garen,1787,914,873,51.15
Yone,Kled,198,108,90,54.55
Yone,Alistar,415,198,217,47.71
Yone,DrMundo,861,408,453,47.39
Yone,Akshan,457,223,234,48.8
Yone,Zilean,311,161,150,51.77
Yone,Hwei,838,413,425,49.28
Yone,Azir,408,183,225,44.85
Yone,Taric,260,98,162,37.69
Yone,Briar,1139,510,629,44.78
Yone,Ornn,474,187,287,39.45
Yone,MasterYi,1133,584,549,51.54
Yone,Yorick,1006,414,592,41.15
Yone,Velkoz,785,352,433,44.84
Yone,Volibear,1344,547,797,40.7
Yone,Quinn,299,157,142,52.51
Yone,Varus,907,437,470,48.18
Yone,Fiora,616,310,306,50.32
Yone,Twitch,934,444,490,47.54
Yone,Lulu,926,437,489,47.19
Yone,Xerath,663,302,361,45.55
Yone,Annie,312,185,127,59.29
Yone,Chogath,1637,823,814,50.27
Yone,Vi,1023,493,530,48.19
Yone,Galio,853,393,460,46.07
Yone,Samira,1232,613,619,49.76
Yone,Lucian,642,300,342,46.73
Yone,Jayce,564,284,280,50.35
Yone,KogMaw,410,186,224,45.37
Yone,Ryze,281,144,137,51.25
Yone,Zoe,506,281,225,55.53
Yone,Gwen,716,383,333,53.49
Yone,RekSai,135,80,55,59.26
Yone,MonkeyKing,605,282,323,46.61
Yone,Kalista,599,355,244,59.27
Yone,Camille,340,160,180,47.06
Yone,Udyr,413,218,195,52.78
Yone,TwistedFate,310,148,162,47.74
Yone,Aphelios,825,353,472,42.79
Yone,KSante,420,235,185,55.95
Yone,Graves,682,326,356,47.8
Yone,Olaf,308,161,147,52.27
Yone,Karma,693,340,353,49.06
Yone,Viktor,680,375,305,55.15
Yone,Bard,333,151,182,45.35
Yone,Karthus,294,178,116,60.54
Yone,Malphite,1004,439,565,43.73
Yone,Ziggs,557,289,268,51.89
Yone,Shyvana,344,153,191,44.48
Yone,Maokai,491,218,273,44.4
Yone,Lillia,761,372,389,48.88
Yone,Belveth,301,146,155,48.5
Yone,Janna,321,161,160,50.16
Yone,Fizz,613,266,347,43.39
Yone,Singed,248,102,146,41.13
Yone,Khazix,783,410,373,52.36
Yone,JarvanIV,378,163,215,43.12
Yone,Shen,803,315,488,39.23
Yone,Rumble,202,96,106,47.52
Yone,Elise,664,366,298,55.12
Yone,Urgot,500,227,273,45.4
Yone,Milio,481,237,244,49.27
Yone,Kassadin,191,100,91,52.36
Yone,Syndra,682,276,406,40.47
Yone,Ambessa,735,330,405,44.9
Yone,Corki,286,171,115,59.79
Yone,Skarner,297,163,134,54.88
Darius,Mordekaiser,2036,1086,950,53.34
Darius,Qiyana,333,213,120,63.96
Darius,Irelia,1015,539,476,53.1
Darius,Ezreal,2000,1090,910,54.5
Darius,Rell,686,345,341,50.29
Darius,Fiora,633,369,264,58.29
Darius,Pantheon,2020,931,1089,46.09
Darius,Katarina,955,480,475,50.26
Darius,Mel,2422,1197,1225,49.42
Darius,Viktor,777,417,360,53.67
Darius,Illaoi,645,234,411,36.28
Darius,Warwick,1988,955,1033,48.04
Darius,Diana,1457,705,752,48.39
Darius,Tristana,951,505,446,53.1
Darius,Milio,657,339,318,51.6
Darius,Viego,1284,625,659,48.68
Darius,Jhin,2074,1090,984,52.56
Darius,Lux,2882,1340,1542,46.5
Darius,Aatrox,1329,686,643,51.62
Darius,Ekko,920,468,452,50.87
Darius,Orianna,554,287,267,51.81
Darius,Malzahar,857,359,498,41.89
Darius,Maokai,596,280,316,46.98
Darius,Sett,2150,1024,1126,47.63
Darius,Zac,352,181,171,51.42
Darius,Yasuo,2202,1199,1003,54.45
Darius,MissFortune,2384,1072,1312,44.97
Darius,Yone,2199,1157,1042,52.61
Darius,Galio,834,422,412,50.6
Darius,Chogath,1597,790,807,49.47
Darius,Vladimir,571,317,254,55.52
Darius,Evelynn,593,279,314,47.05
Darius,Yuumi,1033,507,526,49.08
Darius,Poppy,649,321,328,49.46
Darius,Veigar,1269,620,649,48.86
Darius,Heimerdinger,669,280,389,41.85
Darius,Ziggs,515,243,272,47.18
Darius,Volibear,1272,593,679,46.62
Darius,Akshan,383,159,224,41.51
Darius,Morgana,1577,807,770,51.17
Darius,FiddleSticks,452,237,215,52.43
Darius,Singed,274,140,134,51.09
Darius,Pyke,1227,635,592,51.75
Darius,Lillia,861,446,415,51.8
Darius,Jinx,2260,1062,1198,46.99
Darius,Lulu,957,514,443,53.71
Darius,Nasus,914,481,433,52.63
Darius,Khazix,607,349,258,57.5
Darius,Urgot,515,232,283,45.05
Darius,Tryndamere,744,380,364,51.08
Darius,Briar,1257,629,628,50.04
Darius,Janna,298,165,133,55.37
Darius,Ambessa,573,305,268,53.23
Darius,Smolder,904,449,455,49.67
Darius,Swain,1291,585,706,45.31
Darius,Kayn,1856,928,928,50
Darius,Akali,1101,542,559,49.23
Darius,TahmKench,1513,788,725,52.08
Darius,Kalista,558,322,236,57.71
Darius,Thresh,1481,752,729,50.78
Darius,Udyr,521,281,240,53.93
Darius,Yorick,1082,489,593,45.19
Darius,Karma,794,435,359,54.79
Darius,Gnar,453,254,199,56.07
Darius,Brand,807,370,437,45.85
Darius,Caitlyn,2881,1459,1422,50.64
Darius,Velkoz,658,305,353,46.35
Darius,XinZhao,664,301,363,45.33
Darius,Samira,1116,565,551,50.63
Darius,Zed,1266,664,602,52.45
Darius,Graves,578,273,305,47.23
Darius,Kassadin,264,130,134,49.24
Darius,Vex,622,327,295,52.57
Darius,Vi,977,494,483,50.56
Darius,Nilah,667,346,321,51.87
Darius,Gangplank,576,279,297,48.44
Darius,Nunu,858,428,430,49.88
Darius,Soraka,817,385,432,47.12
Darius,Aurora,1024,564,460,55.08
Darius,Nocturne,988,458,530,46.36
Darius,Olaf,254,123,131,48.43
Darius,Ashe,2087,1061,1026,50.84
Darius,Kayle,984,528,456,53.66
Darius,Vayne,1198,571,627,47.66
Darius,Hwei,977,416,561,42.58
Darius,Senna,1114,523,591,46.95
Darius,Malphite,865,388,477,44.86
Darius,Naafiri,603,347,256,57.55
Darius,Trundle,716,320,396,44.69
Darius,Riven,595,369,226,62.02
Darius,Seraphine,1272,637,635,50.08
Darius,Sion,1011,482,529,47.68
Darius,Twitch,783,392,391,50.06
Darius,Sylas,1125,588,537,52.27
Darius,Kaisa,1577,776,801,49.21
Darius,Renata,291,167,124,57.39
Darius,Aphelios,780,354,426,45.38
Darius,Nautilus,1140,639,501,56.05
Darius,DrMundo,762,357,405,46.85
Darius,Jax,962,448,514,46.57
Darius,Shaco,1087,539,548,49.59
Darius,Talon,657,309,348,47.03
Darius,Taliyah,345,162,183,46.96
Darius,Zoe,563,349,214,61.99
Darius,Quinn,404,204,200,50.5
Darius,Shyvana,347,197,150,56.77
Darius,Fizz,607,323,284,53.21
Darius,Taric,260,117,143,45
Darius,Cassiopeia,419,212,207,50.6
Darius,Ornn,430,200,230,46.51
Darius,Shen,776,398,378,51.29
Darius,MasterYi,1221,673,548,55.12
Darius,Nami,1236,643,593,52.02
Darius,AurelionSol,522,264,258,50.57
Darius,Gragas,670,326,344,48.66
Darius,RekSai,183,98,85,53.55
Darius,KSante,535,315,220,58.88
Darius,Draven,710,387,323,54.51
Darius,Varus,952,467,485,49.05
Darius,Sejuani,428,196,232,45.79
Darius,Neeko,755,418,337,55.36
Darius,Kennen,434,204,230,47
Darius,Garen,2118,958,1160,45.23
Darius,Rakan,623,271,352,43.5
Darius,Ryze,346,215,131,62.14
Darius,Blitzcrank,844,448,396,53.08
Darius,LeeSin,1266,709,557,56
Darius,Ahri,1506,828,678,54.98
Darius,Jayce,453,243,210,53.64
Darius,Renekton,534,290,244,54.31
Darius,Rammus,372,194,178,52.15
Darius,Camille,310,154,156,49.68
Darius,Xayah,722,325,397,45.01
Darius,Sona,444,225,219,50.68
Darius,Teemo,1704,791,913,46.42
Darius,Belveth,263,144,119,54.75
Darius,Azir,405,213,192,52.59
Darius,Leblanc,458,222,236,48.47
Darius,Amumu,1098,481,617,43.81
Darius,Skarner,380,189,191,49.74
Darius,Zilean,380,188,192,49.47
Darius,Lucian,749,418,331,55.81
Darius,Syndra,658,328,330,49.85
Darius,Hecarim,468,265,203,56.62
Darius,KogMaw,347,173,174,49.86
Darius,Rengar,468,284,184,60.68
Darius,Zyra,809,359,450,44.38
Darius,TwistedFate,440,265,175,60.23
Darius,Leona,780,351,429,45
Darius,Annie,272,135,137,49.63
Darius,Xerath,739,325,414,43.98
Darius,Sivir,473,224,249,47.36
Darius,Zeri,528,261,267,49.43
Darius,Karthus,342,170,172,49.71
Darius,Kindred,669,414,255,61.88
Darius,Lissandra,259,112,147,43.24
Darius,Alistar,325,169,156,52
Darius,Gwen,676,335,341,49.56
Darius,Corki,400,225,175,56.25
Darius,Nidalee,325,195,130,60
Darius,JarvanIV,385,162,223,42.08
Darius,Elise,644,339,305,52.64
Darius,Braum,469,277,192,59.06
Darius,Rumble,246,138,108,56.1
Darius,Bard,409,227,182,55.5
Darius,Kled,255,134,121,52.55
Darius,MonkeyKing,524,242,282,46.18
Darius,Ivern,309,170,139,55.02
Darius,Anivia,298,139,159,46.64
Yasuo,Mordekaiser,1795,849,946,47.3
Yasuo,Qiyana,400,233,167,58.25
Yasuo,Irelia,1234,553,681,44.81
Yasuo,Ezreal,2037,1078,959,52.92
Yasuo,Rell,626,308,318,49.2
Yasuo,Singed,277,113,164,40.79
Yasuo,Shaco,1055,542,513,51.37
Yasuo,Zed,1395,813,582,58.28
Yasuo,Hwei,816,397,419,48.65
Yasuo,Lux,3152,1673,1479,53.08
Yasuo,Renekton,633,366,267,57.82
Yasuo,Khazix,782,440,342,56.27
Yasuo,Mel,2794,1527,1267,54.65
Yasuo,Jhin,2126,1072,1054,50.42
Yasuo,Aatrox,1328,720,608,54.22
Yasuo,Sylas,1360,743,617,54.63
Yasuo,Diana,1500,729,771,48.6
Yasuo,Varus,887,488,399,55.02
Yasuo,Blitzcrank,909,463,446,50.94
Yasuo,Ambessa,815,390,425,47.85
Yasuo,Rammus,489,197,292,40.29
Yasuo,Draven,735,422,313,57.41
Yasuo,Viego,1455,713,742,49
Yasuo,Teemo,1696,776,920,45.75
Yasuo,Warwick,1933,977,956,50.54
Yasuo,Azir,460,213,247,46.3
Yasuo,MissFortune,2793,1401,1392,50.16
Yasuo,Neeko,898,519,379,57.8
Yasuo,Gangplank,564,274,290,48.58
Yasuo,Brand,799,422,377,52.82
Yasuo,Malzahar,1036,519,517,50.1
Yasuo,Pyke,1433,722,711,50.38
Yasuo,Briar,1166,596,570,51.11
Yasuo,Ryze,408,259,149,63.48
Yasuo,Vex,803,380,423,47.32
Yasuo,Yuumi,1200,649,551,54.08
Yasuo,Naafiri,538,303,235,56.32
Yasuo,Yone,2926,1423,1503,48.63
Yasuo,Senna,1094,524,570,47.9
Yasuo,Galio,901,438,463,48.61
Yasuo,TahmKench,1297,661,636,50.96
Yasuo,Hecarim,447,196,251,43.85
Yasuo,Veigar,1249,634,615,50.76
Yasuo,Ashe,2230,1075,1155,48.21
Yasuo,Thresh,1606,789,817,49.13
Yasuo,Sett,2019,1039,980,51.46
Yasuo,Amumu,1037,506,531,48.79
Yasuo,Caitlyn,2910,1555,1355,53.44
Yasuo,Poppy,691,325,366,47.03
Yasuo,Malphite,993,475,518,47.83
Yasuo,Evelynn,687,357,330,51.97
Yasuo,Tristana,1207,620,587,51.37
Yasuo,Garen,1959,922,1037,47.06
Yasuo,Kayn,2020,1027,993,50.84
Yasuo,Riven,564,306,258,54.26
Yasuo,Zoe,550,341,209,62
Yasuo,Sona,437,204,233,46.68
Yasuo,Nocturne,1151,499,652,43.35
Yasuo,Jinx,2318,1162,1156,50.13
Yasuo,Lulu,983,489,494,49.75
Yasuo,Samira,1053,513,540,48.72
Yasuo,Darius,2202,1003,1199,45.55
Yasuo,Volibear,1324,658,666,49.7
Yasuo,Chogath,1539,671,868,43.6
Yasuo,Sivir,564,276,288,48.94
Yasuo,Rakan,635,296,339,46.61
Yasuo,Jax,1142,599,543,52.45
Yasuo,Xayah,820,394,426,48.05
Yasuo,Karma,798,402,396,50.38
Yasuo,Seraphine,1373,656,717,47.78
Yasuo,Zilean,349,177,172,50.72
Yasuo,LeeSin,1181,643,538,54.45
Yasuo,Nami,1057,509,548,48.16
Yasuo,Aurora,1039,528,511,50.82
Yasuo,Kaisa,1639,782,857,47.71
Yasuo,Shen,850,449,401,52.82
Yasuo,Gragas,697,399,298,57.25
Yasuo,Alistar,430,269,161,62.56
Yasuo,Kindred,678,364,314,53.69
Yasuo,Nasus,1015,540,475,53.2
Yasuo,Urgot,548,238,310,43.43
Yasuo,DrMundo,735,383,352,52.11
Yasuo,Leblanc,436,238,198,54.59
Yasuo,Nunu,1069,594,475,55.57
Yasuo,Vladimir,849,414,435,48.76
Yasuo,Zac,403,206,197,51.12
Yasuo,Kalista,507,249,258,49.11
Yasuo,Vi,1066,525,541,49.25
Yasuo,Orianna,508,236,272,46.46
Yasuo,Kennen,483,239,244,49.48
Yasuo,MonkeyKing,693,331,362,47.76
Yasuo,Vayne,1229,605,624,49.23
Yasuo,Fiora,673,391,282,58.1
Yasuo,Ziggs,436,222,214,50.92
Yasuo,Nilah,821,345,476,42.02
Yasuo,JarvanIV,495,217,278,43.84
Yasuo,Taliyah,479,285,194,59.5
Yasuo,Soraka,723,353,370,48.82
Yasuo,Sion,772,342,430,44.3
Yasuo,Rengar,582,367,215,63.06
Yasuo,Ahri,1787,926,861,51.82
Yasuo,Anivia,385,203,182,52.73
Yasuo,Sejuani,436,234,202,53.67
Yasuo,AurelionSol,531,294,237,55.37
Yasuo,Shyvana,280,114,166,40.71
Yasuo,Fizz,598,322,276,53.85
Yasuo,Twitch,1004,475,529,47.31
Yasuo,Kayle,999,461,538,46.15
Yasuo,FiddleSticks,567,288,279,50.79
Yasuo,Katarina,1072,604,468,56.34
Yasuo,Lissandra,397,204,193,51.39
Yasuo,XinZhao,674,292,382,43.32
Yasuo,Ornn,522,263,259,50.38
Yasuo,Smolder,884,446,438,50.45
Yasuo,Swain,1323,624,699,47.17
Yasuo,Graves,719,354,365,49.24
Yasuo,Kassadin,222,123,99,55.41
Yasuo,Maokai,505,226,279,44.75
Yasuo,Ivern,294,154,140,52.38
Yasuo,Illaoi,635,291,344,45.83
Yasuo,Morgana,1540,764,776,49.61
Yasuo,Gwen,630,309,321,49.05
Yasuo,RekSai,182,79,103,43.41
Yasuo,Leona,817,324,493,39.66
Yasuo,Akali,1463,714,749,48.8
Yasuo,Pantheon,1944,929,1015,47.79
Yasuo,Corki,451,253,198,56.1
Yasuo,Viktor,804,350,454,43.53
Yasuo,Akshan,404,192,212,47.52
Yasuo,Lillia,789,328,461,41.57
Yasuo,Velkoz,796,403,393,50.63
Yasuo,Skarner,379,210,169,55.41
Yasuo,Ekko,960,430,530,44.79
Yasuo,Xerath,658,332,326,50.46
Yasuo,Trundle,580,258,322,44.48
Yasuo,Aphelios,887,465,422,52.42
Yasuo,Nautilus,1113,602,511,54.09
Yasuo,Zyra,814,436,378,53.56
Yasuo,Annie,437,219,218,50.11
Yasuo,Jayce,536,341,195,63.62
Yasuo,Tryndamere,759,381,378,50.2
Yasuo,MasterYi,1298,651,647,50.15
Yasuo,Zeri,428,224,204,52.34
Yasuo,Taric,343,165,178,48.1
Yasuo,Quinn,314,201,113,64.01
Yasuo,Udyr,437,195,242,44.62
Yasuo,Lucian,830,411,419,49.52
Yasuo,Kled,185,114,71,61.62
Yasuo,KogMaw,401,181,220,45.14
Yasuo,Olaf,304,130,174,42.76
Yasuo,Syndra,582,257,325,44.16
Yasuo,Talon,787,485,302,61.63
Yasuo,Yorick,996,465,531,46.69
Yasuo,Bard,425,216,209,50.82
Yasuo,Camille,381,184,197,48.29
Yasuo,Cassiopeia,396,182,214,45.96
Yasuo,Milio,636,301,335,47.33
Yasuo,Renata,357,198,159,55.46
Yasuo,Elise,627,364,263,58.05
Yasuo,Heimerdinger,718,337,381,46.94
Yasuo,Belveth,390,182,208,46.67
Yasuo,Janna,370,158,212,42.7
Yasuo,Gnar,507,260,247,51.28
Yasuo,Rumble,316,165,151,52.22
Yasuo,Karthus,303,140,163,46.2
Yasuo,Braum,460,231,229,50.22
Yasuo,KSante,462,224,238,48.48
Yasuo,Nidalee,353,221,132,62.61
Yasuo,TwistedFate,397,222,175,55.92
Jhin,Mordekaiser,1556,738,818,47.43
Jhin,Qiyana,395,173,222,43.8
Jhin,Irelia,981,535,446,54.54
Jhin,Ezreal,2035,1164,871,57.2
Jhin,Rell,590,321,269,54.41
Jhin,Aurora,1022,546,476,53.42
Jhin,Volibear,1248,655,593,52.48
Jhin,Yasuo,2126,1054,1072,49.58
Jhin,Vayne,1209,567,642,46.9
Jhin,Shaco,1080,557,523,51.57
Jhin,Chogath,1502,807,695,53.73
Jhin,Kayn,1660,885,775,53.31
Jhin,Gangplank,466,203,263,43.56
Jhin,Hwei,887,452,435,50.96
Jhin,Darius,2074,984,1090,47.44
Jhin,Warwick,1913,945,968,49.4
Jhin,Caitlyn,2986,1505,1481,50.4
Jhin,Morgana,1587,794,793,50.03
Jhin,Gragas,577,316,261,54.77
Jhin,TwistedFate,397,234,163,58.94
Jhin,Lucian,704,372,332,52.84
Jhin,Leona,817,360,457,44.06
Jhin,Zed,1161,607,554,52.28
Jhin,Sona,342,139,203,40.64
Jhin,Kaisa,1644,829,815,50.43
Jhin,Amumu,1045,519,526,49.67
Jhin,Riven,555,317,238,57.12
Jhin,Ahri,1482,742,740,50.07
Jhin,Jinx,2434,1206,1228,49.55
Jhin,Nautilus,1164,603,561,51.8
Jhin,Gwen,639,351,288,54.93
Jhin,Talon,611,305,306,49.92
Jhin,Yone,2077,1084,993,52.19
Jhin,MissFortune,2407,1267,1140,52.64
Jhin,Taric,189,92,97,48.68
Jhin,Nasus,714,363,351,50.84
Jhin,Varus,849,480,369,56.54
Jhin,Neeko,865,450,415,52.02
Jhin,Swain,1194,533,661,44.64
Jhin,Malzahar,847,420,427,49.59
Jhin,Kalista,526,283,243,53.8
Jhin,Poppy,666,351,315,52.7
Jhin,Ekko,907,457,450,50.39
Jhin,Pyke,1424,826,598,58.01
Jhin,Galio,744,335,409,45.03
Jhin,Cassiopeia,385,171,214,44.42
Jhin,Mel,2451,1302,1149,53.12
Jhin,Hecarim,363,210,153,57.85
Jhin,Milio,551,267,284,48.46
Jhin,Garen,1501,776,725,51.7
Jhin,Seraphine,1087,574,513,52.81
Jhin,Zilean,358,189,169,52.79
Jhin,Soraka,765,386,379,50.46
Jhin,Sylas,991,477,514,48.13
Jhin,Ryze,282,136,146,48.23
Jhin,Nunu,965,490,475,50.78
Jhin,Alistar,286,130,156,45.45
Jhin,Lillia,701,347,354,49.5
Jhin,Vladimir,678,349,329,51.47
Jhin,Lulu,1000,514,486,51.4
Jhin,Sett,1775,844,931,47.55
Jhin,Brand,732,379,353,51.78
Jhin,Twitch,1092,514,578,47.07
Jhin,Ashe,1968,936,1032,47.56
Jhin,Zac,383,177,206,46.21
Jhin,Gnar,474,263,211,55.49
Jhin,Jax,915,460,455,50.27
Jhin,Bard,311,152,159,48.87
Jhin,Heimerdinger,613,323,290,52.69
Jhin,FiddleSticks,578,280,298,48.44
Jhin,Katarina,1013,532,481,52.52
Jhin,Akali,1190,627,563,52.69
Jhin,Naafiri,549,317,232,57.74
Jhin,Kayle,737,325,412,44.1
Jhin,Smolder,933,513,420,54.98
Jhin,Sejuani,364,179,185,49.18
Jhin,AurelionSol,467,247,220,52.89
Jhin,Tristana,1092,495,597,45.33
Jhin,Rakan,551,236,315,42.83
Jhin,Samira,1082,529,553,48.89
Jhin,Leblanc,427,251,176,58.78
Jhin,Nami,1027,575,452,55.99
Jhin,Malphite,843,356,487,42.23
Jhin,MonkeyKing,489,218,271,44.58
Jhin,Senna,866,441,425,50.92
Jhin,Shen,722,342,380,47.37
Jhin,Ziggs,511,243,268,47.55
Jhin,Kled,252,147,105,58.33
Jhin,XinZhao,643,265,378,41.21
Jhin,Trundle,585,285,300,48.72
Jhin,Aphelios,775,390,385,50.32
Jhin,Viktor,767,431,336,56.19
Jhin,Yuumi,1094,573,521,52.38
Jhin,Xerath,774,363,411,46.9
Jhin,Rammus,315,149,166,47.3
Jhin,Nocturne,981,493,488,50.25
Jhin,Vex,665,326,339,49.02
Jhin,KSante,369,234,135,63.41
Jhin,Azir,360,206,154,57.22
Jhin,Skarner,384,216,168,56.25
Jhin,Lissandra,327,168,159,51.38
Jhin,DrMundo,622,292,330,46.95
Jhin,Veigar,1210,633,577,52.31
Jhin,Pantheon,1642,767,875,46.71
Jhin,Annie,360,186,174,51.67
Jhin,Syndra,709,318,391,44.85
Jhin,Lux,3052,1592,1460,52.16
Jhin,Karma,775,357,418,46.06
Jhin,Illaoi,473,217,256,45.88
Jhin,Rengar,481,285,196,59.25
Jhin,Xayah,806,380,426,47.15
Jhin,Thresh,1413,653,760,46.21
Jhin,Ornn,559,307,252,54.92
Jhin,Yorick,992,423,569,42.64
Jhin,Braum,564,269,295,47.7
Jhin,Sion,891,436,455,48.93
Jhin,Evelynn,565,330,235,58.41
Jhin,MasterYi,1057,518,539,49.01
Jhin,Kindred,621,340,281,54.75
Jhin,Sivir,498,226,272,45.38
Jhin,Quinn,388,176,212,45.36
Jhin,Teemo,1547,702,845,45.38
Jhin,Camille,441,251,190,56.92
Jhin,Zeri,532,267,265,50.19
Jhin,Singed,275,111,164,40.36
Jhin,Aatrox,1022,515,507,50.39
Jhin,Khazix,787,382,405,48.54
Jhin,Viego,1468,740,728,50.41
Jhin,Diana,1309,719,590,54.93
Jhin,Nilah,573,304,269,53.05
Jhin,RekSai,170,79,91,46.47
Jhin,Velkoz,704,373,331,52.98
Jhin,Vi,895,484,411,54.08
Jhin,Kassadin,270,144,126,53.33
Jhin,Corki,330,203,127,61.52
Jhin,Blitzcrank,699,359,340,51.36
Jhin,Belveth,310,136,174,43.87
Jhin,Orianna,401,205,196,51.12
Jhin,Tryndamere,689,345,344,50.07
Jhin,Renekton,440,259,181,58.86
Jhin,Briar,1011,485,526,47.97
Jhin,Anivia,347,146,201,42.07
Jhin,Zoe,514,290,224,56.42
Jhin,Zyra,597,281,316,47.07
Jhin,Kennen,373,179,194,47.99
Jhin,Ambessa,673,336,337,49.93
Jhin,Maokai,445,208,237,46.74
Jhin,Graves,564,270,294,47.87
Jhin,TahmKench,1136,668,468,58.8
Jhin,JarvanIV,407,208,199,51.11
Jhin,Fiora,419,206,213,49.16
Jhin,KogMaw,443,195,248,44.02
Jhin,LeeSin,1071,588,483,54.9
Jhin,Fizz,581,260,321,44.75
Jhin,Draven,664,377,287,56.78
Jhin,Karthus,236,129,107,54.66
Jhin,Udyr,407,178,229,43.73
Jhin,Elise,691,460,231,66.57
Jhin,Akshan,434,236,198,54.38
Jhin,Taliyah,283,156,127,55.12
Jhin,Renata,212,100,112,47.17
Jhin,Urgot,503,237,266,47.12
Jhin,Rumble,195,118,77,60.51
Jhin,Ivern,250,163,87,65.2
Jhin,Janna,340,139,201,40.88
Jhin,Nidalee,285,160,125,56.14
Jhin,Shyvana,262,118,144,45.04
Jhin,Olaf,236,99,137,41.95
Jhin,Jayce,499,268,231,53.71
Lux,Mordekaiser,2497,1211,1286,48.5
Lux,Qiyana,619,328,291,52.99
Lux,Irelia,1525,785,740,51.48
Lux,Ezreal,2625,1343,1282,51.16
Lux,Rell,779,378,401,48.52
Lux,Sejuani,574,272,302,47.39
Lux,Yasuo,3152,1479,1673,46.92
Lux,Lucian,960,496,464,51.67
Lux,Pantheon,2878,1436,1442,49.9
Lux,Aurora,1575,884,691,56.13
Lux,Volibear,1893,932,961,49.23
Lux,Vayne,1619,785,834,48.49
Lux,Shaco,1640,800,840,48.78
Lux,Aatrox,1651,869,782,52.63
Lux,Sylas,1529,725,804,47.42
Lux,Diana,2270,1120,1150,49.34
Lux,Varus,1283,637,646,49.65
Lux,Blitzcrank,1613,842,771,52.2
Lux,Illaoi,796,411,385,51.63
Lux,Warwick,2591,1308,1283,50.48
Lux,Tristana,1534,730,804,47.59
Lux,Milio,994,398,596,40.04
Lux,Kayle,1200,576,624,48
Lux,Caitlyn,3705,1850,1855,49.93
Lux,Renata,387,179,208,46.25
Lux,Darius,2882,1542,1340,53.5
Lux,Morgana,2764,1253,1511,45.33
Lux,Brand,1483,778,705,52.46
Lux,Akali,1927,956,971,49.61
Lux,MissFortune,4032,1989,2043,49.33
Lux,Kassadin,353,194,159,54.96
Lux,Kayn,2758,1468,1290,53.23
Lux,Sona,649,338,311,52.08
Lux,Sett,2858,1401,1457,49.02
Lux,Amumu,1732,781,951,45.09
Lux,Poppy,910,450,460,49.45
Lux,Teemo,2269,989,1280,43.59
Lux,XinZhao,926,415,511,44.82
Lux,Jinx,3323,1688,1635,50.8
Lux,Neeko,1415,799,616,56.47
Lux,Gwen,900,501,399,55.67
Lux,Skarner,536,240,296,44.78
Lux,Yone,3319,1710,1609,51.52
Lux,Kaisa,2427,1344,1083,55.38
Lux,Seraphine,2340,1193,1147,50.98
Lux,Ornn,672,308,364,45.83
Lux,Ekko,1311,629,682,47.98
Lux,Orianna,794,412,382,51.89
Lux,Malzahar,1228,523,705,42.59
Lux,Maokai,691,364,327,52.68
Lux,Vi,1279,652,627,50.98
Lux,AurelionSol,888,386,502,43.47
Lux,Corki,630,344,286,54.6
Lux,Chogath,2217,1171,1046,52.82
Lux,Yorick,1505,604,901,40.13
Lux,Sivir,760,363,397,47.76
Lux,Xerath,1389,638,751,45.93
Lux,Vladimir,820,424,396,51.71
Lux,Evelynn,996,466,530,46.79
Lux,Yuumi,1632,815,817,49.94
Lux,Nasus,1293,644,649,49.81
Lux,MonkeyKing,796,404,392,50.75
Lux,Zoe,830,473,357,56.99
Lux,Xayah,1023,544,479,53.18
Lux,Zac,512,282,230,55.08
Lux,Heimerdinger,887,422,465,47.58
Lux,LeeSin,1715,857,858,49.97
Lux,Veigar,1989,980,1009,49.27
Lux,Vex,1091,536,555,49.13
Lux,Rakan,868,392,476,45.16
Lux,Gragas,1032,564,468,54.65
Lux,Soraka,1122,556,566,49.55
Lux,Garen,2367,1203,1164,50.82
Lux,Ziggs,748,414,334,55.35
Lux,Zeri,596,302,294,50.67
Lux,Zyra,1077,437,640,40.58
Lux,Talon,999,594,405,59.46
Lux,Pyke,2010,1010,1000,50.25
Lux,Khazix,1078,572,506,53.06
Lux,Nautilus,1808,943,865,52.16
Lux,Twitch,1445,706,739,48.86
Lux,Kennen,743,392,351,52.76
Lux,Naafiri,861,364,497,42.28
Lux,Nocturne,1451,676,775,46.59
Lux,Ashe,3026,1561,1465,51.59
Lux,Thresh,2375,1211,1164,50.99
Lux,Riven,742,426,316,57.41
Lux,JarvanIV,632,270,362,42.72
Lux,Taliyah,421,232,189,55.11
Lux,Draven,997,523,474,52.46
Lux,Jax,1337,686,651,51.31
Lux,Mel,3551,1691,1860,47.62
Lux,Kalista,777,378,399,48.65
Lux,Rammus,474,266,208,56.12
Lux,TahmKench,2134,1109,1025,51.97
Lux,Katarina,1384,768,616,55.49
Lux,Shyvana,458,237,221,51.75
Lux,Fizz,851,461,390,54.17
Lux,Nilah,908,452,456,49.78
Lux,Nami,1671,840,831,50.27
Lux,Malphite,1369,619,750,45.22
Lux,Gnar,633,316,317,49.92
Lux,Samira,1604,808,796,50.37
Lux,Leblanc,683,365,318,53.44
Lux,KSante,620,339,281,54.68
Lux,Quinn,536,269,267,50.19
Lux,FiddleSticks,903,468,435,51.83
Lux,Cassiopeia,582,276,306,47.42
Lux,Lillia,1101,622,479,56.49
Lux,Lissandra,389,170,219,43.7
Lux,Renekton,773,387,386,50.06
Lux,Annie,531,271,260,51.04
Lux,Senna,1425,690,735,48.42
Lux,Alistar,460,214,246,46.52
Lux,Briar,1625,751,874,46.22
Lux,Janna,484,253,231,52.27
Lux,Zed,1539,855,684,55.56
Lux,Smolder,1287,695,592,54
Lux,Galio,1116,546,570,48.92
Lux,Swain,1820,883,937,48.52
Lux,Tryndamere,951,491,460,51.63
Lux,Zilean,480,269,211,56.04
Lux,Bard,502,235,267,46.81
Lux,Rengar,700,413,287,59
Lux,Olaf,426,216,210,50.7
Lux,MasterYi,1784,904,880,50.67
Lux,Velkoz,1083,509,574,47
Lux,Trundle,987,454,533,46
Lux,Fiora,847,444,403,52.42
Lux,Ryze,546,356,190,65.2
Lux,Jhin,3052,1460,1592,47.84
Lux,Aphelios,1072,570,502,53.17
Lux,Hecarim,707,400,307,56.58
Lux,Syndra,954,443,511,46.44
Lux,Akshan,630,359,271,56.98
Lux,Braum,659,319,340,48.41
Lux,Singed,413,189,224,45.76
Lux,Kindred,916,483,433,52.73
Lux,Kled,327,135,192,41.28
Lux,Karma,1289,709,580,55
Lux,Ambessa,969,512,457,52.84
Lux,Rumble,238,131,107,55.04
Lux,Graves,837,456,381,54.48
Lux,Ivern,336,166,170,49.4
Lux,Udyr,627,276,351,44.02
Lux,Taric,369,199,170,53.93
Lux,Nunu,1485,729,756,49.09
Lux,Viktor,1001,478,523,47.75
Lux,Urgot,735,395,340,53.74
Lux,Lulu,1251,639,612,51.08
Lux,DrMundo,1121,450,671,40.14
Lux,Karthus,431,225,206,52.2
Lux,Ahri,2407,1435,972,59.62
Lux,Azir,597,362,235,60.64
Lux,Viego,2025,967,1058,47.75
Lux,Hwei,1314,622,692,47.34
Lux,Camille,549,282,267,51.37
Lux,Shen,1179,581,598,49.28
Lux,TwistedFate,642,340,302,52.96
Lux,Gangplank,622,258,364,41.48
Lux,Sion,1204,605,599,50.25
Lux,Belveth,447,242,205,54.14
Lux,Nidalee,406,264,142,65.02
Lux,Leona,1138,532,606,46.75
Lux,Anivia,457,246,211,53.83
Lux,Elise,1017,536,481,52.7
Lux,KogMaw,544,242,302,44.49
Lux,Jayce,559,298,261,53.31
Lux,RekSai,200,132,68,66
Mordekaiser,Yone,2004,929,1075,46.36
Mordekaiser,Darius,2036,950,1086,46.66
Mordekaiser,Yasuo,1795,946,849,52.7
Mordekaiser,Jhin,1556,818,738,52.57
Mordekaiser,Lux,2497,1286,1211,51.5
Mordekaiser,Singed,217,106,111,48.85
Mordekaiser,Shaco,845,443,402,52.43
Mordekaiser,Zed,826,482,344,58.35
Mordekaiser,Hwei,718,343,375,47.77
Mordekaiser,Fiora,555,317,238,57.12
Mordekaiser,Belveth,267,122,145,45.69
Mordekaiser,Sylas,948,480,468,50.63
Mordekaiser,Ezreal,1428,747,681,52.31
Mordekaiser,Yuumi,819,405,414,49.45
Mordekaiser,Warwick,1754,873,881,49.77
Mordekaiser,Caitlyn,2408,1214,1194,50.42
Mordekaiser,Morgana,1493,774,719,51.84
Mordekaiser,Illaoi,566,297,269,52.47
Mordekaiser,MonkeyKing,495,267,228,53.94
Mordekaiser,Tristana,853,420,433,49.24
Mordekaiser,Garen,1530,877,653,57.32
Mordekaiser,Diana,1277,666,611,52.15
Mordekaiser,Pyke,1143,671,472,58.71
Mordekaiser,Volibear,1144,567,577,49.56
Mordekaiser,Ekko,713,339,374,47.55
Mordekaiser,Kalista,446,227,219,50.9
Mordekaiser,Kayn,1594,849,745,53.26
Mordekaiser,TwistedFate,258,143,115,55.43
Mordekaiser,Smolder,750,440,310,58.67
Mordekaiser,Nautilus,1003,536,467,53.44
Mordekaiser,Renekton,451,234,217,51.88
Mordekaiser,Vex,597,314,283,52.6
Mordekaiser,Samira,986,560,426,56.8
Mordekaiser,Lulu,683,358,325,52.42
Mordekaiser,Urgot,588,279,309,47.45
Mordekaiser,Rengar,417,280,137,67.15
Mordekaiser,Ziggs,484,209,275,43.18
Mordekaiser,Trundle,630,283,347,44.92
Mordekaiser,Yorick,919,420,499,45.7
Mordekaiser,Seraphine,1084,541,543,49.91
Mordekaiser,Sivir,420,200,220,47.62
Mordekaiser,Xerath,600,316,284,52.67
Mordekaiser,KSante,471,277,194,58.81
Mordekaiser,Ashe,1612,817,795,50.68
Mordekaiser,Corki,265,171,94,64.53
Mordekaiser,Vladimir,444,191,253,43.02
Mordekaiser,Tryndamere,533,267,266,50.09
Mordekaiser,Milio,466,239,227,51.29
Mordekaiser,Gangplank,313,182,131,58.15
Mordekaiser,Mel,2150,1110,1040,51.63
Mordekaiser,Hecarim,371,198,173,53.37
Mordekaiser,Heimerdinger,589,269,320,45.67
Mordekaiser,Kindred,519,298,221,57.42
Mordekaiser,Katarina,808,479,329,59.28
Mordekaiser,Janna,178,84,94,47.19
Mordekaiser,Teemo,1292,654,638,50.62
Mordekaiser,LeeSin,824,435,389,52.79
Mordekaiser,Nami,825,392,433,47.52
Mordekaiser,Amumu,935,506,429,54.12
Mordekaiser,Kaisa,1292,677,615,52.4
Mordekaiser,Rakan,433,272,161,62.82
Mordekaiser,Gnar,322,183,139,56.83
Mordekaiser,Viego,1187,638,549,53.75
Mordekaiser,TahmKench,1150,584,566,50.78
Mordekaiser,Akshan,331,144,187,43.5
Mordekaiser,FiddleSticks,513,296,217,57.7
Mordekaiser,Nasus,885,461,424,52.09
Mordekaiser,Neeko,744,349,395,46.91
Mordekaiser,MissFortune,2283,1154,1129,50.55
Mordekaiser,Leblanc,344,189,155,54.94
Mordekaiser,Karma,585,302,283,51.62
Mordekaiser,Fizz,589,303,286,51.44
Mordekaiser,Aatrox,999,591,408,59.16
Mordekaiser,Aurora,969,562,407,58
Mordekaiser,Brand,733,372,361,50.75
Mordekaiser,Gragas,471,308,163,65.39
Mordekaiser,Kennen,372,210,162,56.45
Mordekaiser,Vayne,1102,530,572,48.09
Mordekaiser,Thresh,1254,666,588,53.11
Mordekaiser,Akali,909,493,416,54.24
Mordekaiser,Jinx,1946,1048,898,53.85
Mordekaiser,Xayah,648,365,283,56.33
Mordekaiser,Senna,822,387,435,47.08
Mordekaiser,Shen,550,280,270,50.91
Mordekaiser,Rammus,282,147,135,52.13
Mordekaiser,Cassiopeia,414,204,210,49.28
Mordekaiser,Nunu,881,486,395,55.16
Mordekaiser,Zeri,383,230,153,60.05
Mordekaiser,Sion,642,316,326,49.22
Mordekaiser,Ahri,1270,609,661,47.95
Mordekaiser,Anivia,295,144,151,48.81
Mordekaiser,Poppy,661,319,342,48.26
Mordekaiser,Riven,440,263,177,59.77
Mordekaiser,Briar,1021,495,526,48.48
Mordekaiser,Jayce,329,199,130,60.49
Mordekaiser,Swain,1056,581,475,55.02
Mordekaiser,Sett,1871,1014,857,54.2
Mordekaiser,Pantheon,1531,814,717,53.17
Mordekaiser,Braum,394,212,182,53.81
Mordekaiser,Taric,239,122,117,51.05
Mordekaiser,Chogath,1278,728,550,56.96
Mordekaiser,Rell,419,224,195,53.46
Mordekaiser,Olaf,299,148,151,49.5
Mordekaiser,Evelynn,568,367,201,64.61
Mordekaiser,Leona,746,430,316,57.64
Mordekaiser,Talon,495,286,209,57.78
Mordekaiser,Maokai,407,218,189,53.56
Mordekaiser,Zyra,616,320,296,51.95
Mordekaiser,Malphite,772,446,326,57.77
Mordekaiser,Veigar,1156,530,626,45.85
Mordekaiser,Blitzcrank,772,389,383,50.39
Mordekaiser,Orianna,332,159,173,47.89
Mordekaiser,Draven,519,269,250,51.83
Mordekaiser,Sejuani,332,148,184,44.58
Mordekaiser,Gwen,658,358,300,54.41
Mordekaiser,Malzahar,675,341,334,50.52
Mordekaiser,Galio,750,377,373,50.27
Mordekaiser,MasterYi,1134,537,597,47.35
Mordekaiser,Varus,769,388,381,50.46
Mordekaiser,DrMundo,519,251,268,48.36
Mordekaiser,Nilah,545,285,260,52.29
Mordekaiser,Aphelios,708,366,342,51.69
Mordekaiser,Nocturne,728,395,333,54.26
Mordekaiser,Udyr,340,206,134,60.59
Mordekaiser,JarvanIV,312,167,145,53.53
Mordekaiser,Soraka,624,307,317,49.2
Mordekaiser,Viktor,562,296,266,52.67
Mordekaiser,Karthus,214,111,103,51.87
Mordekaiser,Qiyana,324,194,130,59.88
Mordekaiser,Lucian,508,248,260,48.82
Mordekaiser,Naafiri,463,288,175,62.2
Mordekaiser,Zilean,282,177,105,62.77
Mordekaiser,Kassadin,152,66,86,43.42
Mordekaiser,Graves,476,269,207,56.51
Mordekaiser,Ivern,180,103,77,57.22
Mordekaiser,Velkoz,572,258,314,45.1
Mordekaiser,Ryze,213,141,72,66.2
Mordekaiser,Sona,392,196,196,50
Mordekaiser,Kayle,811,375,436,46.24
Mordekaiser,Irelia,706,419,287,59.35
Mordekaiser,Jax,811,411,400,50.68
Mordekaiser,Khazix,651,336,315,51.61
Mordekaiser,Camille,371,223,148,60.11
Mordekaiser,Shyvana,336,141,195,41.96
Mordekaiser,Taliyah,237,131,106,55.27
Mordekaiser,Twitch,813,410,403,50.43
Mordekaiser,KogMaw,327,197,130,60.24
Mordekaiser,Skarner,321,209,112,65.11
Mordekaiser,Azir,334,209,125,62.57
Mordekaiser,Vi,745,349,396,46.85
Mordekaiser,AurelionSol,444,240,204,54.05
Mordekaiser,Zac,348,155,193,44.54
Mordekaiser,XinZhao,519,260,259,50.1
Mordekaiser,Rumble,160,94,66,58.75
Mordekaiser,Zoe,406,226,180,55.67
Mordekaiser,Renata,251,98,153,39.04
Mordekaiser,Ornn,427,195,232,45.67
Mordekaiser,Lillia,610,350,260,57.38
Mordekaiser,Annie,237,151,86,63.71
Mordekaiser,Syndra,508,281,227,55.31
Mordekaiser,Elise,459,224,235,48.8
Mordekaiser,Kled,211,134,77,63.51
Mordekaiser,Alistar,282,172,110,60.99
Mordekaiser,Nidalee,222,123,99,55.41
Mordekaiser,Quinn,316,176,140,55.7
Mordekaiser,Ambessa,489,262,227,53.58
Mordekaiser,Bard,218,96,122,44.04
Mordekaiser,Lissandra,225,133,92,59.11
Mordekaiser,RekSai,140,67,73,47.86
Qiyana,Yone,364,186,178,51.1
Qiyana,Darius,333,120,213,36.04
Qiyana,Yasuo,400,167,233,41.75
Qiyana,Jhin,395,222,173,56.2
Qiyana,Lux,619,291,328,47.01
Qiyana,Fiora,99,42,57,42.42
Qiyana,Belveth,66,35,31,53.03
Qiyana,Sylas,221,96,125,43.44
Qiyana,Ezreal,371,185,186,49.87
Qiyana,Yuumi,214,77,137,35.98
Qiyana,Illaoi,128,69,59,53.91
Qiyana,Twitch,156,71,85,45.51
Qiyana,Velkoz,144,68,76,47.22
Qiyana,MonkeyKing,81,34,47,41.98
Qiyana,Tristana,194,88,106,45.36
Qiyana,Morgana,292,124,168,42.47
Qiyana,Teemo,261,105,156,40.23
Qiyana,Poppy,92,47,45,51.09
Qiyana,Akali,213,117,96,54.93
Qiyana,Caitlyn,519,218,301,42
Qiyana,Leona,180,75,105,41.67
Qiyana,Zed,303,161,142,53.14
Qiyana,Shaco,163,67,96,41.1
Qiyana,Anivia,34,13,21,38.24
Qiyana,Garen,249,114,135,45.78
Qiyana,FiddleSticks,100,49,51,49
Qiyana,Brand,101,47,54,46.53
Qiyana,Yorick,175,89,86,50.86
Qiyana,Katarina,201,114,87,56.72
Qiyana,Lucian,82,23,59,28.05
Qiyana,Nautilus,246,99,147,40.24
Qiyana,Chogath,251,125,126,49.8
Qiyana,Talon,148,64,84,43.24
Qiyana,Nilah,126,55,71,43.65
Qiyana,Milio,143,70,73,48.95
Qiyana,Kindred,117,52,65,44.44
Qiyana,AurelionSol,91,45,46,49.45
Qiyana,Kalista,106,38,68,35.85
Qiyana,Kayle,130,57,73,43.85
Qiyana,Shyvana,43,21,22,48.84
Qiyana,Galio,111,54,57,48.65
Qiyana,Mel,576,299,277,51.91
Qiyana,Blitzcrank,141,68,73,48.23
Qiyana,Urgot,101,46,55,45.54
Qiyana,Rakan,145,54,91,37.24
Qiyana,Kennen,63,22,41,34.92
Qiyana,JarvanIV,87,42,45,48.28
Qiyana,Karma,142,73,69,51.41
Qiyana,Soraka,136,57,79,41.91
Qiyana,Mordekaiser,324,130,194,40.12
Qiyana,Ekko,188,83,105,44.15
Qiyana,Irelia,173,86,87,49.71
Qiyana,Swain,292,114,178,39.04
Qiyana,Aatrox,194,123,71,63.4
Qiyana,Warwick,298,105,193,35.23
Qiyana,Fizz,125,62,63,49.6
Qiyana,Pyke,246,129,117,52.44
Qiyana,KSante,52,30,22,57.69
Qiyana,Draven,125,59,66,47.2
Qiyana,Renata,52,17,35,32.69
Qiyana,Hwei,157,94,63,59.87
Qiyana,Jinx,536,245,291,45.71
Qiyana,Thresh,270,105,165,38.89
Qiyana,Volibear,236,121,115,51.27
Qiyana,Sett,377,125,252,33.16
Qiyana,Khazix,123,55,68,44.72
Qiyana,Ahri,274,108,166,39.42
Qiyana,DrMundo,120,33,87,27.5
Qiyana,Kayn,291,132,159,45.36
Qiyana,Sivir,68,34,34,50
Qiyana,Vi,194,73,121,37.63
Qiyana,Lulu,173,90,83,52.02
Qiyana,TahmKench,208,104,104,50
Qiyana,Veigar,211,90,121,42.65
Qiyana,Ashe,413,202,211,48.91
Qiyana,Zilean,81,24,57,29.63
Qiyana,Ornn,118,67,51,56.78
Qiyana,Diana,273,124,149,45.42
Qiyana,Kled,41,20,21,48.78
Qiyana,Maokai,140,64,76,45.71
Qiyana,Riven,73,19,54,26.03
Qiyana,Orianna,94,41,53,43.62
Qiyana,Vladimir,148,90,58,60.81
Qiyana,Aphelios,155,69,86,44.52
Qiyana,Rengar,117,45,72,38.46
Qiyana,Rell,111,48,63,43.24
Qiyana,Gragas,164,98,66,59.76
Qiyana,Leblanc,45,20,25,44.44
Qiyana,Jax,199,67,132,33.67
Qiyana,Malphite,169,55,114,32.54
Qiyana,Udyr,65,21,44,32.31
Qiyana,Bard,57,26,31,45.61
Qiyana,Singed,80,40,40,50
Qiyana,MissFortune,447,184,263,41.16
Qiyana,Tryndamere,113,49,64,43.36
Qiyana,Sion,197,82,115,41.62
Qiyana,Graves,108,67,41,62.04
Qiyana,Gnar,79,24,55,30.38
Qiyana,MasterYi,238,92,146,38.66
Qiyana,LeeSin,183,59,124,32.24
Qiyana,Azir,105,64,41,60.95
Qiyana,Nami,208,63,145,30.29
Qiyana,Nasus,204,90,114,44.12
Qiyana,Hecarim,127,63,64,49.61
Qiyana,Vayne,283,128,155,45.23
Qiyana,Seraphine,201,87,114,43.28
Qiyana,Janna,57,28,29,49.12
Qiyana,Pantheon,315,175,140,55.56
Qiyana,Camille,81,40,41,49.38
Qiyana,Syndra,110,39,71,35.45
Qiyana,Nunu,140,72,68,51.43
Qiyana,Ryze,83,39,44,46.99
Qiyana,Evelynn,141,45,96,31.91
Qiyana,Quinn,76,24,52,31.58
Qiyana,Viego,301,153,148,50.83
Qiyana,Xerath,121,51,70,42.15
Qiyana,Aurora,217,126,91,58.06
Qiyana,Briar,247,102,145,41.3
Qiyana,Kassadin,50,31,19,62
Qiyana,Gwen,172,91,81,52.91
Qiyana,Nocturne,145,72,73,49.66
Qiyana,Ambessa,153,38,115,24.84
Qiyana,Gangplank,141,65,76,46.1
Qiyana,Cassiopeia,85,38,47,44.71
Qiyana,Shen,155,53,102,34.19
Qiyana,Rammus,43,10,33,23.26
Qiyana,Heimerdinger,96,40,56,41.67
Qiyana,Vex,150,56,94,37.33
Qiyana,Amumu,219,74,145,33.79
Qiyana,Kaisa,213,103,110,48.36
Qiyana,Varus,188,77,111,40.96
Qiyana,Senna,276,106,170,38.41
Qiyana,XinZhao,126,61,65,48.41
Qiyana,Malzahar,144,48,96,33.33
Qiyana,Sejuani,95,56,39,58.95
Qiyana,Naafiri,109,54,55,49.54
Qiyana,Annie,56,21,35,37.5
Qiyana,Trundle,127,52,75,40.94
Qiyana,KogMaw,54,36,18,66.67
Qiyana,Ziggs,49,29,20,59.18
Qiyana,Karthus,64,34,30,53.13
Qiyana,Nidalee,60,35,25,58.33
Qiyana,Taliyah,60,36,24,60
Qiyana,Renekton,103,35,68,33.98
Qiyana,Ivern,64,37,27,57.81
Qiyana,Zyra,126,48,78,38.1
Qiyana,Viktor,177,97,80,54.8
Qiyana,Samira,163,73,90,44.79
Qiyana,RekSai,39,16,23,41.03
Qiyana,Neeko,116,46,70,39.66
Qiyana,Akshan,55,18,37,32.73
Qiyana,Braum,79,55,24,69.62
Qiyana,Taric,35,29,6,82.86
Qiyana,Lissandra,49,6,43,12.24
Qiyana,Rumble,78,35,43,44.87
Qiyana,Lillia,159,97,62,61.01
Qiyana,Zeri,112,62,50,55.36
Qiyana,Elise,129,76,53,58.91
Qiyana,Olaf,50,28,22,56
Qiyana,Sona,65,29,36,44.62
Qiyana,Zoe,101,50,51,49.5
Qiyana,Zac,79,35,44,44.3
Qiyana,Corki,66,33,33,50
Qiyana,Xayah,139,65,74,46.76
Qiyana,Smolder,127,64,63,50.39
Qiyana,Jayce,117,50,67,42.74
Qiyana,TwistedFate,70,38,32,54.29
Qiyana,Skarner,68,23,45,33.82
Qiyana,Alistar,109,71,38,65.14
Irelia,Yone,1178,624,554,52.97
Irelia,Darius,1015,476,539,46.9
Irelia,Yasuo,1234,681,553,55.19
Irelia,Jhin,981,446,535,45.46
Irelia,Lux,1525,740,785,48.52
Irelia,Warwick,882,399,483,45.24
Irelia,Caitlyn,1322,700,622,52.95
Irelia,Morgana,677,298,379,44.02
Irelia,Yorick,542,221,321,40.77
Irelia,Kayn,945,483,462,51.11
Irelia,Ryze,139,83,56,59.71
Irelia,Pantheon,911,402,509,44.13
Irelia,TahmKench,636,307,329,48.27
Irelia,Malphite,565,231,334,40.88
Irelia,Aphelios,453,216,237,47.68
Irelia,TwistedFate,184,103,81,55.98
Irelia,Gnar,292,162,130,55.48
Irelia,Jax,472,248,224,52.54
Irelia,Neeko,441,212,229,48.07
Irelia,Renekton,204,103,101,50.49
Irelia,JarvanIV,227,119,108,52.42
Irelia,Mel,1191,559,632,46.94
Irelia,Sylas,513,227,286,44.25
Irelia,Singed,143,68,75,47.55
Irelia,Graves,230,123,107,53.48
Irelia,Fizz,279,108,171,38.71
Irelia,Ziggs,228,106,122,46.49
Irelia,Sett,913,412,501,45.13
Irelia,Amumu,554,230,324,41.52
Irelia,Poppy,300,143,157,47.67
Irelia,Zed,661,285,376,43.12
Irelia,Sivir,213,97,116,45.54
Irelia,Blitzcrank,462,206,256,44.59
Irelia,Gangplank,260,127,133,48.85
Irelia,Kaisa,863,468,395,54.23
Irelia,Galio,369,200,169,54.2
Irelia,Cassiopeia,228,120,108,52.63
Irelia,Hwei,478,273,205,57.11
Irelia,Gwen,368,189,179,51.36
Irelia,Skarner,164,90,74,54.88
Irelia,Seraphine,670,280,390,41.79
Irelia,Ornn,255,131,124,51.37
Irelia,MissFortune,1160,563,597,48.53
Irelia,Brand,367,183,184,49.86
Irelia,Teemo,619,268,351,43.3
Irelia,Shaco,495,273,222,55.15
Irelia,Leblanc,168,103,65,61.31
Irelia,Ezreal,873,426,447,48.8
Irelia,Thresh,652,324,328,49.69
Irelia,Illaoi,274,92,182,33.58
Irelia,Aatrox,617,336,281,54.46
Irelia,Ashe,1009,476,533,47.18
Irelia,Gragas,335,182,153,54.33
Irelia,Garen,792,374,418,47.22
Irelia,Volibear,717,309,408,43.1
Irelia,Tristana,534,268,266,50.19
Irelia,Zeri,271,142,129,52.4
Irelia,Zyra,411,218,193,53.04
Irelia,Jayce,266,126,140,47.37
Irelia,Rengar,267,153,114,57.3
Irelia,Swain,602,302,300,50.17
Irelia,Sona,218,120,98,55.05
Irelia,Briar,467,206,261,44.11
Irelia,Kennen,205,95,110,46.34
Irelia,Rammus,195,90,105,46.15
Irelia,Pyke,651,427,224,65.59
Irelia,Riven,200,131,69,65.5
Irelia,Taliyah,131,73,58,55.73
Irelia,Draven,327,187,140,57.19
Irelia,Lulu,373,185,188,49.6
Irelia,Akali,605,310,295,51.24
Irelia,Naafiri,246,128,118,52.03
Irelia,Kayle,458,257,201,56.11
Irelia,Smolder,431,192,239,44.55
Irelia,Khazix,330,165,165,50
Irelia,Sion,433,205,228,47.34
Irelia,FiddleSticks,243,109,134,44.86
Irelia,Zilean,177,102,75,57.63
Irelia,Tryndamere,302,128,174,42.38
Irelia,Nidalee,137,78,59,56.93
Irelia,Aurora,578,226,352,39.1
Irelia,Nami,507,202,305,39.84
Irelia,Nunu,478,248,230,51.88
Irelia,Rakan,236,112,124,47.46
Irelia,Soraka,406,192,214,47.29
Irelia,Lillia,337,145,192,43.03
Irelia,Orianna,198,74,124,37.37
Irelia,Velkoz,363,188,175,51.79
Irelia,Chogath,615,308,307,50.08
Irelia,Veigar,626,321,305,51.28
Irelia,Evelynn,293,166,127,56.66
Irelia,Lissandra,181,101,80,55.8
Irelia,Nilah,260,127,133,48.85
Irelia,Diana,727,372,355,51.17
Irelia,MonkeyKing,288,126,162,43.75
Irelia,Vex,303,154,149,50.83
Irelia,Vayne,573,264,309,46.07
Irelia,Ekko,431,175,256,40.6
Irelia,Senna,469,240,229,51.17
Irelia,Olaf,64,28,36,43.75
Irelia,Jinx,1179,596,583,50.55
Irelia,Leona,439,180,259,41
Irelia,KSante,246,136,110,55.28
Irelia,Zac,175,92,83,52.57
Irelia,Azir,187,88,99,47.06
Irelia,Ahri,820,426,394,51.95
Irelia,Twitch,415,212,203,51.08
Irelia,MasterYi,650,345,305,53.08
Irelia,Nasus,401,195,206,48.63
Irelia,Malzahar,422,209,213,49.53
Irelia,Braum,204,93,111,45.59
Irelia,Syndra,363,160,203,44.08
Irelia,Karma,323,150,173,46.44
Irelia,Nautilus,626,286,340,45.69
Irelia,Lucian,282,132,150,46.81
Irelia,Samira,520,249,271,47.88
Irelia,Nocturne,552,203,349,36.78
Irelia,Trundle,271,151,120,55.72
Irelia,Heimerdinger,281,118,163,41.99
Irelia,Udyr,157,78,79,49.68
Irelia,Milio,270,99,171,36.67
Irelia,Vladimir,327,152,175,46.48
Irelia,Qiyana,173,87,86,50.29
Irelia,Vi,461,283,178,61.39
Irelia,Varus,352,150,202,42.61
Irelia,Mordekaiser,706,287,419,40.65
Irelia,Hecarim,168,83,85,49.4
Irelia,Karthus,147,71,76,48.3
Irelia,Kassadin,133,66,67,49.62
Irelia,Viktor,371,167,204,45.01
Irelia,LeeSin,488,262,226,53.69
Irelia,Kalista,266,148,118,55.64
Irelia,Sejuani,192,79,113,41.15
Irelia,Xayah,336,142,194,42.26
Irelia,Quinn,170,87,83,51.18
Irelia,Katarina,564,325,239,57.62
Irelia,Janna,161,97,64,60.25
Irelia,Renata,140,73,67,52.14
Irelia,Maokai,291,139,152,47.77
Irelia,Urgot,251,104,147,41.43
Irelia,XinZhao,278,122,156,43.88
Irelia,Annie,111,57,54,51.35
Irelia,KogMaw,201,82,119,40.8
Irelia,Shen,402,169,233,42.04
Irelia,Yuumi,574,274,300,47.74
Irelia,Rell,259,123,136,47.49
Irelia,Anivia,135,74,61,54.81
Irelia,Belveth,154,80,74,51.95
Irelia,AurelionSol,226,80,146,35.4
Irelia,DrMundo,307,125,182,40.72
Irelia,Viego,616,309,307,50.16
Irelia,Bard,115,64,51,55.65
Irelia,Kindred,288,144,144,50
Irelia,Zoe,289,156,133,53.98
Irelia,Talon,343,193,150,56.27
Irelia,Ambessa,323,180,143,55.73
Irelia,Kled,98,44,54,44.9
Irelia,Xerath,352,139,213,39.49
Irelia,Alistar,195,84,111,43.08
Irelia,Elise,319,151,168,47.34
Irelia,RekSai,98,23,75,23.47
Irelia,Corki,111,55,56,49.55
Irelia,Ivern,129,66,63,51.16
Irelia,Taric,88,46,42,52.27
Irelia,Rumble,81,50,31,61.73
Irelia,Fiora,275,129,146,46.91
Irelia,Camille,172,48,124,27.91
Irelia,Akshan,243,129,114,53.09
Irelia,Shyvana,155,88,67,56.77
Ezreal,Yone,1988,996,992,50.1
Ezreal,Darius,2000,910,1090,45.5
Ezreal,Yasuo,2037,959,1078,47.08
Ezreal,Jhin,2035,871,1164,42.8
Ezreal,Lux,2625,1282,1343,48.84
Ezreal,Gwen,643,322,321,50.08
Ezreal,Vi,954,401,553,42.03
Ezreal,Zed,993,488,505,49.14
Ezreal,Soraka,571,265,306,46.41
Ezreal,Mordekaiser,1428,681,747,47.69
Ezreal,Kindred,608,283,325,46.55
Ezreal,Qiyana,371,186,185,50.13
Ezreal,Ashe,2131,994,1137,46.64
Ezreal,Sona,408,153,255,37.5
Ezreal,Teemo,1384,596,788,43.06
Ezreal,MonkeyKing,551,285,266,51.72
Ezreal,Malzahar,889,374,515,42.07
Ezreal,Caitlyn,3082,1471,1611,47.73
Ezreal,Morgana,1462,746,716,51.03
Ezreal,Garen,1556,694,862,44.6
Ezreal,Briar,988,429,559,43.42
Ezreal,Akali,1137,527,610,46.35
Ezreal,MissFortune,2261,1012,1249,44.76
Ezreal,Kassadin,248,153,95,61.69
Ezreal,Kayn,1584,729,855,46.02
Ezreal,Kayle,870,384,486,44.14
Ezreal,RekSai,118,54,64,45.76
Ezreal,Seraphine,1124,534,590,47.51
Ezreal,Irelia,873,447,426,51.2
Ezreal,Warwick,1468,651,817,44.35
Ezreal,Galio,787,353,434,44.85
Ezreal,Sivir,564,200,364,35.46
Ezreal,Rell,632,314,318,49.68
Ezreal,Sett,1587,697,890,43.92
Ezreal,Zac,415,222,193,53.49
Ezreal,Yorick,930,409,521,43.98
Ezreal,Xerath,710,336,374,47.32
Ezreal,Fiora,464,249,215,53.66
Ezreal,FiddleSticks,488,212,276,43.44
Ezreal,Syndra,571,253,318,44.31
Ezreal,Vayne,1117,527,590,47.18
Ezreal,Viego,1278,598,680,46.79
Ezreal,AurelionSol,457,203,254,44.42
Ezreal,Nautilus,1200,565,635,47.08
Ezreal,Jinx,2232,1052,1180,47.13
Ezreal,Lulu,1109,527,582,47.52
Ezreal,Camille,485,264,221,54.43
Ezreal,Katarina,832,375,457,45.07
Ezreal,Zyra,707,319,388,45.12
Ezreal,Tryndamere,510,270,240,52.94
Ezreal,Gragas,629,295,334,46.9
Ezreal,Kalista,559,272,287,48.66
Ezreal,Twitch,778,358,420,46.02
Ezreal,Graves,587,301,286,51.28
Ezreal,Sylas,1317,692,625,52.54
Ezreal,Leona,931,431,500,46.29
Ezreal,KSante,472,244,228,51.69
Ezreal,Nasus,761,346,415,45.47
Ezreal,TahmKench,1170,485,685,41.45
Ezreal,Fizz,514,241,273,46.89
Ezreal,Janna,319,142,177,44.51
Ezreal,Nocturne,796,418,378,52.51
Ezreal,Thresh,1470,659,811,44.83
Ezreal,Shen,701,297,404,42.37
Ezreal,Rammus,260,120,140,46.15
Ezreal,Cassiopeia,389,185,204,47.56
Ezreal,Udyr,418,192,226,45.93
Ezreal,Veigar,1113,495,618,44.47
Ezreal,Kennen,391,196,195,50.13
Ezreal,XinZhao,610,246,364,40.33
Ezreal,Kaisa,1776,887,889,49.94
Ezreal,Karthus,251,122,129,48.61
Ezreal,Nilah,516,209,307,40.5
Ezreal,Braum,463,205,258,44.28
Ezreal,Maokai,494,193,301,39.07
Ezreal,Pantheon,1781,851,930,47.78
Ezreal,Aurora,1003,485,518,48.35
Ezreal,Yuumi,964,423,541,43.88
Ezreal,Poppy,665,317,348,47.67
Ezreal,Khazix,741,360,381,48.58
Ezreal,Tristana,1053,519,534,49.29
Ezreal,Neeko,693,274,419,39.54
Ezreal,Nunu,834,366,468,43.88
Ezreal,Vladimir,524,252,272,48.09
Ezreal,Gnar,474,303,171,63.92
Ezreal,Akshan,312,152,160,48.72
Ezreal,Jax,784,373,411,47.58
Ezreal,Velkoz,657,360,297,54.79
Ezreal,Xayah,655,325,330,49.62
Ezreal,Rakan,439,187,252,42.6
Ezreal,MasterYi,1077,521,556,48.38
Ezreal,Shaco,990,542,448,54.75
Ezreal,Azir,402,184,218,45.77
Ezreal,Rengar,561,326,235,58.11
Ezreal,Pyke,1198,613,585,51.17
Ezreal,Lucian,690,295,395,42.75
Ezreal,Renekton,496,206,290,41.53
Ezreal,Zoe,452,221,231,48.89
Ezreal,LeeSin,1130,618,512,54.69
Ezreal,Hwei,768,320,448,41.67
Ezreal,Lillia,625,267,358,42.72
Ezreal,Milio,607,264,343,43.49
Ezreal,Diana,1292,606,686,46.9
Ezreal,Olaf,195,100,95,51.28
Ezreal,Volibear,1138,472,666,41.48
Ezreal,Mel,2252,1154,1098,51.24
Ezreal,Ambessa,717,346,371,48.26
Ezreal,Evelynn,508,259,249,50.98
Ezreal,Anivia,314,166,148,52.87
Ezreal,Singed,270,92,178,34.07
Ezreal,Karma,806,358,448,44.42
Ezreal,Kled,213,62,151,29.11
Ezreal,Zeri,442,226,216,51.13
Ezreal,Swain,1178,528,650,44.82
Ezreal,Talon,590,353,237,59.83
Ezreal,Varus,1001,426,575,42.56
Ezreal,DrMundo,662,300,362,45.32
Ezreal,Ekko,857,368,489,42.94
Ezreal,Amumu,912,422,490,46.27
Ezreal,Ryze,402,168,234,41.79
Ezreal,Belveth,361,168,193,46.54
Ezreal,Nami,1014,458,556,45.17
Ezreal,Ornn,412,147,265,35.68
Ezreal,Blitzcrank,783,386,397,49.3
Ezreal,Elise,766,377,389,49.22
Ezreal,Heimerdinger,656,307,349,46.8
Ezreal,Vex,535,290,245,54.21
Ezreal,Senna,982,421,561,42.87
Ezreal,Brand,681,304,377,44.64
Ezreal,Sion,836,354,482,42.34
Ezreal,Jayce,543,276,267,50.83
Ezreal,KogMaw,366,177,189,48.36
Ezreal,Urgot,474,179,295,37.76
Ezreal,Skarner,281,106,175,37.72
Ezreal,Ziggs,457,195,262,42.67
Ezreal,Leblanc,464,235,229,50.65
Ezreal,Riven,441,225,216,51.02
Ezreal,Annie,295,150,145,50.85
Ezreal,Nidalee,249,146,103,58.63
Ezreal,Orianna,582,278,304,47.77
Ezreal,Smolder,902,433,469,48
Ezreal,Chogath,1337,631,706,47.2
Ezreal,Naafiri,383,171,212,44.65
Ezreal,Aatrox,1099,583,516,53.05
Ezreal,Aphelios,799,405,394,50.69
Ezreal,Alistar,352,201,151,57.1
Ezreal,Shyvana,291,129,162,44.33
Ezreal,Rumble,236,95,141,40.25
Ezreal,Hecarim,382,152,230,39.79
Ezreal,Samira,975,471,504,48.31
Ezreal,Bard,369,165,204,44.72
Ezreal,Illaoi,466,192,274,41.2
Ezreal,Draven,666,356,310,53.45
Ezreal,Malphite,914,400,514,43.76
Ezreal,Taliyah,282,132,150,46.81
Ezreal,Quinn,373,169,204,45.31
Ezreal,Renata,269,160,109,59.48
Ezreal,Trundle,505,198,307,39.21
Ezreal,JarvanIV,458,172,286,37.55
Ezreal,Ahri,1368,654,714,47.81
Ezreal,Sejuani,468,223,245,47.65
Ezreal,Corki,404,209,195,51.73
Ezreal,Ivern,258,113,145,43.8
Ezreal,Zilean,289,136,153,47.06
Ezreal,Lissandra,297,152,145,51.18
Ezreal,Gangplank,472,235,237,49.79
Ezreal,TwistedFate,397,195,202,49.12
Ezreal,Viktor,759,312,447,41.11
Ezreal,Taric,256,104,152,40.63
Rell,Yone,584,285,299,48.8
Rell,Darius,686,341,345,49.71
Rell,Yasuo,626,318,308,50.8
Rell,Jhin,590,269,321,45.59
Rell,Lux,779,401,378,51.48
Rell,Ryze,100,59,41,59
Rell,Warwick,559,310,249,55.46
Rell,Morgana,422,196,226,46.45
Rell,Xayah,252,100,152,39.68
Rell,Veigar,396,188,208,47.47
Rell,Poppy,182,84,98,46.15
Rell,Katarina,301,169,132,56.15
Rell,Twitch,230,123,107,53.48
Rell,Teemo,483,225,258,46.58
Rell,Shaco,318,177,141,55.66
Rell,Leblanc,115,52,63,45.22
Rell,Ezreal,632,318,314,50.32
Rell,Thresh,518,279,239,53.86
Rell,FiddleSticks,182,86,96,47.25
Rell,Syndra,183,78,105,42.62
Rell,Kalista,130,59,71,45.38
Rell,Mel,712,333,379,46.77
Rell,Singed,105,47,58,44.76
Rell,Pyke,371,205,166,55.26
Rell,Volibear,387,223,164,57.62
Rell,Lillia,238,127,111,53.36
Rell,Vladimir,192,72,120,37.5
Rell,Jinx,522,207,315,39.66
Rell,Lulu,174,107,67,61.49
Rell,Yorick,293,90,203,30.72
Rell,Gragas,226,124,102,54.87
Rell,Zac,161,81,80,50.31
Rell,Amumu,417,189,228,45.32
Rell,Chogath,391,185,206,47.31
Rell,Kennen,124,52,72,41.94
Rell,Rammus,95,36,59,37.89
Rell,Caitlyn,751,386,365,51.4
Rell,Zeri,114,53,61,46.49
Rell,Aatrox,336,147,189,43.75
Rell,Belveth,95,44,51,46.32
Rell,Hwei,235,126,109,53.62
Rell,TahmKench,402,235,167,58.46
Rell,Nasus,231,103,128,44.59
Rell,Udyr,135,69,66,51.11
Rell,Ashe,616,312,304,50.65
Rell,Alistar,139,82,57,58.99
Rell,Olaf,53,33,20,62.26
Rell,Mordekaiser,419,195,224,46.54
Rell,Ornn,114,60,54,52.63
Rell,Vi,287,144,143,50.17
Rell,Anivia,101,30,71,29.7
Rell,Yuumi,342,185,157,54.09
Rell,Ekko,236,106,130,44.92
Rell,Nami,314,144,170,45.86
Rell,Jayce,84,48,36,57.14
Rell,DrMundo,173,96,77,55.49
Rell,TwistedFate,125,71,54,56.8
Rell,Samira,392,215,177,54.85
Rell,Seraphine,334,179,155,53.59
Rell,MasterYi,348,172,176,49.43
Rell,Urgot,159,63,96,39.62
Rell,Xerath,198,91,107,45.96
Rell,Tristana,320,178,142,55.63
Rell,Garen,547,290,257,53.02
Rell,Briar,242,125,117,51.65
Rell,Zed,296,137,159,46.28
Rell,Corki,91,50,41,54.95
Rell,Pantheon,515,259,256,50.29
Rell,Diana,390,239,151,61.28
Rell,MissFortune,679,284,395,41.83
Rell,Hecarim,94,57,37,60.64
Rell,Orianna,211,105,106,49.76
Rell,Zyra,240,109,131,45.42
Rell,Karthus,89,52,37,58.43
Rell,Kassadin,100,51,49,51
Rell,Nunu,258,132,126,51.16
Rell,Kaisa,488,242,246,49.59
Rell,Jax,245,105,140,42.86
Rell,RekSai,51,17,34,33.33
Rell,Brand,233,111,122,47.64
Rell,Galio,243,73,170,30.04
Rell,Viego,380,202,178,53.16
Rell,Rakan,175,82,93,46.86
Rell,Ahri,505,248,257,49.11
Rell,Fiora,153,87,66,56.86
Rell,LeeSin,318,133,185,41.82
Rell,Milio,167,74,93,44.31
Rell,Kindred,150,79,71,52.67
Rell,Sett,642,315,327,49.07
Rell,Draven,179,88,91,49.16
Rell,Kayn,467,228,239,48.82
Rell,Akali,332,177,155,53.31
Rell,Sivir,156,86,70,55.13
Rell,Skarner,151,72,79,47.68
Rell,Zilean,118,59,59,50
Rell,Tryndamere,184,115,69,62.5
Rell,Bard,75,38,37,50.67
Rell,Leona,365,178,187,48.77
Rell,JarvanIV,110,39,71,35.45
Rell,Lucian,156,82,74,52.56
Rell,Soraka,229,107,122,46.72
Rell,Riven,161,97,64,60.25
Rell,Karma,242,114,128,47.11
Rell,Sylas,289,122,167,42.21
Rell,Talon,197,112,85,56.85
Rell,Irelia,259,136,123,52.51
Rell,Fizz,134,52,82,38.81
Rell,Graves,237,113,124,47.68
Rell,Neeko,208,131,77,62.98
Rell,Gnar,113,65,48,57.52
Rell,Evelynn,199,94,105,47.24
Rell,Heimerdinger,172,91,81,52.91
Rell,Kayle,179,90,89,50.28
Rell,Swain,376,145,231,38.56
Rell,Aphelios,240,114,126,47.5
Rell,Blitzcrank,299,134,165,44.82
Rell,Trundle,149,89,60,59.73
Rell,Elise,207,120,87,57.97
Rell,Malzahar,289,152,137,52.6
Rell,Cassiopeia,180,95,85,52.78
Rell,Ambessa,176,88,88,50
Rell,Qiyana,111,63,48,56.76
Rell,Akshan,119,47,72,39.5
Rell,KSante,146,70,76,47.95
Rell,Aurora,341,174,167,51.03
Rell,Smolder,257,112,145,43.58
Rell,Lissandra,94,23,71,24.47
Rell,Senna,271,134,137,49.45
Rell,Renata,131,49,82,37.4
Rell,Nidalee,82,36,46,43.9
Rell,Annie,133,74,59,55.64
Rell,Sona,98,49,49,50
Rell,Gangplank,118,30,88,25.42
Rell,Shen,232,133,99,57.33
Rell,Viktor,197,71,126,36.04
Rell,Khazix,206,72,134,34.95
Rell,Janna,163,66,97,40.49
Rell,Vayne,328,165,163,50.3
Rell,Nocturne,290,123,167,42.41
Rell,Malphite,212,108,104,50.94
Rell,Gwen,197,101,96,51.27
Rell,Renekton,132,41,91,31.06
Rell,Illaoi,151,56,95,37.09
Rell,Rengar,130,75,55,57.69
Rell,Varus,216,125,91,57.87
Rell,Velkoz,177,80,97,45.2
Rell,MonkeyKing,161,65,96,40.37
Rell,Naafiri,144,45,99,31.25
Rell,Taliyah,100,61,39,61
Rell,Azir,119,72,47,60.5
Rell,Sion,235,113,122,48.09
Rell,AurelionSol,214,78,136,36.45
Rell,Shyvana,91,26,65,28.57
Rell,KogMaw,121,47,74,38.84
Rell,Kled,46,22,24,47.83
Rell,Sejuani,101,51,50,50.5
Rell,Nautilus,402,197,205,49
Rell,XinZhao,159,63,96,39.62
Rell,Rumble,81,44,37,54.32
Rell,Quinn,97,46,51,47.42
Rell,Maokai,180,91,89,50.56
Rell,Ivern,103,49,54,47.57
Rell,Camille,135,76,59,56.3
Rell,Ziggs,122,63,59,51.64
Rell,Nilah,211,122,89,57.82
Rell,Braum,179,89,90,49.72
Rell,Zoe,154,80,74,51.95
Rell,Taric,57,16,41,28.07
Rell,Vex,227,99,128,43.61
Sejuani,Singed,69,43,26,62.32
Sejuani,Shaco,140,82,58,58.57
Sejuani,Zed,189,97,92,51.32
Sejuani,Hwei,149,75,74,50.34
Sejuani,Lux,574,302,272,52.61
Sejuani,Naafiri,73,28,45,38.36
Sejuani,Briar,190,86,104,45.26
Sejuani,Yone,427,269,158,63
Sejuani,MissFortune,538,255,283,47.4
Sejuani,Senna,177,76,101,42.94
Sejuani,Volibear,342,116,226,33.92
Sejuani,Lillia,165,58,107,35.15
Sejuani,Vladimir,117,41,76,35.04
Sejuani,Jinx,401,219,182,54.61
Sejuani,Lulu,174,69,105,39.66
Sejuani,Riven,79,31,48,39.24
Sejuani,Syndra,146,85,61,58.22
Sejuani,Pyke,214,119,95,55.61
Sejuani,Aurora,261,125,136,47.89
Sejuani,FiddleSticks,137,83,54,60.58
Sejuani,Yasuo,436,202,234,46.33
Sejuani,Jhin,364,185,179,50.82
Sejuani,Vex,116,52,64,44.83
Sejuani,Kayn,406,195,211,48.03
Sejuani,Khazix,175,111,64,63.43
Sejuani,Seraphine,252,128,124,50.79
Sejuani,Sett,402,187,215,46.52
Sejuani,Pantheon,332,197,135,59.34
Sejuani,Ashe,410,238,172,58.05
Sejuani,Braum,99,55,44,55.56
Sejuani,Nasus,151,61,90,40.4
Sejuani,Smolder,156,69,87,44.23
Sejuani,Galio,125,70,55,56
Sejuani,Ahri,319,163,156,51.1
Sejuani,Tristana,140,73,67,52.14
Sejuani,Alistar,109,41,68,37.61
Sejuani,Amumu,254,126,128,49.61
Sejuani,Velkoz,132,81,51,61.36
Sejuani,Yorick,218,87,131,39.91
Sejuani,Rengar,144,101,43,70.14
Sejuani,Neeko,166,91,75,54.82
Sejuani,Gwen,139,79,60,56.83
Sejuani,Katarina,240,140,100,58.33
Sejuani,Elise,207,118,89,57
Sejuani,Teemo,350,127,223,36.29
Sejuani,Vi,173,80,93,46.24
Sejuani,Bard,154,63,91,40.91
Sejuani,Caitlyn,517,248,269,47.97
Sejuani,Mordekaiser,332,184,148,55.42
Sejuani,Aphelios,186,85,101,45.7
Sejuani,Zilean,94,66,28,70.21
Sejuani,Morgana,290,173,117,59.66
Sejuani,Viego,292,150,142,51.37
Sejuani,Samira,257,120,137,46.69
Sejuani,Leona,156,83,73,53.21
Sejuani,Aatrox,234,108,126,46.15
Sejuani,LeeSin,247,121,126,48.99
Sejuani,Akshan,94,30,64,31.91
Sejuani,Zyra,141,64,77,45.39
Sejuani,Trundle,183,101,82,55.19
Sejuani,Rammus,73,36,37,49.32
Sejuani,Fizz,80,41,39,51.25
Sejuani,Sivir,102,40,62,39.22
Sejuani,Lucian,152,82,70,53.95
Sejuani,Darius,428,232,196,54.21
Sejuani,Sona,75,37,38,49.33
Sejuani,Graves,108,68,40,62.96
Sejuani,Ziggs,83,32,51,38.55
Sejuani,Nocturne,186,89,97,47.85
Sejuani,Ekko,159,104,55,65.41
Sejuani,Irelia,192,113,79,58.85
Sejuani,Taric,52,26,26,50
Sejuani,Sylas,263,108,155,41.06
Sejuani,Warwick,330,180,150,54.55
Sejuani,Camille,78,50,28,64.1
Sejuani,Viktor,158,89,69,56.33
Sejuani,Mel,432,208,224,48.15
Sejuani,Ambessa,169,107,62,63.31
Sejuani,Garen,342,180,162,52.63
Sejuani,Soraka,163,67,96,41.1
Sejuani,Renekton,107,65,42,60.75
Sejuani,Thresh,372,182,190,48.92
Sejuani,Shen,156,84,72,53.85
Sejuani,Gangplank,106,56,50,52.83
Sejuani,Gragas,179,105,74,58.66
Sejuani,Udyr,80,46,34,57.5
Sejuani,Ryze,31,16,15,51.61
Sejuani,Akali,232,108,124,46.55
Sejuani,Blitzcrank,177,76,101,42.94
Sejuani,Kindred,106,89,17,83.96
Sejuani,Draven,106,53,53,50
Sejuani,MasterYi,191,90,101,47.12
Sejuani,Nautilus,264,152,112,57.58
Sejuani,Vayne,247,135,112,54.66
Sejuani,Kennen,82,43,39,52.44
Sejuani,Varus,217,117,100,53.92
Sejuani,Yuumi,194,111,83,57.22
Sejuani,Gnar,84,42,42,50
Sejuani,Zeri,68,41,27,60.29
Sejuani,XinZhao,133,49,84,36.84
Sejuani,Veigar,215,97,118,45.12
Sejuani,Karma,191,113,78,59.16
Sejuani,Kled,41,22,19,53.66
Sejuani,Ezreal,468,245,223,52.35
Sejuani,Diana,246,120,126,48.78
Sejuani,TahmKench,219,122,97,55.71
Sejuani,Zoe,129,93,36,72.09
Sejuani,Twitch,211,114,97,54.03
Sejuani,Cassiopeia,88,63,25,71.59
Sejuani,Nilah,150,72,78,48
Sejuani,Nunu,196,88,108,44.9
Sejuani,Milio,139,58,81,41.73
Sejuani,Swain,270,123,147,45.56
Sejuani,Illaoi,87,49,38,56.32
Sejuani,Leblanc,108,62,46,57.41
Sejuani,Brand,98,55,43,56.12
Sejuani,Malphite,182,67,115,36.81
Sejuani,Kaisa,359,237,122,66.02
Sejuani,Xerath,135,105,30,77.78
Sejuani,Jax,171,101,70,59.06
Sejuani,Chogath,276,142,134,51.45
Sejuani,RekSai,24,15,9,62.5
Sejuani,Malzahar,215,99,116,46.05
Sejuani,JarvanIV,130,79,51,60.77
Sejuani,Shyvana,46,14,32,30.43
Sejuani,Lissandra,39,23,16,58.97
Sejuani,Sion,184,104,80,56.52
Sejuani,DrMundo,159,74,85,46.54
Sejuani,Rakan,106,68,38,64.15
Sejuani,KogMaw,90,36,54,40
Sejuani,Corki,99,60,39,60.61
Sejuani,Tryndamere,136,65,71,47.79
Sejuani,KSante,81,39,42,48.15
Sejuani,Xayah,146,81,65,55.48
Sejuani,Quinn,45,22,23,48.89
Sejuani,Skarner,114,60,54,52.63
Sejuani,Qiyana,95,39,56,41.05
Sejuani,Olaf,15,6,9,40
Sejuani,Poppy,121,72,49,59.5
Sejuani,Annie,77,38,39,49.35
Sejuani,Kayle,161,86,75,53.42
Sejuani,Talon,120,81,39,67.5
Sejuani,Nami,251,116,135,46.22
Sejuani,Belveth,50,13,37,26
Sejuani,Ornn,43,24,19,55.81
Sejuani,Fiora,94,52,42,55.32
Sejuani,TwistedFate,78,49,29,62.82
Sejuani,Kalista,105,50,55,47.62
Sejuani,Rell,101,50,51,49.5
Sejuani,Kassadin,50,25,25,50
Sejuani,Urgot,100,42,58,42
Sejuani,Hecarim,69,45,24,65.22
Sejuani,Anivia,62,28,34,45.16
Sejuani,Maokai,103,61,42,59.22
Sejuani,Heimerdinger,135,54,81,40
Sejuani,Jayce,131,75,56,57.25
Sejuani,Zac,96,47,49,48.96
Sejuani,Taliyah,40,10,30,25
Sejuani,Evelynn,124,70,54,56.45
Sejuani,Janna,43,18,25,41.86
Sejuani,AurelionSol,96,57,39,59.38
Sejuani,Azir,78,22,56,28.21
Sejuani,Rumble,56,30,26,53.57
Sejuani,MonkeyKing,97,49,48,50.52
Sejuani,Ivern,53,36,17,67.92
Sejuani,Karthus,70,43,27,61.43
Sejuani,Renata,87,39,48,44.83
Sejuani,Orianna,120,69,51,57.5
Sejuani,Nidalee,35,16,19,45.71
Pantheon,Singed,278,111,167,39.93
Pantheon,Shaco,949,468,481,49.32
Pantheon,Zed,1101,584,517,53.04
Pantheon,Hwei,803,381,422,47.45
Pantheon,Lux,2878,1442,1436,50.1
Pantheon,Darius,2020,1089,931,53.91
Pantheon,Zac,298,169,129,56.71
Pantheon,Poppy,660,307,353,46.52
Pantheon,Twitch,801,478,323,59.68
Pantheon,Maokai,448,230,218,51.34
Pantheon,Graves,501,284,217,56.69
Pantheon,Ahri,1406,721,685,51.28
Pantheon,Nilah,630,275,355,43.65
Pantheon,Malphite,849,365,484,42.99
Pantheon,Garen,1577,790,787,50.1
Pantheon,Briar,964,453,511,46.99
Pantheon,Caitlyn,2188,1079,1109,49.31
Pantheon,Morgana,1400,713,687,50.93
Pantheon,Aatrox,986,605,381,61.36
Pantheon,Brand,726,355,371,48.9
Pantheon,Irelia,911,509,402,55.87
Pantheon,Milio,528,261,267,49.43
Pantheon,Kayn,1765,829,936,46.97
Pantheon,Katarina,946,446,500,47.15
Pantheon,Vayne,1087,515,572,47.38
Pantheon,DrMundo,620,251,369,40.48
Pantheon,Gangplank,399,212,187,53.13
Pantheon,Kaisa,1418,707,711,49.86
Pantheon,Galio,703,318,385,45.23
Pantheon,Cassiopeia,377,198,179,52.52
Pantheon,Sett,1705,822,883,48.21
Pantheon,Talon,649,338,311,52.08
Pantheon,FiddleSticks,604,310,294,51.32
Pantheon,Ashe,1749,895,854,51.17
Pantheon,Blitzcrank,973,513,460,52.72
Pantheon,Lillia,660,353,307,53.48
Pantheon,Sylas,1023,560,463,54.74
Pantheon,TahmKench,1156,568,588,49.13
Pantheon,Jax,880,424,456,48.18
Pantheon,Heimerdinger,551,261,290,47.37
Pantheon,Soraka,661,276,385,41.75
Pantheon,Elise,605,284,321,46.94
Pantheon,Olaf,223,96,127,43.05
Pantheon,Hecarim,369,188,181,50.95
Pantheon,Veigar,1130,476,654,42.12
Pantheon,Tristana,974,466,508,47.84
Pantheon,Braum,552,315,237,57.07
Pantheon,Ryze,295,139,156,47.12
Pantheon,Lulu,888,463,425,52.14
Pantheon,Gnar,468,279,189,59.62
Pantheon,Warwick,1557,723,834,46.44
Pantheon,Malzahar,830,343,487,41.33
Pantheon,XinZhao,631,299,332,47.39
Pantheon,Akali,1036,509,527,49.13
Pantheon,LeeSin,1071,573,498,53.5
Pantheon,Evelynn,563,301,262,53.46
Pantheon,Ezreal,1781,930,851,52.22
Pantheon,Jinx,2154,952,1202,44.2
Pantheon,Samira,881,463,418,52.55
Pantheon,Ekko,790,375,415,47.47
Pantheon,Chogath,1412,669,743,47.38
Pantheon,Yorick,858,389,469,45.34
Pantheon,Sion,788,379,409,48.1
Pantheon,MasterYi,1066,510,556,47.84
Pantheon,AurelionSol,439,218,221,49.66
Pantheon,Seraphine,1123,579,544,51.56
Pantheon,Mordekaiser,1531,717,814,46.83
Pantheon,Sejuani,332,135,197,40.66
Pantheon,Yone,2176,1125,1051,51.7
Pantheon,MissFortune,2190,1040,1150,47.49
Pantheon,Swain,1077,502,575,46.61
Pantheon,Yasuo,1944,1015,929,52.21
Pantheon,Corki,337,169,168,50.15
Pantheon,Karma,672,343,329,51.04
Pantheon,Neeko,861,424,437,49.25
Pantheon,Yuumi,936,463,473,49.47
Pantheon,Rengar,376,237,139,63.03
Pantheon,Jhin,1642,875,767,53.29
Pantheon,Kindred,611,357,254,58.43
Pantheon,Alistar,336,175,161,52.08
Pantheon,Volibear,1090,524,566,48.07
Pantheon,Velkoz,681,282,399,41.41
Pantheon,Varus,832,461,371,55.41
Pantheon,Aurora,1060,542,518,51.13
Pantheon,Trundle,492,233,259,47.36
Pantheon,Mel,2216,1236,980,55.78
Pantheon,Illaoi,499,213,286,42.69
Pantheon,Khazix,642,328,314,51.09
Pantheon,Leona,752,315,437,41.89
Pantheon,Draven,644,329,315,51.09
Pantheon,Nautilus,1114,596,518,53.5
Pantheon,Viego,1143,544,599,47.59
Pantheon,KSante,377,175,202,46.42
Pantheon,Kalista,440,249,191,56.59
Pantheon,Ivern,174,83,91,47.7
Pantheon,Quinn,340,179,161,52.65
Pantheon,Nasus,811,390,421,48.09
Pantheon,Kled,169,93,76,55.03
Pantheon,Taliyah,281,137,144,48.75
Pantheon,Sona,425,169,256,39.76
Pantheon,RekSai,162,70,92,43.21
Pantheon,Zoe,426,246,180,57.75
Pantheon,Nunu,959,511,448,53.28
Pantheon,Thresh,1389,669,720,48.16
Pantheon,Shen,641,256,385,39.94
Pantheon,Riven,453,310,143,68.43
Pantheon,Rell,515,256,259,49.71
Pantheon,Vladimir,659,344,315,52.2
Pantheon,Kayle,895,513,382,57.32
Pantheon,Azir,440,225,215,51.14
Pantheon,Xayah,669,322,347,48.13
Pantheon,Orianna,483,198,285,40.99
Pantheon,Ambessa,645,292,353,45.27
Pantheon,Pyke,1351,809,542,59.88
Pantheon,Anivia,312,135,177,43.27
Pantheon,Nocturne,861,484,377,56.21
Pantheon,Udyr,423,222,201,52.48
Pantheon,Sivir,565,296,269,52.39
Pantheon,Skarner,321,170,151,52.96
Pantheon,Gwen,588,277,311,47.11
Pantheon,Rammus,361,161,200,44.6
Pantheon,Viktor,656,368,288,56.1
Pantheon,Fiora,482,223,259,46.27
Pantheon,Vi,946,421,525,44.5
Pantheon,TwistedFate,405,206,199,50.86
Pantheon,Zilean,262,123,139,46.95
Pantheon,Ziggs,422,219,203,51.9
Pantheon,Ornn,405,200,205,49.38
Pantheon,Aphelios,632,283,349,44.78
Pantheon,Lucian,625,322,303,51.52
Pantheon,Camille,364,222,142,60.99
Pantheon,MonkeyKing,500,225,275,45
Pantheon,Rakan,539,276,263,51.21
Pantheon,Renekton,472,247,225,52.33
Pantheon,Zeri,410,245,165,59.76
Pantheon,Kassadin,226,117,109,51.77
Pantheon,Leblanc,420,249,171,59.29
Pantheon,Fizz,541,287,254,53.05
Pantheon,Renata,245,115,130,46.94
Pantheon,Zyra,641,266,375,41.5
Pantheon,Nami,818,419,399,51.22
Pantheon,Diana,1312,650,662,49.54
Pantheon,Annie,247,116,131,46.96
Pantheon,Xerath,628,318,310,50.64
Pantheon,Lissandra,248,115,133,46.37
Pantheon,Senna,832,425,407,51.08
Pantheon,Naafiri,427,248,179,58.08
Pantheon,Nidalee,304,157,147,51.64
Pantheon,Teemo,1405,628,777,44.7
Pantheon,Qiyana,315,140,175,44.44
Pantheon,Jayce,339,216,123,63.72
Pantheon,Gragas,644,299,345,46.43
Pantheon,Taric,241,82,159,34.02
Pantheon,Karthus,278,130,148,46.76
Pantheon,Smolder,787,414,373,52.6
Pantheon,Tryndamere,647,336,311,51.93
Pantheon,Amumu,981,469,512,47.81
Pantheon,Rumble,232,144,88,62.07
Pantheon,Shyvana,301,126,175,41.86
Pantheon,KogMaw,330,171,159,51.82
Pantheon,Belveth,329,175,154,53.19
Pantheon,Syndra,566,302,264,53.36
Pantheon,Janna,277,134,143,48.38
Pantheon,Urgot,549,232,317,42.26
Pantheon,JarvanIV,421,178,243,42.28
Pantheon,Bard,292,165,127,56.51
Pantheon,Kennen,344,216,128,62.79
Pantheon,Vex,665,338,327,50.83
Pantheon,Akshan,395,174,221,44.05
Singed,Mordekaiser,217,111,106,51.15
Singed,Sejuani,69,26,43,37.68
Singed,Yasuo,277,164,113,59.21
Singed,Lucian,96,53,43,55.21
Singed,Pantheon,278,167,111,60.07
Singed,Irelia,143,75,68,52.45
Singed,Kayn,292,167,125,57.19
Singed,Katarina,171,97,74,56.73
Singed,Vayne,228,110,118,48.25
Singed,DrMundo,111,66,45,59.46
Singed,Heimerdinger,123,80,43,65.04
Singed,Talon,117,65,52,55.56
Singed,Ahri,226,131,95,57.96
Singed,Kalista,71,45,26,63.38
Singed,Brand,110,83,27,75.45
Singed,Sett,264,116,148,43.94
Singed,Vladimir,65,32,33,49.23
Singed,Kindred,69,48,21,69.57
Singed,Aphelios,101,53,48,52.48
Singed,Pyke,170,91,79,53.53
Singed,Darius,274,134,140,48.91
Singed,Poppy,106,54,52,50.94
Singed,Sylas,152,71,81,46.71
Singed,Rell,105,58,47,55.24
Singed,Kayle,154,55,99,35.71
Singed,Akali,174,108,66,62.07
Singed,Soraka,119,61,58,51.26
Singed,Swain,169,108,61,63.91
Singed,Jax,181,77,104,42.54
Singed,Morgana,224,92,132,41.07
Singed,Caitlyn,444,242,202,54.5
Singed,Tryndamere,92,56,36,60.87
Singed,Nasus,197,83,114,42.13
Singed,Galio,147,73,74,49.66
Singed,Smolder,115,85,30,73.91
Singed,JarvanIV,88,33,55,37.5
Singed,Urgot,151,81,70,53.64
Singed,Ekko,140,60,80,42.86
Singed,Xerath,112,63,49,56.25
Singed,Warwick,208,108,100,51.92
Singed,Aurora,152,104,48,68.42
Singed,Samira,179,115,64,64.25
Singed,Neeko,85,52,33,61.18
Singed,Nocturne,175,94,81,53.71
Singed,Orianna,121,51,70,42.15
Singed,Ezreal,270,178,92,65.93
Singed,Bard,57,48,9,84.21
Singed,Maokai,85,38,47,44.71
Singed,Sion,163,113,50,69.33
Singed,Lux,413,224,189,54.24
Singed,Amumu,155,77,78,49.68
Singed,Mel,383,216,167,56.4
Singed,Jhin,275,164,111,59.64
Singed,Yuumi,161,94,67,58.39
Singed,FiddleSticks,90,47,43,52.22
Singed,Zoe,123,86,37,69.92
Singed,Kaisa,278,151,127,54.32
Singed,Taric,47,29,18,61.7
Singed,Karma,142,73,69,51.41
Singed,Zed,162,90,72,55.56
Singed,Veigar,148,81,67,54.73
Singed,Rengar,71,30,41,42.25
Singed,Thresh,283,163,120,57.6
Singed,MasterYi,155,81,74,52.26
Singed,Gragas,106,57,49,53.77
Singed,Aatrox,198,133,65,67.17
Singed,Blitzcrank,148,81,67,54.73
Singed,LeeSin,153,87,66,56.86
Singed,MissFortune,292,171,121,58.56
Singed,Nami,168,87,81,51.79
Singed,Zeri,90,55,35,61.11
Singed,Nunu,170,79,91,46.47
Singed,Malphite,116,80,36,68.97
Singed,Jinx,274,136,138,49.64
Singed,Shen,186,116,70,62.37
Singed,Leblanc,92,53,39,57.61
Singed,Twitch,141,79,62,56.03
Singed,Velkoz,160,64,96,40
Singed,Olaf,42,39,3,92.86
Singed,Kled,33,33,0,100
Singed,Briar,133,77,56,57.89
Singed,Ziggs,49,34,15,69.39
Singed,Nautilus,134,86,48,64.18
Singed,Taliyah,59,39,20,66.1
Singed,Viego,220,119,101,54.09
Singed,Graves,116,77,39,66.38
Singed,AurelionSol,107,43,64,40.19
Singed,Corki,64,35,29,54.69
Singed,Nilah,108,73,35,67.59
Singed,TahmKench,214,132,82,61.68
Singed,Cassiopeia,34,5,29,14.71
Singed,Braum,89,24,65,26.97
Singed,Gangplank,84,34,50,40.48
Singed,Khazix,146,99,47,67.81
Singed,Malzahar,154,54,100,35.06
Singed,Ashe,329,148,181,44.98
Singed,Zilean,50,38,12,76
Singed,Lulu,127,56,71,44.09
Singed,Yone,248,146,102,58.87
Singed,Skarner,41,32,9,78.05
Singed,Senna,199,104,95,52.26
Singed,Evelynn,67,50,17,74.63
Singed,Draven,143,89,54,62.24
Singed,Zyra,104,67,37,64.42
Singed,Udyr,59,27,32,45.76
Singed,Quinn,52,30,22,57.69
Singed,Renata,24,16,8,66.67
Singed,Fizz,79,47,32,59.49
Singed,Volibear,164,92,72,56.1
Singed,Teemo,193,131,62,67.88
Singed,Rammus,61,23,38,37.7
Singed,KSante,56,32,24,57.14
Singed,Shaco,139,99,40,71.22
Singed,Nidalee,39,33,6,84.62
Singed,Elise,94,46,48,48.94
Singed,Garen,226,118,108,52.21
Singed,Qiyana,80,40,40,50
Singed,Viktor,126,74,52,58.73
Singed,Seraphine,191,116,75,60.73
Singed,Riven,74,59,15,79.73
Singed,Lillia,119,53,66,44.54
Singed,Akshan,53,32,21,60.38
Singed,Varus,178,83,95,46.63
Singed,Rakan,82,59,23,71.95
Singed,Ambessa,94,30,64,31.91
Singed,Renekton,50,38,12,76
Singed,Zac,78,43,35,55.13
Singed,Alistar,52,27,25,51.92
Singed,Syndra,86,47,39,54.65
Singed,Jayce,104,51,53,49.04
Singed,Illaoi,70,28,42,40
Singed,Vex,92,64,28,69.57
Singed,Camille,73,33,40,45.21
Singed,Karthus,45,28,17,62.22
Singed,Diana,191,69,122,36.13
Singed,Chogath,233,116,117,49.79
Singed,Naafiri,94,53,41,56.38
Singed,Kennen,67,49,18,73.13
Singed,Vi,126,73,53,57.94
Singed,Xayah,131,79,52,60.31
Singed,Yorick,139,48,91,34.53
Singed,XinZhao,96,56,40,58.33
Singed,Kassadin,47,22,25,46.81
Singed,Tristana,143,96,47,67.13
Singed,Leona,113,62,51,54.87
Singed,Gwen,106,67,39,63.21
Singed,Ryze,56,25,31,44.64
Singed,Gnar,73,51,22,69.86
Singed,Milio,114,58,56,50.88
Singed,Fiora,63,34,29,53.97
Singed,Belveth,45,16,29,35.56
Singed,Hwei,113,50,63,44.25
Singed,MonkeyKing,85,55,30,64.71
Singed,Azir,45,33,12,73.33
Singed,Hecarim,74,37,37,50
Singed,RekSai,31,18,13,58.06
Singed,Trundle,58,33,25,56.9
Singed,TwistedFate,43,32,11,74.42
Singed,Anivia,46,20,26,43.48
Singed,Lissandra,27,12,15,44.44
Singed,Ornn,71,22,49,30.99
Singed,Annie,45,26,19,57.78
Singed,Rumble,45,39,6,86.67
Singed,Sivir,91,25,66,27.47
Singed,Shyvana,30,30,0,100
Singed,Janna,26,6,20,23.08
Singed,Ivern,29,11,18,37.93
Singed,Sona,31,15,16,48.39
Singed,KogMaw,29,6,23,20.69
Shaco,Mordekaiser,845,402,443,47.57
Shaco,Sejuani,140,58,82,41.43
Shaco,Yasuo,1055,513,542,48.63
Shaco,Lucian,252,147,105,58.33
Shaco,Pantheon,949,481,468,50.68
Shaco,Renekton,204,98,106,48.04
Shaco,Kayn,948,382,566,40.3
Shaco,Katarina,567,282,285,49.74
Shaco,Draven,321,163,158,50.78
Shaco,Yuumi,579,289,290,49.91
Shaco,Khazix,367,191,176,52.04
Shaco,Mel,1260,602,658,47.78
Shaco,Jhin,1080,523,557,48.43
Shaco,Lux,1640,840,800,51.22
Shaco,Heimerdinger,338,129,209,38.17
Shaco,Warwick,927,448,479,48.33
Shaco,Neeko,348,168,180,48.28
Shaco,Leona,384,231,153,60.16
Shaco,Fiora,261,135,126,51.72
Shaco,MasterYi,579,223,356,38.51
Shaco,Karma,359,185,174,51.53
Shaco,Irelia,495,222,273,44.85
Shaco,Galio,380,165,215,43.42
Shaco,Sivir,319,183,136,57.37
Shaco,Rell,318,141,177,44.34
Shaco,Yorick,565,221,344,39.12
Shaco,Viego,761,390,371,51.25
Shaco,Malphite,457,211,246,46.17
Shaco,Kaisa,809,405,404,50.06
Shaco,Briar,519,284,235,54.72
Shaco,Zed,566,286,280,50.53
Shaco,Jinx,983,421,562,42.83
Shaco,Lulu,414,248,166,59.9
Shaco,Teemo,708,269,439,37.99
Shaco,Gragas,410,279,131,68.05
Shaco,Qiyana,163,96,67,58.9
Shaco,Caitlyn,1474,713,761,48.37
Shaco,Soraka,367,159,208,43.32
Shaco,Jayce,282,156,126,55.32
Shaco,Amumu,513,196,317,38.21
Shaco,Ashe,954,520,434,54.51
Shaco,Milio,254,126,128,49.61
Shaco,Sett,1073,515,558,48
Shaco,Ivern,139,83,56,59.71
Shaco,Senna,593,294,299,49.58
Shaco,Jax,436,217,219,49.77
Shaco,Diana,766,389,377,50.78
Shaco,Ahri,799,394,405,49.31
Shaco,Aphelios,363,209,154,57.58
Shaco,Illaoi,332,190,142,57.23
Shaco,Velkoz,443,187,256,42.21
Shaco,Veigar,632,240,392,37.97
Shaco,Ekko,502,214,288,42.63
Shaco,Kassadin,188,70,118,37.23
Shaco,TahmKench,516,239,277,46.32
Shaco,Ambessa,285,136,149,47.72
Shaco,LeeSin,594,309,285,52.02
Shaco,Malzahar,453,184,269,40.62
Shaco,MissFortune,1111,544,567,48.96
Shaco,Blitzcrank,404,180,224,44.55
Shaco,Volibear,625,315,310,50.4
Shaco,Nocturne,501,212,289,42.32
Shaco,Xerath,351,194,157,55.27
Shaco,Ezreal,990,448,542,45.25
Shaco,Gangplank,285,123,162,43.16
Shaco,Yone,1195,549,646,45.94
Shaco,Twitch,502,252,250,50.2
Shaco,Swain,626,298,328,47.6
Shaco,Rammus,106,62,44,58.49
Shaco,Chogath,679,301,378,44.33
Shaco,Nautilus,549,259,290,47.18
Shaco,Cassiopeia,221,104,117,47.06
Shaco,Thresh,730,308,422,42.19
Shaco,Aurora,476,256,220,53.78
Shaco,Aatrox,601,297,304,49.42
Shaco,Camille,206,84,122,40.78
Shaco,Azir,214,98,116,45.79
Shaco,Braum,242,109,133,45.04
Shaco,DrMundo,375,156,219,41.6
Shaco,Naafiri,255,116,139,45.49
Shaco,Morgana,803,381,422,47.45
Shaco,Sion,393,129,264,32.82
Shaco,Kled,145,101,44,69.66
Shaco,Vi,527,238,289,45.16
Shaco,Zeri,297,131,166,44.11
Shaco,Brand,396,221,175,55.81
Shaco,Vladimir,305,146,159,47.87
Shaco,Kindred,387,195,192,50.39
Shaco,Seraphine,609,335,274,55.01
Shaco,Sona,264,137,127,51.89
Shaco,Sylas,510,231,279,45.29
Shaco,Nilah,382,174,208,45.55
Shaco,Rumble,141,69,72,48.94
Shaco,KSante,317,167,150,52.68
Shaco,Olaf,145,84,61,57.93
Shaco,Darius,1087,548,539,50.41
Shaco,Vayne,517,256,261,49.52
Shaco,Talon,480,238,242,49.58
Shaco,Taliyah,125,69,56,55.2
Shaco,Zoe,298,157,141,52.68
Shaco,Udyr,218,112,106,51.38
Shaco,Leblanc,247,143,104,57.89
Shaco,Nami,628,287,341,45.7
Shaco,Ornn,215,91,124,42.33
Shaco,Rengar,262,132,130,50.38
Shaco,Kalista,335,159,176,47.46
Shaco,Samira,553,267,286,48.28
Shaco,Evelynn,313,152,161,48.56
Shaco,Trundle,284,137,147,48.24
Shaco,AurelionSol,303,118,185,38.94
Shaco,Maokai,196,110,86,56.12
Shaco,Vex,395,200,195,50.63
Shaco,Gwen,297,177,120,59.6
Shaco,Lillia,343,198,145,57.73
Shaco,Pyke,654,352,302,53.82
Shaco,Fizz,333,125,208,37.54
Shaco,Renata,159,60,99,37.74
Shaco,Karthus,254,139,115,54.72
Shaco,Tryndamere,394,213,181,54.06
Shaco,Varus,518,241,277,46.53
Shaco,FiddleSticks,288,119,169,41.32
Shaco,Ryze,180,58,122,32.22
Shaco,Janna,148,73,75,49.32
Shaco,Graves,318,154,164,48.43
Shaco,Taric,102,43,59,42.16
Shaco,Kayle,383,151,232,39.43
Shaco,Tristana,577,280,297,48.53
Shaco,Garen,749,361,388,48.2
Shaco,Kennen,248,139,109,56.05
Shaco,Quinn,262,125,137,47.71
Shaco,Shen,439,209,230,47.61
Shaco,Viktor,406,183,223,45.07
Shaco,Anivia,177,97,80,54.8
Shaco,Zyra,418,179,239,42.82
Shaco,JarvanIV,245,100,145,40.82
Shaco,XinZhao,314,155,159,49.36
Shaco,TwistedFate,226,155,71,68.58
Shaco,Shyvana,163,60,103,36.81
Shaco,Akshan,182,74,108,40.66
Shaco,Smolder,508,243,265,47.83
Shaco,Nunu,471,201,270,42.68
Shaco,Nidalee,147,114,33,77.55
Shaco,Annie,163,120,43,73.62
Shaco,RekSai,95,45,50,47.37
Shaco,Ziggs,238,132,106,55.46
Shaco,Xayah,396,213,183,53.79
Shaco,Syndra,390,164,226,42.05
Shaco,Hwei,441,236,205,53.51
Shaco,Akali,656,352,304,53.66
Shaco,Rakan,273,113,160,41.39
Shaco,Belveth,175,72,103,41.14
Shaco,Corki,194,97,97,50
Shaco,Gnar,202,134,68,66.34
Shaco,Orianna,243,122,121,50.21
Shaco,Hecarim,270,137,133,50.74
Shaco,MonkeyKing,308,146,162,47.4
Shaco,Lissandra,171,67,104,39.18
Shaco,Poppy,391,200,191,51.15
Shaco,Bard,162,72,90,44.44
Shaco,Riven,263,148,115,56.27
Shaco,Zac,167,89,78,53.29
Shaco,Elise,427,209,218,48.95
Shaco,Singed,139,40,99,28.78
Shaco,Urgot,251,113,138,45.02
Shaco,Alistar,186,95,91,51.08
Shaco,KogMaw,143,61,82,42.66
Shaco,Skarner,151,52,99,34.44
Shaco,Nasus,401,215,186,53.62
Shaco,Zilean,132,52,80,39.39
Zed,Mordekaiser,826,344,482,41.65
Zed,Sejuani,189,92,97,48.68
Zed,Yasuo,1395,582,813,41.72
Zed,Lucian,315,154,161,48.89
Zed,Pantheon,1101,517,584,46.96
Zed,Chogath,711,316,395,44.44
Zed,Kayn,937,463,474,49.41
Zed,Gangplank,228,118,110,51.75
Zed,Ezreal,993,505,488,50.86
Zed,Hwei,528,295,233,55.87
Zed,Diana,879,431,448,49.03
Zed,Yuumi,553,256,297,46.29
Zed,Trundle,292,98,194,33.56
Zed,MasterYi,563,258,305,45.83
Zed,Veigar,677,352,325,51.99
Zed,Jhin,1161,554,607,47.72
Zed,Soraka,383,214,169,55.87
Zed,Gnar,255,117,138,45.88
Zed,Jax,541,275,266,50.83
Zed,Caitlyn,1484,633,851,42.65
Zed,Neeko,404,202,202,50
Zed,Fiora,270,132,138,48.89
Zed,Mel,1390,650,740,46.76
Zed,Karma,388,171,217,44.07
Zed,Malphite,651,284,367,43.63
Zed,Evelynn,336,160,176,47.62
Zed,Irelia,661,376,285,56.88
Zed,Tristana,550,266,284,48.36
Zed,Thresh,827,342,485,41.35
Zed,Ryze,177,70,107,39.55
Zed,Warwick,949,435,514,45.84
Zed,Morgana,799,363,436,45.43
Zed,Xayah,486,138,348,28.4
Zed,Vladimir,325,135,190,41.54
Zed,Shaco,566,280,286,49.47
Zed,Tryndamere,318,120,198,37.74
Zed,Milio,356,157,199,44.1
Zed,Heimerdinger,288,130,158,45.14
Zed,Kindred,294,130,164,44.22
Zed,Katarina,503,272,231,54.08
Zed,Janna,212,73,139,34.43
Zed,Teemo,772,313,459,40.54
Zed,Gragas,376,204,172,54.26
Zed,Qiyana,303,142,161,46.86
Zed,Akali,592,286,306,48.31
Zed,Jinx,1147,494,653,43.07
Zed,Leblanc,230,104,126,45.22
Zed,Senna,459,206,253,44.88
Zed,Amumu,580,259,321,44.66
Zed,Kaisa,894,395,499,44.18
Zed,Seraphine,576,301,275,52.26
Zed,Ashe,1000,471,529,47.1
Zed,Pyke,681,368,313,54.04
Zed,Darius,1266,602,664,47.55
Zed,Nami,630,239,391,37.94
Zed,Aatrox,541,252,289,46.58
Zed,Cassiopeia,196,84,112,42.86
Zed,Yone,1120,544,576,48.57
Zed,Vayne,618,291,327,47.09
Zed,Shyvana,123,32,91,26.02
Zed,Sylas,594,257,337,43.27
Zed,Briar,601,259,342,43.09
Zed,Kled,106,43,63,40.57
Zed,Ambessa,390,211,179,54.1
Zed,Nilah,314,138,176,43.95
Zed,Leona,361,149,212,41.27
Zed,Riven,308,163,145,52.92
Zed,TwistedFate,263,112,151,42.59
Zed,Kennen,214,129,85,60.28
Zed,Ahri,802,349,453,43.52
Zed,Lux,1539,684,855,44.44
Zed,TahmKench,680,296,384,43.53
Zed,MissFortune,1144,543,601,47.47
Zed,Blitzcrank,397,211,186,53.15
Zed,Vex,350,151,199,43.14
Zed,Vi,519,219,300,42.2
Zed,Swain,609,282,327,46.31
Zed,DrMundo,343,149,194,43.44
Zed,Lillia,523,241,282,46.08
Zed,Lissandra,181,69,112,38.12
Zed,FiddleSticks,279,91,188,32.62
Zed,Anivia,158,95,63,60.13
Zed,Poppy,358,165,193,46.09
Zed,XinZhao,350,153,197,43.71
Zed,Syndra,405,184,221,45.43
Zed,Sett,979,393,586,40.14
Zed,Rumble,106,39,67,36.79
Zed,Samira,577,270,307,46.79
Zed,Talon,383,216,167,56.4
Zed,Aurora,591,362,229,61.25
Zed,Taliyah,134,69,65,51.49
Zed,Zoe,308,178,130,57.79
Zed,Twitch,491,249,242,50.71
Zed,Viego,717,343,374,47.84
Zed,Nautilus,640,325,315,50.78
Zed,Urgot,238,107,131,44.96
Zed,Galio,376,137,239,36.44
Zed,Lulu,514,255,259,49.61
Zed,AurelionSol,251,123,128,49
Zed,Zyra,415,119,296,28.67
Zed,Singed,162,72,90,44.44
Zed,Orianna,241,117,124,48.55
Zed,Garen,871,406,465,46.61
Zed,Malzahar,464,223,241,48.06
Zed,Volibear,705,321,384,45.53
Zed,Yorick,585,179,406,30.6
Zed,Ziggs,264,110,154,41.67
Zed,Nasus,424,183,241,43.16
Zed,Rell,296,159,137,53.72
Zed,LeeSin,623,331,292,53.13
Zed,Camille,224,116,108,51.79
Zed,Kayle,372,122,250,32.8
Zed,Zac,229,98,131,42.79
Zed,Braum,231,124,107,53.68
Zed,Velkoz,416,156,260,37.5
Zed,Ornn,190,82,108,43.16
Zed,Graves,348,189,159,54.31
Zed,Bard,181,80,101,44.2
Zed,Gwen,271,143,128,52.77
Zed,Zeri,252,140,112,55.56
Zed,Hecarim,227,118,109,51.98
Zed,Nunu,414,202,212,48.79
Zed,Skarner,171,97,74,56.73
Zed,Elise,393,210,183,53.44
Zed,Renekton,280,102,178,36.43
Zed,Aphelios,555,243,312,43.78
Zed,Renata,162,67,95,41.36
Zed,Nocturne,489,221,268,45.19
Zed,Annie,176,76,100,43.18
Zed,Udyr,231,144,87,62.34
Zed,Maokai,246,119,127,48.37
Zed,MonkeyKing,291,136,155,46.74
Zed,Sion,497,202,295,40.64
Zed,Rengar,309,155,154,50.16
Zed,Ekko,571,316,255,55.34
Zed,Corki,224,98,126,43.75
Zed,Alistar,195,104,91,53.33
Zed,Fizz,349,171,178,49
Zed,Smolder,518,257,261,49.61
Zed,KSante,229,114,115,49.78
Zed,Nidalee,176,90,86,51.14
Zed,Rakan,358,112,246,31.28
Zed,Sivir,216,119,97,55.09
Zed,Kassadin,95,39,56,41.05
Zed,Sona,240,83,157,34.58
Zed,Viktor,385,178,207,46.23
Zed,Khazix,355,145,210,40.85
Zed,Rammus,187,78,109,41.71
Zed,Zilean,208,80,128,38.46
Zed,Akshan,168,93,75,55.36
Zed,Ivern,188,70,118,37.23
Zed,Draven,350,178,172,50.86
Zed,Illaoi,271,106,165,39.11
Zed,Varus,472,187,285,39.62
Zed,Xerath,369,157,212,42.55
Zed,Shen,454,228,226,50.22
Zed,Quinn,275,106,169,38.55
Zed,RekSai,118,46,72,38.98
Zed,KogMaw,191,76,115,39.79
Zed,Azir,243,137,106,56.38
Zed,Karthus,125,47,78,37.6
Zed,Brand,458,209,249,45.63
Zed,Taric,123,64,59,52.03
Zed,Olaf,114,45,69,39.47
Zed,Naafiri,303,130,173,42.9
Zed,JarvanIV,165,69,96,41.82
Zed,Kalista,269,142,127,52.79
Zed,Jayce,262,159,103,60.69
Zed,Belveth,118,49,69,41.53
Zac,Fiora,110,54,56,49.09
Zac,Pantheon,298,129,169,43.29
Zac,Katarina,197,115,82,58.38
Zac,Mel,510,236,274,46.27
Zac,Viktor,162,79,83,48.77
Zac,Ornn,58,38,20,65.52
Zac,Poppy,141,85,56,60.28
Zac,Yone,356,196,160,55.06
Zac,MissFortune,505,267,238,52.87
Zac,Brand,185,69,116,37.3
Zac,Darius,352,171,181,48.58
Zac,Volibear,256,113,143,44.14
Zac,Chogath,328,130,198,39.63
Zac,Ezreal,415,193,222,46.51
Zac,Tryndamere,117,45,72,38.46
Zac,Kayn,345,178,167,51.59
Zac,Aurora,191,96,95,50.26
Zac,Twitch,137,100,37,72.99
Zac,Lux,512,230,282,44.92
Zac,Gragas,100,47,53,47
Zac,XinZhao,142,52,90,36.62
Zac,Yasuo,403,197,206,48.88
Zac,Lucian,141,84,57,59.57
Zac,Velkoz,193,103,90,53.37
Zac,Yorick,210,86,124,40.95
Zac,Cassiopeia,100,62,38,62
Zac,Jhin,383,206,177,53.79
Zac,Rell,161,80,81,49.69
Zac,Samira,209,102,107,48.8
Zac,MasterYi,159,60,99,37.74
Zac,Orianna,59,36,23,61.02
Zac,Malphite,156,59,97,37.82
Zac,Nautilus,268,136,132,50.75
Zac,Ivern,48,21,27,43.75
Zac,Gnar,114,31,83,27.19
Zac,Seraphine,212,94,118,44.34
Zac,Irelia,175,83,92,47.43
Zac,Leona,147,61,86,41.5
Zac,Briar,212,115,97,54.25
Zac,Akali,172,71,101,41.28
Zac,Caitlyn,608,283,325,46.55
Zac,Morgana,209,106,103,50.72
Zac,Sion,213,112,101,52.58
Zac,Ahri,277,138,139,49.82
Zac,Draven,151,95,56,62.91
Zac,Kassadin,82,22,60,26.83
Zac,Renata,61,20,41,32.79
Zac,Teemo,289,127,162,43.94
Zac,Rengar,109,73,36,66.97
Zac,Vladimir,129,74,55,57.36
Zac,Kaisa,274,149,125,54.38
Zac,Xerath,150,72,78,48
Zac,Garen,358,175,183,48.88
Zac,Warwick,352,182,170,51.7
Zac,Xayah,191,77,114,40.31
Zac,Zed,229,131,98,57.21
Zac,Kindred,127,74,53,58.27
Zac,Diana,319,177,142,55.49
Zac,Tristana,167,88,79,52.69
Zac,Yuumi,198,111,87,56.06
Zac,Ashe,394,182,212,46.19
Zac,Riven,111,60,51,54.05
Zac,Nilah,98,26,72,26.53
Zac,Camille,75,38,37,50.67
Zac,Varus,196,79,117,40.31
Zac,Braum,90,59,31,65.56
Zac,Naafiri,94,50,44,53.19
Zac,Veigar,230,135,95,58.7
Zac,Neeko,163,93,70,57.06
Zac,Nasus,135,77,58,57.04
Zac,Pyke,166,76,90,45.78
Zac,Sett,301,142,159,47.18
Zac,Ekko,161,94,67,58.39
Zac,Aphelios,158,65,93,41.14
Zac,Alistar,78,30,48,38.46
Zac,Mordekaiser,348,193,155,55.46
Zac,Vi,250,120,130,48
Zac,Senna,159,77,82,48.43
Zac,AurelionSol,131,42,89,32.06
Zac,Lissandra,90,22,68,24.44
Zac,TahmKench,245,153,92,62.45
Zac,Swain,230,91,139,39.57
Zac,Evelynn,117,78,39,66.67
Zac,Vex,120,60,60,50
Zac,Milio,132,59,73,44.7
Zac,Trundle,108,46,62,42.59
Zac,Lulu,222,126,96,56.76
Zac,Hecarim,66,32,34,48.48
Zac,Khazix,173,105,68,60.69
Zac,MonkeyKing,104,53,51,50.96
Zac,Graves,96,51,45,53.13
Zac,Corki,50,24,26,48
Zac,Elise,148,88,60,59.46
Zac,Anivia,57,35,22,61.4
Zac,Gwen,165,101,64,61.21
Zac,Jinx,447,245,202,54.81
Zac,Zyra,127,77,50,60.63
Zac,Sivir,127,92,35,72.44
Zac,Nidalee,60,20,40,33.33
Zac,Shaco,167,78,89,46.71
Zac,Shyvana,76,34,42,44.74
Zac,Udyr,82,22,60,26.83
Zac,Ziggs,77,57,20,74.03
Zac,Vayne,233,121,112,51.93
Zac,Leblanc,90,47,43,52.22
Zac,Thresh,319,195,124,61.13
Zac,Gangplank,109,61,48,55.96
Zac,Singed,78,35,43,44.87
Zac,Zeri,90,61,29,67.78
Zac,Sona,74,47,27,63.51
Zac,Viego,345,156,189,45.22
Zac,DrMundo,116,63,53,54.31
Zac,Lillia,199,92,107,46.23
Zac,FiddleSticks,169,84,85,49.7
Zac,Nami,205,74,131,36.1
Zac,Urgot,107,57,50,53.27
Zac,Karma,179,87,92,48.6
Zac,Azir,87,27,60,31.03
Zac,KogMaw,82,32,50,39.02
Zac,Nunu,125,49,76,39.2
Zac,Sylas,163,89,74,54.6
Zac,Janna,90,53,37,58.89
Zac,Taric,98,54,44,55.1
Zac,Amumu,272,142,130,52.21
Zac,KSante,119,77,42,64.71
Zac,Jax,198,53,145,26.77
Zac,Blitzcrank,188,109,79,57.98
Zac,Galio,125,76,49,60.8
Zac,Soraka,131,63,68,48.09
Zac,Nocturne,146,75,71,51.37
Zac,Jayce,109,57,52,52.29
Zac,Smolder,177,78,99,44.07
Zac,Bard,98,64,34,65.31
Zac,Zoe,110,61,49,55.45
Zac,LeeSin,211,122,89,57.82
Zac,Akshan,56,29,27,51.79
Zac,JarvanIV,83,43,40,51.81
Zac,Quinn,67,28,39,41.79
Zac,Rammus,73,33,40,45.21
Zac,Maokai,96,52,44,54.17
Zac,Renekton,155,62,93,40
Zac,Annie,60,48,12,80
Zac,Shen,137,99,38,72.26
Zac,Kayle,163,54,109,33.13
Zac,Fizz,110,43,67,39.09
Zac,Illaoi,95,60,35,63.16
Zac,Malzahar,142,52,90,36.62
Zac,TwistedFate,78,58,20,74.36
Zac,Hwei,141,56,85,39.72
Zac,Karthus,72,47,25,65.28
Zac,Olaf,63,35,28,55.56
Zac,Talon,109,78,31,71.56
Zac,Aatrox,254,108,146,42.52
Zac,Qiyana,79,44,35,55.7
Zac,Syndra,119,76,43,63.87
Zac,Rakan,97,61,36,62.89
Zac,Taliyah,91,34,57,37.36
Zac,Heimerdinger,128,62,66,48.44
Zac,Sejuani,96,49,47,51.04
Zac,Skarner,105,51,54,48.57
Zac,Ambessa,147,83,64,56.46
Zac,RekSai,35,23,12,65.71
Zac,Zilean,68,40,28,58.82
Zac,Kalista,100,51,49,51
Zac,Kennen,72,52,20,72.22
Zac,Kled,61,43,18,70.49
Zac,Ryze,61,40,21,65.57
Zac,Belveth,51,31,20,60.78
Zac,Rumble,18,6,12,33.33
Poppy,Fiora,194,134,60,69.07
Poppy,Pantheon,660,353,307,53.48
Poppy,Katarina,355,220,135,61.97
Poppy,Mel,790,393,397,49.75
Poppy,Viktor,232,114,118,49.14
Poppy,Lillia,250,106,144,42.4
Poppy,Aurora,368,181,187,49.18
Poppy,Zeri,256,122,134,47.66
Poppy,Rakan,266,100,166,37.59
Poppy,Renekton,175,92,83,52.57
Poppy,JarvanIV,144,64,80,44.44
Poppy,Jhin,666,315,351,47.3
Poppy,Sylas,286,154,132,53.85
Poppy,Warwick,550,270,280,49.09
Poppy,Briar,421,224,197,53.21
Poppy,Yasuo,691,366,325,52.97
Poppy,Irelia,300,157,143,52.33
Poppy,Lux,910,460,450,50.55
Poppy,Jax,373,187,186,50.13
Poppy,Ahri,512,236,276,46.09
Poppy,Rell,182,98,84,53.85
Poppy,Vladimir,310,155,155,50
Poppy,Zac,141,56,85,39.72
Poppy,Cassiopeia,174,105,69,60.34
Poppy,Ambessa,284,124,160,43.66
Poppy,Xayah,273,117,156,42.86
Poppy,AurelionSol,190,82,108,43.16
Poppy,Khazix,248,134,114,54.03
Poppy,Nautilus,487,263,224,54
Poppy,Darius,649,328,321,50.54
Poppy,Volibear,422,198,224,46.92
Poppy,Caitlyn,891,423,468,47.47
Poppy,TahmKench,426,235,191,55.16
Poppy,Chogath,367,152,215,41.42
Poppy,Talon,280,153,127,54.64
Poppy,Qiyana,92,45,47,48.91
Poppy,Seraphine,356,167,189,46.91
Poppy,FiddleSticks,216,76,140,35.19
Poppy,Singed,106,52,54,49.06
Poppy,Pyke,483,239,244,49.48
Poppy,Sett,617,298,319,48.3
Poppy,Ivern,92,50,42,54.35
Poppy,Neeko,284,159,125,55.99
Poppy,Senna,401,175,226,43.64
Poppy,Elise,167,75,92,44.91
Poppy,Galio,284,128,156,45.07
Poppy,Twitch,287,114,173,39.72
Poppy,Soraka,195,77,118,39.49
Poppy,Belveth,148,90,58,60.81
Poppy,Yone,847,420,427,49.59
Poppy,Mordekaiser,661,342,319,51.74
Poppy,Alistar,158,64,94,40.51
Poppy,Tryndamere,199,108,91,54.27
Poppy,Zyra,257,120,137,46.69
Poppy,Nilah,226,117,109,51.77
Poppy,Sion,281,144,137,51.25
Poppy,Ezreal,665,348,317,52.33
Poppy,Zilean,100,53,47,53
Poppy,Aatrox,373,187,186,50.13
Poppy,Gragas,165,91,74,55.15
Poppy,Teemo,419,220,199,52.51
Poppy,Evelynn,189,96,93,50.79
Poppy,Corki,76,40,36,52.63
Poppy,Rammus,150,78,72,52
Poppy,LeeSin,504,273,231,54.17
Poppy,Nasus,312,121,191,38.78
Poppy,Kaisa,526,298,228,56.65
Poppy,Bard,118,54,64,45.76
Poppy,Rengar,188,118,70,62.77
Poppy,Vayne,377,165,212,43.77
Poppy,Blitzcrank,206,125,81,60.68
Poppy,KSante,179,99,80,55.31
Poppy,Azir,168,102,66,60.71
Poppy,Zed,358,193,165,53.91
Poppy,Malzahar,299,171,128,57.19
Poppy,Nidalee,114,56,58,49.12
Poppy,Vex,229,109,120,47.6
Poppy,Sivir,174,68,106,39.08
Poppy,Karma,256,120,136,46.88
Poppy,Gangplank,147,98,49,66.67
Poppy,Lulu,320,166,154,51.88
Poppy,Ashe,628,330,298,52.55
Poppy,MasterYi,317,164,153,51.74
Poppy,Diana,546,311,235,56.96
Poppy,Varus,315,174,141,55.24
Poppy,Rumble,118,60,58,50.85
Poppy,Samira,394,190,204,48.22
Poppy,Kayn,537,296,241,55.12
Poppy,Hwei,242,146,96,60.33
Poppy,Draven,182,86,96,47.25
Poppy,Gnar,142,77,65,54.23
Poppy,Nocturne,315,154,161,48.89
Poppy,Trundle,241,106,135,43.98
Poppy,XinZhao,173,72,101,41.62
Poppy,Tristana,276,164,112,59.42
Poppy,Orianna,147,58,89,39.46
Poppy,Milio,215,91,124,42.33
Poppy,Illaoi,165,85,80,51.52
Poppy,Morgana,477,232,245,48.64
Poppy,Urgot,162,65,97,40.12
Poppy,Xerath,255,89,166,34.9
Poppy,Veigar,345,166,179,48.12
Poppy,Ekko,293,166,127,56.66
Poppy,Heimerdinger,142,50,92,35.21
Poppy,Kalista,203,96,107,47.29
Poppy,Thresh,579,300,279,51.81
Poppy,Akshan,186,78,108,41.94
Poppy,Nami,269,115,154,42.75
Poppy,Aphelios,227,103,124,45.37
Poppy,Lissandra,85,41,44,48.24
Poppy,Riven,188,129,59,68.62
Poppy,Yuumi,369,199,170,53.93
Poppy,MonkeyKing,162,90,72,55.56
Poppy,MissFortune,731,392,339,53.63
Poppy,Amumu,307,112,195,36.48
Poppy,Nunu,326,187,139,57.36
Poppy,Vi,367,186,181,50.68
Poppy,Velkoz,217,134,83,61.75
Poppy,RekSai,64,38,26,59.38
Poppy,Ziggs,86,42,44,48.84
Poppy,Shen,314,147,167,46.82
Poppy,Brand,226,118,108,52.21
Poppy,Graves,203,111,92,54.68
Poppy,Ornn,119,46,73,38.66
Poppy,TwistedFate,166,90,76,54.22
Poppy,Jinx,713,365,348,51.19
Poppy,Swain,364,171,193,46.98
Poppy,Annie,111,46,65,41.44
Poppy,Leona,366,203,163,55.46
Poppy,Shyvana,115,34,81,29.57
Poppy,Maokai,160,74,86,46.25
Poppy,Kled,81,42,39,51.85
Poppy,Shaco,391,191,200,48.85
Poppy,Yorick,283,122,161,43.11
Poppy,Kindred,209,121,88,57.89
Poppy,DrMundo,262,104,158,39.69
Poppy,Udyr,140,82,58,58.57
Poppy,Malphite,285,135,150,47.37
Poppy,Kassadin,43,15,28,34.88
Poppy,Garen,426,239,187,56.1
Poppy,Taric,118,56,62,47.46
Poppy,Camille,156,89,67,57.05
Poppy,Naafiri,135,80,55,59.26
Poppy,Syndra,215,93,122,43.26
Poppy,Lucian,232,149,83,64.22
Poppy,Viego,369,146,223,39.57
Poppy,Akali,330,189,141,57.27
Poppy,Kennen,130,55,75,42.31
Poppy,Zoe,174,96,78,55.17
Poppy,Kayle,272,182,90,66.91
Poppy,Leblanc,137,76,61,55.47
Poppy,Renata,104,41,63,39.42
Poppy,Quinn,149,98,51,65.77
Poppy,Taliyah,83,39,44,46.99
Poppy,Sona,143,53,90,37.06
Poppy,Braum,136,63,73,46.32
Poppy,Hecarim,118,87,31,73.73
Poppy,Sejuani,121,49,72,40.5
Poppy,Anivia,165,99,66,60
Poppy,KogMaw,134,59,75,44.03
Poppy,Skarner,79,37,42,46.84
Poppy,Janna,134,58,76,43.28
Poppy,Jayce,152,90,62,59.21
Poppy,Smolder,255,115,140,45.1
Poppy,Ryze,102,46,56,45.1
Poppy,Fizz,179,85,94,47.49
Poppy,Olaf,72,30,42,41.67
Poppy,Karthus,61,37,24,60.66
Poppy,Gwen,248,173,75,69.76
Twitch,Fiora,344,197,147,57.27
Twitch,Pantheon,801,323,478,40.32
Twitch,Katarina,377,218,159,57.82
Twitch,Mel,1111,599,512,53.92
Twitch,Viktor,345,159,186,46.09
Twitch,Kayle,352,149,203,42.33
Twitch,Sylas,416,203,213,48.8
Twitch,Qiyana,156,85,71,54.49
Twitch,Caitlyn,1078,546,532,50.65
Twitch,Renata,136,50,86,36.76
Twitch,Samira,423,210,213,49.65
Twitch,Kayn,797,462,335,57.97
Twitch,Nilah,336,164,172,48.81
Twitch,Leona,403,201,202,49.88
Twitch,Riven,243,146,97,60.08
Twitch,Amumu,487,215,272,44.15
Twitch,Zoe,238,140,98,58.82
Twitch,MissFortune,1249,584,665,46.76
Twitch,Sona,184,83,101,45.11
Twitch,Jax,483,218,265,45.13
Twitch,Briar,519,275,244,52.99
Twitch,Ahri,655,334,321,50.99
Twitch,Zeri,258,147,111,56.98
Twitch,Rell,230,107,123,46.52
Twitch,Nasus,410,200,210,48.78
Twitch,MonkeyKing,267,153,114,57.3
Twitch,Xayah,337,139,198,41.25
Twitch,Zac,137,37,100,27.01
Twitch,Jayce,235,102,133,43.4
Twitch,Rengar,229,139,90,60.7
Twitch,Swain,513,266,247,51.85
Twitch,Ezreal,778,420,358,53.98
Twitch,Neeko,311,171,140,54.98
Twitch,Morgana,698,346,352,49.57
Twitch,Tryndamere,296,131,165,44.26
Twitch,Graves,266,158,108,59.4
Twitch,Gnar,228,127,101,55.7
Twitch,Nunu,397,200,197,50.38
Twitch,Lucian,349,173,176,49.57
Twitch,Jhin,1092,578,514,52.93
Twitch,Lux,1445,739,706,51.14
Twitch,Ornn,193,92,101,47.67
Twitch,Warwick,818,414,404,50.61
Twitch,TwistedFate,195,115,80,58.97
Twitch,Gangplank,221,118,103,53.39
Twitch,Taliyah,100,81,19,81
Twitch,Sivir,221,148,73,66.97
Twitch,Soraka,336,173,163,51.49
Twitch,Yorick,522,237,285,45.4
Twitch,Volibear,582,249,333,42.78
Twitch,Cassiopeia,175,70,105,40
Twitch,Gwen,371,199,172,53.64
Twitch,Tristana,444,232,212,52.25
Twitch,Poppy,287,173,114,60.28
Twitch,Draven,276,121,155,43.84
Twitch,KogMaw,219,110,109,50.23
Twitch,Yuumi,484,231,253,47.73
Twitch,Khazix,379,201,178,53.03
Twitch,Yasuo,1004,529,475,52.69
Twitch,Seraphine,600,316,284,52.67
Twitch,Vi,363,137,226,37.74
Twitch,Nocturne,476,210,266,44.12
Twitch,Corki,187,82,105,43.85
Twitch,Shaco,502,250,252,49.8
Twitch,Naafiri,250,151,99,60.4
Twitch,Xerath,409,230,179,56.23
Twitch,Rammus,169,86,83,50.89
Twitch,Nami,426,251,175,58.92
Twitch,Irelia,415,203,212,48.92
Twitch,Malphite,366,174,192,47.54
Twitch,Vladimir,303,131,172,43.23
Twitch,Senna,479,245,234,51.15
Twitch,Aatrox,485,246,239,50.72
Twitch,Trundle,342,175,167,51.17
Twitch,Sett,815,352,463,43.19
Twitch,Jinx,1154,567,587,49.13
Twitch,Karma,362,211,151,58.29
Twitch,Darius,783,391,392,49.94
Twitch,Ekko,542,258,284,47.6
Twitch,Teemo,662,309,353,46.68
Twitch,Shyvana,142,78,64,54.93
Twitch,Galio,308,153,155,49.68
Twitch,Thresh,699,322,377,46.07
Twitch,Viego,538,267,271,49.63
Twitch,Kalista,284,124,160,43.66
Twitch,FiddleSticks,262,157,105,59.92
Twitch,Diana,707,375,332,53.04
Twitch,Yone,934,490,444,52.46
Twitch,Maokai,192,95,97,49.48
Twitch,Zed,491,242,249,49.29
Twitch,Rumble,79,38,41,48.1
Twitch,Nautilus,503,237,266,47.12
Twitch,Garen,695,382,313,54.96
Twitch,Fizz,230,96,134,41.74
Twitch,Kaisa,711,419,292,58.93
Twitch,Ryze,164,46,118,28.05
Twitch,Janna,153,81,72,52.94
Twitch,Heimerdinger,307,163,144,53.09
Twitch,Kindred,218,132,86,60.55
Twitch,TahmKench,507,242,265,47.73
Twitch,Pyke,535,287,248,53.64
Twitch,Shen,365,167,198,45.75
Twitch,Veigar,578,247,331,42.73
Twitch,Blitzcrank,356,157,199,44.1
Twitch,Elise,297,157,140,52.86
Twitch,Chogath,692,278,414,40.17
Twitch,Mordekaiser,813,403,410,49.57
Twitch,Lillia,306,160,146,52.29
Twitch,Singed,141,62,79,43.97
Twitch,Bard,169,78,91,46.15
Twitch,MasterYi,550,249,301,45.27
Twitch,Akali,513,304,209,59.26
Twitch,LeeSin,472,237,235,50.21
Twitch,Varus,435,214,221,49.2
Twitch,Rakan,263,104,159,39.54
Twitch,Ambessa,280,148,132,52.86
Twitch,Akshan,253,100,153,39.53
Twitch,Zyra,258,114,144,44.19
Twitch,Vayne,509,230,279,45.19
Twitch,Azir,131,67,64,51.15
Twitch,Ashe,1040,570,470,54.81
Twitch,Gragas,286,162,124,56.64
Twitch,AurelionSol,230,115,115,50
Twitch,Taric,75,37,38,49.33
Twitch,Evelynn,313,177,136,56.55
Twitch,Vex,275,149,126,54.18
Twitch,Brand,344,179,165,52.03
Twitch,Aphelios,392,172,220,43.88
Twitch,Camille,201,125,76,62.19
Twitch,Illaoi,220,112,108,50.91
Twitch,Hwei,362,200,162,55.25
Twitch,KSante,148,90,58,60.81
Twitch,Kassadin,137,61,76,44.53
Twitch,Udyr,212,151,61,71.23
Twitch,Malzahar,335,150,185,44.78
Twitch,Leblanc,210,109,101,51.9
Twitch,Sejuani,211,97,114,45.97
Twitch,Lulu,398,237,161,59.55
Twitch,JarvanIV,148,67,81,45.27
Twitch,Renekton,238,108,130,45.38
Twitch,Syndra,228,85,143,37.28
Twitch,Alistar,109,50,59,45.87
Twitch,Lissandra,168,58,110,34.52
Twitch,Aurora,594,343,251,57.74
Twitch,Urgot,177,70,107,39.55
Twitch,Braum,308,142,166,46.1
Twitch,Quinn,206,92,114,44.66
Twitch,Skarner,145,72,73,49.66
Twitch,Smolder,414,228,186,55.07
Twitch,DrMundo,330,137,193,41.52
Twitch,Sion,488,268,220,54.92
Twitch,Hecarim,187,130,57,69.52
Twitch,Ziggs,198,119,79,60.1
Twitch,Kennen,168,95,73,56.55
Twitch,Orianna,234,138,96,58.97
Twitch,XinZhao,269,150,119,55.76
Twitch,Talon,373,209,164,56.03
Twitch,Annie,74,43,31,58.11
Twitch,Velkoz,356,187,169,52.53
Twitch,Milio,288,139,149,48.26
Twitch,Ivern,97,49,48,50.52
Twitch,Zilean,155,81,74,52.26
Twitch,Olaf,115,66,49,57.39
Twitch,Kled,115,70,45,60.87
Twitch,Karthus,108,66,42,61.11
Twitch,Nidalee,103,60,43,58.25
Twitch,Anivia,117,68,49,58.12
Twitch,Belveth,136,55,81,40.44
Twitch,RekSai,84,33,51,39.29
Fiora,Darius,633,264,369,41.71
Fiora,Zac,110,56,54,50.91
Fiora,Hwei,240,156,84,65
Fiora,Poppy,194,60,134,30.93
Fiora,Twitch,344,147,197,42.73
Fiora,Mordekaiser,555,238,317,42.88
Fiora,Kindred,192,72,120,37.5
Fiora,Qiyana,99,57,42,57.58
Fiora,Ashe,520,265,255,50.96
Fiora,Sona,95,49,46,51.58
Fiora,Leblanc,71,39,32,54.93
Fiora,Briar,373,148,225,39.68
Fiora,Zoe,131,70,61,53.44
Fiora,Jinx,643,310,333,48.21
Fiora,Nasus,268,126,142,47.01
Fiora,Shaco,261,126,135,48.28
Fiora,Zed,270,138,132,51.11
Fiora,Varus,207,68,139,32.85
Fiora,Neeko,218,106,112,48.62
Fiora,Udyr,141,79,62,56.03
Fiora,Yorick,228,100,128,43.86
Fiora,Sivir,174,82,92,47.13
Fiora,Nautilus,434,198,236,45.62
Fiora,Gangplank,143,83,60,58.04
Fiora,Karthus,57,41,16,71.93
Fiora,Aurora,334,146,188,43.71
Fiora,Ezreal,464,215,249,46.34
Fiora,Senna,211,83,128,39.34
Fiora,Viego,406,210,196,51.72
Fiora,AurelionSol,138,54,84,39.13
Fiora,MissFortune,643,308,335,47.9
Fiora,Malphite,212,77,135,36.32
Fiora,Sett,494,215,279,43.52
Fiora,Sion,250,104,146,41.6
Fiora,Samira,325,143,182,44
Fiora,Alistar,98,46,52,46.94
Fiora,Viktor,225,112,113,49.78
Fiora,Nocturne,239,76,163,31.8
Fiora,Yasuo,673,282,391,41.9
Fiora,Nilah,158,65,93,41.14
Fiora,Bard,64,32,32,50
Fiora,Jax,244,142,102,58.2
Fiora,Diana,423,183,240,43.26
Fiora,Ahri,409,163,246,39.85
Fiora,Aphelios,212,107,105,50.47
Fiora,Aatrox,328,169,159,51.52
Fiora,Draven,156,78,78,50
Fiora,Talon,184,74,110,40.22
Fiora,Lissandra,90,41,49,45.56
Fiora,Vayne,286,147,139,51.4
Fiora,Milio,188,90,98,47.87
Fiora,Chogath,442,212,230,47.96
Fiora,Galio,272,94,178,34.56
Fiora,Soraka,156,63,93,40.38
Fiora,Mel,649,306,343,47.15
Fiora,Velkoz,217,118,99,54.38
Fiora,Kayle,204,86,118,42.16
Fiora,Sylas,257,105,152,40.86
Fiora,Lucian,152,86,66,56.58
Fiora,Nami,291,151,140,51.89
Fiora,MasterYi,336,146,190,43.45
Fiora,Yuumi,258,107,151,41.47
Fiora,Kayn,448,207,241,46.21
Fiora,Warwick,423,179,244,42.32
Fiora,Ziggs,122,58,64,47.54
Fiora,Malzahar,222,91,131,40.99
Fiora,Braum,158,85,73,53.8
Fiora,XinZhao,227,110,117,48.46
Fiora,Lux,847,403,444,47.58
Fiora,Vi,249,91,158,36.55
Fiora,Zilean,75,43,32,57.33
Fiora,LeeSin,255,119,136,46.67
Fiora,Akali,282,157,125,55.67
Fiora,Shyvana,81,49,32,60.49
Fiora,Garen,396,132,264,33.33
Fiora,Veigar,359,139,220,38.72
Fiora,Zyra,152,60,92,39.47
Fiora,KSante,155,96,59,61.94
Fiora,Olaf,29,21,8,72.41
Fiora,Yone,616,306,310,49.68
Fiora,Morgana,448,226,222,50.45
Fiora,Tristana,275,87,188,31.64
Fiora,Lulu,215,98,117,45.58
Fiora,Janna,108,37,71,34.26
Fiora,Caitlyn,633,270,363,42.65
Fiora,Ivern,44,17,27,38.64
Fiora,Tryndamere,182,51,131,28.02
Fiora,Ekko,264,91,173,34.47
Fiora,Thresh,336,137,199,40.77
Fiora,Camille,93,59,34,63.44
Fiora,Lillia,176,103,73,58.52
Fiora,Xerath,222,110,112,49.55
Fiora,Pyke,317,175,142,55.21
Fiora,Evelynn,164,97,67,59.15
Fiora,Riven,171,93,78,54.39
Fiora,Katarina,253,73,180,28.85
Fiora,Xayah,170,65,105,38.24
Fiora,Illaoi,139,74,65,53.24
Fiora,Rell,153,66,87,43.14
Fiora,Volibear,304,138,166,45.39
Fiora,Taliyah,63,27,36,42.86
Fiora,Pantheon,482,259,223,53.73
Fiora,Annie,76,44,32,57.89
Fiora,Swain,321,158,163,49.22
Fiora,Orianna,122,71,51,58.2
Fiora,Seraphine,339,173,166,51.03
Fiora,Teemo,295,135,160,45.76
Fiora,Vex,154,81,73,52.6
Fiora,Naafiri,108,34,74,31.48
Fiora,Gragas,204,120,84,58.82
Fiora,Maokai,109,58,51,53.21
Fiora,TahmKench,368,186,182,50.54
Fiora,Renekton,88,35,53,39.77
Fiora,Nunu,269,98,171,36.43
Fiora,Zeri,112,39,73,34.82
Fiora,Shen,212,111,101,52.36
Fiora,Jhin,419,213,206,50.84
Fiora,Kaisa,393,160,233,40.71
Fiora,Ornn,215,90,125,41.86
Fiora,Elise,196,93,103,47.45
Fiora,Leona,159,51,108,32.08
Fiora,Ambessa,190,91,99,47.89
Fiora,Karma,233,101,132,43.35
Fiora,Vladimir,182,102,80,56.04
Fiora,Amumu,273,151,122,55.31
Fiora,Smolder,186,83,103,44.62
Fiora,Blitzcrank,241,119,122,49.38
Fiora,MonkeyKing,147,86,61,58.5
Fiora,Gwen,259,117,142,45.17
Fiora,Cassiopeia,108,63,45,58.33
Fiora,Rakan,122,34,88,27.87
Fiora,Azir,80,47,33,58.75
Fiora,Kalista,134,73,61,54.48
Fiora,Urgot,110,34,76,30.91
Fiora,Corki,111,62,49,55.86
Fiora,Brand,198,73,125,36.87
Fiora,Irelia,275,146,129,53.09
Fiora,Graves,129,68,61,52.71
Fiora,Ryze,115,35,80,30.43
Fiora,Gnar,72,26,46,36.11
Fiora,Renata,89,29,60,32.58
Fiora,Trundle,121,37,84,30.58
Fiora,FiddleSticks,141,78,63,55.32
Fiora,DrMundo,177,50,127,28.25
Fiora,Akshan,134,55,79,41.04
Fiora,Quinn,103,43,60,41.75
Fiora,Heimerdinger,164,79,85,48.17
Fiora,Sejuani,94,42,52,44.68
Fiora,Hecarim,114,50,64,43.86
Fiora,Jayce,110,67,43,60.91
Fiora,Singed,63,29,34,46.03
Fiora,Syndra,130,82,48,63.08
Fiora,Fizz,105,51,54,48.57
Fiora,Khazix,219,132,87,60.27
Fiora,Rengar,147,85,62,57.82
Fiora,Rammus,91,45,46,49.45
Fiora,Anivia,57,25,32,43.86
Fiora,Rumble,31,14,17,45.16
Fiora,Belveth,121,51,70,42.15
Fiora,Kassadin,58,24,34,41.38
Fiora,TwistedFate,109,30,79,27.52
Fiora,Kennen,81,37,44,45.68
Fiora,KogMaw,129,67,62,51.94
Fiora,Skarner,86,47,39,54.65
Fiora,JarvanIV,88,39,49,44.32
Fiora,Kled,71,28,43,39.44
Fiora,Nidalee,43,31,12,72.09
Fiora,Taric,44,13,31,29.55
Fiora,RekSai,14,6,8,42.86
Katarina,Darius,955,475,480,49.74
Katarina,Zac,197,82,115,41.62
Katarina,Hwei,410,176,234,42.93
Katarina,Poppy,355,135,220,38.03
Katarina,Twitch,377,159,218,42.18
Katarina,Yone,1033,452,581,43.76
Katarina,Shaco,567,285,282,50.26
Katarina,Mel,1244,572,672,45.98
Katarina,Tristana,485,182,303,37.53
Katarina,Pyke,548,264,284,48.18
Katarina,Singed,171,74,97,43.27
Katarina,Graves,277,144,133,51.99
Katarina,Fizz,319,123,196,38.56
Katarina,Ziggs,237,102,135,43.04
Katarina,Pantheon,946,500,446,52.85
Katarina,Jax,382,176,206,46.07
Katarina,Briar,572,264,308,46.15
Katarina,Ahri,823,360,463,43.74
Katarina,Zeri,211,133,78,63.03
Katarina,Rell,301,132,169,43.85
Katarina,Aatrox,530,271,259,51.13
Katarina,Gwen,419,213,206,50.84
Katarina,Syndra,301,159,142,52.82
Katarina,Ashe,904,372,532,41.15
Katarina,Lulu,407,176,231,43.24
Katarina,Mordekaiser,808,329,479,40.72
Katarina,Zed,503,231,272,45.92
Katarina,Jinx,1011,440,571,43.52
Katarina,Lillia,317,144,173,45.43
Katarina,Samira,551,261,290,47.37
Katarina,Karma,413,179,234,43.34
Katarina,Rammus,183,73,110,39.89
Katarina,Blitzcrank,447,183,264,40.94
Katarina,Kayn,861,339,522,39.37
Katarina,Thresh,690,319,371,46.23
Katarina,Ezreal,832,457,375,54.93
Katarina,Yuumi,542,259,283,47.79
Katarina,Yorick,523,208,315,39.77
Katarina,Nunu,396,145,251,36.62
Katarina,Draven,293,138,155,47.1
Katarina,KogMaw,175,74,101,42.29
Katarina,Illaoi,216,90,126,41.67
Katarina,Khazix,420,197,223,46.9
Katarina,Kaisa,742,410,332,55.26
Katarina,Lux,1384,616,768,44.51
Katarina,Malphite,379,170,209,44.85
Katarina,Udyr,262,119,143,45.42
Katarina,Jhin,1013,481,532,47.48
Katarina,Evelynn,286,129,157,45.1
Katarina,XinZhao,325,144,181,44.31
Katarina,Akali,635,282,353,44.41
Katarina,Caitlyn,1295,551,744,42.55
Katarina,Maokai,277,135,142,48.74
Katarina,Yasuo,1072,468,604,43.66
Katarina,Naafiri,201,85,116,42.29
Katarina,Leblanc,197,91,106,46.19
Katarina,MissFortune,1243,451,792,36.28
Katarina,Nami,402,175,227,43.53
Katarina,Gangplank,271,104,167,38.38
Katarina,Nocturne,368,159,209,43.21
Katarina,Corki,230,122,108,53.04
Katarina,Ambessa,300,125,175,41.67
Katarina,Qiyana,201,87,114,43.28
Katarina,LeeSin,585,309,276,52.82
Katarina,Nasus,486,140,346,28.81
Katarina,Zoe,283,158,125,55.83
Katarina,Senna,448,180,268,40.18
Katarina,Shen,343,134,209,39.07
Katarina,Amumu,439,176,263,40.09
Katarina,Leona,369,138,231,37.4
Katarina,Warwick,772,279,493,36.14
Katarina,Malzahar,387,122,265,31.52
Katarina,Soraka,318,172,146,54.09
Katarina,Heimerdinger,297,127,170,42.76
Katarina,Viktor,409,155,254,37.9
Katarina,Morgana,716,319,397,44.55
Katarina,Vayne,481,243,238,50.52
Katarina,Aurora,481,230,251,47.82
Katarina,Nilah,295,174,121,58.98
Katarina,Cassiopeia,170,88,82,51.76
Katarina,Swain,544,229,315,42.1
Katarina,Camille,193,100,93,51.81
Katarina,Hecarim,238,118,120,49.58
Katarina,TwistedFate,169,85,84,50.3
Katarina,Nautilus,541,235,306,43.44
Katarina,Sejuani,240,100,140,41.67
Katarina,Veigar,693,278,415,40.12
Katarina,Garen,780,327,453,41.92
Katarina,MasterYi,566,271,295,47.88
Katarina,Sion,401,173,228,43.14
Katarina,Lucian,318,172,146,54.09
Katarina,Karthus,94,43,51,45.74
Katarina,TahmKench,512,206,306,40.23
Katarina,Renekton,255,123,132,48.24
Katarina,KSante,238,138,100,57.98
Katarina,Belveth,133,63,70,47.37
Katarina,Riven,226,102,124,45.13
Katarina,Rumble,99,41,58,41.41
Katarina,Akshan,188,86,102,45.74
Katarina,Sona,221,109,112,49.32
Katarina,Ornn,164,84,80,51.22
Katarina,Skarner,214,114,100,53.27
Katarina,Ekko,398,146,252,36.68
Katarina,Diana,720,345,375,47.92
Katarina,AurelionSol,181,80,101,44.2
Katarina,Neeko,377,154,223,40.85
Katarina,Vi,394,150,244,38.07
Katarina,Vladimir,308,168,140,54.55
Katarina,Anivia,157,68,89,43.31
Katarina,Seraphine,571,262,309,45.88
Katarina,Gragas,304,129,175,42.43
Katarina,Urgot,251,121,130,48.21
Katarina,Kindred,254,114,140,44.88
Katarina,Fiora,253,180,73,71.15
Katarina,Annie,212,107,105,50.47
Katarina,Bard,181,96,85,53.04
Katarina,Kennen,195,99,96,50.77
Katarina,Rengar,255,151,104,59.22
Katarina,Ivern,101,40,61,39.6
Katarina,Olaf,120,52,68,43.33
Katarina,Irelia,564,239,325,42.38
Katarina,Ryze,169,98,71,57.99
Katarina,Xerath,402,204,198,50.75
Katarina,Orianna,204,123,81,60.29
Katarina,Kled,120,63,57,52.5
Katarina,Galio,417,162,255,38.85
Katarina,Brand,337,178,159,52.82
Katarina,Kayle,460,173,287,37.61
Katarina,Smolder,475,195,280,41.05
Katarina,Janna,153,81,72,52.94
Katarina,MonkeyKing,362,161,201,44.48
Katarina,Trundle,315,109,206,34.6
Katarina,Kalista,247,119,128,48.18
Katarina,Velkoz,301,133,168,44.19
Katarina,Vex,297,80,217,26.94
Katarina,Milio,380,157,223,41.32
Katarina,Viego,692,341,351,49.28
Katarina,Chogath,586,246,340,41.98
Katarina,Alistar,171,103,68,60.23
Katarina,Nidalee,135,72,63,53.33
Katarina,JarvanIV,196,76,120,38.78
Katarina,Sylas,502,243,259,48.41
Katarina,Sett,1031,447,584,43.36
Katarina,Xayah,370,174,196,47.03
Katarina,Sivir,207,79,128,38.16
Katarina,Volibear,605,267,338,44.13
Katarina,Gnar,246,134,112,54.47
Katarina,Jayce,195,80,115,41.03
Katarina,FiddleSticks,201,134,67,66.67
Katarina,Azir,253,106,147,41.9
Katarina,Rakan,287,126,161,43.9
Katarina,Teemo,702,334,368,47.58
Katarina,Lissandra,122,48,74,39.34
Katarina,Taliyah,142,93,49,65.49
Katarina,Zyra,407,118,289,28.99
Katarina,Kassadin,126,48,78,38.1
Katarina,DrMundo,324,108,216,33.33
Katarina,Elise,391,168,223,42.97
Katarina,Renata,114,68,46,59.65
Katarina,Aphelios,318,156,162,49.06
Katarina,Braum,214,117,97,54.67
Katarina,Zilean,95,53,42,55.79
Katarina,Tryndamere,209,120,89,57.42
Katarina,Talon,314,147,167,46.82
Katarina,Varus,441,158,283,35.83
Katarina,Quinn,226,135,91,59.73
Katarina,Taric,104,57,47,54.81
Katarina,Shyvana,169,45,124,26.63
Katarina,RekSai,54,20,34,37.04
Mel,Darius,2422,1225,1197,50.58
Mel,Zac,510,274,236,53.73
Mel,Hwei,1017,494,523,48.57
Mel,Poppy,790,397,393,50.25
Mel,Twitch,1111,512,599,46.08
Mel,Renekton,763,384,379,50.33
Mel,Kayn,2077,979,1098,47.14
Mel,Katarina,1244,672,572,54.02
Mel,Draven,806,329,477,40.82
Mel,Yuumi,1425,647,778,45.4
Mel,Aurora,1233,643,590,52.15
Mel,Volibear,1536,663,873,43.16
Mel,Yasuo,2794,1267,1527,45.35
Mel,Vayne,1418,701,717,49.44
Mel,Shaco,1260,658,602,52.22
Mel,Talon,779,392,387,50.32
Mel,Tristana,1126,562,564,49.91
Mel,Alistar,469,246,223,52.45
Mel,Yorick,1335,623,712,46.67
Mel,FiddleSticks,720,393,327,54.58
Mel,Smolder,1011,511,500,50.54
Mel,Nautilus,1458,750,708,51.44
Mel,Illaoi,582,245,337,42.1
Mel,MonkeyKing,689,391,298,56.75
Mel,Yone,2604,1256,1348,48.23
Mel,Morgana,1653,823,830,49.79
Mel,Gangplank,509,298,211,58.55
Mel,Warwick,2135,991,1144,46.42
Mel,Akali,1440,701,739,48.68
Mel,Caitlyn,3072,1560,1512,50.78
Mel,Sona,594,284,310,47.81
Mel,Riven,709,405,304,57.12
Mel,Ahri,1788,932,856,52.13
Mel,Jinx,2728,1354,1374,49.63
Mel,Nasus,1022,502,520,49.12
Mel,Zed,1390,740,650,53.24
Mel,Varus,1122,487,635,43.4
Mel,Neeko,1037,594,443,57.28
Mel,Swain,1440,651,789,45.21
Mel,Malzahar,1040,483,557,46.44
Mel,Irelia,1191,632,559,53.06
Mel,Kalista,715,433,282,60.56
Mel,Gwen,825,408,417,49.45
Mel,Skarner,445,218,227,48.99
Mel,Kaisa,1897,1030,867,54.3
Mel,Seraphine,1323,635,688,48
Mel,Briar,1389,645,744,46.44
Mel,Vex,565,289,276,51.15
Mel,Milio,879,411,468,46.76
Mel,Mordekaiser,2150,1040,1110,48.37
Mel,Jhin,2451,1149,1302,46.88
Mel,Velkoz,887,388,499,43.74
Mel,Garen,1959,960,999,49
Mel,Zilean,437,261,176,59.73
Mel,Teemo,1696,791,905,46.64
Mel,Leona,1150,470,680,40.87
Mel,Sylas,1313,575,738,43.79
Mel,Kindred,717,385,332,53.7
Mel,Rell,712,379,333,53.23
Mel,Gnar,628,340,288,54.14
Mel,Leblanc,654,354,300,54.13
Mel,Karma,1020,467,553,45.78
Mel,Lillia,879,400,479,45.51
Mel,Vladimir,739,295,444,39.92
Mel,Lulu,1064,516,548,48.5
Mel,Veigar,1309,677,632,51.72
Mel,Kennen,445,261,184,58.65
Mel,Naafiri,594,308,286,51.85
Mel,Xayah,936,494,442,52.78
Mel,Soraka,897,448,449,49.94
Mel,Gragas,767,394,373,51.37
Mel,XinZhao,754,334,420,44.3
Mel,Lucian,816,445,371,54.53
Mel,Aatrox,1353,663,690,49
Mel,Viego,1635,826,809,50.52
Mel,Ashe,2267,1123,1144,49.54
Mel,Blitzcrank,968,562,406,58.06
Mel,Cassiopeia,594,274,320,46.13
Mel,Sett,2083,987,1096,47.38
Mel,Elise,775,417,358,53.81
Mel,Galio,1131,511,620,45.18
Mel,KSante,560,292,268,52.14
Mel,Senna,1237,603,634,48.75
Mel,Thresh,1775,854,921,48.11
Mel,Viktor,998,485,513,48.6
Mel,Pyke,1643,846,797,51.49
Mel,Nilah,848,359,489,42.33
Mel,Malphite,936,496,440,52.99
Mel,Diana,1825,921,904,50.47
Mel,Lux,3551,1860,1691,52.38
Mel,Orianna,831,430,401,51.74
Mel,Udyr,494,212,282,42.91
Mel,Sion,1102,478,624,43.38
Mel,AurelionSol,784,400,384,51.02
Mel,Samira,1254,667,587,53.19
Mel,Jax,1085,473,612,43.59
Mel,Rakan,726,376,350,51.79
Mel,Ekko,937,479,458,51.12
Mel,Fizz,866,467,399,53.93
Mel,Fiora,649,343,306,52.85
Mel,Ziggs,617,259,358,41.98
Mel,LeeSin,1353,665,688,49.15
Mel,Chogath,1917,932,985,48.62
Mel,Ezreal,2252,1098,1154,48.76
Mel,RekSai,177,108,69,61.02
Mel,Evelynn,670,398,272,59.4
Mel,Anivia,368,167,201,45.38
Mel,Olaf,287,133,154,46.34
Mel,MissFortune,2772,1314,1458,47.4
Mel,Pantheon,2216,980,1236,44.22
Mel,KogMaw,383,234,149,61.1
Mel,Urgot,636,303,333,47.64
Mel,Amumu,1219,554,665,45.45
Mel,Annie,362,189,173,52.21
Mel,Ivern,263,154,109,58.56
Mel,Rumble,261,116,145,44.44
Mel,Zoe,530,319,211,60.19
Mel,Renata,318,157,161,49.37
Mel,Qiyana,576,277,299,48.09
Mel,MasterYi,1408,657,751,46.66
Mel,TahmKench,1490,739,751,49.6
Mel,Trundle,809,385,424,47.59
Mel,Singed,383,167,216,43.6
Mel,Quinn,476,225,251,47.27
Mel,Jayce,599,336,263,56.09
Mel,Zyra,778,357,421,45.89
Mel,Nami,1324,694,630,52.42
Mel,Kayle,1068,492,576,46.07
Mel,Rengar,581,374,207,64.37
Mel,Janna,392,174,218,44.39
Mel,Nocturne,1164,559,605,48.02
Mel,Hecarim,488,206,282,42.21
Mel,Kassadin,342,125,217,36.55
Mel,JarvanIV,524,245,279,46.76
Mel,DrMundo,820,337,483,41.1
Mel,Heimerdinger,704,281,423,39.91
Mel,Ryze,504,308,196,61.11
Mel,Braum,596,299,297,50.17
Mel,Shen,821,423,398,51.52
Mel,Aphelios,1001,441,560,44.06
Mel,Bard,466,217,249,46.57
Mel,Sivir,678,286,392,42.18
Mel,Sejuani,432,224,208,51.85
Mel,Ornn,558,245,313,43.91
Mel,Ambessa,891,430,461,48.26
Mel,Shyvana,348,148,200,42.53
Mel,Akshan,507,248,259,48.92
Mel,Vi,1129,587,542,51.99
Mel,Xerath,1130,499,631,44.16
Mel,Syndra,709,345,364,48.66
Mel,TwistedFate,450,238,212,52.89
Mel,Lissandra,388,203,185,52.32
Mel,Brand,858,406,452,47.32
Mel,Khazix,782,412,370,52.69
Mel,Camille,513,255,258,49.71
Mel,Nunu,951,441,510,46.37
Mel,Maokai,642,281,361,43.77
Mel,Kled,306,129,177,42.16
Mel,Zeri,651,349,302,53.61
Mel,Tryndamere,720,342,378,47.5
Mel,Azir,568,253,315,44.54
Mel,Rammus,338,190,148,56.21
Mel,Corki,451,271,180,60.09
Mel,Karthus,373,173,200,46.38
Mel,Graves,688,339,349,49.27
Mel,Taric,252,129,123,51.19
Mel,Nidalee,435,246,189,56.55
Mel,Taliyah,403,202,201,50.12
Mel,Belveth,366,141,225,38.52
Viktor,Darius,777,360,417,46.33
Viktor,Zac,162,83,79,51.23
Viktor,Hwei,412,227,185,55.1
Viktor,Poppy,232,118,114,50.86
Viktor,Twitch,345,186,159,53.91
Viktor,Gangplank,161,57,104,35.4
Viktor,Gragas,325,174,151,53.54
Viktor,TwistedFate,165,90,75,54.55
Viktor,Lucian,273,130,143,47.62
Viktor,Leona,320,160,160,50
Viktor,Tryndamere,206,105,101,50.97
Viktor,Amumu,451,197,254,43.68
Viktor,Mel,998,513,485,51.4
Viktor,Kaisa,644,343,301,53.26
Viktor,Seraphine,426,214,212,50.23
Viktor,Fiora,225,113,112,50.22
Viktor,LeeSin,417,256,161,61.39
Viktor,Ziggs,164,70,94,42.68
Viktor,Jinx,825,435,390,52.73
Viktor,Senna,383,182,201,47.52
Viktor,Kennen,111,79,32,71.17
Viktor,Skarner,165,86,79,52.12
Viktor,Malzahar,360,148,212,41.11
Viktor,Yuumi,339,135,204,39.82
Viktor,Ivern,131,66,65,50.38
Viktor,Katarina,409,254,155,62.1
Viktor,Jhin,767,336,431,43.81
Viktor,Nami,442,199,243,45.02
Viktor,Sett,724,386,338,53.31
Viktor,Rammus,119,71,48,59.66
Viktor,Chogath,538,287,251,53.35
Viktor,Yasuo,804,454,350,56.47
Viktor,Nautilus,410,206,204,50.24
Viktor,Ahri,520,284,236,54.62
Viktor,Zilean,103,54,49,52.43
Viktor,Aurora,456,266,190,58.33
Viktor,Annie,110,59,51,53.64
Viktor,Elise,317,143,174,45.11
Viktor,Ashe,734,351,383,47.82
Viktor,Camille,184,80,104,43.48
Viktor,Kayn,626,339,287,54.15
Viktor,Zeri,161,86,75,53.42
Viktor,Illaoi,233,117,116,50.21
Viktor,Volibear,405,189,216,46.67
Viktor,Naafiri,175,83,92,47.43
Viktor,Lux,1001,523,478,52.25
Viktor,Yorick,290,107,183,36.9
Viktor,Mordekaiser,562,266,296,47.33
Viktor,Evelynn,245,123,122,50.2
Viktor,Tristana,378,203,175,53.7
Viktor,Sylas,414,187,227,45.17
Viktor,Shen,253,158,95,62.45
Viktor,MasterYi,360,140,220,38.89
Viktor,TahmKench,534,241,293,45.13
Viktor,Malphite,353,185,168,52.41
Viktor,Viego,503,256,247,50.89
Viktor,Galio,287,143,144,49.83
Viktor,Samira,358,174,184,48.6
Viktor,Braum,158,65,93,41.14
Viktor,Jax,309,144,165,46.6
Viktor,Graves,206,118,88,57.28
Viktor,Irelia,371,204,167,54.99
Viktor,Caitlyn,984,493,491,50.1
Viktor,Soraka,264,140,124,53.03
Viktor,Kindred,261,141,120,54.02
Viktor,Talon,265,139,126,52.45
Viktor,Varus,301,148,153,49.17
Viktor,Lulu,394,246,148,62.44
Viktor,Sejuani,158,69,89,43.67
Viktor,Aphelios,256,144,112,56.25
Viktor,Velkoz,258,121,137,46.9
Viktor,MonkeyKing,186,89,97,47.85
Viktor,Vladimir,198,105,93,53.03
Viktor,MissFortune,815,354,461,43.44
Viktor,Shaco,406,223,183,54.93
Viktor,Ekko,299,157,142,52.51
Viktor,Bard,148,58,90,39.19
Viktor,Orianna,246,140,106,56.91
Viktor,Pantheon,656,288,368,43.9
Viktor,Riven,163,103,60,63.19
Viktor,Yone,680,305,375,44.85
Viktor,Akshan,176,102,74,57.95
Viktor,Xayah,253,140,113,55.34
Viktor,Rakan,150,80,70,53.33
Viktor,Sion,348,195,153,56.03
Viktor,Nidalee,109,62,47,56.88
Viktor,KSante,163,93,70,57.06
Viktor,Ambessa,297,151,146,50.84
Viktor,Vi,372,150,222,40.32
Viktor,Corki,148,74,74,50
Viktor,Zyra,326,167,159,51.23
Viktor,Heimerdinger,161,69,92,42.86
Viktor,Briar,387,195,192,50.39
Viktor,Taric,98,34,64,34.69
Viktor,Jayce,172,100,72,58.14
Viktor,Nasus,407,203,204,49.88
Viktor,Cassiopeia,167,92,75,55.09
Viktor,Alistar,151,91,60,60.26
Viktor,Pyke,463,254,209,54.86
Viktor,Lillia,215,115,100,53.49
Viktor,Draven,206,100,106,48.54
Viktor,Milio,274,142,132,51.82
Viktor,Zoe,192,94,98,48.96
Viktor,Nilah,179,76,103,42.46
Viktor,Gnar,178,72,106,40.45
Viktor,Zed,385,207,178,53.77
Viktor,Trundle,245,121,124,49.39
Viktor,Veigar,561,219,342,39.04
Viktor,Warwick,562,270,292,48.04
Viktor,Thresh,555,309,246,55.68
Viktor,Blitzcrank,326,203,123,62.27
Viktor,Sona,161,62,99,38.51
Viktor,Taliyah,95,48,47,50.53
Viktor,XinZhao,215,78,137,36.28
Viktor,Brand,343,187,156,54.52
Viktor,Shyvana,96,48,48,50
Viktor,Vayne,458,206,252,44.98
Viktor,Morgana,576,274,302,47.57
Viktor,Teemo,541,214,327,39.56
Viktor,Xerath,263,105,158,39.92
Viktor,Renekton,197,91,106,46.19
Viktor,FiddleSticks,198,117,81,59.09
Viktor,Akali,458,199,259,43.45
Viktor,Singed,126,52,74,41.27
Viktor,Smolder,327,183,144,55.96
Viktor,Karma,373,165,208,44.24
Viktor,Kayle,347,158,189,45.53
Viktor,Janna,178,87,91,48.88
Viktor,Fizz,230,140,90,60.87
Viktor,Rell,197,126,71,63.96
Viktor,Vex,314,160,154,50.96
Viktor,Karthus,105,76,29,72.38
Viktor,Neeko,306,159,147,51.96
Viktor,Nunu,349,162,187,46.42
Viktor,Kassadin,70,27,43,38.57
Viktor,Swain,490,206,284,42.04
Viktor,Nocturne,303,184,119,60.73
Viktor,Maokai,246,133,113,54.07
Viktor,Diana,549,261,288,47.54
Viktor,Ezreal,759,447,312,58.89
Viktor,Kalista,204,143,61,70.1
Viktor,Aatrox,412,244,168,59.22
Viktor,Ryze,134,79,55,58.96
Viktor,Rengar,213,98,115,46.01
Viktor,JarvanIV,160,110,50,68.75
Viktor,Garen,490,236,254,48.16
Viktor,Azir,121,70,51,57.85
Viktor,DrMundo,250,116,134,46.4
Viktor,Hecarim,131,53,78,40.46
Viktor,Sivir,227,108,119,47.58
Viktor,Khazix,347,200,147,57.64
Viktor,Qiyana,177,80,97,45.2
Viktor,Syndra,204,93,111,45.59
Viktor,Anivia,159,56,103,35.22
Viktor,Quinn,146,58,88,39.73
Viktor,Leblanc,123,67,56,54.47
Viktor,Urgot,215,111,104,51.63
Viktor,Lissandra,91,48,43,52.75
Viktor,Udyr,122,66,56,54.1
Viktor,Renata,98,52,46,53.06
Viktor,Rumble,68,26,42,38.24
Viktor,Gwen,254,135,119,53.15
Viktor,Ornn,190,100,90,52.63
Viktor,Kled,95,45,50,47.37
Viktor,Olaf,85,29,56,34.12
Viktor,AurelionSol,204,104,100,50.98
Viktor,KogMaw,166,75,91,45.18
Viktor,Belveth,106,62,44,58.49
Viktor,RekSai,68,20,48,29.41
Pyke,Renekton,304,119,185,39.14
Pyke,Kayn,1083,461,622,42.57
Pyke,Katarina,548,284,264,51.82
Pyke,Draven,383,185,198,48.3
Pyke,Yuumi,692,306,386,44.22
Pyke,Gangplank,279,144,135,51.61
Pyke,Gragas,365,138,227,37.81
Pyke,TwistedFate,279,158,121,56.63
Pyke,Lucian,435,173,262,39.77
Pyke,Leona,581,270,311,46.47
Pyke,TahmKench,839,396,443,47.2
Pyke,Malphite,575,217,358,37.74
Pyke,Yasuo,1433,711,722,49.62
Pyke,Aphelios,540,249,291,46.11
Pyke,Mordekaiser,1143,472,671,41.29
Pyke,Briar,756,304,452,40.21
Pyke,Ryze,206,79,127,38.35
Pyke,Vex,327,111,216,33.94
Pyke,Naafiri,375,182,193,48.53
Pyke,Yone,1457,691,766,47.43
Pyke,MissFortune,1488,713,775,47.92
Pyke,Senna,651,295,356,45.31
Pyke,Viego,902,385,517,42.68
Pyke,Kindred,482,249,233,51.66
Pyke,Jhin,1424,598,826,41.99
Pyke,Sett,1186,519,667,43.76
Pyke,Talon,399,177,222,44.36
Pyke,FiddleSticks,388,191,197,49.23
Pyke,Ashe,1235,554,681,44.86
Pyke,Blitzcrank,583,268,315,45.97
Pyke,Warwick,1125,521,604,46.31
Pyke,Singed,170,79,91,46.47
Pyke,Samira,598,296,302,49.5
Pyke,Soraka,411,154,257,37.47
Pyke,Shen,473,198,275,41.86
Pyke,Diana,958,463,495,48.33
Pyke,DrMundo,401,158,243,39.4
Pyke,Ivern,136,52,84,38.24
Pyke,Nilah,400,141,259,35.25
Pyke,Nocturne,545,290,255,53.21
Pyke,Lissandra,186,83,103,44.62
Pyke,Lux,2010,1000,1010,49.75
Pyke,Darius,1227,592,635,48.25
Pyke,Poppy,483,244,239,50.52
Pyke,Sylas,822,344,478,41.85
Pyke,Rell,371,166,205,44.74
Pyke,Fizz,372,147,225,39.52
Pyke,Gnar,246,122,124,49.59
Pyke,Caitlyn,1661,796,865,47.92
Pyke,Neeko,534,221,313,41.39
Pyke,Irelia,651,224,427,34.41
Pyke,Tryndamere,410,197,213,48.05
Pyke,Amumu,711,334,377,46.98
Pyke,Mel,1643,797,846,48.51
Pyke,Kaisa,951,427,524,44.9
Pyke,Seraphine,666,325,341,48.8
Pyke,Zed,681,313,368,45.96
Pyke,Nunu,592,267,325,45.1
Pyke,KSante,257,129,128,50.19
Pyke,Zeri,354,177,177,50
Pyke,Lulu,542,256,286,47.23
Pyke,Azir,269,130,139,48.33
Pyke,Sejuani,214,95,119,44.39
Pyke,Udyr,285,120,165,42.11
Pyke,Evelynn,488,214,274,43.85
Pyke,Khazix,480,271,209,56.46
Pyke,Camille,235,130,105,55.32
Pyke,LeeSin,721,381,340,52.84
Pyke,Jax,731,343,388,46.92
Pyke,JarvanIV,235,119,116,50.64
Pyke,Hwei,634,305,329,48.11
Pyke,Bard,204,81,123,39.71
Pyke,Morgana,892,400,492,44.84
Pyke,Ambessa,375,164,211,43.73
Pyke,XinZhao,407,151,256,37.1
Pyke,Volibear,788,307,481,38.96
Pyke,Xerath,392,189,203,48.21
Pyke,Ezreal,1198,585,613,48.83
Pyke,Heimerdinger,453,213,240,47.02
Pyke,Aatrox,651,249,402,38.25
Pyke,Taric,133,33,100,24.81
Pyke,Varus,573,197,376,34.38
Pyke,Garen,1026,404,622,39.38
Pyke,Ekko,667,292,375,43.78
Pyke,Ahri,1010,493,517,48.81
Pyke,Jinx,1515,707,808,46.67
Pyke,Zilean,166,71,95,42.77
Pyke,Chogath,832,336,496,40.38
Pyke,Yorick,604,229,375,37.91
Pyke,Thresh,1053,537,516,51
Pyke,Trundle,309,147,162,47.57
Pyke,MasterYi,705,318,387,45.11
Pyke,Sivir,393,162,231,41.22
Pyke,Tristana,733,316,417,43.11
Pyke,Gwen,477,213,264,44.65
Pyke,Maokai,321,153,168,47.66
Pyke,Veigar,806,315,491,39.08
Pyke,Brand,516,236,280,45.74
Pyke,Urgot,318,138,180,43.4
Pyke,Zyra,472,185,287,39.19
Pyke,Malzahar,505,187,318,37.03
Pyke,Quinn,262,146,116,55.73
Pyke,Teemo,1095,492,603,44.93
Pyke,Galio,467,249,218,53.32
Pyke,Nasus,538,209,329,38.85
Pyke,AurelionSol,366,139,227,37.98
Pyke,Qiyana,246,117,129,47.56
Pyke,Nami,636,312,324,49.06
Pyke,Orianna,311,154,157,49.52
Pyke,RekSai,106,74,32,69.81
Pyke,Shaco,654,302,352,46.18
Pyke,Kayle,569,252,317,44.29
Pyke,Aurora,689,306,383,44.41
Pyke,Fiora,317,142,175,44.79
Pyke,Nautilus,842,345,497,40.97
Pyke,Akali,772,344,428,44.56
Pyke,Hecarim,261,113,148,43.3
Pyke,Smolder,539,263,276,48.79
Pyke,Pantheon,1351,542,809,40.12
Pyke,MonkeyKing,312,110,202,35.26
Pyke,Vladimir,388,189,199,48.71
Pyke,Twitch,535,248,287,46.36
Pyke,Anivia,263,142,121,53.99
Pyke,Ziggs,292,129,163,44.18
Pyke,Elise,394,179,215,45.43
Pyke,Leblanc,245,105,140,42.86
Pyke,Vi,496,203,293,40.93
Pyke,Xayah,381,193,188,50.66
Pyke,Zac,166,90,76,54.22
Pyke,Lillia,432,178,254,41.2
Pyke,Rammus,294,128,166,43.54
Pyke,Illaoi,310,142,168,45.81
Pyke,Belveth,203,68,135,33.5
Pyke,Zoe,330,169,161,51.21
Pyke,Viktor,463,209,254,45.14
Pyke,Milio,346,175,171,50.58
Pyke,Nidalee,160,73,87,45.63
Pyke,Kled,152,54,98,35.53
Pyke,Annie,156,74,82,47.44
Pyke,Olaf,140,67,73,47.86
Pyke,Swain,726,285,441,39.26
Pyke,Vayne,657,282,375,42.92
Pyke,Riven,295,195,100,66.1
Pyke,Kassadin,149,58,91,38.93
Pyke,Sion,537,217,320,40.41
Pyke,Rengar,279,182,97,65.23
Pyke,Akshan,242,83,159,34.3
Pyke,Rakan,332,141,191,42.47
Pyke,Skarner,246,162,84,65.85
Pyke,Jayce,277,136,141,49.1
Pyke,Janna,242,114,128,47.11
Pyke,Graves,402,235,167,58.46
Pyke,Syndra,403,162,241,40.2
Pyke,Shyvana,221,109,112,49.32
Pyke,Karma,473,208,265,43.97
Pyke,Corki,226,90,136,39.82
Pyke,Kalista,277,130,147,46.93
Pyke,Alistar,246,131,115,53.25
Pyke,KogMaw,208,88,120,42.31
Pyke,Cassiopeia,274,133,141,48.54
Pyke,Sona,246,75,171,30.49
Pyke,Ornn,296,115,181,38.85
Pyke,Rumble,120,56,64,46.67
Pyke,Velkoz,400,214,186,53.5
Pyke,Karthus,158,71,87,44.94
Pyke,Braum,303,127,176,41.91
Pyke,Taliyah,157,64,93,40.76
Pyke,Renata,136,81,55,59.56
Pyke,Kennen,232,87,145,37.5
Renekton,Yone,546,329,217,60.26
Renekton,Shaco,204,106,98,51.96
Renekton,Mel,763,379,384,49.67
Renekton,Tristana,250,125,125,50
Renekton,Pyke,304,185,119,60.86
Renekton,Aurora,306,170,136,55.56
Renekton,Volibear,355,230,125,64.79
Renekton,Yasuo,633,267,366,42.18
Renekton,Vayne,339,169,170,49.85
Renekton,Swain,263,99,164,37.64
Renekton,Malzahar,193,96,97,49.74
Renekton,Irelia,204,101,103,49.51
Renekton,Kalista,164,64,100,39.02
Renekton,Poppy,175,83,92,47.43
Renekton,Smolder,264,148,116,56.06
Renekton,Ekko,245,121,124,49.39
Renekton,Mordekaiser,451,217,234,48.12
Renekton,Yuumi,192,117,75,60.94
Renekton,Jax,261,136,125,52.11
Renekton,FiddleSticks,105,44,61,41.9
Renekton,Cassiopeia,103,48,55,46.6
Renekton,Caitlyn,599,318,281,53.09
Renekton,Milio,93,36,57,38.71
Renekton,Tryndamere,166,85,81,51.2
Renekton,Diana,370,187,183,50.54
Renekton,Lux,773,386,387,49.94
Renekton,Sivir,108,56,52,51.85
Renekton,Soraka,183,91,92,49.73
Renekton,Kayn,368,165,203,44.84
Renekton,Ezreal,496,290,206,58.47
Renekton,Brand,161,93,68,57.76
Renekton,Nunu,218,117,101,53.67
Renekton,Kaisa,407,199,208,48.89
Renekton,Nami,263,106,157,40.3
Renekton,Camille,108,59,49,54.63
Renekton,Katarina,255,132,123,51.76
Renekton,Zeri,137,77,60,56.2
Renekton,Rengar,126,80,46,63.49
Renekton,Akali,257,135,122,52.53
Renekton,Lucian,119,50,69,42.02
Renekton,Viego,421,241,180,57.24
Renekton,Samira,237,112,125,47.26
Renekton,Leona,202,90,112,44.55
Renekton,Shen,141,74,67,52.48
Renekton,Leblanc,139,73,66,52.52
Renekton,Hwei,185,85,100,45.95
Renekton,Kayle,157,90,67,57.32
Renekton,Janna,91,54,37,59.34
Renekton,Zoe,101,40,61,39.6
Renekton,Gragas,160,85,75,53.13
Renekton,Garen,478,229,249,47.91
Renekton,Nilah,184,96,88,52.17
Renekton,Thresh,453,232,221,51.21
Renekton,Kennen,102,55,47,53.92
Renekton,Evelynn,108,76,32,70.37
Renekton,Trundle,182,100,82,54.95
Renekton,Rammus,90,25,65,27.78
Renekton,Sylas,288,113,175,39.24
Renekton,Xayah,202,105,97,51.98
Renekton,Blitzcrank,225,116,109,51.56
Renekton,MonkeyKing,121,56,65,46.28
Renekton,Vex,156,71,85,45.51
Renekton,Jhin,440,181,259,41.14
Renekton,Nautilus,280,143,137,51.07
Renekton,Darius,534,244,290,45.69
Renekton,Senna,282,159,123,56.38
Renekton,Ashe,522,267,255,51.15
Renekton,Sion,183,73,110,39.89
Renekton,Nidalee,47,34,13,72.34
Renekton,Jinx,496,260,236,52.42
Renekton,KSante,96,35,61,36.46
Renekton,Sejuani,107,42,65,39.25
Renekton,Zed,280,178,102,63.57
Renekton,Naafiri,173,63,110,36.42
Renekton,Draven,195,98,97,50.26
Renekton,Veigar,344,188,156,54.65
Renekton,Neeko,198,108,90,54.55
Renekton,Nasus,294,155,139,52.72
Renekton,Gangplank,119,51,68,42.86
Renekton,Belveth,83,34,49,40.96
Renekton,Maokai,127,71,56,55.91
Renekton,Riven,172,116,56,67.44
Renekton,Karma,203,110,93,54.19
Renekton,Ambessa,233,118,115,50.64
Renekton,Graves,194,105,89,54.12
Renekton,Ahri,425,222,203,52.24
Renekton,Teemo,279,107,172,38.35
Renekton,Briar,233,103,130,44.21
Renekton,Rakan,142,93,49,65.49
Renekton,Jayce,74,42,32,56.76
Renekton,LeeSin,280,122,158,43.57
Renekton,Zilean,80,57,23,71.25
Renekton,Fiora,88,53,35,60.23
Renekton,Elise,242,127,115,52.48
Renekton,Pantheon,472,225,247,47.67
Renekton,Khazix,164,71,93,43.29
Renekton,Braum,143,47,96,32.87
Renekton,Velkoz,209,102,107,48.8
Renekton,Malphite,190,74,116,38.95
Renekton,Lillia,183,91,92,49.73
Renekton,Ryze,70,42,28,60
Renekton,Vi,261,130,131,49.81
Renekton,Fizz,125,53,72,42.4
Renekton,Vladimir,198,132,66,66.67
Renekton,Kled,59,22,37,37.29
Renekton,Morgana,362,216,146,59.67
Renekton,Seraphine,279,138,141,49.46
Renekton,Sett,547,219,328,40.04
Renekton,Viktor,197,106,91,53.81
Renekton,Aatrox,295,192,103,65.08
Renekton,Warwick,436,237,199,54.36
Renekton,Xerath,198,103,95,52.02
Renekton,Olaf,64,32,32,50
Renekton,MissFortune,525,259,266,49.33
Renekton,Kindred,127,56,71,44.09
Renekton,Gnar,127,63,64,49.61
Renekton,Karthus,34,15,19,44.12
Renekton,Twitch,238,130,108,54.62
Renekton,JarvanIV,142,61,81,42.96
Renekton,Bard,118,38,80,32.2
Renekton,Udyr,106,51,55,48.11
Renekton,MasterYi,313,176,137,56.23
Renekton,Annie,91,60,31,65.93
Renekton,Zyra,191,102,89,53.4
Renekton,Gwen,189,106,83,56.08
Renekton,Syndra,150,46,104,30.67
Renekton,Ziggs,125,64,61,51.2
Renekton,Singed,50,12,38,24
Renekton,Alistar,109,80,29,73.39
Renekton,Sona,86,40,46,46.51
Renekton,RekSai,19,13,6,68.42
Renekton,Quinn,115,64,51,55.65
Renekton,DrMundo,143,86,57,60.14
Renekton,Nocturne,191,101,90,52.88
Renekton,Orianna,148,84,64,56.76
Renekton,Galio,192,91,101,47.4
Renekton,Illaoi,177,68,109,38.42
Renekton,TwistedFate,118,32,86,27.12
Renekton,TahmKench,293,156,137,53.24
Renekton,Rell,132,91,41,68.94
Renekton,Kassadin,58,11,47,18.97
Renekton,KogMaw,92,42,50,45.65
Renekton,Shyvana,67,22,45,32.84
Renekton,Heimerdinger,109,73,36,66.97
Renekton,Hecarim,99,49,50,49.49
Renekton,Skarner,149,84,65,56.38
Renekton,Qiyana,103,68,35,66.02
Renekton,Rumble,58,29,29,50
Renekton,Chogath,320,158,162,49.38
Renekton,XinZhao,163,75,88,46.01
Renekton,Amumu,263,140,123,53.23
Renekton,Yorick,305,141,164,46.23
Renekton,Varus,246,114,132,46.34
Renekton,Zac,155,93,62,60
Renekton,Akshan,120,65,55,54.17
Renekton,Taric,66,34,32,51.52
Renekton,Talon,203,124,79,61.08
Renekton,Urgot,141,52,89,36.88
Renekton,Lulu,170,87,83,51.18
Renekton,Renata,71,51,20,71.83
Renekton,Ornn,97,33,64,34.02
Renekton,Corki,112,40,72,35.71
Renekton,Lissandra,58,24,34,41.38
Renekton,Azir,72,47,25,65.28
Renekton,Ivern,65,34,31,52.31
Renekton,Aphelios,175,86,89,49.14
Renekton,Anivia,82,49,33,59.76
Renekton,AurelionSol,124,72,52,58.06
Renekton,Taliyah,71,48,23,67.61
Kayn,Yone,2048,1004,1044,49.02
Kayn,Shaco,948,566,382,59.7
Kayn,Mel,2077,1098,979,52.86
Kayn,Tristana,819,393,426,47.99
Kayn,Pyke,1083,622,461,57.43
Kayn,Gwen,522,274,248,52.49
Kayn,Vi,893,449,444,50.28
Kayn,Zed,937,474,463,50.59
Kayn,Jhin,1660,775,885,46.69
Kayn,Soraka,580,253,327,43.62
Kayn,Aatrox,969,515,454,53.15
Kayn,Brand,761,405,356,53.22
Kayn,Irelia,945,462,483,48.89
Kayn,Caitlyn,2217,1057,1160,47.68
Kayn,Milio,454,191,263,42.07
Kayn,Teemo,1315,611,704,46.46
Kayn,Warwick,1669,719,950,43.08
Kayn,Azir,264,177,87,67.05
Kayn,MissFortune,2053,1066,987,51.92
Kayn,Neeko,823,442,381,53.71
Kayn,Trundle,479,227,252,47.39
Kayn,MasterYi,1227,531,696,43.28
Kayn,Veigar,1102,503,599,45.64
Kayn,Gangplank,380,215,165,56.58
Kayn,Ivern,190,101,89,53.16
Kayn,Swain,1027,514,513,50.05
Kayn,Ornn,416,167,249,40.14
Kayn,Udyr,405,208,197,51.36
Kayn,Lux,2758,1290,1468,46.77
Kayn,Ezreal,1584,855,729,53.98
Kayn,Singed,292,125,167,42.81
Kayn,Graves,578,309,269,53.46
Kayn,Fizz,598,283,315,47.32
Kayn,Ziggs,383,163,220,42.56
Kayn,Pantheon,1765,936,829,53.03
Kayn,XinZhao,495,218,277,44.04
Kayn,Yasuo,2020,993,1027,49.16
Kayn,Jinx,1957,998,959,51
Kayn,FiddleSticks,519,236,283,45.47
Kayn,Akali,1015,561,454,55.27
Kayn,Twitch,797,335,462,42.03
Kayn,Senna,715,357,358,49.93
Kayn,Riven,403,230,173,57.07
Kayn,Amumu,830,369,461,44.46
Kayn,Zoe,453,218,235,48.12
Kayn,Sona,371,173,198,46.63
Kayn,Heimerdinger,528,244,284,46.21
Kayn,Talon,648,383,265,59.1
Kayn,Ahri,1232,570,662,46.27
Kayn,Kalista,474,239,235,50.42
Kayn,Sett,1596,697,899,43.67
Kayn,Ashe,1666,874,792,52.46
Kayn,Blitzcrank,792,427,365,53.91
Kayn,Mordekaiser,1594,745,849,46.74
Kayn,Sylas,982,477,505,48.57
Kayn,Xayah,730,299,431,40.96
Kayn,Smolder,730,378,352,51.78
Kayn,Ekko,774,405,369,52.33
Kayn,Yuumi,990,463,527,46.77
Kayn,Cassiopeia,351,213,138,60.68
Kayn,Nasus,810,379,431,46.79
Kayn,MonkeyKing,462,203,259,43.94
Kayn,Zac,345,167,178,48.41
Kayn,Shen,709,344,365,48.52
Kayn,Diana,1590,740,850,46.54
Kayn,Samira,957,480,477,50.16
Kayn,Camille,346,194,152,56.07
Kayn,Katarina,861,522,339,60.63
Kayn,Zyra,614,277,337,45.11
Kayn,Lulu,670,340,330,50.75
Kayn,Volibear,1102,565,537,51.27
Kayn,Vayne,952,433,519,45.48
Kayn,Briar,1055,517,538,49
Kayn,Nautilus,962,518,444,53.85
Kayn,Darius,1856,928,928,50
Kayn,Maokai,528,265,263,50.19
Kayn,Malphite,937,488,449,52.08
Kayn,Sion,728,377,351,51.79
Kayn,Alistar,241,145,96,60.17
Kayn,Rammus,355,187,168,52.68
Kayn,Sivir,414,198,216,47.83
Kayn,Xerath,733,384,349,52.39
Kayn,Gragas,610,340,270,55.74
Kayn,LeeSin,1074,646,428,60.15
Kayn,Shyvana,242,73,169,30.17
Kayn,Nilah,532,274,258,51.5
Kayn,Nami,992,525,467,52.92
Kayn,Sejuani,406,211,195,51.97
Kayn,Tryndamere,621,302,319,48.63
Kayn,TahmKench,1002,511,491,51
Kayn,Naafiri,432,209,223,48.38
Kayn,Jax,872,417,455,47.82
Kayn,Morgana,1300,612,688,47.08
Kayn,Galio,659,301,358,45.68
Kayn,Illaoi,541,191,350,35.3
Kayn,Leona,803,342,461,42.59
Kayn,Vex,583,260,323,44.6
Kayn,Thresh,1133,542,591,47.84
Kayn,Nocturne,930,449,481,48.28
Kayn,Orianna,381,185,196,48.56
Kayn,Khazix,645,301,344,46.67
Kayn,Varus,680,354,326,52.06
Kayn,Malzahar,738,285,453,38.62
Kayn,Renekton,368,203,165,55.16
Kayn,Viego,1295,698,597,53.9
Kayn,Skarner,280,149,131,53.21
Kayn,DrMundo,613,276,337,45.02
Kayn,Hwei,662,330,332,49.85
Kayn,Aurora,780,370,410,47.44
Kayn,Lillia,627,305,322,48.64
Kayn,Lissandra,273,135,138,49.45
Kayn,Garen,1419,675,744,47.57
Kayn,TwistedFate,369,167,202,45.26
Kayn,Annie,251,140,111,55.78
Kayn,Olaf,174,95,79,54.6
Kayn,Fiora,448,241,207,53.79
Kayn,Kaisa,1334,740,594,55.47
Kayn,Ryze,214,81,133,37.85
Kayn,Rengar,471,296,175,62.85
Kayn,Syndra,541,262,279,48.43
Kayn,JarvanIV,363,181,182,49.86
Kayn,Lucian,566,280,286,49.47
Kayn,Karthus,284,178,106,62.68
Kayn,Karma,696,385,311,55.32
Kayn,Gnar,323,172,151,53.25
Kayn,AurelionSol,370,181,189,48.92
Kayn,Vladimir,526,238,288,45.25
Kayn,Hecarim,427,187,240,43.79
Kayn,Viktor,626,287,339,45.85
Kayn,Leblanc,302,158,144,52.32
Kayn,Poppy,537,241,296,44.88
Kayn,Kayle,622,328,294,52.73
Kayn,Janna,299,128,171,42.81
Kayn,Ambessa,559,312,247,55.81
Kayn,Zilean,292,137,155,46.92
Kayn,Taric,174,70,104,40.23
Kayn,Braum,449,247,202,55.01
Kayn,Elise,621,361,260,58.13
Kayn,Nidalee,251,155,96,61.75
Kayn,Aphelios,635,345,290,54.33
Kayn,Rakan,580,259,321,44.66
Kayn,Yorick,854,329,525,38.52
Kayn,Evelynn,465,256,209,55.05
Kayn,RekSai,108,39,69,36.11
Kayn,Kennen,378,150,228,39.68
Kayn,Velkoz,598,317,281,53.01
Kayn,KSante,367,195,172,53.13
Kayn,Jayce,325,195,130,60
Kayn,Renata,254,145,109,57.09
Kayn,Kindred,525,283,242,53.9
Kayn,Qiyana,291,159,132,54.64
Kayn,Rell,467,239,228,51.18
Kayn,Akshan,339,105,234,30.97
Kayn,Nunu,806,465,341,57.69
Kayn,KogMaw,310,181,129,58.39
Kayn,Corki,338,176,162,52.07
Kayn,Chogath,1205,665,540,55.19
Kayn,Urgot,472,193,279,40.89
Kayn,Kled,187,72,115,38.5
Kayn,Seraphine,1013,492,521,48.57
Kayn,Draven,543,254,289,46.78
Kayn,Kassadin,190,106,84,55.79
Kayn,Belveth,238,121,117,50.84
Kayn,Taliyah,257,129,128,50.19
Kayn,Zeri,387,213,174,55.04
Kayn,Anivia,292,161,131,55.14
Kayn,Bard,246,142,104,57.72
Kayn,Rumble,188,101,87,53.72
Kayn,Quinn,340,156,184,45.88
Draven,Yone,676,341,335,50.44
Draven,Shaco,321,158,163,49.22
Draven,Mel,806,477,329,59.18
Draven,Tristana,333,165,168,49.55
Draven,Pyke,383,198,185,51.7
Draven,Talon,231,95,136,41.13
Draven,Aurora,363,173,190,47.66
Draven,Yasuo,735,313,422,42.59
Draven,Alistar,118,56,62,47.46
Draven,Gangplank,202,122,80,60.4
Draven,MasterYi,286,138,148,48.25
Draven,Veigar,403,185,218,45.91
Draven,Swain,367,135,232,36.78
Draven,AurelionSol,126,45,81,35.71
Draven,Ashe,681,322,359,47.28
Draven,Velkoz,226,98,128,43.36
Draven,Aatrox,288,204,84,70.83
Draven,Viego,447,208,239,46.53
Draven,Sylas,316,166,150,52.53
Draven,Blitzcrank,224,140,84,62.5
Draven,Urgot,194,86,108,44.33
Draven,LeeSin,370,188,182,50.81
Draven,TwistedFate,143,67,76,46.85
Draven,Rakan,146,72,74,49.32
Draven,Evelynn,159,83,76,52.2
Draven,Irelia,327,140,187,42.81
Draven,Lux,997,474,523,47.54
Draven,Jax,222,85,137,38.29
Draven,Graves,198,93,105,46.97
Draven,Katarina,293,155,138,52.9
Draven,Twitch,276,155,121,56.16
Draven,Seraphine,325,157,168,48.31
Draven,Kalista,177,94,83,53.11
Draven,Gragas,292,111,181,38.01
Draven,Orianna,128,76,52,59.38
Draven,Gnar,120,79,41,65.83
Draven,Fiora,156,78,78,50
Draven,Ekko,310,183,127,59.03
Draven,Kassadin,49,26,23,53.06
Draven,Caitlyn,753,352,401,46.75
Draven,TahmKench,296,141,155,47.64
Draven,Akali,341,191,150,56.01
Draven,Zac,151,56,95,37.09
Draven,Diana,467,184,283,39.4
Draven,Vayne,402,171,231,42.54
Draven,Mordekaiser,519,250,269,48.17
Draven,Zeri,174,75,99,43.1
Draven,Sett,562,258,304,45.91
Draven,Volibear,383,191,192,49.87
Draven,KogMaw,82,44,38,53.66
Draven,Gwen,217,106,111,48.85
Draven,JarvanIV,100,41,59,41
Draven,Senna,341,196,145,57.48
Draven,Pantheon,644,315,329,48.91
Draven,Vex,180,86,94,47.78
Draven,Kaisa,549,286,263,52.09
Draven,Poppy,182,96,86,52.75
Draven,Warwick,532,244,288,45.86
Draven,Ryze,83,24,59,28.92
Draven,Garen,489,231,258,47.24
Draven,Briar,353,166,187,47.03
Draven,Malzahar,240,95,145,39.58
Draven,Fizz,197,84,113,42.64
Draven,Teemo,489,257,232,52.56
Draven,Zoe,172,117,55,68.02
Draven,Darius,710,323,387,45.49
Draven,Qiyana,125,66,59,52.8
Draven,Ziggs,156,74,82,47.44
Draven,MissFortune,781,428,353,54.8
Draven,Nami,378,173,205,45.77
Draven,RekSai,46,26,20,56.52
Draven,Brand,233,146,87,62.66
Draven,Vladimir,165,81,84,49.09
Draven,Soraka,219,83,136,37.9
Draven,Cassiopeia,139,79,60,56.83
Draven,Karma,223,97,126,43.5
Draven,Chogath,396,181,215,45.71
Draven,Aphelios,220,99,121,45
Draven,Smolder,250,134,116,53.6
Draven,Hwei,291,160,131,54.98
Draven,Milio,171,42,129,24.56
Draven,KSante,154,68,86,44.16
Draven,Nautilus,365,163,202,44.66
Draven,Kayle,241,102,139,42.32
Draven,Amumu,262,131,131,50
Draven,Janna,78,46,32,58.97
Draven,DrMundo,179,64,115,35.75
Draven,Kindred,230,147,83,63.91
Draven,Rell,179,91,88,50.84
Draven,Renekton,195,97,98,49.74
Draven,Zilean,93,30,63,32.26
Draven,Nocturne,280,96,184,34.29
Draven,Lucian,163,93,70,57.06
Draven,Udyr,165,55,110,33.33
Draven,Annie,127,69,58,54.33
Draven,Maokai,193,89,104,46.11
Draven,Trundle,179,80,99,44.69
Draven,Samira,374,197,177,52.67
Draven,Yorick,304,127,177,41.78
Draven,Neeko,236,119,117,50.42
Draven,Leblanc,154,82,72,53.25
Draven,Hecarim,186,98,88,52.69
Draven,MonkeyKing,174,90,84,51.72
Draven,Ezreal,666,310,356,46.55
Draven,Malphite,265,105,160,39.62
Draven,Heimerdinger,147,59,88,40.14
Draven,Naafiri,122,49,73,40.16
Draven,Thresh,521,211,310,40.5
Draven,Viktor,206,106,100,51.46
Draven,Nunu,210,115,95,54.76
Draven,Shen,233,102,131,43.78
Draven,Singed,143,54,89,37.76
Draven,Lulu,258,134,124,51.94
Draven,Sejuani,106,53,53,50
Draven,Leona,221,91,130,41.18
Draven,Azir,114,58,56,50.88
Draven,Sivir,158,94,64,59.49
Draven,Sion,297,154,143,51.85
Draven,Jinx,682,340,342,49.85
Draven,Ahri,402,190,212,47.26
Draven,Ambessa,222,143,79,64.41
Draven,Morgana,435,222,213,51.03
Draven,Kayn,543,289,254,53.22
Draven,Jhin,664,287,377,43.22
Draven,Lissandra,71,22,49,30.99
Draven,Syndra,174,80,94,45.98
Draven,Illaoi,142,72,70,50.7
Draven,Taliyah,111,57,54,51.35
Draven,Zyra,215,86,129,40
Draven,Riven,140,71,69,50.71
Draven,XinZhao,201,68,133,33.83
Draven,Kennen,134,84,50,62.69
Draven,Elise,200,89,111,44.5
Draven,Zed,350,172,178,49.14
Draven,Braum,198,108,90,54.55
Draven,Anivia,89,56,33,62.92
Draven,Varus,238,100,138,42.02
Draven,Lillia,246,113,133,45.93
Draven,Nilah,161,71,90,44.1
Draven,Olaf,69,39,30,56.52
Draven,Rengar,177,110,67,62.15
Draven,Akshan,174,84,90,48.28
Draven,Khazix,233,133,100,57.08
Draven,Belveth,71,19,52,26.76
Draven,Xayah,187,78,109,41.71
Draven,Galio,303,126,177,41.58
Draven,Shyvana,124,69,55,55.65
Draven,Taric,43,25,18,58.14
Draven,Jayce,132,87,45,65.91
Draven,Karthus,51,35,16,68.63
Draven,Sona,144,38,106,26.39
Draven,Yuumi,300,163,137,54.33
Draven,Skarner,85,49,36,57.65
Draven,Nasus,266,91,175,34.21
Draven,Camille,98,60,38,61.22
Draven,Ivern,103,48,55,46.6
Draven,Tryndamere,186,61,125,32.8
Draven,Corki,123,57,66,46.34
Draven,Quinn,170,78,92,45.88
Draven,FiddleSticks,154,66,88,42.86
Draven,Nidalee,76,44,32,57.89
Draven,Xerath,243,102,141,41.98
Draven,Vi,299,156,143,52.17
Draven,Rammus,140,76,64,54.29
Draven,Ornn,149,59,90,39.6
Draven,Kled,48,37,11,77.08
Draven,Bard,111,46,65,41.44
Draven,Renata,81,48,33,59.26
Draven,Rumble,79,47,32,59.49
Yuumi,Yone,1148,560,588,48.78
Yuumi,Shaco,579,290,289,50.09
Yuumi,Mel,1425,778,647,54.6
Yuumi,Tristana,542,280,262,51.66
Yuumi,Pyke,692,386,306,55.78
Yuumi,Illaoi,301,128,173,42.52
Yuumi,Warwick,864,430,434,49.77
Yuumi,Diana,790,320,470,40.51
Yuumi,Milio,342,181,161,52.92
Yuumi,Mordekaiser,819,414,405,50.55
Yuumi,Kindred,346,214,132,61.85
Yuumi,Qiyana,214,137,77,64.02
Yuumi,Ashe,1028,515,513,50.1
Yuumi,Sona,276,134,142,48.55
Yuumi,Garen,862,409,453,47.45
Yuumi,Briar,527,264,263,50.09
Yuumi,Zed,553,297,256,53.71
Yuumi,Caitlyn,1300,648,652,49.85
Yuumi,Morgana,868,391,477,45.05
Yuumi,Yasuo,1200,551,649,45.92
Yuumi,Gangplank,293,146,147,49.83
Yuumi,Kaisa,795,445,350,55.97
Yuumi,Galio,384,170,214,44.27
Yuumi,Cassiopeia,146,70,76,47.95
Yuumi,Hwei,460,244,216,53.04
Yuumi,Renekton,192,75,117,39.06
Yuumi,Kayn,990,527,463,53.23
Yuumi,Vex,379,200,179,52.77
Yuumi,Samira,626,355,271,56.71
Yuumi,Lulu,620,285,335,45.97
Yuumi,Darius,1033,526,507,50.92
Yuumi,Lux,1632,817,815,50.06
Yuumi,Sivir,195,109,86,55.9
Yuumi,Rakan,385,184,201,47.79
Yuumi,Jinx,1244,578,666,46.46
Yuumi,Volibear,651,298,353,45.78
Yuumi,Camille,283,150,133,53
Yuumi,Katarina,542,283,259,52.21
Yuumi,MissFortune,1247,631,616,50.6
Yuumi,Zyra,348,170,178,48.85
Yuumi,Yorick,487,233,254,47.84
Yuumi,Akshan,182,91,91,50
Yuumi,FiddleSticks,355,170,185,47.89
Yuumi,Sion,440,242,198,55
Yuumi,Bard,208,112,96,53.85
Yuumi,Kennen,202,131,71,64.85
Yuumi,Naafiri,238,112,126,47.06
Yuumi,Xayah,464,230,234,49.57
Yuumi,Soraka,377,195,182,51.72
Yuumi,Ornn,213,93,120,43.66
Yuumi,TwistedFate,200,122,78,61
Yuumi,Jax,449,244,205,54.34
Yuumi,Graves,286,188,98,65.73
Yuumi,Twitch,484,253,231,52.27
Yuumi,Seraphine,627,297,330,47.37
Yuumi,Viktor,339,204,135,60.18
Yuumi,Nocturne,526,241,285,45.82
Yuumi,Annie,209,104,105,49.76
Yuumi,KogMaw,179,73,106,40.78
Yuumi,Alistar,132,77,55,58.33
Yuumi,Akali,699,410,289,58.66
Yuumi,Ezreal,964,541,423,56.12
Yuumi,Nasus,402,201,201,50
Yuumi,Vi,531,274,257,51.6
Yuumi,Renata,160,87,73,54.38
Yuumi,Aatrox,597,323,274,54.1
Yuumi,Chogath,718,372,346,51.81
Yuumi,Lucian,352,186,166,52.84
Yuumi,Nautilus,606,330,276,54.46
Yuumi,Nunu,539,269,270,49.91
Yuumi,Teemo,840,430,410,51.19
Yuumi,Kassadin,123,51,72,41.46
Yuumi,Kalista,345,163,182,47.25
Yuumi,Maokai,300,148,152,49.33
Yuumi,Kled,110,48,62,43.64
Yuumi,AurelionSol,233,95,138,40.77
Yuumi,Jhin,1094,521,573,47.62
Yuumi,MonkeyKing,239,76,163,31.8
Yuumi,Vayne,566,273,293,48.23
Yuumi,Pantheon,936,473,463,50.53
Yuumi,Swain,670,330,340,49.25
Yuumi,Fiora,258,151,107,58.53
Yuumi,Viego,631,307,324,48.65
Yuumi,Vladimir,316,191,125,60.44
Yuumi,LeeSin,575,276,299,48
Yuumi,Aurora,571,293,278,51.31
Yuumi,Rell,342,157,185,45.91
Yuumi,Neeko,368,173,195,47.01
Yuumi,Hecarim,213,128,85,60.09
Yuumi,Leblanc,209,103,106,49.28
Yuumi,Trundle,329,139,190,42.25
Yuumi,Singed,161,67,94,41.61
Yuumi,Thresh,698,403,295,57.74
Yuumi,Sett,1035,474,561,45.8
Yuumi,Karma,489,310,179,63.39
Yuumi,Gwen,420,213,207,50.71
Yuumi,Khazix,344,179,165,52.03
Yuumi,Aphelios,391,205,186,52.43
Yuumi,Smolder,484,248,236,51.24
Yuumi,Ziggs,232,128,104,55.17
Yuumi,Malzahar,412,202,210,49.03
Yuumi,Senna,554,306,248,55.23
Yuumi,Rammus,190,73,117,38.42
Yuumi,Fizz,335,147,188,43.88
Yuumi,Jayce,258,156,102,60.47
Yuumi,Gragas,358,209,149,58.38
Yuumi,Leona,452,187,265,41.37
Yuumi,Nidalee,161,99,62,61.49
Yuumi,Ahri,814,407,407,50
Yuumi,MasterYi,581,282,299,48.54
Yuumi,Ryze,164,62,102,37.8
Yuumi,Janna,204,85,119,41.67
Yuumi,Rengar,290,173,117,59.66
Yuumi,TahmKench,580,245,335,42.24
Yuumi,Amumu,554,302,252,54.51
Yuumi,Varus,531,258,273,48.59
Yuumi,Zoe,324,181,143,55.86
Yuumi,Shyvana,193,86,107,44.56
Yuumi,Zac,198,87,111,43.94
Yuumi,Shen,420,221,199,52.62
Yuumi,Poppy,369,170,199,46.07
Yuumi,Quinn,207,93,114,44.93
Yuumi,Skarner,220,99,121,45
Yuumi,Nami,690,347,343,50.29
Yuumi,Braum,305,139,166,45.57
Yuumi,Malphite,561,250,311,44.56
Yuumi,Orianna,206,119,87,57.77
Yuumi,Nilah,322,192,130,59.63
Yuumi,Urgot,278,133,145,47.84
Yuumi,Sylas,523,265,258,50.67
Yuumi,Ekko,461,224,237,48.59
Yuumi,Zeri,256,144,112,56.25
Yuumi,Irelia,574,300,274,52.26
Yuumi,Heimerdinger,280,118,162,42.14
Yuumi,Corki,220,102,118,46.36
Yuumi,Veigar,614,233,381,37.95
Yuumi,Anivia,146,70,76,47.95
Yuumi,Belveth,182,99,83,54.4
Yuumi,Azir,231,157,74,67.97
Yuumi,Velkoz,359,176,183,49.03
Yuumi,Evelynn,281,157,124,55.87
Yuumi,Lissandra,162,73,89,45.06
Yuumi,Olaf,137,90,47,65.69
Yuumi,Lillia,325,185,140,56.92
Yuumi,Gnar,242,118,124,48.76
Yuumi,Blitzcrank,447,174,273,38.93
Yuumi,DrMundo,381,185,196,48.56
Yuumi,Elise,297,158,139,53.2
Yuumi,Brand,406,226,180,55.67
Yuumi,Xerath,360,200,160,55.56
Yuumi,Riven,207,143,64,69.08
Yuumi,Sejuani,194,83,111,42.78
Yuumi,Syndra,304,161,143,52.96
Yuumi,XinZhao,351,174,177,49.57
Yuumi,KSante,179,107,72,59.78
Yuumi,Tryndamere,332,157,175,47.29
Yuumi,Zilean,105,54,51,51.43
Yuumi,Udyr,221,93,128,42.08
Yuumi,Draven,300,137,163,45.67
Yuumi,Taliyah,124,52,72,41.94
Yuumi,Ambessa,374,187,187,50
Yuumi,JarvanIV,239,131,108,54.81
Yuumi,Talon,341,158,183,46.33
Yuumi,Karthus,186,97,89,52.15
Yuumi,Kayle,455,222,233,48.79
Yuumi,RekSai,81,32,49,39.51
Yuumi,Taric,139,80,59,57.55
Yuumi,Rumble,130,64,66,49.23
Yuumi,Ivern,115,66,49,57.39
Aurora,Renekton,306,136,170,44.44
Aurora,Khazix,392,194,198,49.49
Aurora,Mel,1233,590,643,47.85
Aurora,Jhin,1022,476,546,46.58
Aurora,Lux,1575,691,884,43.87
Aurora,Leblanc,272,135,137,49.63
Aurora,Briar,603,275,328,45.61
Aurora,Zoe,290,179,111,61.72
Aurora,Jinx,1082,495,587,45.75
Aurora,Poppy,368,187,181,50.82
Aurora,Ambessa,364,184,180,50.55
Aurora,Rammus,141,86,55,60.99
Aurora,Draven,363,190,173,52.34
Aurora,Blitzcrank,435,253,182,58.16
Aurora,Fiora,334,188,146,56.29
Aurora,FiddleSticks,370,139,231,37.57
Aurora,Syndra,399,189,210,47.37
Aurora,Vayne,599,268,331,44.74
Aurora,Morgana,728,357,371,49.04
Aurora,Nasus,513,182,331,35.48
Aurora,MonkeyKing,308,135,173,43.83
Aurora,Xayah,412,221,191,53.64
Aurora,Zac,191,95,96,49.74
Aurora,Smolder,406,229,177,56.4
Aurora,Warwick,843,447,396,53.02
Aurora,Yasuo,1039,511,528,49.18
Aurora,Caitlyn,1352,594,758,43.93
Aurora,Velkoz,373,183,190,49.06
Aurora,Tryndamere,371,157,214,42.32
Aurora,Mordekaiser,969,407,562,42
Aurora,MissFortune,1257,630,627,50.12
Aurora,Janna,213,117,96,54.93
Aurora,Gragas,310,160,150,51.61
Aurora,Sylas,571,278,293,48.69
Aurora,Taliyah,85,38,47,44.71
Aurora,Senna,460,175,285,38.04
Aurora,Riven,239,144,95,60.25
Aurora,Sejuani,261,136,125,52.11
Aurora,AurelionSol,255,110,145,43.14
Aurora,Tristana,542,244,298,45.02
Aurora,Rakan,296,123,173,41.55
Aurora,Gwen,381,209,172,54.86
Aurora,Karthus,154,74,80,48.05
Aurora,Yone,1307,663,644,50.73
Aurora,Nilah,357,159,198,44.54
Aurora,Braum,232,85,147,36.64
Aurora,LeeSin,600,293,307,48.83
Aurora,Evelynn,317,175,142,55.21
Aurora,Ezreal,1003,518,485,51.65
Aurora,Brand,378,217,161,57.41
Aurora,Volibear,643,308,335,47.9
Aurora,Ivern,118,67,51,56.78
Aurora,Irelia,578,352,226,60.9
Aurora,Swain,661,287,374,43.42
Aurora,Gangplank,213,106,107,49.77
Aurora,Diana,911,395,516,43.36
Aurora,Aphelios,396,240,156,60.61
Aurora,Leona,467,221,246,47.32
Aurora,TwistedFate,179,108,71,60.34
Aurora,Nami,457,236,221,51.64
Aurora,Shen,413,166,247,40.19
Aurora,Ahri,913,408,505,44.69
Aurora,Samira,578,320,258,55.36
Aurora,Maokai,245,102,143,41.63
Aurora,Kayle,388,182,206,46.91
Aurora,Kindred,352,216,136,61.36
Aurora,Veigar,614,272,342,44.3
Aurora,Lulu,514,276,238,53.7
Aurora,Garen,808,379,429,46.91
Aurora,Shyvana,170,66,104,38.82
Aurora,Seraphine,643,295,348,45.88
Aurora,Ziggs,226,83,143,36.73
Aurora,Darius,1024,460,564,44.92
Aurora,Corki,209,112,97,53.59
Aurora,Elise,335,223,112,66.57
Aurora,Katarina,481,251,230,52.18
Aurora,Karma,430,229,201,53.26
Aurora,Yorick,460,206,254,44.78
Aurora,Akali,692,338,354,48.84
Aurora,Lissandra,162,89,73,54.94
Aurora,Kayn,780,410,370,52.56
Aurora,KSante,204,120,84,58.82
Aurora,Rengar,285,187,98,65.61
Aurora,Shaco,476,220,256,46.22
Aurora,Galio,546,224,322,41.03
Aurora,Kaisa,865,490,375,56.65
Aurora,Zilean,184,84,100,45.65
Aurora,Aatrox,577,288,289,49.91
Aurora,Varus,423,214,209,50.59
Aurora,RekSai,41,19,22,46.34
Aurora,Jax,474,205,269,43.25
Aurora,Viktor,456,190,266,41.67
Aurora,Sett,909,370,539,40.7
Aurora,Zyra,402,179,223,44.53
Aurora,Ornn,247,118,129,47.77
Aurora,Vi,504,217,287,43.06
Aurora,Anivia,160,87,73,54.38
Aurora,Ashe,1129,573,556,50.75
Aurora,Yuumi,571,278,293,48.69
Aurora,Nidalee,157,87,70,55.41
Aurora,Vex,405,220,185,54.32
Aurora,Sivir,327,155,172,47.4
Aurora,Singed,152,48,104,31.58
Aurora,Pantheon,1060,518,542,48.87
Aurora,Kalista,287,133,154,46.34
Aurora,Kennen,213,108,105,50.7
Aurora,Nunu,616,313,303,50.81
Aurora,Zed,591,229,362,38.75
Aurora,Heimerdinger,403,178,225,44.17
Aurora,Trundle,252,139,113,55.16
Aurora,Orianna,361,155,206,42.94
Aurora,TahmKench,604,289,315,47.85
Aurora,Hecarim,239,124,115,51.88
Aurora,Kassadin,139,58,81,41.73
Aurora,Amumu,542,255,287,47.05
Aurora,Nautilus,626,305,321,48.72
Aurora,Teemo,851,359,492,42.19
Aurora,Ekko,453,246,207,54.3
Aurora,Lucian,379,209,170,55.15
Aurora,Pyke,689,383,306,55.59
Aurora,Vladimir,335,218,117,65.07
Aurora,Jayce,292,135,157,46.23
Aurora,Fizz,295,182,113,61.69
Aurora,Zeri,274,159,115,58.03
Aurora,Hwei,411,161,250,39.17
Aurora,Malphite,388,166,222,42.78
Aurora,JarvanIV,215,98,117,45.58
Aurora,Milio,402,229,173,56.97
Aurora,XinZhao,325,145,180,44.62
Aurora,Quinn,228,132,96,57.89
Aurora,Akshan,263,122,141,46.39
Aurora,Chogath,804,377,427,46.89
Aurora,MasterYi,678,340,338,50.15
Aurora,Azir,305,164,141,53.77
Aurora,Neeko,466,255,211,54.72
Aurora,Thresh,777,368,409,47.36
Aurora,Camille,231,112,119,48.48
Aurora,Lillia,385,229,156,59.48
Aurora,Renata,112,52,60,46.43
Aurora,Soraka,393,198,195,50.38
Aurora,Cassiopeia,258,127,131,49.22
Aurora,Alistar,154,95,59,61.69
Aurora,Illaoi,254,123,131,48.43
Aurora,Gnar,210,96,114,45.71
Aurora,Udyr,244,122,122,50
Aurora,Sion,486,225,261,46.3
Aurora,Talon,353,156,197,44.19
Aurora,Viego,656,337,319,51.37
Aurora,Naafiri,287,156,131,54.36
Aurora,Taric,146,55,91,37.67
Aurora,Rell,341,167,174,48.97
Aurora,Malzahar,487,206,281,42.3
Aurora,DrMundo,414,160,254,38.65
Aurora,Graves,321,186,135,57.94
Aurora,Skarner,175,88,87,50.29
Aurora,Sona,200,95,105,47.5
Aurora,Urgot,239,114,125,47.7
Aurora,Ryze,200,90,110,45
Aurora,Bard,182,94,88,51.65
Aurora,Qiyana,217,91,126,41.94
Aurora,Twitch,594,251,343,42.26
Aurora,Rumble,123,88,35,71.54
Aurora,Annie,165,64,101,38.79
Aurora,Xerath,336,131,205,38.99
Aurora,KogMaw,193,103,90,53.37
Aurora,Nocturne,555,263,292,47.39
Aurora,Olaf,131,45,86,34.35
Aurora,Belveth,133,78,55,58.65
Aurora,Kled,82,59,23,71.95
Volibear,Renekton,355,125,230,35.21
Volibear,Khazix,433,213,220,49.19
Volibear,Mel,1536,873,663,56.84
Volibear,Jhin,1248,593,655,47.52
Volibear,Lux,1893,961,932,50.77
Volibear,Mordekaiser,1144,577,567,50.44
Volibear,Viego,850,462,388,54.35
Volibear,Kindred,355,224,131,63.1
Volibear,TahmKench,781,448,333,57.36
Volibear,Sett,1147,617,530,53.79
Volibear,Zac,256,143,113,55.86
Volibear,Yasuo,1324,666,658,50.3
Volibear,MissFortune,1554,743,811,47.81
Volibear,Tristana,662,326,336,49.24
Volibear,Poppy,422,224,198,53.08
Volibear,Veigar,748,401,347,53.61
Volibear,Heimerdinger,372,215,157,57.8
Volibear,Ziggs,338,141,197,41.72
Volibear,Darius,1272,679,593,53.38
Volibear,Samira,623,352,271,56.5
Volibear,Karma,490,262,228,53.47
Volibear,Rammus,185,105,80,56.76
Volibear,Blitzcrank,448,240,208,53.57
Volibear,LeeSin,637,299,338,46.94
Volibear,Irelia,717,408,309,56.9
Volibear,Yuumi,651,353,298,54.22
Volibear,Gnar,254,137,117,53.94
Volibear,Kayn,1102,537,565,48.73
Volibear,Leblanc,270,142,128,52.59
Volibear,Caitlyn,1623,781,842,48.12
Volibear,Sejuani,342,226,116,66.08
Volibear,Rell,387,164,223,42.38
Volibear,Teemo,929,425,504,45.75
Volibear,Trundle,477,223,254,46.75
Volibear,Elise,390,193,197,49.49
Volibear,KSante,296,178,118,60.14
Volibear,Ashe,1080,540,540,50
Volibear,Nasus,657,327,330,49.77
Volibear,Fizz,366,187,179,51.09
Volibear,Azir,283,128,155,45.23
Volibear,Aphelios,441,164,277,37.19
Volibear,Soraka,363,173,190,47.66
Volibear,Aatrox,640,364,276,56.88
Volibear,Sylas,632,287,345,45.41
Volibear,Amumu,648,281,367,43.36
Volibear,Chogath,991,493,498,49.75
Volibear,Twitch,582,333,249,57.22
Volibear,Illaoi,363,174,189,47.93
Volibear,Syndra,306,149,157,48.69
Volibear,Kaisa,1006,602,404,59.84
Volibear,Lucian,340,155,185,45.59
Volibear,Seraphine,839,438,401,52.21
Volibear,Jax,578,284,294,49.13
Volibear,JarvanIV,235,123,112,52.34
Volibear,Hwei,519,255,264,49.13
Volibear,Bard,220,119,101,54.09
Volibear,Sion,480,259,221,53.96
Volibear,AurelionSol,241,76,165,31.54
Volibear,Tryndamere,408,216,192,52.94
Volibear,Nidalee,174,101,73,58.05
Volibear,Aurora,643,335,308,52.1
Volibear,Nami,688,351,337,51.02
Volibear,Quinn,165,83,82,50.3
Volibear,Thresh,831,439,392,52.83
Volibear,Diana,1001,516,485,51.55
Volibear,MasterYi,608,307,301,50.49
Volibear,Shaco,625,310,315,49.6
Volibear,Rengar,310,187,123,60.32
Volibear,Pyke,788,481,307,61.04
Volibear,Udyr,305,159,146,52.13
Volibear,Warwick,1234,651,583,52.76
Volibear,Leona,496,225,271,45.36
Volibear,Galio,422,188,234,44.55
Volibear,Shen,442,211,231,47.74
Volibear,MonkeyKing,353,170,183,48.16
Volibear,Naafiri,323,179,144,55.42
Volibear,Ezreal,1138,666,472,58.52
Volibear,Varus,578,304,274,52.6
Volibear,Ambessa,407,223,184,54.79
Volibear,Nilah,360,151,209,41.94
Volibear,DrMundo,415,192,223,46.27
Volibear,Pantheon,1090,566,524,51.93
Volibear,Nautilus,693,402,291,58.01
Volibear,Braum,277,108,169,38.99
Volibear,Skarner,270,159,111,58.89
Volibear,Vayne,750,337,413,44.93
Volibear,Malzahar,559,260,299,46.51
Volibear,Draven,383,192,191,50.13
Volibear,Briar,638,296,342,46.39
Volibear,Yone,1344,797,547,59.3
Volibear,Hecarim,231,117,114,50.65
Volibear,Velkoz,401,198,203,49.38
Volibear,Yorick,597,240,357,40.2
Volibear,KogMaw,257,125,132,48.64
Volibear,Vi,608,272,336,44.74
Volibear,FiddleSticks,337,173,164,51.34
Volibear,Taliyah,175,81,94,46.29
Volibear,Viktor,405,216,189,53.33
Volibear,Ekko,518,307,211,59.27
Volibear,Swain,840,464,376,55.24
Volibear,Garen,1033,506,527,48.98
Volibear,Talon,406,227,179,55.91
Volibear,Zed,705,384,321,54.47
Volibear,Kalista,265,173,92,65.28
Volibear,Nocturne,633,299,334,47.24
Volibear,Malphite,524,260,264,49.62
Volibear,Xayah,395,203,192,51.39
Volibear,Rakan,329,155,174,47.11
Volibear,Vex,310,162,148,52.26
Volibear,Nunu,602,309,293,51.33
Volibear,Akali,653,357,296,54.67
Volibear,Lillia,548,279,269,50.91
Volibear,Qiyana,236,115,121,48.73
Volibear,Morgana,918,447,471,48.69
Volibear,Lulu,590,297,293,50.34
Volibear,Ryze,153,66,87,43.14
Volibear,Brand,478,250,228,52.3
Volibear,Gragas,495,229,266,46.26
Volibear,Fiora,304,166,138,54.61
Volibear,XinZhao,366,188,178,51.37
Volibear,Akshan,309,117,192,37.86
Volibear,Shyvana,231,112,119,48.48
Volibear,Jinx,1327,650,677,48.98
Volibear,Sona,210,114,96,54.29
Volibear,Xerath,564,268,296,47.52
Volibear,Sivir,413,222,191,53.75
Volibear,Ornn,287,150,137,52.26
Volibear,Gangplank,268,142,126,52.99
Volibear,Zeri,346,196,150,56.65
Volibear,Olaf,159,85,74,53.46
Volibear,Senna,610,368,242,60.33
Volibear,Graves,303,173,130,57.1
Volibear,Urgot,286,124,162,43.36
Volibear,Maokai,286,162,124,56.64
Volibear,Alistar,193,87,106,45.08
Volibear,Katarina,605,338,267,55.87
Volibear,Ahri,992,532,460,53.63
Volibear,Milio,322,138,184,42.86
Volibear,Camille,293,169,124,57.68
Volibear,Taric,122,61,61,50
Volibear,Renata,195,101,94,51.79
Volibear,Singed,164,72,92,43.9
Volibear,Anivia,265,119,146,44.91
Volibear,Riven,278,155,123,55.76
Volibear,Vladimir,295,144,151,48.81
Volibear,Kayle,451,220,231,48.78
Volibear,Orianna,266,132,134,49.62
Volibear,Lissandra,130,73,57,56.15
Volibear,Neeko,542,299,243,55.17
Volibear,Corki,247,124,123,50.2
Volibear,Gwen,399,249,150,62.41
Volibear,Zoe,286,183,103,63.99
Volibear,Kassadin,115,54,61,46.96
Volibear,Kled,131,62,69,47.33
Volibear,Evelynn,393,242,151,61.58
Volibear,TwistedFate,203,97,106,47.78
Volibear,Smolder,504,263,241,52.18
Volibear,Cassiopeia,249,112,137,44.98
Volibear,Zyra,433,206,227,47.58
Volibear,Karthus,162,89,73,54.94
Volibear,Jayce,243,123,120,50.62
Volibear,Kennen,151,91,60,60.26
Volibear,RekSai,111,62,49,55.86
Volibear,Annie,196,127,69,64.8
Volibear,Zilean,178,83,95,46.63
Volibear,Belveth,193,80,113,41.45
Volibear,Rumble,86,44,42,51.16
Volibear,Ivern,155,77,78,49.68
Volibear,Janna,252,135,117,53.57
Vayne,Renekton,339,170,169,50.15
Vayne,Khazix,303,160,143,52.81
Vayne,Mel,1418,717,701,50.56
Vayne,Jhin,1209,642,567,53.1
Vayne,Lux,1619,831,788,51.33
Vayne,Teemo,794,360,434,45.34
Vayne,TahmKench,926,518,408,55.94
Vayne,Jinx,1383,591,792,42.73
Vayne,Zoe,334,215,119,64.37
Vayne,Nami,547,287,260,52.47
Vayne,Singed,228,118,110,51.75
Vayne,Graves,325,175,150,53.85
Vayne,Fizz,284,152,132,53.52
Vayne,Ziggs,265,107,158,40.38
Vayne,Pantheon,1087,572,515,52.62
Vayne,Aatrox,561,339,222,60.43
Vayne,Gwen,376,208,168,55.32
Vayne,Syndra,341,171,170,50.15
Vayne,Ashe,1121,570,551,50.85
Vayne,Lulu,530,245,285,46.23
Vayne,Gangplank,247,113,134,45.75
Vayne,Karthus,143,80,63,55.94
Vayne,Aurora,599,331,268,55.26
Vayne,Ezreal,1117,590,527,52.82
Vayne,Senna,535,240,295,44.86
Vayne,Kennen,302,179,123,59.27
Vayne,Kayn,952,519,433,54.52
Vayne,Naafiri,260,118,142,45.38
Vayne,Xayah,460,228,232,49.57
Vayne,Soraka,405,172,233,42.47
Vayne,Mordekaiser,1102,572,530,51.91
Vayne,Ahri,891,437,454,49.05
Vayne,Nunu,474,225,249,47.47
Vayne,Yasuo,1229,624,605,50.77
Vayne,Zyra,336,152,184,45.24
Vayne,Garen,1123,623,500,55.48
Vayne,Zed,618,327,291,52.91
Vayne,Talon,348,161,187,46.26
Vayne,Milio,246,132,114,53.66
Vayne,Fiora,286,139,147,48.6
Vayne,Elise,469,244,225,52.03
Vayne,Yone,1087,542,545,49.86
Vayne,Tristana,545,264,281,48.44
Vayne,Sivir,299,181,118,60.54
Vayne,Katarina,481,238,243,49.48
Vayne,Kayle,432,224,208,51.85
Vayne,Ekko,510,247,263,48.43
Vayne,Irelia,573,309,264,53.93
Vayne,Yuumi,566,293,273,51.77
Vayne,Nasus,558,221,337,39.61
Vayne,Galio,384,197,187,51.3
Vayne,Smolder,524,214,310,40.84
Vayne,JarvanIV,311,130,181,41.8
Vayne,Amumu,582,297,285,51.03
Vayne,Velkoz,443,228,215,51.47
Vayne,Poppy,377,212,165,56.23
Vayne,Warwick,960,483,477,50.31
Vayne,Leona,529,239,290,45.18
Vayne,MissFortune,1338,685,653,51.2
Vayne,Darius,1198,627,571,52.34
Vayne,Sion,546,266,280,48.72
Vayne,Draven,402,231,171,57.46
Vayne,Sett,1007,548,459,54.42
Vayne,Volibear,750,413,337,55.07
Vayne,KogMaw,174,62,112,35.63
Vayne,Seraphine,711,327,384,45.99
Vayne,Leblanc,203,98,105,48.28
Vayne,Samira,536,237,299,44.22
Vayne,Shen,432,221,211,51.16
Vayne,KSante,276,166,110,60.14
Vayne,Evelynn,347,188,159,54.18
Vayne,MasterYi,697,432,265,61.98
Vayne,Shaco,517,261,256,50.48
Vayne,Kaisa,1018,634,384,62.28
Vayne,Braum,314,157,157,50
Vayne,Diana,788,397,391,50.38
Vayne,Briar,695,288,407,41.44
Vayne,Caitlyn,1477,713,764,48.27
Vayne,Akali,625,364,261,58.24
Vayne,Brand,373,195,178,52.28
Vayne,Sona,218,118,100,54.13
Vayne,Illaoi,370,181,189,48.92
Vayne,Vex,363,187,176,51.52
Vayne,Ornn,324,156,168,48.15
Vayne,Nautilus,751,348,403,46.34
Vayne,Orianna,266,139,127,52.26
Vayne,Morgana,804,400,404,49.75
Vayne,Veigar,643,287,356,44.63
Vayne,Rammus,204,93,111,45.59
Vayne,Zeri,239,131,108,54.81
Vayne,Taric,100,59,41,59
Vayne,Nilah,353,172,181,48.73
Vayne,Swain,686,311,375,45.34
Vayne,Sylas,595,315,280,52.94
Vayne,Viego,717,368,349,51.32
Vayne,Xerath,443,223,220,50.34
Vayne,Twitch,509,279,230,54.81
Vayne,Jax,472,197,275,41.74
Vayne,DrMundo,440,233,207,52.95
Vayne,Vi,466,262,204,56.22
Vayne,Varus,522,259,263,49.62
Vayne,Kalista,227,112,115,49.34
Vayne,Zilean,130,68,62,52.31
Vayne,MonkeyKing,309,135,174,43.69
Vayne,Lucian,361,195,166,54.02
Vayne,Bard,212,91,121,42.92
Vayne,Rengar,234,133,101,56.84
Vayne,Shyvana,151,65,86,43.05
Vayne,Karma,419,234,185,55.85
Vayne,LeeSin,589,332,257,56.37
Vayne,Cassiopeia,240,106,134,44.17
Vayne,Alistar,259,115,144,44.4
Vayne,Gragas,440,213,227,48.41
Vayne,Maokai,409,203,206,49.63
Vayne,Kled,138,92,46,66.67
Vayne,Kindred,351,158,193,45.01
Vayne,Azir,208,102,106,49.04
Vayne,Neeko,437,254,183,58.12
Vayne,Rakan,387,165,222,42.64
Vayne,Pyke,657,375,282,57.08
Vayne,Ryze,208,116,92,55.77
Vayne,Hwei,513,270,243,52.63
Vayne,FiddleSticks,331,173,158,52.27
Vayne,Malzahar,421,218,203,51.78
Vayne,Vladimir,299,163,136,54.52
Vayne,Sejuani,247,112,135,45.34
Vayne,Viktor,458,252,206,55.02
Vayne,XinZhao,399,204,195,51.13
Vayne,Trundle,414,214,200,51.69
Vayne,Tryndamere,338,159,179,47.04
Vayne,Aphelios,491,238,253,48.47
Vayne,Yorick,649,264,385,40.68
Vayne,Camille,207,123,84,59.42
Vayne,Chogath,898,497,401,55.35
Vayne,Janna,179,82,97,45.81
Vayne,Kassadin,170,73,97,42.94
Vayne,Renata,153,55,98,35.95
Vayne,Belveth,189,98,91,51.85
Vayne,Skarner,187,111,76,59.36
Vayne,Qiyana,283,155,128,54.77
Vayne,Zac,233,112,121,48.07
Vayne,Riven,240,122,118,50.83
Vayne,Lillia,422,218,204,51.66
Vayne,Corki,249,161,88,64.66
Vayne,Malphite,609,299,310,49.1
Vayne,Gnar,226,142,84,62.83
Vayne,AurelionSol,290,142,148,48.97
Vayne,Quinn,210,106,104,50.48
Vayne,Blitzcrank,482,259,223,53.73
Vayne,Nocturne,519,272,247,52.41
Vayne,Heimerdinger,290,125,165,43.1
Vayne,Lissandra,121,67,54,55.37
Vayne,Udyr,236,118,118,50
Vayne,Ambessa,400,226,174,56.5
Vayne,Rell,328,163,165,49.7
Vayne,Urgot,275,122,153,44.36
Vayne,Hecarim,206,84,122,40.78
Vayne,Olaf,112,57,55,50.89
Vayne,Akshan,227,115,112,50.66
Vayne,Jayce,277,165,112,59.57
Vayne,Thresh,688,344,344,50
Vayne,TwistedFate,216,112,104,51.85
Vayne,Ivern,138,81,57,58.7
Vayne,Taliyah,217,112,105,51.61
Vayne,Anivia,211,89,122,42.18
Vayne,Annie,179,64,115,35.75
Vayne,Nidalee,138,87,51,63.04
Vayne,Rumble,140,60,80,42.86
Vayne,RekSai,67,40,27,59.7
Khazix,Aurora,392,198,194,50.51
Khazix,Volibear,433,220,213,50.81
Khazix,Yasuo,782,342,440,43.73
Khazix,Vayne,303,143,160,47.19
Khazix,Shaco,367,176,191,47.96
Khazix,Poppy,248,114,134,45.97
Khazix,Diana,525,251,274,47.81
Khazix,Anivia,115,65,50,56.52
Khazix,Caitlyn,929,430,499,46.29
Khazix,Thresh,498,264,234,53.01
Khazix,Garen,628,255,373,40.61
Khazix,FiddleSticks,208,121,87,58.17
Khazix,Lux,1078,506,572,46.94
Khazix,Brand,292,129,163,44.18
Khazix,Darius,607,258,349,42.5
Khazix,Amumu,367,145,222,39.51
Khazix,MissFortune,756,291,465,38.49
Khazix,Swain,383,205,178,53.52
Khazix,Aatrox,401,225,176,56.11
Khazix,Viego,552,258,294,46.74
Khazix,Sylas,374,146,228,39.04
Khazix,Ashe,697,298,399,42.75
Khazix,Blitzcrank,295,142,153,48.14
Khazix,Evelynn,240,126,114,52.5
Khazix,Katarina,420,223,197,53.1
Khazix,Nocturne,360,158,202,43.89
Khazix,Neeko,335,169,166,50.45
Khazix,Sejuani,175,64,111,36.57
Khazix,LeeSin,362,183,179,50.55
Khazix,Irelia,330,165,165,50
Khazix,Twitch,379,178,201,46.97
Khazix,Pyke,480,209,271,43.54
Khazix,Sion,321,124,197,38.63
Khazix,Ezreal,741,381,360,51.42
Khazix,Zilean,133,73,60,54.89
Khazix,Belveth,75,39,36,52
Khazix,Hwei,353,149,204,42.21
Khazix,Jinx,737,301,436,40.84
Khazix,TahmKench,367,152,215,41.42
Khazix,Jax,271,84,187,31
Khazix,Cassiopeia,136,74,62,54.41
Khazix,Milio,212,88,124,41.51
Khazix,Ambessa,197,113,84,57.36
Khazix,Rammus,119,39,80,32.77
Khazix,Kled,76,31,45,40.79
Khazix,Kayn,645,344,301,53.33
Khazix,AurelionSol,144,73,71,50.69
Khazix,Tristana,359,192,167,53.48
Khazix,Ekko,300,133,167,44.33
Khazix,Pantheon,642,314,328,48.91
Khazix,Azir,139,68,71,48.92
Khazix,Ziggs,128,60,68,46.88
Khazix,Lulu,283,125,158,44.17
Khazix,KSante,161,86,75,53.42
Khazix,Riven,207,113,94,54.59
Khazix,Jhin,787,405,382,51.46
Khazix,Yuumi,344,165,179,47.97
Khazix,Sett,594,277,317,46.63
Khazix,Rengar,241,115,126,47.72
Khazix,Kennen,146,75,71,51.37
Khazix,Morgana,559,197,362,35.24
Khazix,Warwick,645,272,373,42.17
Khazix,Kaisa,576,320,256,55.56
Khazix,Jayce,163,75,88,46.01
Khazix,Senna,315,169,146,53.65
Khazix,Chogath,431,188,243,43.62
Khazix,Galio,246,94,152,38.21
Khazix,Shen,280,130,150,46.43
Khazix,Aphelios,279,159,120,56.99
Khazix,Illaoi,183,91,92,49.73
Khazix,Taliyah,90,31,59,34.44
Khazix,Sivir,184,84,100,45.65
Khazix,Velkoz,240,117,123,48.75
Khazix,Mordekaiser,651,315,336,48.39
Khazix,Akali,350,190,160,54.29
Khazix,Seraphine,412,210,202,50.97
Khazix,Briar,418,199,219,47.61
Khazix,Janna,137,64,73,46.72
Khazix,Gangplank,169,78,91,46.15
Khazix,Qiyana,123,68,55,55.28
Khazix,Zoe,215,119,96,55.35
Khazix,Sona,175,81,94,46.29
Khazix,Fizz,216,109,107,50.46
Khazix,Samira,414,178,236,43
Khazix,Ornn,127,48,79,37.8
Khazix,Ivern,57,34,23,59.65
Khazix,Nilah,213,97,116,45.54
Khazix,Teemo,569,236,333,41.48
Khazix,Camille,130,61,69,46.92
Khazix,Leblanc,155,62,93,40
Khazix,Singed,146,47,99,32.19
Khazix,XinZhao,208,113,95,54.33
Khazix,Yorick,306,91,215,29.74
Khazix,KogMaw,97,53,44,54.64
Khazix,Nautilus,326,113,213,34.66
Khazix,DrMundo,256,112,144,43.75
Khazix,Nasus,295,129,166,43.73
Khazix,Mel,782,370,412,47.31
Khazix,Vladimir,157,58,99,36.94
Khazix,MasterYi,456,189,267,41.45
Khazix,Lucian,193,107,86,55.44
Khazix,Maokai,156,68,88,43.59
Khazix,Rakan,225,96,129,42.67
Khazix,Renekton,164,93,71,56.71
Khazix,Veigar,401,179,222,44.64
Khazix,Ahri,548,244,304,44.53
Khazix,Talon,220,96,124,43.64
Khazix,Yone,783,373,410,47.64
Khazix,Zac,173,68,105,39.31
Khazix,Hecarim,132,71,61,53.79
Khazix,Renata,78,19,59,24.36
Khazix,Zed,355,210,145,59.15
Khazix,Trundle,249,120,129,48.19
Khazix,Xayah,225,79,146,35.11
Khazix,Lillia,303,157,146,51.82
Khazix,Vex,220,94,126,42.73
Khazix,Karma,303,144,159,47.52
Khazix,Gnar,183,95,88,51.91
Khazix,Vi,335,156,179,46.57
Khazix,Zeri,197,85,112,43.15
Khazix,Kayle,299,121,178,40.47
Khazix,Varus,311,141,170,45.34
Khazix,Malphite,270,112,158,41.48
Khazix,Udyr,105,76,29,72.38
Khazix,Bard,92,35,57,38.04
Khazix,Zyra,259,125,134,48.26
Khazix,Urgot,177,48,129,27.12
Khazix,JarvanIV,166,74,92,44.58
Khazix,MonkeyKing,305,106,199,34.75
Khazix,Nami,432,211,221,48.84
Khazix,Heimerdinger,217,88,129,40.55
Khazix,Nunu,280,150,130,53.57
Khazix,Gwen,201,102,99,50.75
Khazix,Naafiri,147,53,94,36.05
Khazix,Braum,156,80,76,51.28
Khazix,Ryze,73,45,28,61.64
Khazix,Draven,233,100,133,42.92
Khazix,Smolder,302,135,167,44.7
Khazix,Lissandra,95,39,56,41.05
Khazix,Rell,206,134,72,65.05
Khazix,Gragas,227,120,107,52.86
Khazix,Leona,244,88,156,36.07
Khazix,Orianna,234,99,135,42.31
Khazix,Corki,143,70,73,48.95
Khazix,Shyvana,115,24,91,20.87
Khazix,Soraka,170,101,69,59.41
Khazix,TwistedFate,129,66,63,51.16
Khazix,Annie,135,82,53,60.74
Khazix,Kassadin,47,6,41,12.77
Khazix,Graves,227,126,101,55.51
Khazix,Quinn,124,79,45,63.71
Khazix,Skarner,138,51,87,36.96
Khazix,Kalista,138,68,70,49.28
Khazix,Elise,258,140,118,54.26
Khazix,Viktor,347,147,200,42.36
Khazix,Nidalee,83,48,35,57.83
Khazix,Xerath,208,83,125,39.9
Khazix,Syndra,194,74,120,38.14
Khazix,Fiora,219,87,132,39.73
Khazix,Karthus,101,60,41,59.41
Khazix,Malzahar,278,121,157,43.53
Khazix,Alistar,116,52,64,44.83
Khazix,Kindred,219,115,104,52.51
Khazix,Olaf,69,28,41,40.58
Khazix,Akshan,115,46,69,40
Khazix,Taric,65,8,57,12.31
Khazix,Rumble,64,40,24,62.5
Khazix,Tryndamere,221,118,103,53.39
Khazix,RekSai,38,28,10,73.68
Chogath,Gwen,640,361,279,56.41
Chogath,Vi,734,358,376,48.77
Chogath,Zed,711,395,316,55.56
Chogath,Jhin,1502,695,807,46.27
Chogath,Soraka,497,282,215,56.74
Chogath,Sett,1512,624,888,41.27
Chogath,AurelionSol,421,186,235,44.18
Chogath,Corki,203,116,87,57.14
Chogath,Milio,381,164,217,43.04
Chogath,Zac,328,198,130,60.37
Chogath,Yasuo,1539,868,671,56.4
Chogath,MissFortune,1747,786,961,44.99
Chogath,Lux,2217,1046,1171,47.18
Chogath,Darius,1597,807,790,50.53
Chogath,Viego,877,426,451,48.57
Chogath,Nautilus,848,431,417,50.83
Chogath,Garen,1305,686,619,52.57
Chogath,Malzahar,678,305,373,44.99
Chogath,Seraphine,798,427,371,53.51
Chogath,Zilean,220,108,112,49.09
Chogath,Olaf,197,97,100,49.24
Chogath,LeeSin,896,507,389,56.58
Chogath,Diana,1105,605,500,54.75
Chogath,Karma,524,262,262,50
Chogath,Teemo,1218,668,550,54.84
Chogath,Poppy,367,215,152,58.58
Chogath,Akali,888,543,345,61.15
Chogath,Caitlyn,1881,1034,847,54.97
Chogath,Leona,717,380,337,53
Chogath,Tryndamere,406,211,195,51.97
Chogath,Velkoz,491,236,255,48.07
Chogath,Zeri,363,213,150,58.68
Chogath,Thresh,1113,551,562,49.51
Chogath,Ivern,212,111,101,52.36
Chogath,Neeko,575,315,260,54.78
Chogath,Senna,757,340,417,44.91
Chogath,Yorick,836,427,409,51.08
Chogath,Volibear,991,498,493,50.25
Chogath,Cassiopeia,314,172,142,54.78
Chogath,Rell,391,206,185,52.69
Chogath,Rammus,186,116,70,62.37
Chogath,Jinx,1650,726,924,44
Chogath,TahmKench,1021,519,502,50.83
Chogath,DrMundo,588,243,345,41.33
Chogath,Trundle,470,222,248,47.23
Chogath,Ahri,1111,544,567,48.96
Chogath,Ashe,1429,783,646,54.79
Chogath,Nami,824,418,406,50.73
Chogath,Camille,217,100,117,46.08
Chogath,Pantheon,1412,743,669,52.62
Chogath,Xayah,524,297,227,56.68
Chogath,Yuumi,718,346,372,48.19
Chogath,Warwick,1344,638,706,47.47
Chogath,Irelia,615,307,308,49.92
Chogath,Samira,710,444,266,62.54
Chogath,Malphite,545,316,229,57.98
Chogath,MonkeyKing,369,204,165,55.28
Chogath,Sylas,949,451,498,47.52
Chogath,Swain,962,451,511,46.88
Chogath,Fiora,442,230,212,52.04
Chogath,Amumu,814,358,456,43.98
Chogath,Vladimir,442,188,254,42.53
Chogath,Varus,641,340,301,53.04
Chogath,Janna,298,150,148,50.34
Chogath,Graves,412,240,172,58.25
Chogath,Kassadin,149,71,78,47.65
Chogath,Kalista,381,215,166,56.43
Chogath,Maokai,351,183,168,52.14
Chogath,Shaco,679,378,301,55.67
Chogath,Viktor,538,251,287,46.65
Chogath,Mordekaiser,1278,550,728,43.04
Chogath,Morgana,1071,559,512,52.19
Chogath,Kaisa,1110,512,598,46.13
Chogath,Qiyana,251,126,125,50.2
Chogath,Mel,1917,985,932,51.38
Chogath,KSante,282,161,121,57.09
Chogath,Azir,345,191,154,55.36
Chogath,Pyke,832,496,336,59.62
Chogath,Veigar,944,481,463,50.95
Chogath,Ekko,689,384,305,55.73
Chogath,Lucian,433,204,229,47.11
Chogath,XinZhao,478,262,216,54.81
Chogath,Leblanc,285,160,125,56.14
Chogath,Aatrox,739,381,358,51.56
Chogath,Ryze,267,125,142,46.82
Chogath,Jax,662,368,294,55.59
Chogath,Galio,529,282,247,53.31
Chogath,Yone,1637,814,823,49.73
Chogath,Urgot,406,174,232,42.86
Chogath,Lillia,593,234,359,39.46
Chogath,Lulu,649,340,309,52.39
Chogath,Briar,748,358,390,47.86
Chogath,Ambessa,394,189,205,47.97
Chogath,Elise,616,371,245,60.23
Chogath,Shen,498,255,243,51.2
Chogath,Brand,557,297,260,53.32
Chogath,FiddleSticks,399,212,187,53.13
Chogath,Braum,414,184,230,44.44
Chogath,Aphelios,521,242,279,46.45
Chogath,Kayle,606,258,348,42.57
Chogath,Khazix,431,243,188,56.38
Chogath,Blitzcrank,624,346,278,55.45
Chogath,Nilah,361,198,163,54.85
Chogath,Kled,182,87,95,47.8
Chogath,Vex,570,312,258,54.74
Chogath,Nocturne,584,266,318,45.55
Chogath,Draven,396,215,181,54.29
Chogath,Riven,335,198,137,59.1
Chogath,Twitch,692,414,278,59.83
Chogath,Skarner,289,101,188,34.95
Chogath,Aurora,804,427,377,53.11
Chogath,KogMaw,290,157,133,54.14
Chogath,MasterYi,897,450,447,50.17
Chogath,Orianna,282,147,135,52.13
Chogath,Rengar,331,257,74,77.64
Chogath,Smolder,741,383,358,51.69
Chogath,Kayn,1205,540,665,44.81
Chogath,Talon,518,286,232,55.21
Chogath,Ezreal,1337,706,631,52.8
Chogath,Katarina,586,340,246,58.02
Chogath,RekSai,112,66,46,58.93
Chogath,Ziggs,372,176,196,47.31
Chogath,Nasus,545,271,274,49.72
Chogath,Evelynn,449,260,189,57.91
Chogath,Zyra,451,192,259,42.57
Chogath,Hecarim,303,130,173,42.9
Chogath,Illaoi,433,223,210,51.5
Chogath,Zoe,322,186,136,57.76
Chogath,Hwei,569,263,306,46.22
Chogath,Shyvana,156,75,81,48.08
Chogath,Nunu,562,329,233,58.54
Chogath,Nidalee,198,132,66,66.67
Chogath,Tristana,742,343,399,46.23
Chogath,Fizz,359,147,212,40.95
Chogath,Lissandra,209,110,99,52.63
Chogath,Gragas,445,228,217,51.24
Chogath,Sivir,374,192,182,51.34
Chogath,Syndra,414,237,177,57.25
Chogath,Gangplank,309,132,177,42.72
Chogath,Vayne,898,401,497,44.65
Chogath,Heimerdinger,450,224,226,49.78
Chogath,Sejuani,276,134,142,48.55
Chogath,Kennen,380,175,205,46.05
Chogath,Rumble,136,66,70,48.53
Chogath,Udyr,334,169,165,50.6
Chogath,Alistar,243,121,122,49.79
Chogath,Rakan,447,220,227,49.22
Chogath,Sona,275,133,142,48.36
Chogath,Singed,233,117,116,50.21
Chogath,Kindred,354,203,151,57.34
Chogath,Anivia,239,95,144,39.75
Chogath,Karthus,217,124,93,57.14
Chogath,Taliyah,202,87,115,43.07
Chogath,Gnar,354,163,191,46.05
Chogath,Quinn,270,110,160,40.74
Chogath,Belveth,244,97,147,39.75
Chogath,Renata,177,99,78,55.93
Chogath,JarvanIV,378,164,214,43.39
Chogath,Naafiri,425,211,214,49.65
Chogath,Ornn,414,169,245,40.82
Chogath,Sion,665,356,309,53.53
Chogath,Renekton,320,162,158,50.63
Chogath,TwistedFate,293,147,146,50.17
Chogath,Bard,306,144,162,47.06
Chogath,Annie,237,136,101,57.38
Chogath,Xerath,473,240,233,50.74
Chogath,Akshan,329,120,209,36.47
Chogath,Jayce,335,177,158,52.84
Chogath,Taric,234,79,155,33.76
Gangplank,Gwen,169,85,84,50.3
Gangplank,Vi,249,122,127,49
Gangplank,Zed,228,110,118,48.25
Gangplank,Jhin,466,263,203,56.44
Gangplank,Soraka,162,91,71,56.17
Gangplank,Garen,355,152,203,42.82
Gangplank,Briar,306,119,187,38.89
Gangplank,Caitlyn,740,366,374,49.46
Gangplank,Morgana,345,168,177,48.7
Gangplank,DrMundo,168,80,88,47.62
Gangplank,Lillia,142,92,50,64.79
Gangplank,Viktor,161,104,57,64.6
Gangplank,Pyke,279,135,144,48.39
Gangplank,Yorick,206,91,115,44.17
Gangplank,FiddleSticks,139,48,91,34.53
Gangplank,Draven,202,80,122,39.6
Gangplank,Smolder,192,118,74,61.46
Gangplank,Nautilus,283,131,152,46.29
Gangplank,TahmKench,213,99,114,46.48
Gangplank,Malphite,234,101,133,43.16
Gangplank,Yasuo,564,290,274,51.42
Gangplank,Aphelios,152,80,72,52.63
Gangplank,TwistedFate,159,62,97,38.99
Gangplank,LeeSin,347,188,159,54.18
Gangplank,Yone,476,231,245,48.53
Gangplank,MissFortune,491,224,267,45.62
Gangplank,Mel,509,211,298,41.45
Gangplank,Riven,137,74,63,54.01
Gangplank,Kayn,380,165,215,43.42
Gangplank,Ahri,411,214,197,52.07
Gangplank,Jinx,623,324,299,52.01
Gangplank,Irelia,260,133,127,51.15
Gangplank,Pantheon,399,187,212,46.87
Gangplank,Kassadin,61,29,32,47.54
Gangplank,Yuumi,293,147,146,50.17
Gangplank,Fiora,143,60,83,41.96
Gangplank,Syndra,146,66,80,45.21
Gangplank,Vayne,247,134,113,54.25
Gangplank,Mordekaiser,313,131,182,41.85
Gangplank,Warwick,316,112,204,35.44
Gangplank,Akali,236,124,112,52.54
Gangplank,Velkoz,219,100,119,45.66
Gangplank,Vladimir,162,57,105,35.19
Gangplank,Diana,344,178,166,51.74
Gangplank,Karma,276,122,154,44.2
Gangplank,Shen,240,109,131,45.42
Gangplank,Teemo,411,190,221,46.23
Gangplank,Twitch,221,103,118,46.61
Gangplank,Ornn,135,77,58,57.04
Gangplank,Amumu,277,112,165,40.43
Gangplank,Katarina,271,167,104,61.62
Gangplank,Senna,252,100,152,39.68
Gangplank,Graves,184,87,97,47.28
Gangplank,Aurora,213,107,106,50.23
Gangplank,Nilah,150,80,70,53.33
Gangplank,Hwei,153,83,70,54.25
Gangplank,Olaf,47,22,25,46.81
Gangplank,Aatrox,287,155,132,54.01
Gangplank,Braum,117,70,47,59.83
Gangplank,Varus,266,116,150,43.61
Gangplank,Janna,122,70,52,57.38
Gangplank,Gnar,131,78,53,59.54
Gangplank,Shaco,285,162,123,56.84
Gangplank,Xayah,178,74,104,41.57
Gangplank,Seraphine,261,135,126,51.72
Gangplank,Darius,576,297,279,51.56
Gangplank,XinZhao,143,64,79,44.76
Gangplank,Zeri,114,44,70,38.6
Gangplank,Taric,64,20,44,31.25
Gangplank,Rengar,74,37,37,50
Gangplank,Thresh,381,151,230,39.63
Gangplank,Kalista,136,78,58,57.35
Gangplank,Nasus,230,143,87,62.17
Gangplank,Jayce,153,66,87,43.14
Gangplank,JarvanIV,114,50,64,43.86
Gangplank,Poppy,147,49,98,33.33
Gangplank,Gragas,229,110,119,48.03
Gangplank,Annie,97,58,39,59.79
Gangplank,Ekko,217,107,110,49.31
Gangplank,Akshan,136,67,69,49.26
Gangplank,Nami,271,136,135,50.18
Gangplank,Veigar,263,126,137,47.91
Gangplank,Malzahar,249,110,139,44.18
Gangplank,Camille,102,65,37,63.73
Gangplank,Evelynn,123,68,55,55.28
Gangplank,Taliyah,90,37,53,41.11
Gangplank,Sett,388,139,249,35.82
Gangplank,Ashe,482,238,244,49.38
Gangplank,Viego,343,192,151,55.98
Gangplank,Khazix,169,91,78,53.85
Gangplank,Nocturne,228,93,135,40.79
Gangplank,Xerath,213,106,107,49.77
Gangplank,Lux,622,364,258,58.52
Gangplank,Sona,99,42,57,42.42
Gangplank,Renekton,119,68,51,57.14
Gangplank,Leblanc,124,66,58,53.23
Gangplank,MonkeyKing,139,50,89,35.97
Gangplank,Jax,286,118,168,41.26
Gangplank,Talon,168,76,92,45.24
Gangplank,Volibear,268,126,142,47.01
Gangplank,Singed,84,50,34,59.52
Gangplank,Sejuani,106,50,56,47.17
Gangplank,Sylas,286,171,115,59.79
Gangplank,Illaoi,127,55,72,43.31
Gangplank,Belveth,94,47,47,50
Gangplank,Orianna,101,49,52,48.51
Gangplank,Alistar,110,57,53,51.82
Gangplank,Nidalee,47,30,17,63.83
Gangplank,Ziggs,104,45,59,43.27
Gangplank,Blitzcrank,246,112,134,45.53
Gangplank,Kled,48,20,28,41.67
Gangplank,MasterYi,276,119,157,43.12
Gangplank,Zyra,167,80,87,47.9
Gangplank,Kaisa,385,188,197,48.83
Gangplank,Urgot,145,55,90,37.93
Gangplank,Swain,307,133,174,43.32
Gangplank,Rammus,91,29,62,31.87
Gangplank,Zilean,69,32,37,46.38
Gangplank,Hecarim,74,31,43,41.89
Gangplank,Milio,184,80,104,43.48
Gangplank,Kayle,205,79,126,38.54
Gangplank,Chogath,309,177,132,57.28
Gangplank,Vex,121,50,71,41.32
Gangplank,Skarner,79,46,33,58.23
Gangplank,Renata,77,36,41,46.75
Gangplank,Zac,109,48,61,44.04
Gangplank,Rell,118,88,30,74.58
Gangplank,Leona,180,116,64,64.44
Gangplank,Tryndamere,138,87,51,63.04
Gangplank,Sivir,114,38,76,33.33
Gangplank,Rumble,66,37,29,56.06
Gangplank,Ivern,48,33,15,68.75
Gangplank,Ryze,89,41,48,46.07
Gangplank,Shyvana,103,56,47,54.37
Gangplank,Elise,216,124,92,57.41
Gangplank,Rakan,116,60,56,51.72
Gangplank,Kennen,117,61,56,52.14
Gangplank,Ezreal,472,237,235,50.21
Gangplank,Qiyana,141,76,65,53.9
Gangplank,Lulu,237,127,110,53.59
Gangplank,Sion,280,106,174,37.86
Gangplank,KSante,94,47,47,50
Gangplank,Tristana,291,106,185,36.43
Gangplank,Fizz,120,64,56,53.33
Gangplank,Lucian,192,112,80,58.33
Gangplank,Galio,180,76,104,42.22
Gangplank,Neeko,186,81,105,43.55
Gangplank,Quinn,97,54,43,55.67
Gangplank,Kindred,106,33,73,31.13
Gangplank,Zoe,127,83,44,65.35
Gangplank,Cassiopeia,110,46,64,41.82
Gangplank,Azir,120,55,65,45.83
Gangplank,Brand,138,55,83,39.86
Gangplank,Naafiri,123,42,81,34.15
Gangplank,Samira,264,118,146,44.7
Gangplank,Ambessa,149,89,60,59.73
Gangplank,Lissandra,72,44,28,61.11
Gangplank,Anivia,102,50,52,49.02
Gangplank,Maokai,95,60,35,63.16
Gangplank,Nunu,185,96,89,51.89
Gangplank,Corki,63,28,35,44.44
Gangplank,Trundle,120,58,62,48.33
Gangplank,Udyr,106,57,49,53.77
Gangplank,Bard,98,58,40,59.18
Gangplank,Heimerdinger,149,78,71,52.35
Gangplank,Karthus,69,35,34,50.72
Gangplank,AurelionSol,110,34,76,30.91
Gangplank,KogMaw,48,23,25,47.92
Gangplank,RekSai,74,20,54,27.03
Gwen,Chogath,640,279,361,43.59
Gwen,Kayn,522,248,274,47.51
Gwen,Gangplank,169,84,85,49.7
Gwen,Ezreal,643,321,322,49.92
Gwen,Hwei,304,139,165,45.72
Gwen,Jax,281,95,186,33.81
Gwen,Nidalee,109,50,59,45.87
Gwen,Ahri,614,316,298,51.47
Gwen,Jhin,639,288,351,45.07
Gwen,Senna,353,151,202,42.78
Gwen,Sett,731,289,442,39.53
Gwen,Taliyah,94,34,60,36.17
Gwen,Cassiopeia,160,85,75,53.13
Gwen,Kaisa,626,320,306,51.12
Gwen,Neeko,286,129,157,45.1
Gwen,Irelia,368,179,189,48.64
Gwen,Diana,581,251,330,43.2
Gwen,Lux,900,399,501,44.33
Gwen,Tristana,395,190,205,48.1
Gwen,Mel,825,417,408,50.55
Gwen,XinZhao,212,95,117,44.81
Gwen,Katarina,419,206,213,49.16
Gwen,Teemo,519,210,309,40.46
Gwen,Vayne,376,168,208,44.68
Gwen,TwistedFate,129,44,85,34.11
Gwen,Riven,244,137,107,56.15
Gwen,Nocturne,308,157,151,50.97
Gwen,Zoe,210,103,107,49.05
Gwen,Jinx,851,395,456,46.42
Gwen,Lulu,244,123,121,50.41
Gwen,Camille,107,60,47,56.07
Gwen,Warwick,716,321,395,44.83
Gwen,MissFortune,854,398,456,46.6
Gwen,Zyra,195,91,104,46.67
Gwen,LeeSin,337,191,146,56.68
Gwen,Lucian,290,147,143,50.69
Gwen,Xerath,265,111,154,41.89
Gwen,Elise,269,148,121,55.02
Gwen,Galio,332,162,170,48.8
Gwen,Twitch,371,172,199,46.36
Gwen,Soraka,304,154,150,50.66
Gwen,Illaoi,253,101,152,39.92
Gwen,Aurora,381,172,209,45.14
Gwen,Vi,406,147,259,36.21
Gwen,Briar,349,177,172,50.72
Gwen,Janna,141,40,101,28.37
Gwen,Gnar,126,54,72,42.86
Gwen,Yasuo,630,321,309,50.95
Gwen,Zeri,155,60,95,38.71
Gwen,Taric,89,37,52,41.57
Gwen,Ambessa,264,122,142,46.21
Gwen,Sejuani,139,60,79,43.17
Gwen,Veigar,412,151,261,36.65
Gwen,Nilah,190,101,89,53.16
Gwen,Karma,224,118,106,52.68
Gwen,Lillia,227,101,126,44.49
Gwen,Pyke,477,264,213,55.35
Gwen,Viego,422,213,209,50.47
Gwen,Mordekaiser,658,300,358,45.59
Gwen,Akali,398,170,228,42.71
Gwen,Sylas,339,160,179,47.2
Gwen,Draven,217,111,106,51.15
Gwen,Velkoz,228,115,113,50.44
Gwen,KSante,182,83,99,45.6
Gwen,Belveth,140,59,81,42.14
Gwen,Yuumi,420,207,213,49.29
Gwen,Rengar,177,104,73,58.76
Gwen,Ashe,699,312,387,44.64
Gwen,Kennen,137,101,36,73.72
Gwen,Shaco,297,120,177,40.4
Gwen,Brand,289,108,181,37.37
Gwen,Sona,155,81,74,52.26
Gwen,FiddleSticks,193,81,112,41.97
Gwen,Yone,716,333,383,46.51
Gwen,Caitlyn,808,350,458,43.32
Gwen,Tryndamere,222,121,101,54.5
Gwen,Zed,271,128,143,47.23
Gwen,Blitzcrank,295,141,154,47.8
Gwen,Garen,590,222,368,37.63
Gwen,Trundle,181,69,112,38.12
Gwen,Samira,379,193,186,50.92
Gwen,Heimerdinger,193,70,123,36.27
Gwen,Alistar,132,66,66,50
Gwen,Orianna,162,75,87,46.3
Gwen,Pantheon,588,311,277,52.89
Gwen,AurelionSol,197,73,124,37.06
Gwen,MasterYi,381,170,211,44.62
Gwen,Fizz,232,86,146,37.07
Gwen,Nami,379,178,201,46.97
Gwen,Malzahar,313,149,164,47.6
Gwen,Seraphine,450,188,262,41.78
Gwen,Rammus,147,77,70,52.38
Gwen,Aatrox,302,136,166,45.03
Gwen,Leona,346,171,175,49.42
Gwen,Nasus,293,146,147,49.83
Gwen,Xayah,242,100,142,41.32
Gwen,Rakan,251,48,203,19.12
Gwen,Morgana,690,258,432,37.39
Gwen,Jayce,106,63,43,59.43
Gwen,Zilean,81,47,34,58.02
Gwen,Graves,205,89,116,43.41
Gwen,Hecarim,118,58,60,49.15
Gwen,Nautilus,447,209,238,46.76
Gwen,Nunu,379,207,172,54.62
Gwen,Darius,676,341,335,50.44
Gwen,Yorick,422,135,287,31.99
Gwen,Zac,165,64,101,38.79
Gwen,Malphite,346,159,187,45.95
Gwen,Evelynn,165,75,90,45.45
Gwen,Sion,416,197,219,47.36
Gwen,Ekko,353,182,171,51.56
Gwen,Varus,311,156,155,50.16
Gwen,Leblanc,141,78,63,55.32
Gwen,Vladimir,205,85,120,41.46
Gwen,Ivern,78,31,47,39.74
Gwen,Smolder,303,144,159,47.52
Gwen,Milio,224,118,106,52.68
Gwen,Renekton,189,83,106,43.92
Gwen,Karthus,104,52,52,50
Gwen,Braum,166,69,97,41.57
Gwen,Fiora,259,142,117,54.83
Gwen,Corki,84,34,50,40.48
Gwen,Khazix,201,99,102,49.25
Gwen,TahmKench,476,212,264,44.54
Gwen,Amumu,429,206,223,48.02
Gwen,Volibear,399,150,249,37.59
Gwen,Gragas,257,99,158,38.52
Gwen,Naafiri,208,83,125,39.9
Gwen,Akshan,165,83,82,50.3
Gwen,Aphelios,229,105,124,45.85
Gwen,Sivir,154,56,98,36.36
Gwen,Qiyana,172,81,91,47.09
Gwen,Annie,100,61,39,61
Gwen,JarvanIV,138,47,91,34.06
Gwen,Ziggs,146,65,81,44.52
Gwen,Shyvana,111,63,48,56.76
Gwen,Ryze,102,53,49,51.96
Gwen,Rell,197,96,101,48.73
Gwen,Talon,165,88,77,53.33
Gwen,Thresh,481,181,300,37.63
Gwen,Azir,141,72,69,51.06
Gwen,Shen,318,139,179,43.71
Gwen,MonkeyKing,182,77,105,42.31
Gwen,Singed,106,39,67,36.79
Gwen,DrMundo,246,139,107,56.5
Gwen,Kayle,288,135,153,46.88
Gwen,Swain,298,145,153,48.66
Gwen,Maokai,134,50,84,37.31
Gwen,Anivia,131,47,84,35.88
Gwen,Renata,95,40,55,42.11
Gwen,Urgot,198,133,65,67.17
Gwen,Kassadin,68,19,49,27.94
Gwen,Syndra,153,81,72,52.94
Gwen,Ornn,128,49,79,38.28
Gwen,Udyr,161,60,101,37.27
Gwen,Lissandra,97,49,48,50.52
Gwen,Vex,205,104,101,50.73
Gwen,RekSai,42,30,12,71.43
Gwen,Kindred,237,130,107,54.85
Gwen,Quinn,167,54,113,32.34
Gwen,Bard,143,74,69,51.75
Gwen,Viktor,254,119,135,46.85
Gwen,Rumble,74,24,50,32.43
Gwen,KogMaw,164,85,79,51.83
Gwen,Kalista,148,63,85,42.57
Gwen,Poppy,248,75,173,30.24
Gwen,Skarner,79,28,51,35.44
Gwen,Olaf,72,43,29,59.72
Gwen,Kled,89,34,55,38.2
Vi,Chogath,734,376,358,51.23
Vi,Kayn,893,444,449,49.72
Vi,Gangplank,249,127,122,51
Vi,Ezreal,954,553,401,57.97
Vi,Hwei,440,242,198,55
Vi,Braum,252,134,118,53.17
Vi,XinZhao,289,118,171,40.83
Vi,Lux,1279,627,652,49.02
Vi,Taliyah,189,107,82,56.61
Vi,Yorick,287,114,173,39.72
Vi,Seraphine,438,193,245,44.06
Vi,Sivir,228,87,141,38.16
Vi,Xerath,382,174,208,45.55
Vi,KSante,230,114,116,49.57
Vi,Warwick,893,419,474,46.92
Vi,Diana,755,308,447,40.79
Vi,Ashe,826,459,367,55.57
Vi,Corki,161,92,69,57.14
Vi,Akali,479,227,252,47.39
Vi,Akshan,221,129,92,58.37
Vi,TahmKench,566,273,293,48.23
Vi,Urgot,255,116,139,45.49
Vi,LeeSin,619,363,256,58.64
Vi,TwistedFate,177,90,87,50.85
Vi,Yasuo,1066,541,525,50.75
Vi,Rakan,274,161,113,58.76
Vi,Kennen,204,115,89,56.37
Vi,Kaisa,687,377,310,54.88
Vi,Caitlyn,1320,702,618,53.18
Vi,Malphite,410,216,194,52.68
Vi,Vex,330,188,142,56.97
Vi,Twitch,363,226,137,62.26
Vi,Yuumi,531,257,274,48.4
Vi,Gwen,406,259,147,63.79
Vi,Udyr,197,104,93,52.79
Vi,Orianna,259,139,120,53.67
Vi,Nautilus,552,326,226,59.06
Vi,Darius,977,483,494,49.44
Vi,Zed,519,300,219,57.8
Vi,Syndra,281,108,173,38.43
Vi,Senna,462,154,308,33.33
Vi,Sejuani,173,93,80,53.76
Vi,Heimerdinger,279,91,188,32.62
Vi,Jinx,1048,525,523,50.1
Vi,Zilean,143,51,92,35.66
Vi,Garen,833,417,416,50.06
Vi,Aurora,504,287,217,56.94
Vi,MissFortune,1157,490,667,42.35
Vi,Rell,287,143,144,49.83
Vi,Fiora,249,158,91,63.45
Vi,Sylas,476,212,264,44.54
Vi,Ornn,266,134,132,50.38
Vi,Shaco,527,289,238,54.84
Vi,Annie,123,73,50,59.35
Vi,Volibear,608,336,272,55.26
Vi,Teemo,659,276,383,41.88
Vi,Tristana,469,221,248,47.12
Vi,Thresh,747,371,376,49.67
Vi,Yone,1023,530,493,51.81
Vi,Rengar,180,110,70,61.11
Vi,KogMaw,211,112,99,53.08
Vi,Zoe,279,181,98,64.87
Vi,Anivia,141,86,55,60.99
Vi,JarvanIV,235,119,116,50.64
Vi,Katarina,394,244,150,61.93
Vi,Aatrox,515,242,273,46.99
Vi,FiddleSticks,241,137,104,56.85
Vi,Jayce,239,99,140,41.42
Vi,Gragas,326,180,146,55.21
Vi,Hecarim,202,119,83,58.91
Vi,Jhin,895,411,484,45.92
Vi,Velkoz,351,137,214,39.03
Vi,Irelia,461,178,283,38.61
Vi,Zyra,350,148,202,42.29
Vi,Morgana,697,344,353,49.35
Vi,Rammus,136,30,106,22.06
Vi,Alistar,173,115,58,66.47
Vi,Kassadin,106,37,69,34.91
Vi,Milio,299,143,156,47.83
Vi,Veigar,570,270,300,47.37
Vi,Kayle,482,229,253,47.51
Vi,Amumu,462,194,268,41.99
Vi,AurelionSol,293,137,156,46.76
Vi,Smolder,416,194,222,46.63
Vi,Janna,222,115,107,51.8
Vi,Pantheon,946,525,421,55.5
Vi,Lillia,376,189,187,50.27
Vi,Lulu,360,175,185,48.61
Vi,Jax,404,217,187,53.71
Vi,Nilah,289,148,141,51.21
Vi,Karma,406,208,198,51.23
Vi,Ziggs,292,129,163,44.18
Vi,Pyke,496,293,203,59.07
Vi,Mordekaiser,745,396,349,53.15
Vi,Qiyana,194,121,73,62.37
Vi,Brand,361,229,132,63.43
Vi,Poppy,367,181,186,49.32
Vi,Viego,652,288,364,44.17
Vi,Mel,1129,542,587,48.01
Vi,Gnar,257,153,104,59.53
Vi,Malzahar,402,169,233,42.04
Vi,Ryze,125,82,43,65.6
Vi,Viktor,372,222,150,59.68
Vi,Quinn,169,93,76,55.03
Vi,Xayah,307,141,166,45.93
Vi,Neeko,393,223,170,56.74
Vi,Talon,323,191,132,59.13
Vi,Leona,411,233,178,56.69
Vi,Shen,356,177,179,49.72
Vi,Nami,491,234,257,47.66
Vi,Zac,250,130,120,52
Vi,Camille,208,102,106,49.04
Vi,Leblanc,171,114,57,66.67
Vi,Renata,166,74,92,44.58
Vi,Vayne,466,204,262,43.78
Vi,Zeri,285,129,156,45.26
Vi,MasterYi,633,332,301,52.45
Vi,Fizz,280,159,121,56.79
Vi,Ivern,131,80,51,61.07
Vi,Sett,941,483,458,51.33
Vi,Samira,463,264,199,57.02
Vi,Briar,586,274,312,46.76
Vi,Lucian,424,233,191,54.95
Vi,Ambessa,369,207,162,56.1
Vi,Graves,265,113,152,42.64
Vi,Nunu,414,232,182,56.04
Vi,Sion,429,224,205,52.21
Vi,Skarner,192,114,78,59.38
Vi,Vladimir,195,49,146,25.13
Vi,Aphelios,386,183,203,47.41
Vi,Nidalee,144,86,58,59.72
Vi,Ekko,408,199,209,48.77
Vi,Cassiopeia,227,133,94,58.59
Vi,Tryndamere,301,147,154,48.84
Vi,Swain,622,262,360,42.12
Vi,Khazix,335,179,156,53.43
Vi,Ahri,779,386,393,49.55
Vi,Soraka,365,147,218,40.27
Vi,Renekton,261,131,130,50.19
Vi,Nocturne,516,208,308,40.31
Vi,Elise,273,174,99,63.74
Vi,Illaoi,293,156,137,53.24
Vi,Riven,240,137,103,57.08
Vi,Blitzcrank,302,161,141,53.31
Vi,Kled,81,48,33,59.26
Vi,Varus,455,245,210,53.85
Vi,Galio,417,161,256,38.61
Vi,Belveth,92,54,38,58.7
Vi,Evelynn,251,169,82,67.33
Vi,Taric,92,58,34,63.04
Vi,Naafiri,226,128,98,56.64
Vi,Singed,126,53,73,42.06
Vi,Lissandra,126,70,56,55.56
Vi,Kindred,282,155,127,54.96
Vi,Nasus,383,209,174,54.57
Vi,Kalista,193,94,99,48.7
Vi,DrMundo,356,164,192,46.07
Vi,Trundle,275,95,180,34.55
Vi,Maokai,187,116,71,62.03
Vi,MonkeyKing,256,159,97,62.11
Vi,Azir,176,107,69,60.8
Vi,Olaf,95,53,42,55.79
Vi,RekSai,74,29,45,39.19
Vi,Draven,299,143,156,47.83
Vi,Bard,162,79,83,48.77
Vi,Shyvana,79,36,43,45.57
Vi,Rumble,92,44,48,47.83
Vi,Sona,136,60,76,44.12
Vi,Karthus,65,31,34,47.69
Soraka,Chogath,497,215,282,43.26
Soraka,Kayn,580,327,253,56.38
Soraka,Gangplank,162,71,91,43.83
Soraka,Ezreal,571,306,265,53.59
Soraka,Hwei,305,172,133,56.39
Soraka,Zed,383,169,214,44.13
Soraka,Sona,162,89,73,54.94
Soraka,Kaisa,575,334,241,58.09
Soraka,Amumu,367,197,170,53.68
Soraka,Sett,542,258,284,47.6
Soraka,Vladimir,142,93,49,65.49
Soraka,Kindred,219,134,85,61.19
Soraka,Aphelios,310,139,171,44.84
Soraka,Pyke,411,257,154,62.53
Soraka,Teemo,525,258,267,49.14
Soraka,LeeSin,416,242,174,58.17
Soraka,Yone,647,329,318,50.85
Soraka,Jhin,765,379,386,49.54
Soraka,Nami,391,168,223,42.97
Soraka,Annie,140,75,65,53.57
Soraka,Aatrox,402,196,206,48.76
Soraka,MissFortune,759,358,401,47.17
Soraka,Diana,448,214,234,47.77
Soraka,Akali,447,272,175,60.85
Soraka,Caitlyn,918,518,400,56.43
Soraka,Karma,282,137,145,48.58
Soraka,Shaco,367,208,159,56.68
Soraka,Anivia,159,70,89,44.03
Soraka,Lux,1122,566,556,50.45
Soraka,Morgana,607,276,331,45.47
Soraka,Volibear,363,190,173,52.34
Soraka,Ambessa,290,113,177,38.97
Soraka,Smolder,269,142,127,52.79
Soraka,Swain,385,193,192,50.13
Soraka,Vayne,405,233,172,57.53
Soraka,Briar,373,185,188,49.6
Soraka,Mel,897,449,448,50.06
Soraka,Yuumi,377,182,195,48.28
Soraka,Shen,294,147,147,50
Soraka,Twitch,336,163,173,48.51
Soraka,Nautilus,387,208,179,53.75
Soraka,Pantheon,661,385,276,58.25
Soraka,Warwick,547,307,240,56.12
Soraka,Leblanc,121,70,51,57.85
Soraka,Leona,328,169,159,51.52
Soraka,Gwen,304,150,154,49.34
Soraka,Tristana,340,220,120,64.71
Soraka,Poppy,195,118,77,60.51
Soraka,KSante,143,78,65,54.55
Soraka,Viego,542,246,296,45.39
Soraka,Vex,264,105,159,39.77
Soraka,Jinx,826,423,403,51.21
Soraka,Senna,340,155,185,45.59
Soraka,Ivern,100,65,35,65
Soraka,Yasuo,723,370,353,51.18
Soraka,Evelynn,210,129,81,61.43
Soraka,Brand,233,100,133,42.92
Soraka,Udyr,109,58,51,53.21
Soraka,Orianna,125,69,56,55.2
Soraka,Ashe,606,337,269,55.61
Soraka,Irelia,406,214,192,52.71
Soraka,Quinn,126,73,53,57.94
Soraka,Thresh,497,208,289,41.85
Soraka,Renekton,183,92,91,50.27
Soraka,Lillia,257,100,157,38.91
Soraka,Xerath,272,122,150,44.85
Soraka,Rammus,154,70,84,45.45
Soraka,Garen,465,227,238,48.82
Soraka,Talon,292,173,119,59.25
Soraka,Milio,250,136,114,54.4
Soraka,Singed,119,58,61,48.74
Soraka,Galio,277,138,139,49.82
Soraka,Riven,146,82,64,56.16
Soraka,TwistedFate,137,64,73,46.72
Soraka,Fiora,156,93,63,59.62
Soraka,Varus,345,158,187,45.8
Soraka,Janna,118,62,56,52.54
Soraka,MonkeyKing,202,121,81,59.9
Soraka,Katarina,318,146,172,45.91
Soraka,Darius,817,432,385,52.88
Soraka,Jax,333,133,200,39.94
Soraka,Ekko,336,169,167,50.3
Soraka,Shyvana,119,65,54,54.62
Soraka,Taliyah,113,77,36,68.14
Soraka,Corki,137,100,37,72.99
Soraka,Elise,273,130,143,47.62
Soraka,Seraphine,463,224,239,48.38
Soraka,Mordekaiser,624,317,307,50.8
Soraka,Qiyana,136,79,57,58.09
Soraka,Neeko,273,113,160,41.39
Soraka,Sylas,372,169,203,45.43
Soraka,Gragas,198,138,60,69.7
Soraka,Nilah,194,78,116,40.21
Soraka,Kennen,155,90,65,58.06
Soraka,Malzahar,282,134,148,47.52
Soraka,Yorick,379,146,233,38.52
Soraka,Lulu,380,196,184,51.58
Soraka,Viktor,264,124,140,46.97
Soraka,Lucian,233,113,120,48.5
Soraka,Braum,201,108,93,53.73
Soraka,Ornn,214,98,116,45.79
Soraka,Graves,213,128,85,60.09
Soraka,MasterYi,384,179,205,46.61
Soraka,Draven,219,136,83,62.1
Soraka,Hecarim,161,80,81,49.69
Soraka,Ahri,552,288,264,52.17
Soraka,Blitzcrank,306,192,114,62.75
Soraka,Zeri,213,99,114,46.48
Soraka,Kayle,269,152,117,56.51
Soraka,Kled,77,26,51,33.77
Soraka,Veigar,420,219,201,52.14
Soraka,Sejuani,163,96,67,58.9
Soraka,Sion,306,162,144,52.94
Soraka,Alistar,129,71,58,55.04
Soraka,Malphite,249,123,126,49.4
Soraka,Nunu,324,126,198,38.89
Soraka,Nasus,321,200,121,62.31
Soraka,Rell,229,122,107,53.28
Soraka,KogMaw,153,76,77,49.67
Soraka,Aurora,393,195,198,49.62
Soraka,Bard,128,86,42,67.19
Soraka,TahmKench,391,228,163,58.31
Soraka,Rengar,182,89,93,48.9
Soraka,Cassiopeia,140,77,63,55
Soraka,Naafiri,187,100,87,53.48
Soraka,Trundle,215,108,107,50.23
Soraka,Zilean,117,74,43,63.25
Soraka,Velkoz,242,110,132,45.45
Soraka,Ziggs,171,73,98,42.69
Soraka,Azir,102,64,38,62.75
Soraka,Sivir,105,41,64,39.05
Soraka,Zyra,268,145,123,54.1
Soraka,Vi,365,218,147,59.73
Soraka,Zoe,223,131,92,58.74
Soraka,DrMundo,183,68,115,37.16
Soraka,FiddleSticks,181,90,91,49.72
Soraka,Camille,143,62,81,43.36
Soraka,Olaf,89,52,37,58.43
Soraka,Gnar,127,70,57,55.12
Soraka,Syndra,214,142,72,66.36
Soraka,Nidalee,136,87,49,63.97
Soraka,Fizz,181,91,90,50.28
Soraka,Taric,42,20,22,47.62
Soraka,Karthus,121,79,42,65.29
Soraka,Illaoi,241,115,126,47.72
Soraka,AurelionSol,210,85,125,40.48
Soraka,JarvanIV,130,81,49,62.31
Soraka,Heimerdinger,224,120,104,53.57
Soraka,Samira,319,134,185,42.01
Soraka,Rumble,91,63,28,69.23
Soraka,Khazix,170,69,101,40.59
Soraka,Tryndamere,215,121,94,56.28
Soraka,Kassadin,84,44,40,52.38
Soraka,Maokai,158,88,70,55.7
Soraka,Nocturne,279,144,135,51.61
Soraka,Renata,80,53,27,66.25
Soraka,Zac,131,68,63,51.91
Soraka,Rakan,213,128,85,60.09
Soraka,Jayce,165,63,102,38.18
Soraka,Ryze,79,51,28,64.56
Soraka,Kalista,192,117,75,60.94
Soraka,Belveth,107,43,64,40.19
Soraka,XinZhao,193,87,106,45.08
Soraka,Lissandra,73,44,29,60.27
Soraka,Akshan,140,67,73,47.86
Soraka,Xayah,232,121,111,52.16
Soraka,Skarner,93,37,56,39.78
Soraka,Urgot,150,43,107,28.67
Soraka,RekSai,27,18,9,66.67
Jax,Vladimir,287,144,143,50.17
Jax,Viego,567,277,290,48.85
Jax,Velkoz,206,84,122,40.78
Jax,Kaisa,745,419,326,56.24
Jax,Karma,357,146,211,40.9
Jax,Irelia,472,224,248,47.46
Jax,Zed,541,266,275,49.17
Jax,Galio,364,148,216,40.66
Jax,MissFortune,1031,490,541,47.53
Jax,TahmKench,585,291,294,49.74
Jax,Gwen,281,186,95,66.19
Jax,Talon,307,183,124,59.61
Jax,Yone,1027,553,474,53.85
Jax,Taric,113,22,91,19.47
Jax,Poppy,373,186,187,49.87
Jax,Warwick,781,372,409,47.63
Jax,Katarina,382,206,176,53.93
Jax,Twitch,483,265,218,54.87
Jax,Morgana,686,325,361,47.38
Jax,Briar,534,313,221,58.61
Jax,Vex,316,189,127,59.81
Jax,Jinx,980,519,461,52.96
Jax,Milio,325,173,152,53.23
Jax,Akali,547,239,308,43.69
Jax,Rammus,199,66,133,33.17
Jax,Yasuo,1142,543,599,47.55
Jax,Zyra,271,111,160,40.96
Jax,Ryze,104,63,41,60.58
Jax,Nunu,414,181,233,43.72
Jax,Ahri,724,367,357,50.69
Jax,Lucian,253,123,130,48.62
Jax,Alistar,190,120,70,63.16
Jax,Ornn,222,92,130,41.44
Jax,TwistedFate,211,114,97,54.03
Jax,Caitlyn,1201,519,682,43.21
Jax,Pantheon,880,456,424,51.82
Jax,Leblanc,187,99,88,52.94
Jax,Aphelios,298,170,128,57.05
Jax,Leona,347,130,217,37.46
Jax,Yorick,471,198,273,42.04
Jax,Draven,222,137,85,61.71
Jax,KogMaw,214,117,97,54.67
Jax,Yuumi,449,205,244,45.66
Jax,Tryndamere,323,160,163,49.54
Jax,Sylas,493,271,222,54.97
Jax,Taliyah,160,88,72,55
Jax,Jhin,915,455,460,49.73
Jax,Senna,470,253,217,53.83
Jax,Malphite,298,150,148,50.34
Jax,Diana,624,292,332,46.79
Jax,Lux,1337,651,686,48.69
Jax,Fiora,244,102,142,41.8
Jax,Shaco,436,219,217,50.23
Jax,Fizz,290,148,142,51.03
Jax,Tristana,493,248,245,50.3
Jax,Rakan,247,98,149,39.68
Jax,Sett,866,392,474,45.27
Jax,FiddleSticks,252,121,131,48.02
Jax,Samira,496,249,247,50.2
Jax,Neeko,376,172,204,45.74
Jax,Volibear,578,294,284,50.87
Jax,LeeSin,591,337,254,57.02
Jax,Malzahar,362,121,241,33.43
Jax,Pyke,731,388,343,53.08
Jax,Renekton,261,125,136,47.89
Jax,Khazix,271,187,84,69
Jax,Quinn,162,70,92,43.21
Jax,Kayn,872,455,417,52.18
Jax,Aatrox,453,247,206,54.53
Jax,Mel,1085,612,473,56.41
Jax,Ezreal,784,411,373,52.42
Jax,Elise,294,177,117,60.2
Jax,Shen,362,185,177,51.1
Jax,Amumu,417,155,262,37.17
Jax,Ziggs,243,105,138,43.21
Jax,Jayce,237,140,97,59.07
Jax,Swain,512,213,299,41.6
Jax,Sion,348,174,174,50
Jax,XinZhao,305,134,171,43.93
Jax,Soraka,333,200,133,60.06
Jax,Singed,181,104,77,57.46
Jax,Garen,966,424,542,43.89
Jax,Zilean,186,79,107,42.47
Jax,Rengar,255,179,76,70.2
Jax,Aurora,474,269,205,56.75
Jax,Seraphine,596,307,289,51.51
Jax,Gragas,395,168,227,42.53
Jax,Veigar,636,348,288,54.72
Jax,Kalista,231,118,113,51.08
Jax,Trundle,325,182,143,56
Jax,MonkeyKing,284,155,129,54.58
Jax,Darius,962,514,448,53.43
Jax,Chogath,662,294,368,44.41
Jax,Evelynn,313,163,150,52.08
Jax,Nocturne,431,208,223,48.26
Jax,Thresh,600,298,302,49.67
Jax,Olaf,148,95,53,64.19
Jax,Ashe,927,431,496,46.49
Jax,AurelionSol,266,119,147,44.74
Jax,Nilah,252,135,117,53.57
Jax,Riven,171,93,78,54.39
Jax,Syndra,253,122,131,48.22
Jax,MasterYi,571,295,276,51.66
Jax,Xayah,368,180,188,48.91
Jax,Hwei,434,226,208,52.07
Jax,Illaoi,240,98,142,40.83
Jax,Mordekaiser,811,400,411,49.32
Jax,Nami,430,232,198,53.95
Jax,Nautilus,476,252,224,52.94
Jax,Viktor,309,165,144,53.4
Jax,DrMundo,399,186,213,46.62
Jax,Rell,245,140,105,57.14
Jax,Zoe,223,134,89,60.09
Jax,Udyr,144,74,70,51.39
Jax,Lulu,433,238,195,54.97
Jax,Teemo,653,339,314,51.91
Jax,Lillia,387,183,204,47.29
Jax,Graves,278,144,134,51.8
Jax,Kennen,173,119,54,68.79
Jax,Brand,367,211,156,57.49
Jax,Maokai,223,125,98,56.05
Jax,Camille,195,116,79,59.49
Jax,Skarner,190,82,108,43.16
Jax,Vi,404,187,217,46.29
Jax,Xerath,294,125,169,42.52
Jax,Kayle,438,220,218,50.23
Jax,Ekko,363,210,153,57.85
Jax,Urgot,246,101,145,41.06
Jax,Ivern,47,24,23,51.06
Jax,Kassadin,116,67,49,57.76
Jax,Gangplank,286,168,118,58.74
Jax,Hecarim,204,118,86,57.84
Jax,Annie,174,94,80,54.02
Jax,Vayne,472,275,197,58.26
Jax,Corki,180,109,71,60.56
Jax,Ambessa,357,172,185,48.18
Jax,Varus,432,213,219,49.31
Jax,Heimerdinger,281,126,155,44.84
Jax,Azir,211,110,101,52.13
Jax,Akshan,189,99,90,52.38
Jax,Sona,210,100,110,47.62
Jax,Qiyana,199,132,67,66.33
Jax,Braum,262,130,132,49.62
Jax,Cassiopeia,239,144,95,60.25
Jax,KSante,109,51,58,46.79
Jax,Janna,148,62,86,41.89
Jax,Naafiri,205,88,117,42.93
Jax,Blitzcrank,356,190,166,53.37
Jax,Nasus,390,179,211,45.9
Jax,Gnar,131,56,75,42.75
Jax,Sejuani,171,70,101,40.94
Jax,Smolder,358,183,175,51.12
Jax,Karthus,103,74,29,71.84
Jax,Kled,85,52,33,61.18
Jax,Anivia,169,90,79,53.25
Jax,Kindred,261,154,107,59
Jax,Nidalee,145,84,61,57.93
Jax,JarvanIV,193,89,104,46.11
Jax,Zac,198,145,53,73.23
Jax,Belveth,115,58,57,50.43
Jax,Renata,130,85,45,65.38
Jax,Sivir,300,130,170,43.33
Jax,Shyvana,148,63,85,42.57
Jax,Orianna,233,135,98,57.94
Jax,Bard,152,93,59,61.18
Jax,Rumble,73,35,38,47.95
Jax,Lissandra,102,61,41,59.8
Jax,Zeri,208,143,65,68.75
Jax,RekSai,70,22,48,31.43
XinZhao,Vladimir,176,92,84,52.27
XinZhao,Viego,440,214,226,48.64
XinZhao,Velkoz,227,120,107,52.86
XinZhao,Kaisa,494,247,247,50
XinZhao,Karma,298,122,176,40.94
XinZhao,Garen,543,209,334,38.49
XinZhao,Kayn,495,277,218,55.96
XinZhao,Lux,926,511,415,55.18
XinZhao,Caitlyn,801,452,349,56.43
XinZhao,Thresh,494,231,263,46.76
XinZhao,Aatrox,328,190,138,57.93
XinZhao,Gwen,212,117,95,55.19
XinZhao,Syndra,216,108,108,50
XinZhao,Ashe,699,318,381,45.49
XinZhao,Lulu,301,186,115,61.79
XinZhao,Sett,571,316,255,55.34
XinZhao,Vi,289,171,118,59.17
XinZhao,AurelionSol,97,37,60,38.14
XinZhao,Corki,112,81,31,72.32
XinZhao,Milio,157,91,66,57.96
XinZhao,Riven,184,110,74,59.78
XinZhao,LeeSin,421,250,171,59.38
XinZhao,Mel,754,420,334,55.7
XinZhao,Tristana,319,130,189,40.75
XinZhao,Zac,142,90,52,63.38
XinZhao,FiddleSticks,149,65,84,43.62
XinZhao,Brand,214,128,86,59.81
XinZhao,Jinx,588,276,312,46.94
XinZhao,Amumu,372,135,237,36.29
XinZhao,Akshan,92,47,45,51.09
XinZhao,Ezreal,610,364,246,59.67
XinZhao,Darius,664,363,301,54.67
XinZhao,Ivern,80,46,34,57.5
XinZhao,Katarina,325,181,144,55.69
XinZhao,Pantheon,631,332,299,52.61
XinZhao,Rammus,86,32,54,37.21
XinZhao,Yasuo,674,382,292,56.68
XinZhao,Pyke,407,256,151,62.9
XinZhao,Yone,658,375,283,56.99
XinZhao,Sivir,147,64,83,43.54
XinZhao,Ahri,524,275,249,52.48
XinZhao,Diana,423,222,201,52.48
XinZhao,Jhin,643,378,265,58.79
XinZhao,RekSai,62,31,31,50
XinZhao,Gangplank,143,79,64,55.24
XinZhao,Leona,292,157,135,53.77
XinZhao,Jax,305,171,134,56.07
XinZhao,Ekko,318,171,147,53.77
XinZhao,Trundle,234,121,113,51.71
XinZhao,Aphelios,196,101,95,51.53
XinZhao,Ambessa,207,125,82,60.39
XinZhao,Veigar,387,205,182,52.97
XinZhao,MissFortune,625,282,343,45.12
XinZhao,Nautilus,321,140,181,43.61
XinZhao,Chogath,478,216,262,45.19
XinZhao,Zed,350,197,153,56.29
XinZhao,Galio,253,136,117,53.75
XinZhao,Maokai,142,55,87,38.73
XinZhao,Fiora,227,117,110,51.54
XinZhao,DrMundo,206,96,110,46.6
XinZhao,Poppy,173,101,72,58.38
XinZhao,TwistedFate,100,49,51,49
XinZhao,Samira,319,178,141,55.8
XinZhao,Seraphine,425,243,182,57.18
XinZhao,Urgot,166,52,114,31.33
XinZhao,Sylas,382,178,204,46.6
XinZhao,Rakan,214,127,87,59.35
XinZhao,Shen,206,111,95,53.88
XinZhao,Kassadin,51,38,13,74.51
XinZhao,Blitzcrank,300,134,166,44.67
XinZhao,MonkeyKing,196,78,118,39.8
XinZhao,Vex,222,97,125,43.69
XinZhao,TahmKench,420,193,227,45.95
XinZhao,Cassiopeia,165,93,72,56.36
XinZhao,Lucian,214,148,66,69.16
XinZhao,Nami,315,192,123,60.95
XinZhao,Ornn,159,68,91,42.77
XinZhao,Aurora,325,180,145,55.38
XinZhao,Xayah,272,149,123,54.78
XinZhao,Kayle,209,93,116,44.5
XinZhao,Volibear,366,178,188,48.63
XinZhao,Shaco,314,159,155,50.64
XinZhao,Yorick,445,225,220,50.56
XinZhao,Irelia,278,156,122,56.12
XinZhao,MasterYi,390,186,204,47.69
XinZhao,Akali,417,249,168,59.71
XinZhao,Lillia,222,125,97,56.31
XinZhao,Khazix,208,95,113,45.67
XinZhao,Varus,271,152,119,56.09
XinZhao,Mordekaiser,519,259,260,49.9
XinZhao,Warwick,538,282,256,52.42
XinZhao,Naafiri,138,78,60,56.52
XinZhao,Ziggs,206,89,117,43.2
XinZhao,Kled,50,25,25,50
XinZhao,Gnar,154,97,57,62.99
XinZhao,Nasus,357,207,150,57.98
XinZhao,Ryze,88,43,45,48.86
XinZhao,Bard,85,61,24,71.76
XinZhao,Viktor,215,137,78,63.72
XinZhao,Draven,201,133,68,66.17
XinZhao,Elise,210,116,94,55.24
XinZhao,Udyr,126,74,52,58.73
XinZhao,Vayne,399,195,204,48.87
XinZhao,Anivia,97,48,49,49.48
XinZhao,Sejuani,133,84,49,63.16
XinZhao,Braum,178,86,92,48.31
XinZhao,Kennen,73,38,35,52.05
XinZhao,Gragas,204,107,97,52.45
XinZhao,Heimerdinger,216,105,111,48.61
XinZhao,Morgana,380,185,195,48.68
XinZhao,Briar,348,176,172,50.57
XinZhao,Taric,86,54,32,62.79
XinZhao,Belveth,110,67,43,60.91
XinZhao,Nunu,261,151,110,57.85
XinZhao,Kindred,177,110,67,62.15
XinZhao,Taliyah,108,79,29,73.15
XinZhao,Nilah,206,126,80,61.17
XinZhao,Illaoi,152,86,66,56.58
XinZhao,Xerath,238,112,126,47.06
XinZhao,Yuumi,351,177,174,50.43
XinZhao,Smolder,282,171,111,60.64
XinZhao,Twitch,269,119,150,44.24
XinZhao,Senna,304,137,167,45.07
XinZhao,Malzahar,261,119,142,45.59
XinZhao,Malphite,269,150,119,55.76
XinZhao,Nidalee,98,31,67,31.63
XinZhao,Kalista,162,89,73,54.94
XinZhao,Zyra,199,103,96,51.76
XinZhao,Skarner,97,56,41,57.73
XinZhao,Qiyana,126,65,61,51.59
XinZhao,Evelynn,186,115,71,61.83
XinZhao,Sona,109,61,48,55.96
XinZhao,Singed,96,40,56,41.67
XinZhao,Alistar,87,39,48,44.83
XinZhao,Sion,267,154,113,57.68
XinZhao,Teemo,465,210,255,45.16
XinZhao,Rengar,137,90,47,65.69
XinZhao,Hwei,183,97,86,53.01
XinZhao,KogMaw,128,49,79,38.28
XinZhao,Azir,138,64,74,46.38
XinZhao,Fizz,185,80,105,43.24
XinZhao,Swain,434,219,215,50.46
XinZhao,Renekton,163,88,75,53.99
XinZhao,KSante,166,95,71,57.23
XinZhao,Neeko,305,162,143,53.11
XinZhao,Tryndamere,158,79,79,50
XinZhao,Soraka,193,106,87,54.92
XinZhao,Leblanc,164,109,55,66.46
XinZhao,Quinn,99,67,32,67.68
XinZhao,Graves,146,85,61,58.22
XinZhao,Nocturne,331,153,178,46.22
XinZhao,Karthus,65,37,28,56.92
XinZhao,Zoe,126,84,42,66.67
XinZhao,Hecarim,146,90,56,61.64
XinZhao,Zeri,130,68,62,52.31
XinZhao,Rell,159,96,63,60.38
XinZhao,Talon,187,97,90,51.87
XinZhao,Olaf,87,63,24,72.41
XinZhao,JarvanIV,171,109,62,63.74
XinZhao,Jayce,128,69,59,53.91
XinZhao,Rumble,66,37,29,56.06
XinZhao,Orianna,145,77,68,53.1
XinZhao,Lissandra,66,31,35,46.97
XinZhao,Camille,117,71,46,60.68
XinZhao,Shyvana,134,70,64,52.24
XinZhao,Zilean,73,33,40,45.21
XinZhao,Renata,79,42,37,53.16
XinZhao,Annie,65,44,21,67.69
XinZhao,Janna,82,55,27,67.07
Kennen,Vladimir,147,84,63,57.14
Kennen,Viego,340,118,222,34.71
Kennen,Velkoz,140,44,96,31.43
Kennen,Kaisa,274,134,140,48.91
Kennen,Karma,155,63,92,40.65
Kennen,Aatrox,238,121,117,50.84
Kennen,Sylas,224,94,130,41.96
Kennen,Diana,282,126,156,44.68
Kennen,Varus,168,106,62,63.1
Kennen,Blitzcrank,187,103,84,55.08
Kennen,Vayne,302,123,179,40.73
Kennen,Briar,160,45,115,28.13
Kennen,Lux,743,351,392,47.24
Kennen,Mel,445,184,261,41.35
Kennen,Yuumi,202,71,131,35.15
Kennen,Yone,359,174,185,48.47
Kennen,Gragas,158,74,84,46.84
Kennen,Irelia,205,110,95,53.66
Kennen,TahmKench,234,94,140,40.17
Kennen,Rell,124,72,52,58.06
Kennen,Mordekaiser,372,162,210,43.55
Kennen,Ahri,346,157,189,45.38
Kennen,Nunu,193,97,96,50.26
Kennen,Yasuo,483,244,239,50.52
Kennen,Zyra,97,50,47,51.55
Kennen,Viktor,111,32,79,28.83
Kennen,Nocturne,166,75,91,45.18
Kennen,Annie,66,35,31,53.03
Kennen,KogMaw,87,46,41,52.87
Kennen,Alistar,71,29,42,40.85
Kennen,Vi,204,89,115,43.63
Kennen,Amumu,202,70,132,34.65
Kennen,Akshan,70,37,33,52.86
Kennen,Ezreal,391,195,196,49.87
Kennen,Zed,214,85,129,39.72
Kennen,TwistedFate,77,41,36,53.25
Kennen,Teemo,348,158,190,45.4
Kennen,Maokai,75,22,53,29.33
Kennen,Corki,66,28,38,42.42
Kennen,Taric,44,7,37,15.91
Kennen,Jayce,100,54,46,54
Kennen,JarvanIV,64,29,35,45.31
Kennen,Aurora,213,105,108,49.3
Kennen,Caitlyn,537,237,300,44.13
Kennen,Akali,223,108,115,48.43
Kennen,MasterYi,292,124,168,42.47
Kennen,Swain,264,117,147,44.32
Kennen,MissFortune,487,155,332,31.83
Kennen,Thresh,291,123,168,42.27
Kennen,Qiyana,63,41,22,65.08
Kennen,Neeko,213,108,105,50.7
Kennen,Malphite,206,96,110,46.6
Kennen,Khazix,146,71,75,48.63
Kennen,Lulu,160,81,79,50.63
Kennen,Gwen,137,36,101,26.28
Kennen,Lillia,170,92,78,54.12
Kennen,Morgana,253,115,138,45.45
Kennen,Soraka,155,65,90,41.94
Kennen,Renekton,102,47,55,46.08
Kennen,Darius,434,230,204,53
Kennen,FiddleSticks,117,59,58,50.43
Kennen,Ryze,61,30,31,49.18
Kennen,Kalista,121,73,48,60.33
Kennen,Janna,91,42,49,46.15
Kennen,Kayn,378,228,150,60.32
Kennen,Xayah,172,87,85,50.58
Kennen,Shaco,248,109,139,43.95
Kennen,Sett,420,176,244,41.9
Kennen,Katarina,195,96,99,49.23
Kennen,Rengar,89,64,25,71.91
Kennen,Seraphine,230,104,126,45.22
Kennen,Urgot,141,46,95,32.62
Kennen,Hwei,202,96,106,47.52
Kennen,Jhin,373,194,179,52.01
Kennen,Jax,173,54,119,31.21
Kennen,Zoe,103,77,26,74.76
Kennen,Ashe,380,137,243,36.05
Kennen,Kindred,117,58,59,49.57
Kennen,Galio,135,46,89,34.07
Kennen,Lucian,142,71,71,50
Kennen,Yorick,140,37,103,26.43
Kennen,Rammus,46,26,20,56.52
Kennen,Milio,131,47,84,35.88
Kennen,DrMundo,168,53,115,31.55
Kennen,Lissandra,56,31,25,55.36
Kennen,Zilean,64,20,44,31.25
Kennen,Udyr,101,44,57,43.56
Kennen,Orianna,58,29,29,50
Kennen,Trundle,117,54,63,46.15
Kennen,Rakan,116,52,64,44.83
Kennen,Gnar,114,58,56,50.88
Kennen,Cassiopeia,102,40,62,39.22
Kennen,Nami,215,95,120,44.19
Kennen,Evelynn,171,84,87,49.12
Kennen,Zeri,87,40,47,45.98
Kennen,Leona,162,83,79,51.23
Kennen,Leblanc,87,44,43,50.57
Kennen,Jinx,464,243,221,52.37
Kennen,Warwick,351,203,148,57.83
Kennen,Sejuani,82,39,43,47.56
Kennen,Malzahar,201,106,95,52.74
Kennen,Ekko,161,87,74,54.04
Kennen,Draven,134,50,84,37.31
Kennen,Nautilus,200,73,127,36.5
Kennen,Riven,117,45,72,38.46
Kennen,Tristana,236,110,126,46.61
Kennen,LeeSin,207,118,89,57
Kennen,Xerath,147,69,78,46.94
Kennen,Nasus,197,73,124,37.06
Kennen,XinZhao,73,35,38,47.95
Kennen,Syndra,120,67,53,55.83
Kennen,Nilah,100,46,54,46
Kennen,Veigar,332,143,189,43.07
Kennen,Anivia,69,28,41,40.58
Kennen,Poppy,130,75,55,57.69
Kennen,Naafiri,142,78,64,54.93
Kennen,Chogath,380,205,175,53.95
Kennen,Vex,165,71,94,43.03
Kennen,Kayle,181,71,110,39.23
Kennen,Gangplank,117,56,61,47.86
Kennen,Smolder,219,110,109,50.23
Kennen,Samira,215,88,127,40.93
Kennen,Singed,67,18,49,26.87
Kennen,Garen,318,124,194,38.99
Kennen,Hecarim,88,28,60,31.82
Kennen,Fizz,102,39,63,38.24
Kennen,Twitch,168,73,95,43.45
Kennen,Belveth,62,15,47,24.19
Kennen,Senna,198,96,102,48.48
Kennen,Camille,132,78,54,59.09
Kennen,Quinn,89,41,48,46.07
Kennen,Sona,107,40,67,37.38
Kennen,Illaoi,63,25,38,39.68
Kennen,Brand,157,47,110,29.94
Kennen,Braum,80,43,37,53.75
Kennen,Kled,48,19,29,39.58
Kennen,Aphelios,216,96,120,44.44
Kennen,Azir,54,39,15,72.22
Kennen,Elise,205,77,128,37.56
Kennen,Ambessa,121,89,32,73.55
Kennen,Pantheon,344,128,216,37.21
Kennen,Taliyah,64,30,34,46.88
Kennen,Talon,142,61,81,42.96
Kennen,Volibear,151,60,91,39.74
Kennen,Heimerdinger,141,55,86,39.01
Kennen,Sivir,84,27,57,32.14
Kennen,RekSai,22,19,3,86.36
Kennen,Ornn,109,46,63,42.2
Kennen,Graves,123,61,62,49.59
Kennen,Nidalee,64,35,29,54.69
Kennen,Tryndamere,106,43,63,40.57
Kennen,Fiora,81,44,37,54.32
Kennen,AurelionSol,101,46,55,45.54
Kennen,Bard,107,59,48,55.14
Kennen,MonkeyKing,129,49,80,37.98
Kennen,KSante,80,44,36,55
Kennen,Ivern,66,34,32,51.52
Kennen,Pyke,232,145,87,62.5
Kennen,Karthus,58,44,14,75.86
Kennen,Kassadin,59,20,39,33.9
Kennen,Sion,158,77,81,48.73
Kennen,Shen,131,63,68,48.09
Kennen,Renata,67,26,41,38.81
Kennen,Shyvana,69,39,30,56.52
Kennen,Zac,72,20,52,27.78
Kennen,Olaf,61,15,46,24.59
Kennen,Skarner,42,14,28,33.33
Kennen,Rumble,24,6,18,25
Kennen,Ziggs,50,16,34,32
Kalista,Vladimir,189,88,101,46.56
Kalista,Viego,317,123,194,38.8
Kalista,Velkoz,142,41,101,28.87
Kalista,Kaisa,375,144,231,38.4
Kalista,Karma,219,121,98,55.25
Kalista,Renekton,164,100,64,60.98
Kalista,JarvanIV,168,84,84,50
Kalista,Mel,715,282,433,39.44
Kalista,Jhin,526,243,283,46.2
Kalista,Sylas,302,110,192,36.42
Kalista,Mordekaiser,446,219,227,49.1
Kalista,Kindred,168,95,73,56.55
Kalista,TahmKench,345,158,187,45.8
Kalista,Yorick,218,50,168,22.94
Kalista,AurelionSol,163,44,119,26.99
Kalista,Kayn,474,235,239,49.58
Kalista,Singed,71,26,45,36.62
Kalista,Udyr,100,43,57,43
Kalista,Malphite,274,97,177,35.4
Kalista,Rell,130,71,59,54.62
Kalista,Jayce,171,97,74,56.73
Kalista,Rengar,133,75,58,56.39
Kalista,Swain,313,119,194,38.02
Kalista,Ezreal,559,287,272,51.34
Kalista,Sona,94,26,68,27.66
Kalista,Darius,558,236,322,42.29
Kalista,Trundle,124,35,89,28.23
Kalista,Gragas,136,77,59,56.62
Kalista,Yasuo,507,258,249,50.89
Kalista,Vex,202,84,118,41.58
Kalista,Diana,410,185,225,45.12
Kalista,Akali,339,146,193,43.07
Kalista,Jinx,537,245,292,45.62
Kalista,Lux,777,399,378,51.35
Kalista,Camille,106,37,69,34.91
Kalista,LeeSin,292,166,126,56.85
Kalista,Draven,177,83,94,46.89
Kalista,Senna,210,93,117,44.29
Kalista,Chogath,381,166,215,43.57
Kalista,Yuumi,345,182,163,52.75
Kalista,Ornn,142,67,75,47.18
Kalista,Briar,295,121,174,41.02
Kalista,Caitlyn,712,310,402,43.54
Kalista,Morgana,362,175,187,48.34
Kalista,Ashe,427,192,235,44.96
Kalista,Alistar,90,40,50,44.44
Kalista,Nocturne,213,111,102,52.11
Kalista,Qiyana,106,68,38,64.15
Kalista,Sett,452,209,243,46.24
Kalista,Jax,231,113,118,48.92
Kalista,Janna,87,41,46,47.13
Kalista,Gangplank,136,58,78,42.65
Kalista,MissFortune,699,355,344,50.79
Kalista,Aurora,287,154,133,53.66
Kalista,Aatrox,259,114,145,44.02
Kalista,Rumble,36,20,16,55.56
Kalista,Leona,208,100,108,48.08
Kalista,Urgot,152,52,100,34.21
Kalista,Twitch,284,160,124,56.34
Kalista,Teemo,375,177,198,47.2
Kalista,Pantheon,440,191,249,43.41
Kalista,Graves,124,60,64,48.39
Kalista,Leblanc,130,63,67,48.46
Kalista,Garen,520,231,289,44.42
Kalista,Syndra,123,68,55,55.28
Kalista,Rammus,64,36,28,56.25
Kalista,Fizz,112,44,68,39.29
Kalista,Sivir,88,32,56,36.36
Kalista,Shaco,335,176,159,52.54
Kalista,Taliyah,82,48,34,58.54
Kalista,Shen,191,82,109,42.93
Kalista,Volibear,265,92,173,34.72
Kalista,Tristana,302,130,172,43.05
Kalista,Nami,206,99,107,48.06
Kalista,Poppy,203,107,96,52.71
Kalista,Warwick,427,179,248,41.92
Kalista,Illaoi,126,58,68,46.03
Kalista,Nautilus,312,148,164,47.44
Kalista,Kennen,121,48,73,39.67
Kalista,Yone,599,244,355,40.73
Kalista,Ziggs,150,60,90,40
Kalista,Braum,121,46,75,38.02
Kalista,Irelia,266,118,148,44.36
Kalista,MasterYi,370,160,210,43.24
Kalista,Aphelios,297,166,131,55.89
Kalista,Lissandra,82,43,39,52.44
Kalista,Sion,169,63,106,37.28
Kalista,Katarina,247,128,119,51.82
Kalista,Talon,172,85,87,49.42
Kalista,Lillia,202,106,96,52.48
Kalista,Quinn,70,41,29,58.57
Kalista,Xayah,162,58,104,35.8
Kalista,Neeko,226,88,138,38.94
Kalista,Rakan,150,74,76,49.33
Kalista,Kled,73,34,39,46.58
Kalista,Malzahar,239,117,122,48.95
Kalista,Vayne,227,115,112,50.66
Kalista,Thresh,382,186,196,48.69
Kalista,Cassiopeia,109,40,69,36.7
Kalista,Heimerdinger,170,83,87,48.82
Kalista,Samira,258,92,166,35.66
Kalista,Kayle,265,127,138,47.92
Kalista,Ahri,477,206,271,43.19
Kalista,FiddleSticks,127,57,70,44.88
Kalista,Ekko,159,50,109,31.45
Kalista,Xerath,204,98,106,48.04
Kalista,Seraphine,287,122,165,42.51
Kalista,Hwei,242,94,148,38.84
Kalista,Ambessa,166,102,64,61.45
Kalista,Akshan,90,39,51,43.33
Kalista,Zoe,148,57,91,38.51
Kalista,Fiora,134,61,73,45.52
Kalista,Milio,148,76,72,51.35
Kalista,Shyvana,92,31,61,33.7
Kalista,Smolder,305,143,162,46.89
Kalista,Zeri,131,84,47,64.12
Kalista,Blitzcrank,247,68,179,27.53
Kalista,Viktor,204,61,143,29.9
Kalista,Veigar,400,150,250,37.5
Kalista,Nasus,205,82,123,40
Kalista,XinZhao,162,73,89,45.06
Kalista,Kassadin,92,44,48,47.83
Kalista,KogMaw,87,47,40,54.02
Kalista,Ryze,69,26,43,37.68
Kalista,Khazix,138,70,68,50.72
Kalista,Nunu,208,109,99,52.4
Kalista,Pyke,277,147,130,53.07
Kalista,Lulu,192,78,114,40.63
Kalista,Nilah,195,62,133,31.79
Kalista,Vi,193,99,94,51.3
Kalista,DrMundo,165,77,88,46.67
Kalista,Zed,269,127,142,47.21
Kalista,Corki,61,36,25,59.02
Kalista,Brand,168,83,85,49.4
Kalista,Riven,119,76,43,63.87
Kalista,KSante,123,62,61,50.41
Kalista,Karthus,71,42,29,59.15
Kalista,Hecarim,129,48,81,37.21
Kalista,Varus,269,126,143,46.84
Kalista,Elise,167,67,100,40.12
Kalista,Naafiri,115,53,62,46.09
Kalista,Soraka,192,75,117,39.06
Kalista,Belveth,119,60,59,50.42
Kalista,Sejuani,105,55,50,52.38
Kalista,Orianna,110,70,40,63.64
Kalista,Taric,82,35,47,42.68
Kalista,MonkeyKing,140,66,74,47.14
Kalista,Anivia,77,35,42,45.45
Kalista,Galio,241,111,130,46.06
Kalista,Skarner,93,51,42,54.84
Kalista,Annie,64,40,24,62.5
Kalista,Amumu,238,111,127,46.64
Kalista,Nidalee,96,45,51,46.88
Kalista,TwistedFate,81,43,38,53.09
Kalista,Azir,114,67,47,58.77
Kalista,Olaf,69,24,45,34.78
Kalista,Maokai,113,27,86,23.89
Kalista,Lucian,192,101,91,52.6
Kalista,Zilean,111,55,56,49.55
Kalista,Gnar,108,68,40,62.96
Kalista,Gwen,148,85,63,57.43
Kalista,Renata,73,10,63,13.7
Kalista,Tryndamere,234,143,91,61.11
Kalista,Bard,123,56,67,45.53
Kalista,Zyra,148,77,71,52.03
Kalista,Evelynn,201,104,97,51.74
Kalista,Zac,100,49,51,49
Kalista,Ivern,68,25,43,36.76
Kalista,RekSai,43,16,27,37.21
Lulu,Vladimir,296,168,128,56.76
Lulu,Viego,583,272,311,46.66
Lulu,Velkoz,321,145,176,45.17
Lulu,Kaisa,642,305,337,47.51
Lulu,Karma,421,209,212,49.64
Lulu,Yorick,415,162,253,39.04
Lulu,Diana,539,267,272,49.54
Lulu,Seraphine,528,223,305,42.23
Lulu,Rakan,317,159,158,50.16
Lulu,XinZhao,301,115,186,38.21
Lulu,Katarina,407,231,176,56.76
Lulu,Teemo,640,299,341,46.72
Lulu,Vayne,530,285,245,53.77
Lulu,TwistedFate,179,88,91,49.16
Lulu,Gragas,397,251,146,63.22
Lulu,Gwen,244,121,123,49.59
Lulu,Yasuo,983,494,489,50.25
Lulu,Zeri,258,113,145,43.8
Lulu,Bard,206,90,116,43.69
Lulu,Smolder,392,216,176,55.1
Lulu,Ekko,403,170,233,42.18
Lulu,Mordekaiser,683,325,358,47.58
Lulu,Yuumi,620,335,285,54.03
Lulu,Shaco,414,166,248,40.1
Lulu,Tryndamere,270,105,165,38.89
Lulu,Ezreal,1109,582,527,52.48
Lulu,Milio,352,165,187,46.88
Lulu,Ryze,184,65,119,35.33
Lulu,Nunu,401,199,202,49.63
Lulu,Ahri,703,354,349,50.36
Lulu,Lucian,346,148,198,42.77
Lulu,Alistar,182,69,113,37.91
Lulu,Nasus,354,176,178,49.72
Lulu,Kayn,670,330,340,49.25
Lulu,Neeko,270,112,158,41.48
Lulu,MissFortune,899,480,419,53.39
Lulu,Morgana,577,261,316,45.23
Lulu,Darius,957,443,514,46.29
Lulu,Sejuani,174,105,69,60.34
Lulu,Mel,1064,548,516,51.5
Lulu,Jhin,1000,486,514,48.6
Lulu,Rell,174,67,107,38.51
Lulu,Amumu,474,195,279,41.14
Lulu,Swain,512,217,295,42.38
Lulu,Urgot,229,127,102,55.46
Lulu,LeeSin,536,304,232,56.72
Lulu,Heimerdinger,283,185,98,65.37
Lulu,Warwick,761,358,403,47.04
Lulu,Ashe,937,466,471,49.73
Lulu,Pyke,542,286,256,52.77
Lulu,Camille,182,106,76,58.24
Lulu,MasterYi,517,308,209,59.57
Lulu,Irelia,373,188,185,50.4
Lulu,Pantheon,888,425,463,47.86
Lulu,DrMundo,230,102,128,44.35
Lulu,Trundle,246,94,152,38.21
Lulu,Nami,582,287,295,49.31
Lulu,Nocturne,462,215,247,46.54
Lulu,Aurora,514,238,276,46.3
Lulu,Jinx,881,425,456,48.24
Lulu,Ivern,105,64,41,60.95
Lulu,Sett,775,362,413,46.71
Lulu,Malphite,363,166,197,45.73
Lulu,Tristana,362,199,163,54.97
Lulu,Ziggs,182,55,127,30.22
Lulu,Lillia,320,163,157,50.94
Lulu,Lissandra,129,48,81,37.21
Lulu,FiddleSticks,244,119,125,48.77
Lulu,Ornn,152,67,85,44.08
Lulu,Hwei,440,206,234,46.82
Lulu,Caitlyn,1052,512,540,48.67
Lulu,Illaoi,203,108,95,53.2
Lulu,Malzahar,437,228,209,52.17
Lulu,Khazix,283,158,125,55.83
Lulu,Leona,342,160,182,46.78
Lulu,Poppy,320,154,166,48.13
Lulu,Annie,161,93,68,57.76
Lulu,Nautilus,561,302,259,53.83
Lulu,Yone,926,489,437,52.81
Lulu,Maokai,221,116,105,52.49
Lulu,Fiora,215,117,98,54.42
Lulu,Riven,209,130,79,62.2
Lulu,Akshan,227,104,123,45.81
Lulu,Xerath,305,179,126,58.69
Lulu,Chogath,649,309,340,47.61
Lulu,Zed,514,259,255,50.39
Lulu,Lux,1251,612,639,48.92
Lulu,Rengar,255,170,85,66.67
Lulu,Galio,390,212,178,54.36
Lulu,Samira,426,242,184,56.81
Lulu,Sona,168,68,100,40.48
Lulu,Shen,299,152,147,50.84
Lulu,TahmKench,541,235,306,43.44
Lulu,Kennen,160,79,81,49.38
Lulu,Syndra,257,136,121,52.92
Lulu,Akali,486,262,224,53.91
Lulu,Soraka,380,184,196,48.42
Lulu,Evelynn,268,142,126,52.99
Lulu,Briar,442,194,248,43.89
Lulu,Viktor,394,148,246,37.56
Lulu,Jax,433,195,238,45.03
Lulu,Corki,185,100,85,54.05
Lulu,Volibear,590,293,297,49.66
Lulu,Rammus,122,57,65,46.72
Lulu,Cassiopeia,195,114,81,58.46
Lulu,MonkeyKing,258,124,134,48.06
Lulu,Elise,347,207,140,59.65
Lulu,Quinn,158,86,72,54.43
Lulu,Talon,332,186,146,56.02
Lulu,Varus,399,191,208,47.87
Lulu,Aatrox,525,258,267,49.14
Lulu,Olaf,110,64,46,58.18
Lulu,Vex,188,99,89,52.66
Lulu,Thresh,656,281,375,42.84
Lulu,Kindred,244,129,115,52.87
Lulu,Vi,360,185,175,51.39
Lulu,Sion,454,213,241,46.92
Lulu,Garen,726,326,400,44.9
Lulu,Shyvana,133,83,50,62.41
Lulu,Sivir,199,93,106,46.73
Lulu,Qiyana,173,83,90,47.98
Lulu,Ambessa,333,204,129,61.26
Lulu,Zyra,278,89,189,32.01
Lulu,Graves,289,132,157,45.67
Lulu,Nidalee,152,73,79,48.03
Lulu,Senna,450,245,205,54.44
Lulu,Fizz,208,82,126,39.42
Lulu,Sylas,451,198,253,43.9
Lulu,Xayah,375,195,180,52
Lulu,Leblanc,200,118,82,59
Lulu,Gnar,209,91,118,43.54
Lulu,Zac,222,96,126,43.24
Lulu,Singed,127,71,56,55.91
Lulu,Braum,233,129,104,55.36
Lulu,Zoe,192,107,85,55.73
Lulu,Naafiri,219,112,107,51.14
Lulu,Skarner,187,99,88,52.94
Lulu,Draven,258,124,134,48.06
Lulu,Azir,167,73,94,43.71
Lulu,Kled,90,40,50,44.44
Lulu,Belveth,143,77,66,53.85
Lulu,Hecarim,198,119,79,60.1
Lulu,Nilah,207,119,88,57.49
Lulu,Kassadin,82,35,47,42.68
Lulu,Twitch,398,161,237,40.45
Lulu,Udyr,162,71,91,43.83
Lulu,Aphelios,347,116,231,33.43
Lulu,Blitzcrank,355,186,169,52.39
Lulu,Renata,159,98,61,61.64
Lulu,Veigar,495,244,251,49.29
Lulu,KogMaw,188,79,109,42.02
Lulu,Gangplank,237,110,127,46.41
Lulu,JarvanIV,285,124,161,43.51
Lulu,Orianna,213,112,101,52.58
Lulu,Zilean,171,89,82,52.05
Lulu,Karthus,104,58,46,55.77
Lulu,Brand,339,149,190,43.95
Lulu,Taliyah,169,88,81,52.07
Lulu,Kalista,192,114,78,59.38
Lulu,Kayle,320,119,201,37.19
Lulu,RekSai,102,56,46,54.9
Lulu,Janna,221,94,127,42.53
Lulu,AurelionSol,240,144,96,60
Lulu,KSante,254,144,110,56.69
Lulu,Jayce,281,140,141,49.82
Lulu,Renekton,170,83,87,48.82
Lulu,Anivia,120,58,62,48.33
Lulu,Rumble,124,63,61,50.81
Lulu,Taric,99,47,52,47.47
Vladimir,Jax,287,143,144,49.83
Vladimir,XinZhao,176,84,92,47.73
Vladimir,Kennen,147,63,84,42.86
Vladimir,Kalista,189,101,88,53.44
Vladimir,Lulu,296,128,168,43.24
Vladimir,Illaoi,146,70,76,47.95
Vladimir,Warwick,447,204,243,45.64
Vladimir,Diana,417,179,238,42.93
Vladimir,Tristana,281,169,112,60.14
Vladimir,Milio,120,65,55,54.17
Vladimir,Ornn,139,68,71,48.92
Vladimir,Poppy,310,155,155,50
Vladimir,Yone,707,378,329,53.47
Vladimir,MissFortune,741,379,362,51.15
Vladimir,Brand,296,169,127,57.09
Vladimir,Singed,65,33,32,50.77
Vladimir,Ryze,89,52,37,58.43
Vladimir,Samira,308,129,179,41.88
Vladimir,Soraka,142,49,93,34.51
Vladimir,Mordekaiser,444,253,191,56.98
Vladimir,Briar,396,169,227,42.68
Vladimir,Zed,325,190,135,58.46
Vladimir,Jinx,607,282,325,46.46
Vladimir,Darius,571,254,317,44.48
Vladimir,Garen,408,202,206,49.51
Vladimir,Lux,820,396,424,48.29
Vladimir,Sivir,160,56,104,35
Vladimir,Rakan,216,123,93,56.94
Vladimir,Gangplank,162,105,57,64.81
Vladimir,Lillia,226,85,141,37.61
Vladimir,Sejuani,117,76,41,64.96
Vladimir,Mel,739,444,295,60.08
Vladimir,Jhin,678,329,349,48.53
Vladimir,Rell,192,120,72,62.5
Vladimir,TwistedFate,100,64,36,64
Vladimir,LeeSin,329,183,146,55.62
Vladimir,Yasuo,849,435,414,51.24
Vladimir,Nilah,219,107,112,48.86
Vladimir,Ahri,471,249,222,52.87
Vladimir,Nunu,340,175,165,51.47
Vladimir,Zyra,239,129,110,53.97
Vladimir,Zoe,143,102,41,71.33
Vladimir,Ezreal,524,272,252,51.91
Vladimir,Janna,90,42,48,46.67
Vladimir,Chogath,442,254,188,57.47
Vladimir,Galio,206,107,99,51.94
Vladimir,Yorick,266,113,153,42.48
Vladimir,Kindred,208,103,105,49.52
Vladimir,Ashe,641,353,288,55.07
Vladimir,Ekko,212,117,95,55.19
Vladimir,Caitlyn,764,418,346,54.71
Vladimir,Kayle,302,178,124,58.94
Vladimir,Sona,119,53,66,44.54
Vladimir,Twitch,303,172,131,56.77
Vladimir,Teemo,471,219,252,46.5
Vladimir,Aatrox,311,136,175,43.73
Vladimir,MasterYi,339,173,166,51.03
Vladimir,Yuumi,316,125,191,39.56
Vladimir,Heimerdinger,205,91,114,44.39
Vladimir,Varus,231,140,91,60.61
Vladimir,Maokai,132,66,66,50
Vladimir,Veigar,341,138,203,40.47
Vladimir,Shyvana,71,33,38,46.48
Vladimir,Morgana,426,199,227,46.71
Vladimir,Riven,172,119,53,69.19
Vladimir,Shaco,305,159,146,52.13
Vladimir,Thresh,435,265,170,60.92
Vladimir,Kayn,526,288,238,54.75
Vladimir,Seraphine,282,159,123,56.38
Vladimir,DrMundo,215,92,123,42.79
Vladimir,Irelia,327,175,152,53.52
Vladimir,Swain,382,161,221,42.15
Vladimir,Nasus,230,84,146,36.52
Vladimir,Zac,129,55,74,42.64
Vladimir,Kaisa,503,272,231,54.08
Vladimir,Anivia,111,62,49,55.86
Vladimir,JarvanIV,111,61,50,54.95
Vladimir,Katarina,308,140,168,45.45
Vladimir,TahmKench,358,201,157,56.15
Vladimir,Akali,403,199,204,49.38
Vladimir,FiddleSticks,180,68,112,37.78
Vladimir,Rengar,144,94,50,65.28
Vladimir,Belveth,135,65,70,48.15
Vladimir,Pantheon,659,315,344,47.8
Vladimir,Amumu,350,160,190,45.71
Vladimir,Nami,279,152,127,54.48
Vladimir,Aurora,335,117,218,34.93
Vladimir,Aphelios,213,98,115,46.01
Vladimir,Draven,165,84,81,50.91
Vladimir,Shen,168,85,83,50.6
Vladimir,Pyke,388,199,189,51.29
Vladimir,Viktor,198,93,105,46.97
Vladimir,Senna,238,127,111,53.36
Vladimir,Tryndamere,171,79,92,46.2
Vladimir,Neeko,228,102,126,44.74
Vladimir,KSante,151,76,75,50.33
Vladimir,Taric,71,48,23,67.61
Vladimir,Talon,254,163,91,64.17
Vladimir,Sett,533,238,295,44.65
Vladimir,Leona,222,123,99,55.41
Vladimir,Viego,458,200,258,43.67
Vladimir,Orianna,187,96,91,51.34
Vladimir,Smolder,308,151,157,49.03
Vladimir,Syndra,162,75,87,46.3
Vladimir,Velkoz,186,58,128,31.18
Vladimir,Sylas,297,153,144,51.52
Vladimir,KogMaw,139,75,64,53.96
Vladimir,Nautilus,363,210,153,57.85
Vladimir,Evelynn,193,103,90,53.37
Vladimir,Alistar,111,40,71,36.04
Vladimir,Karthus,67,40,27,59.7
Vladimir,Khazix,157,99,58,63.06
Vladimir,Leblanc,147,75,72,51.02
Vladimir,Camille,147,92,55,62.59
Vladimir,Lucian,164,85,79,51.83
Vladimir,Nidalee,76,25,51,32.89
Vladimir,Vex,142,82,60,57.75
Vladimir,Hwei,285,163,122,57.19
Vladimir,Vi,195,146,49,74.87
Vladimir,Olaf,67,40,27,59.7
Vladimir,Sion,316,148,168,46.84
Vladimir,Akshan,157,89,68,56.69
Vladimir,Urgot,144,83,61,57.64
Vladimir,Qiyana,148,58,90,39.19
Vladimir,Rammus,83,42,41,50.6
Vladimir,Vayne,299,136,163,45.48
Vladimir,Gnar,133,93,40,69.92
Vladimir,Zeri,152,87,65,57.24
Vladimir,Blitzcrank,222,125,97,56.31
Vladimir,Azir,111,58,53,52.25
Vladimir,Fiora,182,80,102,43.96
Vladimir,AurelionSol,133,69,64,51.88
Vladimir,Corki,130,67,63,51.54
Vladimir,Bard,128,59,69,46.09
Vladimir,Volibear,295,151,144,51.19
Vladimir,Braum,144,65,79,45.14
Vladimir,Renekton,198,66,132,33.33
Vladimir,Naafiri,123,46,77,37.4
Vladimir,Trundle,172,65,107,37.79
Vladimir,Fizz,251,122,129,48.61
Vladimir,Ziggs,145,70,75,48.28
Vladimir,Rumble,50,32,18,64
Vladimir,Quinn,98,56,42,57.14
Vladimir,Gwen,205,120,85,58.54
Vladimir,Elise,197,90,107,45.69
Vladimir,Ivern,107,66,41,61.68
Vladimir,Nocturne,349,206,143,59.03
Vladimir,Kassadin,87,30,57,34.48
Vladimir,Xayah,240,118,122,49.17
Vladimir,Malzahar,223,109,114,48.88
Vladimir,Ambessa,184,80,104,43.48
Vladimir,Skarner,91,53,38,58.24
Vladimir,Graves,158,86,72,54.43
Vladimir,Taliyah,117,75,42,64.1
Vladimir,Karma,288,135,153,46.88
Vladimir,Gragas,210,118,92,56.19
Vladimir,MonkeyKing,138,81,57,58.7
Vladimir,Malphite,283,133,150,47
Vladimir,Udyr,110,49,61,44.55
Vladimir,Lissandra,69,33,36,47.83
Vladimir,RekSai,41,18,23,43.9
Vladimir,Hecarim,121,57,64,47.11
Vladimir,Annie,81,36,45,44.44
Vladimir,Cassiopeia,164,113,51,68.9
Vladimir,Jayce,164,79,85,48.17
Vladimir,Renata,110,37,73,33.64
Vladimir,Xerath,151,82,69,54.3
Vladimir,Zilean,83,54,29,65.06
Vladimir,Kled,41,21,20,51.22
Viego,Jax,567,290,277,51.15
Viego,XinZhao,440,226,214,51.36
Viego,Kennen,340,222,118,65.29
Viego,Kalista,317,194,123,61.2
Viego,Lulu,583,311,272,53.34
Viego,Sett,1299,565,734,43.49
Viego,Ivern,145,99,46,68.28
Viego,Veigar,975,469,506,48.1
Viego,Jinx,1594,757,837,47.49
Viego,Darius,1284,659,625,51.32
Viego,Warwick,1240,602,638,48.55
Viego,Yasuo,1455,742,713,51
Viego,Caitlyn,1754,933,821,53.19
Viego,Morgana,916,407,509,44.43
Viego,Volibear,850,388,462,45.65
Viego,Ekko,554,279,275,50.36
Viego,Yone,1364,658,706,48.24
Viego,Pyke,902,517,385,57.32
Viego,Illaoi,334,155,179,46.41
Viego,Aatrox,822,480,342,58.39
Viego,Ashe,1289,624,665,48.41
Viego,Aphelios,502,226,276,45.02
Viego,Gragas,411,208,203,50.61
Viego,FiddleSticks,326,150,176,46.01
Viego,Shaco,761,371,390,48.75
Viego,Syndra,378,196,182,51.85
Viego,Thresh,990,503,487,50.81
Viego,Fiora,406,196,210,48.28
Viego,Galio,570,256,314,44.91
Viego,Ezreal,1278,680,598,53.21
Viego,Chogath,877,451,426,51.43
Viego,Naafiri,318,186,132,58.49
Viego,Nunu,621,264,357,42.51
Viego,Malzahar,531,226,305,42.56
Viego,Zeri,262,160,102,61.07
Viego,Mordekaiser,1187,549,638,46.25
Viego,Khazix,552,294,258,53.26
Viego,Akali,741,401,340,54.12
Viego,Draven,447,239,208,53.47
Viego,Mel,1635,809,826,49.48
Viego,Malphite,657,330,327,50.23
Viego,MissFortune,1534,796,738,51.89
Viego,Soraka,542,296,246,54.61
Viego,Ambessa,521,287,234,55.09
Viego,Vex,417,190,227,45.56
Viego,Blitzcrank,583,240,343,41.17
Viego,Heimerdinger,269,90,179,33.46
Viego,Seraphine,788,449,339,56.98
Viego,Ziggs,353,191,162,54.11
Viego,Yorick,701,317,384,45.22
Viego,Kayn,1295,597,698,46.1
Viego,Nasus,556,269,287,48.38
Viego,Smolder,571,291,280,50.96
Viego,JarvanIV,262,107,155,40.84
Viego,Olaf,172,123,49,71.51
Viego,Evelynn,430,235,195,54.65
Viego,Leona,518,230,288,44.4
Viego,MasterYi,889,473,416,53.21
Viego,Ahri,1015,484,531,47.68
Viego,Sivir,350,184,166,52.57
Viego,Yuumi,631,324,307,51.35
Viego,Orianna,337,165,172,48.96
Viego,Nautilus,887,446,441,50.28
Viego,Gwen,422,209,213,49.53
Viego,Maokai,352,182,170,51.7
Viego,Brand,463,302,161,65.23
Viego,TahmKench,830,442,388,53.25
Viego,Leblanc,304,168,136,55.26
Viego,Samira,666,365,301,54.8
Viego,Shen,487,227,260,46.61
Viego,Graves,403,209,194,51.86
Viego,Taric,178,99,79,55.62
Viego,Rumble,155,93,62,60
Viego,Pantheon,1143,599,544,52.41
Viego,Urgot,347,162,185,46.69
Viego,Twitch,538,271,267,50.37
Viego,Kaisa,1141,560,581,49.08
Viego,Teemo,1145,589,556,51.44
Viego,Renekton,421,180,241,42.76
Viego,Sejuani,292,142,150,48.63
Viego,Taliyah,178,83,95,46.63
Viego,Diana,1068,569,499,53.28
Viego,MonkeyKing,448,225,223,50.22
Viego,Karma,489,207,282,42.33
Viego,Garen,1012,479,533,47.33
Viego,Jhin,1468,728,740,49.59
Viego,Trundle,391,200,191,51.15
Viego,Zed,717,374,343,52.16
Viego,Fizz,380,175,205,46.05
Viego,Quinn,252,140,112,55.56
Viego,Sion,641,300,341,46.8
Viego,Jayce,276,152,124,55.07
Viego,KogMaw,263,124,139,47.15
Viego,Viktor,503,247,256,49.11
Viego,Riven,373,214,159,57.37
Viego,Neeko,531,291,240,54.8
Viego,Elise,492,288,204,58.54
Viego,Lux,2025,1058,967,52.25
Viego,Ornn,300,157,143,52.33
Viego,Hwei,492,257,235,52.24
Viego,Gangplank,343,151,192,44.02
Viego,Rell,380,178,202,46.84
Viego,Kindred,359,207,152,57.66
Viego,Tristana,648,315,333,48.61
Viego,Hecarim,293,155,138,52.9
Viego,Milio,355,138,217,38.87
Viego,LeeSin,900,459,441,51
Viego,AurelionSol,345,208,137,60.29
Viego,Annie,223,100,123,44.84
Viego,Singed,220,101,119,45.91
Viego,Nilah,374,190,184,50.8
Viego,Janna,231,132,99,57.14
Viego,Nocturne,618,316,302,51.13
Viego,Vayne,717,349,368,48.68
Viego,Kayle,407,223,184,54.79
Viego,Amumu,771,296,475,38.39
Viego,KSante,245,143,102,58.37
Viego,Vladimir,458,258,200,56.33
Viego,Vi,652,364,288,55.83
Viego,Katarina,692,351,341,50.72
Viego,Varus,588,311,277,52.89
Viego,Velkoz,418,207,211,49.52
Viego,DrMundo,459,223,236,48.58
Viego,Rengar,326,196,130,60.12
Viego,Nami,706,346,360,49.01
Viego,Belveth,246,89,157,36.18
Viego,Sylas,733,399,334,54.43
Viego,Senna,644,315,329,48.91
Viego,Swain,768,401,367,52.21
Viego,Irelia,616,307,309,49.84
Viego,Anivia,266,139,127,52.26
Viego,Kled,147,81,66,55.1
Viego,Gnar,328,208,120,63.41
Viego,TwistedFate,201,106,95,52.74
Viego,Akshan,321,138,183,42.99
Viego,Sona,258,155,103,60.08
Viego,Corki,256,137,119,53.52
Viego,Skarner,194,135,59,69.59
Viego,Lillia,607,296,311,48.76
Viego,Aurora,656,319,337,48.63
Viego,Lissandra,189,102,87,53.97
Viego,Lucian,413,198,215,47.94
Viego,Udyr,306,133,173,43.46
Viego,Talon,496,300,196,60.48
Viego,Xerath,528,278,250,52.65
Viego,Camille,182,109,73,59.89
Viego,Briar,735,375,360,51.02
Viego,Poppy,369,223,146,60.43
Viego,Kassadin,170,90,80,52.94
Viego,Zyra,517,256,261,49.52
Viego,Xayah,421,231,190,54.87
Viego,Qiyana,301,148,153,49.17
Viego,Zilean,197,128,69,64.97
Viego,Azir,292,186,106,63.7
Viego,Renata,153,87,66,56.86
Viego,Zac,345,189,156,54.78
Viego,Braum,299,106,193,35.45
Viego,Cassiopeia,265,106,159,40
Viego,RekSai,154,101,53,65.58
Viego,Karthus,182,91,91,50
Viego,Nidalee,124,74,50,59.68
Viego,Zoe,362,207,155,57.18
Viego,Tryndamere,512,240,272,46.88
Viego,Rakan,403,239,164,59.31
Viego,Rammus,249,126,123,50.6
Viego,Alistar,296,139,157,46.96
Viego,Ryze,228,143,85,62.72
Viego,Shyvana,205,85,120,41.46
Viego,Bard,207,75,132,36.23
Velkoz,Jax,206,122,84,59.22
Velkoz,XinZhao,227,107,120,47.14
Velkoz,Kennen,140,96,44,68.57
Velkoz,Kalista,142,101,41,71.13
Velkoz,Lulu,321,176,145,54.83
Velkoz,Kayle,274,149,125,54.38
Velkoz,Sylas,296,204,92,68.92
Velkoz,Qiyana,144,76,68,52.78
Velkoz,Caitlyn,951,479,472,50.37
Velkoz,Renata,86,61,25,70.93
Velkoz,Heimerdinger,155,66,89,42.58
Velkoz,Warwick,533,260,273,48.78
Velkoz,Neeko,286,168,118,58.74
Velkoz,Draven,226,128,98,56.64
Velkoz,Leona,247,120,127,48.58
Velkoz,Gangplank,219,119,100,54.34
Velkoz,Hwei,292,174,118,59.59
Velkoz,Mel,887,499,388,56.26
Velkoz,Hecarim,202,106,96,52.48
Velkoz,Milio,187,105,82,56.15
Velkoz,Teemo,567,235,332,41.45
Velkoz,Briar,363,195,168,53.72
Velkoz,Aurora,373,190,183,50.94
Velkoz,Kaisa,503,283,220,56.26
Velkoz,Karma,245,100,145,40.82
Velkoz,LeeSin,426,214,212,50.23
Velkoz,Chogath,491,255,236,51.93
Velkoz,Lucian,216,119,97,55.09
Velkoz,Xerath,320,184,136,57.5
Velkoz,Riven,170,81,89,47.65
Velkoz,Tristana,344,162,182,47.09
Velkoz,Zac,193,90,103,46.63
Velkoz,Darius,658,353,305,53.65
Velkoz,Shaco,443,256,187,57.79
Velkoz,Veigar,451,272,179,60.31
Velkoz,Ashe,637,386,251,60.6
Velkoz,Azir,118,66,52,55.93
Velkoz,Yorick,302,164,138,54.3
Velkoz,MasterYi,370,212,158,57.3
Velkoz,Irelia,363,175,188,48.21
Velkoz,Shen,291,150,141,51.55
Velkoz,Nami,384,199,185,51.82
Velkoz,Aatrox,391,227,164,58.06
Velkoz,Ezreal,657,297,360,45.21
Velkoz,Elise,221,122,99,55.2
Velkoz,Fiora,217,99,118,45.62
Velkoz,Gragas,239,161,78,67.36
Velkoz,Seraphine,514,267,247,51.95
Velkoz,Ziggs,180,96,84,53.33
Velkoz,Vayne,443,215,228,48.53
Velkoz,Jinx,762,389,373,51.05
Velkoz,Yasuo,796,393,403,49.37
Velkoz,Sejuani,132,51,81,38.64
Velkoz,TahmKench,445,242,203,54.38
Velkoz,DrMundo,296,97,199,32.77
Velkoz,Lux,1083,574,509,53
Velkoz,Pantheon,681,399,282,58.59
Velkoz,KSante,122,78,44,63.93
Velkoz,MonkeyKing,147,76,71,51.7
Velkoz,Ekko,281,175,106,62.28
Velkoz,Senna,332,175,157,52.71
Velkoz,Gwen,228,113,115,49.56
Velkoz,JarvanIV,166,91,75,54.82
Velkoz,Yone,785,433,352,55.16
Velkoz,Volibear,401,203,198,50.62
Velkoz,Talon,227,145,82,63.88
Velkoz,AurelionSol,193,104,89,53.89
Velkoz,Jhin,704,331,373,47.02
Velkoz,Vi,351,214,137,60.97
Velkoz,Kassadin,85,46,39,54.12
Velkoz,Corki,141,83,58,58.87
Velkoz,Blitzcrank,269,165,104,61.34
Velkoz,Mordekaiser,572,314,258,54.9
Velkoz,Nidalee,119,63,56,52.94
Velkoz,Ahri,529,262,267,49.53
Velkoz,Sona,164,98,66,59.76
Velkoz,Garen,575,296,279,51.48
Velkoz,Zed,416,260,156,62.5
Velkoz,Aphelios,278,124,154,44.6
Velkoz,Thresh,522,334,188,63.98
Velkoz,Khazix,240,123,117,51.25
Velkoz,Taric,85,38,47,44.71
Velkoz,Swain,388,202,186,52.06
Velkoz,Camille,163,119,44,73.01
Velkoz,Viktor,258,137,121,53.1
Velkoz,Kayn,598,281,317,46.99
Velkoz,Tryndamere,254,135,119,53.15
Velkoz,FiddleSticks,177,87,90,49.15
Velkoz,Singed,160,96,64,60
Velkoz,Galio,246,133,113,54.07
Velkoz,Bard,112,76,36,67.86
Velkoz,Diana,478,282,196,59
Velkoz,Rakan,251,111,140,44.22
Velkoz,Malzahar,251,96,155,38.25
Velkoz,TwistedFate,129,77,52,59.69
Velkoz,Maokai,194,89,105,45.88
Velkoz,Gnar,178,118,60,66.29
Velkoz,Katarina,301,168,133,55.81
Velkoz,Samira,333,162,171,48.65
Velkoz,Poppy,217,83,134,38.25
Velkoz,Viego,418,211,207,50.48
Velkoz,Orianna,158,68,90,43.04
Velkoz,Vladimir,186,128,58,68.82
Velkoz,Rammus,107,62,45,57.94
Velkoz,Nautilus,433,248,185,57.27
Velkoz,Naafiri,233,126,107,54.08
Velkoz,Zeri,193,103,90,53.37
Velkoz,Brand,246,100,146,40.65
Velkoz,Smolder,266,137,129,51.5
Velkoz,Shyvana,92,28,64,30.43
Velkoz,Zilean,201,99,102,49.25
Velkoz,Kled,87,40,47,45.98
Velkoz,Nunu,248,129,119,52.02
Velkoz,Annie,78,47,31,60.26
Velkoz,MissFortune,748,420,328,56.15
Velkoz,Yuumi,359,183,176,50.97
Velkoz,Nasus,286,171,115,59.79
Velkoz,Udyr,128,80,48,62.5
Velkoz,Quinn,152,88,64,57.89
Velkoz,Kindred,190,124,66,65.26
Velkoz,Lissandra,116,68,48,58.62
Velkoz,Renekton,209,107,102,51.2
Velkoz,Soraka,242,132,110,54.55
Velkoz,Syndra,255,139,116,54.51
Velkoz,Zyra,244,93,151,38.11
Velkoz,Cassiopeia,207,124,83,59.9
Velkoz,Alistar,124,54,70,43.55
Velkoz,Rengar,188,112,76,59.57
Velkoz,Ryze,173,91,82,52.6
Velkoz,Malphite,305,160,145,52.46
Velkoz,Leblanc,169,98,71,57.99
Velkoz,Akali,409,211,198,51.59
Velkoz,Fizz,197,77,120,39.09
Velkoz,Vex,226,132,94,58.41
Velkoz,Morgana,480,256,224,53.33
Velkoz,Illaoi,146,89,57,60.96
Velkoz,Xayah,239,107,132,44.77
Velkoz,Braum,204,120,84,58.82
Velkoz,Sett,622,299,323,48.07
Velkoz,Akshan,132,71,61,53.79
Velkoz,Varus,344,185,159,53.78
Velkoz,Olaf,53,28,25,52.83
Velkoz,Nocturne,298,135,163,45.3
Velkoz,Twitch,356,169,187,47.47
Velkoz,Ambessa,273,153,120,56.04
Velkoz,Rell,177,97,80,54.8
Velkoz,Lillia,233,137,96,58.8
Velkoz,Graves,179,105,74,58.66
Velkoz,Ornn,157,79,78,50.32
Velkoz,Skarner,108,61,47,56.48
Velkoz,Amumu,354,135,219,38.14
Velkoz,Anivia,138,80,58,57.97
Velkoz,Trundle,209,97,112,46.41
Velkoz,KogMaw,152,66,86,43.42
Velkoz,RekSai,50,19,31,38
Velkoz,Sion,316,141,175,44.62
Velkoz,Evelynn,219,117,102,53.42
Velkoz,Nilah,237,161,76,67.93
Velkoz,Belveth,110,49,61,44.55
Velkoz,Janna,92,50,42,54.35
Velkoz,Pyke,400,186,214,46.5
Velkoz,Taliyah,93,51,42,54.84
Velkoz,Sivir,194,110,84,56.7
Velkoz,Ivern,114,58,56,50.88
Velkoz,Rumble,51,34,17,66.67
Velkoz,Zoe,175,116,59,66.29
Velkoz,Karthus,85,64,21,75.29
Velkoz,Urgot,135,35,100,25.93
Velkoz,Jayce,156,78,78,50
Kaisa,Jax,745,326,419,43.76
Kaisa,XinZhao,494,247,247,50
Kaisa,Kennen,274,140,134,51.09
Kaisa,Kalista,375,231,144,61.6
Kaisa,Lulu,642,337,305,52.49
Kaisa,Teemo,1050,398,652,37.9
Kaisa,Warwick,1308,601,707,45.95
Kaisa,Azir,323,167,156,51.7
Kaisa,MissFortune,1857,866,991,46.63
Kaisa,Neeko,501,230,271,45.91
Kaisa,Trundle,438,188,250,42.92
Kaisa,MasterYi,820,363,457,44.27
Kaisa,Veigar,968,453,515,46.8
Kaisa,Jhin,1644,815,829,49.57
Kaisa,Soraka,575,241,334,41.91
Kaisa,TahmKench,945,500,445,52.91
Kaisa,Jinx,1908,887,1021,46.49
Kaisa,Zoe,420,224,196,53.33
Kaisa,Nami,746,361,385,48.39
Kaisa,Gwen,626,306,320,48.88
Kaisa,JarvanIV,348,160,188,45.98
Kaisa,Yone,1878,908,970,48.35
Kaisa,Zyra,641,216,425,33.7
Kaisa,Seraphine,920,478,442,51.96
Kaisa,Irelia,863,395,468,45.77
Kaisa,Pantheon,1418,711,707,50.14
Kaisa,Kassadin,213,92,121,43.19
Kaisa,Yuumi,795,350,445,44.03
Kaisa,Diana,1114,534,580,47.94
Kaisa,Lux,2427,1083,1344,44.62
Kaisa,Tristana,786,365,421,46.44
Kaisa,Mel,1897,867,1030,45.7
Kaisa,FiddleSticks,480,212,268,44.17
Kaisa,Shaco,809,404,405,49.94
Kaisa,Syndra,449,230,219,51.22
Kaisa,Thresh,1217,563,654,46.26
Kaisa,Mordekaiser,1292,615,677,47.6
Kaisa,Karma,594,316,278,53.2
Kaisa,Naafiri,358,155,203,43.3
Kaisa,Nunu,703,337,366,47.94
Kaisa,Malzahar,653,300,353,45.94
Kaisa,Zeri,353,169,184,47.88
Kaisa,Smolder,686,335,351,48.83
Kaisa,Yasuo,1639,857,782,52.29
Kaisa,Caitlyn,2167,970,1197,44.76
Kaisa,Velkoz,503,220,283,43.74
Kaisa,Ornn,309,140,169,45.31
Kaisa,TwistedFate,362,190,172,52.49
Kaisa,Morgana,1020,456,564,44.71
Kaisa,Yorick,615,295,320,47.97
Kaisa,Samira,899,417,482,46.38
Kaisa,Zed,894,499,395,55.82
Kaisa,Viktor,644,301,343,46.74
Kaisa,Pyke,951,524,427,55.1
Kaisa,Olaf,222,118,104,53.15
Kaisa,Hecarim,366,159,207,43.44
Kaisa,Braum,442,201,241,45.48
Kaisa,Volibear,1006,404,602,40.16
Kaisa,Evelynn,434,209,225,48.16
Kaisa,Katarina,742,332,410,44.74
Kaisa,Nocturne,731,359,372,49.11
Kaisa,Vi,687,310,377,45.12
Kaisa,Amumu,893,345,548,38.63
Kaisa,Akshan,339,170,169,50.15
Kaisa,Ezreal,1776,889,887,50.06
Kaisa,Orianna,356,117,239,32.87
Kaisa,Malphite,663,308,355,46.46
Kaisa,Nautilus,1001,461,540,46.05
Kaisa,Akali,983,458,525,46.59
Kaisa,LeeSin,924,501,423,54.22
Kaisa,Camille,249,157,92,63.05
Kaisa,Xayah,652,290,362,44.48
Kaisa,Tryndamere,399,161,238,40.35
Kaisa,Sivir,451,230,221,51
Kaisa,Graves,516,270,246,52.33
Kaisa,Maokai,365,160,205,43.84
Kaisa,Gnar,314,135,179,42.99
Kaisa,Taric,201,56,145,27.86
Kaisa,Jayce,332,196,136,59.04
Kaisa,Skarner,278,136,142,48.92
Kaisa,Poppy,526,228,298,43.35
Kaisa,Chogath,1110,598,512,53.87
Kaisa,Talon,504,271,233,53.77
Kaisa,Nilah,569,252,317,44.29
Kaisa,Milio,427,193,234,45.2
Kaisa,Leona,681,335,346,49.19
Kaisa,Aurora,865,375,490,43.35
Kaisa,Kayn,1334,594,740,44.53
Kaisa,Ziggs,259,124,135,47.88
Kaisa,Senna,784,353,431,45.03
Kaisa,Sett,1354,658,696,48.6
Kaisa,Renata,226,92,134,40.71
Kaisa,Rammus,258,112,146,43.41
Kaisa,Renekton,407,208,199,51.11
Kaisa,Sion,665,318,347,47.82
Kaisa,Ashe,1483,710,773,47.88
Kaisa,Briar,922,416,506,45.12
Kaisa,Draven,549,263,286,47.91
Kaisa,Darius,1577,801,776,50.79
Kaisa,Viego,1141,581,560,50.92
Kaisa,Vayne,1018,384,634,37.72
Kaisa,Taliyah,267,105,162,39.33
Kaisa,Singed,278,127,151,45.68
Kaisa,Brand,542,264,278,48.71
Kaisa,Nasus,624,267,357,42.79
Kaisa,Zac,274,125,149,45.62
Kaisa,Swain,1052,445,607,42.3
Kaisa,Rengar,386,231,155,59.84
Kaisa,Hwei,562,269,293,47.86
Kaisa,KogMaw,275,139,136,50.55
Kaisa,Heimerdinger,434,172,262,39.63
Kaisa,Urgot,446,193,253,43.27
Kaisa,Xerath,418,188,230,44.98
Kaisa,Aatrox,829,423,406,51.03
Kaisa,Ryze,217,97,120,44.7
Kaisa,Janna,302,137,165,45.36
Kaisa,Vladimir,503,231,272,45.92
Kaisa,Aphelios,647,249,398,38.49
Kaisa,Alistar,280,154,126,55
Kaisa,Twitch,711,292,419,41.07
Kaisa,Blitzcrank,657,289,368,43.99
Kaisa,Shen,713,302,411,42.36
Kaisa,Lillia,599,302,297,50.42
Kaisa,Khazix,576,256,320,44.44
Kaisa,Anivia,321,184,137,57.32
Kaisa,DrMundo,635,275,360,43.31
Kaisa,Kayle,588,249,339,42.35
Kaisa,Udyr,328,140,188,42.68
Kaisa,Rell,488,246,242,50.41
Kaisa,Galio,634,270,364,42.59
Kaisa,Lucian,583,293,290,50.26
Kaisa,Ekko,568,280,288,49.3
Kaisa,Riven,404,177,227,43.81
Kaisa,Ahri,1172,572,600,48.81
Kaisa,Garen,1190,460,730,38.66
Kaisa,Nidalee,222,96,126,43.24
Kaisa,Lissandra,243,129,114,53.09
Kaisa,Sylas,764,371,393,48.56
Kaisa,Bard,218,67,151,30.73
Kaisa,Kindred,528,309,219,58.52
Kaisa,Ambessa,511,280,231,54.79
Kaisa,Varus,738,350,388,47.43
Kaisa,Illaoi,429,197,232,45.92
Kaisa,Annie,273,125,148,45.79
Kaisa,Fiora,393,233,160,59.29
Kaisa,KSante,313,159,154,50.8
Kaisa,Karthus,288,124,164,43.06
Kaisa,Belveth,270,139,131,51.48
Kaisa,Leblanc,292,133,159,45.55
Kaisa,Gangplank,385,197,188,51.17
Kaisa,Elise,531,297,234,55.93
Kaisa,Corki,309,152,157,49.19
Kaisa,Cassiopeia,335,180,155,53.73
Kaisa,Rakan,515,208,307,40.39
Kaisa,Vex,451,200,251,44.35
Kaisa,Ivern,190,92,98,48.42
Kaisa,Fizz,464,209,255,45.04
Kaisa,Gragas,532,279,253,52.44
Kaisa,Sejuani,359,122,237,33.98
Kaisa,Kled,157,58,99,36.94
Kaisa,Sona,334,155,179,46.41
Kaisa,AurelionSol,453,195,258,43.05
Kaisa,Shyvana,185,61,124,32.97
Kaisa,Qiyana,213,110,103,51.64
Kaisa,Rumble,165,59,106,35.76
Kaisa,Zilean,224,82,142,36.61
Kaisa,MonkeyKing,441,155,286,35.15
Kaisa,RekSai,131,56,75,42.75
Kaisa,Quinn,339,215,124,63.42
Karma,Jax,357,211,146,59.1
Karma,XinZhao,298,176,122,59.06
Karma,Kennen,155,92,63,59.35
Karma,Kalista,219,98,121,44.75
Karma,Lulu,421,212,209,50.36
Karma,Maokai,164,56,108,34.15
Karma,Graves,204,115,89,56.37
Karma,Ahri,567,261,306,46.03
Karma,Nilah,268,125,143,46.64
Karma,Malphite,367,180,187,49.05
Karma,Nasus,345,163,182,47.25
Karma,Shaco,359,174,185,48.47
Karma,Zed,388,217,171,55.93
Karma,Varus,296,143,153,48.31
Karma,Neeko,275,124,151,45.09
Karma,Volibear,490,228,262,46.53
Karma,Ekko,311,165,146,53.05
Karma,Akshan,172,115,57,66.86
Karma,Yasuo,798,396,402,49.62
Karma,Katarina,413,234,179,56.66
Karma,Chogath,524,262,262,50
Karma,Leblanc,213,114,99,53.52
Karma,Caitlyn,1080,533,547,49.35
Karma,Milio,311,116,195,37.3
Karma,Sylas,366,204,162,55.74
Karma,Amumu,375,171,204,45.6
Karma,Vex,210,114,96,54.29
Karma,Kaisa,594,278,316,46.8
Karma,Rakan,241,119,122,49.38
Karma,Gangplank,276,154,122,55.8
Karma,Lillia,259,130,129,50.19
Karma,MissFortune,890,419,471,47.08
Karma,Soraka,282,145,137,51.42
Karma,Smolder,340,211,129,62.06
Karma,Warwick,611,278,333,45.5
Karma,Velkoz,245,145,100,59.18
Karma,Mordekaiser,585,283,302,48.38
Karma,Mel,1020,553,467,54.22
Karma,Ashe,804,400,404,49.75
Karma,Jayce,155,80,75,51.61
Karma,Gragas,267,140,127,52.43
Karma,Darius,794,359,435,45.21
Karma,MasterYi,425,184,241,43.29
Karma,Taric,54,23,31,42.59
Karma,Garen,654,323,331,49.39
Karma,Talon,291,131,160,45.02
Karma,Tristana,365,165,200,45.21
Karma,Aurora,430,201,229,46.74
Karma,Nocturne,339,168,171,49.56
Karma,Pantheon,672,329,343,48.96
Karma,Sett,668,336,332,50.3
Karma,Samira,392,192,200,48.98
Karma,Illaoi,156,88,68,56.41
Karma,Evelynn,196,101,95,51.53
Karma,Hwei,280,158,122,56.43
Karma,Senna,360,188,172,52.22
Karma,Gwen,224,106,118,47.32
Karma,Elise,302,166,136,54.97
Karma,Aatrox,427,196,231,45.9
Karma,Twitch,362,151,211,41.71
Karma,Ryze,168,80,88,47.62
Karma,Jhin,775,418,357,53.94
Karma,Nautilus,376,183,193,48.67
Karma,Poppy,256,136,120,53.13
Karma,Nami,443,220,223,49.66
Karma,Irelia,323,173,150,53.56
Karma,Orianna,211,113,98,53.55
Karma,Ezreal,806,448,358,55.58
Karma,Bard,169,112,57,66.27
Karma,Sion,392,168,224,42.86
Karma,Yorick,415,210,205,50.6
Karma,Xerath,376,172,204,45.74
Karma,Akali,428,203,225,47.43
Karma,Kayn,696,311,385,44.68
Karma,Ziggs,188,91,97,48.4
Karma,Naafiri,157,88,69,56.05
Karma,Lux,1289,580,709,45
Karma,Belveth,140,45,95,32.14
Karma,Viego,489,282,207,57.67
Karma,Yuumi,489,179,310,36.61
Karma,Qiyana,142,69,73,48.59
Karma,Singed,142,69,73,48.59
Karma,Riven,217,114,103,52.53
Karma,LeeSin,517,302,215,58.41
Karma,Olaf,72,48,24,66.67
Karma,Draven,223,126,97,56.5
Karma,Thresh,533,281,252,52.72
Karma,Swain,514,266,248,51.75
Karma,Shen,370,209,161,56.49
Karma,Veigar,396,222,174,56.06
Karma,Blitzcrank,241,123,118,51.04
Karma,Ambessa,205,108,97,52.68
Karma,Jinx,795,343,452,43.14
Karma,Brand,231,138,93,59.74
Karma,Fizz,201,107,94,53.23
Karma,Yone,693,353,340,50.94
Karma,Karthus,90,67,23,74.44
Karma,Diana,511,209,302,40.9
Karma,Skarner,141,71,70,50.35
Karma,Malzahar,329,164,165,49.85
Karma,Vi,406,198,208,48.77
Karma,Gnar,138,103,35,74.64
Karma,FiddleSticks,221,87,134,39.37
Karma,Leona,324,140,184,43.21
Karma,Nunu,369,199,170,53.93
Karma,Zoe,221,151,70,68.33
Karma,TahmKench,414,243,171,58.7
Karma,Renekton,203,93,110,45.81
Karma,Rammus,104,45,59,43.27
Karma,Hecarim,158,87,71,55.06
Karma,Briar,371,179,192,48.25
Karma,KogMaw,152,84,68,55.26
Karma,Seraphine,417,203,214,48.68
Karma,Rell,242,128,114,52.89
Karma,Kayle,331,158,173,47.73
Karma,Vayne,419,185,234,44.15
Karma,Lissandra,79,47,32,59.49
Karma,Morgana,598,322,276,53.85
Karma,Camille,163,94,69,57.67
Karma,Lucian,241,141,100,58.51
Karma,Tryndamere,225,126,99,56
Karma,Sona,186,70,116,37.63
Karma,Sivir,203,79,124,38.92
Karma,Trundle,217,69,148,31.8
Karma,Khazix,303,159,144,52.48
Karma,Galio,280,144,136,51.43
Karma,Braum,251,124,127,49.4
Karma,Alistar,114,63,51,55.26
Karma,Zyra,321,157,164,48.91
Karma,Fiora,233,132,101,56.65
Karma,Cassiopeia,147,91,56,61.9
Karma,Anivia,170,84,86,49.41
Karma,Sejuani,191,78,113,40.84
Karma,Kindred,204,110,94,53.92
Karma,Viktor,373,208,165,55.76
Karma,DrMundo,233,106,127,45.49
Karma,Quinn,121,52,69,42.98
Karma,Xayah,233,134,99,57.51
Karma,Syndra,255,119,136,46.67
Karma,Zac,179,92,87,51.4
Karma,Ornn,173,57,116,32.95
Karma,Shyvana,86,48,38,55.81
Karma,Rengar,244,121,123,49.59
Karma,Ivern,102,59,43,57.84
Karma,Corki,136,65,71,47.79
Karma,RekSai,36,12,24,33.33
Karma,Vladimir,288,153,135,53.13
Karma,KSante,160,114,46,71.25
Karma,Udyr,176,110,66,62.5
Karma,Janna,132,50,82,37.88
Karma,Teemo,583,250,333,42.88
Karma,Kassadin,96,35,61,36.46
Karma,Zeri,184,92,92,50
Karma,Pyke,473,265,208,56.03
Karma,Azir,102,50,52,49.02
Karma,Urgot,226,110,116,48.67
Karma,TwistedFate,182,123,59,67.58
Karma,Aphelios,342,183,159,53.51
Karma,Heimerdinger,219,98,121,44.75
Karma,Annie,109,46,63,42.2
Karma,MonkeyKing,241,120,121,49.79
Karma,JarvanIV,153,69,84,45.1
Karma,Taliyah,123,56,67,45.53
Karma,Renata,109,55,54,50.46
Karma,Zilean,121,49,72,40.5
Karma,Nidalee,116,70,46,60.34
Karma,AurelionSol,132,41,91,31.06
Karma,Rumble,82,37,45,45.12
Karma,Kled,79,48,31,60.76
Aatrox,Kennen,238,117,121,49.16
Aatrox,Warwick,924,407,517,44.05
Aatrox,Yasuo,1328,608,720,45.78
Aatrox,Kindred,353,179,174,50.71
Aatrox,Lux,1651,782,869,47.37
Aatrox,Yorick,565,212,353,37.52
Aatrox,Kayn,969,454,515,46.85
Aatrox,Ryze,176,124,52,70.45
Aatrox,Pantheon,986,381,605,38.64
Aatrox,Naafiri,310,116,194,37.42
Aatrox,Briar,659,319,340,48.41
Aatrox,Yone,1320,658,662,49.85
Aatrox,MissFortune,1297,555,742,42.79
Aatrox,Senna,489,245,244,50.1
Aatrox,Kayle,531,248,283,46.7
Aatrox,Viego,822,342,480,41.61
Aatrox,Irelia,617,281,336,45.54
Aatrox,Jinx,1282,602,680,46.96
Aatrox,Thresh,832,442,390,53.13
Aatrox,Darius,1329,643,686,48.38
Aatrox,Rengar,311,214,97,68.81
Aatrox,Syndra,279,119,160,42.65
Aatrox,Caitlyn,1426,666,760,46.7
Aatrox,XinZhao,328,138,190,42.07
Aatrox,Katarina,530,259,271,48.87
Aatrox,Teemo,1066,441,625,41.37
Aatrox,Vayne,561,222,339,39.57
Aatrox,TwistedFate,232,117,115,50.43
Aatrox,Shen,361,148,213,41
Aatrox,Diana,836,422,414,50.48
Aatrox,Samira,588,294,294,50
Aatrox,Soraka,402,206,196,51.24
Aatrox,Garen,947,471,476,49.74
Aatrox,FiddleSticks,321,158,163,49.22
Aatrox,Brand,378,176,202,46.56
Aatrox,Tryndamere,311,169,142,54.34
Aatrox,Graves,342,163,179,47.66
Aatrox,Sylas,522,245,277,46.93
Aatrox,Leona,486,233,253,47.94
Aatrox,Mordekaiser,999,408,591,40.84
Aatrox,Janna,208,79,129,37.98
Aatrox,Volibear,640,276,364,43.13
Aatrox,Khazix,401,176,225,43.89
Aatrox,Akali,698,369,329,52.87
Aatrox,Draven,288,84,204,29.17
Aatrox,Mel,1353,690,663,51
Aatrox,Smolder,506,246,260,48.62
Aatrox,Rell,336,189,147,56.25
Aatrox,Sett,1068,506,562,47.38
Aatrox,Tristana,544,223,321,40.99
Aatrox,Blitzcrank,490,239,251,48.78
Aatrox,Poppy,373,186,187,49.87
Aatrox,Nunu,529,241,288,45.56
Aatrox,Zed,541,289,252,53.42
Aatrox,Rakan,389,174,215,44.73
Aatrox,Fiora,328,159,169,48.48
Aatrox,Ekko,480,230,250,47.92
Aatrox,Kassadin,134,86,48,64.18
Aatrox,TahmKench,693,357,336,51.52
Aatrox,Camille,212,124,88,58.49
Aatrox,Xayah,386,206,180,53.37
Aatrox,Yuumi,597,274,323,45.9
Aatrox,Veigar,677,337,340,49.78
Aatrox,KSante,276,179,97,64.86
Aatrox,Jax,453,206,247,45.47
Aatrox,Velkoz,391,164,227,41.94
Aatrox,Gangplank,287,132,155,45.99
Aatrox,Malzahar,430,167,263,38.84
Aatrox,Heimerdinger,282,120,162,42.55
Aatrox,Ashe,1040,502,538,48.27
Aatrox,Pyke,651,402,249,61.75
Aatrox,Nasus,424,186,238,43.87
Aatrox,Azir,182,99,83,54.4
Aatrox,Nami,628,275,353,43.79
Aatrox,Shaco,601,304,297,50.58
Aatrox,Annie,222,112,110,50.45
Aatrox,Olaf,79,32,47,40.51
Aatrox,Aurora,577,289,288,50.09
Aatrox,Vladimir,311,175,136,56.27
Aatrox,Gnar,280,168,112,60
Aatrox,Twitch,485,239,246,49.28
Aatrox,Xerath,366,151,215,41.26
Aatrox,Morgana,775,298,477,38.45
Aatrox,Zoe,288,146,142,50.69
Aatrox,Karma,427,231,196,54.1
Aatrox,Ornn,277,143,134,51.62
Aatrox,Kalista,259,145,114,55.98
Aatrox,Chogath,739,358,381,48.44
Aatrox,Hecarim,215,106,109,49.3
Aatrox,Malphite,595,291,304,48.91
Aatrox,Maokai,272,113,159,41.54
Aatrox,Sona,187,82,105,43.85
Aatrox,Ivern,108,76,32,70.37
Aatrox,Belveth,160,87,73,54.38
Aatrox,Jhin,1022,507,515,49.61
Aatrox,LeeSin,617,337,280,54.62
Aatrox,Lillia,392,198,194,50.51
Aatrox,Jayce,256,136,120,53.13
Aatrox,DrMundo,446,191,255,42.83
Aatrox,Seraphine,681,300,381,44.05
Aatrox,Galio,371,175,196,47.17
Aatrox,Nilah,382,182,200,47.64
Aatrox,Urgot,363,172,191,47.38
Aatrox,MasterYi,614,271,343,44.14
Aatrox,Sejuani,234,126,108,53.85
Aatrox,Amumu,422,171,251,40.52
Aatrox,Ahri,757,369,388,48.75
Aatrox,Nautilus,703,305,398,43.39
Aatrox,Qiyana,194,71,123,36.6
Aatrox,Rumble,144,81,63,56.25
Aatrox,Ambessa,358,121,237,33.8
Aatrox,Elise,322,170,152,52.8
Aatrox,Kaisa,829,406,423,48.97
Aatrox,Vi,515,273,242,53.01
Aatrox,Vex,399,198,201,49.62
Aatrox,Milio,392,154,238,39.29
Aatrox,Zeri,287,143,144,49.83
Aatrox,Singed,198,65,133,32.83
Aatrox,Orianna,227,86,141,37.89
Aatrox,Zilean,215,106,109,49.3
Aatrox,Lucian,395,201,194,50.89
Aatrox,Cassiopeia,224,127,97,56.7
Aatrox,Aphelios,366,175,191,47.81
Aatrox,MonkeyKing,285,127,158,44.56
Aatrox,Trundle,267,114,153,42.7
Aatrox,Illaoi,323,138,185,42.72
Aatrox,Gragas,454,187,267,41.19
Aatrox,Braum,241,109,132,45.23
Aatrox,Nidalee,214,108,106,50.47
Aatrox,Lulu,525,267,258,50.86
Aatrox,Karthus,152,64,88,42.11
Aatrox,Neeko,464,214,250,46.12
Aatrox,Ziggs,248,101,147,40.73
Aatrox,JarvanIV,263,141,122,53.61
Aatrox,Evelynn,339,169,170,49.85
Aatrox,Leblanc,232,113,119,48.71
Aatrox,Ezreal,1099,516,583,46.95
Aatrox,Gwen,302,166,136,54.97
Aatrox,Skarner,183,114,69,62.3
Aatrox,Varus,496,237,259,47.78
Aatrox,Corki,170,85,85,50
Aatrox,Rammus,181,105,76,58.01
Aatrox,Fizz,356,174,182,48.88
Aatrox,Swain,680,353,327,51.91
Aatrox,Kled,126,55,71,43.65
Aatrox,Sivir,293,142,151,48.46
Aatrox,Udyr,262,134,128,51.15
Aatrox,Riven,279,132,147,47.31
Aatrox,Renekton,295,103,192,34.92
Aatrox,Hwei,464,213,251,45.91
Aatrox,KogMaw,210,59,151,28.1
Aatrox,RekSai,102,58,44,56.86
Aatrox,Anivia,213,111,102,52.11
Aatrox,Alistar,183,81,102,44.26
Aatrox,Sion,561,287,274,51.16
Aatrox,Talon,363,202,161,55.65
Aatrox,Akshan,176,73,103,41.48
Aatrox,Lissandra,113,50,63,44.25
Aatrox,Renata,161,57,104,35.4
Aatrox,Nocturne,504,210,294,41.67
Aatrox,Viktor,412,168,244,40.78
Aatrox,AurelionSol,282,100,182,35.46
Aatrox,Quinn,189,106,83,56.08
Aatrox,Zyra,386,175,211,45.34
Aatrox,Taliyah,141,65,76,46.1
Aatrox,Shyvana,103,17,86,16.5
Aatrox,Zac,254,146,108,57.48
Aatrox,Bard,228,127,101,55.7
Aatrox,Taric,109,83,26,76.15
Sylas,Kennen,224,130,94,58.04
Sylas,Warwick,962,447,515,46.47
Sylas,Yasuo,1360,617,743,45.37
Sylas,Kindred,331,187,144,56.5
Sylas,Lux,1529,804,725,52.58
Sylas,Maokai,266,128,138,48.12
Sylas,Graves,423,166,257,39.24
Sylas,Ahri,904,409,495,45.24
Sylas,Nilah,327,195,132,59.63
Sylas,Malphite,610,354,256,58.03
Sylas,Mordekaiser,948,468,480,49.37
Sylas,Qiyana,221,125,96,56.56
Sylas,Ashe,1039,519,520,49.95
Sylas,Sona,226,122,104,53.98
Sylas,Illaoi,309,132,177,42.72
Sylas,Twitch,416,213,203,51.2
Sylas,Yone,1221,708,513,57.99
Sylas,Velkoz,296,92,204,31.08
Sylas,Swain,788,406,382,51.52
Sylas,Malzahar,394,176,218,44.67
Sylas,Irelia,513,286,227,55.75
Sylas,Kalista,302,192,110,63.58
Sylas,Poppy,286,132,154,46.15
Sylas,Kayle,483,245,238,50.72
Sylas,MonkeyKing,291,127,164,43.64
Sylas,RekSai,79,45,34,56.96
Sylas,Seraphine,690,390,300,56.52
Sylas,Briar,564,242,322,42.91
Sylas,Evelynn,290,182,108,62.76
Sylas,Tristana,545,266,279,48.81
Sylas,Thresh,669,322,347,48.13
Sylas,Ryze,192,82,110,42.71
Sylas,Morgana,722,330,392,45.71
Sylas,Xayah,377,171,206,45.36
Sylas,Veigar,811,418,393,51.54
Sylas,FiddleSticks,413,215,198,52.06
Sylas,Akali,627,349,278,55.66
Sylas,Senna,427,243,184,56.91
Sylas,Kayn,982,505,477,51.43
Sylas,TwistedFate,230,105,125,45.65
Sylas,Smolder,483,248,235,51.35
Sylas,Nautilus,653,310,343,47.47
Sylas,Diana,713,367,346,51.47
Sylas,MissFortune,1299,613,686,47.19
Sylas,Karma,366,162,204,44.26
Sylas,Pantheon,1023,463,560,45.26
Sylas,Garen,947,408,539,43.08
Sylas,Ziggs,252,147,105,58.33
Sylas,Zeri,316,145,171,45.89
Sylas,Zyra,378,194,184,51.32
Sylas,Nocturne,495,237,258,47.88
Sylas,Lissandra,149,90,59,60.4
Sylas,Jhin,991,514,477,51.87
Sylas,Mel,1313,738,575,56.21
Sylas,Singed,152,81,71,53.29
Sylas,Pyke,822,478,344,58.15
Sylas,Aatrox,522,277,245,53.07
Sylas,Ezreal,1317,625,692,47.46
Sylas,Milio,341,187,154,54.84
Sylas,Yorick,458,230,228,50.22
Sylas,Gragas,344,190,154,55.23
Sylas,Volibear,632,345,287,54.59
Sylas,Khazix,374,228,146,60.96
Sylas,Draven,316,150,166,47.47
Sylas,Gnar,285,182,103,63.86
Sylas,Jax,493,222,271,45.03
Sylas,Aurora,571,293,278,51.31
Sylas,Bard,225,113,112,50.22
Sylas,Riven,279,133,146,47.67
Sylas,Syndra,236,111,125,47.03
Sylas,Jinx,1151,570,581,49.52
Sylas,Zed,594,337,257,56.73
Sylas,Talon,413,257,156,62.23
Sylas,Rammus,158,87,71,55.06
Sylas,Akshan,194,87,107,44.85
Sylas,Chogath,949,498,451,52.48
Sylas,Lillia,373,164,209,43.97
Sylas,Vex,387,152,235,39.28
Sylas,Janna,176,67,109,38.07
Sylas,Sett,1004,474,530,47.21
Sylas,Cassiopeia,222,115,107,51.8
Sylas,Fiora,257,152,105,59.14
Sylas,LeeSin,582,333,249,57.22
Sylas,Zilean,191,97,94,50.79
Sylas,Rengar,208,117,91,56.25
Sylas,Anivia,198,93,105,46.97
Sylas,Galio,562,278,284,49.47
Sylas,Naafiri,312,157,155,50.32
Sylas,Vi,476,264,212,55.46
Sylas,Aphelios,465,237,228,50.97
Sylas,Heimerdinger,364,139,225,38.19
Sylas,Varus,426,225,201,52.82
Sylas,Gwen,339,179,160,52.8
Sylas,JarvanIV,280,151,129,53.93
Sylas,Leblanc,184,95,89,51.63
Sylas,Samira,546,276,270,50.55
Sylas,Shen,350,139,211,39.71
Sylas,Darius,1125,537,588,47.73
Sylas,Shaco,510,279,231,54.71
Sylas,Zoe,254,152,102,59.84
Sylas,Ivern,130,44,86,33.85
Sylas,Quinn,201,143,58,71.14
Sylas,TahmKench,651,300,351,46.08
Sylas,XinZhao,382,204,178,53.4
Sylas,AurelionSol,231,108,123,46.75
Sylas,Rakan,309,145,164,46.93
Sylas,Shyvana,104,56,48,53.85
Sylas,Viktor,414,227,187,54.83
Sylas,Lucian,361,178,183,49.31
Sylas,Soraka,372,203,169,54.57
Sylas,Neeko,423,219,204,51.77
Sylas,Xerath,402,200,202,49.75
Sylas,Renekton,288,175,113,60.76
Sylas,Sivir,323,142,181,43.96
Sylas,Sejuani,263,155,108,58.94
Sylas,Blitzcrank,474,237,237,50
Sylas,Ornn,296,134,162,45.27
Sylas,Vayne,595,277,318,46.55
Sylas,Nasus,506,240,266,47.43
Sylas,Amumu,604,274,330,45.36
Sylas,Caitlyn,1220,628,592,51.48
Sylas,KogMaw,212,97,115,45.75
Sylas,Ekko,464,231,233,49.78
Sylas,Yuumi,523,258,265,49.33
Sylas,Katarina,502,259,243,51.59
Sylas,Lulu,451,253,198,56.1
Sylas,Gangplank,286,115,171,40.21
Sylas,Skarner,216,113,103,52.31
Sylas,Vladimir,297,144,153,48.48
Sylas,Rell,289,167,122,57.79
Sylas,Viego,733,334,399,45.57
Sylas,KSante,269,94,175,34.94
Sylas,Teemo,858,377,481,43.94
Sylas,Braum,308,141,167,45.78
Sylas,Kaisa,764,393,371,51.44
Sylas,DrMundo,392,207,185,52.81
Sylas,Annie,117,53,64,45.3
Sylas,Urgot,312,140,172,44.87
Sylas,Kassadin,123,63,60,51.22
Sylas,Taliyah,161,98,63,60.87
Sylas,Kled,117,49,68,41.88
Sylas,Nami,581,283,298,48.71
Sylas,Udyr,201,94,107,46.77
Sylas,Camille,173,90,83,52.02
Sylas,Nidalee,152,64,88,42.11
Sylas,MasterYi,606,242,364,39.93
Sylas,Corki,147,84,63,57.14
Sylas,Orianna,313,158,155,50.48
Sylas,Elise,349,189,160,54.15
Sylas,Zac,163,74,89,45.4
Sylas,Alistar,233,127,106,54.51
Sylas,Tryndamere,320,139,181,43.44
Sylas,Leona,527,269,258,51.04
Sylas,Ambessa,285,119,166,41.75
Sylas,Nunu,552,279,273,50.54
Sylas,Azir,197,100,97,50.76
Sylas,Rumble,132,67,65,50.76
Sylas,Sion,461,236,225,51.19
Sylas,Hwei,406,184,222,45.32
Sylas,Belveth,163,91,72,55.83
Sylas,Brand,432,253,179,58.56
Sylas,Fizz,359,155,204,43.18
Sylas,Jayce,223,108,115,48.43
Sylas,Hecarim,193,130,63,67.36
Sylas,Trundle,332,158,174,47.59
Sylas,Olaf,116,47,69,40.52
Sylas,Karthus,149,90,59,60.4
Sylas,Taric,132,70,62,53.03
Sylas,Renata,128,46,82,35.94
Diana,Kennen,282,156,126,55.32
Diana,Warwick,1360,539,821,39.63
Diana,Yasuo,1500,771,729,51.4
Diana,Kindred,446,271,175,60.76
Diana,Lux,2270,1150,1120,50.66
Diana,Vladimir,417,238,179,57.07
Diana,Darius,1457,752,705,51.61
Diana,KogMaw,277,156,121,56.32
Diana,Yuumi,790,470,320,59.49
Diana,Sett,1351,667,684,49.37
Diana,Ivern,157,76,81,48.41
Diana,Veigar,1021,536,485,52.5
Diana,Jinx,1564,749,815,47.89
Diana,Lulu,539,272,267,50.46
Diana,Garen,1166,536,630,45.97
Diana,Briar,830,441,389,53.13
Diana,Zed,879,448,431,50.97
Diana,Caitlyn,2080,1030,1050,49.52
Diana,Morgana,1282,640,642,49.92
Diana,Mordekaiser,1277,611,666,47.85
Diana,Ryze,207,116,91,56.04
Diana,Vex,528,295,233,55.87
Diana,Gwen,581,330,251,56.8
Diana,Skarner,276,134,142,48.55
Diana,Yone,1485,734,751,49.43
Diana,Kaisa,1114,580,534,52.06
Diana,Seraphine,860,443,417,51.51
Diana,Ambessa,440,211,229,47.95
Diana,Xayah,564,314,250,55.67
Diana,AurelionSol,372,161,211,43.28
Diana,Khazix,525,274,251,52.19
Diana,Nautilus,820,414,406,50.49
Diana,Vi,755,447,308,59.21
Diana,Azir,258,109,149,42.25
Diana,MissFortune,1874,984,890,52.51
Diana,Chogath,1105,500,605,45.25
Diana,Graves,455,218,237,47.91
Diana,Leblanc,345,187,158,54.2
Diana,Milio,403,159,244,39.45
Diana,Annie,245,113,132,46.12
Diana,Kayn,1590,850,740,53.46
Diana,Aatrox,836,414,422,49.52
Diana,Pyke,958,495,463,51.67
Diana,Sylas,713,346,367,48.53
Diana,Amumu,899,410,489,45.61
Diana,Rakan,373,168,205,45.04
Diana,Gangplank,344,166,178,48.26
Diana,Lillia,539,289,250,53.62
Diana,Soraka,448,234,214,52.23
Diana,Nasus,624,283,341,45.35
Diana,Neeko,595,329,266,55.29
Diana,Swain,770,316,454,41.04
Diana,Shen,575,272,303,47.3
Diana,Rammus,171,86,85,50.29
Diana,Cassiopeia,352,202,150,57.39
Diana,Sivir,416,179,237,43.03
Diana,Xerath,624,293,331,46.96
Diana,Jax,624,332,292,53.21
Diana,Evelynn,529,254,275,48.02
Diana,Mel,1825,904,921,49.53
Diana,Kalista,410,225,185,54.88
Diana,Renata,223,127,96,56.95
Diana,Fiora,423,240,183,56.74
Diana,Shaco,766,377,389,49.22
Diana,Fizz,457,234,223,51.2
Diana,Tristana,791,362,429,45.76
Diana,Renekton,370,183,187,49.46
Diana,Karthus,263,122,141,46.39
Diana,Ashe,1414,763,651,53.96
Diana,Maokai,344,182,162,52.91
Diana,Aurora,911,516,395,56.64
Diana,Nilah,426,199,227,46.71
Diana,Hwei,617,300,317,48.62
Diana,Volibear,1001,485,516,48.45
Diana,XinZhao,423,201,222,47.52
Diana,Irelia,727,355,372,48.83
Diana,Nami,868,459,409,52.88
Diana,Samira,820,367,453,44.76
Diana,Malphite,587,288,299,49.06
Diana,Sion,625,319,306,51.04
Diana,Ahri,1255,646,609,51.47
Diana,Draven,467,283,184,60.6
Diana,Akali,942,491,451,52.12
Diana,Ezreal,1292,686,606,53.1
Diana,Senna,643,323,320,50.23
Diana,Yorick,695,297,398,42.73
Diana,Malzahar,665,292,373,43.91
Diana,Aphelios,645,311,334,48.22
Diana,Braum,367,195,172,53.13
Diana,Trundle,396,198,198,50
Diana,Blitzcrank,586,297,289,50.68
Diana,Poppy,546,235,311,43.04
Diana,Twitch,707,332,375,46.96
Diana,Viego,1068,499,569,46.72
Diana,Katarina,720,375,345,52.08
Diana,Jayce,360,233,127,64.72
Diana,Jhin,1309,590,719,45.07
Diana,Thresh,1140,558,582,48.95
Diana,Illaoi,428,160,268,37.38
Diana,MasterYi,984,493,491,50.1
Diana,Vayne,788,391,397,49.62
Diana,Sona,321,145,176,45.17
Diana,Kayle,644,319,325,49.53
Diana,JarvanIV,342,172,170,50.29
Diana,LeeSin,729,336,393,46.09
Diana,Naafiri,395,225,170,56.96
Diana,KSante,293,134,159,45.73
Diana,Nunu,688,404,284,58.72
Diana,Teemo,1209,559,650,46.24
Diana,Kassadin,222,99,123,44.59
Diana,Ziggs,428,184,244,42.99
Diana,RekSai,108,55,53,50.93
Diana,Talon,580,304,276,52.41
Diana,Rell,390,151,239,38.72
Diana,Leona,648,307,341,47.38
Diana,Elise,464,281,183,60.56
Diana,Rengar,361,223,138,61.77
Diana,Galio,578,262,316,45.33
Diana,Lucian,462,230,232,49.78
Diana,Hecarim,209,127,82,60.77
Diana,Ekko,719,391,328,54.38
Diana,Zac,319,142,177,44.51
Diana,Riven,389,216,173,55.53
Diana,Gragas,465,274,191,58.92
Diana,Olaf,134,78,56,58.21
Diana,Kled,172,79,93,45.93
Diana,Karma,511,302,209,59.1
Diana,Velkoz,478,196,282,41
Diana,Brand,540,238,302,44.07
Diana,Bard,174,104,70,59.77
Diana,Heimerdinger,525,237,288,45.14
Diana,TahmKench,892,493,399,55.27
Diana,Qiyana,273,149,124,54.58
Diana,Nocturne,821,350,471,42.63
Diana,Varus,641,306,335,47.74
Diana,Lissandra,206,102,104,49.51
Diana,Camille,254,122,132,48.03
Diana,Pantheon,1312,662,650,50.46
Diana,DrMundo,593,254,339,42.83
Diana,Nidalee,197,90,107,45.69
Diana,Smolder,704,301,403,42.76
Diana,Zoe,402,233,169,57.96
Diana,Udyr,297,166,131,55.89
Diana,Tryndamere,510,264,246,51.76
Diana,Alistar,290,182,108,62.76
Diana,Sejuani,246,126,120,51.22
Diana,Zyra,589,233,356,39.56
Diana,FiddleSticks,405,213,192,52.59
Diana,Ornn,356,204,152,57.3
Diana,MonkeyKing,429,184,245,42.89
Diana,Quinn,228,131,97,57.46
Diana,Zilean,217,120,97,55.3
Diana,Taric,192,84,108,43.75
Diana,Akshan,273,137,136,50.18
Diana,Gnar,310,195,115,62.9
Diana,Singed,191,122,69,63.87
Diana,Janna,263,162,101,61.6
Diana,Taliyah,223,139,84,62.33
Diana,Corki,226,134,92,59.29
Diana,Viktor,549,288,261,52.46
Diana,Orianna,375,224,151,59.73
Diana,TwistedFate,309,161,148,52.1
Diana,Shyvana,243,93,150,38.27
Diana,Urgot,369,169,200,45.8
Diana,Anivia,235,140,95,59.57
Diana,Syndra,550,232,318,42.18
Diana,Zeri,344,202,142,58.72
Diana,Belveth,221,123,98,55.66
Diana,Rumble,157,88,69,56.05
Varus,Kennen,168,62,106,36.9
Varus,Warwick,788,338,450,42.89
Varus,Yasuo,887,399,488,44.98
Varus,Kindred,226,135,91,59.73
Varus,Lux,1283,646,637,50.35
Varus,Fiora,207,139,68,67.15
Varus,MasterYi,520,274,246,52.69
Varus,Mel,1122,635,487,56.6
Varus,Jhin,849,369,480,43.46
Varus,Karma,296,153,143,51.69
Varus,Fizz,264,142,122,53.79
Varus,Gnar,243,134,109,55.14
Varus,Caitlyn,1381,742,639,53.73
Varus,Neeko,443,223,220,50.34
Varus,Gangplank,266,150,116,56.39
Varus,Chogath,641,301,340,46.96
Varus,Galio,323,163,160,50.46
Varus,MissFortune,1006,522,484,51.89
Varus,Soraka,345,187,158,54.2
Varus,Kled,83,53,30,63.86
Varus,Kayn,680,326,354,47.94
Varus,AurelionSol,205,112,93,54.63
Varus,Tristana,425,183,242,43.06
Varus,Pyke,573,376,197,65.62
Varus,Nasus,331,137,194,41.39
Varus,FiddleSticks,221,115,106,52.04
Varus,Azir,184,81,103,44.02
Varus,Xayah,232,114,118,49.14
Varus,Nami,544,271,273,49.82
Varus,Olaf,104,58,46,55.77
Varus,Volibear,578,274,304,47.4
Varus,Aurora,423,209,214,49.41
Varus,Ashe,888,466,422,52.48
Varus,Smolder,379,210,169,55.41
Varus,Rengar,244,138,106,56.56
Varus,Hwei,375,238,137,63.47
Varus,Thresh,607,314,293,51.73
Varus,Pantheon,832,371,461,44.59
Varus,Xerath,329,106,223,32.22
Varus,Morgana,574,285,289,49.65
Varus,Braum,156,76,80,48.72
Varus,Skarner,162,76,86,46.91
Varus,Syndra,293,126,167,43
Varus,Hecarim,199,111,88,55.78
Varus,Talon,302,186,116,61.59
Varus,Samira,483,233,250,48.24
Varus,Blitzcrank,394,183,211,46.45
Varus,Garen,748,361,387,48.26
Varus,Nocturne,316,171,145,54.11
Varus,Vladimir,231,91,140,39.39
Varus,Sylas,426,201,225,47.18
Varus,Ekko,348,162,186,46.55
Varus,Malphite,330,150,180,45.45
Varus,Poppy,315,141,174,44.76
Varus,Ornn,217,127,90,58.53
Varus,Ambessa,382,184,198,48.17
Varus,Zoe,243,153,90,62.96
Varus,Swain,508,221,287,43.5
Varus,Mordekaiser,769,381,388,49.54
Varus,Amumu,573,267,306,46.6
Varus,Yone,907,470,437,51.82
Varus,Zyra,368,183,185,49.73
Varus,Ezreal,1001,575,426,57.44
Varus,Seraphine,483,235,248,48.65
Varus,MonkeyKing,266,158,108,59.4
Varus,Rakan,283,120,163,42.4
Varus,Sett,883,435,448,49.26
Varus,Lucian,291,145,146,49.83
Varus,Veigar,489,203,286,41.51
Varus,Zilean,164,99,65,60.37
Varus,Irelia,352,202,150,57.39
Varus,Darius,952,485,467,50.95
Varus,Shaco,518,277,241,53.47
Varus,Ahri,704,385,319,54.69
Varus,Graves,239,114,125,47.7
Varus,Taliyah,131,61,70,46.56
Varus,Yuumi,531,273,258,51.41
Varus,Camille,186,98,88,52.69
Varus,Briar,426,206,220,48.36
Varus,Viktor,301,153,148,50.83
Varus,Jinx,1026,488,538,47.56
Varus,Senna,414,200,214,48.31
Varus,Jayce,208,99,109,47.6
Varus,Malzahar,415,209,206,50.36
Varus,Lulu,399,208,191,52.13
Varus,Annie,182,82,100,45.05
Varus,Tryndamere,241,133,108,55.19
Varus,Zac,196,117,79,59.69
Varus,Alistar,160,62,98,38.75
Varus,Leona,349,177,172,50.72
Varus,Viego,588,277,311,47.11
Varus,Orianna,263,93,170,35.36
Varus,Twitch,435,221,214,50.8
Varus,LeeSin,475,259,216,54.53
Varus,Illaoi,200,93,107,46.5
Varus,XinZhao,271,119,152,43.91
Varus,Teemo,743,348,395,46.84
Varus,Akali,505,299,206,59.21
Varus,Vayne,522,263,259,50.38
Varus,Nautilus,485,234,251,48.25
Varus,Aatrox,496,259,237,52.22
Varus,Rumble,104,63,41,60.58
Varus,TahmKench,493,258,235,52.33
Varus,Kaisa,738,388,350,52.57
Varus,Ziggs,215,84,131,39.07
Varus,Jax,432,219,213,50.69
Varus,Diana,641,335,306,52.26
Varus,Heimerdinger,222,99,123,44.59
Varus,Milio,260,146,114,56.15
Varus,Urgot,248,141,107,56.85
Varus,Shen,353,181,172,51.27
Varus,KogMaw,193,88,105,45.6
Varus,Lillia,335,157,178,46.87
Varus,Khazix,311,170,141,54.66
Varus,Sion,397,187,210,47.1
Varus,Sejuani,217,100,117,46.08
Varus,KSante,226,100,126,44.25
Varus,Gwen,311,155,156,49.84
Varus,Gragas,318,151,167,47.48
Varus,Sona,189,107,82,56.61
Varus,Ivern,116,39,77,33.62
Varus,Kassadin,121,63,58,52.07
Varus,Evelynn,234,94,140,40.17
Varus,Draven,238,138,100,57.98
Varus,Zed,472,285,187,60.38
Varus,Singed,178,95,83,53.37
Varus,Renata,100,41,59,41
Varus,Trundle,222,107,115,48.2
Varus,Shyvana,131,47,84,35.88
Varus,Taric,119,55,64,46.22
Varus,Corki,143,74,69,51.75
Varus,Anivia,153,73,80,47.71
Varus,Sivir,314,180,134,57.32
Varus,Vi,455,210,245,46.15
Varus,Rammus,147,80,67,54.42
Varus,Janna,132,60,72,45.45
Varus,Karthus,154,53,101,34.42
Varus,DrMundo,333,171,162,51.35
Varus,Nunu,455,216,239,47.47
Varus,Leblanc,250,140,110,56
Varus,Katarina,441,283,158,64.17
Varus,Akshan,131,80,51,61.07
Varus,Brand,322,132,190,40.99
Varus,Quinn,190,103,87,54.21
Varus,Qiyana,188,111,77,59.04
Varus,Nilah,251,102,149,40.64
Varus,Vex,248,102,146,41.13
Varus,TwistedFate,190,99,91,52.11
Varus,JarvanIV,236,138,98,58.47
Varus,Riven,143,55,88,38.46
Varus,Velkoz,344,159,185,46.22
Varus,Rell,216,91,125,42.13
Varus,Cassiopeia,179,96,83,53.63
Varus,Nidalee,180,107,73,59.44
Varus,Aphelios,356,181,175,50.84
Varus,Elise,290,148,142,51.03
Varus,Ryze,177,89,88,50.28
Varus,Zeri,276,146,130,52.9
Varus,Udyr,175,98,77,56
Varus,Belveth,137,55,82,40.15
Varus,Yorick,556,274,282,49.28
Varus,Kalista,269,143,126,53.16
Varus,Lissandra,104,53,51,50.96
Varus,Maokai,263,140,123,53.23
Varus,Kayle,356,152,204,42.7
Varus,Naafiri,200,130,70,65
Varus,Renekton,246,132,114,53.66
Varus,Bard,118,59,59,50
Varus,RekSai,66,43,23,65.15
Kindred,Aatrox,353,174,179,49.29
Kindred,Sylas,331,144,187,43.5
Kindred,Diana,446,175,271,39.24
Kindred,Varus,226,91,135,40.27
Kindred,Blitzcrank,240,132,108,55
Kindred,Fiora,192,120,72,62.5
Kindred,Belveth,90,57,33,63.33
Kindred,Ezreal,608,325,283,53.45
Kindred,Yuumi,346,132,214,38.15
Kindred,Volibear,355,131,224,36.9
Kindred,Ekko,320,161,159,50.31
Kindred,Yone,659,309,350,46.89
Kindred,Kalista,168,73,95,43.45
Kindred,Pyke,482,233,249,48.34
Kindred,Warwick,534,228,306,42.7
Kindred,Singed,69,21,48,30.43
Kindred,Ryze,83,40,43,48.19
Kindred,Samira,321,116,205,36.14
Kindred,Soraka,219,85,134,38.81
Kindred,Mordekaiser,519,221,298,42.58
Kindred,Briar,417,168,249,40.29
Kindred,Zed,294,164,130,55.78
Kindred,Jinx,695,329,366,47.34
Kindred,Lillia,258,139,119,53.88
Kindred,Yasuo,678,314,364,46.31
Kindred,FiddleSticks,206,125,81,60.68
Kindred,Mel,717,332,385,46.3
Kindred,Amumu,331,115,216,34.74
Kindred,Thresh,365,170,195,46.58
Kindred,Gnar,164,81,83,49.39
Kindred,Malzahar,324,119,205,36.73
Kindred,Tristana,300,169,131,56.33
Kindred,Brand,228,114,114,50
Kindred,Quinn,97,53,44,54.64
Kindred,Talon,225,111,114,49.33
Kindred,Syndra,141,63,78,44.68
Kindred,Caitlyn,768,332,436,43.23
Kindred,Sett,661,269,392,40.7
Kindred,MasterYi,319,159,160,49.84
Kindred,AurelionSol,134,71,63,52.99
Kindred,Seraphine,366,168,198,45.9
Kindred,Nasus,309,93,216,30.1
Kindred,Nocturne,328,136,192,41.46
Kindred,Aurora,352,136,216,38.64
Kindred,Nunu,214,113,101,52.8
Kindred,TwistedFate,132,37,95,28.03
Kindred,Teemo,515,196,319,38.06
Kindred,Malphite,288,140,148,48.61
Kindred,Vladimir,208,105,103,50.48
Kindred,Ziggs,167,70,97,41.92
Kindred,Urgot,180,111,69,61.67
Kindred,Xerath,230,110,120,47.83
Kindred,Pantheon,611,254,357,41.57
Kindred,TahmKench,377,179,198,47.48
Kindred,Qiyana,117,65,52,55.56
Kindred,Ashe,568,225,343,39.61
Kindred,Garen,489,194,295,39.67
Kindred,Maokai,170,82,88,48.24
Kindred,Sion,231,71,160,30.74
Kindred,Akali,395,193,202,48.86
Kindred,Lux,916,433,483,47.27
Kindred,Riven,119,52,67,43.7
Kindred,Shaco,387,192,195,49.61
Kindred,Jhin,621,281,340,45.25
Kindred,Senna,327,131,196,40.06
Kindred,Milio,148,76,72,51.35
Kindred,Naafiri,171,84,87,49.12
Kindred,Orianna,170,70,100,41.18
Kindred,Zilean,120,42,78,35
Kindred,Vex,231,105,126,45.45
Kindred,Illaoi,150,83,67,55.33
Kindred,MonkeyKing,165,78,87,47.27
Kindred,Twitch,218,86,132,39.45
Kindred,Nautilus,270,146,124,54.07
Kindred,Galio,230,124,106,53.91
Kindred,Sona,171,81,90,47.37
Kindred,Hecarim,111,40,71,36.04
Kindred,Zyra,270,78,192,28.89
Kindred,Trundle,187,76,111,40.64
Kindred,Katarina,254,140,114,55.12
Kindred,Rengar,136,88,48,64.71
Kindred,Ivern,59,31,28,52.54
Kindred,Viego,359,152,207,42.34
Kindred,Ahri,459,221,238,48.15
Kindred,Camille,129,54,75,41.86
Kindred,Viktor,261,120,141,45.98
Kindred,Kayn,525,242,283,46.1
Kindred,Zac,127,53,74,41.73
Kindred,Rell,150,71,79,47.33
Kindred,Rammus,113,61,52,53.98
Kindred,Draven,230,83,147,36.09
Kindred,Lulu,244,115,129,47.13
Kindred,Leona,223,93,130,41.7
Kindred,Nilah,233,123,110,52.79
Kindred,Bard,144,80,64,55.56
Kindred,Taric,58,19,39,32.76
Kindred,Hwei,247,84,163,34.01
Kindred,Rakan,144,63,81,43.75
Kindred,Veigar,446,186,260,41.7
Kindred,Skarner,83,29,54,34.94
Kindred,Kennen,117,59,58,50.43
Kindred,LeeSin,359,179,180,49.86
Kindred,Cassiopeia,95,29,66,30.53
Kindred,Alistar,87,34,53,39.08
Kindred,Kaisa,528,219,309,41.48
Kindred,Zeri,157,80,77,50.96
Kindred,Jayce,173,96,77,55.49
Kindred,Irelia,288,144,144,50
Kindred,Vayne,351,193,158,54.99
Kindred,Aphelios,298,168,130,56.38
Kindred,Sejuani,106,17,89,16.04
Kindred,MissFortune,682,319,363,46.77
Kindred,Braum,113,41,72,36.28
Kindred,Darius,669,255,414,38.12
Kindred,Velkoz,190,66,124,34.74
Kindred,Udyr,127,68,59,53.54
Kindred,Nami,361,183,178,50.69
Kindred,JarvanIV,102,28,74,27.45
Kindred,Poppy,209,88,121,42.11
Kindred,Azir,134,58,76,43.28
Kindred,Lucian,174,94,80,54.02
Kindred,Elise,193,116,77,60.1
Kindred,Olaf,116,44,72,37.93
Kindred,Xayah,168,62,106,36.9
Kindred,Karma,204,94,110,46.08
Kindred,Gragas,201,128,73,63.68
Kindred,Renekton,127,71,56,55.91
Kindred,Tryndamere,194,71,123,36.6
Kindred,Swain,345,148,197,42.9
Kindred,Annie,96,41,55,42.71
Kindred,Morgana,435,226,209,51.95
Kindred,Akshan,90,59,31,65.56
Kindred,XinZhao,177,67,110,37.85
Kindred,Kassadin,60,29,31,48.33
Kindred,KogMaw,74,17,57,22.97
Kindred,Janna,99,30,69,30.3
Kindred,Chogath,354,151,203,42.66
Kindred,Jax,261,107,154,41
Kindred,Evelynn,161,68,93,42.24
Kindred,Zoe,128,74,54,57.81
Kindred,Vi,282,127,155,45.04
Kindred,Leblanc,131,49,82,37.4
Kindred,Gangplank,106,73,33,68.87
Kindred,DrMundo,170,97,73,57.06
Kindred,Kayle,258,81,177,31.4
Kindred,Kled,94,33,61,35.11
Kindred,Yorick,287,145,142,50.52
Kindred,Neeko,241,103,138,42.74
Kindred,Anivia,131,85,46,64.89
Kindred,Heimerdinger,163,68,95,41.72
Kindred,Shyvana,75,22,53,29.33
Kindred,Smolder,246,101,145,41.06
Kindred,Ambessa,162,74,88,45.68
Kindred,KSante,132,72,60,54.55
Kindred,RekSai,32,12,20,37.5
Kindred,Ornn,152,65,87,42.76
Kindred,Karthus,92,39,53,42.39
Kindred,Corki,119,69,50,57.98
Kindred,Gwen,237,107,130,45.15
Kindred,Khazix,219,104,115,47.49
Kindred,Fizz,142,72,70,50.7
Kindred,Taliyah,91,31,60,34.07
Kindred,Nidalee,113,55,58,48.67
Kindred,Shen,221,94,127,42.53
Kindred,Graves,170,100,70,58.82
Kindred,Sivir,203,110,93,54.19
Kindred,Lissandra,64,42,22,65.63
Kindred,Rumble,64,29,35,45.31
Kindred,Renata,99,71,28,71.72
Illaoi,Vladimir,146,76,70,52.05
Illaoi,Darius,645,411,234,63.72
Illaoi,Lux,796,385,411,48.37
Illaoi,KogMaw,64,34,30,53.13
Illaoi,Yuumi,301,173,128,57.48
Illaoi,Kayle,270,132,138,48.89
Illaoi,Sylas,309,177,132,57.28
Illaoi,Qiyana,128,59,69,46.09
Illaoi,Caitlyn,765,457,308,59.74
Illaoi,Renata,87,59,28,67.82
Illaoi,Mordekaiser,566,269,297,47.53
Illaoi,Warwick,531,213,318,40.11
Illaoi,Mel,582,337,245,57.9
Illaoi,Nautilus,276,172,104,62.32
Illaoi,Viego,334,179,155,53.59
Illaoi,Irelia,274,182,92,66.42
Illaoi,Jinx,700,339,361,48.43
Illaoi,Thresh,388,200,188,51.55
Illaoi,Volibear,363,189,174,52.07
Illaoi,Evelynn,138,86,52,62.32
Illaoi,Katarina,216,126,90,58.33
Illaoi,Nocturne,317,139,178,43.85
Illaoi,Neeko,248,118,130,47.58
Illaoi,Gwen,253,152,101,60.08
Illaoi,Karthus,48,16,32,33.33
Illaoi,Yone,697,425,272,60.98
Illaoi,Nilah,166,61,105,36.75
Illaoi,Braum,163,92,71,56.44
Illaoi,Shaco,332,142,190,42.77
Illaoi,Veigar,353,175,178,49.58
Illaoi,Ashe,565,282,283,49.91
Illaoi,Azir,99,65,34,65.66
Illaoi,Samira,368,200,168,54.35
Illaoi,Kayn,541,350,191,64.7
Illaoi,Lucian,183,85,98,46.45
Illaoi,Sett,589,305,284,51.78
Illaoi,RekSai,41,22,19,53.66
Illaoi,Hwei,179,86,93,48.04
Illaoi,Ekko,236,118,118,50
Illaoi,Yasuo,635,344,291,54.17
Illaoi,Ahri,406,241,165,59.36
Illaoi,Karma,156,68,88,43.59
Illaoi,Skarner,115,74,41,64.35
Illaoi,Syndra,115,67,48,58.26
Illaoi,Jhin,473,256,217,54.12
Illaoi,Sion,230,117,113,50.87
Illaoi,Pantheon,499,286,213,57.31
Illaoi,Ziggs,147,90,57,61.22
Illaoi,Lulu,203,95,108,46.8
Illaoi,Viktor,233,116,117,49.79
Illaoi,Briar,312,139,173,44.55
Illaoi,Teemo,385,169,216,43.9
Illaoi,Blitzcrank,298,186,112,62.42
Illaoi,Diana,428,268,160,62.62
Illaoi,Poppy,165,80,85,48.48
Illaoi,Heimerdinger,232,88,144,37.93
Illaoi,Kalista,126,68,58,53.97
Illaoi,Swain,305,177,128,58.03
Illaoi,AurelionSol,143,95,48,66.43
Illaoi,Xayah,212,110,102,51.89
Illaoi,Rakan,177,89,88,50.28
Illaoi,Jax,240,142,98,59.17
Illaoi,MissFortune,675,406,269,60.15
Illaoi,Morgana,434,196,238,45.16
Illaoi,Kindred,150,67,83,44.67
Illaoi,Ryze,92,41,51,44.57
Illaoi,Orianna,138,70,68,50.72
Illaoi,Shen,217,112,105,51.61
Illaoi,Aatrox,323,185,138,57.28
Illaoi,Khazix,183,92,91,50.27
Illaoi,Vex,192,73,119,38.02
Illaoi,Vayne,370,189,181,51.08
Illaoi,Malzahar,215,90,125,41.86
Illaoi,Camille,101,58,43,57.43
Illaoi,Rammus,84,35,49,41.67
Illaoi,Alistar,122,74,48,60.66
Illaoi,TwistedFate,125,63,62,50.4
Illaoi,Fiora,139,65,74,46.76
Illaoi,LeeSin,282,147,135,52.13
Illaoi,Kassadin,51,16,35,31.37
Illaoi,Milio,158,98,60,62.03
Illaoi,Malphite,252,132,120,52.38
Illaoi,Sona,141,63,78,44.68
Illaoi,Rengar,115,75,40,65.22
Illaoi,TahmKench,385,239,146,62.08
Illaoi,Garen,445,200,245,44.94
Illaoi,Lillia,181,105,76,58.01
Illaoi,Smolder,216,108,108,50
Illaoi,Tristana,267,126,141,47.19
Illaoi,Zyra,189,94,95,49.74
Illaoi,Gangplank,127,72,55,56.69
Illaoi,Varus,200,107,93,53.5
Illaoi,Pyke,310,168,142,54.19
Illaoi,Chogath,433,210,223,48.5
Illaoi,Hecarim,110,72,38,65.45
Illaoi,MonkeyKing,136,67,69,49.26
Illaoi,Ezreal,466,274,192,58.8
Illaoi,Brand,223,128,95,57.4
Illaoi,Nunu,306,158,148,51.63
Illaoi,Aurora,254,131,123,51.57
Illaoi,Leona,214,113,101,52.8
Illaoi,Xerath,233,111,122,47.64
Illaoi,Ornn,74,34,40,45.95
Illaoi,Twitch,220,108,112,49.09
Illaoi,Amumu,324,127,197,39.2
Illaoi,Kaisa,429,232,197,54.08
Illaoi,Jayce,111,37,74,33.33
Illaoi,Zeri,100,48,52,48
Illaoi,FiddleSticks,203,86,117,42.36
Illaoi,Aphelios,176,111,65,63.07
Illaoi,Draven,142,70,72,49.3
Illaoi,Ambessa,171,107,64,62.57
Illaoi,Talon,112,70,42,62.5
Illaoi,Nidalee,102,70,32,68.63
Illaoi,Zed,271,165,106,60.89
Illaoi,Yorick,323,155,168,47.99
Illaoi,Gnar,121,54,67,44.63
Illaoi,Vi,293,137,156,46.76
Illaoi,Zoe,126,62,64,49.21
Illaoi,Sejuani,87,38,49,43.68
Illaoi,Leblanc,83,26,57,31.33
Illaoi,Seraphine,301,141,160,46.84
Illaoi,Riven,139,101,38,72.66
Illaoi,Trundle,188,99,89,52.66
Illaoi,Cassiopeia,73,47,26,64.38
Illaoi,XinZhao,152,66,86,43.42
Illaoi,Taric,75,29,46,38.67
Illaoi,Ivern,71,42,29,59.15
Illaoi,Velkoz,146,57,89,39.04
Illaoi,Lissandra,75,42,33,56
Illaoi,Galio,197,124,73,62.94
Illaoi,Corki,107,43,64,40.19
Illaoi,Singed,70,42,28,60
Illaoi,Soraka,241,126,115,52.28
Illaoi,Annie,95,53,42,55.79
Illaoi,MasterYi,291,207,84,71.13
Illaoi,Renekton,177,109,68,61.58
Illaoi,KSante,60,37,23,61.67
Illaoi,Fizz,170,105,65,61.76
Illaoi,Nami,266,134,132,50.38
Illaoi,Kennen,63,38,25,60.32
Illaoi,Udyr,95,44,51,46.32
Illaoi,Zilean,93,44,49,47.31
Illaoi,Taliyah,98,58,40,59.18
Illaoi,Akshan,133,54,79,40.6
Illaoi,Rell,151,95,56,62.91
Illaoi,Naafiri,166,68,98,40.96
Illaoi,Nasus,275,121,154,44
Illaoi,Elise,199,125,74,62.81
Illaoi,Akali,353,207,146,58.64
Illaoi,Gragas,209,135,74,64.59
Illaoi,Sivir,165,86,79,52.12
Illaoi,Anivia,63,23,40,36.51
Illaoi,Rumble,66,40,26,60.61
Illaoi,Senna,250,145,105,58
Illaoi,DrMundo,248,98,150,39.52
Illaoi,Quinn,94,47,47,50
Illaoi,Graves,95,52,43,54.74
Illaoi,Bard,100,60,40,60
Illaoi,Maokai,117,68,49,58.12
Illaoi,Belveth,108,61,47,56.48
Illaoi,Zac,95,35,60,36.84
Illaoi,Tryndamere,183,75,108,40.98
Illaoi,Urgot,119,47,72,39.5
Illaoi,Olaf,67,34,33,50.75
Illaoi,Kled,36,20,16,55.56
Illaoi,JarvanIV,94,54,40,57.45
Illaoi,Shyvana,85,61,24,71.76
Illaoi,Janna,82,36,46,43.9
Milio,Vladimir,120,55,65,45.83
Milio,Darius,657,318,339,48.4
Milio,Lux,994,596,398,59.96
Milio,KogMaw,128,62,66,48.44
Milio,Yuumi,342,161,181,47.08
Milio,Yorick,322,153,169,47.52
Milio,Kayn,454,263,191,57.93
Milio,Ryze,54,19,35,35.19
Milio,Pantheon,528,267,261,50.57
Milio,Teemo,429,226,203,52.68
Milio,Warwick,551,291,260,52.81
Milio,Azir,115,50,65,43.48
Milio,MissFortune,645,330,315,51.16
Milio,Neeko,229,105,124,45.85
Milio,Akali,377,172,205,45.62
Milio,Kassadin,72,30,42,41.67
Milio,Sona,143,86,57,60.14
Milio,Braum,139,83,56,59.71
Milio,XinZhao,157,66,91,42.04
Milio,Chogath,381,217,164,56.96
Milio,Taliyah,95,20,75,21.05
Milio,Mordekaiser,466,227,239,48.71
Milio,Briar,299,144,155,48.16
Milio,Zed,356,199,157,55.9
Milio,Jinx,590,243,347,41.19
Milio,Lulu,352,187,165,53.13
Milio,Jax,325,152,173,46.77
Milio,Talon,208,118,90,56.73
Milio,Leblanc,109,59,50,54.13
Milio,Mel,879,468,411,53.24
Milio,Jhin,551,284,267,51.54
Milio,Velkoz,187,82,105,43.85
Milio,Olaf,96,45,51,46.88
Milio,LeeSin,349,158,191,45.27
Milio,Diana,403,244,159,60.55
Milio,Seraphine,373,233,140,62.47
Milio,Karma,311,195,116,62.7
Milio,Tryndamere,178,106,72,59.55
Milio,Graves,188,105,83,55.85
Milio,Sylas,341,154,187,45.16
Milio,Leona,261,101,160,38.7
Milio,DrMundo,185,84,101,45.41
Milio,Shaco,254,128,126,50.39
Milio,Xayah,220,122,98,55.45
Milio,Morgana,479,249,230,51.98
Milio,Ashe,688,361,327,52.47
Milio,Renekton,93,57,36,61.29
Milio,Khazix,212,124,88,58.49
Milio,Malzahar,217,106,111,48.85
Milio,Quinn,167,92,75,55.09
Milio,Vayne,246,114,132,46.34
Milio,Shyvana,93,39,54,41.94
Milio,Soraka,250,114,136,45.6
Milio,Fiora,188,98,90,52.13
Milio,Elise,222,133,89,59.91
Milio,Garen,519,241,278,46.44
Milio,Senna,287,152,135,52.96
Milio,Maokai,179,61,118,34.08
Milio,Corki,127,62,65,48.82
Milio,Taric,76,25,51,32.89
Milio,Camille,120,61,59,50.83
Milio,Hecarim,146,65,81,44.52
Milio,TwistedFate,120,69,51,57.5
Milio,Ezreal,607,343,264,56.51
Milio,Nautilus,425,287,138,67.53
Milio,Kaisa,427,234,193,54.8
Milio,Qiyana,143,73,70,51.05
Milio,Swain,340,152,188,44.71
Milio,Ziggs,159,79,80,49.69
Milio,Nasus,205,91,114,44.39
Milio,Xerath,197,126,71,63.96
Milio,Caitlyn,815,408,407,50.06
Milio,Irelia,270,171,99,63.33
Milio,Amumu,353,135,218,38.24
Milio,Poppy,215,124,91,57.67
Milio,Veigar,357,146,211,40.9
Milio,Gnar,139,105,34,75.54
Milio,Lucian,192,96,96,50
Milio,Nami,335,166,169,49.55
Milio,Aatrox,392,238,154,60.71
Milio,FiddleSticks,187,111,76,59.36
Milio,Kindred,148,72,76,48.65
Milio,Aphelios,292,170,122,58.22
Milio,Rengar,152,85,67,55.92
Milio,Sion,332,149,183,44.88
Milio,Orianna,179,72,107,40.22
Milio,Illaoi,158,60,98,37.97
Milio,Vi,299,156,143,52.17
Milio,Yasuo,636,335,301,52.67
Milio,Rell,167,93,74,55.69
Milio,Sivir,167,100,67,59.88
Milio,Aurora,402,173,229,43.03
Milio,Sett,490,243,247,49.59
Milio,Gragas,209,108,101,51.67
Milio,Viego,355,217,138,61.13
Milio,Draven,171,129,42,75.44
Milio,Blitzcrank,227,121,106,53.3
Milio,Ahri,404,241,163,59.65
Milio,Katarina,380,223,157,58.68
Milio,Evelynn,211,129,82,61.14
Milio,Akshan,139,77,62,55.4
Milio,Smolder,320,169,151,52.81
Milio,MasterYi,397,172,225,43.32
Milio,Tristana,250,145,105,58
Milio,Thresh,469,211,258,44.99
Milio,MonkeyKing,197,113,84,57.36
Milio,Urgot,137,63,74,45.99
Milio,Zac,132,73,59,55.3
Milio,Volibear,322,184,138,57.14
Milio,Kennen,131,84,47,64.12
Milio,Rammus,102,60,42,58.82
Milio,Zeri,162,83,79,51.23
Milio,Pyke,346,171,175,49.42
Milio,Viktor,274,132,142,48.18
Milio,Riven,174,107,67,61.49
Milio,Syndra,175,54,121,30.86
Milio,Kled,61,27,34,44.26
Milio,Lillia,193,109,84,56.48
Milio,Ekko,212,126,86,59.43
Milio,Anivia,108,53,55,49.07
Milio,Samira,255,138,117,54.12
Milio,Ornn,161,67,94,41.61
Milio,Lissandra,64,40,24,62.5
Milio,Varus,260,114,146,43.85
Milio,TahmKench,355,178,177,50.14
Milio,Nunu,231,115,116,49.78
Milio,Heimerdinger,151,72,79,47.68
Milio,Trundle,144,68,76,47.22
Milio,Gangplank,184,104,80,56.52
Milio,Alistar,138,64,74,46.38
Milio,Hwei,278,145,133,52.16
Milio,JarvanIV,179,101,78,56.42
Milio,KSante,143,78,65,54.55
Milio,Gwen,224,106,118,47.32
Milio,Yone,481,244,237,50.73
Milio,Janna,118,45,73,38.14
Milio,Sejuani,139,81,58,58.27
Milio,Brand,152,96,56,63.16
Milio,Renata,117,59,58,50.43
Milio,Vex,190,117,73,61.58
Milio,Udyr,135,55,80,40.74
Milio,Kalista,148,72,76,48.65
Milio,Fizz,216,129,87,59.72
Milio,AurelionSol,105,64,41,60.95
Milio,Galio,222,124,98,55.86
Milio,Naafiri,162,55,107,33.95
Milio,Ivern,108,69,39,63.89
Milio,Nilah,149,79,70,53.02
Milio,Kayle,277,127,150,45.85
Milio,Ambessa,224,116,108,51.79
Milio,Malphite,278,110,168,39.57
Milio,Bard,124,63,61,50.81
Milio,Zyra,234,103,131,44.02
Milio,Twitch,288,149,139,51.74
Milio,Rakan,162,104,58,64.2
Milio,Zoe,124,72,52,58.06
Milio,Skarner,90,52,38,57.78
Milio,Nidalee,92,65,27,70.65
Milio,Cassiopeia,81,47,34,58.02
Milio,Singed,114,56,58,49.12
Milio,Shen,200,90,110,45
Milio,Annie,140,109,31,77.86
Milio,Rumble,99,60,39,60.61
Milio,Nocturne,245,112,133,45.71
Milio,Jayce,115,66,49,57.39
Milio,Zilean,129,75,54,58.14
Milio,Karthus,81,45,36,55.56
Milio,Belveth,92,28,64,30.43
Milio,RekSai,37,17,20,45.95
KogMaw,Illaoi,64,30,34,46.88
KogMaw,Warwick,349,180,169,51.58
KogMaw,Diana,277,121,156,43.68
KogMaw,Tristana,147,79,68,53.74
KogMaw,Milio,128,66,62,51.56
KogMaw,Sion,196,111,85,56.63
KogMaw,Akshan,118,65,53,55.08
KogMaw,Jinx,450,249,201,55.33
KogMaw,Bard,83,36,47,43.37
KogMaw,Jax,214,97,117,45.33
KogMaw,Graves,101,52,49,51.49
KogMaw,Katarina,175,101,74,57.71
KogMaw,Twitch,219,109,110,49.77
KogMaw,Seraphine,227,122,105,53.74
KogMaw,Kennen,87,41,46,47.13
KogMaw,Skarner,95,44,51,46.32
KogMaw,Malzahar,155,84,71,54.19
KogMaw,Yuumi,179,106,73,59.22
KogMaw,Swain,204,106,98,51.96
KogMaw,Morgana,332,177,155,53.31
KogMaw,Caitlyn,510,262,248,51.37
KogMaw,Tryndamere,125,61,64,48.8
KogMaw,Vayne,174,112,62,64.37
KogMaw,Draven,82,38,44,46.34
KogMaw,Mel,383,149,234,38.9
KogMaw,Volibear,257,132,125,51.36
KogMaw,MasterYi,171,99,72,57.89
KogMaw,Hwei,136,93,43,68.38
KogMaw,Samira,221,127,94,57.47
KogMaw,Shyvana,88,41,47,46.59
KogMaw,Fizz,114,54,60,47.37
KogMaw,Yasuo,401,220,181,54.86
KogMaw,Taric,46,25,21,54.35
KogMaw,Gnar,51,25,26,49.02
KogMaw,Vi,211,99,112,46.92
KogMaw,Kaisa,275,136,139,49.45
KogMaw,Nautilus,290,168,122,57.93
KogMaw,Yone,410,224,186,54.63
KogMaw,Viego,263,139,124,52.85
KogMaw,Ezreal,366,189,177,51.64
KogMaw,Blitzcrank,134,73,61,54.48
KogMaw,Mordekaiser,327,130,197,39.76
KogMaw,Talon,123,55,68,44.72
KogMaw,Quinn,72,43,29,59.72
KogMaw,Briar,177,77,100,43.5
KogMaw,Chogath,290,133,157,45.86
KogMaw,Sylas,212,115,97,54.25
KogMaw,Smolder,168,79,89,47.02
KogMaw,Neeko,186,122,64,65.59
KogMaw,Teemo,279,142,137,50.9
KogMaw,Kayn,310,129,181,41.61
KogMaw,Renata,61,42,19,68.85
KogMaw,Darius,347,174,173,50.14
KogMaw,LeeSin,169,100,69,59.17
KogMaw,Irelia,201,119,82,59.2
KogMaw,Karma,152,68,84,44.74
KogMaw,Vladimir,139,64,75,46.04
KogMaw,Khazix,97,44,53,45.36
KogMaw,Kayle,161,102,59,63.35
KogMaw,MissFortune,506,293,213,57.91
KogMaw,Soraka,153,77,76,50.33
KogMaw,Zoe,111,73,38,65.77
KogMaw,Garen,345,193,152,55.94
KogMaw,Ahri,251,141,110,56.18
KogMaw,Jhin,443,248,195,55.98
KogMaw,Rakan,126,51,75,40.48
KogMaw,Varus,193,105,88,54.4
KogMaw,Nasus,155,77,78,49.68
KogMaw,Zyra,158,92,66,58.23
KogMaw,Aatrox,210,151,59,71.9
KogMaw,Rengar,64,48,16,75
KogMaw,Lux,544,302,242,55.51
KogMaw,Kindred,74,57,17,77.03
KogMaw,Veigar,195,83,112,42.56
KogMaw,Ekko,137,46,91,33.58
KogMaw,Yorick,195,77,118,39.49
KogMaw,Lillia,148,64,84,43.24
KogMaw,KSante,87,68,19,78.16
KogMaw,Zac,82,50,32,60.98
KogMaw,Galio,213,84,129,39.44
KogMaw,Sona,113,65,48,57.52
KogMaw,Nunu,126,79,47,62.7
KogMaw,Shaco,143,82,61,57.34
KogMaw,Taliyah,65,27,38,41.54
KogMaw,Xayah,143,72,71,50.35
KogMaw,Lulu,188,109,79,57.98
KogMaw,Zed,191,115,76,60.21
KogMaw,Hecarim,142,73,69,51.41
KogMaw,Sejuani,90,54,36,60
KogMaw,Ambessa,138,80,58,57.97
KogMaw,TahmKench,256,118,138,46.09
KogMaw,Urgot,103,51,52,49.51
KogMaw,Vex,101,58,43,57.43
KogMaw,FiddleSticks,151,66,85,43.71
KogMaw,Evelynn,106,54,52,50.94
KogMaw,Ivern,56,32,24,57.14
KogMaw,Aurora,193,90,103,46.63
KogMaw,Camille,75,23,52,30.67
KogMaw,Renekton,92,50,42,54.35
KogMaw,Kalista,87,40,47,45.98
KogMaw,Sivir,135,82,53,60.74
KogMaw,Nami,181,74,107,40.88
KogMaw,Sett,333,175,158,52.55
KogMaw,Pantheon,330,159,171,48.18
KogMaw,Amumu,214,108,106,50.47
KogMaw,Brand,141,50,91,35.46
KogMaw,Qiyana,54,18,36,33.33
KogMaw,Aphelios,89,57,32,64.04
KogMaw,Shen,171,97,74,56.73
KogMaw,Corki,62,40,22,64.52
KogMaw,Leblanc,83,57,26,68.67
KogMaw,Nocturne,150,79,71,52.67
KogMaw,DrMundo,133,76,57,57.14
KogMaw,Nilah,66,26,40,39.39
KogMaw,Pyke,208,120,88,57.69
KogMaw,Akali,164,91,73,55.49
KogMaw,Syndra,107,53,54,49.53
KogMaw,Kassadin,53,26,27,49.06
KogMaw,XinZhao,128,79,49,61.72
KogMaw,MonkeyKing,65,38,27,58.46
KogMaw,Poppy,134,75,59,55.97
KogMaw,Leona,148,86,62,58.11
KogMaw,Rumble,51,42,9,82.35
KogMaw,Nidalee,56,50,6,89.29
KogMaw,Annie,59,28,31,47.46
KogMaw,Ornn,75,37,38,49.33
KogMaw,Azir,52,33,19,63.46
KogMaw,Xerath,107,49,58,45.79
KogMaw,Olaf,32,22,10,68.75
KogMaw,Orianna,152,83,69,54.61
KogMaw,Alistar,81,55,26,67.9
KogMaw,Trundle,87,43,44,49.43
KogMaw,Ashe,377,207,170,54.91
KogMaw,Zeri,123,66,57,53.66
KogMaw,Velkoz,152,86,66,56.58
KogMaw,Ziggs,80,25,55,31.25
KogMaw,AurelionSol,113,64,49,56.64
KogMaw,Senna,190,94,96,49.47
KogMaw,Rell,121,74,47,61.16
KogMaw,Cassiopeia,83,40,43,48.19
KogMaw,Thresh,296,141,155,47.64
KogMaw,Maokai,104,78,26,75
KogMaw,Karthus,30,27,3,90
KogMaw,Lissandra,33,9,24,27.27
KogMaw,Belveth,57,48,9,84.21
KogMaw,Lucian,118,54,64,45.76
KogMaw,Riven,72,37,35,51.39
KogMaw,Malphite,148,77,71,52.03
KogMaw,Gragas,139,79,60,56.83
KogMaw,Elise,105,48,57,45.71
KogMaw,Heimerdinger,104,64,40,61.54
KogMaw,Ryze,67,42,25,62.69
KogMaw,Braum,99,57,42,57.58
KogMaw,Udyr,87,52,35,59.77
KogMaw,Rammus,64,39,25,60.94
KogMaw,Gwen,164,79,85,48.17
KogMaw,Fiora,129,62,67,48.06
KogMaw,Anivia,75,42,33,56
KogMaw,Viktor,166,91,75,54.82
KogMaw,Naafiri,111,53,58,47.75
KogMaw,Jayce,78,32,46,41.03
KogMaw,Zilean,57,35,22,61.4
KogMaw,TwistedFate,74,39,35,52.7
KogMaw,JarvanIV,66,46,20,69.7
KogMaw,Kled,62,41,21,66.13
KogMaw,Gangplank,48,25,23,52.08
KogMaw,Janna,53,14,39,26.42
KogMaw,RekSai,17,14,3,82.35
KogMaw,Singed,29,23,6,79.31
MasterYi,Maokai,275,121,154,44
MasterYi,Graves,311,169,142,54.34
MasterYi,Ahri,860,422,438,49.07
MasterYi,Nilah,405,209,196,51.6
MasterYi,Malphite,495,260,235,52.53
MasterYi,Yorick,601,260,341,43.26
MasterYi,FiddleSticks,322,138,184,42.86
MasterYi,Draven,286,148,138,51.75
MasterYi,Smolder,499,306,193,61.32
MasterYi,Nautilus,711,289,422,40.65
MasterYi,Kayn,1227,696,531,56.72
MasterYi,Zed,563,305,258,54.17
MasterYi,Sona,239,92,147,38.49
MasterYi,Kaisa,820,457,363,55.73
MasterYi,Amumu,672,315,357,46.88
MasterYi,Nasus,586,266,320,45.39
MasterYi,Shaco,579,356,223,61.49
MasterYi,Varus,520,246,274,47.31
MasterYi,Neeko,541,248,293,45.84
MasterYi,Ryze,178,94,84,52.81
MasterYi,Warwick,1221,594,627,48.65
MasterYi,Morgana,891,459,432,51.52
MasterYi,Xayah,498,213,285,42.77
MasterYi,Veigar,790,354,436,44.81
MasterYi,Sett,1215,573,642,47.16
MasterYi,Caitlyn,1448,745,703,51.45
MasterYi,Lulu,517,209,308,40.43
MasterYi,KSante,196,106,90,54.08
MasterYi,Udyr,238,116,122,48.74
MasterYi,Ashe,1245,728,517,58.47
MasterYi,Akali,762,476,286,62.47
MasterYi,Jinx,1347,701,646,52.04
MasterYi,Karma,425,241,184,56.71
MasterYi,Zac,159,99,60,62.26
MasterYi,Nunu,530,279,251,52.64
MasterYi,Shen,409,217,192,53.06
MasterYi,Riven,253,136,117,53.75
MasterYi,Lillia,352,193,159,54.83
MasterYi,Orianna,303,169,134,55.78
MasterYi,Velkoz,370,158,212,42.7
MasterYi,Volibear,608,301,307,49.51
MasterYi,Nocturne,577,274,303,47.49
MasterYi,Xerath,444,221,223,49.77
MasterYi,Ezreal,1077,556,521,51.62
MasterYi,Blitzcrank,488,243,245,49.8
MasterYi,Pantheon,1066,556,510,52.16
MasterYi,Kindred,319,160,159,50.16
MasterYi,Teemo,914,437,477,47.81
MasterYi,Lucian,345,187,158,54.2
MasterYi,Zyra,415,193,222,46.51
MasterYi,Gnar,245,120,125,48.98
MasterYi,Seraphine,804,377,427,46.89
MasterYi,TahmKench,790,392,398,49.62
MasterYi,Briar,772,416,356,53.89
MasterYi,Heimerdinger,327,168,159,51.38
MasterYi,MissFortune,1582,822,760,51.96
MasterYi,Fiora,336,190,146,56.55
MasterYi,Viego,889,416,473,46.79
MasterYi,Vladimir,339,166,173,48.97
MasterYi,Pyke,705,387,318,54.89
MasterYi,Irelia,650,305,345,46.92
MasterYi,DrMundo,369,175,194,47.43
MasterYi,Lux,1784,880,904,49.33
MasterYi,Bard,200,112,88,56
MasterYi,Katarina,566,295,271,52.12
MasterYi,Tristana,641,302,339,47.11
MasterYi,Yone,1133,549,584,48.46
MasterYi,Akshan,201,111,90,55.22
MasterYi,Aphelios,416,187,229,44.95
MasterYi,Braum,277,121,156,43.68
MasterYi,Kennen,292,168,124,57.53
MasterYi,Ekko,560,283,277,50.54
MasterYi,Poppy,317,153,164,48.26
MasterYi,Yasuo,1298,647,651,49.85
MasterYi,Nidalee,150,94,56,62.67
MasterYi,Mordekaiser,1134,597,537,52.65
MasterYi,KogMaw,171,72,99,42.11
MasterYi,Ornn,238,107,131,44.96
MasterYi,Ambessa,429,233,196,54.31
MasterYi,Zoe,247,159,88,64.37
MasterYi,Jhin,1057,539,518,50.99
MasterYi,Swain,795,389,406,48.93
MasterYi,Samira,573,298,275,52.01
MasterYi,Mel,1408,751,657,53.34
MasterYi,Vayne,697,265,432,38.02
MasterYi,Thresh,815,430,385,52.76
MasterYi,Urgot,367,189,178,51.5
MasterYi,Galio,447,222,225,49.66
MasterYi,Rell,348,176,172,50.57
MasterYi,Diana,984,491,493,49.9
MasterYi,Aatrox,614,343,271,55.86
MasterYi,Darius,1221,548,673,44.88
MasterYi,Viktor,360,220,140,61.11
MasterYi,Alistar,183,96,87,52.46
MasterYi,Fizz,308,164,144,53.25
MasterYi,Nami,424,238,186,56.13
MasterYi,Singed,155,74,81,47.74
MasterYi,Garen,779,366,413,46.98
MasterYi,Corki,176,97,79,55.11
MasterYi,JarvanIV,228,103,125,45.18
MasterYi,Janna,209,97,112,46.41
MasterYi,Evelynn,382,174,208,45.55
MasterYi,Jax,571,276,295,48.34
MasterYi,Zeri,254,130,124,51.18
MasterYi,Yuumi,581,299,282,51.46
MasterYi,Gragas,363,210,153,57.85
MasterYi,LeeSin,628,378,250,60.19
MasterYi,Syndra,370,171,199,46.22
MasterYi,Kalista,370,210,160,56.76
MasterYi,Soraka,384,205,179,53.39
MasterYi,Hecarim,213,88,125,41.31
MasterYi,Ivern,150,85,65,56.67
MasterYi,Trundle,378,209,169,55.29
MasterYi,Elise,380,207,173,54.47
MasterYi,Senna,517,234,283,45.26
MasterYi,Belveth,176,101,75,57.39
MasterYi,Brand,506,290,216,57.31
MasterYi,Sion,534,258,276,48.31
MasterYi,Talon,404,232,172,57.43
MasterYi,Renata,156,82,74,52.56
MasterYi,Gwen,381,211,170,55.38
MasterYi,RekSai,56,29,27,51.79
MasterYi,Aurora,678,338,340,49.85
MasterYi,Chogath,897,447,450,49.83
MasterYi,Naafiri,290,144,146,49.66
MasterYi,XinZhao,390,204,186,52.31
MasterYi,Malzahar,418,212,206,50.72
MasterYi,Twitch,550,301,249,54.73
MasterYi,Skarner,173,117,56,67.63
MasterYi,Zilean,155,94,61,60.65
MasterYi,Annie,233,123,110,52.79
MasterYi,Tryndamere,343,175,168,51.02
MasterYi,Milio,397,225,172,56.68
MasterYi,MonkeyKing,354,135,219,38.14
MasterYi,Azir,226,130,96,57.52
MasterYi,Vi,633,301,332,47.55
MasterYi,Khazix,456,267,189,58.55
MasterYi,Rengar,267,166,101,62.17
MasterYi,Kassadin,124,66,58,53.23
MasterYi,Rakan,390,211,179,54.1
MasterYi,Sejuani,191,101,90,52.88
MasterYi,Leona,487,202,285,41.48
MasterYi,Lissandra,193,98,95,50.78
MasterYi,Gangplank,276,157,119,56.88
MasterYi,Taric,175,83,92,47.43
MasterYi,Kled,98,50,48,51.02
MasterYi,Ziggs,257,143,114,55.64
MasterYi,Cassiopeia,249,155,94,62.25
MasterYi,Rammus,442,196,246,44.34
MasterYi,Qiyana,238,146,92,61.34
MasterYi,Renekton,313,137,176,43.77
MasterYi,Taliyah,169,93,76,55.03
MasterYi,Karthus,173,63,110,36.42
MasterYi,TwistedFate,246,122,124,49.59
MasterYi,AurelionSol,299,132,167,44.15
MasterYi,Sylas,606,364,242,60.07
MasterYi,Kayle,523,259,264,49.52
MasterYi,Jayce,275,143,132,52
MasterYi,Rumble,129,71,58,55.04
MasterYi,Hwei,449,236,213,52.56
MasterYi,Vex,326,183,143,56.13
MasterYi,Quinn,207,94,113,45.41
MasterYi,Illaoi,291,84,207,28.87
MasterYi,Sivir,285,145,140,50.88
MasterYi,Olaf,105,63,42,60
MasterYi,Leblanc,264,145,119,54.92
MasterYi,Anivia,212,108,104,50.94
MasterYi,Camille,209,108,101,51.67
MasterYi,Shyvana,143,73,70,51.05
Ashe,Maokai,424,187,237,44.1
Ashe,Graves,593,280,313,47.22
Ashe,Ahri,1497,760,737,50.77
Ashe,Nilah,606,352,254,58.09
Ashe,Malphite,947,460,487,48.57
Ashe,Fiora,520,255,265,49.04
Ashe,Belveth,300,160,140,53.33
Ashe,Sylas,1039,517,522,49.76
Ashe,Ezreal,2131,1137,994,53.36
Ashe,Yuumi,1028,513,515,49.9
Ashe,Heimerdinger,598,329,269,55.02
Ashe,Warwick,1647,802,845,48.69
Ashe,Neeko,793,425,368,53.59
Ashe,Draven,681,359,322,52.72
Ashe,Leona,804,392,412,48.76
Ashe,Evelynn,629,335,294,53.26
Ashe,Yasuo,2230,1155,1075,51.79
Ashe,Yone,2093,1078,1015,51.51
Ashe,Kayle,795,393,402,49.43
Ashe,Viego,1289,662,627,51.36
Ashe,Irelia,1009,533,476,52.82
Ashe,Jinx,2736,1330,1406,48.61
Ashe,Thresh,1460,705,755,48.29
Ashe,XinZhao,699,381,318,54.51
Ashe,Katarina,904,532,372,58.85
Ashe,Teemo,1516,650,866,42.88
Ashe,Vayne,1121,551,570,49.15
Ashe,TwistedFate,379,178,201,46.97
Ashe,Pantheon,1749,854,895,48.83
Ashe,Kayn,1666,792,874,47.54
Ashe,Leblanc,435,165,270,37.93
Ashe,Sivir,612,288,324,47.06
Ashe,Pyke,1235,681,554,55.14
Ashe,Smolder,756,403,353,53.31
Ashe,Nautilus,963,465,498,48.29
Ashe,DrMundo,689,320,369,46.44
Ashe,Briar,1067,473,594,44.33
Ashe,Anivia,361,177,184,49.03
Ashe,Mordekaiser,1612,795,817,49.32
Ashe,Vi,826,367,459,44.43
Ashe,Azir,417,241,176,57.79
Ashe,MissFortune,2687,1261,1426,46.93
Ashe,Riven,515,330,185,64.08
Ashe,Ivern,290,166,124,57.24
Ashe,Swain,1183,642,541,54.27
Ashe,Nami,1062,539,523,50.75
Ashe,Gnar,388,187,201,48.2
Ashe,Caitlyn,3036,1460,1576,48.09
Ashe,Karma,804,404,400,50.25
Ashe,Volibear,1080,540,540,50
Ashe,LeeSin,1133,596,537,52.6
Ashe,Morgana,1468,755,713,51.43
Ashe,Shaco,954,434,520,45.49
Ashe,Xayah,663,357,306,53.85
Ashe,Sett,1814,877,937,48.35
Ashe,Jhin,1968,1029,939,52.29
Ashe,Senna,1008,467,541,46.33
Ashe,Yorick,875,333,542,38.06
Ashe,Gragas,615,317,298,51.54
Ashe,Lux,3026,1462,1564,48.31
Ashe,Aphelios,745,386,359,51.81
Ashe,Khazix,697,399,298,57.25
Ashe,Akali,1197,596,601,49.79
Ashe,Mel,2267,1144,1123,50.46
Ashe,Zed,1000,529,471,52.9
Ashe,Nunu,804,453,351,56.34
Ashe,KSante,413,203,210,49.15
Ashe,Zeri,457,267,190,58.42
Ashe,Lulu,937,471,466,50.27
Ashe,Sion,867,369,498,42.56
Ashe,MasterYi,1245,517,728,41.53
Ashe,AurelionSol,439,198,241,45.1
Ashe,FiddleSticks,479,224,255,46.76
Ashe,Brand,761,330,431,43.36
Ashe,Milio,688,327,361,47.53
Ashe,Illaoi,565,283,282,50.09
Ashe,Velkoz,637,251,386,39.4
Ashe,Soraka,606,269,337,44.39
Ashe,Chogath,1429,646,783,45.21
Ashe,Jayce,515,249,266,48.35
Ashe,Samira,1026,503,523,49.03
Ashe,Quinn,375,188,187,50.13
Ashe,Shen,704,331,373,47.02
Ashe,Shyvana,258,85,173,32.95
Ashe,Seraphine,1277,601,676,47.06
Ashe,Kled,247,131,116,53.04
Ashe,Ambessa,641,315,326,49.14
Ashe,Diana,1414,651,763,46.04
Ashe,Ekko,863,490,373,56.78
Ashe,Talon,663,361,302,54.45
Ashe,Lissandra,204,82,122,40.2
Ashe,Lucian,706,381,325,53.97
Ashe,Nocturne,965,440,525,45.6
Ashe,Sejuani,410,172,238,41.95
Ashe,Rell,616,304,312,49.35
Ashe,Aatrox,1040,538,502,51.73
Ashe,Fizz,539,229,310,42.49
Ashe,Taric,244,116,128,47.54
Ashe,Tristana,1050,459,591,43.71
Ashe,Alistar,304,145,159,47.7
Ashe,Vladimir,641,288,353,44.93
Ashe,Ziggs,513,260,253,50.68
Ashe,Darius,2087,1026,1061,49.16
Ashe,Rammus,348,134,214,38.51
Ashe,TahmKench,1088,580,508,53.31
Ashe,Rengar,491,274,217,55.8
Ashe,Galio,722,342,380,47.37
Ashe,Urgot,491,248,243,50.51
Ashe,Xerath,665,347,318,52.18
Ashe,Kalista,427,235,192,55.04
Ashe,Sona,498,214,284,42.97
Ashe,Garen,1565,679,886,43.39
Ashe,Kindred,568,343,225,60.39
Ashe,Varus,888,422,466,47.52
Ashe,Hwei,886,374,512,42.21
Ashe,Aurora,1129,556,573,49.25
Ashe,Malzahar,805,314,491,39.01
Ashe,Braum,440,173,267,39.32
Ashe,Zoe,417,252,165,60.43
Ashe,Zilean,265,139,126,52.45
Ashe,Hecarim,382,178,204,46.6
Ashe,Blitzcrank,816,442,374,54.17
Ashe,Veigar,1180,566,614,47.97
Ashe,Karthus,302,140,162,46.36
Ashe,Kaisa,1483,773,710,52.12
Ashe,Poppy,628,298,330,47.45
Ashe,Viktor,734,383,351,52.18
Ashe,Udyr,463,236,227,50.97
Ashe,Nasus,837,428,409,51.14
Ashe,Lillia,713,330,383,46.28
Ashe,Gwen,699,387,312,55.36
Ashe,Jax,927,493,434,53.18
Ashe,Amumu,990,496,494,50.1
Ashe,JarvanIV,426,217,209,50.94
Ashe,Janna,357,170,187,47.62
Ashe,Syndra,640,336,304,52.5
Ashe,Gangplank,482,244,238,50.62
Ashe,Vex,523,275,248,52.58
Ashe,Rakan,541,293,248,54.16
Ashe,MonkeyKing,494,260,234,52.63
Ashe,Bard,251,142,109,56.57
Ashe,Elise,680,380,300,55.88
Ashe,Zyra,763,308,455,40.37
Ashe,Renekton,522,255,267,48.85
Ashe,Renata,268,158,110,58.96
Ashe,Ornn,432,221,211,51.16
Ashe,Camille,434,201,233,46.31
Ashe,Zac,394,212,182,53.81
Ashe,Nidalee,343,193,150,56.27
Ashe,Taliyah,332,171,161,51.51
Ashe,Orianna,529,313,216,59.17
Ashe,Kennen,380,243,137,63.95
Ashe,Annie,398,222,176,55.78
Ashe,Twitch,1040,470,570,45.19
Ashe,Corki,344,177,167,51.45
Ashe,Singed,329,181,148,55.02
Ashe,Qiyana,413,211,202,51.09
Ashe,Tryndamere,676,324,352,47.93
Ashe,Cassiopeia,353,182,171,51.56
Ashe,Ryze,275,119,156,43.27
Ashe,Akshan,404,169,235,41.83
Ashe,Naafiri,467,236,231,50.54
Ashe,Olaf,219,116,103,52.97
Ashe,Skarner,415,219,196,52.77
Ashe,Trundle,574,255,319,44.43
Ashe,Kassadin,185,84,101,45.41
Ashe,KogMaw,377,170,207,45.09
Ashe,RekSai,153,86,67,56.21
Ashe,Rumble,190,101,89,53.16
Graves,Pantheon,501,217,284,43.31
Graves,MasterYi,311,142,169,45.66
Graves,Sylas,423,257,166,60.76
Graves,Ashe,593,313,280,52.78
Graves,Karma,204,89,115,43.63
Graves,Irelia,230,107,123,46.52
Graves,Kayn,578,269,309,46.54
Graves,Katarina,277,133,144,48.01
Graves,Vayne,325,150,175,46.15
Graves,DrMundo,176,114,62,64.77
Graves,Olaf,84,42,42,50
Graves,LeeSin,374,172,202,45.99
Graves,Diana,455,237,218,52.09
Graves,Seraphine,322,128,194,39.75
Graves,Aatrox,342,179,163,52.34
Graves,Twitch,266,108,158,40.6
Graves,Veigar,353,124,229,35.13
Graves,Ezreal,587,286,301,48.72
Graves,Milio,188,83,105,44.15
Graves,Yorick,293,127,166,43.34
Graves,Nunu,337,175,162,51.93
Graves,Draven,198,105,93,53.03
Graves,KogMaw,101,49,52,48.51
Graves,Yuumi,286,98,188,34.27
Graves,Gangplank,184,97,87,52.72
Graves,Aphelios,195,116,79,59.49
Graves,Leona,310,186,124,60
Graves,Darius,578,305,273,52.77
Graves,Chogath,412,172,240,41.75
Graves,Yasuo,719,365,354,50.76
Graves,Kaisa,516,246,270,47.67
Graves,Trundle,171,85,86,49.71
Graves,Caitlyn,789,370,419,46.89
Graves,Sett,581,273,308,46.99
Graves,Smolder,316,159,157,50.32
Graves,Rengar,194,115,79,59.28
Graves,Hwei,238,106,132,44.54
Graves,Thresh,466,266,200,57.08
Graves,Quinn,136,60,76,44.12
Graves,Viego,403,194,209,48.14
Graves,MissFortune,675,282,393,41.78
Graves,Neeko,311,171,140,54.98
Graves,Tristana,285,152,133,53.33
Graves,Lux,837,381,456,45.52
Graves,Ornn,110,61,49,55.45
Graves,Skarner,115,77,38,66.96
Graves,Ekko,249,110,139,44.18
Graves,Lucian,214,104,110,48.6
Graves,Senna,229,117,112,51.09
Graves,Briar,317,132,185,41.64
Graves,Vex,203,100,103,49.26
Graves,Morgana,426,235,191,55.16
Graves,Naafiri,154,70,84,45.45
Graves,Ziggs,152,68,84,44.74
Graves,Kalista,124,64,60,51.61
Graves,Swain,304,125,179,41.12
Graves,Warwick,505,231,274,45.74
Graves,Gragas,200,116,84,58
Graves,Hecarim,163,85,78,52.15
Graves,Kassadin,40,19,21,47.5
Graves,Mordekaiser,476,207,269,43.49
Graves,Jinx,701,337,364,48.07
Graves,Elise,169,101,68,59.76
Graves,Sejuani,108,40,68,37.04
Graves,MonkeyKing,210,97,113,46.19
Graves,Viktor,206,88,118,42.72
Graves,Shaco,318,164,154,51.57
Graves,Zed,348,159,189,45.69
Graves,Varus,239,125,114,52.3
Graves,Soraka,213,85,128,39.91
Graves,Yone,682,356,326,52.2
Graves,Lillia,176,86,90,48.86
Graves,Akali,309,120,189,38.83
Graves,Udyr,81,52,29,64.2
Graves,Jax,278,134,144,48.2
Graves,Singed,116,39,77,33.62
Graves,Braum,228,110,118,48.25
Graves,Sion,256,102,154,39.84
Graves,Jhin,564,294,270,52.13
Graves,Xerath,235,105,130,44.68
Graves,TahmKench,367,200,167,54.5
Graves,Cassiopeia,90,27,63,30
Graves,Garen,471,178,293,37.79
Graves,Ryze,122,59,63,48.36
Graves,Renekton,194,89,105,45.88
Graves,Zeri,131,73,58,55.73
Graves,Lulu,289,157,132,54.33
Graves,Volibear,303,130,173,42.9
Graves,Tryndamere,134,59,75,44.03
Graves,Xayah,275,139,136,50.55
Graves,Kayle,258,129,129,50
Graves,AurelionSol,169,75,94,44.38
Graves,Rell,237,124,113,52.32
Graves,Heimerdinger,145,47,98,32.41
Graves,Shyvana,74,19,55,25.68
Graves,Taric,51,29,22,56.86
Graves,Poppy,203,92,111,45.32
Graves,Rumble,60,18,42,30
Graves,Nautilus,371,167,204,45.01
Graves,Rakan,171,79,92,46.2
Graves,Gwen,205,116,89,56.59
Graves,Vi,265,152,113,57.36
Graves,Zoe,125,74,51,59.2
Graves,Teemo,481,223,258,46.36
Graves,Malphite,273,108,165,39.56
Graves,Alistar,131,47,84,35.88
Graves,Rammus,122,43,79,35.25
Graves,Bard,111,69,42,62.16
Graves,Zac,96,45,51,46.88
Graves,Belveth,94,40,54,42.55
Graves,Evelynn,171,67,104,39.18
Graves,Ahri,413,217,196,52.54
Graves,Orianna,129,58,71,44.96
Graves,FiddleSticks,153,64,89,41.83
Graves,Aurora,321,135,186,42.06
Graves,Sivir,163,56,107,34.36
Graves,Nidalee,118,65,53,55.08
Graves,Brand,225,110,115,48.89
Graves,Samira,348,146,202,41.95
Graves,Riven,149,74,75,49.66
Graves,Qiyana,108,41,67,37.96
Graves,Vladimir,158,72,86,45.57
Graves,Zilean,85,43,42,50.59
Graves,Mel,688,349,339,50.73
Graves,Nasus,266,127,139,47.74
Graves,Akshan,129,53,76,41.09
Graves,Sona,120,53,67,44.17
Graves,Pyke,402,167,235,41.54
Graves,Fiora,129,61,68,47.29
Graves,Malzahar,285,144,141,50.53
Graves,Gnar,147,70,77,47.62
Graves,Jayce,122,42,80,34.43
Graves,Camille,117,56,61,47.86
Graves,Annie,92,38,54,41.3
Graves,Blitzcrank,273,139,134,50.92
Graves,Galio,242,132,110,54.55
Graves,TwistedFate,128,62,66,48.44
Graves,Khazix,227,101,126,44.49
Graves,Taliyah,105,31,74,29.52
Graves,Syndra,173,87,86,50.29
Graves,Renata,87,45,42,51.72
Graves,Shen,227,94,133,41.41
Graves,JarvanIV,108,35,73,32.41
Graves,Velkoz,179,74,105,41.34
Graves,Fizz,149,59,90,39.6
Graves,Leblanc,102,37,65,36.27
Graves,Maokai,152,79,73,51.97
Graves,Nocturne,250,102,148,40.8
Graves,Amumu,403,182,221,45.16
Graves,Azir,92,49,43,53.26
Graves,KSante,172,85,87,49.42
Graves,Lissandra,77,49,28,63.64
Graves,Anivia,103,31,72,30.1
Graves,Nami,289,149,140,51.56
Graves,Illaoi,95,43,52,45.26
Graves,Talon,208,138,70,66.35
Graves,XinZhao,146,61,85,41.78
Graves,Ivern,103,34,69,33.01
Graves,Kennen,123,62,61,50.41
Graves,Karthus,127,60,67,47.24
Graves,Janna,53,18,35,33.96
Graves,Kled,35,13,22,37.14
Graves,Nilah,158,75,83,47.47
Graves,Urgot,152,67,85,44.08
Graves,Kindred,170,70,100,41.18
Graves,RekSai,71,31,40,43.66
Graves,Ambessa,247,126,121,51.01
Graves,Corki,73,27,46,36.99
Graves,Zyra,212,58,154,27.36
Ahri,Pantheon,1406,685,721,48.72
Ahri,MasterYi,860,438,422,50.93
Ahri,Sylas,904,495,409,54.76
Ahri,Ashe,1497,737,760,49.23
Ahri,Karma,567,306,261,53.97
Ahri,Gangplank,411,197,214,47.93
Ahri,Ivern,131,82,49,62.6
Ahri,Mel,1788,856,932,47.87
Ahri,Jhin,1482,740,742,49.93
Ahri,Swain,859,378,481,44
Ahri,Gwen,614,298,316,48.53
Ahri,Talon,577,310,267,53.73
Ahri,Yone,1623,867,756,53.42
Ahri,MissFortune,1817,871,946,47.94
Ahri,Taric,191,78,113,40.84
Ahri,Teemo,1178,542,636,46.01
Ahri,Hecarim,295,188,107,63.73
Ahri,Veigar,1082,502,580,46.4
Ahri,Thresh,1039,535,504,51.49
Ahri,Poppy,512,276,236,53.91
Ahri,Warwick,1410,628,782,44.54
Ahri,Katarina,823,463,360,56.26
Ahri,Twitch,655,321,334,49.01
Ahri,Morgana,1112,541,571,48.65
Ahri,Yorick,831,300,531,36.1
Ahri,AurelionSol,411,201,210,48.91
Ahri,Kayn,1232,662,570,53.73
Ahri,Singed,226,95,131,42.04
Ahri,Udyr,297,141,156,47.47
Ahri,Jax,724,357,367,49.31
Ahri,Elise,543,285,258,52.49
Ahri,Naafiri,354,179,175,50.56
Ahri,Lulu,703,349,354,49.64
Ahri,Nasus,704,317,387,45.03
Ahri,Neeko,712,342,370,48.03
Ahri,Sett,1543,736,807,47.7
Ahri,Senna,822,408,414,49.64
Ahri,Akali,769,337,432,43.82
Ahri,Akshan,327,175,152,53.52
Ahri,TahmKench,791,380,411,48.04
Ahri,Kennen,346,189,157,54.62
Ahri,MonkeyKing,423,203,220,47.99
Ahri,Vladimir,471,222,249,47.13
Ahri,Vayne,891,454,437,50.95
Ahri,Fiora,409,246,163,60.15
Ahri,Shaco,799,405,394,50.69
Ahri,Fizz,396,149,247,37.63
Ahri,Tristana,769,343,426,44.6
Ahri,Rakan,429,221,208,51.52
Ahri,Yasuo,1787,861,926,48.18
Ahri,Belveth,226,101,125,44.69
Ahri,Mordekaiser,1270,661,609,52.05
Ahri,Alistar,264,135,129,51.14
Ahri,Chogath,1111,567,544,51.04
Ahri,Briar,877,420,457,47.89
Ahri,Jayce,335,210,125,62.69
Ahri,Samira,850,412,438,48.47
Ahri,XinZhao,524,249,275,47.52
Ahri,Brand,751,389,362,51.8
Ahri,Ambessa,438,234,204,53.42
Ahri,Rammus,267,122,145,45.69
Ahri,Aurora,913,505,408,55.31
Ahri,Caitlyn,1977,952,1025,48.15
Ahri,Riven,311,186,125,59.81
Ahri,Zed,802,453,349,56.48
Ahri,Smolder,634,289,345,45.58
Ahri,Galio,600,258,342,43
Ahri,Sejuani,319,156,163,48.9
Ahri,Malzahar,683,274,409,40.12
Ahri,Amumu,808,340,468,42.08
Ahri,DrMundo,502,216,286,43.03
Ahri,Viktor,520,236,284,45.38
Ahri,Pyke,1010,517,493,51.19
Ahri,Nocturne,668,295,373,44.16
Ahri,Leblanc,355,197,158,55.49
Ahri,Irelia,820,394,426,48.05
Ahri,Janna,227,107,120,47.14
Ahri,Jinx,1657,823,834,49.67
Ahri,Nautilus,795,435,360,54.72
Ahri,Zac,277,139,138,50.18
Ahri,Diana,1255,609,646,48.53
Ahri,Illaoi,406,165,241,40.64
Ahri,Evelynn,465,259,206,55.7
Ahri,Hwei,751,354,397,47.14
Ahri,Viego,1015,531,484,52.32
Ahri,KSante,369,205,164,55.56
Ahri,Ekko,652,333,319,51.07
Ahri,Lucian,479,239,240,49.9
Ahri,Kassadin,198,82,116,41.41
Ahri,Renata,244,125,119,51.23
Ahri,Maokai,320,155,165,48.44
Ahri,Ornn,325,134,191,41.23
Ahri,Zoe,342,168,174,49.12
Ahri,Aatrox,757,388,369,51.25
Ahri,LeeSin,821,383,438,46.65
Ahri,Zyra,513,186,327,36.26
Ahri,Karthus,244,113,131,46.31
Ahri,Xayah,542,280,262,51.66
Ahri,FiddleSticks,437,217,220,49.66
Ahri,Lux,2407,972,1435,40.38
Ahri,Velkoz,529,267,262,50.47
Ahri,Nilah,560,259,301,46.25
Ahri,Yuumi,814,407,407,50
Ahri,Tryndamere,494,249,245,50.4
Ahri,Varus,704,319,385,45.31
Ahri,Seraphine,889,453,436,50.96
Ahri,Soraka,552,264,288,47.83
Ahri,Rengar,360,222,138,61.67
Ahri,Kindred,459,238,221,51.85
Ahri,Vex,563,254,309,45.12
Ahri,Darius,1506,678,828,45.02
Ahri,Anivia,305,168,137,55.08
Ahri,Blitzcrank,661,347,314,52.5
Ahri,Qiyana,274,166,108,60.58
Ahri,Sona,318,160,158,50.31
Ahri,Gragas,511,250,261,48.92
Ahri,Rell,505,257,248,50.89
Ahri,Nami,749,366,383,48.87
Ahri,Quinn,301,146,155,48.5
Ahri,RekSai,118,63,55,53.39
Ahri,Ryze,307,148,159,48.21
Ahri,Taliyah,291,126,165,43.3
Ahri,Skarner,286,167,119,58.39
Ahri,Xerath,544,273,271,50.18
Ahri,Milio,404,163,241,40.35
Ahri,Kaisa,1172,600,572,51.19
Ahri,Renekton,425,203,222,47.76
Ahri,Lillia,507,233,274,45.96
Ahri,Zeri,412,187,225,45.39
Ahri,Trundle,457,219,238,47.92
Ahri,Kayle,685,311,374,45.4
Ahri,Shen,536,274,262,51.12
Ahri,Braum,448,215,233,47.99
Ahri,Camille,325,138,187,42.46
Ahri,Volibear,992,460,532,46.37
Ahri,Azir,272,136,136,50
Ahri,Khazix,548,304,244,55.47
Ahri,Draven,402,212,190,52.74
Ahri,Kled,161,77,84,47.83
Ahri,KogMaw,251,110,141,43.82
Ahri,Zilean,243,114,129,46.91
Ahri,Graves,413,196,217,47.46
Ahri,Cassiopeia,379,175,204,46.17
Ahri,Ezreal,1368,714,654,52.19
Ahri,Ziggs,333,136,197,40.84
Ahri,JarvanIV,341,130,211,38.12
Ahri,Kalista,477,271,206,56.81
Ahri,Vi,779,393,386,50.45
Ahri,Nunu,795,355,440,44.65
Ahri,Aphelios,597,300,297,50.25
Ahri,Leona,529,268,261,50.66
Ahri,Gnar,347,181,166,52.16
Ahri,TwistedFate,248,125,123,50.4
Ahri,Malphite,676,331,345,48.96
Ahri,Garen,1243,617,626,49.64
Ahri,Nidalee,176,91,85,51.7
Ahri,Urgot,421,185,236,43.94
Ahri,Corki,198,95,103,47.98
Ahri,Lissandra,193,107,86,55.44
Ahri,Syndra,572,259,313,45.28
Ahri,Shyvana,188,98,90,52.13
Ahri,Sion,612,287,325,46.9
Ahri,Bard,271,112,159,41.33
Ahri,Olaf,228,103,125,45.18
Ahri,Annie,320,169,151,52.81
Ahri,Sivir,363,195,168,53.72
Ahri,Rumble,172,113,59,65.7
Ahri,Heimerdinger,518,253,265,48.84
Ahri,Orianna,338,157,181,46.45
Nilah,Pantheon,630,355,275,56.35
Nilah,MasterYi,405,196,209,48.4
Nilah,Sylas,327,132,195,40.37
Nilah,Ashe,606,254,352,41.91
Nilah,Karma,268,143,125,53.36
Nilah,Swain,371,151,220,40.7
Nilah,FiddleSticks,200,89,111,44.5
Nilah,Akali,355,188,167,52.96
Nilah,Twitch,336,172,164,51.19
Nilah,Senna,300,142,158,47.33
Nilah,Yorick,248,91,157,36.69
Nilah,Akshan,111,72,39,64.86
Nilah,Samira,533,267,266,50.09
Nilah,Pyke,400,259,141,64.75
Nilah,TahmKench,332,149,183,44.88
Nilah,Nunu,271,119,152,43.91
Nilah,Vladimir,219,112,107,51.14
Nilah,Nami,334,156,178,46.71
Nilah,Fiora,158,93,65,58.86
Nilah,LeeSin,353,172,181,48.73
Nilah,Ziggs,150,78,72,52
Nilah,Jinx,684,334,350,48.83
Nilah,Nasus,315,119,196,37.78
Nilah,Gragas,210,98,112,46.67
Nilah,Yasuo,821,476,345,57.98
Nilah,Smolder,241,133,108,55.19
Nilah,Mel,848,489,359,57.67
Nilah,KSante,99,62,37,62.63
Nilah,Kayn,532,258,274,48.5
Nilah,MissFortune,886,398,488,44.92
Nilah,Lux,908,456,452,50.22
Nilah,Illaoi,166,105,61,63.25
Nilah,Warwick,573,296,277,51.66
Nilah,Aurora,357,198,159,55.46
Nilah,Ezreal,516,307,209,59.5
Nilah,Neeko,224,107,117,47.77
Nilah,Yone,539,317,222,58.81
Nilah,Poppy,226,109,117,48.23
Nilah,Thresh,462,250,212,54.11
Nilah,Sett,556,229,327,41.19
Nilah,Rammus,86,32,54,37.21
Nilah,Tristana,310,130,180,41.94
Nilah,Karthus,90,36,54,40
Nilah,Zed,314,176,138,56.05
Nilah,Maokai,251,144,107,57.37
Nilah,Gangplank,150,70,80,46.67
Nilah,Diana,426,227,199,53.29
Nilah,Irelia,260,133,127,51.15
Nilah,Aphelios,250,121,129,48.4
Nilah,Leona,302,157,145,51.99
Nilah,Darius,667,321,346,48.13
Nilah,Syndra,184,93,91,50.54
Nilah,Corki,125,41,84,32.8
Nilah,Elise,213,122,91,57.28
Nilah,Katarina,295,121,174,41.02
Nilah,Kaisa,569,317,252,55.71
Nilah,Qiyana,126,71,55,56.35
Nilah,Volibear,360,209,151,58.06
Nilah,Gwen,190,89,101,46.84
Nilah,DrMundo,235,122,113,51.91
Nilah,Lucian,224,93,131,41.52
Nilah,Belveth,89,53,36,59.55
Nilah,AurelionSol,150,75,75,50
Nilah,Briar,425,219,206,51.53
Nilah,Kassadin,92,58,34,63.04
Nilah,Renata,98,55,43,56.12
Nilah,Mordekaiser,545,260,285,47.71
Nilah,Shaco,382,208,174,54.45
Nilah,Zoe,177,118,59,66.67
Nilah,Seraphine,368,184,184,50
Nilah,Olaf,72,37,35,51.39
Nilah,Morgana,495,257,238,51.92
Nilah,Teemo,465,225,240,48.39
Nilah,Aatrox,382,200,182,52.36
Nilah,Jhin,573,269,304,46.95
Nilah,Renekton,184,88,96,47.83
Nilah,Jax,252,117,135,46.43
Nilah,Soraka,194,116,78,59.79
Nilah,Nidalee,88,50,38,56.82
Nilah,Ahri,560,301,259,53.75
Nilah,Sona,133,63,70,47.37
Nilah,Amumu,307,108,199,35.18
Nilah,Caitlyn,857,387,470,45.16
Nilah,Xayah,209,94,115,44.98
Nilah,Ekko,262,126,136,48.09
Nilah,Chogath,361,163,198,45.15
Nilah,Ryze,102,39,63,38.24
Nilah,Xerath,272,129,143,47.43
Nilah,Zac,98,72,26,73.47
Nilah,Skarner,87,47,40,54.02
Nilah,Malzahar,220,91,129,41.36
Nilah,Vi,289,141,148,48.79
Nilah,Viego,374,184,190,49.2
Nilah,Vayne,353,181,172,51.27
Nilah,Zilean,51,29,22,56.86
Nilah,Singed,108,35,73,32.41
Nilah,Kindred,233,110,123,47.21
Nilah,Yuumi,322,130,192,40.37
Nilah,Garen,553,295,258,53.35
Nilah,Khazix,213,116,97,54.46
Nilah,Brand,266,141,125,53.01
Nilah,Evelynn,260,109,151,41.92
Nilah,Leblanc,102,62,40,60.78
Nilah,Kayle,236,111,125,47.03
Nilah,Viktor,179,103,76,57.54
Nilah,Veigar,428,207,221,48.36
Nilah,Shyvana,106,52,54,49.06
Nilah,Orianna,185,102,83,55.14
Nilah,Ambessa,240,147,93,61.25
Nilah,Ornn,181,54,127,29.83
Nilah,Naafiri,189,86,103,45.5
Nilah,Riven,150,100,50,66.67
Nilah,Lulu,207,88,119,42.51
Nilah,Nocturne,337,145,192,43.03
Nilah,Malphite,289,144,145,49.83
Nilah,Trundle,276,122,154,44.2
Nilah,Sejuani,150,78,72,52
Nilah,Kennen,100,54,46,54
Nilah,Blitzcrank,241,153,88,63.49
Nilah,Annie,108,64,44,59.26
Nilah,Draven,161,90,71,55.9
Nilah,Taliyah,62,9,53,14.52
Nilah,Heimerdinger,165,56,109,33.94
Nilah,XinZhao,206,80,126,38.83
Nilah,Azir,116,47,69,40.52
Nilah,Braum,183,107,76,58.47
Nilah,Cassiopeia,117,70,47,59.83
Nilah,Hwei,285,176,109,61.75
Nilah,Vex,224,95,129,42.41
Nilah,Milio,149,70,79,46.98
Nilah,Gnar,143,76,67,53.15
Nilah,Nautilus,338,212,126,62.72
Nilah,Galio,238,92,146,38.66
Nilah,Shen,202,129,73,63.86
Nilah,Hecarim,86,61,25,70.93
Nilah,Varus,251,149,102,59.36
Nilah,JarvanIV,129,49,80,37.98
Nilah,Udyr,90,46,44,51.11
Nilah,Rengar,164,106,58,64.63
Nilah,Kled,72,29,43,40.28
Nilah,Lissandra,81,38,43,46.91
Nilah,Kalista,195,133,62,68.21
Nilah,KogMaw,66,40,26,60.61
Nilah,Sion,282,125,157,44.33
Nilah,Tryndamere,310,203,107,65.48
Nilah,Taric,65,28,37,43.08
Nilah,Talon,159,55,104,34.59
Nilah,Quinn,113,45,68,39.82
Nilah,Anivia,84,49,35,58.33
Nilah,TwistedFate,115,55,60,47.83
Nilah,Zeri,148,91,57,61.49
Nilah,Zyra,250,128,122,51.2
Nilah,Fizz,134,69,65,51.49
Nilah,Velkoz,237,76,161,32.07
Nilah,Sivir,117,62,55,52.99
Nilah,MonkeyKing,180,84,96,46.67
Nilah,Rakan,171,69,102,40.35
Nilah,Alistar,150,72,78,48
Nilah,Camille,111,72,39,64.86
Nilah,Jayce,159,90,69,56.6
Nilah,Graves,158,83,75,52.53
Nilah,Bard,112,41,71,36.61
Nilah,Janna,98,43,55,43.88
Nilah,Lillia,246,109,137,44.31
Nilah,Rell,211,89,122,42.18
Nilah,Ivern,60,36,24,60
Nilah,Urgot,151,58,93,38.41
Nilah,RekSai,47,34,13,72.34
Nilah,Rumble,47,16,31,34.04
Belveth,Mordekaiser,267,145,122,54.31
Belveth,Kindred,90,33,57,36.67
Belveth,Qiyana,66,31,35,46.97
Belveth,Ashe,300,140,160,46.67
Belveth,Sona,46,29,17,63.04
Belveth,Malphite,149,40,109,26.85
Belveth,Rengar,85,41,44,48.24
Belveth,Akali,164,67,97,40.85
Belveth,Rakan,100,49,51,49
Belveth,Sion,163,88,75,53.99
Belveth,Ahri,226,125,101,55.31
Belveth,Anivia,53,40,13,75.47
Belveth,Poppy,148,58,90,39.19
Belveth,Teemo,254,122,132,48.03
Belveth,Khazix,75,36,39,48
Belveth,Smolder,142,73,69,51.41
Belveth,MissFortune,370,167,203,45.14
Belveth,Rell,95,51,44,53.68
Belveth,Warwick,272,132,140,48.53
Belveth,Briar,228,125,103,54.82
Belveth,Nilah,89,36,53,40.45
Belveth,Morgana,221,111,110,50.23
Belveth,Aatrox,160,73,87,45.63
Belveth,Veigar,210,82,128,39.05
Belveth,Ezreal,361,193,168,53.46
Belveth,Karma,140,95,45,67.86
Belveth,Gwen,140,81,59,57.86
Belveth,Katarina,133,70,63,52.63
Belveth,Aphelios,162,96,66,59.26
Belveth,Alistar,48,12,36,25
Belveth,Vladimir,135,70,65,51.85
Belveth,Jhin,310,174,136,56.13
Belveth,Seraphine,164,66,98,40.24
Belveth,Urgot,79,48,31,60.76
Belveth,MasterYi,176,75,101,42.61
Belveth,Hwei,123,69,54,56.1
Belveth,Xayah,156,91,65,58.33
Belveth,Darius,263,119,144,45.25
Belveth,Evelynn,61,12,49,19.67
Belveth,Renekton,83,49,34,59.04
Belveth,Lux,447,205,242,45.86
Belveth,Jinx,332,131,201,39.46
Belveth,Caitlyn,356,166,190,46.63
Belveth,Nautilus,204,112,92,54.9
Belveth,Garen,284,135,149,47.54
Belveth,Shaco,175,103,72,58.86
Belveth,Yone,301,155,146,51.5
Belveth,Yorick,177,83,94,46.89
Belveth,Irelia,154,74,80,48.05
Belveth,Yasuo,390,208,182,53.33
Belveth,TahmKench,195,83,112,42.56
Belveth,Viego,246,157,89,63.82
Belveth,Pyke,203,135,68,66.5
Belveth,Ekko,86,58,28,67.44
Belveth,Vex,91,53,38,58.24
Belveth,Gangplank,94,47,47,50
Belveth,Yuumi,182,83,99,45.6
Belveth,Gragas,98,46,52,46.94
Belveth,Naafiri,81,47,34,58.02
Belveth,Kayle,138,64,74,46.38
Belveth,Graves,94,54,40,57.45
Belveth,Galio,95,45,50,47.37
Belveth,Tristana,126,62,64,49.21
Belveth,Lulu,143,66,77,46.15
Belveth,Kled,33,0,33,0
Belveth,Ivern,71,44,27,61.97
Belveth,Nasus,141,71,70,50.35
Belveth,Kaisa,270,131,139,48.52
Belveth,Elise,119,58,61,48.74
Belveth,Ryze,41,29,12,70.73
Belveth,Vayne,189,91,98,48.15
Belveth,XinZhao,110,43,67,39.09
Belveth,Kayn,238,117,121,49.16
Belveth,Taric,55,19,36,34.55
Belveth,Amumu,198,90,108,45.45
Belveth,Annie,35,17,18,48.57
Belveth,Leona,144,68,76,47.22
Belveth,Lissandra,40,11,29,27.5
Belveth,Vi,92,38,54,41.3
Belveth,Draven,71,52,19,73.24
Belveth,Braum,95,29,66,30.53
Belveth,Udyr,58,27,31,46.55
Belveth,Kennen,62,47,15,75.81
Belveth,Nunu,163,103,60,63.19
Belveth,Leblanc,73,34,39,46.58
Belveth,Zilean,60,25,35,41.67
Belveth,Skarner,77,51,26,66.23
Belveth,Orianna,57,35,22,61.4
Belveth,Cassiopeia,76,54,22,71.05
Belveth,Renata,83,38,45,45.78
Belveth,Jax,115,57,58,49.57
Belveth,Mel,366,225,141,61.48
Belveth,Camille,41,25,16,60.98
Belveth,Pantheon,329,154,175,46.81
Belveth,Shen,120,50,70,41.67
Belveth,Chogath,244,147,97,60.25
Belveth,Quinn,52,25,27,48.08
Belveth,Rammus,79,46,33,58.23
Belveth,Sett,324,123,201,37.96
Belveth,RekSai,35,25,10,71.43
Belveth,Varus,137,82,55,59.85
Belveth,DrMundo,122,81,41,66.39
Belveth,Hecarim,54,33,21,61.11
Belveth,Sylas,163,72,91,44.17
Belveth,Brand,152,56,96,36.84
Belveth,Sejuani,50,37,13,74
Belveth,Sivir,75,33,42,44
Belveth,Nami,181,93,88,51.38
Belveth,Nidalee,49,28,21,57.14
Belveth,Samira,188,79,109,42.02
Belveth,Heimerdinger,101,35,66,34.65
Belveth,KSante,73,48,25,65.75
Belveth,Zeri,65,45,20,69.23
Belveth,Fizz,72,28,44,38.89
Belveth,Zed,118,69,49,58.47
Belveth,Thresh,222,105,117,47.3
Belveth,Tryndamere,104,44,60,42.31
Belveth,Zyra,130,61,69,46.92
Belveth,Bard,30,20,10,66.67
Belveth,Kalista,119,59,60,49.58
Belveth,Swain,171,68,103,39.77
Belveth,LeeSin,136,89,47,65.44
Belveth,Ziggs,68,32,36,47.06
Belveth,Ambessa,151,82,69,54.3
Belveth,Aurora,133,55,78,41.35
Belveth,Singed,45,29,16,64.44
Belveth,Lillia,88,34,54,38.64
Belveth,Soraka,107,64,43,59.81
Belveth,Azir,50,3,47,6
Belveth,Velkoz,110,61,49,55.45
Belveth,Illaoi,108,47,61,43.52
Belveth,Volibear,193,113,80,58.55
Belveth,Diana,221,98,123,44.34
Belveth,KogMaw,57,9,48,15.79
Belveth,Lucian,82,64,18,78.05
Belveth,Maokai,50,23,27,46
Belveth,Talon,102,34,68,33.33
Belveth,Milio,92,64,28,69.57
Belveth,Fiora,121,70,51,57.85
Belveth,MonkeyKing,96,46,50,47.92
Belveth,Kassadin,18,10,8,55.56
Belveth,TwistedFate,65,36,29,55.38
Belveth,Syndra,97,42,55,43.3
Belveth,Janna,57,26,31,45.61
Belveth,Corki,106,63,43,59.43
Belveth,Neeko,116,73,43,62.93
Belveth,Senna,158,70,88,44.3
Belveth,AurelionSol,63,34,29,53.97
Belveth,FiddleSticks,110,51,59,46.36
Belveth,Shyvana,53,18,35,33.96
Belveth,Riven,62,40,22,64.52
Belveth,Twitch,136,81,55,59.56
Belveth,Gnar,51,22,29,43.14
Belveth,Malzahar,151,27,124,17.88
Belveth,Rumble,30,10,20,33.33
Belveth,Nocturne,177,60,117,33.9
Belveth,Xerath,109,59,50,54.13
Belveth,Karthus,44,19,25,43.18
Belveth,Olaf,38,20,18,52.63
Belveth,Viktor,106,44,62,41.51
Belveth,Akshan,101,69,32,68.32
Belveth,Jayce,50,39,11,78
Belveth,Trundle,101,33,68,32.67
Belveth,Blitzcrank,113,59,54,52.21
Belveth,Ornn,65,40,25,61.54
Belveth,Zoe,66,44,22,66.67
Belveth,Zac,51,20,31,39.22
Belveth,JarvanIV,20,14,6,70
Belveth,Taliyah,20,14,6,70
Sona,Fiora,95,46,49,48.42
Sona,Belveth,46,17,29,36.96
Sona,Sylas,226,104,122,46.02
Sona,Ezreal,408,255,153,62.5
Sona,Yuumi,276,142,134,51.45
Sona,Trundle,156,72,84,46.15
Sona,MasterYi,239,147,92,61.51
Sona,Veigar,244,134,110,54.92
Sona,Jhin,342,203,139,59.36
Sona,Soraka,162,73,89,45.06
Sona,Yorick,211,79,132,37.44
Sona,LeeSin,159,107,52,67.3
Sona,Yone,449,256,193,57.02
Sona,MissFortune,510,208,302,40.78
Sona,Mel,594,310,284,52.19
Sona,Ornn,78,21,57,26.92
Sona,Udyr,79,27,52,34.18
Sona,Lux,649,311,338,47.92
Sona,Milio,143,57,86,39.86
Sona,Urgot,149,80,69,53.69
Sona,Kayn,371,198,173,53.37
Sona,Yasuo,437,233,204,53.32
Sona,Twitch,184,101,83,54.89
Sona,Neeko,199,141,58,70.85
Sona,Tryndamere,182,136,46,74.73
Sona,Gragas,90,28,62,31.11
Sona,Irelia,218,98,120,44.95
Sona,Kalista,94,68,26,72.34
Sona,Teemo,402,179,223,44.53
Sona,Leblanc,85,59,26,69.41
Sona,Elise,190,124,66,65.26
Sona,Rammus,53,23,30,43.4
Sona,Fizz,118,49,69,41.53
Sona,DrMundo,132,70,62,53.03
Sona,TahmKench,265,119,146,44.91
Sona,Vladimir,119,66,53,55.46
Sona,Ashe,498,284,214,57.03
Sona,Swain,311,170,141,54.66
Sona,Riven,127,73,54,57.48
Sona,Shaco,264,127,137,48.11
Sona,Ekko,225,118,107,52.44
Sona,Thresh,277,133,144,48.01
Sona,Aatrox,187,105,82,56.15
Sona,Nocturne,230,107,123,46.52
Sona,Aphelios,172,116,56,67.44
Sona,Nautilus,255,161,94,63.14
Sona,Sett,376,191,185,50.8
Sona,Katarina,221,112,109,50.68
Sona,Morgana,374,188,186,50.27
Sona,Diana,321,176,145,54.83
Sona,Briar,270,153,117,56.67
Sona,Pantheon,425,256,169,60.24
Sona,Caitlyn,540,299,241,55.37
Sona,Rumble,29,20,9,68.97
Sona,Malphite,245,125,120,51.02
Sona,Lulu,168,100,68,59.52
Sona,Ambessa,133,53,80,39.85
Sona,Maokai,50,15,35,30
Sona,Gwen,155,74,81,47.74
Sona,Lillia,234,122,112,52.14
Sona,Vayne,218,100,118,45.87
Sona,Velkoz,164,66,98,40.24
Sona,Nilah,133,70,63,52.63
Sona,Sejuani,75,38,37,50.67
Sona,Malzahar,173,117,56,67.63
Sona,Jinx,438,200,238,45.66
Sona,Smolder,142,74,68,52.11
Sona,Mordekaiser,392,196,196,50
Sona,Gnar,105,48,57,45.71
Sona,Kindred,171,90,81,52.63
Sona,Lucian,138,68,70,49.28
Sona,Warwick,398,199,199,50
Sona,TwistedFate,69,23,46,33.33
Sona,Akali,288,134,154,46.53
Sona,Taliyah,55,39,16,70.91
Sona,Hwei,128,59,69,46.09
Sona,Khazix,175,94,81,53.71
Sona,Ahri,318,158,160,49.69
Sona,Illaoi,141,78,63,55.32
Sona,Darius,444,219,225,49.32
Sona,Xayah,141,70,71,49.65
Sona,Rakan,120,60,60,50
Sona,Gangplank,99,57,42,57.58
Sona,Volibear,210,96,114,45.71
Sona,Syndra,92,32,60,34.78
Sona,Nidalee,66,43,23,65.15
Sona,Vex,191,103,88,53.93
Sona,Samira,222,114,108,51.35
Sona,Nunu,179,104,75,58.1
Sona,Cassiopeia,123,78,45,63.41
Sona,Karma,186,116,70,62.37
Sona,Xerath,168,72,96,42.86
Sona,Evelynn,129,77,52,59.69
Sona,Zed,240,157,83,65.42
Sona,JarvanIV,92,49,43,53.26
Sona,Zyra,182,75,107,41.21
Sona,Amumu,185,59,126,31.89
Sona,Heimerdinger,174,100,74,57.47
Sona,Seraphine,280,151,129,53.93
Sona,Viego,258,103,155,39.92
Sona,Nami,226,81,145,35.84
Sona,Kled,49,19,30,38.78
Sona,Rengar,84,54,30,64.29
Sona,Viktor,161,99,62,61.49
Sona,Tristana,168,103,65,61.31
Sona,Galio,141,76,65,53.9
Sona,KSante,76,57,19,75
Sona,Jax,210,110,100,52.38
Sona,Sion,132,68,64,51.52
Sona,FiddleSticks,118,68,50,57.63
Sona,Varus,189,82,107,43.39
Sona,Aurora,200,105,95,52.5
Sona,Brand,122,61,61,50
Sona,Kayle,207,100,107,48.31
Sona,Alistar,68,43,25,63.24
Sona,Camille,63,51,12,80.95
Sona,Naafiri,148,83,65,56.08
Sona,Blitzcrank,118,65,53,55.08
Sona,Rell,98,49,49,50
Sona,Ziggs,108,69,39,63.89
Sona,Zac,74,27,47,36.49
Sona,Renekton,86,46,40,53.49
Sona,Azir,61,30,31,49.18
Sona,Kaisa,334,179,155,53.59
Sona,Renata,50,15,35,30
Sona,Shen,155,80,75,51.61
Sona,Leona,185,81,104,43.78
Sona,Senna,238,114,124,47.9
Sona,KogMaw,113,48,65,42.48
Sona,Karthus,73,39,34,53.42
Sona,Graves,120,67,53,55.83
Sona,Chogath,275,142,133,51.64
Sona,Draven,144,106,38,73.61
Sona,Annie,69,25,44,36.23
Sona,Ivern,65,25,40,38.46
Sona,AurelionSol,97,64,33,65.98
Sona,Kassadin,51,39,12,76.47
Sona,Kennen,107,67,40,62.62
Sona,Talon,149,87,62,58.39
Sona,Poppy,143,90,53,62.94
Sona,XinZhao,109,48,61,44.04
Sona,MonkeyKing,121,54,67,44.63
Sona,Orianna,88,48,40,54.55
Sona,Bard,87,47,40,54.02
Sona,Zeri,68,50,18,73.53
Sona,Pyke,246,171,75,69.51
Sona,Quinn,50,32,18,64
Sona,Skarner,77,36,41,46.75
Sona,Nasus,166,58,108,34.94
Sona,Ryze,51,21,30,41.18
Sona,Lissandra,32,14,18,43.75
Sona,Braum,81,60,21,74.07
Sona,Akshan,69,18,51,26.09
Sona,Anivia,67,43,24,64.18
Sona,Garen,328,152,176,46.34
Sona,Olaf,51,42,9,82.35
Sona,Qiyana,65,36,29,55.38
Sona,Sivir,123,44,79,35.77
Sona,Zilean,71,29,42,40.85
Sona,Corki,75,40,35,53.33
Sona,Vi,136,76,60,55.88
Sona,Jayce,109,69,40,63.3
Sona,Hecarim,82,34,48,41.46
Sona,Janna,65,39,26,60
Sona,Taric,42,35,7,83.33
Sona,Zoe,70,38,32,54.29
Sona,RekSai,33,30,3,90.91
Sona,Shyvana,74,36,38,48.65
Sona,Singed,31,16,15,51.61
Ivern,Yorick,151,78,73,51.66
Ivern,Viego,145,46,99,31.72
Ivern,Diana,157,81,76,51.59
Ivern,Seraphine,105,48,57,45.71
Ivern,Rakan,59,11,48,18.64
Ivern,Riven,87,36,51,41.38
Ivern,Kayn,190,89,101,46.84
Ivern,Ahri,131,49,82,37.4
Ivern,Jinx,239,113,126,47.28
Ivern,Nautilus,171,88,83,51.46
Ivern,Akshan,75,33,42,44
Ivern,FiddleSticks,78,50,28,64.1
Ivern,Samira,113,59,54,52.21
Ivern,Pyke,136,84,52,61.76
Ivern,Shen,93,50,43,53.76
Ivern,Gragas,97,45,52,46.39
Ivern,Yone,204,99,105,48.53
Ivern,Ashe,290,124,166,42.76
Ivern,Alistar,46,33,13,71.74
Ivern,Chogath,212,101,111,47.64
Ivern,Shaco,139,56,83,40.29
Ivern,Poppy,92,42,50,45.65
Ivern,Garen,210,114,96,54.29
Ivern,Rammus,50,20,30,40
Ivern,Soraka,100,35,65,35
Ivern,TahmKench,151,82,69,54.3
Ivern,Zac,48,27,21,56.25
Ivern,XinZhao,80,34,46,42.5
Ivern,Akali,201,97,104,48.26
Ivern,Caitlyn,287,140,147,48.78
Ivern,Maokai,75,47,28,62.67
Ivern,Tryndamere,40,22,18,55
Ivern,Nidalee,33,23,10,69.7
Ivern,Aurora,118,51,67,43.22
Ivern,MissFortune,282,135,147,47.87
Ivern,Nami,149,80,69,53.69
Ivern,Heimerdinger,72,21,51,29.17
Ivern,Viktor,131,65,66,49.62
Ivern,Yasuo,294,140,154,47.62
Ivern,Lulu,105,41,64,39.05
Ivern,Warwick,185,81,104,43.78
Ivern,Mel,263,109,154,41.44
Ivern,Quinn,38,21,17,55.26
Ivern,Teemo,181,64,117,35.36
Ivern,Sett,240,127,113,52.92
Ivern,Lux,336,170,166,50.6
Ivern,Pantheon,174,91,83,52.3
Ivern,Nocturne,115,62,53,53.91
Ivern,Sylas,130,86,44,66.15
Ivern,Aatrox,108,32,76,29.63
Ivern,Vex,75,41,34,54.67
Ivern,Nasus,85,29,56,34.12
Ivern,Briar,72,31,41,43.06
Ivern,Ekko,117,39,78,33.33
Ivern,Zeri,48,18,30,37.5
Ivern,Xerath,83,22,61,26.51
Ivern,Olaf,20,3,17,15
Ivern,Nunu,131,39,92,29.77
Ivern,Thresh,187,66,121,35.29
Ivern,Skarner,48,12,36,25
Ivern,Fiora,44,27,17,61.36
Ivern,Mordekaiser,180,77,103,42.78
Ivern,Veigar,123,37,86,30.08
Ivern,Elise,67,30,37,44.78
Ivern,Lucian,84,37,47,44.05
Ivern,Senna,114,62,52,54.39
Ivern,Kindred,59,28,31,47.46
Ivern,Blitzcrank,89,32,57,35.96
Ivern,Annie,54,37,17,68.52
Ivern,Bard,39,19,20,48.72
Ivern,MasterYi,150,65,85,43.33
Ivern,Swain,119,49,70,41.18
Ivern,Ambessa,112,42,70,37.5
Ivern,Katarina,101,61,40,60.4
Ivern,Braum,111,30,81,27.03
Ivern,MonkeyKing,89,50,39,56.18
Ivern,Khazix,57,23,34,40.35
Ivern,Jax,47,23,24,48.94
Ivern,Karthus,33,18,15,54.55
Ivern,Malphite,95,43,52,45.26
Ivern,Vi,131,51,80,38.93
Ivern,Smolder,116,44,72,37.93
Ivern,Belveth,71,27,44,38.03
Ivern,Kassadin,37,9,28,24.32
Ivern,Lissandra,36,17,19,47.22
Ivern,Zed,188,118,70,62.77
Ivern,Brand,92,52,40,56.52
Ivern,Varus,116,77,39,66.38
Ivern,Gnar,52,28,24,53.85
Ivern,Gwen,78,47,31,60.26
Ivern,Vladimir,107,41,66,38.32
Ivern,Kaisa,190,98,92,51.58
Ivern,Kayle,62,28,34,45.16
Ivern,Rengar,70,38,32,54.29
Ivern,Ezreal,258,145,113,56.2
Ivern,Illaoi,71,29,42,40.85
Ivern,Evelynn,58,25,33,43.1
Ivern,Gangplank,48,15,33,31.25
Ivern,Orianna,60,28,32,46.67
Ivern,Sivir,100,48,52,48
Ivern,Karma,102,43,59,42.16
Ivern,Irelia,129,63,66,48.84
Ivern,Urgot,77,29,48,37.66
Ivern,Rumble,45,30,15,66.67
Ivern,Syndra,58,44,14,75.86
Ivern,Milio,108,39,69,36.11
Ivern,Camille,40,13,27,32.5
Ivern,Ziggs,65,45,20,69.23
Ivern,Corki,43,6,37,13.95
Ivern,Ryze,38,22,16,57.89
Ivern,Jhin,250,87,163,34.8
Ivern,Sona,65,40,25,61.54
Ivern,KogMaw,56,24,32,42.86
Ivern,Darius,309,139,170,44.98
Ivern,Leblanc,33,13,20,39.39
Ivern,Draven,103,55,48,53.4
Ivern,Aphelios,112,62,50,55.36
Ivern,KSante,64,48,16,75
Ivern,Sion,90,39,51,43.33
Ivern,Neeko,71,42,29,59.15
Ivern,Qiyana,64,27,37,42.19
Ivern,Twitch,97,48,49,49.48
Ivern,Cassiopeia,47,26,21,55.32
Ivern,Xayah,106,35,71,33.02
Ivern,Hwei,103,33,70,32.04
Ivern,Zyra,103,35,68,33.98
Ivern,Hecarim,29,23,6,79.31
Ivern,Galio,98,43,55,43.88
Ivern,LeeSin,124,54,70,43.55
Ivern,Vayne,138,57,81,41.3
Ivern,Graves,103,69,34,66.99
Ivern,Zoe,65,31,34,47.69
Ivern,Lillia,81,49,32,60.49
Ivern,Morgana,156,78,78,50
Ivern,DrMundo,105,50,55,47.62
Ivern,Malzahar,83,30,53,36.14
Ivern,Rell,103,54,49,52.43
Ivern,Amumu,128,81,47,63.28
Ivern,Volibear,155,78,77,50.32
Ivern,Taliyah,25,14,11,56
Ivern,Talon,87,41,46,47.13
Ivern,Ornn,44,32,12,72.73
Ivern,Fizz,67,25,42,37.31
Ivern,Trundle,57,28,29,49.12
Ivern,Azir,42,16,26,38.1
Ivern,Nilah,60,24,36,40
Ivern,Kled,33,10,23,30.3
Ivern,Kennen,66,32,34,48.48
Ivern,Velkoz,114,56,58,49.12
Ivern,Udyr,44,19,25,43.18
Ivern,Tristana,105,42,63,40
Ivern,TwistedFate,50,39,11,78
Ivern,RekSai,31,9,22,29.03
Ivern,Jayce,82,42,40,51.22
Ivern,Leona,89,72,17,80.9
Ivern,Shyvana,45,22,23,48.89
Ivern,AurelionSol,81,29,52,35.8
Ivern,Renekton,65,31,34,47.69
Ivern,Sejuani,53,17,36,32.08
Ivern,Yuumi,115,49,66,42.61
Ivern,JarvanIV,63,41,22,65.08
Ivern,Janna,33,12,21,36.36
Ivern,Zilean,27,3,24,11.11
Ivern,Anivia,39,31,8,79.49
Ivern,Kalista,68,43,25,63.24
Ivern,Singed,29,18,11,62.07
Ivern,Naafiri,50,6,44,12
Ivern,Renata,23,15,8,65.22
Ivern,Taric,17,6,11,35.29
Veigar,Yorick,728,314,414,43.13
Veigar,Viego,975,506,469,51.9
Veigar,Diana,1021,485,536,47.5
Veigar,Seraphine,708,383,325,54.1
Veigar,Rakan,381,181,200,47.51
Veigar,FiddleSticks,327,148,179,45.26
Veigar,Draven,403,218,185,54.09
Veigar,Smolder,545,308,237,56.51
Veigar,Nautilus,804,444,360,55.22
Veigar,Kayn,1102,599,503,54.36
Veigar,Zed,677,325,352,48.01
Veigar,Sona,244,110,134,45.08
Veigar,Kaisa,968,515,453,53.2
Veigar,Amumu,744,359,385,48.25
Veigar,Warwick,1168,561,607,48.03
Veigar,Evelynn,342,229,113,66.96
Veigar,Ahri,1082,580,502,53.6
Veigar,Yasuo,1249,615,634,49.24
Veigar,Yone,1369,714,655,52.15
Veigar,Sylas,811,393,418,48.46
Veigar,Caitlyn,1673,864,809,51.64
Veigar,MasterYi,790,436,354,55.19
Veigar,Rell,396,208,188,52.53
Veigar,Darius,1269,649,620,51.14
Veigar,Volibear,748,347,401,46.39
Veigar,AurelionSol,369,172,197,46.61
Veigar,TahmKench,883,435,448,49.26
Veigar,Garen,1015,504,511,49.66
Veigar,Tristana,663,336,327,50.68
Veigar,Lux,1989,1009,980,50.73
Veigar,Morgana,960,517,443,53.85
Veigar,Tryndamere,419,195,224,46.54
Veigar,Graves,353,229,124,64.87
Veigar,MissFortune,1495,751,744,50.23
Veigar,Leona,565,282,283,49.91
Veigar,Teemo,1082,542,540,50.09
Veigar,Trundle,364,186,178,51.1
Veigar,Mel,1309,632,677,48.28
Veigar,Leblanc,257,134,123,52.14
Veigar,Elise,469,266,203,56.72
Veigar,Fizz,430,234,196,54.42
Veigar,Pantheon,1130,654,476,57.88
Veigar,Sion,495,281,214,56.77
Veigar,Ezreal,1113,618,495,55.53
Veigar,Nami,621,301,320,48.47
Veigar,Gnar,233,107,126,45.92
Veigar,Malzahar,526,235,291,44.68
Veigar,Brand,532,251,281,47.18
Veigar,Illaoi,353,178,175,50.42
Veigar,Velkoz,451,179,272,39.69
Veigar,Samira,709,359,350,50.63
Veigar,Orianna,337,210,127,62.31
Veigar,Malphite,582,311,271,53.44
Veigar,Akali,713,370,343,51.89
Veigar,Shaco,632,392,240,62.03
Veigar,Irelia,626,305,321,48.72
Veigar,Aatrox,677,340,337,50.22
Veigar,Briar,658,355,303,53.95
Veigar,Jinx,1460,741,719,50.75
Veigar,Nasus,507,244,263,48.13
Veigar,Nocturne,602,293,309,48.67
Veigar,Aurora,614,342,272,55.7
Veigar,Neeko,537,262,275,48.79
Veigar,Heimerdinger,454,242,212,53.3
Veigar,Sett,1037,530,507,51.11
Veigar,Vex,446,250,196,56.05
Veigar,Jhin,1210,577,633,47.69
Veigar,Senna,648,354,294,54.63
Veigar,TwistedFate,209,108,101,51.67
Veigar,Annie,225,129,96,57.33
Veigar,Chogath,944,463,481,49.05
Veigar,Talon,406,242,164,59.61
Veigar,Maokai,262,132,130,50.38
Veigar,Gwen,412,261,151,63.35
Veigar,Katarina,693,415,278,59.88
Veigar,XinZhao,387,182,205,47.03
Veigar,Aphelios,472,242,230,51.27
Veigar,Braum,339,145,194,42.77
Veigar,Mordekaiser,1156,626,530,54.15
Veigar,Jax,636,288,348,45.28
Veigar,Swain,791,390,401,49.3
Veigar,Janna,179,100,79,55.87
Veigar,Bard,286,159,127,55.59
Veigar,Lillia,439,216,223,49.2
Veigar,Pyke,806,491,315,60.92
Veigar,Ashe,1180,614,566,52.03
Veigar,Vladimir,341,203,138,59.53
Veigar,Thresh,858,476,382,55.48
Veigar,Naafiri,316,188,128,59.49
Veigar,Syndra,366,206,160,56.28
Veigar,Fiora,359,220,139,61.28
Veigar,Sivir,314,157,157,50
Veigar,Hwei,562,258,304,45.91
Veigar,Ryze,172,74,98,43.02
Veigar,Belveth,210,128,82,60.95
Veigar,Gragas,419,248,171,59.19
Veigar,Ekko,539,278,261,51.58
Veigar,Shyvana,155,76,79,49.03
Veigar,Taric,151,46,105,30.46
Veigar,Singed,148,67,81,45.27
Veigar,Milio,357,211,146,59.1
Veigar,Kayle,511,271,240,53.03
Veigar,Poppy,345,179,166,51.88
Veigar,Varus,489,286,203,58.49
Veigar,Skarner,205,116,89,56.59
Veigar,Gangplank,263,137,126,52.09
Veigar,RekSai,94,24,70,25.53
Veigar,Ivern,123,86,37,69.92
Veigar,JarvanIV,234,76,158,32.48
Veigar,KSante,232,159,73,68.53
Veigar,Rengar,279,147,132,52.69
Veigar,Nunu,660,328,332,49.7
Veigar,Twitch,578,331,247,57.27
Veigar,Karma,396,174,222,43.94
Veigar,Vi,570,300,270,52.63
Veigar,Vayne,643,356,287,55.37
Veigar,Soraka,420,201,219,47.86
Veigar,Ornn,261,154,107,59
Veigar,LeeSin,673,405,268,60.18
Veigar,Zac,230,95,135,41.3
Veigar,Renekton,344,156,188,45.35
Veigar,Zilean,201,90,111,44.78
Veigar,Jayce,226,127,99,56.19
Veigar,Ziggs,331,137,194,41.39
Veigar,Yuumi,614,381,233,62.05
Veigar,Nidalee,133,65,68,48.87
Veigar,Kindred,446,260,186,58.3
Veigar,Ambessa,407,217,190,53.32
Veigar,Qiyana,211,121,90,57.35
Veigar,Taliyah,187,119,68,63.64
Veigar,Khazix,401,222,179,55.36
Veigar,Nilah,428,221,207,51.64
Veigar,Viktor,561,342,219,60.96
Veigar,Kled,146,65,81,44.52
Veigar,DrMundo,400,214,186,53.5
Veigar,Azir,232,119,113,51.29
Veigar,Anivia,216,93,123,43.06
Veigar,Sejuani,215,118,97,54.88
Veigar,Kassadin,151,63,88,41.72
Veigar,Akshan,280,164,116,58.57
Veigar,Blitzcrank,543,283,260,52.12
Veigar,Riven,274,178,96,64.96
Veigar,Kennen,332,189,143,56.93
Veigar,Xayah,474,263,211,55.49
Veigar,Alistar,200,84,116,42
Veigar,Corki,226,103,123,45.58
Veigar,KogMaw,195,112,83,57.44
Veigar,Shen,533,324,209,60.79
Veigar,Galio,495,274,221,55.35
Veigar,Karthus,161,75,86,46.58
Veigar,MonkeyKing,369,175,194,47.43
Veigar,Lulu,495,251,244,50.71
Veigar,Udyr,253,138,115,54.55
Veigar,Urgot,319,153,166,47.96
Veigar,Quinn,174,90,84,51.72
Veigar,Renata,170,91,79,53.53
Veigar,Kalista,400,250,150,62.5
Veigar,Zyra,448,236,212,52.68
Veigar,Olaf,128,68,60,53.13
Veigar,Zoe,452,235,217,51.99
Veigar,Xerath,584,305,279,52.23
Veigar,Lucian,402,246,156,61.19
Veigar,Rammus,186,88,98,47.31
Veigar,Lissandra,139,65,74,46.76
Veigar,Cassiopeia,256,143,113,55.86
Veigar,Hecarim,254,170,84,66.93
Veigar,Zeri,286,173,113,60.49
Veigar,Rumble,82,43,39,52.44
Veigar,Camille,176,91,85,51.7
Jinx,Yorick,1070,479,591,44.77
Jinx,Viego,1594,837,757,52.51
Jinx,Diana,1564,815,749,52.11
Jinx,Seraphine,1386,679,707,48.99
Jinx,Rakan,701,373,328,53.21
Jinx,Fiora,643,333,310,51.79
Jinx,Lillia,858,487,371,56.76
Jinx,Aurora,1082,587,495,54.25
Jinx,Zeri,559,326,233,58.32
Jinx,Teemo,1764,808,956,45.8
Jinx,MonkeyKing,698,335,363,47.99
Jinx,Malzahar,1052,524,528,49.81
Jinx,Caitlyn,3402,1719,1683,50.53
Jinx,Morgana,1911,862,1049,45.11
Jinx,Naafiri,617,295,322,47.81
Jinx,Briar,1365,726,639,53.19
Jinx,Yone,2340,1290,1050,55.13
Jinx,MissFortune,3131,1581,1550,50.5
Jinx,Senna,1085,557,528,51.34
Jinx,Gangplank,623,299,324,47.99
Jinx,Ivern,239,126,113,52.72
Jinx,Mel,2728,1374,1354,50.37
Jinx,Jhin,2434,1228,1206,50.45
Jinx,Swain,1339,655,684,48.92
Jinx,Vayne,1383,792,591,57.27
Jinx,Nocturne,1184,541,643,45.69
Jinx,Kaisa,1908,1021,887,53.51
Jinx,Galio,862,464,398,53.83
Jinx,Blitzcrank,1029,579,450,56.27
Jinx,Garen,1737,834,903,48.01
Jinx,Kayn,1957,959,998,49
Jinx,Lux,3323,1635,1688,49.2
Jinx,Thresh,1534,763,771,49.74
Jinx,Illaoi,700,361,339,51.57
Jinx,Aatrox,1282,680,602,53.04
Jinx,Ashe,2736,1406,1330,51.39
Jinx,Aphelios,997,533,464,53.46
Jinx,Gragas,708,372,336,52.54
Jinx,Gwen,851,456,395,53.58
Jinx,Yasuo,2318,1156,1162,49.87
Jinx,Bard,392,198,194,50.51
Jinx,Vladimir,607,325,282,53.54
Jinx,Shaco,983,562,421,57.17
Jinx,Tryndamere,685,366,319,53.43
Jinx,Ezreal,2232,1180,1052,52.87
Jinx,Milio,590,347,243,58.81
Jinx,Jax,980,461,519,47.04
Jinx,Talon,726,396,330,54.55
Jinx,Leblanc,488,279,209,57.17
Jinx,Yuumi,1244,666,578,53.54
Jinx,Malphite,966,469,497,48.55
Jinx,Neeko,952,497,455,52.21
Jinx,Xayah,957,527,430,55.07
Jinx,Heimerdinger,732,386,346,52.73
Jinx,Kindred,695,366,329,52.66
Jinx,Katarina,1011,571,440,56.48
Jinx,Janna,397,175,222,44.08
Jinx,Lissandra,332,184,148,55.42
Jinx,Darius,2260,1198,1062,53.01
Jinx,Sejuani,401,182,219,45.39
Jinx,Rell,522,315,207,60.34
Jinx,Amumu,1327,597,730,44.99
Jinx,KogMaw,450,201,249,44.67
Jinx,FiddleSticks,618,344,274,55.66
Jinx,Soraka,826,403,423,48.79
Jinx,Mordekaiser,1946,898,1048,46.15
Jinx,Zed,1147,653,494,56.93
Jinx,Vex,812,436,376,53.69
Jinx,Samira,1395,757,638,54.27
Jinx,Viktor,825,390,435,47.27
Jinx,Nilah,684,350,334,51.17
Jinx,Akali,1362,718,644,52.72
Jinx,Tristana,1143,530,613,46.37
Jinx,Evelynn,724,434,290,59.94
Jinx,Kalista,537,292,245,54.38
Jinx,Renata,297,136,161,45.79
Jinx,Chogath,1650,924,726,56
Jinx,Azir,398,210,188,52.76
Jinx,Sylas,1151,581,570,50.48
Jinx,Lucian,727,389,338,53.51
Jinx,MasterYi,1347,646,701,47.96
Jinx,Taric,283,113,170,39.93
Jinx,XinZhao,588,312,276,53.06
Jinx,Braum,517,280,237,54.16
Jinx,Annie,306,155,151,50.65
Jinx,Alistar,424,241,183,56.84
Jinx,Pantheon,2154,1202,952,55.8
Jinx,Khazix,737,436,301,59.16
Jinx,Smolder,1109,613,496,55.28
Jinx,Sett,2117,1045,1072,49.36
Jinx,Ekko,973,532,441,54.68
Jinx,Veigar,1460,719,741,49.25
Jinx,Nasus,988,511,477,51.72
Jinx,Zoe,639,385,254,60.25
Jinx,Jayce,554,308,246,55.6
Jinx,Rammus,330,181,149,54.85
Jinx,Sion,939,464,475,49.41
Jinx,Kayle,914,466,448,50.98
Jinx,Lulu,881,456,425,51.76
Jinx,Udyr,506,268,238,52.96
Jinx,TahmKench,1364,625,739,45.82
Jinx,Shyvana,408,212,196,51.96
Jinx,Taliyah,346,176,170,50.87
Jinx,Ziggs,630,302,328,47.94
Jinx,LeeSin,1211,655,556,54.09
Jinx,Pyke,1515,808,707,53.33
Jinx,Irelia,1179,583,596,49.45
Jinx,Velkoz,762,373,389,48.95
Jinx,Ahri,1657,834,823,50.33
Jinx,Rengar,521,289,232,55.47
Jinx,Hwei,867,478,389,55.13
Jinx,Sivir,609,271,338,44.5
Jinx,Vi,1048,523,525,49.9
Jinx,DrMundo,769,392,377,50.98
Jinx,Twitch,1154,587,567,50.87
Jinx,Ryze,318,161,157,50.63
Jinx,Nautilus,1356,683,673,50.37
Jinx,Olaf,275,129,146,46.91
Jinx,Orianna,636,347,289,54.56
Jinx,Urgot,582,306,276,52.58
Jinx,Hecarim,460,249,211,54.13
Jinx,Xerath,890,455,435,51.12
Jinx,Nunu,998,494,504,49.5
Jinx,Syndra,599,293,306,48.91
Jinx,Maokai,499,220,279,44.09
Jinx,Akshan,484,223,261,46.07
Jinx,Zyra,852,407,445,47.77
Jinx,Warwick,2077,1082,995,52.09
Jinx,Karthus,364,193,171,53.02
Jinx,Gnar,591,315,276,53.3
Jinx,Nami,1071,579,492,54.06
Jinx,Trundle,676,319,357,47.19
Jinx,RekSai,205,92,113,44.88
Jinx,Graves,701,364,337,51.93
Jinx,KSante,501,281,220,56.09
Jinx,Sona,438,238,200,54.34
Jinx,Cassiopeia,439,275,164,62.64
Jinx,Qiyana,536,291,245,54.29
Jinx,Varus,1026,538,488,52.44
Jinx,Singed,274,138,136,50.36
Jinx,Riven,525,323,202,61.52
Jinx,TwistedFate,357,184,173,51.54
Jinx,Shen,862,451,411,52.32
Jinx,Ornn,528,243,285,46.02
Jinx,Karma,795,452,343,56.86
Jinx,Kled,234,106,128,45.3
Jinx,Renekton,496,236,260,47.58
Jinx,Volibear,1327,677,650,51.02
Jinx,Belveth,332,201,131,60.54
Jinx,AurelionSol,574,285,289,49.65
Jinx,Brand,788,411,377,52.16
Jinx,Nidalee,316,206,110,65.19
Jinx,Camille,381,194,187,50.92
Jinx,Leona,895,451,444,50.39
Jinx,Poppy,713,348,365,48.81
Jinx,Kassadin,301,117,184,38.87
Jinx,Draven,682,342,340,50.15
Jinx,Ambessa,774,377,397,48.71
Jinx,Zilean,378,193,185,51.06
Jinx,Elise,682,383,299,56.16
Jinx,Zac,447,202,245,45.19
Jinx,Kennen,464,221,243,47.63
Jinx,Corki,325,205,120,63.08
Jinx,Skarner,383,240,143,62.66
Jinx,Anivia,316,173,143,54.75
Jinx,JarvanIV,513,261,252,50.88
Jinx,Fizz,580,267,313,46.03
Jinx,Quinn,412,210,202,50.97
Jinx,Rumble,281,123,158,43.77
Yorick,Sett,832,460,372,55.29
Yorick,Ivern,151,73,78,48.34
Yorick,Veigar,728,414,314,56.87
Yorick,Jinx,1070,591,479,55.23
Yorick,Lulu,415,253,162,60.96
Yorick,Teemo,883,451,432,51.08
Yorick,MonkeyKing,306,171,135,55.88
Yorick,Malzahar,424,229,195,54.01
Yorick,Caitlyn,1467,890,577,60.67
Yorick,Morgana,660,357,303,54.09
Yorick,Aatrox,565,353,212,62.48
Yorick,Brand,441,211,230,47.85
Yorick,Irelia,542,321,221,59.23
Yorick,Milio,322,169,153,52.48
Yorick,Gangplank,206,115,91,55.83
Yorick,MasterYi,601,341,260,56.74
Yorick,Mel,1335,712,623,53.33
Yorick,Swain,514,260,254,50.58
Yorick,Warwick,1049,585,464,55.77
Yorick,Akali,540,307,233,56.85
Yorick,Sona,211,132,79,62.56
Yorick,Heimerdinger,352,192,160,54.55
Yorick,Talon,316,192,124,60.76
Yorick,Ahri,831,531,300,63.9
Yorick,Kalista,218,168,50,77.06
Yorick,FiddleSticks,257,133,124,51.75
Yorick,Shaco,565,344,221,60.88
Yorick,Syndra,349,190,159,54.44
Yorick,Thresh,752,389,363,51.73
Yorick,Urgot,286,160,126,55.94
Yorick,Rengar,241,136,105,56.43
Yorick,Ziggs,295,186,109,63.05
Yorick,Trundle,391,223,168,57.03
Yorick,Fiora,228,128,100,56.14
Yorick,Mordekaiser,919,499,420,54.3
Yorick,Vi,287,173,114,60.28
Yorick,Cassiopeia,197,107,90,54.31
Yorick,Ezreal,930,521,409,56.02
Yorick,Lux,1505,901,604,59.87
Yorick,DrMundo,295,166,129,56.27
Yorick,Nilah,248,157,91,63.31
Yorick,Yuumi,487,254,233,52.16
Yorick,Leblanc,208,116,92,55.77
Yorick,Elise,292,192,100,65.75
Yorick,Sylas,458,228,230,49.78
Yorick,Nocturne,451,228,223,50.55
Yorick,Rell,293,203,90,69.28
Yorick,Ashe,875,542,333,61.94
Yorick,Briar,581,324,257,55.77
Yorick,Hwei,415,234,181,56.39
Yorick,Kaisa,615,320,295,52.03
Yorick,TahmKench,576,319,257,55.38
Yorick,Zac,210,124,86,59.05
Yorick,Amumu,460,253,207,55
Yorick,Chogath,836,409,427,48.92
Yorick,Twitch,522,285,237,54.6
Yorick,Jax,471,273,198,57.96
Yorick,Graves,293,166,127,56.66
Yorick,Katarina,523,315,208,60.23
Yorick,Seraphine,688,399,289,57.99
Yorick,Darius,1082,593,489,54.81
Yorick,Neeko,445,290,155,65.17
Yorick,Taric,95,51,44,53.68
Yorick,Riven,232,126,106,54.31
Yorick,Lillia,372,169,203,45.43
Yorick,Orianna,287,171,116,59.58
Yorick,Velkoz,302,138,164,45.7
Yorick,Ambessa,330,173,157,52.42
Yorick,Qiyana,175,86,89,49.14
Yorick,LeeSin,480,282,198,58.75
Yorick,Nasus,528,330,198,62.5
Yorick,Pantheon,858,469,389,54.66
Yorick,Zoe,243,159,84,65.43
Yorick,Senna,525,307,218,58.48
Yorick,Viego,701,384,317,54.78
Yorick,Skarner,148,79,69,53.38
Yorick,Malphite,385,244,141,63.38
Yorick,Vladimir,266,153,113,57.52
Yorick,Tristana,491,314,177,63.95
Yorick,Aurora,460,254,206,55.22
Yorick,MissFortune,1171,662,509,56.53
Yorick,Gragas,360,198,162,55
Yorick,Rammus,188,65,123,34.57
Yorick,Nami,552,291,261,52.72
Yorick,Lissandra,139,70,69,50.36
Yorick,Pyke,604,375,229,62.09
Yorick,Sejuani,218,131,87,60.09
Yorick,Shen,295,180,115,61.02
Yorick,Naafiri,289,167,122,57.79
Yorick,Diana,695,398,297,57.27
Yorick,Ornn,220,132,88,60
Yorick,Karma,415,205,210,49.4
Yorick,Yone,1006,592,414,58.85
Yorick,Jhin,992,569,423,57.36
Yorick,Volibear,597,357,240,59.8
Yorick,Samira,517,294,223,56.87
Yorick,Rumble,100,52,48,52
Yorick,Leona,388,209,179,53.87
Yorick,Maokai,304,141,163,46.38
Yorick,KSante,163,102,61,62.58
Yorick,Kled,139,78,61,56.12
Yorick,Taliyah,148,89,59,60.14
Yorick,Annie,164,93,71,56.71
Yorick,Blitzcrank,356,242,114,67.98
Yorick,Viktor,290,183,107,63.1
Yorick,Karthus,136,93,43,68.38
Yorick,Xayah,318,198,120,62.26
Yorick,Rakan,259,139,120,53.67
Yorick,Fizz,353,213,140,60.34
Yorick,Sivir,251,100,151,39.84
Yorick,Zed,585,406,179,69.4
Yorick,Nautilus,618,298,320,48.22
Yorick,Zyra,307,172,135,56.03
Yorick,Vex,311,188,123,60.45
Yorick,Lucian,289,153,136,52.94
Yorick,Braum,289,159,130,55.02
Yorick,Kayn,854,525,329,61.48
Yorick,Yasuo,996,531,465,53.31
Yorick,Soraka,379,233,146,61.48
Yorick,Jayce,263,180,83,68.44
Yorick,AurelionSol,267,137,130,51.31
Yorick,Kayle,410,219,191,53.41
Yorick,Hecarim,171,107,64,62.57
Yorick,Smolder,427,234,193,54.8
Yorick,Janna,176,112,64,63.64
Yorick,Tryndamere,387,231,156,59.69
Yorick,Corki,145,99,46,68.28
Yorick,Aphelios,450,259,191,57.56
Yorick,TwistedFate,164,105,59,64.02
Yorick,XinZhao,445,220,225,49.44
Yorick,Evelynn,296,191,105,64.53
Yorick,Xerath,408,204,204,50
Yorick,Zeri,258,114,144,44.19
Yorick,Belveth,177,94,83,53.11
Yorick,Khazix,306,215,91,70.26
Yorick,Draven,304,177,127,58.22
Yorick,Renata,152,74,78,48.68
Yorick,Zilean,148,75,73,50.68
Yorick,Kennen,140,103,37,73.57
Yorick,Bard,189,109,80,57.67
Yorick,Sion,414,211,203,50.97
Yorick,Gwen,422,287,135,68.01
Yorick,Galio,428,254,174,59.35
Yorick,Shyvana,179,87,92,48.6
Yorick,Camille,194,156,38,80.41
Yorick,Poppy,283,161,122,56.89
Yorick,Azir,138,63,75,45.65
Yorick,Illaoi,323,168,155,52.01
Yorick,Vayne,649,385,264,59.32
Yorick,Ekko,406,251,155,61.82
Yorick,Alistar,145,73,72,50.34
Yorick,KogMaw,195,118,77,60.51
Yorick,Gnar,262,170,92,64.89
Yorick,JarvanIV,269,115,154,42.75
Yorick,Anivia,193,102,91,52.85
Yorick,Kassadin,99,52,47,52.53
Yorick,Udyr,202,132,70,65.35
Yorick,Nidalee,94,59,35,62.77
Yorick,Quinn,189,100,89,52.91
Yorick,Garen,778,417,361,53.6
Yorick,Singed,139,91,48,65.47
Yorick,Varus,556,282,274,50.72
Yorick,Akshan,250,154,96,61.6
Yorick,Kindred,287,142,145,49.48
Yorick,Renekton,305,164,141,53.77
Yorick,Ryze,184,117,67,63.59
Yorick,Olaf,89,44,45,49.44
Yorick,Nunu,463,253,210,54.64
Yorick,RekSai,104,58,46,55.77
Seraphine,Sett,1121,503,618,44.87
Seraphine,Ivern,105,57,48,54.29
Seraphine,Veigar,708,325,383,45.9
Seraphine,Jinx,1386,707,679,51.01
Seraphine,Lulu,528,305,223,57.77
Seraphine,Taliyah,120,57,63,47.5
Seraphine,Cassiopeia,257,114,143,44.36
Seraphine,Kaisa,920,442,478,48.04
Seraphine,Neeko,634,330,304,52.05
Seraphine,Sylas,690,300,390,43.48
Seraphine,Ezreal,1124,590,534,52.49
Seraphine,Morgana,1032,475,557,46.03
Seraphine,Irelia,670,390,280,58.21
Seraphine,Diana,860,417,443,48.49
Seraphine,Lux,2340,1147,1193,49.02
Seraphine,Tristana,575,256,319,44.52
Seraphine,Mel,1323,688,635,52
Seraphine,Mordekaiser,1084,543,541,50.09
Seraphine,Vi,438,245,193,55.94
Seraphine,Chogath,798,371,427,46.49
Seraphine,Yasuo,1373,717,656,52.22
Seraphine,Jhin,1087,513,574,47.19
Seraphine,Graves,322,194,128,60.25
Seraphine,Leblanc,265,165,100,62.26
Seraphine,Caitlyn,1687,925,762,54.83
Seraphine,Milio,373,140,233,37.53
Seraphine,Teemo,889,399,490,44.88
Seraphine,Poppy,356,189,167,53.09
Seraphine,Akali,666,357,309,53.6
Seraphine,Leona,535,239,296,44.67
Seraphine,Thresh,820,496,324,60.49
Seraphine,FiddleSticks,368,155,213,42.12
Seraphine,Zed,576,275,301,47.74
Seraphine,Viktor,426,212,214,49.77
Seraphine,Pyke,666,341,325,51.2
Seraphine,Yorick,688,289,399,42.01
Seraphine,Nunu,582,286,296,49.14
Seraphine,Draven,325,168,157,51.69
Seraphine,KogMaw,227,105,122,46.26
Seraphine,Yuumi,627,330,297,52.63
Seraphine,Riven,286,157,129,54.9
Seraphine,Volibear,839,401,438,47.79
Seraphine,Syndra,292,151,141,51.71
Seraphine,Sejuani,252,124,128,49.21
Seraphine,LeeSin,663,356,307,53.7
Seraphine,Twitch,600,284,316,47.33
Seraphine,Sion,534,207,327,38.76
Seraphine,Zac,212,118,94,55.66
Seraphine,AurelionSol,349,176,173,50.43
Seraphine,Gnar,236,118,118,50
Seraphine,Rammus,199,76,123,38.19
Seraphine,Akshan,251,114,137,45.42
Seraphine,Ashe,1277,676,601,52.94
Seraphine,RekSai,135,74,61,54.81
Seraphine,Hwei,529,221,308,41.78
Seraphine,Braum,357,206,151,57.7
Seraphine,Pantheon,1123,544,579,48.44
Seraphine,Kindred,366,198,168,54.1
Seraphine,Lucian,365,208,157,56.99
Seraphine,Zyra,442,213,229,48.19
Seraphine,Gangplank,261,126,135,48.28
Seraphine,MasterYi,804,427,377,53.11
Seraphine,Yone,1274,652,622,51.18
Seraphine,Swain,728,384,344,52.75
Seraphine,Kayle,575,269,306,46.78
Seraphine,Aurora,643,348,295,54.12
Seraphine,Viego,788,339,449,43.02
Seraphine,Velkoz,514,247,267,48.05
Seraphine,Briar,711,368,343,51.76
Seraphine,Soraka,463,239,224,51.62
Seraphine,DrMundo,443,195,248,44.02
Seraphine,Jax,596,289,307,48.49
Seraphine,Vayne,711,384,327,54.01
Seraphine,Malzahar,506,262,244,51.78
Seraphine,Darius,1272,635,637,49.92
Seraphine,Warwick,1184,583,601,49.24
Seraphine,Zilean,169,69,100,40.83
Seraphine,Shaco,609,274,335,44.99
Seraphine,Ekko,548,281,267,51.28
Seraphine,Shyvana,232,94,138,40.52
Seraphine,Garen,1027,491,536,47.81
Seraphine,KSante,291,173,118,59.45
Seraphine,Evelynn,349,180,169,51.58
Seraphine,Sivir,311,139,172,44.69
Seraphine,Vladimir,282,123,159,43.62
Seraphine,Talon,379,215,164,56.73
Seraphine,Varus,483,248,235,51.35
Seraphine,Nilah,368,184,184,50
Seraphine,Nasus,593,261,332,44.01
Seraphine,Zeri,185,95,90,51.35
Seraphine,Xerath,426,224,202,52.58
Seraphine,Aatrox,681,381,300,55.95
Seraphine,XinZhao,425,182,243,42.82
Seraphine,Rell,334,155,179,46.41
Seraphine,Camille,196,93,103,47.45
Seraphine,Rengar,290,184,106,63.45
Seraphine,Amumu,587,235,352,40.03
Seraphine,MissFortune,1618,756,862,46.72
Seraphine,Heimerdinger,467,183,284,39.19
Seraphine,Katarina,571,309,262,54.12
Seraphine,Belveth,164,98,66,59.76
Seraphine,Ahri,889,436,453,49.04
Seraphine,Aphelios,423,212,211,50.12
Seraphine,Anivia,264,133,131,50.38
Seraphine,Urgot,267,126,141,47.19
Seraphine,Trundle,506,237,269,46.84
Seraphine,Xayah,440,197,243,44.77
Seraphine,Blitzcrank,517,212,305,41.01
Seraphine,Zoe,279,145,134,51.97
Seraphine,Rakan,392,206,186,52.55
Seraphine,Rumble,112,65,47,58.04
Seraphine,Nautilus,671,319,352,47.54
Seraphine,Samira,869,407,462,46.84
Seraphine,Galio,482,242,240,50.21
Seraphine,Senna,563,267,296,47.42
Seraphine,Kennen,230,126,104,54.78
Seraphine,Khazix,412,202,210,49.03
Seraphine,Orianna,263,131,132,49.81
Seraphine,Nocturne,622,288,334,46.3
Seraphine,Elise,362,216,146,59.67
Seraphine,Maokai,342,197,145,57.6
Seraphine,Smolder,530,286,244,53.96
Seraphine,Gragas,334,180,154,53.89
Seraphine,Ryze,178,128,50,71.91
Seraphine,Tryndamere,369,181,188,49.05
Seraphine,Ambessa,364,176,188,48.35
Seraphine,Fiora,339,166,173,48.97
Seraphine,Brand,465,225,240,48.39
Seraphine,Fizz,329,152,177,46.2
Seraphine,Gwen,450,262,188,58.22
Seraphine,Karma,417,214,203,51.32
Seraphine,Shen,405,197,208,48.64
Seraphine,Malphite,504,218,286,43.25
Seraphine,Kayn,1013,521,492,51.43
Seraphine,Kled,152,80,72,52.63
Seraphine,Janna,193,97,96,50.26
Seraphine,Nami,603,314,289,52.07
Seraphine,Kassadin,162,70,92,43.21
Seraphine,MonkeyKing,343,199,144,58.02
Seraphine,Lissandra,172,74,98,43.02
Seraphine,JarvanIV,211,76,135,36.02
Seraphine,Sona,280,129,151,46.07
Seraphine,Lillia,409,184,225,44.99
Seraphine,Udyr,249,129,120,51.81
Seraphine,Vex,435,198,237,45.52
Seraphine,Ziggs,348,157,191,45.11
Seraphine,Quinn,247,122,125,49.39
Seraphine,Renekton,279,141,138,50.54
Seraphine,Singed,191,75,116,39.27
Seraphine,Skarner,235,118,117,50.21
Seraphine,Illaoi,301,160,141,53.16
Seraphine,Qiyana,201,114,87,56.72
Seraphine,TahmKench,737,357,380,48.44
Seraphine,Kalista,287,165,122,57.49
Seraphine,Annie,148,69,79,46.62
Seraphine,Renata,132,60,72,45.45
Seraphine,Nidalee,179,105,74,58.66
Seraphine,Karthus,163,104,59,63.8
Seraphine,Corki,169,74,95,43.79
Seraphine,Jayce,272,154,118,56.62
Seraphine,TwistedFate,196,110,86,56.12
Seraphine,Hecarim,181,92,89,50.83
Seraphine,Azir,211,124,87,58.77
Seraphine,Taric,161,80,81,49.69
Seraphine,Naafiri,347,185,162,53.31
Seraphine,Olaf,133,65,68,48.87
Seraphine,Bard,210,108,102,51.43
Seraphine,Alistar,176,79,97,44.89
Seraphine,Ornn,299,139,160,46.49
Rakan,Sett,554,281,273,50.72
Rakan,Ivern,59,48,11,81.36
Rakan,Veigar,381,200,181,52.49
Rakan,Jinx,701,328,373,46.79
Rakan,Lulu,317,158,159,49.84
Rakan,Leblanc,132,44,88,33.33
Rakan,Briar,342,180,162,52.63
Rakan,Zoe,125,71,54,56.8
Rakan,Poppy,266,166,100,62.41
Rakan,DrMundo,202,102,100,50.5
Rakan,Belveth,100,51,49,51
Rakan,Anivia,112,77,35,68.75
Rakan,Vladimir,216,93,123,43.06
Rakan,Evelynn,235,132,103,56.17
Rakan,Yasuo,635,339,296,53.39
Rakan,Tristana,273,118,155,43.22
Rakan,Yuumi,385,201,184,52.21
Rakan,Akali,374,198,176,52.94
Rakan,Rammus,100,51,49,51
Rakan,Zyra,149,45,104,30.2
Rakan,Mordekaiser,433,161,272,37.18
Rakan,Diana,373,205,168,54.96
Rakan,Lux,868,476,392,54.84
Rakan,MissFortune,760,331,429,43.55
Rakan,Karma,241,122,119,50.62
Rakan,Caitlyn,828,406,422,49.03
Rakan,Vi,274,113,161,41.24
Rakan,Orianna,140,81,59,57.86
Rakan,Draven,146,74,72,50.68
Rakan,Xayah,183,91,92,49.73
Rakan,Senna,347,147,200,42.36
Rakan,Jax,247,149,98,60.32
Rakan,Ahri,429,208,221,48.48
Rakan,Aphelios,188,88,100,46.81
Rakan,Aurora,296,173,123,58.45
Rakan,FiddleSticks,152,70,82,46.05
Rakan,Jhin,551,315,236,57.17
Rakan,Vex,244,129,115,52.87
Rakan,Samira,300,197,103,65.67
Rakan,Neeko,242,134,108,55.37
Rakan,Aatrox,389,215,174,55.27
Rakan,Gragas,180,101,79,56.11
Rakan,Cassiopeia,113,49,64,43.36
Rakan,Irelia,236,124,112,52.54
Rakan,Yone,640,281,359,43.91
Rakan,Mel,726,350,376,48.21
Rakan,Ezreal,439,252,187,57.4
Rakan,Elise,230,121,109,52.61
Rakan,Nasus,278,135,143,48.56
Rakan,Amumu,295,130,165,44.07
Rakan,Naafiri,140,77,63,55
Rakan,Xerath,196,94,102,47.96
Rakan,Malphite,278,137,141,49.28
Rakan,Blitzcrank,251,160,91,63.75
Rakan,XinZhao,214,87,127,40.65
Rakan,Qiyana,145,91,54,62.76
Rakan,AurelionSol,118,55,63,46.61
Rakan,Teemo,384,190,194,49.48
Rakan,Sylas,309,164,145,53.07
Rakan,Varus,283,163,120,57.6
Rakan,Yorick,259,120,139,46.33
Rakan,Volibear,329,174,155,52.89
Rakan,Azir,124,46,78,37.1
Rakan,Thresh,527,247,280,46.87
Rakan,Illaoi,177,88,89,49.72
Rakan,Nocturne,212,130,82,61.32
Rakan,Ryze,88,56,32,63.64
Rakan,Kayn,580,321,259,55.34
Rakan,Morgana,392,198,194,50.51
Rakan,Darius,623,352,271,56.5
Rakan,Taliyah,58,26,32,44.83
Rakan,LeeSin,301,161,140,53.49
Rakan,Kayle,252,153,99,60.71
Rakan,Seraphine,392,186,206,47.45
Rakan,Garen,614,280,334,45.6
Rakan,Nunu,289,156,133,53.98
Rakan,Rell,175,93,82,53.14
Rakan,Ashe,541,248,293,45.84
Rakan,Swain,397,165,232,41.56
Rakan,Riven,122,46,76,37.7
Rakan,Talon,225,131,94,58.22
Rakan,Viktor,150,70,80,46.67
Rakan,Sona,120,60,60,50
Rakan,Ornn,123,57,66,46.34
Rakan,Ziggs,140,82,58,58.57
Rakan,Galio,229,103,126,44.98
Rakan,Velkoz,251,140,111,55.78
Rakan,Leona,187,82,105,43.85
Rakan,Twitch,263,159,104,60.46
Rakan,Brand,209,104,105,49.76
Rakan,Shaco,273,160,113,58.61
Rakan,Kalista,150,76,74,50.67
Rakan,Gwen,251,203,48,80.88
Rakan,Kindred,144,81,63,56.25
Rakan,JarvanIV,98,69,29,70.41
Rakan,Gnar,122,60,62,49.18
Rakan,Renekton,142,49,93,34.51
Rakan,Graves,171,92,79,53.8
Rakan,Lucian,250,112,138,44.8
Rakan,Pantheon,539,263,276,48.79
Rakan,Warwick,495,233,262,47.07
Rakan,Zed,358,246,112,68.72
Rakan,Vayne,387,222,165,57.36
Rakan,Janna,97,29,68,29.9
Rakan,Katarina,287,161,126,56.1
Rakan,Khazix,225,129,96,57.33
Rakan,Zilean,76,41,35,53.95
Rakan,Kennen,116,64,52,55.17
Rakan,TahmKench,368,178,190,48.37
Rakan,Kled,60,28,32,46.67
Rakan,KogMaw,126,75,51,59.52
Rakan,Quinn,100,41,59,41
Rakan,MasterYi,390,179,211,45.9
Rakan,Kassadin,70,40,30,57.14
Rakan,Kaisa,515,307,208,59.61
Rakan,Fizz,193,83,110,43.01
Rakan,Sivir,147,71,76,48.3
Rakan,Taric,39,17,22,43.59
Rakan,Urgot,148,81,67,54.73
Rakan,Nautilus,328,181,147,55.18
Rakan,Singed,82,23,59,28.05
Rakan,Shyvana,110,57,53,51.82
Rakan,Pyke,332,191,141,57.53
Rakan,Fiora,122,88,34,72.13
Rakan,Smolder,265,120,145,45.28
Rakan,Lillia,213,113,100,53.05
Rakan,Lissandra,91,39,52,42.86
Rakan,Braum,136,81,55,59.56
Rakan,Gangplank,116,56,60,48.28
Rakan,Chogath,447,227,220,50.78
Rakan,Rengar,174,107,67,61.49
Rakan,RekSai,62,20,42,32.26
Rakan,Sion,303,146,157,48.18
Rakan,Sejuani,106,38,68,35.85
Rakan,Ambessa,223,168,55,75.34
Rakan,KSante,110,31,79,28.18
Rakan,Nami,382,204,178,53.4
Rakan,Ekko,266,155,111,58.27
Rakan,Heimerdinger,136,59,77,43.38
Rakan,Camille,100,68,32,68
Rakan,Shen,228,110,118,48.25
Rakan,Skarner,106,51,55,48.11
Rakan,Syndra,197,58,139,29.44
Rakan,Milio,162,58,104,35.8
Rakan,Zeri,126,60,66,47.62
Rakan,Viego,403,164,239,40.69
Rakan,Soraka,213,85,128,39.91
Rakan,Renata,61,11,50,18.03
Rakan,Olaf,74,54,20,72.97
Rakan,Corki,112,64,48,57.14
Rakan,Malzahar,272,144,128,52.94
Rakan,MonkeyKing,185,99,86,53.51
Rakan,Akshan,178,96,82,53.93
Rakan,TwistedFate,142,84,58,59.15
Rakan,Hecarim,79,20,59,25.32
Rakan,Hwei,239,113,126,47.28
Rakan,Nidalee,90,67,23,74.44
Rakan,Maokai,120,65,55,54.17
Rakan,Nilah,171,102,69,59.65
Rakan,Tryndamere,213,78,135,36.62
Rakan,Bard,114,59,55,51.75
Rakan,Trundle,150,87,63,58
Rakan,Karthus,107,74,33,69.16
Rakan,Udyr,126,56,70,44.44
Rakan,Zac,97,36,61,37.11
Rakan,Jayce,156,72,84,46.15
Rakan,Alistar,143,70,73,48.95
Rakan,Rumble,83,45,38,54.22
Rakan,Annie,119,53,66,44.54
Lillia,Leblanc,177,95,82,53.67
Lillia,Briar,479,189,290,39.46
Lillia,Zoe,171,99,72,57.89
Lillia,Jinx,858,371,487,43.24
Lillia,Poppy,250,144,106,57.6
Lillia,Gangplank,142,50,92,35.21
Lillia,Gragas,231,147,84,63.64
Lillia,TwistedFate,189,83,106,43.92
Lillia,Lucian,201,126,75,62.69
Lillia,Leona,276,127,149,46.01
Lillia,Heimerdinger,221,103,118,46.61
Lillia,Kindred,258,119,139,46.12
Lillia,Katarina,317,173,144,54.57
Lillia,Caitlyn,1031,511,520,49.56
Lillia,Janna,127,57,70,44.88
Lillia,Vladimir,226,141,85,62.39
Lillia,Diana,539,250,289,46.38
Lillia,Akali,413,196,217,47.46
Lillia,Karma,259,129,130,49.81
Lillia,Pantheon,660,307,353,46.52
Lillia,Garen,601,332,269,55.24
Lillia,Ziggs,198,79,119,39.9
Lillia,Zeri,139,58,81,41.73
Lillia,Zyra,212,81,131,38.21
Lillia,Darius,861,415,446,48.2
Lillia,Sejuani,165,107,58,64.85
Lillia,Mel,879,479,400,54.49
Lillia,Jhin,701,354,347,50.5
Lillia,Rell,238,111,127,46.64
Lillia,Yorick,372,203,169,54.57
Lillia,MasterYi,352,159,193,45.17
Lillia,Irelia,337,192,145,56.97
Lillia,Shen,286,145,141,50.7
Lillia,Nami,329,122,207,37.08
Lillia,Teemo,544,271,273,49.82
Lillia,Warwick,603,315,288,52.24
Lillia,Samira,336,182,154,54.17
Lillia,Lux,1101,479,622,43.51
Lillia,Tryndamere,263,152,111,57.79
Lillia,Sivir,163,80,83,49.08
Lillia,Soraka,257,157,100,61.09
Lillia,Malphite,361,199,162,55.12
Lillia,MonkeyKing,185,73,112,39.46
Lillia,Sylas,373,209,164,56.03
Lillia,Swain,504,228,276,45.24
Lillia,Senna,434,194,240,44.7
Lillia,Kayle,275,106,169,38.55
Lillia,Kayn,627,322,305,51.36
Lillia,Yasuo,789,461,328,58.43
Lillia,Ezreal,625,358,267,57.28
Lillia,Morgana,500,244,256,48.8
Lillia,DrMundo,384,177,207,46.09
Lillia,Ekko,363,157,206,43.25
Lillia,Zed,523,282,241,53.92
Lillia,Lulu,320,157,163,49.06
Lillia,Gwen,227,126,101,55.51
Lillia,Maokai,169,71,98,42.01
Lillia,Veigar,439,223,216,50.8
Lillia,Brand,283,124,159,43.82
Lillia,Aatrox,392,194,198,49.49
Lillia,Ashe,713,383,330,53.72
Lillia,Chogath,593,359,234,60.54
Lillia,Kennen,170,78,92,45.88
Lillia,Shaco,343,145,198,42.27
Lillia,Kaisa,599,297,302,49.58
Lillia,Sona,234,112,122,47.86
Lillia,Fiora,176,73,103,41.48
Lillia,Nunu,440,234,206,53.18
Lillia,Aphelios,272,127,145,46.69
Lillia,LeeSin,311,192,119,61.74
Lillia,MissFortune,956,432,524,45.19
Lillia,Xayah,222,141,81,63.51
Lillia,Volibear,548,269,279,49.09
Lillia,Jax,387,204,183,52.71
Lillia,Taliyah,127,61,66,48.03
Lillia,Twitch,306,146,160,47.71
Lillia,KSante,120,73,47,60.83
Lillia,Graves,176,90,86,51.14
Lillia,Taric,89,40,49,44.94
Lillia,Vi,376,187,189,49.73
Lillia,Sion,356,167,189,46.91
Lillia,Skarner,135,87,48,64.44
Lillia,Xerath,276,131,145,47.46
Lillia,Jayce,146,86,60,58.9
Lillia,Kalista,202,96,106,47.52
Lillia,Neeko,290,141,149,48.62
Lillia,XinZhao,222,97,125,43.69
Lillia,Tristana,369,212,157,57.45
Lillia,Hecarim,148,76,72,51.35
Lillia,Malzahar,282,123,159,43.62
Lillia,Fizz,211,104,107,49.29
Lillia,Pyke,432,254,178,58.8
Lillia,Illaoi,181,76,105,41.99
Lillia,Ahri,507,274,233,54.04
Lillia,Talon,254,98,156,38.58
Lillia,Nocturne,255,125,130,49.02
Lillia,Trundle,145,62,83,42.76
Lillia,Yone,761,389,372,51.12
Lillia,Kled,51,25,26,49.02
Lillia,Aurora,385,156,229,40.52
Lillia,Thresh,582,341,241,58.59
Lillia,Zilean,112,53,59,47.32
Lillia,Gnar,147,100,47,68.03
Lillia,Viktor,215,100,115,46.51
Lillia,Syndra,267,111,156,41.57
Lillia,Mordekaiser,610,260,350,42.62
Lillia,Akshan,184,92,92,50
Lillia,Amumu,399,189,210,47.37
Lillia,Azir,154,90,64,58.44
Lillia,AurelionSol,196,122,74,62.24
Lillia,Milio,193,84,109,43.52
Lillia,Ambessa,247,116,131,46.96
Lillia,Khazix,303,146,157,48.18
Lillia,Viego,607,311,296,51.24
Lillia,Olaf,121,50,71,41.32
Lillia,Yuumi,325,140,185,43.08
Lillia,Naafiri,182,68,114,37.36
Lillia,Orianna,140,95,45,67.86
Lillia,Renekton,183,92,91,50.27
Lillia,Seraphine,409,225,184,55.01
Lillia,JarvanIV,228,119,109,52.19
Lillia,Galio,281,91,190,32.38
Lillia,FiddleSticks,237,113,124,47.68
Lillia,Varus,335,178,157,53.13
Lillia,Elise,201,96,105,47.76
Lillia,Ryze,118,61,57,51.69
Lillia,TahmKench,547,316,231,57.77
Lillia,Kassadin,116,56,60,48.28
Lillia,Lissandra,96,39,57,40.63
Lillia,Sett,629,329,300,52.31
Lillia,Alistar,134,69,65,51.49
Lillia,Draven,246,133,113,54.07
Lillia,Singed,119,66,53,55.46
Lillia,Annie,143,71,72,49.65
Lillia,Vayne,422,204,218,48.34
Lillia,Braum,146,77,69,52.74
Lillia,Evelynn,272,143,129,52.57
Lillia,Zac,199,107,92,53.77
Lillia,Udyr,160,64,96,40
Lillia,KogMaw,148,84,64,56.76
Lillia,Vex,250,128,122,51.2
Lillia,Smolder,321,139,182,43.3
Lillia,Rakan,213,100,113,46.95
Lillia,Corki,130,89,41,68.46
Lillia,Hwei,279,153,126,54.84
Lillia,Anivia,90,25,65,27.78
Lillia,Rammus,121,59,62,48.76
Lillia,Nautilus,421,250,171,59.38
Lillia,Riven,149,92,57,61.74
Lillia,Renata,84,41,43,48.81
Lillia,Shyvana,137,67,70,48.91
Lillia,Blitzcrank,384,200,184,52.08
Lillia,Cassiopeia,164,77,87,46.95
Lillia,Rengar,144,74,70,51.39
Lillia,Nasus,329,173,156,52.58
Lillia,Velkoz,233,96,137,41.2
Lillia,Rumble,56,18,38,32.14
Lillia,Karthus,71,28,43,39.44
Lillia,Nidalee,113,68,45,60.18
Lillia,Urgot,142,80,62,56.34
Lillia,Bard,117,64,53,54.7
Lillia,Belveth,88,54,34,61.36
Lillia,RekSai,61,34,27,55.74
Lillia,Ornn,168,87,81,51.79
Lillia,Ivern,81,32,49,39.51
Lillia,Qiyana,159,62,97,38.99
Lillia,Nilah,246,137,109,55.69
Lillia,Camille,140,67,73,47.86
Lillia,Quinn,150,73,77,48.67
Zeri,Leblanc,120,64,56,53.33
Zeri,Briar,294,133,161,45.24
Zeri,Zoe,146,81,65,55.48
Zeri,Jinx,559,233,326,41.68
Zeri,Poppy,256,134,122,52.34
Zeri,Warwick,439,188,251,42.82
Zeri,Katarina,211,78,133,36.97
Zeri,Twitch,258,111,147,43.02
Zeri,Morgana,335,124,211,37.01
Zeri,Riven,128,77,51,60.16
Zeri,Nocturne,210,112,98,53.33
Zeri,Lulu,258,145,113,56.2
Zeri,Gnar,118,70,48,59.32
Zeri,Viego,262,102,160,38.93
Zeri,Yone,528,274,254,51.89
Zeri,Kaisa,353,184,169,52.12
Zeri,TahmKench,289,137,152,47.4
Zeri,Irelia,271,129,142,47.6
Zeri,Lillia,139,81,58,58.27
Zeri,Sylas,316,171,145,54.11
Zeri,Caitlyn,595,311,284,52.27
Zeri,Lux,596,294,302,49.33
Zeri,Teemo,426,225,201,52.82
Zeri,LeeSin,272,133,139,48.9
Zeri,Chogath,363,150,213,41.32
Zeri,Lucian,231,109,122,47.19
Zeri,Xerath,112,37,75,33.04
Zeri,Gragas,164,99,65,60.37
Zeri,Rell,114,61,53,53.51
Zeri,Heimerdinger,135,64,71,47.41
Zeri,Mordekaiser,383,153,230,39.95
Zeri,Ashe,457,190,267,41.58
Zeri,Pyke,354,177,177,50
Zeri,Gwen,155,95,60,61.29
Zeri,RekSai,26,10,16,38.46
Zeri,Gangplank,114,70,44,61.4
Zeri,Leona,298,151,147,50.67
Zeri,Sett,441,203,238,46.03
Zeri,Orianna,153,85,68,55.56
Zeri,Draven,174,99,75,56.9
Zeri,Nautilus,307,167,140,54.4
Zeri,Urgot,171,81,90,47.37
Zeri,Shaco,297,166,131,55.89
Zeri,Annie,101,59,42,58.42
Zeri,Ezreal,442,216,226,48.87
Zeri,Quinn,82,39,43,47.56
Zeri,Yasuo,428,204,224,47.66
Zeri,MissFortune,595,309,286,51.93
Zeri,Neeko,248,144,104,58.06
Zeri,Renekton,137,60,77,43.8
Zeri,Hecarim,107,48,59,44.86
Zeri,Viktor,161,75,86,46.58
Zeri,Jhin,532,265,267,49.81
Zeri,Tryndamere,161,76,85,47.2
Zeri,Ivern,48,30,18,62.5
Zeri,Seraphine,185,90,95,48.65
Zeri,Kayle,217,81,136,37.33
Zeri,FiddleSticks,130,80,50,61.54
Zeri,Taric,70,48,22,68.57
Zeri,Camille,128,71,57,55.47
Zeri,Rengar,144,87,57,60.42
Zeri,Aatrox,287,144,143,50.17
Zeri,MasterYi,254,124,130,48.82
Zeri,Xayah,200,108,92,54
Zeri,Hwei,220,105,115,47.73
Zeri,Zed,252,112,140,44.44
Zeri,Blitzcrank,201,98,103,48.76
Zeri,Ambessa,250,131,119,52.4
Zeri,Singed,90,35,55,38.89
Zeri,Talon,162,57,105,35.19
Zeri,Ekko,207,124,83,59.9
Zeri,Tristana,259,107,152,41.31
Zeri,Soraka,213,114,99,53.52
Zeri,Nasus,281,104,177,37.01
Zeri,Aurora,274,115,159,41.97
Zeri,Vayne,239,108,131,45.19
Zeri,MonkeyKing,104,37,67,35.58
Zeri,Samira,278,150,128,53.96
Zeri,Volibear,346,150,196,43.35
Zeri,Graves,131,58,73,44.27
Zeri,Ahri,412,225,187,54.61
Zeri,Yorick,258,144,114,55.81
Zeri,Velkoz,193,90,103,46.63
Zeri,DrMundo,146,78,68,53.42
Zeri,Shen,200,76,124,38
Zeri,Fizz,136,68,68,50
Zeri,Yuumi,256,112,144,43.75
Zeri,Vi,285,156,129,54.74
Zeri,Swain,250,97,153,38.8
Zeri,Akali,268,122,146,45.52
Zeri,Kindred,157,77,80,49.04
Zeri,Naafiri,91,39,52,42.86
Zeri,Milio,162,79,83,48.77
Zeri,Fiora,112,73,39,65.18
Zeri,Elise,153,59,94,38.56
Zeri,Pantheon,410,165,245,40.24
Zeri,Malzahar,240,96,144,40
Zeri,Darius,528,267,261,50.57
Zeri,Udyr,129,72,57,55.81
Zeri,Cassiopeia,105,45,60,42.86
Zeri,Nami,254,130,124,51.18
Zeri,Illaoi,100,52,48,52
Zeri,Rammus,94,68,26,72.34
Zeri,Kennen,87,47,40,54.02
Zeri,Mel,651,302,349,46.39
Zeri,Zyra,164,84,80,51.22
Zeri,Vladimir,152,65,87,42.76
Zeri,Khazix,197,112,85,56.85
Zeri,Thresh,301,172,129,57.14
Zeri,Sejuani,68,27,41,39.71
Zeri,Renata,77,38,39,49.35
Zeri,Corki,93,50,43,53.76
Zeri,Bard,117,66,51,56.41
Zeri,Zac,90,29,61,32.22
Zeri,Akshan,122,51,71,41.8
Zeri,Ziggs,98,54,44,55.1
Zeri,Kayn,387,174,213,44.96
Zeri,Smolder,235,102,133,43.4
Zeri,AurelionSol,136,59,77,43.38
Zeri,Garen,385,154,231,40
Zeri,Evelynn,117,71,46,60.68
Zeri,Karma,184,92,92,50
Zeri,Kalista,131,47,84,35.88
Zeri,Azir,127,84,43,66.14
Zeri,Vex,176,77,99,43.75
Zeri,Galio,253,108,145,42.69
Zeri,Varus,276,130,146,47.1
Zeri,Rakan,126,66,60,52.38
Zeri,JarvanIV,139,60,79,43.17
Zeri,Ryze,121,60,61,49.59
Zeri,Kassadin,66,32,34,48.48
Zeri,Malphite,211,99,112,46.92
Zeri,Diana,344,142,202,41.28
Zeri,Maokai,111,53,58,47.75
Zeri,Jayce,96,36,60,37.5
Zeri,KSante,130,80,50,61.54
Zeri,TwistedFate,86,55,31,63.95
Zeri,Sona,68,18,50,26.47
Zeri,Nunu,244,99,145,40.57
Zeri,Belveth,65,20,45,30.77
Zeri,Nidalee,56,32,24,57.14
Zeri,Janna,112,56,56,50
Zeri,KogMaw,123,57,66,46.34
Zeri,Syndra,190,107,83,56.32
Zeri,Nilah,148,57,91,38.51
Zeri,Ornn,92,33,59,35.87
Zeri,Lissandra,46,12,34,26.09
Zeri,Zilean,60,18,42,30
Zeri,XinZhao,130,62,68,47.69
Zeri,Qiyana,112,50,62,44.64
Zeri,Skarner,107,56,51,52.34
Zeri,Aphelios,186,102,84,54.84
Zeri,Amumu,268,94,174,35.07
Zeri,Jax,208,65,143,31.25
Zeri,Kled,53,18,35,33.96
Zeri,Sion,256,146,110,57.03
Zeri,Veigar,286,113,173,39.51
Zeri,Taliyah,65,34,31,52.31
Zeri,Alistar,100,41,59,41
Zeri,Senna,274,125,149,45.62
Zeri,Rumble,85,43,42,50.59
Zeri,Anivia,87,37,50,42.53
Zeri,Brand,139,49,90,35.25
Zeri,Trundle,102,54,48,52.94
Zeri,Karthus,87,53,34,60.92
Zeri,Shyvana,65,47,18,72.31
Zeri,Braum,112,55,57,49.11
Zeri,Sivir,90,19,71,21.11
Zeri,Olaf,74,39,35,52.7
Leblanc,Fiora,71,32,39,45.07
Leblanc,Lillia,177,82,95,46.33
Leblanc,Aurora,272,137,135,50.37
Leblanc,Zeri,120,56,64,46.67
Leblanc,Rakan,132,88,44,66.67
Leblanc,Irelia,168,65,103,38.69
Leblanc,Warwick,359,133,226,37.05
Leblanc,Galio,271,100,171,36.9
Leblanc,Sivir,113,45,68,39.82
Leblanc,Rell,115,63,52,54.78
Leblanc,Sett,305,161,144,52.79
Leblanc,Talon,117,57,60,48.72
Leblanc,FiddleSticks,136,69,67,50.74
Leblanc,Ashe,435,270,165,62.07
Leblanc,Blitzcrank,178,112,66,62.92
Leblanc,Malphite,178,80,98,44.94
Leblanc,Rengar,128,89,39,69.53
Leblanc,Akali,256,125,131,48.83
Leblanc,Yone,352,174,178,49.43
Leblanc,Briar,190,80,110,42.11
Leblanc,Vex,174,77,97,44.25
Leblanc,Jinx,488,209,279,42.83
Leblanc,Milio,109,50,59,45.87
Leblanc,Olaf,51,27,24,52.94
Leblanc,LeeSin,262,135,127,51.53
Leblanc,Diana,345,158,187,45.8
Leblanc,Seraphine,265,100,165,37.74
Leblanc,Karma,213,99,114,46.48
Leblanc,Mordekaiser,344,155,189,45.06
Leblanc,Volibear,270,128,142,47.41
Leblanc,Mel,654,300,354,45.87
Leblanc,Neeko,188,102,86,54.26
Leblanc,Yorick,208,92,116,44.23
Leblanc,Veigar,257,123,134,47.86
Leblanc,Caitlyn,481,207,274,43.04
Leblanc,Sona,85,26,59,30.59
Leblanc,Jayce,98,46,52,46.94
Leblanc,Amumu,191,91,100,47.64
Leblanc,Yasuo,436,198,238,45.41
Leblanc,Jax,187,88,99,47.06
Leblanc,Heimerdinger,108,29,79,26.85
Leblanc,Soraka,121,51,70,42.15
Leblanc,Zed,230,126,104,54.78
Leblanc,Samira,279,139,140,49.82
Leblanc,Ambessa,169,59,110,34.91
Leblanc,Nunu,192,100,92,52.08
Leblanc,Kayle,209,91,118,43.54
Leblanc,Katarina,197,106,91,53.81
Leblanc,Jhin,427,176,251,41.22
Leblanc,Lux,683,318,365,46.56
Leblanc,Ekko,157,77,80,49.04
Leblanc,Kassadin,27,13,14,48.15
Leblanc,TahmKench,205,87,118,42.44
Leblanc,Gnar,110,61,49,55.45
Leblanc,KSante,147,58,89,39.46
Leblanc,Ahri,355,158,197,44.51
Leblanc,Anivia,100,61,39,61
Leblanc,Xayah,161,100,61,62.11
Leblanc,Chogath,285,125,160,43.86
Leblanc,MissFortune,501,245,256,48.9
Leblanc,Malzahar,171,65,106,38.01
Leblanc,Viego,304,136,168,44.74
Leblanc,Vayne,203,105,98,51.72
Leblanc,Sylas,184,89,95,48.37
Leblanc,Camille,109,64,45,58.72
Leblanc,Kayn,302,144,158,47.68
Leblanc,Yuumi,209,106,103,50.72
Leblanc,Lucian,127,58,69,45.67
Leblanc,Nami,233,124,109,53.22
Leblanc,Teemo,294,128,166,43.54
Leblanc,Shaco,247,104,143,42.11
Leblanc,Naafiri,138,53,85,38.41
Leblanc,Ziggs,79,29,50,36.71
Leblanc,Kalista,130,67,63,51.54
Leblanc,Swain,169,64,105,37.87
Leblanc,Renekton,139,66,73,47.48
Leblanc,Leona,237,83,154,35.02
Leblanc,Janna,89,32,57,35.96
Leblanc,JarvanIV,103,49,54,47.57
Leblanc,Udyr,101,50,51,49.5
Leblanc,Skarner,96,47,49,48.96
Leblanc,Ezreal,464,229,235,49.35
Leblanc,Trundle,121,62,59,51.24
Leblanc,Rammus,66,25,41,37.88
Leblanc,MonkeyKing,118,65,53,55.08
Leblanc,Nautilus,268,124,144,46.27
Leblanc,Garen,362,170,192,46.96
Leblanc,Singed,92,39,53,42.39
Leblanc,Bard,70,47,23,67.14
Leblanc,Nocturne,151,70,81,46.36
Leblanc,Darius,458,236,222,51.53
Leblanc,Gragas,164,101,63,61.59
Leblanc,Gangplank,124,58,66,46.77
Leblanc,Tristana,191,110,81,57.59
Leblanc,Pyke,245,140,105,57.14
Leblanc,Aatrox,232,119,113,51.29
Leblanc,Riven,111,45,66,40.54
Leblanc,Aphelios,166,80,86,48.19
Leblanc,DrMundo,170,78,92,45.88
Leblanc,Thresh,388,237,151,61.08
Leblanc,Khazix,155,93,62,60
Leblanc,Shen,204,102,102,50
Leblanc,Nilah,102,40,62,39.22
Leblanc,Kled,42,9,33,21.43
Leblanc,Vi,171,57,114,33.33
Leblanc,Draven,154,72,82,46.75
Leblanc,Lulu,200,82,118,41
Leblanc,Vladimir,147,72,75,48.98
Leblanc,Brand,144,64,80,44.44
Leblanc,Zoe,140,67,73,47.86
Leblanc,Pantheon,420,171,249,40.71
Leblanc,Evelynn,136,64,72,47.06
Leblanc,Azir,100,49,51,49
Leblanc,Fizz,141,59,82,41.84
Leblanc,Kaisa,292,159,133,54.45
Leblanc,Tryndamere,139,62,77,44.6
Leblanc,Kennen,87,43,44,49.43
Leblanc,Qiyana,45,25,20,55.56
Leblanc,Karthus,90,43,47,47.78
Leblanc,Twitch,210,101,109,48.1
Leblanc,Gwen,141,63,78,44.68
Leblanc,AurelionSol,76,31,45,40.79
Leblanc,Morgana,232,90,142,38.79
Leblanc,Velkoz,169,71,98,42.01
Leblanc,Smolder,234,81,153,34.62
Leblanc,Illaoi,83,57,26,68.67
Leblanc,Sejuani,108,46,62,42.59
Leblanc,Ornn,90,31,59,34.44
Leblanc,Zac,90,43,47,47.78
Leblanc,Elise,177,98,79,55.37
Leblanc,Hwei,197,89,108,45.18
Leblanc,Braum,148,43,105,29.05
Leblanc,Poppy,137,61,76,44.53
Leblanc,Shyvana,62,21,41,33.87
Leblanc,Lissandra,72,27,45,37.5
Leblanc,Orianna,136,74,62,54.41
Leblanc,Nasus,190,112,78,58.95
Leblanc,MasterYi,264,119,145,45.08
Leblanc,TwistedFate,95,60,35,63.16
Leblanc,Belveth,73,39,34,53.42
Leblanc,Senna,175,103,72,58.86
Leblanc,Varus,250,110,140,44
Leblanc,Sion,200,105,95,52.5
Leblanc,Hecarim,57,20,37,35.09
Leblanc,Kindred,131,82,49,62.6
Leblanc,Ivern,33,20,13,60.61
Leblanc,Nidalee,53,18,35,33.96
Leblanc,Alistar,102,46,56,45.1
Leblanc,Urgot,114,39,75,34.21
Leblanc,KogMaw,83,26,57,31.33
Leblanc,Graves,102,65,37,63.73
Leblanc,Syndra,164,66,98,40.24
Leblanc,Corki,107,69,38,64.49
Leblanc,Quinn,97,39,58,40.21
Leblanc,Cassiopeia,69,35,34,50.72
Leblanc,Viktor,123,56,67,45.53
Leblanc,XinZhao,164,55,109,33.54
Leblanc,Akshan,97,32,65,32.99
Leblanc,Annie,55,25,30,45.45
Leblanc,Maokai,107,29,78,27.1
Leblanc,Zyra,150,35,115,23.33
Leblanc,RekSai,22,6,16,27.27
Leblanc,Xerath,112,29,83,25.89
Leblanc,Renata,51,39,12,76.47
Leblanc,Ryze,42,17,25,40.48
Leblanc,Rumble,83,35,48,42.17
Leblanc,Taliyah,55,20,35,36.36
Leblanc,Zilean,58,27,31,46.55
Leblanc,Taric,19,10,9,52.63
Briar,Fiora,373,225,148,60.32
Briar,Lillia,479,290,189,60.54
Briar,Aurora,603,328,275,54.39
Briar,Zeri,294,161,133,54.76
Briar,Rakan,342,162,180,47.37
Briar,Pantheon,964,511,453,53.01
Briar,Diana,830,389,441,46.87
Briar,Gangplank,306,187,119,61.11
Briar,Ezreal,988,559,429,56.58
Briar,Yuumi,527,263,264,49.91
Briar,Garen,808,401,407,49.63
Briar,Yasuo,1166,570,596,48.89
Briar,Caitlyn,1469,692,777,47.11
Briar,Pyke,756,452,304,59.79
Briar,Aatrox,659,340,319,51.59
Briar,Sejuani,190,104,86,54.74
Briar,Jinx,1365,639,726,46.81
Briar,Sett,1011,463,548,45.8
Briar,Amumu,581,238,343,40.96
Briar,Sylas,564,322,242,57.09
Briar,Poppy,421,197,224,46.79
Briar,Warwick,1090,592,498,54.31
Briar,Katarina,572,308,264,53.85
Briar,Twitch,519,244,275,47.01
Briar,Morgana,831,405,426,48.74
Briar,Malphite,515,214,301,41.55
Briar,Rengar,251,177,74,70.52
Briar,Akali,683,315,368,46.12
Briar,Ashe,1067,594,473,55.67
Briar,Vladimir,396,227,169,57.32
Briar,Shaco,519,235,284,45.28
Briar,Tryndamere,326,166,160,50.92
Briar,Milio,299,155,144,51.84
Briar,Jax,534,221,313,41.39
Briar,Talon,301,184,117,61.13
Briar,Leblanc,190,110,80,57.89
Briar,Mel,1389,744,645,53.56
Briar,Heimerdinger,306,184,122,60.13
Briar,Kindred,417,249,168,59.71
Briar,Janna,188,92,96,48.94
Briar,Smolder,418,222,196,53.11
Briar,Velkoz,363,168,195,46.28
Briar,Darius,1257,628,629,49.96
Briar,Brand,526,246,280,46.77
Briar,Kennen,160,115,45,71.88
Briar,Kayn,1055,538,517,51
Briar,Naafiri,338,179,159,52.96
Briar,Xayah,344,162,182,47.09
Briar,Soraka,373,188,185,50.4
Briar,Yorick,581,257,324,44.23
Briar,Irelia,467,261,206,55.89
Briar,Samira,620,317,303,51.13
Briar,Nami,559,258,301,46.15
Briar,DrMundo,462,215,247,46.54
Briar,Trundle,404,190,214,47.03
Briar,Ahri,877,457,420,52.11
Briar,Gwen,349,172,177,49.28
Briar,Nunu,592,296,296,50
Briar,Lux,1625,874,751,53.78
Briar,Mordekaiser,1021,526,495,51.52
Briar,Zed,601,342,259,56.91
Briar,MissFortune,1285,698,587,54.32
Briar,Veigar,658,303,355,46.05
Briar,KSante,175,90,85,51.43
Briar,Gragas,287,172,115,59.93
Briar,MasterYi,772,356,416,46.11
Briar,Shyvana,172,99,73,57.56
Briar,Taliyah,165,69,96,41.82
Briar,Swain,589,272,317,46.18
Briar,Kayle,472,255,217,54.03
Briar,Nocturne,604,315,289,52.15
Briar,Lucian,350,195,155,55.71
Briar,Seraphine,711,343,368,48.24
Briar,Ambessa,359,185,174,51.53
Briar,Zac,212,97,115,45.75
Briar,Kalista,295,174,121,58.98
Briar,Olaf,146,75,71,51.37
Briar,Yone,1139,629,510,55.22
Briar,Belveth,228,103,125,45.18
Briar,AurelionSol,336,115,221,34.23
Briar,Neeko,439,226,213,51.48
Briar,Nilah,425,206,219,48.47
Briar,Zyra,386,215,171,55.7
Briar,Volibear,638,342,296,53.61
Briar,Vex,361,198,163,54.85
Briar,Kaisa,922,506,416,54.88
Briar,Ivern,72,41,31,56.94
Briar,Syndra,302,125,177,41.39
Briar,Maokai,253,117,136,46.25
Briar,Illaoi,312,173,139,55.45
Briar,Hwei,505,255,250,50.5
Briar,Graves,317,185,132,58.36
Briar,Zoe,284,160,124,56.34
Briar,Tristana,482,223,259,46.27
Briar,Vayne,695,407,288,58.56
Briar,Sona,270,117,153,43.33
Briar,Chogath,748,390,358,52.14
Briar,Draven,353,187,166,52.97
Briar,Teemo,885,331,554,37.4
Briar,Xerath,457,240,217,52.52
Briar,Nasus,471,270,201,57.32
Briar,Riven,245,144,101,58.78
Briar,Rell,242,117,125,48.35
Briar,Nidalee,151,102,49,67.55
Briar,Hecarim,170,99,71,58.24
Briar,Varus,426,220,206,51.64
Briar,Lulu,442,248,194,56.11
Briar,Ornn,249,89,160,35.74
Briar,Jhin,1011,526,485,52.03
Briar,Nautilus,570,310,260,54.39
Briar,Sion,465,200,265,43.01
Briar,Khazix,418,219,199,52.39
Briar,Ekko,514,252,262,49.03
Briar,Singed,133,56,77,42.11
Briar,Leona,557,287,270,51.53
Briar,KogMaw,177,100,77,56.5
Briar,Thresh,825,463,362,56.12
Briar,Fizz,328,164,164,50
Briar,Jayce,242,127,115,52.48
Briar,Ziggs,253,143,110,56.52
Briar,TahmKench,717,379,338,52.86
Briar,Cassiopeia,285,136,149,47.72
Briar,Braum,307,147,160,47.88
Briar,Renekton,233,130,103,55.79
Briar,Galio,529,314,215,59.36
Briar,Malzahar,462,250,212,54.11
Briar,Karma,371,192,179,51.75
Briar,MonkeyKing,233,114,119,48.93
Briar,Aphelios,438,216,222,49.32
Briar,Viktor,387,192,195,49.61
Briar,Shen,432,207,225,47.92
Briar,Renata,175,87,88,49.71
Briar,Vi,586,312,274,53.24
Briar,Camille,243,129,114,53.09
Briar,Quinn,268,135,133,50.37
Briar,Lissandra,212,122,90,57.55
Briar,Elise,315,193,122,61.27
Briar,Kassadin,103,66,37,64.08
Briar,Evelynn,361,224,137,62.05
Briar,Karthus,126,80,46,63.49
Briar,Annie,165,125,40,75.76
Briar,LeeSin,554,316,238,57.04
Briar,Senna,541,273,268,50.46
Briar,Skarner,196,107,89,54.59
Briar,Corki,157,71,86,45.22
Briar,Viego,735,360,375,48.98
Briar,XinZhao,348,172,176,49.43
Briar,Ryze,236,135,101,57.2
Briar,Udyr,224,97,127,43.3
Briar,Qiyana,247,145,102,58.7
Briar,Taric,131,43,88,32.82
Briar,FiddleSticks,338,180,158,53.25
Briar,Bard,192,90,102,46.88
Briar,Rumble,95,45,50,47.37
Briar,JarvanIV,197,88,109,44.67
Briar,Sivir,285,111,174,38.95
Briar,Urgot,282,120,162,42.55
Briar,Azir,209,116,93,55.5
Briar,TwistedFate,163,92,71,56.44
Briar,Alistar,207,97,110,46.86
Briar,Orianna,269,129,140,47.96
Briar,Blitzcrank,459,285,174,62.09
Briar,Anivia,212,112,100,52.83
Briar,Akshan,230,119,111,51.74
Briar,Kled,165,80,85,48.48
Briar,Zilean,187,96,91,51.34
Briar,Rammus,275,147,128,53.45
Briar,Gnar,261,138,123,52.87
Briar,RekSai,86,51,35,59.3
Zoe,Fiora,131,61,70,46.56
Zoe,Lillia,171,72,99,42.11
Zoe,Aurora,290,111,179,38.28
Zoe,Zeri,146,65,81,44.52
Zoe,Rakan,125,54,71,43.2
Zoe,Vayne,334,119,215,35.63
Zoe,Nocturne,211,82,129,38.86
Zoe,Kaisa,420,196,224,46.67
Zoe,Galio,225,103,122,45.78
Zoe,Blitzcrank,245,114,131,46.53
Zoe,Urgot,175,61,114,34.86
Zoe,Kayn,453,235,218,51.88
Zoe,Yasuo,550,209,341,38
Zoe,Twitch,238,98,140,41.18
Zoe,Neeko,218,112,106,51.38
Zoe,Gragas,165,75,90,45.45
Zoe,Gwen,210,107,103,50.95
Zoe,Bard,118,59,59,50
Zoe,Tryndamere,162,64,98,39.51
Zoe,Lux,830,357,473,43.01
Zoe,Nunu,187,81,106,43.32
Zoe,Caitlyn,694,302,392,43.52
Zoe,Vladimir,143,41,102,28.67
Zoe,Yorick,243,84,159,34.57
Zoe,Ekko,314,137,177,43.63
Zoe,Katarina,283,125,158,44.17
Zoe,Jinx,639,254,385,39.75
Zoe,Sion,241,99,142,41.08
Zoe,Evelynn,149,73,76,48.99
Zoe,Akali,265,118,147,44.53
Zoe,Ezreal,452,231,221,51.11
Zoe,Aatrox,288,142,146,49.31
Zoe,Naafiri,150,97,53,64.67
Zoe,Ashe,417,165,252,39.57
Zoe,Morgana,418,181,237,43.3
Zoe,Trundle,161,52,109,32.3
Zoe,MasterYi,247,88,159,35.63
Zoe,Ahri,342,174,168,50.88
Zoe,Varus,243,90,153,37.04
Zoe,KSante,81,36,45,44.44
Zoe,Sivir,129,77,52,59.69
Zoe,Mel,530,211,319,39.81
Zoe,DrMundo,196,87,109,44.39
Zoe,Sylas,254,102,152,40.16
Zoe,Nilah,177,59,118,33.33
Zoe,Darius,563,214,349,38.01
Zoe,Shaco,298,141,157,47.32
Zoe,Zed,308,130,178,42.21
Zoe,Braum,150,74,76,49.33
Zoe,Kled,68,39,29,57.35
Zoe,Warwick,393,132,261,33.59
Zoe,Taliyah,68,19,49,27.94
Zoe,TahmKench,240,124,116,51.67
Zoe,Ornn,129,66,63,51.16
Zoe,Skarner,109,48,61,44.04
Zoe,Lucian,143,62,81,43.36
Zoe,Senna,240,91,149,37.92
Zoe,Nasus,184,39,145,21.2
Zoe,Briar,284,124,160,43.66
Zoe,AurelionSol,141,67,74,47.52
Zoe,Singed,123,37,86,30.08
Zoe,TwistedFate,118,37,81,31.36
Zoe,Brand,206,59,147,28.64
Zoe,Gnar,141,56,85,39.72
Zoe,Vi,279,98,181,35.13
Zoe,Nautilus,250,104,146,41.6
Zoe,Olaf,48,26,22,54.17
Zoe,Pantheon,426,180,246,42.25
Zoe,Renekton,101,61,40,60.4
Zoe,MissFortune,510,216,294,42.35
Zoe,Thresh,359,145,214,40.39
Zoe,Yone,506,225,281,44.47
Zoe,Draven,172,55,117,31.98
Zoe,Shen,155,57,98,36.77
Zoe,Jax,223,89,134,39.91
Zoe,Hecarim,94,42,52,44.68
Zoe,Seraphine,279,134,145,48.03
Zoe,Sett,403,152,251,37.72
Zoe,Khazix,215,96,119,44.65
Zoe,Jhin,514,224,290,43.58
Zoe,Yuumi,324,143,181,44.14
Zoe,Xayah,206,92,114,44.66
Zoe,Kennen,103,26,77,25.24
Zoe,Karma,221,70,151,31.67
Zoe,Corki,119,61,58,51.26
Zoe,Hwei,266,123,143,46.24
Zoe,Mordekaiser,406,180,226,44.33
Zoe,Chogath,322,136,186,42.24
Zoe,Pyke,330,161,169,48.79
Zoe,Garen,337,129,208,38.28
Zoe,Rengar,168,75,93,44.64
Zoe,Xerath,197,81,116,41.12
Zoe,Samira,265,115,150,43.4
Zoe,Malphite,269,89,180,33.09
Zoe,Amumu,287,106,181,36.93
Zoe,MonkeyKing,125,66,59,52.8
Zoe,Quinn,129,69,60,53.49
Zoe,Ambessa,189,72,117,38.1
Zoe,Graves,125,51,74,40.8
Zoe,Irelia,289,133,156,46.02
Zoe,Lulu,192,85,107,44.27
Zoe,KogMaw,111,38,73,34.23
Zoe,Nami,307,129,178,42.02
Zoe,Viktor,192,98,94,51.04
Zoe,Leblanc,140,73,67,52.14
Zoe,Ryze,109,53,56,48.62
Zoe,Leona,208,73,135,35.1
Zoe,Malzahar,249,61,188,24.5
Zoe,Zyra,206,83,123,40.29
Zoe,Riven,125,75,50,60
Zoe,Shyvana,104,49,55,47.12
Zoe,Cassiopeia,124,70,54,56.45
Zoe,Soraka,223,92,131,41.26
Zoe,Diana,402,169,233,42.04
Zoe,Kassadin,53,17,36,32.08
Zoe,LeeSin,271,125,146,46.13
Zoe,Swain,334,111,223,33.23
Zoe,Sejuani,129,36,93,27.91
Zoe,Illaoi,126,64,62,50.79
Zoe,Poppy,174,78,96,44.83
Zoe,Elise,151,71,80,47.02
Zoe,Smolder,180,86,94,47.78
Zoe,Maokai,105,19,86,18.1
Zoe,Orianna,120,82,38,68.33
Zoe,Volibear,286,103,183,36.01
Zoe,Aphelios,251,110,141,43.82
Zoe,Kalista,148,91,57,61.49
Zoe,Teemo,471,190,281,40.34
Zoe,Tristana,219,58,161,26.48
Zoe,Syndra,237,127,110,53.59
Zoe,Azir,124,65,59,52.42
Zoe,Ziggs,169,92,77,54.44
Zoe,JarvanIV,85,31,54,36.47
Zoe,Viego,362,155,207,42.82
Zoe,Kindred,128,54,74,42.19
Zoe,Janna,123,45,78,36.59
Zoe,Gangplank,127,44,83,34.65
Zoe,Veigar,452,217,235,48.01
Zoe,Milio,124,52,72,41.94
Zoe,Anivia,79,34,45,43.04
Zoe,Kayle,205,74,131,36.1
Zoe,FiddleSticks,114,55,59,48.25
Zoe,Jayce,133,77,56,57.89
Zoe,Zac,110,49,61,44.55
Zoe,Taric,42,6,36,14.29
Zoe,Zilean,100,26,74,26
Zoe,Karthus,83,35,48,42.17
Zoe,Ivern,65,34,31,52.31
Zoe,XinZhao,126,42,84,33.33
Zoe,Heimerdinger,122,45,77,36.89
Zoe,Akshan,135,51,84,37.78
Zoe,Camille,105,27,78,25.71
Zoe,Nidalee,79,49,30,62.03
Zoe,Lissandra,78,21,57,26.92
Zoe,Qiyana,101,51,50,50.5
Zoe,Renata,88,54,34,61.36
Zoe,Talon,168,64,104,38.1
Zoe,Fizz,155,63,92,40.65
Zoe,Rell,154,74,80,48.05
Zoe,Velkoz,175,59,116,33.71
Zoe,Udyr,92,54,38,58.7
Zoe,Alistar,96,42,54,43.75
Zoe,Vex,111,55,56,49.55
Zoe,Sona,70,32,38,45.71
Zoe,RekSai,45,13,32,28.89
Zoe,Belveth,66,22,44,33.33
Zoe,Rumble,33,19,14,57.58
Zoe,Annie,73,38,35,52.05
Zoe,Rammus,54,13,41,24.07
LeeSin,Teemo,744,294,450,39.52
LeeSin,MonkeyKing,286,108,178,37.76
LeeSin,Malzahar,462,176,286,38.1
LeeSin,Caitlyn,1439,609,830,42.32
LeeSin,Morgana,749,306,443,40.85
LeeSin,Gangplank,347,159,188,45.82
LeeSin,Warwick,1035,472,563,45.6
LeeSin,Akali,540,241,299,44.63
LeeSin,Sona,159,52,107,32.7
LeeSin,Garen,896,375,521,41.85
LeeSin,Volibear,637,338,299,53.06
LeeSin,Tristana,576,281,295,48.78
LeeSin,Lux,1715,858,857,50.03
LeeSin,Chogath,896,389,507,43.42
LeeSin,Graves,374,202,172,54.01
LeeSin,Leblanc,262,127,135,48.47
LeeSin,Milio,349,191,158,54.73
LeeSin,Mordekaiser,824,389,435,47.21
LeeSin,Amumu,492,235,257,47.76
LeeSin,Yasuo,1181,538,643,45.55
LeeSin,Soraka,416,174,242,41.83
LeeSin,Gwen,337,146,191,43.32
LeeSin,Tryndamere,357,157,200,43.98
LeeSin,Velkoz,426,212,214,49.77
LeeSin,Zeri,272,139,133,51.1
LeeSin,Thresh,893,434,459,48.6
LeeSin,KSante,329,193,136,58.66
LeeSin,Ashe,1133,537,596,47.4
LeeSin,Nasus,402,169,233,42.04
LeeSin,TahmKench,648,283,365,43.67
LeeSin,Fizz,278,124,154,44.6
LeeSin,Nunu,569,274,295,48.15
LeeSin,Vladimir,329,146,183,44.38
LeeSin,Samira,596,297,299,49.83
LeeSin,Nami,580,210,370,36.21
LeeSin,Gragas,449,204,245,45.43
LeeSin,XinZhao,421,171,250,40.62
LeeSin,Lucian,362,176,186,48.62
LeeSin,Vi,619,256,363,41.36
LeeSin,Orianna,336,152,184,45.24
LeeSin,Draven,370,182,188,49.19
LeeSin,Lulu,536,232,304,43.28
LeeSin,Viktor,417,161,256,38.61
LeeSin,Nocturne,573,243,330,42.41
LeeSin,Nilah,353,181,172,51.27
LeeSin,Bard,255,120,135,47.06
LeeSin,Sett,959,441,518,45.99
LeeSin,Kayn,1074,428,646,39.85
LeeSin,Ryze,163,52,111,31.9
LeeSin,Khazix,362,179,183,49.45
LeeSin,MissFortune,1142,513,629,44.92
LeeSin,Seraphine,663,307,356,46.3
LeeSin,Kalista,292,126,166,43.15
LeeSin,Gnar,212,114,98,53.77
LeeSin,Pyke,721,340,381,47.16
LeeSin,Pantheon,1071,498,573,46.5
LeeSin,Aurora,600,307,293,51.17
LeeSin,Jax,591,254,337,42.98
LeeSin,JarvanIV,282,105,177,37.23
LeeSin,Hwei,481,179,302,37.21
LeeSin,Kaisa,924,423,501,45.78
LeeSin,Yorick,480,198,282,41.25
LeeSin,Shaco,594,285,309,47.98
LeeSin,Katarina,585,276,309,47.18
LeeSin,Nautilus,739,354,385,47.9
LeeSin,Riven,241,111,130,46.06
LeeSin,Yone,1216,561,655,46.13
LeeSin,Trundle,247,109,138,44.13
LeeSin,Naafiri,289,107,182,37.02
LeeSin,Aphelios,505,260,245,51.49
LeeSin,Shen,358,166,192,46.37
LeeSin,Rammus,179,78,101,43.58
LeeSin,Jayce,275,148,127,53.82
LeeSin,Skarner,176,76,100,43.18
LeeSin,Jinx,1211,556,655,45.91
LeeSin,Poppy,504,231,273,45.83
LeeSin,Neeko,373,194,179,52.01
LeeSin,Sylas,582,249,333,42.78
LeeSin,Lissandra,113,45,68,39.82
LeeSin,Ezreal,1130,512,618,45.31
LeeSin,Mel,1353,688,665,50.85
LeeSin,Talon,428,187,241,43.69
LeeSin,RekSai,125,67,58,53.6
LeeSin,Leona,351,144,207,41.03
LeeSin,Ornn,301,143,158,47.51
LeeSin,Anivia,198,93,105,46.97
LeeSin,Yuumi,575,299,276,52
LeeSin,Fiora,255,136,119,53.33
LeeSin,Hecarim,208,88,120,42.31
LeeSin,Blitzcrank,556,289,267,51.98
LeeSin,Ziggs,213,81,132,38.03
LeeSin,Evelynn,385,191,194,49.61
LeeSin,Sivir,299,121,178,40.47
LeeSin,Aatrox,617,280,337,45.38
LeeSin,Xerath,390,178,212,45.64
LeeSin,Sejuani,247,126,121,51.01
LeeSin,Ahri,821,438,383,53.35
LeeSin,Camille,239,107,132,44.77
LeeSin,Rengar,282,174,108,61.7
LeeSin,Diana,729,393,336,53.91
LeeSin,Singed,153,66,87,43.14
LeeSin,Zed,623,292,331,46.87
LeeSin,Urgot,209,104,105,49.76
LeeSin,Ekko,519,265,254,51.06
LeeSin,Lillia,311,119,192,38.26
LeeSin,Smolder,476,252,224,52.94
LeeSin,Braum,220,114,106,51.82
LeeSin,Brand,381,233,148,61.15
LeeSin,Xayah,335,152,183,45.37
LeeSin,Irelia,488,226,262,46.31
LeeSin,MasterYi,628,250,378,39.81
LeeSin,Rakan,301,140,161,46.51
LeeSin,Darius,1266,557,709,44
LeeSin,Karma,517,215,302,41.59
LeeSin,Taliyah,252,118,134,46.83
LeeSin,Ambessa,390,200,190,51.28
LeeSin,Olaf,140,59,81,42.14
LeeSin,Kayle,400,176,224,44
LeeSin,Illaoi,282,135,147,47.87
LeeSin,Rell,318,185,133,58.18
LeeSin,Viego,900,441,459,49
LeeSin,Veigar,673,268,405,39.82
LeeSin,Quinn,263,125,138,47.53
LeeSin,Cassiopeia,259,104,155,40.15
LeeSin,Renata,150,40,110,26.67
LeeSin,Twitch,472,235,237,49.79
LeeSin,Sion,458,200,258,43.67
LeeSin,KogMaw,169,69,100,40.83
LeeSin,Vex,303,134,169,44.22
LeeSin,Swain,646,263,383,40.71
LeeSin,Heimerdinger,285,133,152,46.67
LeeSin,Varus,475,216,259,45.47
LeeSin,FiddleSticks,321,130,191,40.5
LeeSin,Maokai,285,79,206,27.72
LeeSin,Kindred,359,180,179,50.14
LeeSin,Vayne,589,257,332,43.63
LeeSin,Renekton,280,158,122,56.43
LeeSin,Udyr,222,88,134,39.64
LeeSin,Shyvana,184,98,86,53.26
LeeSin,Kassadin,128,79,49,61.72
LeeSin,Corki,260,123,137,47.31
LeeSin,Elise,411,192,219,46.72
LeeSin,TwistedFate,290,146,144,50.34
LeeSin,Jhin,1071,483,588,45.1
LeeSin,Kled,105,58,47,55.24
LeeSin,DrMundo,386,226,160,58.55
LeeSin,Briar,554,238,316,42.96
LeeSin,AurelionSol,324,138,186,42.59
LeeSin,Janna,214,92,122,42.99
LeeSin,Zyra,379,146,233,38.52
LeeSin,Alistar,182,101,81,55.49
LeeSin,Zoe,271,146,125,53.87
LeeSin,Senna,487,220,267,45.17
LeeSin,Karthus,151,89,62,58.94
LeeSin,Rumble,141,79,62,56.03
LeeSin,Kennen,207,89,118,43
LeeSin,Annie,180,64,116,35.56
LeeSin,Galio,437,176,261,40.27
LeeSin,Qiyana,183,124,59,67.76
LeeSin,Syndra,305,137,168,44.92
LeeSin,Taric,128,58,70,45.31
LeeSin,Malphite,502,191,311,38.05
LeeSin,Akshan,207,82,125,39.61
LeeSin,Zac,211,89,122,42.18
LeeSin,Belveth,136,47,89,34.56
LeeSin,Ivern,124,70,54,56.45
LeeSin,Azir,269,147,122,54.65
LeeSin,Zilean,164,74,90,45.12
LeeSin,Nidalee,181,97,84,53.59
Swain,Teemo,849,422,427,49.71
Swain,MonkeyKing,303,158,145,52.15
Swain,Malzahar,650,327,323,50.31
Swain,Caitlyn,1643,844,799,51.37
Swain,Morgana,858,346,512,40.33
Swain,Yorick,514,254,260,49.42
Swain,FiddleSticks,363,206,157,56.75
Swain,Draven,367,232,135,63.22
Swain,Smolder,517,292,225,56.48
Swain,Nautilus,719,407,312,56.61
Swain,Riven,340,196,144,57.65
Swain,Kayn,1027,513,514,49.95
Swain,Ahri,859,481,378,56
Swain,Jinx,1339,684,655,51.08
Swain,Renekton,263,164,99,62.36
Swain,JarvanIV,297,155,142,52.19
Swain,Mel,1440,789,651,54.79
Swain,Jhin,1194,661,533,55.36
Swain,Sylas,788,382,406,48.48
Swain,Samira,714,354,360,49.58
Swain,Nilah,371,220,151,59.3
Swain,Leona,515,272,243,52.82
Swain,Shen,487,229,258,47.02
Swain,Gragas,384,205,179,53.39
Swain,Yone,1252,674,578,53.83
Swain,Ashe,1183,541,642,45.73
Swain,Alistar,189,119,70,62.96
Swain,Tryndamere,378,229,149,60.58
Swain,Irelia,602,300,302,49.83
Swain,Kalista,313,194,119,61.98
Swain,Twitch,513,247,266,48.15
Swain,Nasus,502,252,250,50.2
Swain,Khazix,383,178,205,46.48
Swain,Diana,770,454,316,58.96
Swain,Urgot,341,164,177,48.09
Swain,Lulu,512,295,217,57.62
Swain,KSante,258,101,157,39.15
Swain,Darius,1291,706,585,54.69
Swain,Azir,222,124,98,55.86
Swain,Aphelios,488,275,213,56.35
Swain,Soraka,385,192,193,49.87
Swain,Taliyah,160,68,92,42.5
Swain,Senna,595,306,289,51.43
Swain,Sett,1048,608,440,58.02
Swain,Akali,690,401,289,58.12
Swain,Tristana,644,339,305,52.64
Swain,Blitzcrank,619,378,241,61.07
Swain,Nidalee,124,96,28,77.42
Swain,Aurora,661,374,287,56.58
Swain,MissFortune,1322,709,613,53.63
Swain,Nami,612,270,342,44.12
Swain,Chogath,962,511,451,53.12
Swain,Lillia,504,276,228,54.76
Swain,Vex,347,190,157,54.76
Swain,Janna,200,88,112,44
Swain,TahmKench,783,472,311,60.28
Swain,Jax,512,299,213,58.4
Swain,Mordekaiser,1056,475,581,44.98
Swain,Pantheon,1077,575,502,53.39
Swain,Yasuo,1323,699,624,52.83
Swain,Braum,337,205,132,60.83
Swain,Maokai,328,204,124,62.2
Swain,Gnar,245,177,68,72.24
Swain,Shaco,626,328,298,52.4
Swain,Xayah,400,201,199,50.25
Swain,Seraphine,728,344,384,47.25
Swain,Briar,589,317,272,53.82
Swain,Fizz,297,171,126,57.58
Swain,Singed,169,61,108,36.09
Swain,Garen,980,557,423,56.84
Swain,Zed,609,327,282,53.69
Swain,KogMaw,204,98,106,48.04
Swain,Lux,1820,937,883,51.48
Swain,Katarina,544,315,229,57.9
Swain,Neeko,550,341,209,62
Swain,Yuumi,670,340,330,50.75
Swain,Talon,371,207,164,55.8
Swain,Milio,340,188,152,55.29
Swain,Ornn,303,173,130,57.1
Swain,TwistedFate,257,164,93,63.81
Swain,Annie,233,138,95,59.23
Swain,Kayle,486,290,196,59.67
Swain,Sona,311,141,170,45.34
Swain,Rengar,297,215,82,72.39
Swain,Malphite,449,246,203,54.79
Swain,Veigar,791,401,390,50.7
Swain,Zyra,501,265,236,52.89
Swain,Kennen,264,147,117,55.68
Swain,Ekko,488,256,232,52.46
Swain,Ezreal,1178,650,528,55.18
Swain,Trundle,371,157,214,42.32
Swain,MasterYi,795,406,389,51.07
Swain,Varus,508,287,221,56.5
Swain,Heimerdinger,311,164,147,52.73
Swain,DrMundo,438,230,208,52.51
Swain,Graves,304,179,125,58.88
Swain,Leblanc,169,105,64,62.13
Swain,Vladimir,382,221,161,57.85
Swain,Volibear,840,376,464,44.76
Swain,Qiyana,292,178,114,60.96
Swain,Kaisa,1052,607,445,57.7
Swain,Xerath,362,177,185,48.9
Swain,Illaoi,305,128,177,41.97
Swain,Warwick,1138,497,641,43.67
Swain,Naafiri,353,235,118,66.57
Swain,Orianna,258,141,117,54.65
Swain,Zilean,181,85,96,46.96
Swain,Ivern,119,70,49,58.82
Swain,Velkoz,388,186,202,47.94
Swain,Rakan,397,232,165,58.44
Swain,Karma,514,248,266,48.25
Swain,Jayce,262,119,143,45.42
Swain,Vayne,686,375,311,54.66
Swain,Brand,505,296,209,58.61
Swain,Fiora,321,163,158,50.78
Swain,Camille,221,167,54,75.57
Swain,LeeSin,646,383,263,59.29
Swain,Syndra,336,126,210,37.5
Swain,Hwei,561,324,237,57.75
Swain,Thresh,954,486,468,50.94
Swain,Ryze,158,88,70,55.7
Swain,Zeri,250,153,97,61.2
Swain,Zac,230,139,91,60.43
Swain,Viego,768,367,401,47.79
Swain,Bard,190,129,61,67.89
Swain,Cassiopeia,252,125,127,49.6
Swain,Poppy,364,193,171,53.02
Swain,Kassadin,173,65,108,37.57
Swain,Karthus,174,102,72,58.62
Swain,Pyke,726,441,285,60.74
Swain,Nocturne,550,323,227,58.73
Swain,Galio,573,283,290,49.39
Swain,Sion,520,271,249,52.12
Swain,Aatrox,680,327,353,48.09
Swain,Rammus,170,58,112,34.12
Swain,Rell,376,231,145,61.44
Swain,Corki,205,126,79,61.46
Swain,Skarner,229,122,107,53.28
Swain,Gangplank,307,174,133,56.68
Swain,Udyr,228,112,116,49.12
Swain,Vi,622,360,262,57.88
Swain,Nunu,550,362,188,65.82
Swain,Taric,129,58,71,44.96
Swain,Zoe,334,223,111,66.77
Swain,Elise,313,161,152,51.44
Swain,Kindred,345,197,148,57.1
Swain,Sejuani,270,147,123,54.44
Swain,Ziggs,278,176,102,63.31
Swain,Evelynn,323,196,127,60.68
Swain,Amumu,627,313,314,49.92
Swain,Shyvana,205,89,116,43.41
Swain,Lissandra,184,108,76,58.7
Swain,Viktor,490,284,206,57.96
Swain,Olaf,158,72,86,45.57
Swain,Ambessa,420,239,181,56.9
Swain,Sivir,304,138,166,45.39
Swain,Quinn,216,109,107,50.46
Swain,Akshan,248,122,126,49.19
Swain,Gwen,298,153,145,51.34
Swain,Lucian,289,163,126,56.4
Swain,Rumble,152,62,90,40.79
Swain,XinZhao,434,215,219,49.54
Swain,AurelionSol,282,117,165,41.49
Swain,Anivia,234,109,125,46.58
Swain,Belveth,171,103,68,60.23
Swain,Hecarim,237,130,107,54.85
Swain,Renata,168,110,58,65.48
Swain,RekSai,118,54,64,45.76
Swain,Kled,127,62,65,48.82
Teemo,Yorick,883,432,451,48.92
Teemo,LeeSin,744,450,294,60.48
Teemo,Ezreal,1384,788,596,56.94
Teemo,Jinx,1764,956,808,54.2
Teemo,Swain,849,427,422,50.29
Teemo,MonkeyKing,410,186,224,45.37
Teemo,Kayn,1315,704,611,53.54
Teemo,Yasuo,1696,920,776,54.25
Teemo,Kaisa,1050,652,398,62.1
Teemo,Milio,429,203,226,47.32
Teemo,Vayne,794,434,360,54.66
Teemo,Nocturne,786,403,383,51.27
Teemo,Galio,533,256,277,48.03
Teemo,Blitzcrank,666,385,281,57.81
Teemo,Warwick,1329,707,622,53.2
Teemo,Evelynn,575,362,213,62.96
Teemo,Ahri,1178,636,542,53.99
Teemo,Yone,1663,947,716,56.95
Teemo,Garen,1331,797,534,59.88
Teemo,Lux,2269,1280,989,56.41
Teemo,Caitlyn,2187,1128,1059,51.58
Teemo,Thresh,1131,616,515,54.47
Teemo,Irelia,619,351,268,56.7
Teemo,Sivir,415,217,198,52.29
Teemo,Rell,483,258,225,53.42
Teemo,Aatrox,1066,625,441,58.63
Teemo,Gwen,519,309,210,59.54
Teemo,Syndra,477,249,228,52.2
Teemo,Ashe,1516,866,650,57.12
Teemo,Lulu,640,341,299,53.28
Teemo,Mordekaiser,1292,638,654,49.38
Teemo,Amumu,851,428,423,50.29
Teemo,Soraka,525,267,258,50.86
Teemo,Smolder,683,378,305,55.34
Teemo,Velkoz,567,332,235,58.55
Teemo,Chogath,1218,550,668,45.16
Teemo,Talon,486,278,208,57.2
Teemo,Qiyana,261,156,105,59.77
Teemo,Mel,1696,905,791,53.36
Teemo,Seraphine,889,490,399,55.12
Teemo,Zed,772,459,313,59.46
Teemo,Shaco,708,439,269,62.01
Teemo,Anivia,243,84,159,34.57
Teemo,Morgana,1004,559,445,55.68
Teemo,Tryndamere,487,271,216,55.65
Teemo,Zeri,426,201,225,47.18
Teemo,Volibear,929,504,425,54.25
Teemo,Veigar,1082,540,542,49.91
Teemo,Sona,402,223,179,55.47
Teemo,Sion,741,346,395,46.69
Teemo,Akshan,308,145,163,47.08
Teemo,Bard,285,155,130,54.39
Teemo,Gangplank,411,221,190,53.77
Teemo,Taliyah,270,170,100,62.96
Teemo,Akali,898,486,412,54.12
Teemo,Belveth,254,132,122,51.97
Teemo,Hwei,646,306,340,47.37
Teemo,TahmKench,837,462,375,55.2
Teemo,MissFortune,1978,1048,930,52.98
Teemo,Lillia,544,273,271,50.18
Teemo,Gnar,373,225,148,60.32
Teemo,Rammus,215,96,119,44.65
Teemo,Poppy,419,199,220,47.49
Teemo,Sett,1280,637,643,49.77
Teemo,MasterYi,914,477,437,52.19
Teemo,AurelionSol,420,249,171,59.29
Teemo,Kindred,515,319,196,61.94
Teemo,Kennen,348,190,158,54.6
Teemo,Tristana,775,429,346,55.35
Teemo,Yuumi,840,410,430,48.81
Teemo,Ekko,634,366,268,57.73
Teemo,Lucian,437,214,223,48.97
Teemo,TwistedFate,315,194,121,61.59
Teemo,Cassiopeia,451,231,220,51.22
Teemo,DrMundo,486,243,243,50
Teemo,Nautilus,989,549,440,55.51
Teemo,Trundle,430,223,207,51.86
Teemo,Aphelios,619,368,251,59.45
Teemo,Malphite,936,450,486,48.08
Teemo,Vladimir,471,252,219,53.5
Teemo,Senna,790,411,379,52.03
Teemo,Ziggs,458,261,197,56.99
Teemo,Sejuani,350,223,127,63.71
Teemo,Heimerdinger,529,259,270,48.96
Teemo,Zilean,224,118,106,52.68
Teemo,Hecarim,309,142,167,45.95
Teemo,Twitch,662,353,309,53.32
Teemo,Ivern,181,117,64,64.64
Teemo,Jhin,1547,845,702,54.62
Teemo,Pyke,1095,603,492,55.07
Teemo,Viego,1145,556,589,48.56
Teemo,Kalista,375,198,177,52.8
Teemo,FiddleSticks,480,246,234,51.25
Teemo,Udyr,364,169,195,46.43
Teemo,Leblanc,294,166,128,56.46
Teemo,Nami,807,422,385,52.29
Teemo,Vi,659,383,276,58.12
Teemo,Nilah,465,240,225,51.61
Teemo,Samira,847,447,400,52.77
Teemo,Taric,207,100,107,48.31
Teemo,Ornn,401,172,229,42.89
Teemo,Skarner,226,92,134,40.71
Teemo,Illaoi,385,216,169,56.1
Teemo,Naafiri,339,191,148,56.34
Teemo,Xayah,494,278,216,56.28
Teemo,Rakan,384,194,190,50.52
Teemo,Nasus,779,440,339,56.48
Teemo,Zac,289,162,127,56.06
Teemo,Briar,885,554,331,62.6
Teemo,Urgot,371,203,168,54.72
Teemo,Draven,489,232,257,47.44
Teemo,Vex,576,302,274,52.43
Teemo,Diana,1209,650,559,53.76
Teemo,Leona,612,309,303,50.49
Teemo,Ryze,300,146,154,48.67
Teemo,Aurora,851,492,359,57.81
Teemo,Braum,441,196,245,44.44
Teemo,Jax,653,314,339,48.09
Teemo,Zyra,648,301,347,46.45
Teemo,Gragas,505,330,175,65.35
Teemo,Xerath,587,374,213,63.71
Teemo,Quinn,358,206,152,57.54
Teemo,Darius,1704,913,791,53.58
Teemo,Renata,220,99,121,45
Teemo,Ambessa,452,268,184,59.29
Teemo,KogMaw,279,137,142,49.1
Teemo,Nunu,692,346,346,50
Teemo,Azir,270,143,127,52.96
Teemo,Renekton,279,172,107,61.65
Teemo,Khazix,569,333,236,58.52
Teemo,Brand,665,346,319,52.03
Teemo,Neeko,667,382,285,57.27
Teemo,Fiora,295,160,135,54.24
Teemo,Malzahar,735,364,371,49.52
Teemo,Kayle,744,361,383,48.52
Teemo,Corki,232,130,102,56.03
Teemo,Janna,206,125,81,60.68
Teemo,Fizz,448,210,238,46.88
Teemo,Alistar,266,192,74,72.18
Teemo,Sylas,858,481,377,56.06
Teemo,Varus,743,395,348,53.16
Teemo,Shyvana,238,110,128,46.22
Teemo,Lissandra,249,132,117,53.01
Teemo,Kled,208,104,104,50
Teemo,Graves,481,258,223,53.64
Teemo,Orianna,327,196,131,59.94
Teemo,Shen,467,206,261,44.11
Teemo,Elise,482,264,218,54.77
Teemo,Rengar,339,210,129,61.95
Teemo,Maokai,388,176,212,45.36
Teemo,Singed,193,62,131,32.12
Teemo,Riven,370,209,161,56.49
Teemo,Katarina,702,368,334,52.42
Teemo,Olaf,231,151,80,65.37
Teemo,KSante,247,162,85,65.59
Teemo,Kassadin,150,88,62,58.67
Teemo,Karthus,218,107,111,49.08
Teemo,Annie,278,164,114,58.99
Teemo,Viktor,541,327,214,60.44
Teemo,Pantheon,1405,777,628,55.3
Teemo,Nidalee,220,123,97,55.91
Teemo,JarvanIV,320,146,174,45.63
Teemo,Zoe,471,281,190,59.66
Teemo,Karma,583,333,250,57.12
Teemo,Rumble,301,148,153,49.17
Teemo,XinZhao,465,255,210,54.84
Teemo,RekSai,123,88,35,71.54
Teemo,Camille,279,159,120,56.99
Teemo,Jayce,389,189,200,48.59
MonkeyKing,Yorick,306,135,171,44.12
MonkeyKing,LeeSin,286,178,108,62.24
MonkeyKing,Ezreal,551,266,285,48.28
MonkeyKing,Jinx,698,363,335,52.01
MonkeyKing,Swain,303,145,158,47.85
MonkeyKing,Teemo,410,224,186,54.63
MonkeyKing,Warwick,538,250,288,46.47
MonkeyKing,Azir,132,98,34,74.24
MonkeyKing,MissFortune,714,358,356,50.14
MonkeyKing,Neeko,232,116,116,50
MonkeyKing,Mordekaiser,495,228,267,46.06
MonkeyKing,Qiyana,81,47,34,58.02
MonkeyKing,Mel,689,298,391,43.25
MonkeyKing,Nautilus,304,155,149,50.99
MonkeyKing,Sett,464,228,236,49.14
MonkeyKing,Taliyah,104,59,45,56.73
MonkeyKing,Sylas,291,164,127,56.36
MonkeyKing,Morgana,372,198,174,53.23
MonkeyKing,Tryndamere,173,89,84,51.45
MonkeyKing,Kayn,462,259,203,56.06
MonkeyKing,Aurora,308,173,135,56.17
MonkeyKing,Twitch,267,114,153,42.7
MonkeyKing,Lux,796,392,404,49.25
MonkeyKing,Ahri,423,220,203,52.01
MonkeyKing,Nunu,249,109,140,43.78
MonkeyKing,Yasuo,693,362,331,52.24
MonkeyKing,Zyra,230,104,126,45.22
MonkeyKing,Chogath,369,165,204,44.72
MonkeyKing,Lillia,185,112,73,60.54
MonkeyKing,Vex,182,87,95,47.8
MonkeyKing,Jhin,489,271,218,55.42
MonkeyKing,Janna,100,60,40,60
MonkeyKing,Caitlyn,718,346,372,48.19
MonkeyKing,Soraka,202,81,121,40.1
MonkeyKing,Kayle,218,87,131,39.91
MonkeyKing,Ekko,249,131,118,52.61
MonkeyKing,Irelia,288,162,126,56.25
MonkeyKing,Yuumi,239,163,76,68.2
MonkeyKing,Volibear,353,183,170,51.84
MonkeyKing,Lucian,164,112,52,68.29
MonkeyKing,Blitzcrank,220,113,107,51.36
MonkeyKing,Akali,308,165,143,53.57
MonkeyKing,Evelynn,160,63,97,39.38
MonkeyKing,Velkoz,147,71,76,48.3
MonkeyKing,Jax,284,129,155,45.42
MonkeyKing,Braum,178,84,94,47.19
MonkeyKing,Viego,448,223,225,49.78
MonkeyKing,Heimerdinger,171,71,100,41.52
MonkeyKing,Udyr,132,66,66,50
MonkeyKing,Malzahar,230,101,129,43.91
MonkeyKing,Xayah,219,123,96,56.16
MonkeyKing,Rammus,94,31,63,32.98
MonkeyKing,Varus,266,108,158,40.6
MonkeyKing,Yone,605,323,282,53.39
MonkeyKing,Graves,210,113,97,53.81
MonkeyKing,Aatrox,285,158,127,55.44
MonkeyKing,Ziggs,148,80,68,54.05
MonkeyKing,Kindred,165,87,78,52.73
MonkeyKing,Ryze,118,50,68,42.37
MonkeyKing,Karthus,69,35,34,50.72
MonkeyKing,Kassadin,65,47,18,72.31
MonkeyKing,Renekton,121,65,56,53.72
MonkeyKing,XinZhao,196,118,78,60.2
MonkeyKing,Leblanc,118,53,65,44.92
MonkeyKing,Shen,213,107,106,50.23
MonkeyKing,Pyke,312,202,110,64.74
MonkeyKing,Viktor,186,97,89,52.15
MonkeyKing,Ashe,494,234,260,47.37
MonkeyKing,Senna,291,165,126,56.7
MonkeyKing,Garen,496,243,253,48.99
MonkeyKing,JarvanIV,136,94,42,69.12
MonkeyKing,Hwei,216,122,94,56.48
MonkeyKing,Lulu,258,134,124,51.94
MonkeyKing,Leona,195,80,115,41.03
MonkeyKing,Ivern,89,39,50,43.82
MonkeyKing,Olaf,65,34,31,52.31
MonkeyKing,Katarina,362,201,161,55.52
MonkeyKing,Kled,92,42,50,45.65
MonkeyKing,Poppy,162,72,90,44.44
MonkeyKing,Zeri,104,67,37,64.42
MonkeyKing,Gangplank,139,89,50,64.03
MonkeyKing,Smolder,225,138,87,61.33
MonkeyKing,Alistar,147,83,64,56.46
MonkeyKing,Urgot,153,63,90,41.18
MonkeyKing,MasterYi,354,219,135,61.86
MonkeyKing,Zed,291,155,136,53.26
MonkeyKing,Milio,197,84,113,42.64
MonkeyKing,Briar,233,119,114,51.07
MonkeyKing,Illaoi,136,69,67,50.74
MonkeyKing,Shaco,308,162,146,52.6
MonkeyKing,Draven,174,84,90,48.28
MonkeyKing,Vayne,309,174,135,56.31
MonkeyKing,Nasus,193,69,124,35.75
MonkeyKing,Zoe,125,59,66,47.2
MonkeyKing,Pantheon,500,275,225,55
MonkeyKing,DrMundo,235,132,103,56.17
MonkeyKing,Seraphine,343,144,199,41.98
MonkeyKing,Zac,104,51,53,49.04
MonkeyKing,AurelionSol,142,82,60,57.75
MonkeyKing,Aphelios,185,71,114,38.38
MonkeyKing,Tristana,255,102,153,40
MonkeyKing,TwistedFate,106,66,40,62.26
MonkeyKing,Taric,34,13,21,38.24
MonkeyKing,Khazix,305,199,106,65.25
MonkeyKing,Fiora,147,61,86,41.5
MonkeyKing,Diana,429,245,184,57.11
MonkeyKing,Brand,246,145,101,58.94
MonkeyKing,Veigar,369,194,175,52.57
MonkeyKing,Camille,99,66,33,66.67
MonkeyKing,Vladimir,138,57,81,41.3
MonkeyKing,Gragas,168,65,103,38.69
MonkeyKing,FiddleSticks,189,97,92,51.32
MonkeyKing,Orianna,137,76,61,55.47
MonkeyKing,Elise,178,116,62,65.17
MonkeyKing,Riven,135,84,51,62.22
MonkeyKing,Darius,524,282,242,53.82
MonkeyKing,KSante,122,60,62,49.18
MonkeyKing,Thresh,414,195,219,47.1
MonkeyKing,Xerath,136,77,59,56.62
MonkeyKing,Fizz,137,53,84,38.69
MonkeyKing,Annie,70,26,44,37.14
MonkeyKing,Maokai,135,40,95,29.63
MonkeyKing,Kaisa,441,286,155,64.85
MonkeyKing,Rell,161,96,65,59.63
MonkeyKing,Talon,206,150,56,72.82
MonkeyKing,Gwen,182,105,77,57.69
MonkeyKing,Naafiri,133,60,73,45.11
MonkeyKing,Samira,326,190,136,58.28
MonkeyKing,Sona,121,67,54,55.37
MonkeyKing,Ornn,119,68,51,57.14
MonkeyKing,Skarner,153,108,45,70.59
MonkeyKing,Anivia,119,43,76,36.13
MonkeyKing,Gnar,90,41,49,45.56
MonkeyKing,Rakan,185,86,99,46.49
MonkeyKing,KogMaw,65,27,38,41.54
MonkeyKing,Vi,256,97,159,37.89
MonkeyKing,Sion,210,94,116,44.76
MonkeyKing,TahmKench,389,210,179,53.98
MonkeyKing,Trundle,159,68,91,42.77
MonkeyKing,Nocturne,242,134,108,55.37
MonkeyKing,Cassiopeia,112,30,82,26.79
MonkeyKing,Quinn,113,68,45,60.18
MonkeyKing,Hecarim,108,52,56,48.15
MonkeyKing,Akshan,102,66,36,64.71
MonkeyKing,Ambessa,177,93,84,52.54
MonkeyKing,Malphite,211,128,83,60.66
MonkeyKing,Karma,241,121,120,50.21
MonkeyKing,Amumu,302,160,142,52.98
MonkeyKing,Rengar,113,88,25,77.88
MonkeyKing,Nilah,180,96,84,53.33
MonkeyKing,Kalista,140,74,66,52.86
MonkeyKing,Zilean,80,47,33,58.75
MonkeyKing,Singed,85,30,55,35.29
MonkeyKing,Lissandra,122,62,60,50.82
MonkeyKing,Bard,92,49,43,53.26
MonkeyKing,Nami,284,144,140,50.7
MonkeyKing,Shyvana,119,44,75,36.97
MonkeyKing,Rumble,63,46,17,73.02
MonkeyKing,Jayce,135,54,81,40
MonkeyKing,Galio,180,64,116,35.56
MonkeyKing,Syndra,138,77,61,55.8
MonkeyKing,Belveth,96,50,46,52.08
MonkeyKing,Kennen,129,80,49,62.02
MonkeyKing,Renata,67,36,31,53.73
MonkeyKing,Corki,119,82,37,68.91
MonkeyKing,Sejuani,97,48,49,49.48
MonkeyKing,Sivir,164,62,102,37.8
MonkeyKing,Nidalee,89,45,44,50.56
MonkeyKing,RekSai,24,6,18,25
Malzahar,Yorick,424,195,229,45.99
Malzahar,LeeSin,462,286,176,61.9
Malzahar,Ezreal,889,515,374,57.93
Malzahar,Jinx,1052,528,524,50.19
Malzahar,Swain,650,323,327,49.69
Malzahar,TahmKench,537,322,215,59.96
Malzahar,Malphite,385,195,190,50.65
Malzahar,Yasuo,1036,517,519,49.9
Malzahar,Aphelios,419,274,145,65.39
Malzahar,TwistedFate,220,114,106,51.82
Malzahar,Renekton,193,97,96,50.26
Malzahar,JarvanIV,203,77,126,37.93
Malzahar,Mel,1040,557,483,53.56
Malzahar,Jhin,847,427,420,50.41
Malzahar,Sylas,394,218,176,55.33
Malzahar,Darius,857,498,359,58.11
Malzahar,Rengar,205,132,73,64.39
Malzahar,Syndra,279,128,151,45.88
Malzahar,Caitlyn,1126,649,477,57.64
Malzahar,Lux,1228,705,523,57.41
Malzahar,Chogath,678,373,305,55.01
Malzahar,Morgana,584,336,248,57.53
Malzahar,Gnar,211,121,90,57.35
Malzahar,Viego,531,305,226,57.44
Malzahar,Yone,812,443,369,54.56
Malzahar,Kaisa,653,353,300,54.06
Malzahar,Sett,809,445,364,55.01
Malzahar,Sion,343,162,181,47.23
Malzahar,Samira,390,260,130,66.67
Malzahar,Alistar,151,81,70,53.64
Malzahar,Viktor,360,212,148,58.89
Malzahar,Nocturne,392,219,173,55.87
Malzahar,Annie,118,77,41,65.25
Malzahar,KogMaw,155,71,84,45.81
Malzahar,Kindred,324,205,119,63.27
Malzahar,Veigar,526,291,235,55.32
Malzahar,Corki,151,100,51,66.23
Malzahar,Pantheon,830,487,343,58.67
Malzahar,Jax,362,241,121,66.57
Malzahar,Hwei,374,195,179,52.14
Malzahar,Bard,138,94,44,68.12
Malzahar,FiddleSticks,261,157,104,60.15
Malzahar,Cassiopeia,192,92,100,47.92
Malzahar,Milio,217,111,106,51.15
Malzahar,Quinn,152,73,79,48.03
Malzahar,Talon,342,205,137,59.94
Malzahar,Olaf,127,67,60,52.76
Malzahar,Aatrox,430,263,167,61.16
Malzahar,Katarina,387,265,122,68.48
Malzahar,Smolder,506,269,237,53.16
Malzahar,Braum,189,81,108,42.86
Malzahar,Shaco,453,269,184,59.38
Malzahar,Riven,137,89,48,64.96
Malzahar,Senna,452,243,209,53.76
Malzahar,Jayce,230,139,91,60.43
Malzahar,Rammus,194,117,77,60.31
Malzahar,Kayn,738,453,285,61.38
Malzahar,Ahri,683,409,274,59.88
Malzahar,Tristana,388,222,166,57.22
Malzahar,Nasus,326,202,124,61.96
Malzahar,Amumu,446,229,217,51.35
Malzahar,Naafiri,287,125,162,43.55
Malzahar,MissFortune,944,510,434,54.03
Malzahar,Xerath,345,188,157,54.49
Malzahar,Trundle,217,98,119,45.16
Malzahar,Irelia,422,213,209,50.47
Malzahar,Evelynn,248,169,79,68.15
Malzahar,Anivia,155,101,54,65.16
Malzahar,Poppy,299,128,171,42.81
Malzahar,Fiora,222,131,91,59.01
Malzahar,Diana,665,373,292,56.09
Malzahar,Ashe,805,491,314,60.99
Malzahar,Volibear,559,299,260,53.49
Malzahar,Seraphine,506,244,262,48.22
Malzahar,Azir,194,105,89,54.12
Malzahar,Ziggs,204,104,100,50.98
Malzahar,Lulu,437,209,228,47.83
Malzahar,Mordekaiser,675,334,341,49.48
Malzahar,Leblanc,171,106,65,61.99
Malzahar,Shen,361,171,190,47.37
Malzahar,Pyke,505,318,187,62.97
Malzahar,Nautilus,438,224,214,51.14
Malzahar,MonkeyKing,230,129,101,56.09
Malzahar,Akali,514,327,187,63.62
Malzahar,Zed,464,241,223,51.94
Malzahar,Draven,240,145,95,60.42
Malzahar,Yuumi,412,210,202,50.97
Malzahar,Elise,195,111,84,56.92
Malzahar,Gangplank,249,139,110,55.82
Malzahar,Xayah,319,180,139,56.43
Malzahar,Sona,173,56,117,32.37
Malzahar,Soraka,282,148,134,52.48
Malzahar,Akshan,220,102,118,46.36
Malzahar,Illaoi,215,125,90,58.14
Malzahar,Nidalee,134,78,56,58.21
Malzahar,Orianna,228,127,101,55.7
Malzahar,Zyra,228,117,111,51.32
Malzahar,Varus,415,206,209,49.64
Malzahar,Nilah,220,129,91,58.64
Malzahar,Karma,329,165,164,50.15
Malzahar,Velkoz,251,155,96,61.75
Malzahar,Warwick,714,362,352,50.7
Malzahar,MasterYi,418,206,212,49.28
Malzahar,Nunu,451,238,213,52.77
Malzahar,Gragas,251,132,119,52.59
Malzahar,Gwen,313,164,149,52.4
Malzahar,Vi,402,233,169,57.96
Malzahar,Lillia,282,159,123,56.38
Malzahar,Neeko,338,162,176,47.93
Malzahar,Briar,462,212,250,45.89
Malzahar,Urgot,218,104,114,47.71
Malzahar,Camille,120,58,62,48.33
Malzahar,Tryndamere,290,193,97,66.55
Malzahar,Teemo,735,371,364,50.48
Malzahar,Heimerdinger,227,127,100,55.95
Malzahar,Lissandra,104,77,27,74.04
Malzahar,Kalista,239,122,117,51.05
Malzahar,DrMundo,275,127,148,46.18
Malzahar,Shyvana,162,74,88,45.68
Malzahar,Garen,665,351,314,52.78
Malzahar,Singed,154,100,54,64.94
Malzahar,Thresh,710,413,297,58.17
Malzahar,Udyr,176,95,81,53.98
Malzahar,Kayle,359,192,167,53.48
Malzahar,Leona,329,198,131,60.18
Malzahar,Zeri,240,144,96,60
Malzahar,Kassadin,89,55,34,61.8
Malzahar,Rell,289,137,152,47.4
Malzahar,Ornn,201,134,67,66.67
Malzahar,Zoe,249,188,61,75.5
Malzahar,Ekko,325,186,139,57.23
Malzahar,Vayne,421,203,218,48.22
Malzahar,Kennen,201,95,106,47.26
Malzahar,Aurora,487,281,206,57.7
Malzahar,Brand,313,183,130,58.47
Malzahar,KSante,177,108,69,61.02
Malzahar,Twitch,335,185,150,55.22
Malzahar,Ryze,157,105,52,66.88
Malzahar,Lucian,263,147,116,55.89
Malzahar,Blitzcrank,413,267,146,64.65
Malzahar,Taric,86,35,51,40.7
Malzahar,Vladimir,223,114,109,51.12
Malzahar,Maokai,219,90,129,41.1
Malzahar,Vex,246,140,106,56.91
Malzahar,Zilean,158,107,51,67.72
Malzahar,Ambessa,272,137,135,50.37
Malzahar,Karthus,126,89,37,70.63
Malzahar,Hecarim,136,69,67,50.74
Malzahar,Sejuani,215,116,99,53.95
Malzahar,Galio,385,217,168,56.36
Malzahar,Nami,482,270,212,56.02
Malzahar,Graves,285,141,144,49.47
Malzahar,XinZhao,261,142,119,54.41
Malzahar,Skarner,130,76,54,58.46
Malzahar,Qiyana,144,96,48,66.67
Malzahar,Rumble,83,48,35,57.83
Malzahar,Sivir,183,90,93,49.18
Malzahar,Fizz,270,138,132,51.11
Malzahar,AurelionSol,310,152,158,49.03
Malzahar,Renata,170,112,58,65.88
Malzahar,Rakan,272,128,144,47.06
Malzahar,Khazix,278,157,121,56.47
Malzahar,Ivern,83,53,30,63.86
Malzahar,Zac,142,90,52,63.38
Malzahar,Kled,72,41,31,56.94
Malzahar,RekSai,90,58,32,64.44
Malzahar,Belveth,151,124,27,82.12
Malzahar,Taliyah,107,58,49,54.21
Malzahar,Janna,127,70,57,55.12
Caitlyn,Yorick,1467,577,890,39.33
Caitlyn,LeeSin,1439,830,609,57.68
Caitlyn,Ezreal,3082,1611,1471,52.27
Caitlyn,Jinx,3402,1683,1719,49.47
Caitlyn,Swain,1643,799,844,48.63
Caitlyn,Illaoi,765,308,457,40.26
Caitlyn,Twitch,1078,532,546,49.35
Caitlyn,Yone,2827,1404,1423,49.66
Caitlyn,Lux,3705,1855,1850,50.07
Caitlyn,Velkoz,951,472,479,49.63
Caitlyn,Pantheon,2188,1109,1079,50.69
Caitlyn,Diana,2080,1050,1030,50.48
Caitlyn,Gangplank,740,374,366,50.54
Caitlyn,Yuumi,1300,652,648,50.15
Caitlyn,Mordekaiser,2408,1194,1214,49.58
Caitlyn,Viego,1754,821,933,46.81
Caitlyn,Irelia,1322,622,700,47.05
Caitlyn,Jhin,2986,1481,1505,49.6
Caitlyn,Kayn,2217,1160,1057,52.32
Caitlyn,Ryze,409,206,203,50.37
Caitlyn,Briar,1469,777,692,52.89
Caitlyn,Vex,877,446,431,50.86
Caitlyn,MissFortune,3730,1712,2018,45.9
Caitlyn,Mel,3072,1512,1560,49.22
Caitlyn,Zed,1484,851,633,57.35
Caitlyn,Galio,911,509,402,55.87
Caitlyn,TahmKench,1711,910,801,53.19
Caitlyn,Warwick,2325,1198,1127,51.53
Caitlyn,Yasuo,2910,1355,1555,46.56
Caitlyn,Teemo,2187,1059,1128,48.42
Caitlyn,XinZhao,801,349,452,43.57
Caitlyn,Neeko,1208,628,580,51.99
Caitlyn,Morgana,1801,952,849,52.86
Caitlyn,Xayah,1080,545,535,50.46
Caitlyn,Veigar,1673,809,864,48.36
Caitlyn,Aatrox,1426,760,666,53.3
Caitlyn,Ekko,1189,644,545,54.16
Caitlyn,Orianna,698,384,314,55.01
Caitlyn,Malzahar,1126,477,649,42.36
Caitlyn,Maokai,682,322,360,47.21
Caitlyn,Ambessa,868,436,432,50.23
Caitlyn,AurelionSol,717,338,379,47.14
Caitlyn,Khazix,929,499,430,53.71
Caitlyn,Nautilus,1486,660,826,44.41
Caitlyn,Lillia,1031,520,511,50.44
Caitlyn,Tristana,1386,682,704,49.21
Caitlyn,Poppy,891,468,423,52.53
Caitlyn,Heimerdinger,738,340,398,46.07
Caitlyn,Ziggs,750,383,367,51.07
Caitlyn,Olaf,235,105,130,44.68
Caitlyn,Seraphine,1687,762,925,45.17
Caitlyn,Karma,1080,547,533,50.65
Caitlyn,Nami,1330,676,654,50.83
Caitlyn,Rakan,828,422,406,50.97
Caitlyn,Soraka,918,400,518,43.57
Caitlyn,Aurora,1352,758,594,56.07
Caitlyn,Kaisa,2167,1197,970,55.24
Caitlyn,Chogath,1881,847,1034,45.03
Caitlyn,Talon,957,571,386,59.67
Caitlyn,Qiyana,519,301,218,58
Caitlyn,Shaco,1474,761,713,51.63
Caitlyn,Anivia,467,229,238,49.04
Caitlyn,Garen,2079,1088,991,52.33
Caitlyn,Zeri,595,284,311,47.73
Caitlyn,Zyra,955,477,478,49.95
Caitlyn,Volibear,1623,842,781,51.88
Caitlyn,Ashe,3036,1576,1460,51.91
Caitlyn,Trundle,842,451,391,53.56
Caitlyn,Leblanc,481,274,207,56.96
Caitlyn,Elise,916,490,426,53.49
Caitlyn,Amumu,1347,614,733,45.58
Caitlyn,Pyke,1661,865,796,52.08
Caitlyn,Varus,1381,639,742,46.27
Caitlyn,Thresh,1868,1043,825,55.84
Caitlyn,Jax,1201,682,519,56.79
Caitlyn,Gragas,834,486,348,58.27
Caitlyn,Rell,751,365,386,48.6
Caitlyn,Camille,447,266,181,59.51
Caitlyn,MasterYi,1448,703,745,48.55
Caitlyn,Malphite,1080,494,586,45.74
Caitlyn,Udyr,511,283,228,55.38
Caitlyn,Evelynn,693,352,341,50.79
Caitlyn,Akali,1522,850,672,55.85
Caitlyn,Vi,1320,618,702,46.82
Caitlyn,Akshan,545,249,296,45.69
Caitlyn,Darius,2881,1422,1459,49.36
Caitlyn,Azir,587,293,294,49.91
Caitlyn,Ivern,287,147,140,51.22
Caitlyn,Katarina,1295,744,551,57.45
Caitlyn,JarvanIV,497,193,304,38.83
Caitlyn,Hwei,1082,488,594,45.1
Caitlyn,Bard,540,310,230,57.41
Caitlyn,Tryndamere,831,427,404,51.38
Caitlyn,Nidalee,321,181,140,56.39
Caitlyn,Draven,753,401,352,53.25
Caitlyn,Renekton,599,281,318,46.91
Caitlyn,Quinn,484,236,248,48.76
Caitlyn,Zoe,694,392,302,56.48
Caitlyn,Janna,382,220,162,57.59
Caitlyn,Lucian,820,424,396,51.71
Caitlyn,Nasus,1167,625,542,53.56
Caitlyn,Kindred,768,436,332,56.77
Caitlyn,Riven,637,410,227,64.36
Caitlyn,TwistedFate,586,330,256,56.31
Caitlyn,Sett,2426,1093,1333,45.05
Caitlyn,Blitzcrank,1095,578,517,52.79
Caitlyn,Shen,927,380,547,40.99
Caitlyn,Ahri,1977,1025,952,51.85
Caitlyn,Samira,1511,866,645,57.31
Caitlyn,MonkeyKing,718,372,346,51.81
Caitlyn,Smolder,1361,742,619,54.52
Caitlyn,Brand,1083,534,549,49.31
Caitlyn,Skarner,406,216,190,53.2
Caitlyn,Singed,444,202,242,45.5
Caitlyn,KogMaw,510,248,262,48.63
Caitlyn,Vladimir,764,346,418,45.29
Caitlyn,Corki,476,270,206,56.72
Caitlyn,Cassiopeia,635,327,308,51.5
Caitlyn,Zilean,406,189,217,46.55
Caitlyn,Rammus,445,218,227,48.99
Caitlyn,Hecarim,505,263,242,52.08
Caitlyn,Zac,608,325,283,53.45
Caitlyn,Kalista,712,402,310,56.46
Caitlyn,Nocturne,1329,626,703,47.1
Caitlyn,Sion,1011,469,542,46.39
Caitlyn,Gnar,661,304,357,45.99
Caitlyn,Graves,789,419,370,53.11
Caitlyn,Sejuani,517,269,248,52.03
Caitlyn,Lissandra,349,179,170,51.29
Caitlyn,FiddleSticks,797,395,402,49.56
Caitlyn,Milio,815,407,408,49.94
Caitlyn,Xerath,1141,523,618,45.84
Caitlyn,Lulu,1052,540,512,51.33
Caitlyn,Rengar,633,323,310,51.03
Caitlyn,Kennen,537,300,237,55.87
Caitlyn,Annie,422,198,224,46.92
Caitlyn,Senna,1448,731,717,50.48
Caitlyn,Aphelios,1078,564,514,52.32
Caitlyn,Vayne,1477,764,713,51.73
Caitlyn,Sona,540,241,299,44.63
Caitlyn,Kayle,1169,609,560,52.1
Caitlyn,Fiora,633,363,270,57.35
Caitlyn,Gwen,808,458,350,56.68
Caitlyn,Braum,732,378,354,51.64
Caitlyn,Leona,1008,504,504,50
Caitlyn,Karthus,303,177,126,58.42
Caitlyn,Kassadin,280,148,132,52.86
Caitlyn,Viktor,984,491,493,49.9
Caitlyn,Urgot,642,226,416,35.2
Caitlyn,Nilah,857,470,387,54.84
Caitlyn,Taliyah,366,193,173,52.73
Caitlyn,Sivir,711,344,367,48.38
Caitlyn,Syndra,836,390,446,46.65
Caitlyn,Shyvana,388,145,243,37.37
Caitlyn,KSante,600,327,273,54.5
Caitlyn,RekSai,210,123,87,58.57
Caitlyn,Sylas,1220,592,628,48.52
Caitlyn,Naafiri,709,358,351,50.49
Caitlyn,Belveth,356,190,166,53.37
Caitlyn,Alistar,461,277,184,60.09
Caitlyn,Nunu,1224,681,543,55.64
Caitlyn,Jayce,556,336,220,60.43
Caitlyn,Ornn,578,263,315,45.5
Caitlyn,Fizz,711,359,352,50.49
Caitlyn,Taric,316,133,183,42.09
Caitlyn,DrMundo,920,389,531,42.28
Caitlyn,Renata,406,235,171,57.88
Caitlyn,Rumble,231,126,105,54.55
Caitlyn,Kled,294,140,154,47.62
Morgana,Yorick,660,303,357,45.91
Morgana,LeeSin,749,443,306,59.15
Morgana,Ezreal,1462,716,746,48.97
Morgana,Jinx,1911,1049,862,54.89
Morgana,Swain,858,512,346,59.67
Morgana,Pantheon,1400,687,713,49.07
Morgana,Diana,1282,642,640,50.08
Morgana,Gangplank,345,177,168,51.3
Morgana,Yuumi,868,477,391,54.95
Morgana,Mordekaiser,1493,719,774,48.16
Morgana,Viego,916,509,407,55.57
Morgana,Irelia,677,379,298,55.98
Morgana,Jhin,1587,793,794,49.97
Morgana,Lux,2764,1511,1253,54.67
Morgana,Qiyana,292,168,124,57.53
Morgana,Warwick,1496,761,735,50.87
Morgana,Mel,1653,830,823,50.21
Morgana,Nautilus,925,482,443,52.11
Morgana,Kayle,603,267,336,44.28
Morgana,MonkeyKing,372,174,198,46.77
Morgana,RekSai,105,50,55,47.62
Morgana,Yone,1657,905,752,54.62
Morgana,Seraphine,1032,557,475,53.97
Morgana,Sylas,722,392,330,54.29
Morgana,Caitlyn,1801,849,952,47.14
Morgana,Zed,799,436,363,54.57
Morgana,MasterYi,891,432,459,48.48
Morgana,Rell,422,226,196,53.55
Morgana,Jax,686,361,325,52.62
Morgana,Briar,831,426,405,51.26
Morgana,Ahri,1112,571,541,51.35
Morgana,Zeri,335,211,124,62.99
Morgana,Karthus,222,126,96,56.76
Morgana,Aurora,728,371,357,50.96
Morgana,Senna,669,304,365,45.44
Morgana,Garen,1075,531,544,49.4
Morgana,Darius,1577,770,807,48.83
Morgana,Malzahar,584,248,336,42.47
Morgana,Zilean,212,75,137,35.38
Morgana,Heimerdinger,543,248,295,45.67
Morgana,Veigar,960,443,517,46.15
Morgana,Teemo,1004,445,559,44.32
Morgana,Gragas,518,307,211,59.27
Morgana,Soraka,607,331,276,54.53
Morgana,Twitch,698,352,346,50.43
Morgana,Lulu,577,316,261,54.77
Morgana,KSante,293,150,143,51.19
Morgana,Ashe,1468,713,755,48.57
Morgana,Nasus,618,297,321,48.06
Morgana,TahmKench,856,505,351,59
Morgana,Fizz,445,206,239,46.29
Morgana,Gnar,321,172,149,53.58
Morgana,Nunu,705,386,319,54.75
Morgana,Lucian,379,214,165,56.46
Morgana,Elise,432,290,142,67.13
Morgana,Kaisa,1020,564,456,55.29
Morgana,Riven,320,178,142,55.63
Morgana,FiddleSticks,443,229,214,51.69
Morgana,Brand,659,306,353,46.43
Morgana,Milio,479,230,249,48.02
Morgana,Camille,262,141,121,53.82
Morgana,Xayah,503,281,222,55.86
Morgana,Evelynn,625,376,249,60.16
Morgana,Lissandra,265,173,92,65.28
Morgana,MissFortune,1853,998,855,53.86
Morgana,Pyke,892,492,400,55.16
Morgana,Kayn,1300,688,612,52.92
Morgana,Katarina,716,397,319,55.45
Morgana,Ekko,620,286,334,46.13
Morgana,Yasuo,1540,776,764,50.39
Morgana,Singed,224,132,92,58.93
Morgana,KogMaw,332,155,177,46.69
Morgana,Azir,316,220,96,69.62
Morgana,Nami,801,410,391,51.19
Morgana,Chogath,1071,512,559,47.81
Morgana,Shen,600,325,275,54.17
Morgana,Lillia,500,256,244,51.2
Morgana,Sivir,425,203,222,47.76
Morgana,Neeko,725,391,334,53.93
Morgana,Ambessa,385,204,181,52.99
Morgana,Zac,209,103,106,49.28
Morgana,Kalista,362,187,175,51.66
Morgana,Rengar,308,164,144,53.25
Morgana,Anivia,279,101,178,36.2
Morgana,Galio,610,326,284,53.44
Morgana,Aatrox,775,477,298,61.55
Morgana,Varus,574,289,285,50.35
Morgana,Shaco,803,422,381,52.55
Morgana,Tristana,761,404,357,53.09
Morgana,Zoe,418,237,181,56.7
Morgana,Belveth,221,110,111,49.77
Morgana,AurelionSol,283,141,142,49.82
Morgana,Maokai,437,211,226,48.28
Morgana,Sion,543,245,298,45.12
Morgana,Akali,823,468,355,56.87
Morgana,Sejuani,290,117,173,40.34
Morgana,Vladimir,426,227,199,53.29
Morgana,Fiora,448,222,226,49.55
Morgana,Nilah,495,238,257,48.08
Morgana,Rumble,122,75,47,61.48
Morgana,Akshan,341,145,196,42.52
Morgana,Sona,374,186,188,49.73
Morgana,Samira,815,480,335,58.9
Morgana,Sett,1324,693,631,52.34
Morgana,Graves,426,191,235,44.84
Morgana,Urgot,406,168,238,41.38
Morgana,Poppy,477,245,232,51.36
Morgana,Malphite,578,321,257,55.54
Morgana,Khazix,559,362,197,64.76
Morgana,Jayce,313,194,119,61.98
Morgana,Kennen,253,138,115,54.55
Morgana,Taric,201,88,113,43.78
Morgana,Braum,320,176,144,55
Morgana,Aphelios,539,269,270,49.91
Morgana,DrMundo,578,292,286,50.52
Morgana,Cassiopeia,342,200,142,58.48
Morgana,Rakan,392,194,198,49.49
Morgana,Illaoi,434,238,196,54.84
Morgana,Amumu,765,391,374,51.11
Morgana,Vi,697,353,344,50.65
Morgana,Bard,272,157,115,57.72
Morgana,Rammus,245,128,117,52.24
Morgana,Vex,504,269,235,53.37
Morgana,Volibear,918,471,447,51.31
Morgana,Vayne,804,404,400,50.25
Morgana,Skarner,239,150,89,62.76
Morgana,Nocturne,741,364,377,49.12
Morgana,Ryze,271,134,137,49.45
Morgana,Thresh,994,518,476,52.11
Morgana,Blitzcrank,729,387,342,53.09
Morgana,Nidalee,208,110,98,52.88
Morgana,Hwei,607,313,294,51.57
Morgana,Xerath,680,322,358,47.35
Morgana,Ornn,350,188,162,53.71
Morgana,Trundle,421,210,211,49.88
Morgana,Tryndamere,511,279,232,54.6
Morgana,TwistedFate,257,144,113,56.03
Morgana,Orianna,330,174,156,52.73
Morgana,Hecarim,247,90,157,36.44
Morgana,Gwen,690,432,258,62.61
Morgana,Smolder,610,297,313,48.69
Morgana,Karma,598,276,322,46.15
Morgana,Naafiri,361,192,169,53.19
Morgana,Leona,609,328,281,53.86
Morgana,Udyr,312,168,144,53.85
Morgana,Syndra,411,250,161,60.83
Morgana,Draven,435,213,222,48.97
Morgana,Ziggs,390,205,185,52.56
Morgana,Talon,414,232,182,56.04
Morgana,Quinn,282,129,153,45.74
Morgana,Viktor,576,302,274,52.43
Morgana,Zyra,574,262,312,45.64
Morgana,Annie,296,169,127,57.09
Morgana,Renekton,362,146,216,40.33
Morgana,Corki,235,123,112,52.34
Morgana,Leblanc,232,142,90,61.21
Morgana,XinZhao,380,195,185,51.32
Morgana,Shyvana,220,88,132,40
Morgana,Renata,218,79,139,36.24
Morgana,Kindred,435,209,226,48.05
Morgana,Velkoz,480,224,256,46.67
Morgana,Janna,237,128,109,54.01
Morgana,Kled,188,88,100,46.81
Morgana,Taliyah,158,91,67,57.59
Morgana,Alistar,255,148,107,58.04
Morgana,Kassadin,170,93,77,54.71
Morgana,JarvanIV,237,83,154,35.02
Morgana,Olaf,177,67,110,37.85
Morgana,Ivern,156,78,78,50
Kayle,Illaoi,270,138,132,51.11
Kayle,Twitch,352,203,149,57.67
Kayle,Yone,788,398,390,50.51
Kayle,Lux,1200,624,576,52
Kayle,Velkoz,274,125,149,45.62
Kayle,Sett,766,366,400,47.78
Kayle,Taliyah,122,58,64,47.54
Kayle,Sylas,483,238,245,49.28
Kayle,Ezreal,870,486,384,55.86
Kayle,Morgana,603,336,267,55.72
Kayle,Aatrox,531,283,248,53.3
Kayle,Ashe,795,402,393,50.57
Kayle,Aphelios,340,177,163,52.06
Kayle,Gragas,294,157,137,53.4
Kayle,KSante,174,105,69,60.34
Kayle,Nasus,433,221,212,51.04
Kayle,TahmKench,418,185,233,44.26
Kayle,Fizz,204,114,90,55.88
Kayle,Irelia,458,201,257,43.89
Kayle,Nocturne,371,226,145,60.92
Kayle,Jayce,174,84,90,48.28
Kayle,Jhin,737,412,325,55.9
Kayle,Senna,491,248,243,50.51
Kayle,Yasuo,999,538,461,53.85
Kayle,Naafiri,228,113,115,49.56
Kayle,Leblanc,209,118,91,56.46
Kayle,MissFortune,993,488,505,49.14
Kayle,Nami,435,208,227,47.82
Kayle,Singed,154,99,55,64.29
Kayle,Galio,305,132,173,43.28
Kayle,Smolder,392,193,199,49.23
Kayle,Brand,294,165,129,56.12
Kayle,Aurora,388,206,182,53.09
Kayle,Jinx,914,448,466,49.02
Kayle,Seraphine,575,306,269,53.22
Kayle,MonkeyKing,218,131,87,60.09
Kayle,Vex,255,144,111,56.47
Kayle,Vayne,432,208,224,48.15
Kayle,Briar,472,217,255,45.97
Kayle,Fiora,204,118,86,57.84
Kayle,Cassiopeia,183,81,102,44.26
Kayle,Darius,984,456,528,46.34
Kayle,Warwick,757,362,395,47.82
Kayle,Shen,286,132,154,46.15
Kayle,Lillia,275,169,106,61.45
Kayle,Sivir,179,73,106,40.78
Kayle,Neeko,310,181,129,58.39
Kayle,Vladimir,302,124,178,41.06
Kayle,Rammus,123,67,56,54.47
Kayle,Swain,486,196,290,40.33
Kayle,Ekko,351,186,165,52.99
Kayle,Qiyana,130,73,57,56.15
Kayle,Zeri,217,136,81,62.67
Kayle,TwistedFate,164,91,73,55.49
Kayle,Gnar,98,81,17,82.65
Kayle,Diana,644,325,319,50.47
Kayle,Veigar,511,240,271,46.97
Kayle,Lucian,219,112,107,51.14
Kayle,Renekton,157,67,90,42.68
Kayle,Kayn,622,294,328,47.27
Kayle,Caitlyn,1169,560,609,47.9
Kayle,Mel,1068,576,492,53.93
Kayle,Pantheon,895,382,513,42.68
Kayle,Zed,372,250,122,67.2
Kayle,Nautilus,467,268,199,57.39
Kayle,Mordekaiser,811,436,375,53.76
Kayle,Anivia,199,92,107,46.23
Kayle,Pyke,569,317,252,55.71
Kayle,Chogath,606,348,258,57.43
Kayle,Kaisa,588,339,249,57.65
Kayle,Yorick,410,191,219,46.59
Kayle,Nunu,367,185,182,50.41
Kayle,Rakan,252,99,153,39.29
Kayle,Rumble,76,42,34,55.26
Kayle,Shaco,383,232,151,60.57
Kayle,Talon,305,188,117,61.64
Kayle,Tristana,396,161,235,40.66
Kayle,Soraka,269,117,152,43.49
Kayle,JarvanIV,195,65,130,33.33
Kayle,LeeSin,400,224,176,56
Kayle,Hwei,374,178,196,47.59
Kayle,Ornn,192,120,72,62.5
Kayle,Xayah,253,104,149,41.11
Kayle,Zyra,259,112,147,43.24
Kayle,Corki,115,62,53,53.91
Kayle,Ziggs,181,80,101,44.2
Kayle,Vi,482,253,229,52.49
Kayle,Katarina,460,287,173,62.39
Kayle,Draven,241,139,102,57.68
Kayle,XinZhao,209,116,93,55.5
Kayle,Viego,407,184,223,45.21
Kayle,Quinn,151,83,68,54.97
Kayle,DrMundo,306,161,145,52.61
Kayle,Jax,438,218,220,49.77
Kayle,Malphite,428,192,236,44.86
Kayle,Ahri,685,374,311,54.6
Kayle,Renata,115,62,53,53.91
Kayle,Teemo,744,383,361,51.48
Kayle,Samira,445,239,206,53.71
Kayle,Graves,258,129,129,50
Kayle,Shyvana,149,41,108,27.52
Kayle,Amumu,462,210,252,45.45
Kayle,Garen,783,425,358,54.28
Kayle,KogMaw,161,59,102,36.65
Kayle,Karma,331,173,158,52.27
Kayle,Evelynn,300,172,128,57.33
Kayle,Nilah,236,125,111,52.97
Kayle,Leona,324,124,200,38.27
Kayle,Akali,500,271,229,54.2
Kayle,Blitzcrank,322,174,148,54.04
Kayle,Malzahar,359,167,192,46.52
Kayle,Rell,179,89,90,49.72
Kayle,Belveth,138,74,64,53.62
Kayle,Kled,103,43,60,41.75
Kayle,Kalista,265,138,127,52.08
Kayle,Khazix,299,178,121,59.53
Kayle,AurelionSol,231,116,115,50.22
Kayle,Thresh,592,309,283,52.2
Kayle,Gangplank,205,126,79,61.46
Kayle,Volibear,451,231,220,51.22
Kayle,Sona,207,107,100,51.69
Kayle,Braum,229,109,120,47.6
Kayle,Ryze,135,57,78,42.22
Kayle,Annie,130,62,68,47.69
Kayle,Udyr,156,89,67,57.05
Kayle,Hecarim,173,99,74,57.23
Kayle,Janna,129,72,57,55.81
Kayle,Poppy,272,90,182,33.09
Kayle,Viktor,347,189,158,54.47
Kayle,Ivern,62,34,28,54.84
Kayle,MasterYi,523,264,259,50.48
Kayle,Camille,154,90,64,58.44
Kayle,Kennen,181,110,71,60.77
Kayle,FiddleSticks,244,111,133,45.49
Kayle,Kassadin,122,56,66,45.9
Kayle,Heimerdinger,206,107,99,51.94
Kayle,Akshan,216,89,127,41.2
Kayle,Milio,277,150,127,54.15
Kayle,Olaf,97,62,35,63.92
Kayle,Xerath,331,156,175,47.13
Kayle,Ambessa,236,125,111,52.97
Kayle,Tryndamere,249,101,148,40.56
Kayle,Sejuani,161,75,86,46.58
Kayle,Elise,290,130,160,44.83
Kayle,Orianna,176,50,126,28.41
Kayle,Nidalee,137,97,40,70.8
Kayle,Azir,156,98,58,62.82
Kayle,Gwen,288,153,135,53.13
Kayle,Maokai,220,95,125,43.18
Kayle,Zoe,205,131,74,63.9
Kayle,Lulu,320,201,119,62.81
Kayle,Kindred,258,177,81,68.6
Kayle,Yuumi,455,233,222,51.21
Kayle,Bard,144,56,88,38.89
Kayle,Varus,356,204,152,57.3
Kayle,Riven,134,82,52,61.19
Kayle,Syndra,186,98,88,52.69
Kayle,Trundle,226,107,119,47.35
Kayle,Karthus,124,81,43,65.32
Kayle,RekSai,55,21,34,38.18
Kayle,Sion,325,153,172,47.08
Kayle,Skarner,140,97,43,69.29
Kayle,Zac,163,109,54,66.87
Kayle,Lissandra,109,51,58,46.79
Kayle,Rengar,163,99,64,60.74
Kayle,Urgot,264,132,132,50
Kayle,Zilean,116,60,56,51.72
Kayle,Alistar,131,50,81,38.17
Kayle,Taric,84,28,56,33.33
Renata,Illaoi,87,28,59,32.18
Renata,Twitch,136,86,50,63.24
Renata,Yone,283,165,118,58.3
Renata,Lux,387,208,179,53.75
Renata,Velkoz,86,25,61,29.07
Renata,Malphite,172,65,107,37.79
Renata,Diana,223,96,127,43.05
Renata,Akali,174,87,87,50
Renata,Jinx,297,161,136,54.21
Renata,Warwick,197,107,90,54.31
Renata,Vex,44,21,23,47.73
Renata,Yuumi,160,73,87,45.63
Renata,Camille,85,29,56,34.12
Renata,Azir,83,40,43,48.19
Renata,Kaisa,226,134,92,59.29
Renata,Braum,86,28,58,32.56
Renata,Naafiri,78,50,28,64.1
Renata,Zac,61,41,20,67.21
Renata,Ahri,244,119,125,48.77
Renata,Nilah,98,43,55,43.88
Renata,Zyra,108,49,59,45.37
Renata,Darius,291,124,167,42.61
Renata,Mel,318,161,157,50.63
Renata,TwistedFate,56,27,29,48.21
Renata,Maokai,81,43,38,53.09
Renata,Shaco,159,99,60,62.26
Renata,Qiyana,52,35,17,67.31
Renata,Ziggs,45,19,26,42.22
Renata,Kayn,254,109,145,42.91
Renata,Senna,176,79,97,44.89
Renata,Ashe,268,110,158,41.04
Renata,Irelia,140,67,73,47.86
Renata,Teemo,220,121,99,55
Renata,MasterYi,156,74,82,47.44
Renata,Yasuo,357,159,198,44.54
Renata,Aphelios,129,67,62,51.94
Renata,Janna,39,19,20,48.72
Renata,LeeSin,150,110,40,73.33
Renata,Zed,162,95,67,58.64
Renata,KogMaw,61,19,42,31.15
Renata,Nami,151,76,75,50.33
Renata,Garen,194,109,85,56.19
Renata,Kayle,115,53,62,46.09
Renata,Kled,45,18,27,40
Renata,Vi,166,92,74,55.42
Renata,Aurora,112,60,52,53.57
Renata,Thresh,216,106,110,49.07
Renata,Yorick,152,78,74,51.32
Renata,Briar,175,88,87,50.29
Renata,Neeko,132,88,44,66.67
Renata,Nautilus,199,89,110,44.72
Renata,Mordekaiser,251,153,98,60.96
Renata,Ekko,99,48,51,48.48
Renata,Heimerdinger,101,53,48,52.48
Renata,Blitzcrank,81,36,45,44.44
Renata,Singed,24,8,16,33.33
Renata,Ezreal,269,109,160,40.52
Renata,Volibear,195,94,101,48.21
Renata,Khazix,78,59,19,75.64
Renata,Lucian,61,18,43,29.51
Renata,Ambessa,104,49,55,47.12
Renata,Pantheon,245,130,115,53.06
Renata,Zeri,77,39,38,50.65
Renata,Elise,80,35,45,43.75
Renata,Fizz,79,22,57,27.85
Renata,Samira,192,99,93,51.56
Renata,Rell,131,82,49,62.6
Renata,Cassiopeia,41,18,23,43.9
Renata,Riven,92,63,29,68.48
Renata,Vayne,153,98,55,64.05
Renata,JarvanIV,99,49,50,49.49
Renata,Katarina,114,46,68,40.35
Renata,Morgana,218,139,79,63.76
Renata,Milio,117,58,59,49.57
Renata,Gangplank,77,41,36,53.25
Renata,Varus,100,59,41,59
Renata,Lulu,159,61,98,38.36
Renata,Viego,153,66,87,43.14
Renata,Sona,50,35,15,70
Renata,Zilean,47,21,26,44.68
Renata,Jhin,212,112,100,52.83
Renata,Sett,174,55,119,31.61
Renata,Caitlyn,406,171,235,42.12
Renata,Seraphine,132,72,60,54.55
Renata,Aatrox,161,104,57,64.6
Renata,Lillia,84,43,41,51.19
Renata,Taliyah,60,20,40,33.33
Renata,Poppy,104,63,41,60.58
Renata,MissFortune,340,146,194,42.94
Renata,Karthus,26,18,8,69.23
Renata,Gnar,97,46,51,47.42
Renata,Fiora,89,60,29,67.42
Renata,Olaf,32,9,23,28.13
Renata,Veigar,170,79,91,46.47
Renata,FiddleSticks,87,25,62,28.74
Renata,Xayah,102,52,50,50.98
Renata,Belveth,83,45,38,54.22
Renata,Syndra,49,26,23,53.06
Renata,Jax,130,45,85,34.62
Renata,Amumu,139,67,72,48.2
Renata,Corki,39,14,25,35.9
Renata,Alistar,65,29,36,44.62
Renata,Shen,126,53,73,42.06
Renata,Lissandra,40,9,31,22.5
Renata,RekSai,26,7,19,26.92
Renata,Evelynn,76,31,45,40.79
Renata,Soraka,80,27,53,33.75
Renata,Trundle,79,40,39,50.63
Renata,Graves,87,42,45,48.28
Renata,Malzahar,170,58,112,34.12
Renata,Chogath,177,78,99,44.07
Renata,Nasus,97,52,45,53.61
Renata,DrMundo,79,35,44,44.3
Renata,Rakan,61,50,11,81.97
Renata,KSante,58,29,29,50
Renata,Bard,59,23,36,38.98
Renata,Xerath,103,41,62,39.81
Renata,Gwen,95,55,40,57.89
Renata,Nocturne,108,51,57,47.22
Renata,Vladimir,110,73,37,66.36
Renata,Akshan,86,51,35,59.3
Renata,Leona,94,62,32,65.96
Renata,Shyvana,23,14,9,60.87
Renata,TahmKench,177,83,94,46.89
Renata,Ryze,37,19,18,51.35
Renata,Rengar,102,57,45,55.88
Renata,Orianna,61,44,17,72.13
Renata,Talon,97,57,40,58.76
Renata,Quinn,34,25,9,73.53
Renata,Hecarim,28,13,15,46.43
Renata,Viktor,98,46,52,46.94
Renata,Galio,85,49,36,57.65
Renata,Renekton,71,20,51,28.17
Renata,Swain,168,58,110,34.52
Renata,Karma,109,54,55,49.54
Renata,Jayce,44,13,31,29.55
Renata,Hwei,99,37,62,37.37
Renata,Zoe,88,34,54,38.64
Renata,Kassadin,33,3,30,9.09
Renata,Sivir,91,45,46,49.45
Renata,Pyke,136,55,81,40.44
Renata,Smolder,171,111,60,64.91
Renata,MonkeyKing,67,31,36,46.27
Renata,Brand,71,49,22,69.01
Renata,Urgot,75,35,40,46.67
Renata,Nunu,96,33,63,34.38
Renata,Gragas,93,44,49,47.31
Renata,Annie,43,10,33,23.26
Renata,Kalista,73,63,10,86.3
Renata,Tristana,147,75,72,51.02
Renata,Leblanc,51,12,39,23.53
Renata,Draven,81,33,48,40.74
Renata,Sion,121,56,65,46.28
Renata,Nidalee,31,23,8,74.19
Renata,Kennen,67,41,26,61.19
Renata,Kindred,99,28,71,28.28
Renata,AurelionSol,52,18,34,34.62
Renata,Sejuani,87,48,39,55.17
Renata,Sylas,128,82,46,64.06
Renata,XinZhao,79,37,42,46.84
Renata,Taric,25,16,9,64
Renata,Tryndamere,81,54,27,66.67
Renata,Rammus,23,23,0,100
Renata,Ornn,63,32,31,50.79
Renata,Anivia,30,14,16,46.67
Renata,Ivern,23,8,15,34.78
Renata,Skarner,56,35,21,62.5
Renata,Rumble,26,9,17,34.62
Renata,Udyr,20,9,11,45
Ambessa,Talon,229,137,92,59.83
Ambessa,Aurora,364,180,184,49.45
Ambessa,Yasuo,815,425,390,52.15
Ambessa,Tristana,325,192,133,59.08
Ambessa,Alistar,109,55,54,50.46
Ambessa,Poppy,284,160,124,56.34
Ambessa,Diana,440,229,211,52.05
Ambessa,Anivia,129,99,30,76.74
Ambessa,Caitlyn,868,432,436,49.77
Ambessa,Thresh,564,287,277,50.89
Ambessa,KSante,192,105,87,54.69
Ambessa,Darius,573,268,305,46.77
Ambessa,Azir,188,97,91,51.6
Ambessa,Aphelios,245,131,114,53.47
Ambessa,Soraka,290,177,113,61.03
Ambessa,Akali,358,174,184,48.6
Ambessa,Viego,521,234,287,44.91
Ambessa,Leblanc,169,110,59,65.09
Ambessa,Sett,643,287,356,44.63
Ambessa,Rammus,131,82,49,62.6
Ambessa,Pyke,375,211,164,56.27
Ambessa,Yorick,330,157,173,47.58
Ambessa,Shaco,285,149,136,52.28
Ambessa,Katarina,300,175,125,58.33
Ambessa,Lucian,188,103,85,54.79
Ambessa,Nautilus,321,154,167,47.98
Ambessa,Karthus,68,39,29,57.35
Ambessa,Zed,390,179,211,45.9
Ambessa,Ashe,641,323,318,50.39
Ambessa,Maokai,184,91,93,49.46
Ambessa,Garen,549,228,321,41.53
Ambessa,Shen,281,82,199,29.18
Ambessa,Khazix,197,84,113,42.64
Ambessa,Ahri,438,204,234,46.58
Ambessa,Samira,385,156,229,40.52
Ambessa,Ornn,196,98,98,50
Ambessa,Briar,359,174,185,48.47
Ambessa,Morgana,385,181,204,47.01
Ambessa,Volibear,407,184,223,45.21
Ambessa,Gwen,264,142,122,53.79
Ambessa,Elise,207,117,90,56.52
Ambessa,Smolder,353,195,158,55.24
Ambessa,Rengar,191,109,82,57.07
Ambessa,Hwei,261,112,149,42.91
Ambessa,XinZhao,207,82,125,39.61
Ambessa,Ezreal,717,371,346,51.74
Ambessa,Leona,306,149,157,48.69
Ambessa,Trundle,184,72,112,39.13
Ambessa,MasterYi,429,196,233,45.69
Ambessa,Varus,382,198,184,51.83
Ambessa,Lux,969,457,512,47.16
Ambessa,Aatrox,358,237,121,66.2
Ambessa,Chogath,394,205,189,52.03
Ambessa,Ryze,104,51,53,49.04
Ambessa,Janna,114,41,73,35.96
Ambessa,Nasus,309,163,146,52.75
Ambessa,Kayn,559,247,312,44.19
Ambessa,MissFortune,661,328,333,49.62
Ambessa,Sona,133,80,53,60.15
Ambessa,Nocturne,342,151,191,44.15
Ambessa,Neeko,232,97,135,41.81
Ambessa,LeeSin,390,190,200,48.72
Ambessa,Zeri,250,119,131,47.6
Ambessa,Pantheon,645,353,292,54.73
Ambessa,Sejuani,169,62,107,36.69
Ambessa,Ivern,112,70,42,62.5
Ambessa,Urgot,127,38,89,29.92
Ambessa,Jhin,673,337,336,50.07
Ambessa,Karma,205,97,108,47.32
Ambessa,Taric,88,36,52,40.91
Ambessa,Kled,72,31,41,43.06
Ambessa,Warwick,541,280,261,51.76
Ambessa,Seraphine,364,188,176,51.65
Ambessa,Teemo,452,184,268,40.71
Ambessa,Mel,891,461,430,51.74
Ambessa,Viktor,297,146,151,49.16
Ambessa,Twitch,280,132,148,47.14
Ambessa,Lulu,333,129,204,38.74
Ambessa,Renekton,233,115,118,49.36
Ambessa,Udyr,153,81,72,52.94
Ambessa,Annie,107,49,58,45.79
Ambessa,Amumu,295,164,131,55.59
Ambessa,Braum,181,98,83,54.14
Ambessa,Shyvana,111,53,58,47.75
Ambessa,TahmKench,441,245,196,55.56
Ambessa,Veigar,407,190,217,46.68
Ambessa,Zilean,89,29,60,32.58
Ambessa,Vi,369,162,207,43.9
Ambessa,Zoe,189,117,72,61.9
Ambessa,Kaisa,511,231,280,45.21
Ambessa,Jax,357,185,172,51.82
Ambessa,Evelynn,162,88,74,54.32
Ambessa,Draven,222,79,143,35.59
Ambessa,Jinx,774,397,377,51.29
Ambessa,Xayah,229,94,135,41.05
Ambessa,Renata,104,55,49,52.88
Ambessa,Quinn,112,55,57,49.11
Ambessa,Irelia,323,143,180,44.27
Ambessa,Lillia,247,131,116,53.04
Ambessa,Nilah,240,93,147,38.75
Ambessa,Hecarim,131,91,40,69.47
Ambessa,Rell,176,88,88,50
Ambessa,Fiora,190,99,91,52.11
Ambessa,Naafiri,111,48,63,43.24
Ambessa,Orianna,222,114,108,51.35
Ambessa,Illaoi,171,64,107,37.43
Ambessa,Heimerdinger,149,61,88,40.94
Ambessa,Brand,201,90,111,44.78
Ambessa,Cassiopeia,110,63,47,57.27
Ambessa,Riven,204,83,121,40.69
Ambessa,Gnar,186,101,85,54.3
Ambessa,DrMundo,241,124,117,51.45
Ambessa,Mordekaiser,489,227,262,46.42
Ambessa,Gragas,241,109,132,45.23
Ambessa,Galio,230,80,150,34.78
Ambessa,Tryndamere,288,174,114,60.42
Ambessa,Sion,223,127,96,56.95
Ambessa,Senna,287,123,164,42.86
Ambessa,Syndra,192,97,95,50.52
Ambessa,Zyra,224,85,139,37.95
Ambessa,Vladimir,184,104,80,56.52
Ambessa,Singed,94,64,30,68.09
Ambessa,Ziggs,128,72,56,56.25
Ambessa,Nami,376,184,192,48.94
Ambessa,Malzahar,272,135,137,49.63
Ambessa,Kalista,166,64,102,38.55
Ambessa,Qiyana,153,115,38,75.16
Ambessa,Yone,735,405,330,55.1
Ambessa,TwistedFate,102,40,62,39.22
Ambessa,Rakan,223,55,168,24.66
Ambessa,Sylas,285,166,119,58.25
Ambessa,Swain,420,181,239,43.1
Ambessa,Bard,148,79,69,53.38
Ambessa,KogMaw,138,58,80,42.03
Ambessa,Vayne,400,171,229,42.75
Ambessa,FiddleSticks,225,120,105,53.33
Ambessa,Blitzcrank,336,180,156,53.57
Ambessa,Milio,224,108,116,48.21
Ambessa,JarvanIV,159,80,79,50.31
Ambessa,Kassadin,55,31,24,56.36
Ambessa,Fizz,100,28,72,28
Ambessa,Velkoz,273,120,153,43.96
Ambessa,Kayle,236,111,125,47.03
Ambessa,Camille,161,60,101,37.27
Ambessa,Yuumi,374,187,187,50
Ambessa,Kennen,121,32,89,26.45
Ambessa,RekSai,44,14,30,31.82
Ambessa,Nunu,252,140,112,55.56
Ambessa,Ekko,336,155,181,46.13
Ambessa,Belveth,151,69,82,45.7
Ambessa,Kindred,162,88,74,54.32
Ambessa,Gangplank,149,60,89,40.27
Ambessa,MonkeyKing,177,84,93,47.46
Ambessa,Akshan,179,89,90,49.72
Ambessa,Xerath,210,84,126,40
Ambessa,Nidalee,122,67,55,54.92
Ambessa,Sivir,208,96,112,46.15
Ambessa,Skarner,154,89,65,57.79
Ambessa,Taliyah,116,48,68,41.38
Ambessa,Jayce,178,127,51,71.35
Ambessa,Lissandra,127,76,51,59.84
Ambessa,Vex,215,101,114,46.98
Ambessa,Malphite,321,104,217,32.4
Ambessa,Olaf,68,43,25,63.24
Ambessa,Graves,247,121,126,48.99
Ambessa,AurelionSol,176,79,97,44.89
Ambessa,Zac,147,64,83,43.54
Ambessa,Corki,113,84,29,74.34
Ambessa,Rumble,72,35,37,48.61
Rammus,Talon,118,91,27,77.12
Rammus,Aurora,141,55,86,39.01
Rammus,Yasuo,489,292,197,59.71
Rammus,Tristana,231,113,118,48.92
Rammus,Alistar,45,16,29,35.56
Rammus,Malphite,164,93,71,56.71
Rammus,Jax,199,133,66,66.83
Rammus,Neeko,118,64,54,54.24
Rammus,Xayah,163,102,61,62.58
Rammus,Rakan,100,49,51,49
Rammus,Volibear,185,80,105,43.24
Rammus,Ekko,165,84,81,50.91
Rammus,Akshan,79,48,31,60.76
Rammus,Katarina,183,110,73,60.11
Rammus,Yone,504,333,171,66.07
Rammus,Gragas,83,58,25,69.88
Rammus,Irelia,195,105,90,53.85
Rammus,TahmKench,156,60,96,38.46
Rammus,Rell,95,59,36,62.11
Rammus,Mordekaiser,282,135,147,47.87
Rammus,Kayn,355,168,187,47.32
Rammus,Diana,171,85,86,49.71
Rammus,Ezreal,260,140,120,53.85
Rammus,Thresh,220,115,105,52.27
Rammus,Chogath,186,70,116,37.63
Rammus,Ivern,50,30,20,60
Rammus,Lux,474,208,266,43.88
Rammus,Ambessa,131,49,82,37.4
Rammus,XinZhao,86,54,32,62.79
Rammus,Nilah,86,54,32,62.79
Rammus,Soraka,154,84,70,54.55
Rammus,Teemo,215,119,96,55.35
Rammus,Evelynn,72,22,50,30.56
Rammus,Sylas,158,71,87,44.94
Rammus,Seraphine,199,123,76,61.81
Rammus,Malzahar,194,77,117,39.69
Rammus,Jinx,330,149,181,45.15
Rammus,Shen,109,52,57,47.71
Rammus,Khazix,119,80,39,67.23
Rammus,Ahri,267,145,122,54.31
Rammus,Samira,169,92,77,54.44
Rammus,Maokai,71,16,55,22.54
Rammus,DrMundo,94,50,44,53.19
Rammus,Shaco,106,44,62,41.51
Rammus,Viktor,119,48,71,40.34
Rammus,Jhin,315,166,149,52.7
Rammus,Poppy,150,72,78,48
Rammus,Garen,280,142,138,50.71
Rammus,Sett,287,148,139,51.57
Rammus,Lucian,82,67,15,81.71
Rammus,Sona,53,30,23,56.6
Rammus,Yorick,188,123,65,65.43
Rammus,Akali,197,115,82,58.38
Rammus,Twitch,169,83,86,49.11
Rammus,Zilean,66,28,38,42.42
Rammus,LeeSin,179,101,78,56.42
Rammus,Caitlyn,445,227,218,51.01
Rammus,Ashe,348,214,134,61.49
Rammus,Camille,93,38,55,40.86
Rammus,Hecarim,80,43,37,53.75
Rammus,TwistedFate,80,48,32,60
Rammus,Nautilus,176,91,85,51.7
Rammus,Rengar,110,68,42,61.82
Rammus,Galio,168,84,84,50
Rammus,Kayle,123,56,67,45.53
Rammus,Nunu,120,58,62,48.33
Rammus,Kaisa,258,146,112,56.59
Rammus,Nami,158,85,73,53.8
Rammus,Smolder,122,67,55,54.92
Rammus,MonkeyKing,94,63,31,67.02
Rammus,Sejuani,73,37,36,50.68
Rammus,Kalista,64,28,36,43.75
Rammus,Yuumi,190,117,73,61.58
Rammus,Amumu,211,116,95,54.98
Rammus,MissFortune,385,223,162,57.92
Rammus,Renekton,90,65,25,72.22
Rammus,Leblanc,66,41,25,62.12
Rammus,Corki,58,31,27,53.45
Rammus,Morgana,245,117,128,47.76
Rammus,Illaoi,84,49,35,58.33
Rammus,Vi,136,106,30,77.94
Rammus,Syndra,83,43,40,51.81
Rammus,Lulu,122,65,57,53.28
Rammus,Darius,372,178,194,47.85
Rammus,Quinn,86,48,38,55.81
Rammus,Orianna,114,48,66,42.11
Rammus,Pantheon,361,200,161,55.4
Rammus,Tryndamere,86,53,33,61.63
Rammus,FiddleSticks,86,38,48,44.19
Rammus,Vayne,204,111,93,54.41
Rammus,Kindred,113,52,61,46.02
Rammus,Riven,115,64,51,55.65
Rammus,Karma,104,59,45,56.73
Rammus,Velkoz,107,45,62,42.06
Rammus,Pyke,294,166,128,56.46
Rammus,Gwen,147,70,77,47.62
Rammus,Brand,120,65,55,54.17
Rammus,Karthus,60,26,34,43.33
Rammus,Senna,195,132,63,67.69
Rammus,Kennen,46,20,26,43.48
Rammus,Leona,166,58,108,34.94
Rammus,Naafiri,71,53,18,74.65
Rammus,Milio,102,42,60,41.18
Rammus,Aatrox,181,76,105,41.99
Rammus,JarvanIV,108,67,41,62.04
Rammus,Cassiopeia,107,28,79,26.17
Rammus,Zyra,131,73,58,55.73
Rammus,Graves,122,79,43,64.75
Rammus,Swain,170,112,58,65.88
Rammus,Jayce,78,22,56,28.21
Rammus,Zeri,94,26,68,27.66
Rammus,Zed,187,109,78,58.29
Rammus,Gangplank,91,62,29,68.13
Rammus,Vex,123,85,38,69.11
Rammus,Singed,61,38,23,62.3
Rammus,Mel,338,148,190,43.79
Rammus,Warwick,375,189,186,50.4
Rammus,Vladimir,83,41,42,49.4
Rammus,Gnar,79,60,19,75.95
Rammus,MasterYi,442,246,196,55.66
Rammus,Fizz,102,62,40,60.78
Rammus,Kled,47,30,17,63.83
Rammus,Varus,147,67,80,45.58
Rammus,Lillia,121,62,59,51.24
Rammus,Qiyana,43,33,10,76.74
Rammus,Nasus,155,82,73,52.9
Rammus,Xerath,105,64,41,60.95
Rammus,Trundle,135,66,69,48.89
Rammus,Belveth,79,33,46,41.77
Rammus,Viego,249,123,126,49.4
Rammus,Aphelios,151,84,67,55.63
Rammus,Heimerdinger,50,22,28,44
Rammus,Sivir,61,36,25,59.02
Rammus,Ryze,52,25,27,48.08
Rammus,Zac,73,40,33,54.79
Rammus,Nocturne,148,56,92,37.84
Rammus,Veigar,186,98,88,52.69
Rammus,Fiora,91,46,45,50.55
Rammus,Taric,52,14,38,26.92
Rammus,Briar,275,128,147,46.55
Rammus,Skarner,19,10,9,52.63
Rammus,Rumble,34,19,15,55.88
Rammus,Draven,140,64,76,45.71
Rammus,Hwei,144,61,83,42.36
Rammus,Bard,37,13,24,35.14
Rammus,Shyvana,72,25,47,34.72
Rammus,Anivia,39,23,16,58.97
Rammus,Blitzcrank,143,61,82,42.66
Rammus,Elise,74,40,34,54.05
Rammus,Braum,78,47,31,60.26
Rammus,Nidalee,43,24,19,55.81
Rammus,Lissandra,59,32,27,54.24
Rammus,Ziggs,125,51,74,40.8
Rammus,KogMaw,64,25,39,39.06
Rammus,Udyr,67,44,23,65.67
Rammus,AurelionSol,83,42,41,50.6
Rammus,Urgot,120,77,43,64.17
Rammus,KSante,70,47,23,67.14
Rammus,Sion,132,70,62,53.03
Rammus,Ornn,85,32,53,37.65
Rammus,Taliyah,37,28,9,75.68
Rammus,Olaf,46,22,24,47.83
Rammus,RekSai,36,22,14,61.11
Rammus,Azir,52,31,21,59.62
Rammus,Kassadin,34,24,10,70.59
Rammus,Renata,23,0,23,0
Rammus,Annie,32,10,22,31.25
Rammus,Janna,49,24,25,48.98
Rammus,Zoe,54,41,13,75.93
Talon,Ambessa,229,92,137,40.17
Talon,Rammus,118,27,91,22.88
Talon,Mel,779,387,392,49.68
Talon,Draven,231,136,95,58.87
Talon,Blitzcrank,278,129,149,46.4
Talon,Jax,307,124,183,40.39
Talon,Nidalee,102,75,27,73.53
Talon,Ahri,577,267,310,46.27
Talon,Jhin,611,306,305,50.08
Talon,Senna,348,154,194,44.25
Talon,Yorick,316,124,192,39.24
Talon,AurelionSol,161,63,98,39.13
Talon,Kayn,648,265,383,40.9
Talon,Singed,117,52,65,44.44
Talon,Udyr,131,75,56,57.25
Talon,Pantheon,649,311,338,47.92
Talon,Leblanc,117,60,57,51.28
Talon,Sivir,170,81,89,47.65
Talon,Pyke,399,222,177,55.64
Talon,Yone,728,385,343,52.88
Talon,Briar,301,117,184,38.87
Talon,Vex,217,116,101,53.46
Talon,Jinx,726,330,396,45.45
Talon,Milio,208,90,118,43.27
Talon,Teemo,486,208,278,42.8
Talon,Poppy,280,127,153,45.36
Talon,Akali,414,173,241,41.79
Talon,Caitlyn,957,386,571,40.33
Talon,Leona,286,134,152,46.85
Talon,Nocturne,343,200,143,58.31
Talon,Lissandra,100,60,40,60
Talon,Lux,999,405,594,40.54
Talon,Vayne,348,187,161,53.74
Talon,Shyvana,89,26,63,29.21
Talon,Sylas,413,156,257,37.77
Talon,Karma,291,160,131,54.98
Talon,Soraka,292,119,173,40.75
Talon,Nasus,202,116,86,57.43
Talon,Kindred,225,114,111,50.67
Talon,Malzahar,342,137,205,40.06
Talon,Tristana,346,136,210,39.31
Talon,Nautilus,426,211,215,49.53
Talon,Fiora,184,110,74,59.78
Talon,Elise,302,151,151,50
Talon,Garen,412,189,223,45.87
Talon,Ashe,663,302,361,45.55
Talon,Trundle,202,88,114,43.56
Talon,Naafiri,199,116,83,58.29
Talon,Aphelios,257,113,144,43.97
Talon,Shen,227,96,131,42.29
Talon,Amumu,360,143,217,39.72
Talon,MissFortune,756,346,410,45.77
Talon,Xerath,200,89,111,44.5
Talon,LeeSin,428,241,187,56.31
Talon,Kaisa,504,233,271,46.23
Talon,Qiyana,148,84,64,56.76
Talon,Swain,371,164,207,44.2
Talon,Sett,613,264,349,43.07
Talon,Mordekaiser,495,209,286,42.22
Talon,Veigar,406,164,242,40.39
Talon,Thresh,500,216,284,43.2
Talon,Varus,302,116,186,38.41
Talon,Zyra,251,126,125,50.2
Talon,Galio,237,102,135,43.04
Talon,Ezreal,590,237,353,40.17
Talon,Seraphine,379,164,215,43.27
Talon,Darius,657,348,309,52.97
Talon,Shaco,480,242,238,50.42
Talon,Zed,383,167,216,43.6
Talon,Braum,190,82,108,43.16
Talon,Volibear,406,179,227,44.09
Talon,Nami,321,171,150,53.27
Talon,Rengar,237,136,101,57.38
Talon,Lucian,269,151,118,56.13
Talon,Ekko,353,190,163,53.82
Talon,Velkoz,227,82,145,36.12
Talon,Yasuo,787,302,485,38.37
Talon,Diana,580,276,304,47.59
Talon,Sion,367,143,224,38.96
Talon,Orianna,162,78,84,48.15
Talon,Camille,172,68,104,39.53
Talon,Viktor,265,126,139,47.55
Talon,Zeri,162,105,57,64.81
Talon,Kayle,305,117,188,38.36
Talon,Brand,257,98,159,38.13
Talon,Rakan,225,94,131,41.78
Talon,Lulu,332,146,186,43.98
Talon,KogMaw,123,68,55,55.28
Talon,MasterYi,404,172,232,42.57
Talon,Janna,149,53,96,35.57
Talon,Vladimir,254,91,163,35.83
Talon,Alistar,131,48,83,36.64
Talon,Gangplank,168,92,76,54.76
Talon,Nunu,349,147,202,42.12
Talon,Jayce,192,118,74,61.46
Talon,Kalista,172,87,85,50.58
Talon,Neeko,306,156,150,50.98
Talon,Chogath,518,232,286,44.79
Talon,Quinn,148,72,76,48.65
Talon,Lillia,254,156,98,61.42
Talon,Gragas,261,90,171,34.48
Talon,Xayah,291,122,169,41.92
Talon,Vi,323,132,191,40.87
Talon,Evelynn,250,118,132,47.2
Talon,Rell,197,85,112,43.15
Talon,Anivia,112,61,51,54.46
Talon,Urgot,187,77,110,41.18
Talon,Olaf,59,20,39,33.9
Talon,Irelia,343,150,193,43.73
Talon,Warwick,569,246,323,43.23
Talon,Khazix,220,124,96,56.36
Talon,Aurora,353,197,156,55.81
Talon,Karthus,74,26,48,35.14
Talon,Gnar,135,71,64,52.59
Talon,Morgana,414,182,232,43.96
Talon,Syndra,242,99,143,40.91
Talon,Kled,110,60,50,54.55
Talon,DrMundo,246,80,166,32.52
Talon,Smolder,304,177,127,58.22
Talon,Illaoi,112,42,70,37.5
Talon,Viego,496,196,300,39.52
Talon,Fizz,228,123,105,53.95
Talon,Samira,333,167,166,50.15
Talon,Akshan,149,76,73,51.01
Talon,Taric,51,35,16,68.63
Talon,Malphite,336,143,193,42.56
Talon,Aatrox,363,161,202,44.35
Talon,Katarina,314,167,147,53.18
Talon,TahmKench,355,138,217,38.87
Talon,Ziggs,190,119,71,62.63
Talon,Twitch,373,164,209,43.97
Talon,Sona,149,62,87,41.61
Talon,Heimerdinger,198,57,141,28.79
Talon,Gwen,165,77,88,46.67
Talon,Sejuani,120,39,81,32.5
Talon,Yuumi,341,183,158,53.67
Talon,TwistedFate,135,65,70,48.15
Talon,FiddleSticks,233,94,139,40.34
Talon,Cassiopeia,143,71,72,49.65
Talon,Hwei,291,137,154,47.08
Talon,MonkeyKing,206,56,150,27.18
Talon,Azir,104,51,53,49.04
Talon,Nilah,159,104,55,65.41
Talon,Tryndamere,251,148,103,58.96
Talon,Ryze,113,58,55,51.33
Talon,Graves,208,70,138,33.65
Talon,Maokai,166,57,109,34.34
Talon,Kennen,142,81,61,57.04
Talon,Annie,155,84,71,54.19
Talon,Zilean,97,53,44,54.64
Talon,Ornn,178,61,117,34.27
Talon,Renekton,203,79,124,38.92
Talon,XinZhao,187,90,97,48.13
Talon,Renata,97,40,57,41.24
Talon,Skarner,108,60,48,55.56
Talon,Taliyah,128,69,59,53.91
Talon,Ivern,87,46,41,52.87
Talon,Corki,124,77,47,62.1
Talon,Bard,106,31,75,29.25
Talon,Belveth,102,68,34,66.67
Talon,JarvanIV,114,72,42,63.16
Talon,Zac,109,31,78,28.44
Talon,Zoe,168,104,64,61.9
Talon,Kassadin,88,52,36,59.09
Talon,RekSai,65,42,23,64.62
Talon,Riven,183,74,109,40.44
Talon,Rumble,79,32,47,40.51
Talon,KSante,139,92,47,66.19
Talon,Hecarim,126,51,75,40.48
Alistar,Ambessa,109,54,55,49.54
Alistar,Rammus,45,29,16,64.44
Alistar,Mel,469,223,246,47.55
Alistar,Draven,118,62,56,52.54
Alistar,Blitzcrank,142,77,65,54.23
Alistar,Jax,190,70,120,36.84
Alistar,Elise,118,67,51,56.78
Alistar,Naafiri,78,29,49,37.18
Alistar,Jhin,286,156,130,54.55
Alistar,Lulu,182,113,69,62.09
Alistar,Riven,95,55,40,57.89
Alistar,Ivern,46,13,33,28.26
Alistar,Yasuo,430,161,269,37.44
Alistar,Swain,189,70,119,37.04
Alistar,Nami,162,59,103,36.42
Alistar,Fiora,98,52,46,53.06
Alistar,Kayn,241,96,145,39.83
Alistar,Malzahar,151,70,81,46.36
Alistar,Aphelios,103,52,51,50.49
Alistar,Zilean,68,23,45,33.82
Alistar,Sion,169,83,86,49.11
Alistar,Rengar,133,78,55,58.65
Alistar,Ahri,264,129,135,48.86
Alistar,Anivia,75,32,43,42.67
Alistar,Poppy,158,94,64,59.49
Alistar,Kennen,71,42,29,59.15
Alistar,Skarner,96,31,65,32.29
Alistar,Jinx,424,183,241,43.16
Alistar,Yuumi,132,55,77,41.67
Alistar,Warwick,282,149,133,52.84
Alistar,Malphite,154,64,90,41.56
Alistar,Lux,460,246,214,53.48
Alistar,Kled,34,20,14,58.82
Alistar,Gragas,132,58,74,43.94
Alistar,Rell,139,57,82,41.01
Alistar,Sett,362,195,167,53.87
Alistar,Sejuani,109,68,41,62.39
Alistar,Yone,415,217,198,52.29
Alistar,Ashe,304,159,145,52.3
Alistar,Urgot,107,37,70,34.58
Alistar,Ekko,243,135,108,55.56
Alistar,Xerath,107,46,61,42.99
Alistar,Kalista,90,50,40,55.56
Alistar,Pantheon,336,161,175,47.92
Alistar,Orianna,92,59,33,64.13
Alistar,Nautilus,362,177,185,48.9
Alistar,KSante,80,38,42,47.5
Alistar,Belveth,48,36,12,75
Alistar,MasterYi,183,87,96,47.54
Alistar,Kaisa,280,126,154,45
Alistar,Gwen,132,66,66,50
Alistar,Illaoi,122,48,74,39.34
Alistar,Vi,173,58,115,33.53
Alistar,Syndra,91,51,40,56.04
Alistar,Camille,47,15,32,31.91
Alistar,Varus,160,98,62,61.25
Alistar,Braum,78,39,39,50
Alistar,Talon,131,83,48,63.36
Alistar,Thresh,407,205,202,50.37
Alistar,MonkeyKing,147,64,83,43.54
Alistar,Akshan,85,57,28,67.06
Alistar,Caitlyn,461,184,277,39.91
Alistar,Soraka,129,58,71,44.96
Alistar,Katarina,171,68,103,39.77
Alistar,Samira,197,99,98,50.25
Alistar,Ezreal,352,151,201,42.9
Alistar,Zac,78,48,30,61.54
Alistar,Zed,195,91,104,46.67
Alistar,Bard,84,49,35,58.33
Alistar,Volibear,193,106,87,54.92
Alistar,Smolder,150,70,80,46.67
Alistar,Teemo,266,74,192,27.82
Alistar,AurelionSol,93,41,52,44.09
Alistar,Lissandra,60,27,33,45
Alistar,Senna,163,82,81,50.31
Alistar,Vladimir,111,71,40,63.96
Alistar,Hecarim,83,43,40,51.81
Alistar,Akali,232,146,86,62.93
Alistar,TwistedFate,79,33,46,41.77
Alistar,Aurora,154,59,95,38.31
Alistar,Kindred,87,53,34,60.92
Alistar,Viktor,151,60,91,39.74
Alistar,Vayne,259,144,115,55.6
Alistar,Gangplank,110,53,57,48.18
Alistar,Brand,133,61,72,45.86
Alistar,Trundle,115,69,46,60
Alistar,Darius,325,156,169,48
Alistar,Graves,131,84,47,64.12
Alistar,Neeko,150,99,51,66
Alistar,Gnar,109,54,55,49.54
Alistar,Karma,114,51,63,44.74
Alistar,Mordekaiser,282,110,172,39.01
Alistar,Nunu,116,61,55,52.59
Alistar,Shen,138,77,61,55.8
Alistar,Tristana,196,115,81,58.67
Alistar,Velkoz,124,70,54,56.45
Alistar,LeeSin,182,81,101,44.51
Alistar,Milio,138,74,64,53.62
Alistar,Diana,290,108,182,37.24
Alistar,Irelia,195,111,84,56.92
Alistar,Lillia,134,65,69,48.51
Alistar,Sona,68,25,43,36.76
Alistar,Leona,152,79,73,51.97
Alistar,Yorick,145,72,73,49.66
Alistar,Veigar,200,116,84,58
Alistar,MissFortune,410,195,215,47.56
Alistar,Renekton,109,29,80,26.61
Alistar,Twitch,109,59,50,54.13
Alistar,Jayce,91,49,42,53.85
Alistar,Singed,52,25,27,48.08
Alistar,TahmKench,227,106,121,46.7
Alistar,Shaco,186,91,95,48.92
Alistar,Sylas,233,106,127,45.49
Alistar,Chogath,243,122,121,50.21
Alistar,Taliyah,82,33,49,40.24
Alistar,Xayah,171,93,78,54.39
Alistar,Aatrox,183,102,81,55.74
Alistar,Galio,108,37,71,34.26
Alistar,Evelynn,67,41,26,61.19
Alistar,FiddleSticks,64,35,29,54.69
Alistar,Fizz,80,45,35,56.25
Alistar,Lucian,122,55,67,45.08
Alistar,Morgana,255,107,148,41.96
Alistar,Renata,65,36,29,55.38
Alistar,XinZhao,87,48,39,55.17
Alistar,Rumble,61,31,30,50.82
Alistar,Azir,90,37,53,41.11
Alistar,Nocturne,172,68,104,39.53
Alistar,Leblanc,102,56,46,54.9
Alistar,Cassiopeia,72,29,43,40.28
Alistar,Ornn,98,45,53,45.92
Alistar,Pyke,246,115,131,46.75
Alistar,Briar,207,110,97,53.14
Alistar,Vex,85,40,45,47.06
Alistar,Viego,296,157,139,53.04
Alistar,Taric,50,14,36,28
Alistar,Amumu,166,95,71,57.23
Alistar,JarvanIV,99,33,66,33.33
Alistar,KogMaw,81,26,55,32.1
Alistar,Hwei,114,56,58,49.12
Alistar,Garen,373,137,236,36.73
Alistar,Seraphine,176,97,79,55.11
Alistar,Heimerdinger,112,33,79,29.46
Alistar,Quinn,93,47,46,50.54
Alistar,Nasus,108,56,52,51.85
Alistar,Ziggs,91,33,58,36.26
Alistar,Khazix,116,64,52,55.17
Alistar,Sivir,91,41,50,45.05
Alistar,Nilah,150,78,72,52
Alistar,Tryndamere,78,22,56,28.21
Alistar,Nidalee,49,27,22,55.1
Alistar,Zyra,121,51,70,42.15
Alistar,DrMundo,146,61,85,41.78
Alistar,Corki,96,62,34,64.58
Alistar,Zeri,100,59,41,59
Alistar,Maokai,95,50,45,52.63
Alistar,Kayle,131,81,50,61.83
Alistar,Annie,78,19,59,24.36
Alistar,Udyr,91,41,50,45.05
Alistar,Kassadin,49,38,11,77.55
Alistar,Rakan,143,73,70,51.05
Alistar,Zoe,96,54,42,56.25
Alistar,Qiyana,109,38,71,34.86
Alistar,Ryze,36,19,17,52.78
Alistar,Olaf,27,10,17,37.04
Alistar,Shyvana,63,10,53,15.87
Alistar,Janna,58,34,24,58.62
Alistar,Karthus,50,20,30,40
Alistar,RekSai,37,19,18,51.35
Garen,Pantheon,1577,787,790,49.9
Garen,Diana,1166,630,536,54.03
Garen,Gangplank,355,203,152,57.18
Garen,Ezreal,1556,862,694,55.4
Garen,Yuumi,862,453,409,52.55
Garen,Mordekaiser,1530,653,877,42.68
Garen,Briar,808,407,401,50.37
Garen,Ryze,317,154,163,48.58
Garen,Vex,549,316,233,57.56
Garen,Teemo,1331,534,797,40.12
Garen,XinZhao,543,334,209,61.51
Garen,Yasuo,1959,1037,922,52.94
Garen,Jinx,1737,903,834,51.99
Garen,Neeko,767,426,341,55.54
Garen,Vladimir,408,206,202,50.49
Garen,Evelynn,506,282,224,55.73
Garen,Tristana,758,360,398,47.49
Garen,Chogath,1305,619,686,47.43
Garen,Morgana,1075,544,531,50.6
Garen,Jhin,1501,725,776,48.3
Garen,Mel,1959,999,960,51
Garen,Heimerdinger,469,250,219,53.3
Garen,LeeSin,896,521,375,58.15
Garen,Veigar,1015,511,504,50.34
Garen,Irelia,792,418,374,52.78
Garen,Lillia,601,269,332,44.76
Garen,Sylas,947,539,408,56.92
Garen,Caitlyn,2079,991,1088,47.67
Garen,Lux,2367,1164,1203,49.18
Garen,Aatrox,947,476,471,50.26
Garen,Khazix,628,373,255,59.39
Garen,Qiyana,249,135,114,54.22
Garen,MissFortune,1948,1021,927,52.41
Garen,Nautilus,1027,510,517,49.66
Garen,Sion,658,353,305,53.65
Garen,Warwick,1372,635,737,46.28
Garen,Akshan,392,236,156,60.2
Garen,Bard,290,168,122,57.93
Garen,Ivern,210,96,114,45.71
Garen,Vayne,1123,500,623,44.52
Garen,Shyvana,277,100,177,36.1
Garen,Karma,654,331,323,50.61
Garen,Soraka,465,238,227,51.18
Garen,Sett,1470,811,659,55.17
Garen,Talon,412,223,189,54.13
Garen,Lissandra,238,138,100,57.98
Garen,Milio,519,278,241,53.56
Garen,Aphelios,673,278,395,41.31
Garen,Leona,716,323,393,45.11
Garen,Riven,480,344,136,71.67
Garen,Ambessa,549,321,228,58.47
Garen,TwistedFate,356,203,153,57.02
Garen,Nami,760,446,314,58.68
Garen,Yone,1787,873,914,48.85
Garen,Trundle,521,271,250,52.02
Garen,Naafiri,408,223,185,54.66
Garen,Shen,760,410,350,53.95
Garen,Aurora,808,429,379,53.09
Garen,Fizz,549,284,265,51.73
Garen,Swain,980,423,557,43.16
Garen,Jax,966,542,424,56.11
Garen,Tryndamere,702,326,376,46.44
Garen,Corki,348,239,109,68.68
Garen,Pyke,1026,622,404,60.62
Garen,Rammus,280,138,142,49.29
Garen,DrMundo,613,343,270,55.95
Garen,TahmKench,982,534,448,54.38
Garen,Camille,404,192,212,47.52
Garen,Hecarim,362,195,167,53.87
Garen,Kayn,1419,744,675,52.43
Garen,Nocturne,757,402,355,53.1
Garen,Ashe,1565,886,679,56.61
Garen,Ornn,413,190,223,46
Garen,Vi,833,416,417,49.94
Garen,Anivia,281,148,133,52.67
Garen,Kindred,489,295,194,60.33
Garen,Varus,748,387,361,51.74
Garen,Maokai,390,139,251,35.64
Garen,Katarina,780,453,327,58.08
Garen,Fiora,396,264,132,66.67
Garen,Amumu,941,434,507,46.12
Garen,Samira,820,448,372,54.63
Garen,Seraphine,1027,536,491,52.19
Garen,Thresh,1200,631,569,52.58
Garen,Viego,1012,533,479,52.67
Garen,Ekko,736,375,361,50.95
Garen,Senna,699,362,337,51.79
Garen,Kalista,520,289,231,55.58
Garen,Zed,871,465,406,53.39
Garen,Draven,489,258,231,52.76
Garen,Volibear,1033,527,506,51.02
Garen,Cassiopeia,374,212,162,56.68
Garen,JarvanIV,389,221,168,56.81
Garen,Twitch,695,313,382,45.04
Garen,KSante,471,278,193,59.02
Garen,Nunu,779,400,379,51.35
Garen,Nasus,688,371,317,53.92
Garen,MasterYi,779,413,366,53.02
Garen,Rell,547,257,290,46.98
Garen,Renekton,478,249,229,52.09
Garen,Azir,345,187,158,54.2
Garen,Xayah,680,350,330,51.47
Garen,Akali,983,508,475,51.68
Garen,FiddleSticks,395,196,199,49.62
Garen,Zac,358,183,175,51.12
Garen,Darius,2118,1160,958,54.77
Garen,Velkoz,575,279,296,48.52
Garen,Rakan,614,334,280,54.4
Garen,Shaco,749,388,361,51.8
Garen,Gwen,590,368,222,62.37
Garen,Rengar,434,250,184,57.6
Garen,Malphite,759,397,362,52.31
Garen,Annie,234,123,111,52.56
Garen,Jayce,378,238,140,62.96
Garen,MonkeyKing,496,253,243,51.01
Garen,Lucian,531,317,214,59.7
Garen,Elise,483,306,177,63.35
Garen,Xerath,544,277,267,50.92
Garen,Sejuani,342,162,180,47.37
Garen,Leblanc,362,192,170,53.04
Garen,Lulu,726,400,326,55.1
Garen,AurelionSol,408,208,200,50.98
Garen,Nilah,553,258,295,46.65
Garen,Kassadin,152,62,90,40.79
Garen,Graves,471,293,178,62.21
Garen,Illaoi,445,245,200,55.06
Garen,Kaisa,1190,730,460,61.34
Garen,Renata,194,85,109,43.81
Garen,Brand,626,354,272,56.55
Garen,Belveth,284,149,135,52.46
Garen,Nidalee,243,147,96,60.49
Garen,Taric,205,99,106,48.29
Garen,Kayle,783,358,425,45.72
Garen,Malzahar,665,314,351,47.22
Garen,Zoe,337,208,129,61.72
Garen,Gnar,328,150,178,45.73
Garen,Smolder,671,356,315,53.06
Garen,Kled,184,59,125,32.07
Garen,Syndra,483,291,192,60.25
Garen,KogMaw,345,152,193,44.06
Garen,Galio,674,325,349,48.22
Garen,Zyra,608,272,336,44.74
Garen,Skarner,222,125,97,56.31
Garen,Ziggs,421,219,202,52.02
Garen,Poppy,426,187,239,43.9
Garen,Blitzcrank,652,392,260,60.12
Garen,Singed,226,108,118,47.79
Garen,Gragas,496,278,218,56.05
Garen,Hwei,649,324,325,49.92
Garen,Ahri,1243,626,617,50.36
Garen,Sivir,439,215,224,48.97
Garen,Karthus,268,148,120,55.22
Garen,Braum,491,252,239,51.32
Garen,Udyr,438,212,226,48.4
Garen,Kennen,318,194,124,61.01
Garen,Zeri,385,231,154,60
Garen,Urgot,491,258,233,52.55
Garen,Janna,265,140,125,52.83
Garen,Quinn,354,177,177,50
Garen,Yorick,778,361,417,46.4
Garen,Viktor,490,254,236,51.84
Garen,Zilean,231,110,121,47.62
Garen,Olaf,194,118,76,60.82
Garen,RekSai,64,44,20,68.75
Garen,Taliyah,263,169,94,64.26
Garen,Alistar,373,236,137,63.27
Garen,Orianna,377,194,183,51.46
Garen,Sona,328,176,152,53.66
Garen,Rumble,140,90,50,64.29
Ryze,Aatrox,176,52,124,29.55
Ryze,Brand,88,38,50,43.18
Ryze,Irelia,139,56,83,40.29
Ryze,Caitlyn,409,203,206,49.63
Ryze,Milio,54,35,19,64.81
Ryze,Garen,317,163,154,51.42
Ryze,Diana,207,91,116,43.96
Ryze,Yasuo,408,149,259,36.52
Ryze,Pyke,206,127,79,61.65
Ryze,Sylas,192,110,82,57.29
Ryze,Zed,177,107,70,60.45
Ryze,MasterYi,178,84,94,47.19
Ryze,Rell,100,41,59,41
Ryze,Sett,271,134,137,49.45
Ryze,Vladimir,89,37,52,41.57
Ryze,Kindred,83,43,40,51.81
Ryze,Aphelios,101,55,46,54.46
Ryze,Jax,104,41,63,39.42
Ryze,Elise,113,70,43,61.95
Ryze,Naafiri,67,42,25,62.69
Ryze,Jhin,282,146,136,51.77
Ryze,Lulu,184,119,65,64.67
Ryze,Camille,80,51,29,63.75
Ryze,LeeSin,163,111,52,68.1
Ryze,Pantheon,295,156,139,52.88
Ryze,Samira,238,107,131,44.96
Ryze,Ekko,143,80,63,55.94
Ryze,Tristana,157,72,85,45.86
Ryze,Kayn,214,133,81,62.15
Ryze,Lux,546,190,356,34.8
Ryze,Jinx,318,157,161,49.37
Ryze,Karma,168,88,80,52.38
Ryze,Chogath,267,142,125,53.18
Ryze,Hwei,137,55,82,40.15
Ryze,Draven,83,59,24,71.08
Ryze,Warwick,352,195,157,55.4
Ryze,Veigar,172,98,74,56.98
Ryze,Ezreal,402,234,168,58.21
Ryze,Ambessa,104,53,51,50.96
Ryze,Shen,157,63,94,40.13
Ryze,Kaisa,217,120,97,55.3
Ryze,KSante,80,52,28,65
Ryze,Nunu,126,63,63,50
Ryze,Yone,281,137,144,48.75
Ryze,Thresh,228,151,77,66.23
Ryze,Mordekaiser,213,72,141,33.8
Ryze,Teemo,300,154,146,51.33
Ryze,AurelionSol,92,49,43,53.26
Ryze,Xayah,90,38,52,42.22
Ryze,Rakan,88,32,56,36.36
Ryze,Kennen,61,31,30,50.82
Ryze,Shaco,180,122,58,67.78
Ryze,Twitch,164,118,46,71.95
Ryze,Yuumi,164,102,62,62.2
Ryze,Illaoi,92,51,41,55.43
Ryze,MonkeyKing,118,68,50,57.63
Ryze,Vex,112,58,54,51.79
Ryze,Mel,504,196,308,38.89
Ryze,Darius,346,131,215,37.86
Ryze,FiddleSticks,88,54,34,61.36
Ryze,Azir,90,59,31,65.56
Ryze,Volibear,153,87,66,56.86
Ryze,Trundle,95,57,38,60
Ryze,TahmKench,206,87,119,42.23
Ryze,Amumu,196,95,101,48.47
Ryze,Ziggs,65,36,29,55.38
Ryze,Malphite,151,85,66,56.29
Ryze,Katarina,169,71,98,42.01
Ryze,Nilah,102,63,39,61.76
Ryze,Seraphine,178,50,128,28.09
Ryze,Karthus,37,24,13,64.86
Ryze,Taliyah,49,40,9,81.63
Ryze,Morgana,271,137,134,50.55
Ryze,Ahri,307,159,148,51.79
Ryze,Nautilus,176,116,60,65.91
Ryze,Cassiopeia,68,43,25,63.24
Ryze,MissFortune,361,158,203,43.77
Ryze,Braum,83,43,40,51.81
Ryze,Graves,122,63,59,51.64
Ryze,Fizz,60,26,34,43.33
Ryze,Vi,125,43,82,34.4
Ryze,Akshan,69,39,30,56.52
Ryze,Corki,64,36,28,56.25
Ryze,Zyra,128,48,80,37.5
Ryze,Senna,154,85,69,55.19
Ryze,DrMundo,162,81,81,50
Ryze,Swain,158,70,88,44.3
Ryze,Sejuani,31,15,16,48.39
Ryze,Neeko,88,38,50,43.18
Ryze,Akali,176,81,95,46.02
Ryze,Sion,157,68,89,43.31
Ryze,XinZhao,88,45,43,51.14
Ryze,Tryndamere,175,87,88,49.71
Ryze,Vayne,208,92,116,44.23
Ryze,Blitzcrank,130,40,90,30.77
Ryze,Kled,30,12,18,40
Ryze,Zoe,109,56,53,51.38
Ryze,Renekton,70,28,42,40
Ryze,Udyr,98,39,59,39.8
Ryze,Lillia,118,57,61,48.31
Ryze,Malzahar,157,52,105,33.12
Ryze,Ashe,275,156,119,56.73
Ryze,Riven,49,30,19,61.22
Ryze,Nocturne,156,60,96,38.46
Ryze,Hecarim,84,38,46,45.24
Ryze,Velkoz,173,82,91,47.4
Ryze,Lucian,133,59,74,44.36
Ryze,Nami,174,99,75,56.9
Ryze,Belveth,41,12,29,29.27
Ryze,Heimerdinger,81,52,29,64.2
Ryze,Kayle,135,78,57,57.78
Ryze,Briar,236,101,135,42.8
Ryze,Aurora,200,110,90,55
Ryze,Taric,34,12,22,35.29
Ryze,Qiyana,83,44,39,53.01
Ryze,Gragas,117,58,59,49.57
Ryze,Gangplank,89,48,41,53.93
Ryze,Khazix,73,28,45,38.36
Ryze,Jayce,76,48,28,63.16
Ryze,Leona,114,58,56,50.88
Ryze,Urgot,71,28,43,39.44
Ryze,Kassadin,63,41,22,65.08
Ryze,Xerath,102,60,42,58.82
Ryze,Annie,46,19,27,41.3
Ryze,Ivern,38,16,22,42.11
Ryze,Fiora,115,80,35,69.57
Ryze,TwistedFate,57,23,34,40.35
Ryze,Rengar,109,50,59,45.87
Ryze,Gwen,102,49,53,48.04
Ryze,Olaf,43,20,23,46.51
Ryze,Viktor,134,55,79,41.04
Ryze,Kalista,69,43,26,62.32
Ryze,Sivir,91,46,45,50.55
Ryze,Varus,177,88,89,49.72
Ryze,Galio,123,81,42,65.85
Ryze,Singed,56,31,25,55.36
Ryze,Zeri,121,61,60,50.41
Ryze,Soraka,79,28,51,35.44
Ryze,Ornn,74,33,41,44.59
Ryze,Viego,228,85,143,37.28
Ryze,Maokai,86,34,52,39.53
Ryze,Yorick,184,67,117,36.41
Ryze,Talon,113,55,58,48.67
Ryze,Sona,51,30,21,58.82
Ryze,Rumble,30,6,24,20
Ryze,Smolder,149,83,66,55.7
Ryze,Renata,37,18,19,48.65
Ryze,JarvanIV,74,12,62,16.22
Ryze,Evelynn,83,39,44,46.99
Ryze,Rammus,52,27,25,51.92
Ryze,Orianna,79,23,56,29.11
Ryze,Nasus,109,51,58,46.79
Ryze,Poppy,102,56,46,54.9
Ryze,Nidalee,33,30,3,90.91
Ryze,KogMaw,67,25,42,37.31
Ryze,Syndra,60,22,38,36.67
Ryze,Skarner,55,30,25,54.55
Ryze,Janna,117,63,54,53.85
Ryze,Gnar,59,23,36,38.98
Ryze,Leblanc,42,25,17,59.52
Ryze,Anivia,65,42,23,64.62
Ryze,Alistar,36,17,19,47.22
Ryze,Zilean,52,27,25,51.92
Ryze,Shyvana,36,23,13,63.89
Ryze,Zac,61,21,40,34.43
Ryze,RekSai,25,15,10,60
Ryze,Bard,56,37,19,66.07
Ryze,Quinn,61,39,22,63.93
Ryze,Lissandra,31,8,23,25.81
Brand,Yorick,441,230,211,52.15
Brand,Kayn,761,356,405,46.78
Brand,Ryze,88,50,38,56.82
Brand,Lux,1483,705,778,47.54
Brand,Pantheon,726,371,355,51.1
Brand,TahmKench,554,275,279,49.64
Brand,Malphite,330,171,159,51.82
Brand,Yasuo,799,377,422,47.18
Brand,Aphelios,300,170,130,56.67
Brand,TwistedFate,89,45,44,50.56
Brand,Vladimir,296,127,169,42.91
Brand,Zac,185,116,69,62.7
Brand,Cassiopeia,141,59,82,41.84
Brand,Irelia,367,184,183,50.14
Brand,AurelionSol,190,74,116,38.95
Brand,Singed,110,27,83,24.55
Brand,Udyr,168,92,76,54.76
Brand,Sett,689,337,352,48.91
Brand,MissFortune,1064,551,513,51.79
Brand,Aatrox,378,202,176,53.44
Brand,Khazix,292,163,129,55.82
Brand,Qiyana,101,54,47,53.47
Brand,Nautilus,538,310,228,57.62
Brand,Tryndamere,279,143,136,51.25
Brand,Briar,526,280,246,53.23
Brand,Mordekaiser,733,361,372,49.25
Brand,Janna,114,51,63,44.74
Brand,Gnar,187,120,67,64.17
Brand,Nunu,355,171,184,48.17
Brand,Lucian,214,82,132,38.32
Brand,Jhin,732,353,379,48.22
Brand,Samira,452,200,252,44.25
Brand,Nami,393,204,189,51.91
Brand,XinZhao,214,86,128,40.19
Brand,Morgana,659,353,306,53.57
Brand,Ashe,761,431,330,56.64
Brand,Braum,207,123,84,59.42
Brand,Darius,807,437,370,54.15
Brand,Kindred,228,114,114,50
Brand,Veigar,532,281,251,52.82
Brand,Corki,123,57,66,46.34
Brand,Nocturne,447,250,197,55.93
Brand,Aurora,378,161,217,42.59
Brand,Soraka,233,133,100,57.08
Brand,Kayle,294,129,165,43.88
Brand,Akali,380,222,158,58.42
Brand,Yone,879,453,426,51.54
Brand,Tristana,429,228,201,53.15
Brand,Sivir,221,86,135,38.91
Brand,Ahri,751,362,389,48.2
Brand,Neeko,398,210,188,52.76
Brand,Heimerdinger,268,151,117,56.34
Brand,Renekton,161,68,93,42.24
Brand,Caitlyn,1083,549,534,50.69
Brand,Lillia,283,159,124,56.18
Brand,Pyke,516,280,236,54.26
Brand,Viego,463,161,302,34.77
Brand,Urgot,217,105,112,48.39
Brand,Amumu,353,168,185,47.59
Brand,Shaco,396,175,221,44.19
Brand,FiddleSticks,179,95,84,53.07
Brand,Zoe,206,147,59,71.36
Brand,Kaisa,542,278,264,51.29
Brand,Taric,80,41,39,51.25
Brand,Chogath,557,260,297,46.68
Brand,Ezreal,681,377,304,55.36
Brand,Gwen,289,181,108,62.63
Brand,Vayne,373,178,195,47.72
Brand,LeeSin,381,148,233,38.85
Brand,Thresh,560,320,240,57.14
Brand,DrMundo,399,172,227,43.11
Brand,Draven,233,87,146,37.34
Brand,Rell,233,122,111,52.36
Brand,Talon,257,159,98,61.87
Brand,Ekko,342,169,173,49.42
Brand,Volibear,478,228,250,47.7
Brand,MasterYi,506,216,290,42.69
Brand,Hwei,350,201,149,57.43
Brand,Karma,231,93,138,40.26
Brand,Katarina,337,159,178,47.18
Brand,Jax,367,156,211,42.51
Brand,Kled,68,25,43,36.76
Brand,Xerath,367,155,212,42.23
Brand,Nidalee,85,54,31,63.53
Brand,Swain,505,209,296,41.39
Brand,Vi,361,132,229,36.57
Brand,Jinx,788,377,411,47.84
Brand,Riven,124,67,57,54.03
Brand,Nilah,266,125,141,46.99
Brand,Trundle,214,98,116,45.79
Brand,Diana,540,302,238,55.93
Brand,Seraphine,465,240,225,51.61
Brand,Velkoz,246,146,100,59.35
Brand,Teemo,665,319,346,47.97
Brand,Senna,411,166,245,40.39
Brand,Shen,342,178,164,52.05
Brand,Rakan,209,105,104,50.24
Brand,Garen,626,272,354,43.45
Brand,Rammus,120,55,65,45.83
Brand,Ornn,163,60,103,36.81
Brand,Poppy,226,108,118,47.79
Brand,Warwick,704,301,403,42.76
Brand,KSante,141,100,41,70.92
Brand,Illaoi,223,95,128,42.6
Brand,Rengar,163,110,53,67.48
Brand,Mel,858,452,406,52.68
Brand,Leblanc,144,80,64,55.56
Brand,Twitch,344,165,179,47.97
Brand,Jayce,147,78,69,53.06
Brand,Orianna,157,61,96,38.85
Brand,Alistar,133,72,61,54.14
Brand,Karthus,115,65,50,56.52
Brand,Leona,257,110,147,42.8
Brand,Fizz,217,143,74,65.9
Brand,Zyra,287,129,158,44.95
Brand,Viktor,343,156,187,45.48
Brand,Camille,133,76,57,57.14
Brand,Azir,143,84,59,58.74
Brand,Blitzcrank,340,134,206,39.41
Brand,Ambessa,201,111,90,55.22
Brand,Malzahar,313,130,183,41.53
Brand,Yuumi,406,180,226,44.33
Brand,Sona,122,61,61,50
Brand,Ivern,92,40,52,43.48
Brand,Kassadin,107,44,63,41.12
Brand,Elise,251,118,133,47.01
Brand,Graves,225,115,110,51.11
Brand,Milio,152,56,96,36.84
Brand,Bard,121,62,59,51.24
Brand,Sejuani,98,43,55,43.88
Brand,MonkeyKing,246,101,145,41.06
Brand,Galio,382,203,179,53.14
Brand,Nasus,317,195,122,61.51
Brand,Fiora,198,125,73,63.13
Brand,Gragas,237,141,96,59.49
Brand,Anivia,122,51,71,41.8
Brand,Xayah,235,137,98,58.3
Brand,Varus,322,190,132,59.01
Brand,Zed,458,249,209,54.37
Brand,Quinn,162,77,85,47.53
Brand,Kennen,157,110,47,70.06
Brand,KogMaw,141,91,50,64.54
Brand,Ziggs,147,72,75,48.98
Brand,Lulu,339,190,149,56.05
Brand,Belveth,152,96,56,63.16
Brand,Gangplank,138,83,55,60.14
Brand,Kalista,168,85,83,50.6
Brand,Akshan,162,81,81,50
Brand,Sion,278,123,155,44.24
Brand,Sylas,432,179,253,41.44
Brand,Maokai,218,102,116,46.79
Brand,Smolder,357,174,183,48.74
Brand,Syndra,185,110,75,59.46
Brand,Taliyah,78,48,30,61.54
Brand,Vex,291,151,140,51.89
Brand,Lissandra,98,54,44,55.1
Brand,Hecarim,163,88,75,53.99
Brand,Annie,96,41,55,42.71
Brand,Naafiri,171,81,90,47.37
Brand,Evelynn,216,126,90,58.33
Brand,Renata,71,22,49,30.99
Brand,Zeri,139,90,49,64.75
Brand,Shyvana,81,29,52,35.8
Brand,Olaf,74,38,36,51.35
Brand,JarvanIV,152,73,79,48.03
Brand,Zilean,146,62,84,42.47
Brand,Rumble,55,36,19,65.45
Brand,Skarner,106,55,51,51.89
Brand,RekSai,30,17,13,56.67
DrMundo,Gangplank,168,88,80,52.38
DrMundo,Gragas,254,165,89,64.96
DrMundo,TwistedFate,149,65,84,43.62
DrMundo,Lucian,201,125,76,62.19
DrMundo,Leona,333,167,166,50.15
DrMundo,Singed,111,45,66,40.54
DrMundo,Graves,176,62,114,35.23
DrMundo,Fizz,205,117,88,57.07
DrMundo,Ziggs,170,76,94,44.71
DrMundo,Pantheon,620,369,251,59.52
DrMundo,Malphite,235,139,96,59.15
DrMundo,Rengar,160,80,80,50
DrMundo,Akali,411,232,179,56.45
DrMundo,Ashe,689,369,320,53.56
DrMundo,Rakan,202,100,102,49.5
DrMundo,Yorick,295,129,166,43.73
DrMundo,Akshan,155,85,70,54.84
DrMundo,FiddleSticks,204,124,80,60.78
DrMundo,Samira,454,272,182,59.91
DrMundo,Pyke,401,243,158,60.6
DrMundo,Jayce,201,117,84,58.21
DrMundo,Amumu,415,184,231,44.34
DrMundo,Yasuo,735,352,383,47.89
DrMundo,Milio,185,101,84,54.59
DrMundo,Chogath,588,345,243,58.67
DrMundo,Briar,462,247,215,53.46
DrMundo,Lulu,230,128,102,55.65
DrMundo,Sett,777,429,348,55.21
DrMundo,Rammus,94,44,50,46.81
DrMundo,Nautilus,434,250,184,57.6
DrMundo,Kayn,613,337,276,54.98
DrMundo,Zed,343,194,149,56.56
DrMundo,Yone,861,453,408,52.61
DrMundo,MissFortune,811,489,322,60.3
DrMundo,Senna,314,150,164,47.77
DrMundo,Garen,613,270,343,44.05
DrMundo,Ahri,502,286,216,56.97
DrMundo,Sona,132,62,70,46.97
DrMundo,Teemo,486,243,243,50
DrMundo,Jhin,622,330,292,53.05
DrMundo,Volibear,415,223,192,53.73
DrMundo,MasterYi,369,194,175,52.57
DrMundo,Seraphine,443,248,195,55.98
DrMundo,Nilah,235,113,122,48.09
DrMundo,Velkoz,296,199,97,67.23
DrMundo,Shaco,375,219,156,58.4
DrMundo,Lillia,384,207,177,53.91
DrMundo,Lissandra,66,41,25,62.12
DrMundo,Jinx,769,377,392,49.02
DrMundo,Mordekaiser,519,268,251,51.64
DrMundo,Zoe,196,109,87,55.61
DrMundo,Ezreal,662,362,300,54.68
DrMundo,Darius,762,405,357,53.15
DrMundo,Aphelios,259,128,131,49.42
DrMundo,Neeko,265,145,120,54.72
DrMundo,Aatrox,446,255,191,57.17
DrMundo,XinZhao,206,110,96,53.4
DrMundo,Vladimir,215,123,92,57.21
DrMundo,Tristana,377,219,158,58.09
DrMundo,Rell,173,77,96,44.51
DrMundo,Swain,438,208,230,47.49
DrMundo,Shen,177,118,59,66.67
DrMundo,Lux,1121,671,450,59.86
DrMundo,TahmKench,529,292,237,55.2
DrMundo,Morgana,578,286,292,49.48
DrMundo,Urgot,143,97,46,67.83
DrMundo,Skarner,106,72,34,67.92
DrMundo,Ekko,286,126,160,44.06
DrMundo,Kaisa,635,360,275,56.69
DrMundo,Mel,820,483,337,58.9
DrMundo,Jax,399,213,186,53.38
DrMundo,RekSai,53,21,32,39.62
DrMundo,Brand,399,227,172,56.89
DrMundo,Smolder,302,156,146,51.66
DrMundo,Riven,129,79,50,61.24
DrMundo,Hwei,245,138,107,56.33
DrMundo,Blitzcrank,279,100,179,35.84
DrMundo,Draven,179,115,64,64.25
DrMundo,Warwick,575,285,290,49.57
DrMundo,Qiyana,120,87,33,72.5
DrMundo,Xayah,248,127,121,51.21
DrMundo,Evelynn,224,129,95,57.59
DrMundo,Kayle,306,145,161,47.39
DrMundo,Leblanc,170,92,78,54.12
DrMundo,Sion,222,132,90,59.46
DrMundo,Viego,459,236,223,51.42
DrMundo,Braum,162,94,68,58.02
DrMundo,Zyra,322,169,153,52.48
DrMundo,Zeri,146,68,78,46.58
DrMundo,Vayne,440,207,233,47.05
DrMundo,Ryze,162,81,81,50
DrMundo,Karthus,119,83,36,69.75
DrMundo,Udyr,114,60,54,52.63
DrMundo,AurelionSol,179,87,92,48.6
DrMundo,Khazix,256,144,112,56.25
DrMundo,Irelia,307,182,125,59.28
DrMundo,Malzahar,275,148,127,53.82
DrMundo,Hecarim,182,140,42,76.92
DrMundo,Sylas,392,185,207,47.19
DrMundo,Nami,361,224,137,62.05
DrMundo,Kennen,168,115,53,68.45
DrMundo,MonkeyKing,235,103,132,43.83
DrMundo,Veigar,400,186,214,46.5
DrMundo,KSante,133,72,61,54.14
DrMundo,Diana,593,339,254,57.17
DrMundo,Talon,246,166,80,67.48
DrMundo,Quinn,148,64,84,43.24
DrMundo,Aurora,414,254,160,61.35
DrMundo,Yuumi,381,196,185,51.44
DrMundo,Corki,130,69,61,53.08
DrMundo,Poppy,262,158,104,60.31
DrMundo,Katarina,324,216,108,66.67
DrMundo,LeeSin,386,160,226,41.45
DrMundo,Vex,191,94,97,49.21
DrMundo,Xerath,276,150,126,54.35
DrMundo,Caitlyn,920,531,389,57.72
DrMundo,Soraka,183,115,68,62.84
DrMundo,Ambessa,241,117,124,48.55
DrMundo,Kassadin,92,58,34,63.04
DrMundo,Nunu,322,170,152,52.8
DrMundo,Karma,233,127,106,54.51
DrMundo,Gnar,155,85,70,54.84
DrMundo,Zac,116,53,63,45.69
DrMundo,Zilean,102,41,61,40.2
DrMundo,Renekton,143,57,86,39.86
DrMundo,Twitch,330,193,137,58.48
DrMundo,Varus,333,162,171,48.65
DrMundo,Sejuani,159,85,74,53.46
DrMundo,Nidalee,102,68,34,66.67
DrMundo,Naafiri,176,90,86,51.14
DrMundo,Heimerdinger,231,119,112,51.52
DrMundo,Taliyah,102,51,51,50
DrMundo,Galio,288,158,130,54.86
DrMundo,Belveth,122,41,81,33.61
DrMundo,Kindred,170,73,97,42.94
DrMundo,Gwen,246,107,139,43.5
DrMundo,Nocturne,317,186,131,58.68
DrMundo,Renata,79,44,35,55.7
DrMundo,Azir,113,52,61,46.02
DrMundo,Trundle,268,107,161,39.93
DrMundo,Kalista,165,88,77,53.33
DrMundo,Thresh,414,191,223,46.14
DrMundo,Bard,141,65,76,46.1
DrMundo,KogMaw,133,57,76,42.86
DrMundo,Fiora,177,127,50,71.75
DrMundo,Viktor,250,134,116,53.6
DrMundo,Janna,78,55,23,70.51
DrMundo,Vi,356,192,164,53.93
DrMundo,Illaoi,248,150,98,60.48
DrMundo,Syndra,215,157,58,73.02
DrMundo,Olaf,73,47,26,64.38
DrMundo,Tryndamere,203,121,82,59.61
DrMundo,Kled,103,66,37,64.08
DrMundo,Cassiopeia,155,74,81,47.74
DrMundo,Maokai,188,79,109,42.02
DrMundo,JarvanIV,107,51,56,47.66
DrMundo,Orianna,246,157,89,63.82
DrMundo,Annie,132,76,56,57.58
DrMundo,Taric,91,50,41,54.95
DrMundo,Ivern,105,55,50,52.38
DrMundo,Alistar,146,85,61,58.22
DrMundo,Ornn,183,112,71,61.2
DrMundo,Anivia,126,65,61,51.59
DrMundo,Elise,233,163,70,69.96
DrMundo,Sivir,168,106,62,63.1
DrMundo,Camille,114,62,52,54.39
DrMundo,Nasus,207,108,99,52.17
DrMundo,Shyvana,95,55,40,57.89
DrMundo,Rumble,81,53,28,65.43
Gragas,DrMundo,254,89,165,35.04
Gragas,Lillia,231,84,147,36.36
Gragas,Viktor,325,151,174,46.46
Gragas,Jhin,577,261,316,45.23
Gragas,Pyke,365,227,138,62.19
Gragas,Kayle,294,137,157,46.6
Gragas,Viego,411,203,208,49.39
Gragas,Irelia,335,153,182,45.67
Gragas,Jinx,708,336,372,47.46
Gragas,Thresh,585,261,324,44.62
Gragas,Riven,157,83,74,52.87
Gragas,Nocturne,293,119,174,40.61
Gragas,Zoe,165,90,75,54.55
Gragas,Lulu,397,146,251,36.78
Gragas,Zed,376,172,204,45.74
Gragas,Shaco,410,131,279,31.95
Gragas,Anivia,131,63,68,48.09
Gragas,Lux,1032,468,564,45.35
Gragas,Morgana,518,211,307,40.73
Gragas,Ivern,97,52,45,53.61
Gragas,Yasuo,697,298,399,42.75
Gragas,Swain,384,179,205,46.61
Gragas,Nami,359,165,194,45.96
Gragas,Jayce,168,98,70,58.33
Gragas,Rengar,205,120,85,58.54
Gragas,Ezreal,629,334,295,53.1
Gragas,Sona,90,62,28,68.89
Gragas,LeeSin,449,245,204,54.57
Gragas,Mel,767,373,394,48.63
Gragas,Tristana,320,146,174,45.63
Gragas,Zac,100,53,47,53
Gragas,Sylas,344,154,190,44.77
Gragas,Rell,226,102,124,45.13
Gragas,Ashe,615,298,317,48.46
Gragas,Mordekaiser,471,163,308,34.61
Gragas,Warwick,670,305,365,45.52
Gragas,Yone,709,315,394,44.43
Gragas,Kalista,136,59,77,43.38
Gragas,Kennen,158,84,74,53.16
Gragas,Rammus,83,25,58,30.12
Gragas,Caitlyn,834,348,486,41.73
Gragas,Zeri,164,65,99,39.63
Gragas,Kayn,610,270,340,44.26
Gragas,Aurora,310,150,160,48.39
Gragas,Nilah,210,112,98,53.33
Gragas,Karma,267,127,140,47.57
Gragas,Camille,160,58,102,36.25
Gragas,Draven,292,181,111,61.99
Gragas,Senna,329,134,195,40.73
Gragas,Poppy,165,74,91,44.85
Gragas,Nunu,313,162,151,51.76
Gragas,MissFortune,793,320,473,40.35
Gragas,Rakan,180,79,101,43.89
Gragas,Nasus,272,93,179,34.19
Gragas,Udyr,194,73,121,37.63
Gragas,Alistar,132,74,58,56.06
Gragas,TahmKench,356,189,167,53.09
Gragas,Briar,287,115,172,40.07
Gragas,Heimerdinger,202,96,106,47.52
Gragas,Blitzcrank,267,152,115,56.93
Gragas,Velkoz,239,78,161,32.64
Gragas,Yorick,360,162,198,45
Gragas,Evelynn,144,72,72,50
Gragas,Akali,386,184,202,47.67
Gragas,Neeko,286,143,143,50
Gragas,Jax,395,227,168,57.47
Gragas,Janna,164,60,104,36.59
Gragas,Sett,606,257,349,42.41
Gragas,Nautilus,416,245,171,58.89
Gragas,Elise,277,138,139,49.82
Gragas,Annie,126,59,67,46.83
Gragas,Ziggs,151,60,91,39.74
Gragas,Naafiri,134,51,83,38.06
Gragas,Gangplank,229,119,110,51.97
Gragas,Ornn,152,78,74,51.32
Gragas,Sivir,181,76,105,41.99
Gragas,Veigar,419,171,248,40.81
Gragas,Samira,364,172,192,47.25
Gragas,Tryndamere,224,109,115,48.66
Gragas,Shyvana,128,43,85,33.59
Gragas,Fizz,157,61,96,38.85
Gragas,Taric,86,24,62,27.91
Gragas,Singed,106,49,57,46.23
Gragas,Darius,670,344,326,51.34
Gragas,Shen,321,148,173,46.11
Gragas,Vi,326,146,180,44.79
Gragas,Yuumi,358,149,209,41.62
Gragas,Graves,200,84,116,42
Gragas,Renekton,160,75,85,46.88
Gragas,Soraka,198,60,138,30.3
Gragas,Katarina,304,175,129,57.57
Gragas,Gnar,145,81,64,55.86
Gragas,Xerath,264,118,146,44.7
Gragas,Leona,265,146,119,55.09
Gragas,Aphelios,270,147,123,54.44
Gragas,MasterYi,363,153,210,42.15
Gragas,Zyra,230,93,137,40.43
Gragas,Aatrox,454,267,187,58.81
Gragas,TwistedFate,147,63,84,42.86
Gragas,Seraphine,334,154,180,46.11
Gragas,Teemo,505,175,330,34.65
Gragas,Volibear,495,266,229,53.74
Gragas,Ahri,511,261,250,51.08
Gragas,Diana,465,191,274,41.08
Gragas,Milio,209,101,108,48.33
Gragas,Sion,296,128,168,43.24
Gragas,Nidalee,118,58,60,49.15
Gragas,Hwei,248,156,92,62.9
Gragas,Leblanc,164,63,101,38.41
Gragas,Smolder,415,189,226,45.54
Gragas,Syndra,211,100,111,47.39
Gragas,Malzahar,251,119,132,47.41
Gragas,Talon,261,171,90,65.52
Gragas,Lucian,246,128,118,52.03
Gragas,Twitch,286,124,162,43.36
Gragas,Orianna,169,107,62,63.31
Gragas,Sejuani,179,74,105,41.34
Gragas,FiddleSticks,178,69,109,38.76
Gragas,Fiora,204,84,120,41.18
Gragas,Vayne,440,227,213,51.59
Gragas,Belveth,98,52,46,53.06
Gragas,Corki,158,82,76,51.9
Gragas,Karthus,131,90,41,68.7
Gragas,KSante,175,69,106,39.43
Gragas,Olaf,84,30,54,35.71
Gragas,Ekko,307,144,163,46.91
Gragas,Galio,304,102,202,33.55
Gragas,Chogath,445,217,228,48.76
Gragas,Qiyana,164,66,98,40.24
Gragas,Hecarim,139,92,47,66.19
Gragas,Xayah,240,99,141,41.25
Gragas,Varus,318,167,151,52.52
Gragas,Garen,496,218,278,43.95
Gragas,Kindred,201,73,128,36.32
Gragas,Malphite,269,107,162,39.78
Gragas,Ambessa,241,132,109,54.77
Gragas,XinZhao,204,97,107,47.55
Gragas,Kaisa,532,253,279,47.56
Gragas,Ryze,117,59,58,50.43
Gragas,Gwen,257,158,99,61.48
Gragas,Pantheon,644,345,299,53.57
Gragas,Akshan,159,63,96,39.62
Gragas,Quinn,141,94,47,66.67
Gragas,Bard,136,63,73,46.32
Gragas,Khazix,227,107,120,47.14
Gragas,Skarner,81,29,52,35.8
Gragas,Vladimir,210,92,118,43.81
Gragas,MonkeyKing,168,103,65,61.31
Gragas,Trundle,174,63,111,36.21
Gragas,Braum,216,88,128,40.74
Gragas,Azir,157,73,84,46.5
Gragas,Brand,237,96,141,40.51
Gragas,Zilean,114,41,73,35.96
Gragas,Urgot,174,49,125,28.16
Gragas,Kassadin,103,75,28,72.82
Gragas,Vex,243,107,136,44.03
Gragas,Lissandra,107,35,72,32.71
Gragas,Taliyah,107,52,55,48.6
Gragas,Illaoi,209,74,135,35.41
Gragas,Amumu,376,167,209,44.41
Gragas,Maokai,207,68,139,32.85
Gragas,Kled,59,39,20,66.1
Gragas,Cassiopeia,132,45,87,34.09
Gragas,KogMaw,139,60,79,43.17
Gragas,RekSai,33,3,30,9.09
Gragas,JarvanIV,130,81,49,62.31
Gragas,Renata,93,49,44,52.69
Gragas,AurelionSol,149,51,98,34.23
Gragas,Rumble,67,37,30,55.22
TwistedFate,DrMundo,149,84,65,56.38
TwistedFate,Lillia,189,106,83,56.08
TwistedFate,Viktor,165,75,90,45.45
TwistedFate,Jhin,397,163,234,41.06
TwistedFate,Pyke,279,121,158,43.37
TwistedFate,Gangplank,159,97,62,61.01
TwistedFate,Brand,89,44,45,49.44
TwistedFate,Irelia,184,81,103,44.02
TwistedFate,Malzahar,220,106,114,48.18
TwistedFate,Aatrox,232,115,117,49.57
TwistedFate,Gwen,129,85,44,65.89
TwistedFate,Syndra,108,46,62,42.59
TwistedFate,Ashe,379,201,178,53.03
TwistedFate,Lulu,179,91,88,50.84
TwistedFate,Mordekaiser,258,115,143,44.57
TwistedFate,Amumu,192,81,111,42.19
TwistedFate,Sylas,230,125,105,54.35
TwistedFate,Xayah,154,74,80,48.05
TwistedFate,TahmKench,202,94,108,46.53
TwistedFate,Nunu,170,89,81,52.35
TwistedFate,Vladimir,100,36,64,36
TwistedFate,Samira,182,98,84,53.85
TwistedFate,Nami,230,102,128,44.35
TwistedFate,Jax,211,97,114,45.97
TwistedFate,Elise,137,72,65,52.55
TwistedFate,Kaisa,362,172,190,47.51
TwistedFate,Twitch,195,80,115,41.03
TwistedFate,Yuumi,200,78,122,39
TwistedFate,Vi,177,87,90,49.15
TwistedFate,Orianna,154,89,65,57.79
TwistedFate,Draven,143,76,67,53.15
TwistedFate,Garen,356,153,203,42.98
TwistedFate,Zed,263,151,112,57.41
TwistedFate,Aurora,179,71,108,39.66
TwistedFate,Caitlyn,586,256,330,43.69
TwistedFate,Soraka,137,73,64,53.28
TwistedFate,Kindred,132,95,37,71.97
TwistedFate,Kennen,77,36,41,46.75
TwistedFate,Tristana,177,104,73,58.76
TwistedFate,Teemo,315,121,194,38.41
TwistedFate,Maokai,115,51,64,44.35
TwistedFate,Corki,84,38,46,45.24
TwistedFate,Taric,56,23,33,41.07
TwistedFate,Rammus,80,32,48,40
TwistedFate,Katarina,169,84,85,49.7
TwistedFate,Milio,120,51,69,42.5
TwistedFate,Kayn,369,202,167,54.74
TwistedFate,Veigar,209,101,108,48.33
TwistedFate,Swain,257,93,164,36.19
TwistedFate,Renata,56,29,27,51.79
TwistedFate,XinZhao,100,51,49,51
TwistedFate,Rell,125,54,71,43.2
TwistedFate,Kayle,164,73,91,44.51
TwistedFate,FiddleSticks,91,53,38,58.24
TwistedFate,Zoe,118,81,37,68.64
TwistedFate,Camille,112,59,53,52.68
TwistedFate,Rengar,111,60,51,54.05
TwistedFate,Sett,353,148,205,41.93
TwistedFate,MissFortune,449,232,217,51.67
TwistedFate,Sona,69,46,23,66.67
TwistedFate,Jinx,357,173,184,48.46
TwistedFate,Yone,310,162,148,52.26
TwistedFate,Illaoi,125,62,63,49.6
TwistedFate,Gragas,147,84,63,57.14
TwistedFate,Lux,642,302,340,47.04
TwistedFate,Leona,158,62,96,39.24
TwistedFate,Pantheon,405,199,206,49.14
TwistedFate,Akali,224,75,149,33.48
TwistedFate,Shaco,226,71,155,31.42
TwistedFate,Velkoz,129,52,77,40.31
TwistedFate,Yorick,164,59,105,35.98
TwistedFate,Zyra,160,50,110,31.25
TwistedFate,Karthus,63,10,53,15.87
TwistedFate,Mel,450,212,238,47.11
TwistedFate,Morgana,257,113,144,43.97
TwistedFate,Darius,440,175,265,39.77
TwistedFate,Poppy,166,76,90,45.78
TwistedFate,Bard,56,27,29,48.21
TwistedFate,Galio,143,61,82,42.66
TwistedFate,Alistar,79,46,33,58.23
TwistedFate,LeeSin,290,144,146,49.66
TwistedFate,Kassadin,53,19,34,35.85
TwistedFate,Viego,201,95,106,47.26
TwistedFate,Hecarim,109,49,60,44.95
TwistedFate,Thresh,313,140,173,44.73
TwistedFate,MonkeyKing,106,40,66,37.74
TwistedFate,Ekko,189,107,82,56.61
TwistedFate,Ahri,248,123,125,49.6
TwistedFate,MasterYi,246,124,122,50.41
TwistedFate,Nautilus,182,86,96,47.25
TwistedFate,Vex,107,40,67,37.38
TwistedFate,Yasuo,397,175,222,44.08
TwistedFate,Trundle,136,48,88,35.29
TwistedFate,Ezreal,397,202,195,50.88
TwistedFate,Ambessa,102,62,40,60.78
TwistedFate,AurelionSol,99,47,52,47.47
TwistedFate,Udyr,90,56,34,62.22
TwistedFate,Leblanc,95,35,60,36.84
TwistedFate,Renekton,118,86,32,72.88
TwistedFate,Kled,40,16,24,40
TwistedFate,Ryze,57,34,23,59.65
TwistedFate,Diana,309,148,161,47.9
TwistedFate,Fizz,157,58,99,36.94
TwistedFate,Varus,190,91,99,47.89
TwistedFate,Khazix,129,63,66,48.84
TwistedFate,Naafiri,98,36,62,36.73
TwistedFate,Quinn,69,28,41,40.58
TwistedFate,Blitzcrank,181,77,104,42.54
TwistedFate,Volibear,203,106,97,52.22
TwistedFate,Graves,128,66,62,51.56
TwistedFate,Seraphine,196,86,110,43.88
TwistedFate,Briar,163,71,92,43.56
TwistedFate,Nocturne,202,86,116,42.57
TwistedFate,Talon,135,70,65,51.85
TwistedFate,Akshan,97,34,63,35.05
TwistedFate,Nasus,173,64,109,36.99
TwistedFate,Karma,182,59,123,32.42
TwistedFate,Sion,170,79,91,46.47
TwistedFate,Annie,98,53,45,54.08
TwistedFate,Zeri,86,31,55,36.05
TwistedFate,Hwei,142,75,67,52.82
TwistedFate,Azir,96,33,63,34.38
TwistedFate,Ornn,45,28,17,62.22
TwistedFate,RekSai,36,17,19,47.22
TwistedFate,Rakan,142,58,84,40.85
TwistedFate,Chogath,293,146,147,49.83
TwistedFate,Vayne,216,104,112,48.15
TwistedFate,Smolder,163,78,85,47.85
TwistedFate,Olaf,29,12,17,41.38
TwistedFate,Riven,94,53,41,56.38
TwistedFate,Sejuani,78,29,49,37.18
TwistedFate,Nilah,115,60,55,52.17
TwistedFate,Neeko,149,75,74,50.34
TwistedFate,KSante,83,49,34,59.04
TwistedFate,Tryndamere,117,55,62,47.01
TwistedFate,Warwick,289,123,166,42.56
TwistedFate,Lucian,145,67,78,46.21
TwistedFate,Urgot,102,38,64,37.25
TwistedFate,Skarner,63,35,28,55.56
TwistedFate,Aphelios,196,89,107,45.41
TwistedFate,Malphite,174,69,105,39.66
TwistedFate,Zac,78,20,58,25.64
TwistedFate,Shyvana,51,18,33,35.29
TwistedFate,Senna,171,94,77,54.97
TwistedFate,Anivia,54,36,18,66.67
TwistedFate,Fiora,109,79,30,72.48
TwistedFate,Heimerdinger,118,54,64,45.76
TwistedFate,Jayce,125,67,58,53.6
TwistedFate,Kalista,81,38,43,46.91
TwistedFate,Belveth,65,29,36,44.62
TwistedFate,Cassiopeia,81,52,29,64.2
TwistedFate,Braum,149,74,75,49.66
TwistedFate,Nidalee,77,28,49,36.36
TwistedFate,JarvanIV,74,43,31,58.11
TwistedFate,Singed,43,11,32,25.58
TwistedFate,Rumble,45,26,19,57.78
TwistedFate,Ivern,50,11,39,22
TwistedFate,Sivir,115,55,60,47.83
TwistedFate,Shen,101,50,51,49.5
TwistedFate,Xerath,149,29,120,19.46
TwistedFate,Gnar,104,56,48,53.85
TwistedFate,Qiyana,70,32,38,45.71
TwistedFate,Janna,50,32,18,64
TwistedFate,Ziggs,87,43,44,49.43
TwistedFate,Lissandra,59,23,36,38.98
TwistedFate,Taliyah,48,22,26,45.83
TwistedFate,KogMaw,74,35,39,47.3
TwistedFate,Evelynn,80,29,51,36.25
TwistedFate,Zilean,39,20,19,51.28
Leona,DrMundo,333,166,167,49.85
Leona,Lillia,276,149,127,53.99
Leona,Viktor,320,160,160,50
Leona,Jhin,817,457,360,55.94
Leona,Pyke,581,311,270,53.53
Leona,Yone,732,396,336,54.1
Leona,Shaco,384,153,231,39.84
Leona,AurelionSol,225,87,138,38.67
Leona,Ashe,804,412,392,51.24
Leona,Velkoz,247,127,120,51.42
Leona,Swain,515,243,272,47.18
Leona,FiddleSticks,259,124,135,47.88
Leona,Akali,500,227,273,45.4
Leona,Twitch,403,202,201,50.12
Leona,Senna,481,268,213,55.72
Leona,Chogath,717,337,380,47
Leona,Talon,286,152,134,53.15
Leona,Qiyana,180,105,75,58.33
Leona,Mel,1150,680,470,59.13
Leona,Seraphine,535,296,239,55.33
Leona,Aatrox,486,253,233,52.06
Leona,Veigar,565,283,282,50.09
Leona,Ezreal,931,500,431,53.71
Leona,Milio,261,160,101,61.3
Leona,Jax,347,217,130,62.54
Leona,Heimerdinger,254,119,135,46.85
Leona,Soraka,328,159,169,48.48
Leona,Sett,866,429,437,49.54
Leona,Karthus,83,25,58,30.12
Leona,Zed,361,212,149,58.73
Leona,Maokai,210,119,91,56.67
Leona,Samira,437,265,172,60.64
Leona,Kayn,803,461,342,57.41
Leona,Lucian,225,118,107,52.44
Leona,Thresh,610,255,355,41.8
Leona,Garen,716,393,323,54.89
Leona,Graves,310,124,186,40
Leona,Aurora,467,246,221,52.68
Leona,Nilah,302,145,157,48.01
Leona,Hwei,366,184,182,50.27
Leona,Katarina,369,231,138,62.6
Leona,Gnar,209,121,88,57.89
Leona,XinZhao,292,135,157,46.23
Leona,Yasuo,817,493,324,60.34
Leona,Zeri,298,147,151,49.33
Leona,Taric,93,28,65,30.11
Leona,Nasus,443,170,273,38.37
Leona,Galio,366,172,194,46.99
Leona,Smolder,402,191,211,47.51
Leona,JarvanIV,209,124,85,59.33
Leona,Mordekaiser,746,316,430,42.36
Leona,Viego,518,288,230,55.6
Leona,Irelia,439,259,180,59
Leona,Kaisa,681,346,335,50.81
Leona,Udyr,153,84,69,54.9
Leona,Volibear,496,271,225,54.64
Leona,Rengar,173,110,63,63.58
Leona,Vayne,529,290,239,54.82
Leona,Blitzcrank,500,270,230,54
Leona,KSante,148,68,80,45.95
Leona,Zac,147,86,61,58.5
Leona,Azir,220,95,125,43.18
Leona,Ambessa,306,157,149,51.31
Leona,MissFortune,1023,485,538,47.41
Leona,Nautilus,599,301,298,50.25
Leona,Warwick,796,373,423,46.86
Leona,Tryndamere,228,130,98,57.02
Leona,LeeSin,351,207,144,58.97
Leona,Ekko,428,255,173,59.58
Leona,Sion,342,175,167,51.17
Leona,Pantheon,752,437,315,58.11
Leona,Ziggs,114,45,69,39.47
Leona,Lulu,342,182,160,53.22
Leona,Hecarim,132,78,54,59.09
Leona,Yorick,388,179,209,46.13
Leona,Kalista,208,108,100,51.92
Leona,Renekton,202,112,90,55.45
Leona,Sejuani,156,73,83,46.79
Leona,Taliyah,196,87,109,44.39
Leona,Kled,93,48,45,51.61
Leona,Shen,258,125,133,48.45
Leona,Leblanc,237,154,83,64.98
Leona,Yuumi,452,265,187,58.63
Leona,Teemo,612,303,309,49.51
Leona,Gragas,265,119,146,44.91
Leona,Diana,648,341,307,52.62
Leona,Caitlyn,1008,504,504,50
Leona,TwistedFate,158,96,62,60.76
Leona,MonkeyKing,195,115,80,58.97
Leona,Briar,557,270,287,48.47
Leona,TahmKench,501,281,220,56.09
Leona,Evelynn,228,138,90,60.53
Leona,Varus,349,172,177,49.28
Leona,Nami,408,208,200,50.98
Leona,Kindred,223,130,93,58.3
Leona,Vladimir,222,99,123,44.59
Leona,Nocturne,412,198,214,48.06
Leona,Karma,324,184,140,56.79
Leona,Rakan,187,105,82,56.15
Leona,Lux,1138,606,532,53.25
Leona,Syndra,287,172,115,59.93
Leona,Zyra,338,173,165,51.18
Leona,Rell,365,187,178,51.23
Leona,Vi,411,178,233,43.31
Leona,Gwen,346,175,171,50.58
Leona,Kayle,324,200,124,61.73
Leona,Darius,780,429,351,55
Leona,Rammus,166,108,58,65.06
Leona,Illaoi,214,101,113,47.2
Leona,Nunu,374,179,195,47.86
Leona,Amumu,423,145,278,34.28
Leona,Jinx,895,444,451,49.61
Leona,Morgana,609,281,328,46.14
Leona,Draven,221,130,91,58.82
Leona,Malzahar,329,131,198,39.82
Leona,Tristana,444,258,186,58.11
Leona,Poppy,366,163,203,44.54
Leona,Orianna,194,102,92,52.58
Leona,Aphelios,302,158,144,52.32
Leona,Brand,257,147,110,57.2
Leona,Kennen,162,79,83,48.77
Leona,Neeko,257,118,139,45.91
Leona,MasterYi,487,285,202,58.52
Leona,Zoe,208,135,73,64.9
Leona,Fiora,159,108,51,67.92
Leona,Ahri,529,261,268,49.34
Leona,Xerath,276,150,126,54.35
Leona,Malphite,490,260,230,53.06
Leona,Anivia,141,58,83,41.13
Leona,Alistar,152,73,79,48.03
Leona,Gangplank,180,64,116,35.56
Leona,Belveth,144,76,68,52.78
Leona,Sona,185,104,81,56.22
Leona,Urgot,189,101,88,53.44
Leona,Janna,182,133,49,73.08
Leona,Ryze,114,56,58,49.12
Leona,Riven,138,85,53,61.59
Leona,Elise,255,130,125,50.98
Leona,Sylas,527,258,269,48.96
Leona,Khazix,244,156,88,63.93
Leona,Sivir,235,115,120,48.94
Leona,Shyvana,114,71,43,62.28
Leona,Zilean,159,93,66,58.49
Leona,Skarner,140,71,69,50.71
Leona,Vex,311,167,144,53.7
Leona,Quinn,147,73,74,49.66
Leona,Trundle,249,107,142,42.97
Leona,Cassiopeia,198,131,67,66.16
Leona,Singed,113,51,62,45.13
Leona,Lissandra,140,71,69,50.71
Leona,Naafiri,175,94,81,53.71
Leona,Ornn,203,107,96,52.71
Leona,Rumble,88,46,42,52.27
Leona,Fizz,194,99,95,51.03
Leona,Xayah,244,127,117,52.05
Leona,KogMaw,148,62,86,41.89
Leona,Renata,94,32,62,34.04
Leona,Akshan,162,93,69,57.41
Leona,Olaf,76,37,39,48.68
Leona,RekSai,102,59,43,57.84
Leona,Braum,166,65,101,39.16
Leona,Jayce,151,88,63,58.28
Leona,Kassadin,101,63,38,62.38
Leona,Camille,148,99,49,66.89
Leona,Ivern,89,17,72,19.1
Leona,Corki,168,88,80,52.38
Leona,Annie,110,66,44,60
Leona,Bard,141,49,92,34.75
Leona,Nidalee,81,44,37,54.32
Azir,MonkeyKing,132,34,98,25.76
Azir,Kayn,264,87,177,32.95
Azir,Yasuo,460,247,213,53.7
Azir,Kaisa,323,156,167,48.3
Azir,Milio,115,65,50,56.52
Azir,KSante,70,47,23,67.14
Azir,Warwick,369,160,209,43.36
Azir,Diana,258,149,109,57.75
Azir,Ashe,417,176,241,42.21
Azir,Corki,92,47,45,51.09
Azir,Sett,411,195,216,47.45
Azir,Volibear,283,155,128,54.77
Azir,Ambessa,188,91,97,48.4
Azir,Smolder,172,84,88,48.84
Azir,Swain,222,98,124,44.14
Azir,Riven,73,42,31,57.53
Azir,Syndra,135,53,82,39.26
Azir,Jinx,398,188,210,47.24
Azir,Pyke,269,139,130,51.67
Azir,Illaoi,99,34,65,34.34
Azir,Caitlyn,587,294,293,50.09
Azir,Velkoz,118,52,66,44.07
Azir,Nocturne,201,85,116,42.29
Azir,Xerath,208,88,120,42.31
Azir,Ezreal,402,218,184,54.23
Azir,Blitzcrank,192,78,114,40.63
Azir,Aatrox,182,83,99,45.6
Azir,Cassiopeia,127,72,55,56.69
Azir,Varus,184,103,81,55.98
Azir,Morgana,316,96,220,30.38
Azir,Chogath,345,154,191,44.64
Azir,Poppy,168,66,102,39.29
Azir,Irelia,187,99,88,52.94
Azir,Jhin,360,154,206,42.78
Azir,Leona,220,125,95,56.82
Azir,Shaco,214,116,98,54.21
Azir,Akali,210,121,89,57.62
Azir,Sivir,118,54,64,45.76
Azir,Renata,83,43,40,51.81
Azir,Nunu,200,101,99,50.5
Azir,Yone,408,225,183,55.15
Azir,Malzahar,194,89,105,45.88
Azir,Khazix,139,71,68,51.08
Azir,Nasus,158,62,96,39.24
Azir,Maokai,103,50,53,48.54
Azir,Elise,121,60,61,49.59
Azir,Vex,187,86,101,45.99
Azir,Lucian,166,80,86,48.19
Azir,Senna,238,125,113,52.52
Azir,Malphite,168,67,101,39.88
Azir,Xayah,165,93,72,56.36
Azir,Rakan,124,78,46,62.9
Azir,Garen,345,158,187,45.8
Azir,Lux,597,235,362,39.36
Azir,Ryze,90,31,59,34.44
Azir,Pantheon,440,215,225,48.86
Azir,Darius,405,192,213,47.41
Azir,Mordekaiser,334,125,209,37.43
Azir,Evelynn,89,40,49,44.94
Azir,Aurora,305,141,164,46.23
Azir,Naafiri,103,49,54,47.57
Azir,MasterYi,226,96,130,42.48
Azir,Twitch,131,64,67,48.85
Azir,Teemo,270,127,143,47.04
Azir,Vayne,208,106,102,50.96
Azir,Ahri,272,136,136,50
Azir,Katarina,253,147,106,58.1
Azir,Yuumi,231,74,157,32.03
Azir,Gnar,123,63,60,51.22
Azir,Annie,74,32,42,43.24
Azir,Tristana,251,120,131,47.81
Azir,Ekko,205,107,98,52.2
Azir,Lillia,154,64,90,41.56
Azir,Draven,114,56,58,49.12
Azir,Lulu,167,94,73,56.29
Azir,Leblanc,100,51,49,51
Azir,Jax,211,101,110,47.87
Azir,Trundle,150,80,70,53.33
Azir,Soraka,102,38,64,37.25
Azir,TahmKench,225,79,146,35.11
Azir,Udyr,87,53,34,60.92
Azir,Orianna,118,66,52,55.93
Azir,Mel,568,315,253,55.46
Azir,Veigar,232,113,119,48.71
Azir,Braum,118,58,60,49.15
Azir,Rengar,138,80,58,57.97
Azir,Yorick,138,75,63,54.35
Azir,Kindred,134,76,58,56.72
Azir,Vladimir,111,53,58,47.75
Azir,Brand,143,59,84,41.26
Azir,FiddleSticks,127,47,80,37.01
Azir,Shen,184,107,77,58.15
Azir,Skarner,81,26,55,32.1
Azir,Samira,221,111,110,50.23
Azir,Qiyana,105,41,64,39.05
Azir,Zyra,122,84,38,68.85
Azir,Viego,292,106,186,36.3
Azir,Nilah,116,69,47,59.48
Azir,Sona,61,31,30,50.82
Azir,Zac,87,60,27,68.97
Azir,Galio,154,88,66,57.14
Azir,Fiora,80,33,47,41.25
Azir,Lissandra,75,41,34,54.67
Azir,Thresh,315,212,103,67.3
Azir,MissFortune,446,195,251,43.72
Azir,Sion,180,76,104,42.22
Azir,Zed,243,106,137,43.62
Azir,Taric,61,24,37,39.34
Azir,Amumu,175,87,88,49.71
Azir,Zoe,124,59,65,47.58
Azir,Zeri,127,43,84,33.86
Azir,Gragas,157,84,73,53.5
Azir,Sylas,197,97,100,49.24
Azir,Taliyah,52,31,21,59.62
Azir,Karma,102,52,50,50.98
Azir,Aphelios,136,61,75,44.85
Azir,Seraphine,211,87,124,41.23
Azir,Alistar,90,53,37,58.89
Azir,Briar,209,93,116,44.5
Azir,Nautilus,257,143,114,55.64
Azir,Gwen,141,69,72,48.94
Azir,Gangplank,120,65,55,54.17
Azir,Kayle,156,58,98,37.18
Azir,Heimerdinger,109,36,73,33.03
Azir,Ziggs,43,23,20,53.49
Azir,Talon,104,53,51,50.96
Azir,Kennen,54,15,39,27.78
Azir,Quinn,80,50,30,62.5
Azir,DrMundo,113,61,52,53.98
Azir,Viktor,121,51,70,42.15
Azir,Janna,56,25,31,44.64
Azir,Fizz,66,27,39,40.91
Azir,Neeko,162,78,84,48.15
Azir,XinZhao,138,74,64,53.62
Azir,TwistedFate,96,63,33,65.63
Azir,Vi,176,69,107,39.2
Azir,Graves,92,43,49,46.74
Azir,KogMaw,52,19,33,36.54
Azir,Rell,119,47,72,39.5
Azir,Olaf,32,19,13,59.38
Azir,Tryndamere,122,79,43,64.75
Azir,Bard,52,22,30,42.31
Azir,Belveth,50,47,3,94
Azir,Shyvana,47,11,36,23.4
Azir,Ornn,103,55,48,53.4
Azir,LeeSin,269,122,147,45.35
Azir,Anivia,74,47,27,63.51
Azir,Singed,45,12,33,26.67
Azir,Karthus,41,24,17,58.54
Azir,AurelionSol,76,20,56,26.32
Azir,Zilean,60,40,20,66.67
Azir,JarvanIV,88,48,40,54.55
Azir,Hecarim,62,25,37,40.32
Azir,Akshan,75,34,41,45.33
Azir,Camille,68,43,25,63.24
Azir,Hwei,180,89,91,49.44
Azir,Ivern,42,26,16,61.9
Azir,Kalista,114,47,67,41.23
Azir,Jayce,106,53,53,50
Azir,Urgot,126,70,56,55.56
Azir,Rumble,37,16,21,43.24
Azir,Nami,132,67,65,50.76
Azir,Sejuani,78,56,22,71.79
Azir,Renekton,72,25,47,34.72
Azir,RekSai,51,28,23,54.9
Azir,Nidalee,54,42,12,77.78
Azir,Rammus,52,21,31,40.38
Azir,Kled,51,15,36,29.41
Azir,Kassadin,21,15,6,71.43
MissFortune,MonkeyKing,714,356,358,49.86
MissFortune,Kayn,2053,987,1066,48.08
MissFortune,Yasuo,2793,1392,1401,49.84
MissFortune,Kaisa,1857,991,866,53.37
MissFortune,Milio,645,315,330,48.84
MissFortune,Gangplank,491,267,224,54.38
MissFortune,Warwick,2343,1122,1221,47.89
MissFortune,Akali,1492,700,792,46.92
MissFortune,Caitlyn,3730,2018,1712,54.1
MissFortune,Sona,510,302,208,59.22
MissFortune,Aatrox,1297,742,555,57.21
MissFortune,Sejuani,538,283,255,52.6
MissFortune,Jinx,3131,1550,1581,49.5
MissFortune,Pyke,1488,775,713,52.08
MissFortune,Gnar,566,296,270,52.3
MissFortune,Jax,1031,541,490,52.47
MissFortune,Neeko,1135,658,477,57.97
MissFortune,Ornn,470,210,260,44.68
MissFortune,Udyr,475,254,221,53.47
MissFortune,Lux,4032,2043,1989,50.67
MissFortune,Ezreal,2261,1249,1012,55.24
MissFortune,Nidalee,323,187,136,57.89
MissFortune,Ahri,1817,946,871,52.06
MissFortune,Jhin,2407,1140,1267,47.36
MissFortune,Senna,1022,515,507,50.39
MissFortune,Urgot,650,309,341,47.54
MissFortune,Twitch,1249,665,584,53.24
MissFortune,Vladimir,741,362,379,48.85
MissFortune,Zac,505,238,267,47.13
MissFortune,Cassiopeia,553,309,244,55.88
MissFortune,Irelia,1160,597,563,51.47
MissFortune,Darius,2384,1312,1072,55.03
MissFortune,Volibear,1554,811,743,52.19
MissFortune,Chogath,1747,961,786,55.01
MissFortune,Brand,1064,513,551,48.21
MissFortune,Fiora,643,335,308,52.1
MissFortune,Yone,2620,1469,1151,56.07
MissFortune,Galio,819,373,446,45.54
MissFortune,KSante,388,208,180,53.61
MissFortune,Diana,1874,890,984,47.49
MissFortune,Ashe,2687,1426,1261,53.07
MissFortune,Corki,426,248,178,58.22
MissFortune,Shen,832,423,409,50.84
MissFortune,Samira,1303,586,717,44.97
MissFortune,Soraka,759,401,358,52.83
MissFortune,Sylas,1299,686,613,52.81
MissFortune,Amumu,1295,596,699,46.02
MissFortune,Vex,825,401,424,48.61
MissFortune,Rakan,760,429,331,56.45
MissFortune,Gwen,854,456,398,53.4
MissFortune,Thresh,1592,913,679,57.35
MissFortune,Yuumi,1247,616,631,49.4
MissFortune,Karma,890,471,419,52.92
MissFortune,Garen,1948,927,1021,47.59
MissFortune,FiddleSticks,622,290,332,46.62
MissFortune,Mordekaiser,2283,1129,1154,49.45
MissFortune,Lulu,899,419,480,46.61
MissFortune,Veigar,1495,744,751,49.77
MissFortune,Nasus,1147,621,526,54.14
MissFortune,Khazix,756,465,291,61.51
MissFortune,Aurora,1257,627,630,49.88
MissFortune,Viego,1534,738,796,48.11
MissFortune,Nocturne,1150,596,554,51.83
MissFortune,Jayce,412,229,183,55.58
MissFortune,Sett,2310,1177,1133,50.95
MissFortune,Shyvana,303,158,145,52.15
MissFortune,Fizz,776,426,350,54.9
MissFortune,Nilah,886,488,398,55.08
MissFortune,Nami,1191,594,597,49.87
MissFortune,LeeSin,1142,629,513,55.08
MissFortune,Evelynn,719,359,360,49.93
MissFortune,Belveth,370,203,167,54.86
MissFortune,Hwei,949,497,452,52.37
MissFortune,TahmKench,1501,759,742,50.57
MissFortune,Orianna,467,256,211,54.82
MissFortune,Nautilus,1405,731,674,52.03
MissFortune,Ivern,282,147,135,52.13
MissFortune,Swain,1322,613,709,46.37
MissFortune,Kayle,993,505,488,50.86
MissFortune,Katarina,1243,792,451,63.72
MissFortune,Gragas,793,473,320,59.65
MissFortune,Teemo,1978,930,1048,47.02
MissFortune,Morgana,1853,855,998,46.14
MissFortune,Briar,1285,587,698,45.68
MissFortune,RekSai,141,67,74,47.52
MissFortune,Braum,681,338,343,49.63
MissFortune,Varus,1006,484,522,48.11
MissFortune,Janna,363,204,159,56.2
MissFortune,Shaco,1111,567,544,51.04
MissFortune,Riven,485,302,183,62.27
MissFortune,Pantheon,2190,1150,1040,52.51
MissFortune,Zed,1144,601,543,52.53
MissFortune,MasterYi,1582,760,822,48.04
MissFortune,Trundle,820,364,456,44.39
MissFortune,Malzahar,944,434,510,45.97
MissFortune,Talon,756,410,346,54.23
MissFortune,DrMundo,811,322,489,39.7
MissFortune,Yorick,1171,509,662,43.47
MissFortune,Blitzcrank,956,508,448,53.14
MissFortune,Smolder,920,524,396,56.96
MissFortune,JarvanIV,404,219,185,54.21
MissFortune,Rengar,568,353,215,62.15
MissFortune,Vayne,1338,653,685,48.8
MissFortune,XinZhao,625,343,282,54.88
MissFortune,Leona,1023,538,485,52.59
MissFortune,Vi,1157,667,490,57.65
MissFortune,Anivia,414,207,207,50
MissFortune,Leblanc,501,256,245,51.1
MissFortune,Maokai,539,255,284,47.31
MissFortune,Mel,2772,1458,1314,52.6
MissFortune,Kalista,699,344,355,49.21
MissFortune,Kennen,487,332,155,68.17
MissFortune,Ekko,998,517,481,51.8
MissFortune,Graves,675,393,282,58.22
MissFortune,Zeri,595,286,309,48.07
MissFortune,Taric,268,153,115,57.09
MissFortune,Rumble,222,118,104,53.15
MissFortune,Akshan,477,218,259,45.7
MissFortune,Tryndamere,836,463,373,55.38
MissFortune,Malphite,1116,566,550,50.72
MissFortune,Zoe,510,294,216,57.65
MissFortune,Heimerdinger,933,463,470,49.62
MissFortune,Ambessa,661,333,328,50.38
MissFortune,Rammus,385,162,223,42.08
MissFortune,Seraphine,1618,862,756,53.28
MissFortune,Ziggs,593,282,311,47.55
MissFortune,Karthus,328,171,157,52.13
MissFortune,AurelionSol,738,298,440,40.38
MissFortune,Rell,679,395,284,58.17
MissFortune,Xayah,950,530,420,55.79
MissFortune,Lucian,664,387,277,58.28
MissFortune,Singed,292,121,171,41.44
MissFortune,Draven,781,353,428,45.2
MissFortune,Lillia,956,524,432,54.81
MissFortune,Illaoi,675,269,406,39.85
MissFortune,Hecarim,468,269,199,57.48
MissFortune,Tristana,1511,794,717,52.55
MissFortune,Aphelios,917,482,435,52.56
MissFortune,TwistedFate,449,217,232,48.33
MissFortune,Viktor,815,461,354,56.56
MissFortune,Olaf,287,171,116,59.58
MissFortune,Nunu,1171,572,599,48.85
MissFortune,Camille,364,210,154,57.69
MissFortune,Kled,289,164,125,56.75
MissFortune,Poppy,731,339,392,46.37
MissFortune,Skarner,360,221,139,61.39
MissFortune,Xerath,966,419,547,43.37
MissFortune,Elise,759,453,306,59.68
MissFortune,Quinn,527,277,250,52.56
MissFortune,Kassadin,227,90,137,39.65
MissFortune,Annie,313,188,125,60.06
MissFortune,Ryze,361,203,158,56.23
MissFortune,Zyra,825,352,473,42.67
MissFortune,Sivir,696,335,361,48.13
MissFortune,KogMaw,506,213,293,42.09
MissFortune,Sion,982,410,572,41.75
MissFortune,Naafiri,581,298,283,51.29
MissFortune,Velkoz,748,328,420,43.85
MissFortune,Zilean,329,191,138,58.05
MissFortune,Kindred,682,363,319,53.23
MissFortune,Syndra,662,377,285,56.95
MissFortune,Qiyana,447,263,184,58.84
MissFortune,Renekton,525,266,259,50.67
MissFortune,Bard,374,189,185,50.53
MissFortune,Alistar,410,215,195,52.44
MissFortune,Taliyah,316,166,150,52.53
MissFortune,Azir,446,251,195,56.28
MissFortune,Renata,340,194,146,57.06
MissFortune,Lissandra,296,150,146,50.68
Neeko,MonkeyKing,232,116,116,50
Neeko,Kayn,823,381,442,46.29
Neeko,Yasuo,898,379,519,42.2
Neeko,Kaisa,501,271,230,54.09
Neeko,Milio,229,124,105,54.15
Neeko,Irelia,441,229,212,51.93
Neeko,Zed,404,202,202,50
Neeko,Galio,308,107,201,34.74
Neeko,MissFortune,1135,477,658,42.03
Neeko,TahmKench,474,213,261,44.94
Neeko,Yone,926,470,456,50.76
Neeko,Shaco,348,180,168,51.72
Neeko,AurelionSol,225,88,137,39.11
Neeko,Ashe,793,368,425,46.41
Neeko,Velkoz,286,118,168,41.26
Neeko,Fiora,218,112,106,51.38
Neeko,MasterYi,541,293,248,54.16
Neeko,Mel,1037,443,594,42.72
Neeko,Jhin,865,415,450,47.98
Neeko,Karma,275,151,124,54.91
Neeko,Gwen,286,157,129,54.9
Neeko,JarvanIV,114,43,71,37.72
Neeko,Zyra,346,153,193,44.22
Neeko,Seraphine,634,304,330,47.95
Neeko,Garen,767,341,426,44.46
Neeko,Lux,1415,616,799,43.53
Neeko,Caitlyn,1208,580,628,48.01
Neeko,Thresh,592,303,289,51.18
Neeko,Riven,193,103,90,53.37
Neeko,Amumu,476,223,253,46.85
Neeko,Zoe,218,106,112,48.62
Neeko,Sona,199,58,141,29.15
Neeko,Akali,464,220,244,47.41
Neeko,Rammus,118,54,64,45.76
Neeko,Jinx,952,455,497,47.79
Neeko,Mordekaiser,744,395,349,53.09
Neeko,Diana,595,266,329,44.71
Neeko,Ahri,712,370,342,51.97
Neeko,Twitch,311,140,171,45.02
Neeko,Lulu,270,158,112,58.52
Neeko,Gnar,165,83,82,50.3
Neeko,Leblanc,188,86,102,45.74
Neeko,Pyke,534,313,221,58.61
Neeko,Varus,443,220,223,49.66
Neeko,Chogath,575,260,315,45.22
Neeko,Poppy,284,125,159,44.01
Neeko,Illaoi,248,130,118,52.42
Neeko,Khazix,335,166,169,49.55
Neeko,Syndra,225,69,156,30.67
Neeko,Udyr,155,58,97,37.42
Neeko,Yorick,445,155,290,34.83
Neeko,Jax,376,204,172,54.26
Neeko,Naafiri,206,114,92,55.34
Neeko,Tristana,365,192,173,52.6
Neeko,Rakan,242,108,134,44.63
Neeko,Karthus,101,49,52,48.51
Neeko,Nilah,224,117,107,52.23
Neeko,Braum,179,73,106,40.78
Neeko,Sion,400,159,241,39.75
Neeko,FiddleSticks,177,88,89,49.72
Neeko,Ezreal,693,419,274,60.46
Neeko,Zilean,121,58,63,47.93
Neeko,Trundle,241,111,130,46.06
Neeko,Nocturne,466,230,236,49.36
Neeko,Orianna,222,107,115,48.2
Neeko,Veigar,537,275,262,51.21
Neeko,Brand,398,188,210,47.24
Neeko,Cassiopeia,220,97,123,44.09
Neeko,Pantheon,861,437,424,50.75
Neeko,Swain,550,209,341,38
Neeko,Gragas,286,143,143,50
Neeko,LeeSin,373,179,194,47.99
Neeko,Kayle,310,129,181,41.61
Neeko,Morgana,725,334,391,46.07
Neeko,Sejuani,166,75,91,45.18
Neeko,Smolder,290,118,172,40.69
Neeko,Rengar,193,114,79,59.07
Neeko,Hwei,363,175,188,48.21
Neeko,Singed,85,33,52,38.82
Neeko,Yuumi,368,195,173,52.99
Neeko,Blitzcrank,333,229,104,68.77
Neeko,Warwick,758,368,390,48.55
Neeko,Briar,439,213,226,48.52
Neeko,Senna,412,210,202,50.97
Neeko,Urgot,285,106,179,37.19
Neeko,Annie,134,64,70,47.76
Neeko,Graves,311,140,171,45.02
Neeko,Zeri,248,104,144,41.94
Neeko,Taric,118,36,82,30.51
Neeko,DrMundo,265,120,145,45.28
Neeko,Samira,486,212,274,43.62
Neeko,Kennen,213,105,108,49.3
Neeko,Katarina,377,223,154,59.15
Neeko,Soraka,273,160,113,58.61
Neeko,Ambessa,232,135,97,58.19
Neeko,Darius,755,337,418,44.64
Neeko,Viego,531,240,291,45.2
Neeko,Sylas,423,204,219,48.23
Neeko,Nami,414,214,200,51.69
Neeko,Aphelios,333,128,205,38.44
Neeko,Lissandra,102,46,56,45.1
Neeko,Vladimir,228,126,102,55.26
Neeko,Corki,102,65,37,63.73
Neeko,Ziggs,200,79,121,39.5
Neeko,Aatrox,464,250,214,53.88
Neeko,Xayah,341,124,217,36.36
Neeko,Skarner,136,98,38,72.06
Neeko,Xerath,284,125,159,44.01
Neeko,Zac,163,70,93,42.94
Neeko,Renekton,198,90,108,45.45
Neeko,Sett,742,299,443,40.3
Neeko,KogMaw,186,64,122,34.41
Neeko,Janna,144,66,78,45.83
Neeko,Talon,306,150,156,49.02
Neeko,Lillia,290,149,141,51.38
Neeko,Hecarim,180,105,75,58.33
Neeko,Malzahar,338,176,162,52.07
Neeko,Fizz,218,102,116,46.79
Neeko,Kalista,226,138,88,61.06
Neeko,Vi,393,170,223,43.26
Neeko,Teemo,667,285,382,42.73
Neeko,Aurora,466,211,255,45.28
Neeko,Rell,208,77,131,37.02
Neeko,Nasus,445,208,237,46.74
Neeko,Draven,236,117,119,49.58
Neeko,Renata,132,44,88,33.33
Neeko,Lucian,257,137,120,53.31
Neeko,Vex,282,153,129,54.26
Neeko,Ryze,88,50,38,56.82
Neeko,Olaf,125,60,65,48
Neeko,Vayne,437,183,254,41.88
Neeko,Ekko,316,140,176,44.3
Neeko,Nunu,394,170,224,43.15
Neeko,Evelynn,270,119,151,44.07
Neeko,Malphite,325,170,155,52.31
Neeko,Alistar,150,51,99,34
Neeko,Camille,148,99,49,66.89
Neeko,Leona,257,139,118,54.09
Neeko,Shen,241,97,144,40.25
Neeko,Nautilus,509,212,297,41.65
Neeko,Sivir,222,118,104,53.15
Neeko,Nidalee,97,61,36,62.89
Neeko,Kassadin,97,34,63,35.05
Neeko,Maokai,250,137,113,54.8
Neeko,Volibear,542,243,299,44.83
Neeko,Taliyah,108,47,61,43.52
Neeko,Elise,300,139,161,46.33
Neeko,Bard,124,91,33,73.39
Neeko,Heimerdinger,289,109,180,37.72
Neeko,Viktor,306,147,159,48.04
Neeko,Jayce,173,81,92,46.82
Neeko,Gangplank,186,105,81,56.45
Neeko,Akshan,183,62,121,33.88
Neeko,Ivern,71,29,42,40.85
Neeko,Quinn,186,74,112,39.78
Neeko,Azir,162,84,78,51.85
Neeko,Anivia,124,49,75,39.52
Neeko,Tryndamere,267,105,162,39.33
Neeko,Kindred,241,138,103,57.26
Neeko,Qiyana,116,70,46,60.34
Neeko,TwistedFate,149,74,75,49.66
Neeko,XinZhao,305,143,162,46.89
Neeko,RekSai,60,31,29,51.67
Neeko,Kled,72,44,28,61.11
Neeko,KSante,125,60,65,48
Neeko,Shyvana,153,69,84,45.1
Neeko,Ornn,154,77,77,50
Neeko,Belveth,116,43,73,37.07
Neeko,Rumble,55,17,38,30.91
FiddleSticks,Gangplank,139,91,48,65.47
FiddleSticks,MasterYi,322,184,138,57.14
FiddleSticks,Veigar,327,179,148,54.74
FiddleSticks,Mel,720,327,393,45.42
FiddleSticks,Swain,363,157,206,43.25
FiddleSticks,Samira,326,183,143,56.13
FiddleSticks,Kayn,519,283,236,54.53
FiddleSticks,Sylas,413,198,215,47.94
FiddleSticks,Nilah,200,111,89,55.5
FiddleSticks,Leona,259,135,124,52.12
FiddleSticks,Pantheon,604,294,310,48.68
FiddleSticks,Leblanc,136,67,69,49.26
FiddleSticks,Sivir,148,91,57,61.49
FiddleSticks,Pyke,388,197,191,50.77
FiddleSticks,Yorick,257,124,133,48.25
FiddleSticks,Viego,326,176,150,53.99
FiddleSticks,Malphite,278,151,127,54.32
FiddleSticks,Kaisa,480,268,212,55.83
FiddleSticks,Rell,182,96,86,52.75
FiddleSticks,Karthus,104,58,46,55.77
FiddleSticks,Aurora,370,231,139,62.43
FiddleSticks,Ezreal,488,276,212,56.56
FiddleSticks,Senna,306,144,162,47.06
FiddleSticks,DrMundo,204,80,124,39.22
FiddleSticks,Ivern,78,28,50,35.9
FiddleSticks,Mordekaiser,513,217,296,42.3
FiddleSticks,Yuumi,355,185,170,52.11
FiddleSticks,Aatrox,321,163,158,50.78
FiddleSticks,Khazix,208,87,121,41.83
FiddleSticks,Qiyana,100,51,49,51
FiddleSticks,MissFortune,622,332,290,53.38
FiddleSticks,Nautilus,402,193,209,48.01
FiddleSticks,Darius,452,215,237,47.57
FiddleSticks,Poppy,216,140,76,64.81
FiddleSticks,Kindred,206,81,125,39.32
FiddleSticks,Warwick,482,247,235,51.24
FiddleSticks,Aphelios,236,107,129,45.34
FiddleSticks,KSante,93,61,32,65.59
FiddleSticks,Vex,218,126,92,57.8
FiddleSticks,Jinx,618,274,344,44.34
FiddleSticks,Tryndamere,179,92,87,51.4
FiddleSticks,Amumu,311,132,179,42.44
FiddleSticks,Seraphine,368,213,155,57.88
FiddleSticks,Udyr,131,63,68,48.09
FiddleSticks,Jhin,578,298,280,51.56
FiddleSticks,Evelynn,179,99,80,55.31
FiddleSticks,XinZhao,149,84,65,56.38
FiddleSticks,Morgana,443,214,229,48.31
FiddleSticks,Ashe,479,255,224,53.24
FiddleSticks,Braum,158,103,55,65.19
FiddleSticks,Riven,202,110,92,54.46
FiddleSticks,Sejuani,137,54,83,39.42
FiddleSticks,AurelionSol,124,52,72,41.94
FiddleSticks,Tristana,324,144,180,44.44
FiddleSticks,Rakan,152,82,70,53.95
FiddleSticks,Jax,252,131,121,51.98
FiddleSticks,Naafiri,156,74,82,47.44
FiddleSticks,Irelia,243,134,109,55.14
FiddleSticks,Neeko,177,89,88,50.28
FiddleSticks,Yone,618,355,263,57.44
FiddleSticks,Nocturne,248,119,129,47.98
FiddleSticks,Lucian,176,84,92,47.73
FiddleSticks,Yasuo,567,279,288,49.21
FiddleSticks,Nami,266,153,113,57.52
FiddleSticks,Renekton,105,61,44,58.1
FiddleSticks,Malzahar,261,104,157,39.85
FiddleSticks,Lux,903,435,468,48.17
FiddleSticks,Quinn,111,51,60,45.95
FiddleSticks,Cassiopeia,92,29,63,31.52
FiddleSticks,Varus,221,106,115,47.96
FiddleSticks,Janna,132,75,57,56.82
FiddleSticks,Rengar,141,101,40,71.63
FiddleSticks,Anivia,103,71,32,68.93
FiddleSticks,Xayah,237,123,114,51.9
FiddleSticks,Galio,188,87,101,46.28
FiddleSticks,Ekko,295,184,111,62.37
FiddleSticks,Zed,279,188,91,67.38
FiddleSticks,Caitlyn,797,402,395,50.44
FiddleSticks,Lulu,244,125,119,51.23
FiddleSticks,Akali,284,169,115,59.51
FiddleSticks,Ziggs,117,49,68,41.88
FiddleSticks,Volibear,337,164,173,48.66
FiddleSticks,Hwei,265,161,104,60.75
FiddleSticks,Urgot,152,71,81,46.71
FiddleSticks,Twitch,262,105,157,40.08
FiddleSticks,Teemo,480,234,246,48.75
FiddleSticks,Singed,90,43,47,47.78
FiddleSticks,Zeri,130,50,80,38.46
FiddleSticks,TwistedFate,91,38,53,41.76
FiddleSticks,Brand,179,84,95,46.93
FiddleSticks,Vladimir,180,112,68,62.22
FiddleSticks,Vi,241,104,137,43.15
FiddleSticks,Ahri,437,220,217,50.34
FiddleSticks,Milio,187,76,111,40.64
FiddleSticks,Chogath,399,187,212,46.87
FiddleSticks,TahmKench,326,167,159,51.23
FiddleSticks,Gwen,193,112,81,58.03
FiddleSticks,Elise,194,68,126,35.05
FiddleSticks,Kennen,117,58,59,49.57
FiddleSticks,Shaco,288,169,119,58.68
FiddleSticks,Hecarim,156,71,85,45.51
FiddleSticks,Garen,395,199,196,50.38
FiddleSticks,Ryze,88,34,54,38.64
FiddleSticks,Blitzcrank,247,107,140,43.32
FiddleSticks,Rammus,86,48,38,55.81
FiddleSticks,Velkoz,177,90,87,50.85
FiddleSticks,Sett,586,298,288,50.85
FiddleSticks,Karma,221,134,87,60.63
FiddleSticks,Shen,186,102,84,54.84
FiddleSticks,LeeSin,321,191,130,59.5
FiddleSticks,Syndra,169,68,101,40.24
FiddleSticks,Zyra,188,82,106,43.62
FiddleSticks,Maokai,112,52,60,46.43
FiddleSticks,Gragas,178,109,69,61.24
FiddleSticks,Thresh,364,201,163,55.22
FiddleSticks,Katarina,201,67,134,33.33
FiddleSticks,Nasus,284,136,148,47.89
FiddleSticks,Xerath,136,55,81,40.44
FiddleSticks,Graves,153,89,64,58.17
FiddleSticks,Illaoi,203,117,86,57.64
FiddleSticks,Vayne,331,158,173,47.73
FiddleSticks,Trundle,202,118,84,58.42
FiddleSticks,Camille,119,48,71,40.34
FiddleSticks,Azir,127,80,47,62.99
FiddleSticks,Kalista,127,70,57,55.12
FiddleSticks,Lillia,237,124,113,52.32
FiddleSticks,Nunu,282,166,116,58.87
FiddleSticks,Sona,118,50,68,42.37
FiddleSticks,Taric,84,35,49,41.67
FiddleSticks,Viktor,198,81,117,40.91
FiddleSticks,Nidalee,101,63,38,62.38
FiddleSticks,Soraka,181,91,90,50.28
FiddleSticks,Diana,405,192,213,47.41
FiddleSticks,Zac,169,85,84,50.3
FiddleSticks,Corki,109,56,53,51.38
FiddleSticks,Heimerdinger,183,91,92,49.73
FiddleSticks,Akshan,121,72,49,59.5
FiddleSticks,Taliyah,104,35,69,33.65
FiddleSticks,Kayle,244,133,111,54.51
FiddleSticks,Orianna,120,67,53,55.83
FiddleSticks,Briar,338,158,180,46.75
FiddleSticks,Ambessa,225,105,120,46.67
FiddleSticks,MonkeyKing,189,92,97,48.68
FiddleSticks,Shyvana,64,41,23,64.06
FiddleSticks,Alistar,64,29,35,45.31
FiddleSticks,Smolder,271,158,113,58.3
FiddleSticks,Gnar,142,73,69,51.41
FiddleSticks,Renata,87,62,25,71.26
FiddleSticks,KogMaw,151,85,66,56.29
FiddleSticks,Ornn,110,49,61,44.55
FiddleSticks,Talon,233,139,94,59.66
FiddleSticks,Fiora,141,63,78,44.68
FiddleSticks,Kassadin,67,24,43,35.82
FiddleSticks,Draven,154,88,66,57.14
FiddleSticks,Jayce,128,69,59,53.91
FiddleSticks,Lissandra,60,17,43,28.33
FiddleSticks,Zoe,114,59,55,51.75
FiddleSticks,Olaf,68,22,46,32.35
FiddleSticks,Sion,233,139,94,59.66
FiddleSticks,Bard,123,57,66,46.34
FiddleSticks,JarvanIV,100,48,52,48
FiddleSticks,Fizz,161,83,78,51.55
FiddleSticks,Skarner,103,33,70,32.04
FiddleSticks,Zilean,62,25,37,40.32
FiddleSticks,Kled,57,37,20,64.91
FiddleSticks,Belveth,110,59,51,53.64
FiddleSticks,Annie,113,60,53,53.1
FiddleSticks,Rumble,73,40,33,54.79
FiddleSticks,RekSai,32,22,10,68.75
Smolder,Gangplank,192,74,118,38.54
Smolder,MasterYi,499,193,306,38.68
Smolder,Veigar,545,237,308,43.49
Smolder,Mel,1011,500,511,49.46
Smolder,Swain,517,225,292,43.52
Smolder,Mordekaiser,750,310,440,41.33
Smolder,Amumu,434,179,255,41.24
Smolder,Sylas,483,235,248,48.65
Smolder,Xayah,261,141,120,54.02
Smolder,Ashe,756,350,406,46.3
Smolder,Renekton,264,116,148,43.94
Smolder,Kayn,730,352,378,48.22
Smolder,Vex,245,139,106,56.73
Smolder,Samira,506,278,228,54.94
Smolder,Lulu,392,176,216,44.9
Smolder,Teemo,683,305,378,44.66
Smolder,Briar,418,196,222,46.89
Smolder,Aurora,406,177,229,43.6
Smolder,Kaisa,686,351,335,51.17
Smolder,Karma,340,129,211,37.94
Smolder,KSante,191,81,110,42.41
Smolder,Darius,904,455,449,50.33
Smolder,Azir,172,88,84,51.16
Smolder,Aphelios,411,227,184,55.23
Smolder,Soraka,269,127,142,47.21
Smolder,Yone,947,443,504,46.78
Smolder,Nilah,241,108,133,44.81
Smolder,Irelia,431,239,192,55.45
Smolder,Nocturne,427,188,239,44.03
Smolder,Jayce,181,102,79,56.35
Smolder,Jhin,933,420,513,45.02
Smolder,Senna,383,178,205,46.48
Smolder,Tryndamere,263,138,125,52.47
Smolder,Zyra,289,148,141,51.21
Smolder,TahmKench,528,289,239,54.73
Smolder,Aatrox,506,260,246,51.38
Smolder,Belveth,142,69,73,48.59
Smolder,Hwei,341,186,155,54.55
Smolder,Jinx,1109,496,613,44.72
Smolder,Kayle,392,199,193,50.77
Smolder,Akali,393,201,192,51.15
Smolder,Yasuo,884,438,446,49.55
Smolder,Warwick,740,304,436,41.08
Smolder,Malzahar,506,237,269,46.84
Smolder,Tristana,453,221,232,48.79
Smolder,Sejuani,156,87,69,55.77
Smolder,Ahri,634,345,289,54.42
Smolder,Caitlyn,1361,619,742,45.48
Smolder,Lux,1287,592,695,46
Smolder,Maokai,210,105,105,50
Smolder,Corki,110,59,51,53.64
Smolder,Taric,144,59,85,40.97
Smolder,Singed,115,30,85,26.09
Smolder,Viego,571,280,291,49.04
Smolder,Vayne,524,307,217,58.59
Smolder,MissFortune,920,396,524,43.04
Smolder,Leona,402,211,191,52.49
Smolder,Ambessa,353,158,195,44.76
Smolder,Varus,379,169,210,44.59
Smolder,Graves,316,157,159,49.68
Smolder,Neeko,290,172,118,59.31
Smolder,Nasus,329,178,151,54.1
Smolder,Thresh,662,323,339,48.79
Smolder,Rammus,122,55,67,45.08
Smolder,Yuumi,484,236,248,48.76
Smolder,LeeSin,476,224,252,47.06
Smolder,Sona,142,68,74,47.89
Smolder,Anivia,156,70,86,44.87
Smolder,Braum,222,109,113,49.1
Smolder,DrMundo,302,146,156,48.34
Smolder,Nunu,363,170,193,46.83
Smolder,Malphite,400,178,222,44.5
Smolder,Pyke,539,276,263,51.21
Smolder,Skarner,129,63,66,48.84
Smolder,Ezreal,902,469,433,52
Smolder,Seraphine,530,244,286,46.04
Smolder,Draven,250,116,134,46.4
Smolder,Yorick,427,193,234,45.2
Smolder,Vi,416,222,194,53.37
Smolder,Katarina,475,280,195,58.95
Smolder,Nautilus,533,283,250,53.1
Smolder,Ziggs,227,92,135,40.53
Smolder,Sion,428,221,207,51.64
Smolder,Gragas,415,226,189,54.46
Smolder,MonkeyKing,225,87,138,38.67
Smolder,Akshan,158,50,108,31.65
Smolder,Sett,809,334,475,41.29
Smolder,Shaco,508,265,243,52.17
Smolder,KogMaw,168,89,79,52.98
Smolder,Milio,320,151,169,47.19
Smolder,Vladimir,308,157,151,50.97
Smolder,Gnar,221,103,118,46.61
Smolder,Chogath,741,358,383,48.31
Smolder,Illaoi,216,108,108,50
Smolder,Fizz,253,109,144,43.08
Smolder,Lucian,242,111,131,45.87
Smolder,Urgot,275,130,145,47.27
Smolder,Zed,518,261,257,50.39
Smolder,Alistar,150,80,70,53.33
Smolder,Evelynn,260,119,141,45.77
Smolder,Heimerdinger,246,136,110,55.28
Smolder,Morgana,610,313,297,51.31
Smolder,Garen,671,315,356,46.94
Smolder,Trundle,277,157,120,56.68
Smolder,Velkoz,266,129,137,48.5
Smolder,Kled,46,12,34,26.09
Smolder,Ekko,402,194,208,48.26
Smolder,Sivir,249,151,98,60.64
Smolder,Rengar,280,162,118,57.86
Smolder,Galio,399,153,246,38.35
Smolder,Ivern,116,72,44,62.07
Smolder,Shen,329,162,167,49.24
Smolder,Cassiopeia,189,95,94,50.26
Smolder,Rell,257,145,112,56.42
Smolder,Diana,704,403,301,57.24
Smolder,Talon,304,127,177,41.78
Smolder,Blitzcrank,352,181,171,51.42
Smolder,Lissandra,105,72,33,68.57
Smolder,Fiora,186,103,83,55.38
Smolder,Gwen,303,159,144,52.48
Smolder,Viktor,327,144,183,44.04
Smolder,Leblanc,234,153,81,65.38
Smolder,Ornn,252,130,122,51.59
Smolder,Jax,358,175,183,48.88
Smolder,Zoe,180,94,86,52.22
Smolder,Camille,169,87,82,51.48
Smolder,Taliyah,143,63,80,44.06
Smolder,Zeri,235,133,102,56.6
Smolder,Elise,279,147,132,52.69
Smolder,Twitch,414,186,228,44.93
Smolder,XinZhao,282,111,171,39.36
Smolder,Lillia,321,182,139,56.7
Smolder,Rakan,265,145,120,54.72
Smolder,Khazix,302,167,135,55.3
Smolder,Kennen,219,109,110,49.77
Smolder,Kalista,305,162,143,53.11
Smolder,Karthus,134,79,55,58.96
Smolder,Nami,500,269,231,53.8
Smolder,Pantheon,787,373,414,47.4
Smolder,FiddleSticks,271,113,158,41.7
Smolder,Annie,143,75,68,52.45
Smolder,Quinn,212,75,137,35.38
Smolder,Riven,203,103,100,50.74
Smolder,Volibear,504,241,263,47.82
Smolder,Kassadin,118,63,55,53.39
Smolder,Xerath,354,155,199,43.79
Smolder,Naafiri,207,94,113,45.41
Smolder,JarvanIV,234,107,127,45.73
Smolder,Orianna,142,74,68,52.11
Smolder,Nidalee,129,61,68,47.29
Smolder,Zac,177,99,78,55.93
Smolder,Brand,357,183,174,51.26
Smolder,TwistedFate,163,85,78,52.15
Smolder,Rumble,107,42,65,39.25
Smolder,Kindred,246,145,101,58.94
Smolder,Ryze,149,66,83,44.3
Smolder,Bard,145,48,97,33.1
Smolder,Syndra,304,155,149,50.99
Smolder,Hecarim,226,135,91,59.73
Smolder,Janna,130,69,61,53.08
Smolder,Poppy,255,140,115,54.9
Smolder,AurelionSol,188,84,104,44.68
Smolder,Shyvana,171,93,78,54.39
Smolder,Zilean,159,85,74,53.46
Smolder,Udyr,142,53,89,37.32
Smolder,Olaf,114,50,64,43.86
Smolder,Renata,171,60,111,35.09
Smolder,Qiyana,127,63,64,49.61
Smolder,RekSai,68,39,29,57.35
Nautilus,Gangplank,283,152,131,53.71
Nautilus,MasterYi,711,422,289,59.35
Nautilus,Veigar,804,360,444,44.78
Nautilus,Mel,1458,708,750,48.56
Nautilus,Swain,719,312,407,43.39
Nautilus,Illaoi,276,104,172,37.68
Nautilus,MonkeyKing,304,149,155,49.01
Nautilus,Yone,1291,608,683,47.1
Nautilus,Tristana,576,317,259,55.03
Nautilus,Morgana,925,443,482,47.89
Nautilus,Ivern,171,83,88,48.54
Nautilus,Jhin,1164,561,603,48.2
Nautilus,Mordekaiser,1003,467,536,46.56
Nautilus,Amumu,692,307,385,44.36
Nautilus,Sylas,653,343,310,52.53
Nautilus,Xayah,472,221,251,46.82
Nautilus,Ashe,963,498,465,51.71
Nautilus,Urgot,326,150,176,46.01
Nautilus,Rengar,278,173,105,62.23
Nautilus,Ziggs,274,124,150,45.26
Nautilus,Trundle,369,127,242,34.42
Nautilus,Fiora,434,236,198,54.38
Nautilus,Poppy,487,224,263,46
Nautilus,Diana,820,406,414,49.51
Nautilus,Anivia,226,103,123,45.58
Nautilus,Caitlyn,1486,826,660,55.59
Nautilus,Thresh,1028,560,468,54.47
Nautilus,Galio,557,268,289,48.11
Nautilus,Ezreal,1200,635,565,52.92
Nautilus,Chogath,848,417,431,49.17
Nautilus,KSante,237,120,117,50.63
Nautilus,Warwick,1095,514,581,46.94
Nautilus,Corki,193,92,101,47.67
Nautilus,Garen,1027,517,510,50.34
Nautilus,FiddleSticks,402,209,193,51.99
Nautilus,Lux,1808,865,943,47.84
Nautilus,Brand,538,228,310,42.38
Nautilus,Kayn,962,444,518,46.15
Nautilus,Taliyah,227,116,111,51.1
Nautilus,Sivir,376,136,240,36.17
Nautilus,Soraka,387,179,208,46.25
Nautilus,Sion,483,222,261,45.96
Nautilus,AurelionSol,329,159,170,48.33
Nautilus,Nami,487,219,268,44.97
Nautilus,Zac,268,132,136,49.25
Nautilus,Nunu,554,288,266,51.99
Nautilus,Kaisa,1001,540,461,53.95
Nautilus,Shen,426,208,218,48.83
Nautilus,Riven,287,168,119,58.54
Nautilus,Vi,552,226,326,40.94
Nautilus,MissFortune,1405,674,731,47.97
Nautilus,Ambessa,321,167,154,52.02
Nautilus,Yuumi,606,276,330,45.54
Nautilus,Qiyana,246,147,99,59.76
Nautilus,LeeSin,739,385,354,52.1
Nautilus,Quinn,193,95,98,49.22
Nautilus,Talon,426,215,211,50.47
Nautilus,Syndra,408,195,213,47.79
Nautilus,Sett,1093,496,597,45.38
Nautilus,DrMundo,434,184,250,42.4
Nautilus,Shaco,549,290,259,52.82
Nautilus,Viktor,410,204,206,49.76
Nautilus,Rammus,176,85,91,48.3
Nautilus,Katarina,541,306,235,56.56
Nautilus,Milio,425,138,287,32.47
Nautilus,Teemo,989,440,549,44.49
Nautilus,Ahri,795,360,435,45.28
Nautilus,Senna,598,286,312,47.83
Nautilus,Ekko,509,252,257,49.51
Nautilus,Aphelios,505,221,284,43.76
Nautilus,Nasus,469,203,266,43.28
Nautilus,Zilean,173,68,105,39.31
Nautilus,Volibear,693,291,402,41.99
Nautilus,XinZhao,321,181,140,56.39
Nautilus,Leona,599,298,301,49.75
Nautilus,Yasuo,1113,511,602,45.91
Nautilus,Jinx,1356,673,683,49.63
Nautilus,Karma,376,193,183,51.33
Nautilus,Braum,355,153,202,43.1
Nautilus,Skarner,267,146,121,54.68
Nautilus,Viego,887,441,446,49.72
Nautilus,Irelia,626,340,286,54.31
Nautilus,Zeri,307,140,167,45.6
Nautilus,Alistar,362,185,177,51.1
Nautilus,Akali,630,314,316,49.84
Nautilus,Pantheon,1114,518,596,46.5
Nautilus,Vex,405,214,191,52.84
Nautilus,Gragas,416,171,245,41.11
Nautilus,Lulu,561,259,302,46.17
Nautilus,Malphite,494,236,258,47.77
Nautilus,Samira,661,308,353,46.6
Nautilus,Blitzcrank,532,308,224,57.89
Nautilus,Hwei,437,208,229,47.6
Nautilus,Darius,1140,501,639,43.95
Nautilus,Malzahar,438,214,224,48.86
Nautilus,Sona,255,94,161,36.86
Nautilus,Zed,640,315,325,49.22
Nautilus,Heimerdinger,325,181,144,55.69
Nautilus,Udyr,277,150,127,54.15
Nautilus,Aatrox,703,398,305,56.61
Nautilus,Akshan,234,114,120,48.72
Nautilus,Zyra,403,183,220,45.41
Nautilus,KogMaw,290,122,168,42.07
Nautilus,Zoe,250,146,104,58.4
Nautilus,RekSai,69,31,38,44.93
Nautilus,Twitch,503,266,237,52.88
Nautilus,Yorick,618,320,298,51.78
Nautilus,Kalista,312,164,148,52.56
Nautilus,JarvanIV,279,111,168,39.78
Nautilus,Aurora,626,321,305,51.28
Nautilus,TahmKench,726,336,390,46.28
Nautilus,Kayle,467,199,268,42.61
Nautilus,Kindred,270,124,146,45.93
Nautilus,Jax,476,224,252,47.06
Nautilus,Xerath,418,152,266,36.36
Nautilus,Pyke,842,497,345,59.03
Nautilus,Fizz,316,155,161,49.05
Nautilus,Seraphine,671,352,319,52.46
Nautilus,Renekton,280,137,143,48.93
Nautilus,Leblanc,268,144,124,53.73
Nautilus,Vayne,751,403,348,53.66
Nautilus,Briar,570,260,310,45.61
Nautilus,Orianna,305,139,166,45.57
Nautilus,Draven,365,202,163,55.34
Nautilus,Ornn,330,148,182,44.85
Nautilus,Camille,189,111,78,58.73
Nautilus,Smolder,533,250,283,46.9
Nautilus,Janna,236,135,101,57.2
Nautilus,Ryze,176,60,116,34.09
Nautilus,Lucian,320,173,147,54.06
Nautilus,Singed,134,48,86,35.82
Nautilus,Elise,376,217,159,57.71
Nautilus,Belveth,204,92,112,45.1
Nautilus,Maokai,329,96,233,29.18
Nautilus,Cassiopeia,312,159,153,50.96
Nautilus,Velkoz,433,185,248,42.73
Nautilus,Gnar,292,121,171,41.44
Nautilus,Taric,147,71,76,48.3
Nautilus,Bard,218,91,127,41.74
Nautilus,Vladimir,363,153,210,42.15
Nautilus,Khazix,326,213,113,65.34
Nautilus,Renata,199,110,89,55.28
Nautilus,Varus,485,251,234,51.75
Nautilus,Graves,371,204,167,54.99
Nautilus,Evelynn,283,181,102,63.96
Nautilus,Kassadin,164,88,76,53.66
Nautilus,Gwen,447,238,209,53.24
Nautilus,Sejuani,264,112,152,42.42
Nautilus,Kennen,200,127,73,63.5
Nautilus,Neeko,509,297,212,58.35
Nautilus,Nocturne,567,312,255,55.03
Nautilus,Rakan,328,147,181,44.82
Nautilus,Naafiri,251,141,110,56.18
Nautilus,Hecarim,251,108,143,43.03
Nautilus,Karthus,178,62,116,34.83
Nautilus,Tryndamere,406,226,180,55.67
Nautilus,TwistedFate,182,96,86,52.75
Nautilus,Lillia,421,171,250,40.62
Nautilus,Nidalee,194,134,60,69.07
Nautilus,Annie,187,102,85,54.55
Nautilus,Nilah,338,126,212,37.28
Nautilus,Olaf,195,76,119,38.97
Nautilus,Azir,257,114,143,44.36
Nautilus,Kled,121,74,47,61.16
Nautilus,Lissandra,177,72,105,40.68
Nautilus,Shyvana,183,72,111,39.34
Nautilus,Rell,402,205,197,51
Nautilus,Jayce,285,171,114,60
Nautilus,Rumble,136,89,47,65.44
TahmKench,Gangplank,213,114,99,53.52
TahmKench,Brand,554,279,275,50.36
TahmKench,Irelia,636,329,307,51.73
TahmKench,Malzahar,537,215,322,40.04
TahmKench,Pyke,839,443,396,52.8
TahmKench,Gnar,351,190,161,54.13
TahmKench,Jax,585,294,291,50.26
TahmKench,Yasuo,1297,636,661,49.04
TahmKench,Caitlyn,1711,801,910,46.81
TahmKench,Neeko,474,261,213,55.06
TahmKench,Vayne,926,408,518,44.06
TahmKench,Nocturne,513,254,259,49.51
TahmKench,Kaisa,945,445,500,47.09
TahmKench,Galio,453,182,271,40.18
TahmKench,Blitzcrank,544,296,248,54.41
TahmKench,Volibear,781,333,448,42.64
TahmKench,Ekko,576,257,319,44.62
TahmKench,Yone,1315,653,662,49.66
TahmKench,Kalista,345,187,158,54.2
TahmKench,Tristana,643,310,333,48.21
TahmKench,Poppy,426,191,235,44.84
TahmKench,Veigar,883,448,435,50.74
TahmKench,Heimerdinger,388,194,194,50
TahmKench,Ziggs,304,138,166,45.39
TahmKench,Naafiri,321,129,192,40.19
TahmKench,Nunu,501,285,216,56.89
TahmKench,Zeri,289,152,137,52.6
TahmKench,Mordekaiser,1150,566,584,49.22
TahmKench,LeeSin,648,365,283,56.33
TahmKench,Kayle,418,233,185,55.74
TahmKench,Ezreal,1170,685,485,58.55
TahmKench,Morgana,856,351,505,41
TahmKench,TwistedFate,202,108,94,53.47
TahmKench,Nilah,332,183,149,55.12
TahmKench,Vi,566,293,273,51.77
TahmKench,Ahri,791,411,380,51.96
TahmKench,Darius,1513,725,788,47.92
TahmKench,Maokai,264,113,151,42.8
TahmKench,Yorick,576,257,319,44.62
TahmKench,Pantheon,1156,588,568,50.87
TahmKench,Samira,606,239,367,39.44
TahmKench,Nami,609,272,337,44.66
TahmKench,Kennen,234,140,94,59.83
TahmKench,Rammus,156,96,60,61.54
TahmKench,Chogath,1021,502,519,49.17
TahmKench,Ivern,151,69,82,45.7
TahmKench,Lux,2134,1025,1109,48.03
TahmKench,Kayn,1002,491,511,49
TahmKench,Smolder,528,239,289,45.27
TahmKench,Thresh,822,407,415,49.51
TahmKench,Teemo,837,375,462,44.8
TahmKench,Khazix,367,215,152,58.58
TahmKench,MissFortune,1501,742,759,49.43
TahmKench,Rell,402,167,235,41.54
TahmKench,Aatrox,693,336,357,48.48
TahmKench,Shaco,516,277,239,53.68
TahmKench,Leblanc,205,118,87,57.56
TahmKench,Draven,296,155,141,52.36
TahmKench,Hwei,515,257,258,49.9
TahmKench,Cassiopeia,247,96,151,38.87
TahmKench,Riven,232,133,99,57.33
TahmKench,Senna,546,274,272,50.18
TahmKench,Jayce,276,165,111,59.78
TahmKench,Swain,783,311,472,39.72
TahmKench,Sion,589,313,276,53.14
TahmKench,Gragas,356,167,189,46.91
TahmKench,Zed,680,384,296,56.47
TahmKench,Jinx,1364,739,625,54.18
TahmKench,MasterYi,790,398,392,50.38
TahmKench,Garen,982,448,534,45.62
TahmKench,Sett,1097,522,575,47.58
TahmKench,Lucian,396,246,150,62.12
TahmKench,Sona,265,146,119,55.09
TahmKench,Vex,358,179,179,50
TahmKench,Malphite,579,303,276,52.33
TahmKench,Amumu,577,205,372,35.53
TahmKench,Ashe,1088,508,580,46.69
TahmKench,Velkoz,445,203,242,45.62
TahmKench,Kindred,377,198,179,52.52
TahmKench,AurelionSol,335,138,197,41.19
TahmKench,Urgot,341,160,181,46.92
TahmKench,Viego,830,388,442,46.75
TahmKench,Katarina,512,306,206,59.77
TahmKench,Elise,388,216,172,55.67
TahmKench,Annie,219,109,110,49.77
TahmKench,Nasus,533,224,309,42.03
TahmKench,Mel,1490,751,739,50.4
TahmKench,Rengar,340,205,135,60.29
TahmKench,Akali,633,329,304,51.97
TahmKench,KSante,240,144,96,60
TahmKench,Sylas,651,351,300,53.92
TahmKench,Trundle,480,215,265,44.79
TahmKench,Akshan,264,126,138,47.73
TahmKench,Corki,243,145,98,59.67
TahmKench,Ornn,317,147,170,46.37
TahmKench,Zoe,240,116,124,48.33
TahmKench,DrMundo,529,237,292,44.8
TahmKench,Viktor,534,293,241,54.87
TahmKench,Lulu,541,306,235,56.56
TahmKench,Vladimir,358,157,201,43.85
TahmKench,Evelynn,330,200,130,60.61
TahmKench,Aurora,604,315,289,52.15
TahmKench,Warwick,1031,510,521,49.47
TahmKench,FiddleSticks,326,159,167,48.77
TahmKench,Nautilus,726,390,336,53.72
TahmKench,Yuumi,580,335,245,57.76
TahmKench,Ryze,206,119,87,57.77
TahmKench,Twitch,507,265,242,52.27
TahmKench,Xerath,402,195,207,48.51
TahmKench,XinZhao,420,227,193,54.05
TahmKench,JarvanIV,261,133,128,50.96
TahmKench,Zyra,452,214,238,47.35
TahmKench,Sivir,274,126,148,45.99
TahmKench,Leona,501,220,281,43.91
TahmKench,Karma,414,171,243,41.3
TahmKench,Illaoi,385,146,239,37.92
TahmKench,Jhin,1136,468,668,41.2
TahmKench,Aphelios,425,211,214,49.65
TahmKench,Graves,367,167,200,45.5
TahmKench,Briar,717,338,379,47.14
TahmKench,Singed,214,82,132,38.32
TahmKench,Belveth,195,112,83,57.44
TahmKench,Janna,225,87,138,38.67
TahmKench,Zac,245,92,153,37.55
TahmKench,Bard,240,145,95,60.42
TahmKench,Diana,892,399,493,44.73
TahmKench,Soraka,391,163,228,41.69
TahmKench,Ambessa,441,196,245,44.44
TahmKench,Qiyana,208,104,104,50
TahmKench,Fiora,368,182,186,49.46
TahmKench,Varus,493,235,258,47.67
TahmKench,Rakan,368,190,178,51.63
TahmKench,Azir,225,146,79,64.89
TahmKench,Tryndamere,344,200,144,58.14
TahmKench,Milio,355,177,178,49.86
TahmKench,Hecarim,311,187,124,60.13
TahmKench,Udyr,209,89,120,42.58
TahmKench,Lillia,547,231,316,42.23
TahmKench,Lissandra,183,102,81,55.74
TahmKench,Nidalee,218,117,101,53.67
TahmKench,Sejuani,219,97,122,44.29
TahmKench,Olaf,202,107,95,52.97
TahmKench,Camille,239,110,129,46.03
TahmKench,Kassadin,152,64,88,42.11
TahmKench,Syndra,347,179,168,51.59
TahmKench,Seraphine,737,380,357,51.56
TahmKench,Braum,398,177,221,44.47
TahmKench,Xayah,416,194,222,46.63
TahmKench,Alistar,227,121,106,53.3
TahmKench,Gwen,476,264,212,55.46
TahmKench,Skarner,172,98,74,56.98
TahmKench,Karthus,163,93,70,57.06
TahmKench,Talon,355,217,138,61.13
TahmKench,Taliyah,213,122,91,57.28
TahmKench,Shyvana,119,49,70,41.18
TahmKench,Fizz,293,126,167,43
TahmKench,KogMaw,256,138,118,53.91
TahmKench,Anivia,164,79,85,48.17
TahmKench,Renekton,293,137,156,46.76
TahmKench,Orianna,264,142,122,53.79
TahmKench,Shen,419,193,226,46.06
TahmKench,MonkeyKing,389,179,210,46.02
TahmKench,Quinn,215,106,109,49.3
TahmKench,Renata,177,94,83,53.11
TahmKench,Kled,151,54,97,35.76
TahmKench,RekSai,68,29,39,42.65
TahmKench,Rumble,113,62,51,54.87
TahmKench,Zilean,180,106,74,58.89
TahmKench,Taric,150,63,87,42
Aphelios,Gangplank,152,72,80,47.37
Aphelios,Brand,300,130,170,43.33
Aphelios,Irelia,453,237,216,52.32
Aphelios,Malzahar,419,145,274,34.61
Aphelios,Pyke,540,291,249,53.89
Aphelios,Kayle,340,163,177,47.94
Aphelios,Viego,502,276,226,54.98
Aphelios,Jinx,997,464,533,46.54
Aphelios,Thresh,594,302,292,50.84
Aphelios,Warwick,768,326,442,42.45
Aphelios,Singed,101,48,53,47.52
Aphelios,Ryze,101,46,55,45.54
Aphelios,Samira,449,226,223,50.33
Aphelios,Soraka,310,171,139,55.16
Aphelios,Sett,607,256,351,42.17
Aphelios,Volibear,441,277,164,62.81
Aphelios,Ambessa,245,114,131,46.53
Aphelios,Smolder,411,184,227,44.77
Aphelios,Swain,488,213,275,43.65
Aphelios,Malphite,355,162,193,45.63
Aphelios,Sion,419,180,239,42.96
Aphelios,Alistar,103,51,52,49.51
Aphelios,Jax,298,128,170,42.95
Aphelios,FiddleSticks,236,129,107,54.66
Aphelios,Heimerdinger,252,113,139,44.84
Aphelios,Ashe,745,359,386,48.19
Aphelios,Fiora,212,105,107,49.53
Aphelios,Shaco,363,154,209,42.42
Aphelios,Fizz,227,153,74,67.4
Aphelios,Tristana,359,187,172,52.09
Aphelios,Rakan,188,100,88,53.19
Aphelios,Garen,673,395,278,58.69
Aphelios,Graves,195,79,116,40.51
Aphelios,Aurora,396,156,240,39.39
Aphelios,Nilah,250,129,121,51.6
Aphelios,Hwei,359,188,171,52.37
Aphelios,Talon,257,144,113,56.03
Aphelios,LeeSin,505,245,260,48.51
Aphelios,Jhin,775,385,390,49.68
Aphelios,Senna,431,189,242,43.85
Aphelios,XinZhao,196,95,101,48.47
Aphelios,Nautilus,505,284,221,56.24
Aphelios,Teemo,619,251,368,40.55
Aphelios,Yasuo,887,422,465,47.58
Aphelios,Rengar,180,105,75,58.33
Aphelios,Anivia,86,47,39,54.65
Aphelios,Xayah,272,168,104,61.76
Aphelios,Galio,259,106,153,40.93
Aphelios,Diana,645,334,311,51.78
Aphelios,Veigar,472,230,242,48.73
Aphelios,Sejuani,186,101,85,54.3
Aphelios,Sylas,465,228,237,49.03
Aphelios,Lux,1072,502,570,46.83
Aphelios,Tryndamere,244,135,109,55.33
Aphelios,MasterYi,416,229,187,55.05
Aphelios,Orianna,254,125,129,49.21
Aphelios,Darius,780,426,354,54.62
Aphelios,Caitlyn,1078,514,564,47.68
Aphelios,Sona,172,56,116,32.56
Aphelios,DrMundo,259,131,128,50.58
Aphelios,Mordekaiser,708,342,366,48.31
Aphelios,Akali,468,271,197,57.91
Aphelios,Lucian,301,144,157,47.84
Aphelios,Nami,373,187,186,50.13
Aphelios,KSante,213,131,82,61.5
Aphelios,Belveth,162,66,96,40.74
Aphelios,Riven,153,85,68,55.56
Aphelios,Yuumi,391,186,205,47.57
Aphelios,Kaisa,647,398,249,61.51
Aphelios,Kayn,635,290,345,45.67
Aphelios,Amumu,467,168,299,35.97
Aphelios,Chogath,521,279,242,53.55
Aphelios,Morgana,539,270,269,50.09
Aphelios,Camille,167,82,85,49.1
Aphelios,Lillia,272,145,127,53.31
Aphelios,Aatrox,366,191,175,52.19
Aphelios,Elise,240,136,104,56.67
Aphelios,Seraphine,423,211,212,49.88
Aphelios,Gragas,270,123,147,45.56
Aphelios,Milio,292,122,170,41.78
Aphelios,Vladimir,213,115,98,53.99
Aphelios,Velkoz,278,154,124,55.4
Aphelios,Khazix,279,120,159,43.01
Aphelios,Mel,1001,560,441,55.94
Aphelios,Vex,260,153,107,58.85
Aphelios,MissFortune,917,435,482,47.44
Aphelios,Viktor,256,112,144,43.75
Aphelios,Nocturne,364,155,209,42.58
Aphelios,Yone,825,472,353,57.21
Aphelios,Draven,220,121,99,55
Aphelios,Poppy,227,124,103,54.63
Aphelios,Kalista,297,131,166,44.11
Aphelios,Neeko,333,205,128,61.56
Aphelios,Renata,129,62,67,48.06
Aphelios,Yorick,450,191,259,42.44
Aphelios,Zed,555,312,243,56.22
Aphelios,Evelynn,260,139,121,53.46
Aphelios,Leblanc,166,86,80,51.81
Aphelios,TahmKench,425,214,211,50.35
Aphelios,RekSai,44,20,24,45.45
Aphelios,Pantheon,632,349,283,55.22
Aphelios,Ekko,312,116,196,37.18
Aphelios,Urgot,159,74,85,46.54
Aphelios,Briar,438,222,216,50.68
Aphelios,Ezreal,799,394,405,49.31
Aphelios,Zac,158,93,65,58.86
Aphelios,Bard,222,117,105,52.7
Aphelios,Jayce,204,117,87,57.35
Aphelios,Twitch,392,220,172,56.12
Aphelios,Shyvana,120,57,63,47.5
Aphelios,Zilean,119,57,62,47.9
Aphelios,Gnar,113,61,52,53.98
Aphelios,Kindred,298,130,168,43.62
Aphelios,Cassiopeia,199,97,102,48.74
Aphelios,Karthus,148,92,56,62.16
Aphelios,Leona,302,144,158,47.68
Aphelios,Kled,93,43,50,46.24
Aphelios,MonkeyKing,185,114,71,61.62
Aphelios,Vi,386,203,183,52.59
Aphelios,Nasus,380,166,214,43.68
Aphelios,Rell,240,126,114,52.5
Aphelios,Illaoi,176,65,111,36.93
Aphelios,Maokai,190,110,80,57.89
Aphelios,Qiyana,155,86,69,55.48
Aphelios,Ahri,597,297,300,49.75
Aphelios,Vayne,491,253,238,51.53
Aphelios,Annie,140,68,72,48.57
Aphelios,Hecarim,114,76,38,66.67
Aphelios,Naafiri,185,72,113,38.92
Aphelios,Lulu,347,231,116,66.57
Aphelios,Olaf,117,57,60,48.72
Aphelios,Katarina,318,162,156,50.94
Aphelios,Quinn,133,71,62,53.38
Aphelios,Ziggs,232,110,122,47.41
Aphelios,Braum,146,62,84,42.47
Aphelios,Xerath,248,109,139,43.95
Aphelios,Shen,265,137,128,51.7
Aphelios,Zoe,251,141,110,56.18
Aphelios,Zyra,313,128,185,40.89
Aphelios,AurelionSol,158,80,78,50.63
Aphelios,Gwen,229,124,105,54.15
Aphelios,JarvanIV,134,64,70,47.76
Aphelios,Taliyah,128,100,28,78.13
Aphelios,Corki,153,93,60,60.78
Aphelios,Nunu,319,153,166,47.96
Aphelios,Udyr,141,72,69,51.06
Aphelios,Rumble,81,38,43,46.91
Aphelios,Sivir,235,97,138,41.28
Aphelios,Varus,356,175,181,49.16
Aphelios,Kennen,216,120,96,55.56
Aphelios,Azir,136,75,61,55.15
Aphelios,Blitzcrank,275,123,152,44.73
Aphelios,Ivern,112,50,62,44.64
Aphelios,KogMaw,89,32,57,35.96
Aphelios,Trundle,256,147,109,57.42
Aphelios,Karma,342,159,183,46.49
Aphelios,Rammus,151,67,84,44.37
Aphelios,Janna,177,52,125,29.38
Aphelios,Syndra,182,83,99,45.6
Aphelios,Lissandra,119,41,78,34.45
Aphelios,Akshan,162,72,90,44.44
Aphelios,TwistedFate,196,107,89,54.59
Aphelios,Zeri,186,84,102,45.16
Aphelios,Nidalee,162,94,68,58.02
Aphelios,Skarner,125,60,65,48
Aphelios,Ornn,172,61,111,35.47
Aphelios,Kassadin,100,36,64,36
Aphelios,Renekton,175,89,86,50.86
Aphelios,Taric,106,61,45,57.55
Amumu,Trundle,417,186,231,44.6
Amumu,MasterYi,672,357,315,53.13
Amumu,Veigar,744,385,359,51.75
Amumu,Jhin,1045,523,522,50.05
Amumu,Soraka,367,170,197,46.32
Amumu,Warwick,1125,591,534,52.53
Amumu,Briar,581,343,238,59.04
Amumu,Yasuo,1037,531,506,51.21
Amumu,Irelia,554,324,230,58.48
Amumu,Lux,1732,951,781,54.91
Amumu,Urgot,269,165,104,61.34
Amumu,Kayn,830,461,369,55.54
Amumu,Twitch,487,272,215,55.85
Amumu,Neeko,476,253,223,53.15
Amumu,Yone,1158,699,459,60.36
Amumu,TwistedFate,192,111,81,57.81
Amumu,Smolder,434,255,179,58.76
Amumu,Nautilus,692,385,307,55.64
Amumu,Teemo,851,423,428,49.71
Amumu,LeeSin,492,257,235,52.24
Amumu,Nami,601,310,291,51.58
Amumu,Mordekaiser,935,429,506,45.88
Amumu,Diana,899,489,410,54.39
Amumu,MissFortune,1295,699,596,53.98
Amumu,Karma,375,204,171,54.4
Amumu,Nasus,430,203,227,47.21
Amumu,Khazix,367,222,145,60.49
Amumu,Lulu,474,279,195,58.86
Amumu,Kindred,331,216,115,65.26
Amumu,Fizz,280,149,131,53.21
Amumu,Gnar,243,168,75,69.14
Amumu,Caitlyn,1347,733,614,54.42
Amumu,Sion,502,280,222,55.78
Amumu,Akshan,194,139,55,71.65
Amumu,Jinx,1327,730,597,55.01
Amumu,Bard,217,102,115,47
Amumu,DrMundo,415,231,184,55.66
Amumu,Shaco,513,317,196,61.79
Amumu,Leblanc,191,100,91,52.36
Amumu,Xayah,400,255,145,63.75
Amumu,Yorick,460,207,253,45
Amumu,Volibear,648,367,281,56.64
Amumu,Cassiopeia,281,156,125,55.52
Amumu,Rell,417,228,189,54.68
Amumu,Thresh,653,379,274,58.04
Amumu,FiddleSticks,311,179,132,57.56
Amumu,Zed,580,321,259,55.34
Amumu,Viktor,451,254,197,56.32
Amumu,Pyke,711,377,334,53.02
Amumu,Olaf,186,125,61,67.2
Amumu,Hecarim,252,161,91,63.89
Amumu,Tristana,504,265,239,52.58
Amumu,Braum,269,161,108,59.85
Amumu,Kennen,202,132,70,65.35
Amumu,XinZhao,372,237,135,63.71
Amumu,Akali,652,411,241,63.04
Amumu,Kaisa,893,548,345,61.37
Amumu,Gangplank,277,165,112,59.57
Amumu,Nocturne,599,305,294,50.92
Amumu,Corki,169,85,84,50.3
Amumu,Jax,417,259,158,62.11
Amumu,Katarina,439,263,176,59.91
Amumu,Chogath,814,456,358,56.02
Amumu,Galio,414,216,198,52.17
Amumu,Hwei,408,195,213,47.79
Amumu,Ahri,808,468,340,57.92
Amumu,Malzahar,446,217,229,48.65
Amumu,Talon,360,217,143,60.28
Amumu,Rakan,295,165,130,55.93
Amumu,Senna,573,291,282,50.79
Amumu,Vayne,582,285,297,48.97
Amumu,Sejuani,254,128,126,50.39
Amumu,TahmKench,577,372,205,64.47
Amumu,Brand,353,185,168,52.41
Amumu,Mel,1219,665,554,54.55
Amumu,Zyra,390,217,173,55.64
Amumu,Varus,573,306,267,53.4
Amumu,Shyvana,188,84,104,44.68
Amumu,Garen,941,507,434,53.88
Amumu,Singed,155,78,77,50.32
Amumu,Ezreal,912,490,422,53.73
Amumu,Jayce,205,110,95,53.66
Amumu,Aatrox,422,251,171,59.48
Amumu,JarvanIV,238,103,135,43.28
Amumu,Karthus,168,101,67,60.12
Amumu,Orianna,276,159,117,57.61
Amumu,Milio,353,218,135,61.76
Amumu,Rammus,211,95,116,45.02
Amumu,Ashe,990,494,496,49.9
Amumu,Seraphine,587,352,235,59.97
Amumu,Aurora,542,287,255,52.95
Amumu,Aphelios,467,299,168,64.03
Amumu,KSante,193,127,66,65.8
Amumu,Vladimir,350,190,160,54.29
Amumu,Nilah,307,199,108,64.82
Amumu,Yuumi,554,252,302,45.49
Amumu,Vex,375,183,192,48.8
Amumu,Morgana,765,374,391,48.89
Amumu,Skarner,146,104,42,71.23
Amumu,Ryze,196,101,95,51.53
Amumu,Elise,323,223,100,69.04
Amumu,Vi,462,268,194,58.01
Amumu,Draven,262,131,131,50
Amumu,Kled,133,69,64,51.88
Amumu,Poppy,307,195,112,63.52
Amumu,AurelionSol,333,194,139,58.26
Amumu,Sylas,604,330,274,54.64
Amumu,Xerath,429,248,181,57.81
Amumu,Darius,1098,617,481,56.19
Amumu,Malphite,446,229,217,51.35
Amumu,Viego,771,472,299,61.22
Amumu,Maokai,271,107,164,39.48
Amumu,Rengar,222,104,118,46.85
Amumu,Syndra,271,117,154,43.17
Amumu,Lucian,353,176,177,49.86
Amumu,Lissandra,111,53,58,47.75
Amumu,Samira,581,325,256,55.94
Amumu,Kayle,462,252,210,54.55
Amumu,Ambessa,295,131,164,44.41
Amumu,Taliyah,174,106,68,60.92
Amumu,Ekko,421,228,193,54.16
Amumu,Heimerdinger,365,200,165,54.79
Amumu,Blitzcrank,452,246,206,54.42
Amumu,Zoe,287,181,106,63.07
Amumu,Evelynn,286,171,115,59.79
Amumu,Ornn,232,125,107,53.88
Amumu,Naafiri,248,137,111,55.24
Amumu,Leona,423,278,145,65.72
Amumu,Tryndamere,302,150,152,49.67
Amumu,Illaoi,324,197,127,60.8
Amumu,Annie,236,122,114,51.69
Amumu,Sona,185,126,59,68.11
Amumu,Lillia,399,210,189,52.63
Amumu,Shen,373,201,172,53.89
Amumu,Riven,247,140,107,56.68
Amumu,Ziggs,244,116,128,47.54
Amumu,Fiora,273,122,151,44.69
Amumu,Nunu,588,280,308,47.62
Amumu,Janna,161,59,102,36.65
Amumu,Sett,1041,601,440,57.73
Amumu,Gwen,429,223,206,51.98
Amumu,Swain,627,314,313,50.08
Amumu,Belveth,198,108,90,54.55
Amumu,Camille,168,109,59,64.88
Amumu,Sivir,286,180,106,62.94
Amumu,Zac,272,130,142,47.79
Amumu,Kassadin,107,67,40,62.62
Amumu,Nidalee,181,116,65,64.09
Amumu,Qiyana,219,145,74,66.21
Amumu,Azir,175,88,87,50.29
Amumu,Renata,139,72,67,51.8
Amumu,Pantheon,981,512,469,52.19
Amumu,Taric,141,67,74,47.52
Amumu,KogMaw,214,106,108,49.53
Amumu,Zilean,160,86,74,53.75
Amumu,Quinn,188,113,75,60.11
Amumu,Gragas,376,209,167,55.59
Amumu,Velkoz,354,219,135,61.86
Amumu,Graves,403,221,182,54.84
Amumu,Alistar,166,71,95,42.77
Amumu,Renekton,263,123,140,46.77
Amumu,Anivia,188,107,81,56.91
Amumu,Rumble,131,55,76,41.98
Amumu,Udyr,206,107,99,51.94
Amumu,MonkeyKing,302,142,160,47.02
Amumu,Ivern,128,47,81,36.72
Amumu,Kalista,238,127,111,53.36
Amumu,Zeri,268,174,94,64.93
Amumu,RekSai,41,32,9,78.05
Trundle,Kayn,479,252,227,52.61
Trundle,Zed,292,194,98,66.44
Trundle,Sona,156,84,72,53.85
Trundle,Kaisa,438,250,188,57.08
Trundle,Amumu,417,231,186,55.4
Trundle,Mordekaiser,630,347,283,55.08
Trundle,Udyr,124,63,61,50.81
Trundle,Yorick,391,168,223,42.97
Trundle,Sivir,126,60,66,47.62
Trundle,Nautilus,369,242,127,65.58
Trundle,Volibear,477,254,223,53.25
Trundle,Veigar,364,178,186,48.9
Trundle,Caitlyn,842,391,451,46.44
Trundle,Warwick,613,325,288,53.02
Trundle,Yone,640,344,296,53.75
Trundle,Kalista,124,89,35,71.77
Trundle,Thresh,448,245,203,54.69
Trundle,Olaf,89,44,45,49.44
Trundle,Hecarim,126,75,51,59.52
Trundle,Tristana,230,127,103,55.22
Trundle,Braum,210,116,94,55.24
Trundle,Chogath,470,248,222,52.77
Trundle,Briar,404,214,190,52.97
Trundle,Jayce,164,89,75,54.27
Trundle,Samira,353,187,166,52.97
Trundle,Lulu,246,152,94,61.79
Trundle,MissFortune,820,456,364,55.61
Trundle,Neeko,241,130,111,53.94
Trundle,Heimerdinger,159,99,60,62.26
Trundle,Talon,202,114,88,56.44
Trundle,LeeSin,247,138,109,55.87
Trundle,Garen,521,250,271,47.98
Trundle,Jhin,585,300,285,51.28
Trundle,Senna,278,150,128,53.96
Trundle,Pyke,309,162,147,52.43
Trundle,XinZhao,234,113,121,48.29
Trundle,Teemo,430,207,223,48.14
Trundle,Yasuo,580,322,258,55.52
Trundle,Gnar,112,58,54,51.79
Trundle,Graves,171,86,85,50.29
Trundle,Twitch,342,167,175,48.83
Trundle,Malzahar,217,119,98,54.84
Trundle,Ekko,326,210,116,64.42
Trundle,Galio,229,141,88,61.57
Trundle,Lux,987,533,454,54
Trundle,Darius,716,396,320,55.31
Trundle,Diana,396,198,198,50
Trundle,Pantheon,492,259,233,52.64
Trundle,Jax,325,143,182,44
Trundle,Ornn,155,86,69,55.48
Trundle,Ambessa,184,112,72,60.87
Trundle,Zoe,161,109,52,67.7
Trundle,Swain,371,214,157,57.68
Trundle,Mel,809,424,385,52.41
Trundle,Yuumi,329,190,139,57.75
Trundle,TahmKench,480,265,215,55.21
Trundle,Irelia,271,120,151,44.28
Trundle,Poppy,241,135,106,56.02
Trundle,Kled,108,74,34,68.52
Trundle,Viego,391,191,200,48.85
Trundle,Lucian,181,107,74,59.12
Trundle,Sejuani,183,82,101,44.81
Trundle,Jinx,676,357,319,52.81
Trundle,Shaco,284,147,137,51.76
Trundle,Aurora,252,113,139,44.84
Trundle,Aatrox,267,153,114,57.3
Trundle,Anivia,115,61,54,53.04
Trundle,Kindred,187,111,76,59.36
Trundle,Blitzcrank,304,192,112,63.16
Trundle,Renekton,182,82,100,45.05
Trundle,Rengar,144,77,67,53.47
Trundle,Leblanc,121,59,62,48.76
Trundle,Seraphine,506,269,237,53.16
Trundle,Gwen,181,112,69,61.88
Trundle,MasterYi,378,169,209,44.71
Trundle,Ryze,95,38,57,40
Trundle,Katarina,315,206,109,65.4
Trundle,Brand,214,116,98,54.21
Trundle,Tryndamere,249,117,132,46.99
Trundle,Ahri,457,238,219,52.08
Trundle,Draven,179,99,80,55.31
Trundle,Bard,133,77,56,57.89
Trundle,Morgana,421,211,210,50.12
Trundle,Lillia,145,83,62,57.24
Trundle,Shen,232,128,104,55.17
Trundle,Nocturne,379,208,171,54.88
Trundle,Zilean,63,37,26,58.73
Trundle,Zac,108,62,46,57.41
Trundle,Smolder,277,120,157,43.32
Trundle,Alistar,115,46,69,40
Trundle,JarvanIV,105,59,46,56.19
Trundle,Cassiopeia,120,57,63,47.5
Trundle,Zyra,215,101,114,46.98
Trundle,Kennen,117,63,54,53.85
Trundle,Riven,141,89,52,63.12
Trundle,Syndra,150,87,63,58
Trundle,Ezreal,505,307,198,60.79
Trundle,Viktor,245,124,121,50.61
Trundle,Nasus,300,175,125,58.33
Trundle,Soraka,215,107,108,49.77
Trundle,Akali,336,217,119,64.58
Trundle,Khazix,249,129,120,51.81
Trundle,Azir,150,70,80,46.67
Trundle,Rell,149,60,89,40.27
Trundle,Lissandra,82,53,29,64.63
Trundle,Ziggs,131,65,66,49.62
Trundle,Karma,217,148,69,68.2
Trundle,Evelynn,191,108,83,56.54
Trundle,Taric,86,56,30,65.12
Trundle,FiddleSticks,202,84,118,41.58
Trundle,Vex,205,83,122,40.49
Trundle,Milio,144,76,68,52.78
Trundle,Hwei,216,111,105,51.39
Trundle,Corki,133,107,26,80.45
Trundle,KSante,141,100,41,70.92
Trundle,Vayne,414,200,214,48.31
Trundle,Vladimir,172,107,65,62.21
Trundle,Xayah,233,130,103,55.79
Trundle,Sett,577,319,258,55.29
Trundle,Nami,265,154,111,58.11
Trundle,Nilah,276,154,122,55.8
Trundle,Malphite,248,112,136,45.16
Trundle,Sion,295,151,144,51.19
Trundle,Camille,84,49,35,58.33
Trundle,Varus,222,115,107,51.8
Trundle,Illaoi,188,89,99,47.34
Trundle,Ashe,574,319,255,55.57
Trundle,Elise,179,98,81,54.75
Trundle,Orianna,122,80,42,65.57
Trundle,TwistedFate,136,88,48,64.71
Trundle,Gragas,174,111,63,63.79
Trundle,Kassadin,84,49,35,58.33
Trundle,Leona,249,142,107,57.03
Trundle,Rammus,135,69,66,51.11
Trundle,Qiyana,127,75,52,59.06
Trundle,Karthus,74,58,16,78.38
Trundle,Renata,79,39,40,49.37
Trundle,Fiora,121,84,37,69.42
Trundle,Akshan,178,110,68,61.8
Trundle,Naafiri,123,63,60,51.22
Trundle,DrMundo,268,161,107,60.07
Trundle,Skarner,104,61,43,58.65
Trundle,Aphelios,256,109,147,42.58
Trundle,Nunu,332,174,158,52.41
Trundle,Vi,275,180,95,65.45
Trundle,Velkoz,209,112,97,53.59
Trundle,Fizz,131,64,67,48.85
Trundle,Xerath,190,91,99,47.89
Trundle,KogMaw,87,44,43,50.57
Trundle,MonkeyKing,159,91,68,57.23
Trundle,Kayle,226,119,107,52.65
Trundle,Quinn,97,52,45,53.61
Trundle,Urgot,168,44,124,26.19
Trundle,Sylas,332,174,158,52.41
Trundle,Rumble,65,31,34,47.69
Trundle,Rakan,150,63,87,42
Trundle,Taliyah,87,63,24,72.41
Trundle,RekSai,44,28,16,63.64
Trundle,Ivern,57,29,28,50.88
Trundle,Gangplank,120,62,58,51.67
Trundle,Shyvana,51,25,26,49.02
Trundle,Maokai,155,60,95,38.71
Trundle,Singed,58,25,33,43.1
Trundle,Janna,101,43,58,42.57
Trundle,Zeri,102,48,54,47.06
Trundle,AurelionSol,187,87,100,46.52
Trundle,Nidalee,91,62,29,68.13
Trundle,Annie,89,47,42,52.81
Trundle,Belveth,101,68,33,67.33
Vex,Garen,549,233,316,42.44
Vex,Diana,528,233,295,44.13
Vex,Yasuo,803,423,380,52.68
Vex,Caitlyn,877,431,446,49.14
Vex,Pyke,327,216,111,66.06
Vex,Smolder,245,106,139,43.27
Vex,Ekko,323,172,151,53.25
Vex,Mordekaiser,597,283,314,47.4
Vex,Yuumi,379,179,200,47.23
Vex,Jax,316,127,189,40.19
Vex,Talon,217,101,116,46.54
Vex,Leblanc,174,97,77,55.75
Vex,Mel,565,276,289,48.85
Vex,Lux,1091,555,536,50.87
Vex,MissFortune,825,424,401,51.39
Vex,Karma,210,96,114,45.71
Vex,Warwick,551,288,263,52.27
Vex,Yone,862,443,419,51.39
Vex,Kalista,202,118,84,58.42
Vex,Thresh,453,242,211,53.42
Vex,Malphite,287,134,153,46.69
Vex,FiddleSticks,218,92,126,42.2
Vex,Soraka,264,159,105,60.23
Vex,Akali,404,200,204,49.5
Vex,Jinx,812,376,436,46.31
Vex,Xayah,281,158,123,56.23
Vex,Senna,345,175,170,50.72
Vex,Viego,417,227,190,54.44
Vex,Tristana,395,219,176,55.44
Vex,Riven,148,77,71,52.03
Vex,Sejuani,116,64,52,55.17
Vex,AurelionSol,120,56,64,46.67
Vex,Rakan,244,115,129,47.13
Vex,Nasus,194,80,114,41.24
Vex,Vi,330,142,188,43.03
Vex,Renata,44,23,21,52.27
Vex,MonkeyKing,182,95,87,52.2
Vex,Sylas,387,235,152,60.72
Vex,Swain,347,157,190,45.24
Vex,Darius,622,295,327,47.43
Vex,Kayn,583,323,260,55.4
Vex,Zed,350,199,151,56.86
Vex,Syndra,198,111,87,56.06
Vex,Kayle,255,111,144,43.53
Vex,Irelia,303,149,154,49.17
Vex,TahmKench,358,179,179,50
Vex,Veigar,446,196,250,43.95
Vex,Jhin,665,339,326,50.98
Vex,Poppy,229,120,109,52.4
Vex,Elise,190,113,77,59.47
Vex,Aurora,405,185,220,45.68
Vex,Nami,261,131,130,50.19
Vex,Sett,640,340,300,53.13
Vex,Briar,361,163,198,45.15
Vex,Draven,180,94,86,52.22
Vex,Nautilus,405,191,214,47.16
Vex,Rengar,144,92,52,63.89
Vex,Ivern,75,34,41,45.33
Vex,Graves,203,103,100,50.74
Vex,Ezreal,535,245,290,45.79
Vex,Teemo,576,274,302,47.57
Vex,Aatrox,399,201,198,50.38
Vex,Shaco,395,195,200,49.37
Vex,Azir,187,101,86,54.01
Vex,Yorick,311,123,188,39.55
Vex,Kindred,231,126,105,54.55
Vex,Heimerdinger,225,137,88,60.89
Vex,Ryze,112,54,58,48.21
Vex,KSante,96,59,37,61.46
Vex,Volibear,310,148,162,47.74
Vex,Karthus,114,65,49,57.02
Vex,Kassadin,71,22,49,30.99
Vex,Illaoi,192,119,73,61.98
Vex,Amumu,375,192,183,51.2
Vex,Ashe,523,248,275,47.42
Vex,Vayne,363,176,187,48.48
Vex,Renekton,156,85,71,54.49
Vex,XinZhao,222,125,97,56.31
Vex,Ahri,563,309,254,54.88
Vex,Corki,90,34,56,37.78
Vex,Morgana,504,235,269,46.63
Vex,Hwei,305,133,172,43.61
Vex,Aphelios,260,107,153,41.15
Vex,Nidalee,95,55,40,57.89
Vex,Orianna,140,74,66,52.86
Vex,Chogath,570,258,312,45.26
Vex,Nocturne,345,197,148,57.1
Vex,Cassiopeia,238,129,109,54.2
Vex,Ornn,145,74,71,51.03
Vex,Lulu,188,89,99,47.34
Vex,Skarner,92,48,44,52.17
Vex,Katarina,297,217,80,73.06
Vex,Quinn,117,42,75,35.9
Vex,Camille,104,61,43,58.65
Vex,LeeSin,303,169,134,55.78
Vex,Hecarim,112,43,69,38.39
Vex,Maokai,122,59,63,48.36
Vex,Fiora,154,73,81,47.4
Vex,Naafiri,164,84,80,51.22
Vex,Belveth,91,38,53,41.76
Vex,Twitch,275,126,149,45.82
Vex,Zac,120,60,60,50
Vex,Neeko,282,129,153,45.74
Vex,Shen,225,84,141,37.33
Vex,Vladimir,142,60,82,42.25
Vex,Nunu,333,178,155,53.45
Vex,Annie,123,50,73,40.65
Vex,Sona,191,88,103,46.07
Vex,Kled,60,25,35,41.67
Vex,Khazix,220,126,94,57.27
Vex,Galio,231,78,153,33.77
Vex,Braum,171,83,88,48.54
Vex,Trundle,205,122,83,59.51
Vex,Rammus,123,38,85,30.89
Vex,Seraphine,435,237,198,54.48
Vex,DrMundo,191,97,94,50.79
Vex,Kaisa,451,251,200,55.65
Vex,Gangplank,121,71,50,58.68
Vex,Blitzcrank,237,100,137,42.19
Vex,Olaf,78,24,54,30.77
Vex,JarvanIV,142,58,84,40.85
Vex,Tryndamere,221,118,103,53.39
Vex,Sion,383,167,216,43.6
Vex,Malzahar,246,106,140,43.09
Vex,Samira,316,180,136,56.96
Vex,Xerath,285,136,149,47.72
Vex,Viktor,314,154,160,49.04
Vex,Milio,190,73,117,38.42
Vex,Velkoz,226,94,132,41.59
Vex,TwistedFate,107,67,40,62.62
Vex,Lillia,250,122,128,48.8
Vex,Kennen,165,94,71,56.97
Vex,MasterYi,326,143,183,43.87
Vex,Singed,92,28,64,30.43
Vex,Nilah,224,129,95,57.59
Vex,Taliyah,91,52,39,57.14
Vex,Qiyana,150,94,56,62.67
Vex,Lucian,253,135,118,53.36
Vex,Rumble,57,26,31,45.61
Vex,KogMaw,101,43,58,42.57
Vex,Leona,311,144,167,46.3
Vex,Varus,248,146,102,58.87
Vex,Sivir,143,64,79,44.76
Vex,Gragas,243,136,107,55.97
Vex,Zeri,176,99,77,56.25
Vex,Gnar,162,85,77,52.47
Vex,Ziggs,167,45,122,26.95
Vex,RekSai,39,34,5,87.18
Vex,Alistar,85,45,40,52.94
Vex,Akshan,129,75,54,58.14
Vex,Pantheon,665,327,338,49.17
Vex,Zyra,234,119,115,50.85
Vex,Brand,291,140,151,48.11
Vex,Anivia,133,73,60,54.89
Vex,Evelynn,184,91,93,49.46
Vex,Bard,129,66,63,51.16
Vex,Gwen,205,101,104,49.27
Vex,Shyvana,83,51,32,61.45
Vex,Lissandra,82,43,39,52.44
Vex,Jayce,151,98,53,64.9
Vex,Fizz,176,101,75,57.39
Vex,Zilean,90,53,37,58.89
Vex,Urgot,122,55,67,45.08
Vex,Ambessa,215,114,101,53.02
Vex,Janna,113,34,79,30.09
Vex,Udyr,116,80,36,68.97
Vex,Taric,58,23,35,39.66
Vex,Rell,227,128,99,56.39
Vex,Zoe,111,56,55,50.45
Akali,Yorick,540,233,307,43.15
Akali,LeeSin,540,299,241,55.37
Akali,Yone,1447,790,657,54.6
Akali,MissFortune,1492,792,700,53.08
Akali,Mel,1440,739,701,51.32
Akali,Ornn,299,152,147,50.84
Akali,Udyr,167,91,76,54.49
Akali,Lux,1927,971,956,50.39
Akali,Ezreal,1137,610,527,53.65
Akali,Milio,377,205,172,54.38
Akali,Samira,634,282,352,44.48
Akali,Kayn,1015,454,561,44.73
Akali,Sylas,627,278,349,44.34
Akali,Nilah,355,167,188,47.04
Akali,Leona,500,273,227,54.6
Akali,DrMundo,411,179,232,43.55
Akali,Belveth,164,97,67,59.15
Akali,Leblanc,256,131,125,51.17
Akali,Briar,683,368,315,53.88
Akali,Anivia,198,82,116,41.41
Akali,Malphite,496,238,258,47.98
Akali,Jax,547,308,239,56.31
Akali,Neeko,464,244,220,52.59
Akali,Xayah,422,204,218,48.34
Akali,Rakan,374,176,198,47.06
Akali,Gangplank,236,112,124,47.46
Akali,Hwei,507,237,270,46.75
Akali,Hecarim,257,111,146,43.19
Akali,Lillia,413,217,196,52.54
Akali,Soraka,447,175,272,39.15
Akali,Chogath,888,345,543,38.85
Akali,Talon,414,241,173,58.21
Akali,Qiyana,213,96,117,45.07
Akali,Seraphine,666,309,357,46.4
Akali,Heimerdinger,372,132,240,35.48
Akali,Vi,479,252,227,52.61
Akali,Ahri,769,432,337,56.18
Akali,Darius,1101,559,542,50.77
Akali,Maokai,263,143,120,54.37
Akali,Aatrox,698,329,369,47.13
Akali,Viego,741,340,401,45.88
Akali,Ashe,1197,601,596,50.21
Akali,Blitzcrank,540,285,255,52.78
Akali,Mordekaiser,909,416,493,45.76
Akali,Zed,592,306,286,51.69
Akali,Vex,404,204,200,50.5
Akali,Ambessa,358,184,174,51.4
Akali,Nunu,597,315,282,52.76
Akali,Jinx,1362,644,718,47.28
Akali,Evelynn,415,231,184,55.66
Akali,Kalista,339,193,146,56.93
Akali,Renata,174,87,87,50
Akali,MasterYi,762,286,476,37.53
Akali,Caitlyn,1522,672,850,44.15
Akali,Taric,137,44,93,32.12
Akali,Amumu,652,241,411,36.96
Akali,Akshan,255,80,175,31.37
Akali,Irelia,605,295,310,48.76
Akali,Nocturne,470,229,241,48.72
Akali,Jayce,211,125,86,59.24
Akali,Jhin,1190,563,627,47.31
Akali,Senna,611,283,328,46.32
Akali,Riven,281,182,99,64.77
Akali,Naafiri,334,124,210,37.13
Akali,Tristana,585,300,285,51.28
Akali,Ivern,201,104,97,51.74
Akali,Katarina,635,353,282,55.59
Akali,Pantheon,1036,527,509,50.87
Akali,Teemo,898,412,486,45.88
Akali,Warwick,1028,433,595,42.12
Akali,Veigar,713,343,370,48.11
Akali,Kaisa,983,525,458,53.41
Akali,Yuumi,699,289,410,41.34
Akali,Lucian,329,174,155,52.89
Akali,Swain,690,289,401,41.88
Akali,Singed,174,66,108,37.93
Akali,Galio,510,206,304,40.39
Akali,Smolder,393,192,201,48.85
Akali,Brand,380,158,222,41.58
Akali,Yasuo,1463,749,714,51.2
Akali,Thresh,824,423,401,51.33
Akali,Skarner,239,110,129,46.03
Akali,Aurora,692,354,338,51.16
Akali,Zoe,265,147,118,55.47
Akali,Gragas,386,202,184,52.33
Akali,Rammus,197,82,115,41.62
Akali,Nami,555,272,283,49.01
Akali,Zac,172,101,71,58.72
Akali,Sion,549,253,296,46.08
Akali,Draven,341,150,191,43.99
Akali,Nasus,580,269,311,46.38
Akali,Diana,942,451,491,47.88
Akali,Zilean,133,68,65,51.13
Akali,Camille,216,116,100,53.7
Akali,Azir,210,89,121,42.38
Akali,Braum,269,145,124,53.9
Akali,KSante,288,180,108,62.5
Akali,MonkeyKing,308,143,165,46.43
Akali,Ekko,554,255,299,46.03
Akali,Fiora,282,125,157,44.33
Akali,Kindred,395,202,193,51.14
Akali,Morgana,823,355,468,43.13
Akali,Gwen,398,228,170,57.29
Akali,JarvanIV,250,111,139,44.4
Akali,Kennen,223,115,108,51.57
Akali,Nautilus,630,316,314,50.16
Akali,FiddleSticks,284,115,169,40.49
Akali,Karma,428,225,203,52.57
Akali,Quinn,277,117,160,42.24
Akali,Sivir,326,150,176,46.01
Akali,Gnar,274,147,127,53.65
Akali,AurelionSol,247,83,164,33.6
Akali,Renekton,257,122,135,47.47
Akali,Aphelios,468,197,271,42.09
Akali,TahmKench,633,304,329,48.03
Akali,Malzahar,514,187,327,36.38
Akali,Sett,1052,467,585,44.39
Akali,Vayne,625,261,364,41.76
Akali,Tryndamere,349,203,146,58.17
Akali,Fizz,339,162,177,47.79
Akali,Vladimir,403,204,199,50.62
Akali,Garen,983,475,508,48.32
Akali,Lulu,486,224,262,46.09
Akali,RekSai,83,37,46,44.58
Akali,Pyke,772,428,344,55.44
Akali,Volibear,653,296,357,45.33
Akali,Sona,288,154,134,53.47
Akali,Annie,191,83,108,43.46
Akali,Khazix,350,160,190,45.71
Akali,Orianna,241,119,122,49.38
Akali,Janna,208,83,125,39.9
Akali,Zyra,342,152,190,44.44
Akali,Corki,170,81,89,47.65
Akali,Ziggs,317,137,180,43.22
Akali,Graves,309,189,120,61.17
Akali,TwistedFate,224,149,75,66.52
Akali,Rell,332,155,177,46.69
Akali,Syndra,296,145,151,48.99
Akali,XinZhao,417,168,249,40.29
Akali,Twitch,513,209,304,40.74
Akali,Shaco,656,304,352,46.34
Akali,Varus,505,206,299,40.79
Akali,Zeri,268,146,122,54.48
Akali,Alistar,232,86,146,37.07
Akali,Ryze,176,95,81,53.98
Akali,Kayle,500,229,271,45.8
Akali,Sejuani,232,124,108,53.45
Akali,Kassadin,141,50,91,35.46
Akali,Trundle,336,119,217,35.42
Akali,Xerath,446,207,239,46.41
Akali,Viktor,458,259,199,56.55
Akali,Urgot,255,92,163,36.08
Akali,Poppy,330,141,189,42.73
Akali,Velkoz,409,198,211,48.41
Akali,Rengar,252,161,91,63.89
Akali,Nidalee,133,74,59,55.64
Akali,Shyvana,162,74,88,45.68
Akali,Lissandra,177,122,55,68.93
Akali,Rumble,133,74,59,55.64
Akali,Olaf,150,78,72,52
Akali,Cassiopeia,254,115,139,45.28
Akali,Bard,207,115,92,55.56
Akali,Illaoi,353,146,207,41.36
Akali,Elise,300,161,139,53.67
Akali,KogMaw,164,73,91,44.51
Akali,Shen,352,151,201,42.9
Akali,Taliyah,226,126,100,55.75
Akali,Karthus,178,86,92,48.31
Akali,Kled,148,65,83,43.92
Naafiri,Aatrox,310,194,116,62.58
Naafiri,Sejuani,73,45,28,61.64
Naafiri,Yasuo,538,235,303,43.68
Naafiri,Jinx,617,322,295,52.19
Naafiri,Pyke,375,193,182,51.47
Naafiri,Gnar,114,62,52,54.39
Naafiri,Viego,318,132,186,41.51
Naafiri,Yone,674,273,401,40.5
Naafiri,Kaisa,358,203,155,56.7
Naafiri,TahmKench,321,192,129,59.81
Naafiri,Ryze,67,25,42,37.31
Naafiri,Nunu,247,124,123,50.2
Naafiri,Ahri,354,175,179,49.44
Naafiri,Lucian,153,85,68,55.56
Naafiri,Alistar,78,49,29,62.82
Naafiri,Vayne,260,142,118,54.62
Naafiri,Briar,338,159,179,47.04
Naafiri,Lux,861,497,364,57.72
Naafiri,Mel,594,286,308,48.15
Naafiri,Yuumi,238,126,112,52.94
Naafiri,Irelia,246,118,128,47.97
Naafiri,Nocturne,250,127,123,50.8
Naafiri,Jayce,98,62,36,63.27
Naafiri,Jhin,549,232,317,42.26
Naafiri,Senna,248,111,137,44.76
Naafiri,Sett,476,227,249,47.69
Naafiri,FiddleSticks,156,82,74,52.56
Naafiri,Akali,334,210,124,62.87
Naafiri,Samira,277,136,141,49.1
Naafiri,Neeko,206,92,114,44.66
Naafiri,Kayle,228,115,113,50.44
Naafiri,Katarina,201,116,85,57.71
Naafiri,KSante,89,54,35,60.67
Naafiri,Kayn,432,223,209,51.62
Naafiri,Quinn,118,43,75,36.44
Naafiri,Thresh,304,148,156,48.68
Naafiri,Talon,199,83,116,41.71
Naafiri,LeeSin,289,182,107,62.98
Naafiri,Garen,408,185,223,45.34
Naafiri,Malzahar,287,162,125,56.45
Naafiri,Twitch,250,99,151,39.6
Naafiri,Rakan,140,63,77,45
Naafiri,Yorick,289,122,167,42.21
Naafiri,Volibear,323,144,179,44.58
Naafiri,Blitzcrank,238,129,109,54.2
Naafiri,Shaco,255,139,116,54.51
Naafiri,Darius,603,256,347,42.45
Naafiri,Sylas,312,155,157,49.68
Naafiri,Tristana,208,73,135,35.1
Naafiri,Zoe,150,53,97,35.33
Naafiri,Kassadin,50,32,18,64
Naafiri,Renata,78,28,50,35.9
Naafiri,Gragas,134,83,51,61.94
Naafiri,Karma,157,69,88,43.95
Naafiri,Veigar,316,128,188,40.51
Naafiri,Viktor,175,92,83,52.57
Naafiri,Teemo,339,148,191,43.66
Naafiri,Graves,154,84,70,54.55
Naafiri,Leblanc,138,85,53,61.59
Naafiri,Mordekaiser,463,175,288,37.8
Naafiri,Diana,395,170,225,43.04
Naafiri,Kindred,171,87,84,50.88
Naafiri,Swain,353,118,235,33.43
Naafiri,JarvanIV,132,56,76,42.42
Naafiri,Hwei,153,90,63,58.82
Naafiri,Riven,82,59,23,71.95
Naafiri,Nami,282,114,168,40.43
Naafiri,Xayah,178,77,101,43.26
Naafiri,Evelynn,208,143,65,68.75
Naafiri,Zac,94,44,50,46.81
Naafiri,Renekton,173,110,63,63.58
Naafiri,Caitlyn,709,351,358,49.51
Naafiri,Zilean,69,44,25,63.77
Naafiri,MasterYi,290,146,144,50.34
Naafiri,Azir,103,54,49,52.43
Naafiri,Ezreal,383,212,171,55.35
Naafiri,Velkoz,233,107,126,45.92
Naafiri,Vex,164,80,84,48.78
Naafiri,Bard,101,54,47,53.47
Naafiri,Ekko,206,102,104,49.51
Naafiri,Fiora,108,74,34,68.52
Naafiri,XinZhao,138,60,78,43.48
Naafiri,Draven,122,73,49,59.84
Naafiri,Rammus,71,18,53,25.35
Naafiri,Zeri,91,52,39,57.14
Naafiri,Amumu,248,111,137,44.76
Naafiri,MissFortune,581,283,298,48.71
Naafiri,Morgana,361,169,192,46.81
Naafiri,Syndra,171,94,77,54.97
Naafiri,Lulu,219,107,112,48.86
Naafiri,Belveth,81,34,47,41.98
Naafiri,Soraka,187,87,100,46.52
Naafiri,Ambessa,111,63,48,56.76
Naafiri,Lillia,182,114,68,62.64
Naafiri,Aurora,287,131,156,45.64
Naafiri,Cassiopeia,86,40,46,46.51
Naafiri,Nilah,189,103,86,54.5
Naafiri,Ornn,156,53,103,33.97
Naafiri,Heimerdinger,177,72,105,40.68
Naafiri,Anivia,74,42,32,56.76
Naafiri,Udyr,107,52,55,48.6
Naafiri,Nasus,221,90,131,40.72
Naafiri,Warwick,487,229,258,47.02
Naafiri,Elise,199,115,84,57.79
Naafiri,Jax,205,117,88,57.07
Naafiri,Vladimir,123,77,46,62.6
Naafiri,Nautilus,251,110,141,43.82
Naafiri,Ashe,467,231,236,49.46
Naafiri,Rengar,97,51,46,52.58
Naafiri,Poppy,135,55,80,40.74
Naafiri,Galio,161,70,91,43.48
Naafiri,Ziggs,126,65,61,51.59
Naafiri,Sona,148,65,83,43.92
Naafiri,Aphelios,185,113,72,61.08
Naafiri,Pantheon,427,179,248,41.92
Naafiri,Kennen,142,64,78,45.07
Naafiri,Khazix,147,94,53,63.95
Naafiri,Gwen,208,125,83,60.1
Naafiri,Xerath,155,71,84,45.81
Naafiri,Malphite,203,84,119,41.38
Naafiri,Camille,108,58,50,53.7
Naafiri,Fizz,136,62,74,45.59
Naafiri,Singed,94,41,53,43.62
Naafiri,RekSai,18,9,9,50
Naafiri,AurelionSol,151,81,70,53.64
Naafiri,Milio,162,107,55,66.05
Naafiri,Vi,226,98,128,43.36
Naafiri,Orianna,115,35,80,30.43
Naafiri,Shen,230,97,133,42.17
Naafiri,DrMundo,176,86,90,48.86
Naafiri,Corki,97,67,30,69.07
Naafiri,TwistedFate,98,62,36,63.27
Naafiri,Qiyana,109,55,54,50.46
Naafiri,Illaoi,166,98,68,59.04
Naafiri,Zed,303,173,130,57.1
Naafiri,Chogath,425,214,211,50.35
Naafiri,Braum,127,58,69,45.67
Naafiri,Leona,175,81,94,46.29
Naafiri,MonkeyKing,133,73,60,54.89
Naafiri,Trundle,123,60,63,48.78
Naafiri,Rell,144,99,45,68.75
Naafiri,Tryndamere,196,108,88,55.1
Naafiri,Hecarim,108,64,44,59.26
Naafiri,Seraphine,347,162,185,46.69
Naafiri,Smolder,207,113,94,54.59
Naafiri,Gangplank,123,81,42,65.85
Naafiri,Zyra,192,94,98,48.96
Naafiri,Varus,200,70,130,35
Naafiri,Kalista,115,62,53,53.91
Naafiri,Sion,174,74,100,42.53
Naafiri,Janna,86,43,43,50
Naafiri,Lissandra,71,44,27,61.97
Naafiri,Karthus,80,42,38,52.5
Naafiri,Maokai,108,45,63,41.67
Naafiri,Akshan,131,76,55,58.02
Naafiri,Sivir,126,75,51,59.52
Naafiri,Skarner,120,61,59,50.83
Naafiri,Brand,171,90,81,52.63
Naafiri,Taric,64,45,19,70.31
Naafiri,Olaf,47,29,18,61.7
Naafiri,Shyvana,122,43,79,35.25
Naafiri,Annie,115,52,63,45.22
Naafiri,Rumble,67,45,22,67.16
Naafiri,KogMaw,111,58,53,52.25
Naafiri,Taliyah,74,36,38,48.65
Naafiri,Nidalee,71,42,29,59.15
Naafiri,Kled,69,25,44,36.23
Naafiri,Urgot,106,44,62,41.51
Naafiri,Ivern,50,44,6,88
Senna,Aatrox,489,244,245,49.9
Senna,Sejuani,177,101,76,57.06
Senna,Yasuo,1094,570,524,52.1
Senna,Jinx,1085,528,557,48.66
Senna,Pyke,651,356,295,54.69
Senna,Gwen,353,202,151,57.22
Senna,Talon,348,194,154,55.75
Senna,Yone,1029,621,408,60.35
Senna,MissFortune,1022,507,515,49.61
Senna,Taric,110,44,66,40
Senna,Samira,520,297,223,57.12
Senna,Kayn,715,358,357,50.07
Senna,Sylas,427,181,246,42.39
Senna,Nilah,300,158,142,52.67
Senna,Leona,481,213,268,44.28
Senna,Fiora,211,128,83,60.66
Senna,FiddleSticks,306,162,144,52.94
Senna,Syndra,238,118,120,49.58
Senna,Vayne,535,295,240,55.14
Senna,Morgana,669,365,304,54.56
Senna,Chogath,757,417,340,55.09
Senna,Shaco,593,299,294,50.42
Senna,Ahri,822,414,408,50.36
Senna,Ashe,1008,538,470,53.37
Senna,Poppy,401,226,175,56.36
Senna,Malphite,459,223,236,48.58
Senna,Mel,1237,634,603,51.25
Senna,Soraka,340,185,155,54.41
Senna,Mordekaiser,822,435,387,52.92
Senna,Zed,459,253,206,55.12
Senna,Vex,345,170,175,49.28
Senna,Rakan,347,200,147,57.64
Senna,Viktor,383,201,182,52.48
Senna,Nocturne,490,238,252,48.57
Senna,Bard,189,98,91,51.85
Senna,Gnar,240,127,113,52.92
Senna,Jax,470,217,253,46.17
Senna,Aurora,460,285,175,61.96
Senna,Swain,595,289,306,48.57
Senna,Fizz,238,115,123,48.32
Senna,Tristana,504,269,235,53.37
Senna,Akali,611,328,283,53.68
Senna,Naafiri,248,137,111,55.24
Senna,Kayle,491,243,248,49.49
Senna,Smolder,383,202,181,52.74
Senna,Kalista,210,117,93,55.71
Senna,Gragas,329,195,134,59.27
Senna,Orianna,262,137,125,52.29
Senna,Gangplank,252,152,100,60.32
Senna,Corki,168,66,102,39.29
Senna,Lux,1425,732,693,51.37
Senna,Yorick,525,218,307,41.52
Senna,Ekko,377,199,178,52.79
Senna,Katarina,448,268,180,59.82
Senna,Sion,439,209,230,47.61
Senna,Sett,817,372,445,45.53
Senna,Lissandra,110,65,45,59.09
Senna,Milio,287,135,152,47.04
Senna,Lillia,434,240,194,55.3
Senna,Jhin,866,425,441,49.08
Senna,Janna,137,43,94,31.39
Senna,Olaf,120,78,42,65
Senna,Braum,204,112,92,54.9
Senna,TahmKench,546,272,274,49.82
Senna,Malzahar,452,209,243,46.24
Senna,Blitzcrank,461,263,198,57.05
Senna,Vi,462,308,154,66.67
Senna,Thresh,752,338,414,44.95
Senna,Trundle,278,128,150,46.04
Senna,Aphelios,431,242,189,56.15
Senna,Shen,420,188,232,44.76
Senna,Nunu,497,280,217,56.34
Senna,DrMundo,314,164,150,52.23
Senna,Amumu,573,279,294,48.69
Senna,Irelia,469,229,240,48.83
Senna,Warwick,861,440,421,51.1
Senna,Veigar,648,294,354,45.37
Senna,Nautilus,598,312,286,52.17
Senna,Darius,1114,591,523,53.05
Senna,Karma,360,172,188,47.78
Senna,Diana,643,320,323,49.77
Senna,Twitch,479,234,245,48.85
Senna,Teemo,790,379,411,47.97
Senna,Kaisa,784,431,353,54.97
Senna,Evelynn,236,132,104,55.93
Senna,Velkoz,332,157,175,47.29
Senna,Nasus,425,242,183,56.94
Senna,Neeko,412,202,210,49.03
Senna,Draven,341,145,196,42.52
Senna,Shyvana,155,83,72,53.55
Senna,Galio,369,174,195,47.15
Senna,Caitlyn,1448,717,731,49.52
Senna,Garen,699,337,362,48.21
Senna,Graves,229,112,117,48.91
Senna,Zoe,240,149,91,62.08
Senna,Jayce,227,113,114,49.78
Senna,Ezreal,982,561,421,57.13
Senna,Kindred,327,196,131,59.94
Senna,Yuumi,554,248,306,44.77
Senna,Azir,238,113,125,47.48
Senna,Ivern,114,52,62,45.61
Senna,Anivia,163,85,78,52.15
Senna,Hecarim,185,91,94,49.19
Senna,Khazix,315,146,169,46.35
Senna,Sivir,227,90,137,39.65
Senna,Seraphine,563,296,267,52.58
Senna,MonkeyKing,291,126,165,43.3
Senna,Vladimir,238,111,127,46.64
Senna,Varus,414,214,200,51.69
Senna,Urgot,301,168,133,55.81
Senna,MasterYi,517,283,234,54.74
Senna,Renekton,282,123,159,43.62
Senna,Renata,176,97,79,55.11
Senna,Karthus,131,59,72,45.04
Senna,Lucian,283,157,126,55.48
Senna,Nami,556,247,309,44.42
Senna,Volibear,610,242,368,39.67
Senna,Lulu,450,205,245,45.56
Senna,Brand,411,245,166,59.61
Senna,Ryze,154,69,85,44.81
Senna,Zac,159,82,77,51.57
Senna,Ziggs,242,106,136,43.8
Senna,Viego,644,329,315,51.09
Senna,Alistar,163,81,82,49.69
Senna,Rammus,195,63,132,32.31
Senna,Nidalee,142,84,58,59.15
Senna,Kled,85,30,55,35.29
Senna,Udyr,178,86,92,48.31
Senna,Xerath,382,173,209,45.29
Senna,Ornn,270,154,116,57.04
Senna,Singed,199,95,104,47.74
Senna,Kassadin,109,55,54,50.46
Senna,Tryndamere,305,156,149,51.15
Senna,Riven,266,137,129,51.5
Senna,Rell,271,137,134,50.55
Senna,Briar,541,268,273,49.54
Senna,LeeSin,487,267,220,54.83
Senna,Pantheon,832,407,425,48.92
Senna,Camille,139,93,46,66.91
Senna,Ambessa,287,161,126,56.1
Senna,Skarner,141,94,47,66.67
Senna,Hwei,375,221,154,58.93
Senna,Heimerdinger,226,112,114,49.56
Senna,Rengar,173,88,85,50.87
Senna,Sona,238,124,114,52.1
Senna,KSante,174,116,58,66.67
Senna,Xayah,364,186,178,51.1
Senna,Kennen,198,102,96,51.52
Senna,Leblanc,175,72,103,41.14
Senna,Elise,356,173,183,48.6
Senna,XinZhao,304,167,137,54.93
Senna,Quinn,171,76,95,44.44
Senna,Qiyana,276,170,106,61.59
Senna,Annie,137,83,54,60.58
Senna,RekSai,66,48,18,72.73
Senna,Cassiopeia,215,106,109,49.3
Senna,Zyra,421,205,216,48.69
Senna,Maokai,281,119,162,42.35
Senna,Illaoi,250,105,145,42
Senna,Akshan,249,160,89,64.26
Senna,AurelionSol,299,163,136,54.52
Senna,KogMaw,190,96,94,50.53
Senna,JarvanIV,207,90,117,43.48
Senna,Zilean,131,93,38,70.99
Senna,TwistedFate,171,77,94,45.03
Senna,Zeri,274,149,125,54.38
Senna,Belveth,158,88,70,55.7
Senna,Taliyah,190,98,92,51.58
Senna,Rumble,100,57,43,57
Galio,Gnar,182,94,88,51.65
Galio,Jax,364,216,148,59.34
Galio,Yasuo,901,463,438,51.39
Galio,Caitlyn,911,402,509,44.13
Galio,Neeko,308,201,107,65.26
Galio,Teemo,533,277,256,51.97
Galio,TahmKench,453,271,182,59.82
Galio,Jinx,862,398,464,46.17
Galio,Zoe,225,122,103,54.22
Galio,Nami,371,224,147,60.38
Galio,Irelia,369,169,200,45.8
Galio,Pantheon,703,385,318,54.77
Galio,Kassadin,112,64,48,57.14
Galio,Jhin,744,409,335,54.97
Galio,Yuumi,384,214,170,55.73
Galio,Shaco,380,215,165,56.58
Galio,Leblanc,271,171,100,63.1
Galio,Ezreal,787,434,353,55.15
Galio,Thresh,548,277,271,50.55
Galio,Darius,834,412,422,49.4
Galio,Viego,570,314,256,55.09
Galio,AurelionSol,243,153,90,62.96
Galio,MissFortune,819,446,373,54.46
Galio,Nautilus,557,289,268,51.89
Galio,Gwen,332,170,162,51.2
Galio,Mel,1131,620,511,54.82
Galio,Tristana,352,200,152,56.82
Galio,Poppy,284,156,128,54.93
Galio,Kayle,305,173,132,56.72
Galio,Kayn,659,358,301,54.32
Galio,Akali,510,304,206,59.61
Galio,Soraka,277,139,138,50.18
Galio,Fiora,272,178,94,65.44
Galio,Amumu,414,198,216,47.83
Galio,Vladimir,206,99,107,48.06
Galio,Varus,323,160,163,49.54
Galio,Janna,133,73,60,54.89
Galio,Warwick,708,369,339,52.12
Galio,Sejuani,125,55,70,44
Galio,Ahri,600,342,258,57
Galio,Lux,1116,570,546,51.08
Galio,Singed,147,74,73,50.34
Galio,Vayne,384,187,197,48.7
Galio,Leona,366,194,172,53.01
Galio,Volibear,422,234,188,55.45
Galio,Rammus,168,84,84,50
Galio,Aurora,546,322,224,58.97
Galio,Ashe,722,380,342,52.63
Galio,Sylas,562,284,278,50.53
Galio,FiddleSticks,188,101,87,53.72
Galio,Aphelios,259,153,106,59.07
Galio,Morgana,610,284,326,46.56
Galio,Trundle,229,88,141,38.43
Galio,XinZhao,253,117,136,46.25
Galio,Mordekaiser,750,373,377,49.73
Galio,Samira,305,156,149,51.15
Galio,Shen,281,133,148,47.33
Galio,Ekko,371,193,178,52.02
Galio,Qiyana,111,57,54,51.35
Galio,Twitch,308,155,153,50.32
Galio,Senna,369,195,174,52.85
Galio,Talon,237,135,102,56.96
Galio,Chogath,529,247,282,46.69
Galio,MasterYi,447,225,222,50.34
Galio,Zed,376,239,137,63.56
Galio,Aatrox,371,196,175,52.83
Galio,Pyke,467,218,249,46.68
Galio,Malphite,390,210,180,53.85
Galio,Yone,853,460,393,53.93
Galio,Lulu,390,178,212,45.64
Galio,Skarner,163,106,57,65.03
Galio,Zilean,130,58,72,44.62
Galio,Viktor,287,144,143,50.17
Galio,Kindred,230,106,124,46.09
Galio,Lucian,252,176,76,69.84
Galio,Sion,356,207,149,58.15
Galio,Diana,578,316,262,54.67
Galio,Orianna,188,123,65,65.43
Galio,Kaisa,634,364,270,57.41
Galio,Khazix,246,152,94,61.79
Galio,Rell,243,170,73,69.96
Galio,Seraphine,482,240,242,49.79
Galio,Rengar,189,123,66,65.08
Galio,Hwei,380,218,162,57.37
Galio,Katarina,417,255,162,61.15
Galio,Velkoz,246,113,133,45.93
Galio,Camille,144,85,59,59.03
Galio,Braum,182,122,60,67.03
Galio,Xayah,337,144,193,42.73
Galio,Rakan,229,126,103,55.02
Galio,Briar,529,215,314,40.64
Galio,Heimerdinger,241,140,101,58.09
Galio,Zyra,288,167,121,57.99
Galio,Fizz,274,152,122,55.47
Galio,Sivir,245,115,130,46.94
Galio,Xerath,243,138,105,56.79
Galio,Kennen,135,89,46,65.93
Galio,TwistedFate,143,82,61,57.34
Galio,Nocturne,411,191,220,46.47
Galio,Annie,124,93,31,75
Galio,Swain,573,290,283,50.61
Galio,Shyvana,147,72,75,48.98
Galio,Belveth,95,50,45,52.63
Galio,Smolder,399,246,153,61.65
Galio,Sett,738,402,336,54.47
Galio,Garen,674,349,325,51.78
Galio,Yorick,428,174,254,40.65
Galio,Vex,231,153,78,66.23
Galio,Karma,280,136,144,48.57
Galio,Gragas,304,202,102,66.45
Galio,Nunu,314,170,144,54.14
Galio,Sona,141,65,76,46.1
Galio,Lillia,281,190,91,67.62
Galio,Ziggs,224,130,94,58.04
Galio,Nasus,337,197,140,58.46
Galio,Naafiri,161,91,70,56.52
Galio,Syndra,196,91,105,46.43
Galio,Blitzcrank,258,132,126,51.16
Galio,LeeSin,437,261,176,59.73
Galio,Ambessa,230,150,80,65.22
Galio,Brand,382,179,203,46.86
Galio,Azir,154,66,88,42.86
Galio,KogMaw,213,129,84,60.56
Galio,Nidalee,142,74,68,52.11
Galio,Evelynn,244,158,86,64.75
Galio,Riven,188,100,88,53.19
Galio,Vi,417,256,161,61.39
Galio,Veigar,495,221,274,44.65
Galio,Jayce,159,81,78,50.94
Galio,Illaoi,197,73,124,37.06
Galio,Malzahar,385,168,217,43.64
Galio,Anivia,140,84,56,60
Galio,Draven,303,177,126,58.42
Galio,Alistar,108,71,37,65.74
Galio,RekSai,65,33,32,50.77
Galio,Taliyah,120,60,60,50
Galio,Renekton,192,101,91,52.6
Galio,Milio,222,98,124,44.14
Galio,Olaf,104,33,71,31.73
Galio,Tryndamere,233,144,89,61.8
Galio,Nilah,238,146,92,61.34
Galio,Gangplank,180,104,76,57.78
Galio,Graves,242,110,132,45.45
Galio,Elise,268,160,108,59.7
Galio,Cassiopeia,172,60,112,34.88
Galio,Corki,180,101,79,56.11
Galio,KSante,180,96,84,53.33
Galio,Zeri,253,145,108,57.31
Galio,Zac,125,49,76,39.2
Galio,Ryze,123,42,81,34.15
Galio,DrMundo,288,130,158,45.14
Galio,Hecarim,138,99,39,71.74
Galio,JarvanIV,182,97,85,53.3
Galio,Quinn,170,101,69,59.41
Galio,Akshan,151,85,66,56.29
Galio,Karthus,100,69,31,69
Galio,Maokai,120,56,64,46.67
Galio,Ivern,98,55,43,56.12
Galio,Bard,149,81,68,54.36
Galio,Ornn,198,101,97,51.01
Galio,Lissandra,106,63,43,59.43
Galio,Kalista,241,130,111,53.94
Galio,MonkeyKing,180,116,64,64.44
Galio,Renata,85,36,49,42.35
Galio,Udyr,188,123,65,65.43
Galio,Urgot,141,71,70,50.35
Galio,Taric,115,53,62,46.09
Galio,Kled,70,29,41,41.43
Galio,Rumble,108,59,49,54.63
Gnar,Irelia,292,130,162,44.52
Gnar,Zed,255,138,117,54.12
Gnar,Galio,182,88,94,48.35
Gnar,MissFortune,566,270,296,47.7
Gnar,TahmKench,351,161,190,45.87
Gnar,Naafiri,114,52,62,45.61
Gnar,Nunu,176,88,88,50
Gnar,Malzahar,211,90,121,42.65
Gnar,Zeri,118,48,70,40.68
Gnar,Mordekaiser,322,139,183,43.17
Gnar,Volibear,254,117,137,46.06
Gnar,Mel,628,288,340,45.86
Gnar,Ashe,388,201,187,51.8
Gnar,Neeko,165,82,83,49.7
Gnar,Amumu,243,75,168,30.86
Gnar,Pyke,246,124,122,50.41
Gnar,Varus,243,109,134,44.86
Gnar,Thresh,350,197,153,56.29
Gnar,Sett,480,231,249,48.13
Gnar,Warwick,412,178,234,43.2
Gnar,Brand,187,67,120,35.83
Gnar,Twitch,228,101,127,44.3
Gnar,Morgana,321,149,172,46.42
Gnar,Tryndamere,160,76,84,47.5
Gnar,Sylas,285,103,182,36.14
Gnar,Taliyah,95,41,54,43.16
Gnar,Jhin,474,211,263,44.51
Gnar,Senna,240,113,127,47.08
Gnar,Darius,453,199,254,43.93
Gnar,Kindred,164,83,81,50.61
Gnar,Veigar,233,126,107,54.08
Gnar,Corki,109,31,78,28.44
Gnar,Pantheon,468,189,279,40.38
Gnar,Camille,66,24,42,36.36
Gnar,LeeSin,212,98,114,46.23
Gnar,Draven,120,41,79,34.17
Gnar,Sion,222,94,128,42.34
Gnar,Zac,114,83,31,72.81
Gnar,AurelionSol,145,49,96,33.79
Gnar,Lux,633,317,316,50.08
Gnar,Teemo,373,148,225,39.68
Gnar,Evelynn,165,73,92,44.24
Gnar,Ezreal,474,171,303,36.08
Gnar,Seraphine,236,118,118,50
Gnar,Gangplank,131,53,78,40.46
Gnar,MasterYi,245,125,120,51.02
Gnar,Yone,483,240,243,49.69
Gnar,Swain,245,68,177,27.76
Gnar,Gwen,126,72,54,57.14
Gnar,RekSai,49,30,19,61.22
Gnar,Kaisa,314,179,135,57.01
Gnar,Leona,209,88,121,42.11
Gnar,Leblanc,110,49,61,44.55
Gnar,Aatrox,280,112,168,40
Gnar,Trundle,112,54,58,48.21
Gnar,Caitlyn,661,357,304,54.01
Gnar,Lucian,132,64,68,48.48
Gnar,Karthus,98,63,35,64.29
Gnar,Kayn,323,151,172,46.75
Gnar,Akali,274,127,147,46.35
Gnar,Sivir,98,60,38,61.22
Gnar,Hwei,199,80,119,40.2
Gnar,Poppy,142,65,77,45.77
Gnar,Kayle,98,17,81,17.35
Gnar,Fizz,103,61,42,59.22
Gnar,Jinx,591,276,315,46.7
Gnar,Milio,139,34,105,24.46
Gnar,Rengar,105,61,44,58.1
Gnar,KogMaw,51,26,25,50.98
Gnar,Zoe,141,85,56,60.28
Gnar,Gragas,145,64,81,44.14
Gnar,Xayah,196,105,91,53.57
Gnar,Tristana,217,92,125,42.4
Gnar,Sona,105,57,48,54.29
Gnar,Nocturne,200,107,93,53.5
Gnar,Velkoz,178,60,118,33.71
Gnar,Karma,138,35,103,25.36
Gnar,Smolder,221,118,103,53.39
Gnar,Syndra,131,66,65,50.38
Gnar,Vi,257,104,153,40.47
Gnar,Nautilus,292,171,121,58.56
Gnar,Shaco,202,68,134,33.66
Gnar,Katarina,246,112,134,45.53
Gnar,Nami,249,105,144,42.17
Gnar,Yasuo,507,247,260,48.72
Gnar,Lillia,147,47,100,31.97
Gnar,Malphite,346,147,199,42.49
Gnar,Rakan,122,62,60,50.82
Gnar,Rell,113,48,65,42.48
Gnar,Garen,328,178,150,54.27
Gnar,Lulu,209,118,91,56.46
Gnar,Aphelios,113,52,61,46.02
Gnar,Azir,123,60,63,48.78
Gnar,Kennen,114,56,58,49.12
Gnar,Aurora,210,114,96,54.29
Gnar,XinZhao,154,57,97,37.01
Gnar,Viktor,178,106,72,59.55
Gnar,Kassadin,80,44,36,55
Gnar,Viego,328,120,208,36.59
Gnar,Alistar,109,55,54,50.46
Gnar,Shen,184,78,106,42.39
Gnar,Maokai,76,48,28,63.16
Gnar,Nasus,212,121,91,57.08
Gnar,Talon,135,64,71,47.41
Gnar,Cassiopeia,126,48,78,38.1
Gnar,Vladimir,133,40,93,30.08
Gnar,Khazix,183,88,95,48.09
Gnar,Yuumi,242,124,118,51.24
Gnar,Sejuani,84,42,42,50
Gnar,Annie,104,72,32,69.23
Gnar,Lissandra,48,16,32,33.33
Gnar,Ivern,52,24,28,46.15
Gnar,Ambessa,186,85,101,45.7
Gnar,Zyra,175,81,94,46.29
Gnar,Illaoi,121,67,54,55.37
Gnar,Ekko,179,70,109,39.11
Gnar,Ahri,347,166,181,47.84
Gnar,Samira,222,84,138,37.84
Gnar,Renekton,127,64,63,50.39
Gnar,Rammus,79,19,60,24.05
Gnar,Qiyana,79,55,24,69.62
Gnar,Udyr,80,40,40,50
Gnar,Soraka,127,57,70,44.88
Gnar,DrMundo,155,70,85,45.16
Gnar,Blitzcrank,196,115,81,58.67
Gnar,Jax,131,75,56,57.25
Gnar,Quinn,81,33,48,40.74
Gnar,Xerath,137,39,98,28.47
Gnar,Vayne,226,84,142,37.17
Gnar,KSante,90,57,33,63.33
Gnar,Diana,310,115,195,37.1
Gnar,Bard,33,30,3,90.91
Gnar,Yorick,262,92,170,35.11
Gnar,Skarner,122,63,59,51.64
Gnar,Nilah,143,67,76,46.85
Gnar,JarvanIV,106,58,48,54.72
Gnar,Riven,97,51,46,52.58
Gnar,Graves,147,77,70,52.38
Gnar,Braum,109,51,58,46.79
Gnar,Renata,97,51,46,52.58
Gnar,Ziggs,93,15,78,16.13
Gnar,Janna,120,48,72,40
Gnar,Fiora,72,46,26,63.89
Gnar,FiddleSticks,142,69,73,48.59
Gnar,Chogath,354,191,163,53.95
Gnar,Ornn,130,42,88,32.31
Gnar,Vex,162,77,85,47.53
Gnar,Heimerdinger,124,61,63,49.19
Gnar,MonkeyKing,90,49,41,54.44
Gnar,Singed,73,22,51,30.14
Gnar,Jayce,142,79,63,55.63
Gnar,Shyvana,85,41,44,48.24
Gnar,Elise,137,43,94,31.39
Gnar,Briar,261,123,138,47.13
Gnar,Urgot,131,46,85,35.11
Gnar,Olaf,57,37,20,64.91
Gnar,Orianna,63,24,39,38.1
Gnar,Zilean,57,23,34,40.35
Gnar,Hecarim,68,38,30,55.88
Gnar,Kled,56,29,27,51.79
Gnar,Kalista,108,40,68,37.04
Gnar,Ryze,59,36,23,61.02
Gnar,Belveth,51,29,22,56.86
Gnar,Rumble,53,18,35,33.96
Gnar,Taric,69,28,41,40.58
Gnar,TwistedFate,104,48,56,46.15
Gnar,Anivia,115,50,65,43.48
Gnar,Akshan,68,32,36,47.06
Gnar,Nidalee,53,27,26,50.94
Riven,Gangplank,137,63,74,45.99
Riven,Ivern,87,51,36,58.62
Riven,Mel,709,304,405,42.88
Riven,Jhin,555,238,317,42.88
Riven,Swain,340,144,196,42.35
Riven,Urgot,148,57,91,38.51
Riven,Kayn,403,173,230,42.93
Riven,Yasuo,564,258,306,45.74
Riven,Twitch,243,97,146,39.92
Riven,Neeko,193,90,103,46.63
Riven,Gragas,157,74,83,47.13
Riven,Gwen,244,107,137,43.85
Riven,Zeri,128,51,77,39.84
Riven,Bard,74,28,46,37.84
Riven,Shen,176,73,103,41.48
Riven,Yone,529,273,256,51.61
Riven,Ashe,515,185,330,35.92
Riven,Alistar,95,40,55,42.11
Riven,XinZhao,184,74,110,40.22
Riven,Lucian,203,107,96,52.71
Riven,Velkoz,170,89,81,52.35
Riven,Evelynn,192,85,107,44.27
Riven,Irelia,200,69,131,34.5
Riven,Tristana,266,102,164,38.35
Riven,Lux,742,316,426,42.59
Riven,Azir,73,31,42,42.47
Riven,Sejuani,79,48,31,60.76
Riven,Sylas,279,146,133,52.33
Riven,Seraphine,286,129,157,45.1
Riven,Mordekaiser,440,177,263,40.23
Riven,Morgana,320,142,178,44.38
Riven,Braum,111,47,64,42.34
Riven,Aurora,239,95,144,39.75
Riven,FiddleSticks,202,92,110,45.54
Riven,Vex,148,71,77,47.97
Riven,Sett,483,223,260,46.17
Riven,Akali,281,99,182,35.23
Riven,Samira,345,182,163,52.75
Riven,Udyr,85,25,60,29.41
Riven,Orianna,110,68,42,61.82
Riven,Nautilus,287,119,168,41.46
Riven,Yorick,232,106,126,45.69
Riven,MasterYi,253,117,136,46.25
Riven,Nami,268,78,190,29.1
Riven,Garen,480,136,344,28.33
Riven,Zed,308,145,163,47.08
Riven,Caitlyn,637,227,410,35.64
Riven,Soraka,146,64,82,43.84
Riven,TahmKench,232,99,133,42.67
Riven,Malzahar,137,48,89,35.04
Riven,MissFortune,485,183,302,37.73
Riven,Blitzcrank,202,83,119,41.09
Riven,LeeSin,241,130,111,53.94
Riven,Ahri,311,125,186,40.19
Riven,Darius,595,226,369,37.98
Riven,Vladimir,172,53,119,30.81
Riven,Kindred,119,67,52,56.3
Riven,Sona,127,54,73,42.52
Riven,Khazix,207,94,113,45.41
Riven,Katarina,226,124,102,54.87
Riven,Aphelios,153,68,85,44.44
Riven,Lulu,209,79,130,37.8
Riven,Briar,245,101,144,41.22
Riven,Corki,111,44,67,39.64
Riven,Pantheon,453,143,310,31.57
Riven,Warwick,349,148,201,42.41
Riven,Heimerdinger,126,74,52,58.73
Riven,Anivia,125,55,70,44
Riven,Viego,373,159,214,42.63
Riven,Jax,171,78,93,45.61
Riven,Xayah,185,83,102,44.86
Riven,Fiora,171,78,93,45.61
Riven,Ezreal,441,216,225,48.98
Riven,Akshan,83,41,42,49.4
Riven,Syndra,178,65,113,36.52
Riven,Xerath,150,70,80,46.67
Riven,Karma,217,103,114,47.47
Riven,Rengar,144,62,82,43.06
Riven,Naafiri,82,23,59,28.05
Riven,DrMundo,129,50,79,38.76
Riven,Jinx,525,202,323,38.48
Riven,Ekko,343,143,200,41.69
Riven,Rakan,122,76,46,62.3
Riven,Diana,389,173,216,44.47
Riven,Chogath,335,137,198,40.9
Riven,Nunu,226,94,132,41.59
Riven,Viktor,163,60,103,36.81
Riven,Poppy,188,59,129,31.38
Riven,Zac,111,51,60,45.95
Riven,Kaisa,404,227,177,56.19
Riven,Leblanc,111,66,45,59.46
Riven,Renekton,172,56,116,32.56
Riven,Rammus,115,51,64,44.35
Riven,Brand,124,57,67,45.97
Riven,Hecarim,116,42,74,36.21
Riven,Camille,111,54,57,48.65
Riven,Rell,161,64,97,39.75
Riven,JarvanIV,91,33,58,36.26
Riven,Zilean,87,46,41,52.87
Riven,KSante,94,36,58,38.3
Riven,Trundle,141,52,89,36.88
Riven,Kassadin,49,20,29,40.82
Riven,Milio,174,67,107,38.51
Riven,Nidalee,78,46,32,58.97
Riven,Pyke,295,100,195,33.9
Riven,Teemo,370,161,209,43.51
Riven,Senna,266,129,137,48.5
Riven,Amumu,247,107,140,43.32
Riven,Qiyana,73,54,19,73.97
Riven,Zoe,125,50,75,40
Riven,Kled,54,20,34,37.04
Riven,Draven,140,69,71,49.29
Riven,Volibear,278,123,155,44.24
Riven,Yuumi,207,64,143,30.92
Riven,Annie,115,44,71,38.26
Riven,Nilah,150,50,100,33.33
Riven,Aatrox,279,147,132,52.69
Riven,Shaco,263,115,148,43.73
Riven,Thresh,400,151,249,37.75
Riven,Kennen,117,72,45,61.54
Riven,Ryze,49,19,30,38.78
Riven,Taric,80,22,58,27.5
Riven,Malphite,262,70,192,26.72
Riven,Ambessa,204,121,83,59.31
Riven,Singed,74,15,59,20.27
Riven,Renata,92,29,63,31.52
Riven,Vi,240,103,137,42.92
Riven,Ziggs,161,73,88,45.34
Riven,Veigar,274,96,178,35.04
Riven,Graves,149,75,74,50.34
Riven,Cassiopeia,107,40,67,37.38
Riven,Maokai,126,34,92,26.98
Riven,Vayne,240,118,122,49.17
Riven,Zyra,165,56,109,33.94
Riven,Illaoi,139,38,101,27.34
Riven,Galio,188,88,100,46.81
Riven,Tryndamere,157,72,85,45.86
Riven,Lillia,149,57,92,38.26
Riven,Leona,138,53,85,38.41
Riven,Sion,278,97,181,34.89
Riven,Skarner,91,41,50,45.05
Riven,Lissandra,59,29,30,49.15
Riven,Karthus,74,24,50,32.43
Riven,Gnar,97,46,51,47.42
Riven,MonkeyKing,135,51,84,37.78
Riven,Sivir,113,45,68,39.82
Riven,Varus,143,88,55,61.54
Riven,Shyvana,54,24,30,44.44
Riven,Smolder,203,100,103,49.26
Riven,Hwei,183,78,105,42.62
Riven,Kalista,119,43,76,36.13
Riven,Nasus,254,99,155,38.98
Riven,Nocturne,166,79,87,47.59
Riven,Elise,164,89,75,54.27
Riven,Kayle,134,52,82,38.81
Riven,Fizz,140,43,97,30.71
Riven,TwistedFate,94,41,53,43.62
Riven,KogMaw,72,35,37,48.61
Riven,AurelionSol,81,30,51,37.04
Riven,Taliyah,90,31,59,34.44
Riven,Olaf,54,27,27,50
Riven,Jayce,126,63,63,50
Riven,Ornn,116,22,94,18.97
Riven,Talon,183,109,74,59.56
Riven,Belveth,62,22,40,35.48
Riven,Janna,93,26,67,27.96
Riven,Quinn,102,58,44,56.86
Riven,RekSai,50,13,37,26
Riven,Rumble,72,27,45,37.5
AurelionSol,Heimerdinger,187,109,78,58.29
AurelionSol,Warwick,405,256,149,63.21
AurelionSol,Neeko,225,137,88,60.89
AurelionSol,Draven,126,81,45,64.29
AurelionSol,Leona,225,138,87,61.33
AurelionSol,Talon,161,98,63,60.87
AurelionSol,Ahri,411,210,201,51.09
AurelionSol,Kalista,163,119,44,73.01
AurelionSol,Brand,190,116,74,61.05
AurelionSol,Braum,146,66,80,45.21
AurelionSol,XinZhao,97,60,37,61.86
AurelionSol,Lux,888,502,386,56.53
AurelionSol,Chogath,421,235,186,55.82
AurelionSol,Taliyah,86,63,23,73.26
AurelionSol,Poppy,190,108,82,56.84
AurelionSol,Diana,372,211,161,56.72
AurelionSol,Anivia,100,55,45,55
AurelionSol,Caitlyn,717,379,338,52.86
AurelionSol,Thresh,382,171,211,44.76
AurelionSol,Fiora,138,84,54,60.87
AurelionSol,Yone,521,270,251,51.82
AurelionSol,Galio,243,90,153,37.04
AurelionSol,Ezreal,457,254,203,55.58
AurelionSol,Tristana,285,129,156,45.26
AurelionSol,Veigar,369,197,172,53.39
AurelionSol,Ziggs,149,50,99,33.56
AurelionSol,KSante,91,47,44,51.65
AurelionSol,Udyr,116,78,38,67.24
AurelionSol,Ashe,439,241,198,54.9
AurelionSol,Nautilus,329,170,159,51.67
AurelionSol,Aurora,255,145,110,56.86
AurelionSol,FiddleSticks,124,72,52,58.06
AurelionSol,Yasuo,531,237,294,44.63
AurelionSol,Jhin,467,220,247,47.11
AurelionSol,Vex,120,64,56,53.33
AurelionSol,Gnar,145,96,49,66.21
AurelionSol,Volibear,241,165,76,68.46
AurelionSol,Mel,784,384,400,48.98
AurelionSol,Samira,254,112,142,44.09
AurelionSol,Seraphine,349,173,176,49.57
AurelionSol,Pantheon,439,221,218,50.34
AurelionSol,Kindred,134,63,71,47.01
AurelionSol,Teemo,420,171,249,40.71
AurelionSol,Lucian,210,134,76,63.81
AurelionSol,Zyra,194,101,93,52.06
AurelionSol,Khazix,144,71,73,49.31
AurelionSol,Varus,205,93,112,45.37
AurelionSol,Yuumi,233,138,95,59.23
AurelionSol,TahmKench,335,197,138,58.81
AurelionSol,Nocturne,268,138,130,51.49
AurelionSol,Qiyana,91,46,45,50.55
AurelionSol,Sett,461,254,207,55.1
AurelionSol,Briar,336,221,115,65.77
AurelionSol,Nilah,150,75,75,50
AurelionSol,Morgana,283,142,141,50.18
AurelionSol,Kayn,370,189,181,51.08
AurelionSol,Akali,247,164,83,66.4
AurelionSol,Sivir,127,51,76,40.16
AurelionSol,Hwei,229,110,119,48.03
AurelionSol,Urgot,135,51,84,37.78
AurelionSol,Sylas,231,123,108,53.25
AurelionSol,Zed,251,128,123,51
AurelionSol,Rakan,118,63,55,53.39
AurelionSol,Zoe,141,74,67,52.48
AurelionSol,Nunu,216,119,97,55.09
AurelionSol,Katarina,181,101,80,55.8
AurelionSol,Pyke,366,227,139,62.02
AurelionSol,Ekko,159,77,82,48.43
AurelionSol,Shaco,303,185,118,61.06
AurelionSol,Velkoz,193,89,104,46.11
AurelionSol,Darius,522,258,264,49.43
AurelionSol,Jax,266,147,119,55.26
AurelionSol,MissFortune,738,440,298,59.62
AurelionSol,Illaoi,143,48,95,33.57
AurelionSol,Ryze,92,43,49,46.74
AurelionSol,Blitzcrank,217,122,95,56.22
AurelionSol,Yorick,267,130,137,48.69
AurelionSol,Viego,345,137,208,39.71
AurelionSol,Vi,293,156,137,53.24
AurelionSol,Singed,107,64,43,59.81
AurelionSol,Gwen,197,124,73,62.94
AurelionSol,Amumu,333,139,194,41.74
AurelionSol,Garen,408,200,208,49.02
AurelionSol,Jinx,574,289,285,50.35
AurelionSol,Nami,260,131,129,50.38
AurelionSol,Mordekaiser,444,204,240,45.95
AurelionSol,Rengar,127,84,43,66.14
AurelionSol,Hecarim,129,63,66,48.84
AurelionSol,Twitch,230,115,115,50
AurelionSol,DrMundo,179,92,87,51.4
AurelionSol,Graves,169,94,75,55.62
AurelionSol,Zac,131,89,42,67.94
AurelionSol,Irelia,226,146,80,64.6
AurelionSol,Alistar,93,52,41,55.91
AurelionSol,Evelynn,184,130,54,70.65
AurelionSol,Syndra,202,120,82,59.41
AurelionSol,Kled,69,45,24,65.22
AurelionSol,Lillia,196,74,122,37.76
AurelionSol,MonkeyKing,142,60,82,42.25
AurelionSol,Elise,226,146,80,64.6
AurelionSol,Kayle,231,115,116,49.78
AurelionSol,Vladimir,133,64,69,48.12
AurelionSol,Malphite,192,69,123,35.94
AurelionSol,Kassadin,35,23,12,65.71
AurelionSol,Sion,238,109,129,45.8
AurelionSol,Leblanc,76,45,31,59.21
AurelionSol,LeeSin,324,186,138,57.41
AurelionSol,MasterYi,299,167,132,55.85
AurelionSol,Kaisa,453,258,195,56.95
AurelionSol,Vayne,290,148,142,51.03
AurelionSol,Nidalee,93,45,48,48.39
AurelionSol,Aphelios,158,78,80,49.37
AurelionSol,Xerath,159,99,60,62.26
AurelionSol,Soraka,210,125,85,59.52
AurelionSol,Jayce,185,97,88,52.43
AurelionSol,Milio,105,41,64,39.05
AurelionSol,Shen,200,121,79,60.5
AurelionSol,Naafiri,151,70,81,46.36
AurelionSol,Zeri,136,77,59,56.62
AurelionSol,TwistedFate,99,52,47,52.53
AurelionSol,Sona,97,33,64,34.02
AurelionSol,Malzahar,310,158,152,50.97
AurelionSol,Aatrox,282,182,100,64.54
AurelionSol,Karthus,86,32,54,37.21
AurelionSol,JarvanIV,130,73,57,56.15
AurelionSol,Bard,84,51,33,60.71
AurelionSol,Swain,282,165,117,58.51
AurelionSol,KogMaw,113,49,64,43.36
AurelionSol,Senna,299,136,163,45.48
AurelionSol,Rell,214,136,78,63.55
AurelionSol,Xayah,142,100,42,70.42
AurelionSol,Nasus,253,132,121,52.17
AurelionSol,Akshan,103,49,54,47.57
AurelionSol,Lulu,240,96,144,40
AurelionSol,Cassiopeia,101,44,57,43.56
AurelionSol,Camille,84,49,35,58.33
AurelionSol,Azir,76,56,20,73.68
AurelionSol,Smolder,188,104,84,55.32
AurelionSol,Riven,81,51,30,62.96
AurelionSol,Zilean,70,39,31,55.71
AurelionSol,Skarner,79,31,48,39.24
AurelionSol,Kennen,101,55,46,54.46
AurelionSol,Orianna,155,84,71,54.19
AurelionSol,Belveth,63,29,34,46.03
AurelionSol,Fizz,167,86,81,51.5
AurelionSol,Tryndamere,186,104,82,55.91
AurelionSol,Quinn,88,61,27,69.32
AurelionSol,Viktor,204,100,104,49.02
AurelionSol,Rammus,83,41,42,49.4
AurelionSol,Karma,132,91,41,68.94
AurelionSol,Sejuani,96,39,57,40.63
AurelionSol,Corki,92,69,23,75
AurelionSol,Trundle,187,100,87,53.48
AurelionSol,Gragas,149,98,51,65.77
AurelionSol,Ambessa,176,97,79,55.11
AurelionSol,Ivern,81,52,29,64.2
AurelionSol,Gangplank,110,76,34,69.09
AurelionSol,Annie,93,68,25,73.12
AurelionSol,Lissandra,94,47,47,50
AurelionSol,Maokai,135,61,74,45.19
AurelionSol,Ornn,121,60,61,49.59
AurelionSol,Taric,74,64,10,86.49
AurelionSol,Janna,67,45,22,67.16
AurelionSol,Renata,52,34,18,65.38
AurelionSol,Rumble,53,14,39,26.42
AurelionSol,Olaf,72,38,34,52.78
AurelionSol,Shyvana,87,29,58,33.33
AurelionSol,Renekton,124,52,72,41.94
AurelionSol,RekSai,39,16,23,41.03
Heimerdinger,Yone,674,380,294,56.38
Heimerdinger,Shaco,338,209,129,61.83
Heimerdinger,AurelionSol,187,78,109,41.71
Heimerdinger,Ashe,598,269,329,44.98
Heimerdinger,Velkoz,155,89,66,57.42
Heimerdinger,Yorick,352,160,192,45.45
Heimerdinger,Kayn,528,284,244,53.79
Heimerdinger,Singed,123,43,80,34.96
Heimerdinger,Udyr,106,50,56,47.17
Heimerdinger,Mordekaiser,589,320,269,54.33
Heimerdinger,Briar,306,122,184,39.87
Heimerdinger,Zed,288,158,130,54.86
Heimerdinger,Jinx,732,346,386,47.27
Heimerdinger,Lillia,221,118,103,53.39
Heimerdinger,Darius,669,389,280,58.15
Heimerdinger,Volibear,372,157,215,42.2
Heimerdinger,Caitlyn,738,398,340,53.93
Heimerdinger,TahmKench,388,194,194,50
Heimerdinger,Garen,469,219,250,46.7
Heimerdinger,Tristana,320,176,144,55
Heimerdinger,Lux,887,465,422,52.42
Heimerdinger,Morgana,543,295,248,54.33
Heimerdinger,Warwick,550,296,254,53.82
Heimerdinger,Akali,372,240,132,64.52
Heimerdinger,Akshan,195,101,94,51.79
Heimerdinger,Pantheon,551,290,261,52.63
Heimerdinger,Leblanc,108,79,29,73.15
Heimerdinger,Aphelios,252,139,113,55.16
Heimerdinger,Leona,254,135,119,53.15
Heimerdinger,Nunu,383,149,234,38.9
Heimerdinger,KSante,111,75,36,67.57
Heimerdinger,Zeri,135,71,64,52.59
Heimerdinger,Lulu,283,98,185,34.63
Heimerdinger,Malphite,186,94,92,50.54
Heimerdinger,Jhin,613,290,323,47.31
Heimerdinger,Evelynn,146,92,54,63.01
Heimerdinger,Gragas,202,106,96,52.48
Heimerdinger,Pyke,453,240,213,52.98
Heimerdinger,MasterYi,327,159,168,48.62
Heimerdinger,Aatrox,282,162,120,57.45
Heimerdinger,Viego,269,179,90,66.54
Heimerdinger,Fizz,181,86,95,47.51
Heimerdinger,Taric,54,33,21,61.11
Heimerdinger,Trundle,159,60,99,37.74
Heimerdinger,Nocturne,314,152,162,48.41
Heimerdinger,Orianna,144,71,73,49.31
Heimerdinger,Veigar,454,212,242,46.7
Heimerdinger,Brand,268,117,151,43.66
Heimerdinger,Ivern,72,51,21,70.83
Heimerdinger,Katarina,297,170,127,57.24
Heimerdinger,Nami,301,176,125,58.47
Heimerdinger,Teemo,529,270,259,51.04
Heimerdinger,Vi,279,188,91,67.38
Heimerdinger,Bard,88,41,47,46.59
Heimerdinger,Vladimir,205,114,91,55.61
Heimerdinger,Sylas,364,225,139,61.81
Heimerdinger,Ekko,271,136,135,50.18
Heimerdinger,Syndra,215,103,112,47.91
Heimerdinger,Samira,267,138,129,51.69
Heimerdinger,Maokai,132,78,54,59.09
Heimerdinger,Swain,311,147,164,47.27
Heimerdinger,MonkeyKing,171,100,71,58.48
Heimerdinger,Ezreal,656,349,307,53.2
Heimerdinger,Tryndamere,219,136,83,62.1
Heimerdinger,Irelia,281,163,118,58.01
Heimerdinger,Nautilus,325,144,181,44.31
Heimerdinger,Olaf,118,43,75,36.44
Heimerdinger,Aurora,403,225,178,55.83
Heimerdinger,Kaisa,434,262,172,60.37
Heimerdinger,Poppy,142,92,50,64.79
Heimerdinger,Illaoi,232,144,88,62.07
Heimerdinger,Anivia,96,41,55,42.71
Heimerdinger,JarvanIV,56,18,38,32.14
Heimerdinger,MissFortune,933,470,463,50.38
Heimerdinger,RekSai,60,29,31,48.33
Heimerdinger,Seraphine,467,284,183,60.81
Heimerdinger,Riven,126,52,74,41.27
Heimerdinger,Hwei,195,101,94,51.79
Heimerdinger,Vex,225,88,137,39.11
Heimerdinger,Mel,704,423,281,60.09
Heimerdinger,Twitch,307,144,163,46.91
Heimerdinger,Xayah,215,153,62,71.16
Heimerdinger,Rengar,106,58,48,54.72
Heimerdinger,Shen,241,126,115,52.28
Heimerdinger,Thresh,390,244,146,62.56
Heimerdinger,Gwen,193,123,70,63.73
Heimerdinger,Blitzcrank,321,170,151,52.96
Heimerdinger,Xerath,200,94,106,47
Heimerdinger,Yasuo,718,381,337,53.06
Heimerdinger,Sett,613,318,295,51.88
Heimerdinger,Lucian,180,91,89,50.56
Heimerdinger,LeeSin,285,152,133,53.33
Heimerdinger,Malzahar,227,100,127,44.05
Heimerdinger,Galio,241,101,140,41.91
Heimerdinger,Yuumi,280,162,118,57.86
Heimerdinger,Viktor,161,92,69,57.14
Heimerdinger,Graves,145,98,47,67.59
Heimerdinger,Diana,525,288,237,54.86
Heimerdinger,Draven,147,88,59,59.86
Heimerdinger,Nidalee,66,39,27,59.09
Heimerdinger,Amumu,365,165,200,45.21
Heimerdinger,Renata,101,48,53,47.52
Heimerdinger,Smolder,246,110,136,44.72
Heimerdinger,Rell,172,81,91,47.09
Heimerdinger,Varus,222,123,99,55.41
Heimerdinger,Jax,281,155,126,55.16
Heimerdinger,Sivir,162,88,74,54.32
Heimerdinger,Sona,174,74,100,42.53
Heimerdinger,Kled,81,52,29,64.2
Heimerdinger,Nasus,336,169,167,50.3
Heimerdinger,Kalista,170,87,83,51.18
Heimerdinger,Ambessa,149,88,61,59.06
Heimerdinger,Naafiri,177,105,72,59.32
Heimerdinger,Milio,151,79,72,52.32
Heimerdinger,Ryze,81,29,52,35.8
Heimerdinger,XinZhao,216,111,105,51.39
Heimerdinger,Chogath,450,226,224,50.22
Heimerdinger,Khazix,217,129,88,59.45
Heimerdinger,Nilah,165,109,56,66.06
Heimerdinger,Senna,226,114,112,50.44
Heimerdinger,Zyra,214,97,117,45.33
Heimerdinger,Ziggs,205,106,99,51.71
Heimerdinger,FiddleSticks,183,92,91,50.27
Heimerdinger,Braum,135,94,41,69.63
Heimerdinger,Camille,83,56,27,67.47
Heimerdinger,Vayne,290,165,125,56.9
Heimerdinger,Neeko,289,180,109,62.28
Heimerdinger,Qiyana,96,56,40,58.33
Heimerdinger,Soraka,224,104,120,46.43
Heimerdinger,Kayle,206,99,107,48.06
Heimerdinger,Corki,77,39,38,50.65
Heimerdinger,Taliyah,106,49,57,46.23
Heimerdinger,Rakan,136,77,59,56.62
Heimerdinger,Annie,77,50,27,64.94
Heimerdinger,Talon,198,141,57,71.21
Heimerdinger,Quinn,146,96,50,65.75
Heimerdinger,DrMundo,231,112,119,48.48
Heimerdinger,Elise,228,119,109,52.19
Heimerdinger,Shyvana,106,34,72,32.08
Heimerdinger,Renekton,109,36,73,33.03
Heimerdinger,Urgot,134,70,64,52.24
Heimerdinger,Lissandra,70,33,37,47.14
Heimerdinger,Azir,109,73,36,66.97
Heimerdinger,Gnar,124,63,61,50.81
Heimerdinger,Hecarim,97,50,47,51.55
Heimerdinger,Cassiopeia,122,69,53,56.56
Heimerdinger,Fiora,164,85,79,51.83
Heimerdinger,Belveth,101,66,35,65.35
Heimerdinger,Karthus,76,12,64,15.79
Heimerdinger,Rammus,50,28,22,56
Heimerdinger,Kindred,163,95,68,58.28
Heimerdinger,Zilean,94,47,47,50
Heimerdinger,Sion,273,148,125,54.21
Heimerdinger,Karma,219,121,98,55.25
Heimerdinger,Alistar,112,79,33,70.54
Heimerdinger,Kennen,141,86,55,60.99
Heimerdinger,Jayce,180,148,32,82.22
Heimerdinger,Janna,88,53,35,60.23
Heimerdinger,Zoe,122,77,45,63.11
Heimerdinger,Kassadin,88,33,55,37.5
Heimerdinger,Skarner,111,73,38,65.77
Heimerdinger,Ahri,518,265,253,51.16
Heimerdinger,KogMaw,104,40,64,38.46
Heimerdinger,TwistedFate,118,64,54,54.24
Heimerdinger,Sejuani,135,81,54,60
Heimerdinger,Zac,128,66,62,51.56
Heimerdinger,Gangplank,149,71,78,47.65
Heimerdinger,Ornn,128,78,50,60.94
Heimerdinger,Rumble,47,19,28,40.43
Nocturne,Teemo,786,383,403,48.73
Nocturne,TahmKench,513,259,254,50.49
Nocturne,Jinx,1184,643,541,54.31
Nocturne,Zoe,211,129,82,61.14
Nocturne,Nami,483,241,242,49.9
Nocturne,Gragas,293,174,119,59.39
Nocturne,Gwen,308,151,157,49.03
Nocturne,Yasuo,1151,652,499,56.65
Nocturne,Zeri,210,98,112,46.67
Nocturne,Bard,147,68,79,46.26
Nocturne,Sylas,495,255,240,51.52
Nocturne,Ekko,430,209,221,48.6
Nocturne,Talon,343,143,200,41.69
Nocturne,Pyke,545,255,290,46.79
Nocturne,Yorick,451,223,228,49.45
Nocturne,Ezreal,796,378,418,47.49
Nocturne,Lux,1451,772,679,53.2
Nocturne,Fiora,239,163,76,68.2
Nocturne,LeeSin,573,330,243,57.59
Nocturne,Ziggs,186,106,80,56.99
Nocturne,Senna,490,249,241,50.82
Nocturne,Illaoi,317,178,139,56.15
Nocturne,Khazix,360,202,158,56.11
Nocturne,Syndra,258,140,118,54.26
Nocturne,Kaisa,731,372,359,50.89
Nocturne,Kennen,166,91,75,54.82
Nocturne,Skarner,173,108,65,62.43
Nocturne,Malzahar,392,173,219,44.13
Nocturne,Yuumi,526,285,241,54.18
Nocturne,Akali,470,241,229,51.28
Nocturne,Naafiri,250,123,127,49.2
Nocturne,Kayle,371,145,226,39.08
Nocturne,MissFortune,1150,554,596,48.17
Nocturne,Smolder,427,236,191,55.27
Nocturne,Evelynn,325,159,166,48.92
Nocturne,Brand,447,197,250,44.07
Nocturne,Sett,918,469,449,51.09
Nocturne,FiddleSticks,248,129,119,52.02
Nocturne,Tristana,506,258,248,50.99
Nocturne,Blitzcrank,465,278,187,59.78
Nocturne,Ornn,312,161,151,51.6
Nocturne,Amumu,599,294,305,49.08
Nocturne,Katarina,368,209,159,56.79
Nocturne,Twitch,476,266,210,55.88
Nocturne,RekSai,69,29,40,42.03
Nocturne,Hwei,401,231,170,57.61
Nocturne,Ashe,965,525,440,54.4
Nocturne,Braum,323,188,135,58.2
Nocturne,MasterYi,577,303,274,52.51
Nocturne,Shaco,501,289,212,57.68
Nocturne,Azir,201,116,85,57.71
Nocturne,Rengar,231,159,72,68.83
Nocturne,Kindred,328,192,136,58.54
Nocturne,Veigar,602,309,293,51.33
Nocturne,Yone,947,489,458,51.64
Nocturne,Lulu,462,247,215,53.46
Nocturne,Neeko,466,236,230,50.64
Nocturne,Kayn,930,481,449,51.72
Nocturne,Heimerdinger,314,162,152,51.59
Nocturne,Corki,193,135,58,69.95
Nocturne,Elise,412,242,170,58.74
Nocturne,Darius,988,530,458,53.64
Nocturne,Karma,339,171,168,50.44
Nocturne,Briar,604,289,315,47.85
Nocturne,Cassiopeia,210,112,98,53.33
Nocturne,Jhin,981,485,496,49.44
Nocturne,KSante,203,102,101,50.25
Nocturne,Ahri,668,373,295,55.84
Nocturne,Caitlyn,1329,703,626,52.9
Nocturne,Garen,757,355,402,46.9
Nocturne,AurelionSol,268,130,138,48.51
Nocturne,Kalista,213,102,111,47.89
Nocturne,Singed,175,81,94,46.29
Nocturne,Varus,316,145,171,45.89
Nocturne,Maokai,226,111,115,49.12
Nocturne,Warwick,891,411,480,46.13
Nocturne,Lucian,335,171,164,51.04
Nocturne,Zilean,230,140,90,60.87
Nocturne,Sona,230,123,107,53.48
Nocturne,Ivern,115,53,62,46.09
Nocturne,Irelia,552,349,203,63.22
Nocturne,Poppy,315,161,154,51.11
Nocturne,Mordekaiser,728,333,395,45.74
Nocturne,Akshan,168,50,118,29.76
Nocturne,Jax,431,220,211,51.04
Nocturne,Volibear,633,334,299,52.76
Nocturne,Ambessa,342,188,154,54.97
Nocturne,Mel,1164,605,559,51.98
Nocturne,Xayah,383,204,179,53.26
Nocturne,Rakan,212,82,130,38.68
Nocturne,Sejuani,186,97,89,52.15
Nocturne,Urgot,282,131,151,46.45
Nocturne,Seraphine,622,334,288,53.7
Nocturne,Gangplank,228,135,93,59.21
Nocturne,Kled,81,47,34,58.02
Nocturne,Pantheon,861,377,484,43.79
Nocturne,Vex,345,148,197,42.9
Nocturne,Chogath,584,318,266,54.45
Nocturne,Aphelios,364,209,155,57.42
Nocturne,Karthus,133,61,72,45.86
Nocturne,Taliyah,144,108,36,75
Nocturne,Morgana,741,377,364,50.88
Nocturne,Viego,618,299,319,48.38
Nocturne,Leblanc,151,81,70,53.64
Nocturne,Gnar,200,93,107,46.5
Nocturne,Samira,434,196,238,45.16
Nocturne,Leona,412,214,198,51.94
Nocturne,Draven,280,184,96,65.71
Nocturne,Zed,489,268,221,54.81
Nocturne,Lillia,255,130,125,50.98
Nocturne,Trundle,379,171,208,45.12
Nocturne,Lissandra,153,85,68,55.56
Nocturne,JarvanIV,180,93,87,51.67
Nocturne,Tryndamere,271,174,97,64.21
Nocturne,Orianna,294,164,130,55.78
Nocturne,Diana,821,471,350,57.37
Nocturne,Kassadin,132,60,72,45.45
Nocturne,Galio,411,220,191,53.53
Nocturne,Swain,550,227,323,41.27
Nocturne,Nilah,337,192,145,56.97
Nocturne,Nautilus,567,255,312,44.97
Nocturne,Nasus,383,211,172,55.09
Nocturne,Zyra,305,166,139,54.43
Nocturne,Ryze,156,96,60,61.54
Nocturne,Janna,141,62,79,43.97
Nocturne,Vi,516,308,208,59.69
Nocturne,Vladimir,349,143,206,40.97
Nocturne,Malphite,424,215,209,50.71
Nocturne,Thresh,737,385,352,52.24
Nocturne,Quinn,175,71,104,40.57
Nocturne,Hecarim,174,80,94,45.98
Nocturne,Renekton,191,90,101,47.12
Nocturne,Qiyana,145,73,72,50.34
Nocturne,Vayne,519,247,272,47.59
Nocturne,Viktor,303,119,184,39.27
Nocturne,Annie,124,91,33,73.39
Nocturne,Shen,273,130,143,47.62
Nocturne,Jayce,200,106,94,53
Nocturne,Aatrox,504,294,210,58.33
Nocturne,Nunu,460,220,240,47.83
Nocturne,Fizz,282,134,148,47.52
Nocturne,Rell,290,167,123,57.59
Nocturne,Sivir,340,151,189,44.41
Nocturne,Velkoz,298,163,135,54.7
Nocturne,Camille,206,143,63,69.42
Nocturne,Soraka,279,135,144,48.39
Nocturne,Alistar,172,104,68,60.47
Nocturne,TwistedFate,202,116,86,57.43
Nocturne,Aurora,555,292,263,52.61
Nocturne,Zac,146,71,75,48.63
Nocturne,DrMundo,317,131,186,41.32
Nocturne,KogMaw,150,71,79,47.33
Nocturne,Riven,166,87,79,52.41
Nocturne,Graves,250,148,102,59.2
Nocturne,Udyr,147,70,77,47.62
Nocturne,Renata,108,57,51,52.78
Nocturne,Nidalee,135,87,48,64.44
Nocturne,Xerath,363,197,166,54.27
Nocturne,MonkeyKing,242,108,134,44.63
Nocturne,Anivia,155,87,68,56.13
Nocturne,Sion,384,179,205,46.61
Nocturne,XinZhao,331,178,153,53.78
Nocturne,Rammus,148,92,56,62.16
Nocturne,Rumble,77,40,37,51.95
Nocturne,Olaf,119,73,46,61.34
Nocturne,Milio,245,133,112,54.29
Nocturne,Shyvana,114,73,41,64.04
Nocturne,Belveth,177,117,60,66.1
Nocturne,Taric,85,35,50,41.18
Nami,Vayne,547,260,287,47.53
Nami,Nocturne,483,242,241,50.1
Nami,Kaisa,746,385,361,51.61
Nami,Galio,371,147,224,39.62
Nami,Blitzcrank,427,184,243,43.09
Nami,Mordekaiser,825,433,392,52.48
Nami,Amumu,601,291,310,48.42
Nami,Yasuo,1057,548,509,51.84
Nami,Caitlyn,1330,654,676,49.17
Nami,Soraka,391,223,168,57.03
Nami,Shen,365,234,131,64.11
Nami,Gragas,359,194,165,54.04
Nami,Yone,1010,512,498,50.69
Nami,Ashe,1062,523,539,49.25
Nami,Alistar,162,103,59,63.58
Nami,TwistedFate,230,128,102,55.65
Nami,LeeSin,580,370,210,63.79
Nami,Nilah,334,178,156,53.29
Nami,Brand,393,189,204,48.09
Nami,Sett,1015,487,528,47.98
Nami,Briar,559,301,258,53.85
Nami,Hwei,521,275,246,52.78
Nami,TahmKench,609,337,272,55.34
Nami,KSante,220,115,105,52.27
Nami,Udyr,228,140,88,61.4
Nami,Veigar,621,320,301,51.53
Nami,Nautilus,487,268,219,55.03
Nami,Kayn,992,467,525,47.08
Nami,MissFortune,1191,597,594,50.13
Nami,Lux,1671,831,840,49.73
Nami,Volibear,688,337,351,48.98
Nami,Ivern,149,69,80,46.31
Nami,Irelia,507,305,202,60.16
Nami,Swain,612,342,270,55.88
Nami,Chogath,824,406,418,49.27
Nami,Jayce,254,182,72,71.65
Nami,Samira,567,309,258,54.5
Nami,Lulu,582,295,287,50.69
Nami,Zed,630,391,239,62.06
Nami,Ekko,434,250,184,57.6
Nami,Tristana,430,199,231,46.28
Nami,Kayle,435,227,208,52.18
Nami,FiddleSticks,266,113,153,42.48
Nami,Katarina,402,227,175,56.47
Nami,Jhin,1027,452,575,44.01
Nami,Riven,268,190,78,70.9
Nami,Lillia,329,207,122,62.92
Nami,Orianna,281,150,131,53.38
Nami,Velkoz,384,185,199,48.18
Nami,Garen,760,314,446,41.32
Nami,Aurora,457,221,236,48.36
Nami,Heimerdinger,301,125,176,41.53
Nami,Viktor,442,243,199,54.98
Nami,Aatrox,628,353,275,56.21
Nami,Cassiopeia,185,72,113,38.92
Nami,Varus,544,273,271,50.18
Nami,Morgana,801,391,410,48.81
Nami,Olaf,131,62,69,47.33
Nami,Yorick,552,261,291,47.28
Nami,Diana,868,409,459,47.12
Nami,Akali,555,283,272,50.99
Nami,Twitch,426,175,251,41.08
Nami,Zilean,165,66,99,40
Nami,Fiora,291,140,151,48.11
Nami,Rammus,158,73,85,46.2
Nami,Renekton,263,157,106,59.7
Nami,Zyra,392,149,243,38.01
Nami,Nidalee,175,102,73,58.29
Nami,Vex,261,130,131,49.81
Nami,Sivir,281,165,116,58.72
Nami,Karma,443,223,220,50.34
Nami,Sion,544,245,299,45.04
Nami,Evelynn,266,112,154,42.11
Nami,Rell,314,170,144,54.14
Nami,Leblanc,233,109,124,46.78
Nami,Aphelios,373,186,187,49.87
Nami,Warwick,845,432,413,51.12
Nami,Ezreal,1014,556,458,54.83
Nami,Teemo,807,385,422,47.71
Nami,Shaco,628,341,287,54.3
Nami,Nasus,379,197,182,51.98
Nami,Mel,1324,630,694,47.58
Nami,Thresh,811,457,354,56.35
Nami,Fizz,309,180,129,58.25
Nami,Jinx,1071,492,579,45.94
Nami,Milio,335,169,166,50.45
Nami,Talon,321,150,171,46.73
Nami,Kalista,206,107,99,51.94
Nami,Pyke,636,324,312,50.94
Nami,MasterYi,424,186,238,43.87
Nami,Darius,1236,593,643,47.98
Nami,Gangplank,271,135,136,49.82
Nami,Poppy,269,154,115,57.25
Nami,Tryndamere,286,139,147,48.6
Nami,Singed,168,81,87,48.21
Nami,Draven,378,205,173,54.23
Nami,Neeko,414,200,214,48.31
Nami,Camille,197,103,94,52.28
Nami,Jax,430,198,232,46.05
Nami,Vladimir,279,127,152,45.52
Nami,Skarner,180,104,76,57.78
Nami,Rengar,210,123,87,58.57
Nami,Naafiri,282,168,114,59.57
Nami,Lucian,361,205,156,56.79
Nami,Ahri,749,383,366,51.13
Nami,Ziggs,249,148,101,59.44
Nami,XinZhao,315,123,192,39.05
Nami,Taric,152,39,113,25.66
Nami,Yuumi,690,343,347,49.71
Nami,Leona,408,200,208,49.02
Nami,AurelionSol,260,129,131,49.62
Nami,Gwen,379,201,178,53.03
Nami,Urgot,293,143,150,48.81
Nami,Kassadin,134,50,84,37.31
Nami,Senna,556,309,247,55.58
Nami,Renata,151,75,76,49.67
Nami,Viego,706,360,346,50.99
Nami,Braum,290,148,142,51.03
Nami,Vi,491,257,234,52.34
Nami,Syndra,382,176,206,46.07
Nami,Gnar,249,144,105,57.83
Nami,Xayah,429,248,181,57.81
Nami,DrMundo,361,137,224,37.95
Nami,Lissandra,159,90,69,56.6
Nami,Ornn,225,131,94,58.22
Nami,Seraphine,603,289,314,47.93
Nami,Corki,205,131,74,63.9
Nami,Zoe,307,178,129,57.98
Nami,Kennen,215,120,95,55.81
Nami,Kindred,361,178,183,49.31
Nami,Zeri,254,124,130,48.82
Nami,Akshan,206,119,87,57.77
Nami,Sona,226,145,81,64.16
Nami,Maokai,178,87,91,48.88
Nami,Pantheon,818,399,419,48.78
Nami,Malphite,553,306,247,55.33
Nami,Sylas,581,298,283,51.29
Nami,Janna,210,100,110,47.62
Nami,Ryze,174,75,99,43.1
Nami,Trundle,265,111,154,41.89
Nami,Quinn,173,84,89,48.55
Nami,Khazix,432,221,211,51.16
Nami,Qiyana,208,145,63,69.71
Nami,Taliyah,183,121,62,66.12
Nami,Elise,363,225,138,61.98
Nami,Ambessa,376,192,184,51.06
Nami,Zac,205,131,74,63.9
Nami,RekSai,98,55,43,56.12
Nami,Malzahar,482,212,270,43.98
Nami,Smolder,500,231,269,46.2
Nami,JarvanIV,198,103,95,52.02
Nami,Rakan,382,178,204,46.6
Nami,Illaoi,266,132,134,49.62
Nami,Hecarim,166,54,112,32.53
Nami,Kled,139,70,69,50.36
Nami,Xerath,400,210,190,52.5
Nami,KogMaw,181,107,74,59.12
Nami,Annie,172,106,66,61.63
Nami,Nunu,452,202,250,44.69
Nami,Sejuani,251,135,116,53.78
Nami,Belveth,181,88,93,48.62
Nami,Bard,204,114,90,55.88
Nami,Karthus,97,71,26,73.2
Nami,Graves,289,140,149,48.44
Nami,Anivia,188,107,81,56.91
Nami,MonkeyKing,284,140,144,49.3
Nami,Shyvana,145,64,81,44.14
Nami,Rumble,98,46,52,46.94
Nami,Azir,132,65,67,49.24
Ornn,Akali,299,147,152,49.16
Ornn,MissFortune,470,260,210,55.32
Ornn,Kassadin,62,37,25,59.68
Ornn,Kayn,416,249,167,59.86
Ornn,Sona,78,57,21,73.08
Ornn,Vladimir,139,71,68,51.08
Ornn,Zac,58,20,38,34.48
Ornn,Cassiopeia,69,32,37,46.38
Ornn,Irelia,255,124,131,48.63
Ornn,Lux,672,364,308,54.17
Ornn,Jax,222,130,92,58.56
Ornn,Elise,166,103,63,62.05
Ornn,Kaisa,309,169,140,54.69
Ornn,Twitch,193,101,92,52.33
Ornn,Yuumi,213,120,93,56.34
Ornn,Gangplank,135,58,77,42.96
Ornn,Nocturne,312,151,161,48.4
Ornn,Yasuo,522,259,263,49.62
Ornn,Corki,77,25,52,32.47
Ornn,Ambessa,196,98,98,50
Ornn,Kalista,142,75,67,52.82
Ornn,Swain,303,130,173,42.9
Ornn,Garen,413,223,190,54
Ornn,LeeSin,301,158,143,52.49
Ornn,Aurora,247,129,118,52.23
Ornn,Rell,114,54,60,47.37
Ornn,Aatrox,277,134,143,48.38
Ornn,Vi,266,132,134,49.62
Ornn,Yone,474,287,187,60.55
Ornn,Nasus,192,116,76,60.42
Ornn,Sion,244,155,89,63.52
Ornn,Yorick,220,88,132,40
Ornn,Xerath,168,86,82,51.19
Ornn,Jhin,559,252,307,45.08
Ornn,Lulu,152,85,67,55.92
Ornn,Trundle,155,69,86,44.52
Ornn,MasterYi,238,131,107,55.04
Ornn,Ahri,325,191,134,58.77
Ornn,Varus,217,90,127,41.47
Ornn,Gragas,152,74,78,48.68
Ornn,Syndra,198,123,75,62.12
Ornn,Sett,409,191,218,46.7
Ornn,Kled,69,29,40,42.03
Ornn,Warwick,463,231,232,49.89
Ornn,Taliyah,62,34,28,54.84
Ornn,Ezreal,412,265,147,64.32
Ornn,TahmKench,317,170,147,53.63
Ornn,Teemo,401,229,172,57.11
Ornn,Graves,110,49,61,44.55
Ornn,Zoe,129,63,66,48.84
Ornn,Katarina,164,80,84,48.78
Ornn,Quinn,80,46,34,57.5
Ornn,Shaco,215,124,91,57.67
Ornn,Darius,430,230,200,53.49
Ornn,Braum,128,65,63,50.78
Ornn,Viego,300,143,157,47.67
Ornn,Zed,190,108,82,56.84
Ornn,Soraka,214,116,98,54.21
Ornn,Vayne,324,168,156,51.85
Ornn,Briar,249,160,89,64.26
Ornn,Orianna,161,83,78,51.55
Ornn,Mel,558,313,245,56.09
Ornn,Jinx,528,285,243,53.98
Ornn,Thresh,316,137,179,43.35
Ornn,Kayle,192,72,120,37.5
Ornn,XinZhao,159,91,68,57.23
Ornn,Vex,145,71,74,48.97
Ornn,Ashe,432,211,221,48.84
Ornn,Veigar,261,107,154,41
Ornn,Tristana,289,165,124,57.09
Ornn,Nautilus,330,182,148,55.15
Ornn,Khazix,127,79,48,62.2
Ornn,Sylas,296,162,134,54.73
Ornn,Xayah,176,79,97,44.89
Ornn,Rakan,123,66,57,53.66
Ornn,Fizz,116,50,66,43.1
Ornn,Pantheon,405,205,200,50.62
Ornn,Volibear,287,137,150,47.74
Ornn,Morgana,350,162,188,46.29
Ornn,Ekko,192,112,80,58.33
Ornn,Caitlyn,578,315,263,54.5
Ornn,Brand,163,103,60,63.19
Ornn,KSante,160,72,88,45
Ornn,Poppy,119,73,46,61.34
Ornn,Bard,105,52,53,49.52
Ornn,Nami,225,94,131,41.78
Ornn,Amumu,232,107,125,46.12
Ornn,Qiyana,118,51,67,43.22
Ornn,Mordekaiser,427,232,195,54.33
Ornn,Illaoi,74,40,34,54.05
Ornn,Hwei,175,96,79,54.86
Ornn,Evelynn,148,85,63,57.43
Ornn,Senna,270,116,154,42.96
Ornn,Zilean,94,52,42,55.32
Ornn,Malphite,152,99,53,65.13
Ornn,Fiora,215,125,90,58.14
Ornn,Milio,161,94,67,58.39
Ornn,Shen,187,91,96,48.66
Ornn,Malzahar,201,67,134,33.33
Ornn,Nilah,181,127,54,70.17
Ornn,Ziggs,120,76,44,63.33
Ornn,JarvanIV,114,72,42,63.16
Ornn,Naafiri,156,103,53,66.03
Ornn,Leblanc,90,59,31,65.56
Ornn,Smolder,252,122,130,48.41
Ornn,Janna,70,28,42,40
Ornn,Diana,356,152,204,42.7
Ornn,Samira,252,121,131,48.02
Ornn,Zyra,162,90,72,55.56
Ornn,Olaf,84,33,51,39.29
Ornn,Annie,91,33,58,36.26
Ornn,Karma,173,116,57,67.05
Ornn,Hecarim,79,28,51,35.44
Ornn,Lissandra,65,38,27,58.46
Ornn,Anivia,80,39,41,48.75
Ornn,Sivir,130,87,43,66.92
Ornn,Taric,40,16,24,40
Ornn,Udyr,77,34,43,44.16
Ornn,FiddleSticks,110,61,49,55.45
Ornn,Gnar,130,88,42,67.69
Ornn,Rengar,117,80,37,68.38
Ornn,Alistar,98,53,45,54.08
Ornn,Lucian,166,80,86,48.19
Ornn,Chogath,414,245,169,59.18
Ornn,Leona,203,96,107,47.29
Ornn,Velkoz,157,78,79,49.68
Ornn,MonkeyKing,119,51,68,42.86
Ornn,Blitzcrank,185,107,78,57.84
Ornn,Sejuani,43,19,24,44.19
Ornn,Pyke,296,181,115,61.15
Ornn,Nunu,219,118,101,53.88
Ornn,TwistedFate,45,17,28,37.78
Ornn,KogMaw,75,38,37,50.67
Ornn,Camille,98,58,40,59.18
Ornn,Ryze,74,41,33,55.41
Ornn,Gwen,128,79,49,61.72
Ornn,Jayce,70,51,19,72.86
Ornn,Shyvana,54,24,30,44.44
Ornn,Azir,103,48,55,46.6
Ornn,Seraphine,299,160,139,53.51
Ornn,Zeri,92,59,33,64.13
Ornn,Lillia,168,81,87,48.21
Ornn,Galio,198,97,101,48.99
Ornn,Talon,178,117,61,65.73
Ornn,Kindred,152,87,65,57.24
Ornn,Akshan,98,68,30,69.39
Ornn,Kennen,109,63,46,57.8
Ornn,Draven,149,90,59,60.4
Ornn,Tryndamere,177,89,88,50.28
Ornn,Nidalee,94,72,22,76.6
Ornn,RekSai,46,19,27,41.3
Ornn,DrMundo,183,71,112,38.8
Ornn,Neeko,154,77,77,50
Ornn,Ivern,44,12,32,27.27
Ornn,Maokai,104,42,62,40.38
Ornn,Renekton,97,64,33,65.98
Ornn,Viktor,190,90,100,47.37
Ornn,Riven,116,94,22,81.03
Ornn,Aphelios,172,111,61,64.53
Ornn,Skarner,57,21,36,36.84
Ornn,Heimerdinger,128,50,78,39.06
Ornn,Rammus,85,53,32,62.35
Ornn,Singed,71,49,22,69.01
Ornn,Urgot,82,40,42,48.78
Ornn,AurelionSol,121,61,60,50.41
Ornn,Karthus,45,15,30,33.33
Ornn,Rumble,64,29,35,45.31
Ornn,Belveth,65,25,40,38.46
Ornn,Renata,63,31,32,49.21
Udyr,Akali,167,76,91,45.51
Udyr,MissFortune,475,221,254,46.53
Udyr,Kassadin,28,17,11,60.71
Udyr,Kayn,405,197,208,48.64
Udyr,Sona,79,52,27,65.82
Udyr,Heimerdinger,106,56,50,52.83
Udyr,Talon,131,56,75,42.75
Udyr,Ahri,297,156,141,52.53
Udyr,Kalista,100,57,43,57
Udyr,Brand,168,76,92,45.24
Udyr,Urgot,136,72,64,52.94
Udyr,Rengar,121,56,65,46.28
Udyr,Ziggs,110,63,47,57.27
Udyr,Trundle,124,61,63,49.19
Udyr,Fiora,141,62,79,43.97
Udyr,Sion,239,140,99,58.58
Udyr,MasterYi,238,122,116,51.26
Udyr,AurelionSol,116,38,78,32.76
Udyr,Ezreal,418,226,192,54.07
Udyr,Nami,228,88,140,38.6
Udyr,FiddleSticks,131,68,63,51.91
Udyr,Katarina,262,143,119,54.58
Udyr,Caitlyn,511,228,283,44.62
Udyr,Pyke,285,165,120,57.89
Udyr,Darius,521,240,281,46.07
Udyr,Neeko,155,97,58,62.58
Udyr,Taric,70,41,29,58.57
Udyr,Riven,85,60,25,70.59
Udyr,Vi,197,93,104,47.21
Udyr,Mel,494,282,212,57.09
Udyr,Soraka,109,51,58,46.79
Udyr,Kled,44,21,23,47.73
Udyr,Warwick,321,151,170,47.04
Udyr,Gragas,194,121,73,62.37
Udyr,Jinx,506,238,268,47.04
Udyr,Rell,135,66,69,48.89
Udyr,Olaf,62,42,20,67.74
Udyr,Evelynn,117,48,69,41.03
Udyr,Volibear,305,146,159,47.87
Udyr,Leona,153,69,84,45.1
Udyr,Teemo,364,195,169,53.57
Udyr,Shaco,218,106,112,48.62
Udyr,Yasuo,437,242,195,55.38
Udyr,Ashe,463,227,236,49.03
Udyr,Lux,627,351,276,55.98
Udyr,Akshan,115,76,39,66.09
Udyr,Hwei,143,77,66,53.85
Udyr,Xerath,118,60,58,50.85
Udyr,Mordekaiser,340,134,206,39.41
Udyr,MonkeyKing,132,66,66,50
Udyr,Tryndamere,156,78,78,50
Udyr,Irelia,157,79,78,50.32
Udyr,Nautilus,277,127,150,45.85
Udyr,Nunu,206,86,120,41.75
Udyr,Leblanc,101,51,50,50.5
Udyr,Kaisa,328,188,140,57.32
Udyr,Jax,144,70,74,48.61
Udyr,Yone,413,195,218,47.22
Udyr,Samira,235,124,111,52.77
Udyr,Thresh,380,184,196,48.42
Udyr,Pantheon,423,201,222,47.52
Udyr,Graves,81,29,52,35.8
Udyr,Tristana,214,85,129,39.72
Udyr,Ambessa,153,72,81,47.06
Udyr,Zed,231,87,144,37.66
Udyr,Draven,165,110,55,66.67
Udyr,Bard,84,34,50,40.48
Udyr,DrMundo,114,54,60,47.37
Udyr,Sett,367,182,185,49.59
Udyr,Sejuani,80,34,46,42.5
Udyr,LeeSin,222,134,88,60.36
Udyr,Cassiopeia,107,57,50,53.27
Udyr,Senna,178,92,86,51.69
Udyr,Kennen,101,57,44,56.44
Udyr,Malzahar,176,81,95,46.02
Udyr,Morgana,312,144,168,46.15
Udyr,Singed,59,32,27,54.24
Udyr,Velkoz,128,48,80,37.5
Udyr,Kindred,127,59,68,46.46
Udyr,Aurora,244,122,122,50
Udyr,Zeri,129,57,72,44.19
Udyr,Azir,87,34,53,39.08
Udyr,Swain,228,116,112,50.88
Udyr,Aatrox,262,128,134,48.85
Udyr,Seraphine,249,120,129,48.19
Udyr,Jhin,407,229,178,56.27
Udyr,Ekko,177,74,103,41.81
Udyr,XinZhao,126,52,74,41.27
Udyr,Sylas,201,107,94,53.23
Udyr,Naafiri,107,55,52,51.4
Udyr,Poppy,140,58,82,41.43
Udyr,Twitch,212,61,151,28.77
Udyr,Ryze,98,59,39,60.2
Udyr,TahmKench,209,120,89,57.42
Udyr,Diana,297,131,166,44.11
Udyr,Viego,306,173,133,56.54
Udyr,Maokai,130,38,92,29.23
Udyr,Khazix,105,29,76,27.62
Udyr,Qiyana,65,44,21,67.69
Udyr,Lulu,162,91,71,56.17
Udyr,Malphite,174,79,95,45.4
Udyr,Kayle,156,67,89,42.95
Udyr,Zac,82,60,22,73.17
Udyr,Renekton,106,55,51,51.89
Udyr,Gnar,80,40,40,50
Udyr,Shen,222,91,131,40.99
Udyr,Lillia,160,96,64,60
Udyr,Orianna,60,22,38,36.67
Udyr,Briar,224,127,97,56.7
Udyr,Chogath,334,165,169,49.4
Udyr,Blitzcrank,163,79,84,48.47
Udyr,Milio,135,80,55,59.26
Udyr,Veigar,253,115,138,45.45
Udyr,Skarner,88,38,50,43.18
Udyr,Karma,176,66,110,37.5
Udyr,Vayne,236,118,118,50
Udyr,Garen,438,226,212,51.6
Udyr,Quinn,75,19,56,25.33
Udyr,Belveth,58,31,27,53.45
Udyr,Nasus,163,89,74,54.6
Udyr,TwistedFate,90,34,56,37.78
Udyr,Xayah,129,75,54,58.14
Udyr,Hecarim,72,43,29,59.72
Udyr,Yuumi,221,128,93,57.92
Udyr,Yorick,202,70,132,34.65
Udyr,KSante,117,57,60,48.72
Udyr,Ornn,77,43,34,55.84
Udyr,Zyra,106,45,61,42.45
Udyr,Vladimir,110,61,49,55.45
Udyr,Aphelios,141,69,72,48.94
Udyr,Illaoi,95,51,44,53.68
Udyr,Corki,82,51,31,62.2
Udyr,Karthus,58,21,37,36.21
Udyr,Nilah,90,44,46,48.89
Udyr,Janna,60,18,42,30
Udyr,Lucian,138,61,77,44.2
Udyr,Varus,175,77,98,44
Udyr,Sivir,117,42,75,35.9
Udyr,Fizz,104,54,50,51.92
Udyr,Nocturne,147,77,70,52.38
Udyr,Elise,161,85,76,52.8
Udyr,Amumu,206,99,107,48.06
Udyr,Syndra,146,78,68,53.42
Udyr,Gwen,161,101,60,62.73
Udyr,Annie,81,42,39,51.85
Udyr,Viktor,122,56,66,45.9
Udyr,Nidalee,96,73,23,76.04
Udyr,Zilean,84,28,56,33.33
Udyr,Taliyah,67,34,33,50.75
Udyr,Smolder,142,89,53,62.68
Udyr,Galio,188,65,123,34.57
Udyr,Rakan,126,70,56,55.56
Udyr,Vex,116,36,80,31.03
Udyr,Anivia,80,35,45,43.75
Udyr,KogMaw,87,35,52,40.23
Udyr,Gangplank,106,49,57,46.23
Udyr,Braum,106,72,34,67.92
Udyr,Ivern,44,25,19,56.82
Udyr,Rammus,67,23,44,34.33
Udyr,RekSai,38,24,14,63.16
Udyr,Zoe,92,38,54,41.3
Udyr,Alistar,91,50,41,54.95
Udyr,Camille,90,60,30,66.67
Udyr,Jayce,103,63,40,61.17
Udyr,Shyvana,55,21,34,38.18
Udyr,Rumble,53,22,31,41.51
Udyr,JarvanIV,85,36,49,42.35
Udyr,Lissandra,37,23,14,62.16
Udyr,Renata,20,11,9,55
Kassadin,Ornn,62,25,37,40.32
Kassadin,Udyr,28,11,17,39.29
Kassadin,Lux,353,159,194,45.04
Kassadin,Ezreal,248,95,153,38.31
Kassadin,Milio,72,42,30,58.33
Kassadin,Gangplank,61,32,29,52.46
Kassadin,Kaisa,213,121,92,56.81
Kassadin,Galio,112,48,64,42.86
Kassadin,Cassiopeia,38,19,19,50
Kassadin,Hwei,78,52,26,66.67
Kassadin,Aatrox,134,48,86,35.82
Kassadin,Shaco,188,118,70,62.77
Kassadin,Leblanc,27,14,13,51.85
Kassadin,Draven,49,23,26,46.94
Kassadin,Darius,264,134,130,50.76
Kassadin,Chogath,149,78,71,52.35
Kassadin,Yasuo,222,99,123,44.59
Kassadin,Yuumi,123,72,51,58.54
Kassadin,Naafiri,50,18,32,36
Kassadin,Zac,82,60,22,73.17
Kassadin,Ahri,198,116,82,58.59
Kassadin,Nilah,92,34,58,36.96
Kassadin,Zyra,76,48,28,63.16
Kassadin,XinZhao,51,13,38,25.49
Kassadin,Hecarim,64,36,28,56.25
Kassadin,Jhin,270,126,144,46.67
Kassadin,Velkoz,85,39,46,45.88
Kassadin,Mordekaiser,152,86,66,56.58
Kassadin,Diana,222,123,99,55.41
Kassadin,Tristana,111,53,58,47.75
Kassadin,Taric,39,17,22,43.59
Kassadin,Warwick,199,102,97,51.26
Kassadin,Graves,40,21,19,52.5
Kassadin,Aurora,139,81,58,58.27
Kassadin,Mel,342,217,125,63.45
Kassadin,Irelia,133,67,66,50.38
Kassadin,MonkeyKing,65,18,47,27.69
Kassadin,Vex,71,49,22,69.01
Kassadin,Caitlyn,280,132,148,47.14
Kassadin,Rell,100,49,51,49
Kassadin,Illaoi,51,35,16,68.63
Kassadin,Vi,106,69,37,65.09
Kassadin,Sivir,50,25,25,50
Kassadin,Jax,116,49,67,42.24
Kassadin,Karthus,27,21,6,77.78
Kassadin,Lucian,43,26,17,60.47
Kassadin,Nami,134,84,50,62.69
Kassadin,Garen,152,90,62,59.21
Kassadin,Skarner,30,13,17,43.33
Kassadin,Zilean,21,13,8,61.9
Kassadin,MissFortune,227,137,90,60.35
Kassadin,Tryndamere,90,51,39,56.67
Kassadin,Evelynn,112,50,62,44.64
Kassadin,Syndra,76,53,23,69.74
Kassadin,Xerath,52,24,28,46.15
Kassadin,Nunu,73,33,40,45.21
Kassadin,Seraphine,162,92,70,56.79
Kassadin,Nautilus,164,76,88,46.34
Kassadin,Zed,95,56,39,58.95
Kassadin,Pantheon,226,109,117,48.23
Kassadin,Nocturne,132,72,60,54.55
Kassadin,Akali,141,91,50,64.54
Kassadin,Jinx,301,184,117,61.13
Kassadin,Annie,14,11,3,78.57
Kassadin,Sett,208,133,75,63.94
Kassadin,Ekko,137,88,49,64.23
Kassadin,Swain,173,108,65,62.43
Kassadin,LeeSin,128,49,79,38.28
Kassadin,Riven,49,29,20,59.18
Kassadin,Rengar,63,52,11,82.54
Kassadin,Gnar,80,36,44,45
Kassadin,MasterYi,124,58,66,46.77
Kassadin,TwistedFate,53,34,19,64.15
Kassadin,Senna,109,54,55,49.54
Kassadin,Kayn,190,84,106,44.21
Kassadin,Malzahar,89,34,55,38.2
Kassadin,Malphite,88,31,57,35.23
Kassadin,Sylas,123,60,63,48.78
Kassadin,Rakan,70,30,40,42.86
Kassadin,Ivern,37,28,9,75.68
Kassadin,Katarina,126,78,48,61.9
Kassadin,Teemo,150,62,88,41.33
Kassadin,Briar,103,37,66,35.92
Kassadin,Twitch,137,76,61,55.47
Kassadin,Poppy,43,28,15,65.12
Kassadin,AurelionSol,35,12,23,34.29
Kassadin,Zoe,53,36,17,67.92
Kassadin,Lillia,116,60,56,51.72
Kassadin,Lulu,82,47,35,57.32
Kassadin,Veigar,151,88,63,58.28
Kassadin,Brand,107,63,44,58.88
Kassadin,Pyke,149,91,58,61.07
Kassadin,Varus,121,58,63,47.93
Kassadin,DrMundo,92,34,58,36.96
Kassadin,Vladimir,87,57,30,65.52
Kassadin,Neeko,97,63,34,64.95
Kassadin,KSante,67,37,30,55.22
Kassadin,Vayne,170,97,73,57.06
Kassadin,TahmKench,152,88,64,57.89
Kassadin,Maokai,77,43,34,55.84
Kassadin,Orianna,41,14,27,34.15
Kassadin,Viego,170,80,90,47.06
Kassadin,Xayah,91,37,54,40.66
Kassadin,Kindred,60,31,29,51.67
Kassadin,Urgot,111,44,67,39.64
Kassadin,Elise,83,56,27,67.47
Kassadin,Braum,77,37,40,48.05
Kassadin,Nasus,124,73,51,58.87
Kassadin,Yone,191,91,100,47.64
Kassadin,Blitzcrank,103,57,46,55.34
Kassadin,Qiyana,50,19,31,38
Kassadin,Ziggs,55,43,12,78.18
Kassadin,Amumu,107,40,67,37.38
Kassadin,Viktor,70,43,27,61.43
Kassadin,Thresh,185,88,97,47.57
Kassadin,Volibear,115,61,54,53.04
Kassadin,Yorick,99,47,52,47.47
Kassadin,Kayle,122,66,56,54.1
Kassadin,Ashe,185,101,84,54.59
Kassadin,Ryze,63,22,41,34.92
Kassadin,Camille,62,43,19,69.35
Kassadin,Corki,75,56,19,74.67
Kassadin,Karma,96,61,35,63.54
Kassadin,Sona,51,12,39,23.53
Kassadin,Fizz,51,22,29,43.14
Kassadin,Trundle,84,35,49,41.67
Kassadin,Soraka,84,40,44,47.62
Kassadin,Gragas,103,28,75,27.18
Kassadin,Ambessa,55,24,31,43.64
Kassadin,Kled,20,14,6,70
Kassadin,Khazix,47,41,6,87.23
Kassadin,Renekton,58,47,11,81.03
Kassadin,Kalista,92,48,44,52.17
Kassadin,Morgana,170,77,93,45.29
Kassadin,Singed,47,25,22,53.19
Kassadin,Bard,60,35,25,58.33
Kassadin,Samira,102,49,53,48.04
Kassadin,Zeri,66,34,32,51.52
Kassadin,FiddleSticks,67,43,24,64.18
Kassadin,Smolder,118,55,63,46.61
Kassadin,Akshan,29,10,19,34.48
Kassadin,KogMaw,53,27,26,50.94
Kassadin,Gwen,68,49,19,72.06
Kassadin,Quinn,45,13,32,28.89
Kassadin,Heimerdinger,88,55,33,62.5
Kassadin,JarvanIV,25,13,12,52
Kassadin,Sejuani,50,25,25,50
Kassadin,Shen,72,27,45,37.5
Kassadin,Sion,111,32,79,28.83
Kassadin,Fiora,58,34,24,58.62
Kassadin,Belveth,18,8,10,44.44
Kassadin,RekSai,16,6,10,37.5
Kassadin,Renata,33,30,3,90.91
Kassadin,Talon,88,36,52,40.91
Kassadin,Rumble,22,13,9,59.09
Kassadin,Leona,101,38,63,37.62
Kassadin,Aphelios,100,64,36,64
Kassadin,Kennen,59,39,20,66.1
Kassadin,Shyvana,35,15,20,42.86
Kassadin,Alistar,49,11,38,22.45
Kassadin,Taliyah,32,13,19,40.63
Kassadin,Nidalee,43,33,10,76.74
Kassadin,Janna,33,16,17,48.48
Kassadin,Anivia,70,38,32,54.29
Kassadin,Jayce,22,6,16,27.27
Kassadin,Rammus,34,10,24,29.41
Kassadin,Azir,21,6,15,28.57
Kassadin,Olaf,20,8,12,40
Kassadin,Lissandra,22,9,13,40.91
Taric,Jax,113,91,22,80.53
Taric,Nidalee,34,16,18,47.06
Taric,Ahri,191,113,78,59.16
Taric,Jhin,189,97,92,51.32
Taric,Senna,110,66,44,60
Taric,Udyr,70,29,41,41.43
Taric,Yorick,95,44,51,46.32
Taric,Akali,137,93,44,67.88
Taric,Jinx,283,170,113,60.07
Taric,Karma,54,31,23,57.41
Taric,Heimerdinger,54,21,33,38.89
Taric,Warwick,202,127,75,62.87
Taric,Mordekaiser,239,117,122,48.95
Taric,Ashe,244,128,116,52.46
Taric,Pyke,133,100,33,75.19
Taric,Gwen,89,52,37,58.43
Taric,RekSai,15,12,3,80
Taric,Gangplank,64,44,20,68.75
Taric,Kaisa,201,145,56,72.14
Taric,Leona,93,65,28,69.89
Taric,Kennen,44,37,7,84.09
Taric,TwistedFate,56,33,23,58.93
Taric,Cassiopeia,76,52,24,68.42
Taric,Smolder,144,85,59,59.03
Taric,Milio,76,51,25,67.11
Taric,Sett,220,120,100,54.55
Taric,Nunu,72,36,36,50
Taric,Yone,260,162,98,62.31
Taric,Quinn,84,33,51,39.29
Taric,Viego,178,79,99,44.38
Taric,Yasuo,343,178,165,51.9
Taric,MissFortune,268,115,153,42.91
Taric,Neeko,118,82,36,69.49
Taric,Teemo,207,107,100,51.69
Taric,Akshan,49,29,20,59.18
Taric,Corki,41,25,16,60.98
Taric,Lux,369,170,199,46.07
Taric,Singed,47,18,29,38.3
Taric,Zeri,70,22,48,31.43
Taric,Brand,80,39,41,48.75
Taric,Darius,260,143,117,55
Taric,Gragas,86,62,24,72.09
Taric,Veigar,151,105,46,69.54
Taric,KogMaw,46,21,25,45.65
Taric,Thresh,206,134,72,65.05
Taric,Kayn,174,104,70,59.77
Taric,Kassadin,39,22,17,56.41
Taric,Ziggs,62,25,37,40.32
Taric,Morgana,201,113,88,56.22
Taric,Shaco,102,59,43,57.84
Taric,Hwei,87,57,30,65.52
Taric,Sejuani,52,26,26,50
Taric,Taliyah,56,30,26,53.57
Taric,Sivir,88,54,34,61.36
Taric,Velkoz,85,47,38,55.29
Taric,Ambessa,88,52,36,59.09
Taric,Lillia,89,49,40,55.06
Taric,Vladimir,71,23,48,32.39
Taric,Vayne,100,41,59,41
Taric,Nami,152,113,39,74.34
Taric,Viktor,98,64,34,65.31
Taric,Xayah,70,30,40,42.86
Taric,Nautilus,147,76,71,51.7
Taric,Garen,205,106,99,51.71
Taric,Kindred,58,39,19,67.24
Taric,Graves,51,22,29,43.14
Taric,Twitch,75,38,37,50.67
Taric,Volibear,122,61,61,50
Taric,Evelynn,84,41,43,48.81
Taric,Trundle,86,30,56,34.88
Taric,JarvanIV,43,27,16,62.79
Taric,Aurora,146,91,55,62.33
Taric,MasterYi,175,92,83,52.57
Taric,Lissandra,27,17,10,62.96
Taric,Caitlyn,316,183,133,57.91
Taric,Rakan,39,22,17,56.41
Taric,Riven,80,58,22,72.5
Taric,FiddleSticks,84,49,35,58.33
Taric,Tristana,117,36,81,30.77
Taric,Swain,129,71,58,55.04
Taric,Talon,51,16,35,31.37
Taric,Orianna,48,19,29,39.58
Taric,MonkeyKing,34,21,13,61.76
Taric,Malzahar,86,51,35,59.3
Taric,Poppy,118,62,56,52.54
Taric,XinZhao,86,32,54,37.21
Taric,Ryze,34,22,12,64.71
Taric,Varus,119,64,55,53.78
Taric,Belveth,55,36,19,65.45
Taric,Illaoi,75,46,29,61.33
Taric,Urgot,82,48,34,58.54
Taric,Diana,192,108,84,56.25
Taric,Soraka,42,22,20,52.38
Taric,Mel,252,123,129,48.81
Taric,LeeSin,128,70,58,54.69
Taric,Zac,98,44,54,44.9
Taric,Pantheon,241,159,82,65.98
Taric,Briar,131,88,43,67.18
Taric,Irelia,88,42,46,47.73
Taric,Nasus,94,45,49,47.87
Taric,Vi,92,34,58,36.96
Taric,Azir,61,37,24,60.66
Taric,Draven,43,18,25,41.86
Taric,Ornn,40,24,16,60
Taric,KSante,45,33,12,73.33
Taric,Zed,123,59,64,47.97
Taric,Samira,108,75,33,69.44
Taric,Amumu,141,74,67,52.48
Taric,Lucian,58,38,20,65.52
Taric,Annie,29,20,9,68.97
Taric,Seraphine,161,81,80,50.31
Taric,Ezreal,256,152,104,59.38
Taric,Zyra,66,32,34,48.48
Taric,Maokai,82,43,39,52.44
Taric,Nilah,65,37,28,56.92
Taric,Alistar,50,36,14,72
Taric,Tryndamere,72,47,25,65.28
Taric,Fizz,112,57,55,50.89
Taric,Jayce,89,52,37,58.43
Taric,Elise,122,78,44,63.93
Taric,Ekko,101,59,42,58.42
Taric,Blitzcrank,86,52,34,60.47
Taric,Zoe,42,36,6,85.71
Taric,Kalista,82,47,35,57.32
Taric,Katarina,104,47,57,45.19
Taric,Renekton,66,32,34,48.48
Taric,Qiyana,35,6,29,17.14
Taric,Rammus,52,38,14,73.08
Taric,Yuumi,139,59,80,42.45
Taric,DrMundo,91,41,50,45.05
Taric,Shyvana,23,6,17,26.09
Taric,Karthus,35,13,22,37.14
Taric,Anivia,51,12,39,23.53
Taric,Xerath,100,38,62,38
Taric,Chogath,234,155,79,66.24
Taric,Naafiri,64,19,45,29.69
Taric,Galio,115,62,53,53.91
Taric,Rengar,65,41,24,63.08
Taric,Sion,100,57,43,57
Taric,Sylas,132,62,70,46.97
Taric,Khazix,65,57,8,87.69
Taric,Rell,57,41,16,71.93
Taric,Shen,97,67,30,69.07
Taric,Syndra,67,29,38,43.28
Taric,Vex,58,35,23,60.34
Taric,Gnar,69,41,28,59.42
Taric,Janna,44,37,7,84.09
Taric,Lulu,99,52,47,52.53
Taric,Nocturne,85,50,35,58.82
Taric,Skarner,48,32,16,66.67
Taric,Rumble,32,5,27,15.63
Taric,Malphite,80,33,47,41.25
Taric,AurelionSol,74,10,64,13.51
Taric,Bard,35,12,23,34.29
Taric,Kayle,84,56,28,66.67
Taric,TahmKench,150,87,63,58
Taric,Camille,41,26,15,63.41
Taric,Sona,42,7,35,16.67
Taric,Aatrox,109,26,83,23.85
Taric,Fiora,44,31,13,70.45
Taric,Aphelios,106,45,61,42.45
Taric,Olaf,20,10,10,50
Taric,Renata,25,9,16,36
Taric,Braum,44,8,36,18.18
Taric,Hecarim,33,30,3,90.91
Taric,Kled,22,7,15,31.82
Taric,Leblanc,19,9,10,47.37
Taric,Ivern,17,11,6,64.71
Taric,Zilean,9,3,6,33.33
Nidalee,Gwen,109,59,50,54.13
Nidalee,Talon,102,27,75,26.47
Nidalee,Yone,291,131,160,45.02
Nidalee,MissFortune,323,136,187,42.11
Nidalee,Taric,34,18,16,52.94
Nidalee,Volibear,174,73,101,41.95
Nidalee,Ivern,33,10,23,30.3
Nidalee,Irelia,137,59,78,43.07
Nidalee,Caitlyn,321,140,181,43.61
Nidalee,Swain,124,28,96,22.58
Nidalee,Poppy,114,58,56,50.88
Nidalee,Elise,101,53,48,52.48
Nidalee,Aurora,157,70,87,44.59
Nidalee,Tristana,109,40,69,36.7
Nidalee,Nami,175,73,102,41.71
Nidalee,MasterYi,150,56,94,37.33
Nidalee,Hwei,112,33,79,29.46
Nidalee,Samira,176,72,104,40.91
Nidalee,Kayn,251,96,155,38.25
Nidalee,Briar,151,49,102,32.45
Nidalee,Velkoz,119,56,63,47.06
Nidalee,Nilah,88,38,50,43.18
Nidalee,Yuumi,161,62,99,38.51
Nidalee,Aatrox,214,106,108,49.53
Nidalee,Shyvana,60,23,37,38.33
Nidalee,Vex,95,40,55,42.11
Nidalee,Ezreal,249,103,146,41.37
Nidalee,Malzahar,134,56,78,41.79
Nidalee,Renekton,47,13,34,27.66
Nidalee,Gragas,118,60,58,50.85
Nidalee,Viktor,109,47,62,43.12
Nidalee,Ashe,343,150,193,43.73
Nidalee,Morgana,208,98,110,47.12
Nidalee,Tryndamere,89,38,51,42.7
Nidalee,Shaco,147,33,114,22.45
Nidalee,Brand,85,31,54,36.47
Nidalee,Lux,406,142,264,34.98
Nidalee,Blitzcrank,102,43,59,42.16
Nidalee,Kaisa,222,126,96,56.76
Nidalee,Lulu,152,79,73,51.97
Nidalee,Katarina,135,63,72,46.67
Nidalee,Jinx,316,110,206,34.81
Nidalee,Garen,243,96,147,39.51
Nidalee,Veigar,133,68,65,51.13
Nidalee,Bard,64,31,33,48.44
Nidalee,Heimerdinger,66,27,39,40.91
Nidalee,Zed,176,86,90,48.86
Nidalee,Senna,142,58,84,40.85
Nidalee,Gangplank,47,17,30,36.17
Nidalee,Pyke,160,87,73,54.38
Nidalee,Vladimir,76,51,25,67.11
Nidalee,Nunu,169,69,100,40.83
Nidalee,Annie,29,10,19,34.48
Nidalee,Sona,66,23,43,34.85
Nidalee,Riven,78,32,46,41.03
Nidalee,Vi,144,58,86,40.28
Nidalee,Chogath,198,66,132,33.33
Nidalee,Fizz,55,13,42,23.64
Nidalee,Ziggs,108,37,71,34.26
Nidalee,Darius,325,130,195,40
Nidalee,Diana,197,107,90,54.31
Nidalee,Mordekaiser,222,99,123,44.59
Nidalee,Shen,109,43,66,39.45
Nidalee,Zac,60,40,20,66.67
Nidalee,Yasuo,353,132,221,37.39
Nidalee,TahmKench,218,101,117,46.33
Nidalee,Graves,118,53,65,44.92
Nidalee,Illaoi,102,32,70,31.37
Nidalee,FiddleSticks,101,38,63,37.62
Nidalee,Singed,39,6,33,15.38
Nidalee,Orianna,60,23,37,38.33
Nidalee,Corki,43,12,31,27.91
Nidalee,Neeko,97,36,61,37.11
Nidalee,Rell,82,46,36,56.1
Nidalee,Pantheon,304,147,157,48.36
Nidalee,Sylas,152,88,64,57.89
Nidalee,Galio,142,68,74,47.89
Nidalee,Zyra,92,49,43,53.26
Nidalee,AurelionSol,93,48,45,51.61
Nidalee,Soraka,136,49,87,36.03
Nidalee,Viego,124,50,74,40.32
Nidalee,Teemo,220,97,123,44.09
Nidalee,Ekko,104,44,60,42.31
Nidalee,Mel,435,189,246,43.45
Nidalee,Sion,171,68,103,39.77
Nidalee,Sett,209,101,108,48.33
Nidalee,Nautilus,194,60,134,30.93
Nidalee,DrMundo,102,34,68,33.33
Nidalee,JarvanIV,58,36,22,62.07
Nidalee,Amumu,181,65,116,35.91
Nidalee,Akali,133,59,74,44.36
Nidalee,Ahri,176,85,91,48.3
Nidalee,KSante,55,21,34,38.18
Nidalee,Jax,145,61,84,42.07
Nidalee,Seraphine,179,74,105,41.34
Nidalee,Nasus,152,50,102,32.89
Nidalee,XinZhao,98,67,31,68.37
Nidalee,Jhin,285,125,160,43.86
Nidalee,Yorick,94,35,59,37.23
Nidalee,Olaf,45,11,34,24.44
Nidalee,Varus,180,73,107,40.56
Nidalee,Quinn,59,26,33,44.07
Nidalee,Leblanc,53,35,18,66.04
Nidalee,Kayle,137,40,97,29.2
Nidalee,Qiyana,60,25,35,41.67
Nidalee,Lucian,134,59,75,44.03
Nidalee,Belveth,49,21,28,42.86
Nidalee,Draven,76,32,44,42.11
Nidalee,Warwick,232,86,146,37.07
Nidalee,Lillia,113,45,68,39.82
Nidalee,KogMaw,56,6,50,10.71
Nidalee,Khazix,83,35,48,42.17
Nidalee,Smolder,129,68,61,52.71
Nidalee,Milio,92,27,65,29.35
Nidalee,RekSai,19,3,16,15.79
Nidalee,Malphite,136,41,95,30.15
Nidalee,Nocturne,135,48,87,35.56
Nidalee,Zeri,56,24,32,42.86
Nidalee,Braum,111,42,69,37.84
Nidalee,Xayah,87,30,57,34.48
Nidalee,Rakan,90,23,67,25.56
Nidalee,Ambessa,122,55,67,45.08
Nidalee,Akshan,100,48,52,48
Nidalee,LeeSin,181,84,97,46.41
Nidalee,Vayne,138,51,87,36.96
Nidalee,Twitch,103,43,60,41.75
Nidalee,Alistar,49,22,27,44.9
Nidalee,Thresh,259,110,149,42.47
Nidalee,Evelynn,97,41,56,42.27
Nidalee,Udyr,96,23,73,23.96
Nidalee,Zoe,79,30,49,37.97
Nidalee,Ornn,94,22,72,23.4
Nidalee,Kennen,64,29,35,45.31
Nidalee,Ryze,33,3,30,9.09
Nidalee,Maokai,87,35,52,40.23
Nidalee,Hecarim,56,17,39,30.36
Nidalee,Syndra,84,34,50,40.48
Nidalee,Camille,73,34,39,46.58
Nidalee,Xerath,128,55,73,42.97
Nidalee,Kalista,96,51,45,53.13
Nidalee,Janna,30,9,21,30
Nidalee,Cassiopeia,57,27,30,47.37
Nidalee,Kindred,113,58,55,51.33
Nidalee,Aphelios,162,68,94,41.98
Nidalee,Karma,116,46,70,39.66
Nidalee,Karthus,63,29,34,46.03
Nidalee,TwistedFate,77,49,28,63.64
Nidalee,Kled,32,19,13,59.38
Nidalee,Rammus,43,19,24,44.19
Nidalee,Lissandra,37,13,24,35.14
Nidalee,Skarner,32,22,10,68.75
Nidalee,Kassadin,43,10,33,23.26
Nidalee,MonkeyKing,89,44,45,49.44
Nidalee,Renata,31,8,23,25.81
Nidalee,Leona,81,37,44,45.68
Nidalee,Sivir,88,26,62,29.55
Nidalee,Naafiri,71,29,42,40.85
Nidalee,Trundle,91,29,62,31.87
Nidalee,Urgot,118,63,55,53.39
Nidalee,Gnar,53,26,27,49.06
Nidalee,Fiora,43,12,31,27.91
Nidalee,Taliyah,62,30,32,48.39
Nidalee,Azir,54,12,42,22.22
Nidalee,Zilean,48,32,16,66.67
Nidalee,Rumble,38,6,32,15.79
Nidalee,Anivia,46,9,37,19.57
Nidalee,Jayce,103,58,45,56.31
Nidalee,Rengar,61,34,27,55.74
Nidalee,Sejuani,35,19,16,54.29
Nasus,Fiora,268,142,126,52.99
Nasus,MasterYi,586,320,266,54.61
Nasus,Mel,1022,520,502,50.88
Nasus,Jhin,714,351,363,49.16
Nasus,Karma,345,182,163,52.75
Nasus,Tryndamere,294,157,137,53.4
Nasus,Kayn,810,431,379,53.21
Nasus,Aurora,513,331,182,64.52
Nasus,Twitch,410,210,200,51.22
Nasus,Lux,1293,649,644,50.19
Nasus,Mordekaiser,885,424,461,47.91
Nasus,Diana,624,341,283,54.65
Nasus,Ahri,704,387,317,54.97
Nasus,Lulu,354,178,176,50.28
Nasus,Darius,914,433,481,47.37
Nasus,Amumu,430,227,203,52.79
Nasus,Yasuo,1015,475,540,46.8
Nasus,MissFortune,1147,526,621,45.86
Nasus,Swain,502,250,252,49.8
Nasus,Volibear,657,330,327,50.23
Nasus,LeeSin,402,233,169,57.96
Nasus,Kayle,433,212,221,48.96
Nasus,Ezreal,761,415,346,54.53
Nasus,Morgana,618,321,297,51.94
Nasus,Yone,997,559,438,56.07
Nasus,Nilah,315,196,119,62.22
Nasus,Malphite,405,188,217,46.42
Nasus,Warwick,971,495,476,50.98
Nasus,Vex,194,114,80,58.76
Nasus,Yuumi,402,201,201,50
Nasus,Yorick,528,198,330,37.5
Nasus,Ekko,394,223,171,56.6
Nasus,Katarina,486,346,140,71.19
Nasus,Jinx,988,477,511,48.28
Nasus,Sion,352,177,175,50.28
Nasus,Quinn,116,59,57,50.86
Nasus,Talon,202,86,116,42.57
Nasus,Syndra,306,127,179,41.5
Nasus,Caitlyn,1167,542,625,46.44
Nasus,Sett,773,443,330,57.31
Nasus,Kindred,309,216,93,69.9
Nasus,Veigar,507,263,244,51.87
Nasus,Kled,75,44,31,58.67
Nasus,Gragas,272,179,93,65.81
Nasus,Rell,231,128,103,55.41
Nasus,Sejuani,151,90,61,59.6
Nasus,Malzahar,326,124,202,38.04
Nasus,Rakan,278,143,135,51.44
Nasus,Aatrox,424,238,186,56.13
Nasus,Cassiopeia,222,103,119,46.4
Nasus,Varus,331,194,137,58.61
Nasus,Jayce,199,132,67,66.33
Nasus,Skarner,148,78,70,52.7
Nasus,Poppy,312,191,121,61.22
Nasus,Singed,197,114,83,57.87
Nasus,Viego,556,287,269,51.62
Nasus,Vayne,558,337,221,60.39
Nasus,Leona,443,273,170,61.63
Nasus,Akali,580,311,269,53.62
Nasus,Xayah,318,177,141,55.66
Nasus,Nautilus,469,266,203,56.72
Nasus,Milio,205,114,91,55.61
Nasus,Irelia,401,206,195,51.37
Nasus,Evelynn,268,130,138,48.51
Nasus,Anivia,118,65,53,55.08
Nasus,Ornn,192,76,116,39.58
Nasus,Gangplank,230,87,143,37.83
Nasus,Senna,425,183,242,43.06
Nasus,Smolder,329,151,178,45.9
Nasus,TahmKench,533,309,224,57.97
Nasus,Azir,158,96,62,60.76
Nasus,Pantheon,811,421,390,51.91
Nasus,Nami,379,182,197,48.02
Nasus,Xerath,322,174,148,54.04
Nasus,Ashe,837,409,428,48.86
Nasus,Ivern,85,56,29,65.88
Nasus,Seraphine,593,332,261,55.99
Nasus,Zoe,184,145,39,78.8
Nasus,Nunu,411,195,216,47.45
Nasus,Tristana,356,186,170,52.25
Nasus,Pyke,538,329,209,61.15
Nasus,Teemo,779,339,440,43.52
Nasus,Rengar,183,122,61,66.67
Nasus,Vladimir,230,146,84,63.48
Nasus,Kaisa,624,357,267,57.21
Nasus,Ambessa,309,146,163,47.25
Nasus,Maokai,220,103,117,46.82
Nasus,Garen,688,317,371,46.08
Nasus,Briar,471,201,270,42.68
Nasus,Zed,424,241,183,56.84
Nasus,Corki,145,63,82,43.45
Nasus,Karthus,95,62,33,65.26
Nasus,KSante,136,84,52,61.76
Nasus,Zeri,281,177,104,62.99
Nasus,Sylas,506,266,240,52.57
Nasus,Zac,135,58,77,42.96
Nasus,Renekton,294,139,155,47.28
Nasus,Zilean,115,66,49,57.39
Nasus,Ziggs,173,86,87,49.71
Nasus,JarvanIV,183,96,87,52.46
Nasus,Lucian,307,127,180,41.37
Nasus,Soraka,321,121,200,37.69
Nasus,Shen,308,144,164,46.75
Nasus,Chogath,545,274,271,50.28
Nasus,Braum,219,106,113,48.4
Nasus,Janna,108,57,51,52.78
Nasus,Gwen,293,147,146,50.17
Nasus,Neeko,445,237,208,53.26
Nasus,Taliyah,94,35,59,37.23
Nasus,Khazix,295,166,129,56.27
Nasus,Viktor,407,204,203,50.12
Nasus,Thresh,685,363,322,52.99
Nasus,MonkeyKing,193,124,69,64.25
Nasus,Samira,573,360,213,62.83
Nasus,FiddleSticks,284,148,136,52.11
Nasus,Velkoz,286,115,171,40.21
Nasus,XinZhao,357,150,207,42.02
Nasus,Trundle,300,125,175,41.67
Nasus,Fizz,194,100,94,51.55
Nasus,Aphelios,380,214,166,56.32
Nasus,Blitzcrank,362,209,153,57.73
Nasus,Belveth,141,70,71,49.65
Nasus,Heimerdinger,336,167,169,49.7
Nasus,Gnar,212,91,121,42.92
Nasus,Hecarim,141,78,63,55.32
Nasus,Zyra,277,161,116,58.12
Nasus,Nocturne,383,172,211,44.91
Nasus,KogMaw,155,78,77,50.32
Nasus,Naafiri,221,131,90,59.28
Nasus,Galio,337,140,197,41.54
Nasus,Elise,280,123,157,43.93
Nasus,Kennen,197,124,73,62.94
Nasus,Qiyana,204,114,90,55.88
Nasus,Jax,390,211,179,54.1
Nasus,Kassadin,124,51,73,41.13
Nasus,Urgot,298,155,143,52.01
Nasus,Akshan,162,67,95,41.36
Nasus,Bard,92,57,35,61.96
Nasus,Graves,266,139,127,52.26
Nasus,Annie,170,77,93,45.29
Nasus,Brand,317,122,195,38.49
Nasus,Taric,94,49,45,52.13
Nasus,Shaco,401,186,215,46.38
Nasus,Hwei,325,154,171,47.38
Nasus,Udyr,163,74,89,45.4
Nasus,Leblanc,190,78,112,41.05
Nasus,Shyvana,103,47,56,45.63
Nasus,Vi,383,174,209,45.43
Nasus,Draven,266,175,91,65.79
Nasus,Olaf,117,57,60,48.72
Nasus,Sivir,207,110,97,53.14
Nasus,Nidalee,152,102,50,67.11
Nasus,Kalista,205,123,82,60
Nasus,Rammus,155,73,82,47.1
Nasus,Rumble,94,53,41,56.38
Nasus,Illaoi,275,154,121,56
Nasus,Lillia,329,156,173,47.42
Nasus,Camille,199,121,78,60.8
Nasus,Renata,97,45,52,46.39
Nasus,TwistedFate,173,109,64,63.01
Nasus,Riven,254,155,99,61.02
Nasus,Lissandra,106,72,34,67.92
Nasus,Sona,166,108,58,65.06
Nasus,AurelionSol,253,121,132,47.83
Nasus,Alistar,108,52,56,48.15
Nasus,Orianna,153,73,80,47.71
Nasus,Ryze,109,58,51,53.21
Nasus,RekSai,58,49,9,84.48
Nasus,DrMundo,207,99,108,47.83
JarvanIV,Swain,297,142,155,47.81
JarvanIV,Malzahar,203,126,77,62.07
JarvanIV,Irelia,227,108,119,47.58
JarvanIV,Kalista,168,84,84,50
JarvanIV,Poppy,144,80,64,55.56
JarvanIV,Sett,389,185,204,47.56
JarvanIV,Taliyah,54,21,33,38.89
JarvanIV,Cassiopeia,91,46,45,50.55
JarvanIV,Kaisa,348,188,160,54.02
JarvanIV,Neeko,114,71,43,62.28
JarvanIV,Yasuo,495,278,217,56.16
JarvanIV,Evelynn,93,52,41,55.91
JarvanIV,Tristana,222,111,111,50
JarvanIV,Lux,632,362,270,57.28
JarvanIV,Volibear,235,112,123,47.66
JarvanIV,LeeSin,282,177,105,62.77
JarvanIV,Caitlyn,497,304,193,61.17
JarvanIV,Pyke,235,116,119,49.36
JarvanIV,Singed,88,55,33,62.5
JarvanIV,Viego,262,155,107,59.16
JarvanIV,Vayne,311,181,130,58.2
JarvanIV,MissFortune,404,185,219,45.79
JarvanIV,Leona,209,85,124,40.67
JarvanIV,Gangplank,114,64,50,56.14
JarvanIV,Rengar,116,75,41,64.66
JarvanIV,Kennen,64,35,29,54.69
JarvanIV,Akali,250,139,111,55.6
JarvanIV,Kayn,363,182,181,50.14
JarvanIV,Sylas,280,129,151,46.07
JarvanIV,Draven,100,59,41,59
JarvanIV,Velkoz,166,75,91,45.18
JarvanIV,Mordekaiser,312,145,167,46.47
JarvanIV,Amumu,238,135,103,56.72
JarvanIV,Qiyana,87,45,42,51.72
JarvanIV,Garen,389,168,221,43.19
JarvanIV,Diana,342,170,172,49.71
JarvanIV,Heimerdinger,56,38,18,67.86
JarvanIV,Vi,235,116,119,49.36
JarvanIV,Vladimir,111,50,61,45.05
JarvanIV,Leblanc,103,54,49,52.43
JarvanIV,Veigar,234,158,76,67.52
JarvanIV,Ashe,426,209,217,49.06
JarvanIV,Nautilus,279,168,111,60.22
JarvanIV,KSante,91,48,43,52.75
JarvanIV,MasterYi,228,125,103,54.82
JarvanIV,Mel,524,279,245,53.24
JarvanIV,Ekko,146,79,67,54.11
JarvanIV,Naafiri,132,76,56,57.58
JarvanIV,Kayle,195,130,65,66.67
JarvanIV,Tryndamere,139,81,58,58.27
JarvanIV,MonkeyKing,136,42,94,30.88
JarvanIV,Lucian,147,71,76,48.3
JarvanIV,Elise,179,108,71,60.34
JarvanIV,TahmKench,261,128,133,49.04
JarvanIV,Shaco,245,145,100,59.18
JarvanIV,Aurora,215,117,98,54.42
JarvanIV,Xayah,185,96,89,51.89
JarvanIV,Aatrox,263,122,141,46.39
JarvanIV,Skarner,64,46,18,71.88
JarvanIV,Nasus,183,87,96,47.54
JarvanIV,Katarina,196,120,76,61.22
JarvanIV,Rell,110,71,39,64.55
JarvanIV,Kled,68,34,34,50
JarvanIV,Nocturne,180,87,93,48.33
JarvanIV,Malphite,221,119,102,53.85
JarvanIV,Warwick,338,213,125,63.02
JarvanIV,Rakan,98,29,69,29.59
JarvanIV,Riven,91,58,33,63.74
JarvanIV,Jhin,407,199,208,48.89
JarvanIV,Thresh,330,182,148,55.15
JarvanIV,Trundle,105,46,59,43.81
JarvanIV,Rammus,108,41,67,37.96
JarvanIV,Fizz,126,67,59,53.17
JarvanIV,Sona,92,43,49,46.74
JarvanIV,Kindred,102,74,28,72.55
JarvanIV,Ezreal,458,286,172,62.45
JarvanIV,Seraphine,211,135,76,63.98
JarvanIV,Yone,378,215,163,56.88
JarvanIV,Taric,43,16,27,37.21
JarvanIV,Lillia,228,109,119,47.81
JarvanIV,Ahri,341,211,130,61.88
JarvanIV,Ornn,114,42,72,36.84
JarvanIV,Hwei,174,118,56,67.82
JarvanIV,Darius,385,223,162,57.92
JarvanIV,Hecarim,106,56,50,52.83
JarvanIV,Twitch,148,81,67,54.73
JarvanIV,Blitzcrank,196,118,78,60.2
JarvanIV,Camille,110,72,38,65.45
JarvanIV,Khazix,166,92,74,55.42
JarvanIV,Milio,179,78,101,43.58
JarvanIV,Renekton,142,81,61,57.04
JarvanIV,Renata,99,50,49,50.51
JarvanIV,Vex,142,84,58,59.15
JarvanIV,Sejuani,130,51,79,39.23
JarvanIV,Teemo,320,174,146,54.38
JarvanIV,Nidalee,58,22,36,37.93
JarvanIV,Lulu,285,161,124,56.49
JarvanIV,Yorick,269,154,115,57.25
JarvanIV,Aphelios,134,70,64,52.24
JarvanIV,Janna,59,39,20,66.1
JarvanIV,Soraka,130,49,81,37.69
JarvanIV,Gnar,106,48,58,45.28
JarvanIV,Zoe,85,54,31,63.53
JarvanIV,Gwen,138,91,47,65.94
JarvanIV,Jinx,513,252,261,49.12
JarvanIV,Nami,198,95,103,47.98
JarvanIV,Sion,205,109,96,53.17
JarvanIV,Jax,193,104,89,53.89
JarvanIV,Ambessa,159,79,80,49.69
JarvanIV,Rumble,59,24,35,40.68
JarvanIV,Briar,197,109,88,55.33
JarvanIV,Nilah,129,80,49,62.02
JarvanIV,Akshan,83,41,42,49.4
JarvanIV,Varus,236,98,138,41.53
JarvanIV,Braum,113,59,54,52.21
JarvanIV,Yuumi,239,108,131,45.19
JarvanIV,Bard,105,62,43,59.05
JarvanIV,Graves,108,73,35,67.59
JarvanIV,AurelionSol,130,57,73,43.85
JarvanIV,Chogath,378,214,164,56.61
JarvanIV,Viktor,160,50,110,31.25
JarvanIV,Zed,165,96,69,58.18
JarvanIV,Pantheon,421,243,178,57.72
JarvanIV,Galio,182,85,97,46.7
JarvanIV,Zeri,139,79,60,56.83
JarvanIV,Samira,200,105,95,52.5
JarvanIV,Shen,189,77,112,40.74
JarvanIV,Olaf,18,12,6,66.67
JarvanIV,Smolder,234,127,107,54.27
JarvanIV,Syndra,132,69,63,52.27
JarvanIV,Xerath,127,58,69,45.67
JarvanIV,Alistar,99,66,33,66.67
JarvanIV,FiddleSticks,100,52,48,52
JarvanIV,Corki,99,57,42,57.58
JarvanIV,Morgana,237,154,83,64.98
JarvanIV,Zac,83,40,43,48.19
JarvanIV,Maokai,123,75,48,60.98
JarvanIV,Ryze,74,62,12,83.78
JarvanIV,Karma,153,84,69,54.9
JarvanIV,Senna,207,117,90,56.52
JarvanIV,DrMundo,107,56,51,52.34
JarvanIV,Nunu,205,109,96,53.17
JarvanIV,Karthus,53,22,31,41.51
JarvanIV,Kassadin,25,12,13,48
JarvanIV,Sivir,117,82,35,70.09
JarvanIV,Azir,88,40,48,45.45
JarvanIV,Lissandra,68,29,39,42.65
JarvanIV,Talon,114,42,72,36.84
JarvanIV,XinZhao,171,62,109,36.26
JarvanIV,Zilean,55,31,24,56.36
JarvanIV,Gragas,130,49,81,37.69
JarvanIV,Shyvana,68,35,33,51.47
JarvanIV,Anivia,91,42,49,46.15
JarvanIV,RekSai,37,22,15,59.46
JarvanIV,TwistedFate,74,31,43,41.89
JarvanIV,Urgot,89,41,48,46.07
JarvanIV,Orianna,110,56,54,50.91
JarvanIV,Brand,152,79,73,51.97
JarvanIV,Jayce,118,72,46,61.02
JarvanIV,Fiora,88,49,39,55.68
JarvanIV,Udyr,85,49,36,57.65
JarvanIV,Illaoi,94,40,54,42.55
JarvanIV,KogMaw,66,20,46,30.3
JarvanIV,Ivern,63,22,41,34.92
JarvanIV,Annie,82,52,30,63.41
JarvanIV,Ziggs,95,19,76,20
JarvanIV,Quinn,91,51,40,56.04
JarvanIV,Zyra,128,67,61,52.34
JarvanIV,Belveth,20,6,14,30
Fizz,Irelia,279,171,108,61.29
Fizz,Kayn,598,315,283,52.68
Fizz,Katarina,319,196,123,61.44
Fizz,Vayne,284,132,152,46.48
Fizz,DrMundo,205,88,117,42.93
Fizz,Mordekaiser,589,286,303,48.56
Fizz,Amumu,280,131,149,46.79
Fizz,Pyke,372,225,147,60.48
Fizz,Varus,264,122,142,46.21
Fizz,Thresh,424,234,190,55.19
Fizz,Volibear,366,179,187,48.91
Fizz,LeeSin,278,154,124,55.4
Fizz,Kayle,204,90,114,44.12
Fizz,Ezreal,514,273,241,53.11
Fizz,Morgana,445,239,206,53.71
Fizz,Olaf,54,31,23,57.41
Fizz,Hecarim,125,67,58,53.6
Fizz,Veigar,430,196,234,45.58
Fizz,Tristana,276,122,154,44.2
Fizz,Braum,124,55,69,44.35
Fizz,Jax,290,142,148,48.97
Fizz,Diana,457,223,234,48.8
Fizz,Ahri,396,247,149,62.37
Fizz,Aphelios,227,74,153,32.6
Fizz,Senna,238,123,115,51.68
Fizz,KSante,109,64,45,58.72
Fizz,Yasuo,598,276,322,46.15
Fizz,MissFortune,776,350,426,45.1
Fizz,Lux,851,390,461,45.83
Fizz,Heimerdinger,181,95,86,52.49
Fizz,Warwick,604,285,319,47.19
Fizz,Ashe,539,310,229,57.51
Fizz,Garen,549,265,284,48.27
Fizz,Shyvana,118,52,66,44.07
Fizz,Mel,866,399,467,46.07
Fizz,Taliyah,82,45,37,54.88
Fizz,Swain,297,126,171,42.42
Fizz,Sett,461,228,233,49.46
Fizz,Lucian,211,119,92,56.4
Fizz,Sona,118,69,49,58.47
Fizz,Darius,607,284,323,46.79
Fizz,Gragas,157,96,61,61.15
Fizz,KogMaw,114,60,54,52.63
Fizz,Gnar,103,42,61,40.78
Fizz,Nami,309,129,180,41.75
Fizz,Yorick,353,140,213,39.66
Fizz,Sejuani,80,39,41,48.75
Fizz,Kalista,112,68,44,60.71
Fizz,Yuumi,335,188,147,56.12
Fizz,Urgot,161,37,124,22.98
Fizz,Viego,380,205,175,53.95
Fizz,Qiyana,125,63,62,50.4
Fizz,Draven,197,113,84,57.36
Fizz,MasterYi,308,144,164,46.75
Fizz,Akali,339,177,162,52.21
Fizz,Twitch,230,134,96,58.26
Fizz,Blitzcrank,278,128,150,46.04
Fizz,Shaco,333,208,125,62.46
Fizz,Ziggs,154,86,68,55.84
Fizz,Rumble,65,38,27,58.46
Fizz,Aurora,295,113,182,38.31
Fizz,Nautilus,316,161,155,50.95
Fizz,Xerath,250,134,116,53.6
Fizz,Khazix,216,107,109,49.54
Fizz,Karma,201,94,107,46.77
Fizz,Gwen,232,146,86,62.93
Fizz,Briar,328,164,164,50
Fizz,Zilean,81,37,44,45.68
Fizz,RekSai,51,6,45,11.76
Fizz,Ornn,116,66,50,56.9
Fizz,Seraphine,329,177,152,53.8
Fizz,Lillia,211,107,104,50.71
Fizz,Samira,333,175,158,52.55
Fizz,Neeko,218,116,102,53.21
Fizz,Ryze,60,34,26,56.67
Fizz,Smolder,253,144,109,56.92
Fizz,Zyra,222,129,93,58.11
Fizz,Zeri,136,68,68,50
Fizz,Zed,349,178,171,51
Fizz,Lulu,208,126,82,60.58
Fizz,Teemo,448,238,210,53.13
Fizz,Vi,280,121,159,43.21
Fizz,Galio,274,122,152,44.53
Fizz,Rell,134,82,52,61.19
Fizz,Yone,613,347,266,56.61
Fizz,Aatrox,356,182,174,51.12
Fizz,JarvanIV,126,59,67,46.83
Fizz,Cassiopeia,123,65,58,52.85
Fizz,Nasus,194,94,100,48.45
Fizz,Pantheon,541,254,287,46.95
Fizz,Singed,79,32,47,40.51
Fizz,Caitlyn,711,352,359,49.51
Fizz,Chogath,359,212,147,59.05
Fizz,Ekko,229,138,91,60.26
Fizz,Leblanc,141,82,59,58.16
Fizz,Jhin,581,321,260,55.25
Fizz,Nidalee,55,42,13,76.36
Fizz,Brand,217,74,143,34.1
Fizz,Renekton,125,72,53,57.6
Fizz,Rakan,193,110,83,56.99
Fizz,Vladimir,251,129,122,51.39
Fizz,Xayah,270,139,131,51.48
Fizz,Talon,228,105,123,46.05
Fizz,Renata,79,57,22,72.15
Fizz,Kaisa,464,255,209,54.96
Fizz,Evelynn,179,97,82,54.19
Fizz,Syndra,211,81,130,38.39
Fizz,Annie,105,83,22,79.05
Fizz,Rammus,102,40,62,39.22
Fizz,Velkoz,197,120,77,60.91
Fizz,Viktor,230,90,140,39.13
Fizz,Soraka,181,90,91,49.72
Fizz,Corki,55,16,39,29.09
Fizz,Akshan,111,61,50,54.95
Fizz,Milio,216,87,129,40.28
Fizz,Naafiri,136,74,62,54.41
Fizz,Hwei,235,119,116,50.64
Fizz,Kennen,102,63,39,61.76
Fizz,TahmKench,293,167,126,57
Fizz,Gangplank,120,56,64,46.67
Fizz,Alistar,80,35,45,43.75
Fizz,Illaoi,170,65,105,38.24
Fizz,Nocturne,282,148,134,52.48
Fizz,Kassadin,51,29,22,56.86
Fizz,TwistedFate,157,99,58,63.06
Fizz,Jinx,580,313,267,53.97
Fizz,Ambessa,100,72,28,72
Fizz,Malzahar,270,132,138,48.89
Fizz,Sion,258,134,124,51.94
Fizz,MonkeyKing,137,84,53,61.31
Fizz,Orianna,155,73,82,47.1
Fizz,Tryndamere,234,82,152,35.04
Fizz,Rengar,85,59,26,69.41
Fizz,Graves,149,90,59,60.4
Fizz,Udyr,104,50,54,48.08
Fizz,Maokai,141,80,61,56.74
Fizz,Sivir,135,64,71,47.41
Fizz,Anivia,133,86,47,64.66
Fizz,Azir,66,39,27,59.09
Fizz,Leona,194,95,99,48.97
Fizz,Skarner,83,42,41,50.6
Fizz,Sylas,359,204,155,56.82
Fizz,Quinn,93,28,65,30.11
Fizz,Nunu,265,118,147,44.53
Fizz,XinZhao,185,105,80,56.76
Fizz,Riven,140,97,43,69.29
Fizz,Belveth,72,44,28,61.11
Fizz,Trundle,131,67,64,51.15
Fizz,Taric,112,55,57,49.11
Fizz,Elise,189,101,88,53.44
Fizz,Fiora,105,54,51,51.43
Fizz,Camille,116,86,30,74.14
Fizz,Nilah,134,65,69,48.51
Fizz,Karthus,66,9,57,13.64
Fizz,Lissandra,86,36,50,41.86
Fizz,Malphite,208,120,88,57.69
Fizz,Janna,96,41,55,42.71
Fizz,Zac,110,67,43,60.91
Fizz,FiddleSticks,161,78,83,48.45
Fizz,Shen,195,75,120,38.46
Fizz,Poppy,179,94,85,52.51
Fizz,Kindred,142,70,72,49.3
Fizz,Vex,176,75,101,42.61
Fizz,Ivern,67,42,25,62.69
Fizz,Zoe,155,92,63,59.35
Fizz,AurelionSol,167,81,86,48.5
Fizz,Kled,67,38,29,56.72
Fizz,Jayce,166,122,44,73.49
Fizz,Bard,87,18,69,20.69
Ziggs,Irelia,228,122,106,53.51
Ziggs,Kayn,383,220,163,57.44
Ziggs,Katarina,237,135,102,56.96
Ziggs,Vayne,265,158,107,59.62
Ziggs,DrMundo,170,94,76,55.29
Ziggs,Mordekaiser,484,275,209,56.82
Ziggs,Udyr,110,47,63,42.73
Ziggs,Yorick,295,109,186,36.95
Ziggs,Sivir,144,82,62,56.94
Ziggs,Nautilus,274,150,124,54.74
Ziggs,Darius,515,272,243,52.82
Ziggs,Volibear,338,197,141,58.28
Ziggs,AurelionSol,149,99,50,66.44
Ziggs,Caitlyn,750,367,383,48.93
Ziggs,TahmKench,304,166,138,54.61
Ziggs,Lillia,198,119,79,60.1
Ziggs,Sylas,252,105,147,41.67
Ziggs,Lux,748,334,414,44.65
Ziggs,Viktor,164,94,70,57.32
Ziggs,Nocturne,186,80,106,43.01
Ziggs,Yasuo,436,214,222,49.08
Ziggs,Nilah,150,72,78,48
Ziggs,Bard,101,66,35,65.35
Ziggs,Jax,243,138,105,56.79
Ziggs,Jhin,511,268,243,52.45
Ziggs,Thresh,366,219,147,59.84
Ziggs,Aurora,226,143,83,63.27
Ziggs,Viego,353,162,191,45.89
Ziggs,Mel,617,358,259,58.02
Ziggs,Jinx,630,328,302,52.06
Ziggs,Velkoz,180,84,96,46.67
Ziggs,Kindred,167,97,70,58.08
Ziggs,Lulu,182,127,55,69.78
Ziggs,Ashe,513,253,260,49.32
Ziggs,Fiora,122,64,58,52.46
Ziggs,Teemo,458,197,261,43.01
Ziggs,Kaisa,259,135,124,52.12
Ziggs,Milio,159,80,79,50.31
Ziggs,Illaoi,147,57,90,38.78
Ziggs,Malzahar,204,100,104,49.02
Ziggs,Khazix,128,68,60,53.13
Ziggs,Leona,114,69,45,60.53
Ziggs,FiddleSticks,117,68,49,58.12
Ziggs,Gragas,151,91,60,60.26
Ziggs,LeeSin,213,132,81,61.97
Ziggs,Karma,188,97,91,51.6
Ziggs,Sett,460,216,244,46.96
Ziggs,Graves,152,84,68,55.26
Ziggs,Leblanc,79,50,29,63.29
Ziggs,Yuumi,232,104,128,44.83
Ziggs,KSante,93,50,43,53.76
Ziggs,Zed,264,154,110,58.33
Ziggs,Fizz,154,68,86,44.16
Ziggs,Draven,156,82,74,52.56
Ziggs,Renata,45,26,19,57.78
Ziggs,Warwick,414,230,184,55.56
Ziggs,MissFortune,593,311,282,52.45
Ziggs,Diana,428,244,184,57.01
Ziggs,Tristana,164,97,67,59.15
Ziggs,Taric,62,37,25,59.68
Ziggs,Sejuani,83,51,32,61.45
Ziggs,MonkeyKing,148,68,80,45.95
Ziggs,Kalista,150,90,60,60
Ziggs,Ezreal,457,262,195,57.33
Ziggs,Ekko,190,94,96,49.47
Ziggs,Nami,249,101,148,40.56
Ziggs,Cassiopeia,147,105,42,71.43
Ziggs,Lucian,143,77,66,53.85
Ziggs,Skarner,108,57,51,52.78
Ziggs,Ryze,65,29,36,44.62
Ziggs,Elise,204,124,80,60.78
Ziggs,Kayle,181,101,80,55.8
Ziggs,Tryndamere,166,86,80,51.81
Ziggs,Akali,317,180,137,56.78
Ziggs,Neeko,200,121,79,60.5
Ziggs,Yone,557,268,289,48.11
Ziggs,Singed,49,15,34,30.61
Ziggs,Smolder,227,135,92,59.47
Ziggs,Pyke,292,163,129,55.82
Ziggs,Aatrox,248,147,101,59.27
Ziggs,Xayah,200,108,92,54
Ziggs,Rakan,140,58,82,41.43
Ziggs,Rengar,100,61,39,61
Ziggs,Vi,292,163,129,55.82
Ziggs,Pantheon,422,203,219,48.1
Ziggs,Evelynn,163,108,55,66.26
Ziggs,Nasus,173,87,86,50.29
Ziggs,Briar,253,110,143,43.48
Ziggs,Veigar,331,194,137,58.61
Ziggs,Shen,236,131,105,55.51
Ziggs,Shaco,238,106,132,44.54
Ziggs,Chogath,372,196,176,52.69
Ziggs,Poppy,86,44,42,51.16
Ziggs,Senna,242,136,106,56.2
Ziggs,XinZhao,206,117,89,56.8
Ziggs,Taliyah,77,50,27,64.94
Ziggs,Samira,279,149,130,53.41
Ziggs,Kled,62,39,23,62.9
Ziggs,Varus,215,131,84,60.93
Ziggs,Gangplank,104,59,45,56.73
Ziggs,Olaf,52,29,23,55.77
Ziggs,Nidalee,108,71,37,65.74
Ziggs,Morgana,390,185,205,47.44
Ziggs,Soraka,171,98,73,57.31
Ziggs,Trundle,131,66,65,50.38
Ziggs,Ahri,333,197,136,59.16
Ziggs,Ornn,120,44,76,36.67
Ziggs,Amumu,244,128,116,52.46
Ziggs,Galio,224,94,130,41.96
Ziggs,Seraphine,348,191,157,54.89
Ziggs,Zyra,184,102,82,55.43
Ziggs,Malphite,256,166,90,64.84
Ziggs,Garen,421,202,219,47.98
Ziggs,Vladimir,145,75,70,51.72
Ziggs,MasterYi,257,114,143,44.36
Ziggs,Camille,79,52,27,65.82
Ziggs,Naafiri,126,61,65,48.41
Ziggs,Syndra,234,126,108,53.85
Ziggs,Blitzcrank,229,117,112,51.09
Ziggs,Riven,161,88,73,54.66
Ziggs,Hwei,223,103,120,46.19
Ziggs,Nunu,160,69,91,43.13
Ziggs,Zac,77,20,57,25.97
Ziggs,Annie,92,47,45,51.09
Ziggs,Renekton,125,61,64,48.8
Ziggs,Swain,278,102,176,36.69
Ziggs,Aphelios,232,122,110,52.59
Ziggs,Ambessa,128,56,72,43.75
Ziggs,Sona,108,39,69,36.11
Ziggs,Xerath,177,91,86,51.41
Ziggs,Zeri,98,44,54,44.9
Ziggs,Zilean,56,28,28,50
Ziggs,Akshan,92,39,53,42.39
Ziggs,Heimerdinger,205,99,106,48.29
Ziggs,Kassadin,55,12,43,21.82
Ziggs,Karthus,44,22,22,50
Ziggs,Twitch,198,79,119,39.9
Ziggs,Janna,70,32,38,45.71
Ziggs,Urgot,152,78,74,51.32
Ziggs,Ivern,65,20,45,30.77
Ziggs,Sion,152,90,62,59.21
Ziggs,Zoe,169,77,92,45.56
Ziggs,Talon,190,71,119,37.37
Ziggs,Gnar,93,78,15,83.87
Ziggs,Braum,138,65,73,47.1
Ziggs,Gwen,146,81,65,55.48
Ziggs,Corki,92,45,47,48.91
Ziggs,Brand,147,75,72,51.02
Ziggs,Qiyana,49,20,29,40.82
Ziggs,Vex,167,122,45,73.05
Ziggs,Shyvana,101,40,61,39.6
Ziggs,Maokai,86,43,43,50
Ziggs,Azir,43,20,23,46.51
Ziggs,Orianna,129,71,58,55.04
Ziggs,KogMaw,80,55,25,68.75
Ziggs,Belveth,68,36,32,52.94
Ziggs,Alistar,91,58,33,63.74
Ziggs,Hecarim,91,51,40,56.04
Ziggs,Lissandra,71,31,40,43.66
Ziggs,Rell,122,59,63,48.36
Ziggs,Rammus,125,74,51,59.2
Ziggs,Jayce,120,83,37,69.17
Ziggs,TwistedFate,87,44,43,50.57
Ziggs,Anivia,74,44,30,59.46
Ziggs,Quinn,61,20,41,32.79
Ziggs,Rumble,51,35,16,68.63
Ziggs,JarvanIV,95,76,19,80
Ziggs,RekSai,42,24,18,57.14
Ziggs,Kennen,50,34,16,68
Zyra,Sett,610,302,308,49.51
Zyra,Taliyah,90,24,66,26.67
Zyra,Cassiopeia,147,90,57,61.22
Zyra,Kaisa,641,425,216,66.3
Zyra,Neeko,346,193,153,55.78
Zyra,Malphite,252,138,114,54.76
Zyra,Jax,271,157,114,57.93
Zyra,Xayah,258,162,96,62.79
Zyra,Rakan,149,104,45,69.8
Zyra,Gwen,195,104,91,53.33
Zyra,Kayn,614,337,277,54.89
Zyra,Thresh,558,327,231,58.6
Zyra,Ezreal,707,388,319,54.88
Zyra,Yuumi,348,178,170,51.15
Zyra,Irelia,411,193,218,46.96
Zyra,Lillia,212,131,81,61.79
Zyra,Sylas,378,184,194,48.68
Zyra,Caitlyn,955,478,477,50.05
Zyra,Lux,1077,640,437,59.42
Zyra,Kennen,97,47,50,48.45
Zyra,MonkeyKing,230,126,104,54.78
Zyra,Vladimir,239,110,129,46.03
Zyra,Vayne,336,184,152,54.76
Zyra,Yone,808,468,340,57.92
Zyra,Smolder,289,141,148,48.79
Zyra,Poppy,257,137,120,53.31
Zyra,MasterYi,415,222,193,53.49
Zyra,AurelionSol,194,93,101,47.94
Zyra,Seraphine,442,229,213,51.81
Zyra,Mordekaiser,616,296,320,48.05
Zyra,Nunu,349,189,160,54.15
Zyra,Aurora,402,223,179,55.47
Zyra,Nami,392,243,149,61.99
Zyra,Swain,501,236,265,47.11
Zyra,Janna,129,56,73,43.41
Zyra,Briar,386,171,215,44.3
Zyra,Kassadin,76,28,48,36.84
Zyra,Yasuo,814,378,436,46.44
Zyra,Renata,108,59,49,54.63
Zyra,Amumu,390,173,217,44.36
Zyra,Tristana,323,174,149,53.87
Zyra,Pyke,472,287,185,60.81
Zyra,Fiora,152,92,60,60.53
Zyra,Samira,377,211,166,55.97
Zyra,Talon,251,125,126,49.8
Zyra,Varus,368,185,183,50.27
Zyra,Urgot,185,119,66,64.32
Zyra,Zed,415,296,119,71.33
Zyra,Mel,778,421,357,54.11
Zyra,Sejuani,141,77,64,54.61
Zyra,Ahri,513,327,186,63.74
Zyra,Jinx,852,445,407,52.23
Zyra,Nautilus,403,220,183,54.59
Zyra,Yorick,307,135,172,43.97
Zyra,Vi,350,202,148,57.71
Zyra,Shen,221,98,123,44.34
Zyra,Kindred,270,192,78,71.11
Zyra,Ekko,328,217,111,66.16
Zyra,Rell,240,131,109,54.58
Zyra,Gragas,230,137,93,59.57
Zyra,Blitzcrank,320,169,151,52.81
Zyra,Teemo,648,347,301,53.55
Zyra,Shaco,418,239,179,57.18
Zyra,Malzahar,228,111,117,48.68
Zyra,Ashe,763,455,308,59.63
Zyra,TahmKench,452,238,214,52.65
Zyra,Kayle,259,147,112,56.76
Zyra,Tryndamere,262,136,126,51.91
Zyra,Akali,342,190,152,55.56
Zyra,Jhin,597,313,284,52.43
Zyra,Maokai,159,69,90,43.4
Zyra,Ryze,128,80,48,62.5
Zyra,Viktor,326,159,167,48.77
Zyra,Twitch,258,144,114,55.81
Zyra,Lulu,278,189,89,67.99
Zyra,DrMundo,322,153,169,47.52
Zyra,Fizz,222,93,129,41.89
Zyra,Leona,338,165,173,48.82
Zyra,Darius,809,450,359,55.62
Zyra,FiddleSticks,188,106,82,56.38
Zyra,Hwei,282,142,140,50.35
Zyra,Anivia,142,73,69,51.41
Zyra,Illaoi,189,95,94,50.26
Zyra,Chogath,451,259,192,57.43
Zyra,MissFortune,825,473,352,57.33
Zyra,Braum,166,95,71,57.23
Zyra,Galio,288,121,167,42.01
Zyra,TwistedFate,160,110,50,68.75
Zyra,Singed,104,37,67,35.58
Zyra,Trundle,215,114,101,53.02
Zyra,Rammus,131,58,73,44.27
Zyra,Sona,182,107,75,58.79
Zyra,Kled,79,45,34,56.96
Zyra,Zeri,164,80,84,48.78
Zyra,Pantheon,641,375,266,58.5
Zyra,Gangplank,167,87,80,52.1
Zyra,Zoe,206,123,83,59.71
Zyra,Draven,215,129,86,60
Zyra,Katarina,407,289,118,71.01
Zyra,Garen,608,336,272,55.26
Zyra,Brand,287,158,129,55.05
Zyra,Zac,127,50,77,39.37
Zyra,Karma,321,164,157,51.09
Zyra,Velkoz,244,151,93,61.89
Zyra,Hecarim,161,83,78,51.55
Zyra,Soraka,268,123,145,45.9
Zyra,Evelynn,160,105,55,65.63
Zyra,Morgana,574,312,262,54.36
Zyra,Nasus,277,116,161,41.88
Zyra,Skarner,103,52,51,50.49
Zyra,Ziggs,184,82,102,44.57
Zyra,Sivir,236,134,102,56.78
Zyra,Nocturne,305,139,166,45.57
Zyra,KogMaw,158,66,92,41.77
Zyra,LeeSin,379,233,146,61.48
Zyra,Orianna,174,83,91,47.7
Zyra,Gnar,175,94,81,53.71
Zyra,Khazix,259,134,125,51.74
Zyra,Diana,589,356,233,60.44
Zyra,KSante,176,118,58,67.05
Zyra,Syndra,320,161,159,50.31
Zyra,Ambessa,224,139,85,62.05
Zyra,Elise,221,115,106,52.04
Zyra,Akshan,93,43,50,46.24
Zyra,Sion,335,156,179,46.57
Zyra,Renekton,191,89,102,46.6
Zyra,Viego,517,258,259,49.9
Zyra,Riven,165,109,56,66.06
Zyra,Azir,122,38,84,31.15
Zyra,Ornn,162,72,90,44.44
Zyra,Lucian,230,141,89,61.3
Zyra,Karthus,140,100,40,71.43
Zyra,Heimerdinger,214,117,97,54.67
Zyra,Camille,106,60,46,56.6
Zyra,Nidalee,92,43,49,46.74
Zyra,Aphelios,313,185,128,59.11
Zyra,Xerath,300,150,150,50
Zyra,RekSai,66,26,40,39.39
Zyra,Warwick,747,387,360,51.81
Zyra,Shyvana,81,59,22,72.84
Zyra,Udyr,106,61,45,57.55
Zyra,Milio,234,131,103,55.98
Zyra,XinZhao,199,96,103,48.24
Zyra,Veigar,448,212,236,47.32
Zyra,Senna,421,213,208,50.59
Zyra,Olaf,165,77,88,46.67
Zyra,Taric,66,34,32,51.52
Zyra,Volibear,433,227,206,52.42
Zyra,Bard,151,87,64,57.62
Zyra,Jayce,213,149,64,69.95
Zyra,Rengar,131,68,63,51.91
Zyra,Qiyana,126,78,48,61.9
Zyra,Ivern,103,68,35,66.02
Zyra,Naafiri,192,98,94,51.04
Zyra,Aatrox,386,211,175,54.66
Zyra,Vex,234,115,119,49.15
Zyra,Belveth,130,69,61,53.08
Zyra,Nilah,250,122,128,48.8
Zyra,Alistar,121,70,51,57.85
Zyra,Annie,133,84,49,63.16
Zyra,Corki,126,54,72,42.86
Zyra,Lissandra,108,60,48,55.56
Zyra,Quinn,154,75,79,48.7
Zyra,Leblanc,150,115,35,76.67
Zyra,Zilean,107,60,47,56.07
Zyra,Rumble,90,43,47,47.78
Zyra,Kalista,148,71,77,47.97
Zyra,Graves,212,154,58,72.64
Zyra,JarvanIV,128,61,67,47.66
Taliyah,Gwen,94,60,34,63.83
Taliyah,JarvanIV,54,33,21,61.11
Taliyah,Yone,281,133,148,47.33
Taliyah,Zyra,90,66,24,73.33
Taliyah,Seraphine,120,63,57,52.5
Taliyah,Kayle,122,64,58,52.46
Taliyah,MonkeyKing,104,45,59,43.27
Taliyah,RekSai,25,6,19,24
Taliyah,Sett,263,133,130,50.57
Taliyah,Vi,189,82,107,43.39
Taliyah,AurelionSol,86,23,63,26.74
Taliyah,Corki,49,19,30,38.78
Taliyah,Milio,95,75,20,78.95
Taliyah,Shen,116,54,62,46.55
Taliyah,Teemo,270,100,170,37.04
Taliyah,Twitch,100,19,81,19
Taliyah,Nautilus,227,111,116,48.9
Taliyah,Yasuo,479,194,285,40.5
Taliyah,Evelynn,60,34,26,56.67
Taliyah,Irelia,131,58,73,44.27
Taliyah,Tristana,153,89,64,58.17
Taliyah,Lux,421,189,232,44.89
Taliyah,Gnar,95,54,41,56.84
Taliyah,Jax,160,72,88,45
Taliyah,Aurora,85,47,38,55.29
Taliyah,Swain,160,92,68,57.5
Taliyah,Bard,57,24,33,42.11
Taliyah,Briar,165,96,69,58.18
Taliyah,Fizz,82,37,45,45.12
Taliyah,Jinx,346,170,176,49.13
Taliyah,Soraka,113,36,77,31.86
Taliyah,Volibear,175,94,81,53.71
Taliyah,Viego,178,95,83,53.37
Taliyah,Samira,122,79,43,64.75
Taliyah,Leona,196,109,87,55.61
Taliyah,Darius,345,183,162,53.04
Taliyah,Shaco,125,56,69,44.8
Taliyah,Zed,134,65,69,48.51
Taliyah,Kaisa,267,162,105,60.67
Taliyah,Braum,92,58,34,63.04
Taliyah,Ornn,62,28,34,45.16
Taliyah,Yorick,148,59,89,39.86
Taliyah,Zoe,68,49,19,72.06
Taliyah,Blitzcrank,161,76,85,47.2
Taliyah,Pantheon,281,144,137,51.25
Taliyah,Rengar,99,56,43,56.57
Taliyah,Ekko,136,81,55,59.56
Taliyah,Kalista,82,34,48,41.46
Taliyah,Thresh,271,127,144,46.86
Taliyah,Gangplank,90,53,37,58.89
Taliyah,Nunu,173,81,92,46.82
Taliyah,Rakan,58,32,26,55.17
Taliyah,Varus,131,70,61,53.44
Taliyah,Khazix,90,59,31,65.56
Taliyah,Caitlyn,366,173,193,47.27
Taliyah,Taric,56,26,30,46.43
Taliyah,LeeSin,252,134,118,53.17
Taliyah,Sona,55,16,39,29.09
Taliyah,Mordekaiser,237,106,131,44.73
Taliyah,Lillia,127,66,61,51.97
Taliyah,Fiora,63,36,27,57.14
Taliyah,Nocturne,144,36,108,25
Taliyah,Ryze,49,9,40,18.37
Taliyah,Sion,177,55,122,31.07
Taliyah,Ahri,291,165,126,56.7
Taliyah,Ashe,332,161,171,48.49
Taliyah,Singed,59,20,39,33.9
Taliyah,Nasus,94,59,35,62.77
Taliyah,Amumu,174,68,106,39.08
Taliyah,Ezreal,282,150,132,53.19
Taliyah,Veigar,187,68,119,36.36
Taliyah,Ziggs,77,27,50,35.06
Taliyah,Sylas,161,63,98,39.13
Taliyah,Viktor,95,47,48,49.47
Taliyah,Draven,111,54,57,48.65
Taliyah,Katarina,142,49,93,34.51
Taliyah,MasterYi,169,76,93,44.97
Taliyah,Nilah,62,53,9,85.48
Taliyah,Nami,183,62,121,33.88
Taliyah,Kayn,257,128,129,49.81
Taliyah,Akshan,51,24,27,47.06
Taliyah,XinZhao,108,29,79,26.85
Taliyah,MissFortune,316,150,166,47.47
Taliyah,Jhin,283,127,156,44.88
Taliyah,Neeko,108,61,47,56.48
Taliyah,Vladimir,117,42,75,35.9
Taliyah,Smolder,143,80,63,55.94
Taliyah,Malphite,145,54,91,37.24
Taliyah,Annie,57,16,41,28.07
Taliyah,KogMaw,65,38,27,58.46
Taliyah,Alistar,82,49,33,59.76
Taliyah,Galio,120,60,60,50
Taliyah,FiddleSticks,104,69,35,66.35
Taliyah,Xerath,109,51,58,46.79
Taliyah,Lucian,102,49,53,48.04
Taliyah,Skarner,72,35,37,48.61
Taliyah,Diana,223,84,139,37.67
Taliyah,Vex,91,39,52,42.86
Taliyah,Karthus,67,41,26,61.19
Taliyah,TahmKench,213,91,122,42.72
Taliyah,Camille,77,31,46,40.26
Taliyah,Aphelios,128,28,100,21.88
Taliyah,Renata,60,40,20,66.67
Taliyah,Warwick,215,109,106,50.7
Taliyah,Morgana,158,67,91,42.41
Taliyah,Yuumi,124,72,52,58.06
Taliyah,Mel,403,201,202,49.88
Taliyah,Cassiopeia,46,40,6,86.96
Taliyah,Heimerdinger,106,57,49,53.77
Taliyah,Azir,52,21,31,40.38
Taliyah,Chogath,202,115,87,56.93
Taliyah,Poppy,83,44,39,53.01
Taliyah,Illaoi,98,40,58,40.82
Taliyah,Graves,105,74,31,70.48
Taliyah,Gragas,107,55,52,51.4
Taliyah,DrMundo,102,51,51,50
Taliyah,Lulu,169,81,88,47.93
Taliyah,Qiyana,60,24,36,40
Taliyah,Garen,263,94,169,35.74
Taliyah,KSante,66,28,38,42.42
Taliyah,Rell,100,39,61,39
Taliyah,Kennen,64,34,30,53.13
Taliyah,Hwei,145,91,54,62.76
Taliyah,Brand,78,30,48,38.46
Taliyah,Urgot,80,42,38,52.5
Taliyah,Akali,226,100,126,44.25
Taliyah,Vayne,217,105,112,48.39
Taliyah,Aatrox,141,76,65,53.9
Taliyah,Ambessa,116,68,48,58.62
Taliyah,Tryndamere,113,51,62,45.13
Taliyah,Janna,79,16,63,20.25
Taliyah,Talon,128,59,69,46.09
Taliyah,Hecarim,50,24,26,48
Taliyah,Elise,96,37,59,38.54
Taliyah,Sivir,51,22,29,43.14
Taliyah,Udyr,67,33,34,49.25
Taliyah,Ivern,25,11,14,44
Taliyah,Velkoz,93,42,51,45.16
Taliyah,Xayah,87,28,59,32.18
Taliyah,Trundle,87,24,63,27.59
Taliyah,Karma,123,67,56,54.47
Taliyah,Kindred,91,60,31,65.93
Taliyah,Riven,90,59,31,65.56
Taliyah,Zeri,65,31,34,47.69
Taliyah,Pyke,157,93,64,59.24
Taliyah,Jayce,91,50,41,54.95
Taliyah,Zac,91,57,34,62.64
Taliyah,Sejuani,40,30,10,75
Taliyah,Zilean,84,50,34,59.52
Taliyah,Senna,190,92,98,48.42
Taliyah,Kassadin,32,19,13,59.38
Taliyah,Lissandra,23,6,17,26.09
Taliyah,Shyvana,67,28,39,41.79
Taliyah,Kled,46,27,19,58.7
Taliyah,Malzahar,107,49,58,45.79
Taliyah,Naafiri,74,38,36,51.35
Taliyah,Orianna,97,48,49,49.48
Taliyah,Syndra,57,36,21,63.16
Taliyah,TwistedFate,48,26,22,54.17
Taliyah,Olaf,51,33,18,64.71
Taliyah,Rammus,37,9,28,24.32
Taliyah,Leblanc,55,35,20,63.64
Taliyah,Maokai,87,47,40,54.02
Taliyah,Nidalee,62,32,30,51.61
Taliyah,Quinn,58,46,12,79.31
Taliyah,Anivia,48,25,23,52.08
Taliyah,Renekton,71,23,48,32.39
Taliyah,Rumble,32,20,12,62.5
Taliyah,Belveth,20,6,14,30
Cassiopeia,Gwen,160,75,85,46.88
Cassiopeia,JarvanIV,91,45,46,49.45
Cassiopeia,Yone,523,259,264,49.52
Cassiopeia,Zyra,147,57,90,38.78
Cassiopeia,Seraphine,257,143,114,55.64
Cassiopeia,Irelia,228,108,120,47.37
Cassiopeia,Pantheon,377,179,198,47.48
Cassiopeia,Kassadin,38,19,19,50
Cassiopeia,Jhin,385,214,171,55.58
Cassiopeia,Yuumi,146,76,70,52.05
Cassiopeia,Ornn,69,37,32,53.62
Cassiopeia,Poppy,174,69,105,39.66
Cassiopeia,MissFortune,553,244,309,44.12
Cassiopeia,Brand,141,82,59,58.16
Cassiopeia,Yorick,197,90,107,45.69
Cassiopeia,Kayn,351,138,213,39.32
Cassiopeia,Sivir,125,66,59,52.8
Cassiopeia,Xerath,242,124,118,51.24
Cassiopeia,Zac,100,38,62,38
Cassiopeia,Amumu,281,125,156,44.48
Cassiopeia,Chogath,314,142,172,45.22
Cassiopeia,Twitch,175,105,70,60
Cassiopeia,Mel,594,320,274,53.87
Cassiopeia,Mordekaiser,414,210,204,50.72
Cassiopeia,Diana,352,150,202,42.61
Cassiopeia,Ezreal,389,204,185,52.44
Cassiopeia,Thresh,315,183,132,58.1
Cassiopeia,Nunu,149,76,73,51.01
Cassiopeia,Zed,196,112,84,57.14
Cassiopeia,Rakan,113,64,49,56.64
Cassiopeia,Renekton,103,55,48,53.4
Cassiopeia,Khazix,136,62,74,45.59
Cassiopeia,Malzahar,192,100,92,52.08
Cassiopeia,Lux,582,306,276,52.58
Cassiopeia,Quinn,70,35,35,50
Cassiopeia,TahmKench,247,151,96,61.13
Cassiopeia,Sett,371,167,204,45.01
Cassiopeia,Blitzcrank,236,79,157,33.47
Cassiopeia,Katarina,170,82,88,48.24
Cassiopeia,Shaco,221,117,104,52.94
Cassiopeia,Neeko,220,123,97,55.91
Cassiopeia,Caitlyn,635,308,327,48.5
Cassiopeia,Nasus,222,119,103,53.6
Cassiopeia,FiddleSticks,92,63,29,68.48
Cassiopeia,Azir,127,55,72,43.31
Cassiopeia,Xayah,122,68,54,55.74
Cassiopeia,Nami,185,113,72,61.08
Cassiopeia,Teemo,451,220,231,48.78
Cassiopeia,Maokai,92,34,58,36.96
Cassiopeia,Sylas,222,107,115,48.2
Cassiopeia,Corki,83,52,31,62.65
Cassiopeia,Taric,76,24,52,31.58
Cassiopeia,Kayle,183,102,81,55.74
Cassiopeia,Nocturne,210,98,112,46.67
Cassiopeia,Lucian,100,41,59,41
Cassiopeia,Garen,374,162,212,43.32
Cassiopeia,Darius,419,207,212,49.4
Cassiopeia,Aatrox,224,97,127,43.3
Cassiopeia,Jinx,439,164,275,37.36
Cassiopeia,Morgana,342,142,200,41.52
Cassiopeia,Olaf,77,28,49,36.36
Cassiopeia,Draven,139,60,79,43.17
Cassiopeia,Kled,57,23,34,40.35
Cassiopeia,Vex,238,109,129,45.8
Cassiopeia,Yasuo,396,214,182,54.04
Cassiopeia,Lulu,195,81,114,41.54
Cassiopeia,XinZhao,165,72,93,43.64
Cassiopeia,Ziggs,147,42,105,28.57
Cassiopeia,LeeSin,259,155,104,59.85
Cassiopeia,Graves,90,63,27,70
Cassiopeia,Briar,285,149,136,52.28
Cassiopeia,Ryze,68,25,43,36.76
Cassiopeia,Singed,34,29,5,85.29
Cassiopeia,Nautilus,312,153,159,49.04
Cassiopeia,Aurora,258,131,127,50.78
Cassiopeia,Kindred,95,66,29,69.47
Cassiopeia,Viktor,167,75,92,44.91
Cassiopeia,Vayne,240,134,106,55.83
Cassiopeia,Tryndamere,151,68,83,45.03
Cassiopeia,Hwei,178,86,92,48.31
Cassiopeia,Sona,123,45,78,36.59
Cassiopeia,Udyr,107,50,57,46.73
Cassiopeia,Swain,252,127,125,50.4
Cassiopeia,Kalista,109,69,40,63.3
Cassiopeia,Aphelios,199,102,97,51.26
Cassiopeia,Soraka,140,63,77,45
Cassiopeia,Trundle,120,63,57,52.5
Cassiopeia,Rammus,107,79,28,73.83
Cassiopeia,Fizz,123,58,65,47.15
Cassiopeia,Ashe,353,171,182,48.44
Cassiopeia,Kennen,102,62,40,60.78
Cassiopeia,Zeri,105,60,45,57.14
Cassiopeia,Rengar,108,49,59,45.37
Cassiopeia,Ahri,379,204,175,53.83
Cassiopeia,Orianna,98,55,43,56.12
Cassiopeia,Smolder,189,94,95,49.74
Cassiopeia,Gnar,126,78,48,61.9
Cassiopeia,Vi,227,94,133,41.41
Cassiopeia,Rell,180,85,95,47.22
Cassiopeia,Kaisa,335,155,180,46.27
Cassiopeia,Zoe,124,54,70,43.55
Cassiopeia,Naafiri,86,46,40,53.49
Cassiopeia,Hecarim,112,60,52,53.57
Cassiopeia,Velkoz,207,83,124,40.1
Cassiopeia,Warwick,423,190,233,44.92
Cassiopeia,Ambessa,110,47,63,42.73
Cassiopeia,Karma,147,56,91,38.1
Cassiopeia,Jax,239,95,144,39.75
Cassiopeia,Samira,250,122,128,48.8
Cassiopeia,Elise,159,94,65,59.12
Cassiopeia,Sejuani,88,25,63,28.41
Cassiopeia,MasterYi,249,94,155,37.75
Cassiopeia,Annie,64,29,35,45.31
Cassiopeia,Renata,41,23,18,56.1
Cassiopeia,Riven,107,67,40,62.62
Cassiopeia,Illaoi,73,26,47,35.62
Cassiopeia,Urgot,136,70,66,51.47
Cassiopeia,Viego,265,159,106,60
Cassiopeia,Fiora,108,45,63,41.67
Cassiopeia,Akshan,108,49,59,45.37
Cassiopeia,Nilah,117,47,70,40.17
Cassiopeia,Qiyana,85,47,38,55.29
Cassiopeia,Malphite,188,75,113,39.89
Cassiopeia,Lillia,164,87,77,53.05
Cassiopeia,Taliyah,46,6,40,13.04
Cassiopeia,Belveth,76,22,54,28.95
Cassiopeia,Syndra,198,85,113,42.93
Cassiopeia,Camille,55,40,15,72.73
Cassiopeia,Galio,172,112,60,65.12
Cassiopeia,Varus,179,83,96,46.37
Cassiopeia,Gangplank,110,64,46,58.18
Cassiopeia,Akali,254,139,115,54.72
Cassiopeia,Vladimir,164,51,113,31.1
Cassiopeia,Leona,198,67,131,33.84
Cassiopeia,Senna,215,109,106,50.7
Cassiopeia,Alistar,72,43,29,59.72
Cassiopeia,Talon,143,72,71,50.35
Cassiopeia,Volibear,249,137,112,55.02
Cassiopeia,Anivia,105,72,33,68.57
Cassiopeia,Heimerdinger,122,53,69,43.44
Cassiopeia,KSante,81,30,51,37.04
Cassiopeia,Karthus,72,31,41,43.06
Cassiopeia,Ekko,177,55,122,31.07
Cassiopeia,Sion,215,90,125,41.86
Cassiopeia,Pyke,274,141,133,51.46
Cassiopeia,Ivern,47,21,26,44.68
Cassiopeia,Lissandra,51,21,30,41.18
Cassiopeia,Evelynn,113,65,48,57.52
Cassiopeia,Milio,81,34,47,41.98
Cassiopeia,Skarner,93,54,39,58.06
Cassiopeia,MonkeyKing,112,82,30,73.21
Cassiopeia,Leblanc,69,34,35,49.28
Cassiopeia,KogMaw,83,43,40,51.81
Cassiopeia,DrMundo,155,81,74,52.26
Cassiopeia,Zilean,36,13,23,36.11
Cassiopeia,RekSai,36,23,13,63.89
Cassiopeia,AurelionSol,101,57,44,56.44
Cassiopeia,Shen,83,38,45,45.78
Cassiopeia,Gragas,132,87,45,65.91
Cassiopeia,Tristana,277,130,147,46.93
Cassiopeia,Janna,47,21,26,44.68
Cassiopeia,Veigar,256,113,143,44.14
Cassiopeia,Bard,62,22,40,35.48
Cassiopeia,Nidalee,57,30,27,52.63
Cassiopeia,TwistedFate,81,29,52,35.8
Cassiopeia,Shyvana,57,14,43,24.56
Cassiopeia,Braum,83,36,47,43.37
Cassiopeia,Jayce,102,37,65,36.27
Cassiopeia,Rumble,29,10,19,34.48
Evelynn,Teemo,575,213,362,37.04
Evelynn,Hecarim,102,54,48,52.94
Evelynn,Veigar,342,113,229,33.04
Evelynn,Ashe,629,294,335,46.74
Evelynn,Thresh,321,133,188,41.43
Evelynn,Yasuo,687,330,357,48.03
Evelynn,Sylas,290,108,182,37.24
Evelynn,Zed,336,176,160,52.38
Evelynn,Sivir,134,52,82,38.81
Evelynn,Blitzcrank,280,135,145,48.21
Evelynn,Darius,593,314,279,52.95
Evelynn,Garen,506,224,282,44.27
Evelynn,Lux,996,530,466,53.21
Evelynn,Rakan,235,103,132,43.83
Evelynn,Riven,192,107,85,55.73
Evelynn,JarvanIV,93,41,52,44.09
Evelynn,Taliyah,60,26,34,43.33
Evelynn,Draven,159,76,83,47.8
Evelynn,Malphite,207,79,128,38.16
Evelynn,Diana,529,275,254,51.98
Evelynn,Akali,415,184,231,44.34
Evelynn,Jinx,724,290,434,40.06
Evelynn,Illaoi,138,52,86,37.68
Evelynn,Khazix,240,114,126,47.5
Evelynn,Syndra,180,120,60,66.67
Evelynn,Kaisa,434,225,209,51.84
Evelynn,Heimerdinger,146,54,92,36.99
Evelynn,FiddleSticks,179,80,99,44.69
Evelynn,Katarina,286,157,129,54.9
Evelynn,Caitlyn,693,341,352,49.21
Evelynn,Pyke,488,274,214,56.15
Evelynn,Pantheon,563,262,301,46.54
Evelynn,Nocturne,325,166,159,51.08
Evelynn,Aurora,317,142,175,44.79
Evelynn,MissFortune,719,360,359,50.07
Evelynn,Soraka,210,81,129,38.57
Evelynn,Yone,674,327,347,48.52
Evelynn,Irelia,293,127,166,43.34
Evelynn,Morgana,625,249,376,39.84
Evelynn,Gnar,165,92,73,55.76
Evelynn,Rammus,72,50,22,69.44
Evelynn,Akshan,97,42,55,43.3
Evelynn,Poppy,189,93,96,49.21
Evelynn,Warwick,576,240,336,41.67
Evelynn,Zoe,149,76,73,51.01
Evelynn,Gragas,144,72,72,50
Evelynn,Mordekaiser,568,201,367,35.39
Evelynn,Viego,430,195,235,45.35
Evelynn,Udyr,117,69,48,58.97
Evelynn,Ahri,465,206,259,44.3
Evelynn,Karma,196,95,101,48.47
Evelynn,Sett,498,238,260,47.79
Evelynn,KSante,113,68,45,60.18
Evelynn,MonkeyKing,160,97,63,60.63
Evelynn,Ekko,287,132,155,45.99
Evelynn,Lucian,142,62,80,43.66
Evelynn,Senna,236,104,132,44.07
Evelynn,Nasus,268,138,130,51.49
Evelynn,Malzahar,248,79,169,31.85
Evelynn,Ezreal,508,249,259,49.02
Evelynn,Mel,670,272,398,40.6
Evelynn,Jhin,565,235,330,41.59
Evelynn,Nami,266,154,112,57.89
Evelynn,Vayne,347,159,188,45.82
Evelynn,LeeSin,385,194,191,50.39
Evelynn,Seraphine,349,169,180,48.42
Evelynn,Shyvana,119,63,56,52.94
Evelynn,Viktor,245,122,123,49.8
Evelynn,Janna,75,34,41,45.33
Evelynn,Jax,313,150,163,47.92
Evelynn,Olaf,39,18,21,46.15
Evelynn,Shaco,313,161,152,51.44
Evelynn,TahmKench,330,130,200,39.39
Evelynn,RekSai,29,9,20,31.03
Evelynn,Tristana,377,164,213,43.5
Evelynn,Xayah,272,139,133,51.1
Evelynn,MasterYi,382,208,174,54.45
Evelynn,Renekton,108,32,76,29.63
Evelynn,Fiora,164,67,97,40.85
Evelynn,Kayn,465,209,256,44.95
Evelynn,Gangplank,123,55,68,44.72
Evelynn,Nunu,263,106,157,40.3
Evelynn,Hwei,302,170,132,56.29
Evelynn,Lulu,268,126,142,47.01
Evelynn,Quinn,111,57,54,51.35
Evelynn,Kled,33,11,22,33.33
Evelynn,Samira,345,163,182,47.25
Evelynn,Leona,228,90,138,39.47
Evelynn,DrMundo,224,95,129,42.41
Evelynn,Belveth,61,49,12,80.33
Evelynn,Azir,89,49,40,55.06
Evelynn,Aphelios,260,121,139,46.54
Evelynn,Naafiri,208,65,143,31.25
Evelynn,Aatrox,339,170,169,50.15
Evelynn,Milio,211,82,129,38.86
Evelynn,Ziggs,163,55,108,33.74
Evelynn,Nilah,260,151,109,58.08
Evelynn,Yorick,296,105,191,35.47
Evelynn,Kassadin,112,62,50,55.36
Evelynn,Shen,202,109,93,53.96
Evelynn,Talon,250,132,118,52.8
Evelynn,Chogath,449,189,260,42.09
Evelynn,Braum,165,92,73,55.76
Evelynn,Anivia,108,57,51,52.78
Evelynn,Corki,63,19,44,30.16
Evelynn,Vladimir,193,90,103,46.63
Evelynn,Nautilus,283,102,181,36.04
Evelynn,Twitch,313,136,177,43.45
Evelynn,Kayle,300,128,172,42.67
Evelynn,Zac,117,39,78,33.33
Evelynn,Amumu,286,115,171,40.21
Evelynn,Smolder,260,141,119,54.23
Evelynn,Rell,199,105,94,52.76
Evelynn,Ornn,148,63,85,42.57
Evelynn,Singed,67,17,50,25.37
Evelynn,Sona,129,52,77,40.31
Evelynn,Neeko,270,151,119,55.93
Evelynn,AurelionSol,184,54,130,29.35
Evelynn,Ambessa,162,74,88,45.68
Evelynn,Taric,84,43,41,51.19
Evelynn,Kennen,171,87,84,50.88
Evelynn,Yuumi,281,124,157,44.13
Evelynn,Graves,171,104,67,60.82
Evelynn,Leblanc,136,72,64,52.94
Evelynn,Trundle,191,83,108,43.46
Evelynn,Gwen,165,90,75,54.55
Evelynn,Briar,361,137,224,37.95
Evelynn,Zyra,160,55,105,34.38
Evelynn,Rengar,123,90,33,73.17
Evelynn,Varus,234,140,94,59.83
Evelynn,Fizz,179,82,97,45.81
Evelynn,Lillia,272,129,143,47.43
Evelynn,Qiyana,141,96,45,68.09
Evelynn,Swain,323,127,196,39.32
Evelynn,Ivern,58,33,25,56.9
Evelynn,Galio,244,86,158,35.25
Evelynn,Annie,104,60,44,57.69
Evelynn,Vi,251,82,169,32.67
Evelynn,Alistar,67,26,41,38.81
Evelynn,Rumble,66,31,35,46.97
Evelynn,Zeri,117,46,71,39.32
Evelynn,Kindred,161,93,68,57.76
Evelynn,Volibear,393,151,242,38.42
Evelynn,XinZhao,186,71,115,38.17
Evelynn,KogMaw,106,52,54,49.06
Evelynn,Renata,76,45,31,59.21
Evelynn,Xerath,187,93,94,49.73
Evelynn,Cassiopeia,113,48,65,42.48
Evelynn,Urgot,166,88,78,53.01
Evelynn,Elise,205,129,76,62.93
Evelynn,Ryze,83,44,39,53.01
Evelynn,Velkoz,219,102,117,46.58
Evelynn,Vex,184,93,91,50.54
Evelynn,Sion,271,117,154,43.17
Evelynn,Tryndamere,177,70,107,39.55
Evelynn,Bard,90,53,37,58.89
Evelynn,Zilean,84,39,45,46.43
Evelynn,Nidalee,97,56,41,57.73
Evelynn,Karthus,95,39,56,41.05
Evelynn,Maokai,142,64,78,45.07
Evelynn,Brand,216,90,126,41.67
Evelynn,Skarner,111,59,52,53.15
Evelynn,Sejuani,124,54,70,43.55
Evelynn,Lissandra,97,46,51,47.42
Evelynn,Orianna,128,65,63,50.78
Evelynn,Kalista,201,97,104,48.26
Evelynn,Camille,45,24,21,53.33
Evelynn,Jayce,89,42,47,47.19
Evelynn,TwistedFate,80,51,29,63.75
Hecarim,Warwick,379,181,198,47.76
Hecarim,Evelynn,102,48,54,47.06
Hecarim,Ahri,295,107,188,36.27
Hecarim,Yasuo,447,251,196,56.15
Hecarim,Yone,437,260,177,59.5
Hecarim,Mordekaiser,371,173,198,46.63
Hecarim,Akali,257,146,111,56.81
Hecarim,Jhin,363,153,210,42.15
Hecarim,Velkoz,202,96,106,47.52
Hecarim,Trundle,126,51,75,40.48
Hecarim,Amumu,252,91,161,36.11
Hecarim,Fizz,125,58,67,46.4
Hecarim,Kaisa,366,207,159,56.56
Hecarim,Pantheon,369,181,188,49.05
Hecarim,Garen,362,167,195,46.13
Hecarim,Rammus,80,37,43,46.25
Hecarim,Katarina,238,120,118,50.42
Hecarim,Caitlyn,505,242,263,47.92
Hecarim,Milio,146,81,65,55.48
Hecarim,Ashe,382,204,178,53.4
Hecarim,LeeSin,208,120,88,57.69
Hecarim,Varus,199,88,111,44.22
Hecarim,Lux,707,307,400,43.42
Hecarim,Aatrox,215,109,106,50.7
Hecarim,Volibear,231,114,117,49.35
Hecarim,Teemo,309,167,142,54.05
Hecarim,Jinx,460,211,249,45.87
Hecarim,Leona,132,54,78,40.91
Hecarim,Camille,63,26,37,41.27
Hecarim,Kayn,427,240,187,56.21
Hecarim,Zeri,107,59,48,55.14
Hecarim,Yuumi,213,85,128,39.91
Hecarim,Shen,158,80,78,50.63
Hecarim,Vi,202,83,119,41.09
Hecarim,Kassadin,64,28,36,43.75
Hecarim,Corki,63,39,24,61.9
Hecarim,Blitzcrank,159,79,80,49.69
Hecarim,Graves,163,78,85,47.85
Hecarim,Aurora,239,115,124,48.12
Hecarim,Mel,488,282,206,57.79
Hecarim,KSante,114,72,42,63.16
Hecarim,FiddleSticks,156,85,71,54.49
Hecarim,Irelia,168,85,83,50.6
Hecarim,Senna,185,94,91,50.81
Hecarim,Kindred,111,71,40,63.96
Hecarim,Ekko,176,87,89,49.43
Hecarim,Rell,94,37,57,39.36
Hecarim,Briar,170,71,99,41.76
Hecarim,Zoe,94,52,42,55.32
Hecarim,MissFortune,468,199,269,42.52
Hecarim,Soraka,161,81,80,50.31
Hecarim,MasterYi,213,125,88,58.69
Hecarim,Zed,227,109,118,48.02
Hecarim,Pyke,261,148,113,56.7
Hecarim,Yorick,171,64,107,37.43
Hecarim,Diana,209,82,127,39.23
Hecarim,Viego,293,138,155,47.1
Hecarim,Samira,208,83,125,39.9
Hecarim,Thresh,292,144,148,49.32
Hecarim,Sett,309,134,175,43.37
Hecarim,Riven,116,74,42,63.79
Hecarim,Darius,468,203,265,43.38
Hecarim,AurelionSol,129,66,63,51.16
Hecarim,Karma,158,71,87,44.94
Hecarim,Lillia,148,72,76,48.65
Hecarim,Jax,204,86,118,42.16
Hecarim,Neeko,180,75,105,41.67
Hecarim,Chogath,303,173,130,57.1
Hecarim,Vex,112,69,43,61.61
Hecarim,DrMundo,182,42,140,23.08
Hecarim,Ezreal,382,230,152,60.21
Hecarim,Morgana,247,157,90,63.56
Hecarim,Illaoi,110,38,72,34.55
Hecarim,Shaco,270,133,137,49.26
Hecarim,Draven,186,88,98,47.31
Hecarim,Alistar,83,40,43,48.19
Hecarim,Shyvana,75,40,35,53.33
Hecarim,Gwen,118,60,58,50.85
Hecarim,Zac,66,34,32,51.52
Hecarim,Khazix,132,61,71,46.21
Hecarim,Lucian,130,80,50,61.54
Hecarim,Ambessa,131,40,91,30.53
Hecarim,Nasus,141,63,78,44.68
Hecarim,TwistedFate,109,60,49,55.05
Hecarim,Gangplank,74,43,31,58.11
Hecarim,Lulu,198,79,119,39.9
Hecarim,TahmKench,311,124,187,39.87
Hecarim,Cassiopeia,112,52,60,46.43
Hecarim,Gragas,139,47,92,33.81
Hecarim,Bard,84,36,48,42.86
Hecarim,Zyra,161,78,83,48.45
Hecarim,JarvanIV,106,50,56,47.17
Hecarim,Aphelios,114,38,76,33.33
Hecarim,Ryze,84,46,38,54.76
Hecarim,Nautilus,251,143,108,56.97
Hecarim,Kayle,173,74,99,42.77
Hecarim,Akshan,132,62,70,46.97
Hecarim,Skarner,67,50,17,74.63
Hecarim,Qiyana,127,64,63,50.39
Hecarim,Nocturne,174,94,80,54.02
Hecarim,Malzahar,136,67,69,49.26
Hecarim,Ornn,79,51,28,64.56
Hecarim,Twitch,187,57,130,30.48
Hecarim,Rengar,128,86,42,67.19
Hecarim,KogMaw,142,69,73,48.59
Hecarim,Kennen,88,60,28,68.18
Hecarim,Udyr,72,29,43,40.28
Hecarim,Leblanc,57,37,20,64.91
Hecarim,Nilah,86,25,61,29.07
Hecarim,Nami,166,112,54,67.47
Hecarim,Vayne,206,122,84,59.22
Hecarim,Tristana,190,76,114,40
Hecarim,Kled,34,8,26,23.53
Hecarim,Seraphine,181,89,92,49.17
Hecarim,Vladimir,121,64,57,52.89
Hecarim,Poppy,118,31,87,26.27
Hecarim,Galio,138,39,99,28.26
Hecarim,Belveth,54,21,33,38.89
Hecarim,Hwei,180,96,84,53.33
Hecarim,Quinn,55,33,22,60
Hecarim,Janna,63,29,34,46.03
Hecarim,Xerath,184,77,107,41.85
Hecarim,Renekton,99,50,49,50.51
Hecarim,Heimerdinger,97,47,50,48.45
Hecarim,Maokai,86,53,33,61.63
Hecarim,Viktor,131,78,53,59.54
Hecarim,Naafiri,108,44,64,40.74
Hecarim,Syndra,150,66,84,44
Hecarim,Kalista,129,81,48,62.79
Hecarim,Lissandra,41,13,28,31.71
Hecarim,Malphite,186,75,111,40.32
Hecarim,Tryndamere,145,81,64,55.86
Hecarim,Nunu,249,103,146,41.37
Hecarim,Sylas,193,63,130,32.64
Hecarim,Fiora,114,64,50,56.14
Hecarim,Olaf,47,25,22,53.19
Hecarim,Orianna,76,54,22,71.05
Hecarim,Braum,95,54,41,56.84
Hecarim,Ivern,29,6,23,20.69
Hecarim,Xayah,124,54,70,43.55
Hecarim,Rakan,79,59,20,74.68
Hecarim,MonkeyKing,108,56,52,51.85
Hecarim,Sivir,105,48,57,45.71
Hecarim,Brand,163,75,88,46.01
Hecarim,XinZhao,146,56,90,38.36
Hecarim,Swain,237,107,130,45.15
Hecarim,Smolder,226,91,135,40.27
Hecarim,Veigar,254,84,170,33.07
Hecarim,Annie,71,46,25,64.79
Hecarim,Renata,28,15,13,53.57
Hecarim,Sion,166,58,108,34.94
Hecarim,Taliyah,50,26,24,52
Hecarim,Elise,116,61,55,52.59
Hecarim,Zilean,58,19,39,32.76
Hecarim,Karthus,61,40,21,65.57
Hecarim,Sejuani,69,24,45,34.78
Hecarim,Ziggs,91,40,51,43.96
Hecarim,Azir,62,37,25,59.68
Hecarim,Nidalee,56,39,17,69.64
Hecarim,Singed,74,37,37,50
Hecarim,Anivia,42,33,9,78.57
Hecarim,Gnar,68,30,38,44.12
Hecarim,Jayce,88,34,54,38.64
Hecarim,RekSai,31,10,21,32.26
Hecarim,Urgot,89,40,49,44.94
Hecarim,Talon,126,75,51,59.52
Hecarim,Sona,82,48,34,58.54
Hecarim,Rumble,44,21,23,47.73
Hecarim,Taric,33,3,30,9.09
Thresh,Warwick,1262,526,736,41.68
Thresh,Evelynn,321,188,133,58.57
Thresh,Ahri,1039,504,535,48.51
Thresh,Yasuo,1606,817,789,50.87
Thresh,Yone,1544,798,746,51.68
Thresh,Sylas,669,347,322,51.87
Thresh,Zed,827,485,342,58.65
Thresh,Sivir,363,184,179,50.69
Thresh,Blitzcrank,739,382,357,51.69
Thresh,Teemo,1131,515,616,45.53
Thresh,XinZhao,494,263,231,53.24
Thresh,Jinx,1534,771,763,50.26
Thresh,Neeko,592,289,303,48.82
Thresh,Irelia,652,328,324,50.31
Thresh,Galio,548,271,277,49.45
Thresh,Rell,518,239,279,46.14
Thresh,Illaoi,388,188,200,48.45
Thresh,Aatrox,832,390,442,46.88
Thresh,Ashe,1460,755,705,51.71
Thresh,Aphelios,594,292,302,49.16
Thresh,Gragas,585,324,261,55.38
Thresh,Yorick,752,363,389,48.27
Thresh,Viego,990,487,503,49.19
Thresh,Malphite,670,283,387,42.24
Thresh,Kaisa,1217,654,563,53.74
Thresh,Ambessa,564,277,287,49.11
Thresh,Xayah,523,282,241,53.92
Thresh,AurelionSol,382,211,171,55.24
Thresh,Khazix,498,234,264,46.99
Thresh,Nautilus,1028,468,560,45.53
Thresh,Camille,281,135,146,48.04
Thresh,Katarina,690,371,319,53.77
Thresh,MissFortune,1592,679,913,42.65
Thresh,Zyra,558,231,327,41.4
Thresh,LeeSin,893,459,434,51.4
Thresh,Chogath,1113,562,551,50.49
Thresh,Lucian,500,254,246,50.8
Thresh,Xerath,508,232,276,45.67
Thresh,Kindred,365,195,170,53.42
Thresh,Fizz,424,190,234,44.81
Thresh,Gnar,350,153,197,43.71
Thresh,Caitlyn,1868,825,1043,44.16
Thresh,Ezreal,1470,811,659,55.17
Thresh,Lux,2375,1164,1211,49.01
Thresh,Darius,1481,729,752,49.22
Thresh,Trundle,448,203,245,45.31
Thresh,Vex,453,211,242,46.58
Thresh,Mordekaiser,1254,588,666,46.89
Thresh,Nunu,734,378,356,51.5
Thresh,Shen,623,330,293,52.97
Thresh,Rammus,220,105,115,47.73
Thresh,Cassiopeia,315,132,183,41.9
Thresh,Tryndamere,505,228,277,45.15
Thresh,Amumu,653,274,379,41.96
Thresh,Mel,1775,921,854,51.89
Thresh,Seraphine,820,324,496,39.51
Thresh,Tristana,715,328,387,45.87
Thresh,Nilah,462,212,250,45.89
Thresh,TahmKench,822,415,407,50.49
Thresh,Naafiri,304,156,148,51.32
Thresh,Volibear,831,392,439,47.17
Thresh,Soraka,497,289,208,58.15
Thresh,Ekko,572,291,281,50.87
Thresh,Leona,610,355,255,58.2
Thresh,Ziggs,366,147,219,40.16
Thresh,Kayn,1133,591,542,52.16
Thresh,Syndra,454,214,240,47.14
Thresh,Senna,752,414,338,55.05
Thresh,Akali,824,401,423,48.67
Thresh,Akshan,344,105,239,30.52
Thresh,Skarner,250,141,109,56.4
Thresh,Shaco,730,422,308,57.81
Thresh,Lissandra,180,76,104,42.22
Thresh,Pyke,1053,516,537,49
Thresh,Talon,500,284,216,56.8
Thresh,Maokai,355,170,185,47.89
Thresh,Varus,607,293,314,48.27
Thresh,Graves,466,200,266,42.92
Thresh,Gangplank,381,230,151,60.37
Thresh,Hwei,604,294,310,48.68
Thresh,Jhin,1413,760,653,53.79
Thresh,Kennen,291,168,123,57.73
Thresh,Karthus,222,121,101,54.5
Thresh,Veigar,858,382,476,44.52
Thresh,Vladimir,435,170,265,39.08
Thresh,Sona,277,144,133,51.99
Thresh,Urgot,360,183,177,50.83
Thresh,Twitch,699,377,322,53.93
Thresh,MasterYi,815,385,430,47.24
Thresh,Smolder,662,339,323,51.21
Thresh,Yuumi,698,295,403,42.26
Thresh,Garen,1200,569,631,47.42
Thresh,Vi,747,376,371,50.33
Thresh,Diana,1140,582,558,51.05
Thresh,Annie,197,86,111,43.65
Thresh,Shyvana,195,84,111,43.08
Thresh,Taric,206,72,134,34.95
Thresh,Nami,811,354,457,43.65
Thresh,Singed,283,120,163,42.4
Thresh,Taliyah,271,144,127,53.14
Thresh,Jax,600,302,298,50.33
Thresh,Zoe,359,214,145,59.61
Thresh,Poppy,579,279,300,48.19
Thresh,Sett,1224,543,681,44.36
Thresh,Rengar,364,221,143,60.71
Thresh,Ivern,187,121,66,64.71
Thresh,Ryze,228,77,151,33.77
Thresh,Pantheon,1389,720,669,51.84
Thresh,Renekton,453,221,232,48.79
Thresh,Fiora,336,199,137,59.23
Thresh,Rakan,527,280,247,53.13
Thresh,Brand,560,240,320,42.86
Thresh,Velkoz,522,188,334,36.02
Thresh,Heimerdinger,390,146,244,37.44
Thresh,Qiyana,270,165,105,61.11
Thresh,Udyr,380,196,184,51.58
Thresh,Karma,533,252,281,47.28
Thresh,Ornn,316,179,137,56.65
Thresh,KSante,354,196,158,55.37
Thresh,Sion,682,272,410,39.88
Thresh,Hecarim,292,148,144,50.68
Thresh,Lulu,656,375,281,57.16
Thresh,Samira,756,340,416,44.97
Thresh,Morgana,994,476,518,47.89
Thresh,Alistar,407,202,205,49.63
Thresh,Briar,825,362,463,43.88
Thresh,Anivia,254,147,107,57.87
Thresh,Leblanc,388,151,237,38.92
Thresh,Milio,469,258,211,55.01
Thresh,Sejuani,372,190,182,51.08
Thresh,Corki,286,150,136,52.45
Thresh,Swain,954,468,486,49.06
Thresh,Aurora,777,409,368,52.64
Thresh,Lillia,582,241,341,41.41
Thresh,Renata,216,110,106,50.93
Thresh,FiddleSticks,364,163,201,44.78
Thresh,Kalista,382,196,186,51.31
Thresh,Zilean,267,139,128,52.06
Thresh,JarvanIV,330,148,182,44.85
Thresh,Malzahar,710,297,413,41.83
Thresh,Draven,521,310,211,59.5
Thresh,Nasus,685,322,363,47.01
Thresh,Rumble,168,72,96,42.86
Thresh,Kled,161,89,72,55.28
Thresh,Quinn,268,109,159,40.67
Thresh,Viktor,555,246,309,44.32
Thresh,TwistedFate,313,173,140,55.27
Thresh,Zeri,301,129,172,42.86
Thresh,Kayle,592,283,309,47.8
Thresh,Elise,500,258,242,51.6
Thresh,Riven,400,249,151,62.25
Thresh,Nocturne,737,352,385,47.76
Thresh,Janna,312,147,165,47.12
Thresh,Zac,319,124,195,38.87
Thresh,Braum,460,227,233,49.35
Thresh,Olaf,160,53,107,33.13
Thresh,Kassadin,185,97,88,52.43
Thresh,Orianna,381,189,192,49.61
Thresh,Azir,315,103,212,32.7
Thresh,Jayce,357,177,180,49.58
Thresh,MonkeyKing,414,219,195,52.9
Thresh,Gwen,481,300,181,62.37
Thresh,Bard,216,84,132,38.89
Thresh,RekSai,114,58,56,50.88
Thresh,DrMundo,414,223,191,53.86
Thresh,Vayne,688,344,344,50
Thresh,Belveth,222,117,105,52.7
Thresh,KogMaw,296,155,141,52.36
Thresh,Nidalee,259,149,110,57.53
RekSai,Sett,93,26,67,27.96
RekSai,Taliyah,25,19,6,76
RekSai,Sylas,79,34,45,43.04
RekSai,Ezreal,118,64,54,54.24
RekSai,Morgana,105,55,50,52.38
RekSai,Illaoi,41,19,22,46.34
RekSai,Nocturne,69,40,29,57.97
RekSai,Ekko,68,52,16,76.47
RekSai,MissFortune,141,74,67,52.48
RekSai,Seraphine,135,61,74,45.19
RekSai,Gnar,49,19,30,38.78
RekSai,XinZhao,62,31,31,50
RekSai,Yasuo,182,103,79,56.59
RekSai,Zeri,26,16,10,61.54
RekSai,Taric,15,3,12,20
RekSai,Tryndamere,54,30,24,55.56
RekSai,LeeSin,125,58,67,46.4
RekSai,Aurora,41,22,19,53.66
RekSai,Mel,177,69,108,38.98
RekSai,Rumble,24,15,9,62.5
RekSai,Pantheon,162,92,70,56.79
RekSai,Jhin,170,91,79,53.53
RekSai,Nautilus,69,38,31,55.07
RekSai,Darius,183,85,98,46.45
RekSai,Evelynn,29,20,9,68.97
RekSai,Heimerdinger,60,31,29,51.67
RekSai,Jinx,205,113,92,55.12
RekSai,Pyke,106,32,74,30.19
RekSai,Diana,108,53,55,49.07
RekSai,Yone,135,55,80,40.74
RekSai,Veigar,94,70,24,74.47
RekSai,DrMundo,53,32,21,60.38
RekSai,Kayn,108,69,39,63.89
RekSai,Akali,83,46,37,55.42
RekSai,Draven,46,20,26,43.48
RekSai,Rell,51,34,17,66.67
RekSai,Camille,19,19,0,100
RekSai,Ahri,118,55,63,46.61
RekSai,Caitlyn,210,87,123,41.43
RekSai,Fizz,51,45,6,88.24
RekSai,MasterYi,56,27,29,48.21
RekSai,Aphelios,44,24,20,54.55
RekSai,Shaco,95,50,45,52.63
RekSai,Chogath,112,46,66,41.07
RekSai,Poppy,64,26,38,40.63
RekSai,Shyvana,31,21,10,67.74
RekSai,Maokai,15,6,9,40
RekSai,Warwick,100,52,48,52
RekSai,Irelia,98,75,23,76.53
RekSai,Sivir,31,9,22,29.03
RekSai,Annie,48,23,25,47.92
RekSai,Renekton,19,6,13,31.58
RekSai,Sejuani,24,9,15,37.5
RekSai,Urgot,46,20,26,43.48
RekSai,Viego,154,53,101,34.42
RekSai,Aatrox,102,44,58,43.14
RekSai,Zed,118,72,46,61.02
RekSai,Karma,36,24,12,66.67
RekSai,Galio,65,32,33,49.23
RekSai,Nami,98,43,55,43.88
RekSai,Naafiri,18,9,9,50
RekSai,Zyra,66,40,26,60.61
RekSai,Xayah,66,42,24,63.64
RekSai,Rakan,62,42,20,67.74
RekSai,Vladimir,41,23,18,56.1
RekSai,Renata,26,19,7,73.08
RekSai,Teemo,123,35,88,28.46
RekSai,Belveth,35,10,25,28.57
RekSai,Vex,39,5,34,12.82
RekSai,Kaisa,131,75,56,57.25
RekSai,Senna,66,18,48,27.27
RekSai,Karthus,32,17,15,53.13
RekSai,Thresh,114,56,58,49.12
RekSai,Garen,64,20,44,31.25
RekSai,KSante,59,28,31,47.46
RekSai,Lulu,102,46,56,45.1
RekSai,TwistedFate,36,19,17,52.78
RekSai,Ambessa,44,30,14,68.18
RekSai,Nidalee,19,16,3,84.21
RekSai,Akshan,39,14,25,35.9
RekSai,Qiyana,39,23,16,58.97
RekSai,Ashe,153,67,86,43.79
RekSai,Mordekaiser,140,73,67,52.14
RekSai,Velkoz,50,31,19,62
RekSai,Volibear,111,49,62,44.14
RekSai,Lillia,61,27,34,44.26
RekSai,Lucian,51,29,22,56.86
RekSai,Braum,64,10,54,15.63
RekSai,Kayle,55,34,21,61.82
RekSai,Neeko,60,29,31,48.33
RekSai,Vi,74,45,29,60.81
RekSai,TahmKench,68,39,29,57.35
RekSai,Cassiopeia,36,13,23,36.11
RekSai,Yuumi,81,49,32,60.49
RekSai,Kennen,22,3,19,13.64
RekSai,Kindred,32,20,12,62.5
RekSai,Hwei,65,33,32,50.77
RekSai,Leona,102,43,59,42.16
RekSai,Tristana,76,23,53,30.26
RekSai,Gwen,42,12,30,28.57
RekSai,Ornn,46,27,19,58.7
RekSai,Trundle,44,16,28,36.36
RekSai,Gragas,33,30,3,90.91
RekSai,Blitzcrank,73,32,41,43.84
RekSai,Amumu,41,9,32,21.95
RekSai,Malzahar,90,32,58,35.56
RekSai,Singed,31,13,18,41.94
RekSai,Kassadin,16,10,6,62.5
RekSai,Kled,32,10,22,31.25
RekSai,Leblanc,22,16,6,72.73
RekSai,Hecarim,31,21,10,67.74
RekSai,Nasus,58,9,49,15.52
RekSai,Talon,65,23,42,35.38
RekSai,Nunu,94,45,49,47.87
RekSai,JarvanIV,37,15,22,40.54
RekSai,Elise,77,53,24,68.83
RekSai,Janna,36,25,11,69.44
RekSai,Sion,99,59,40,59.6
RekSai,Graves,71,40,31,56.34
RekSai,Udyr,38,14,24,36.84
RekSai,Zilean,18,8,10,44.44
RekSai,Yorick,104,46,58,44.23
RekSai,Swain,118,64,54,54.24
RekSai,Jax,70,48,22,68.57
RekSai,Lux,200,68,132,34
RekSai,Ivern,31,22,9,70.97
RekSai,Skarner,27,9,18,33.33
RekSai,Smolder,68,29,39,42.65
RekSai,Zac,35,12,23,34.29
RekSai,Shen,63,30,33,47.62
RekSai,Rengar,70,27,43,38.57
RekSai,Azir,51,23,28,45.1
RekSai,Malphite,63,31,32,49.21
RekSai,Varus,66,23,43,34.85
RekSai,Viktor,68,48,20,70.59
RekSai,Vayne,67,27,40,40.3
RekSai,Twitch,84,51,33,60.71
RekSai,Katarina,54,34,20,62.96
RekSai,Samira,101,44,57,43.56
RekSai,Lissandra,28,10,18,35.71
RekSai,Quinn,36,0,36,0
RekSai,Syndra,46,23,23,50
RekSai,Corki,35,7,28,20
RekSai,Riven,50,37,13,74
RekSai,Nilah,47,13,34,27.66
RekSai,Soraka,27,9,18,33.33
RekSai,Brand,30,13,17,43.33
RekSai,Rammus,36,14,22,38.89
RekSai,Briar,86,35,51,40.7
RekSai,Sona,33,3,30,9.09
RekSai,AurelionSol,39,23,16,58.97
RekSai,Zoe,45,32,13,71.11
RekSai,Gangplank,74,54,20,72.97
RekSai,Khazix,38,10,28,26.32
RekSai,FiddleSticks,32,10,22,31.25
RekSai,Ryze,25,10,15,40
RekSai,Anivia,29,10,19,34.48
RekSai,Kalista,43,27,16,62.79
RekSai,Ziggs,42,18,24,42.86
RekSai,Orianna,37,18,19,48.65
RekSai,Xerath,28,12,16,42.86
RekSai,Alistar,37,18,19,48.65
RekSai,Jayce,34,10,24,29.41
RekSai,KogMaw,17,3,14,17.65
RekSai,MonkeyKing,24,18,6,75
RekSai,Milio,37,20,17,54.05
RekSai,Fiora,14,8,6,57.14
RekSai,Olaf,6,3,3,50
RekSai,Bard,9,9,0,100
Sivir,Malphite,294,159,135,54.08
Sivir,Evelynn,134,82,52,61.19
Sivir,Irelia,213,116,97,54.46
Sivir,Tristana,213,97,116,45.54
Sivir,Thresh,363,179,184,49.31
Sivir,Teemo,415,198,217,47.71
Sivir,Shaco,319,136,183,42.63
Sivir,Leblanc,113,68,45,60.18
Sivir,Ezreal,564,364,200,64.54
Sivir,Sett,440,271,169,61.59
Sivir,Talon,170,89,81,52.35
Sivir,FiddleSticks,148,57,91,38.51
Sivir,Ashe,612,324,288,52.94
Sivir,Blitzcrank,307,148,159,48.21
Sivir,Urgot,147,75,72,51.02
Sivir,Rengar,99,87,12,87.88
Sivir,Ziggs,144,62,82,43.06
Sivir,Trundle,126,66,60,52.38
Sivir,Fiora,174,92,82,52.87
Sivir,Mordekaiser,420,220,200,52.38
Sivir,Vi,228,141,87,61.84
Sivir,Cassiopeia,125,59,66,47.2
Sivir,Lux,760,397,363,52.24
Sivir,Vladimir,160,104,56,65
Sivir,Yasuo,564,288,276,51.06
Sivir,Yuumi,195,86,109,44.1
Sivir,Shen,194,96,98,49.48
Sivir,Yone,569,280,289,49.21
Sivir,Twitch,221,73,148,33.03
Sivir,Nautilus,376,240,136,63.83
Sivir,Kayn,414,216,198,52.17
Sivir,Diana,416,237,179,56.97
Sivir,Renekton,108,52,56,48.15
Sivir,Lillia,163,83,80,50.92
Sivir,Annie,81,51,30,62.96
Sivir,Kaisa,451,221,230,49
Sivir,Xerath,183,131,52,71.58
Sivir,XinZhao,147,83,64,56.46
Sivir,Vayne,299,118,181,39.46
Sivir,Brand,221,135,86,61.09
Sivir,Kayle,179,106,73,59.22
Sivir,Morgana,425,222,203,52.24
Sivir,Viego,350,166,184,47.43
Sivir,Jinx,609,338,271,55.5
Sivir,Pyke,393,231,162,58.78
Sivir,Camille,119,65,54,54.62
Sivir,Warwick,422,160,262,37.91
Sivir,Azir,118,64,54,54.24
Sivir,Braum,126,77,49,61.11
Sivir,Poppy,174,106,68,60.92
Sivir,Elise,179,86,93,48.04
Sivir,Aurora,327,172,155,52.6
Sivir,Nami,281,116,165,41.28
Sivir,Akali,326,176,150,53.99
Sivir,Gragas,181,105,76,58.01
Sivir,Syndra,209,131,78,62.68
Sivir,Veigar,314,157,157,50
Sivir,Gnar,98,38,60,38.78
Sivir,AurelionSol,127,76,51,59.84
Sivir,LeeSin,299,178,121,59.53
Sivir,Zoe,129,52,77,40.31
Sivir,Jhin,498,272,226,54.62
Sivir,Seraphine,311,172,139,55.31
Sivir,Yorick,251,151,100,60.16
Sivir,Sejuani,102,62,40,60.78
Sivir,Kalista,88,56,32,63.64
Sivir,Khazix,184,100,84,54.35
Sivir,Caitlyn,711,367,344,51.62
Sivir,Taric,88,34,54,38.64
Sivir,Mel,678,392,286,57.82
Sivir,Sylas,323,181,142,56.04
Sivir,Senna,227,137,90,60.35
Sivir,Pantheon,565,269,296,47.61
Sivir,Kassadin,50,25,25,50
Sivir,Milio,167,67,100,40.12
Sivir,TahmKench,274,148,126,54.01
Sivir,Qiyana,68,34,34,50
Sivir,Rell,156,70,86,44.87
Sivir,Volibear,413,191,222,46.25
Sivir,Lulu,199,106,93,53.27
Sivir,Katarina,207,128,79,61.84
Sivir,Galio,245,130,115,53.06
Sivir,MissFortune,696,361,335,51.87
Sivir,Smolder,249,98,151,39.36
Sivir,Zed,216,97,119,44.91
Sivir,Darius,473,249,224,52.64
Sivir,Karma,203,124,79,61.08
Sivir,Ekko,177,91,86,51.41
Sivir,Lucian,196,141,55,71.94
Sivir,Draven,158,64,94,40.51
Sivir,Heimerdinger,162,74,88,45.68
Sivir,Aatrox,293,151,142,51.54
Sivir,Hwei,232,103,129,44.4
Sivir,Chogath,374,182,192,48.66
Sivir,Soraka,105,64,41,60.95
Sivir,Kled,43,24,19,55.81
Sivir,Zac,127,35,92,27.56
Sivir,Rakan,147,76,71,51.7
Sivir,Zyra,236,102,134,43.22
Sivir,Graves,163,107,56,65.64
Sivir,Neeko,222,104,118,46.85
Sivir,RekSai,31,22,9,70.97
Sivir,Maokai,126,50,76,39.68
Sivir,Orianna,135,57,78,42.22
Sivir,Varus,314,134,180,42.68
Sivir,Gangplank,114,76,38,66.67
Sivir,Gwen,154,98,56,63.64
Sivir,Ivern,100,52,48,52
Sivir,Garen,439,224,215,51.03
Sivir,Amumu,286,106,180,37.06
Sivir,MasterYi,285,140,145,49.12
Sivir,Nunu,281,148,133,52.67
Sivir,Leona,235,120,115,51.06
Sivir,Ornn,130,43,87,33.08
Sivir,Swain,304,166,138,54.61
Sivir,Vex,143,79,64,55.24
Sivir,Riven,113,68,45,60.18
Sivir,Nocturne,340,189,151,55.59
Sivir,Rumble,40,26,14,65
Sivir,Nasus,207,97,110,46.86
Sivir,Karthus,85,55,30,64.71
Sivir,Malzahar,183,93,90,50.82
Sivir,Aphelios,235,138,97,58.72
Sivir,Jax,300,170,130,56.67
Sivir,Briar,285,174,111,61.05
Sivir,Corki,109,59,50,54.13
Sivir,Ryze,91,45,46,49.45
Sivir,KogMaw,135,53,82,39.26
Sivir,Udyr,117,75,42,64.1
Sivir,Sion,229,129,100,56.33
Sivir,Illaoi,165,79,86,47.88
Sivir,Belveth,75,42,33,56
Sivir,Fizz,135,71,64,52.59
Sivir,Viktor,227,119,108,52.42
Sivir,Xayah,171,81,90,47.37
Sivir,Tryndamere,174,100,74,57.47
Sivir,Shyvana,94,53,41,56.38
Sivir,Quinn,102,66,36,64.71
Sivir,Hecarim,105,57,48,54.29
Sivir,Samira,295,161,134,54.58
Sivir,Skarner,84,62,22,73.81
Sivir,Rammus,61,25,36,40.98
Sivir,Kennen,84,57,27,67.86
Sivir,Akshan,122,30,92,24.59
Sivir,Ambessa,208,112,96,53.85
Sivir,Nilah,117,55,62,47.01
Sivir,Alistar,91,50,41,54.95
Sivir,Olaf,64,29,35,45.31
Sivir,Naafiri,126,51,75,40.48
Sivir,Anivia,125,80,45,64
Sivir,Ahri,363,168,195,46.28
Sivir,JarvanIV,117,35,82,29.91
Sivir,Bard,117,55,62,47.01
Sivir,Taliyah,51,29,22,56.86
Sivir,Sona,123,79,44,64.23
Sivir,Renata,91,46,45,50.55
Sivir,Velkoz,194,84,110,43.3
Sivir,Lissandra,35,10,25,28.57
Sivir,Kindred,203,93,110,45.81
Sivir,TwistedFate,115,60,55,52.17
Sivir,DrMundo,168,62,106,36.9
Sivir,KSante,94,60,34,63.83
Sivir,Zilean,110,57,53,51.82
Sivir,MonkeyKing,164,102,62,62.2
Sivir,Jayce,129,75,54,58.14
Sivir,Janna,114,68,46,59.65
Sivir,Nidalee,88,62,26,70.45
Sivir,Singed,91,66,25,72.53
Sivir,Zeri,90,71,19,78.89
Xayah,Sylas,377,206,171,54.64
Xayah,Caitlyn,1080,535,545,49.54
Xayah,Zed,486,348,138,71.6
Xayah,MasterYi,498,285,213,57.23
Xayah,Rell,252,152,100,60.32
Xayah,Yone,736,395,341,53.67
Xayah,Kayn,730,431,299,59.04
Xayah,TwistedFate,154,80,74,51.95
Xayah,Smolder,261,120,141,45.98
Xayah,Nautilus,472,251,221,53.18
Xayah,Poppy,273,156,117,57.14
Xayah,Diana,564,250,314,44.33
Xayah,Anivia,99,60,39,60.61
Xayah,Thresh,523,241,282,46.08
Xayah,Akali,422,218,204,51.66
Xayah,Rammus,163,61,102,37.42
Xayah,Yasuo,820,426,394,51.95
Xayah,Jinx,957,430,527,44.93
Xayah,Zyra,258,96,162,37.21
Xayah,Tryndamere,229,120,109,52.4
Xayah,Aurora,412,191,221,46.36
Xayah,Twitch,337,198,139,58.75
Xayah,Lux,1023,479,544,46.82
Xayah,Jayce,197,108,89,54.82
Xayah,Amumu,400,145,255,36.25
Xayah,Ashe,663,306,357,46.15
Xayah,Milio,220,98,122,44.55
Xayah,Vayne,460,232,228,50.43
Xayah,Briar,344,182,162,52.91
Xayah,Mel,936,442,494,47.22
Xayah,Yuumi,464,234,230,50.43
Xayah,Mordekaiser,648,283,365,43.67
Xayah,Vex,281,123,158,43.77
Xayah,Samira,374,220,154,58.82
Xayah,Rakan,183,92,91,50.27
Xayah,Aatrox,386,180,206,46.63
Xayah,Chogath,524,227,297,43.32
Xayah,Kaisa,652,362,290,55.52
Xayah,Morgana,503,222,281,44.14
Xayah,Ezreal,655,330,325,50.38
Xayah,Elise,244,113,131,46.31
Xayah,Gangplank,178,104,74,58.43
Xayah,Swain,400,199,201,49.75
Xayah,Cassiopeia,122,54,68,44.26
Xayah,Varus,232,118,114,50.86
Xayah,Nasus,318,141,177,44.34
Xayah,Zilean,86,34,52,39.53
Xayah,FiddleSticks,237,114,123,48.1
Xayah,Leblanc,161,61,100,37.89
Xayah,Aphelios,272,104,168,38.24
Xayah,Hwei,312,142,170,45.51
Xayah,Jhin,806,426,380,52.85
Xayah,MonkeyKing,219,96,123,43.84
Xayah,Teemo,494,216,278,43.72
Xayah,Yorick,318,120,198,37.74
Xayah,Ahri,542,262,280,48.34
Xayah,Riven,185,102,83,55.14
Xayah,Malzahar,319,139,180,43.57
Xayah,Syndra,224,107,117,47.77
Xayah,Volibear,395,192,203,48.61
Xayah,Evelynn,272,133,139,48.9
Xayah,Azir,165,72,93,43.64
Xayah,Illaoi,212,102,110,48.11
Xayah,Nocturne,383,179,204,46.74
Xayah,Ryze,90,52,38,57.78
Xayah,MissFortune,950,420,530,44.21
Xayah,Blitzcrank,331,197,134,59.52
Xayah,Garen,680,330,350,48.53
Xayah,Jax,368,188,180,51.09
Xayah,Gnar,196,91,105,46.43
Xayah,Zeri,200,92,108,46
Xayah,Xerath,267,119,148,44.57
Xayah,Urgot,131,76,55,58.02
Xayah,Skarner,101,51,50,50.5
Xayah,Ekko,274,126,148,45.99
Xayah,Heimerdinger,215,62,153,28.84
Xayah,Zac,191,114,77,59.69
Xayah,LeeSin,335,183,152,54.63
Xayah,Fiora,170,105,65,61.76
Xayah,Pantheon,669,347,322,51.87
Xayah,Annie,139,74,65,53.24
Xayah,Bard,124,66,58,53.23
Xayah,Renekton,202,97,105,48.02
Xayah,Rengar,202,139,63,68.81
Xayah,Seraphine,440,243,197,55.23
Xayah,Kennen,172,85,87,49.42
Xayah,Lillia,222,81,141,36.49
Xayah,Irelia,336,194,142,57.74
Xayah,Nilah,209,115,94,55.02
Xayah,Malphite,349,185,164,53.01
Xayah,JarvanIV,185,89,96,48.11
Xayah,Lucian,250,122,128,48.8
Xayah,Kayle,253,149,104,58.89
Xayah,XinZhao,272,123,149,45.22
Xayah,Darius,722,397,325,54.99
Xayah,Warwick,557,304,253,54.58
Xayah,Viktor,253,113,140,44.66
Xayah,Sona,141,71,70,50.35
Xayah,Ornn,176,97,79,55.11
Xayah,Neeko,341,217,124,63.64
Xayah,Ziggs,200,92,108,46
Xayah,Galio,337,193,144,57.27
Xayah,Zoe,206,114,92,55.34
Xayah,DrMundo,248,121,127,48.79
Xayah,Belveth,156,65,91,41.67
Xayah,Naafiri,178,101,77,56.74
Xayah,Pyke,381,188,193,49.34
Xayah,Kalista,162,104,58,64.2
Xayah,Vi,307,166,141,54.07
Xayah,Talon,291,169,122,58.08
Xayah,Shaco,396,183,213,46.21
Xayah,Graves,275,136,139,49.45
Xayah,Lulu,375,180,195,48
Xayah,Katarina,370,196,174,52.97
Xayah,Taric,70,40,30,57.14
Xayah,Gwen,242,142,100,58.68
Xayah,Sett,719,317,402,44.09
Xayah,Nami,429,181,248,42.19
Xayah,Maokai,127,58,69,45.67
Xayah,Janna,127,59,68,46.46
Xayah,Ambessa,229,135,94,58.95
Xayah,Khazix,225,146,79,64.89
Xayah,KSante,172,73,99,42.44
Xayah,Gragas,240,141,99,58.75
Xayah,Nunu,402,180,222,44.78
Xayah,Tristana,274,120,154,43.8
Xayah,Trundle,233,103,130,44.21
Xayah,Fizz,270,131,139,48.52
Xayah,Kindred,168,106,62,63.1
Xayah,Vladimir,240,122,118,50.83
Xayah,Kassadin,91,54,37,59.34
Xayah,Viego,421,190,231,45.13
Xayah,Veigar,474,211,263,44.51
Xayah,TahmKench,416,222,194,53.37
Xayah,Karma,233,99,134,42.49
Xayah,Shen,268,142,126,52.99
Xayah,Senna,364,178,186,48.9
Xayah,Lissandra,96,48,48,50
Xayah,Draven,187,109,78,58.29
Xayah,Braum,173,94,79,54.34
Xayah,KogMaw,143,71,72,49.65
Xayah,Alistar,171,78,93,45.61
Xayah,Akshan,209,117,92,55.98
Xayah,RekSai,66,24,42,36.36
Xayah,Velkoz,239,132,107,55.23
Xayah,Sion,335,158,177,47.16
Xayah,Udyr,129,54,75,41.86
Xayah,Sejuani,146,65,81,44.52
Xayah,Brand,235,98,137,41.7
Xayah,Orianna,170,70,100,41.18
Xayah,Singed,131,52,79,39.69
Xayah,Renata,102,50,52,49.02
Xayah,Ivern,106,71,35,66.98
Xayah,Leona,244,117,127,47.95
Xayah,Sivir,171,90,81,52.63
Xayah,Karthus,130,60,70,46.15
Xayah,Hecarim,124,70,54,56.45
Xayah,Shyvana,110,38,72,34.55
Xayah,AurelionSol,142,42,100,29.58
Xayah,Nidalee,87,57,30,65.52
Xayah,Camille,141,96,45,68.09
Xayah,Kled,85,35,50,41.18
Xayah,Olaf,74,37,37,50
Xayah,Soraka,232,111,121,47.84
Xayah,Corki,145,76,69,52.41
Xayah,Taliyah,87,59,28,67.82
Xayah,Qiyana,139,74,65,53.24
Xayah,Rumble,76,36,40,47.37
Xayah,Quinn,109,59,50,54.13
Samira,Swain,714,360,354,50.42
Samira,FiddleSticks,326,143,183,43.87
Samira,Akali,634,352,282,55.52
Samira,Twitch,423,213,210,50.35
Samira,Senna,520,223,297,42.88
Samira,Smolder,506,228,278,45.06
Samira,Ekko,551,303,248,54.99
Samira,Mordekaiser,986,426,560,43.2
Samira,Yasuo,1053,540,513,51.28
Samira,Yuumi,626,271,355,43.29
Samira,Sett,1033,457,576,44.24
Samira,Vladimir,308,179,129,58.12
Samira,Kindred,321,205,116,63.86
Samira,Aphelios,449,223,226,49.67
Samira,Pyke,598,302,296,50.5
Samira,Volibear,623,271,352,43.5
Samira,Akshan,272,98,174,36.03
Samira,Katarina,551,290,261,52.63
Samira,Annie,158,89,69,56.33
Samira,Kayn,957,477,480,49.84
Samira,Aatrox,588,294,294,50
Samira,MissFortune,1303,717,586,55.03
Samira,DrMundo,454,182,272,40.09
Samira,Ivern,113,54,59,47.79
Samira,Nilah,533,266,267,49.91
Samira,TwistedFate,182,84,98,46.15
Samira,LeeSin,596,299,297,50.17
Samira,Brand,452,252,200,55.75
Samira,Briar,620,303,317,48.87
Samira,Hwei,493,233,260,47.26
Samira,Kaisa,899,482,417,53.62
Samira,TahmKench,606,367,239,60.56
Samira,Fiora,325,182,143,56
Samira,Malzahar,390,130,260,33.33
Samira,Zilean,160,61,99,38.13
Samira,Jinx,1395,638,757,45.73
Samira,Leblanc,279,140,139,50.18
Samira,Xayah,374,154,220,41.18
Samira,Riven,345,163,182,47.25
Samira,Jax,496,247,249,49.8
Samira,Naafiri,277,141,136,50.9
Samira,Tristana,573,293,280,51.13
Samira,Rakan,300,103,197,34.33
Samira,Zac,209,107,102,51.2
Samira,Nunu,509,220,289,43.22
Samira,Veigar,709,350,359,49.37
Samira,Shen,364,162,202,44.51
Samira,Sion,476,213,263,44.75
Samira,AurelionSol,254,142,112,55.91
Samira,Jhin,1082,553,529,51.11
Samira,Lux,1604,796,808,49.63
Samira,Trundle,353,166,187,47.03
Samira,Ahri,850,438,412,51.53
Samira,Ashe,1026,523,503,50.97
Samira,Nami,567,258,309,45.5
Samira,Darius,1116,551,565,49.37
Samira,Pantheon,881,418,463,47.45
Samira,Ryze,238,131,107,55.04
Samira,Lillia,336,154,182,45.83
Samira,Chogath,710,266,444,37.46
Samira,Mel,1254,587,667,46.81
Samira,Warwick,1003,450,553,44.87
Samira,Malphite,496,227,269,45.77
Samira,Illaoi,368,168,200,45.65
Samira,Leona,437,172,265,39.36
Samira,Ambessa,385,229,156,59.48
Samira,Rammus,169,77,92,45.56
Samira,Aurora,578,258,320,44.64
Samira,Caitlyn,1511,645,866,42.69
Samira,Kled,128,54,74,42.19
Samira,Diana,820,453,367,55.24
Samira,Karma,392,200,192,51.02
Samira,Singed,179,64,115,35.75
Samira,Blitzcrank,463,254,209,54.86
Samira,Varus,483,250,233,51.76
Samira,Irelia,520,271,249,52.12
Samira,Elise,269,162,107,60.22
Samira,Viego,666,301,365,45.2
Samira,Galio,305,149,156,48.85
Samira,Vayne,536,299,237,55.78
Samira,Sylas,546,270,276,49.45
Samira,Tryndamere,321,132,189,41.12
Samira,Nautilus,661,353,308,53.4
Samira,Yorick,517,223,294,43.13
Samira,Nidalee,176,104,72,59.09
Samira,KogMaw,221,94,127,42.53
Samira,Poppy,394,204,190,51.78
Samira,Zed,577,307,270,53.21
Samira,Shyvana,122,54,68,44.26
Samira,MasterYi,573,275,298,47.99
Samira,Garen,820,372,448,45.37
Samira,Zyra,377,166,211,44.03
Samira,Neeko,486,274,212,56.38
Samira,Renekton,237,125,112,52.74
Samira,Sejuani,257,137,120,53.31
Samira,Taliyah,122,43,79,35.25
Samira,Teemo,847,400,447,47.23
Samira,Corki,237,96,141,40.51
Samira,Heimerdinger,267,129,138,48.31
Samira,Gragas,364,192,172,52.75
Samira,Morgana,815,335,480,41.1
Samira,XinZhao,319,141,178,44.2
Samira,Rell,392,177,215,45.15
Samira,Shaco,553,286,267,51.72
Samira,Yone,1232,619,613,50.24
Samira,Lulu,426,184,242,43.19
Samira,Viktor,358,184,174,51.4
Samira,KSante,238,135,103,56.72
Samira,Gwen,379,186,193,49.08
Samira,Seraphine,869,462,407,53.16
Samira,Udyr,235,111,124,47.23
Samira,Hecarim,208,125,83,60.1
Samira,Khazix,414,236,178,57
Samira,Karthus,127,85,42,66.93
Samira,Thresh,756,416,340,55.03
Samira,Braum,211,95,116,45.02
Samira,Evelynn,345,182,163,52.75
Samira,Nocturne,434,238,196,54.84
Samira,Velkoz,333,171,162,51.35
Samira,Urgot,263,89,174,33.84
Samira,Zeri,278,128,150,46.04
Samira,Fizz,333,158,175,47.45
Samira,Draven,374,177,197,47.33
Samira,Bard,198,99,99,50
Samira,Alistar,197,98,99,49.75
Samira,Kayle,445,206,239,46.29
Samira,Amumu,581,256,325,44.06
Samira,Ezreal,975,504,471,51.69
Samira,Vi,463,199,264,42.98
Samira,Zoe,265,150,115,56.6
Samira,Sona,222,108,114,48.65
Samira,Nasus,573,213,360,37.17
Samira,Ziggs,279,130,149,46.59
Samira,Milio,255,117,138,45.88
Samira,Quinn,156,80,76,51.28
Samira,Kalista,258,166,92,64.34
Samira,Xerath,388,201,187,51.8
Samira,Cassiopeia,250,128,122,51.2
Samira,Orianna,279,149,130,53.41
Samira,Talon,333,166,167,49.85
Samira,Renata,192,93,99,48.44
Samira,Rengar,206,127,79,61.65
Samira,Graves,348,202,146,58.05
Samira,Gnar,222,138,84,62.16
Samira,Azir,221,110,111,49.77
Samira,Ornn,252,131,121,51.98
Samira,Camille,176,88,88,50
Samira,Vex,316,136,180,43.04
Samira,Janna,193,107,86,55.44
Samira,Lucian,306,151,155,49.35
Samira,Soraka,319,185,134,57.99
Samira,Kennen,215,127,88,59.07
Samira,Skarner,232,97,135,41.81
Samira,Olaf,77,43,34,55.84
Samira,Syndra,313,129,184,41.21
Samira,Jayce,234,129,105,55.13
Samira,Taric,108,33,75,30.56
Samira,Maokai,278,140,138,50.36
Samira,Anivia,196,103,93,52.55
Samira,Kassadin,102,53,49,51.96
Samira,MonkeyKing,326,136,190,41.72
Samira,JarvanIV,200,95,105,47.5
Samira,Belveth,188,109,79,57.98
Samira,Lissandra,149,73,76,48.99
Samira,Qiyana,163,90,73,55.21
Samira,Gangplank,264,146,118,55.3
Samira,Sivir,295,134,161,45.42
Samira,Rumble,79,55,24,69.62
Samira,RekSai,101,57,44,56.44
Skarner,Irelia,164,74,90,45.12
Skarner,Diana,276,142,134,51.45
Skarner,Lux,536,296,240,55.22
Skarner,Tristana,184,76,108,41.3
Skarner,Mel,445,227,218,51.01
Skarner,Viktor,165,79,86,47.88
Skarner,Nocturne,173,65,108,37.57
Skarner,Annie,77,45,32,58.44
Skarner,KogMaw,95,51,44,53.68
Skarner,Alistar,96,65,31,67.71
Skarner,Yorick,148,69,79,46.62
Skarner,Kayn,280,131,149,46.79
Skarner,Akali,239,129,110,53.97
Skarner,Caitlyn,406,190,216,46.8
Skarner,Sett,331,169,162,51.06
Skarner,LeeSin,176,100,76,56.82
Skarner,Nasus,148,70,78,47.3
Skarner,Kaisa,278,142,136,51.08
Skarner,Bard,88,44,44,50
Skarner,Yasuo,379,169,210,44.59
Skarner,Jhin,384,168,216,43.75
Skarner,Thresh,250,109,141,43.6
Skarner,Illaoi,115,41,74,35.65
Skarner,Volibear,270,111,159,41.11
Skarner,Varus,162,86,76,53.09
Skarner,Nautilus,267,121,146,45.32
Skarner,Teemo,226,134,92,59.29
Skarner,Graves,115,38,77,33.04
Skarner,Zoe,109,61,48,55.96
Skarner,Katarina,214,100,114,46.73
Skarner,Galio,163,57,106,34.97
Skarner,Warwick,313,132,181,42.17
Skarner,Veigar,205,89,116,43.41
Skarner,Ivern,48,36,12,75
Skarner,Ezreal,281,175,106,62.28
Skarner,Xayah,101,50,51,49.5
Skarner,DrMundo,106,34,72,32.08
Skarner,Nunu,192,99,93,51.56
Skarner,Leblanc,96,49,47,51.04
Skarner,Nami,180,76,104,42.22
Skarner,Smolder,129,66,63,51.16
Skarner,Zed,171,74,97,43.27
Skarner,Morgana,239,89,150,37.24
Skarner,Pantheon,321,151,170,47.04
Skarner,Amumu,146,42,104,28.77
Skarner,Ziggs,108,51,57,47.22
Skarner,Malphite,120,58,62,48.33
Skarner,Sion,167,56,111,33.53
Skarner,Shen,149,94,55,63.09
Skarner,Jax,190,108,82,56.84
Skarner,Rengar,126,74,52,58.73
Skarner,Nilah,87,40,47,45.98
Skarner,Karma,141,70,71,49.65
Skarner,Chogath,289,188,101,65.05
Skarner,JarvanIV,64,18,46,28.13
Skarner,Vex,92,44,48,47.83
Skarner,Mordekaiser,321,112,209,34.89
Skarner,Lucian,120,50,70,41.67
Skarner,Yuumi,220,121,99,55
Skarner,Kled,47,24,23,51.06
Skarner,Lillia,135,48,87,35.56
Skarner,Ahri,286,119,167,41.61
Skarner,MissFortune,360,139,221,38.61
Skarner,Neeko,136,38,98,27.94
Skarner,Darius,380,191,189,50.26
Skarner,MasterYi,173,56,117,32.37
Skarner,Kassadin,30,17,13,56.67
Skarner,Rell,151,79,72,52.32
Skarner,Aatrox,183,69,114,37.7
Skarner,Sylas,216,103,113,47.69
Skarner,Kindred,83,54,29,65.06
Skarner,Singed,41,9,32,21.95
Skarner,Vi,192,78,114,40.63
Skarner,Lulu,187,88,99,47.06
Skarner,Viego,194,59,135,30.41
Skarner,Swain,229,107,122,46.72
Skarner,Aurora,175,87,88,49.71
Skarner,Zyra,103,51,52,49.51
Skarner,Garen,222,97,125,43.69
Skarner,Azir,81,55,26,67.9
Skarner,Briar,196,89,107,45.41
Skarner,Gangplank,79,33,46,41.77
Skarner,Urgot,72,34,38,47.22
Skarner,Jinx,383,143,240,37.34
Skarner,Seraphine,235,117,118,49.79
Skarner,Hecarim,67,17,50,25.37
Skarner,Ashe,415,196,219,47.23
Skarner,Vayne,187,76,111,40.64
Skarner,Vladimir,91,38,53,41.76
Skarner,Senna,141,47,94,33.33
Skarner,Twitch,145,73,72,50.34
Skarner,Pyke,246,84,162,34.15
Skarner,Shaco,151,99,52,65.56
Skarner,Tryndamere,109,50,59,45.87
Skarner,Udyr,88,50,38,56.82
Skarner,Syndra,107,41,66,38.32
Skarner,TahmKench,172,74,98,43.02
Skarner,Taliyah,72,37,35,51.39
Skarner,Zilean,49,38,11,77.55
Skarner,Gragas,81,52,29,64.2
Skarner,Elise,129,57,72,44.19
Skarner,Gnar,122,59,63,48.36
Skarner,Orianna,123,53,70,43.09
Skarner,Ekko,154,66,88,42.86
Skarner,Riven,91,50,41,54.95
Skarner,Samira,232,135,97,58.19
Skarner,Draven,85,36,49,42.35
Skarner,Belveth,77,26,51,33.77
Skarner,Leona,140,69,71,49.29
Skarner,Quinn,94,32,62,34.04
Skarner,XinZhao,97,41,56,42.27
Skarner,Malzahar,130,54,76,41.54
Skarner,Sejuani,114,54,60,47.37
Skarner,Rakan,106,55,51,51.89
Skarner,Khazix,138,87,51,63.04
Skarner,Braum,103,42,61,40.78
Skarner,Renekton,149,65,84,43.62
Skarner,MonkeyKing,153,45,108,29.41
Skarner,Shyvana,79,28,51,35.44
Skarner,Velkoz,108,47,61,43.52
Skarner,Milio,90,38,52,42.22
Skarner,Trundle,104,43,61,41.35
Skarner,Fizz,83,41,42,49.4
Skarner,Sona,77,41,36,53.25
Skarner,Yone,297,134,163,45.12
Skarner,Blitzcrank,144,67,77,46.53
Skarner,Cassiopeia,93,39,54,41.94
Skarner,Poppy,79,42,37,53.16
Skarner,Sivir,84,22,62,26.19
Skarner,Camille,81,42,39,51.85
Skarner,Akshan,115,40,75,34.78
Skarner,Anivia,60,31,29,51.67
Skarner,Kayle,140,43,97,30.71
Skarner,Janna,50,13,37,26
Skarner,Naafiri,120,59,61,49.17
Skarner,Ambessa,154,65,89,42.21
Skarner,Hwei,116,57,59,49.14
Skarner,Rammus,19,9,10,47.37
Skarner,Heimerdinger,111,38,73,34.23
Skarner,Talon,108,48,60,44.44
Skarner,FiddleSticks,103,70,33,67.96
Skarner,TwistedFate,63,28,35,44.44
Skarner,Rumble,57,33,24,57.89
Skarner,Soraka,93,56,37,60.22
Skarner,Kalista,93,42,51,45.16
Skarner,Zeri,107,51,56,47.66
Skarner,Xerath,132,85,47,64.39
Skarner,KSante,88,43,45,48.86
Skarner,AurelionSol,79,48,31,60.76
Skarner,Corki,68,36,32,52.94
Skarner,Evelynn,111,52,59,46.85
Skarner,Aphelios,125,65,60,52
Skarner,Ryze,55,25,30,45.45
Skarner,Jayce,73,10,63,13.7
Skarner,Ornn,57,36,21,63.16
Skarner,Zac,105,54,51,51.43
Skarner,Nidalee,32,10,22,31.25
Skarner,Gwen,79,51,28,64.56
Skarner,Fiora,86,39,47,45.35
Skarner,Maokai,53,32,21,60.38
Skarner,RekSai,27,18,9,66.67
Skarner,Taric,48,16,32,33.33
Skarner,Qiyana,68,45,23,66.18
Skarner,Brand,106,51,55,48.11
Skarner,Kennen,42,28,14,66.67
Skarner,Olaf,48,20,28,41.67
Skarner,Lissandra,50,18,32,36
Skarner,Renata,56,21,35,37.5
Skarner,Karthus,21,8,13,38.1
Urgot,Riven,148,91,57,61.49
Urgot,Amumu,269,104,165,38.66
Urgot,Zoe,175,114,61,65.14
Urgot,MissFortune,650,341,309,52.46
Urgot,Sona,149,69,80,46.31
Urgot,Mordekaiser,588,309,279,52.55
Urgot,Udyr,136,64,72,47.06
Urgot,Yorick,286,126,160,44.06
Urgot,Sivir,147,72,75,48.98
Urgot,Nautilus,326,176,150,53.99
Urgot,Darius,515,283,232,54.95
Urgot,Yasuo,548,310,238,56.57
Urgot,Swain,341,177,164,51.91
Urgot,Vi,255,139,116,54.51
Urgot,Orianna,97,55,42,56.7
Urgot,Draven,194,108,86,55.67
Urgot,Lulu,229,102,127,44.54
Urgot,Singed,151,70,81,46.36
Urgot,Kindred,180,69,111,38.33
Urgot,Ashe,491,243,248,49.49
Urgot,Alistar,107,70,37,65.42
Urgot,Kled,82,35,47,42.68
Urgot,Zeri,171,90,81,52.63
Urgot,Neeko,285,179,106,62.81
Urgot,TahmKench,341,181,160,53.08
Urgot,Brand,217,112,105,51.61
Urgot,Mel,636,333,303,52.36
Urgot,Jinx,582,276,306,47.42
Urgot,Pyke,318,180,138,56.6
Urgot,Thresh,360,177,183,49.17
Urgot,Viego,347,185,162,53.31
Urgot,Kalista,152,100,52,65.79
Urgot,FiddleSticks,152,81,71,53.29
Urgot,Chogath,406,232,174,57.14
Urgot,MasterYi,367,178,189,48.5
Urgot,Zed,238,131,107,55.04
Urgot,Lux,735,340,395,46.26
Urgot,Morgana,406,238,168,58.62
Urgot,Aatrox,363,191,172,52.62
Urgot,XinZhao,166,114,52,68.67
Urgot,Qiyana,101,55,46,54.46
Urgot,AurelionSol,135,84,51,62.22
Urgot,Zyra,185,66,119,35.68
Urgot,Warwick,532,294,238,55.26
Urgot,Fizz,161,124,37,77.02
Urgot,Teemo,371,168,203,45.28
Urgot,Poppy,162,97,65,59.88
Urgot,Ekko,191,118,73,61.78
Urgot,Kaisa,446,253,193,56.73
Urgot,Rell,159,96,63,60.38
Urgot,Sett,543,274,269,50.46
Urgot,LeeSin,209,105,104,50.24
Urgot,Ezreal,474,295,179,62.24
Urgot,Xayah,131,55,76,41.98
Urgot,DrMundo,143,46,97,32.17
Urgot,Shen,156,89,67,57.05
Urgot,Tryndamere,168,95,73,56.55
Urgot,Katarina,251,130,121,51.79
Urgot,Seraphine,267,141,126,52.81
Urgot,Caitlyn,642,416,226,64.8
Urgot,Nocturne,282,151,131,53.55
Urgot,Elise,162,108,54,66.67
Urgot,Senna,301,133,168,44.19
Urgot,Maokai,137,72,65,52.55
Urgot,Kennen,141,95,46,67.38
Urgot,Belveth,79,31,48,39.24
Urgot,Ambessa,127,89,38,70.08
Urgot,Irelia,251,147,104,58.57
Urgot,Samira,263,174,89,66.16
Urgot,Yuumi,278,145,133,52.16
Urgot,Jax,246,145,101,58.94
Urgot,Karthus,48,40,8,83.33
Urgot,MonkeyKing,153,90,63,58.82
Urgot,Lucian,176,111,65,63.07
Urgot,Nami,293,150,143,51.19
Urgot,Malzahar,218,114,104,52.29
Urgot,Aphelios,159,85,74,53.46
Urgot,Milio,137,74,63,54.01
Urgot,Kayn,472,279,193,59.11
Urgot,Volibear,286,162,124,56.64
Urgot,Smolder,275,145,130,52.73
Urgot,Talon,187,110,77,58.82
Urgot,Sylas,312,172,140,55.13
Urgot,Vladimir,144,61,83,42.36
Urgot,Gangplank,145,90,55,62.07
Urgot,Varus,248,107,141,43.15
Urgot,Rakan,148,67,81,45.27
Urgot,Aurora,239,125,114,52.3
Urgot,Braum,153,60,93,39.22
Urgot,Yone,500,273,227,54.6
Urgot,Camille,79,68,11,86.08
Urgot,Khazix,177,129,48,72.88
Urgot,Akali,255,163,92,63.92
Urgot,Skarner,72,38,34,52.78
Urgot,Shaco,251,138,113,54.98
Urgot,Zac,107,50,57,46.73
Urgot,Kassadin,111,67,44,60.36
Urgot,Twitch,177,107,70,60.45
Urgot,Nasus,298,143,155,47.99
Urgot,Cassiopeia,136,66,70,48.53
Urgot,RekSai,46,26,20,56.52
Urgot,Leona,189,88,101,46.56
Urgot,Taric,82,34,48,41.46
Urgot,Anivia,127,69,58,54.33
Urgot,KSante,79,37,42,46.84
Urgot,Fiora,110,76,34,69.09
Urgot,Veigar,319,166,153,52.04
Urgot,Ivern,77,48,29,62.34
Urgot,Jhin,503,266,237,52.88
Urgot,Ryze,71,43,28,60.56
Urgot,Ziggs,152,74,78,48.68
Urgot,Tristana,216,110,106,50.93
Urgot,Garen,491,233,258,47.45
Urgot,Ahri,421,236,185,56.06
Urgot,Vayne,275,153,122,55.64
Urgot,KogMaw,103,52,51,50.49
Urgot,Xerath,188,118,70,62.77
Urgot,Gragas,174,125,49,71.84
Urgot,Akshan,119,62,57,52.1
Urgot,Briar,282,162,120,57.45
Urgot,Hwei,215,104,111,48.37
Urgot,Blitzcrank,187,76,111,40.64
Urgot,Leblanc,114,75,39,65.79
Urgot,Quinn,94,78,16,82.98
Urgot,Diana,369,200,169,54.2
Urgot,Pantheon,549,317,232,57.74
Urgot,Malphite,175,93,82,53.14
Urgot,Heimerdinger,134,64,70,47.76
Urgot,Karma,226,116,110,51.33
Urgot,Gwen,198,65,133,32.83
Urgot,Evelynn,166,78,88,46.99
Urgot,Corki,115,50,65,43.48
Urgot,Lillia,142,62,80,43.66
Urgot,Taliyah,80,38,42,47.5
Urgot,Viktor,215,104,111,48.37
Urgot,Trundle,168,124,44,73.81
Urgot,Sejuani,100,58,42,58
Urgot,Syndra,149,66,83,44.3
Urgot,Renekton,141,89,52,63.12
Urgot,TwistedFate,102,64,38,62.75
Urgot,Bard,91,51,40,56.04
Urgot,Olaf,49,22,27,44.9
Urgot,Gnar,131,85,46,64.89
Urgot,Rumble,39,24,15,61.54
Urgot,Nunu,194,126,68,64.95
Urgot,Zilean,101,52,49,51.49
Urgot,Sion,250,103,147,41.2
Urgot,Kayle,264,132,132,50
Urgot,Vex,122,67,55,54.92
Urgot,Galio,141,70,71,49.65
Urgot,Rengar,103,72,31,69.9
Urgot,Illaoi,119,72,47,60.5
Urgot,Azir,126,56,70,44.44
Urgot,Graves,152,85,67,55.92
Urgot,Renata,75,40,35,53.33
Urgot,Hecarim,89,49,40,55.06
Urgot,JarvanIV,89,48,41,53.93
Urgot,Soraka,150,107,43,71.33
Urgot,Rammus,120,43,77,35.83
Urgot,Lissandra,76,38,38,50
Urgot,Nilah,151,93,58,61.59
Urgot,Jayce,101,56,45,55.45
Urgot,Annie,76,42,34,55.26
Urgot,Velkoz,135,100,35,74.07
Urgot,Ornn,82,42,40,51.22
Urgot,Nidalee,118,55,63,46.61
Urgot,Janna,99,80,19,80.81
Urgot,Naafiri,106,62,44,58.49
Urgot,Shyvana,72,39,33,54.17
Orianna,Darius,554,267,287,48.19
Orianna,Rengar,135,104,31,77.04
Orianna,Syndra,255,136,119,53.33
Orianna,Caitlyn,698,314,384,44.99
Orianna,Lux,794,382,412,48.11
Orianna,Urgot,97,42,55,43.3
Orianna,LeeSin,336,184,152,54.76
Orianna,TwistedFate,154,65,89,42.21
Orianna,Yasuo,508,272,236,53.54
Orianna,Rakan,140,59,81,42.14
Orianna,Camille,85,50,35,58.82
Orianna,Mel,831,401,430,48.26
Orianna,Draven,128,52,76,40.63
Orianna,Senna,262,125,137,47.71
Orianna,Zac,59,23,36,38.98
Orianna,Nunu,209,111,98,53.11
Orianna,Veigar,337,127,210,37.69
Orianna,Kaisa,356,239,117,67.13
Orianna,Shen,253,151,102,59.68
Orianna,Riven,110,42,68,38.18
Orianna,Vi,259,120,139,46.33
Orianna,MissFortune,467,211,256,45.18
Orianna,Soraka,125,56,69,44.8
Orianna,Yorick,287,116,171,40.42
Orianna,MasterYi,303,134,169,44.22
Orianna,Irelia,198,124,74,62.63
Orianna,Nami,281,131,150,46.62
Orianna,Yone,485,228,257,47.01
Orianna,Neeko,222,115,107,51.8
Orianna,Kayn,381,196,185,51.44
Orianna,Heimerdinger,144,73,71,50.69
Orianna,Mordekaiser,332,173,159,52.11
Orianna,Viego,337,172,165,51.04
Orianna,Zeri,153,68,85,44.44
Orianna,Alistar,92,33,59,35.87
Orianna,Singed,121,70,51,57.85
Orianna,Karma,211,98,113,46.45
Orianna,Jinx,636,289,347,45.44
Orianna,Akshan,112,46,66,41.07
Orianna,Aphelios,254,129,125,50.79
Orianna,Braum,144,58,86,40.28
Orianna,Amumu,276,117,159,42.39
Orianna,Zed,241,124,117,51.45
Orianna,Poppy,147,89,58,60.54
Orianna,Pyke,311,157,154,50.48
Orianna,Aurora,361,206,155,57.06
Orianna,Aatrox,227,141,86,62.11
Orianna,Kindred,170,100,70,58.82
Orianna,Swain,258,117,141,45.35
Orianna,Blitzcrank,252,124,128,49.21
Orianna,Ekko,201,94,107,46.77
Orianna,Rell,211,106,105,50.24
Orianna,Illaoi,138,68,70,49.28
Orianna,Jhin,401,196,205,48.88
Orianna,Talon,162,84,78,51.85
Orianna,Galio,188,65,123,34.57
Orianna,Lucian,163,83,80,50.92
Orianna,Milio,179,107,72,59.78
Orianna,Ornn,161,78,83,48.45
Orianna,Pantheon,483,285,198,59.01
Orianna,Nautilus,305,166,139,54.43
Orianna,Akali,241,122,119,50.62
Orianna,Vayne,266,127,139,47.74
Orianna,Seraphine,263,132,131,50.19
Orianna,Shyvana,99,51,48,51.52
Orianna,Vex,140,66,74,47.14
Orianna,Ezreal,582,304,278,52.23
Orianna,Malzahar,228,101,127,44.3
Orianna,Gwen,162,87,75,53.7
Orianna,Rammus,114,66,48,57.89
Orianna,Katarina,204,81,123,39.71
Orianna,Viktor,246,106,140,43.09
Orianna,Ashe,529,216,313,40.83
Orianna,Yuumi,206,87,119,42.23
Orianna,Fiora,122,51,71,41.8
Orianna,Vladimir,187,91,96,48.66
Orianna,Varus,263,170,93,64.64
Orianna,Velkoz,158,90,68,56.96
Orianna,Chogath,282,135,147,47.87
Orianna,Gragas,169,62,107,36.69
Orianna,Shaco,243,121,122,49.79
Orianna,Morgana,330,156,174,47.27
Orianna,Bard,70,34,36,48.57
Orianna,Gangplank,101,52,49,51.49
Orianna,Brand,157,96,61,61.15
Orianna,Sett,393,192,201,48.85
Orianna,Nocturne,294,130,164,44.22
Orianna,Kennen,58,29,29,50
Orianna,Teemo,327,131,196,40.06
Orianna,Malphite,182,75,107,41.21
Orianna,Karthus,39,19,20,48.72
Orianna,Nilah,185,83,102,44.86
Orianna,Leona,194,92,102,47.42
Orianna,Xerath,272,100,172,36.76
Orianna,Graves,129,71,58,55.04
Orianna,Cassiopeia,98,43,55,43.88
Orianna,Qiyana,94,53,41,56.38
Orianna,Azir,118,52,66,44.07
Orianna,KSante,64,45,19,70.31
Orianna,Ambessa,222,108,114,48.65
Orianna,Lillia,140,45,95,32.14
Orianna,Samira,279,130,149,46.59
Orianna,Maokai,147,65,82,44.22
Orianna,Anivia,89,57,32,64.04
Orianna,Volibear,266,134,132,50.38
Orianna,Zyra,174,91,83,52.3
Orianna,Nidalee,60,37,23,61.67
Orianna,Taric,48,29,19,60.42
Orianna,Kassadin,41,27,14,65.85
Orianna,Udyr,60,38,22,63.33
Orianna,Sylas,313,155,158,49.52
Orianna,Zilean,72,28,44,38.89
Orianna,Zoe,120,38,82,31.67
Orianna,Sivir,135,78,57,57.78
Orianna,Renekton,148,64,84,43.24
Orianna,Ivern,60,32,28,53.33
Orianna,Elise,192,87,105,45.31
Orianna,Tryndamere,161,79,82,49.07
Orianna,Thresh,381,192,189,50.39
Orianna,FiddleSticks,120,53,67,44.17
Orianna,Trundle,122,42,80,34.43
Orianna,Leblanc,136,62,74,45.59
Orianna,Lulu,213,101,112,47.42
Orianna,Naafiri,115,80,35,69.57
Orianna,Skarner,123,70,53,56.91
Orianna,Khazix,234,135,99,57.69
Orianna,Hwei,171,110,61,64.33
Orianna,Diana,375,151,224,40.27
Orianna,Twitch,234,96,138,41.03
Orianna,MonkeyKing,137,61,76,44.53
Orianna,Belveth,57,22,35,38.6
Orianna,Xayah,170,100,70,58.82
Orianna,TahmKench,264,122,142,46.21
Orianna,Kled,43,19,24,44.19
Orianna,Jax,233,98,135,42.06
Orianna,Fizz,155,82,73,52.9
Orianna,Annie,123,55,68,44.72
Orianna,Sion,209,86,123,41.15
Orianna,Kayle,176,126,50,71.59
Orianna,Briar,269,140,129,52.04
Orianna,Sona,88,40,48,45.45
Orianna,Warwick,482,218,264,45.23
Orianna,Ziggs,129,58,71,44.96
Orianna,Smolder,142,68,74,47.89
Orianna,Tristana,231,135,96,58.44
Orianna,Hecarim,76,22,54,28.95
Orianna,KogMaw,152,69,83,45.39
Orianna,Garen,377,183,194,48.54
Orianna,Quinn,107,20,87,18.69
Orianna,Kalista,110,40,70,36.36
Orianna,Nasus,153,80,73,52.29
Orianna,Corki,109,48,61,44.04
Orianna,Ryze,79,56,23,70.89
Orianna,DrMundo,246,89,157,36.18
Orianna,Janna,110,58,52,52.73
Orianna,Renata,61,17,44,27.87
Orianna,Gnar,63,39,24,61.9
Orianna,Jayce,154,56,98,36.36
Orianna,AurelionSol,155,71,84,45.81
Orianna,Olaf,60,39,21,65
Orianna,Ahri,338,181,157,53.55
Orianna,JarvanIV,110,54,56,49.09
Orianna,Lissandra,68,34,34,50
Orianna,Rumble,77,48,29,62.34
Orianna,XinZhao,145,68,77,46.9
Orianna,Evelynn,128,63,65,49.22
Orianna,Taliyah,97,49,48,50.52
Orianna,Sejuani,120,51,69,42.5
Orianna,RekSai,37,19,18,51.35
Rengar,Aatrox,311,97,214,31.19
Rengar,Ekko,227,75,152,33.04
Rengar,Orianna,135,31,104,22.96
Rengar,Malzahar,205,73,132,35.61
Rengar,Maokai,122,54,68,44.26
Rengar,Mordekaiser,417,137,280,32.85
Rengar,Udyr,121,65,56,53.72
Rengar,Yorick,241,105,136,43.57
Rengar,Sivir,99,12,87,12.12
Rengar,Nautilus,278,105,173,37.77
Rengar,DrMundo,160,80,80,50
Rengar,Belveth,85,44,41,51.76
Rengar,Leblanc,128,39,89,30.47
Rengar,Briar,251,74,177,29.48
Rengar,Anivia,67,27,40,40.3
Rengar,Tryndamere,179,89,90,49.72
Rengar,Gragas,205,85,120,41.46
Rengar,Irelia,267,114,153,42.7
Rengar,Kalista,133,58,75,43.61
Rengar,Twitch,229,90,139,39.3
Rengar,Yasuo,582,215,367,36.94
Rengar,Yone,546,221,325,40.48
Rengar,Alistar,133,55,78,41.35
Rengar,Volibear,310,123,187,39.68
Rengar,Nocturne,231,72,159,31.17
Rengar,Xerath,167,56,111,33.53
Rengar,Ezreal,561,235,326,41.89
Rengar,Blitzcrank,222,100,122,45.05
Rengar,Poppy,188,70,118,37.23
Rengar,Warwick,353,181,172,51.27
Rengar,Leona,173,63,110,36.42
Rengar,MissFortune,568,215,353,37.85
Rengar,Lux,700,287,413,41
Rengar,Rammus,110,42,68,38.18
Rengar,Aurora,285,98,187,34.39
Rengar,Ashe,491,217,274,44.2
Rengar,Pantheon,376,139,237,36.97
Rengar,Jax,255,76,179,29.8
Rengar,Sejuani,144,43,101,29.86
Rengar,Syndra,151,51,100,33.77
Rengar,Jinx,521,232,289,44.53
Rengar,Swain,297,82,215,27.61
Rengar,Sylas,208,91,117,43.75
Rengar,FiddleSticks,141,40,101,28.37
Rengar,Aphelios,180,75,105,41.67
Rengar,Morgana,308,144,164,46.75
Rengar,Ambessa,191,82,109,42.93
Rengar,Varus,244,106,138,43.44
Rengar,Graves,194,79,115,40.72
Rengar,Neeko,193,79,114,40.93
Rengar,Gangplank,74,37,37,50
Rengar,Kayn,471,175,296,37.15
Rengar,Hwei,197,83,114,42.13
Rengar,Jhin,481,196,285,40.75
Rengar,Jayce,119,51,68,42.86
Rengar,JarvanIV,116,41,75,35.34
Rengar,Caitlyn,633,310,323,48.97
Rengar,Vex,144,52,92,36.11
Rengar,Renekton,126,46,80,36.51
Rengar,TahmKench,340,135,205,39.71
Rengar,Gwen,177,73,104,41.24
Rengar,LeeSin,282,108,174,38.3
Rengar,TwistedFate,111,51,60,45.95
Rengar,Zeri,144,57,87,39.58
Rengar,Seraphine,290,106,184,36.55
Rengar,Nasus,183,61,122,33.33
Rengar,Zac,109,36,73,33.03
Rengar,Mel,581,207,374,35.63
Rengar,Singed,71,41,30,57.75
Rengar,Shaco,262,130,132,49.62
Rengar,Taliyah,99,43,56,43.43
Rengar,Shen,200,74,126,37
Rengar,Gnar,105,44,61,41.9
Rengar,Vi,180,70,110,38.89
Rengar,Kaisa,386,155,231,40.16
Rengar,Rumble,39,24,15,61.54
Rengar,Malphite,190,74,116,38.95
Rengar,Lulu,255,85,170,33.33
Rengar,Khazix,241,126,115,52.28
Rengar,Talon,237,101,136,42.62
Rengar,Thresh,364,143,221,39.29
Rengar,Olaf,43,21,22,48.84
Rengar,Nunu,280,146,134,52.14
Rengar,Vladimir,144,50,94,34.72
Rengar,Diana,361,138,223,38.23
Rengar,Veigar,279,132,147,47.31
Rengar,Milio,152,67,85,44.08
Rengar,Kindred,136,48,88,35.29
Rengar,Heimerdinger,106,48,58,45.28
Rengar,Yuumi,290,117,173,40.34
Rengar,Trundle,144,67,77,46.53
Rengar,Xayah,202,63,139,31.19
Rengar,Riven,144,82,62,56.94
Rengar,Ahri,360,138,222,38.33
Rengar,Nami,210,87,123,41.43
Rengar,Garen,434,184,250,42.4
Rengar,Galio,189,66,123,34.92
Rengar,Katarina,255,104,151,40.78
Rengar,Braum,148,51,97,34.46
Rengar,Kennen,89,25,64,28.09
Rengar,Skarner,126,52,74,41.27
Rengar,Illaoi,115,40,75,34.78
Rengar,Ziggs,100,39,61,39
Rengar,Elise,181,81,100,44.75
Rengar,Sion,175,54,121,30.86
Rengar,Viego,326,130,196,39.88
Rengar,Annie,78,16,62,20.51
Rengar,AurelionSol,127,43,84,33.86
Rengar,Chogath,331,74,257,22.36
Rengar,Darius,468,184,284,39.32
Rengar,Zed,309,154,155,49.84
Rengar,Amumu,222,118,104,53.15
Rengar,Janna,144,55,89,38.19
Rengar,Vayne,234,101,133,43.16
Rengar,Brand,163,53,110,32.52
Rengar,Zoe,168,93,75,55.36
Rengar,MasterYi,267,101,166,37.83
Rengar,Soraka,182,93,89,51.1
Rengar,Lucian,147,64,83,43.54
Rengar,KSante,165,58,107,35.15
Rengar,Kassadin,63,11,52,17.46
Rengar,Teemo,339,129,210,38.05
Rengar,Smolder,280,118,162,42.14
Rengar,Cassiopeia,108,59,49,54.63
Rengar,Sona,84,30,54,35.71
Rengar,Qiyana,117,72,45,61.54
Rengar,Akshan,74,36,38,48.65
Rengar,Tristana,198,90,108,45.45
Rengar,Azir,138,58,80,42.03
Rengar,Karthus,77,45,32,58.44
Rengar,Corki,100,47,53,47
Rengar,Bard,162,57,105,35.19
Rengar,Sett,446,166,280,37.22
Rengar,Evelynn,123,33,90,26.83
Rengar,Naafiri,97,46,51,47.42
Rengar,Velkoz,188,76,112,40.43
Rengar,Samira,206,79,127,38.35
Rengar,KogMaw,64,16,48,25
Rengar,Ivern,70,32,38,45.71
Rengar,Draven,177,67,110,37.85
Rengar,Pyke,279,97,182,34.77
Rengar,Senna,173,85,88,49.13
Rengar,Akali,252,91,161,36.11
Rengar,Karma,244,123,121,50.41
Rengar,Rakan,174,67,107,38.51
Rengar,Hecarim,128,42,86,32.81
Rengar,Zilean,72,26,46,36.11
Rengar,Ryze,109,59,50,54.13
Rengar,Quinn,125,42,83,33.6
Rengar,Camille,75,41,34,54.67
Rengar,Rell,130,55,75,42.31
Rengar,Viktor,213,115,98,53.99
Rengar,Nilah,164,58,106,35.37
Rengar,Ornn,117,37,80,31.62
Rengar,Lillia,144,70,74,48.61
Rengar,Fizz,85,26,59,30.59
Rengar,XinZhao,137,47,90,34.31
Rengar,Kled,55,25,30,45.45
Rengar,Zyra,131,63,68,48.09
Rengar,Lissandra,96,42,54,43.75
Rengar,Fiora,147,62,85,42.18
Rengar,Renata,102,45,57,44.12
Rengar,MonkeyKing,113,25,88,22.12
Rengar,Shyvana,58,31,27,53.45
Rengar,Kayle,163,64,99,39.26
Rengar,Urgot,103,31,72,30.1
Rengar,Taric,65,24,41,36.92
Rengar,RekSai,70,43,27,61.43
Rengar,Nidalee,61,27,34,44.26
Syndra,Aatrox,279,160,119,57.35
Syndra,Ekko,232,124,108,53.45
Syndra,Orianna,255,119,136,46.67
Syndra,Malzahar,279,151,128,54.12
Syndra,Maokai,105,57,48,54.29
Syndra,XinZhao,216,108,108,50
Syndra,Katarina,301,142,159,47.18
Syndra,Teemo,477,228,249,47.8
Syndra,Vayne,341,170,171,49.85
Syndra,TwistedFate,108,62,46,57.41
Syndra,Yorick,349,159,190,45.56
Syndra,Viego,378,182,196,48.15
Syndra,Malphite,255,129,126,50.59
Syndra,Kaisa,449,219,230,48.78
Syndra,Rell,183,105,78,57.38
Syndra,Gangplank,146,80,66,54.79
Syndra,Karthus,96,69,27,71.88
Syndra,Aurora,399,210,189,52.63
Syndra,Ezreal,571,318,253,55.69
Syndra,Senna,238,120,118,50.42
Syndra,Volibear,306,157,149,51.31
Syndra,Evelynn,180,60,120,33.33
Syndra,Nocturne,258,118,140,45.74
Syndra,Neeko,225,156,69,69.33
Syndra,Azir,135,82,53,60.74
Syndra,Sejuani,146,61,85,41.78
Syndra,Sylas,236,125,111,52.97
Syndra,Lucian,217,127,90,58.53
Syndra,Seraphine,292,141,151,48.29
Syndra,Nasus,306,179,127,58.5
Syndra,Kindred,141,78,63,55.32
Syndra,Tristana,244,142,102,58.2
Syndra,Nautilus,408,213,195,52.21
Syndra,Vex,198,87,111,43.94
Syndra,Vi,281,173,108,61.57
Syndra,Nilah,184,91,93,49.46
Syndra,Thresh,454,240,214,52.86
Syndra,Rengar,151,100,51,66.23
Syndra,Jhin,709,391,318,55.15
Syndra,Illaoi,115,48,67,41.74
Syndra,Irelia,363,203,160,55.92
Syndra,Varus,293,167,126,57
Syndra,Kayn,541,279,262,51.57
Syndra,Hwei,265,152,113,57.36
Syndra,Lux,954,511,443,53.56
Syndra,Ornn,198,75,123,37.88
Syndra,Zed,405,221,184,54.57
Syndra,Sivir,209,78,131,37.32
Syndra,Veigar,366,160,206,43.72
Syndra,Heimerdinger,215,112,103,52.09
Syndra,Briar,302,177,125,58.61
Syndra,Jinx,599,306,293,51.09
Syndra,Warwick,493,266,227,53.96
Syndra,Kalista,123,55,68,44.72
Syndra,Yasuo,582,325,257,55.84
Syndra,Jax,253,131,122,51.78
Syndra,Xayah,224,117,107,52.23
Syndra,Lulu,257,121,136,47.08
Syndra,MasterYi,370,199,171,53.78
Syndra,Ashe,640,304,336,47.5
Syndra,Riven,178,113,65,63.48
Syndra,Bard,92,37,55,40.22
Syndra,Rammus,83,40,43,48.19
Syndra,Caitlyn,836,446,390,53.35
Syndra,Alistar,91,40,51,43.96
Syndra,Braum,151,75,76,49.67
Syndra,Gragas,211,111,100,52.61
Syndra,Akali,296,151,145,51.01
Syndra,Kassadin,76,23,53,30.26
Syndra,Vladimir,162,87,75,53.7
Syndra,Gnar,131,65,66,49.62
Syndra,Sona,92,60,32,65.22
Syndra,Darius,658,330,328,50.15
Syndra,Leona,287,115,172,40.07
Syndra,Swain,336,210,126,62.5
Syndra,Shaco,390,226,164,57.95
Syndra,Amumu,271,154,117,56.83
Syndra,Mel,709,364,345,51.34
Syndra,Nami,382,206,176,53.93
Syndra,FiddleSticks,169,101,68,59.76
Syndra,Anivia,144,79,65,54.86
Syndra,Sett,519,261,258,50.29
Syndra,Shen,211,99,112,46.92
Syndra,Garen,483,192,291,39.75
Syndra,Naafiri,171,77,94,45.03
Syndra,Lillia,267,156,111,58.43
Syndra,Mordekaiser,508,227,281,44.69
Syndra,AurelionSol,202,82,120,40.59
Syndra,Morgana,411,161,250,39.17
Syndra,KSante,152,102,50,67.11
Syndra,Trundle,150,63,87,42
Syndra,Milio,175,121,54,69.14
Syndra,Talon,242,143,99,59.09
Syndra,Draven,174,94,80,54.02
Syndra,MissFortune,662,285,377,43.05
Syndra,Xerath,255,112,143,43.92
Syndra,Chogath,414,177,237,42.75
Syndra,Velkoz,255,116,139,45.49
Syndra,Yuumi,304,143,161,47.04
Syndra,Poppy,215,122,93,56.74
Syndra,Galio,196,105,91,53.57
Syndra,Ziggs,234,108,126,46.15
Syndra,Kennen,120,53,67,44.17
Syndra,TahmKench,347,168,179,48.41
Syndra,Twitch,228,143,85,62.72
Syndra,Ambessa,192,95,97,49.48
Syndra,Zyra,320,159,161,49.69
Syndra,Akshan,78,36,42,46.15
Syndra,LeeSin,305,168,137,55.08
Syndra,Sion,258,149,109,57.75
Syndra,Blitzcrank,257,135,122,52.53
Syndra,Fizz,211,130,81,61.61
Syndra,Soraka,214,72,142,33.64
Syndra,Renekton,150,104,46,69.33
Syndra,Qiyana,110,71,39,64.55
Syndra,Karma,255,136,119,53.33
Syndra,Singed,86,39,47,45.35
Syndra,Yone,682,406,276,59.53
Syndra,Skarner,107,66,41,61.68
Syndra,Ivern,58,14,44,24.14
Syndra,Pyke,403,241,162,59.8
Syndra,Zoe,237,110,127,46.41
Syndra,Cassiopeia,198,113,85,57.07
Syndra,Renata,49,23,26,46.94
Syndra,Samira,313,184,129,58.79
Syndra,Ahri,572,313,259,54.72
Syndra,Graves,173,86,87,49.71
Syndra,Rakan,197,139,58,70.56
Syndra,Pantheon,566,264,302,46.64
Syndra,Diana,550,318,232,57.82
Syndra,Leblanc,164,98,66,59.76
Syndra,Nunu,295,132,163,44.75
Syndra,KogMaw,107,54,53,50.47
Syndra,Hecarim,150,84,66,56
Syndra,Elise,187,116,71,62.03
Syndra,Kled,77,36,41,46.75
Syndra,JarvanIV,132,63,69,47.73
Syndra,Jayce,120,57,63,47.5
Syndra,Viktor,204,111,93,54.41
Syndra,Kayle,186,88,98,47.31
Syndra,DrMundo,215,58,157,26.98
Syndra,Brand,185,75,110,40.54
Syndra,Gwen,153,72,81,47.06
Syndra,Aphelios,182,99,83,54.4
Syndra,Fiora,130,48,82,36.92
Syndra,Zeri,190,83,107,43.68
Syndra,Annie,111,62,49,55.86
Syndra,Khazix,194,120,74,61.86
Syndra,Udyr,146,68,78,46.58
Syndra,Quinn,87,48,39,55.17
Syndra,Tryndamere,194,104,90,53.61
Syndra,Smolder,304,149,155,49.01
Syndra,Olaf,65,37,28,56.92
Syndra,Urgot,149,83,66,55.7
Syndra,Rumble,62,35,27,56.45
Syndra,Nidalee,84,50,34,59.52
Syndra,MonkeyKing,138,61,77,44.2
Syndra,Corki,158,111,47,70.25
Syndra,Belveth,97,55,42,56.7
Syndra,Zac,119,43,76,36.13
Syndra,Ryze,60,38,22,63.33
Syndra,Taric,67,38,29,56.72
Syndra,Camille,152,84,68,55.26
Syndra,Shyvana,123,44,79,35.77
Syndra,Lissandra,64,35,29,54.69
Syndra,Zilean,96,33,63,34.38
Syndra,Taliyah,57,21,36,36.84
Syndra,Janna,124,60,64,48.39
Syndra,RekSai,46,23,23,50
Braum,Sett,446,235,211,52.69
Braum,Vi,252,118,134,46.83
Braum,AurelionSol,146,80,66,54.79
Braum,Corki,126,36,90,28.57
Braum,Milio,139,56,83,40.29
Braum,Trundle,210,94,116,44.76
Braum,Amumu,269,108,161,40.15
Braum,Fizz,124,69,55,55.65
Braum,Kaisa,442,241,201,54.52
Braum,Pantheon,552,237,315,42.93
Braum,Riven,111,64,47,57.66
Braum,FiddleSticks,158,55,103,34.81
Braum,Brand,207,84,123,40.58
Braum,Jinx,517,237,280,45.84
Braum,Illaoi,163,71,92,43.56
Braum,Warwick,349,177,172,50.72
Braum,Aurora,232,147,85,63.36
Braum,Ezreal,463,258,205,55.72
Braum,Neeko,179,106,73,59.22
Braum,Nocturne,323,135,188,41.8
Braum,Ekko,204,114,90,55.88
Braum,MissFortune,681,343,338,50.37
Braum,Seraphine,357,151,206,42.3
Braum,Gangplank,117,47,70,40.17
Braum,Malzahar,189,108,81,57.14
Braum,Tristana,292,141,151,48.29
Braum,Senna,204,92,112,45.1
Braum,Mordekaiser,394,182,212,46.19
Braum,Sejuani,99,44,55,44.44
Braum,Yone,413,243,170,58.84
Braum,Swain,337,132,205,39.17
Braum,Shaco,242,133,109,54.96
Braum,Akali,269,124,145,46.1
Braum,Sivir,126,49,77,38.89
Braum,Renata,86,58,28,67.44
Braum,Fiora,158,73,85,46.2
Braum,Diana,367,172,195,46.87
Braum,Veigar,339,194,145,57.23
Braum,Ashe,440,267,173,60.68
Braum,Volibear,277,169,108,61.01
Braum,Irelia,204,111,93,54.41
Braum,Varus,156,80,76,51.28
Braum,Nautilus,355,202,153,56.9
Braum,Tryndamere,198,101,97,51.01
Braum,MasterYi,277,156,121,56.32
Braum,Orianna,144,86,58,59.72
Braum,Lux,659,340,319,51.59
Braum,MonkeyKing,178,94,84,52.81
Braum,Jhin,564,295,269,52.3
Braum,Vayne,314,157,157,50
Braum,Talon,190,108,82,56.84
Braum,Taliyah,92,34,58,36.96
Braum,Zoe,150,76,74,50.67
Braum,Shen,192,84,108,43.75
Braum,Kayn,449,202,247,44.99
Braum,Chogath,414,230,184,55.56
Braum,Viktor,158,93,65,58.86
Braum,Morgana,320,144,176,45
Braum,Hwei,188,83,105,44.15
Braum,Caitlyn,732,354,378,48.36
Braum,Teemo,441,245,196,55.56
Braum,Lucian,141,90,51,63.83
Braum,Ornn,128,63,65,49.22
Braum,Yorick,289,130,159,44.98
Braum,Kalista,121,75,46,61.98
Braum,LeeSin,220,106,114,48.18
Braum,Mel,596,297,299,49.83
Braum,Smolder,222,113,109,50.9
Braum,Zed,231,107,124,46.32
Braum,Sion,227,116,111,51.1
Braum,Soraka,201,93,108,46.27
Braum,Aatrox,241,132,109,54.77
Braum,Rengar,148,97,51,65.54
Braum,Ivern,111,81,30,72.97
Braum,Syndra,151,76,75,50.33
Braum,Samira,211,116,95,54.98
Braum,Maokai,104,33,71,31.73
Braum,Zac,90,31,59,34.44
Braum,Galio,182,60,122,32.97
Braum,Alistar,78,39,39,50
Braum,Graves,228,118,110,51.75
Braum,Yuumi,305,166,139,54.43
Braum,DrMundo,162,68,94,41.98
Braum,Nami,290,142,148,48.97
Braum,Briar,307,160,147,52.12
Braum,Ryze,83,40,43,48.19
Braum,Singed,89,65,24,73.03
Braum,Nasus,219,113,106,51.6
Braum,Evelynn,165,73,92,44.24
Braum,Ahri,448,233,215,52.01
Braum,Zyra,166,71,95,42.77
Braum,Ambessa,181,83,98,45.86
Braum,Sylas,308,167,141,54.22
Braum,Camille,103,37,66,35.92
Braum,Karthus,67,29,38,43.28
Braum,Yasuo,460,229,231,49.78
Braum,Lulu,233,104,129,44.64
Braum,Kindred,113,72,41,63.72
Braum,Nunu,230,125,105,54.35
Braum,Renekton,143,96,47,67.13
Braum,Vex,171,88,83,51.46
Braum,Karma,251,127,124,50.6
Braum,Azir,118,60,58,50.85
Braum,Jax,262,132,130,50.38
Braum,Draven,198,90,108,45.45
Braum,Vladimir,144,79,65,54.86
Braum,XinZhao,178,92,86,51.69
Braum,Urgot,153,93,60,60.78
Braum,Annie,82,38,44,46.34
Braum,Kayle,229,120,109,52.4
Braum,Gwen,166,97,69,58.43
Braum,Katarina,214,97,117,45.33
Braum,Aphelios,146,84,62,57.53
Braum,TahmKench,398,221,177,55.53
Braum,Lillia,146,69,77,47.26
Braum,Kassadin,77,40,37,51.95
Braum,Twitch,308,166,142,53.9
Braum,Leblanc,148,105,43,70.95
Braum,Nilah,183,76,107,41.53
Braum,Thresh,460,233,227,50.65
Braum,Viego,299,193,106,64.55
Braum,Heimerdinger,135,41,94,30.37
Braum,Quinn,94,36,58,38.3
Braum,Khazix,156,76,80,48.72
Braum,Xerath,195,91,104,46.67
Braum,Darius,469,192,277,40.94
Braum,Blitzcrank,227,128,99,56.39
Braum,Belveth,95,66,29,69.47
Braum,Xayah,173,79,94,45.66
Braum,Rakan,136,55,81,40.44
Braum,Elise,145,88,57,60.69
Braum,Garen,491,239,252,48.68
Braum,Velkoz,204,84,120,41.18
Braum,Jayce,101,53,48,52.48
Braum,Shyvana,48,21,27,43.75
Braum,Gnar,109,58,51,53.21
Braum,Gragas,216,128,88,59.26
Braum,Ziggs,138,73,65,52.9
Braum,JarvanIV,113,54,59,47.79
Braum,KSante,88,50,38,56.82
Braum,Poppy,136,73,63,53.68
Braum,Kennen,80,37,43,46.25
Braum,Bard,117,61,56,52.14
Braum,Naafiri,127,69,58,54.33
Braum,Skarner,103,61,42,59.22
Braum,Olaf,58,33,25,56.9
Braum,Kled,75,44,31,58.67
Braum,Janna,76,39,37,51.32
Braum,Hecarim,95,41,54,43.16
Braum,Nidalee,111,69,42,62.16
Braum,Malphite,262,103,159,39.31
Braum,Qiyana,79,24,55,30.38
Braum,Sona,81,21,60,25.93
Braum,RekSai,64,54,10,84.38
Braum,Lissandra,108,43,65,39.81
Braum,Anivia,95,57,38,60
Braum,Rumble,41,28,13,68.29
Braum,Zilean,71,36,35,50.7
Braum,Leona,166,101,65,60.84
Braum,Pyke,303,176,127,58.09
Braum,Akshan,77,46,31,59.74
Braum,KogMaw,99,42,57,42.42
Braum,TwistedFate,149,75,74,50.34
Braum,Rell,179,90,89,50.28
Braum,Rammus,78,31,47,39.74
Braum,Udyr,106,34,72,32.08
Braum,Cassiopeia,83,47,36,56.63
Braum,Zeri,112,57,55,50.89
Braum,Taric,44,36,8,81.82
Corki,Braum,126,90,36,71.43
Corki,XinZhao,112,31,81,27.68
Corki,Lux,630,286,344,45.4
Corki,Chogath,203,87,116,42.86
Corki,Taliyah,49,30,19,61.22
Corki,Mordekaiser,265,94,171,35.47
Corki,Vi,161,69,92,42.86
Corki,Azir,92,45,47,48.91
Corki,MissFortune,426,178,248,41.78
Corki,Nautilus,193,101,92,52.33
Corki,Gnar,109,78,31,71.56
Corki,Warwick,244,101,143,41.39
Corki,Malzahar,151,51,100,33.77
Corki,Tristana,192,74,118,38.54
Corki,Brand,123,66,57,53.66
Corki,Ornn,77,52,25,67.53
Corki,Amumu,169,84,85,49.7
Corki,Katarina,230,108,122,46.96
Corki,Twitch,187,105,82,56.15
Corki,Senna,168,99,69,58.93
Corki,Garen,348,109,239,31.32
Corki,Ekko,121,50,71,41.32
Corki,Yasuo,451,198,253,43.9
Corki,Caitlyn,476,206,270,43.28
Corki,Poppy,76,36,40,47.37
Corki,Aurora,209,97,112,46.41
Corki,Nocturne,193,58,135,30.05
Corki,Pantheon,337,168,169,49.85
Corki,Nilah,125,84,41,67.2
Corki,Soraka,137,37,100,27.01
Corki,Kennen,66,38,28,57.58
Corki,TwistedFate,84,46,38,54.76
Corki,Cassiopeia,83,31,52,37.35
Corki,Smolder,110,51,59,46.36
Corki,Milio,127,65,62,51.18
Corki,TahmKench,243,98,145,40.33
Corki,Samira,237,141,96,59.49
Corki,Taric,41,16,25,39.02
Corki,Hecarim,63,24,39,38.1
Corki,Jhin,330,124,206,37.58
Corki,Velkoz,141,58,83,41.13
Corki,Nasus,145,82,63,56.55
Corki,MasterYi,176,79,97,44.89
Corki,Riven,111,67,44,60.36
Corki,Rell,91,41,50,45.05
Corki,Rammus,58,27,31,46.55
Corki,Vex,90,56,34,62.22
Corki,Lulu,185,85,100,45.95
Corki,Kayle,115,53,62,46.09
Corki,Tryndamere,134,64,70,47.76
Corki,Akali,170,89,81,52.35
Corki,Neeko,102,37,65,36.27
Corki,Yorick,145,46,99,31.72
Corki,Singed,64,29,35,45.31
Corki,Ryze,64,28,36,43.75
Corki,Kayn,338,162,176,47.93
Corki,Viktor,148,74,74,50
Corki,Zed,224,126,98,56.25
Corki,Ashe,344,167,177,48.55
Corki,Thresh,286,136,150,47.55
Corki,Jax,180,68,112,37.78
Corki,Shaco,194,97,97,50
Corki,Zoe,119,58,61,48.74
Corki,Yuumi,220,118,102,53.64
Corki,Teemo,232,102,130,43.97
Corki,Evelynn,63,44,19,69.84
Corki,Janna,77,34,43,44.16
Corki,Aatrox,170,85,85,50
Corki,Lucian,88,42,46,47.73
Corki,Nami,205,74,131,36.1
Corki,LeeSin,260,137,123,52.69
Corki,Zac,50,26,24,52
Corki,Gragas,158,76,82,48.1
Corki,Viego,256,116,140,45.31
Corki,Darius,400,175,225,43.75
Corki,Kaisa,309,157,152,50.81
Corki,Swain,205,79,126,38.54
Corki,DrMundo,130,61,69,46.92
Corki,Trundle,133,26,107,19.55
Corki,Rengar,100,53,47,53
Corki,Vladimir,130,63,67,48.46
Corki,Mel,451,180,271,39.91
Corki,Sett,283,106,177,37.46
Corki,Nunu,217,110,107,50.69
Corki,Jinx,325,120,205,36.92
Corki,Briar,157,86,71,54.78
Corki,Ezreal,404,195,209,48.27
Corki,Morgana,235,112,123,47.66
Corki,Nidalee,43,31,12,72.09
Corki,Volibear,247,123,124,49.8
Corki,Annie,49,22,27,44.9
Corki,Vayne,249,88,161,35.34
Corki,Zeri,93,43,50,46.24
Corki,Gwen,84,50,34,59.52
Corki,Veigar,226,123,103,54.42
Corki,Sylas,147,63,84,42.86
Corki,Varus,143,69,74,48.25
Corki,Irelia,111,56,55,50.45
Corki,FiddleSticks,109,53,56,48.62
Corki,Illaoi,107,64,43,59.81
Corki,Lillia,130,41,89,31.54
Corki,Fizz,55,39,16,70.91
Corki,Karma,136,71,65,52.21
Corki,Fiora,111,49,62,44.14
Corki,Ivern,43,37,6,86.05
Corki,Kassadin,75,19,56,25.33
Corki,Aphelios,153,60,93,39.22
Corki,Diana,226,92,134,40.71
Corki,Sejuani,99,39,60,39.39
Corki,Shen,143,48,95,33.57
Corki,KSante,65,35,30,53.85
Corki,Khazix,143,73,70,51.05
Corki,Blitzcrank,165,70,95,42.42
Corki,Heimerdinger,77,38,39,49.35
Corki,Renata,39,25,14,64.1
Corki,Udyr,82,31,51,37.8
Corki,Zilean,80,42,38,52.5
Corki,Sion,183,112,71,61.2
Corki,Ziggs,92,47,45,51.09
Corki,Pyke,226,136,90,60.18
Corki,Naafiri,97,30,67,30.93
Corki,Ahri,198,103,95,52.02
Corki,Sivir,109,50,59,45.87
Corki,Seraphine,169,95,74,56.21
Corki,Galio,180,79,101,43.89
Corki,Draven,123,66,57,53.66
Corki,KogMaw,62,22,40,35.48
Corki,Jayce,73,45,28,61.64
Corki,Xerath,107,33,74,30.84
Corki,Olaf,59,31,28,52.54
Corki,Shyvana,65,31,34,47.69
Corki,Yone,286,112,174,39.16
Corki,Kalista,61,25,36,40.98
Corki,Leblanc,107,38,69,35.51
Corki,Rakan,112,48,64,42.86
Corki,Karthus,23,3,20,13.04
Corki,Urgot,115,65,50,56.52
Corki,JarvanIV,99,42,57,42.42
Corki,Camille,133,78,55,58.65
Corki,Orianna,109,61,48,55.96
Corki,Akshan,60,26,34,43.33
Corki,Xayah,145,69,76,47.59
Corki,Zyra,126,72,54,57.14
Corki,Talon,124,47,77,37.9
Corki,Kindred,119,50,69,42.02
Corki,Hwei,155,71,84,45.81
Corki,Maokai,78,39,39,50
Corki,Syndra,158,47,111,29.75
Corki,Gangplank,63,35,28,55.56
Corki,Lissandra,47,25,22,53.19
Corki,Alistar,96,34,62,35.42
Corki,Quinn,86,46,40,53.49
Corki,Skarner,68,32,36,47.06
Corki,Qiyana,66,33,33,50
Corki,Belveth,106,43,63,40.57
Corki,Renekton,112,72,40,64.29
Corki,MonkeyKing,119,37,82,31.09
Corki,AurelionSol,92,23,69,25
Corki,Bard,91,37,54,40.66
Corki,Leona,168,80,88,47.62
Corki,Elise,125,58,67,46.4
Corki,Kled,55,20,35,36.36
Corki,Sona,75,35,40,46.67
Corki,Malphite,140,63,77,45
Corki,Ambessa,113,29,84,25.66
Corki,RekSai,35,28,7,80
Corki,Anivia,51,19,32,37.25
Corki,Graves,73,46,27,63.01
Corki,Rumble,45,36,9,80
Bard,Riven,74,46,28,62.16
Bard,Nocturne,147,79,68,53.74
Bard,Zoe,118,59,59,50
Bard,Jinx,392,194,198,49.49
Bard,Lulu,206,116,90,56.31
Bard,Teemo,285,130,155,45.61
Bard,Amumu,217,115,102,53
Bard,Garen,290,122,168,42.07
Bard,KogMaw,83,47,36,56.63
Bard,Yuumi,208,96,112,46.15
Bard,Fiora,64,32,32,50
Bard,LeeSin,255,135,120,52.94
Bard,Ziggs,101,35,66,34.65
Bard,Senna,189,91,98,48.15
Bard,Tryndamere,143,81,62,56.64
Bard,Sylas,225,112,113,49.78
Bard,Taliyah,57,33,24,57.89
Bard,Jhin,311,159,152,51.13
Bard,Volibear,220,101,119,45.91
Bard,Malzahar,138,44,94,31.88
Bard,Caitlyn,540,230,310,42.59
Bard,Pyke,204,123,81,60.29
Bard,Jayce,66,46,20,69.7
Bard,Skarner,88,44,44,50
Bard,Lux,502,267,235,53.19
Bard,Poppy,118,64,54,54.24
Bard,Malphite,122,49,73,40.16
Bard,Sejuani,154,91,63,59.09
Bard,Heimerdinger,88,47,41,53.41
Bard,Zilean,44,19,25,43.18
Bard,Singed,57,9,48,15.79
Bard,MasterYi,200,88,112,44
Bard,Veigar,286,127,159,44.41
Bard,Karma,169,57,112,33.73
Bard,Yasuo,425,209,216,49.18
Bard,Ekko,170,77,93,45.29
Bard,Hwei,139,84,55,60.43
Bard,Sett,354,181,173,51.13
Bard,Ivern,39,20,19,51.28
Bard,Katarina,181,85,96,46.96
Bard,Xayah,124,58,66,46.77
Bard,Mel,466,249,217,53.43
Bard,Zed,181,101,80,55.8
Bard,Morgana,272,115,157,42.28
Bard,Akshan,78,50,28,64.1
Bard,Syndra,92,55,37,59.78
Bard,Xerath,152,84,68,55.26
Bard,Warwick,272,104,168,38.24
Bard,Viktor,148,90,58,60.81
Bard,Ashe,251,109,142,43.43
Bard,Yone,333,182,151,54.65
Bard,Shen,172,65,107,37.79
Bard,Leblanc,70,23,47,32.86
Bard,Twitch,169,91,78,53.85
Bard,Velkoz,112,36,76,32.14
Bard,Kindred,144,64,80,44.44
Bard,Trundle,133,56,77,42.11
Bard,Udyr,84,50,34,59.52
Bard,Samira,198,99,99,50
Bard,Rell,75,37,38,49.33
Bard,Aphelios,222,105,117,47.3
Bard,Alistar,84,35,49,41.67
Bard,Nidalee,64,33,31,51.56
Bard,Naafiri,101,47,54,46.53
Bard,Nautilus,218,127,91,58.26
Bard,TahmKench,240,95,145,39.58
Bard,Diana,174,70,104,40.23
Bard,Ezreal,369,204,165,55.28
Bard,Swain,190,61,129,32.11
Bard,Irelia,115,51,64,44.35
Bard,Orianna,70,36,34,51.43
Bard,Vayne,212,121,91,57.08
Bard,Soraka,128,42,86,32.81
Bard,Ornn,105,53,52,50.48
Bard,TwistedFate,56,29,27,51.79
Bard,Kaisa,218,151,67,69.27
Bard,Yorick,189,80,109,42.33
Bard,XinZhao,85,24,61,28.24
Bard,Graves,111,42,69,37.84
Bard,Shaco,162,90,72,55.56
Bard,Hecarim,84,48,36,57.14
Bard,Rengar,162,105,57,64.81
Bard,Vladimir,128,69,59,53.91
Bard,Karthus,34,19,15,55.88
Bard,Khazix,92,57,35,61.96
Bard,Qiyana,57,31,26,54.39
Bard,Renekton,118,80,38,67.8
Bard,Aurora,182,88,94,48.35
Bard,MissFortune,374,185,189,49.47
Bard,Elise,173,95,78,54.91
Bard,Brand,121,59,62,48.76
Bard,Annie,62,47,15,75.81
Bard,Zeri,117,51,66,43.59
Bard,Mordekaiser,218,122,96,55.96
Bard,Nasus,92,35,57,38.04
Bard,Kayn,246,104,142,42.28
Bard,Gnar,33,3,30,9.09
Bard,Neeko,124,33,91,26.61
Bard,Gragas,136,73,63,53.68
Bard,Ambessa,148,69,79,46.62
Bard,Briar,192,102,90,53.13
Bard,Darius,409,182,227,44.5
Bard,Milio,124,61,63,49.19
Bard,Sion,174,134,40,77.01
Bard,Nunu,188,71,117,37.77
Bard,JarvanIV,105,43,62,40.95
Bard,Tristana,190,102,88,53.68
Bard,AurelionSol,84,33,51,39.29
Bard,Kassadin,60,25,35,41.67
Bard,Lucian,92,39,53,42.39
Bard,Braum,117,56,61,47.86
Bard,Akali,207,92,115,44.44
Bard,Jax,152,59,93,38.82
Bard,Thresh,216,132,84,61.11
Bard,Quinn,115,75,40,65.22
Bard,Pantheon,292,127,165,43.49
Bard,Camille,81,47,34,58.02
Bard,DrMundo,141,76,65,53.9
Bard,Olaf,46,14,32,30.43
Bard,Nami,204,90,114,44.12
Bard,Renata,59,36,23,61.02
Bard,Zyra,151,64,87,42.38
Bard,Sona,87,40,47,45.98
Bard,Ahri,271,159,112,58.67
Bard,Kayle,144,88,56,61.11
Bard,Zac,98,34,64,34.69
Bard,FiddleSticks,123,66,57,53.66
Bard,Lillia,117,53,64,45.3
Bard,Belveth,30,10,20,33.33
Bard,Illaoi,100,40,60,40
Bard,Azir,52,30,22,57.69
Bard,Seraphine,210,102,108,48.57
Bard,Chogath,306,162,144,52.94
Bard,Anivia,69,48,21,69.57
Bard,Smolder,145,97,48,66.9
Bard,Galio,149,68,81,45.64
Bard,Maokai,86,23,63,26.74
Bard,MonkeyKing,92,43,49,46.74
Bard,Evelynn,90,37,53,41.11
Bard,Urgot,91,40,51,43.96
Bard,Vex,129,63,66,48.84
Bard,Sivir,117,62,55,52.99
Bard,Rakan,114,55,59,48.25
Bard,Cassiopeia,62,40,22,64.52
Bard,Rammus,37,24,13,64.86
Bard,Varus,118,59,59,50
Bard,Talon,106,75,31,70.75
Bard,Viego,207,132,75,63.77
Bard,Nilah,112,71,41,63.39
Bard,Gwen,143,69,74,48.25
Bard,Janna,81,51,30,62.96
Bard,Vi,162,83,79,51.23
Bard,Kennen,107,48,59,44.86
Bard,Aatrox,228,101,127,44.3
Bard,Blitzcrank,128,49,79,38.28
Bard,Gangplank,98,40,58,40.82
Bard,Rumble,45,13,32,28.89
Bard,KSante,95,68,27,71.58
Bard,Draven,111,65,46,58.56
Bard,Corki,91,54,37,59.34
Bard,Kled,22,19,3,86.36
Bard,Kalista,123,67,56,54.47
Bard,Shyvana,44,13,31,29.55
Bard,Leona,141,92,49,65.25
Bard,Fizz,87,69,18,79.31
Bard,Taric,35,23,12,65.71
Bard,Ryze,56,19,37,33.93
Bard,Lissandra,39,10,29,25.64
Bard,RekSai,9,0,9,0
Xerath,Mordekaiser,600,284,316,47.33
Xerath,Vi,382,208,174,54.45
Xerath,Cassiopeia,242,118,124,48.76
Xerath,Ezreal,710,374,336,52.68
Xerath,Lux,1389,751,638,54.07
Xerath,Gwen,265,154,111,58.11
Xerath,Tryndamere,259,74,185,28.57
Xerath,Velkoz,320,136,184,42.5
Xerath,Zeri,112,75,37,66.96
Xerath,Thresh,508,276,232,54.33
Xerath,Kayn,733,349,384,47.61
Xerath,Diana,624,331,293,53.04
Xerath,Sivir,183,52,131,28.42
Xerath,Soraka,272,150,122,55.15
Xerath,MasterYi,444,223,221,50.23
Xerath,Shaco,351,157,194,44.73
Xerath,Azir,208,120,88,57.69
Xerath,Rengar,167,111,56,66.47
Xerath,Pyke,392,203,189,51.79
Xerath,Malzahar,345,157,188,45.51
Xerath,Twitch,409,179,230,43.77
Xerath,Talon,200,111,89,55.5
Xerath,Jhin,774,411,363,53.1
Xerath,Rakan,196,102,94,52.04
Xerath,Singed,112,49,63,43.75
Xerath,Kindred,230,120,110,52.17
Xerath,Yasuo,658,326,332,49.54
Xerath,Ashe,665,318,347,47.82
Xerath,Alistar,107,61,46,57.01
Xerath,Aatrox,366,215,151,58.74
Xerath,Warwick,686,370,316,53.94
Xerath,Varus,329,223,106,67.78
Xerath,Milio,197,71,126,36.04
Xerath,Ornn,168,82,86,48.81
Xerath,Hwei,330,159,171,48.18
Xerath,Caitlyn,1141,618,523,54.16
Xerath,Karma,376,204,172,54.26
Xerath,Nasus,322,148,174,45.96
Xerath,LeeSin,390,212,178,54.36
Xerath,Ivern,83,61,22,73.49
Xerath,Jinx,890,435,455,48.88
Xerath,Seraphine,426,202,224,47.42
Xerath,Yone,663,361,302,54.45
Xerath,Udyr,118,58,60,49.15
Xerath,Tristana,338,95,243,28.11
Xerath,Lulu,305,126,179,41.31
Xerath,Zac,150,78,72,52
Xerath,Swain,362,185,177,51.1
Xerath,Briar,457,217,240,47.48
Xerath,Poppy,255,166,89,65.1
Xerath,Ekko,363,152,211,41.87
Xerath,Kaisa,418,230,188,55.02
Xerath,Rell,198,107,91,54.04
Xerath,Gragas,264,146,118,55.3
Xerath,Xayah,267,148,119,55.43
Xerath,Fiora,222,112,110,50.45
Xerath,Sylas,402,202,200,50.25
Xerath,Nautilus,418,266,152,63.64
Xerath,Riven,150,80,70,53.33
Xerath,Bard,152,68,84,44.74
Xerath,Karthus,57,29,28,50.88
Xerath,KSante,175,78,97,44.57
Xerath,TahmKench,402,207,195,51.49
Xerath,Sion,341,205,136,60.12
Xerath,Garen,544,267,277,49.08
Xerath,Teemo,587,213,374,36.29
Xerath,Katarina,402,198,204,49.25
Xerath,Nilah,272,143,129,52.57
Xerath,Fizz,250,116,134,46.4
Xerath,Gangplank,213,107,106,50.23
Xerath,Kled,62,36,26,58.06
Xerath,Lillia,276,145,131,52.54
Xerath,Ahri,544,271,273,49.82
Xerath,MissFortune,966,547,419,56.63
Xerath,Neeko,284,159,125,55.99
Xerath,Graves,235,130,105,55.32
Xerath,Vayne,443,220,223,49.66
Xerath,Jax,294,169,125,57.48
Xerath,Amumu,429,181,248,42.19
Xerath,Heimerdinger,200,106,94,53
Xerath,Volibear,564,296,268,52.48
Xerath,Morgana,680,358,322,52.65
Xerath,Brand,367,212,155,57.77
Xerath,Blitzcrank,291,149,142,51.2
Xerath,Yorick,408,204,204,50
Xerath,Kassadin,52,28,24,53.85
Xerath,Mel,1130,631,499,55.84
Xerath,Galio,243,105,138,43.21
Xerath,Zoe,197,116,81,58.88
Xerath,Darius,739,414,325,56.02
Xerath,FiddleSticks,136,81,55,59.56
Xerath,Senna,382,209,173,54.71
Xerath,Illaoi,233,122,111,52.36
Xerath,Sona,168,96,72,57.14
Xerath,Irelia,352,213,139,60.51
Xerath,Orianna,272,172,100,63.24
Xerath,Syndra,255,143,112,56.08
Xerath,Samira,388,187,201,48.2
Xerath,Yuumi,360,160,200,44.44
Xerath,DrMundo,276,126,150,45.65
Xerath,Viktor,263,158,105,60.08
Xerath,Leona,276,126,150,45.65
Xerath,Sett,787,381,406,48.41
Xerath,Renekton,198,95,103,47.98
Xerath,Pantheon,628,310,318,49.36
Xerath,Viego,528,250,278,47.35
Xerath,Akali,446,239,207,53.59
Xerath,Kennen,147,78,69,53.06
Xerath,Kalista,204,106,98,51.96
Xerath,Janna,110,57,53,51.82
Xerath,Akshan,125,46,79,36.8
Xerath,Ziggs,177,86,91,48.59
Xerath,Sejuani,135,30,105,22.22
Xerath,Malphite,288,164,124,56.94
Xerath,Vex,285,149,136,52.28
Xerath,Gnar,137,98,39,71.53
Xerath,Qiyana,121,70,51,57.85
Xerath,Zilean,100,46,54,46
Xerath,XinZhao,238,126,112,52.94
Xerath,Aphelios,248,139,109,56.05
Xerath,Camille,159,84,75,52.83
Xerath,Naafiri,155,84,71,54.19
Xerath,Zed,369,212,157,57.45
Xerath,Braum,195,104,91,53.33
Xerath,Zyra,300,150,150,50
Xerath,AurelionSol,159,60,99,37.74
Xerath,Annie,140,78,62,55.71
Xerath,Aurora,336,205,131,61.01
Xerath,Taliyah,109,58,51,53.21
Xerath,Shen,303,160,143,52.81
Xerath,Ryze,102,42,60,41.18
Xerath,Urgot,188,70,118,37.23
Xerath,Rammus,105,41,64,39.05
Xerath,Lucian,215,118,97,54.88
Xerath,Nami,400,190,210,47.5
Xerath,Nunu,301,177,124,58.8
Xerath,Kayle,331,175,156,52.87
Xerath,MonkeyKing,136,59,77,43.38
Xerath,Veigar,584,279,305,47.77
Xerath,Corki,107,74,33,69.16
Xerath,Hecarim,184,107,77,58.15
Xerath,Smolder,354,199,155,56.21
Xerath,Renata,103,62,41,60.19
Xerath,Evelynn,187,94,93,50.27
Xerath,Shyvana,127,68,59,53.54
Xerath,JarvanIV,127,69,58,54.33
Xerath,KogMaw,107,58,49,54.21
Xerath,Maokai,167,77,90,46.11
Xerath,Trundle,190,99,91,52.11
Xerath,Olaf,82,53,29,64.63
Xerath,Vladimir,151,69,82,45.7
Xerath,Nocturne,363,166,197,45.73
Xerath,Khazix,208,125,83,60.1
Xerath,Elise,254,167,87,65.75
Xerath,Draven,243,141,102,58.02
Xerath,Ambessa,210,126,84,60
Xerath,Chogath,473,233,240,49.26
Xerath,Lissandra,73,19,54,26.03
Xerath,Nidalee,128,73,55,57.03
Xerath,Skarner,132,47,85,35.61
Xerath,Taric,100,62,38,62
Xerath,Rumble,156,91,65,58.33
Xerath,Leblanc,112,83,29,74.11
Xerath,Jayce,176,88,88,50
Xerath,TwistedFate,149,120,29,80.54
Xerath,Quinn,131,79,52,60.31
Xerath,Belveth,109,50,59,45.87
Xerath,Anivia,149,69,80,46.31
Xerath,RekSai,28,16,12,57.14
Karthus,Fiora,57,16,41,28.07
Karthus,FiddleSticks,104,46,58,44.23
Karthus,Syndra,96,27,69,28.13
Karthus,Vayne,143,63,80,44.06
Karthus,Morgana,222,96,126,43.24
Karthus,Illaoi,48,32,16,66.67
Karthus,Warwick,258,108,150,41.86
Karthus,Aurora,154,80,74,51.95
Karthus,Ezreal,251,129,122,51.39
Karthus,Neeko,101,52,49,51.49
Karthus,Kled,44,13,31,29.55
Karthus,Ambessa,68,29,39,42.65
Karthus,Diana,263,141,122,53.61
Karthus,Nilah,90,54,36,60
Karthus,Leona,83,58,25,69.88
Karthus,Gnar,98,35,63,35.71
Karthus,Kayn,284,106,178,37.32
Karthus,Katarina,94,51,43,54.26
Karthus,Ashe,302,162,140,53.64
Karthus,Thresh,222,101,121,45.5
Karthus,Yorick,136,43,93,31.62
Karthus,Mordekaiser,214,103,111,48.13
Karthus,Ahri,244,131,113,53.69
Karthus,Jinx,364,171,193,46.98
Karthus,Amumu,168,67,101,39.88
Karthus,Shaco,254,115,139,45.28
Karthus,MissFortune,328,157,171,47.87
Karthus,Lux,431,206,225,47.8
Karthus,Irelia,147,76,71,51.7
Karthus,MonkeyKing,69,34,35,49.28
Karthus,Vex,114,49,65,42.98
Karthus,Caitlyn,303,126,177,41.58
Karthus,Rell,89,37,52,41.57
Karthus,Nasus,95,33,62,34.74
Karthus,Xerath,57,28,29,49.12
Karthus,Aatrox,152,88,64,57.89
Karthus,Yone,294,116,178,39.46
Karthus,Samira,127,42,85,33.07
Karthus,Karma,90,23,67,25.56
Karthus,Nocturne,133,72,61,54.14
Karthus,Ryze,37,13,24,35.14
Karthus,Blitzcrank,108,64,44,59.26
Karthus,Urgot,48,8,40,16.67
Karthus,Ivern,33,15,18,45.45
Karthus,Kassadin,27,6,21,22.22
Karthus,Senna,131,72,59,54.96
Karthus,DrMundo,119,36,83,30.25
Karthus,TwistedFate,63,53,10,84.13
Karthus,Yasuo,303,163,140,53.8
Karthus,Rammus,60,34,26,56.67
Karthus,Vladimir,67,27,40,40.3
Karthus,Braum,67,38,29,56.72
Karthus,Sett,280,134,146,47.86
Karthus,Darius,342,172,170,50.29
Karthus,Ekko,72,35,37,48.61
Karthus,Swain,174,72,102,41.38
Karthus,Orianna,39,20,19,51.28
Karthus,Aphelios,148,56,92,37.84
Karthus,Brand,115,50,65,43.48
Karthus,Kaisa,288,164,124,56.94
Karthus,Gragas,131,41,90,31.3
Karthus,Talon,74,48,26,64.86
Karthus,Jhin,236,107,129,45.34
Karthus,Tristana,183,79,104,43.17
Karthus,Rengar,77,32,45,41.56
Karthus,Briar,126,46,80,36.51
Karthus,Mel,373,200,173,53.62
Karthus,Teemo,218,111,107,50.92
Karthus,Leblanc,90,47,43,52.22
Karthus,Bard,34,15,19,44.12
Karthus,LeeSin,151,62,89,41.06
Karthus,Renekton,34,19,15,55.88
Karthus,Nautilus,178,116,62,65.17
Karthus,Gwen,104,52,52,50
Karthus,MasterYi,173,110,63,63.58
Karthus,Elise,94,45,49,47.87
Karthus,Jax,103,29,74,28.16
Karthus,Viktor,105,29,76,27.62
Karthus,Zyra,140,40,100,28.57
Karthus,Hwei,139,68,71,48.92
Karthus,Viego,182,91,91,50
Karthus,Malzahar,126,37,89,29.37
Karthus,Lucian,57,32,25,56.14
Karthus,Veigar,161,86,75,53.42
Karthus,Soraka,121,42,79,34.71
Karthus,Ziggs,44,22,22,50
Karthus,Nunu,120,49,71,40.83
Karthus,Sona,73,34,39,46.58
Karthus,Varus,154,101,53,65.58
Karthus,Singed,45,17,28,37.78
Karthus,Garen,268,120,148,44.78
Karthus,Shen,95,53,42,55.79
Karthus,TahmKench,163,70,93,42.94
Karthus,Taliyah,67,26,41,38.81
Karthus,Janna,60,26,34,43.33
Karthus,Draven,51,16,35,31.37
Karthus,Pantheon,278,148,130,53.24
Karthus,Zed,125,78,47,62.4
Karthus,Smolder,134,55,79,41.04
Karthus,Riven,74,50,24,67.57
Karthus,Chogath,217,93,124,42.86
Karthus,Renata,26,8,18,30.77
Karthus,Lulu,104,46,58,44.23
Karthus,Annie,42,19,23,45.24
Karthus,Sivir,85,30,55,35.29
Karthus,Udyr,58,37,21,63.79
Karthus,Tryndamere,83,48,35,57.83
Karthus,Seraphine,163,59,104,36.2
Karthus,Trundle,74,16,58,21.62
Karthus,AurelionSol,86,54,32,62.79
Karthus,Qiyana,64,30,34,46.88
Karthus,Yuumi,186,89,97,47.85
Karthus,Lillia,71,43,28,60.56
Karthus,Sion,114,36,78,31.58
Karthus,Jayce,52,15,37,28.85
Karthus,RekSai,32,15,17,46.88
Karthus,Cassiopeia,72,41,31,56.94
Karthus,Kalista,71,29,42,40.85
Karthus,Corki,23,20,3,86.96
Karthus,Nami,97,26,71,26.8
Karthus,Heimerdinger,76,64,12,84.21
Karthus,Xayah,130,70,60,53.85
Karthus,Malphite,115,39,76,33.91
Karthus,Volibear,162,73,89,45.06
Karthus,Galio,100,31,69,31
Karthus,Kayle,124,43,81,34.68
Karthus,Fizz,66,57,9,86.36
Karthus,Khazix,101,41,60,40.59
Karthus,Zoe,83,48,35,57.83
Karthus,XinZhao,65,28,37,43.08
Karthus,Twitch,108,42,66,38.89
Karthus,Naafiri,80,38,42,47.5
Karthus,Olaf,18,6,12,33.33
Karthus,JarvanIV,53,31,22,58.49
Karthus,Akali,178,92,86,51.69
Karthus,Kindred,92,53,39,57.61
Karthus,Akshan,52,31,21,59.62
Karthus,KogMaw,30,3,27,10
Karthus,Pyke,158,87,71,55.06
Karthus,Camille,44,32,12,72.73
Karthus,Graves,127,67,60,52.76
Karthus,Zilean,77,33,44,42.86
Karthus,Azir,41,17,24,41.46
Karthus,Hecarim,61,21,40,34.43
Karthus,Evelynn,95,56,39,58.95
Karthus,Milio,81,36,45,44.44
Karthus,Taric,35,22,13,62.86
Karthus,Rakan,107,33,74,30.84
Karthus,Sylas,149,59,90,39.6
Karthus,Zac,72,25,47,34.72
Karthus,Maokai,74,36,38,48.65
Karthus,Nidalee,63,34,29,53.97
Karthus,Kennen,58,14,44,24.14
Karthus,Velkoz,85,21,64,24.71
Karthus,Poppy,61,24,37,39.34
Karthus,KSante,65,26,39,40
Karthus,Zeri,87,34,53,39.08
Karthus,Gangplank,69,34,35,49.28
Karthus,Belveth,44,25,19,56.82
Karthus,Anivia,59,32,27,54.24
Karthus,Quinn,63,30,33,47.62
Karthus,Sejuani,70,27,43,38.57
Karthus,Ornn,45,30,15,66.67
Karthus,Vi,65,34,31,52.31
Karthus,Alistar,50,30,20,60
Karthus,Shyvana,57,21,36,36.84
Karthus,Rumble,21,15,6,71.43
Karthus,Lissandra,15,6,9,40
Karthus,Skarner,21,13,8,61.9
Anivia,Ambessa,129,30,99,23.26
Anivia,Xayah,99,39,60,39.39
Anivia,AurelionSol,100,45,55,45
Anivia,Khazix,115,50,65,43.48
Anivia,Nautilus,226,123,103,54.42
Anivia,Malphite,146,97,49,66.44
Anivia,Rengar,67,40,27,59.7
Anivia,Akali,198,116,82,58.59
Anivia,Ashe,361,184,177,50.97
Anivia,Rakan,112,35,77,31.25
Anivia,Teemo,243,159,84,65.43
Anivia,Gragas,131,68,63,51.91
Anivia,Qiyana,34,21,13,61.76
Anivia,Caitlyn,467,238,229,50.96
Anivia,Soraka,159,89,70,55.97
Anivia,Yasuo,385,182,203,47.27
Anivia,Belveth,53,13,40,24.53
Anivia,Yone,324,157,167,48.46
Anivia,Mordekaiser,295,151,144,51.19
Anivia,Alistar,75,43,32,57.33
Anivia,Sylas,198,105,93,53.03
Anivia,FiddleSticks,103,32,71,31.07
Anivia,Leblanc,100,39,61,39
Anivia,Aphelios,86,39,47,45.35
Anivia,Morgana,279,178,101,63.8
Anivia,Nasus,118,53,65,44.92
Anivia,Zed,158,63,95,39.87
Anivia,Malzahar,155,54,101,34.84
Anivia,Ezreal,314,148,166,47.13
Anivia,Mel,368,201,167,54.62
Anivia,Garen,281,133,148,47.33
Anivia,LeeSin,198,105,93,53.03
Anivia,Aurora,160,73,87,45.63
Anivia,MissFortune,414,207,207,50
Anivia,Rell,101,71,30,70.3
Anivia,Heimerdinger,96,55,41,57.29
Anivia,Vi,141,55,86,39.01
Anivia,Vladimir,111,49,62,44.14
Anivia,Riven,125,70,55,56
Anivia,Katarina,157,89,68,56.69
Anivia,Kaisa,321,137,184,42.68
Anivia,Kayle,199,107,92,53.77
Anivia,Trundle,115,54,61,46.96
Anivia,Senna,163,78,85,47.85
Anivia,Sett,405,205,200,50.62
Anivia,Warwick,319,173,146,54.23
Anivia,Smolder,156,86,70,55.13
Anivia,Seraphine,264,131,133,49.62
Anivia,Pantheon,312,177,135,56.73
Anivia,Shaco,177,80,97,45.2
Anivia,Jhin,347,201,146,57.93
Anivia,Ahri,305,137,168,44.92
Anivia,Pyke,263,121,142,46.01
Anivia,Nunu,121,54,67,44.63
Anivia,Thresh,254,107,147,42.13
Anivia,Syndra,144,65,79,45.14
Anivia,Tristana,213,99,114,46.48
Anivia,Zyra,142,69,73,48.59
Anivia,Evelynn,108,51,57,47.22
Anivia,Talon,112,51,61,45.54
Anivia,Irelia,135,61,74,45.19
Anivia,Yuumi,146,76,70,52.05
Anivia,Zac,57,22,35,38.6
Anivia,Viego,266,127,139,47.74
Anivia,Milio,108,55,53,50.93
Anivia,Hwei,111,36,75,32.43
Anivia,Volibear,265,146,119,55.09
Anivia,Naafiri,74,32,42,43.24
Anivia,XinZhao,97,49,48,50.52
Anivia,Veigar,216,123,93,56.94
Anivia,Draven,89,33,56,37.08
Anivia,Karma,170,86,84,50.59
Anivia,Orianna,89,32,57,35.96
Anivia,Lux,457,211,246,46.17
Anivia,Shyvana,90,34,56,37.78
Anivia,Leona,141,83,58,58.87
Anivia,Kennen,69,41,28,59.42
Anivia,Ekko,93,43,50,46.24
Anivia,Varus,153,80,73,52.29
Anivia,Camille,77,34,43,44.16
Anivia,Jinx,316,143,173,45.25
Anivia,Urgot,127,58,69,45.67
Anivia,Lucian,97,39,58,40.21
Anivia,Ornn,80,41,39,51.25
Anivia,Kayn,292,131,161,44.86
Anivia,Akshan,120,60,60,50
Anivia,Aatrox,213,102,111,47.89
Anivia,Lillia,90,65,25,72.22
Anivia,Galio,140,56,84,40
Anivia,Chogath,239,144,95,60.25
Anivia,Yorick,193,91,102,47.15
Anivia,Jax,169,79,90,46.75
Anivia,Janna,62,30,32,48.39
Anivia,TahmKench,164,85,79,51.83
Anivia,Brand,122,71,51,58.2
Anivia,Darius,298,159,139,53.36
Anivia,Samira,196,93,103,47.45
Anivia,Briar,212,100,112,47.17
Anivia,Cassiopeia,105,33,72,31.43
Anivia,Shen,117,46,71,39.32
Anivia,Tryndamere,102,35,67,34.31
Anivia,Diana,235,95,140,40.43
Anivia,Kled,19,7,12,36.84
Anivia,Zoe,79,45,34,56.96
Anivia,Fizz,133,47,86,35.34
Anivia,Illaoi,63,40,23,63.49
Anivia,MonkeyKing,119,76,43,63.87
Anivia,Gwen,131,84,47,64.12
Anivia,Velkoz,138,58,80,42.03
Anivia,Poppy,165,66,99,40
Anivia,Neeko,124,75,49,60.48
Anivia,Graves,103,72,31,69.9
Anivia,KSante,72,24,48,33.33
Anivia,Quinn,47,23,24,48.94
Anivia,Sion,214,96,118,44.86
Anivia,Swain,234,125,109,53.42
Anivia,Kindred,131,46,85,35.11
Anivia,Viktor,159,103,56,64.78
Anivia,Amumu,188,81,107,43.09
Anivia,Nami,188,81,107,43.09
Anivia,Nilah,84,35,49,41.67
Anivia,Nocturne,155,68,87,43.87
Anivia,Lissandra,63,38,25,60.32
Anivia,Vex,133,60,73,45.11
Anivia,Bard,69,21,48,30.43
Anivia,Azir,74,27,47,36.49
Anivia,Sona,67,24,43,35.82
Anivia,MasterYi,212,104,108,49.06
Anivia,Gangplank,102,52,50,50.98
Anivia,Skarner,60,29,31,48.33
Anivia,Vayne,211,122,89,57.82
Anivia,Sivir,125,45,80,36
Anivia,Braum,95,38,57,40
Anivia,Twitch,117,49,68,41.88
Anivia,Kalista,77,42,35,54.55
Anivia,Fiora,57,32,25,56.14
Anivia,Annie,56,39,17,69.64
Anivia,Zilean,24,6,18,25
Anivia,Sejuani,62,34,28,54.84
Anivia,TwistedFate,54,18,36,33.33
Anivia,Taric,51,39,12,76.47
Anivia,DrMundo,126,61,65,48.41
Anivia,Rammus,39,16,23,41.03
Anivia,Blitzcrank,110,42,68,38.18
Anivia,Hecarim,42,9,33,21.43
Anivia,Udyr,80,45,35,56.25
Anivia,Lulu,120,62,58,51.67
Anivia,JarvanIV,91,49,42,53.85
Anivia,Singed,46,26,20,56.52
Anivia,KogMaw,75,33,42,44
Anivia,Zeri,87,50,37,57.47
Anivia,Karthus,59,27,32,45.76
Anivia,Ryze,65,23,42,35.38
Anivia,Xerath,149,80,69,53.69
Anivia,Ziggs,74,30,44,40.54
Anivia,Jayce,104,55,49,52.88
Anivia,Rumble,47,16,31,34.04
Anivia,Gnar,115,65,50,56.52
Anivia,Elise,106,67,39,63.21
Anivia,Renekton,82,33,49,40.24
Anivia,Kassadin,70,32,38,45.71
Anivia,Maokai,71,46,25,64.79
Anivia,Corki,51,32,19,62.75
Anivia,Nidalee,46,37,9,80.43
Anivia,Olaf,30,20,10,66.67
Anivia,Taliyah,48,23,25,47.92
Anivia,Ivern,39,8,31,20.51
Anivia,RekSai,29,19,10,65.52
Anivia,Renata,30,16,14,53.33
KSante,Mordekaiser,471,194,277,41.19
KSante,Vi,230,116,114,50.43
KSante,Azir,70,23,47,32.86
KSante,MissFortune,388,180,208,46.39
KSante,Nautilus,237,117,120,49.37
KSante,Volibear,296,118,178,39.86
KSante,LeeSin,329,136,193,41.34
KSante,Kayle,174,69,105,39.66
KSante,Ezreal,472,228,244,48.31
KSante,Morgana,293,143,150,48.81
KSante,Sett,399,161,238,40.35
KSante,Ambessa,192,87,105,45.31
KSante,Smolder,191,110,81,57.59
KSante,Swain,258,157,101,60.85
KSante,Malphite,200,102,98,51
KSante,FiddleSticks,93,32,61,34.41
KSante,Mel,560,268,292,47.86
KSante,Soraka,143,65,78,45.45
KSante,Heimerdinger,111,36,75,32.43
KSante,Warwick,293,141,152,48.12
KSante,Ashe,413,210,203,50.85
KSante,Pyke,257,128,129,49.81
KSante,Sion,190,67,123,35.26
KSante,MasterYi,196,90,106,45.92
KSante,AurelionSol,91,44,47,48.35
KSante,Nami,220,105,115,47.73
KSante,Shyvana,74,39,35,52.7
KSante,Fizz,109,45,64,41.28
KSante,Nilah,99,37,62,37.37
KSante,Naafiri,89,35,54,39.33
KSante,Lux,620,281,339,45.32
KSante,Aatrox,276,97,179,35.14
KSante,Briar,175,85,90,48.57
KSante,Elise,189,101,88,53.44
KSante,Chogath,282,121,161,42.91
KSante,Poppy,179,80,99,44.69
KSante,Irelia,246,110,136,44.72
KSante,Jhin,369,135,234,36.59
KSante,Leona,148,80,68,54.05
KSante,Aurora,204,84,120,41.18
KSante,Nocturne,203,101,102,49.75
KSante,Leblanc,147,89,58,60.54
KSante,Janna,92,33,59,35.87
KSante,Akali,288,108,180,37.5
KSante,Evelynn,113,45,68,39.82
KSante,Ahri,369,164,205,44.44
KSante,Velkoz,122,44,78,36.07
KSante,Tristana,201,91,110,45.27
KSante,Vayne,276,110,166,39.86
KSante,Zoe,81,45,36,55.56
KSante,Seraphine,291,118,173,40.55
KSante,Fiora,155,59,96,38.06
KSante,Shaco,317,150,167,47.32
KSante,Nunu,164,96,68,58.54
KSante,Pantheon,377,202,175,53.58
KSante,Yorick,163,61,102,37.42
KSante,Quinn,74,47,27,63.51
KSante,TahmKench,240,96,144,40
KSante,Gwen,182,99,83,54.4
KSante,Khazix,161,75,86,46.58
KSante,Katarina,238,100,138,42.02
KSante,Aphelios,213,82,131,38.5
KSante,Alistar,80,42,38,52.5
KSante,Garen,471,193,278,40.98
KSante,Diana,293,159,134,54.27
KSante,Ryze,80,28,52,35
KSante,Darius,535,220,315,41.12
KSante,Qiyana,52,22,30,42.31
KSante,Ziggs,93,43,50,46.24
KSante,JarvanIV,91,43,48,47.25
KSante,Ekko,177,88,89,49.72
KSante,Jinx,501,220,281,43.91
KSante,Hecarim,114,42,72,36.84
KSante,Vex,96,37,59,38.54
KSante,Veigar,232,73,159,31.47
KSante,Amumu,193,66,127,34.2
KSante,Samira,238,103,135,43.28
KSante,Kayn,367,172,195,46.87
KSante,Nasus,136,52,84,38.24
KSante,Xerath,175,97,78,55.43
KSante,Thresh,354,158,196,44.63
KSante,Vladimir,151,75,76,49.67
KSante,Caitlyn,600,273,327,45.5
KSante,Yone,420,185,235,44.05
KSante,Lillia,120,47,73,39.17
KSante,Draven,154,86,68,55.84
KSante,Blitzcrank,194,76,118,39.18
KSante,Renekton,96,61,35,63.54
KSante,Lucian,154,85,69,55.19
KSante,Viego,245,102,143,41.63
KSante,Viktor,163,70,93,42.94
KSante,Ornn,160,88,72,55
KSante,Sylas,269,175,94,65.06
KSante,Shen,181,82,99,45.3
KSante,Zed,229,115,114,50.22
KSante,Brand,141,41,100,29.08
KSante,Kaisa,313,154,159,49.2
KSante,Riven,94,58,36,61.7
KSante,Rengar,165,107,58,64.85
KSante,Syndra,152,50,102,32.89
KSante,Twitch,148,58,90,39.19
KSante,Kled,48,9,39,18.75
KSante,Gragas,175,106,69,60.57
KSante,Teemo,247,85,162,34.41
KSante,Orianna,64,19,45,29.69
KSante,Rell,146,76,70,52.05
KSante,Singed,56,24,32,42.86
KSante,DrMundo,133,61,72,45.86
KSante,Yasuo,462,238,224,51.52
KSante,Xayah,172,99,73,57.56
KSante,Trundle,141,41,100,29.08
KSante,Malzahar,177,69,108,38.98
KSante,Varus,226,126,100,55.75
KSante,Sona,76,19,57,25
KSante,Jax,109,58,51,53.21
KSante,Milio,143,65,78,45.45
KSante,Kassadin,67,30,37,44.78
KSante,Zyra,176,58,118,32.95
KSante,Camille,79,54,25,68.35
KSante,KogMaw,87,19,68,21.84
KSante,Yuumi,179,72,107,40.22
KSante,Senna,174,58,116,33.33
KSante,Gnar,90,33,57,36.67
KSante,Akshan,88,41,47,46.59
KSante,Urgot,79,42,37,53.16
KSante,Zac,119,42,77,35.29
KSante,Tryndamere,115,70,45,60.87
KSante,Karma,160,46,114,28.75
KSante,Rakan,110,79,31,71.82
KSante,Gangplank,94,47,47,50
KSante,Corki,65,30,35,46.15
KSante,Sejuani,81,42,39,51.85
KSante,Nidalee,55,34,21,61.82
KSante,Illaoi,60,23,37,38.33
KSante,Udyr,117,60,57,51.28
KSante,Taric,45,12,33,26.67
KSante,MonkeyKing,122,62,60,50.82
KSante,Braum,88,38,50,43.18
KSante,Galio,180,84,96,46.67
KSante,Ivern,64,16,48,25
KSante,Hwei,179,68,111,37.99
KSante,Renata,58,29,29,50
KSante,Cassiopeia,81,51,30,62.96
KSante,Kalista,123,61,62,49.59
KSante,Annie,59,20,39,33.9
KSante,Zeri,130,50,80,38.46
KSante,RekSai,59,31,28,52.54
KSante,Taliyah,66,38,28,57.58
KSante,Graves,172,87,85,50.58
KSante,Belveth,73,25,48,34.25
KSante,Anivia,72,48,24,66.67
KSante,XinZhao,166,71,95,42.77
KSante,Jayce,111,56,55,50.45
KSante,Maokai,139,54,85,38.85
KSante,Lulu,254,110,144,43.31
KSante,Kindred,132,60,72,45.45
KSante,TwistedFate,83,34,49,40.96
KSante,Neeko,125,65,60,52
KSante,Skarner,88,45,43,51.14
KSante,Rumble,61,32,29,52.46
KSante,Kennen,80,36,44,45
KSante,Zilean,70,19,51,27.14
KSante,Sivir,94,34,60,36.17
KSante,Bard,95,27,68,28.42
KSante,Rammus,70,23,47,32.86
KSante,Talon,139,47,92,33.81
KSante,Karthus,65,39,26,60
KSante,Lissandra,38,15,23,39.47
KSante,Olaf,29,10,19,34.48
Tryndamere,Mordekaiser,533,266,267,49.91
Tryndamere,Briar,326,160,166,49.08
Tryndamere,Zed,318,198,120,62.26
Tryndamere,Jinx,685,319,366,46.57
Tryndamere,Lulu,270,165,105,61.11
Tryndamere,Nasus,294,137,157,46.6
Tryndamere,MonkeyKing,173,84,89,48.55
Tryndamere,Zoe,162,98,64,60.49
Tryndamere,Xayah,229,109,120,47.6
Tryndamere,Zac,117,72,45,61.54
Tryndamere,Jayce,106,60,46,56.6
Tryndamere,Rengar,179,90,89,50.28
Tryndamere,Swain,378,149,229,39.42
Tryndamere,Ezreal,510,240,270,47.06
Tryndamere,Sona,182,46,136,25.27
Tryndamere,Teemo,487,216,271,44.35
Tryndamere,LeeSin,357,200,157,56.02
Tryndamere,Chogath,406,195,211,48.03
Tryndamere,Lucian,186,116,70,62.37
Tryndamere,Xerath,259,185,74,71.43
Tryndamere,Aatrox,311,142,169,45.66
Tryndamere,Twitch,296,165,131,55.74
Tryndamere,Veigar,419,224,195,53.46
Tryndamere,Milio,178,72,106,40.45
Tryndamere,Darius,744,364,380,48.92
Tryndamere,Aurora,371,214,157,57.68
Tryndamere,Brand,279,136,143,48.75
Tryndamere,Thresh,505,277,228,54.85
Tryndamere,FiddleSticks,179,87,92,48.6
Tryndamere,Viktor,206,101,105,49.03
Tryndamere,Pyke,410,213,197,51.95
Tryndamere,Gnar,160,84,76,52.5
Tryndamere,Jax,323,163,160,50.46
Tryndamere,Bard,143,62,81,43.36
Tryndamere,Yone,716,367,349,51.26
Tryndamere,Kayn,621,319,302,51.37
Tryndamere,Smolder,263,125,138,47.53
Tryndamere,Poppy,199,91,108,45.73
Tryndamere,Volibear,408,192,216,47.06
Tryndamere,Ivern,40,18,22,45
Tryndamere,Irelia,302,174,128,57.62
Tryndamere,Caitlyn,831,404,427,48.62
Tryndamere,Renekton,166,81,85,48.8
Tryndamere,Lillia,263,111,152,42.21
Tryndamere,Annie,127,57,70,44.88
Tryndamere,Kaisa,399,238,161,59.65
Tryndamere,Singed,92,36,56,39.13
Tryndamere,Garen,702,376,326,53.56
Tryndamere,KogMaw,125,64,61,51.2
Tryndamere,Lux,951,460,491,48.37
Tryndamere,RekSai,54,24,30,44.44
Tryndamere,Leona,228,98,130,42.98
Tryndamere,Akshan,123,57,66,46.34
Tryndamere,Aphelios,244,109,135,44.67
Tryndamere,Braum,198,97,101,48.99
Tryndamere,Warwick,639,282,357,44.13
Tryndamere,Yasuo,759,378,381,49.8
Tryndamere,Zilean,103,58,45,56.31
Tryndamere,Malphite,404,184,220,45.54
Tryndamere,Samira,321,189,132,58.88
Tryndamere,Blitzcrank,247,104,143,42.11
Tryndamere,Ekko,222,109,113,49.1
Tryndamere,Zeri,161,85,76,52.8
Tryndamere,Heimerdinger,219,83,136,37.9
Tryndamere,Udyr,156,78,78,50
Tryndamere,Akali,349,146,203,41.83
Tryndamere,MissFortune,836,373,463,44.62
Tryndamere,Gragas,224,115,109,51.34
Tryndamere,Fiora,182,131,51,71.98
Tryndamere,Shaco,394,181,213,45.94
Tryndamere,Ahri,494,245,249,49.6
Tryndamere,Nami,286,147,139,51.4
Tryndamere,Jhin,689,344,345,49.93
Tryndamere,Urgot,168,73,95,43.45
Tryndamere,Gwen,222,101,121,45.5
Tryndamere,JarvanIV,139,58,81,41.73
Tryndamere,Hwei,328,127,201,38.72
Tryndamere,Rammus,86,33,53,38.37
Tryndamere,Seraphine,369,188,181,50.95
Tryndamere,Velkoz,254,119,135,46.85
Tryndamere,Vladimir,171,92,79,53.8
Tryndamere,Zyra,262,126,136,48.09
Tryndamere,Corki,134,70,64,52.24
Tryndamere,Ziggs,166,80,86,48.19
Tryndamere,Camille,174,97,77,55.75
Tryndamere,Varus,241,108,133,44.81
Tryndamere,Yorick,387,156,231,40.31
Tryndamere,Nunu,321,117,204,36.45
Tryndamere,Nidalee,89,51,38,57.3
Tryndamere,MasterYi,343,168,175,48.98
Tryndamere,Kassadin,90,39,51,43.33
Tryndamere,Tristana,370,192,178,51.89
Tryndamere,Trundle,249,132,117,53.01
Tryndamere,Rell,184,69,115,37.5
Tryndamere,Malzahar,290,97,193,33.45
Tryndamere,Morgana,511,232,279,45.4
Tryndamere,Graves,134,75,59,55.97
Tryndamere,Cassiopeia,151,83,68,54.97
Tryndamere,Ashe,676,352,324,52.07
Tryndamere,Karma,225,99,126,44
Tryndamere,Sett,547,254,293,46.44
Tryndamere,Nocturne,271,97,174,35.79
Tryndamere,Amumu,302,152,150,50.33
Tryndamere,Ryze,175,88,87,50.29
Tryndamere,Senna,305,149,156,48.85
Tryndamere,Mel,720,378,342,52.5
Tryndamere,Vi,301,154,147,51.16
Tryndamere,Shen,213,92,121,43.19
Tryndamere,Leblanc,139,77,62,55.4
Tryndamere,TahmKench,344,144,200,41.86
Tryndamere,Vayne,338,179,159,52.96
Tryndamere,Diana,510,246,264,48.24
Tryndamere,Qiyana,113,64,49,56.64
Tryndamere,Kindred,194,123,71,63.4
Tryndamere,Ambessa,288,114,174,39.58
Tryndamere,Vex,221,103,118,46.61
Tryndamere,Nautilus,406,180,226,44.33
Tryndamere,Gangplank,138,51,87,36.96
Tryndamere,Riven,157,85,72,54.14
Tryndamere,Katarina,209,89,120,42.58
Tryndamere,Orianna,161,82,79,50.93
Tryndamere,Skarner,109,59,50,54.13
Tryndamere,Sylas,320,181,139,56.56
Tryndamere,Janna,87,56,31,64.37
Tryndamere,KSante,115,45,70,39.13
Tryndamere,Yuumi,332,175,157,52.71
Tryndamere,Sejuani,136,71,65,52.21
Tryndamere,Galio,233,89,144,38.2
Tryndamere,Soraka,215,94,121,43.72
Tryndamere,Karthus,83,35,48,42.17
Tryndamere,Pantheon,647,311,336,48.07
Tryndamere,Olaf,79,28,51,35.44
Tryndamere,Kayle,249,148,101,59.44
Tryndamere,Draven,186,125,61,67.2
Tryndamere,Fizz,234,152,82,64.96
Tryndamere,Viego,512,272,240,53.13
Tryndamere,Maokai,124,66,58,53.23
Tryndamere,Anivia,102,67,35,65.69
Tryndamere,Elise,201,99,102,49.25
Tryndamere,Naafiri,196,88,108,44.9
Tryndamere,Sion,346,143,203,41.33
Tryndamere,Nilah,310,107,203,34.52
Tryndamere,Hecarim,145,64,81,44.14
Tryndamere,Sivir,174,74,100,42.53
Tryndamere,Lissandra,69,23,46,33.33
Tryndamere,Neeko,267,162,105,60.67
Tryndamere,Taric,72,25,47,34.72
Tryndamere,Azir,122,43,79,35.25
Tryndamere,Talon,251,103,148,41.04
Tryndamere,Belveth,104,60,44,57.69
Tryndamere,DrMundo,203,82,121,40.39
Tryndamere,XinZhao,158,79,79,50
Tryndamere,Syndra,194,90,104,46.39
Tryndamere,TwistedFate,117,62,55,52.99
Tryndamere,Evelynn,177,107,70,60.45
Tryndamere,Quinn,171,109,62,63.74
Tryndamere,Alistar,78,56,22,71.79
Tryndamere,Kled,79,34,45,43.04
Tryndamere,Taliyah,113,62,51,54.87
Tryndamere,Rakan,213,135,78,63.38
Tryndamere,Ornn,177,88,89,49.72
Tryndamere,Illaoi,183,108,75,59.02
Tryndamere,Kennen,106,63,43,59.43
Tryndamere,AurelionSol,186,82,104,44.09
Tryndamere,Kalista,234,91,143,38.89
Tryndamere,Shyvana,84,28,56,33.33
Tryndamere,Rumble,31,15,16,48.39
Tryndamere,Khazix,221,103,118,46.61
Tryndamere,Renata,81,27,54,33.33
Janna,Mordekaiser,178,94,84,52.81
Janna,Briar,188,96,92,51.06
Janna,Zed,212,139,73,65.57
Janna,Jinx,397,222,175,55.92
Janna,Lillia,127,70,57,55.12
Janna,Aatrox,208,129,79,62.02
Janna,Darius,298,133,165,44.63
Janna,Aurora,213,96,117,45.07
Janna,Ezreal,319,177,142,55.49
Janna,Brand,114,63,51,55.26
Janna,Gwen,141,101,40,71.63
Janna,Nunu,141,54,87,38.3
Janna,Caitlyn,382,162,220,42.41
Janna,Vladimir,90,48,42,53.33
Janna,Lux,484,231,253,47.73
Janna,Malphite,129,90,39,69.77
Janna,MonkeyKing,100,40,60,40
Janna,Sylas,176,109,67,61.93
Janna,Swain,200,112,88,56
Janna,Senna,137,94,43,68.61
Janna,Gangplank,122,52,70,42.62
Janna,Chogath,298,148,150,49.66
Janna,Galio,133,60,73,45.11
Janna,MissFortune,363,159,204,43.8
Janna,Soraka,118,56,62,47.46
Janna,KSante,92,59,33,64.13
Janna,FiddleSticks,132,57,75,43.18
Janna,Ahri,227,120,107,52.86
Janna,Blitzcrank,168,71,97,42.26
Janna,Gragas,164,104,60,63.41
Janna,Veigar,179,79,100,44.13
Janna,Kalista,87,46,41,52.87
Janna,Zyra,129,73,56,56.59
Janna,Renekton,91,37,54,40.66
Janna,Kayn,299,171,128,57.19
Janna,Leblanc,89,57,32,64.04
Janna,Mel,392,218,174,55.61
Janna,Fiora,108,71,37,65.74
Janna,Evelynn,75,41,34,54.67
Janna,Tristana,195,122,73,62.56
Janna,Ambessa,114,73,41,64.04
Janna,Elise,206,104,102,50.49
Janna,Shen,109,32,77,29.36
Janna,Kaisa,302,165,137,54.64
Janna,MasterYi,209,112,97,53.59
Janna,Ashe,357,187,170,52.38
Janna,Kennen,91,49,42,53.85
Janna,Shaco,148,75,73,50.68
Janna,Twitch,153,72,81,47.06
Janna,Yuumi,204,119,85,58.33
Janna,Akali,208,125,83,60.1
Janna,Khazix,137,73,64,53.28
Janna,Irelia,161,64,97,39.75
Janna,Yorick,176,64,112,36.36
Janna,Vi,222,107,115,48.2
Janna,Katarina,153,72,81,47.06
Janna,Draven,78,32,46,41.03
Janna,Nautilus,236,101,135,42.8
Janna,Viego,231,99,132,42.86
Janna,Talon,149,96,53,64.43
Janna,Renata,39,20,19,51.28
Janna,Jayce,82,49,33,59.76
Janna,Neeko,144,78,66,54.17
Janna,Teemo,206,81,125,39.32
Janna,Yone,321,160,161,49.84
Janna,Corki,77,43,34,55.84
Janna,Nasus,108,51,57,47.22
Janna,Rengar,144,89,55,61.81
Janna,Yasuo,370,212,158,57.3
Janna,TahmKench,225,138,87,61.33
Janna,Warwick,283,139,144,49.12
Janna,Ekko,122,68,54,55.74
Janna,Seraphine,193,96,97,49.74
Janna,Sion,214,126,88,58.88
Janna,Xayah,127,68,59,53.54
Janna,Rakan,97,68,29,70.1
Janna,Nami,210,110,100,52.38
Janna,Jax,148,86,62,58.11
Janna,Amumu,161,102,59,63.35
Janna,LeeSin,214,122,92,57.01
Janna,Nocturne,141,79,62,56.03
Janna,Vayne,179,97,82,54.19
Janna,Milio,118,73,45,61.86
Janna,Kayle,129,57,72,44.19
Janna,Ornn,70,42,28,60
Janna,Thresh,312,165,147,52.88
Janna,Qiyana,57,29,28,50.88
Janna,Viktor,178,91,87,51.12
Janna,Xerath,110,53,57,48.18
Janna,Kindred,99,69,30,69.7
Janna,Varus,132,72,60,54.55
Janna,Morgana,237,109,128,45.99
Janna,Samira,193,86,107,44.56
Janna,Rell,163,97,66,59.51
Janna,Leona,182,49,133,26.92
Janna,Zac,90,37,53,41.11
Janna,Pyke,242,128,114,52.89
Janna,Diana,263,101,162,38.4
Janna,Tryndamere,87,31,56,35.63
Janna,Ziggs,70,38,32,54.29
Janna,JarvanIV,59,20,39,33.9
Janna,Karthus,60,34,26,56.67
Janna,Sett,248,105,143,42.34
Janna,Anivia,62,32,30,51.61
Janna,Karma,132,82,50,62.12
Janna,Garen,265,125,140,47.17
Janna,Zoe,123,78,45,63.41
Janna,Gnar,120,72,48,60
Janna,Jhin,340,201,139,59.12
Janna,Annie,49,21,28,42.86
Janna,Lucian,138,75,63,54.35
Janna,Udyr,60,42,18,70
Janna,Quinn,82,51,31,62.2
Janna,Pantheon,277,143,134,51.62
Janna,Hecarim,63,34,29,53.97
Janna,Lissandra,63,27,36,42.86
Janna,Maokai,95,35,60,36.84
Janna,DrMundo,78,23,55,29.49
Janna,Azir,56,31,25,55.36
Janna,Braum,76,37,39,48.68
Janna,Zeri,112,56,56,50
Janna,Aphelios,177,125,52,70.62
Janna,Lulu,221,127,94,57.47
Janna,Naafiri,86,43,43,50
Janna,Heimerdinger,88,35,53,39.77
Janna,Velkoz,92,42,50,45.65
Janna,Skarner,50,37,13,74
Janna,Orianna,110,52,58,47.27
Janna,Poppy,134,76,58,56.72
Janna,Fizz,96,55,41,57.29
Janna,Cassiopeia,47,26,21,55.32
Janna,Taliyah,79,63,16,79.75
Janna,Hwei,134,70,64,52.24
Janna,Smolder,130,61,69,46.92
Janna,Akshan,92,40,52,43.48
Janna,Graves,53,35,18,66.04
Janna,Zilean,73,30,43,41.1
Janna,Nidalee,30,21,9,70
Janna,Nilah,98,55,43,56.12
Janna,Bard,81,30,51,37.04
Janna,Vex,113,79,34,69.91
Janna,Belveth,57,31,26,54.39
Janna,Volibear,252,117,135,46.43
Janna,Trundle,101,58,43,57.43
Janna,RekSai,36,11,25,30.56
Janna,Ryze,117,54,63,46.15
Janna,Sejuani,43,25,18,58.14
Janna,Camille,125,53,72,42.4
Janna,Riven,93,67,26,72.04
Janna,Taric,44,7,37,15.91
Janna,TwistedFate,50,18,32,36
Janna,Malzahar,127,57,70,44.88
Janna,Kassadin,33,17,16,51.52
Janna,Sivir,114,46,68,40.35
Janna,Syndra,124,64,60,51.61
Janna,AurelionSol,67,22,45,32.84
Janna,Shyvana,47,28,19,59.57
Janna,Urgot,99,19,80,19.19
Janna,Sona,65,26,39,40
Janna,Alistar,58,24,34,41.38
Janna,Olaf,62,25,37,40.32
Janna,Rumble,48,27,21,56.25
Janna,Kled,40,34,6,85
Janna,Ivern,33,21,12,63.64
Janna,KogMaw,53,39,14,73.58
Janna,Singed,26,20,6,76.92
Janna,XinZhao,82,27,55,32.93
Janna,Illaoi,82,46,36,56.1
Janna,Rammus,49,25,24,51.02
Akshan,Darius,383,224,159,58.49
Akshan,Samira,272,174,98,63.97
Akshan,Karma,172,57,115,33.14
Akshan,Rammus,79,31,48,39.24
Akshan,Blitzcrank,179,108,71,60.34
Akshan,DrMundo,155,70,85,45.16
Akshan,Ivern,75,42,33,56
Akshan,Mordekaiser,331,187,144,56.5
Akshan,Nilah,111,39,72,35.14
Akshan,Yuumi,182,91,91,50
Akshan,Teemo,308,163,145,52.92
Akshan,Amumu,194,55,139,28.35
Akshan,Garen,392,156,236,39.8
Akshan,KogMaw,118,53,65,44.92
Akshan,Heimerdinger,195,94,101,48.21
Akshan,Vi,221,92,129,41.63
Akshan,Ahri,327,152,175,46.48
Akshan,Maokai,132,67,65,50.76
Akshan,Kennen,70,33,37,47.14
Akshan,XinZhao,92,45,47,48.91
Akshan,Akali,255,175,80,68.63
Akshan,Kaisa,339,169,170,49.85
Akshan,Caitlyn,545,296,249,54.31
Akshan,Evelynn,97,55,42,56.7
Akshan,Sylas,194,107,87,55.15
Akshan,Ezreal,312,160,152,51.28
Akshan,Seraphine,251,137,114,54.58
Akshan,Yasuo,404,212,192,52.48
Akshan,Yone,457,234,223,51.2
Akshan,Thresh,344,239,105,69.48
Akshan,Tryndamere,123,66,57,53.66
Akshan,MasterYi,201,90,111,44.78
Akshan,Orianna,112,66,46,58.93
Akshan,Tristana,174,87,87,50
Akshan,Lux,630,271,359,43.02
Akshan,TahmKench,264,138,126,52.27
Akshan,Nocturne,168,118,50,70.24
Akshan,Taric,49,20,29,40.82
Akshan,Sett,289,127,162,43.94
Akshan,Elise,203,75,128,36.95
Akshan,Katarina,188,102,86,54.26
Akshan,MissFortune,477,259,218,54.3
Akshan,Morgana,341,196,145,57.48
Akshan,Udyr,115,39,76,33.91
Akshan,Lulu,227,123,104,54.19
Akshan,Sejuani,94,64,30,68.09
Akshan,Jinx,484,261,223,53.93
Akshan,Nautilus,234,120,114,51.28
Akshan,Warwick,354,144,210,40.68
Akshan,Gangplank,136,69,67,50.74
Akshan,Poppy,186,108,78,58.06
Akshan,Riven,83,42,41,50.6
Akshan,Malzahar,220,118,102,53.64
Akshan,Bard,78,28,50,35.9
Akshan,Nunu,242,128,114,52.89
Akshan,Viktor,176,74,102,42.05
Akshan,Lucian,155,46,109,29.68
Akshan,Malphite,228,105,123,46.05
Akshan,Volibear,309,192,117,62.14
Akshan,Aurora,263,141,122,53.61
Akshan,Kayn,339,234,105,69.03
Akshan,Smolder,158,108,50,68.35
Akshan,Alistar,85,28,57,32.94
Akshan,Shaco,182,108,74,59.34
Akshan,Mel,507,259,248,51.08
Akshan,Milio,139,62,77,44.6
Akshan,Ryze,69,30,39,43.48
Akshan,Twitch,253,153,100,60.47
Akshan,Olaf,40,10,30,25
Akshan,Lillia,184,92,92,50
Akshan,Viego,321,183,138,57.01
Akshan,Vladimir,157,68,89,43.31
Akshan,Nami,206,87,119,42.23
Akshan,Rengar,74,38,36,51.35
Akshan,Rell,119,72,47,60.5
Akshan,Jax,189,90,99,47.62
Akshan,Zed,168,75,93,44.64
Akshan,Ashe,404,235,169,58.17
Akshan,Talon,149,73,76,48.99
Akshan,Shen,169,93,76,55.03
Akshan,Veigar,280,116,164,41.43
Akshan,Singed,53,21,32,39.62
Akshan,Jhin,434,198,236,45.62
Akshan,Zyra,93,50,43,53.76
Akshan,Hecarim,132,70,62,53.03
Akshan,Syndra,78,42,36,53.85
Akshan,Kindred,90,31,59,34.44
Akshan,Taliyah,51,27,24,52.94
Akshan,Draven,174,90,84,51.72
Akshan,Xerath,125,79,46,63.2
Akshan,Zeri,122,71,51,58.2
Akshan,Pyke,242,159,83,65.7
Akshan,Ziggs,92,53,39,57.61
Akshan,Hwei,210,145,65,69.05
Akshan,Gwen,165,82,83,49.7
Akshan,Gragas,159,96,63,60.38
Akshan,Kalista,90,51,39,56.67
Akshan,Diana,273,136,137,49.82
Akshan,Cassiopeia,108,59,49,54.63
Akshan,Nasus,162,95,67,58.64
Akshan,KSante,88,47,41,53.41
Akshan,Fizz,111,50,61,45.05
Akshan,Graves,129,76,53,58.91
Akshan,Annie,80,27,53,33.75
Akshan,Anivia,120,60,60,50
Akshan,FiddleSticks,121,49,72,40.5
Akshan,Xayah,209,92,117,44.02
Akshan,Aatrox,176,103,73,58.52
Akshan,Kayle,216,127,89,58.8
Akshan,Varus,131,51,80,38.93
Akshan,Velkoz,132,61,71,46.21
Akshan,Sion,187,82,105,43.85
Akshan,JarvanIV,83,42,41,50.6
Akshan,Illaoi,133,79,54,59.4
Akshan,Neeko,183,121,62,66.12
Akshan,Swain,248,126,122,50.81
Akshan,Urgot,119,57,62,47.9
Akshan,LeeSin,207,125,82,60.39
Akshan,Vayne,227,112,115,49.34
Akshan,Shyvana,52,37,15,71.15
Akshan,Galio,151,66,85,43.71
Akshan,Trundle,178,68,110,38.2
Akshan,TwistedFate,97,63,34,64.95
Akshan,Yorick,250,96,154,38.4
Akshan,Irelia,243,114,129,46.91
Akshan,Brand,162,81,81,50
Akshan,Kassadin,29,19,10,65.52
Akshan,Rakan,178,82,96,46.07
Akshan,Fiora,134,79,55,58.96
Akshan,Vex,129,54,75,41.86
Akshan,Camille,124,72,52,58.06
Akshan,Senna,249,89,160,35.74
Akshan,RekSai,39,25,14,64.1
Akshan,Renata,86,35,51,40.7
Akshan,Zac,56,27,29,48.21
Akshan,Quinn,83,55,28,66.27
Akshan,MonkeyKing,102,36,66,35.29
Akshan,Qiyana,55,37,18,67.27
Akshan,AurelionSol,103,54,49,52.43
Akshan,Ambessa,179,90,89,50.28
Akshan,Sona,69,51,18,73.91
Akshan,Leblanc,97,65,32,67.01
Akshan,Briar,230,111,119,48.26
Akshan,Leona,162,69,93,42.59
Akshan,Skarner,115,75,40,65.22
Akshan,Sivir,122,92,30,75.41
Akshan,Soraka,140,73,67,52.14
Akshan,Nidalee,100,52,48,52
Akshan,Aphelios,162,90,72,55.56
Akshan,Naafiri,131,55,76,41.98
Akshan,Ekko,168,94,74,55.95
Akshan,Renekton,120,55,65,45.83
Akshan,Corki,60,34,26,56.67
Akshan,Zoe,135,84,51,62.22
Akshan,Chogath,329,209,120,63.53
Akshan,Ornn,98,30,68,30.61
Akshan,Karthus,52,21,31,40.38
Akshan,Pantheon,395,221,174,55.95
Akshan,Janna,92,52,40,56.52
Akshan,Kled,68,39,29,57.35
Akshan,Azir,75,41,34,54.67
Akshan,Lissandra,45,21,24,46.67
Akshan,Braum,77,31,46,40.26
Akshan,Khazix,115,69,46,60
Akshan,Zilean,62,23,39,37.1
Akshan,Rumble,31,3,28,9.68
Akshan,Jayce,88,38,50,43.18
Akshan,Belveth,101,32,69,31.68
Akshan,Gnar,68,36,32,52.94
Zilean,Chogath,220,112,108,50.91
Zilean,Morgana,212,137,75,64.62
Zilean,Yasuo,349,172,177,49.28
Zilean,Jhin,358,169,189,47.21
Zilean,Mel,437,176,261,40.27
Zilean,Malphite,192,108,84,56.25
Zilean,Sett,308,133,175,43.18
Zilean,Sion,138,40,98,28.99
Zilean,Samira,160,99,61,61.88
Zilean,Alistar,68,45,23,66.18
Zilean,Poppy,100,47,53,47
Zilean,Khazix,133,60,73,45.11
Zilean,Irelia,177,75,102,42.37
Zilean,Tristana,130,49,81,37.69
Zilean,Neeko,121,63,58,52.07
Zilean,Jax,186,107,79,57.53
Zilean,Rammus,66,38,28,57.58
Zilean,Lux,480,211,269,43.96
Zilean,Caitlyn,406,217,189,53.45
Zilean,Nami,165,99,66,60
Zilean,Yone,311,150,161,48.23
Zilean,Sylas,191,94,97,49.21
Zilean,Viktor,103,49,54,47.57
Zilean,Pyke,166,95,71,57.23
Zilean,Akali,133,65,68,48.87
Zilean,Warwick,201,98,103,48.76
Zilean,Aurora,184,100,84,54.35
Zilean,Xayah,86,52,34,60.47
Zilean,Nautilus,173,105,68,60.69
Zilean,Teemo,224,106,118,47.32
Zilean,Vi,143,92,51,64.34
Zilean,Bard,44,25,19,56.82
Zilean,Fiora,75,32,43,42.67
Zilean,Sejuani,94,28,66,29.79
Zilean,Ashe,265,126,139,47.55
Zilean,Tryndamere,103,45,58,43.69
Zilean,Nocturne,230,90,140,39.13
Zilean,Seraphine,169,100,69,59.17
Zilean,Mordekaiser,282,105,177,37.23
Zilean,Galio,130,72,58,55.38
Zilean,Kayn,292,155,137,53.08
Zilean,Varus,164,65,99,39.63
Zilean,Blitzcrank,143,94,49,65.73
Zilean,Aatrox,215,109,106,50.7
Zilean,Kindred,120,78,42,65
Zilean,Swain,181,96,85,53.04
Zilean,Pantheon,262,139,123,53.05
Zilean,Nilah,51,22,29,43.14
Zilean,Naafiri,69,25,44,36.23
Zilean,Draven,93,63,30,67.74
Zilean,Veigar,201,111,90,55.22
Zilean,Nasus,115,49,66,42.61
Zilean,Fizz,81,44,37,54.32
Zilean,Darius,380,192,188,50.53
Zilean,MasterYi,155,61,94,39.35
Zilean,Kassadin,21,8,13,38.1
Zilean,Rell,118,59,59,50
Zilean,Yorick,148,73,75,49.32
Zilean,Lillia,112,59,53,52.68
Zilean,Trundle,63,26,37,41.27
Zilean,Vayne,130,62,68,47.69
Zilean,Thresh,267,128,139,47.94
Zilean,Riven,87,41,46,47.13
Zilean,Singed,50,12,38,24
Zilean,Kennen,64,44,20,68.75
Zilean,Ekko,150,76,74,50.67
Zilean,Lucian,138,70,68,50.72
Zilean,Ambessa,89,60,29,67.42
Zilean,Qiyana,81,57,24,70.37
Zilean,Aphelios,119,62,57,52.1
Zilean,Velkoz,201,102,99,50.75
Zilean,Renekton,80,23,57,28.75
Zilean,Gwen,81,34,47,41.98
Zilean,Ornn,94,42,52,44.68
Zilean,MissFortune,329,138,191,41.95
Zilean,Rakan,76,35,41,46.05
Zilean,Ahri,243,129,114,53.09
Zilean,Jinx,378,185,193,48.94
Zilean,Soraka,117,43,74,36.75
Zilean,Zed,208,128,80,61.54
Zilean,Gangplank,69,37,32,53.62
Zilean,Quinn,53,38,15,71.7
Zilean,Viego,197,69,128,35.03
Zilean,Katarina,95,42,53,44.21
Zilean,Xerath,100,54,46,54
Zilean,Graves,85,42,43,49.41
Zilean,Diana,217,97,120,44.7
Zilean,Ezreal,289,153,136,52.94
Zilean,Ziggs,56,28,28,50
Zilean,Malzahar,158,51,107,32.28
Zilean,Renata,47,26,21,55.32
Zilean,DrMundo,102,61,41,59.8
Zilean,Orianna,72,44,28,61.11
Zilean,Skarner,49,11,38,22.45
Zilean,Yuumi,105,51,54,48.57
Zilean,Lulu,171,82,89,47.95
Zilean,Belveth,60,35,25,58.33
Zilean,Leona,159,66,93,41.51
Zilean,Gragas,114,73,41,64.04
Zilean,Rengar,72,46,26,63.89
Zilean,Illaoi,93,49,44,52.69
Zilean,Kaisa,224,142,82,63.39
Zilean,Corki,80,38,42,47.5
Zilean,Garen,231,121,110,52.38
Zilean,Amumu,160,74,86,46.25
Zilean,Heimerdinger,94,47,47,50
Zilean,Twitch,155,74,81,47.74
Zilean,Camille,57,39,18,68.42
Zilean,Zoe,100,74,26,74
Zilean,Talon,97,44,53,45.36
Zilean,Cassiopeia,36,23,13,63.89
Zilean,LeeSin,164,90,74,54.88
Zilean,Volibear,178,95,83,53.37
Zilean,Briar,187,91,96,48.66
Zilean,Zeri,60,42,18,70
Zilean,Senna,131,38,93,29.01
Zilean,MonkeyKing,80,33,47,41.25
Zilean,Shen,146,43,103,29.45
Zilean,Evelynn,84,45,39,53.57
Zilean,Karthus,77,44,33,57.14
Zilean,Anivia,24,18,6,75
Zilean,Azir,60,20,40,33.33
Zilean,Shaco,132,80,52,60.61
Zilean,Milio,129,54,75,41.86
Zilean,Hecarim,58,39,19,67.24
Zilean,AurelionSol,70,31,39,44.29
Zilean,Nunu,157,56,101,35.67
Zilean,Elise,97,49,48,50.52
Zilean,Vladimir,83,29,54,34.94
Zilean,Urgot,101,49,52,48.51
Zilean,Braum,71,35,36,49.3
Zilean,Smolder,159,74,85,46.54
Zilean,Udyr,84,56,28,66.67
Zilean,Gnar,57,34,23,59.65
Zilean,Janna,73,43,30,58.9
Zilean,JarvanIV,55,24,31,43.64
Zilean,FiddleSticks,62,37,25,59.68
Zilean,Vex,90,37,53,41.11
Zilean,Lissandra,50,25,25,50
Zilean,Kayle,116,56,60,48.28
Zilean,Akshan,62,39,23,62.9
Zilean,Shyvana,47,41,6,87.23
Zilean,Karma,121,72,49,59.5
Zilean,Sona,71,42,29,59.15
Zilean,Taliyah,84,34,50,40.48
Zilean,Kalista,111,56,55,50.45
Zilean,KSante,70,51,19,72.86
Zilean,Zyra,107,47,60,43.93
Zilean,TahmKench,180,74,106,41.11
Zilean,Hwei,99,53,46,53.54
Zilean,Maokai,74,46,28,62.16
Zilean,RekSai,18,10,8,55.56
Zilean,Sivir,110,53,57,48.18
Zilean,Jayce,80,46,34,57.5
Zilean,Syndra,96,63,33,65.63
Zilean,Brand,146,84,62,57.53
Zilean,Zac,68,28,40,41.18
Zilean,KogMaw,57,22,35,38.6
Zilean,XinZhao,73,40,33,54.79
Zilean,Ryze,52,25,27,48.08
Zilean,Kled,59,38,21,64.41
Zilean,Rumble,40,14,26,35
Zilean,Nidalee,48,16,32,33.33
Zilean,Leblanc,58,31,27,53.45
Zilean,Olaf,26,16,10,61.54
Zilean,Ivern,27,24,3,88.89
Zilean,TwistedFate,39,19,20,48.72
Zilean,Annie,32,17,15,53.13
Zilean,Taric,9,6,3,66.67
Olaf,Chogath,197,100,97,50.76
Olaf,Graves,84,42,42,50
Olaf,Leblanc,51,24,27,47.06
Olaf,Caitlyn,235,130,105,55.32
Olaf,Milio,96,51,45,53.13
Olaf,Trundle,89,45,44,50.56
Olaf,Amumu,186,61,125,32.8
Olaf,Fizz,54,23,31,42.59
Olaf,Kaisa,222,104,118,46.85
Olaf,Pantheon,223,127,96,56.95
Olaf,Gangplank,47,25,22,53.19
Olaf,Warwick,237,116,121,48.95
Olaf,Malzahar,127,60,67,47.24
Olaf,Tristana,126,63,63,50
Olaf,Senna,120,42,78,35
Olaf,Darius,254,131,123,51.57
Olaf,Nami,131,69,62,52.67
Olaf,Rell,53,20,33,37.74
Olaf,Mordekaiser,299,151,148,50.5
Olaf,Viego,172,49,123,28.49
Olaf,Irelia,64,36,28,56.25
Olaf,Udyr,62,20,42,32.26
Olaf,Aatrox,79,47,32,59.49
Olaf,Kayn,174,79,95,45.4
Olaf,Lux,426,210,216,49.3
Olaf,Ezreal,195,95,100,48.72
Olaf,Varus,104,46,58,44.23
Olaf,Briar,146,71,75,48.63
Olaf,Mel,287,154,133,53.66
Olaf,Jinx,275,146,129,53.09
Olaf,Blitzcrank,125,49,76,39.2
Olaf,Fiora,29,8,21,27.59
Olaf,Shaco,145,61,84,42.07
Olaf,Nunu,107,48,59,44.86
Olaf,Nilah,72,35,37,48.61
Olaf,Heimerdinger,118,75,43,63.56
Olaf,Evelynn,39,21,18,53.85
Olaf,Zoe,48,22,26,45.83
Olaf,Jax,148,53,95,35.81
Olaf,Yasuo,304,174,130,57.24
Olaf,Rengar,43,22,21,51.16
Olaf,Ivern,20,17,3,85
Olaf,Cassiopeia,77,49,28,63.64
Olaf,LeeSin,140,81,59,57.86
Olaf,Katarina,120,68,52,56.67
Olaf,MissFortune,287,116,171,40.42
Olaf,Karma,72,24,48,33.33
Olaf,Yone,308,147,161,47.73
Olaf,Lulu,110,46,64,41.82
Olaf,Singed,42,3,39,7.14
Olaf,MonkeyKing,65,31,34,47.69
Olaf,Diana,134,56,78,41.79
Olaf,Volibear,159,74,85,46.54
Olaf,Talon,59,39,20,66.1
Olaf,Neeko,125,65,60,52
Olaf,Vladimir,67,27,40,40.3
Olaf,Akshan,40,30,10,75
Olaf,Pyke,140,73,67,52.14
Olaf,Ziggs,52,23,29,44.23
Olaf,Gragas,84,54,30,64.29
Olaf,Yuumi,137,47,90,34.31
Olaf,Camille,22,13,9,59.09
Olaf,Lillia,121,71,50,58.68
Olaf,Teemo,231,80,151,34.63
Olaf,Renekton,64,32,32,50
Olaf,TahmKench,202,95,107,47.03
Olaf,Kindred,116,72,44,62.07
Olaf,Ashe,219,103,116,47.03
Olaf,Vex,78,54,24,69.23
Olaf,Aphelios,117,60,57,51.28
Olaf,Soraka,89,37,52,41.57
Olaf,Ornn,84,51,33,60.71
Olaf,Draven,69,30,39,43.48
Olaf,Sett,231,99,132,42.86
Olaf,Thresh,160,107,53,66.88
Olaf,MasterYi,105,42,63,40
Olaf,Galio,104,71,33,68.27
Olaf,Swain,158,86,72,54.43
Olaf,Lucian,76,48,28,63.16
Olaf,Nasus,117,60,57,51.28
Olaf,Kayle,97,35,62,36.08
Olaf,Akali,150,72,78,48
Olaf,Samira,77,34,43,44.16
Olaf,Renata,32,23,9,71.88
Olaf,Sejuani,15,9,6,60
Olaf,Ryze,43,23,20,53.49
Olaf,Velkoz,53,25,28,47.17
Olaf,Tryndamere,79,51,28,64.56
Olaf,Nautilus,195,119,76,61.03
Olaf,Nidalee,45,34,11,75.56
Olaf,Zed,114,69,45,60.53
Olaf,Veigar,128,60,68,46.88
Olaf,Vayne,112,55,57,49.11
Olaf,Jhin,236,137,99,58.05
Olaf,Aurora,131,86,45,65.65
Olaf,Corki,59,28,31,47.46
Olaf,Zyra,165,88,77,53.33
Olaf,Garen,194,76,118,39.18
Olaf,Braum,58,25,33,43.1
Olaf,Ekko,121,44,77,36.36
Olaf,Rakan,74,20,54,27.03
Olaf,Bard,46,32,14,69.57
Olaf,JarvanIV,18,6,12,33.33
Olaf,Elise,73,40,33,54.79
Olaf,FiddleSticks,68,46,22,67.65
Olaf,Azir,32,13,19,40.63
Olaf,KogMaw,32,10,22,31.25
Olaf,Hecarim,47,22,25,46.81
Olaf,Ahri,228,125,103,54.82
Olaf,Xerath,82,29,53,35.37
Olaf,TwistedFate,29,17,12,58.62
Olaf,Seraphine,133,68,65,51.13
Olaf,DrMundo,73,26,47,35.62
Olaf,Twitch,115,49,66,42.61
Olaf,Yorick,89,45,44,50.56
Olaf,Vi,95,42,53,44.21
Olaf,Morgana,177,110,67,62.15
Olaf,Sivir,64,35,29,54.69
Olaf,Karthus,18,12,6,66.67
Olaf,Sona,51,9,42,17.65
Olaf,Syndra,65,28,37,43.08
Olaf,Quinn,65,18,47,27.69
Olaf,Nocturne,119,46,73,38.66
Olaf,XinZhao,87,24,63,27.59
Olaf,Urgot,49,27,22,55.1
Olaf,Xayah,74,37,37,50
Olaf,Qiyana,50,22,28,44
Olaf,Kled,22,0,22,0
Olaf,Maokai,65,34,31,52.31
Olaf,Leona,76,39,37,51.32
Olaf,Gnar,57,20,37,35.09
Olaf,Sylas,116,69,47,59.48
Olaf,Malphite,129,75,54,58.14
Olaf,Lissandra,50,25,25,50
Olaf,Riven,54,27,27,50
Olaf,Zac,63,28,35,44.44
Olaf,Naafiri,47,18,29,38.3
Olaf,Khazix,69,41,28,59.42
Olaf,Smolder,114,64,50,56.14
Olaf,Orianna,60,21,39,35
Olaf,Hwei,116,64,52,55.17
Olaf,Kalista,69,45,24,65.22
Olaf,Jayce,73,41,32,56.16
Olaf,Annie,36,23,13,63.89
Olaf,Illaoi,67,33,34,49.25
Olaf,Viktor,85,56,29,65.88
Olaf,Ambessa,68,25,43,36.76
Olaf,Rumble,26,13,13,50
Olaf,Poppy,72,42,30,58.33
Olaf,Sion,67,22,45,32.84
Olaf,Gwen,72,29,43,40.28
Olaf,Brand,74,36,38,48.65
Olaf,Belveth,38,18,20,47.37
Olaf,Shen,126,72,54,57.14
Olaf,Taliyah,51,18,33,35.29
Olaf,Alistar,27,17,10,62.96
Olaf,Rammus,46,24,22,52.17
Olaf,AurelionSol,72,34,38,47.22
Olaf,Kennen,61,46,15,75.41
Olaf,Skarner,48,28,20,58.33
Olaf,Janna,62,37,25,59.68
Olaf,Taric,20,10,10,50
Olaf,Anivia,30,10,20,33.33
Olaf,Zilean,26,10,16,38.46
Olaf,KSante,29,19,10,65.52
Olaf,Zeri,74,35,39,47.3
Olaf,Shyvana,26,20,6,76.92
Olaf,Kassadin,20,12,8,60
Olaf,RekSai,6,3,3,50
Annie,Shen,72,29,43,40.28
Annie,Warwick,262,134,128,51.15
Annie,Diana,245,132,113,53.88
Annie,Samira,158,69,89,43.67
Annie,Soraka,140,65,75,46.43
Annie,Kennen,66,31,35,46.97
Annie,Skarner,77,32,45,41.56
Annie,Malzahar,118,41,77,34.75
Annie,Jinx,306,151,155,49.35
Annie,Yuumi,209,105,104,50.24
Annie,Tryndamere,127,70,57,55.12
Annie,Lux,531,260,271,48.96
Annie,Sivir,81,30,51,37.04
Annie,Aatrox,222,110,112,49.55
Annie,Kayn,251,111,140,44.22
Annie,Veigar,225,96,129,42.67
Annie,Jhin,360,174,186,48.33
Annie,Swain,233,95,138,40.77
Annie,Kled,31,25,6,80.65
Annie,Vi,123,50,73,40.65
Annie,Yasuo,437,218,219,49.89
Annie,Zeri,101,42,59,41.58
Annie,Neeko,134,70,64,52.24
Annie,TahmKench,219,110,109,50.23
Annie,Gragas,126,67,59,53.17
Annie,Mel,362,173,189,47.79
Annie,Gangplank,97,39,58,40.21
Annie,Sett,357,130,227,36.41
Annie,Viktor,110,51,59,46.36
Annie,Caitlyn,422,224,198,53.08
Annie,Lulu,161,68,93,42.24
Annie,Yorick,164,71,93,43.29
Annie,Ekko,112,63,49,56.25
Annie,Yone,312,127,185,40.71
Annie,Thresh,197,111,86,56.35
Annie,Ivern,54,17,37,31.48
Annie,Katarina,212,105,107,49.53
Annie,Xayah,139,65,74,46.76
Annie,Garen,234,111,123,47.44
Annie,Sion,136,85,51,62.5
Annie,Akali,191,108,83,56.54
Annie,Ezreal,295,145,150,49.15
Annie,Varus,182,100,82,54.95
Annie,Viego,223,123,100,55.16
Annie,Fiora,76,32,44,42.11
Annie,Irelia,111,54,57,48.65
Annie,MasterYi,233,110,123,47.21
Annie,MissFortune,313,125,188,39.94
Annie,Shaco,163,43,120,26.38
Annie,Rengar,78,62,16,79.49
Annie,Zed,176,100,76,56.82
Annie,Ashe,398,176,222,44.22
Annie,Ambessa,107,58,49,54.21
Annie,Jax,174,80,94,45.98
Annie,Draven,127,58,69,45.67
Annie,Darius,272,137,135,50.37
Annie,Sylas,117,64,53,54.7
Annie,Nidalee,29,19,10,65.52
Annie,Vex,123,73,50,59.35
Annie,Velkoz,78,31,47,39.74
Annie,Mordekaiser,237,86,151,36.29
Annie,Amumu,236,114,122,48.31
Annie,Kaisa,273,148,125,54.21
Annie,Pyke,156,82,74,52.56
Annie,Kassadin,14,3,11,21.43
Annie,Galio,124,31,93,25
Annie,Poppy,111,65,46,58.56
Annie,Azir,74,42,32,56.76
Annie,Riven,115,71,44,61.74
Annie,Briar,165,40,125,24.24
Annie,Gnar,104,32,72,30.77
Annie,Teemo,278,114,164,41.01
Annie,Morgana,296,127,169,42.91
Annie,Aphelios,140,72,68,51.43
Annie,Pantheon,247,131,116,53.04
Annie,Braum,82,44,38,53.66
Annie,Cassiopeia,64,35,29,54.69
Annie,Maokai,63,31,32,49.21
Annie,Kayle,130,68,62,52.31
Annie,LeeSin,180,116,64,64.44
Annie,Nilah,108,44,64,40.74
Annie,Rell,133,59,74,44.36
Annie,Renekton,91,31,60,34.07
Annie,RekSai,48,25,23,52.08
Annie,Ziggs,92,45,47,48.91
Annie,Kindred,96,55,41,57.29
Annie,Lillia,143,72,71,50.35
Annie,Fizz,105,22,83,20.95
Annie,Corki,49,27,22,55.1
Annie,Bard,62,15,47,24.19
Annie,Ornn,91,58,33,63.74
Annie,Belveth,35,18,17,51.43
Annie,Taliyah,57,41,16,71.93
Annie,Camille,70,30,40,42.86
Annie,Gwen,100,39,61,39
Annie,Nasus,170,93,77,54.71
Annie,Akshan,80,53,27,66.25
Annie,Aurora,165,101,64,61.21
Annie,Evelynn,104,44,60,42.31
Annie,Malphite,122,76,46,62.3
Annie,Xerath,140,62,78,44.29
Annie,Seraphine,148,79,69,53.38
Annie,Nautilus,187,85,102,45.45
Annie,Illaoi,95,42,53,44.21
Annie,Nocturne,124,33,91,26.61
Annie,Ryze,46,27,19,58.7
Annie,Sona,69,44,25,63.77
Annie,Twitch,74,31,43,41.89
Annie,Graves,92,54,38,58.7
Annie,Elise,98,61,37,62.24
Annie,Smolder,143,68,75,47.55
Annie,Karthus,42,23,19,54.76
Annie,Heimerdinger,77,27,50,35.06
Annie,Senna,137,54,83,39.42
Annie,Khazix,135,53,82,39.26
Annie,Qiyana,56,35,21,62.5
Annie,Janna,49,28,21,57.14
Annie,Vladimir,81,45,36,55.56
Annie,Nami,172,66,106,38.37
Annie,Sejuani,77,39,38,50.65
Annie,MonkeyKing,70,44,26,62.86
Annie,Orianna,123,68,55,55.28
Annie,Taric,29,9,20,31.03
Annie,Quinn,52,12,40,23.08
Annie,Nunu,147,79,68,53.74
Annie,KSante,59,39,20,66.1
Annie,TwistedFate,98,45,53,45.92
Annie,KogMaw,59,31,28,52.54
Annie,Ahri,320,151,169,47.19
Annie,Talon,155,71,84,45.81
Annie,Tristana,170,75,95,44.12
Annie,Syndra,111,49,62,44.14
Annie,Chogath,237,101,136,42.62
Annie,Karma,109,63,46,57.8
Annie,Milio,140,31,109,22.14
Annie,Udyr,81,39,42,48.15
Annie,Volibear,196,69,127,35.2
Annie,Leblanc,55,30,25,54.55
Annie,Hwei,106,59,47,55.66
Annie,Zac,60,12,48,20
Annie,Blitzcrank,127,57,70,44.88
Annie,DrMundo,132,56,76,42.42
Annie,Brand,96,55,41,57.29
Annie,Vayne,179,115,64,64.25
Annie,Zyra,133,49,84,36.84
Annie,Hecarim,71,25,46,35.21
Annie,Anivia,56,17,39,30.36
Annie,Kalista,64,24,40,37.5
Annie,Shyvana,58,13,45,22.41
Annie,Alistar,78,59,19,75.64
Annie,Naafiri,115,63,52,54.78
Annie,FiddleSticks,113,53,60,46.9
Annie,Olaf,36,13,23,36.11
Annie,Jayce,73,22,51,30.14
Annie,Renata,43,33,10,76.74
Annie,Urgot,76,34,42,44.74
Annie,Leona,110,44,66,40
Annie,Singed,45,19,26,42.22
Annie,AurelionSol,93,25,68,26.88
Annie,Rakan,119,66,53,55.46
Annie,JarvanIV,82,30,52,36.59
Annie,Trundle,89,42,47,47.19
Annie,XinZhao,65,21,44,32.31
Annie,Lucian,90,48,42,53.33
Annie,Rammus,32,22,10,68.75
Annie,Rumble,13,13,0,100
Annie,Zoe,73,35,38,47.95
Annie,Lissandra,29,9,20,31.03
Annie,Zilean,32,15,17,46.88
Camille,Gwen,107,47,60,43.93
Camille,Kayn,346,152,194,43.93
Camille,Thresh,281,146,135,51.96
Camille,Ezreal,485,221,264,45.57
Camille,Yuumi,283,133,150,47
Camille,Sett,358,186,172,51.96
Camille,Ryze,80,29,51,36.25
Camille,Caitlyn,447,181,266,40.49
Camille,Lulu,182,76,106,41.76
Camille,Kalista,106,69,37,65.09
Camille,Gragas,160,102,58,63.75
Camille,Orianna,85,35,50,41.18
Camille,Gnar,66,42,24,63.64
Camille,Pyke,235,105,130,44.68
Camille,Aatrox,212,88,124,41.51
Camille,Chogath,217,117,100,53.92
Camille,Kaisa,249,92,157,36.95
Camille,Morgana,262,121,141,46.18
Camille,Garen,404,212,192,52.48
Camille,Rammus,93,55,38,59.14
Camille,Katarina,193,93,100,48.19
Camille,Milio,120,59,61,49.17
Camille,Shaco,206,122,84,59.22
Camille,Akali,216,100,116,46.3
Camille,Sivir,119,54,65,45.38
Camille,Renata,85,56,29,65.88
Camille,Renekton,108,49,59,45.37
Camille,Hecarim,63,37,26,58.73
Camille,Viktor,184,104,80,56.52
Camille,Jhin,441,190,251,43.08
Camille,Leblanc,109,45,64,41.28
Camille,LeeSin,239,132,107,55.23
Camille,TwistedFate,112,53,59,47.32
Camille,Zeri,128,57,71,44.53
Camille,Seraphine,196,103,93,52.55
Camille,Fiora,93,34,59,36.56
Camille,Nunu,192,98,94,51.04
Camille,Zed,224,108,116,48.21
Camille,Aphelios,167,85,82,50.9
Camille,Nami,197,94,103,47.72
Camille,Gangplank,102,37,65,36.27
Camille,Yone,340,180,160,52.94
Camille,Lux,549,267,282,48.63
Camille,Shen,185,74,111,40
Camille,Illaoi,101,43,58,42.57
Camille,Kindred,129,75,54,58.14
Camille,Talon,172,104,68,60.47
Camille,Varus,186,88,98,47.31
Camille,Mordekaiser,371,148,223,39.89
Camille,Sejuani,78,28,50,35.9
Camille,Yasuo,381,197,184,51.71
Camille,Velkoz,163,44,119,26.99
Camille,Darius,310,156,154,50.32
Camille,Warwick,333,150,183,45.05
Camille,Ashe,434,233,201,53.69
Camille,Nautilus,189,78,111,41.27
Camille,Tryndamere,174,77,97,44.25
Camille,Zac,75,37,38,49.33
Camille,Galio,144,59,85,40.97
Camille,MissFortune,364,154,210,42.31
Camille,Alistar,47,32,15,68.09
Camille,RekSai,19,0,19,0
Camille,Jax,195,79,116,40.51
Camille,Lucian,132,70,62,53.03
Camille,Riven,111,57,54,51.35
Camille,Khazix,130,69,61,53.08
Camille,Vex,104,43,61,41.35
Camille,Swain,221,54,167,24.43
Camille,Malzahar,120,62,58,51.67
Camille,Kled,30,18,12,60
Camille,Vi,208,106,102,50.96
Camille,Ahri,325,187,138,57.54
Camille,Aurora,231,119,112,51.52
Camille,Lissandra,20,6,14,30
Camille,Briar,243,114,129,46.91
Camille,Mel,513,258,255,50.29
Camille,Jinx,381,187,194,49.08
Camille,Pantheon,364,142,222,39.01
Camille,Twitch,201,76,125,37.81
Camille,Vladimir,147,55,92,37.41
Camille,Braum,103,66,37,64.08
Camille,Karma,163,69,94,42.33
Camille,Neeko,148,49,99,33.11
Camille,Volibear,293,124,169,42.32
Camille,Olaf,22,9,13,40.91
Camille,Diana,254,132,122,51.97
Camille,Yorick,194,38,156,19.59
Camille,Brand,133,57,76,42.86
Camille,FiddleSticks,119,71,48,59.66
Camille,Sylas,173,83,90,47.98
Camille,Poppy,156,67,89,42.95
Camille,Viego,182,73,109,40.11
Camille,Ziggs,79,27,52,34.18
Camille,Sona,63,12,51,19.05
Camille,Ekko,149,69,80,46.31
Camille,Vayne,207,84,123,40.58
Camille,TahmKench,239,129,110,53.97
Camille,Urgot,79,11,68,13.92
Camille,JarvanIV,110,38,72,34.55
Camille,Blitzcrank,165,66,99,40
Camille,Soraka,143,81,62,56.64
Camille,Shyvana,70,20,50,28.57
Camille,Senna,139,46,93,33.09
Camille,Trundle,84,35,49,41.67
Camille,Qiyana,81,41,40,50.62
Camille,Samira,176,88,88,50
Camille,Smolder,169,82,87,48.52
Camille,Tristana,182,97,85,53.3
Camille,Xerath,159,75,84,47.17
Camille,Malphite,145,73,72,50.34
Camille,Anivia,77,43,34,55.84
Camille,KSante,79,25,54,31.65
Camille,Zyra,106,46,60,43.4
Camille,Heimerdinger,83,27,56,32.53
Camille,Kayle,154,64,90,41.56
Camille,Amumu,168,59,109,35.12
Camille,Singed,73,40,33,54.79
Camille,Naafiri,108,50,58,46.3
Camille,MonkeyKing,99,33,66,33.33
Camille,Annie,70,40,30,57.14
Camille,Taliyah,77,46,31,59.74
Camille,Ivern,40,27,13,67.5
Camille,Kassadin,62,19,43,30.65
Camille,Irelia,172,124,48,72.09
Camille,Graves,117,61,56,52.14
Camille,Draven,98,38,60,38.78
Camille,Elise,161,69,92,42.86
Camille,Hwei,132,65,67,49.24
Camille,Rakan,100,32,68,32
Camille,Kennen,132,54,78,40.91
Camille,Maokai,52,33,19,63.46
Camille,Rengar,75,34,41,45.33
Camille,Cassiopeia,55,15,40,27.27
Camille,Belveth,41,16,25,39.02
Camille,KogMaw,75,52,23,69.33
Camille,Nocturne,206,63,143,30.58
Camille,Ambessa,161,101,60,62.73
Camille,Nasus,199,78,121,39.2
Camille,Bard,81,34,47,41.98
Camille,Teemo,279,120,159,43.01
Camille,Quinn,55,31,24,56.36
Camille,Akshan,124,52,72,41.94
Camille,Ornn,98,40,58,40.82
Camille,Sion,165,56,109,33.94
Camille,Zilean,57,18,39,31.58
Camille,Fizz,116,30,86,25.86
Camille,Xayah,141,45,96,31.91
Camille,Skarner,81,39,42,48.15
Camille,Corki,133,55,78,41.35
Camille,Zoe,105,78,27,74.29
Camille,AurelionSol,84,35,49,41.67
Camille,Karthus,44,12,32,27.27
Camille,Nilah,111,39,72,35.14
Camille,Rell,135,59,76,43.7
Camille,Nidalee,73,39,34,53.42
Camille,Azir,68,25,43,36.76
Camille,Jayce,89,29,60,32.58
Camille,MasterYi,209,101,108,48.33
Camille,DrMundo,114,52,62,45.61
Camille,Syndra,152,68,84,44.74
Camille,Leona,148,49,99,33.11
Camille,Janna,125,72,53,57.6
Camille,Udyr,90,30,60,33.33
Camille,Veigar,176,85,91,48.3
Camille,XinZhao,117,46,71,39.32
Camille,Taric,41,15,26,36.59
Camille,Lillia,140,73,67,52.14
Camille,Evelynn,45,21,24,46.67
Camille,Rumble,26,6,20,23.08
Nunu,Gnar,176,88,88,50
Nunu,Viego,621,357,264,57.49
Nunu,Yone,1132,584,548,51.59
Nunu,Kaisa,703,366,337,52.06
Nunu,TahmKench,501,216,285,43.11
Nunu,Jax,414,233,181,56.28
Nunu,Elise,279,175,104,62.72
Nunu,Naafiri,247,123,124,49.8
Nunu,Jhin,965,475,490,49.22
Nunu,Lulu,401,202,199,50.37
Nunu,Sett,834,360,474,43.17
Nunu,Warwick,816,387,429,47.43
Nunu,Brand,355,184,171,51.83
Nunu,Twitch,397,197,200,49.62
Nunu,Morgana,705,319,386,45.25
Nunu,TwistedFate,170,81,89,47.65
Nunu,LeeSin,569,295,274,51.85
Nunu,Yasuo,1069,475,594,44.43
Nunu,Nilah,271,152,119,56.09
Nunu,Kennen,193,96,97,49.74
Nunu,MonkeyKing,249,140,109,56.22
Nunu,Vladimir,340,165,175,48.53
Nunu,Vayne,474,249,225,52.53
Nunu,Thresh,734,356,378,48.5
Nunu,Akali,597,282,315,47.24
Nunu,Leblanc,192,92,100,47.92
Nunu,Tristana,390,228,162,58.46
Nunu,Graves,337,162,175,48.07
Nunu,Katarina,396,251,145,63.38
Nunu,Seraphine,582,296,286,50.86
Nunu,Heimerdinger,383,234,149,61.1
Nunu,Mordekaiser,881,395,486,44.84
Nunu,Ashe,804,351,453,43.66
Nunu,Pyke,592,325,267,54.9
Nunu,Samira,509,289,220,56.78
Nunu,MasterYi,530,251,279,47.36
Nunu,Orianna,209,98,111,46.89
Nunu,Malphite,341,163,178,47.8
Nunu,Nautilus,554,266,288,48.01
Nunu,Aatrox,529,288,241,54.44
Nunu,Gragas,313,151,162,48.24
Nunu,Cassiopeia,149,73,76,48.99
Nunu,Irelia,478,230,248,48.12
Nunu,Briar,592,296,296,50
Nunu,Zoe,187,106,81,56.68
Nunu,Ezreal,834,468,366,56.12
Nunu,Janna,141,87,54,61.7
Nunu,Kindred,214,101,113,47.2
Nunu,Yuumi,539,270,269,50.09
Nunu,Darius,858,430,428,50.12
Nunu,Senna,497,217,280,43.66
Nunu,Azir,200,99,101,49.5
Nunu,Taric,72,36,36,50
Nunu,Rammus,120,62,58,51.67
Nunu,Renekton,218,101,117,46.33
Nunu,Zyra,349,160,189,45.85
Nunu,KSante,164,68,96,41.46
Nunu,Olaf,107,59,48,55.14
Nunu,Aurora,616,303,313,49.19
Nunu,Jinx,998,504,494,50.5
Nunu,Lux,1485,756,729,50.91
Nunu,Nasus,411,216,195,52.55
Nunu,AurelionSol,216,97,119,44.91
Nunu,Rengar,280,134,146,47.86
Nunu,Ivern,131,92,39,70.23
Nunu,Garen,779,379,400,48.65
Nunu,Diana,688,284,404,41.28
Nunu,Ryze,126,63,63,50
Nunu,Pantheon,959,448,511,46.72
Nunu,Camille,192,94,98,48.96
Nunu,Lillia,440,206,234,46.82
Nunu,Udyr,206,120,86,58.25
Nunu,Skarner,192,93,99,48.44
Nunu,Rell,258,126,132,48.84
Nunu,Evelynn,263,157,106,59.7
Nunu,Taliyah,173,92,81,53.18
Nunu,Kayle,367,182,185,49.59
Nunu,Volibear,602,293,309,48.67
Nunu,Rakan,289,133,156,46.02
Nunu,Singed,170,91,79,53.53
Nunu,Smolder,363,193,170,53.17
Nunu,Zed,414,212,202,51.21
Nunu,Shen,285,143,142,50.18
Nunu,Veigar,660,332,328,50.3
Nunu,MissFortune,1171,599,572,51.15
Nunu,Blitzcrank,419,168,251,40.1
Nunu,Riven,226,132,94,58.41
Nunu,Akshan,242,114,128,47.11
Nunu,Poppy,326,139,187,42.64
Nunu,Anivia,121,67,54,55.37
Nunu,Kayn,806,341,465,42.31
Nunu,Lucian,289,112,177,38.75
Nunu,Karma,369,170,199,46.07
Nunu,Tryndamere,321,204,117,63.55
Nunu,Shaco,471,270,201,57.32
Nunu,Talon,349,202,147,57.88
Nunu,Caitlyn,1224,543,681,44.36
Nunu,Malzahar,451,213,238,47.23
Nunu,Teemo,692,346,346,50
Nunu,Soraka,324,198,126,61.11
Nunu,Illaoi,306,148,158,48.37
Nunu,Chogath,562,233,329,41.46
Nunu,Leona,374,195,179,52.14
Nunu,Fiora,269,171,98,63.57
Nunu,Draven,210,95,115,45.24
Nunu,Vi,414,182,232,43.96
Nunu,Kassadin,73,40,33,54.79
Nunu,Mel,951,510,441,53.63
Nunu,Nidalee,169,100,69,59.17
Nunu,Vex,333,155,178,46.55
Nunu,Velkoz,248,119,129,47.98
Nunu,Hwei,407,175,232,43
Nunu,Sona,179,75,104,41.9
Nunu,Neeko,394,224,170,56.85
Nunu,Gwen,379,172,207,45.38
Nunu,Braum,230,105,125,45.65
Nunu,Ekko,361,167,194,46.26
Nunu,Galio,314,144,170,45.86
Nunu,Milio,231,116,115,50.22
Nunu,Alistar,116,55,61,47.41
Nunu,FiddleSticks,282,116,166,41.13
Nunu,Corki,217,107,110,49.31
Nunu,Swain,550,188,362,34.18
Nunu,Amumu,588,308,280,52.38
Nunu,Ahri,795,440,355,55.35
Nunu,Xayah,402,222,180,55.22
Nunu,Sejuani,196,108,88,55.1
Nunu,Ziggs,160,91,69,56.88
Nunu,DrMundo,322,152,170,47.2
Nunu,Qiyana,140,68,72,48.57
Nunu,XinZhao,261,110,151,42.15
Nunu,Khazix,280,130,150,46.43
Nunu,Zac,125,76,49,60.8
Nunu,KogMaw,126,47,79,37.3
Nunu,Karthus,120,71,49,59.17
Nunu,Sion,403,173,230,42.93
Nunu,Viktor,349,187,162,53.58
Nunu,Sivir,281,133,148,47.33
Nunu,Varus,455,239,216,52.53
Nunu,Belveth,163,60,103,36.81
Nunu,Shyvana,132,72,60,54.55
Nunu,Sylas,552,273,279,49.46
Nunu,Nocturne,460,240,220,52.17
Nunu,Aphelios,319,166,153,52.04
Nunu,Xerath,301,124,177,41.2
Nunu,Bard,188,117,71,62.23
Nunu,Quinn,172,91,81,52.91
Nunu,Kalista,208,99,109,47.6
Nunu,Nami,452,250,202,55.31
Nunu,Maokai,241,125,116,51.87
Nunu,Kled,78,30,48,38.46
Nunu,Annie,147,68,79,46.26
Nunu,Syndra,295,163,132,55.25
Nunu,Trundle,332,158,174,47.59
Nunu,Fizz,265,147,118,55.47
Nunu,Ornn,219,101,118,46.12
Nunu,Hecarim,249,146,103,58.63
Nunu,Zeri,244,145,99,59.43
Nunu,Ambessa,252,112,140,44.44
Nunu,Yorick,463,210,253,45.36
Nunu,JarvanIV,205,96,109,46.83
Nunu,Lissandra,109,51,58,46.79
Nunu,Zilean,157,101,56,64.33
Nunu,Gangplank,185,89,96,48.11
Nunu,Urgot,194,68,126,35.05
Nunu,RekSai,94,49,45,52.13
Nunu,Rumble,93,51,42,54.84
Nunu,Renata,96,63,33,65.63
Nunu,Jayce,236,142,94,60.17
Lissandra,Sylas,149,59,90,39.6
Lissandra,Ekko,141,78,63,55.32
Lissandra,Talon,100,40,60,40
Lissandra,Jinx,332,148,184,44.58
Lissandra,Pyke,186,103,83,55.38
Lissandra,Yone,329,171,158,51.98
Lissandra,Yasuo,397,193,204,48.61
Lissandra,Irelia,181,80,101,44.2
Lissandra,Morgana,265,92,173,34.72
Lissandra,Lux,389,219,170,56.3
Lissandra,Fiora,90,49,41,54.44
Lissandra,Elise,80,34,46,42.5
Lissandra,Garen,238,100,138,42.02
Lissandra,Ashe,204,122,82,59.8
Lissandra,Senna,110,45,65,40.91
Lissandra,LeeSin,113,68,45,60.18
Lissandra,Hwei,109,28,81,25.69
Lissandra,Aurora,162,73,89,45.06
Lissandra,Yorick,139,69,70,49.64
Lissandra,Kayn,273,138,135,50.55
Lissandra,Jhin,327,159,168,48.62
Lissandra,Thresh,180,104,76,57.78
Lissandra,DrMundo,66,25,41,37.88
Lissandra,Zed,181,112,69,61.88
Lissandra,Caitlyn,349,170,179,48.71
Lissandra,Lulu,129,81,48,62.79
Lissandra,Poppy,85,44,41,51.76
Lissandra,Kalista,82,39,43,47.56
Lissandra,Neeko,102,56,46,54.9
Lissandra,Kled,59,39,20,66.1
Lissandra,Nocturne,153,68,85,44.44
Lissandra,Malzahar,104,27,77,25.96
Lissandra,Kaisa,243,114,129,46.91
Lissandra,Mel,388,185,203,47.68
Lissandra,Zac,90,68,22,75.56
Lissandra,Amumu,111,58,53,52.25
Lissandra,Alistar,60,33,27,55
Lissandra,Camille,20,14,6,70
Lissandra,Karma,79,32,47,40.51
Lissandra,Kennen,56,25,31,44.64
Lissandra,Lucian,73,28,45,38.36
Lissandra,Nami,159,69,90,43.4
Lissandra,Teemo,249,117,132,46.99
Lissandra,Darius,259,147,112,56.76
Lissandra,Seraphine,172,98,74,56.98
Lissandra,Velkoz,116,48,68,41.38
Lissandra,Shaco,171,104,67,60.82
Lissandra,Quinn,55,20,35,36.36
Lissandra,Briar,212,90,122,42.45
Lissandra,MasterYi,193,95,98,49.22
Lissandra,Milio,64,24,40,37.5
Lissandra,Diana,206,104,102,50.49
Lissandra,Yuumi,162,89,73,54.94
Lissandra,Trundle,82,29,53,35.37
Lissandra,Katarina,122,74,48,60.66
Lissandra,Draven,71,49,22,69.01
Lissandra,Chogath,209,99,110,47.37
Lissandra,Taric,27,10,17,37.04
Lissandra,Ivern,36,19,17,52.78
Lissandra,Rell,94,71,23,75.53
Lissandra,Viego,189,87,102,46.03
Lissandra,Gnar,48,32,16,66.67
Lissandra,Lillia,96,57,39,59.38
Lissandra,Smolder,105,33,72,31.43
Lissandra,TahmKench,183,81,102,44.26
Lissandra,Pantheon,248,133,115,53.63
Lissandra,Volibear,130,57,73,43.85
Lissandra,Tristana,153,67,86,43.79
Lissandra,Twitch,168,110,58,65.48
Lissandra,Ornn,65,27,38,41.54
Lissandra,Ezreal,297,145,152,48.82
Lissandra,Blitzcrank,112,59,53,52.68
Lissandra,Sett,226,118,108,52.21
Lissandra,Khazix,95,56,39,58.95
Lissandra,Azir,75,34,41,45.33
Lissandra,Shen,132,70,62,53.03
Lissandra,Illaoi,75,33,42,44
Lissandra,Belveth,40,29,11,72.5
Lissandra,Xayah,96,48,48,50
Lissandra,Rakan,91,52,39,57.14
Lissandra,Sejuani,39,16,23,41.03
Lissandra,Leblanc,72,45,27,62.5
Lissandra,Swain,184,76,108,41.3
Lissandra,Sion,145,79,66,54.48
Lissandra,Aatrox,113,63,50,55.75
Lissandra,Vayne,121,54,67,44.63
Lissandra,Riven,59,30,29,50.85
Lissandra,Vi,126,56,70,44.44
Lissandra,Akali,177,55,122,31.07
Lissandra,Rumble,45,30,15,66.67
Lissandra,Vladimir,69,36,33,52.17
Lissandra,Ahri,193,86,107,44.56
Lissandra,Renata,40,31,9,77.5
Lissandra,MissFortune,296,146,150,49.32
Lissandra,Gragas,107,72,35,67.29
Lissandra,Nilah,81,43,38,53.09
Lissandra,Leona,140,69,71,49.29
Lissandra,Janna,63,36,27,57.14
Lissandra,Heimerdinger,70,37,33,52.86
Lissandra,Hecarim,41,28,13,68.29
Lissandra,Varus,104,51,53,49.04
Lissandra,FiddleSticks,60,43,17,71.67
Lissandra,Cassiopeia,51,30,21,58.82
Lissandra,Samira,149,76,73,51.01
Lissandra,Nasus,106,34,72,32.08
Lissandra,Nautilus,177,105,72,59.32
Lissandra,Warwick,239,82,157,34.31
Lissandra,Graves,77,28,49,36.36
Lissandra,Tryndamere,69,46,23,66.67
Lissandra,Rengar,96,54,42,56.25
Lissandra,Mordekaiser,225,92,133,40.89
Lissandra,Shyvana,58,26,32,44.83
Lissandra,Brand,98,44,54,44.9
Lissandra,Anivia,63,25,38,39.68
Lissandra,Sona,32,18,14,56.25
Lissandra,Soraka,73,29,44,39.73
Lissandra,Naafiri,71,27,44,38.03
Lissandra,Jax,102,41,61,40.2
Lissandra,Aphelios,119,78,41,65.55
Lissandra,Gwen,97,48,49,49.48
Lissandra,Fizz,86,50,36,58.14
Lissandra,Gangplank,72,28,44,38.89
Lissandra,Braum,108,65,43,60.19
Lissandra,Malphite,131,70,61,53.44
Lissandra,Viktor,91,43,48,47.25
Lissandra,Zeri,46,34,12,73.91
Lissandra,Veigar,139,74,65,53.24
Lissandra,MonkeyKing,122,60,62,49.18
Lissandra,Qiyana,49,43,6,87.76
Lissandra,KogMaw,33,24,9,72.73
Lissandra,Galio,106,43,63,40.57
Lissandra,Nunu,109,58,51,53.21
Lissandra,Maokai,60,20,40,33.33
Lissandra,Jayce,50,37,13,74
Lissandra,Kayle,109,58,51,53.21
Lissandra,Vex,82,39,43,47.56
Lissandra,Zoe,78,57,21,73.08
Lissandra,Xerath,73,54,19,73.97
Lissandra,JarvanIV,68,39,29,57.35
Lissandra,Ziggs,71,40,31,56.34
Lissandra,Zyra,108,48,60,44.44
Lissandra,Ambessa,127,51,76,40.16
Lissandra,Olaf,50,25,25,50
Lissandra,Corki,47,22,25,46.81
Lissandra,Akshan,45,24,21,53.33
Lissandra,Zilean,50,25,25,50
Lissandra,Nidalee,37,24,13,64.86
Lissandra,Sivir,35,25,10,71.43
Lissandra,Rammus,59,27,32,45.76
Lissandra,Kindred,64,22,42,34.38
Lissandra,Orianna,68,34,34,50
Lissandra,Evelynn,97,51,46,52.58
Lissandra,Renekton,58,34,24,58.62
Lissandra,Urgot,76,38,38,50
Lissandra,Singed,27,15,12,55.56
Lissandra,XinZhao,66,35,31,53.03
Lissandra,Taliyah,23,17,6,73.91
Lissandra,Syndra,64,29,35,45.31
Lissandra,AurelionSol,94,47,47,50
Lissandra,KSante,38,23,15,60.53
Lissandra,TwistedFate,59,36,23,61.02
Lissandra,RekSai,28,18,10,64.29
Lissandra,Skarner,50,32,18,64
Lissandra,Udyr,37,14,23,37.84
Lissandra,Bard,39,29,10,74.36
Lissandra,Annie,29,20,9,68.97
Lissandra,Karthus,15,9,6,60
Lissandra,Ryze,31,23,8,74.19
Lissandra,Kassadin,22,13,9,59.09
Elise,Ryze,113,43,70,38.05
Elise,Nunu,279,104,175,37.28
Elise,Ahri,543,258,285,47.51
Elise,Lucian,226,113,113,50
Elise,Alistar,118,51,67,43.22
Elise,Yorick,292,100,192,34.25
Elise,Volibear,390,197,193,50.51
Elise,Veigar,469,203,266,43.28
Elise,Caitlyn,916,426,490,46.51
Elise,Sona,190,66,124,34.74
Elise,Ornn,166,63,103,37.95
Elise,Warwick,509,218,291,42.83
Elise,TwistedFate,137,65,72,47.45
Elise,Morgana,432,142,290,32.87
Elise,Gwen,269,121,148,44.98
Elise,Pantheon,605,321,284,53.06
Elise,Mel,775,358,417,46.19
Elise,Tristana,329,150,179,45.59
Elise,Poppy,167,92,75,55.09
Elise,KSante,189,88,101,46.56
Elise,Jax,294,117,177,39.8
Elise,Velkoz,221,99,122,44.8
Elise,Xayah,244,131,113,53.69
Elise,Rakan,230,109,121,47.39
Elise,Sett,618,265,353,42.88
Elise,Talon,302,151,151,50
Elise,Lissandra,80,46,34,57.5
Elise,Vayne,469,222,247,47.33
Elise,Milio,222,89,133,40.09
Elise,Aurora,335,112,223,33.43
Elise,Nocturne,412,167,245,40.53
Elise,Nilah,213,91,122,42.72
Elise,Soraka,273,143,130,52.38
Elise,Ambessa,207,90,117,43.48
Elise,Sejuani,207,89,118,43
Elise,Karma,302,136,166,45.03
Elise,Nidalee,101,48,53,47.52
Elise,Vex,190,77,113,40.53
Elise,Sivir,179,93,86,51.96
Elise,TahmKench,388,172,216,44.33
Elise,Gragas,277,139,138,50.18
Elise,Samira,269,107,162,39.78
Elise,Malphite,291,127,164,43.64
Elise,Viktor,317,174,143,54.89
Elise,Blitzcrank,247,137,110,55.47
Elise,Rumble,59,22,37,37.29
Elise,Akshan,203,128,75,63.05
Elise,Ezreal,766,389,377,50.78
Elise,Aatrox,322,152,170,47.2
Elise,Chogath,616,245,371,39.77
Elise,Janna,206,102,104,49.51
Elise,Kayn,621,260,361,41.87
Elise,Graves,169,68,101,40.24
Elise,Malzahar,195,84,111,43.08
Elise,Ivern,67,37,30,55.22
Elise,FiddleSticks,194,126,68,64.95
Elise,Azir,121,61,60,50.41
Elise,Viego,492,204,288,41.46
Elise,Aphelios,240,104,136,43.33
Elise,Diana,464,183,281,39.44
Elise,Ashe,680,297,383,43.68
Elise,Urgot,162,54,108,33.33
Elise,MasterYi,380,173,207,45.53
Elise,Seraphine,362,146,216,40.33
Elise,Garen,483,177,306,36.65
Elise,JarvanIV,179,71,108,39.66
Elise,Hwei,336,187,149,55.65
Elise,Twitch,297,140,157,47.14
Elise,Lulu,347,140,207,40.35
Elise,Amumu,323,100,223,30.96
Elise,Zed,393,183,210,46.56
Elise,Ziggs,204,80,124,39.22
Elise,Rengar,181,100,81,55.25
Elise,Yasuo,627,263,364,41.95
Elise,Nautilus,376,159,217,42.29
Elise,MissFortune,759,306,453,40.32
Elise,Pyke,394,215,179,54.57
Elise,Renekton,242,115,127,47.52
Elise,Zeri,153,94,59,61.44
Elise,Shen,250,106,144,42.4
Elise,LeeSin,411,219,192,53.28
Elise,Zac,148,60,88,40.54
Elise,Teemo,482,218,264,45.23
Elise,AurelionSol,226,80,146,35.4
Elise,Fiora,196,103,93,52.55
Elise,Mordekaiser,459,235,224,51.2
Elise,Briar,315,122,193,38.73
Elise,Rell,207,87,120,42.03
Elise,Kaisa,531,234,297,44.07
Elise,Jinx,682,299,383,43.84
Elise,XinZhao,210,94,116,44.76
Elise,Yuumi,297,139,158,46.8
Elise,Lillia,201,105,96,52.24
Elise,Draven,200,111,89,55.5
Elise,Thresh,500,242,258,48.4
Elise,Naafiri,199,84,115,42.21
Elise,Kindred,193,77,116,39.9
Elise,Irelia,319,168,151,52.66
Elise,Shaco,427,218,209,51.05
Elise,Lux,1017,481,536,47.3
Elise,Swain,313,152,161,48.56
Elise,Renata,80,45,35,56.25
Elise,Singed,94,48,46,51.06
Elise,Cassiopeia,159,65,94,40.88
Elise,Vladimir,197,107,90,54.31
Elise,Belveth,119,61,58,51.26
Elise,Katarina,391,223,168,57.03
Elise,Brand,251,133,118,52.99
Elise,Nasus,280,157,123,56.07
Elise,Vi,273,99,174,36.26
Elise,Yone,664,298,366,44.88
Elise,Darius,644,305,339,47.36
Elise,Jhin,691,231,460,33.43
Elise,Zyra,221,106,115,47.96
Elise,Bard,173,78,95,45.09
Elise,Karthus,94,49,45,52.13
Elise,Nami,363,138,225,38.02
Elise,Leblanc,177,79,98,44.63
Elise,Zoe,151,80,71,52.98
Elise,Ekko,293,168,125,57.34
Elise,Kassadin,83,27,56,32.53
Elise,Sylas,349,160,189,45.85
Elise,Smolder,279,132,147,47.31
Elise,Gangplank,216,92,124,42.59
Elise,Neeko,300,161,139,53.67
Elise,Braum,145,57,88,39.31
Elise,Quinn,124,40,84,32.26
Elise,Orianna,192,105,87,54.69
Elise,Leona,255,125,130,49.02
Elise,Trundle,179,81,98,45.25
Elise,Skarner,129,72,57,55.81
Elise,Senna,356,180,176,50.56
Elise,Sion,292,122,170,41.78
Elise,MonkeyKing,178,62,116,34.83
Elise,Camille,161,92,69,57.14
Elise,Annie,98,37,61,37.76
Elise,Galio,268,108,160,40.3
Elise,Varus,290,142,148,48.97
Elise,Heimerdinger,228,109,119,47.81
Elise,Kled,102,43,59,42.16
Elise,Kayle,290,160,130,55.17
Elise,Illaoi,199,74,125,37.19
Elise,Jayce,153,49,104,32.03
Elise,Khazix,258,118,140,45.74
Elise,Kennen,205,128,77,62.44
Elise,Akali,300,139,161,46.33
Elise,Tryndamere,201,102,99,50.75
Elise,Olaf,73,33,40,45.21
Elise,Riven,164,75,89,45.73
Elise,Syndra,187,71,116,37.97
Elise,Udyr,161,76,85,47.2
Elise,Kalista,167,100,67,59.88
Elise,Fizz,189,88,101,46.56
Elise,Taric,122,44,78,36.07
Elise,Evelynn,205,76,129,37.07
Elise,Shyvana,126,53,73,42.06
Elise,Xerath,254,87,167,34.25
Elise,Gnar,137,94,43,68.61
Elise,Maokai,174,61,113,35.06
Elise,Qiyana,129,53,76,41.09
Elise,Hecarim,116,55,61,47.41
Elise,Zilean,97,48,49,49.48
Elise,Taliyah,96,59,37,61.46
Elise,KogMaw,105,57,48,54.29
Elise,DrMundo,233,70,163,30.04
Elise,Rammus,74,34,40,45.95
Elise,RekSai,77,24,53,31.17
Elise,Corki,125,67,58,53.6
Elise,Anivia,106,39,67,36.79
Jayce,Tryndamere,106,46,60,43.4
Jayce,Gragas,168,70,98,41.67
Jayce,Irelia,266,140,126,52.63
Jayce,Kalista,171,74,97,43.27
Jayce,Twitch,235,133,102,56.6
Jayce,DrMundo,201,84,117,41.79
Jayce,Shaco,282,126,156,44.68
Jayce,Leblanc,98,52,46,53.06
Jayce,Xayah,197,89,108,45.18
Jayce,Karma,155,75,80,48.39
Jayce,Akali,211,86,125,40.76
Jayce,Naafiri,98,36,62,36.73
Jayce,Kayle,174,90,84,51.72
Jayce,MissFortune,412,183,229,44.42
Jayce,Smolder,181,79,102,43.65
Jayce,Trundle,164,75,89,45.73
Jayce,Ahri,335,125,210,37.31
Jayce,Ashe,515,266,249,51.65
Jayce,Nami,254,72,182,28.35
Jayce,TahmKench,276,111,165,40.22
Jayce,Jax,237,97,140,40.93
Jayce,Malzahar,230,91,139,39.57
Jayce,Jinx,554,246,308,44.4
Jayce,Mordekaiser,329,130,199,39.51
Jayce,Sett,368,153,215,41.58
Jayce,LeeSin,275,127,148,46.18
Jayce,Nasus,199,67,132,33.67
Jayce,Kaisa,332,136,196,40.96
Jayce,Bard,66,20,46,30.3
Jayce,Gangplank,153,87,66,56.86
Jayce,Rengar,119,68,51,57.14
Jayce,Yasuo,536,195,341,36.38
Jayce,Kennen,100,46,54,46
Jayce,Aatrox,256,120,136,46.88
Jayce,Diana,360,127,233,35.28
Jayce,Mel,599,263,336,43.91
Jayce,Rell,84,36,48,42.86
Jayce,Amumu,205,95,110,46.34
Jayce,Senna,227,114,113,50.22
Jayce,Yone,564,280,284,49.65
Jayce,Viego,276,124,152,44.93
Jayce,Ezreal,543,267,276,49.17
Jayce,Blitzcrank,154,79,75,51.3
Jayce,Morgana,313,119,194,38.02
Jayce,Vi,239,140,99,58.58
Jayce,Yuumi,258,102,156,39.53
Jayce,Yorick,263,83,180,31.56
Jayce,Khazix,163,88,75,53.99
Jayce,Aurora,292,157,135,53.77
Jayce,Garen,378,140,238,37.04
Jayce,Varus,208,109,99,52.4
Jayce,Swain,262,143,119,54.58
Jayce,Darius,453,210,243,46.36
Jayce,Kayn,325,130,195,40
Jayce,Janna,82,33,49,40.24
Jayce,Talon,192,74,118,38.54
Jayce,Caitlyn,556,220,336,39.57
Jayce,Lillia,146,60,86,41.1
Jayce,Briar,242,115,127,47.52
Jayce,Veigar,226,99,127,43.81
Jayce,Viktor,172,72,100,41.86
Jayce,Kindred,173,77,96,44.51
Jayce,Katarina,195,115,80,58.97
Jayce,Aphelios,204,87,117,42.65
Jayce,Brand,147,69,78,46.94
Jayce,Renekton,74,32,42,43.24
Jayce,Warwick,379,179,200,47.23
Jayce,Gwen,106,43,63,40.57
Jayce,Tristana,192,110,82,57.29
Jayce,Illaoi,111,74,37,66.67
Jayce,Rammus,78,56,22,71.79
Jayce,Kled,44,21,23,47.73
Jayce,Alistar,91,42,49,46.15
Jayce,Pantheon,339,123,216,36.28
Jayce,MasterYi,275,132,143,48
Jayce,Ryze,76,28,48,36.84
Jayce,Pyke,277,141,136,50.9
Jayce,Galio,159,78,81,49.06
Jayce,Singed,104,53,51,50.96
Jayce,Lux,559,261,298,46.69
Jayce,AurelionSol,185,88,97,47.57
Jayce,Neeko,173,92,81,53.18
Jayce,Braum,101,48,53,47.52
Jayce,Nocturne,200,94,106,47
Jayce,Hwei,162,77,85,47.53
Jayce,Draven,132,45,87,34.09
Jayce,Graves,122,80,42,65.57
Jayce,Samira,234,105,129,44.87
Jayce,Thresh,357,180,177,50.42
Jayce,Seraphine,272,118,154,43.38
Jayce,Zac,109,52,57,47.71
Jayce,Shyvana,44,31,13,70.45
Jayce,Corki,73,28,45,38.36
Jayce,Elise,153,104,49,67.97
Jayce,Karthus,52,37,15,71.15
Jayce,Soraka,165,102,63,61.82
Jayce,Zyra,213,64,149,30.05
Jayce,Vayne,277,112,165,40.43
Jayce,Vladimir,164,85,79,51.83
Jayce,Jhin,499,231,268,46.29
Jayce,FiddleSticks,128,59,69,46.09
Jayce,Zeri,96,60,36,62.5
Jayce,Sylas,223,115,108,51.57
Jayce,Gnar,142,63,79,44.37
Jayce,Zed,262,103,159,39.31
Jayce,Maokai,137,22,115,16.06
Jayce,Teemo,389,200,189,51.41
Jayce,Syndra,120,63,57,52.5
Jayce,Zoe,133,56,77,42.11
Jayce,Fiora,110,43,67,39.09
Jayce,Volibear,243,120,123,49.38
Jayce,Sion,169,88,81,52.07
Jayce,Taric,89,37,52,41.57
Jayce,Quinn,110,46,64,41.82
Jayce,KSante,111,55,56,49.55
Jayce,Ornn,70,19,51,27.14
Jayce,Heimerdinger,180,32,148,17.78
Jayce,Malphite,210,81,129,38.57
Jayce,Lulu,281,141,140,50.18
Jayce,Ambessa,178,51,127,28.65
Jayce,Poppy,152,62,90,40.79
Jayce,Nautilus,285,114,171,40
Jayce,Lissandra,50,13,37,26
Jayce,Milio,115,49,66,42.61
Jayce,MonkeyKing,135,81,54,60
Jayce,Nilah,159,69,90,43.4
Jayce,Vex,151,53,98,35.1
Jayce,Chogath,335,158,177,47.16
Jayce,XinZhao,128,59,69,46.09
Jayce,TwistedFate,125,58,67,46.4
Jayce,Renata,44,31,13,70.45
Jayce,Riven,126,63,63,50
Jayce,Sejuani,131,56,75,42.75
Jayce,Orianna,154,98,56,63.64
Jayce,Camille,89,60,29,67.42
Jayce,Taliyah,91,41,50,45.05
Jayce,Azir,106,53,53,50
Jayce,Hecarim,88,54,34,61.36
Jayce,Olaf,73,32,41,43.84
Jayce,Leona,151,63,88,41.72
Jayce,Shen,131,37,94,28.24
Jayce,Annie,73,51,22,69.86
Jayce,Xerath,176,88,88,50
Jayce,Rakan,156,84,72,53.85
Jayce,Nunu,236,94,142,39.83
Jayce,Skarner,73,63,10,86.3
Jayce,Fizz,166,44,122,26.51
Jayce,Ivern,82,40,42,48.78
Jayce,Urgot,101,45,56,44.55
Jayce,Udyr,103,40,63,38.83
Jayce,Akshan,88,50,38,56.82
Jayce,Cassiopeia,102,65,37,63.73
Jayce,Ziggs,120,37,83,30.83
Jayce,Zilean,80,34,46,42.5
Jayce,Qiyana,117,67,50,57.26
Jayce,Lucian,145,69,76,47.59
Jayce,Velkoz,156,78,78,50
Jayce,JarvanIV,118,46,72,38.98
Jayce,Ekko,163,76,87,46.63
Jayce,KogMaw,78,46,32,58.97
Jayce,Sivir,129,54,75,41.86
Jayce,Anivia,104,49,55,47.12
Jayce,Sona,109,40,69,36.7
Jayce,Belveth,50,11,39,22
Jayce,Kassadin,22,16,6,72.73
Jayce,Evelynn,89,47,42,52.81
Jayce,Rumble,77,21,56,27.27
Jayce,Nidalee,103,45,58,43.69
Jayce,RekSai,34,24,10,70.59
Sion,Teemo,741,395,346,53.31
Sion,Amumu,502,222,280,44.22
Sion,Garen,658,305,353,46.35
Sion,KogMaw,196,85,111,43.37
Sion,Yuumi,440,198,242,45
Sion,Fiora,250,146,104,58.4
Sion,Kayn,728,351,377,48.21
Sion,Malzahar,343,181,162,52.77
Sion,Aphelios,419,239,180,57.04
Sion,Zilean,138,98,40,71.01
Sion,KSante,190,123,67,64.74
Sion,Udyr,239,99,140,41.42
Sion,Veigar,495,214,281,43.23
Sion,Ashe,867,498,369,57.44
Sion,Nautilus,483,261,222,54.04
Sion,Yasuo,772,430,342,55.7
Sion,Belveth,163,75,88,46.01
Sion,Yone,946,481,465,50.85
Sion,Mordekaiser,642,326,316,50.78
Sion,Alistar,169,86,83,50.89
Sion,Poppy,281,137,144,48.75
Sion,Khazix,321,197,124,61.37
Sion,Irelia,433,228,205,52.66
Sion,Tristana,459,267,192,58.17
Sion,Neeko,400,241,159,60.25
Sion,Gnar,222,128,94,57.66
Sion,Volibear,480,221,259,46.04
Sion,Mel,1102,624,478,56.62
Sion,Samira,476,263,213,55.25
Sion,Seraphine,534,327,207,61.24
Sion,Nasus,352,175,177,49.72
Sion,Pantheon,788,409,379,51.9
Sion,Zoe,241,142,99,58.92
Sion,Senna,439,230,209,52.39
Sion,TahmKench,589,276,313,46.86
Sion,Jax,348,174,174,50
Sion,Jinx,939,475,464,50.59
Sion,Akali,549,296,253,53.92
Sion,Zac,213,101,112,47.42
Sion,Diana,625,306,319,48.96
Sion,Vayne,546,280,266,51.28
Sion,Caitlyn,1011,542,469,53.61
Sion,Ornn,244,89,155,36.48
Sion,Shaco,393,264,129,67.18
Sion,Hwei,376,189,187,50.27
Sion,Karma,392,224,168,57.14
Sion,Singed,163,50,113,30.67
Sion,Kindred,231,160,71,69.26
Sion,Katarina,401,228,173,56.86
Sion,Kaisa,665,347,318,52.18
Sion,Morgana,543,298,245,54.88
Sion,Illaoi,230,113,117,49.13
Sion,Jhin,891,455,436,51.07
Sion,Leona,342,167,175,48.83
Sion,Darius,1011,529,482,52.32
Sion,Ekko,375,203,172,54.13
Sion,Nami,544,299,245,54.96
Sion,Viego,641,341,300,53.2
Sion,Ezreal,836,482,354,57.66
Sion,Blitzcrank,406,227,179,55.91
Sion,Braum,227,111,116,48.9
Sion,Talon,367,224,143,61.04
Sion,Galio,356,149,207,41.85
Sion,Lucian,284,121,163,42.61
Sion,Milio,332,183,149,55.12
Sion,Briar,465,265,200,56.99
Sion,Annie,136,51,85,37.5
Sion,Xerath,341,136,205,39.88
Sion,Thresh,682,410,272,60.12
Sion,Warwick,795,359,436,45.16
Sion,Kalista,169,106,63,62.72
Sion,Skarner,167,111,56,66.47
Sion,Lillia,356,189,167,53.09
Sion,Lulu,454,241,213,53.08
Sion,Renekton,183,110,73,60.11
Sion,Gragas,296,168,128,56.76
Sion,Viktor,348,153,195,43.97
Sion,MasterYi,534,276,258,51.69
Sion,Taliyah,177,122,55,68.93
Sion,Smolder,428,207,221,48.36
Sion,Graves,256,154,102,60.16
Sion,Lux,1204,599,605,49.75
Sion,Soraka,306,144,162,47.06
Sion,DrMundo,222,90,132,40.54
Sion,Rengar,175,121,54,69.14
Sion,LeeSin,458,258,200,56.33
Sion,Zed,497,295,202,59.36
Sion,MissFortune,982,572,410,58.25
Sion,Vi,429,205,224,47.79
Sion,Ryze,157,89,68,56.69
Sion,Janna,214,88,126,41.12
Sion,Vladimir,316,168,148,53.16
Sion,Draven,297,143,154,48.15
Sion,Swain,520,249,271,47.88
Sion,Aurora,486,261,225,53.7
Sion,Yorick,414,203,211,49.03
Sion,Sett,803,390,413,48.57
Sion,Varus,397,210,187,52.9
Sion,Gwen,416,219,197,52.64
Sion,AurelionSol,238,129,109,54.2
Sion,Sona,132,64,68,48.48
Sion,Malphite,316,153,163,48.42
Sion,Qiyana,197,115,82,58.38
Sion,Ambessa,223,96,127,43.05
Sion,Vex,383,216,167,56.4
Sion,Pyke,537,320,217,59.59
Sion,Trundle,295,144,151,48.81
Sion,Zyra,335,179,156,53.43
Sion,Syndra,258,109,149,42.25
Sion,Shyvana,123,49,74,39.84
Sion,Nunu,403,230,173,57.07
Sion,Nidalee,171,103,68,60.23
Sion,Sejuani,184,80,104,43.48
Sion,Lissandra,145,66,79,45.52
Sion,Aatrox,561,274,287,48.84
Sion,Twitch,488,220,268,45.08
Sion,Shen,410,182,228,44.39
Sion,Riven,278,181,97,65.11
Sion,Xayah,335,177,158,52.84
Sion,Rakan,303,157,146,51.82
Sion,Azir,180,104,76,57.78
Sion,Gangplank,280,174,106,62.14
Sion,Elise,292,170,122,58.22
Sion,Ziggs,152,62,90,40.79
Sion,Leblanc,200,95,105,47.5
Sion,JarvanIV,205,96,109,46.83
Sion,Corki,183,71,112,38.8
Sion,Akshan,187,105,82,56.15
Sion,XinZhao,267,113,154,42.32
Sion,Bard,174,40,134,22.99
Sion,Fizz,258,124,134,48.06
Sion,Sylas,461,225,236,48.81
Sion,Orianna,209,123,86,58.85
Sion,Quinn,164,71,93,43.29
Sion,Ivern,90,51,39,56.67
Sion,Maokai,255,144,111,56.47
Sion,Sivir,229,100,129,43.67
Sion,Ahri,612,325,287,53.1
Sion,Chogath,665,309,356,46.47
Sion,Karthus,114,78,36,68.42
Sion,Brand,278,155,123,55.76
Sion,Nilah,282,157,125,55.67
Sion,Tryndamere,346,203,143,58.67
Sion,TwistedFate,170,91,79,53.53
Sion,Cassiopeia,215,125,90,58.14
Sion,FiddleSticks,233,94,139,40.34
Sion,MonkeyKing,210,116,94,55.24
Sion,Anivia,214,118,96,55.14
Sion,Jayce,169,81,88,47.93
Sion,Camille,165,109,56,66.06
Sion,Rell,235,122,113,51.91
Sion,Heimerdinger,273,125,148,45.79
Sion,Naafiri,174,100,74,57.47
Sion,Nocturne,384,205,179,53.39
Sion,Velkoz,316,175,141,55.38
Sion,Evelynn,271,154,117,56.83
Sion,Kayle,325,172,153,52.92
Sion,Hecarim,166,108,58,65.06
Sion,Kassadin,111,79,32,71.17
Sion,Urgot,250,147,103,58.8
Sion,Zeri,256,110,146,42.97
Sion,Taric,100,43,57,43
Sion,Rumble,66,38,28,57.58
Sion,RekSai,99,40,59,40.4
Sion,Rammus,132,62,70,46.97
Sion,Olaf,67,45,22,67.16
Sion,Renata,121,65,56,53.72
Sion,Kennen,158,81,77,51.27
Sion,Kled,108,74,34,68.52
Shyvana,KSante,74,35,39,47.3
Shyvana,Kayn,242,169,73,69.83
Shyvana,Yasuo,280,166,114,59.29
Shyvana,MissFortune,303,145,158,47.85
Shyvana,Lux,458,221,237,48.25
Shyvana,Garen,277,177,100,63.9
Shyvana,Zed,123,91,32,73.98
Shyvana,Talon,89,63,26,70.79
Shyvana,Ashe,258,173,85,67.05
Shyvana,Milio,93,54,39,58.06
Shyvana,Aurora,170,104,66,61.18
Shyvana,Briar,172,73,99,42.44
Shyvana,Fizz,118,66,52,55.93
Shyvana,Jinx,408,196,212,48.04
Shyvana,Soraka,119,54,65,45.38
Shyvana,Vladimir,71,38,33,53.52
Shyvana,Ekko,109,67,42,61.47
Shyvana,Qiyana,43,22,21,51.16
Shyvana,Twitch,142,64,78,45.07
Shyvana,Senna,155,72,83,46.45
Shyvana,Fiora,81,32,49,39.51
Shyvana,Amumu,188,104,84,55.32
Shyvana,Samira,122,68,54,55.74
Shyvana,Seraphine,232,138,94,59.48
Shyvana,Darius,347,150,197,43.23
Shyvana,Gragas,128,85,43,66.41
Shyvana,Veigar,155,79,76,50.97
Shyvana,KogMaw,88,47,41,53.41
Shyvana,Thresh,195,111,84,56.92
Shyvana,Evelynn,119,56,63,47.06
Shyvana,Tristana,185,79,106,42.7
Shyvana,Sylas,104,48,56,46.15
Shyvana,Mordekaiser,336,195,141,58.04
Shyvana,Nidalee,60,37,23,61.67
Shyvana,Orianna,99,48,51,48.48
Shyvana,Caitlyn,388,243,145,62.63
Shyvana,Yuumi,193,107,86,55.44
Shyvana,Volibear,231,119,112,51.52
Shyvana,Yone,344,191,153,55.52
Shyvana,Lulu,133,50,83,37.59
Shyvana,Sett,274,127,147,46.35
Shyvana,Shaco,163,103,60,63.19
Shyvana,Mel,348,200,148,57.47
Shyvana,Graves,74,55,19,74.32
Shyvana,Kayle,149,108,41,72.48
Shyvana,Ezreal,291,162,129,55.67
Shyvana,Malzahar,162,88,74,54.32
Shyvana,Warwick,254,129,125,50.79
Shyvana,Teemo,238,128,110,53.78
Shyvana,Hecarim,75,35,40,46.67
Shyvana,Vayne,151,86,65,56.95
Shyvana,Chogath,156,81,75,51.92
Shyvana,Ambessa,111,58,53,52.25
Shyvana,Aphelios,120,63,57,52.5
Shyvana,Velkoz,92,64,28,69.57
Shyvana,RekSai,31,10,21,32.26
Shyvana,LeeSin,184,86,98,46.74
Shyvana,Nilah,106,54,52,50.94
Shyvana,Poppy,115,81,34,70.43
Shyvana,Galio,147,75,72,51.02
Shyvana,Yorick,179,92,87,51.4
Shyvana,Viktor,96,48,48,50
Shyvana,Zoe,104,55,49,52.88
Shyvana,Anivia,90,56,34,62.22
Shyvana,Camille,70,50,20,71.43
Shyvana,Zac,76,42,34,55.26
Shyvana,Morgana,220,132,88,60
Shyvana,Varus,131,84,47,64.12
Shyvana,Sion,123,74,49,60.16
Shyvana,Karma,86,38,48,44.19
Shyvana,Rakan,110,53,57,48.18
Shyvana,Gangplank,103,47,56,45.63
Shyvana,Kalista,92,61,31,66.3
Shyvana,Sejuani,46,32,14,69.57
Shyvana,Leblanc,62,41,21,66.13
Shyvana,Swain,205,116,89,56.59
Shyvana,Lillia,137,70,67,51.09
Shyvana,Draven,124,55,69,44.35
Shyvana,Leona,114,43,71,37.72
Shyvana,TahmKench,119,70,49,58.82
Shyvana,Akali,162,88,74,54.32
Shyvana,Kaisa,185,124,61,67.03
Shyvana,Braum,48,27,21,56.25
Shyvana,Nasus,103,56,47,54.37
Shyvana,Nunu,132,60,72,45.45
Shyvana,Pyke,221,112,109,50.68
Shyvana,FiddleSticks,64,23,41,35.94
Shyvana,Lucian,102,25,77,24.51
Shyvana,Blitzcrank,157,97,60,61.78
Shyvana,Khazix,115,91,24,79.13
Shyvana,Zyra,81,22,59,27.16
Shyvana,Gwen,111,48,63,43.24
Shyvana,Diana,243,150,93,61.73
Shyvana,Riven,54,30,24,55.56
Shyvana,Jax,148,85,63,57.43
Shyvana,Malphite,123,68,55,55.28
Shyvana,Pantheon,301,175,126,58.14
Shyvana,Renekton,67,45,22,67.16
Shyvana,Ahri,188,90,98,47.87
Shyvana,Ziggs,101,61,40,60.4
Shyvana,Heimerdinger,106,72,34,67.92
Shyvana,Jhin,262,144,118,54.96
Shyvana,Jayce,44,13,31,29.55
Shyvana,Akshan,52,15,37,28.85
Shyvana,Corki,65,34,31,52.31
Shyvana,Skarner,79,51,28,64.56
Shyvana,Xerath,127,59,68,46.46
Shyvana,Shen,121,47,74,38.84
Shyvana,Sivir,94,41,53,43.62
Shyvana,Maokai,59,11,48,18.64
Shyvana,Nautilus,183,111,72,60.66
Shyvana,Kindred,75,53,22,70.67
Shyvana,Rell,91,65,26,71.43
Shyvana,Lissandra,58,32,26,55.17
Shyvana,Elise,126,73,53,57.94
Shyvana,Renata,23,9,14,39.13
Shyvana,Viego,205,120,85,58.54
Shyvana,Xayah,110,72,38,65.45
Shyvana,Azir,47,36,11,76.6
Shyvana,Ornn,54,30,24,55.56
Shyvana,Gnar,85,44,41,51.76
Shyvana,Neeko,153,84,69,54.9
Shyvana,Taric,23,17,6,73.91
Shyvana,Rengar,58,27,31,46.55
Shyvana,Vex,83,32,51,38.55
Shyvana,Aatrox,103,86,17,83.5
Shyvana,Katarina,169,124,45,73.37
Shyvana,Quinn,96,52,44,54.17
Shyvana,MonkeyKing,119,75,44,63.03
Shyvana,Irelia,155,67,88,43.23
Shyvana,Smolder,171,78,93,45.61
Shyvana,Rammus,72,47,25,65.28
Shyvana,TwistedFate,51,33,18,64.71
Shyvana,Annie,58,45,13,77.59
Shyvana,Nami,145,81,64,55.86
Shyvana,Trundle,51,26,25,50.98
Shyvana,JarvanIV,68,33,35,48.53
Shyvana,Zilean,47,6,41,12.77
Shyvana,Naafiri,122,79,43,64.75
Shyvana,Vi,79,43,36,54.43
Shyvana,Cassiopeia,57,43,14,75.44
Shyvana,Hwei,125,74,51,59.2
Shyvana,Belveth,53,35,18,66.04
Shyvana,Kassadin,35,20,15,57.14
Shyvana,Nocturne,114,41,73,35.96
Shyvana,Brand,81,52,29,64.2
Shyvana,Ivern,45,23,22,51.11
Shyvana,Taliyah,67,39,28,58.21
Shyvana,Tryndamere,84,56,28,66.67
Shyvana,Syndra,123,79,44,64.23
Shyvana,Bard,44,31,13,70.45
Shyvana,DrMundo,95,40,55,42.11
Shyvana,Udyr,55,34,21,61.82
Shyvana,Zeri,65,18,47,27.69
Shyvana,MasterYi,143,70,73,48.95
Shyvana,XinZhao,134,64,70,47.76
Shyvana,Rumble,36,20,16,55.56
Shyvana,Kennen,69,30,39,43.48
Shyvana,Janna,47,19,28,40.43
Shyvana,Urgot,72,33,39,45.83
Shyvana,Alistar,63,53,10,84.13
Shyvana,Singed,30,0,30,0
Shyvana,AurelionSol,87,58,29,66.67
Shyvana,Ryze,36,13,23,36.11
Shyvana,Kled,28,8,20,28.57
Shyvana,Illaoi,85,24,61,28.24
Shyvana,Sona,74,38,36,51.35
Shyvana,Karthus,57,36,21,63.16
Shyvana,Olaf,26,6,20,23.08
Quinn,Naafiri,118,75,43,63.56
Quinn,Volibear,165,82,83,49.7
Quinn,Lux,536,267,269,49.81
Quinn,Ashe,375,187,188,49.87
Quinn,Soraka,126,53,73,42.06
Quinn,Jax,162,92,70,56.79
Quinn,FiddleSticks,111,60,51,54.05
Quinn,Cassiopeia,70,35,35,50
Quinn,Caitlyn,484,248,236,51.24
Quinn,Milio,167,75,92,44.91
Quinn,Nasus,116,57,59,49.14
Quinn,Kindred,97,44,53,45.36
Quinn,Malzahar,152,79,73,51.97
Quinn,Tristana,199,117,82,58.79
Quinn,Nautilus,193,98,95,50.78
Quinn,Yone,299,142,157,47.49
Quinn,Graves,136,76,60,55.88
Quinn,Akali,277,160,117,57.76
Quinn,Zeri,82,43,39,52.44
Quinn,Taric,84,51,33,60.71
Quinn,Malphite,271,118,153,43.54
Quinn,Ivern,38,17,21,44.74
Quinn,Yasuo,314,113,201,35.99
Quinn,Jhin,388,212,176,54.64
Quinn,Pyke,262,116,146,44.27
Quinn,KSante,74,27,47,36.49
Quinn,Darius,404,200,204,49.5
Quinn,Sylas,201,58,143,28.86
Quinn,Mel,476,251,225,52.73
Quinn,Pantheon,340,161,179,47.35
Quinn,Warwick,329,159,170,48.33
Quinn,Viego,252,112,140,44.44
Quinn,Ornn,80,34,46,42.5
Quinn,Shaco,262,137,125,52.29
Quinn,Irelia,170,83,87,48.82
Quinn,Evelynn,111,54,57,48.65
Quinn,Rammus,86,38,48,44.19
Quinn,Hwei,126,85,41,67.46
Quinn,Lulu,158,72,86,45.57
Quinn,Teemo,358,152,206,42.46
Quinn,Ahri,301,155,146,51.5
Quinn,Yuumi,207,114,93,55.07
Quinn,Aurora,228,96,132,42.11
Quinn,KogMaw,72,29,43,40.28
Quinn,Kayle,151,68,83,45.03
Quinn,LeeSin,263,138,125,52.47
Quinn,Vex,117,75,42,64.1
Quinn,MissFortune,527,250,277,47.44
Quinn,Kalista,70,29,41,41.43
Quinn,Vi,169,76,93,44.97
Quinn,Talon,148,76,72,51.35
Quinn,Briar,268,133,135,49.63
Quinn,Zoe,129,60,69,46.51
Quinn,Singed,52,22,30,42.31
Quinn,Ezreal,373,204,169,54.69
Quinn,Velkoz,152,64,88,42.11
Quinn,Ambessa,112,57,55,50.89
Quinn,Lissandra,55,35,20,63.64
Quinn,Samira,156,76,80,48.72
Quinn,Thresh,268,159,109,59.33
Quinn,Rakan,100,59,41,59
Quinn,Morgana,282,153,129,54.26
Quinn,DrMundo,148,84,64,56.76
Quinn,Mordekaiser,316,140,176,44.3
Quinn,Seraphine,247,125,122,50.61
Quinn,Vladimir,98,42,56,42.86
Quinn,Sett,376,157,219,41.76
Quinn,Nami,173,89,84,51.45
Quinn,Nocturne,175,104,71,59.43
Quinn,Aphelios,133,62,71,46.62
Quinn,Karma,121,69,52,57.02
Quinn,Gnar,81,48,33,59.26
Quinn,Qiyana,76,52,24,68.42
Quinn,Diana,228,97,131,42.54
Quinn,Zilean,53,15,38,28.3
Quinn,Renekton,115,51,64,44.35
Quinn,Twitch,206,114,92,55.34
Quinn,Braum,94,58,36,61.7
Quinn,Zed,275,169,106,61.45
Quinn,MasterYi,207,113,94,54.59
Quinn,Elise,124,84,40,67.74
Quinn,Vayne,210,104,106,49.52
Quinn,Gragas,141,47,94,33.33
Quinn,Udyr,75,56,19,74.67
Quinn,Poppy,149,51,98,34.23
Quinn,Swain,216,107,109,49.54
Quinn,Sejuani,45,23,22,51.11
Quinn,Kennen,89,48,41,53.93
Quinn,Kayn,340,184,156,54.12
Quinn,Veigar,174,84,90,48.28
Quinn,Varus,190,87,103,45.79
Quinn,Senna,171,95,76,55.56
Quinn,Gangplank,97,43,54,44.33
Quinn,Garen,354,177,177,50
Quinn,Rengar,125,83,42,66.4
Quinn,Smolder,212,137,75,64.62
Quinn,Skarner,94,62,32,65.96
Quinn,Jinx,412,202,210,49.03
Quinn,Yorick,189,89,100,47.09
Quinn,TwistedFate,69,41,28,59.42
Quinn,Leona,147,74,73,50.34
Quinn,Heimerdinger,146,50,96,34.25
Quinn,Khazix,124,45,79,36.29
Quinn,Janna,82,31,51,37.8
Quinn,Brand,162,85,77,52.47
Quinn,Ekko,163,65,98,39.88
Quinn,Nidalee,59,33,26,55.93
Quinn,Lucian,91,55,36,60.44
Quinn,Chogath,270,160,110,59.26
Quinn,Aatrox,189,83,106,43.92
Quinn,Nunu,172,81,91,47.09
Quinn,Belveth,52,27,25,51.92
Quinn,Urgot,94,16,78,17.02
Quinn,Sion,164,93,71,56.71
Quinn,Draven,170,92,78,54.12
Quinn,Hecarim,55,22,33,40
Quinn,Annie,52,40,12,76.92
Quinn,Bard,115,40,75,34.78
Quinn,Galio,170,69,101,40.59
Quinn,Amumu,188,75,113,39.89
Quinn,Neeko,186,112,74,60.22
Quinn,Azir,80,30,50,37.5
Quinn,Shen,88,55,33,62.5
Quinn,Fiora,103,60,43,58.25
Quinn,Camille,55,24,31,43.64
Quinn,Katarina,226,91,135,40.27
Quinn,Fizz,93,65,28,69.89
Quinn,Sona,50,18,32,36
Quinn,Anivia,47,24,23,51.06
Quinn,Leblanc,97,58,39,59.79
Quinn,Illaoi,94,47,47,50
Quinn,TahmKench,215,109,106,50.7
Quinn,Jayce,110,64,46,58.18
Quinn,Viktor,146,88,58,60.27
Quinn,Nilah,113,68,45,60.18
Quinn,Kaisa,339,124,215,36.58
Quinn,MonkeyKing,113,45,68,39.82
Quinn,Orianna,107,87,20,81.31
Quinn,Sivir,102,36,66,35.29
Quinn,Akshan,83,28,55,33.73
Quinn,Zac,67,39,28,58.21
Quinn,Trundle,97,45,52,46.39
Quinn,XinZhao,99,32,67,32.32
Quinn,Syndra,87,39,48,44.83
Quinn,Alistar,93,46,47,49.46
Quinn,Kassadin,45,32,13,71.11
Quinn,Tryndamere,171,62,109,36.26
Quinn,Olaf,65,47,18,72.31
Quinn,Rell,97,51,46,52.58
Quinn,Renata,34,9,25,26.47
Quinn,Shyvana,96,44,52,45.83
Quinn,Zyra,154,79,75,51.3
Quinn,Gwen,167,113,54,67.66
Quinn,Maokai,79,42,37,53.16
Quinn,Blitzcrank,165,62,103,37.58
Quinn,Corki,86,40,46,46.51
Quinn,AurelionSol,88,27,61,30.68
Quinn,Xerath,131,52,79,39.69
Quinn,Riven,102,44,58,43.14
Quinn,Xayah,109,50,59,45.87
Quinn,Karthus,63,33,30,52.38
Quinn,Ziggs,61,41,20,67.21
Quinn,RekSai,36,36,0,100
Quinn,Kled,45,29,16,64.44
Quinn,Lillia,150,77,73,51.33
Quinn,Rumble,19,10,9,52.63
Quinn,Taliyah,58,12,46,20.69
Quinn,JarvanIV,91,40,51,43.96
Quinn,Ryze,61,22,39,36.07
Kled,Sett,213,80,133,37.56
Kled,Karthus,44,31,13,70.45
Kled,Zed,106,63,43,59.43
Kled,Ashe,247,116,131,46.96
Kled,Maokai,59,32,27,54.24
Kled,Nasus,75,31,44,41.33
Kled,Udyr,44,23,21,52.27
Kled,Jhin,252,105,147,41.67
Kled,Alistar,34,14,20,41.18
Kled,Yone,198,90,108,45.45
Kled,Khazix,76,45,31,59.21
Kled,Varus,83,30,53,36.14
Kled,Samira,128,74,54,57.81
Kled,Yuumi,110,62,48,56.36
Kled,Urgot,82,47,35,57.32
Kled,Shaco,145,44,101,30.34
Kled,Annie,31,6,25,19.35
Kled,Ezreal,213,151,62,70.89
Kled,Lux,327,192,135,58.72
Kled,Ornn,69,40,29,57.97
Kled,Yorick,139,61,78,43.88
Kled,Zoe,68,29,39,42.65
Kled,Blitzcrank,94,27,67,28.72
Kled,Pantheon,169,76,93,44.97
Kled,Trundle,108,34,74,31.48
Kled,Yasuo,185,71,114,38.38
Kled,Leona,93,45,48,48.39
Kled,Chogath,182,95,87,52.2
Kled,Nocturne,81,34,47,41.98
Kled,Cassiopeia,57,34,23,59.65
Kled,Soraka,77,51,26,66.23
Kled,Ambessa,72,41,31,56.94
Kled,Evelynn,33,22,11,66.67
Kled,Katarina,120,57,63,47.5
Kled,Jinx,234,128,106,54.7
Kled,Singed,33,0,33,0
Kled,MonkeyKing,92,50,42,54.35
Kled,Diana,172,93,79,54.07
Kled,MissFortune,289,125,164,43.25
Kled,Amumu,133,64,69,48.12
Kled,Skarner,47,23,24,48.94
Kled,Warwick,210,126,84,60
Kled,Xerath,62,26,36,41.94
Kled,Brand,68,43,25,63.24
Kled,Camille,30,12,18,40
Kled,Lillia,51,26,25,50.98
Kled,Leblanc,42,33,9,78.57
Kled,Renata,45,27,18,60
Kled,Kayn,187,115,72,61.5
Kled,Lissandra,59,20,39,33.9
Kled,Kalista,73,39,34,53.42
Kled,JarvanIV,68,34,34,50
Kled,Rumble,45,27,18,60
Kled,XinZhao,50,25,25,50
Kled,Smolder,46,34,12,73.91
Kled,Seraphine,152,72,80,47.37
Kled,Garen,184,125,59,67.93
Kled,Vayne,138,46,92,33.33
Kled,Thresh,161,72,89,44.72
Kled,Shen,130,75,55,57.69
Kled,Lucian,75,34,41,45.33
Kled,Senna,85,55,30,64.71
Kled,Qiyana,41,21,20,51.22
Kled,Velkoz,87,47,40,54.02
Kled,Teemo,208,104,104,50
Kled,Ziggs,62,23,39,37.1
Kled,Pyke,152,98,54,64.47
Kled,Aatrox,126,71,55,56.35
Kled,AurelionSol,69,24,45,34.78
Kled,Aphelios,93,50,43,53.76
Kled,Milio,61,34,27,55.74
Kled,Ahri,161,84,77,52.17
Kled,Lulu,90,50,40,55.56
Kled,Rakan,60,32,28,53.33
Kled,Poppy,81,39,42,48.15
Kled,Viego,147,66,81,44.9
Kled,Irelia,98,54,44,55.1
Kled,Mel,306,177,129,57.84
Kled,Zyra,79,34,45,43.04
Kled,Ryze,30,18,12,60
Kled,Belveth,33,33,0,100
Kled,Heimerdinger,81,29,52,35.8
Kled,Gangplank,48,28,20,58.33
Kled,Vex,60,35,25,58.33
Kled,KSante,48,39,9,81.25
Kled,Mordekaiser,211,77,134,36.49
Kled,Veigar,146,81,65,55.48
Kled,Riven,54,34,20,62.96
Kled,Talon,110,50,60,45.45
Kled,Sona,49,30,19,61.22
Kled,Kayle,103,60,43,58.25
Kled,LeeSin,105,47,58,44.76
Kled,Sylas,117,68,49,58.12
Kled,MasterYi,98,48,50,48.98
Kled,Sivir,43,19,24,44.19
Kled,Renekton,59,37,22,62.71
Kled,Sejuani,41,19,22,46.34
Kled,Ekko,111,65,46,58.56
Kled,Jayce,44,23,21,52.27
Kled,Kaisa,157,99,58,63.06
Kled,Vi,81,33,48,40.74
Kled,Rammus,47,17,30,36.17
Kled,Jax,85,33,52,38.82
Kled,Morgana,188,100,88,53.19
Kled,Darius,255,121,134,47.45
Kled,TwistedFate,40,24,16,60
Kled,Nami,139,69,70,49.64
Kled,Volibear,131,69,62,52.67
Kled,Hecarim,34,26,8,76.47
Kled,Kassadin,20,6,14,30
Kled,Orianna,43,24,19,55.81
Kled,Kennen,48,29,19,60.42
Kled,Elise,102,59,43,57.84
Kled,Nilah,72,43,29,59.72
Kled,Rengar,55,30,25,54.55
Kled,Tristana,165,71,94,43.03
Kled,Caitlyn,294,154,140,52.38
Kled,Anivia,19,12,7,63.16
Kled,Nunu,78,48,30,61.54
Kled,Braum,75,31,44,41.33
Kled,Kindred,94,61,33,64.89
Kled,Nautilus,121,47,74,38.84
Kled,Syndra,77,41,36,53.25
Kled,TahmKench,151,97,54,64.24
Kled,Twitch,115,45,70,39.13
Kled,Rell,46,24,22,52.17
Kled,DrMundo,103,37,66,35.92
Kled,Xayah,85,50,35,58.82
Kled,Briar,165,85,80,51.52
Kled,Neeko,72,28,44,38.89
Kled,Gragas,59,20,39,33.9
Kled,Tryndamere,79,45,34,56.96
Kled,Akshan,68,29,39,42.65
Kled,Malzahar,72,31,41,43.06
Kled,Draven,48,11,37,22.92
Kled,Olaf,22,22,0,100
Kled,Graves,35,22,13,62.86
Kled,Aurora,82,23,59,28.05
Kled,Malphite,79,21,58,26.58
Kled,Zeri,53,35,18,66.04
Kled,FiddleSticks,57,20,37,35.09
Kled,Viktor,95,50,45,52.63
Kled,RekSai,32,22,10,68.75
Kled,Ivern,33,23,10,69.7
Kled,Nidalee,32,13,19,40.63
Kled,Gnar,56,27,29,48.21
Kled,Fizz,67,29,38,43.28
Kled,Vladimir,41,20,21,48.78
Kled,Bard,22,3,19,13.64
Kled,Swain,127,65,62,51.18
Kled,Galio,70,41,29,58.57
Kled,Gwen,89,55,34,61.8
Kled,Taliyah,46,19,27,41.3
Kled,Corki,55,35,20,63.64
Kled,Akali,148,83,65,56.08
Kled,Illaoi,36,16,20,44.44
Kled,Sion,108,34,74,31.48
Kled,Fiora,71,43,28,60.56
Kled,Hwei,83,52,31,62.65
Kled,Naafiri,69,44,25,63.77
Kled,KogMaw,62,21,41,33.87
Kled,Zac,61,18,43,29.51
Kled,Quinn,45,16,29,35.56
Kled,Zilean,59,21,38,35.59
Kled,Shyvana,28,20,8,71.43
Kled,Azir,51,36,15,70.59
Kled,Karma,79,31,48,39.24
Kled,Janna,40,6,34,15
Kled,Taric,22,15,7,68.18
Rumble,Poppy,118,58,60,49.15
Rumble,Viego,155,62,93,40
Rumble,Zed,106,67,39,63.21
Rumble,Mel,261,145,116,55.56
Rumble,Lux,238,107,131,44.96
Rumble,Yorick,100,48,52,48
Rumble,Shaco,141,72,69,51.06
Rumble,Kalista,36,16,20,44.44
Rumble,Blitzcrank,44,29,15,65.91
Rumble,Sett,203,98,105,48.28
Rumble,Elise,59,37,22,62.71
Rumble,Katarina,99,58,41,58.59
Rumble,MissFortune,222,104,118,46.85
Rumble,Morgana,122,47,75,38.52
Rumble,Aatrox,144,63,81,43.75
Rumble,Rengar,39,15,24,38.46
Rumble,RekSai,24,9,15,37.5
Rumble,Twitch,79,41,38,51.9
Rumble,Sona,29,9,20,31.03
Rumble,Kayle,76,34,42,44.74
Rumble,Warwick,201,79,122,39.3
Rumble,Fizz,65,27,38,41.54
Rumble,Tristana,95,41,54,43.16
Rumble,Seraphine,112,47,65,41.96
Rumble,Mordekaiser,160,66,94,41.25
Rumble,Graves,60,42,18,70
Rumble,Yasuo,316,151,165,47.78
Rumble,Ezreal,236,141,95,59.75
Rumble,Maokai,40,7,33,17.5
Rumble,Kled,45,18,27,40
Rumble,Varus,104,41,63,39.42
Rumble,Ekko,72,43,29,59.72
Rumble,Thresh,168,96,72,57.14
Rumble,Yone,202,106,96,52.48
Rumble,LeeSin,141,62,79,43.97
Rumble,Vladimir,50,18,32,36
Rumble,Gangplank,66,29,37,43.94
Rumble,MasterYi,129,58,71,44.96
Rumble,Aurora,123,35,88,28.46
Rumble,Chogath,136,70,66,51.47
Rumble,Darius,246,108,138,43.9
Rumble,Evelynn,66,35,31,53.03
Rumble,Irelia,81,31,50,38.27
Rumble,Jhin,195,77,118,39.49
Rumble,Ivern,45,15,30,33.33
Rumble,Vex,57,31,26,54.39
Rumble,Shen,126,59,67,46.83
Rumble,Lissandra,45,15,30,33.33
Rumble,Soraka,91,28,63,30.77
Rumble,Kayn,188,87,101,46.28
Rumble,Akali,133,59,74,44.36
Rumble,Kaisa,165,106,59,64.24
Rumble,Briar,95,50,45,52.63
Rumble,Sivir,40,14,26,35
Rumble,JarvanIV,59,35,24,59.32
Rumble,Teemo,301,153,148,50.83
Rumble,Malzahar,83,35,48,42.17
Rumble,Aphelios,81,43,38,53.09
Rumble,Sylas,132,65,67,49.24
Rumble,Nasus,94,41,53,43.62
Rumble,Caitlyn,231,105,126,45.45
Rumble,Pantheon,232,88,144,37.93
Rumble,Alistar,61,30,31,49.18
Rumble,Lillia,56,38,18,67.86
Rumble,Jinx,281,158,123,56.23
Rumble,Swain,152,90,62,59.21
Rumble,Renekton,58,29,29,50
Rumble,Leona,88,42,46,47.73
Rumble,Illaoi,66,26,40,39.39
Rumble,Jax,73,38,35,52.05
Rumble,KogMaw,51,9,42,17.65
Rumble,Pyke,120,64,56,53.33
Rumble,Amumu,131,76,55,58.02
Rumble,Ryze,30,24,6,80
Rumble,Smolder,107,65,42,60.75
Rumble,Ashe,190,89,101,46.84
Rumble,Milio,99,39,60,39.39
Rumble,Nocturne,77,37,40,48.05
Rumble,Vayne,140,80,60,57.14
Rumble,Qiyana,78,43,35,55.13
Rumble,Rammus,34,15,19,44.12
Rumble,Ahri,172,59,113,34.3
Rumble,Rell,81,37,44,45.68
Rumble,Trundle,65,34,31,52.31
Rumble,Volibear,86,42,44,48.84
Rumble,Urgot,39,15,24,38.46
Rumble,Skarner,57,24,33,42.11
Rumble,Braum,41,13,28,31.71
Rumble,MonkeyKing,63,17,46,26.98
Rumble,Yuumi,130,66,64,50.77
Rumble,Fiora,31,17,14,54.84
Rumble,Syndra,62,27,35,43.55
Rumble,KSante,61,29,32,47.54
Rumble,Viktor,68,42,26,61.76
Rumble,Diana,157,69,88,43.95
Rumble,Gwen,74,50,24,67.57
Rumble,Xerath,156,65,91,41.67
Rumble,Samira,79,24,55,30.38
Rumble,Garen,140,50,90,35.71
Rumble,TahmKench,113,51,62,45.13
Rumble,Veigar,82,39,43,47.56
Rumble,Sion,66,28,38,42.42
Rumble,Kassadin,22,9,13,40.91
Rumble,Nunu,93,42,51,45.16
Rumble,Velkoz,51,17,34,33.33
Rumble,Talon,79,47,32,59.49
Rumble,XinZhao,66,29,37,43.94
Rumble,TwistedFate,45,19,26,42.22
Rumble,Bard,45,32,13,71.11
Rumble,Zeri,85,42,43,49.41
Rumble,Olaf,26,13,13,50
Rumble,Belveth,30,20,10,66.67
Rumble,Orianna,77,29,48,37.66
Rumble,Vi,92,48,44,52.17
Rumble,Xayah,76,40,36,52.63
Rumble,Naafiri,67,22,45,32.84
Rumble,Nami,98,52,46,53.06
Rumble,Gnar,53,35,18,66.04
Rumble,Azir,37,21,16,56.76
Rumble,Kindred,64,35,29,54.69
Rumble,Akshan,31,28,3,90.32
Rumble,Zyra,90,47,43,52.22
Rumble,Rakan,83,38,45,45.78
Rumble,Leblanc,83,48,35,57.83
Rumble,Sejuani,56,26,30,46.43
Rumble,Khazix,64,24,40,37.5
Rumble,Lulu,124,61,63,49.19
Rumble,Taric,32,27,5,84.38
Rumble,Tryndamere,31,16,15,51.61
Rumble,Nautilus,136,47,89,34.56
Rumble,Anivia,47,31,16,65.96
Rumble,Brand,55,19,36,34.55
Rumble,Singed,45,6,39,13.33
Rumble,Ziggs,51,16,35,31.37
Rumble,Udyr,53,31,22,58.49
Rumble,Shyvana,36,16,20,44.44
Rumble,DrMundo,81,28,53,34.57
Rumble,Heimerdinger,47,28,19,59.57
Rumble,Draven,79,32,47,40.51
Rumble,AurelionSol,53,39,14,73.58
Rumble,Ornn,64,35,29,54.69
Rumble,Galio,108,49,59,45.37
Rumble,Malphite,137,49,88,35.77
Rumble,Senna,100,43,57,43
Rumble,Hecarim,44,23,21,52.27
Rumble,FiddleSticks,73,33,40,45.21
Rumble,Karma,82,45,37,54.88
Rumble,Riven,72,45,27,62.5
Rumble,Zilean,40,26,14,65
Rumble,Quinn,19,9,10,47.37
Rumble,Nilah,47,31,16,65.96
Rumble,Nidalee,38,32,6,84.21
Rumble,Jayce,77,56,21,72.73
Rumble,Ambessa,72,37,35,51.39
Rumble,Lucian,85,41,44,48.24
Rumble,Janna,48,21,27,43.75
Rumble,Camille,26,20,6,76.92
Rumble,Kennen,24,18,6,75
Rumble,Hwei,55,29,26,52.73
Rumble,Gragas,67,30,37,44.78
Rumble,Neeko,55,38,17,69.09
Rumble,Corki,45,9,36,20
Rumble,Cassiopeia,29,19,10,65.52
Rumble,Karthus,21,6,15,28.57
Rumble,Zoe,33,14,19,42.42
Rumble,Annie,13,0,13,0
Rumble,Taliyah,32,12,20,37.5
Rumble,Zac,18,12,6,66.67
Rumble,Renata,26,17,9,65.38
