Name,Opponent,Games,Wins,Losses,WR
Sett,Malphite,767,352,415,45.89
Sett,Ekko,814,436,378,53.56
Sett,Hwei,739,427,312,57.78
Sett,Lucian,598,329,269,55.02
Sett,Maokai,549,269,280,49
Sett,Yorick,817,363,454,44.43
Sett,Viego,1260,710,550,56.35
Sett,Diana,1309,651,658,49.73
Sett,Seraphine,1115,612,503,54.89
Sett,Rakan,536,261,275,48.69
Sett,Gwen,713,436,277,61.15
Sett,JarvanIV,371,192,179,51.75
Sett,Yone,2215,1160,1055,52.37
Sett,Zyra,601,305,296,50.75
Sett,Kayle,742,379,363,51.08
Sett,MonkeyKing,455,233,222,51.21
Sett,RekSai,93,67,26,72.04
Sett,Warwick,1722,841,881,48.84
Sett,Briar,1002,545,457,54.39
Sett,Yasuo,1950,947,1003,48.56
Sett,Irelia,901,498,403,55.27
Sett,Lux,2816,1430,1386,50.78
Sett,Pantheon,1657,862,795,52.02
Sett,Kayn,1566,884,682,56.45
Sett,Leblanc,284,132,152,46.48
Sett,Sivir,425,166,259,39.06
Sett,Pyke,1174,655,519,55.79
Sett,Braum,428,202,226,47.2
Sett,XinZhao,544,246,298,45.22
Sett,Chogath,1479,864,615,58.42
Sett,Taliyah,254,127,127,50
Sett,Darius,2075,1090,985,52.53
Sett,Volibear,1129,515,614,45.62
Sett,Ezreal,1500,830,670,55.33
Sett,Brand,674,343,331,50.89
Sett,Singed,261,148,113,56.7
Sett,Ryze,262,128,134,48.85
Sett,Samira,1018,564,454,55.4
Sett,Soraka,515,269,246,52.23
Sett,KSante,384,229,155,59.64
Sett,Azir,396,207,189,52.27
Sett,Aphelios,598,345,253,57.69
Sett,Gnar,468,246,222,52.56
Sett,Nunu,825,474,351,57.45
Sett,Jhin,1739,910,829,52.33
Sett,Shaco,1046,540,506,51.63
Sett,Ahri,1489,777,712,52.18
Sett,Ashe,1757,901,856,51.28
Sett,Poppy,611,316,295,51.72
Sett,Nami,1006,522,484,51.89
Sett,Fiora,482,273,209,56.64
Sett,Malzahar,797,355,442,44.54
Sett,Zilean,293,166,127,56.66
Sett,Mel,2002,1045,957,52.2
Sett,Tristana,974,508,466,52.16
Sett,Camille,346,163,183,47.11
Sett,MasterYi,1182,618,564,52.28
Sett,LeeSin,890,479,411,53.82
Sett,Riven,453,245,208,54.08
Sett,Jax,845,462,383,54.67
Sett,Naafiri,461,249,212,54.01
Sett,MissFortune,2253,1106,1147,49.09
Sett,Nocturne,882,434,448,49.21
Sett,Aatrox,1014,535,479,52.76
Sett,Swain,1015,416,599,40.99
Sett,Jinx,2024,1027,997,50.74
Sett,Ambessa,616,338,278,54.87
Sett,Nilah,556,327,229,58.81
Sett,Kled,207,127,80,61.35
Sett,Leona,836,422,414,50.48
Sett,Nasus,761,330,431,43.36
Sett,Kindred,652,386,266,59.2
Sett,Nautilus,1054,579,475,54.93
Sett,Elise,594,338,256,56.9
Sett,Garen,1422,635,787,44.66
Sett,Senna,811,442,369,54.5
Sett,Illaoi,583,278,305,47.68
Sett,Sylas,959,500,459,52.14
Sett,Cassiopeia,365,198,167,54.25
Sett,Caitlyn,2384,1309,1075,54.91
Sett,Teemo,1253,628,625,50.12
Sett,Mordekaiser,1814,833,981,45.92
Sett,Sejuani,390,212,178,54.36
Sett,Alistar,350,161,189,46
Sett,Lulu,733,392,341,53.48
Sett,DrMundo,768,339,429,44.14
Sett,Viktor,697,329,368,47.2
Sett,Rammus,278,133,145,47.84
Sett,Fizz,449,224,225,49.89
Sett,TahmKench,1061,563,498,53.06
Sett,Jayce,356,212,144,59.55
Sett,Skarner,313,153,160,48.88
Sett,Veigar,1019,495,524,48.58
Sett,Karma,638,314,324,49.22
Sett,AurelionSol,452,204,248,45.13
Sett,Kalista,437,228,209,52.17
Sett,Talon,601,343,258,57.07
Sett,Evelynn,495,257,238,51.92
Sett,Graves,557,296,261,53.14
Sett,Twitch,800,451,349,56.38
Sett,Kaisa,1288,663,625,51.48
Sett,Taric,214,97,117,45.33
Sett,Aurora,894,530,364,59.28
Sett,Zeri,426,226,200,53.05
Sett,Vayne,974,444,530,45.59
Sett,Draven,544,295,249,54.23
Sett,Vex,628,294,334,46.82
Sett,Gragas,585,340,245,58.12
Sett,Annie,351,227,124,64.67
Sett,Ornn,397,209,188,52.64
Sett,Zed,940,559,381,59.47
Sett,Ivern,237,113,124,47.68
Sett,Yuumi,1020,555,465,54.41
Sett,Rumble,182,96,86,52.75
Sett,Akshan,289,162,127,56.06
Sett,Sona,367,179,188,48.77
Sett,Morgana,1273,607,666,47.68
Sett,Ziggs,451,241,210,53.44
Sett,Akali,1025,570,455,55.61
Sett,Shen,671,341,330,50.82
Sett,Khazix,579,311,268,53.71
Sett,Varus,856,430,426,50.23
Sett,Thresh,1170,654,516,55.9
Sett,Blitzcrank,750,400,350,53.33
Sett,Urgot,531,260,271,48.96
Sett,Anivia,402,197,205,49
Sett,Gangplank,358,231,127,64.53
Sett,Bard,348,173,175,49.71
Sett,Kennen,405,235,170,58.02
Sett,TwistedFate,350,205,145,58.57
Sett,Qiyana,362,249,113,68.78
Sett,Zoe,397,251,146,63.22
Sett,Milio,472,235,237,49.79
Sett,Rell,621,318,303,51.21
Sett,Vladimir,524,292,232,55.73
Sett,FiddleSticks,577,279,298,48.35
Sett,Hecarim,300,169,131,56.33
Sett,Shyvana,271,144,127,53.14
Sett,Smolder,794,469,325,59.07
Sett,Neeko,730,434,296,59.45
Sett,Heimerdinger,595,283,312,47.56
Sett,Zac,292,153,139,52.4
Sett,Katarina,1019,575,444,56.43
Sett,Syndra,501,243,258,48.5
Sett,Udyr,364,182,182,50
Sett,Xayah,692,390,302,56.36
Sett,Vi,908,437,471,48.13
Sett,Tryndamere,526,278,248,52.85
Sett,Orianna,378,198,180,52.38
Sett,Kassadin,208,75,133,36.06
Sett,Karthus,268,140,128,52.24
Sett,Galio,687,318,369,46.29
Sett,Sion,779,404,375,51.86
Sett,Rengar,437,274,163,62.7
Sett,Corki,271,171,100,63.1
Sett,Renekton,535,319,216,59.63
Sett,Xerath,775,403,372,52
Sett,Trundle,565,252,313,44.6
Sett,Lillia,611,285,326,46.64
Sett,Quinn,370,219,151,59.19
Sett,Amumu,1011,431,580,42.63
Sett,Lissandra,217,105,112,48.39
Sett,Olaf,225,132,93,58.67
Sett,Nidalee,200,102,98,51
Sett,Renata,168,116,52,69.05
Sett,Janna,245,143,102,58.37
Sett,Velkoz,610,314,296,51.48
Sett,KogMaw,333,158,175,47.45
Sett,Belveth,309,189,120,61.17
Warwick,Malphite,709,338,371,47.67
Warwick,Ekko,790,389,401,49.24
Warwick,Hwei,616,273,343,44.32
Warwick,Lucian,490,260,230,53.06
Warwick,Maokai,387,202,185,52.2
Warwick,Aatrox,882,493,389,55.9
Warwick,Sylas,920,497,423,54.02
Warwick,Diana,1318,803,515,60.93
Warwick,Varus,767,441,326,57.5
Warwick,Blitzcrank,654,430,224,65.75
Warwick,Vladimir,441,240,201,54.42
Warwick,Darius,1940,1003,937,51.7
Warwick,Lux,2537,1253,1284,49.39
Warwick,KogMaw,337,166,171,49.26
Warwick,Yuumi,840,422,418,50.24
Warwick,Illaoi,528,318,210,60.23
Warwick,Nunu,810,423,387,52.22
Warwick,Irelia,879,483,396,54.95
Warwick,Jhin,1853,941,912,50.78
Warwick,Swain,1132,638,494,56.36
Warwick,Mordekaiser,1706,854,852,50.06
Warwick,Viego,1213,629,584,51.85
Warwick,MonkeyKing,520,282,238,54.23
Warwick,Kayn,1645,935,710,56.84
Warwick,Yasuo,1828,914,914,50
Warwick,Kaisa,1254,689,565,54.94
Warwick,Milio,545,257,288,47.16
Warwick,Yone,1847,1032,815,55.87
Warwick,Tristana,935,470,465,50.27
Warwick,Morgana,1460,708,752,48.49
Warwick,Yorick,1022,458,564,44.81
Warwick,LeeSin,978,527,451,53.89
Warwick,MissFortune,2301,1209,1092,52.54
Warwick,Mel,2075,1108,967,53.4
Warwick,Shaco,909,464,445,51.05
Warwick,AurelionSol,405,149,256,36.79
Warwick,Ashe,1593,812,781,50.97
Warwick,Velkoz,521,270,251,51.82
Warwick,Teemo,1290,607,683,47.05
Warwick,Hecarim,373,198,175,53.08
Warwick,Veigar,1147,595,552,51.87
Warwick,Thresh,1211,709,502,58.55
Warwick,Sett,1722,881,841,51.16
Warwick,Amumu,1104,531,573,48.1
Warwick,Caitlyn,2268,1088,1180,47.97
Warwick,Poppy,541,274,267,50.65
Warwick,Zed,910,487,423,53.52
Warwick,MasterYi,1176,606,570,51.53
Warwick,Rell,541,243,298,44.92
Warwick,Jax,769,403,366,52.41
Warwick,Briar,1075,486,589,45.21
Warwick,Ahri,1386,767,619,55.34
Warwick,Zeri,433,248,185,57.27
Warwick,Leblanc,350,220,130,62.86
Warwick,Ezreal,1417,787,630,55.54
Warwick,Kindred,528,303,225,57.39
Warwick,Aphelios,747,433,314,57.97
Warwick,Pyke,1089,577,512,52.98
Warwick,Vi,881,468,413,53.12
Warwick,Azir,351,197,154,56.13
Warwick,Nautilus,1038,557,481,53.66
Warwick,Gangplank,292,189,103,64.73
Warwick,Annie,256,125,131,48.83
Warwick,Gwen,704,392,312,55.68
Warwick,Aurora,804,381,423,47.39
Warwick,Karma,575,315,260,54.78
Warwick,Garen,1309,719,590,54.93
Warwick,Gnar,400,228,172,57
Warwick,Elise,491,279,212,56.82
Warwick,Twitch,806,401,405,49.75
Warwick,Heimerdinger,541,248,293,45.84
Warwick,Trundle,607,285,322,46.95
Warwick,Gragas,649,359,290,55.32
Warwick,Vex,539,257,282,47.68
Warwick,FiddleSticks,476,232,244,48.74
Warwick,Soraka,538,237,301,44.05
Warwick,KSante,269,137,132,50.93
Warwick,Lulu,725,388,337,53.52
Warwick,Corki,241,140,101,58.09
Warwick,Pantheon,1536,828,708,53.91
Warwick,Karthus,258,150,108,58.14
Warwick,Nilah,561,271,290,48.31
Warwick,Braum,343,166,177,48.4
Warwick,Akali,1013,592,421,58.44
Warwick,Nasus,950,461,489,48.53
Warwick,Renata,188,84,104,44.68
Warwick,Lillia,579,273,306,47.15
Warwick,Chogath,1326,700,626,52.79
Warwick,Alistar,273,130,143,47.62
Warwick,Samira,988,544,444,55.06
Warwick,Olaf,237,121,116,51.05
Warwick,Katarina,757,481,276,63.54
Warwick,Smolder,722,430,292,59.56
Warwick,Udyr,303,161,142,53.14
Warwick,Galio,681,336,345,49.34
Warwick,Fizz,586,307,279,52.39
Warwick,Taric,196,72,124,36.73
Warwick,Evelynn,558,327,231,58.6
Warwick,Kayle,742,392,350,52.83
Warwick,Volibear,1201,568,633,47.29
Warwick,Rengar,353,172,181,48.73
Warwick,Vayne,918,465,453,50.65
Warwick,Senna,846,415,431,49.05
Warwick,Zilean,195,103,92,52.82
Warwick,Fiora,408,235,173,57.6
Warwick,Sivir,413,259,154,62.71
Warwick,Xerath,659,313,346,47.5
Warwick,Leona,778,414,364,53.21
Warwick,Singed,199,97,102,48.74
Warwick,Belveth,272,140,132,51.47
Warwick,Neeko,743,381,362,51.28
Warwick,Tryndamere,624,354,270,56.73
Warwick,Nocturne,858,465,393,54.2
Warwick,Seraphine,1163,595,568,51.16
Warwick,Ivern,179,101,78,56.42
Warwick,Draven,520,276,244,53.08
Warwick,Ryze,349,154,195,44.13
Warwick,Nami,818,404,414,49.39
Warwick,Ornn,457,229,228,50.11
Warwick,Zoe,378,249,129,65.87
Warwick,Jinx,2014,968,1046,48.06
Warwick,Graves,466,253,213,54.29
Warwick,Syndra,487,224,263,46
Warwick,Urgot,514,226,288,43.97
Warwick,Qiyana,289,187,102,64.71
Warwick,Quinn,317,170,147,53.63
Warwick,Kalista,421,248,173,58.91
Warwick,Akshan,339,204,135,60.18
Warwick,Skarner,307,178,129,57.98
Warwick,Khazix,633,370,263,58.45
Warwick,Ziggs,402,184,218,45.77
Warwick,TahmKench,1010,509,501,50.4
Warwick,Kassadin,196,97,99,49.49
Warwick,Riven,328,189,139,57.62
Warwick,Zac,340,167,173,49.12
Warwick,Anivia,307,140,167,45.6
Warwick,Rumble,192,119,73,61.98
Warwick,Sejuani,303,144,159,47.52
Warwick,Sona,389,196,193,50.39
Warwick,Bard,263,165,98,62.74
Warwick,Sion,774,424,350,54.78
Warwick,Ambessa,520,249,271,47.88
Warwick,Camille,324,177,147,54.63
Warwick,Xayah,530,235,295,44.34
Warwick,DrMundo,557,281,276,50.45
Warwick,Kled,204,84,120,41.18
Warwick,Malzahar,681,334,347,49.05
Warwick,Brand,692,394,298,56.94
Warwick,JarvanIV,305,116,189,38.03
Warwick,Shyvana,254,125,129,49.21
Warwick,XinZhao,505,241,264,47.72
Warwick,Janna,265,135,130,50.94
Warwick,Jayce,364,191,173,52.47
Warwick,Talon,551,311,240,56.44
Warwick,Rakan,486,256,230,52.67
Warwick,Shen,544,306,238,56.25
Warwick,Viktor,526,274,252,52.09
Warwick,Rammus,366,183,183,50
Warwick,Kennen,342,142,200,41.52
Warwick,Cassiopeia,423,233,190,55.08
Warwick,Naafiri,484,255,229,52.69
Warwick,Renekton,436,199,237,45.64
Warwick,RekSai,91,39,52,42.86
Warwick,Taliyah,212,103,109,48.58
Warwick,Zyra,735,351,384,47.76
Warwick,Orianna,464,258,206,55.6
Warwick,Nidalee,223,143,80,64.13
Warwick,Lissandra,230,148,82,64.35
Warwick,TwistedFate,286,163,123,56.99
Shen,Malphite,269,130,139,48.33
Shen,Ekko,290,158,132,54.48
Shen,Hwei,262,149,113,56.87
Shen,Lucian,253,96,157,37.94
Shen,Maokai,173,74,99,42.77
Shen,Annie,69,40,29,57.97
Shen,Kayn,697,359,338,51.51
Shen,Aatrox,331,198,133,59.82
Shen,MissFortune,793,388,405,48.93
Shen,Pyke,461,269,192,58.35
Shen,Riven,167,97,70,58.08
Shen,Ivern,90,43,47,47.78
Shen,Yasuo,814,380,434,46.68
Shen,Swain,460,240,220,52.17
Shen,Nami,344,113,231,32.85
Shen,Gangplank,222,116,106,52.25
Shen,Taliyah,110,62,48,56.36
Shen,Sivir,185,89,96,48.11
Shen,Soraka,279,141,138,50.54
Shen,Mordekaiser,508,249,259,49.02
Shen,Diana,542,285,257,52.58
Shen,Ezreal,644,359,285,55.75
Shen,Thresh,590,281,309,47.63
Shen,Samira,352,193,159,54.83
Shen,MasterYi,376,177,199,47.07
Shen,Orianna,238,96,142,40.34
Shen,Nautilus,411,206,205,50.12
Shen,Lillia,280,138,142,49.29
Shen,Ashe,656,346,310,52.74
Shen,Velkoz,276,132,144,47.83
Shen,Jax,350,165,185,47.14
Shen,Katarina,334,209,125,62.57
Shen,Jhin,686,359,327,52.33
Shen,Ambessa,257,184,73,71.6
Shen,Rammus,100,51,49,51
Shen,Aurora,395,241,154,61.01
Shen,Caitlyn,888,529,359,59.57
Shen,Talon,221,131,90,59.28
Shen,LeeSin,322,186,136,57.76
Shen,Garen,718,335,383,46.66
Shen,Senna,414,229,185,55.31
Shen,Kayle,274,145,129,52.92
Shen,Morgana,582,269,313,46.22
Shen,Yorick,286,109,177,38.11
Shen,Volibear,430,222,208,51.63
Shen,Blitzcrank,310,168,142,54.19
Shen,Malzahar,355,187,168,52.68
Shen,Viego,481,257,224,53.43
Shen,Galio,254,130,124,51.18
Shen,Vayne,411,205,206,49.88
Shen,Sylas,326,196,130,60.12
Shen,Renekton,138,67,71,48.55
Shen,Leona,234,112,122,47.86
Shen,Sett,671,330,341,49.18
Shen,Rengar,200,126,74,63
Shen,Kalista,185,109,76,58.92
Shen,DrMundo,174,59,115,33.91
Shen,Darius,734,354,380,48.23
Shen,Viktor,235,89,146,37.87
Shen,Lulu,269,132,137,49.07
Shen,Chogath,474,231,243,48.73
Shen,Ryze,142,82,60,57.75
Shen,Janna,106,77,29,72.64
Shen,Zoe,149,95,54,63.76
Shen,Gragas,312,173,139,55.45
Shen,Pantheon,599,352,247,58.76
Shen,Kaisa,659,378,281,57.36
Shen,XinZhao,194,86,108,44.33
Shen,Hecarim,152,75,77,49.34
Shen,Braum,180,102,78,56.67
Shen,Urgot,153,67,86,43.79
Shen,Tristana,335,152,183,45.37
Shen,Zyra,203,114,89,56.16
Shen,Illaoi,208,105,103,50.48
Shen,Lux,1125,559,566,49.69
Shen,Camille,176,105,71,59.66
Shen,Khazix,259,138,121,53.28
Shen,Heimerdinger,232,109,123,46.98
Shen,Mel,776,371,405,47.81
Shen,MonkeyKing,195,97,98,49.74
Shen,Vladimir,159,77,82,48.43
Shen,Shaco,427,221,206,51.76
Shen,Jinx,826,396,430,47.94
Shen,Nunu,282,142,140,50.35
Shen,Twitch,359,195,164,54.32
Shen,Karma,349,155,194,44.41
Shen,Skarner,140,52,88,37.14
Shen,Yuumi,408,193,215,47.3
Shen,Singed,177,67,110,37.85
Shen,Bard,163,104,59,63.8
Shen,Evelynn,199,90,109,45.23
Shen,Zeri,182,118,64,64.84
Shen,Ziggs,227,102,125,44.93
Shen,Brand,336,161,175,47.92
Shen,Seraphine,402,205,197,51
Shen,Sejuani,144,69,75,47.92
Shen,Poppy,287,155,132,54.01
Shen,Irelia,387,227,160,58.66
Shen,Leblanc,177,87,90,49.15
Shen,Vi,344,173,171,50.29
Shen,FiddleSticks,180,81,99,45
Shen,Nasus,284,152,132,53.52
Shen,Ahri,515,247,268,47.96
Shen,Trundle,223,98,125,43.95
Shen,Briar,414,210,204,50.72
Shen,KSante,154,81,73,52.6
Shen,Vex,216,141,75,65.28
Shen,Fiora,203,92,111,45.32
Shen,Elise,241,138,103,57.26
Shen,Draven,227,128,99,56.39
Shen,Kled,130,55,75,42.31
Shen,Syndra,202,106,96,52.48
Shen,Teemo,452,255,197,56.42
Shen,Amumu,361,166,195,45.98
Shen,Gnar,178,103,75,57.87
Shen,Smolder,311,158,153,50.8
Shen,Warwick,544,238,306,43.75
Shen,Ornn,184,96,88,52.17
Shen,Tryndamere,213,121,92,56.81
Shen,Yone,773,476,297,61.58
Shen,Varus,335,163,172,48.66
Shen,Neeko,238,141,97,59.24
Shen,Nidalee,97,60,37,61.86
Shen,Azir,181,74,107,40.88
Shen,Alistar,132,58,74,43.94
Shen,Akshan,169,76,93,44.97
Shen,Rell,220,93,127,42.27
Shen,Xayah,253,120,133,47.43
Shen,Sona,140,66,74,47.14
Shen,Udyr,222,131,91,59.01
Shen,Aphelios,250,116,134,46.4
Shen,Veigar,527,206,321,39.09
Shen,Zed,430,220,210,51.16
Shen,Lissandra,132,62,70,46.97
Shen,AurelionSol,191,70,121,36.65
Shen,Sion,392,219,173,55.87
Shen,Qiyana,155,102,53,65.81
Shen,Karthus,89,39,50,43.82
Shen,Nocturne,246,134,112,54.47
Shen,Naafiri,218,124,94,56.88
Shen,Xerath,291,140,151,48.11
Shen,Rumble,117,61,56,52.14
Shen,Corki,131,86,45,65.65
Shen,Nilah,193,70,123,36.27
Shen,Rakan,213,109,104,51.17
Shen,Renata,126,73,53,57.94
Shen,TahmKench,410,226,184,55.12
Shen,Belveth,114,70,44,61.4
Shen,Graves,194,112,82,57.73
Shen,Gwen,300,173,127,57.67
Shen,KogMaw,159,65,94,40.88
Shen,Anivia,108,65,43,60.19
Shen,Quinn,88,33,55,37.5
Shen,JarvanIV,162,94,68,58.02
Shen,Shyvana,118,74,44,62.71
Shen,Akali,343,201,142,58.6
Shen,Milio,191,107,84,56.02
Shen,Cassiopeia,80,42,38,52.5
Shen,Zac,128,32,96,25
Shen,Kassadin,66,45,21,68.18
Shen,Zilean,134,97,37,72.39
Shen,Fizz,180,111,69,61.67
Shen,Kindred,209,118,91,56.46
Shen,Jayce,116,79,37,68.1
Shen,TwistedFate,86,42,44,48.84
Shen,Taric,94,30,64,31.91
Shen,Kennen,122,62,60,50.82
Shen,Olaf,123,51,72,41.46
Shen,RekSai,57,30,27,52.63
Tristana,Malphite,420,189,231,45
Tristana,Ekko,437,211,226,48.28
Tristana,Hwei,360,181,179,50.28
Tristana,Lucian,263,152,111,57.79
Tristana,Maokai,143,69,74,48.25
Tristana,Renekton,232,116,116,50
Tristana,Kayn,792,411,381,51.89
Tristana,Katarina,476,300,176,63.03
Tristana,Draven,324,159,165,49.07
Tristana,Yuumi,530,259,271,48.87
Tristana,Vladimir,275,109,166,39.64
Tristana,Darius,921,431,490,46.8
Tristana,Lux,1474,774,700,52.51
Tristana,KogMaw,141,65,76,46.1
Tristana,Ambessa,319,133,186,41.69
Tristana,Rammus,231,118,113,51.08
Tristana,Mel,1063,534,529,50.24
Tristana,Blitzcrank,466,257,209,55.15
Tristana,Mordekaiser,832,418,414,50.24
Tristana,Qiyana,191,103,88,53.93
Tristana,Warwick,935,465,470,49.73
Tristana,Nautilus,561,250,311,44.56
Tristana,Yasuo,1147,566,581,49.35
Tristana,Sylas,509,264,245,51.87
Tristana,Zed,517,272,245,52.61
Tristana,Sivir,204,113,91,55.39
Tristana,Gwen,386,205,181,53.11
Tristana,Skarner,181,108,73,59.67
Tristana,Yone,1102,519,583,47.1
Tristana,Kaisa,741,406,335,54.79
Tristana,Seraphine,560,313,247,55.89
Tristana,Garen,725,392,333,54.07
Tristana,Rakan,261,146,115,55.94
Tristana,Volibear,653,333,320,51
Tristana,AurelionSol,273,150,123,54.95
Tristana,Caitlyn,1344,680,664,50.6
Tristana,TahmKench,637,333,304,52.28
Tristana,Heimerdinger,317,141,176,44.48
Tristana,LeeSin,540,280,260,51.85
Tristana,Veigar,651,318,333,48.85
Tristana,Irelia,522,257,265,49.23
Tristana,Gragas,311,168,143,54.02
Tristana,XinZhao,301,183,118,60.8
Tristana,Velkoz,341,182,159,53.37
Tristana,Sett,974,466,508,47.84
Tristana,Elise,311,170,141,54.66
Tristana,Galio,334,152,182,45.51
Tristana,Twitch,435,209,226,48.05
Tristana,Soraka,331,111,220,33.53
Tristana,Trundle,221,94,127,42.53
Tristana,Amumu,480,233,247,48.54
Tristana,Fizz,264,148,116,56.06
Tristana,Pantheon,956,496,460,51.88
Tristana,Nunu,381,162,219,42.52
Tristana,Vex,386,173,213,44.82
Tristana,Jinx,1101,589,512,53.5
Tristana,Riven,251,164,87,65.34
Tristana,JarvanIV,204,105,99,51.47
Tristana,Taliyah,147,64,83,43.54
Tristana,Thresh,685,372,313,54.31
Tristana,Jax,481,239,242,49.69
Tristana,Diana,749,408,341,54.47
Tristana,Ahri,742,411,331,55.39
Tristana,Aphelios,350,169,181,48.29
Tristana,Senna,501,235,266,46.91
Tristana,Aurora,524,286,238,54.58
Tristana,FiddleSticks,318,177,141,55.66
Tristana,Jhin,1047,573,474,54.73
Tristana,Akali,567,285,282,50.26
Tristana,Samira,564,280,284,49.65
Tristana,Neeko,362,173,189,47.79
Tristana,Kindred,288,122,166,42.36
Tristana,Corki,189,118,71,62.43
Tristana,Sion,447,192,255,42.95
Tristana,Ezreal,981,501,480,51.07
Tristana,Zilean,127,81,46,63.78
Tristana,Nocturne,503,248,255,49.3
Tristana,Aatrox,517,312,205,60.35
Tristana,Swain,617,290,327,47
Tristana,Ryze,154,85,69,55.19
Tristana,Nami,409,219,190,53.55
Tristana,Nilah,304,180,124,59.21
Tristana,Quinn,196,82,114,41.84
Tristana,Talon,337,207,130,61.42
Tristana,Syndra,238,102,136,42.86
Tristana,Olaf,123,63,60,51.22
Tristana,Smolder,438,229,209,52.28
Tristana,Braum,283,148,135,52.3
Tristana,Karma,338,176,162,52.07
Tristana,Vayne,521,275,246,52.78
Tristana,Brand,408,189,219,46.32
Tristana,TwistedFate,168,73,95,43.45
Tristana,Teemo,748,337,411,45.05
Tristana,Khazix,347,164,183,47.26
Tristana,Varus,410,233,177,56.83
Tristana,Sejuani,128,67,61,52.34
Tristana,Ashe,1014,579,435,57.1
Tristana,Malzahar,382,166,216,43.46
Tristana,Yorick,479,168,311,35.07
Tristana,Lulu,329,154,175,46.81
Tristana,Naafiri,205,132,73,64.39
Tristana,Morgana,743,354,389,47.64
Tristana,KSante,189,110,79,58.2
Tristana,Nidalee,109,69,40,63.3
Tristana,MasterYi,617,321,296,52.03
Tristana,Pyke,721,414,307,57.42
Tristana,Akshan,174,87,87,50
Tristana,Zyra,311,146,165,46.95
Tristana,Graves,267,127,140,47.57
Tristana,Vi,454,239,215,52.64
Tristana,Fiora,266,185,81,69.55
Tristana,Xerath,329,240,89,72.95
Tristana,DrMundo,371,155,216,41.78
Tristana,Poppy,264,106,158,40.15
Tristana,Nasus,332,158,174,47.59
Tristana,Briar,479,256,223,53.44
Tristana,Shyvana,182,103,79,56.59
Tristana,Viktor,369,175,194,47.43
Tristana,Janna,186,70,116,37.63
Tristana,Kalista,299,172,127,57.53
Tristana,Rell,311,139,172,44.69
Tristana,Evelynn,374,213,161,56.95
Tristana,Kassadin,105,55,50,52.38
Tristana,Ziggs,161,67,94,41.61
Tristana,Gnar,211,122,89,57.82
Tristana,Shen,335,183,152,54.63
Tristana,Rumble,89,51,38,57.3
Tristana,Shaco,565,291,274,51.5
Tristana,MissFortune,1469,702,767,47.79
Tristana,Zeri,247,152,95,61.54
Tristana,Kayle,393,235,158,59.8
Tristana,Viego,633,324,309,51.18
Tristana,Zac,152,76,76,50
Tristana,Ornn,277,121,156,43.68
Tristana,Udyr,202,123,79,60.89
Tristana,Leblanc,182,75,107,41.21
Tristana,Tryndamere,352,163,189,46.31
Tristana,Milio,244,102,142,41.8
Tristana,Lillia,360,157,203,43.61
Tristana,Anivia,207,108,99,52.17
Tristana,Illaoi,267,141,126,52.81
Tristana,Jayce,174,73,101,41.95
Tristana,Leona,411,174,237,42.34
Tristana,Azir,239,125,114,52.3
Tristana,Belveth,117,61,56,52.14
Tristana,Chogath,724,393,331,54.28
Tristana,Rengar,195,105,90,53.85
Tristana,Sona,162,65,97,40.12
Tristana,Karthus,174,95,79,54.6
Tristana,Alistar,184,75,109,40.76
Tristana,MonkeyKing,243,147,96,60.49
Tristana,Xayah,262,148,114,56.49
Tristana,Kennen,224,120,104,53.57
Tristana,Taric,117,81,36,69.23
Tristana,Lissandra,141,77,64,54.61
Tristana,Camille,164,85,79,51.83
Tristana,Urgot,213,106,107,49.77
Tristana,Zoe,213,158,55,74.18
Tristana,Gangplank,267,173,94,64.79
Tristana,Hecarim,181,111,70,61.33
Tristana,Singed,137,44,93,32.12
Tristana,Bard,190,88,102,46.32
Tristana,Kled,159,91,68,57.23
Tristana,Orianna,228,96,132,42.11
Tristana,Annie,170,95,75,55.88
Tristana,Cassiopeia,271,141,130,52.03
Tristana,RekSai,70,50,20,71.43
Tristana,Ivern,102,60,42,58.82
Tristana,Renata,147,72,75,48.98
Blitzcrank,Malphite,385,198,187,51.43
Blitzcrank,Ekko,302,163,139,53.97
Blitzcrank,Hwei,348,143,205,41.09
Blitzcrank,Lucian,300,133,167,44.33
Blitzcrank,Maokai,237,62,175,26.16
Blitzcrank,Kennen,178,81,97,45.51
Blitzcrank,Warwick,654,224,430,34.25
Blitzcrank,Yasuo,861,425,436,49.36
Blitzcrank,Kindred,228,102,126,44.74
Blitzcrank,Lux,1544,744,800,48.19
Blitzcrank,Talon,272,146,126,53.68
Blitzcrank,Aurora,429,179,250,41.72
Blitzcrank,Tristana,466,209,257,44.85
Blitzcrank,Alistar,136,65,71,47.79
Blitzcrank,Teemo,657,281,376,42.77
Blitzcrank,TahmKench,514,242,272,47.08
Blitzcrank,Jinx,993,432,561,43.5
Blitzcrank,Zoe,239,128,111,53.56
Blitzcrank,Nami,406,231,175,56.9
Blitzcrank,Evelynn,274,139,135,50.73
Blitzcrank,Irelia,444,250,194,56.31
Blitzcrank,Thresh,694,333,361,47.98
Blitzcrank,Pantheon,931,448,483,48.12
Blitzcrank,Kayn,774,353,421,45.61
Blitzcrank,Leblanc,163,63,100,38.65
Blitzcrank,Sivir,292,153,139,52.4
Blitzcrank,Pyke,559,300,259,53.67
Blitzcrank,Volibear,436,199,237,45.64
Blitzcrank,Akshan,176,71,105,40.34
Blitzcrank,Katarina,426,249,177,58.45
Blitzcrank,Khazix,274,144,130,52.55
Blitzcrank,Akali,525,246,279,46.86
Blitzcrank,Draven,209,81,128,38.76
Blitzcrank,Mel,920,388,532,42.17
Blitzcrank,Viego,568,337,231,59.33
Blitzcrank,Yone,823,383,440,46.54
Blitzcrank,Nocturne,420,169,251,40.24
Blitzcrank,Aatrox,475,248,227,52.21
Blitzcrank,Swain,604,235,369,38.91
Blitzcrank,Cassiopeia,233,154,79,66.09
Blitzcrank,Shaco,392,218,174,55.61
Blitzcrank,Riven,190,116,74,61.05
Blitzcrank,Caitlyn,1044,481,563,46.07
Blitzcrank,Senna,443,192,251,43.34
Blitzcrank,MasterYi,458,236,222,51.53
Blitzcrank,Azir,177,108,69,61.02
Blitzcrank,Rengar,222,122,100,54.95
Blitzcrank,Gragas,264,115,149,43.56
Blitzcrank,Zed,361,171,190,47.37
Blitzcrank,MissFortune,926,439,487,47.41
Blitzcrank,Poppy,197,72,125,36.55
Blitzcrank,Leona,488,224,264,45.9
Blitzcrank,Janna,162,91,71,56.17
Blitzcrank,Shen,310,142,168,45.81
Blitzcrank,MonkeyKing,208,98,110,47.12
Blitzcrank,Naafiri,235,109,126,46.38
Blitzcrank,Mordekaiser,751,377,374,50.2
Blitzcrank,Samira,448,203,245,45.31
Blitzcrank,Neeko,327,101,226,30.89
Blitzcrank,Olaf,122,73,49,59.84
Blitzcrank,Diana,559,268,291,47.94
Blitzcrank,Ashe,768,341,427,44.4
Blitzcrank,LeeSin,514,246,268,47.86
Blitzcrank,Varus,373,199,174,53.35
Blitzcrank,Tryndamere,238,137,101,57.56
Blitzcrank,Elise,241,104,137,43.15
Blitzcrank,Nautilus,520,221,299,42.5
Blitzcrank,Rakan,248,88,160,35.48
Blitzcrank,Rumble,38,9,29,23.68
Blitzcrank,Qiyana,138,70,68,50.72
Blitzcrank,Kled,91,64,27,70.33
Blitzcrank,Taliyah,161,85,76,52.8
Blitzcrank,Ezreal,756,385,371,50.93
Blitzcrank,Yorick,341,111,230,32.55
Blitzcrank,Illaoi,280,103,177,36.79
Blitzcrank,Fizz,275,147,128,53.45
Blitzcrank,Kaisa,615,347,268,56.42
Blitzcrank,Sion,382,164,218,42.93
Blitzcrank,Jayce,142,66,76,46.48
Blitzcrank,KogMaw,131,61,70,46.56
Blitzcrank,XinZhao,261,142,119,54.41
Blitzcrank,Hecarim,153,77,76,50.33
Blitzcrank,Jhin,663,325,338,49.02
Blitzcrank,Velkoz,260,98,162,37.69
Blitzcrank,Sett,750,350,400,46.67
Blitzcrank,Zilean,137,46,91,33.58
Blitzcrank,AurelionSol,208,89,119,42.79
Blitzcrank,Xayah,313,125,188,39.94
Blitzcrank,Singed,136,61,75,44.85
Blitzcrank,Orianna,243,125,118,51.44
Blitzcrank,Trundle,295,109,186,36.95
Blitzcrank,Ivern,89,57,32,64.04
Blitzcrank,Darius,805,375,430,46.58
Blitzcrank,FiddleSticks,229,128,101,55.9
Blitzcrank,Chogath,603,266,337,44.11
Blitzcrank,Renekton,219,103,116,47.03
Blitzcrank,Seraphine,511,299,212,58.51
Blitzcrank,Gwen,286,151,135,52.8
Blitzcrank,Zeri,189,97,92,51.32
Blitzcrank,Zyra,305,145,160,47.54
Blitzcrank,Heimerdinger,315,148,167,46.98
Blitzcrank,DrMundo,273,176,97,64.47
Blitzcrank,Soraka,288,108,180,37.5
Blitzcrank,Ahri,625,290,335,46.4
Blitzcrank,Sylas,438,219,219,50
Blitzcrank,Nunu,419,251,168,59.9
Blitzcrank,Twitch,341,190,151,55.72
Blitzcrank,Karma,217,106,111,48.85
Blitzcrank,Milio,227,106,121,46.7
Blitzcrank,KSante,179,106,73,59.22
Blitzcrank,Karthus,105,44,61,41.9
Blitzcrank,Morgana,705,324,381,45.96
Blitzcrank,Xerath,291,142,149,48.8
Blitzcrank,Nidalee,99,59,40,59.6
Blitzcrank,Amumu,437,197,240,45.08
Blitzcrank,Renata,75,39,36,52
Blitzcrank,Gangplank,225,122,103,54.22
Blitzcrank,Kayle,316,142,174,44.94
Blitzcrank,Sejuani,162,92,70,56.79
Blitzcrank,Nasus,344,144,200,41.86
Blitzcrank,Rell,287,156,131,54.36
Blitzcrank,Ryze,121,84,37,69.42
Blitzcrank,Viktor,305,111,194,36.39
Blitzcrank,Vladimir,219,97,122,44.29
Blitzcrank,Yuumi,429,267,162,62.24
Blitzcrank,Brand,331,200,131,60.42
Blitzcrank,Malzahar,392,140,252,35.71
Blitzcrank,Smolder,331,162,169,48.94
Blitzcrank,Garen,637,254,383,39.87
Blitzcrank,JarvanIV,187,69,118,36.9
Blitzcrank,Galio,234,114,120,48.72
Blitzcrank,Ziggs,220,112,108,50.91
Blitzcrank,Sona,112,50,62,44.64
Blitzcrank,Camille,147,84,63,57.14
Blitzcrank,Veigar,540,257,283,47.59
Blitzcrank,Vex,228,131,97,57.46
Blitzcrank,Fiora,229,113,116,49.34
Blitzcrank,Nilah,241,88,153,36.51
Blitzcrank,Jax,350,163,187,46.57
Blitzcrank,Lulu,331,157,174,47.43
Blitzcrank,Syndra,254,119,135,46.85
Blitzcrank,Gnar,193,78,115,40.41
Blitzcrank,Vi,281,132,149,46.98
Blitzcrank,Udyr,157,84,73,53.5
Blitzcrank,Braum,215,93,122,43.26
Blitzcrank,Kassadin,97,40,57,41.24
Blitzcrank,Lissandra,103,44,59,42.72
Blitzcrank,Vayne,461,208,253,45.12
Blitzcrank,Ambessa,318,144,174,45.28
Blitzcrank,Kalista,238,176,62,73.95
Blitzcrank,Corki,156,89,67,57.05
Blitzcrank,Lillia,369,175,194,47.43
Blitzcrank,Shyvana,154,57,97,37.01
Blitzcrank,Graves,255,131,124,51.37
Blitzcrank,TwistedFate,163,95,68,58.28
Blitzcrank,Zac,188,79,109,42.02
Blitzcrank,Aphelios,260,140,120,53.85
Blitzcrank,Urgot,184,111,73,60.33
Blitzcrank,Briar,456,174,282,38.16
Blitzcrank,Ornn,185,78,107,42.16
Blitzcrank,Skarner,135,74,61,54.81
Blitzcrank,Taric,86,34,52,39.53
Blitzcrank,Annie,121,67,54,55.37
Blitzcrank,Rammus,137,76,61,55.47
Blitzcrank,RekSai,73,41,32,56.16
Blitzcrank,Quinn,159,103,56,64.78
Blitzcrank,Anivia,104,65,39,62.5
Blitzcrank,Bard,119,70,49,58.82
Blitzcrank,Belveth,107,51,56,47.66
Malphite,Sett,767,415,352,54.11
Malphite,Warwick,709,371,338,52.33
Malphite,Shen,269,139,130,51.67
Malphite,Tristana,420,231,189,55
Malphite,Blitzcrank,385,187,198,48.57
Malphite,Pantheon,786,454,332,57.76
Malphite,MasterYi,444,217,227,48.87
Malphite,Sylas,550,220,330,40
Malphite,Ashe,863,442,421,51.22
Malphite,Karma,346,175,171,50.58
Malphite,Gangplank,198,118,80,59.6
Malphite,Brand,312,150,162,48.08
Malphite,Irelia,544,325,219,59.74
Malphite,Malzahar,367,181,186,49.32
Malphite,Pyke,557,349,208,62.66
Malphite,Yasuo,906,479,427,52.87
Malphite,Zed,597,331,266,55.44
Malphite,Sivir,282,126,156,44.68
Malphite,FiddleSticks,254,118,136,46.46
Malphite,Shaco,436,240,196,55.05
Malphite,Syndra,237,123,114,51.9
Malphite,Kalista,241,156,85,64.73
Malphite,Thresh,601,363,238,60.4
Malphite,DrMundo,223,87,136,39.01
Malphite,Belveth,146,109,37,74.66
Malphite,Leblanc,157,89,68,56.69
Malphite,Briar,503,298,205,59.24
Malphite,Anivia,140,46,94,32.86
Malphite,Akali,478,252,226,52.72
Malphite,Rammus,149,65,84,43.62
Malphite,Jinx,915,467,448,51.04
Malphite,Zyra,243,108,135,44.44
Malphite,Fiora,200,123,77,61.5
Malphite,Kayn,910,425,485,46.7
Malphite,Aphelios,328,181,147,55.18
Malphite,Zilean,177,81,96,45.76
Malphite,KSante,188,95,93,50.53
Malphite,Viego,639,324,315,50.7
Malphite,Vex,278,147,131,52.88
Malphite,Senna,450,233,217,51.78
Malphite,Jax,289,142,147,49.13
Malphite,Evelynn,204,128,76,62.75
Malphite,Mel,882,425,457,48.19
Malphite,Renata,166,101,65,60.84
Malphite,Heimerdinger,177,89,88,50.28
Malphite,Katarina,358,191,167,53.35
Malphite,Caitlyn,1011,541,470,53.51
Malphite,Zac,144,88,56,61.11
Malphite,Nunu,338,178,160,52.66
Malphite,Veigar,561,259,302,46.17
Malphite,Kaisa,600,319,281,53.17
Malphite,Nasus,387,205,182,52.97
Malphite,Vi,395,191,204,48.35
Malphite,Lux,1300,714,586,54.92
Malphite,Alistar,127,75,52,59.06
Malphite,Samira,487,263,224,54
Malphite,Chogath,521,211,310,40.5
Malphite,Lillia,343,147,196,42.86
Malphite,Jhin,795,469,326,58.99
Malphite,Janna,126,39,87,30.95
Malphite,Yorick,367,135,232,36.78
Malphite,Kindred,273,142,131,52.01
Malphite,Lulu,309,161,148,52.1
Malphite,TahmKench,564,276,288,48.94
Malphite,Diana,545,269,276,49.36
Malphite,Darius,808,450,358,55.69
Malphite,Twitch,351,183,168,52.14
Malphite,Teemo,894,462,432,51.68
Malphite,Bard,119,73,46,61.34
Malphite,Mordekaiser,730,299,431,40.96
Malphite,Swain,410,188,222,45.85
Malphite,Tryndamere,380,208,172,54.74
Malphite,Elise,261,140,121,53.64
Malphite,Nautilus,464,246,218,53.02
Malphite,Varus,303,165,138,54.46
Malphite,Rakan,269,138,131,51.3
Malphite,Quinn,265,147,118,55.47
Malphite,Aatrox,553,283,270,51.18
Malphite,Rengar,181,107,74,59.12
Malphite,Galio,351,165,186,47.01
Malphite,Sona,239,114,125,47.7
Malphite,Kennen,200,107,93,53.5
Malphite,MissFortune,1050,520,530,49.52
Malphite,Morgana,545,239,306,43.85
Malphite,Viktor,332,150,182,45.18
Malphite,Volibear,506,261,245,51.58
Malphite,Azir,156,95,61,60.9
Malphite,Xayah,331,152,179,45.92
Malphite,Garen,696,320,376,45.98
Malphite,Singed,110,36,74,32.73
Malphite,Smolder,364,198,166,54.4
Malphite,Skarner,117,59,58,50.43
Malphite,Aurora,373,213,160,57.1
Malphite,Ryze,133,60,73,45.11
Malphite,Illaoi,240,117,123,48.75
Malphite,Yone,953,547,406,57.4
Malphite,Akshan,213,117,96,54.93
Malphite,Yuumi,534,293,241,54.87
Malphite,Amumu,425,208,217,48.94
Malphite,Ivern,92,52,40,56.52
Malphite,Soraka,231,114,117,49.35
Malphite,Kayle,398,218,180,54.77
Malphite,Seraphine,498,280,218,56.22
Malphite,JarvanIV,212,93,119,43.87
Malphite,Draven,262,157,105,59.92
Malphite,Gnar,343,199,144,58.02
Malphite,Zoe,263,177,86,67.3
Malphite,Ezreal,839,484,355,57.69
Malphite,Hwei,379,206,173,54.35
Malphite,Graves,234,141,93,60.26
Malphite,Orianna,170,98,72,57.65
Malphite,Neeko,307,146,161,47.56
Malphite,Ornn,140,50,90,35.71
Malphite,Ekko,390,210,180,53.85
Malphite,Renekton,181,107,74,59.12
Malphite,Kassadin,88,57,31,64.77
Malphite,Gwen,337,187,150,55.49
Malphite,Nami,511,229,282,44.81
Malphite,Poppy,279,150,129,53.76
Malphite,AurelionSol,186,120,66,64.52
Malphite,Nilah,283,145,138,51.24
Malphite,Ziggs,244,81,163,33.2
Malphite,Leona,457,212,245,46.39
Malphite,Riven,253,183,70,72.33
Malphite,Khazix,243,137,106,56.38
Malphite,Qiyana,169,114,55,67.46
Malphite,Gragas,260,153,107,58.85
Malphite,Velkoz,293,136,157,46.42
Malphite,Nocturne,364,176,188,48.35
Malphite,Udyr,165,89,76,53.94
Malphite,Sion,289,148,141,51.21
Malphite,Trundle,239,133,106,55.65
Malphite,Sejuani,173,109,64,63.01
Malphite,Ahri,643,318,325,49.46
Malphite,Vayne,570,292,278,51.23
Malphite,Xerath,258,112,146,43.41
Malphite,Camille,127,60,67,47.24
Malphite,Naafiri,197,116,81,58.88
Malphite,Taliyah,142,88,54,61.97
Malphite,Lucian,254,142,112,55.91
Malphite,Talon,321,187,134,58.26
Malphite,Annie,116,43,73,37.07
Malphite,Cassiopeia,188,113,75,60.11
Malphite,Milio,272,168,104,61.76
Malphite,XinZhao,242,101,141,41.74
Malphite,Vladimir,268,144,124,53.73
Malphite,Rell,194,89,105,45.88
Malphite,LeeSin,439,275,164,62.64
Malphite,Shyvana,117,52,65,44.44
Malphite,Urgot,166,79,87,47.59
Malphite,Zeri,196,103,93,52.55
Malphite,Hecarim,183,108,75,59.02
Malphite,Nidalee,118,83,35,70.34
Malphite,Karthus,103,73,30,70.87
Malphite,Maokai,147,78,69,53.06
Malphite,MonkeyKing,181,74,107,40.88
Malphite,Braum,250,150,100,60
Malphite,Fizz,184,67,117,36.41
Malphite,Lissandra,128,61,67,47.66
Malphite,Jayce,171,111,60,64.91
Malphite,KogMaw,136,65,71,47.79
Malphite,TwistedFate,159,96,63,60.38
Malphite,Olaf,126,54,72,42.86
Malphite,Kled,79,58,21,73.42
Malphite,Ambessa,309,211,98,68.28
Malphite,Corki,125,71,54,56.8
Malphite,RekSai,54,29,25,53.7
Malphite,Taric,71,44,27,61.97
Malphite,Rumble,104,61,43,58.65
Ekko,Sett,814,378,436,46.44
Ekko,Warwick,790,401,389,50.76
Ekko,Shen,290,132,158,45.52
Ekko,Tristana,437,226,211,51.72
Ekko,Blitzcrank,302,139,163,46.03
Ekko,Mordekaiser,698,368,330,52.72
Ekko,Viego,536,263,273,49.07
Ekko,Kindred,314,159,155,50.64
Ekko,Jhin,871,432,439,49.6
Ekko,TahmKench,573,316,257,55.15
Ekko,Darius,890,431,459,48.43
Ekko,Rengar,224,149,75,66.52
Ekko,Syndra,220,105,115,47.73
Ekko,Caitlyn,1153,530,623,45.97
Ekko,Lux,1272,661,611,51.97
Ekko,Renekton,242,121,121,50
Ekko,Kayn,759,363,396,47.83
Ekko,Vex,323,151,172,46.75
Ekko,Samira,536,242,294,45.15
Ekko,Lulu,361,209,152,57.89
Ekko,Karma,299,140,159,46.82
Ekko,Rammus,159,81,78,50.94
Ekko,Yone,904,471,433,52.1
Ekko,Nocturne,412,215,197,52.18
Ekko,Lissandra,141,63,78,44.68
Ekko,Pantheon,742,391,351,52.7
Ekko,Ryze,137,60,77,43.8
Ekko,Jinx,949,432,517,45.52
Ekko,Nami,428,178,250,41.59
Ekko,Aatrox,453,229,224,50.55
Ekko,Shaco,490,288,202,58.78
Ekko,Leblanc,142,71,71,50
Ekko,Draven,307,127,180,41.37
Ekko,Hwei,301,154,147,51.16
Ekko,Nasus,385,162,223,42.08
Ekko,Zoe,308,177,131,57.47
Ekko,Ashe,830,361,469,43.49
Ekko,Senna,377,178,199,47.21
Ekko,Mel,907,437,470,48.18
Ekko,Lucian,270,151,119,55.93
Ekko,Thresh,539,269,270,49.91
Ekko,RekSai,65,16,49,24.62
Ekko,Braum,198,87,111,43.94
Ekko,Illaoi,233,118,115,50.64
Ekko,MonkeyKing,228,103,125,45.18
Ekko,Vayne,489,251,238,51.33
Ekko,Morgana,602,322,280,53.49
Ekko,XinZhao,306,138,168,45.1
Ekko,Irelia,419,244,175,58.23
Ekko,Soraka,330,164,166,49.7
Ekko,Teemo,625,265,360,42.4
Ekko,Khazix,291,164,127,56.36
Ekko,Vladimir,206,95,111,46.12
Ekko,Corki,115,71,44,61.74
Ekko,Pyke,664,375,289,56.48
Ekko,Singed,128,74,54,57.81
Ekko,Yasuo,915,509,406,55.63
Ekko,Alistar,243,108,135,44.44
Ekko,Nautilus,491,251,240,51.12
Ekko,Lillia,360,206,154,57.22
Ekko,FiddleSticks,283,105,178,37.1
Ekko,Akali,527,290,237,55.03
Ekko,Evelynn,284,155,129,54.58
Ekko,Ahri,637,313,324,49.14
Ekko,Chogath,677,299,378,44.17
Ekko,Velkoz,278,103,175,37.05
Ekko,Trundle,314,113,201,35.99
Ekko,Leona,419,167,252,39.86
Ekko,Heimerdinger,271,135,136,49.82
Ekko,Varus,339,177,162,52.21
Ekko,Maokai,193,97,96,50.26
Ekko,MasterYi,536,259,277,48.32
Ekko,Swain,476,226,250,47.48
Ekko,MissFortune,971,463,508,47.68
Ekko,Sion,357,166,191,46.5
Ekko,Twitch,524,275,249,52.48
Ekko,Rell,227,124,103,54.63
Ekko,Kayle,348,162,186,46.55
Ekko,Shyvana,106,42,64,39.62
Ekko,Galio,359,169,190,47.08
Ekko,Seraphine,536,267,269,49.81
Ekko,Sona,222,104,118,46.85
Ekko,Ezreal,824,468,356,56.8
Ekko,Garen,718,352,366,49.03
Ekko,Tryndamere,216,110,106,50.93
Ekko,Ivern,111,78,33,70.27
Ekko,Graves,243,139,104,57.2
Ekko,Katarina,392,246,146,62.76
Ekko,Annie,112,49,63,43.75
Ekko,Veigar,524,258,266,49.24
Ekko,Gangplank,190,95,95,50
Ekko,Volibear,515,211,304,40.97
Ekko,Qiyana,182,102,80,56.04
Ekko,Taliyah,130,52,78,40
Ekko,Urgot,191,73,118,38.22
Ekko,Xerath,357,211,146,59.1
Ekko,Poppy,284,118,166,41.55
Ekko,Talon,344,157,187,45.64
Ekko,AurelionSol,159,82,77,51.57
Ekko,KSante,162,80,82,49.38
Ekko,Fiora,255,167,88,65.49
Ekko,Aurora,435,198,237,45.52
Ekko,LeeSin,492,236,256,47.97
Ekko,Xayah,262,142,120,54.2
Ekko,DrMundo,274,151,123,55.11
Ekko,JarvanIV,143,67,76,46.85
Ekko,Hecarim,176,89,87,50.57
Ekko,Orianna,198,104,94,52.53
Ekko,Zyra,319,111,208,34.8
Ekko,Sejuani,153,55,98,35.95
Ekko,Bard,170,93,77,54.71
Ekko,Nilah,259,133,126,51.35
Ekko,Viktor,290,139,151,47.93
Ekko,Zeri,198,80,118,40.4
Ekko,Brand,336,170,166,50.6
Ekko,Diana,686,307,379,44.75
Ekko,Ziggs,190,96,94,50.53
Ekko,Riven,331,197,134,59.52
Ekko,Briar,499,250,249,50.1
Ekko,Kaisa,547,276,271,50.46
Ekko,Jax,360,153,207,42.5
Ekko,Sylas,443,227,216,51.24
Ekko,Yuumi,443,228,215,51.47
Ekko,Aphelios,306,193,113,63.07
Ekko,Zed,559,249,310,44.54
Ekko,Ornn,189,80,109,42.33
Ekko,Zac,158,64,94,40.51
Ekko,Belveth,83,25,58,30.12
Ekko,Naafiri,194,95,99,48.97
Ekko,Amumu,418,190,228,45.45
Ekko,Renata,99,51,48,51.52
Ekko,Zilean,144,74,70,51.39
Ekko,Rumble,63,26,37,41.27
Ekko,Smolder,384,202,182,52.6
Ekko,Janna,119,51,68,42.86
Ekko,Neeko,316,176,140,55.7
Ekko,Kassadin,137,49,88,35.77
Ekko,Karthus,69,37,32,53.62
Ekko,Azir,202,98,104,48.51
Ekko,Sivir,168,83,85,49.4
Ekko,Malphite,390,180,210,46.15
Ekko,Milio,209,86,123,41.15
Ekko,Nunu,355,191,164,53.8
Ekko,Fizz,223,91,132,40.81
Ekko,Vi,399,203,196,50.88
Ekko,Gragas,307,163,144,53.09
Ekko,Malzahar,325,139,186,42.77
Ekko,Kennen,161,74,87,45.96
Ekko,Kalista,159,109,50,68.55
Ekko,Udyr,177,103,74,58.19
Ekko,Gwen,344,168,176,48.84
Ekko,Kled,111,46,65,41.44
Ekko,Camille,143,77,66,53.85
Ekko,Gnar,170,103,67,60.59
Ekko,TwistedFate,186,82,104,44.09
Ekko,Anivia,90,47,43,52.22
Ekko,Yorick,397,152,245,38.29
Ekko,Elise,278,119,159,42.81
Ekko,KogMaw,131,91,40,69.47
Ekko,Nidalee,83,45,38,54.22
Ekko,Skarner,151,88,63,58.28
Ekko,Rakan,257,105,152,40.86
Ekko,Quinn,157,95,62,60.51
Ekko,Olaf,121,77,44,63.64
Ekko,Cassiopeia,174,119,55,68.39
Ekko,Ambessa,327,175,152,53.52
Ekko,Taric,101,42,59,41.58
Ekko,Akshan,162,68,94,41.98
Ekko,Jayce,154,81,73,52.6
Hwei,Sett,739,312,427,42.22
Hwei,Warwick,616,343,273,55.68
Hwei,Shen,262,113,149,43.13
Hwei,Tristana,360,179,181,49.72
Hwei,Blitzcrank,348,205,143,58.91
Hwei,Mordekaiser,703,366,337,52.06
Hwei,Sejuani,134,71,63,52.99
Hwei,Yasuo,789,401,388,50.82
Hwei,Lucian,255,145,110,56.86
Hwei,Pantheon,773,401,372,51.88
Hwei,Fiora,231,81,150,35.06
Hwei,Katarina,404,231,173,57.18
Hwei,Mel,981,499,482,50.87
Hwei,Viktor,403,179,224,44.42
Hwei,Gwen,301,162,139,53.82
Hwei,Vi,431,192,239,44.55
Hwei,Zed,501,218,283,43.51
Hwei,Jhin,872,429,443,49.2
Hwei,Soraka,293,133,160,45.39
Hwei,Irelia,478,205,273,42.89
Hwei,Kassadin,75,26,49,34.67
Hwei,Yuumi,445,210,235,47.19
Hwei,Akali,495,267,228,53.94
Hwei,Velkoz,283,118,165,41.7
Hwei,Yorick,415,181,234,43.61
Hwei,Samira,484,254,230,52.48
Hwei,Nami,512,243,269,47.46
Hwei,Volibear,492,249,243,50.61
Hwei,LeeSin,457,284,173,62.14
Hwei,Malzahar,368,176,192,47.83
Hwei,Caitlyn,1043,570,473,54.65
Hwei,Pyke,619,320,299,51.7
Hwei,Teemo,637,331,306,51.96
Hwei,Khazix,341,198,143,58.06
Hwei,Smolder,329,143,186,43.47
Hwei,MissFortune,925,443,482,47.89
Hwei,Rell,226,103,123,45.58
Hwei,Ekko,301,147,154,48.84
Hwei,TahmKench,503,249,254,49.5
Hwei,Gangplank,144,64,80,44.44
Hwei,Diana,602,308,294,51.16
Hwei,Aphelios,350,165,185,47.14
Hwei,Leona,351,173,178,49.29
Hwei,Illaoi,173,93,80,53.76
Hwei,Nocturne,386,161,225,41.71
Hwei,Seraphine,520,299,221,57.5
Hwei,Amumu,393,201,192,51.15
Hwei,Lissandra,106,81,25,76.42
Hwei,Kayn,650,326,324,50.15
Hwei,Ezreal,723,427,296,59.06
Hwei,Yone,802,404,398,50.37
Hwei,Darius,926,537,389,57.99
Hwei,Ahri,739,397,342,53.72
Hwei,Jinx,849,377,472,44.41
Hwei,Karma,259,110,149,42.47
Hwei,Ambessa,246,143,103,58.13
Hwei,Ashe,841,494,347,58.74
Hwei,Varus,345,125,220,36.23
Hwei,Graves,217,120,97,55.3
Hwei,Neeko,354,185,169,52.26
Hwei,Rengar,197,114,83,57.87
Hwei,Syndra,265,113,152,42.64
Hwei,Xayah,306,170,136,55.56
Hwei,Thresh,559,280,279,50.09
Hwei,Sion,367,181,186,49.32
Hwei,Xerath,321,168,153,52.34
Hwei,Lulu,401,219,182,54.61
Hwei,Nidalee,100,70,30,70
Hwei,KogMaw,130,37,93,28.46
Hwei,Nautilus,416,223,193,53.61
Hwei,Veigar,547,301,246,55.03
Hwei,FiddleSticks,262,101,161,38.55
Hwei,Gnar,190,113,77,59.47
Hwei,AurelionSol,223,119,104,53.36
Hwei,Poppy,239,93,146,38.91
Hwei,Ryze,131,76,55,58.02
Hwei,Udyr,134,63,71,47.01
Hwei,Briar,496,250,246,50.4
Hwei,Renekton,170,91,79,53.53
Hwei,Kaisa,535,275,260,51.4
Hwei,Heimerdinger,186,88,98,47.31
Hwei,Braum,185,102,83,55.14
Hwei,Jax,431,208,223,48.26
Hwei,Zeri,211,112,99,53.08
Hwei,Naafiri,150,60,90,40
Hwei,Lux,1296,677,619,52.24
Hwei,Bard,130,52,78,40
Hwei,Evelynn,293,129,164,44.03
Hwei,Viego,480,229,251,47.71
Hwei,Qiyana,157,63,94,40.13
Hwei,Taric,84,27,57,32.14
Hwei,Vex,290,160,130,55.17
Hwei,Sona,128,69,59,53.91
Hwei,DrMundo,245,107,138,43.67
Hwei,Kayle,374,196,178,52.41
Hwei,Draven,282,128,154,45.39
Hwei,Tryndamere,325,198,127,60.92
Hwei,MonkeyKing,210,91,119,43.33
Hwei,Elise,330,146,184,44.24
Hwei,Aurora,396,244,152,61.62
Hwei,Quinn,123,41,82,33.33
Hwei,Galio,365,150,215,41.1
Hwei,Kennen,196,100,96,51.02
Hwei,Belveth,117,51,66,43.59
Hwei,Brand,347,149,198,42.94
Hwei,Gragas,239,89,150,37.24
Hwei,Morgana,586,279,307,47.61
Hwei,Swain,537,216,321,40.22
Hwei,Shaco,420,193,227,45.95
Hwei,Zyra,270,134,136,49.63
Hwei,Zoe,263,143,120,54.37
Hwei,Kindred,244,163,81,66.8
Hwei,Chogath,548,294,254,53.65
Hwei,Malphite,379,173,206,45.65
Hwei,Vladimir,279,122,157,43.73
Hwei,Nunu,404,229,175,56.68
Hwei,Cassiopeia,172,89,83,51.74
Hwei,Ornn,160,70,90,43.75
Hwei,Twitch,359,159,200,44.29
Hwei,Vayne,483,228,255,47.2
Hwei,Maokai,150,66,84,44
Hwei,Sivir,226,126,100,55.75
Hwei,Anivia,111,75,36,67.57
Hwei,Trundle,213,102,111,47.89
Hwei,JarvanIV,159,50,109,31.45
Hwei,Aatrox,446,248,198,55.61
Hwei,Milio,275,133,142,48.36
Hwei,Ziggs,214,114,100,53.27
Hwei,Leblanc,188,108,80,57.45
Hwei,Senna,369,151,218,40.92
Hwei,Karthus,136,71,65,52.21
Hwei,Akshan,195,53,142,27.18
Hwei,Kalista,233,139,94,59.66
Hwei,Garen,613,301,312,49.1
Hwei,MasterYi,422,195,227,46.21
Hwei,Nilah,279,106,173,37.99
Hwei,Lillia,270,123,147,45.56
Hwei,Fizz,223,107,116,47.98
Hwei,Nasus,310,159,151,51.29
Hwei,Orianna,159,55,104,34.59
Hwei,Jayce,147,76,71,51.7
Hwei,Camille,126,64,62,50.79
Hwei,Urgot,200,105,95,52.5
Hwei,Talon,276,142,134,51.45
Hwei,Sylas,382,210,172,54.97
Hwei,Hecarim,180,84,96,46.67
Hwei,Riven,180,105,75,58.33
Hwei,KSante,158,96,62,60.76
Hwei,XinZhao,177,83,94,46.89
Hwei,TwistedFate,136,64,72,47.06
Hwei,Ivern,103,70,33,67.96
Hwei,Taliyah,136,51,85,37.5
Hwei,Alistar,105,55,50,52.38
Hwei,Rakan,230,120,110,52.17
Hwei,Singed,107,63,44,58.88
Hwei,Annie,106,47,59,44.34
Hwei,RekSai,65,32,33,49.23
Hwei,Skarner,113,56,57,49.56
Hwei,Janna,131,64,67,48.85
Hwei,Rammus,138,77,61,55.8
Hwei,Corki,152,84,68,55.26
Hwei,Zac,135,79,56,58.52
Hwei,Renata,99,62,37,62.63
Hwei,Azir,171,85,86,49.71
Hwei,Olaf,113,52,61,46.02
Hwei,Shyvana,116,45,71,38.79
Hwei,Zilean,96,46,50,47.92
Hwei,Kled,77,31,46,40.26
Hwei,Rumble,46,23,23,50
Lucian,Sett,598,269,329,44.98
Lucian,Warwick,490,230,260,46.94
Lucian,Shen,253,157,96,62.06
Lucian,Tristana,263,111,152,42.21
Lucian,Blitzcrank,300,167,133,55.67
Lucian,Singed,81,40,41,49.38
Lucian,Shaco,240,102,138,42.5
Lucian,Zed,303,152,151,50.17
Lucian,Hwei,255,110,145,43.14
Lucian,Lux,912,437,475,47.92
Lucian,DrMundo,198,73,125,36.87
Lucian,Lillia,189,72,117,38.1
Lucian,Viktor,252,140,112,55.56
Lucian,Jhin,677,323,354,47.71
Lucian,Pyke,408,247,161,60.54
Lucian,Jax,247,130,117,52.63
Lucian,Elise,208,104,104,50
Lucian,Naafiri,138,56,82,40.58
Lucian,Lulu,304,171,133,56.25
Lucian,Gwen,275,137,138,49.82
Lucian,Tryndamere,180,67,113,37.22
Lucian,Velkoz,207,94,113,45.41
Lucian,Zeri,222,116,106,52.25
Lucian,Thresh,473,237,236,50.11
Lucian,Brand,202,123,79,60.89
Lucian,Twitch,340,173,167,50.88
Lucian,Morgana,367,159,208,43.32
Lucian,Riven,188,87,101,46.28
Lucian,LeeSin,329,177,152,53.8
Lucian,Mel,789,365,424,46.26
Lucian,Zac,141,57,84,40.43
Lucian,Volibear,331,176,155,53.17
Lucian,Syndra,199,81,118,40.7
Lucian,Jinx,664,317,347,47.74
Lucian,FiddleSticks,164,86,78,52.44
Lucian,Akali,308,143,165,46.43
Lucian,Ambessa,179,79,100,44.13
Lucian,Yuumi,328,151,177,46.04
Lucian,Qiyana,82,59,23,71.95
Lucian,Caitlyn,772,366,406,47.41
Lucian,Illaoi,180,95,85,52.78
Lucian,Ekko,270,119,151,44.07
Lucian,Leona,207,101,106,48.79
Lucian,Ashe,643,286,357,44.48
Lucian,MasterYi,297,131,166,44.11
Lucian,AurelionSol,198,73,125,36.87
Lucian,Ezreal,630,365,265,57.94
Lucian,Seraphine,338,148,190,43.79
Lucian,Teemo,410,208,202,50.73
Lucian,Rammus,76,15,61,19.74
Lucian,Fizz,205,86,119,41.95
Lucian,TahmKench,384,147,237,38.28
Lucian,Briar,338,149,189,44.08
Lucian,Fiora,149,63,86,42.28
Lucian,Cassiopeia,91,50,41,54.95
Lucian,MonkeyKing,143,49,94,34.27
Lucian,Nilah,209,125,84,59.81
Lucian,Evelynn,139,80,59,57.55
Lucian,Ahri,452,225,227,49.78
Lucian,Chogath,406,217,189,53.45
Lucian,Nocturne,311,158,153,50.8
Lucian,Irelia,270,141,129,52.22
Lucian,Gnar,126,65,61,51.59
Lucian,Kayn,548,274,274,50
Lucian,Katarina,294,140,154,47.62
Lucian,Renekton,101,57,44,56.44
Lucian,Leblanc,118,69,49,58.47
Lucian,Aphelios,292,154,138,52.74
Lucian,Graves,184,101,83,54.89
Lucian,Zoe,134,75,59,55.97
Lucian,Yasuo,755,374,381,49.54
Lucian,Trundle,172,71,101,41.28
Lucian,Kayle,216,104,112,48.15
Lucian,Milio,183,90,93,49.18
Lucian,Sylas,316,156,160,49.37
Lucian,Mordekaiser,487,254,233,52.16
Lucian,Talon,263,115,148,43.73
Lucian,Yone,612,330,282,53.92
Lucian,Varus,273,143,130,52.38
Lucian,Sejuani,146,67,79,45.89
Lucian,Azir,151,83,68,54.97
Lucian,Yorick,274,136,138,49.64
Lucian,Ivern,81,47,34,58.02
Lucian,Aatrox,362,176,186,48.62
Lucian,Aurora,361,161,200,44.6
Lucian,MissFortune,628,259,369,41.24
Lucian,Braum,126,42,84,33.33
Lucian,Galio,234,73,161,31.2
Lucian,Sona,132,64,68,48.48
Lucian,Soraka,227,114,113,50.22
Lucian,Sion,272,160,112,58.82
Lucian,Diana,426,217,209,50.94
Lucian,Orianna,148,68,80,45.95
Lucian,Kaisa,541,266,275,49.17
Lucian,Nami,334,144,190,43.11
Lucian,Garen,483,187,296,38.72
Lucian,JarvanIV,123,64,59,52.03
Lucian,XinZhao,193,60,133,31.09
Lucian,Ziggs,134,63,71,47.01
Lucian,Xayah,226,113,113,50
Lucian,Akshan,140,103,37,73.57
Lucian,Camille,123,56,67,45.53
Lucian,Nautilus,299,141,158,47.16
Lucian,KSante,136,57,79,41.91
Lucian,Skarner,120,70,50,58.33
Lucian,Nunu,274,171,103,62.41
Lucian,Urgot,170,65,105,38.24
Lucian,Kassadin,43,17,26,39.53
Lucian,Senna,262,114,148,43.51
Lucian,Darius,698,307,391,43.98
Lucian,Heimerdinger,171,86,85,50.29
Lucian,Draven,139,64,75,46.04
Lucian,Smolder,221,119,102,53.85
Lucian,Pantheon,583,291,292,49.91
Lucian,Gragas,234,112,122,47.86
Lucian,Amumu,335,162,173,48.36
Lucian,Nasus,292,171,121,58.56
Lucian,Rell,153,74,79,48.37
Lucian,Neeko,251,117,134,46.61
Lucian,Vayne,346,160,186,46.24
Lucian,Kennen,136,65,71,47.79
Lucian,Vi,403,173,230,42.93
Lucian,Lissandra,67,39,28,58.21
Lucian,Zilean,129,65,64,50.39
Lucian,Khazix,184,80,104,43.48
Lucian,Rengar,147,83,64,56.46
Lucian,Rakan,241,129,112,53.53
Lucian,Kled,75,41,34,54.67
Lucian,Vladimir,158,73,85,46.2
Lucian,Karma,211,91,120,43.13
Lucian,Corki,85,43,42,50.59
Lucian,Sivir,184,52,132,28.26
Lucian,Hecarim,127,47,80,37.01
Lucian,Renata,55,43,12,78.18
Lucian,Viego,395,200,195,50.63
Lucian,Kindred,159,77,82,48.43
Lucian,Malzahar,251,113,138,45.02
Lucian,Ryze,127,68,59,53.54
Lucian,Poppy,220,77,143,35
Lucian,Zyra,215,89,126,41.4
Lucian,Karthus,51,22,29,43.14
Lucian,Anivia,88,55,33,62.5
Lucian,Malphite,254,112,142,44.09
Lucian,Samira,288,143,145,49.65
Lucian,Taliyah,90,47,43,52.22
Lucian,Vex,229,109,120,47.6
Lucian,Shyvana,99,77,22,77.78
Lucian,Gangplank,165,71,94,43.03
Lucian,Alistar,110,61,49,55.45
Lucian,Olaf,70,22,48,31.43
Lucian,Xerath,200,91,109,45.5
Lucian,Janna,135,63,72,46.67
Lucian,Quinn,85,30,55,35.29
Lucian,Taric,58,20,38,34.48
Lucian,Udyr,135,74,61,54.81
Lucian,Bard,86,47,39,54.65
Lucian,Ornn,157,83,74,52.87
Lucian,Nidalee,113,63,50,55.75
Lucian,Swain,265,117,148,44.15
Lucian,Maokai,140,74,66,52.86
Lucian,Veigar,396,153,243,38.64
Lucian,RekSai,45,19,26,42.22
Lucian,TwistedFate,136,75,61,55.15
Lucian,KogMaw,115,61,54,53.04
Lucian,Belveth,76,15,61,19.74
Lucian,Kalista,183,88,95,48.09
Lucian,Jayce,142,76,66,53.52
Lucian,Annie,84,36,48,42.86
Lucian,Rumble,73,38,35,52.05
Maokai,Sett,549,280,269,51
Maokai,Warwick,387,185,202,47.8
Maokai,Shen,173,99,74,57.23
Maokai,Tristana,143,74,69,51.75
Maokai,Blitzcrank,237,175,62,73.84
Maokai,Pantheon,436,209,227,47.94
Maokai,MasterYi,257,139,118,54.09
Maokai,Sylas,245,126,119,51.43
Maokai,Ashe,400,225,175,56.25
Maokai,Karma,155,102,53,65.81
Maokai,Darius,566,301,265,53.18
Maokai,Rengar,119,68,51,57.14
Maokai,Syndra,102,48,54,47.06
Maokai,Caitlyn,655,342,313,52.21
Maokai,Lux,676,315,361,46.6
Maokai,Kayn,522,257,265,49.23
Maokai,Akali,245,117,128,47.76
Maokai,Akshan,126,65,61,51.59
Maokai,TahmKench,255,145,110,56.86
Maokai,Ivern,75,28,47,37.33
Maokai,Katarina,274,139,135,50.73
Maokai,Ezreal,473,289,184,61.1
Maokai,Kled,53,24,29,45.28
Maokai,Ambessa,184,93,91,50.54
Maokai,Diana,329,150,179,45.59
Maokai,Nilah,251,107,144,42.63
Maokai,Leona,186,82,104,44.09
Maokai,Rammus,71,55,16,77.46
Maokai,Aurora,242,140,102,57.85
Maokai,Swain,313,118,195,37.7
Maokai,Chogath,336,162,174,48.21
Maokai,Yasuo,478,261,217,54.6
Maokai,Kaisa,338,184,154,54.44
Maokai,Yuumi,288,146,142,50.69
Maokai,Kennen,69,47,22,68.12
Maokai,TwistedFate,115,64,51,55.65
Maokai,Cassiopeia,92,58,34,63.04
Maokai,Smolder,201,102,99,50.75
Maokai,Milio,179,118,61,65.92
Maokai,Mordekaiser,392,180,212,45.92
Maokai,Veigar,256,127,129,49.61
Maokai,Thresh,343,179,164,52.19
Maokai,XinZhao,139,84,55,60.43
Maokai,MissFortune,518,281,237,54.25
Maokai,Garen,354,224,130,63.28
Maokai,Nocturne,208,106,102,50.96
Maokai,Vladimir,132,66,66,50
Maokai,Ekko,193,96,97,49.74
Maokai,Singed,82,44,38,53.66
Maokai,Kindred,164,85,79,51.83
Maokai,Morgana,428,220,208,51.4
Maokai,Lillia,163,98,65,60.12
Maokai,Pyke,309,156,153,50.49
Maokai,Ahri,311,159,152,51.13
Maokai,Viego,343,161,182,46.94
Maokai,Aatrox,248,147,101,59.27
Maokai,Renata,78,35,43,44.87
Maokai,Yorick,295,160,135,54.24
Maokai,Azir,94,44,50,46.81
Maokai,Twitch,189,97,92,51.32
Maokai,Lulu,200,93,107,46.5
Maokai,Heimerdinger,129,54,75,41.86
Maokai,Briar,250,136,114,54.4
Maokai,Jinx,481,267,214,55.51
Maokai,Nasus,211,114,97,54.03
Maokai,Shaco,181,74,107,40.88
Maokai,Sona,47,35,12,74.47
Maokai,Urgot,137,65,72,47.45
Maokai,Seraphine,339,142,197,41.89
Maokai,Jax,217,92,125,42.4
Maokai,Jhin,433,234,199,54.04
Maokai,Braum,104,71,33,68.27
Maokai,Irelia,282,149,133,52.84
Maokai,Velkoz,185,102,83,55.14
Maokai,Renekton,121,53,68,43.8
Maokai,Nautilus,314,227,87,72.29
Maokai,Zyra,153,87,66,56.86
Maokai,Yone,470,258,212,54.89
Maokai,Amumu,253,155,98,61.26
Maokai,Zed,222,118,104,53.15
Maokai,Draven,193,104,89,53.89
Maokai,LeeSin,261,194,67,74.33
Maokai,Vex,113,54,59,47.79
Maokai,FiddleSticks,103,51,52,49.51
Maokai,Volibear,283,124,159,43.82
Maokai,Rumble,40,33,7,82.5
Maokai,Xayah,115,66,49,57.39
Maokai,Fiora,97,45,52,46.39
Maokai,Vayne,397,197,200,49.62
Maokai,Khazix,153,85,68,55.56
Maokai,Qiyana,134,76,58,56.72
Maokai,RekSai,15,9,6,60
Maokai,Poppy,154,83,71,53.9
Maokai,Teemo,373,200,173,53.62
Maokai,Mel,615,346,269,56.26
Maokai,Gnar,73,28,45,38.36
Maokai,Hwei,150,84,66,56
Maokai,Aphelios,187,77,110,41.18
Maokai,Nami,172,85,87,49.42
Maokai,Orianna,144,82,62,56.94
Maokai,Udyr,124,92,32,74.19
Maokai,Annie,60,29,31,48.33
Maokai,Neeko,247,110,137,44.53
Maokai,Kassadin,77,34,43,44.16
Maokai,Riven,120,89,31,74.17
Maokai,Malzahar,213,126,87,59.15
Maokai,Zoe,102,83,19,81.37
Maokai,Sivir,114,67,47,58.77
Maokai,Viktor,231,110,121,47.62
Maokai,Camille,43,13,30,30.23
Maokai,Soraka,152,67,85,44.08
Maokai,Samira,272,138,134,50.74
Maokai,MonkeyKing,129,89,40,68.99
Maokai,Graves,137,70,67,51.09
Maokai,Tryndamere,118,58,60,49.15
Maokai,Ziggs,86,43,43,50
Maokai,Senna,275,156,119,56.73
Maokai,Kayle,214,122,92,57.01
Maokai,Sion,249,108,141,43.37
Maokai,Gwen,131,84,47,64.12
Maokai,Nunu,241,116,125,48.13
Maokai,Fizz,138,58,80,42.03
Maokai,Lucian,140,66,74,47.14
Maokai,Janna,92,57,35,61.96
Maokai,Hecarim,83,30,53,36.14
Maokai,Zeri,102,49,53,48.04
Maokai,Brand,206,107,99,51.94
Maokai,Varus,245,111,134,45.31
Maokai,Taric,76,33,43,43.42
Maokai,Vi,178,65,113,36.52
Maokai,Jayce,134,115,19,85.82
Maokai,Gragas,201,139,62,69.15
Maokai,Xerath,158,90,68,56.96
Maokai,Shyvana,56,45,11,80.36
Maokai,Malphite,147,69,78,46.94
Maokai,Ryze,86,52,34,60.47
Maokai,Galio,111,61,50,54.95
Maokai,Talon,160,103,57,64.38
Maokai,JarvanIV,111,45,66,40.54
Maokai,KSante,133,82,51,61.65
Maokai,Illaoi,111,49,62,44.14
Maokai,Rakan,120,55,65,45.83
Maokai,Zac,84,35,49,41.67
Maokai,DrMundo,188,109,79,57.98
Maokai,KogMaw,104,26,78,25
Maokai,Naafiri,108,63,45,58.33
Maokai,Leblanc,107,78,29,72.9
Maokai,Elise,159,107,52,67.3
Maokai,Gangplank,89,32,57,35.96
Maokai,Bard,77,60,17,77.92
Maokai,Lissandra,60,40,20,66.67
Maokai,Rell,177,89,88,50.28
Maokai,Belveth,50,27,23,54
Maokai,Olaf,65,31,34,47.69
Maokai,Nidalee,87,52,35,59.77
Maokai,Sejuani,91,33,58,36.26
Maokai,Corki,75,39,36,52
Maokai,Quinn,79,37,42,46.84
Maokai,Evelynn,142,78,64,54.93
Maokai,Ornn,101,59,42,58.42
Maokai,Alistar,89,42,47,47.19
Maokai,Trundle,149,92,57,61.74
Maokai,Karthus,71,35,36,49.3
Maokai,Kalista,107,83,24,77.57
Maokai,Zilean,71,28,43,39.44
Maokai,Skarner,47,18,29,38.3
Maokai,AurelionSol,123,68,55,55.28
Maokai,Anivia,65,22,43,33.85
Maokai,Taliyah,87,40,47,45.98
Yone,Mordekaiser,1944,1033,911,53.14
Yone,Qiyana,364,178,186,48.9
Yone,Irelia,1163,545,618,46.86
Yone,Ezreal,1871,938,933,50.13
Yone,Rell,560,287,273,51.25
Yone,Renekton,516,199,317,38.57
Yone,Kayn,1997,1008,989,50.48
Yone,Katarina,1000,563,437,56.3
Yone,Draven,655,323,332,49.31
Yone,Yuumi,1124,579,545,51.51
Yone,Kayle,764,375,389,49.08
Yone,Sylas,1125,480,645,42.67
Yone,Caitlyn,2722,1381,1341,50.73
Yone,Renata,268,115,153,42.91
Yone,Warwick,1847,815,1032,44.13
Yone,Mel,2532,1315,1217,51.94
Yone,Nautilus,1228,656,572,53.42
Yone,Gangplank,431,227,204,52.67
Yone,Akali,1402,648,754,46.22
Yone,Sona,437,184,253,42.11
Yone,Aatrox,1236,632,604,51.13
Yone,Sejuani,400,143,257,35.75
Yone,Yasuo,2803,1434,1369,51.16
Yone,Jinx,2256,1017,1239,45.08
Yone,Pyke,1409,736,673,52.24
Yone,Heimerdinger,662,282,380,42.6
Yone,Neeko,911,450,461,49.4
Yone,Leona,696,324,372,46.55
Yone,Jax,1000,465,535,46.5
Yone,Nidalee,273,151,122,55.31
Yone,Ahri,1587,732,855,46.12
Yone,Jhin,2011,954,1057,47.44
Yone,Senna,990,387,603,39.09
Yone,Sett,2215,1055,1160,47.63
Yone,Taliyah,275,148,127,53.82
Yone,Cassiopeia,508,255,253,50.2
Yone,Kaisa,1773,913,860,51.49
Yone,Teemo,1612,686,926,42.56
Yone,Hecarim,422,174,248,41.23
Yone,Veigar,1345,649,696,48.25
Yone,Ashe,1970,961,1009,48.78
Yone,Thresh,1457,707,750,48.52
Yone,Morgana,1606,731,875,45.52
Yone,Viego,1325,691,634,52.15
Yone,Kindred,635,344,291,54.17
Yone,TahmKench,1282,647,635,50.47
Yone,Diana,1425,715,710,50.18
Yone,Lux,3214,1558,1656,48.48
Yone,Tristana,1102,583,519,52.9
Yone,Vladimir,662,302,360,45.62
Yone,Zac,335,151,184,45.07
Yone,Amumu,1113,441,672,39.62
Yone,Xayah,709,335,374,47.25
Yone,Darius,2088,997,1091,47.75
Yone,AurelionSol,509,245,264,48.13
Yone,MissFortune,2527,1109,1418,43.89
Yone,Talon,707,334,373,47.24
Yone,Leblanc,331,178,153,53.78
Yone,Soraka,617,297,320,48.14
Yone,Naafiri,659,389,270,59.03
Yone,Nunu,1117,539,578,48.25
Yone,Malzahar,755,342,413,45.3
Yone,Zeri,510,245,265,48.04
Yone,Ekko,904,433,471,47.9
Yone,Riven,505,244,261,48.32
Yone,Ivern,189,102,87,53.97
Yone,Swain,1213,557,656,45.92
Yone,Nami,986,492,494,49.9
Yone,Sivir,530,274,256,51.7
Yone,Trundle,628,296,332,47.13
Yone,Gragas,679,373,306,54.93
Yone,Vex,838,407,431,48.57
Yone,Kennen,350,182,168,52
Yone,Rammus,480,162,318,33.75
Yone,Nasus,955,411,544,43.04
Yone,Smolder,893,474,419,53.08
Yone,Sion,901,447,454,49.61
Yone,Rengar,546,325,221,59.52
Yone,Anivia,318,167,151,52.52
Yone,Poppy,826,421,405,50.97
Yone,Illaoi,682,266,416,39
Yone,Aurora,1259,629,630,49.96
Yone,Tryndamere,698,340,358,48.71
Yone,Zyra,748,310,438,41.44
Yone,Nilah,536,222,314,41.42
Yone,FiddleSticks,576,254,322,44.1
Yone,Blitzcrank,823,440,383,53.46
Yone,Zed,1051,540,511,51.38
Yone,Rakan,622,350,272,56.27
Yone,Evelynn,656,341,315,51.98
Yone,Lissandra,317,155,162,48.9
Yone,XinZhao,622,271,351,43.57
Yone,Vayne,1027,524,503,51.02
Yone,Brand,852,420,432,49.3
Yone,Pantheon,2077,1018,1059,49.01
Yone,Braum,386,158,228,40.93
Yone,Gnar,471,237,234,50.32
Yone,Shaco,1162,628,534,54.04
Yone,Seraphine,1250,604,646,48.32
Yone,Nocturne,890,437,453,49.1
Yone,Orianna,467,245,222,52.46
Yone,LeeSin,1111,598,513,53.83
Yone,Garen,1706,881,825,51.64
Yone,Kled,192,102,90,53.13
Yone,Alistar,370,177,193,47.84
Yone,DrMundo,840,393,447,46.79
Yone,Akshan,448,214,234,47.77
Yone,Zilean,302,161,141,53.31
Yone,Hwei,802,398,404,49.63
Yone,Azir,387,177,210,45.74
Yone,Taric,254,95,159,37.4
Yone,Briar,1121,504,617,44.96
Yone,Ornn,462,184,278,39.83
Yone,MasterYi,1061,551,510,51.93
Yone,Yorick,991,408,583,41.17
Yone,Velkoz,746,325,421,43.57
Yone,Volibear,1311,529,782,40.35
Yone,Quinn,284,148,136,52.11
Yone,Varus,862,419,443,48.61
Yone,Fiora,586,289,297,49.32
Yone,Twitch,919,438,481,47.66
Yone,Lulu,860,410,450,47.67
Yone,Xerath,630,290,340,46.03
Yone,Annie,291,173,118,59.45
Yone,Chogath,1595,802,793,50.28
Yone,Vi,978,466,512,47.65
Yone,Galio,808,378,430,46.78
Yone,Samira,1211,607,604,50.12
Yone,Lucian,612,282,330,46.08
Yone,Jayce,552,278,274,50.36
Yone,KogMaw,392,174,218,44.39
Yone,Ryze,272,141,131,51.84
Yone,Zoe,488,269,219,55.12
Yone,Gwen,695,368,327,52.95
Yone,RekSai,129,77,52,59.69
Yone,MonkeyKing,581,264,317,45.44
Yone,Kalista,566,343,223,60.6
Yone,Camille,316,151,165,47.78
Yone,Udyr,401,206,195,51.37
Yone,TwistedFate,301,148,153,49.17
Yone,Aphelios,798,344,454,43.11
Yone,KSante,375,214,161,57.07
Yone,Graves,637,308,329,48.35
Yone,Olaf,302,161,141,53.31
Yone,Karma,648,313,335,48.3
Yone,Viktor,635,354,281,55.75
Yone,Bard,324,145,179,44.75
Yone,Karthus,288,175,113,60.76
Yone,Malphite,953,406,547,42.6
Yone,Ziggs,548,283,265,51.64
Yone,Shyvana,338,150,188,44.38
Yone,Maokai,470,212,258,45.11
Yone,Lillia,734,357,377,48.64
Yone,Belveth,286,140,146,48.95
Yone,Janna,315,158,157,50.16
Yone,Fizz,589,248,341,42.11
Yone,Singed,239,99,140,41.42
Yone,Khazix,753,389,364,51.66
Yone,JarvanIV,342,148,194,43.27
Yone,Shen,773,297,476,38.42
Yone,Rumble,178,90,88,50.56
Yone,Elise,634,348,286,54.89
Yone,Urgot,485,221,264,45.57
Yone,Milio,463,228,235,49.24
Yone,Kassadin,188,97,91,51.6
Yone,Syndra,667,270,397,40.48
Yone,Ambessa,681,312,369,45.81
Yone,Corki,271,165,106,60.89
Yone,Skarner,291,157,134,53.95
Darius,Mordekaiser,1949,1038,911,53.26
Darius,Qiyana,330,210,120,63.64
Darius,Irelia,988,518,470,52.43
Darius,Ezreal,1859,1027,832,55.24
Darius,Rell,647,321,326,49.61
Darius,Fiora,600,342,258,57
Darius,Pantheon,1924,880,1044,45.74
Darius,Katarina,937,468,469,49.95
Darius,Mel,2335,1161,1174,49.72
Darius,Viktor,720,387,333,53.75
Darius,Illaoi,618,222,396,35.92
Darius,Warwick,1940,937,1003,48.3
Darius,Diana,1415,684,731,48.34
Darius,Tristana,921,490,431,53.2
Darius,Milio,633,327,306,51.66
Darius,Viego,1218,577,641,47.37
Darius,Jhin,1990,1045,945,52.51
Darius,Lux,2777,1268,1509,45.66
Darius,Aatrox,1212,632,580,52.15
Darius,Ekko,890,459,431,51.57
Darius,Orianna,527,272,255,51.61
Darius,Malzahar,809,329,480,40.67
Darius,Maokai,566,265,301,46.82
Darius,Sett,2075,985,1090,47.47
Darius,Zac,331,178,153,53.78
Darius,Yasuo,2070,1151,919,55.6
Darius,MissFortune,2303,1045,1258,45.38
Darius,Yone,2088,1091,997,52.25
Darius,Galio,765,392,373,51.24
Darius,Chogath,1549,769,780,49.64
Darius,Vladimir,550,302,248,54.91
Darius,Evelynn,572,264,308,46.15
Darius,Yuumi,994,486,508,48.89
Darius,Poppy,622,312,310,50.16
Darius,Veigar,1245,617,628,49.56
Darius,Heimerdinger,639,268,371,41.94
Darius,Ziggs,503,234,269,46.52
Darius,Volibear,1221,563,658,46.11
Darius,Akshan,377,156,221,41.38
Darius,Morgana,1508,780,728,51.72
Darius,FiddleSticks,419,219,200,52.27
Darius,Singed,262,134,128,51.15
Darius,Pyke,1194,611,583,51.17
Darius,Lillia,843,434,409,51.48
Darius,Jinx,2131,999,1132,46.88
Darius,Lulu,894,481,413,53.8
Darius,Nasus,890,460,430,51.69
Darius,Khazix,574,340,234,59.23
Darius,Urgot,488,226,262,46.31
Darius,Tryndamere,723,368,355,50.9
Darius,Briar,1236,617,619,49.92
Darius,Janna,277,156,121,56.32
Darius,Ambessa,534,287,247,53.75
Darius,Smolder,856,431,425,50.35
Darius,Swain,1225,552,673,45.06
Darius,Kayn,1808,901,907,49.83
Darius,Akali,1050,515,535,49.05
Darius,TahmKench,1477,767,710,51.93
Darius,Kalista,528,310,218,58.71
Darius,Thresh,1388,713,675,51.37
Darius,Udyr,500,272,228,54.4
Darius,Yorick,1061,480,581,45.24
Darius,Karma,725,411,314,56.69
Darius,Gnar,432,245,187,56.71
Darius,Brand,774,349,425,45.09
Darius,Caitlyn,2764,1381,1383,49.96
Darius,Velkoz,646,302,344,46.75
Darius,XinZhao,610,277,333,45.41
Darius,Samira,1089,547,542,50.23
Darius,Zed,1185,607,578,51.22
Darius,Graves,524,246,278,46.95
Darius,Kassadin,258,127,131,49.22
Darius,Vex,601,315,286,52.41
Darius,Vi,914,467,447,51.09
Darius,Nilah,646,331,315,51.24
Darius,Gangplank,513,252,261,49.12
Darius,Nunu,852,428,424,50.23
Darius,Soraka,775,361,414,46.58
Darius,Aurora,952,531,421,55.78
Darius,Nocturne,931,437,494,46.94
Darius,Olaf,242,117,125,48.35
Darius,Ashe,1916,974,942,50.84
Darius,Kayle,963,516,447,53.58
Darius,Vayne,1135,544,591,47.93
Darius,Hwei,926,389,537,42.01
Darius,Senna,1084,508,576,46.86
Darius,Malphite,808,358,450,44.31
Darius,Naafiri,597,341,256,57.12
Darius,Trundle,695,311,384,44.75
Darius,Riven,574,351,223,61.15
Darius,Seraphine,1242,613,629,49.36
Darius,Sion,984,464,520,47.15
Darius,Twitch,756,374,382,49.47
Darius,Sylas,1047,552,495,52.72
Darius,Kaisa,1457,713,744,48.94
Darius,Renata,273,158,115,57.88
Darius,Aphelios,741,336,405,45.34
Darius,Nautilus,1098,618,480,56.28
Darius,DrMundo,732,342,390,46.72
Darius,Jax,911,412,499,45.23
Darius,Shaco,1051,506,545,48.14
Darius,Talon,636,306,330,48.11
Darius,Taliyah,324,144,180,44.44
Darius,Zoe,548,340,208,62.04
Darius,Quinn,377,189,188,50.13
Darius,Shyvana,341,197,144,57.77
Darius,Fizz,577,299,278,51.82
Darius,Taric,254,117,137,46.06
Darius,Cassiopeia,413,209,204,50.61
Darius,Ornn,412,191,221,46.36
Darius,Shen,734,380,354,51.77
Darius,MasterYi,1128,604,524,53.55
Darius,Nami,1158,601,557,51.9
Darius,AurelionSol,504,255,249,50.6
Darius,Gragas,640,314,326,49.06
Darius,RekSai,168,92,76,54.76
Darius,KSante,466,270,196,57.94
Darius,Draven,695,375,320,53.96
Darius,Varus,901,440,461,48.83
Darius,Sejuani,407,187,220,45.95
Darius,Neeko,737,412,325,55.9
Darius,Kennen,416,186,230,44.71
Darius,Garen,2022,922,1100,45.6
Darius,Rakan,605,262,343,43.31
Darius,Ryze,322,206,116,63.98
Darius,Blitzcrank,805,430,375,53.42
Darius,LeeSin,1137,634,503,55.76
Darius,Ahri,1428,786,642,55.04
Darius,Jayce,420,225,195,53.57
Darius,Renekton,519,281,238,54.14
Darius,Rammus,339,179,160,52.8
Darius,Camille,283,139,144,49.12
Darius,Xayah,692,301,391,43.5
Darius,Sona,426,219,207,51.41
Darius,Teemo,1635,761,874,46.54
Darius,Belveth,245,138,107,56.33
Darius,Azir,384,198,186,51.56
Darius,Leblanc,428,201,227,46.96
Darius,Amumu,1050,454,596,43.24
Darius,Skarner,359,174,185,48.47
Darius,Zilean,365,179,186,49.04
Darius,Lucian,698,391,307,56.02
Darius,Syndra,625,313,312,50.08
Darius,Hecarim,453,259,194,57.17
Darius,KogMaw,338,170,168,50.3
Darius,Rengar,456,275,181,60.31
Darius,Zyra,755,341,414,45.17
Darius,TwistedFate,419,256,163,61.1
Darius,Leona,741,324,417,43.72
Darius,Annie,263,132,131,50.19
Darius,Xerath,712,310,402,43.54
Darius,Sivir,452,212,240,46.9
Darius,Zeri,480,243,237,50.63
Darius,Karthus,330,164,166,49.7
Darius,Kindred,639,402,237,62.91
Darius,Lissandra,238,106,132,44.54
Darius,Alistar,271,139,132,51.29
Darius,Gwen,664,329,335,49.55
Darius,Corki,385,219,166,56.88
Darius,Nidalee,292,177,115,60.62
Darius,JarvanIV,349,147,202,42.12
Darius,Elise,605,315,290,52.07
Darius,Braum,448,262,186,58.48
Darius,Rumble,216,123,93,56.94
Darius,Bard,385,215,170,55.84
Darius,Kled,252,131,121,51.98
Darius,MonkeyKing,479,218,261,45.51
Darius,Ivern,294,161,133,54.76
Darius,Anivia,283,133,150,47
Yasuo,Mordekaiser,1705,789,916,46.28
Yasuo,Qiyana,394,230,164,58.38
Yasuo,Irelia,1198,541,657,45.16
Yasuo,Ezreal,1896,1009,887,53.22
Yasuo,Rell,590,299,291,50.68
Yasuo,Singed,265,107,158,40.38
Yasuo,Shaco,1016,524,492,51.57
Yasuo,Zed,1296,753,543,58.1
Yasuo,Hwei,789,388,401,49.18
Yasuo,Lux,3038,1616,1422,53.19
Yasuo,Renekton,594,345,249,58.08
Yasuo,Khazix,737,416,321,56.45
Yasuo,Mel,2662,1443,1219,54.21
Yasuo,Jhin,2021,1015,1006,50.22
Yasuo,Aatrox,1238,684,554,55.25
Yasuo,Sylas,1258,695,563,55.25
Yasuo,Diana,1416,684,732,48.31
Yasuo,Varus,827,449,378,54.29
Yasuo,Blitzcrank,861,436,425,50.64
Yasuo,Ambessa,770,369,401,47.92
Yasuo,Rammus,459,179,280,39
Yasuo,Draven,714,410,304,57.42
Yasuo,Viego,1395,677,718,48.53
Yasuo,Teemo,1615,728,887,45.08
Yasuo,Warwick,1828,914,914,50
Yasuo,Azir,427,192,235,44.96
Yasuo,MissFortune,2712,1365,1347,50.33
Yasuo,Neeko,877,507,370,57.81
Yasuo,Gangplank,492,241,251,48.98
Yasuo,Brand,772,407,365,52.72
Yasuo,Malzahar,988,495,493,50.1
Yasuo,Pyke,1373,692,681,50.4
Yasuo,Briar,1142,587,555,51.4
Yasuo,Ryze,378,235,143,62.17
Yasuo,Vex,752,359,393,47.74
Yasuo,Yuumi,1131,607,524,53.67
Yasuo,Naafiri,514,288,226,56.03
Yasuo,Yone,2803,1369,1434,48.84
Yasuo,Senna,1067,503,564,47.14
Yasuo,Galio,814,393,421,48.28
Yasuo,TahmKench,1240,628,612,50.65
Yasuo,Hecarim,441,193,248,43.76
Yasuo,Veigar,1222,622,600,50.9
Yasuo,Ashe,2056,1003,1053,48.78
Yasuo,Thresh,1504,747,757,49.67
Yasuo,Sett,1950,1003,947,51.44
Yasuo,Amumu,962,467,495,48.54
Yasuo,Caitlyn,2763,1465,1298,53.02
Yasuo,Poppy,649,304,345,46.84
Yasuo,Malphite,906,427,479,47.13
Yasuo,Evelynn,672,351,321,52.23
Yasuo,Tristana,1147,581,566,50.65
Yasuo,Garen,1848,874,974,47.29
Yasuo,Kayn,1963,991,972,50.48
Yasuo,Riven,534,297,237,55.62
Yasuo,Zoe,523,326,197,62.33
Yasuo,Sona,425,201,224,47.29
Yasuo,Nocturne,1067,457,610,42.83
Yasuo,Jinx,2192,1099,1093,50.14
Yasuo,Lulu,905,456,449,50.39
Yasuo,Samira,999,498,501,49.85
Yasuo,Darius,2070,919,1151,44.4
Yasuo,Volibear,1273,637,636,50.04
Yasuo,Chogath,1500,659,841,43.93
Yasuo,Sivir,540,270,270,50
Yasuo,Rakan,599,275,324,45.91
Yasuo,Jax,1091,569,522,52.15
Yasuo,Xayah,757,358,399,47.29
Yasuo,Karma,717,366,351,51.05
Yasuo,Seraphine,1325,632,693,47.7
Yasuo,Zilean,319,162,157,50.78
Yasuo,LeeSin,1073,586,487,54.61
Yasuo,Nami,1006,482,524,47.91
Yasuo,Aurora,979,495,484,50.56
Yasuo,Kaisa,1537,740,797,48.15
Yasuo,Shen,814,434,380,53.32
Yasuo,Gragas,664,381,283,57.38
Yasuo,Alistar,400,242,158,60.5
Yasuo,Kindred,663,352,311,53.09
Yasuo,Nasus,964,501,463,51.97
Yasuo,Urgot,518,226,292,43.63
Yasuo,DrMundo,705,368,337,52.2
Yasuo,Leblanc,412,223,189,54.13
Yasuo,Nunu,1054,585,469,55.5
Yasuo,Vladimir,807,402,405,49.81
Yasuo,Zac,391,206,185,52.69
Yasuo,Kalista,480,234,246,48.75
Yasuo,Vi,1015,498,517,49.06
Yasuo,Orianna,487,224,263,46
Yasuo,Kennen,465,230,235,49.46
Yasuo,MonkeyKing,651,307,344,47.16
Yasuo,Vayne,1160,569,591,49.05
Yasuo,Fiora,634,373,261,58.83
Yasuo,Ziggs,421,219,202,52.02
Yasuo,Nilah,794,330,464,41.56
Yasuo,JarvanIV,426,187,239,43.9
Yasuo,Taliyah,449,270,179,60.13
Yasuo,Soraka,687,341,346,49.64
Yasuo,Sion,727,321,406,44.15
Yasuo,Rengar,567,355,212,62.61
Yasuo,Ahri,1718,890,828,51.8
Yasuo,Anivia,349,173,176,49.57
Yasuo,Sejuani,403,225,178,55.83
Yasuo,AurelionSol,516,282,234,54.65
Yasuo,Shyvana,271,114,157,42.07
Yasuo,Fizz,559,298,261,53.31
Yasuo,Twitch,989,466,523,47.12
Yasuo,Kayle,984,452,532,45.93
Yasuo,FiddleSticks,546,279,267,51.1
Yasuo,Katarina,1048,592,456,56.49
Yasuo,Lissandra,376,192,184,51.06
Yasuo,XinZhao,614,271,343,44.14
Yasuo,Ornn,501,257,244,51.3
Yasuo,Smolder,824,395,429,47.94
Yasuo,Swain,1245,579,666,46.51
Yasuo,Graves,653,327,326,50.08
Yasuo,Kassadin,219,123,96,56.16
Yasuo,Maokai,478,217,261,45.4
Yasuo,Ivern,282,148,134,52.48
Yasuo,Illaoi,602,273,329,45.35
Yasuo,Morgana,1474,719,755,48.78
Yasuo,Gwen,609,297,312,48.77
Yasuo,RekSai,173,73,100,42.2
Yasuo,Leona,784,303,481,38.65
Yasuo,Akali,1415,708,707,50.04
Yasuo,Pantheon,1818,869,949,47.8
Yasuo,Corki,439,250,189,56.95
Yasuo,Viktor,738,323,415,43.77
Yasuo,Akshan,392,186,206,47.45
Yasuo,Lillia,765,316,449,41.31
Yasuo,Velkoz,772,385,387,49.87
Yasuo,Skarner,358,201,157,56.15
Yasuo,Ekko,915,406,509,44.37
Yasuo,Xerath,625,320,305,51.2
Yasuo,Trundle,556,249,307,44.78
Yasuo,Aphelios,845,441,404,52.19
Yasuo,Nautilus,1068,575,493,53.84
Yasuo,Zyra,763,409,354,53.6
Yasuo,Annie,419,213,206,50.84
Yasuo,Jayce,470,296,174,62.98
Yasuo,Tryndamere,723,369,354,51.04
Yasuo,MasterYi,1190,591,599,49.66
Yasuo,Zeri,392,203,189,51.79
Yasuo,Taric,337,162,175,48.07
Yasuo,Quinn,299,192,107,64.21
Yasuo,Udyr,422,186,236,44.08
Yasuo,Lucian,755,381,374,50.46
Yasuo,Kled,176,111,65,63.07
Yasuo,KogMaw,383,169,214,44.13
Yasuo,Olaf,295,127,168,43.05
Yasuo,Syndra,528,227,301,42.99
Yasuo,Talon,748,458,290,61.23
Yasuo,Yorick,948,456,492,48.1
Yasuo,Bard,398,201,197,50.5
Yasuo,Camille,348,166,182,47.7
Yasuo,Cassiopeia,378,176,202,46.56
Yasuo,Milio,621,286,335,46.05
Yasuo,Renata,339,189,150,55.75
Yasuo,Elise,582,340,242,58.42
Yasuo,Heimerdinger,703,334,369,47.51
Yasuo,Belveth,378,176,202,46.56
Yasuo,Janna,355,155,200,43.66
Yasuo,Gnar,477,239,238,50.1
Yasuo,Rumble,277,147,130,53.07
Yasuo,Karthus,279,125,154,44.8
Yasuo,Braum,430,207,223,48.14
Yasuo,KSante,405,191,214,47.16
Yasuo,Nidalee,320,206,114,64.38
Yasuo,TwistedFate,376,210,166,55.85
Jhin,Mordekaiser,1514,714,800,47.16
Jhin,Qiyana,383,170,213,44.39
Jhin,Irelia,957,520,437,54.34
Jhin,Ezreal,1915,1107,808,57.81
Jhin,Rell,581,321,260,55.25
Jhin,Aurora,998,537,461,53.81
Jhin,Volibear,1221,631,590,51.68
Jhin,Yasuo,2021,1006,1015,49.78
Jhin,Vayne,1152,519,633,45.05
Jhin,Shaco,1053,539,514,51.19
Jhin,Chogath,1475,798,677,54.1
Jhin,Kayn,1627,861,766,52.92
Jhin,Gangplank,433,188,245,43.42
Jhin,Hwei,872,443,429,50.8
Jhin,Warwick,1853,912,941,49.22
Jhin,Veigar,1180,621,559,52.63
Jhin,Ashe,1869,888,981,47.51
Jhin,Nami,979,554,425,56.59
Jhin,Darius,1990,945,1045,47.49
Jhin,Caitlyn,2857,1445,1412,50.58
Jhin,Morgana,1545,773,772,50.03
Jhin,Gragas,565,310,255,54.87
Jhin,TwistedFate,388,231,157,59.54
Jhin,Lucian,677,354,323,52.29
Jhin,Leona,796,354,442,44.47
Jhin,Zed,1110,577,533,51.98
Jhin,Sona,333,136,197,40.84
Jhin,Kaisa,1566,787,779,50.26
Jhin,Amumu,1009,501,508,49.65
Jhin,Riven,540,311,229,57.59
Jhin,Ahri,1416,712,704,50.28
Jhin,Jinx,2353,1161,1192,49.34
Jhin,Nautilus,1116,582,534,52.15
Jhin,Gwen,624,345,279,55.29
Jhin,Talon,587,290,297,49.4
Jhin,Yone,2011,1057,954,52.56
Jhin,MissFortune,2320,1237,1083,53.32
Jhin,Taric,183,86,97,46.99
Jhin,Nasus,693,357,336,51.52
Jhin,Varus,807,459,348,56.88
Jhin,Neeko,847,438,409,51.71
Jhin,Swain,1137,506,631,44.5
Jhin,Malzahar,811,402,409,49.57
Jhin,Kalista,511,271,240,53.03
Jhin,Poppy,645,336,309,52.09
Jhin,Ekko,871,439,432,50.4
Jhin,Pyke,1394,811,583,58.18
Jhin,Galio,693,305,388,44.01
Jhin,Cassiopeia,376,171,205,45.48
Jhin,Mel,2376,1269,1107,53.41
Jhin,Hecarim,357,207,150,57.98
Jhin,Milio,533,255,278,47.84
Jhin,Garen,1447,749,698,51.76
Jhin,Seraphine,1069,565,504,52.85
Jhin,Zilean,352,183,169,51.99
Jhin,Soraka,741,368,373,49.66
Jhin,Sylas,934,444,490,47.54
Jhin,Ryze,264,130,134,49.24
Jhin,Nunu,959,487,472,50.78
Jhin,Alistar,268,121,147,45.15
Jhin,Lillia,677,338,339,49.93
Jhin,Vladimir,651,334,317,51.31
Jhin,Lulu,916,472,444,51.53
Jhin,Sett,1739,829,910,47.67
Jhin,Brand,708,364,344,51.41
Jhin,Twitch,1071,499,572,46.59
Jhin,Zac,353,162,191,45.89
Jhin,Gnar,453,254,199,56.07
Jhin,Jax,879,439,440,49.94
Jhin,Bard,293,146,147,49.83
Jhin,Heimerdinger,589,308,281,52.29
Jhin,FiddleSticks,563,280,283,49.73
Jhin,Katarina,974,520,454,53.39
Jhin,Akali,1166,621,545,53.26
Jhin,Naafiri,540,308,232,57.04
Jhin,Kayle,716,316,400,44.13
Jhin,Smolder,885,489,396,55.25
Jhin,Sejuani,337,161,176,47.77
Jhin,AurelionSol,437,235,202,53.78
Jhin,Tristana,1047,474,573,45.27
Jhin,Rakan,527,227,300,43.07
Jhin,Samira,1067,526,541,49.3
Jhin,Leblanc,406,245,161,60.34
Jhin,Malphite,795,326,469,41.01
Jhin,MonkeyKing,465,200,265,43.01
Jhin,Senna,842,429,413,50.95
Jhin,Shen,686,327,359,47.67
Jhin,Ziggs,505,237,268,46.93
Jhin,Kled,246,141,105,57.32
Jhin,XinZhao,607,247,360,40.69
Jhin,Trundle,567,273,294,48.15
Jhin,Aphelios,739,372,367,50.34
Jhin,Viktor,743,419,324,56.39
Jhin,Yuumi,1067,555,512,52.01
Jhin,Xerath,741,351,390,47.37
Jhin,Rammus,294,137,157,46.6
Jhin,Nocturne,939,484,455,51.54
Jhin,Vex,647,314,333,48.53
Jhin,KSante,324,210,114,64.81
Jhin,Azir,348,197,151,56.61
Jhin,Skarner,369,210,159,56.91
Jhin,Lissandra,312,156,156,50
Jhin,DrMundo,610,283,327,46.39
Jhin,Pantheon,1588,743,845,46.79
Jhin,Annie,351,177,174,50.43
Jhin,Syndra,694,312,382,44.96
Jhin,Lux,2962,1541,1421,52.03
Jhin,Karma,733,336,397,45.84
Jhin,Illaoi,464,211,253,45.47
Jhin,Rengar,481,285,196,59.25
Jhin,Xayah,773,362,411,46.83
Jhin,Thresh,1329,605,724,45.52
Jhin,Ornn,544,292,252,53.68
Jhin,Yorick,974,414,560,42.51
Jhin,Braum,540,257,283,47.59
Jhin,Sion,861,427,434,49.59
Jhin,Evelynn,559,324,235,57.96
Jhin,MasterYi,994,488,506,49.09
Jhin,Kindred,591,325,266,54.99
Jhin,Sivir,483,217,266,44.93
Jhin,Quinn,361,158,203,43.77
Jhin,Teemo,1499,678,821,45.23
Jhin,Camille,423,239,184,56.5
Jhin,Zeri,514,261,253,50.78
Jhin,Singed,257,102,155,39.69
Jhin,Aatrox,959,485,474,50.57
Jhin,Khazix,754,370,384,49.07
Jhin,Viego,1438,725,713,50.42
Jhin,Diana,1246,683,563,54.82
Jhin,Nilah,567,301,266,53.09
Jhin,RekSai,158,73,85,46.2
Jhin,Velkoz,686,367,319,53.5
Jhin,Vi,865,457,408,52.83
Jhin,Kassadin,261,144,117,55.17
Jhin,Corki,312,188,124,60.26
Jhin,Blitzcrank,663,338,325,50.98
Jhin,Belveth,301,133,168,44.19
Jhin,Orianna,383,193,190,50.39
Jhin,Tryndamere,662,333,329,50.3
Jhin,Renekton,425,256,169,60.24
Jhin,Briar,1002,482,520,48.1
Jhin,Anivia,332,137,195,41.27
Jhin,Zoe,496,278,218,56.05
Jhin,Zyra,558,269,289,48.21
Jhin,Kennen,355,167,188,47.04
Jhin,Ambessa,652,321,331,49.23
Jhin,Maokai,433,199,234,45.96
Jhin,Graves,531,255,276,48.02
Jhin,TahmKench,1094,641,453,58.59
Jhin,JarvanIV,374,193,181,51.6
Jhin,Fiora,407,200,207,49.14
Jhin,KogMaw,425,195,230,45.88
Jhin,LeeSin,990,552,438,55.76
Jhin,Fizz,569,257,312,45.17
Jhin,Draven,661,374,287,56.58
Jhin,Karthus,221,117,104,52.94
Jhin,Udyr,395,175,220,44.3
Jhin,Elise,670,445,225,66.42
Jhin,Akshan,425,233,192,54.82
Jhin,Taliyah,274,147,127,53.65
Jhin,Renata,203,97,106,47.78
Jhin,Urgot,485,234,251,48.25
Jhin,Rumble,177,109,68,61.58
Jhin,Ivern,247,163,84,65.99
Jhin,Janna,331,136,195,41.09
Jhin,Nidalee,240,142,98,59.17
Jhin,Shyvana,256,115,141,44.92
Jhin,Olaf,224,93,131,41.52
Jhin,Jayce,484,253,231,52.27
Lux,Mordekaiser,2419,1154,1265,47.71
Lux,Qiyana,607,325,282,53.54
Lux,Irelia,1498,767,731,51.2
Lux,Ezreal,2535,1289,1246,50.85
Lux,Rell,764,369,395,48.3
Lux,Sejuani,553,266,287,48.1
Lux,Yasuo,3038,1422,1616,46.81
Lux,Lucian,912,475,437,52.08
Lux,Pantheon,2794,1388,1406,49.68
Lux,Aurora,1518,866,652,57.05
Lux,Volibear,1839,896,943,48.72
Lux,Vayne,1553,758,795,48.81
Lux,Shaco,1601,785,816,49.03
Lux,Aatrox,1561,830,731,53.17
Lux,Sylas,1430,689,741,48.18
Lux,Diana,2186,1081,1105,49.45
Lux,Varus,1217,601,616,49.38
Lux,Blitzcrank,1544,800,744,51.81
Lux,Illaoi,784,399,385,50.89
Lux,Warwick,2537,1284,1253,50.61
Lux,Tristana,1474,700,774,47.49
Lux,Milio,958,383,575,39.98
Lux,Kayle,1158,552,606,47.67
Lux,Caitlyn,3603,1811,1792,50.26
Lux,Renata,387,179,208,46.25
Lux,Darius,2777,1509,1268,54.34
Lux,Morgana,2671,1217,1454,45.56
Lux,Brand,1453,763,690,52.51
Lux,Akali,1885,947,938,50.24
Lux,MissFortune,3948,1950,1998,49.39
Lux,Kassadin,347,188,159,54.18
Lux,Kayn,2695,1441,1254,53.47
Lux,Sona,640,338,302,52.81
Lux,Sett,2816,1386,1430,49.22
Lux,Amumu,1681,754,927,44.85
Lux,Poppy,871,435,436,49.94
Lux,Teemo,2212,965,1247,43.63
Lux,XinZhao,854,376,478,44.03
Lux,Jinx,3227,1655,1572,51.29
Lux,Neeko,1388,781,607,56.27
Lux,Gwen,885,498,387,56.27
Lux,Skarner,509,228,281,44.79
Lux,Yone,3214,1656,1558,51.52
Lux,Kaisa,2304,1275,1029,55.34
Lux,Seraphine,2298,1169,1129,50.87
Lux,Ornn,648,290,358,44.75
Lux,Ekko,1272,611,661,48.03
Lux,Orianna,752,406,346,53.99
Lux,Malzahar,1189,514,675,43.23
Lux,Maokai,676,361,315,53.4
Lux,Vi,1231,628,603,51.02
Lux,AurelionSol,849,368,481,43.35
Lux,Corki,612,335,277,54.74
Lux,Chogath,2166,1156,1010,53.37
Lux,Yorick,1469,586,883,39.89
Lux,Sivir,742,360,382,48.52
Lux,Xerath,1359,635,724,46.73
Lux,Vladimir,805,415,390,51.55
Lux,Evelynn,972,457,515,47.02
Lux,Yuumi,1581,794,787,50.22
Lux,Nasus,1257,632,625,50.28
Lux,MonkeyKing,760,389,371,51.18
Lux,Zoe,812,464,348,57.14
Lux,Xayah,978,517,461,52.86
Lux,Zac,485,264,221,54.43
Lux,Heimerdinger,872,413,459,47.36
Lux,LeeSin,1607,818,789,50.9
Lux,Veigar,1968,974,994,49.49
Lux,Vex,1064,518,546,48.68
Lux,Rakan,859,389,470,45.29
Lux,Gragas,1005,552,453,54.93
Lux,Soraka,1086,544,542,50.09
Lux,Garen,2280,1173,1107,51.45
Lux,Ziggs,724,408,316,56.35
Lux,Zeri,560,284,276,50.71
Lux,Zyra,1035,422,613,40.77
Lux,Talon,960,582,378,60.63
Lux,Pyke,1968,995,973,50.56
Lux,Khazix,1036,551,485,53.19
Lux,Nautilus,1751,919,832,52.48
Lux,Twitch,1430,697,733,48.74
Lux,Kennen,722,386,336,53.46
Lux,Naafiri,846,364,482,43.03
Lux,Nocturne,1382,652,730,47.18
Lux,Ashe,2876,1492,1384,51.88
Lux,Thresh,2288,1178,1110,51.49
Lux,Riven,727,420,307,57.77
Lux,JarvanIV,587,249,338,42.42
Lux,Taliyah,409,226,183,55.26
Lux,Draven,985,520,465,52.79
Lux,Jax,1301,668,633,51.35
Lux,Mel,3431,1634,1797,47.62
Lux,Kalista,747,372,375,49.8
Lux,Rammus,453,260,193,57.4
Lux,TahmKench,2110,1103,1007,52.27
Lux,Katarina,1363,753,610,55.25
Lux,Shyvana,434,225,209,51.84
Lux,Fizz,836,452,384,54.07
Lux,Nilah,890,446,444,50.11
Lux,Nami,1650,831,819,50.36
Lux,Malphite,1300,586,714,45.08
Lux,Gnar,615,307,308,49.92
Lux,Samira,1562,787,775,50.38
Lux,Leblanc,626,338,288,53.99
Lux,KSante,593,327,266,55.14
Lux,Quinn,509,257,252,50.49
Lux,FiddleSticks,858,453,405,52.8
Lux,Cassiopeia,570,273,297,47.89
Lux,Lillia,1077,610,467,56.64
Lux,Lissandra,377,161,216,42.71
Lux,Renekton,740,375,365,50.68
Lux,Annie,519,268,251,51.64
Lux,Senna,1407,681,726,48.4
Lux,Alistar,439,205,234,46.7
Lux,Briar,1616,751,865,46.47
Lux,Janna,469,250,219,53.3
Lux,Zed,1464,813,651,55.53
Lux,Smolder,1257,680,577,54.1
Lux,Galio,1044,513,531,49.14
Lux,Swain,1775,853,922,48.06
Lux,Tryndamere,918,479,439,52.18
Lux,Zilean,465,263,202,56.56
Lux,Bard,484,226,258,46.69
Lux,Rengar,697,413,284,59.25
Lux,Olaf,411,216,195,52.55
Lux,MasterYi,1724,871,853,50.52
Lux,Velkoz,1056,497,559,47.06
Lux,Trundle,975,451,524,46.26
Lux,Fiora,811,429,382,52.9
Lux,Ryze,537,347,190,64.62
Lux,Jhin,2962,1421,1541,47.97
Lux,Aphelios,1057,561,496,53.07
Lux,Hecarim,695,394,301,56.69
Lux,Syndra,915,428,487,46.78
Lux,Akshan,627,359,268,57.26
Lux,Braum,635,313,322,49.29
Lux,Singed,410,189,221,46.1
Lux,Kindred,907,480,427,52.92
Lux,Kled,315,126,189,40
Lux,Karma,1229,673,556,54.76
Lux,Ambessa,939,497,442,52.93
Lux,Rumble,217,119,98,54.84
Lux,Graves,813,444,369,54.61
Lux,Ivern,315,154,161,48.89
Lux,Udyr,624,273,351,43.75
Lux,Taric,354,190,164,53.67
Lux,Nunu,1473,723,750,49.08
Lux,Viktor,965,466,499,48.29
Lux,Urgot,714,389,325,54.48
Lux,Lulu,1164,597,567,51.29
Lux,DrMundo,1100,435,665,39.55
Lux,Karthus,407,207,200,50.86
Lux,Ahri,2326,1393,933,59.89
Lux,Azir,570,350,220,61.4
Lux,Viego,1983,946,1037,47.71
Lux,Hwei,1296,619,677,47.76
Lux,Camille,534,279,255,52.25
Lux,Shen,1125,566,559,50.31
Lux,TwistedFate,621,325,296,52.33
Lux,Gangplank,577,240,337,41.59
Lux,Sion,1165,581,584,49.87
Lux,Belveth,447,242,205,54.14
Lux,Nidalee,361,243,118,67.31
Lux,Leona,1090,502,588,46.06
Lux,Anivia,442,237,205,53.62
Lux,Elise,987,521,466,52.79
Lux,KogMaw,529,239,290,45.18
Lux,Jayce,544,298,246,54.78
Lux,RekSai,179,114,65,63.69
Mordekaiser,Yone,1944,911,1033,46.86
Mordekaiser,Darius,1949,911,1038,46.74
Mordekaiser,Yasuo,1705,916,789,53.72
Mordekaiser,Jhin,1514,800,714,52.84
Mordekaiser,Lux,2419,1265,1154,52.29
Mordekaiser,Singed,214,106,108,49.53
Mordekaiser,Shaco,818,431,387,52.69
Mordekaiser,Zed,784,461,323,58.8
Mordekaiser,Hwei,703,337,366,47.94
Mordekaiser,Fiora,540,308,232,57.04
Mordekaiser,Belveth,264,119,145,45.08
Mordekaiser,Sylas,909,462,447,50.83
Mordekaiser,Ezreal,1344,699,645,52.01
Mordekaiser,Yuumi,792,396,396,50
Mordekaiser,Illaoi,536,279,257,52.05
Mordekaiser,Nunu,875,483,392,55.2
Mordekaiser,Irelia,691,410,281,59.33
Mordekaiser,Swain,1047,584,463,55.78
Mordekaiser,Warwick,1706,852,854,49.94
Mordekaiser,Caitlyn,2333,1178,1155,50.49
Mordekaiser,Morgana,1460,753,707,51.58
Mordekaiser,MonkeyKing,486,264,222,54.32
Mordekaiser,Tristana,832,414,418,49.76
Mordekaiser,Garen,1470,829,641,56.39
Mordekaiser,Diana,1232,651,581,52.84
Mordekaiser,Pyke,1119,659,460,58.89
Mordekaiser,Volibear,1099,546,553,49.68
Mordekaiser,Ekko,698,330,368,47.28
Mordekaiser,Kalista,431,218,213,50.58
Mordekaiser,Kayn,1561,837,724,53.62
Mordekaiser,TwistedFate,252,140,112,55.56
Mordekaiser,Smolder,738,434,304,58.81
Mordekaiser,Nautilus,985,521,464,52.89
Mordekaiser,Renekton,427,222,205,51.99
Mordekaiser,Vex,573,302,271,52.71
Mordekaiser,Samira,968,551,417,56.92
Mordekaiser,Lulu,635,334,301,52.6
Mordekaiser,Urgot,564,267,297,47.34
Mordekaiser,Rengar,411,277,134,67.4
Mordekaiser,Ziggs,469,206,263,43.92
Mordekaiser,Trundle,609,277,332,45.48
Mordekaiser,Yorick,904,417,487,46.13
Mordekaiser,Seraphine,1069,535,534,50.05
Mordekaiser,Sivir,387,185,202,47.8
Mordekaiser,Xerath,561,298,263,53.12
Mordekaiser,KSante,441,259,182,58.73
Mordekaiser,Ashe,1540,781,759,50.71
Mordekaiser,Corki,235,156,79,66.38
Mordekaiser,Vladimir,432,185,247,42.82
Mordekaiser,Tryndamere,515,258,257,50.1
Mordekaiser,Milio,451,227,224,50.33
Mordekaiser,Gangplank,298,176,122,59.06
Mordekaiser,Mel,2087,1077,1010,51.61
Mordekaiser,Hecarim,371,198,173,53.37
Mordekaiser,Heimerdinger,583,269,314,46.14
Mordekaiser,Kindred,504,289,215,57.34
Mordekaiser,Katarina,781,464,317,59.41
Mordekaiser,Janna,175,84,91,48
Mordekaiser,Teemo,1280,648,632,50.63
Mordekaiser,LeeSin,755,393,362,52.05
Mordekaiser,Nami,789,371,418,47.02
Mordekaiser,Amumu,914,488,426,53.39
Mordekaiser,Kaisa,1259,662,597,52.58
Mordekaiser,Rakan,427,266,161,62.3
Mordekaiser,Gnar,313,174,139,55.59
Mordekaiser,Viego,1154,623,531,53.99
Mordekaiser,TahmKench,1123,578,545,51.47
Mordekaiser,Akshan,322,138,184,42.86
Mordekaiser,FiddleSticks,498,293,205,58.84
Mordekaiser,Nasus,855,449,406,52.51
Mordekaiser,Neeko,732,340,392,46.45
Mordekaiser,MissFortune,2199,1118,1081,50.84
Mordekaiser,Leblanc,320,177,143,55.31
Mordekaiser,Karma,525,269,256,51.24
Mordekaiser,Fizz,565,288,277,50.97
Mordekaiser,Aatrox,930,561,369,60.32
Mordekaiser,Aurora,927,541,386,58.36
Mordekaiser,Brand,709,354,355,49.93
Mordekaiser,Gragas,456,302,154,66.23
Mordekaiser,Kennen,360,204,156,56.67
Mordekaiser,Vayne,1075,524,551,48.74
Mordekaiser,Thresh,1209,642,567,53.1
Mordekaiser,Akali,879,472,407,53.7
Mordekaiser,Jinx,1874,1018,856,54.32
Mordekaiser,Xayah,618,347,271,56.15
Mordekaiser,Senna,804,375,429,46.64
Mordekaiser,Shen,508,259,249,50.98
Mordekaiser,Rammus,276,144,132,52.17
Mordekaiser,Cassiopeia,396,198,198,50
Mordekaiser,Zeri,368,218,150,59.24
Mordekaiser,Sion,624,304,320,48.72
Mordekaiser,Ahri,1246,600,646,48.15
Mordekaiser,Anivia,280,132,148,47.14
Mordekaiser,Poppy,646,313,333,48.45
Mordekaiser,Riven,422,257,165,60.9
Mordekaiser,Briar,1006,489,517,48.61
Mordekaiser,Jayce,326,196,130,60.12
Mordekaiser,Sett,1814,981,833,54.08
Mordekaiser,Pantheon,1450,787,663,54.28
Mordekaiser,Braum,382,206,176,53.93
Mordekaiser,Taric,233,119,114,51.07
Mordekaiser,Chogath,1248,719,529,57.61
Mordekaiser,Rell,392,215,177,54.85
Mordekaiser,Olaf,287,145,142,50.52
Mordekaiser,Evelynn,559,364,195,65.12
Mordekaiser,Leona,716,418,298,58.38
Mordekaiser,Talon,474,277,197,58.44
Mordekaiser,Maokai,392,212,180,54.08
Mordekaiser,Zyra,592,302,290,51.01
Mordekaiser,Malphite,730,431,299,59.04
Mordekaiser,Veigar,1135,521,614,45.9
Mordekaiser,Blitzcrank,751,374,377,49.8
Mordekaiser,Orianna,314,153,161,48.73
Mordekaiser,Draven,507,266,241,52.47
Mordekaiser,Sejuani,320,139,181,43.44
Mordekaiser,Gwen,649,352,297,54.24
Mordekaiser,Malzahar,651,329,322,50.54
Mordekaiser,Galio,690,347,343,50.29
Mordekaiser,MasterYi,1098,513,585,46.72
Mordekaiser,Varus,730,376,354,51.51
Mordekaiser,DrMundo,507,248,259,48.92
Mordekaiser,Nilah,539,282,257,52.32
Mordekaiser,Aphelios,693,357,336,51.52
Mordekaiser,Nocturne,689,386,303,56.02
Mordekaiser,Udyr,328,197,131,60.06
Mordekaiser,JarvanIV,285,155,130,54.39
Mordekaiser,Soraka,600,292,308,48.67
Mordekaiser,Viktor,529,287,242,54.25
Mordekaiser,Karthus,208,105,103,50.48
Mordekaiser,Qiyana,318,191,127,60.06
Mordekaiser,Lucian,487,233,254,47.84
Mordekaiser,Naafiri,454,288,166,63.44
Mordekaiser,Zilean,279,174,105,62.37
Mordekaiser,Kassadin,146,63,83,43.15
Mordekaiser,Graves,455,260,195,57.14
Mordekaiser,Ivern,177,103,74,58.19
Mordekaiser,Velkoz,551,246,305,44.65
Mordekaiser,Ryze,204,132,72,64.71
Mordekaiser,Sona,371,184,187,49.6
Mordekaiser,Kayle,802,372,430,46.38
Mordekaiser,Jax,793,402,391,50.69
Mordekaiser,Khazix,639,333,306,52.11
Mordekaiser,Camille,353,211,142,59.77
Mordekaiser,Shyvana,321,138,183,42.99
Mordekaiser,Taliyah,237,131,106,55.27
Mordekaiser,Twitch,783,389,394,49.68
Mordekaiser,KogMaw,321,194,127,60.44
Mordekaiser,Skarner,309,197,112,63.75
Mordekaiser,Azir,316,197,119,62.34
Mordekaiser,Vi,706,328,378,46.46
Mordekaiser,AurelionSol,432,231,201,53.47
Mordekaiser,Zac,327,146,181,44.65
Mordekaiser,XinZhao,483,245,238,50.72
Mordekaiser,Rumble,151,88,63,58.28
Mordekaiser,Zoe,394,223,171,56.6
Mordekaiser,Renata,248,98,150,39.52
Mordekaiser,Ornn,415,189,226,45.54
Mordekaiser,Lillia,589,344,245,58.4
Mordekaiser,Annie,228,148,80,64.91
Mordekaiser,Syndra,496,272,224,54.84
Mordekaiser,Elise,435,212,223,48.74
Mordekaiser,Kled,211,134,77,63.51
Mordekaiser,Alistar,258,154,104,59.69
Mordekaiser,Nidalee,192,108,84,56.25
Mordekaiser,Quinn,304,167,137,54.93
Mordekaiser,Ambessa,477,259,218,54.3
Mordekaiser,Bard,218,96,122,44.04
Mordekaiser,Lissandra,216,124,92,57.41
Mordekaiser,RekSai,128,58,70,45.31
Qiyana,Yone,364,186,178,51.1
Qiyana,Darius,330,120,210,36.36
Qiyana,Yasuo,394,164,230,41.62
Qiyana,Jhin,383,213,170,55.61
Qiyana,Lux,607,282,325,46.46
Qiyana,Fiora,99,42,57,42.42
Qiyana,Belveth,63,32,31,50.79
Qiyana,Sylas,218,96,122,44.04
Qiyana,Ezreal,359,176,183,49.03
Qiyana,Yuumi,208,71,137,34.13
Qiyana,Illaoi,128,69,59,53.91
Qiyana,Twitch,156,71,85,45.51
Qiyana,Velkoz,144,68,76,47.22
Qiyana,MonkeyKing,81,34,47,41.98
Qiyana,Tristana,191,88,103,46.07
Qiyana,Morgana,289,124,165,42.91
Qiyana,Teemo,258,102,156,39.53
Qiyana,Poppy,92,47,45,51.09
Qiyana,Akali,213,117,96,54.93
Qiyana,Caitlyn,516,218,298,42.25
Qiyana,Leona,177,75,102,42.37
Qiyana,Zed,300,158,142,52.67
Qiyana,Shaco,163,67,96,41.1
Qiyana,Anivia,31,10,21,32.26
Qiyana,Garen,240,105,135,43.75
Qiyana,FiddleSticks,94,43,51,45.74
Qiyana,Brand,101,47,54,46.53
Qiyana,Yorick,169,83,86,49.11
Qiyana,Katarina,198,114,84,57.58
Qiyana,Lucian,82,23,59,28.05
Qiyana,Nautilus,246,99,147,40.24
Qiyana,Chogath,245,119,126,48.57
Qiyana,Talon,145,61,84,42.07
Qiyana,Nilah,126,55,71,43.65
Qiyana,Milio,140,67,73,47.86
Qiyana,Kindred,114,52,62,45.61
Qiyana,AurelionSol,91,45,46,49.45
Qiyana,Kalista,100,32,68,32
Qiyana,Kayle,130,57,73,43.85
Qiyana,Shyvana,43,21,22,48.84
Qiyana,Galio,105,48,57,45.71
Qiyana,Mel,573,296,277,51.66
Qiyana,Blitzcrank,138,68,70,49.28
Qiyana,Urgot,98,46,52,46.94
Qiyana,Rakan,145,54,91,37.24
Qiyana,Kennen,63,22,41,34.92
Qiyana,JarvanIV,87,42,45,48.28
Qiyana,Karma,136,70,66,51.47
Qiyana,Soraka,133,57,76,42.86
Qiyana,Mordekaiser,318,127,191,39.94
Qiyana,Ekko,182,80,102,43.96
Qiyana,Irelia,170,83,87,48.82
Qiyana,Swain,292,114,178,39.04
Qiyana,Aatrox,191,123,68,64.4
Qiyana,Warwick,289,102,187,35.29
Qiyana,Fizz,122,59,63,48.36
Qiyana,Pyke,246,129,117,52.44
Qiyana,KSante,52,30,22,57.69
Qiyana,Draven,125,59,66,47.2
Qiyana,Renata,49,14,35,28.57
Qiyana,Hwei,157,94,63,59.87
Qiyana,Jinx,521,236,285,45.3
Qiyana,Thresh,255,96,159,37.65
Qiyana,Volibear,227,112,115,49.34
Qiyana,Sett,362,113,249,31.22
Qiyana,Khazix,123,55,68,44.72
Qiyana,Ahri,268,108,160,40.3
Qiyana,DrMundo,117,33,84,28.21
Qiyana,Kayn,288,129,159,44.79
Qiyana,Sivir,68,34,34,50
Qiyana,Vi,194,73,121,37.63
Qiyana,Lulu,164,81,83,49.39
Qiyana,TahmKench,208,104,104,50
Qiyana,Veigar,211,90,121,42.65
Qiyana,Ashe,401,193,208,48.13
Qiyana,Zilean,78,24,54,30.77
Qiyana,Ornn,118,67,51,56.78
Qiyana,Diana,267,121,146,45.32
Qiyana,Kled,41,20,21,48.78
Qiyana,Maokai,134,58,76,43.28
Qiyana,Riven,70,19,51,27.14
Qiyana,Orianna,91,41,50,45.05
Qiyana,Vladimir,145,87,58,60
Qiyana,Aphelios,149,63,86,42.28
Qiyana,Rengar,117,45,72,38.46
Qiyana,Rell,111,48,63,43.24
Qiyana,Gragas,161,95,66,59.01
Qiyana,Leblanc,45,20,25,44.44
Qiyana,Jax,196,67,129,34.18
Qiyana,Malphite,169,55,114,32.54
Qiyana,Udyr,65,21,44,32.31
Qiyana,Bard,57,26,31,45.61
Qiyana,Singed,80,40,40,50
Qiyana,MissFortune,438,184,254,42.01
Qiyana,Tryndamere,107,46,61,42.99
Qiyana,Sion,197,82,115,41.62
Qiyana,Graves,105,67,38,63.81
Qiyana,Gnar,79,24,55,30.38
Qiyana,MasterYi,238,92,146,38.66
Qiyana,LeeSin,174,50,124,28.74
Qiyana,Azir,102,61,41,59.8
Qiyana,Nami,205,60,145,29.27
Qiyana,Nasus,204,90,114,44.12
Qiyana,Hecarim,124,63,61,50.81
Qiyana,Vayne,283,128,155,45.23
Qiyana,Seraphine,195,84,111,43.08
Qiyana,Janna,57,28,29,49.12
Qiyana,Pantheon,312,175,137,56.09
Qiyana,Camille,81,40,41,49.38
Qiyana,Syndra,110,39,71,35.45
Qiyana,Nunu,137,72,65,52.55
Qiyana,Ryze,77,33,44,42.86
Qiyana,Evelynn,141,45,96,31.91
Qiyana,Quinn,76,24,52,31.58
Qiyana,Viego,292,147,145,50.34
Qiyana,Xerath,118,48,70,40.68
Qiyana,Aurora,211,126,85,59.72
Qiyana,Briar,241,96,145,39.83
Qiyana,Kassadin,50,31,19,62
Qiyana,Gwen,169,91,78,53.85
Qiyana,Nocturne,142,72,70,50.7
Qiyana,Ambessa,153,38,115,24.84
Qiyana,Gangplank,132,56,76,42.42
Qiyana,Cassiopeia,82,38,44,46.34
Qiyana,Shen,155,53,102,34.19
Qiyana,Rammus,43,10,33,23.26
Qiyana,Heimerdinger,96,40,56,41.67
Qiyana,Vex,144,50,94,34.72
Qiyana,Amumu,210,65,145,30.95
Qiyana,Kaisa,213,103,110,48.36
Qiyana,Varus,185,77,108,41.62
Qiyana,Senna,270,103,167,38.15
Qiyana,XinZhao,123,61,62,49.59
Qiyana,Malzahar,144,48,96,33.33
Qiyana,Sejuani,92,53,39,57.61
Qiyana,Naafiri,106,51,55,48.11
Qiyana,Annie,56,21,35,37.5
Qiyana,Trundle,127,52,75,40.94
Qiyana,KogMaw,54,36,18,66.67
Qiyana,Ziggs,49,29,20,59.18
Qiyana,Karthus,61,31,30,50.82
Qiyana,Nidalee,57,32,25,56.14
Qiyana,Taliyah,60,36,24,60
Qiyana,Renekton,103,35,68,33.98
Qiyana,Ivern,64,37,27,57.81
Qiyana,Zyra,126,48,78,38.1
Qiyana,Viktor,177,97,80,54.8
Qiyana,Samira,160,73,87,45.63
Qiyana,RekSai,39,16,23,41.03
Qiyana,Neeko,113,46,67,40.71
Qiyana,Akshan,55,18,37,32.73
Qiyana,Braum,79,55,24,69.62
Qiyana,Taric,35,29,6,82.86
Qiyana,Lissandra,49,6,43,12.24
Qiyana,Rumble,69,32,37,46.38
Qiyana,Lillia,159,97,62,61.01
Qiyana,Zeri,103,56,47,54.37
Qiyana,Elise,129,76,53,58.91
Qiyana,Olaf,50,28,22,56
Qiyana,Sona,65,29,36,44.62
Qiyana,Zoe,101,50,51,49.5
Qiyana,Zac,76,32,44,42.11
Qiyana,Corki,63,33,30,52.38
Qiyana,Xayah,139,65,74,46.76
Qiyana,Smolder,115,55,60,47.83
Qiyana,Jayce,117,50,67,42.74
Qiyana,TwistedFate,70,38,32,54.29
Qiyana,Skarner,68,23,45,33.82
Qiyana,Alistar,109,71,38,65.14
Irelia,Yone,1163,618,545,53.14
Irelia,Darius,988,470,518,47.57
Irelia,Yasuo,1198,657,541,54.84
Irelia,Jhin,957,437,520,45.66
Irelia,Lux,1498,731,767,48.8
Irelia,Mordekaiser,691,281,410,40.67
Irelia,Warwick,879,396,483,45.05
Irelia,Veigar,617,321,296,52.03
Irelia,Ashe,976,461,515,47.23
Irelia,Nami,483,187,296,38.72
Irelia,Caitlyn,1295,679,616,52.43
Irelia,Morgana,671,292,379,43.52
Irelia,Yorick,530,212,318,40
Irelia,Kayn,924,462,462,50
Irelia,Ryze,139,83,56,59.71
Irelia,Pantheon,881,387,494,43.93
Irelia,TahmKench,630,301,329,47.78
Irelia,Malphite,544,219,325,40.26
Irelia,Aphelios,447,216,231,48.32
Irelia,TwistedFate,178,97,81,54.49
Irelia,Gnar,289,162,127,56.06
Irelia,Jax,460,242,218,52.61
Irelia,Neeko,432,206,226,47.69
Irelia,Renekton,201,100,101,49.75
Irelia,JarvanIV,212,113,99,53.3
Irelia,Mel,1158,541,617,46.72
Irelia,Sylas,489,218,271,44.58
Irelia,Singed,137,68,69,49.64
Irelia,Graves,221,120,101,54.3
Irelia,Fizz,276,105,171,38.04
Irelia,Ziggs,225,106,119,47.11
Irelia,Sett,901,403,498,44.73
Irelia,Amumu,536,221,315,41.23
Irelia,Poppy,285,137,148,48.07
Irelia,Zed,619,273,346,44.1
Irelia,Sivir,207,97,110,46.86
Irelia,Blitzcrank,444,194,250,43.69
Irelia,Gangplank,230,112,118,48.7
Irelia,Kaisa,821,444,377,54.08
Irelia,Galio,342,188,154,54.97
Irelia,Cassiopeia,222,117,105,52.7
Irelia,Hwei,478,273,205,57.11
Irelia,Gwen,365,189,176,51.78
Irelia,Skarner,164,90,74,54.88
Irelia,Seraphine,670,280,390,41.79
Irelia,Ornn,249,128,121,51.41
Irelia,MissFortune,1118,548,570,49.02
Irelia,Brand,358,183,175,51.12
Irelia,Teemo,598,256,342,42.81
Irelia,Shaco,477,261,216,54.72
Irelia,Leblanc,159,100,59,62.89
Irelia,Ezreal,852,420,432,49.3
Irelia,Thresh,634,318,316,50.16
Irelia,Illaoi,268,92,176,34.33
Irelia,Aatrox,605,330,275,54.55
Irelia,Gragas,323,176,147,54.49
Irelia,Garen,771,368,403,47.73
Irelia,Volibear,696,303,393,43.53
Irelia,Tristana,522,265,257,50.77
Irelia,Zeri,268,139,129,51.87
Irelia,Zyra,402,212,190,52.74
Irelia,Jayce,239,108,131,45.19
Irelia,Rengar,264,150,114,56.82
Irelia,Swain,572,281,291,49.13
Irelia,Sona,218,120,98,55.05
Irelia,Briar,461,206,255,44.69
Irelia,Kennen,199,89,110,44.72
Irelia,Rammus,186,87,99,46.77
Irelia,Pyke,636,415,221,65.25
Irelia,Riven,188,125,63,66.49
Irelia,Taliyah,128,70,58,54.69
Irelia,Draven,318,184,134,57.86
Irelia,Lulu,352,176,176,50
Irelia,Akali,587,301,286,51.28
Irelia,Naafiri,243,128,115,52.67
Irelia,Kayle,455,254,201,55.82
Irelia,Smolder,419,183,236,43.68
Irelia,Khazix,321,156,165,48.6
Irelia,Sion,427,202,225,47.31
Irelia,FiddleSticks,237,106,131,44.73
Irelia,Zilean,165,93,72,56.36
Irelia,Tryndamere,302,128,174,42.38
Irelia,Nidalee,125,78,47,62.4
Irelia,Aurora,578,226,352,39.1
Irelia,Nunu,478,248,230,51.88
Irelia,Rakan,233,109,124,46.78
Irelia,Soraka,397,189,208,47.61
Irelia,Lillia,331,142,189,42.9
Irelia,Orianna,189,74,115,39.15
Irelia,Velkoz,354,188,166,53.11
Irelia,Chogath,594,290,304,48.82
Irelia,Evelynn,293,166,127,56.66
Irelia,Lissandra,178,98,80,55.06
Irelia,Nilah,260,127,133,48.85
Irelia,Diana,703,354,349,50.36
Irelia,MonkeyKing,279,123,156,44.09
Irelia,Vex,297,151,146,50.84
Irelia,Vayne,558,255,303,45.7
Irelia,Ekko,419,175,244,41.77
Irelia,Senna,466,237,229,50.86
Irelia,Olaf,64,28,36,43.75
Irelia,Jinx,1158,587,571,50.69
Irelia,Leona,430,174,256,40.47
Irelia,KSante,243,136,107,55.97
Irelia,Zac,169,92,77,54.44
Irelia,Azir,187,88,99,47.06
Irelia,Ahri,796,417,379,52.39
Irelia,Twitch,412,209,203,50.73
Irelia,MasterYi,641,339,302,52.89
Irelia,Nasus,392,189,203,48.21
Irelia,Malzahar,410,200,210,48.78
Irelia,Braum,195,93,102,47.69
Irelia,Syndra,357,157,200,43.98
Irelia,Karma,299,144,155,48.16
Irelia,Nautilus,611,277,334,45.34
Irelia,Lucian,270,129,141,47.78
Irelia,Samira,505,249,256,49.31
Irelia,Nocturne,534,191,343,35.77
Irelia,Trundle,259,145,114,55.98
Irelia,Heimerdinger,278,115,163,41.37
Irelia,Udyr,148,72,76,48.65
Irelia,Milio,264,96,168,36.36
Irelia,Vladimir,324,152,172,46.91
Irelia,Qiyana,170,87,83,51.18
Irelia,Vi,455,280,175,61.54
Irelia,Varus,334,144,190,43.11
Irelia,Hecarim,168,83,85,49.4
Irelia,Karthus,144,68,76,47.22
Irelia,Kassadin,130,66,64,50.77
Irelia,Viktor,353,152,201,43.06
Irelia,LeeSin,449,244,205,54.34
Irelia,Kalista,260,142,118,54.62
Irelia,Sejuani,180,76,104,42.22
Irelia,Xayah,324,133,191,41.05
Irelia,Quinn,161,87,74,54.04
Irelia,Katarina,561,322,239,57.4
Irelia,Janna,161,97,64,60.25
Irelia,Renata,140,73,67,52.14
Irelia,Maokai,282,133,149,47.16
Irelia,Urgot,248,104,144,41.94
Irelia,XinZhao,266,119,147,44.74
Irelia,Annie,105,57,48,54.29
Irelia,KogMaw,192,76,116,39.58
Irelia,Shen,387,160,227,41.34
Irelia,Yuumi,547,259,288,47.35
Irelia,Rell,247,120,127,48.58
Irelia,Anivia,129,68,61,52.71
Irelia,Belveth,145,74,71,51.03
Irelia,AurelionSol,223,80,143,35.87
Irelia,DrMundo,301,125,176,41.53
Irelia,Viego,595,303,292,50.92
Irelia,Bard,112,61,51,54.46
Irelia,Kindred,282,144,138,51.06
Irelia,Zoe,280,150,130,53.57
Irelia,Talon,337,187,150,55.49
Irelia,Ambessa,311,171,140,54.98
Irelia,Kled,98,44,54,44.9
Irelia,Xerath,340,133,207,39.12
Irelia,Alistar,189,84,105,44.44
Irelia,Elise,316,148,168,46.84
Irelia,RekSai,95,23,72,24.21
Irelia,Corki,96,46,50,47.92
Irelia,Ivern,120,60,60,50
Irelia,Taric,79,37,42,46.84
Irelia,Rumble,72,47,25,65.28
Irelia,Fiora,263,117,146,44.49
Irelia,Camille,160,48,112,30
Irelia,Akshan,240,129,111,53.75
Irelia,Shyvana,155,88,67,56.77
Ezreal,Yone,1871,933,938,49.87
Ezreal,Darius,1859,832,1027,44.76
Ezreal,Yasuo,1896,887,1009,46.78
Ezreal,Jhin,1915,808,1107,42.19
Ezreal,Lux,2535,1246,1289,49.15
Ezreal,Gwen,622,310,312,49.84
Ezreal,Vi,894,377,517,42.17
Ezreal,Zed,903,443,460,49.06
Ezreal,Soraka,535,244,291,45.61
Ezreal,Mordekaiser,1344,645,699,47.99
Ezreal,Kindred,581,271,310,46.64
Ezreal,Qiyana,359,183,176,50.97
Ezreal,Ashe,1948,901,1047,46.25
Ezreal,Sona,396,150,246,37.88
Ezreal,Garen,1454,634,820,43.6
Ezreal,Briar,949,399,550,42.04
Ezreal,Caitlyn,2944,1408,1536,47.83
Ezreal,Morgana,1402,719,683,51.28
Ezreal,Akali,1071,491,580,45.85
Ezreal,MissFortune,2156,973,1183,45.13
Ezreal,Kassadin,236,144,92,61.02
Ezreal,Kayn,1548,717,831,46.32
Ezreal,Kayle,825,354,471,42.91
Ezreal,MonkeyKing,512,267,245,52.15
Ezreal,RekSai,100,42,58,42
Ezreal,Seraphine,1079,510,569,47.27
Ezreal,Irelia,852,432,420,50.7
Ezreal,Warwick,1417,630,787,44.46
Ezreal,Galio,733,326,407,44.47
Ezreal,Sivir,516,185,331,35.85
Ezreal,Rell,578,287,291,49.65
Ezreal,Sett,1500,670,830,44.67
Ezreal,Zac,385,204,181,52.99
Ezreal,Yorick,903,403,500,44.63
Ezreal,Xerath,674,324,350,48.07
Ezreal,Fiora,434,237,197,54.61
Ezreal,FiddleSticks,461,203,258,44.03
Ezreal,Syndra,547,247,300,45.16
Ezreal,Vayne,1027,497,530,48.39
Ezreal,Viego,1194,556,638,46.57
Ezreal,AurelionSol,433,191,242,44.11
Ezreal,Nautilus,1125,532,593,47.29
Ezreal,Jinx,2124,995,1129,46.85
Ezreal,Lulu,1004,476,528,47.41
Ezreal,Camille,434,234,200,53.92
Ezreal,Katarina,790,351,439,44.43
Ezreal,Zyra,650,280,370,43.08
Ezreal,Tryndamere,480,255,225,53.13
Ezreal,Gragas,590,283,307,47.97
Ezreal,Kalista,502,245,257,48.8
Ezreal,Twitch,763,346,417,45.35
Ezreal,Graves,545,283,262,51.93
Ezreal,Sylas,1218,650,568,53.37
Ezreal,Leona,868,392,476,45.16
Ezreal,KSante,454,232,222,51.1
Ezreal,Nasus,722,331,391,45.84
Ezreal,TahmKench,1119,455,664,40.66
Ezreal,Fizz,496,232,264,46.77
Ezreal,Janna,304,133,171,43.75
Ezreal,Nocturne,736,391,345,53.13
Ezreal,Thresh,1350,593,757,43.93
Ezreal,Shen,644,285,359,44.25
Ezreal,Rammus,248,111,137,44.76
Ezreal,Cassiopeia,377,173,204,45.89
Ezreal,Udyr,409,189,220,46.21
Ezreal,Veigar,1077,480,597,44.57
Ezreal,Kennen,349,175,174,50.14
Ezreal,XinZhao,544,213,331,39.15
Ezreal,Kaisa,1623,818,805,50.4
Ezreal,Karthus,242,113,129,46.69
Ezreal,Nilah,492,194,298,39.43
Ezreal,Braum,430,196,234,45.58
Ezreal,Maokai,473,184,289,38.9
Ezreal,Pantheon,1676,794,882,47.37
Ezreal,Aurora,931,452,479,48.55
Ezreal,Teemo,1330,569,761,42.78
Ezreal,Yuumi,916,405,511,44.21
Ezreal,Poppy,635,308,327,48.5
Ezreal,Khazix,669,318,351,47.53
Ezreal,Tristana,981,480,501,48.93
Ezreal,Neeko,675,268,407,39.7
Ezreal,Nunu,816,357,459,43.75
Ezreal,Vladimir,491,228,263,46.44
Ezreal,Gnar,444,285,159,64.19
Ezreal,Akshan,294,143,151,48.64
Ezreal,Jax,730,343,387,46.99
Ezreal,Velkoz,633,345,288,54.5
Ezreal,Xayah,604,304,300,50.33
Ezreal,Rakan,427,181,246,42.39
Ezreal,MasterYi,1002,491,511,49
Ezreal,Shaco,951,527,424,55.42
Ezreal,Azir,375,172,203,45.87
Ezreal,Rengar,549,317,232,57.74
Ezreal,Pyke,1147,580,567,50.57
Ezreal,Lucian,630,265,365,42.06
Ezreal,Renekton,463,188,275,40.6
Ezreal,Zoe,437,212,225,48.51
Ezreal,LeeSin,1013,555,458,54.79
Ezreal,Hwei,723,296,427,40.94
Ezreal,Lillia,601,255,346,42.43
Ezreal,Milio,565,252,313,44.6
Ezreal,Diana,1208,567,641,46.94
Ezreal,Olaf,195,100,95,51.28
Ezreal,Volibear,1096,448,648,40.88
Ezreal,Mel,2138,1097,1041,51.31
Ezreal,Ambessa,675,328,347,48.59
Ezreal,Evelynn,490,247,243,50.41
Ezreal,Anivia,296,157,139,53.04
Ezreal,Singed,261,86,175,32.95
Ezreal,Karma,719,322,397,44.78
Ezreal,Kled,213,62,151,29.11
Ezreal,Zeri,409,205,204,50.12
Ezreal,Swain,1127,498,629,44.19
Ezreal,Talon,560,335,225,59.82
Ezreal,Varus,932,381,551,40.88
Ezreal,DrMundo,638,285,353,44.67
Ezreal,Ekko,824,356,468,43.2
Ezreal,Amumu,852,389,463,45.66
Ezreal,Ryze,366,150,216,40.98
Ezreal,Belveth,340,156,184,45.88
Ezreal,Nami,969,443,526,45.72
Ezreal,Ornn,397,138,259,34.76
Ezreal,Blitzcrank,756,371,385,49.07
Ezreal,Elise,724,353,371,48.76
Ezreal,Heimerdinger,641,301,340,46.96
Ezreal,Malzahar,829,347,482,41.86
Ezreal,Vex,502,275,227,54.78
Ezreal,Senna,949,403,546,42.47
Ezreal,Brand,648,283,365,43.67
Ezreal,Sion,812,342,470,42.12
Ezreal,Jayce,513,267,246,52.05
Ezreal,KogMaw,351,171,180,48.72
Ezreal,Urgot,453,170,283,37.53
Ezreal,Skarner,269,100,169,37.17
Ezreal,Ziggs,442,186,256,42.08
Ezreal,Leblanc,407,205,202,50.37
Ezreal,Riven,420,216,204,51.43
Ezreal,Annie,277,141,136,50.9
Ezreal,Nidalee,234,134,100,57.26
Ezreal,Orianna,552,266,286,48.19
Ezreal,Smolder,839,400,439,47.68
Ezreal,Chogath,1286,613,673,47.67
Ezreal,Naafiri,362,159,203,43.92
Ezreal,Aatrox,979,529,450,54.03
Ezreal,Aphelios,757,378,379,49.93
Ezreal,Alistar,337,189,148,56.08
Ezreal,Shyvana,285,129,156,45.26
Ezreal,Rumble,218,86,132,39.45
Ezreal,Hecarim,349,140,209,40.11
Ezreal,Samira,945,456,489,48.25
Ezreal,Bard,354,156,198,44.07
Ezreal,Illaoi,451,183,268,40.58
Ezreal,Draven,642,335,307,52.18
Ezreal,Malphite,839,355,484,42.31
Ezreal,Taliyah,270,129,141,47.78
Ezreal,Quinn,346,160,186,46.24
Ezreal,Renata,245,142,103,57.96
Ezreal,Trundle,478,183,295,38.28
Ezreal,JarvanIV,410,145,265,35.37
Ezreal,Ahri,1314,627,687,47.72
Ezreal,Sejuani,414,199,215,48.07
Ezreal,Corki,389,203,186,52.19
Ezreal,Ivern,243,107,136,44.03
Ezreal,Zilean,277,133,144,48.01
Ezreal,Lissandra,285,146,139,51.23
Ezreal,Gangplank,439,220,219,50.11
Ezreal,TwistedFate,373,183,190,49.06
Ezreal,Viktor,702,285,417,40.6
Ezreal,Taric,250,104,146,41.6
Rell,Yone,560,273,287,48.75
Rell,Darius,647,326,321,50.39
Rell,Yasuo,590,291,299,49.32
Rell,Jhin,581,260,321,44.75
Rell,Lux,764,395,369,51.7
Rell,Ryze,97,59,38,60.82
Rell,Warwick,541,298,243,55.08
Rell,Morgana,398,184,214,46.23
Rell,Xayah,243,91,152,37.45
Rell,Veigar,393,185,208,47.07
Rell,Poppy,158,75,83,47.47
Rell,Katarina,292,166,126,56.85
Rell,Twitch,218,117,101,53.67
Rell,Teemo,477,222,255,46.54
Rell,Shaco,315,174,141,55.24
Rell,Leblanc,106,49,57,46.23
Rell,Ezreal,578,291,287,50.35
Rell,Thresh,500,267,233,53.4
Rell,FiddleSticks,179,86,93,48.04
Rell,Syndra,174,78,96,44.83
Rell,Kalista,124,59,65,47.58
Rell,Mel,700,324,376,46.29
Rell,Singed,102,47,55,46.08
Rell,Pyke,362,199,163,54.97
Rell,Volibear,378,220,158,58.2
Rell,Lillia,214,124,90,57.94
Rell,Vladimir,180,69,111,38.33
Rell,Jinx,495,195,300,39.39
Rell,Lulu,159,98,61,61.64
Rell,Yorick,290,87,203,30
Rell,Gragas,214,121,93,56.54
Rell,Zac,155,81,74,52.26
Rell,Amumu,399,180,219,45.11
Rell,Chogath,388,185,203,47.68
Rell,Kennen,121,49,72,40.5
Rell,Rammus,92,36,56,39.13
Rell,Caitlyn,745,383,362,51.41
Rell,Zeri,111,50,61,45.05
Rell,Aatrox,324,138,186,42.59
Rell,Belveth,95,44,51,46.32
Rell,Hwei,226,123,103,54.42
Rell,TahmKench,384,220,164,57.29
Rell,Nasus,225,100,125,44.44
Rell,Udyr,132,66,66,50
Rell,Ashe,565,288,277,50.97
Rell,Alistar,130,76,54,58.46
Rell,Olaf,53,33,20,62.26
Rell,Mordekaiser,392,177,215,45.15
Rell,Ornn,114,60,54,52.63
Rell,Vi,278,144,134,51.8
Rell,Anivia,92,30,62,32.61
Rell,Yuumi,327,185,142,56.57
Rell,Ekko,227,103,124,45.37
Rell,Nami,299,135,164,45.15
Rell,Jayce,84,48,36,57.14
Rell,DrMundo,167,93,74,55.69
Rell,TwistedFate,122,68,54,55.74
Rell,Samira,377,206,171,54.64
Rell,Seraphine,319,176,143,55.17
Rell,MasterYi,336,169,167,50.3
Rell,Urgot,150,63,87,42
Rell,Xerath,195,91,104,46.67
Rell,Tristana,311,172,139,55.31
Rell,Garen,532,281,251,52.82
Rell,Briar,242,125,117,51.65
Rell,Zed,287,131,156,45.64
Rell,Corki,88,50,38,56.82
Rell,Pantheon,500,256,244,51.2
Rell,Diana,369,227,142,61.52
Rell,MissFortune,655,278,377,42.44
Rell,Hecarim,91,57,34,62.64
Rell,Orianna,208,105,103,50.48
Rell,Zyra,228,106,122,46.49
Rell,Karthus,86,49,37,56.98
Rell,Kassadin,97,48,49,49.48
Rell,Nunu,252,126,126,50
Rell,Kaisa,482,242,240,50.21
Rell,Jax,239,105,134,43.93
Rell,RekSai,48,14,34,29.17
Rell,Brand,224,111,113,49.55
Rell,Galio,213,67,146,31.46
Rell,Viego,365,193,172,52.88
Rell,Rakan,160,73,87,45.63
Rell,Ahri,487,239,248,49.08
Rell,Fiora,144,84,60,58.33
Rell,LeeSin,303,121,182,39.93
Rell,Milio,161,71,90,44.1
Rell,Kindred,144,76,68,52.78
Rell,Sett,621,303,318,48.79
Rell,Draven,176,85,91,48.3
Rell,Kayn,458,222,236,48.47
Rell,Akali,308,165,143,53.57
Rell,Sivir,147,80,67,54.42
Rell,Skarner,145,66,79,45.52
Rell,Zilean,118,59,59,50
Rell,Tryndamere,178,112,66,62.92
Rell,Bard,69,35,34,50.72
Rell,Leona,332,166,166,50
Rell,JarvanIV,92,33,59,35.87
Rell,Lucian,153,79,74,51.63
Rell,Soraka,226,104,122,46.02
Rell,Riven,158,97,61,61.39
Rell,Karma,224,105,119,46.88
Rell,Sylas,277,113,164,40.79
Rell,Talon,188,106,82,56.38
Rell,Irelia,247,127,120,51.42
Rell,Fizz,125,46,79,36.8
Rell,Graves,225,110,115,48.89
Rell,Neeko,208,131,77,62.98
Rell,Gnar,104,59,45,56.73
Rell,Evelynn,196,94,102,47.96
Rell,Heimerdinger,169,88,81,52.07
Rell,Kayle,176,90,86,51.14
Rell,Swain,367,142,225,38.69
Rell,Aphelios,237,114,123,48.1
Rell,Blitzcrank,287,131,156,45.64
Rell,Trundle,146,86,60,58.9
Rell,Elise,201,117,84,58.21
Rell,Malzahar,280,149,131,53.21
Rell,Cassiopeia,174,92,82,52.87
Rell,Ambessa,173,85,88,49.13
Rell,Qiyana,111,63,48,56.76
Rell,Akshan,116,47,69,40.52
Rell,KSante,137,64,73,46.72
Rell,Aurora,329,171,158,51.98
Rell,Smolder,248,109,139,43.95
Rell,Lissandra,94,23,71,24.47
Rell,Senna,265,128,137,48.3
Rell,Renata,128,49,79,38.28
Rell,Nidalee,76,36,40,47.37
Rell,Annie,133,74,59,55.64
Rell,Sona,95,46,49,48.42
Rell,Gangplank,106,21,85,19.81
Rell,Shen,220,127,93,57.73
Rell,Viktor,185,65,120,35.14
Rell,Khazix,194,69,125,35.57
Rell,Janna,157,60,97,38.22
Rell,Vayne,307,162,145,52.77
Rell,Nocturne,284,120,164,42.25
Rell,Malphite,194,105,89,54.12
Rell,Gwen,194,101,93,52.06
Rell,Renekton,126,38,88,30.16
Rell,Illaoi,139,53,86,38.13
Rell,Rengar,130,75,55,57.69
Rell,Varus,201,119,82,59.2
Rell,Velkoz,174,80,94,45.98
Rell,MonkeyKing,152,62,90,40.79
Rell,Naafiri,141,42,99,29.79
Rell,Taliyah,97,58,39,59.79
Rell,Azir,116,72,44,62.07
Rell,Sion,235,113,122,48.09
Rell,AurelionSol,208,75,133,36.06
Rell,Shyvana,91,26,65,28.57
Rell,KogMaw,115,47,68,40.87
Rell,Kled,40,19,21,47.5
Rell,Sejuani,95,48,47,50.53
Rell,Nautilus,393,194,199,49.36
Rell,XinZhao,141,60,81,42.55
Rell,Rumble,66,35,31,53.03
Rell,Quinn,94,43,51,45.74
Rell,Maokai,177,88,89,49.72
Rell,Ivern,100,49,51,49
Rell,Camille,120,70,50,58.33
Rell,Ziggs,122,63,59,51.64
Rell,Nilah,211,122,89,57.82
Rell,Braum,173,86,87,49.71
Rell,Zoe,151,80,71,52.98
Rell,Taric,57,16,41,28.07
Rell,Vex,218,99,119,45.41
Sejuani,Singed,69,43,26,62.32
Sejuani,Shaco,134,79,55,58.96
Sejuani,Zed,177,94,83,53.11
Sejuani,Hwei,134,63,71,47.01
Sejuani,Lux,553,287,266,51.9
Sejuani,Naafiri,73,28,45,38.36
Sejuani,Briar,190,86,104,45.26
Sejuani,Yone,400,257,143,64.25
Sejuani,MissFortune,505,234,271,46.34
Sejuani,Senna,171,73,98,42.69
Sejuani,Volibear,327,113,214,34.56
Sejuani,Lillia,165,58,107,35.15
Sejuani,Vladimir,111,38,73,34.23
Sejuani,Jinx,359,204,155,56.82
Sejuani,Lulu,156,60,96,38.46
Sejuani,Riven,73,28,45,38.36
Sejuani,Syndra,134,76,58,56.72
Sejuani,Pyke,211,116,95,54.98
Sejuani,Aurora,240,116,124,48.33
Sejuani,FiddleSticks,125,74,51,59.2
Sejuani,Yasuo,403,178,225,44.17
Sejuani,Jhin,337,176,161,52.23
Sejuani,Vex,110,49,61,44.55
Sejuani,Kayn,394,186,208,47.21
Sejuani,Khazix,169,108,61,63.91
Sejuani,Seraphine,240,125,115,52.08
Sejuani,Sett,390,178,212,45.64
Sejuani,Pantheon,308,182,126,59.09
Sejuani,Ashe,374,214,160,57.22
Sejuani,Braum,87,49,38,56.32
Sejuani,Nasus,151,61,90,40.4
Sejuani,Smolder,144,63,81,43.75
Sejuani,Galio,119,64,55,53.78
Sejuani,Ahri,289,148,141,51.21
Sejuani,Tristana,128,61,67,47.66
Sejuani,Alistar,106,38,68,35.85
Sejuani,Amumu,230,120,110,52.17
Sejuani,Velkoz,129,81,48,62.79
Sejuani,Yorick,212,84,128,39.62
Sejuani,Rengar,144,101,43,70.14
Sejuani,Neeko,154,82,72,53.25
Sejuani,Gwen,124,73,51,58.87
Sejuani,Katarina,231,137,94,59.31
Sejuani,Elise,198,115,83,58.08
Sejuani,Teemo,338,124,214,36.69
Sejuani,Vi,152,71,81,46.71
Sejuani,Bard,142,57,85,40.14
Sejuani,Caitlyn,490,230,260,46.94
Sejuani,Mordekaiser,320,181,139,56.56
Sejuani,Aphelios,177,85,92,48.02
Sejuani,Zilean,82,66,16,80.49
Sejuani,Morgana,281,170,111,60.5
Sejuani,Viego,280,141,139,50.36
Sejuani,Samira,248,114,134,45.97
Sejuani,Leona,141,77,64,54.61
Sejuani,Aatrox,201,90,111,44.78
Sejuani,LeeSin,217,106,111,48.85
Sejuani,Akshan,94,30,64,31.91
Sejuani,Zyra,117,52,65,44.44
Sejuani,Trundle,180,98,82,54.44
Sejuani,Rammus,70,33,37,47.14
Sejuani,Fizz,77,41,36,53.25
Sejuani,Sivir,96,34,62,35.42
Sejuani,Lucian,146,79,67,54.11
Sejuani,Darius,407,220,187,54.05
Sejuani,Sona,75,37,38,49.33
Sejuani,Graves,96,68,28,70.83
Sejuani,Ziggs,80,29,51,36.25
Sejuani,Nocturne,177,86,91,48.59
Sejuani,Ekko,153,98,55,64.05
Sejuani,Irelia,180,104,76,57.78
Sejuani,Taric,52,26,26,50
Sejuani,Sylas,245,108,137,44.08
Sejuani,Warwick,303,159,144,52.48
Sejuani,Camille,72,47,25,65.28
Sejuani,Viktor,152,86,66,56.58
Sejuani,Mel,411,202,209,49.15
Sejuani,Ambessa,157,101,56,64.33
Sejuani,Garen,315,168,147,53.33
Sejuani,Soraka,151,64,87,42.38
Sejuani,Renekton,104,62,42,59.62
Sejuani,Thresh,351,170,181,48.43
Sejuani,Shen,144,75,69,52.08
Sejuani,Gangplank,100,56,44,56
Sejuani,Gragas,167,99,68,59.28
Sejuani,Udyr,77,46,31,59.74
Sejuani,Ryze,25,13,12,52
Sejuani,Akali,223,105,118,47.09
Sejuani,Blitzcrank,162,70,92,43.21
Sejuani,Kindred,91,80,11,87.91
Sejuani,Draven,106,53,53,50
Sejuani,MasterYi,176,84,92,47.73
Sejuani,Nautilus,255,146,109,57.25
Sejuani,Vayne,229,132,97,57.64
Sejuani,Kennen,76,43,33,56.58
Sejuani,Varus,205,114,91,55.61
Sejuani,Yuumi,182,105,77,57.69
Sejuani,Gnar,78,36,42,46.15
Sejuani,Zeri,59,41,18,69.49
Sejuani,XinZhao,124,43,81,34.68
Sejuani,Veigar,206,91,115,44.17
Sejuani,Karma,167,98,69,58.68
Sejuani,Kled,38,22,16,57.89
Sejuani,Ezreal,414,215,199,51.93
Sejuani,Diana,240,117,123,48.75
Sejuani,TahmKench,210,116,94,55.24
Sejuani,Zoe,126,90,36,71.43
Sejuani,Twitch,199,111,88,55.78
Sejuani,Cassiopeia,79,54,25,68.35
Sejuani,Nilah,150,72,78,48
Sejuani,Nunu,193,85,108,44.04
Sejuani,Milio,133,55,78,41.35
Sejuani,Swain,252,108,144,42.86
Sejuani,Illaoi,81,46,35,56.79
Sejuani,Leblanc,96,53,43,55.21
Sejuani,Brand,86,46,40,53.49
Sejuani,Malphite,173,64,109,36.99
Sejuani,Kaisa,341,228,113,66.86
Sejuani,Xerath,129,99,30,76.74
Sejuani,Jax,156,92,64,58.97
Sejuani,Chogath,267,136,131,50.94
Sejuani,RekSai,18,9,9,50
Sejuani,Malzahar,191,90,101,47.12
Sejuani,JarvanIV,115,70,45,60.87
Sejuani,Shyvana,46,14,32,30.43
Sejuani,Lissandra,33,23,10,69.7
Sejuani,Sion,169,101,68,59.76
Sejuani,DrMundo,156,74,82,47.44
Sejuani,Rakan,100,65,35,65
Sejuani,KogMaw,90,36,54,40
Sejuani,Corki,99,60,39,60.61
Sejuani,Tryndamere,127,59,68,46.46
Sejuani,KSante,72,33,39,45.83
Sejuani,Xayah,137,78,59,56.93
Sejuani,Quinn,45,22,23,48.89
Sejuani,Skarner,99,54,45,54.55
Sejuani,Qiyana,92,39,53,42.39
Sejuani,Olaf,15,6,9,40
Sejuani,Poppy,118,72,46,61.02
Sejuani,Annie,74,35,39,47.3
Sejuani,Kayle,149,80,69,53.69
Sejuani,Talon,120,81,39,67.5
Sejuani,Nami,245,113,132,46.12
Sejuani,Belveth,41,10,31,24.39
Sejuani,Ornn,40,21,19,52.5
Sejuani,Fiora,85,43,42,50.59
Sejuani,TwistedFate,75,46,29,61.33
Sejuani,Kalista,102,47,55,46.08
Sejuani,Rell,95,47,48,49.47
Sejuani,Kassadin,38,22,16,57.89
Sejuani,Urgot,85,36,49,42.35
Sejuani,Hecarim,66,42,24,63.64
Sejuani,Anivia,59,28,31,47.46
Sejuani,Maokai,91,58,33,63.74
Sejuani,Heimerdinger,135,54,81,40
Sejuani,Jayce,113,69,44,61.06
Sejuani,Zac,93,47,46,50.54
Sejuani,Taliyah,37,7,30,18.92
Sejuani,Evelynn,121,67,54,55.37
Sejuani,Janna,43,18,25,41.86
Sejuani,AurelionSol,84,48,36,57.14
Sejuani,Azir,66,13,53,19.7
Sejuani,Rumble,50,27,23,54
Sejuani,MonkeyKing,91,49,42,53.85
Sejuani,Ivern,50,33,17,66
Sejuani,Karthus,67,40,27,59.7
Sejuani,Renata,81,36,45,44.44
Sejuani,Orianna,117,69,48,58.97
Sejuani,Nidalee,32,16,16,50
Pantheon,Singed,269,108,161,40.15
Pantheon,Shaco,922,456,466,49.46
Pantheon,Zed,1050,551,499,52.48
Pantheon,Hwei,773,372,401,48.12
Pantheon,Lux,2794,1406,1388,50.32
Pantheon,Darius,1924,1044,880,54.26
Pantheon,Zac,289,163,126,56.4
Pantheon,Poppy,636,298,338,46.86
Pantheon,Twitch,786,463,323,58.91
Pantheon,Maokai,436,227,209,52.06
Pantheon,Graves,474,263,211,55.49
Pantheon,Ahri,1361,703,658,51.65
Pantheon,Nilah,630,275,355,43.65
Pantheon,Malphite,786,332,454,42.24
Pantheon,Garen,1511,751,760,49.7
Pantheon,Briar,949,444,505,46.79
Pantheon,Caitlyn,2071,1004,1067,48.48
Pantheon,Morgana,1346,689,657,51.19
Pantheon,Aatrox,947,584,363,61.67
Pantheon,Brand,708,343,365,48.45
Pantheon,Irelia,881,494,387,56.07
Pantheon,Milio,510,246,264,48.24
Pantheon,Kayn,1735,808,927,46.57
Pantheon,Katarina,934,443,491,47.43
Pantheon,Vayne,1036,491,545,47.39
Pantheon,DrMundo,617,251,366,40.68
Pantheon,Gangplank,363,200,163,55.1
Pantheon,Kaisa,1328,662,666,49.85
Pantheon,Galio,661,282,379,42.66
Pantheon,Cassiopeia,368,195,173,52.99
Pantheon,Sett,1657,795,862,47.98
Pantheon,Talon,625,323,302,51.68
Pantheon,FiddleSticks,580,301,279,51.9
Pantheon,Ashe,1653,856,797,51.78
Pantheon,Blitzcrank,931,483,448,51.88
Pantheon,Lillia,645,347,298,53.8
Pantheon,Sylas,951,515,436,54.15
Pantheon,TahmKench,1108,541,567,48.83
Pantheon,Jax,862,415,447,48.14
Pantheon,Heimerdinger,530,243,287,45.85
Pantheon,Soraka,646,264,382,40.87
Pantheon,Elise,575,269,306,46.78
Pantheon,Olaf,223,96,127,43.05
Pantheon,Hecarim,357,182,175,50.98
Pantheon,Veigar,1124,473,651,42.08
Pantheon,Tristana,956,460,496,48.12
Pantheon,Braum,543,312,231,57.46
Pantheon,Ryze,292,139,153,47.6
Pantheon,Lulu,837,445,392,53.17
Pantheon,Gnar,447,270,177,60.4
Pantheon,Warwick,1536,708,828,46.09
Pantheon,Malzahar,800,325,475,40.63
Pantheon,XinZhao,568,278,290,48.94
Pantheon,Akali,994,491,503,49.4
Pantheon,LeeSin,1008,537,471,53.27
Pantheon,Evelynn,554,298,256,53.79
Pantheon,Ezreal,1676,882,794,52.63
Pantheon,Jinx,2076,910,1166,43.83
Pantheon,Samira,863,454,409,52.61
Pantheon,Ekko,742,351,391,47.3
Pantheon,Chogath,1379,648,731,46.99
Pantheon,Yorick,843,383,460,45.43
Pantheon,Sion,764,367,397,48.04
Pantheon,MasterYi,1003,474,529,47.26
Pantheon,AurelionSol,424,209,215,49.29
Pantheon,Seraphine,1090,561,529,51.47
Pantheon,Mordekaiser,1450,663,787,45.72
Pantheon,Sejuani,308,126,182,40.91
Pantheon,Yone,2077,1059,1018,50.99
Pantheon,MissFortune,2130,1007,1123,47.28
Pantheon,Swain,1050,487,563,46.38
Pantheon,Yasuo,1818,949,869,52.2
Pantheon,Corki,328,166,162,50.61
Pantheon,Karma,627,319,308,50.88
Pantheon,Neeko,843,418,425,49.58
Pantheon,Yuumi,900,439,461,48.78
Pantheon,Rengar,376,237,139,63.03
Pantheon,Jhin,1588,845,743,53.21
Pantheon,Kindred,602,354,248,58.8
Pantheon,Alistar,300,154,146,51.33
Pantheon,Volibear,1054,506,548,48.01
Pantheon,Velkoz,669,276,393,41.26
Pantheon,Varus,814,455,359,55.9
Pantheon,Aurora,1030,527,503,51.17
Pantheon,Trundle,477,224,253,46.96
Pantheon,Mel,2114,1176,938,55.63
Pantheon,Illaoi,478,207,271,43.31
Pantheon,Khazix,621,316,305,50.89
Pantheon,Leona,716,294,422,41.06
Pantheon,Draven,626,317,309,50.64
Pantheon,Nautilus,1084,590,494,54.43
Pantheon,Viego,1080,508,572,47.04
Pantheon,KSante,353,166,187,47.03
Pantheon,Kalista,428,249,179,58.18
Pantheon,Ivern,165,80,85,48.48
Pantheon,Quinn,334,176,158,52.69
Pantheon,Nasus,781,375,406,48.02
Pantheon,Kled,163,87,76,53.37
Pantheon,Taliyah,266,134,132,50.38
Pantheon,Sona,416,166,250,39.9
Pantheon,RekSai,150,58,92,38.67
Pantheon,Zoe,405,237,168,58.52
Pantheon,Nunu,944,505,439,53.5
Pantheon,Thresh,1347,642,705,47.66
Pantheon,Shen,599,247,352,41.24
Pantheon,Riven,432,298,134,68.98
Pantheon,Rell,500,244,256,48.8
Pantheon,Vladimir,635,332,303,52.28
Pantheon,Kayle,871,504,367,57.86
Pantheon,Azir,410,207,203,50.49
Pantheon,Xayah,630,307,323,48.73
Pantheon,Orianna,471,195,276,41.4
Pantheon,Ambessa,600,262,338,43.67
Pantheon,Pyke,1300,773,527,59.46
Pantheon,Anivia,294,129,165,43.88
Pantheon,Nocturne,810,454,356,56.05
Pantheon,Udyr,414,219,195,52.9
Pantheon,Sivir,553,287,266,51.9
Pantheon,Skarner,312,164,148,52.56
Pantheon,Gwen,573,271,302,47.29
Pantheon,Rammus,346,158,188,45.66
Pantheon,Viktor,614,350,264,57
Pantheon,Fiora,467,217,250,46.47
Pantheon,Vi,898,394,504,43.88
Pantheon,TwistedFate,393,203,190,51.65
Pantheon,Zilean,259,123,136,47.49
Pantheon,Ziggs,404,207,197,51.24
Pantheon,Ornn,396,197,199,49.75
Pantheon,Aphelios,611,271,340,44.35
Pantheon,Lucian,583,292,291,50.09
Pantheon,Camille,343,210,133,61.22
Pantheon,MonkeyKing,479,216,263,45.09
Pantheon,Rakan,524,264,260,50.38
Pantheon,Renekton,454,238,216,52.42
Pantheon,Zeri,395,236,159,59.75
Pantheon,Kassadin,220,111,109,50.45
Pantheon,Leblanc,393,234,159,59.54
Pantheon,Fizz,535,284,251,53.08
Pantheon,Renata,239,109,130,45.61
Pantheon,Zyra,620,254,366,40.97
Pantheon,Nami,803,416,387,51.81
Pantheon,Diana,1237,620,617,50.12
Pantheon,Annie,244,116,128,47.54
Pantheon,Xerath,598,309,289,51.67
Pantheon,Lissandra,239,109,130,45.61
Pantheon,Senna,811,413,398,50.92
Pantheon,Naafiri,427,248,179,58.08
Pantheon,Nidalee,280,139,141,49.64
Pantheon,Teemo,1357,601,756,44.29
Pantheon,Qiyana,312,137,175,43.91
Pantheon,Jayce,324,207,117,63.89
Pantheon,Gragas,614,293,321,47.72
Pantheon,Taric,235,82,153,34.89
Pantheon,Karthus,269,127,142,47.21
Pantheon,Smolder,760,396,364,52.11
Pantheon,Tryndamere,635,333,302,52.44
Pantheon,Amumu,954,454,500,47.59
Pantheon,Rumble,205,126,79,61.46
Pantheon,Shyvana,292,126,166,43.15
Pantheon,KogMaw,324,165,159,50.93
Pantheon,Belveth,314,163,151,51.91
Pantheon,Syndra,548,293,255,53.47
Pantheon,Janna,265,134,131,50.57
Pantheon,Urgot,534,226,308,42.32
Pantheon,JarvanIV,379,160,219,42.22
Pantheon,Bard,286,162,124,56.64
Pantheon,Kennen,320,198,122,61.88
Pantheon,Vex,662,338,324,51.06
Pantheon,Akshan,386,171,215,44.3
Singed,Mordekaiser,214,108,106,50.47
Singed,Sejuani,69,26,43,37.68
Singed,Yasuo,265,158,107,59.62
Singed,Lucian,81,41,40,50.62
Singed,Pantheon,269,161,108,59.85
Singed,Irelia,137,69,68,50.36
Singed,Kayn,280,155,125,55.36
Singed,Katarina,165,94,71,56.97
Singed,Vayne,219,104,115,47.49
Singed,DrMundo,111,66,45,59.46
Singed,Heimerdinger,123,80,43,65.04
Singed,Talon,111,62,49,55.86
Singed,Ahri,211,131,80,62.09
Singed,Kalista,65,42,23,64.62
Singed,Brand,107,83,24,77.57
Singed,Sett,261,113,148,43.3
Singed,Vladimir,65,32,33,49.23
Singed,Kindred,69,48,21,69.57
Singed,Aphelios,98,50,48,51.02
Singed,Pyke,158,85,73,53.8
Singed,Darius,262,128,134,48.85
Singed,Poppy,97,45,52,46.39
Singed,Sylas,146,68,78,46.58
Singed,Rell,102,55,47,53.92
Singed,Kayle,154,55,99,35.71
Singed,Akali,174,108,66,62.07
Singed,Soraka,119,61,58,51.26
Singed,Swain,160,108,52,67.5
Singed,Jax,175,74,101,42.29
Singed,Morgana,209,86,123,41.15
Singed,Caitlyn,420,224,196,53.33
Singed,Tryndamere,92,56,36,60.87
Singed,Nasus,185,74,111,40
Singed,Galio,141,67,74,47.52
Singed,Smolder,115,85,30,73.91
Singed,JarvanIV,76,33,43,43.42
Singed,Urgot,133,72,61,54.14
Singed,Ekko,128,54,74,42.19
Singed,Xerath,109,63,46,57.8
Singed,Warwick,199,102,97,51.26
Singed,Aurora,152,104,48,68.42
Singed,Samira,176,112,64,63.64
Singed,Neeko,82,52,30,63.41
Singed,Nocturne,166,88,78,53.01
Singed,Orianna,109,45,64,41.28
Singed,Ezreal,261,175,86,67.05
Singed,Bard,54,45,9,83.33
Singed,Maokai,82,38,44,46.34
Singed,Sion,151,107,44,70.86
Singed,Lux,410,221,189,53.9
Singed,Amumu,146,74,72,50.68
Singed,Mel,371,210,161,56.6
Singed,Jhin,257,155,102,60.31
Singed,Yuumi,161,94,67,58.39
Singed,FiddleSticks,90,47,43,52.22
Singed,Zoe,114,80,34,70.18
Singed,Kaisa,272,151,121,55.51
Singed,Taric,44,26,18,59.09
Singed,Karma,133,67,66,50.38
Singed,Zed,153,87,66,56.86
Singed,Veigar,142,78,64,54.93
Singed,Rengar,71,30,41,42.25
Singed,Thresh,277,160,117,57.76
Singed,MasterYi,146,81,65,55.48
Singed,Gragas,106,57,49,53.77
Singed,Aatrox,192,133,59,69.27
Singed,Blitzcrank,136,75,61,55.15
Singed,LeeSin,132,75,57,56.82
Singed,MissFortune,286,168,118,58.74
Singed,Nami,153,78,75,50.98
Singed,Zeri,87,52,35,59.77
Singed,Nunu,170,79,91,46.47
Singed,Malphite,110,74,36,67.27
Singed,Jinx,265,133,132,50.19
Singed,Shen,177,110,67,62.15
Singed,Leblanc,77,41,36,53.25
Singed,Twitch,138,76,62,55.07
Singed,Velkoz,157,61,96,38.85
Singed,Olaf,42,39,3,92.86
Singed,Kled,33,33,0,100
Singed,Briar,130,77,53,59.23
Singed,Ziggs,46,31,15,67.39
Singed,Nautilus,128,83,45,64.84
Singed,Taliyah,59,39,20,66.1
Singed,Viego,217,119,98,54.84
Singed,Graves,113,74,39,65.49
Singed,AurelionSol,107,43,64,40.19
Singed,Corki,64,35,29,54.69
Singed,Nilah,108,73,35,67.59
Singed,TahmKench,211,132,79,62.56
Singed,Cassiopeia,31,5,26,16.13
Singed,Braum,89,24,65,26.97
Singed,Gangplank,81,31,50,38.27
Singed,Khazix,143,96,47,67.13
Singed,Malzahar,148,48,100,32.43
Singed,Ashe,305,133,172,43.61
Singed,Zilean,50,38,12,76
Singed,Lulu,115,47,68,40.87
Singed,Yone,239,140,99,58.58
Singed,Skarner,41,32,9,78.05
Singed,Senna,193,98,95,50.78
Singed,Evelynn,67,50,17,74.63
Singed,Draven,140,89,51,63.57
Singed,Zyra,101,64,37,63.37
Singed,Udyr,56,27,29,48.21
Singed,Quinn,46,24,22,52.17
Singed,Renata,24,16,8,66.67
Singed,Fizz,79,47,32,59.49
Singed,Volibear,161,92,69,57.14
Singed,Teemo,181,125,56,69.06
Singed,Rammus,58,20,38,34.48
Singed,KSante,53,32,21,60.38
Singed,Shaco,133,99,34,74.44
Singed,Nidalee,30,24,6,80
Singed,Elise,94,46,48,48.94
Singed,Garen,205,106,99,51.71
Singed,Qiyana,80,40,40,50
Singed,Viktor,126,74,52,58.73
Singed,Seraphine,191,116,75,60.73
Singed,Riven,74,59,15,79.73
Singed,Lillia,119,53,66,44.54
Singed,Akshan,53,32,21,60.38
Singed,Varus,166,83,83,50
Singed,Rakan,76,56,20,73.68
Singed,Ambessa,91,30,61,32.97
Singed,Renekton,47,38,9,80.85
Singed,Zac,69,40,29,57.97
Singed,Alistar,49,24,25,48.98
Singed,Syndra,83,47,36,56.63
Singed,Jayce,95,45,50,47.37
Singed,Illaoi,70,28,42,40
Singed,Vex,89,61,28,68.54
Singed,Camille,64,27,37,42.19
Singed,Karthus,36,19,17,52.78
Singed,Diana,179,60,119,33.52
Singed,Chogath,218,110,108,50.46
Singed,Naafiri,94,53,41,56.38
Singed,Kennen,61,43,18,70.49
Singed,Vi,123,73,50,59.35
Singed,Xayah,119,70,49,58.82
Singed,Yorick,136,48,88,35.29
Singed,XinZhao,87,50,37,57.47
Singed,Kassadin,47,22,25,46.81
Singed,Tristana,137,93,44,67.88
Singed,Leona,104,53,51,50.96
Singed,Gwen,106,67,39,63.21
Singed,Ryze,50,19,31,38
Singed,Gnar,73,51,22,69.86
Singed,Milio,108,58,50,53.7
Singed,Fiora,63,34,29,53.97
Singed,Belveth,45,16,29,35.56
Singed,Hwei,107,44,63,41.12
Singed,MonkeyKing,76,49,27,64.47
Singed,Azir,39,30,9,76.92
Singed,Hecarim,74,37,37,50
Singed,RekSai,31,18,13,58.06
Singed,Trundle,55,30,25,54.55
Singed,TwistedFate,43,32,11,74.42
Singed,Anivia,43,17,26,39.53
Singed,Lissandra,27,12,15,44.44
Singed,Ornn,65,19,46,29.23
Singed,Annie,45,26,19,57.78
Singed,Rumble,45,39,6,86.67
Singed,Sivir,88,25,63,28.41
Singed,Shyvana,27,27,0,100
Singed,Janna,26,6,20,23.08
Singed,Ivern,26,8,18,30.77
Singed,Sona,28,15,13,53.57
Singed,KogMaw,26,3,23,11.54
Shaco,Mordekaiser,818,387,431,47.31
Shaco,Sejuani,134,55,79,41.04
Shaco,Yasuo,1016,492,524,48.43
Shaco,Lucian,240,138,102,57.5
Shaco,Pantheon,922,466,456,50.54
Shaco,Renekton,192,92,100,47.92
Shaco,Kayn,930,382,548,41.08
Shaco,Katarina,558,279,279,50
Shaco,Draven,312,160,152,51.28
Shaco,Yuumi,558,274,284,49.1
Shaco,Khazix,349,185,164,53.01
Shaco,Mel,1212,584,628,48.18
Shaco,Jhin,1053,514,539,48.81
Shaco,Lux,1601,816,785,50.97
Shaco,Heimerdinger,335,126,209,37.61
Shaco,Warwick,909,445,464,48.95
Shaco,Neeko,348,168,180,48.28
Shaco,Leona,378,228,150,60.32
Shaco,Fiora,258,132,126,51.16
Shaco,MasterYi,546,208,338,38.1
Shaco,Karma,338,170,168,50.3
Shaco,Irelia,477,216,261,45.28
Shaco,Galio,359,156,203,43.45
Shaco,Sivir,310,177,133,57.1
Shaco,Rell,315,141,174,44.76
Shaco,Yorick,550,218,332,39.64
Shaco,Viego,743,381,362,51.28
Shaco,Malphite,436,196,240,44.95
Shaco,Kaisa,791,402,389,50.82
Shaco,Briar,504,275,229,54.56
Shaco,Zed,545,280,265,51.38
Shaco,Jinx,938,409,529,43.6
Shaco,Lulu,384,236,148,61.46
Shaco,Teemo,681,260,421,38.18
Shaco,Gragas,404,279,125,69.06
Shaco,Qiyana,163,96,67,58.9
Shaco,Caitlyn,1405,686,719,48.83
Shaco,Soraka,355,159,196,44.79
Shaco,Jayce,258,153,105,59.3
Shaco,Amumu,498,190,308,38.15
Shaco,Ashe,906,499,407,55.08
Shaco,Milio,254,126,128,49.61
Shaco,Sett,1046,506,540,48.37
Shaco,Ivern,136,83,53,61.03
Shaco,Senna,587,288,299,49.06
Shaco,Jax,421,211,210,50.12
Shaco,Diana,736,374,362,50.82
Shaco,Ahri,772,391,381,50.65
Shaco,Aphelios,351,200,151,56.98
Shaco,Illaoi,323,187,136,57.89
Shaco,Velkoz,437,187,250,42.79
Shaco,Veigar,605,228,377,37.69
Shaco,Ekko,490,202,288,41.22
Shaco,Kassadin,188,70,118,37.23
Shaco,TahmKench,507,236,271,46.55
Shaco,Ambessa,252,115,137,45.63
Shaco,LeeSin,549,282,267,51.37
Shaco,Malzahar,441,181,260,41.04
Shaco,MissFortune,1078,532,546,49.35
Shaco,Blitzcrank,392,174,218,44.39
Shaco,Volibear,616,312,304,50.65
Shaco,Nocturne,465,203,262,43.66
Shaco,Xerath,336,191,145,56.85
Shaco,Ezreal,951,424,527,44.58
Shaco,Gangplank,270,120,150,44.44
Shaco,Yone,1162,534,628,45.96
Shaco,Twitch,487,243,244,49.9
Shaco,Swain,605,286,319,47.27
Shaco,Rammus,97,56,41,57.73
Shaco,Chogath,679,301,378,44.33
Shaco,Nautilus,540,256,284,47.41
Shaco,Cassiopeia,218,104,114,47.71
Shaco,Thresh,685,293,392,42.77
Shaco,Aurora,461,253,208,54.88
Shaco,Aatrox,577,288,289,49.91
Shaco,Camille,200,78,122,39
Shaco,Azir,208,95,113,45.67
Shaco,Braum,230,100,130,43.48
Shaco,DrMundo,369,156,213,42.28
Shaco,Naafiri,249,110,139,44.18
Shaco,Morgana,788,372,416,47.21
Shaco,Sion,393,129,264,32.82
Shaco,Kled,139,101,38,72.66
Shaco,Vi,512,226,286,44.14
Shaco,Zeri,285,125,160,43.86
Shaco,Brand,384,212,172,55.21
Shaco,Vladimir,305,146,159,47.87
Shaco,Kindred,387,195,192,50.39
Shaco,Seraphine,603,329,274,54.56
Shaco,Sona,258,137,121,53.1
Shaco,Sylas,492,219,273,44.51
Shaco,Nilah,382,174,208,45.55
Shaco,Rumble,132,66,66,50
Shaco,KSante,305,158,147,51.8
Shaco,Olaf,142,84,58,59.15
Shaco,Darius,1051,545,506,51.86
Shaco,Vayne,505,250,255,49.5
Shaco,Talon,477,235,242,49.27
Shaco,Taliyah,119,69,50,57.98
Shaco,Zoe,295,157,138,53.22
Shaco,Udyr,215,112,103,52.09
Shaco,Leblanc,238,140,98,58.82
Shaco,Nami,601,275,326,45.76
Shaco,Ornn,212,91,121,42.92
Shaco,Rengar,259,129,130,49.81
Shaco,Kalista,320,153,167,47.81
Shaco,Samira,553,267,286,48.28
Shaco,Evelynn,304,143,161,47.04
Shaco,Trundle,281,134,147,47.69
Shaco,AurelionSol,285,115,170,40.35
Shaco,Maokai,181,107,74,59.12
Shaco,Vex,380,191,189,50.26
Shaco,Gwen,285,171,114,60
Shaco,Lillia,340,198,142,58.24
Shaco,Pyke,633,343,290,54.19
Shaco,Fizz,324,116,208,35.8
Shaco,Renata,153,54,99,35.29
Shaco,Karthus,245,133,112,54.29
Shaco,Tryndamere,385,207,178,53.77
Shaco,Varus,509,238,271,46.76
Shaco,FiddleSticks,279,116,163,41.58
Shaco,Ryze,180,58,122,32.22
Shaco,Janna,142,73,69,51.41
Shaco,Graves,306,154,152,50.33
Shaco,Taric,102,43,59,42.16
Shaco,Kayle,380,151,229,39.74
Shaco,Tristana,565,274,291,48.5
Shaco,Garen,707,337,370,47.67
Shaco,Kennen,242,136,106,56.2
Shaco,Quinn,244,116,128,47.54
Shaco,Shen,427,206,221,48.24
Shaco,Viktor,388,171,217,44.07
Shaco,Anivia,168,97,71,57.74
Shaco,Zyra,388,170,218,43.81
Shaco,JarvanIV,230,97,133,42.17
Shaco,XinZhao,299,146,153,48.83
Shaco,TwistedFate,214,152,62,71.03
Shaco,Shyvana,154,60,94,38.96
Shaco,Akshan,176,71,105,40.34
Shaco,Smolder,502,243,259,48.41
Shaco,Nunu,459,198,261,43.14
Shaco,Nidalee,141,108,33,76.6
Shaco,Annie,160,117,43,73.13
Shaco,RekSai,86,42,44,48.84
Shaco,Ziggs,226,123,103,54.42
Shaco,Xayah,384,210,174,54.69
Shaco,Syndra,381,161,220,42.26
Shaco,Hwei,420,227,193,54.05
Shaco,Akali,641,349,292,54.45
Shaco,Rakan,261,110,151,42.15
Shaco,Belveth,172,69,103,40.12
Shaco,Corki,194,97,97,50
Shaco,Gnar,199,134,65,67.34
Shaco,Orianna,222,110,112,49.55
Shaco,Hecarim,267,137,130,51.31
Shaco,MonkeyKing,302,143,159,47.35
Shaco,Lissandra,168,67,101,39.88
Shaco,Poppy,382,197,185,51.57
Shaco,Bard,159,72,87,45.28
Shaco,Riven,257,142,115,55.25
Shaco,Zac,155,80,75,51.61
Shaco,Elise,409,200,209,48.9
Shaco,Singed,133,34,99,25.56
Shaco,Urgot,245,113,132,46.12
Shaco,Alistar,183,92,91,50.27
Shaco,KogMaw,137,55,82,40.15
Shaco,Skarner,151,52,99,34.44
Shaco,Nasus,389,212,177,54.5
Shaco,Zilean,123,46,77,37.4
Zed,Mordekaiser,784,323,461,41.2
Zed,Sejuani,177,83,94,46.89
Zed,Yasuo,1296,543,753,41.9
Zed,Lucian,303,151,152,49.83
Zed,Pantheon,1050,499,551,47.52
Zed,Chogath,672,298,374,44.35
Zed,Kayn,919,454,465,49.4
Zed,Gangplank,207,106,101,51.21
Zed,Ezreal,903,460,443,50.94
Zed,Hwei,501,283,218,56.49
Zed,Diana,813,389,424,47.85
Zed,Yuumi,517,244,273,47.2
Zed,Trundle,286,98,188,34.27
Zed,MasterYi,521,240,281,46.07
Zed,Veigar,650,343,307,52.77
Zed,Jhin,1110,533,577,48.02
Zed,Soraka,356,202,154,56.74
Zed,Gnar,246,108,138,43.9
Zed,Jax,514,257,257,50
Zed,Caitlyn,1394,573,821,41.1
Zed,Neeko,392,193,199,49.23
Zed,Fiora,261,123,138,47.13
Zed,Mel,1318,620,698,47.04
Zed,Karma,346,156,190,45.09
Zed,Malphite,597,266,331,44.56
Zed,Evelynn,321,151,170,47.04
Zed,Irelia,619,346,273,55.9
Zed,Tristana,517,245,272,47.39
Zed,Thresh,776,312,464,40.21
Zed,Ryze,162,64,98,39.51
Zed,Warwick,910,423,487,46.48
Zed,Morgana,784,348,436,44.39
Zed,Xayah,450,123,327,27.33
Zed,Vladimir,313,126,187,40.26
Zed,Shaco,545,265,280,48.62
Zed,Tryndamere,297,105,192,35.35
Zed,Milio,344,151,193,43.9
Zed,Heimerdinger,279,124,155,44.44
Zed,Kindred,282,127,155,45.04
Zed,Katarina,479,263,216,54.91
Zed,Janna,200,64,136,32
Zed,Teemo,739,298,441,40.32
Zed,Gragas,346,189,157,54.62
Zed,Qiyana,300,142,158,47.33
Zed,Akali,553,271,282,49.01
Zed,Jinx,1081,467,614,43.2
Zed,Leblanc,200,89,111,44.5
Zed,Senna,447,206,241,46.09
Zed,Amumu,559,253,306,45.26
Zed,Kaisa,840,383,457,45.6
Zed,Seraphine,546,289,257,52.93
Zed,Ashe,904,414,490,45.8
Zed,Pyke,657,362,295,55.1
Zed,Darius,1185,578,607,48.78
Zed,Nami,612,236,376,38.56
Zed,Aatrox,490,225,265,45.92
Zed,Cassiopeia,187,75,112,40.11
Zed,Yone,1051,511,540,48.62
Zed,Vayne,564,267,297,47.34
Zed,Shyvana,117,32,85,27.35
Zed,Sylas,552,239,313,43.3
Zed,Briar,574,244,330,42.51
Zed,Kled,97,40,57,41.24
Zed,Ambessa,369,211,158,57.18
Zed,Nilah,305,132,173,43.28
Zed,Leona,346,143,203,41.33
Zed,Riven,293,154,139,52.56
Zed,TwistedFate,248,106,142,42.74
Zed,Kennen,196,123,73,62.76
Zed,Ahri,775,334,441,43.1
Zed,Lux,1464,651,813,44.47
Zed,TahmKench,647,284,363,43.89
Zed,MissFortune,1084,522,562,48.15
Zed,Blitzcrank,361,190,171,52.63
Zed,Vex,332,145,187,43.67
Zed,Vi,498,204,294,40.96
Zed,Swain,588,270,318,45.92
Zed,DrMundo,331,146,185,44.11
Zed,Lillia,508,232,276,45.67
Zed,Lissandra,175,66,109,37.71
Zed,FiddleSticks,270,91,179,33.7
Zed,Anivia,152,89,63,58.55
Zed,Poppy,337,153,184,45.4
Zed,XinZhao,308,132,176,42.86
Zed,Syndra,393,181,212,46.06
Zed,Sett,940,381,559,40.53
Zed,Rumble,91,30,61,32.97
Zed,Samira,559,264,295,47.23
Zed,Talon,371,210,161,56.6
Zed,Aurora,555,338,217,60.9
Zed,Taliyah,122,63,59,51.64
Zed,Zoe,299,178,121,59.53
Zed,Twitch,470,237,233,50.43
Zed,Viego,678,325,353,47.94
Zed,Nautilus,589,310,279,52.63
Zed,Urgot,229,101,128,44.1
Zed,Galio,337,122,215,36.2
Zed,Lulu,448,225,223,50.22
Zed,AurelionSol,236,111,125,47.03
Zed,Zyra,385,110,275,28.57
Zed,Singed,153,66,87,43.14
Zed,Orianna,226,114,112,50.44
Zed,Garen,784,370,414,47.19
Zed,Malzahar,431,208,223,48.26
Zed,Volibear,672,300,372,44.64
Zed,Yorick,570,170,400,29.82
Zed,Ziggs,249,101,148,40.56
Zed,Nasus,409,171,238,41.81
Zed,Rell,287,156,131,54.36
Zed,LeeSin,530,277,253,52.26
Zed,Camille,200,101,99,50.5
Zed,Kayle,357,113,244,31.65
Zed,Zac,211,92,119,43.6
Zed,Braum,225,121,104,53.78
Zed,Velkoz,401,147,254,36.66
Zed,Ornn,190,82,108,43.16
Zed,Graves,315,171,144,54.29
Zed,Bard,181,80,101,44.2
Zed,Gwen,256,137,119,53.52
Zed,Zeri,240,137,103,57.08
Zed,Hecarim,215,115,100,53.49
Zed,Nunu,408,199,209,48.77
Zed,Skarner,162,88,74,54.32
Zed,Elise,393,210,183,53.44
Zed,Renekton,271,102,169,37.64
Zed,Aphelios,534,234,300,43.82
Zed,Renata,147,61,86,41.5
Zed,Nocturne,441,203,238,46.03
Zed,Annie,167,70,97,41.92
Zed,Udyr,216,138,78,63.89
Zed,Maokai,222,104,118,46.85
Zed,MonkeyKing,270,127,143,47.04
Zed,Sion,479,196,283,40.92
Zed,Rengar,297,149,148,50.17
Zed,Ekko,559,310,249,55.46
Zed,Corki,206,89,117,43.2
Zed,Alistar,177,89,88,50.28
Zed,Fizz,346,171,175,49.42
Zed,Smolder,491,245,246,49.9
Zed,KSante,199,102,97,51.26
Zed,Nidalee,161,84,77,52.17
Zed,Rakan,349,109,240,31.23
Zed,Sivir,201,113,88,56.22
Zed,Kassadin,95,39,56,41.05
Zed,Sona,231,77,154,33.33
Zed,Viktor,361,166,195,45.98
Zed,Khazix,325,133,192,40.92
Zed,Rammus,175,75,100,42.86
Zed,Zilean,196,74,122,37.76
Zed,Akshan,165,93,72,56.36
Zed,Ivern,182,70,112,38.46
Zed,Draven,338,172,166,50.89
Zed,Illaoi,247,100,147,40.49
Zed,Varus,442,172,270,38.91
Zed,Xerath,354,154,200,43.5
Zed,Shen,430,210,220,48.84
Zed,Quinn,257,97,160,37.74
Zed,RekSai,112,43,69,38.39
Zed,KogMaw,176,76,100,43.18
Zed,Azir,231,134,97,58.01
Zed,Karthus,116,44,72,37.93
Zed,Brand,440,200,240,45.45
Zed,Taric,123,64,59,52.03
Zed,Olaf,105,42,63,40
Zed,Naafiri,282,118,164,41.84
Zed,JarvanIV,153,66,87,43.14
Zed,Kalista,245,136,109,55.51
Zed,Jayce,241,144,97,59.75
Zed,Belveth,109,43,66,39.45
Zac,Fiora,110,54,56,49.09
Zac,Pantheon,289,126,163,43.6
Zac,Katarina,188,109,79,57.98
Zac,Mel,489,230,259,47.03
Zac,Viktor,150,76,74,50.67
Zac,Ornn,49,29,20,59.18
Zac,Poppy,138,82,56,59.42
Zac,Yone,335,184,151,54.93
Zac,MissFortune,484,255,229,52.69
Zac,Brand,179,69,110,38.55
Zac,Darius,331,153,178,46.22
Zac,Volibear,244,104,140,42.62
Zac,Chogath,325,127,198,39.08
Zac,Ezreal,385,181,204,47.01
Zac,Tryndamere,111,42,69,37.84
Zac,Kayn,333,169,164,50.75
Zac,Aurora,176,90,86,51.14
Zac,Twitch,122,91,31,74.59
Zac,Lux,485,221,264,45.57
Zac,Gragas,94,44,50,46.81
Zac,XinZhao,130,49,81,37.69
Zac,Yasuo,391,185,206,47.31
Zac,Lucian,141,84,57,59.57
Zac,Velkoz,184,94,90,51.09
Zac,Yorick,201,83,118,41.29
Zac,Cassiopeia,97,62,35,63.92
Zac,Jhin,353,191,162,54.11
Zac,Rell,155,74,81,47.74
Zac,Samira,197,96,101,48.73
Zac,MasterYi,150,54,96,36
Zac,Orianna,50,27,23,54
Zac,Malphite,144,56,88,38.89
Zac,Nautilus,262,133,129,50.76
Zac,Ivern,42,15,27,35.71
Zac,Gnar,111,31,80,27.93
Zac,Seraphine,188,76,112,40.43
Zac,Irelia,169,77,92,45.56
Zac,Leona,138,55,83,39.86
Zac,Briar,212,115,97,54.25
Zac,Akali,166,71,95,42.77
Zac,Caitlyn,584,268,316,45.89
Zac,Morgana,206,106,100,51.46
Zac,Sion,207,109,98,52.66
Zac,Ahri,262,123,139,46.95
Zac,Draven,136,86,50,63.24
Zac,Kassadin,76,19,57,25
Zac,Renata,58,20,38,34.48
Zac,Teemo,274,127,147,46.35
Zac,Rengar,106,73,33,68.87
Zac,Vladimir,126,71,55,56.35
Zac,Kaisa,250,134,116,53.6
Zac,Xerath,147,72,75,48.98
Zac,Garen,352,172,180,48.86
Zac,Warwick,340,173,167,50.88
Zac,Xayah,182,74,108,40.66
Zac,Zed,211,119,92,56.4
Zac,Kindred,121,71,50,58.68
Zac,Diana,310,174,136,56.13
Zac,Tristana,152,76,76,50
Zac,Yuumi,186,105,81,56.45
Zac,Ashe,367,167,200,45.5
Zac,Riven,99,51,48,51.52
Zac,Nilah,95,23,72,24.21
Zac,Camille,75,38,37,50.67
Zac,Varus,190,79,111,41.58
Zac,Braum,75,44,31,58.67
Zac,Naafiri,88,44,44,50
Zac,Veigar,227,135,92,59.47
Zac,Neeko,157,87,70,55.41
Zac,Nasus,126,71,55,56.35
Zac,Pyke,157,70,87,44.59
Zac,Sett,292,139,153,47.6
Zac,Ekko,158,94,64,59.49
Zac,Aphelios,152,62,90,40.79
Zac,Alistar,75,27,48,36
Zac,Mordekaiser,327,181,146,55.35
Zac,Vi,229,105,124,45.85
Zac,Senna,159,77,82,48.43
Zac,AurelionSol,119,39,80,32.77
Zac,Lissandra,84,22,62,26.19
Zac,TahmKench,212,132,80,62.26
Zac,Swain,221,85,136,38.46
Zac,Evelynn,114,75,39,65.79
Zac,Vex,117,57,60,48.72
Zac,Milio,129,56,73,43.41
Zac,Trundle,102,43,59,42.16
Zac,Lulu,204,117,87,57.35
Zac,Hecarim,63,29,34,46.03
Zac,Khazix,167,99,68,59.28
Zac,MonkeyKing,104,53,51,50.96
Zac,Graves,93,48,45,51.61
Zac,Corki,50,24,26,48
Zac,Elise,142,85,57,59.86
Zac,Anivia,57,35,22,61.4
Zac,Gwen,162,101,61,62.35
Zac,Jinx,432,236,196,54.63
Zac,Zyra,121,74,47,61.16
Zac,Sivir,115,83,32,72.17
Zac,Nidalee,54,20,34,37.04
Zac,Shaco,155,75,80,48.39
Zac,Shyvana,73,34,39,46.58
Zac,Udyr,79,22,57,27.85
Zac,Ziggs,74,54,20,72.97
Zac,Vayne,227,115,112,50.66
Zac,Leblanc,90,47,43,52.22
Zac,Thresh,295,183,112,62.03
Zac,Gangplank,97,55,42,56.7
Zac,Singed,69,29,40,42.03
Zac,Zeri,72,49,23,68.06
Zac,Sona,74,47,27,63.51
Zac,Viego,318,144,174,45.28
Zac,DrMundo,110,60,50,54.55
Zac,Lillia,193,86,107,44.56
Zac,FiddleSticks,163,81,82,49.69
Zac,Nami,190,71,119,37.37
Zac,Urgot,104,57,47,54.81
Zac,Karma,161,78,83,48.45
Zac,Azir,78,21,57,26.92
Zac,KogMaw,79,29,50,36.71
Zac,Nunu,125,49,76,39.2
Zac,Sylas,148,83,65,56.08
Zac,Janna,87,50,37,57.47
Zac,Taric,98,54,44,55.1
Zac,Amumu,257,127,130,49.42
Zac,KSante,107,71,36,66.36
Zac,Jax,186,44,142,23.66
Zac,Blitzcrank,188,109,79,57.98
Zac,Galio,113,67,46,59.29
Zac,Soraka,131,63,68,48.09
Zac,Nocturne,137,72,65,52.55
Zac,Jayce,103,54,49,52.43
Zac,Smolder,162,69,93,42.59
Zac,Bard,95,61,34,64.21
Zac,Zoe,107,61,46,57.01
Zac,LeeSin,175,104,71,59.43
Zac,Akshan,56,29,27,51.79
Zac,JarvanIV,74,37,37,50
Zac,Quinn,61,25,36,40.98
Zac,Rammus,70,30,40,42.86
Zac,Maokai,84,49,35,58.33
Zac,Renekton,149,59,90,39.6
Zac,Annie,60,48,12,80
Zac,Shen,128,96,32,75
Zac,Kayle,163,54,109,33.13
Zac,Fizz,104,37,67,35.58
Zac,Illaoi,92,60,32,65.22
Zac,Malzahar,136,49,87,36.03
Zac,TwistedFate,78,58,20,74.36
Zac,Hwei,135,56,79,41.48
Zac,Karthus,66,44,22,66.67
Zac,Olaf,54,29,25,53.7
Zac,Talon,103,72,31,69.9
Zac,Aatrox,224,87,137,38.84
Zac,Qiyana,76,44,32,57.89
Zac,Syndra,113,76,37,67.26
Zac,Rakan,94,58,36,61.7
Zac,Taliyah,91,34,57,37.36
Zac,Heimerdinger,116,56,60,48.28
Zac,Sejuani,93,46,47,49.46
Zac,Skarner,93,48,45,51.61
Zac,Ambessa,138,77,61,55.8
Zac,RekSai,35,23,12,65.71
Zac,Zilean,59,31,28,52.54
Zac,Kalista,91,45,46,49.45
Zac,Kennen,63,46,17,73.02
Zac,Kled,58,40,18,68.97
Zac,Ryze,61,40,21,65.57
Zac,Belveth,45,28,17,62.22
Zac,Rumble,18,6,12,33.33
Poppy,Fiora,191,134,57,70.16
Poppy,Pantheon,636,338,298,53.14
Poppy,Katarina,349,214,135,61.32
Poppy,Mel,781,390,391,49.94
Poppy,Viktor,226,111,115,49.12
Poppy,Lillia,244,103,141,42.21
Poppy,Aurora,356,178,178,50
Poppy,Zeri,241,113,128,46.89
Poppy,Rakan,254,94,160,37.01
Poppy,Renekton,172,89,83,51.74
Poppy,JarvanIV,129,55,74,42.64
Poppy,Jhin,645,309,336,47.91
Poppy,Sylas,271,145,126,53.51
Poppy,Warwick,541,267,274,49.35
Poppy,Briar,418,224,194,53.59
Poppy,Yasuo,649,345,304,53.16
Poppy,Irelia,285,148,137,51.93
Poppy,Lux,871,436,435,50.06
Poppy,Jax,358,178,180,49.72
Poppy,Ahri,485,227,258,46.8
Poppy,Rell,158,83,75,52.53
Poppy,Vladimir,307,152,155,49.51
Poppy,Zac,138,56,82,40.58
Poppy,Cassiopeia,168,105,63,62.5
Poppy,Ambessa,272,124,148,45.59
Poppy,Xayah,255,108,147,42.35
Poppy,AurelionSol,181,76,105,41.99
Poppy,Khazix,236,131,105,55.51
Poppy,Nautilus,469,251,218,53.52
Poppy,Darius,622,310,312,49.84
Poppy,Volibear,398,189,209,47.49
Poppy,Caitlyn,867,408,459,47.06
Poppy,TahmKench,417,232,185,55.64
Poppy,Chogath,361,146,215,40.44
Poppy,Talon,259,138,121,53.28
Poppy,Qiyana,92,45,47,48.91
Poppy,Seraphine,341,158,183,46.33
Poppy,FiddleSticks,213,76,137,35.68
Poppy,Singed,97,52,45,53.61
Poppy,Pyke,468,233,235,49.79
Poppy,Sett,611,295,316,48.28
Poppy,Ivern,86,47,39,54.65
Poppy,Neeko,281,156,125,55.52
Poppy,Senna,398,175,223,43.97
Poppy,Elise,161,72,89,44.72
Poppy,Galio,272,128,144,47.06
Poppy,Twitch,284,111,173,39.08
Poppy,Soraka,195,77,118,39.49
Poppy,Belveth,145,90,55,62.07
Poppy,Yone,826,405,421,49.03
Poppy,Mordekaiser,646,333,313,51.55
Poppy,Alistar,146,55,91,37.67
Poppy,Tryndamere,196,105,91,53.57
Poppy,Zyra,251,114,137,45.42
Poppy,Nilah,223,117,106,52.47
Poppy,Sion,275,141,134,51.27
Poppy,Ezreal,635,327,308,51.5
Poppy,Zilean,91,50,41,54.95
Poppy,Aatrox,343,175,168,51.02
Poppy,Gragas,156,82,74,52.56
Poppy,Teemo,404,211,193,52.23
Poppy,Evelynn,189,96,93,50.79
Poppy,Corki,70,34,36,48.57
Poppy,Rammus,147,75,72,51.02
Poppy,LeeSin,459,255,204,55.56
Poppy,Nasus,300,118,182,39.33
Poppy,Kaisa,496,277,219,55.85
Poppy,Bard,118,54,64,45.76
Poppy,Rengar,182,112,70,61.54
Poppy,Vayne,365,159,206,43.56
Poppy,Blitzcrank,197,125,72,63.45
Poppy,KSante,164,90,74,54.88
Poppy,Azir,165,99,66,60
Poppy,Zed,337,184,153,54.6
Poppy,Malzahar,293,168,125,57.34
Poppy,Nidalee,111,56,55,50.45
Poppy,Vex,220,106,114,48.18
Poppy,Sivir,171,65,106,38.01
Poppy,Karma,256,120,136,46.88
Poppy,Gangplank,138,95,43,68.84
Poppy,Lulu,296,154,142,52.03
Poppy,Ashe,601,318,283,52.91
Poppy,MasterYi,302,155,147,51.32
Poppy,Diana,513,296,217,57.7
Poppy,Varus,300,165,135,55
Poppy,Rumble,115,60,55,52.17
Poppy,Samira,379,184,195,48.55
Poppy,Kayn,531,293,238,55.18
Poppy,Hwei,239,146,93,61.09
Poppy,Draven,179,86,93,48.04
Poppy,Gnar,133,68,65,51.13
Poppy,Nocturne,300,148,152,49.33
Poppy,Trundle,223,94,129,42.15
Poppy,XinZhao,161,66,95,40.99
Poppy,Tristana,264,158,106,59.85
Poppy,Orianna,144,58,86,40.28
Poppy,Milio,209,91,118,43.54
Poppy,Illaoi,156,85,71,54.49
Poppy,Morgana,468,232,236,49.57
Poppy,Urgot,156,59,97,37.82
Poppy,Xerath,249,86,163,34.54
Poppy,Veigar,345,166,179,48.12
Poppy,Ekko,284,166,118,58.45
Poppy,Heimerdinger,142,50,92,35.21
Poppy,Kalista,194,96,98,49.48
Poppy,Thresh,546,285,261,52.2
Poppy,Akshan,186,78,108,41.94
Poppy,Nami,260,106,154,40.77
Poppy,Aphelios,218,103,115,47.25
Poppy,Lissandra,76,35,41,46.05
Poppy,Riven,185,126,59,68.11
Poppy,Yuumi,360,199,161,55.28
Poppy,MonkeyKing,162,90,72,55.56
Poppy,MissFortune,701,380,321,54.21
Poppy,Amumu,298,109,189,36.58
Poppy,Nunu,323,184,139,56.97
Poppy,Vi,352,177,175,50.28
Poppy,Velkoz,214,131,83,61.21
Poppy,RekSai,64,38,26,59.38
Poppy,Ziggs,77,36,41,46.75
Poppy,Shen,287,132,155,45.99
Poppy,Brand,223,118,105,52.91
Poppy,Graves,188,99,89,52.66
Poppy,Ornn,116,43,73,37.07
Poppy,TwistedFate,163,90,73,55.21
Poppy,Jinx,695,362,333,52.09
Poppy,Swain,349,168,181,48.14
Poppy,Annie,108,46,62,42.59
Poppy,Leona,351,194,157,55.27
Poppy,Shyvana,109,31,78,28.44
Poppy,Maokai,154,71,83,46.1
Poppy,Kled,75,39,36,52
Poppy,Shaco,382,185,197,48.43
Poppy,Yorick,274,119,155,43.43
Poppy,Kindred,203,118,85,58.13
Poppy,DrMundo,262,104,158,39.69
Poppy,Udyr,134,76,58,56.72
Poppy,Malphite,279,129,150,46.24
Poppy,Kassadin,43,15,28,34.88
Poppy,Garen,402,233,169,57.96
Poppy,Taric,118,56,62,47.46
Poppy,Camille,144,80,64,55.56
Poppy,Naafiri,132,77,55,58.33
Poppy,Syndra,209,87,122,41.63
Poppy,Lucian,220,143,77,65
Poppy,Viego,351,143,208,40.74
Poppy,Akali,324,186,138,57.41
Poppy,Kennen,121,49,72,40.5
Poppy,Zoe,168,93,75,55.36
Poppy,Kayle,263,176,87,66.92
Poppy,Leblanc,116,61,55,52.59
Poppy,Renata,101,38,63,37.62
Poppy,Quinn,146,95,51,65.07
Poppy,Taliyah,77,39,38,50.65
Poppy,Sona,140,53,87,37.86
Poppy,Braum,133,60,73,45.11
Poppy,Hecarim,115,87,28,75.65
Poppy,Sejuani,118,46,72,38.98
Poppy,Anivia,156,96,60,61.54
Poppy,KogMaw,125,56,69,44.8
Poppy,Skarner,76,37,39,48.68
Poppy,Janna,128,55,73,42.97
Poppy,Jayce,149,90,59,60.4
Poppy,Smolder,249,112,137,44.98
Poppy,Ryze,93,37,56,39.78
Poppy,Fizz,176,85,91,48.3
Poppy,Olaf,72,30,42,41.67
Poppy,Karthus,52,34,18,65.38
Poppy,Gwen,242,170,72,70.25
Twitch,Fiora,338,194,144,57.4
Twitch,Pantheon,786,323,463,41.09
Twitch,Katarina,365,215,150,58.9
Twitch,Mel,1087,581,506,53.45
Twitch,Viktor,336,156,180,46.43
Twitch,Kayle,343,149,194,43.44
Twitch,Sylas,398,200,198,50.25
Twitch,Qiyana,156,85,71,54.49
Twitch,Caitlyn,1060,543,517,51.23
Twitch,Renata,136,50,86,36.76
Twitch,Samira,414,204,210,49.28
Twitch,Kayn,794,462,332,58.19
Twitch,Nilah,333,164,169,49.25
Twitch,Leona,391,198,193,50.64
Twitch,Riven,237,143,94,60.34
Twitch,Amumu,481,209,272,43.45
Twitch,Zoe,238,140,98,58.82
Twitch,MissFortune,1222,575,647,47.05
Twitch,Sona,178,83,95,46.63
Twitch,Jax,480,218,262,45.42
Twitch,Briar,519,275,244,52.99
Twitch,Ahri,649,328,321,50.54
Twitch,Zeri,252,141,111,55.95
Twitch,Rell,218,101,117,46.33
Twitch,Nasus,401,194,207,48.38
Twitch,MonkeyKing,264,153,111,57.95
Twitch,Xayah,331,136,195,41.09
Twitch,Zac,122,31,91,25.41
Twitch,Jayce,211,90,121,42.65
Twitch,Rengar,226,136,90,60.18
Twitch,Swain,510,266,244,52.16
Twitch,Ezreal,763,417,346,54.65
Twitch,Neeko,308,168,140,54.55
Twitch,Morgana,692,340,352,49.13
Twitch,Tryndamere,296,131,165,44.26
Twitch,Graves,254,152,102,59.84
Twitch,Gnar,219,124,95,56.62
Twitch,Nunu,397,200,197,50.38
Twitch,Lucian,340,167,173,49.12
Twitch,Jhin,1071,572,499,53.41
Twitch,Lux,1430,733,697,51.26
Twitch,Ornn,193,92,101,47.67
Twitch,Warwick,806,405,401,50.25
Twitch,TwistedFate,186,112,74,60.22
Twitch,Gangplank,209,112,97,53.59
Twitch,Taliyah,100,81,19,81
Twitch,Sivir,209,142,67,67.94
Twitch,Soraka,327,173,154,52.91
Twitch,Yorick,516,237,279,45.93
Twitch,Volibear,573,243,330,42.41
Twitch,Cassiopeia,172,67,105,38.95
Twitch,Gwen,368,199,169,54.08
Twitch,Tristana,435,226,209,51.95
Twitch,Poppy,284,173,111,60.92
Twitch,Draven,276,121,155,43.84
Twitch,KogMaw,216,107,109,49.54
Twitch,Yuumi,475,225,250,47.37
Twitch,Khazix,370,198,172,53.51
Twitch,Yasuo,989,523,466,52.88
Twitch,Seraphine,594,316,278,53.2
Twitch,Vi,351,134,217,38.18
Twitch,Nocturne,461,207,254,44.9
Twitch,Corki,181,79,102,43.65
Twitch,Shaco,487,244,243,50.1
Twitch,Naafiri,247,148,99,59.92
Twitch,Xerath,394,224,170,56.85
Twitch,Rammus,166,86,80,51.81
Twitch,Nami,408,239,169,58.58
Twitch,Irelia,412,203,209,49.27
Twitch,Malphite,351,168,183,47.86
Twitch,Vladimir,300,128,172,42.67
Twitch,Senna,476,245,231,51.47
Twitch,Aatrox,473,240,233,50.74
Twitch,Trundle,339,175,164,51.62
Twitch,Sett,800,349,451,43.63
Twitch,Jinx,1100,561,539,51
Twitch,Karma,344,202,142,58.72
Twitch,Darius,756,382,374,50.53
Twitch,Ekko,524,249,275,47.52
Twitch,Teemo,647,303,344,46.83
Twitch,Shyvana,139,75,64,53.96
Twitch,Galio,293,144,149,49.15
Twitch,Thresh,684,313,371,45.76
Twitch,Viego,529,267,262,50.47
Twitch,Kalista,281,121,160,43.06
Twitch,FiddleSticks,250,148,102,59.2
Twitch,Diana,692,372,320,53.76
Twitch,Yone,919,481,438,52.34
Twitch,Maokai,189,92,97,48.68
Twitch,Zed,470,233,237,49.57
Twitch,Rumble,76,35,41,46.05
Twitch,Nautilus,500,237,263,47.4
Twitch,Garen,677,370,307,54.65
Twitch,Fizz,224,96,128,42.86
Twitch,Kaisa,684,398,286,58.19
Twitch,Ryze,161,46,115,28.57
Twitch,Janna,138,81,57,58.7
Twitch,Heimerdinger,304,163,141,53.62
Twitch,Kindred,215,132,83,61.4
Twitch,TahmKench,498,242,256,48.59
Twitch,Pyke,523,278,245,53.15
Twitch,Shen,359,164,195,45.68
Twitch,Veigar,569,244,325,42.88
Twitch,Blitzcrank,341,151,190,44.28
Twitch,Elise,297,157,140,52.86
Twitch,Chogath,680,275,405,40.44
Twitch,Mordekaiser,783,394,389,50.32
Twitch,Lillia,303,160,143,52.81
Twitch,Singed,138,62,76,44.93
Twitch,Bard,166,75,91,45.18
Twitch,MasterYi,541,243,298,44.92
Twitch,Akali,498,301,197,60.44
Twitch,LeeSin,448,228,220,50.89
Twitch,Varus,414,202,212,48.79
Twitch,Rakan,254,104,150,40.94
Twitch,Ambessa,271,145,126,53.51
Twitch,Akshan,253,100,153,39.53
Twitch,Zyra,243,114,129,46.91
Twitch,Vayne,500,224,276,44.8
Twitch,Azir,128,64,64,50
Twitch,Ashe,1016,561,455,55.22
Twitch,Gragas,283,162,121,57.24
Twitch,AurelionSol,227,115,112,50.66
Twitch,Taric,69,34,35,49.28
Twitch,Evelynn,310,177,133,57.1
Twitch,Vex,269,149,120,55.39
Twitch,Brand,338,176,162,52.07
Twitch,Aphelios,383,169,214,44.13
Twitch,Camille,198,122,76,61.62
Twitch,Illaoi,217,109,108,50.23
Twitch,Hwei,359,200,159,55.71
Twitch,KSante,142,84,58,59.15
Twitch,Kassadin,137,61,76,44.53
Twitch,Udyr,206,148,58,71.84
Twitch,Malzahar,323,141,182,43.65
Twitch,Leblanc,210,109,101,51.9
Twitch,Sejuani,199,88,111,44.22
Twitch,Lulu,377,222,155,58.89
Twitch,JarvanIV,142,64,78,45.07
Twitch,Renekton,229,108,121,47.16
Twitch,Syndra,219,79,140,36.07
Twitch,Alistar,106,50,56,47.17
Twitch,Lissandra,165,58,107,35.15
Twitch,Aurora,585,340,245,58.12
Twitch,Urgot,177,70,107,39.55
Twitch,Braum,299,142,157,47.49
Twitch,Quinn,200,92,108,46
Twitch,Skarner,139,69,70,49.64
Twitch,Smolder,408,228,180,55.88
Twitch,DrMundo,327,137,190,41.9
Twitch,Sion,479,268,211,55.95
Twitch,Hecarim,184,127,57,69.02
Twitch,Ziggs,198,119,79,60.1
Twitch,Kennen,165,92,73,55.76
Twitch,Orianna,216,132,84,61.11
Twitch,XinZhao,251,144,107,57.37
Twitch,Talon,370,209,161,56.49
Twitch,Annie,71,40,31,56.34
Twitch,Velkoz,347,184,163,53.03
Twitch,Milio,288,139,149,48.26
Twitch,Ivern,94,49,45,52.13
Twitch,Zilean,155,81,74,52.26
Twitch,Olaf,112,66,46,58.93
Twitch,Kled,109,70,39,64.22
Twitch,Karthus,105,66,39,62.86
Twitch,Nidalee,91,54,37,59.34
Twitch,Anivia,114,65,49,57.02
Twitch,Belveth,133,52,81,39.1
Twitch,RekSai,81,33,48,40.74
Fiora,Darius,600,258,342,43
Fiora,Zac,110,56,54,50.91
Fiora,Hwei,231,150,81,64.94
Fiora,Poppy,191,57,134,29.84
Fiora,Twitch,338,144,194,42.6
Fiora,Mordekaiser,540,232,308,42.96
Fiora,Kindred,186,69,117,37.1
Fiora,Qiyana,99,57,42,57.58
Fiora,Ashe,481,244,237,50.73
Fiora,Sona,92,46,46,50
Fiora,Leblanc,68,36,32,52.94
Fiora,Briar,364,145,219,39.84
Fiora,Zoe,128,67,61,52.34
Fiora,Jinx,616,298,318,48.38
Fiora,Nasus,259,120,139,46.33
Fiora,Shaco,258,126,132,48.84
Fiora,Zed,261,138,123,52.87
Fiora,Varus,195,68,127,34.87
Fiora,Neeko,212,106,106,50
Fiora,Udyr,138,79,59,57.25
Fiora,Yorick,225,100,125,44.44
Fiora,Sivir,168,82,86,48.81
Fiora,Nautilus,422,195,227,46.21
Fiora,Gangplank,128,83,45,64.84
Fiora,Karthus,51,38,13,74.51
Fiora,Aurora,322,140,182,43.48
Fiora,Ezreal,434,197,237,45.39
Fiora,Senna,211,83,128,39.34
Fiora,Viego,397,207,190,52.14
Fiora,AurelionSol,132,54,78,40.91
Fiora,MissFortune,616,290,326,47.08
Fiora,Malphite,200,77,123,38.5
Fiora,Sett,482,209,273,43.36
Fiora,Sion,241,95,146,39.42
Fiora,Samira,322,143,179,44.41
Fiora,Alistar,98,46,52,46.94
Fiora,Viktor,219,112,107,51.14
Fiora,Nocturne,224,64,160,28.57
Fiora,Yasuo,634,261,373,41.17
Fiora,Nilah,155,65,90,41.94
Fiora,Bard,64,32,32,50
Fiora,Jax,238,142,96,59.66
Fiora,Diana,414,183,231,44.2
Fiora,Ahri,391,157,234,40.15
Fiora,Aphelios,206,104,102,50.49
Fiora,Aatrox,304,154,150,50.66
Fiora,Draven,156,78,78,50
Fiora,Talon,178,71,107,39.89
Fiora,Lissandra,87,41,46,47.13
Fiora,Vayne,274,141,133,51.46
Fiora,Milio,185,90,95,48.65
Fiora,Chogath,430,203,227,47.21
Fiora,Galio,263,91,172,34.6
Fiora,Soraka,141,54,87,38.3
Fiora,Mel,619,294,325,47.5
Fiora,Velkoz,217,118,99,54.38
Fiora,Kayle,198,86,112,43.43
Fiora,Sylas,245,105,140,42.86
Fiora,Lucian,149,86,63,57.72
Fiora,Nami,288,151,137,52.43
Fiora,MasterYi,318,137,181,43.08
Fiora,Yuumi,243,101,142,41.56
Fiora,Kayn,445,207,238,46.52
Fiora,Warwick,408,173,235,42.4
Fiora,Ziggs,119,55,64,46.22
Fiora,Malzahar,213,85,128,39.91
Fiora,Braum,143,79,64,55.24
Fiora,XinZhao,215,107,108,49.77
Fiora,Lux,811,382,429,47.1
Fiora,Vi,231,79,152,34.2
Fiora,Zilean,75,43,32,57.33
Fiora,LeeSin,249,116,133,46.59
Fiora,Akali,279,157,122,56.27
Fiora,Shyvana,75,49,26,65.33
Fiora,Garen,369,123,246,33.33
Fiora,Veigar,353,139,214,39.38
Fiora,Zyra,149,57,92,38.26
Fiora,KSante,143,87,56,60.84
Fiora,Olaf,26,21,5,80.77
Fiora,Yone,586,297,289,50.68
Fiora,Morgana,430,220,210,51.16
Fiora,Tristana,266,81,185,30.45
Fiora,Lulu,200,98,102,49
Fiora,Janna,105,37,68,35.24
Fiora,Caitlyn,612,264,348,43.14
Fiora,Ivern,44,17,27,38.64
Fiora,Tryndamere,170,45,125,26.47
Fiora,Ekko,255,88,167,34.51
Fiora,Thresh,321,131,190,40.81
Fiora,Camille,90,59,31,65.56
Fiora,Lillia,167,100,67,59.88
Fiora,Xerath,219,110,109,50.23
Fiora,Pyke,311,172,139,55.31
Fiora,Evelynn,155,91,64,58.71
Fiora,Riven,165,87,78,52.73
Fiora,Katarina,250,73,177,29.2
Fiora,Xayah,164,65,99,39.63
Fiora,Illaoi,130,68,62,52.31
Fiora,Rell,144,60,84,41.67
Fiora,Volibear,295,135,160,45.76
Fiora,Taliyah,60,24,36,40
Fiora,Pantheon,467,250,217,53.53
Fiora,Annie,76,44,32,57.89
Fiora,Swain,312,158,154,50.64
Fiora,Orianna,116,68,48,58.62
Fiora,Seraphine,333,170,163,51.05
Fiora,Teemo,286,129,157,45.1
Fiora,Vex,145,81,64,55.86
Fiora,Naafiri,108,34,74,31.48
Fiora,Gragas,195,114,81,58.46
Fiora,Maokai,97,52,45,53.61
Fiora,TahmKench,359,186,173,51.81
Fiora,Renekton,82,35,47,42.68
Fiora,Nunu,269,98,171,36.43
Fiora,Zeri,106,39,67,36.79
Fiora,Shen,203,111,92,54.68
Fiora,Jhin,407,207,200,50.86
Fiora,Kaisa,363,151,212,41.6
Fiora,Ornn,212,90,122,42.45
Fiora,Elise,184,90,94,48.91
Fiora,Leona,156,51,105,32.69
Fiora,Ambessa,172,82,90,47.67
Fiora,Karma,218,89,129,40.83
Fiora,Vladimir,176,99,77,56.25
Fiora,Amumu,267,151,116,56.55
Fiora,Smolder,168,77,91,45.83
Fiora,Blitzcrank,229,116,113,50.66
Fiora,MonkeyKing,141,83,58,58.87
Fiora,Gwen,256,114,142,44.53
Fiora,Cassiopeia,108,63,45,58.33
Fiora,Rakan,122,34,88,27.87
Fiora,Azir,74,44,30,59.46
Fiora,Kalista,128,70,58,54.69
Fiora,Urgot,101,34,67,33.66
Fiora,Corki,102,56,46,54.9
Fiora,Brand,198,73,125,36.87
Fiora,Irelia,263,146,117,55.51
Fiora,Graves,111,59,52,53.15
Fiora,Ryze,106,32,74,30.19
Fiora,Gnar,72,26,46,36.11
Fiora,Renata,80,23,57,28.75
Fiora,Trundle,115,34,81,29.57
Fiora,FiddleSticks,132,75,57,56.82
Fiora,DrMundo,174,47,127,27.01
Fiora,Akshan,131,55,76,41.98
Fiora,Quinn,97,43,54,44.33
Fiora,Heimerdinger,161,79,82,49.07
Fiora,Sejuani,85,42,43,49.41
Fiora,Hecarim,114,50,64,43.86
Fiora,Jayce,89,52,37,58.43
Fiora,Singed,63,29,34,46.03
Fiora,Syndra,127,82,45,64.57
Fiora,Fizz,102,48,54,47.06
Fiora,Khazix,210,126,84,60
Fiora,Rengar,147,85,62,57.82
Fiora,Rammus,85,45,40,52.94
Fiora,Anivia,51,25,26,49.02
Fiora,Rumble,31,14,17,45.16
Fiora,Belveth,121,51,70,42.15
Fiora,Kassadin,55,21,34,38.18
Fiora,TwistedFate,103,27,76,26.21
Fiora,Kennen,81,37,44,45.68
Fiora,KogMaw,129,67,62,51.94
Fiora,Skarner,77,44,33,57.14
Fiora,JarvanIV,82,33,49,40.24
Fiora,Kled,71,28,43,39.44
Fiora,Nidalee,43,31,12,72.09
Fiora,Taric,44,13,31,29.55
Fiora,RekSai,14,6,8,42.86
Katarina,Darius,937,469,468,50.05
Katarina,Zac,188,79,109,42.02
Katarina,Hwei,404,173,231,42.82
Katarina,Poppy,349,135,214,38.68
Katarina,Twitch,365,150,215,41.1
Katarina,Yone,1000,437,563,43.7
Katarina,Shaco,558,279,279,50
Katarina,Mel,1223,560,663,45.79
Katarina,Tristana,476,176,300,36.97
Katarina,Pyke,536,264,272,49.25
Katarina,Singed,165,71,94,43.03
Katarina,Graves,265,138,127,52.08
Katarina,Fizz,313,120,193,38.34
Katarina,Ziggs,228,99,129,43.42
Katarina,Pantheon,934,491,443,52.57
Katarina,Jax,379,176,203,46.44
Katarina,Briar,569,261,308,45.87
Katarina,Ahri,802,354,448,44.14
Katarina,Zeri,208,130,78,62.5
Katarina,Rell,292,126,166,43.15
Katarina,Aatrox,506,256,250,50.59
Katarina,Gwen,413,213,200,51.57
Katarina,Syndra,298,159,139,53.36
Katarina,Ashe,880,363,517,41.25
Katarina,Lulu,380,161,219,42.37
Katarina,Mordekaiser,781,317,464,40.59
Katarina,Zed,479,216,263,45.09
Katarina,Jinx,981,428,553,43.63
Katarina,Lillia,311,138,173,44.37
Katarina,Samira,539,255,284,47.31
Katarina,Karma,395,173,222,43.8
Katarina,Rammus,183,73,110,39.89
Katarina,Blitzcrank,426,177,249,41.55
Katarina,Kayn,852,336,516,39.44
Katarina,Thresh,654,304,350,46.48
Katarina,Ezreal,790,439,351,55.57
Katarina,Yuumi,536,253,283,47.2
Katarina,Yorick,523,208,315,39.77
Katarina,Nunu,396,145,251,36.62
Katarina,Draven,290,138,152,47.59
Katarina,KogMaw,175,74,101,42.29
Katarina,Illaoi,207,84,123,40.58
Katarina,Khazix,405,191,214,47.16
Katarina,Kaisa,727,404,323,55.57
Katarina,Lux,1363,610,753,44.75
Katarina,Malphite,358,167,191,46.65
Katarina,Udyr,256,113,143,44.14
Katarina,Jhin,974,454,520,46.61
Katarina,Evelynn,286,129,157,45.1
Katarina,XinZhao,310,141,169,45.48
Katarina,Akali,614,273,341,44.46
Katarina,Caitlyn,1268,536,732,42.27
Katarina,Maokai,274,135,139,49.27
Katarina,Yasuo,1048,456,592,43.51
Katarina,Naafiri,198,85,113,42.93
Katarina,Leblanc,182,82,100,45.05
Katarina,MissFortune,1222,442,780,36.17
Katarina,Nami,378,163,215,43.12
Katarina,Gangplank,259,98,161,37.84
Katarina,Nocturne,359,159,200,44.29
Katarina,Corki,215,119,96,55.35
Katarina,Ambessa,282,116,166,41.13
Katarina,Qiyana,198,84,114,42.42
Katarina,LeeSin,531,279,252,52.54
Katarina,Nasus,480,140,340,29.17
Katarina,Zoe,277,152,125,54.87
Katarina,Senna,448,180,268,40.18
Katarina,Shen,334,125,209,37.43
Katarina,Amumu,424,170,254,40.09
Katarina,Leona,363,135,228,37.19
Katarina,Warwick,757,276,481,36.46
Katarina,Malzahar,381,119,262,31.23
Katarina,Soraka,312,172,140,55.13
Katarina,Heimerdinger,294,127,167,43.2
Katarina,Viktor,397,146,251,36.78
Katarina,Morgana,707,316,391,44.7
Katarina,Vayne,457,231,226,50.55
Katarina,Aurora,469,227,242,48.4
Katarina,Nilah,286,171,115,59.79
Katarina,Cassiopeia,167,88,79,52.69
Katarina,Swain,535,226,309,42.24
Katarina,Camille,163,82,81,50.31
Katarina,Hecarim,235,118,117,50.21
Katarina,TwistedFate,169,85,84,50.3
Katarina,Nautilus,532,229,303,43.05
Katarina,Sejuani,231,94,137,40.69
Katarina,Veigar,681,278,403,40.82
Katarina,Garen,744,306,438,41.13
Katarina,MasterYi,548,259,289,47.26
Katarina,Sion,392,173,219,44.13
Katarina,Lucian,294,154,140,52.38
Katarina,Karthus,91,43,48,47.25
Katarina,TahmKench,497,197,300,39.64
Katarina,Renekton,243,114,129,46.91
Katarina,KSante,220,132,88,60
Katarina,Belveth,130,60,70,46.15
Katarina,Riven,217,96,121,44.24
Katarina,Rumble,96,38,58,39.58
Katarina,Akshan,185,86,99,46.49
Katarina,Sona,218,109,109,50
Katarina,Ornn,164,84,80,51.22
Katarina,Skarner,208,108,100,51.92
Katarina,Ekko,392,146,246,37.24
Katarina,Diana,702,339,363,48.29
Katarina,AurelionSol,178,80,98,44.94
Katarina,Neeko,368,148,220,40.22
Katarina,Vi,382,147,235,38.48
Katarina,Vladimir,299,165,134,55.18
Katarina,Anivia,157,68,89,43.31
Katarina,Seraphine,556,250,306,44.96
Katarina,Gragas,283,117,166,41.34
Katarina,Urgot,245,118,127,48.16
Katarina,Kindred,251,114,137,45.42
Katarina,Fiora,250,177,73,70.8
Katarina,Annie,209,104,105,49.76
Katarina,Bard,178,96,82,53.93
Katarina,Kennen,183,90,93,49.18
Katarina,Rengar,249,145,104,58.23
Katarina,Ivern,101,40,61,39.6
Katarina,Olaf,120,52,68,43.33
Katarina,Irelia,561,239,322,42.6
Katarina,Ryze,163,95,68,58.28
Katarina,Xerath,387,195,192,50.39
Katarina,Orianna,201,120,81,59.7
Katarina,Kled,120,63,57,52.5
Katarina,Galio,399,153,246,38.35
Katarina,Brand,337,178,159,52.82
Katarina,Kayle,448,167,281,37.28
Katarina,Smolder,466,189,277,40.56
Katarina,Janna,150,78,72,52
Katarina,MonkeyKing,356,155,201,43.54
Katarina,Trundle,306,103,203,33.66
Katarina,Kalista,238,119,119,50
Katarina,Velkoz,295,130,165,44.07
Katarina,Vex,291,77,214,26.46
Katarina,Milio,377,157,220,41.64
Katarina,Viego,677,335,342,49.48
Katarina,Chogath,577,237,340,41.07
Katarina,Alistar,162,97,65,59.88
Katarina,Nidalee,129,66,63,51.16
Katarina,JarvanIV,184,70,114,38.04
Katarina,Sylas,466,225,241,48.28
Katarina,Sett,1019,444,575,43.57
Katarina,Xayah,367,174,193,47.41
Katarina,Sivir,204,79,125,38.73
Katarina,Volibear,599,267,332,44.57
Katarina,Gnar,237,131,106,55.27
Katarina,Jayce,189,74,115,39.15
Katarina,FiddleSticks,189,125,64,66.14
Katarina,Azir,250,106,144,42.4
Katarina,Rakan,278,120,158,43.17
Katarina,Teemo,684,325,359,47.51
Katarina,Lissandra,119,45,74,37.82
Katarina,Taliyah,139,90,49,64.75
Katarina,Zyra,392,115,277,29.34
Katarina,Kassadin,117,45,72,38.46
Katarina,DrMundo,321,105,216,32.71
Katarina,Elise,376,162,214,43.09
Katarina,Renata,111,65,46,58.56
Katarina,Aphelios,309,156,153,50.49
Katarina,Braum,211,114,97,54.03
Katarina,Zilean,92,50,42,54.35
Katarina,Tryndamere,206,120,86,58.25
Katarina,Talon,308,147,161,47.73
Katarina,Varus,435,158,277,36.32
Katarina,Quinn,220,132,88,60
Katarina,Taric,104,57,47,54.81
Katarina,Shyvana,166,45,121,27.11
Katarina,RekSai,51,20,31,39.22
Mel,Darius,2335,1174,1161,50.28
Mel,Zac,489,259,230,52.97
Mel,Hwei,981,482,499,49.13
Mel,Poppy,781,391,390,50.06
Mel,Twitch,1087,506,581,46.55
Mel,Renekton,751,375,376,49.93
Mel,Kayn,2044,958,1086,46.87
Mel,Katarina,1223,663,560,54.21
Mel,Draven,782,323,459,41.3
Mel,Yuumi,1362,620,742,45.52
Mel,Aurora,1188,619,569,52.1
Mel,Volibear,1494,642,852,42.97
Mel,Yasuo,2662,1219,1443,45.79
Mel,Vayne,1355,683,672,50.41
Mel,Shaco,1212,628,584,51.82
Mel,Talon,761,383,378,50.33
Mel,Tristana,1063,529,534,49.76
Mel,Alistar,448,231,217,51.56
Mel,Yorick,1320,614,706,46.52
Mel,FiddleSticks,684,375,309,54.82
Mel,Smolder,984,493,491,50.1
Mel,Nautilus,1395,717,678,51.4
Mel,Illaoi,567,239,328,42.15
Mel,MonkeyKing,668,379,289,56.74
Mel,Yone,2532,1217,1315,48.06
Mel,Morgana,1620,802,818,49.51
Mel,Gangplank,488,289,199,59.22
Mel,Warwick,2075,967,1108,46.6
Mel,Akali,1410,692,718,49.08
Mel,Caitlyn,2976,1491,1485,50.1
Mel,Sona,585,275,310,47.01
Mel,Riven,679,384,295,56.55
Mel,Ahri,1743,911,832,52.27
Mel,Jinx,2635,1315,1320,49.91
Mel,Nasus,989,475,514,48.03
Mel,Zed,1318,698,620,52.96
Mel,Varus,1083,469,614,43.31
Mel,Neeko,1022,582,440,56.95
Mel,Swain,1404,633,771,45.09
Mel,Malzahar,995,459,536,46.13
Mel,Irelia,1158,617,541,53.28
Mel,Kalista,703,430,273,61.17
Mel,Gwen,813,399,414,49.08
Mel,Skarner,430,212,218,49.3
Mel,Kaisa,1798,985,813,54.78
Mel,Seraphine,1305,632,673,48.43
Mel,Briar,1374,636,738,46.29
Mel,Vex,556,283,273,50.9
Mel,Milio,852,387,465,45.42
Mel,Mordekaiser,2087,1010,1077,48.39
Mel,Jhin,2376,1107,1269,46.59
Mel,Velkoz,875,388,487,44.34
Mel,Garen,1917,945,972,49.3
Mel,Zilean,422,252,170,59.72
Mel,Teemo,1651,770,881,46.64
Mel,Leona,1099,443,656,40.31
Mel,Sylas,1205,512,693,42.49
Mel,Kindred,693,373,320,53.82
Mel,Rell,700,376,324,53.71
Mel,Gnar,598,328,270,54.85
Mel,Leblanc,615,339,276,55.12
Mel,Karma,972,449,523,46.19
Mel,Lillia,870,397,473,45.63
Mel,Vladimir,715,283,432,39.58
Mel,Lulu,974,489,485,50.21
Mel,Veigar,1282,656,626,51.17
Mel,Kennen,436,255,181,58.49
Mel,Naafiri,582,299,283,51.37
Mel,Xayah,888,467,421,52.59
Mel,Soraka,852,427,425,50.12
Mel,Gragas,716,364,352,50.84
Mel,XinZhao,709,322,387,45.42
Mel,Lucian,789,424,365,53.74
Mel,Aatrox,1269,621,648,48.94
Mel,Viego,1560,778,782,49.87
Mel,Ashe,2147,1057,1090,49.23
Mel,Blitzcrank,920,532,388,57.83
Mel,Cassiopeia,579,271,308,46.8
Mel,Sett,2002,957,1045,47.8
Mel,Elise,748,408,340,54.55
Mel,Galio,1065,484,581,45.45
Mel,KSante,506,259,247,51.19
Mel,Senna,1198,585,613,48.83
Mel,Thresh,1697,812,885,47.85
Mel,Viktor,950,455,495,47.89
Mel,Pyke,1601,831,770,51.91
Mel,Nilah,830,353,477,42.53
Mel,Malphite,882,457,425,51.81
Mel,Diana,1735,864,871,49.8
Mel,Lux,3431,1797,1634,52.38
Mel,Orianna,801,412,389,51.44
Mel,Udyr,479,209,270,43.63
Mel,Sion,1063,463,600,43.56
Mel,AurelionSol,760,388,372,51.05
Mel,Samira,1221,649,572,53.15
Mel,Jax,1043,443,600,42.47
Mel,Rakan,708,367,341,51.84
Mel,Ekko,907,470,437,51.82
Mel,Fizz,821,425,396,51.77
Mel,Fiora,619,325,294,52.5
Mel,Ziggs,605,253,352,41.82
Mel,LeeSin,1269,623,646,49.09
Mel,Chogath,1881,917,964,48.75
Mel,Ezreal,2138,1041,1097,48.69
Mel,RekSai,168,102,66,60.71
Mel,Evelynn,667,395,272,59.22
Mel,Anivia,356,158,198,44.38
Mel,Olaf,275,124,151,45.09
Mel,MissFortune,2667,1263,1404,47.36
Mel,Pantheon,2114,938,1176,44.37
Mel,KogMaw,365,222,143,60.82
Mel,Urgot,606,297,309,49.01
Mel,Amumu,1186,542,644,45.7
Mel,Annie,362,189,173,52.21
Mel,Ivern,251,145,106,57.77
Mel,Rumble,231,104,127,45.02
Mel,Zoe,515,310,205,60.19
Mel,Renata,312,157,155,50.32
Mel,Qiyana,573,277,296,48.34
Mel,MasterYi,1360,633,727,46.54
Mel,TahmKench,1451,721,730,49.69
Mel,Trundle,797,382,415,47.93
Mel,Singed,371,161,210,43.4
Mel,Quinn,455,216,239,47.47
Mel,Jayce,578,327,251,56.57
Mel,Zyra,736,333,403,45.24
Mel,Nami,1279,670,609,52.38
Mel,Kayle,1041,471,570,45.24
Mel,Rengar,569,365,204,64.15
Mel,Janna,377,165,212,43.77
Mel,Nocturne,1113,538,575,48.34
Mel,Hecarim,476,200,276,42.02
Mel,Kassadin,333,122,211,36.64
Mel,JarvanIV,500,224,276,44.8
Mel,DrMundo,796,325,471,40.83
Mel,Heimerdinger,695,275,420,39.57
Mel,Ryze,483,293,190,60.66
Mel,Braum,578,287,291,49.65
Mel,Shen,776,405,371,52.19
Mel,Aphelios,971,429,542,44.18
Mel,Bard,454,208,246,45.81
Mel,Sivir,654,271,383,41.44
Mel,Sejuani,411,209,202,50.85
Mel,Ornn,546,236,310,43.22
Mel,Ambessa,828,403,425,48.67
Mel,Shyvana,345,148,197,42.9
Mel,Akshan,492,239,253,48.58
Mel,Vi,1078,560,518,51.95
Mel,Xerath,1082,469,613,43.35
Mel,Syndra,706,342,364,48.44
Mel,TwistedFate,438,232,206,52.97
Mel,Lissandra,379,197,182,51.98
Mel,Brand,834,403,431,48.32
Mel,Khazix,764,406,358,53.14
Mel,Camille,468,234,234,50
Mel,Nunu,945,438,507,46.35
Mel,Maokai,615,269,346,43.74
Mel,Kled,300,126,174,42
Mel,Zeri,624,325,299,52.08
Mel,Tryndamere,693,333,360,48.05
Mel,Azir,541,244,297,45.1
Mel,Rammus,326,184,142,56.44
Mel,Corki,436,262,174,60.09
Mel,Karthus,349,164,185,46.99
Mel,Graves,646,330,316,51.08
Mel,Taric,249,126,123,50.6
Mel,Nidalee,420,231,189,55
Mel,Taliyah,394,193,201,48.98
Mel,Belveth,348,135,213,38.79
Viktor,Darius,720,333,387,46.25
Viktor,Zac,150,74,76,49.33
Viktor,Hwei,403,224,179,55.58
Viktor,Poppy,226,115,111,50.88
Viktor,Twitch,336,180,156,53.57
Viktor,Gangplank,152,57,95,37.5
Viktor,Gragas,304,162,142,53.29
Viktor,TwistedFate,162,87,75,53.7
Viktor,Lucian,252,112,140,44.44
Viktor,Leona,296,142,154,47.97
Viktor,Tryndamere,200,99,101,49.5
Viktor,Amumu,421,179,242,42.52
Viktor,Mel,950,495,455,52.11
Viktor,Kaisa,593,310,283,52.28
Viktor,Seraphine,411,205,206,49.88
Viktor,Fiora,219,107,112,48.86
Viktor,LeeSin,384,232,152,60.42
Viktor,Ziggs,158,67,91,42.41
Viktor,Jinx,768,405,363,52.73
Viktor,Senna,359,167,192,46.52
Viktor,Kennen,102,70,32,68.63
Viktor,Skarner,156,86,70,55.13
Viktor,Malzahar,333,124,209,37.24
Viktor,Yuumi,315,135,180,42.86
Viktor,Ivern,122,63,59,51.64
Viktor,Katarina,397,251,146,63.22
Viktor,Jhin,743,324,419,43.61
Viktor,Nami,430,193,237,44.88
Viktor,Sett,697,368,329,52.8
Viktor,Rammus,101,62,39,61.39
Viktor,Chogath,505,269,236,53.27
Viktor,Yasuo,738,415,323,56.23
Viktor,Nautilus,383,194,189,50.65
Viktor,Ahri,490,266,224,54.29
Viktor,Zilean,91,48,43,52.75
Viktor,Aurora,426,251,175,58.92
Viktor,Annie,98,56,42,57.14
Viktor,Elise,296,128,168,43.24
Viktor,Ashe,680,336,344,49.41
Viktor,Camille,178,74,104,41.57
Viktor,Kayn,599,321,278,53.59
Viktor,Zeri,152,80,72,52.63
Viktor,Illaoi,227,114,113,50.22
Viktor,Volibear,393,180,213,45.8
Viktor,Naafiri,169,80,89,47.34
Viktor,Lux,965,499,466,51.71
Viktor,Yorick,281,104,177,37.01
Viktor,Mordekaiser,529,242,287,45.75
Viktor,Evelynn,236,117,119,49.58
Viktor,Tristana,369,194,175,52.57
Viktor,Sylas,390,175,215,44.87
Viktor,Shen,235,146,89,62.13
Viktor,MasterYi,324,119,205,36.73
Viktor,TahmKench,516,238,278,46.12
Viktor,Malphite,332,182,150,54.82
Viktor,Viego,476,232,244,48.74
Viktor,Galio,266,128,138,48.12
Viktor,Samira,349,168,181,48.14
Viktor,Braum,158,65,93,41.14
Viktor,Jax,291,132,159,45.36
Viktor,Graves,179,109,70,60.89
Viktor,Irelia,353,201,152,56.94
Viktor,Caitlyn,930,445,485,47.85
Viktor,Soraka,255,137,118,53.73
Viktor,Kindred,246,132,114,53.66
Viktor,Talon,259,136,123,52.51
Viktor,Varus,286,142,144,49.65
Viktor,Lulu,361,222,139,61.5
Viktor,Sejuani,152,66,86,43.42
Viktor,Aphelios,238,132,106,55.46
Viktor,Velkoz,252,115,137,45.63
Viktor,MonkeyKing,171,83,88,48.54
Viktor,Vladimir,183,93,90,50.82
Viktor,MissFortune,776,336,440,43.3
Viktor,Shaco,388,217,171,55.93
Viktor,Ekko,290,151,139,52.07
Viktor,Bard,145,55,90,37.93
Viktor,Orianna,231,134,97,58.01
Viktor,Pantheon,614,264,350,43
Viktor,Riven,157,100,57,63.69
Viktor,Yone,635,281,354,44.25
Viktor,Akshan,167,93,74,55.69
Viktor,Xayah,235,125,110,53.19
Viktor,Rakan,147,80,67,54.42
Viktor,Sion,330,183,147,55.45
Viktor,Nidalee,97,59,38,60.82
Viktor,KSante,142,75,67,52.82
Viktor,Ambessa,285,145,140,50.88
Viktor,Vi,342,132,210,38.6
Viktor,Corki,145,74,71,51.03
Viktor,Zyra,311,161,150,51.77
Viktor,Heimerdinger,152,63,89,41.45
Viktor,Briar,378,192,186,50.79
Viktor,Taric,98,34,64,34.69
Viktor,Jayce,160,94,66,58.75
Viktor,Nasus,395,197,198,49.87
Viktor,Cassiopeia,161,89,72,55.28
Viktor,Alistar,136,76,60,55.88
Viktor,Pyke,439,239,200,54.44
Viktor,Lillia,206,109,97,52.91
Viktor,Draven,200,97,103,48.5
Viktor,Milio,259,133,126,51.35
Viktor,Zoe,177,88,89,49.72
Viktor,Nilah,179,76,103,42.46
Viktor,Gnar,169,63,106,37.28
Viktor,Zed,361,195,166,54.02
Viktor,Trundle,230,115,115,50
Viktor,Veigar,546,213,333,39.01
Viktor,Warwick,526,252,274,47.91
Viktor,Thresh,525,282,243,53.71
Viktor,Blitzcrank,305,194,111,63.61
Viktor,Sona,155,62,93,40
Viktor,Taliyah,92,48,44,52.17
Viktor,XinZhao,194,72,122,37.11
Viktor,Brand,331,175,156,52.87
Viktor,Shyvana,96,48,48,50
Viktor,Vayne,425,191,234,44.94
Viktor,Morgana,555,262,293,47.21
Viktor,Teemo,508,202,306,39.76
Viktor,Xerath,254,102,152,40.16
Viktor,Renekton,188,85,103,45.21
Viktor,FiddleSticks,192,111,81,57.81
Viktor,Akali,437,193,244,44.16
Viktor,Singed,126,52,74,41.27
Viktor,Smolder,306,177,129,57.84
Viktor,Karma,340,147,193,43.24
Viktor,Kayle,338,155,183,45.86
Viktor,Janna,172,84,88,48.84
Viktor,Fizz,206,122,84,59.22
Viktor,Rell,185,120,65,64.86
Viktor,Vex,308,157,151,50.97
Viktor,Karthus,102,73,29,71.57
Viktor,Neeko,303,159,144,52.48
Viktor,Nunu,346,159,187,45.95
Viktor,Kassadin,64,21,43,32.81
Viktor,Swain,472,197,275,41.74
Viktor,Nocturne,288,172,116,59.72
Viktor,Maokai,231,121,110,52.38
Viktor,Diana,519,240,279,46.24
Viktor,Ezreal,702,417,285,59.4
Viktor,Kalista,198,137,61,69.19
Viktor,Aatrox,382,229,153,59.95
Viktor,Ryze,125,73,52,58.4
Viktor,Rengar,210,95,115,45.24
Viktor,JarvanIV,133,92,41,69.17
Viktor,Garen,475,233,242,49.05
Viktor,Azir,94,55,39,58.51
Viktor,DrMundo,241,113,128,46.89
Viktor,Hecarim,125,53,72,42.4
Viktor,Sivir,206,102,104,49.51
Viktor,Khazix,326,185,141,56.75
Viktor,Qiyana,177,80,97,45.2
Viktor,Syndra,192,84,108,43.75
Viktor,Anivia,144,53,91,36.81
Viktor,Quinn,143,58,85,40.56
Viktor,Leblanc,114,64,50,56.14
Viktor,Urgot,197,99,98,50.25
Viktor,Lissandra,85,42,43,49.41
Viktor,Udyr,116,66,50,56.9
Viktor,Renata,98,52,46,53.06
Viktor,Rumble,53,20,33,37.74
Viktor,Gwen,245,129,116,52.65
Viktor,Ornn,181,97,84,53.59
Viktor,Kled,92,45,47,48.91
Viktor,Olaf,79,29,50,36.71
Viktor,AurelionSol,192,95,97,49.48
Viktor,KogMaw,160,72,88,45
Viktor,Belveth,97,62,35,63.92
Viktor,RekSai,59,17,42,28.81
Pyke,Renekton,298,119,179,39.93
Pyke,Kayn,1065,455,610,42.72
Pyke,Katarina,536,272,264,50.75
Pyke,Draven,374,182,192,48.66
Pyke,Yuumi,677,297,380,43.87
Pyke,Gangplank,267,138,129,51.69
Pyke,Gragas,353,135,218,38.24
Pyke,TwistedFate,267,152,115,56.93
Pyke,Lucian,408,161,247,39.46
Pyke,Leona,572,267,305,46.68
Pyke,TahmKench,824,384,440,46.6
Pyke,Malphite,557,208,349,37.34
Pyke,Yasuo,1373,681,692,49.6
Pyke,Aphelios,531,249,282,46.89
Pyke,Mordekaiser,1119,460,659,41.11
Pyke,Briar,750,301,449,40.13
Pyke,Ryze,194,70,124,36.08
Pyke,Vex,321,108,213,33.64
Pyke,Naafiri,369,179,190,48.51
Pyke,Yone,1409,673,736,47.76
Pyke,MissFortune,1434,686,748,47.84
Pyke,Senna,636,289,347,45.44
Pyke,Viego,887,376,511,42.39
Pyke,Kindred,479,249,230,51.98
Pyke,Jhin,1394,583,811,41.82
Pyke,Sett,1174,519,655,44.21
Pyke,Talon,393,174,219,44.27
Pyke,FiddleSticks,385,191,194,49.61
Pyke,Ashe,1175,533,642,45.36
Pyke,Blitzcrank,559,259,300,46.33
Pyke,Warwick,1089,512,577,47.02
Pyke,Singed,158,73,85,46.2
Pyke,Samira,589,290,299,49.24
Pyke,Soraka,405,154,251,38.02
Pyke,Shen,461,192,269,41.65
Pyke,Diana,916,445,471,48.58
Pyke,DrMundo,389,155,234,39.85
Pyke,Ivern,127,49,78,38.58
Pyke,Nilah,397,138,259,34.76
Pyke,Nocturne,527,278,249,52.75
Pyke,Lissandra,174,80,94,45.98
Pyke,Lux,1968,973,995,49.44
Pyke,Darius,1194,583,611,48.83
Pyke,Poppy,468,235,233,50.21
Pyke,Sylas,804,338,466,42.04
Pyke,Rell,362,163,199,45.03
Pyke,Fizz,357,138,219,38.66
Pyke,Gnar,234,110,124,47.01
Pyke,Caitlyn,1631,781,850,47.88
Pyke,Neeko,534,221,313,41.39
Pyke,Irelia,636,221,415,34.75
Pyke,Tryndamere,398,194,204,48.74
Pyke,Amumu,699,328,371,46.92
Pyke,Mel,1601,770,831,48.09
Pyke,Kaisa,906,403,503,44.48
Pyke,Seraphine,660,319,341,48.33
Pyke,Zed,657,295,362,44.9
Pyke,Nunu,589,267,322,45.33
Pyke,KSante,233,114,119,48.93
Pyke,Zeri,336,174,162,51.79
Pyke,Lulu,512,241,271,47.07
Pyke,Azir,257,127,130,49.42
Pyke,Sejuani,211,95,116,45.02
Pyke,Udyr,276,120,156,43.48
Pyke,Evelynn,485,214,271,44.12
Pyke,Khazix,462,259,203,56.06
Pyke,Camille,226,127,99,56.19
Pyke,LeeSin,688,360,328,52.33
Pyke,Jax,719,337,382,46.87
Pyke,JarvanIV,211,101,110,47.87
Pyke,Hwei,619,299,320,48.3
Pyke,Bard,198,78,120,39.39
Pyke,Morgana,883,394,489,44.62
Pyke,Ambessa,363,158,205,43.53
Pyke,XinZhao,389,145,244,37.28
Pyke,Volibear,776,304,472,39.18
Pyke,Xerath,371,186,185,50.13
Pyke,Ezreal,1147,567,580,49.43
Pyke,Heimerdinger,441,204,237,46.26
Pyke,Aatrox,621,246,375,39.61
Pyke,Taric,133,33,100,24.81
Pyke,Varus,558,191,367,34.23
Pyke,Garen,981,380,601,38.74
Pyke,Ekko,664,289,375,43.52
Pyke,Ahri,983,487,496,49.54
Pyke,Jinx,1491,695,796,46.61
Pyke,Zilean,166,71,95,42.77
Pyke,Chogath,811,327,484,40.32
Pyke,Yorick,595,223,372,37.48
Pyke,Thresh,1014,531,483,52.37
Pyke,Trundle,300,141,159,47
Pyke,MasterYi,687,309,378,44.98
Pyke,Sivir,387,159,228,41.09
Pyke,Tristana,721,307,414,42.58
Pyke,Gwen,465,207,258,44.52
Pyke,Maokai,309,153,156,49.51
Pyke,Veigar,788,303,485,38.45
Pyke,Brand,516,236,280,45.74
Pyke,Urgot,309,138,171,44.66
Pyke,Zyra,448,179,269,39.96
Pyke,Malzahar,487,178,309,36.55
Pyke,Quinn,256,140,116,54.69
Pyke,Teemo,1077,489,588,45.4
Pyke,Galio,446,240,206,53.81
Pyke,Nasus,529,206,323,38.94
Pyke,AurelionSol,351,139,212,39.6
Pyke,Qiyana,246,117,129,47.56
Pyke,Nami,624,306,318,49.04
Pyke,Orianna,305,151,154,49.51
Pyke,RekSai,106,74,32,69.81
Pyke,Shaco,633,290,343,45.81
Pyke,Kayle,557,252,305,45.24
Pyke,Aurora,671,297,374,44.26
Pyke,Fiora,311,139,172,44.69
Pyke,Nautilus,812,333,479,41.01
Pyke,Akali,754,344,410,45.62
Pyke,Hecarim,252,110,142,43.65
Pyke,Smolder,527,254,273,48.2
Pyke,Pantheon,1300,527,773,40.54
Pyke,MonkeyKing,294,107,187,36.39
Pyke,Vladimir,382,186,196,48.69
Pyke,Twitch,523,245,278,46.85
Pyke,Anivia,248,139,109,56.05
Pyke,Ziggs,286,123,163,43.01
Pyke,Elise,385,176,209,45.71
Pyke,Leblanc,236,99,137,41.95
Pyke,Vi,475,194,281,40.84
Pyke,Xayah,372,187,185,50.27
Pyke,Zac,157,87,70,55.41
Pyke,Lillia,420,172,248,40.95
Pyke,Rammus,291,125,166,42.96
Pyke,Illaoi,301,139,162,46.18
Pyke,Belveth,200,68,132,34
Pyke,Zoe,330,169,161,51.21
Pyke,Viktor,439,200,239,45.56
Pyke,Milio,331,166,165,50.15
Pyke,Nidalee,157,70,87,44.59
Pyke,Kled,152,54,98,35.53
Pyke,Annie,156,74,82,47.44
Pyke,Olaf,134,61,73,45.52
Pyke,Swain,711,285,426,40.08
Pyke,Vayne,618,270,348,43.69
Pyke,Riven,292,192,100,65.75
Pyke,Kassadin,143,58,85,40.56
Pyke,Sion,525,214,311,40.76
Pyke,Rengar,276,179,97,64.86
Pyke,Akshan,242,83,159,34.3
Pyke,Rakan,332,141,191,42.47
Pyke,Skarner,240,162,78,67.5
Pyke,Jayce,271,133,138,49.08
Pyke,Janna,224,108,116,48.21
Pyke,Graves,384,226,158,58.85
Pyke,Syndra,385,156,229,40.52
Pyke,Shyvana,218,109,109,50
Pyke,Karma,449,199,250,44.32
Pyke,Corki,220,90,130,40.91
Pyke,Kalista,265,127,138,47.92
Pyke,Alistar,222,122,100,54.95
Pyke,KogMaw,202,85,117,42.08
Pyke,Cassiopeia,271,130,141,47.97
Pyke,Sona,237,75,162,31.65
Pyke,Ornn,278,106,172,38.13
Pyke,Rumble,114,53,61,46.49
Pyke,Velkoz,397,214,183,53.9
Pyke,Karthus,149,71,78,47.65
Pyke,Braum,294,121,173,41.16
Pyke,Taliyah,148,58,90,39.19
Pyke,Renata,124,78,46,62.9
Pyke,Kennen,226,84,142,37.17
Renekton,Yone,516,317,199,61.43
Renekton,Shaco,192,100,92,52.08
Renekton,Mel,751,376,375,50.07
Renekton,Tristana,232,116,116,50
Renekton,Pyke,298,179,119,60.07
Renekton,Aurora,294,164,130,55.78
Renekton,Volibear,346,221,125,63.87
Renekton,Yasuo,594,249,345,41.92
Renekton,Vayne,324,166,158,51.23
Renekton,Swain,260,99,161,38.08
Renekton,Malzahar,190,96,94,50.53
Renekton,Irelia,201,101,100,50.25
Renekton,Kalista,158,64,94,40.51
Renekton,Poppy,172,83,89,48.26
Renekton,Smolder,261,145,116,55.56
Renekton,Ekko,242,121,121,50
Renekton,Mordekaiser,427,205,222,48.01
Renekton,Yuumi,180,108,72,60
Renekton,Jax,261,136,125,52.11
Renekton,FiddleSticks,93,38,55,40.86
Renekton,Cassiopeia,103,48,55,46.6
Renekton,Caitlyn,584,315,269,53.94
Renekton,Milio,87,30,57,34.48
Renekton,Tryndamere,166,85,81,51.2
Renekton,Diana,349,175,174,50.14
Renekton,Lux,740,365,375,49.32
Renekton,Sivir,105,53,52,50.48
Renekton,Soraka,174,85,89,48.85
Renekton,Kayn,359,162,197,45.13
Renekton,Ezreal,463,275,188,59.4
Renekton,Brand,161,93,68,57.76
Renekton,Nunu,212,117,95,55.19
Renekton,Kaisa,392,196,196,50
Renekton,Nami,242,100,142,41.32
Renekton,Camille,93,47,46,50.54
Renekton,Katarina,243,129,114,53.09
Renekton,Zeri,134,74,60,55.22
Renekton,Rengar,123,77,46,62.6
Renekton,Akali,251,132,119,52.59
Renekton,Lucian,101,44,57,43.56
Renekton,Viego,409,238,171,58.19
Renekton,Samira,231,112,119,48.48
Renekton,Leona,193,90,103,46.63
Renekton,Shen,138,71,67,51.45
Renekton,Leblanc,130,64,66,49.23
Renekton,Hwei,170,79,91,46.47
Renekton,Kayle,151,90,61,59.6
Renekton,Janna,91,54,37,59.34
Renekton,Zoe,98,40,58,40.82
Renekton,Gragas,148,76,72,51.35
Renekton,Garen,439,208,231,47.38
Renekton,Nilah,178,90,88,50.56
Renekton,Thresh,429,226,203,52.68
Renekton,Kennen,99,55,44,55.56
Renekton,Evelynn,105,76,29,72.38
Renekton,Trundle,179,100,79,55.87
Renekton,Rammus,90,25,65,27.78
Renekton,Sylas,264,98,166,37.12
Renekton,Xayah,193,96,97,49.74
Renekton,Blitzcrank,219,116,103,52.97
Renekton,MonkeyKing,103,47,56,45.63
Renekton,Vex,156,71,85,45.51
Renekton,Jhin,425,169,256,39.76
Renekton,Nautilus,268,137,131,51.12
Renekton,Darius,519,238,281,45.86
Renekton,Senna,282,159,123,56.38
Renekton,Ashe,474,252,222,53.16
Renekton,Sion,180,73,107,40.56
Renekton,Nidalee,41,28,13,68.29
Renekton,Jinx,481,245,236,50.94
Renekton,KSante,78,29,49,37.18
Renekton,Sejuani,104,42,62,40.38
Renekton,Zed,271,169,102,62.36
Renekton,Naafiri,170,60,110,35.29
Renekton,Draven,192,98,94,51.04
Renekton,Veigar,341,185,156,54.25
Renekton,Neeko,198,108,90,54.55
Renekton,Nasus,285,149,136,52.28
Renekton,Gangplank,113,51,62,45.13
Renekton,Belveth,77,34,43,44.16
Renekton,Maokai,121,68,53,56.2
Renekton,Riven,172,116,56,67.44
Renekton,Karma,185,101,84,54.59
Renekton,Ambessa,221,118,103,53.39
Renekton,Graves,188,102,86,54.26
Renekton,Ahri,416,222,194,53.37
Renekton,Teemo,279,107,172,38.35
Renekton,Briar,230,100,130,43.48
Renekton,Rakan,139,90,49,64.75
Renekton,Jayce,71,42,29,59.15
Renekton,LeeSin,268,119,149,44.4
Renekton,Zilean,74,51,23,68.92
Renekton,Fiora,82,47,35,57.32
Renekton,Elise,233,121,112,51.93
Renekton,Pantheon,454,216,238,47.58
Renekton,Khazix,161,71,90,44.1
Renekton,Braum,140,47,93,33.57
Renekton,Velkoz,206,99,107,48.06
Renekton,Malphite,181,74,107,40.88
Renekton,Lillia,168,82,86,48.81
Renekton,Ryze,61,39,22,63.93
Renekton,Vi,255,124,131,48.63
Renekton,Fizz,125,53,72,42.4
Renekton,Vladimir,189,129,60,68.25
Renekton,Kled,59,22,37,37.29
Renekton,Morgana,356,213,143,59.83
Renekton,Seraphine,276,138,138,50
Renekton,Sett,535,216,319,40.37
Renekton,Viktor,188,103,85,54.79
Renekton,Aatrox,271,183,88,67.53
Renekton,Warwick,436,237,199,54.36
Renekton,Xerath,195,103,92,52.82
Renekton,Olaf,64,32,32,50
Renekton,MissFortune,513,253,260,49.32
Renekton,Kindred,121,53,68,43.8
Renekton,Gnar,127,63,64,49.61
Renekton,Karthus,31,15,16,48.39
Renekton,Twitch,229,121,108,52.84
Renekton,JarvanIV,130,55,75,42.31
Renekton,Bard,109,32,77,29.36
Renekton,Udyr,106,51,55,48.11
Renekton,MasterYi,298,164,134,55.03
Renekton,Annie,85,57,28,67.06
Renekton,Zyra,176,93,83,52.84
Renekton,Gwen,186,103,83,55.38
Renekton,Syndra,147,43,104,29.25
Renekton,Ziggs,122,61,61,50
Renekton,Singed,47,9,38,19.15
Renekton,Alistar,91,68,23,74.73
Renekton,Sona,83,40,43,48.19
Renekton,RekSai,19,13,6,68.42
Renekton,Quinn,112,64,48,57.14
Renekton,DrMundo,140,86,54,61.43
Renekton,Nocturne,173,92,81,53.18
Renekton,Orianna,139,81,58,58.27
Renekton,Galio,183,91,92,49.73
Renekton,Illaoi,177,68,109,38.42
Renekton,TwistedFate,106,29,77,27.36
Renekton,TahmKench,281,150,131,53.38
Renekton,Rell,126,88,38,69.84
Renekton,Kassadin,58,11,47,18.97
Renekton,KogMaw,92,42,50,45.65
Renekton,Shyvana,64,19,45,29.69
Renekton,Heimerdinger,109,73,36,66.97
Renekton,Hecarim,99,49,50,49.49
Renekton,Skarner,149,84,65,56.38
Renekton,Qiyana,103,68,35,66.02
Renekton,Rumble,52,23,29,44.23
Renekton,Chogath,314,155,159,49.36
Renekton,XinZhao,154,75,79,48.7
Renekton,Amumu,260,137,123,52.69
Renekton,Yorick,293,135,158,46.08
Renekton,Varus,225,105,120,46.67
Renekton,Zac,149,90,59,60.4
Renekton,Akshan,117,62,55,52.99
Renekton,Taric,66,34,32,51.52
Renekton,Talon,194,118,76,60.82
Renekton,Urgot,141,52,89,36.88
Renekton,Lulu,158,81,77,51.27
Renekton,Renata,68,51,17,75
Renekton,Ornn,88,30,58,34.09
Renekton,Corki,112,40,72,35.71
Renekton,Lissandra,58,24,34,41.38
Renekton,Azir,72,47,25,65.28
Renekton,Ivern,65,34,31,52.31
Renekton,Aphelios,175,86,89,49.14
Renekton,Anivia,82,49,33,59.76
Renekton,AurelionSol,121,69,52,57.02
Renekton,Taliyah,65,45,20,69.23
Kayn,Yone,1997,989,1008,49.52
Kayn,Shaco,930,548,382,58.92
Kayn,Mel,2044,1086,958,53.13
Kayn,Tristana,792,381,411,48.11
Kayn,Pyke,1065,610,455,57.28
Kayn,Gwen,519,274,245,52.79
Kayn,Vi,872,440,432,50.46
Kayn,Zed,919,465,454,50.6
Kayn,Jhin,1627,766,861,47.08
Kayn,Soraka,577,253,324,43.85
Kayn,Aatrox,942,500,442,53.08
Kayn,Brand,746,402,344,53.89
Kayn,Irelia,924,462,462,50
Kayn,Caitlyn,2160,1030,1130,47.69
Kayn,Milio,448,185,263,41.29
Kayn,Teemo,1285,605,680,47.08
Kayn,Warwick,1645,710,935,43.16
Kayn,Azir,261,174,87,66.67
Kayn,MissFortune,2017,1048,969,51.96
Kayn,Neeko,814,436,378,53.56
Kayn,Trundle,470,224,246,47.66
Kayn,MasterYi,1200,519,681,43.25
Kayn,Veigar,1087,497,590,45.72
Kayn,Gangplank,368,203,165,55.16
Kayn,Ivern,187,101,86,54.01
Kayn,Swain,1006,505,501,50.2
Kayn,Ornn,413,164,249,39.71
Kayn,Udyr,402,205,197,51
Kayn,Lux,2695,1254,1441,46.53
Kayn,Ezreal,1548,831,717,53.68
Kayn,Singed,280,125,155,44.64
Kayn,Graves,566,297,269,52.47
Kayn,Fizz,595,280,315,47.06
Kayn,Ziggs,377,160,217,42.44
Kayn,Pantheon,1735,927,808,53.43
Kayn,XinZhao,480,218,262,45.42
Kayn,Yasuo,1963,972,991,49.52
Kayn,Jinx,1912,980,932,51.26
Kayn,FiddleSticks,495,224,271,45.25
Kayn,Akali,1003,555,448,55.33
Kayn,Twitch,794,332,462,41.81
Kayn,Senna,706,351,355,49.72
Kayn,Riven,391,230,161,58.82
Kayn,Amumu,815,363,452,44.54
Kayn,Zoe,453,218,235,48.12
Kayn,Sona,371,173,198,46.63
Kayn,Heimerdinger,507,235,272,46.35
Kayn,Talon,618,365,253,59.06
Kayn,Ahri,1211,567,644,46.82
Kayn,Kalista,474,239,235,50.42
Kayn,Sett,1566,682,884,43.55
Kayn,Ashe,1630,862,768,52.88
Kayn,Blitzcrank,774,421,353,54.39
Kayn,Mordekaiser,1561,724,837,46.38
Kayn,Sylas,946,465,481,49.15
Kayn,Xayah,712,293,419,41.15
Kayn,Smolder,709,363,346,51.2
Kayn,Ekko,759,396,363,52.17
Kayn,Yuumi,966,454,512,47
Kayn,Cassiopeia,345,207,138,60
Kayn,Nasus,798,373,425,46.74
Kayn,MonkeyKing,462,203,259,43.94
Kayn,Zac,333,164,169,49.25
Kayn,Shen,697,338,359,48.49
Kayn,Diana,1572,731,841,46.5
Kayn,Samira,951,477,474,50.16
Kayn,Camille,334,194,140,58.08
Kayn,Katarina,852,516,336,60.56
Kayn,Zyra,590,265,325,44.92
Kayn,Lulu,634,319,315,50.32
Kayn,Volibear,1090,559,531,51.28
Kayn,Vayne,934,424,510,45.4
Kayn,Briar,1046,517,529,49.43
Kayn,Nautilus,953,515,438,54.04
Kayn,Darius,1808,907,901,50.17
Kayn,Maokai,522,265,257,50.77
Kayn,Malphite,910,485,425,53.3
Kayn,Sion,710,368,342,51.83
Kayn,Alistar,232,145,87,62.5
Kayn,Rammus,346,184,162,53.18
Kayn,Sivir,411,198,213,48.18
Kayn,Xerath,712,378,334,53.09
Kayn,Gragas,583,319,264,54.72
Kayn,LeeSin,1029,625,404,60.74
Kayn,Shyvana,242,73,169,30.17
Kayn,Nilah,523,271,252,51.82
Kayn,Nami,968,513,455,53
Kayn,Sejuani,394,208,186,52.79
Kayn,Tryndamere,612,299,313,48.86
Kayn,TahmKench,978,496,482,50.72
Kayn,Naafiri,429,209,220,48.72
Kayn,Jax,863,414,449,47.97
Kayn,Morgana,1288,609,679,47.28
Kayn,Galio,632,286,346,45.25
Kayn,Illaoi,526,185,341,35.17
Kayn,Leona,779,336,443,43.13
Kayn,Vex,574,254,320,44.25
Kayn,Thresh,1103,527,576,47.78
Kayn,Nocturne,897,434,463,48.38
Kayn,Orianna,381,185,196,48.56
Kayn,Khazix,636,301,335,47.33
Kayn,Varus,659,345,314,52.35
Kayn,Malzahar,717,276,441,38.49
Kayn,Renekton,359,197,162,54.87
Kayn,Viego,1277,692,585,54.19
Kayn,Skarner,280,149,131,53.21
Kayn,DrMundo,604,270,334,44.7
Kayn,Hwei,650,324,326,49.85
Kayn,Aurora,765,367,398,47.97
Kayn,Lillia,624,305,319,48.88
Kayn,Lissandra,273,135,138,49.45
Kayn,Garen,1392,666,726,47.84
Kayn,TwistedFate,354,161,193,45.48
Kayn,Annie,248,137,111,55.24
Kayn,Olaf,174,95,79,54.6
Kayn,Fiora,445,238,207,53.48
Kayn,Kaisa,1289,719,570,55.78
Kayn,Ryze,208,75,133,36.06
Kayn,Rengar,459,293,166,63.83
Kayn,Syndra,532,256,276,48.12
Kayn,JarvanIV,345,172,173,49.86
Kayn,Lucian,548,274,274,50
Kayn,Karthus,278,172,106,61.87
Kayn,Karma,663,373,290,56.26
Kayn,Gnar,311,166,145,53.38
Kayn,AurelionSol,361,178,183,49.31
Kayn,Vladimir,511,229,282,44.81
Kayn,Hecarim,427,187,240,43.79
Kayn,Viktor,599,278,321,46.41
Kayn,Leblanc,287,155,132,54.01
Kayn,Poppy,531,238,293,44.82
Kayn,Kayle,619,328,291,52.99
Kayn,Janna,296,125,171,42.23
Kayn,Ambessa,553,312,241,56.42
Kayn,Zilean,280,134,146,47.86
Kayn,Taric,171,70,101,40.94
Kayn,Braum,434,235,199,54.15
Kayn,Elise,618,361,257,58.41
Kayn,Nidalee,242,149,93,61.57
Kayn,Aphelios,623,345,278,55.38
Kayn,Rakan,574,256,318,44.6
Kayn,Yorick,848,329,519,38.8
Kayn,Evelynn,459,253,206,55.12
Kayn,RekSai,105,36,69,34.29
Kayn,Kennen,369,144,225,39.02
Kayn,Velkoz,592,317,275,53.55
Kayn,KSante,358,195,163,54.47
Kayn,Jayce,316,195,121,61.71
Kayn,Renata,254,145,109,57.09
Kayn,Kindred,516,277,239,53.68
Kayn,Qiyana,288,159,129,55.21
Kayn,Rell,458,236,222,51.53
Kayn,Akshan,336,105,231,31.25
Kayn,Nunu,803,465,338,57.91
Kayn,KogMaw,304,178,126,58.55
Kayn,Corki,329,170,159,51.67
Kayn,Chogath,1178,650,528,55.18
Kayn,Urgot,469,190,279,40.51
Kayn,Kled,187,72,115,38.5
Kayn,Seraphine,998,483,515,48.4
Kayn,Draven,534,251,283,47
Kayn,Kassadin,190,106,84,55.79
Kayn,Belveth,229,121,108,52.84
Kayn,Taliyah,248,126,122,50.81
Kayn,Zeri,363,195,168,53.72
Kayn,Anivia,289,158,131,54.67
Kayn,Bard,237,142,95,59.92
Kayn,Rumble,176,95,81,53.98
Kayn,Quinn,334,156,178,46.71
Draven,Yone,655,332,323,50.69
Draven,Shaco,312,152,160,48.72
Draven,Mel,782,459,323,58.7
Draven,Tristana,324,165,159,50.93
Draven,Pyke,374,192,182,51.34
Draven,Talon,228,92,136,40.35
Draven,Aurora,339,158,181,46.61
Draven,Yasuo,714,304,410,42.58
Draven,Alistar,118,56,62,47.46
Draven,Gangplank,193,119,74,61.66
Draven,MasterYi,277,132,145,47.65
Draven,Veigar,391,176,215,45.01
Draven,Swain,361,135,226,37.4
Draven,AurelionSol,126,45,81,35.71
Draven,Ashe,657,307,350,46.73
Draven,Velkoz,226,98,128,43.36
Draven,Aatrox,282,201,81,71.28
Draven,Viego,438,205,233,46.8
Draven,Sylas,301,157,144,52.16
Draven,Blitzcrank,209,128,81,61.24
Draven,Urgot,182,80,102,43.96
Draven,LeeSin,358,179,179,50
Draven,TwistedFate,140,67,73,47.86
Draven,Rakan,140,69,71,49.29
Draven,Evelynn,153,83,70,54.25
Draven,Irelia,318,134,184,42.14
Draven,Lux,985,465,520,47.21
Draven,Jax,216,79,137,36.57
Draven,Graves,195,90,105,46.15
Draven,Katarina,290,152,138,52.41
Draven,Twitch,276,155,121,56.16
Draven,Seraphine,325,157,168,48.31
Draven,Kalista,177,94,83,53.11
Draven,Gragas,289,111,178,38.41
Draven,Orianna,128,76,52,59.38
Draven,Gnar,108,67,41,62.04
Draven,Fiora,156,78,78,50
Draven,Ekko,307,180,127,58.63
Draven,Kassadin,49,26,23,53.06
Draven,Caitlyn,729,337,392,46.23
Draven,TahmKench,296,141,155,47.64
Draven,Akali,335,191,144,57.01
Draven,Zac,136,50,86,36.76
Draven,Diana,452,178,274,39.38
Draven,Vayne,381,156,225,40.94
Draven,Mordekaiser,507,241,266,47.53
Draven,Zeri,162,69,93,42.59
Draven,Sett,544,249,295,45.77
Draven,Volibear,371,188,183,50.67
Draven,KogMaw,82,44,38,53.66
Draven,Gwen,211,106,105,50.24
Draven,JarvanIV,100,41,59,41
Draven,Senna,335,190,145,56.72
Draven,Pantheon,626,309,317,49.36
Draven,Vex,171,83,88,48.54
Draven,Kaisa,510,268,242,52.55
Draven,Poppy,179,93,86,51.96
Draven,Warwick,520,244,276,46.92
Draven,Ryze,83,24,59,28.92
Draven,Garen,471,219,252,46.5
Draven,Briar,344,163,181,47.38
Draven,Malzahar,237,92,145,38.82
Draven,Fizz,188,78,110,41.49
Draven,Teemo,474,248,226,52.32
Draven,Zoe,169,114,55,67.46
Draven,Darius,695,320,375,46.04
Draven,Qiyana,125,66,59,52.8
Draven,Ziggs,153,71,82,46.41
Draven,MissFortune,769,425,344,55.27
Draven,Nami,369,167,202,45.26
Draven,RekSai,46,26,20,56.52
Draven,Brand,227,143,84,63
Draven,Vladimir,150,72,78,48
Draven,Soraka,213,80,133,37.56
Draven,Cassiopeia,136,79,57,58.09
Draven,Karma,202,91,111,45.05
Draven,Chogath,393,178,215,45.29
Draven,Aphelios,211,93,118,44.08
Draven,Smolder,244,128,116,52.46
Draven,Hwei,282,154,128,54.61
Draven,Milio,168,42,126,25
Draven,KSante,136,59,77,43.38
Draven,Nautilus,353,157,196,44.48
Draven,Kayle,238,102,136,42.86
Draven,Amumu,250,119,131,47.6
Draven,Janna,75,43,32,57.33
Draven,DrMundo,176,64,112,36.36
Draven,Kindred,221,138,83,62.44
Draven,Rell,176,91,85,51.7
Draven,Renekton,192,94,98,48.96
Draven,Zilean,87,27,60,31.03
Draven,Nocturne,271,96,175,35.42
Draven,Lucian,139,75,64,53.96
Draven,Udyr,165,55,110,33.33
Draven,Annie,127,69,58,54.33
Draven,Maokai,193,89,104,46.11
Draven,Trundle,170,80,90,47.06
Draven,Samira,365,191,174,52.33
Draven,Yorick,295,121,174,41.02
Draven,Neeko,230,113,117,49.13
Draven,Leblanc,154,82,72,53.25
Draven,Hecarim,177,92,85,51.98
Draven,MonkeyKing,174,90,84,51.72
Draven,Ezreal,642,307,335,47.82
Draven,Malphite,262,105,157,40.08
Draven,Heimerdinger,141,53,88,37.59
Draven,Naafiri,116,46,70,39.66
Draven,Thresh,500,199,301,39.8
Draven,Viktor,200,103,97,51.5
Draven,Nunu,210,115,95,54.76
Draven,Shen,227,99,128,43.61
Draven,Singed,140,51,89,36.43
Draven,Lulu,234,125,109,53.42
Draven,Sejuani,106,53,53,50
Draven,Leona,206,79,127,38.35
Draven,Azir,111,55,56,49.55
Draven,Sivir,149,88,61,59.06
Draven,Sion,294,151,143,51.36
Draven,Jinx,664,331,333,49.85
Draven,Ahri,378,181,197,47.88
Draven,Ambessa,213,137,76,64.32
Draven,Morgana,426,216,210,50.7
Draven,Kayn,534,283,251,53
Draven,Jhin,661,287,374,43.42
Draven,Lissandra,68,19,49,27.94
Draven,Syndra,168,74,94,44.05
Draven,Illaoi,136,72,64,52.94
Draven,Taliyah,111,57,54,51.35
Draven,Zyra,209,86,123,41.15
Draven,Riven,140,71,69,50.71
Draven,XinZhao,186,59,127,31.72
Draven,Kennen,128,78,50,60.94
Draven,Elise,200,89,111,44.5
Draven,Zed,338,166,172,49.11
Draven,Braum,195,105,90,53.85
Draven,Anivia,83,53,30,63.86
Draven,Varus,223,94,129,42.15
Draven,Lillia,246,113,133,45.93
Draven,Nilah,161,71,90,44.1
Draven,Olaf,69,39,30,56.52
Draven,Rengar,174,107,67,61.49
Draven,Akshan,174,84,90,48.28
Draven,Khazix,221,121,100,54.75
Draven,Belveth,71,19,52,26.76
Draven,Xayah,181,75,106,41.44
Draven,Galio,285,111,174,38.95
Draven,Shyvana,121,69,52,57.02
Draven,Taric,40,25,15,62.5
Draven,Jayce,123,84,39,68.29
Draven,Karthus,51,35,16,68.63
Draven,Sona,144,38,106,26.39
Draven,Yuumi,285,157,128,55.09
Draven,Skarner,76,46,30,60.53
Draven,Nasus,260,88,172,33.85
Draven,Camille,89,54,35,60.67
Draven,Ivern,100,45,55,45
Draven,Tryndamere,186,61,125,32.8
Draven,Corki,123,57,66,46.34
Draven,Quinn,161,75,86,46.58
Draven,FiddleSticks,142,60,82,42.25
Draven,Nidalee,73,44,29,60.27
Draven,Xerath,243,102,141,41.98
Draven,Vi,290,153,137,52.76
Draven,Rammus,131,73,58,55.73
Draven,Ornn,146,56,90,38.36
Draven,Kled,48,37,11,77.08
Draven,Bard,111,46,65,41.44
Draven,Renata,78,48,30,61.54
Draven,Rumble,79,47,32,59.49
Yuumi,Yone,1124,545,579,48.49
Yuumi,Shaco,558,284,274,50.9
Yuumi,Mel,1362,742,620,54.48
Yuumi,Tristana,530,271,259,51.13
Yuumi,Pyke,677,380,297,56.13
Yuumi,Illaoi,289,122,167,42.21
Yuumi,Warwick,840,418,422,49.76
Yuumi,Diana,757,302,455,39.89
Yuumi,Milio,333,175,158,52.55
Yuumi,Mordekaiser,792,396,396,50
Yuumi,Kindred,337,208,129,61.72
Yuumi,Qiyana,208,137,71,65.87
Yuumi,Ashe,968,476,492,49.17
Yuumi,Sona,276,134,142,48.55
Yuumi,Garen,805,385,420,47.83
Yuumi,Briar,512,252,260,49.22
Yuumi,Zed,517,273,244,52.8
Yuumi,Caitlyn,1243,615,628,49.48
Yuumi,Morgana,856,379,477,44.28
Yuumi,Yasuo,1131,524,607,46.33
Yuumi,Gangplank,260,131,129,50.38
Yuumi,Kaisa,765,433,332,56.6
Yuumi,Galio,336,149,187,44.35
Yuumi,Cassiopeia,143,67,76,46.85
Yuumi,Hwei,445,235,210,52.81
Yuumi,Renekton,180,72,108,40
Yuumi,Kayn,966,512,454,53
Yuumi,Vex,352,179,173,50.85
Yuumi,Samira,608,346,262,56.91
Yuumi,Lulu,575,264,311,45.91
Yuumi,Darius,994,508,486,51.11
Yuumi,Lux,1581,787,794,49.78
Yuumi,Sivir,180,103,77,57.22
Yuumi,Rakan,370,181,189,48.92
Yuumi,Jinx,1193,560,633,46.94
Yuumi,Volibear,636,289,347,45.44
Yuumi,Camille,253,135,118,53.36
Yuumi,Katarina,536,283,253,52.8
Yuumi,MissFortune,1193,595,598,49.87
Yuumi,Zyra,324,161,163,49.69
Yuumi,Yorick,469,224,245,47.76
Yuumi,Akshan,173,85,88,49.13
Yuumi,FiddleSticks,328,158,170,48.17
Yuumi,Sion,425,230,195,54.12
Yuumi,Bard,208,112,96,53.85
Yuumi,Kennen,193,125,68,64.77
Yuumi,Naafiri,220,100,120,45.45
Yuumi,Xayah,440,221,219,50.23
Yuumi,Soraka,353,186,167,52.69
Yuumi,Ornn,207,90,117,43.48
Yuumi,TwistedFate,188,116,72,61.7
Yuumi,Jax,416,226,190,54.33
Yuumi,Graves,265,170,95,64.15
Yuumi,Twitch,475,250,225,52.63
Yuumi,Seraphine,618,288,330,46.6
Yuumi,Viktor,315,180,135,57.14
Yuumi,Nocturne,505,232,273,45.94
Yuumi,Annie,203,101,102,49.75
Yuumi,KogMaw,167,67,100,40.12
Yuumi,Alistar,120,68,52,56.67
Yuumi,Akali,672,392,280,58.33
Yuumi,Ezreal,916,511,405,55.79
Yuumi,Nasus,378,189,189,50
Yuumi,Vi,501,271,230,54.09
Yuumi,Renata,154,81,73,52.6
Yuumi,Aatrox,567,311,256,54.85
Yuumi,Chogath,688,357,331,51.89
Yuumi,Lucian,328,177,151,53.96
Yuumi,Nautilus,576,312,264,54.17
Yuumi,Nunu,533,263,270,49.34
Yuumi,Teemo,822,415,407,50.49
Yuumi,Kassadin,123,51,72,41.46
Yuumi,Kalista,318,157,161,49.37
Yuumi,Maokai,288,142,146,49.31
Yuumi,Kled,104,45,59,43.27
Yuumi,AurelionSol,227,89,138,39.21
Yuumi,Jhin,1067,512,555,47.99
Yuumi,MonkeyKing,224,73,151,32.59
Yuumi,Vayne,542,264,278,48.71
Yuumi,Pantheon,900,461,439,51.22
Yuumi,Swain,649,321,328,49.46
Yuumi,Fiora,243,142,101,58.44
Yuumi,Viego,610,292,318,47.87
Yuumi,Vladimir,307,188,119,61.24
Yuumi,LeeSin,533,252,281,47.28
Yuumi,Aurora,559,287,272,51.34
Yuumi,Rell,327,142,185,43.43
Yuumi,Neeko,365,170,195,46.58
Yuumi,Hecarim,204,122,82,59.8
Yuumi,Leblanc,197,100,97,50.76
Yuumi,Trundle,320,133,187,41.56
Yuumi,Singed,161,67,94,41.61
Yuumi,Thresh,647,376,271,58.11
Yuumi,Sett,1020,465,555,45.59
Yuumi,Karma,459,289,170,62.96
Yuumi,Gwen,417,210,207,50.36
Yuumi,Khazix,323,164,159,50.77
Yuumi,Aphelios,370,193,177,52.16
Yuumi,Smolder,454,233,221,51.32
Yuumi,Ziggs,223,122,101,54.71
Yuumi,Malzahar,385,193,192,50.13
Yuumi,Senna,536,291,245,54.29
Yuumi,Rammus,187,73,114,39.04
Yuumi,Fizz,332,144,188,43.37
Yuumi,Jayce,237,138,99,58.23
Yuumi,Gragas,346,200,146,57.8
Yuumi,Leona,431,178,253,41.3
Yuumi,Nidalee,146,87,59,59.59
Yuumi,Ahri,772,392,380,50.78
Yuumi,MasterYi,560,279,281,49.82
Yuumi,Ryze,155,62,93,40
Yuumi,Janna,195,82,113,42.05
Yuumi,Rengar,278,161,117,57.91
Yuumi,TahmKench,568,245,323,43.13
Yuumi,Amumu,536,293,243,54.66
Yuumi,Varus,510,240,270,47.06
Yuumi,Zoe,318,178,140,55.97
Yuumi,Shyvana,190,86,104,45.26
Yuumi,Zac,186,81,105,43.55
Yuumi,Shen,408,215,193,52.7
Yuumi,Poppy,360,161,199,44.72
Yuumi,Quinn,201,93,108,46.27
Yuumi,Skarner,202,90,112,44.55
Yuumi,Nami,669,341,328,50.97
Yuumi,Braum,293,133,160,45.39
Yuumi,Malphite,534,241,293,45.13
Yuumi,Orianna,200,119,81,59.5
Yuumi,Nilah,310,180,130,58.06
Yuumi,Urgot,266,127,139,47.74
Yuumi,Sylas,499,265,234,53.11
Yuumi,Ekko,443,215,228,48.53
Yuumi,Zeri,244,141,103,57.79
Yuumi,Irelia,547,288,259,52.65
Yuumi,Heimerdinger,274,112,162,40.88
Yuumi,Corki,211,99,112,46.92
Yuumi,Veigar,584,221,363,37.84
Yuumi,Anivia,125,55,70,44
Yuumi,Belveth,170,90,80,52.94
Yuumi,Azir,219,151,68,68.95
Yuumi,Velkoz,353,173,180,49.01
Yuumi,Evelynn,281,157,124,55.87
Yuumi,Lissandra,156,70,86,44.87
Yuumi,Olaf,128,84,44,65.63
Yuumi,Lillia,322,182,140,56.52
Yuumi,Gnar,233,112,121,48.07
Yuumi,Blitzcrank,429,162,267,37.76
Yuumi,DrMundo,375,182,193,48.53
Yuumi,Elise,270,146,124,54.07
Yuumi,Brand,394,220,174,55.84
Yuumi,Xerath,345,194,151,56.23
Yuumi,Riven,204,143,61,70.1
Yuumi,Sejuani,182,77,105,42.31
Yuumi,Syndra,289,152,137,52.6
Yuumi,XinZhao,327,165,162,50.46
Yuumi,KSante,173,104,69,60.12
Yuumi,Tryndamere,317,154,163,48.58
Yuumi,Zilean,96,51,45,53.13
Yuumi,Udyr,215,90,125,41.86
Yuumi,Draven,285,128,157,44.91
Yuumi,Taliyah,121,52,69,42.98
Yuumi,Ambessa,365,187,178,51.23
Yuumi,JarvanIV,218,125,93,57.34
Yuumi,Talon,326,146,180,44.79
Yuumi,Karthus,183,97,86,53.01
Yuumi,Kayle,443,216,227,48.76
Yuumi,RekSai,75,29,46,38.67
Yuumi,Taric,136,77,59,56.62
Yuumi,Rumble,121,61,60,50.41
Yuumi,Ivern,112,66,46,58.93
Aurora,Renekton,294,130,164,44.22
Aurora,Khazix,380,185,195,48.68
Aurora,Mel,1188,569,619,47.9
Aurora,Jhin,998,461,537,46.19
Aurora,Lux,1518,652,866,42.95
Aurora,Leblanc,248,117,131,47.18
Aurora,Briar,597,269,328,45.06
Aurora,Zoe,284,173,111,60.92
Aurora,Jinx,1043,483,560,46.31
Aurora,Poppy,356,178,178,50
Aurora,Ambessa,355,181,174,50.99
Aurora,Rammus,138,83,55,60.14
Aurora,Draven,339,181,158,53.39
Aurora,Blitzcrank,429,250,179,58.28
Aurora,Fiora,322,182,140,56.52
Aurora,FiddleSticks,358,136,222,37.99
Aurora,Syndra,393,186,207,47.33
Aurora,Vayne,563,244,319,43.34
Aurora,Morgana,707,345,362,48.8
Aurora,Nasus,495,176,319,35.56
Aurora,MonkeyKing,305,135,170,44.26
Aurora,Xayah,403,212,191,52.61
Aurora,Zac,176,86,90,48.86
Aurora,Smolder,385,217,168,56.36
Aurora,Warwick,804,423,381,52.61
Aurora,Yasuo,979,484,495,49.44
Aurora,Caitlyn,1313,579,734,44.1
Aurora,Velkoz,370,180,190,48.65
Aurora,Tryndamere,371,157,214,42.32
Aurora,Mordekaiser,927,386,541,41.64
Aurora,MissFortune,1236,615,621,49.76
Aurora,Janna,210,114,96,54.29
Aurora,Gragas,286,151,135,52.8
Aurora,Sylas,550,266,284,48.36
Aurora,Taliyah,82,35,47,42.68
Aurora,Senna,454,169,285,37.22
Aurora,Riven,230,141,89,61.3
Aurora,Sejuani,240,124,116,51.67
Aurora,AurelionSol,249,110,139,44.18
Aurora,Tristana,524,238,286,45.42
Aurora,Rakan,293,120,173,40.96
Aurora,Gwen,375,209,166,55.73
Aurora,Karthus,151,74,77,49.01
Aurora,Yone,1259,630,629,50.04
Aurora,Nilah,348,153,195,43.97
Aurora,Braum,205,70,135,34.15
Aurora,LeeSin,567,266,301,46.91
Aurora,Evelynn,317,175,142,55.21
Aurora,Ezreal,931,479,452,51.45
Aurora,Brand,369,217,152,58.81
Aurora,Volibear,625,302,323,48.32
Aurora,Ivern,115,67,48,58.26
Aurora,Irelia,578,352,226,60.9
Aurora,Swain,652,284,368,43.56
Aurora,Gangplank,195,97,98,49.74
Aurora,Diana,872,380,492,43.58
Aurora,Aphelios,369,219,150,59.35
Aurora,Leona,440,206,234,46.82
Aurora,TwistedFate,170,99,71,58.24
Aurora,Nami,439,230,209,52.39
Aurora,Shen,395,154,241,38.99
Aurora,Ahri,868,390,478,44.93
Aurora,Samira,569,317,252,55.71
Aurora,Maokai,242,102,140,42.15
Aurora,Kayle,385,179,206,46.49
Aurora,Kindred,334,198,136,59.28
Aurora,Veigar,599,266,333,44.41
Aurora,Lulu,481,261,220,54.26
Aurora,Garen,793,370,423,46.66
Aurora,Shyvana,167,66,101,39.52
Aurora,Seraphine,631,289,342,45.8
Aurora,Ziggs,217,83,134,38.25
Aurora,Darius,952,421,531,44.22
Aurora,Corki,206,109,97,52.91
Aurora,Elise,332,223,109,67.17
Aurora,Katarina,469,242,227,51.6
Aurora,Karma,406,217,189,53.45
Aurora,Yorick,451,200,251,44.35
Aurora,Akali,668,338,330,50.6
Aurora,Lissandra,159,86,73,54.09
Aurora,Kayn,765,398,367,52.03
Aurora,KSante,183,105,78,57.38
Aurora,Rengar,276,181,95,65.58
Aurora,Shaco,461,208,253,45.12
Aurora,Galio,525,215,310,40.95
Aurora,Kaisa,832,472,360,56.73
Aurora,Zilean,181,81,100,44.75
Aurora,Aatrox,547,267,280,48.81
Aurora,Varus,402,202,200,50.25
Aurora,RekSai,41,19,22,46.34
Aurora,Jax,450,190,260,42.22
Aurora,Viktor,426,175,251,41.08
Aurora,Sett,894,364,530,40.72
Aurora,Zyra,384,173,211,45.05
Aurora,Ornn,232,112,120,48.28
Aurora,Vi,477,205,272,42.98
Aurora,Anivia,154,84,70,54.55
Aurora,Ashe,1051,543,508,51.67
Aurora,Yuumi,559,272,287,48.66
Aurora,Nidalee,157,87,70,55.41
Aurora,Vex,399,217,182,54.39
Aurora,Sivir,312,146,166,46.79
Aurora,Singed,152,48,104,31.58
Aurora,Pantheon,1030,503,527,48.83
Aurora,Kalista,281,130,151,46.26
Aurora,Kennen,204,102,102,50
Aurora,Nunu,607,307,300,50.58
Aurora,Zed,555,217,338,39.1
Aurora,Heimerdinger,394,172,222,43.65
Aurora,Trundle,243,133,110,54.73
Aurora,Orianna,343,149,194,43.44
Aurora,TahmKench,580,280,300,48.28
Aurora,Hecarim,230,118,112,51.3
Aurora,Kassadin,136,58,78,42.65
Aurora,Amumu,533,249,284,46.72
Aurora,Nautilus,608,293,315,48.19
Aurora,Teemo,818,350,468,42.79
Aurora,Ekko,435,237,198,54.48
Aurora,Lucian,361,200,161,55.4
Aurora,Pyke,671,374,297,55.74
Aurora,Vladimir,335,218,117,65.07
Aurora,Jayce,286,132,154,46.15
Aurora,Fizz,280,176,104,62.86
Aurora,Zeri,259,150,109,57.92
Aurora,Hwei,396,152,244,38.38
Aurora,Malphite,373,160,213,42.9
Aurora,JarvanIV,185,83,102,44.86
Aurora,Milio,387,220,167,56.85
Aurora,XinZhao,301,139,162,46.18
Aurora,Quinn,222,129,93,58.11
Aurora,Akshan,257,116,141,45.14
Aurora,Chogath,780,368,412,47.18
Aurora,MasterYi,660,331,329,50.15
Aurora,Azir,296,161,135,54.39
Aurora,Neeko,457,252,205,55.14
Aurora,Thresh,741,353,388,47.64
Aurora,Camille,222,109,113,49.1
Aurora,Lillia,358,214,144,59.78
Aurora,Renata,109,52,57,47.71
Aurora,Soraka,378,186,192,49.21
Aurora,Cassiopeia,252,124,128,49.21
Aurora,Alistar,136,80,56,58.82
Aurora,Illaoi,248,123,125,49.6
Aurora,Gnar,204,96,108,47.06
Aurora,Udyr,241,119,122,49.38
Aurora,Sion,474,216,258,45.57
Aurora,Talon,338,150,188,44.38
Aurora,Viego,644,334,310,51.86
Aurora,Naafiri,284,156,128,54.93
Aurora,Taric,143,52,91,36.36
Aurora,Rell,329,158,171,48.02
Aurora,Malzahar,469,191,278,40.72
Aurora,DrMundo,405,157,248,38.77
Aurora,Graves,300,177,123,59
Aurora,Skarner,166,85,81,51.2
Aurora,Sona,197,95,102,48.22
Aurora,Urgot,233,111,122,47.64
Aurora,Ryze,188,84,104,44.68
Aurora,Bard,176,88,88,50
Aurora,Qiyana,211,85,126,40.28
Aurora,Twitch,585,245,340,41.88
Aurora,Rumble,105,76,29,72.38
Aurora,Annie,159,61,98,38.36
Aurora,Xerath,324,128,196,39.51
Aurora,KogMaw,193,103,90,53.37
Aurora,Nocturne,516,245,271,47.48
Aurora,Olaf,122,42,80,34.43
Aurora,Belveth,133,78,55,58.65
Aurora,Kled,76,56,20,73.68
Volibear,Renekton,346,125,221,36.13
Volibear,Khazix,418,210,208,50.24
Volibear,Mel,1494,852,642,57.03
Volibear,Jhin,1221,590,631,48.32
Volibear,Lux,1839,943,896,51.28
Volibear,Mordekaiser,1099,553,546,50.32
Volibear,Viego,835,453,382,54.25
Volibear,Kindred,355,224,131,63.1
Volibear,TahmKench,772,442,330,57.25
Volibear,Sett,1129,614,515,54.38
Volibear,Zac,244,140,104,57.38
Volibear,Yasuo,1273,636,637,49.96
Volibear,MissFortune,1515,722,793,47.66
Volibear,Tristana,653,320,333,49
Volibear,Poppy,398,209,189,52.51
Volibear,Veigar,733,395,338,53.89
Volibear,Heimerdinger,369,215,154,58.27
Volibear,Ziggs,326,132,194,40.49
Volibear,Darius,1221,658,563,53.89
Volibear,Samira,611,346,265,56.63
Volibear,Karma,451,238,213,52.77
Volibear,Rammus,173,102,71,58.96
Volibear,Blitzcrank,436,237,199,54.36
Volibear,LeeSin,613,287,326,46.82
Volibear,Irelia,696,393,303,56.47
Volibear,Yuumi,636,347,289,54.56
Volibear,Gnar,248,137,111,55.24
Volibear,Kayn,1090,531,559,48.72
Volibear,Leblanc,255,136,119,53.33
Volibear,Caitlyn,1578,760,818,48.16
Volibear,Sejuani,327,214,113,65.44
Volibear,Rell,378,158,220,41.8
Volibear,Teemo,908,410,498,45.15
Volibear,Trundle,471,220,251,46.71
Volibear,Elise,375,184,191,49.07
Volibear,KSante,278,166,112,59.71
Volibear,Ashe,1047,528,519,50.43
Volibear,Nasus,636,318,318,50
Volibear,Fizz,351,181,170,51.57
Volibear,Azir,277,125,152,45.13
Volibear,Aphelios,417,146,271,35.01
Volibear,Soraka,351,164,187,46.72
Volibear,Aatrox,610,349,261,57.21
Volibear,Sylas,602,269,333,44.68
Volibear,Amumu,633,275,358,43.44
Volibear,Chogath,976,487,489,49.9
Volibear,Twitch,573,330,243,57.59
Volibear,Illaoi,357,168,189,47.06
Volibear,Syndra,303,149,154,49.17
Volibear,Kaisa,961,584,377,60.77
Volibear,Lucian,331,155,176,46.83
Volibear,Seraphine,824,432,392,52.43
Volibear,Jax,563,275,288,48.85
Volibear,JarvanIV,205,105,100,51.22
Volibear,Hwei,492,243,249,49.39
Volibear,Bard,217,116,101,53.46
Volibear,Sion,465,253,212,54.41
Volibear,AurelionSol,229,76,153,33.19
Volibear,Tryndamere,399,213,186,53.38
Volibear,Nidalee,162,101,61,62.35
Volibear,Aurora,625,323,302,51.68
Volibear,Nami,667,345,322,51.72
Volibear,Quinn,153,74,79,48.37
Volibear,Thresh,798,421,377,52.76
Volibear,Diana,968,501,467,51.76
Volibear,MasterYi,581,298,283,51.29
Volibear,Shaco,616,304,312,49.35
Volibear,Rengar,301,178,123,59.14
Volibear,Pyke,776,472,304,60.82
Volibear,Udyr,293,150,143,51.19
Volibear,Warwick,1201,633,568,52.71
Volibear,Leona,484,222,262,45.87
Volibear,Galio,395,182,213,46.08
Volibear,Shen,430,208,222,48.37
Volibear,MonkeyKing,338,161,177,47.63
Volibear,Naafiri,308,170,138,55.19
Volibear,Ezreal,1096,648,448,59.12
Volibear,Varus,545,289,256,53.03
Volibear,Ambessa,392,211,181,53.83
Volibear,Nilah,357,148,209,41.46
Volibear,DrMundo,415,192,223,46.27
Volibear,Pantheon,1054,548,506,51.99
Volibear,Nautilus,666,393,273,59.01
Volibear,Braum,268,102,166,38.06
Volibear,Skarner,270,159,111,58.89
Volibear,Vayne,723,325,398,44.95
Volibear,Malzahar,538,245,293,45.54
Volibear,Draven,371,183,188,49.33
Volibear,Briar,632,293,339,46.36
Volibear,Yone,1311,782,529,59.65
Volibear,Hecarim,228,114,114,50
Volibear,Velkoz,392,195,197,49.74
Volibear,Yorick,582,234,348,40.21
Volibear,KogMaw,251,122,129,48.61
Volibear,Vi,578,266,312,46.02
Volibear,FiddleSticks,325,167,158,51.38
Volibear,Taliyah,172,81,91,47.09
Volibear,Viktor,393,213,180,54.2
Volibear,Ekko,515,304,211,59.03
Volibear,Swain,825,458,367,55.52
Volibear,Garen,1000,491,509,49.1
Volibear,Talon,394,218,176,55.33
Volibear,Zed,672,372,300,55.36
Volibear,Kalista,256,167,89,65.23
Volibear,Nocturne,615,290,325,47.15
Volibear,Malphite,506,245,261,48.42
Volibear,Xayah,392,203,189,51.79
Volibear,Rakan,317,149,168,47
Volibear,Vex,304,156,148,51.32
Volibear,Nunu,590,309,281,52.37
Volibear,Akali,638,354,284,55.49
Volibear,Lillia,527,276,251,52.37
Volibear,Qiyana,227,115,112,50.66
Volibear,Morgana,888,429,459,48.31
Volibear,Lulu,545,270,275,49.54
Volibear,Ryze,150,66,84,44
Volibear,Brand,469,241,228,51.39
Volibear,Gragas,477,220,257,46.12
Volibear,Fiora,295,160,135,54.24
Volibear,XinZhao,357,182,175,50.98
Volibear,Akshan,300,117,183,39
Volibear,Shyvana,222,103,119,46.4
Volibear,Jinx,1270,623,647,49.06
Volibear,Sona,210,114,96,54.29
Volibear,Xerath,558,268,290,48.03
Volibear,Sivir,401,213,188,53.12
Volibear,Ornn,284,150,134,52.82
Volibear,Gangplank,250,133,117,53.2
Volibear,Zeri,334,184,150,55.09
Volibear,Olaf,156,85,71,54.49
Volibear,Senna,601,365,236,60.73
Volibear,Graves,294,167,127,56.8
Volibear,Urgot,286,124,162,43.36
Volibear,Maokai,283,159,124,56.18
Volibear,Alistar,178,81,97,45.51
Volibear,Katarina,599,332,267,55.43
Volibear,Ahri,977,526,451,53.84
Volibear,Milio,313,129,184,41.21
Volibear,Camille,290,166,124,57.24
Volibear,Taric,122,61,61,50
Volibear,Renata,183,92,91,50.27
Volibear,Singed,161,69,92,42.86
Volibear,Anivia,250,116,134,46.4
Volibear,Riven,272,155,117,56.99
Volibear,Vladimir,286,144,142,50.35
Volibear,Kayle,442,214,228,48.42
Volibear,Orianna,260,132,128,50.77
Volibear,Lissandra,127,70,57,55.12
Volibear,Neeko,539,296,243,54.92
Volibear,Corki,241,124,117,51.45
Volibear,Gwen,396,246,150,62.12
Volibear,Zoe,274,171,103,62.41
Volibear,Kassadin,115,54,61,46.96
Volibear,Kled,125,59,66,47.2
Volibear,Evelynn,387,242,145,62.53
Volibear,TwistedFate,188,88,100,46.81
Volibear,Smolder,492,260,232,52.85
Volibear,Cassiopeia,249,112,137,44.98
Volibear,Zyra,415,191,224,46.02
Volibear,Karthus,156,83,73,53.21
Volibear,Jayce,237,117,120,49.37
Volibear,Kennen,148,88,60,59.46
Volibear,RekSai,111,62,49,55.86
Volibear,Annie,193,127,66,65.8
Volibear,Zilean,169,80,89,47.34
Volibear,Belveth,190,77,113,40.53
Volibear,Rumble,80,41,39,51.25
Volibear,Ivern,155,77,78,49.68
Volibear,Janna,249,135,114,54.22
Vayne,Renekton,324,158,166,48.77
Vayne,Khazix,288,151,137,52.43
Vayne,Mel,1355,672,683,49.59
Vayne,Jhin,1152,633,519,54.95
Vayne,Lux,1553,795,758,51.19
Vayne,Teemo,758,342,416,45.12
Vayne,TahmKench,890,500,390,56.18
Vayne,Jinx,1323,570,753,43.08
Vayne,Zoe,331,215,116,64.95
Vayne,Nami,529,275,254,51.98
Vayne,Singed,219,115,104,52.51
Vayne,Graves,301,163,138,54.15
Vayne,Fizz,275,149,126,54.18
Vayne,Ziggs,250,98,152,39.2
Vayne,Pantheon,1036,545,491,52.61
Vayne,Aatrox,522,312,210,59.77
Vayne,Gwen,349,199,150,57.02
Vayne,Syndra,335,168,167,50.15
Vayne,Ashe,1034,519,515,50.19
Vayne,Lulu,488,227,261,46.52
Vayne,Gangplank,220,104,116,47.27
Vayne,Karthus,143,80,63,55.94
Vayne,Aurora,563,319,244,56.66
Vayne,Ezreal,1027,530,497,51.61
Vayne,Senna,514,231,283,44.94
Vayne,Kennen,293,170,123,58.02
Vayne,Kayn,934,510,424,54.6
Vayne,Naafiri,248,109,139,43.95
Vayne,Xayah,439,219,220,49.89
Vayne,Soraka,384,154,230,40.1
Vayne,Mordekaiser,1075,551,524,51.26
Vayne,Ahri,867,434,433,50.06
Vayne,Nunu,471,225,246,47.77
Vayne,Yasuo,1160,591,569,50.95
Vayne,Zyra,309,137,172,44.34
Vayne,Garen,1060,590,470,55.66
Vayne,Zed,564,297,267,52.66
Vayne,Talon,342,158,184,46.2
Vayne,Milio,231,129,102,55.84
Vayne,Fiora,274,133,141,48.54
Vayne,Elise,418,211,207,50.48
Vayne,Yone,1027,503,524,48.98
Vayne,Tristana,521,246,275,47.22
Vayne,Sivir,293,175,118,59.73
Vayne,Katarina,457,226,231,49.45
Vayne,Kayle,417,218,199,52.28
Vayne,Ekko,489,238,251,48.67
Vayne,Irelia,558,303,255,54.3
Vayne,Yuumi,542,278,264,51.29
Vayne,Nasus,528,209,319,39.58
Vayne,Galio,348,176,172,50.57
Vayne,Smolder,506,208,298,41.11
Vayne,JarvanIV,287,115,172,40.07
Vayne,Amumu,567,288,279,50.79
Vayne,Velkoz,431,222,209,51.51
Vayne,Poppy,365,206,159,56.44
Vayne,Warwick,918,453,465,49.35
Vayne,Leona,514,230,284,44.75
Vayne,MissFortune,1278,658,620,51.49
Vayne,Darius,1135,591,544,52.07
Vayne,Sion,516,248,268,48.06
Vayne,Draven,381,225,156,59.06
Vayne,Sett,974,530,444,54.41
Vayne,Volibear,723,398,325,55.05
Vayne,KogMaw,171,62,109,36.26
Vayne,Seraphine,693,318,375,45.89
Vayne,Leblanc,197,95,102,48.22
Vayne,Samira,515,231,284,44.85
Vayne,Shen,411,206,205,50.12
Vayne,KSante,246,142,104,57.72
Vayne,Evelynn,338,182,156,53.85
Vayne,MasterYi,652,405,247,62.12
Vayne,Shaco,505,255,250,50.5
Vayne,Kaisa,970,607,363,62.58
Vayne,Braum,311,154,157,49.52
Vayne,Diana,743,382,361,51.41
Vayne,Briar,692,285,407,41.18
Vayne,Caitlyn,1393,644,749,46.23
Vayne,Akali,589,349,240,59.25
Vayne,Brand,364,192,172,52.75
Vayne,Sona,218,118,100,54.13
Vayne,Illaoi,337,166,171,49.26
Vayne,Vex,345,169,176,48.99
Vayne,Ornn,315,150,165,47.62
Vayne,Nautilus,718,330,388,45.96
Vayne,Orianna,251,136,115,54.18
Vayne,Morgana,792,394,398,49.75
Vayne,Veigar,628,281,347,44.75
Vayne,Rammus,195,90,105,46.15
Vayne,Zeri,221,122,99,55.2
Vayne,Taric,97,56,41,57.73
Vayne,Nilah,350,172,178,49.14
Vayne,Swain,656,293,363,44.66
Vayne,Sylas,565,300,265,53.1
Vayne,Viego,678,350,328,51.62
Vayne,Xerath,422,217,205,51.42
Vayne,Twitch,500,276,224,55.2
Vayne,Jax,448,188,260,41.96
Vayne,DrMundo,425,224,201,52.71
Vayne,Vi,433,250,183,57.74
Vayne,Varus,492,244,248,49.59
Vayne,Kalista,218,112,106,51.38
Vayne,Zilean,121,62,59,51.24
Vayne,MonkeyKing,288,123,165,42.71
Vayne,Lucian,346,186,160,53.76
Vayne,Bard,203,88,115,43.35
Vayne,Rengar,228,127,101,55.7
Vayne,Shyvana,145,62,83,42.76
Vayne,Karma,386,216,170,55.96
Vayne,LeeSin,544,308,236,56.62
Vayne,Cassiopeia,237,106,131,44.73
Vayne,Alistar,238,103,135,43.28
Vayne,Gragas,413,201,212,48.67
Vayne,Maokai,397,200,197,50.38
Vayne,Kled,138,92,46,66.67
Vayne,Kindred,339,152,187,44.84
Vayne,Azir,199,96,103,48.24
Vayne,Neeko,419,236,183,56.32
Vayne,Rakan,381,165,216,43.31
Vayne,Pyke,618,348,270,56.31
Vayne,Ryze,199,107,92,53.77
Vayne,Hwei,483,255,228,52.8
Vayne,FiddleSticks,313,167,146,53.35
Vayne,Malzahar,403,206,197,51.12
Vayne,Vladimir,284,157,127,55.28
Vayne,Sejuani,229,97,132,42.36
Vayne,Viktor,425,234,191,55.06
Vayne,XinZhao,366,195,171,53.28
Vayne,Trundle,405,211,194,52.1
Vayne,Tryndamere,326,153,173,46.93
Vayne,Aphelios,467,229,238,49.04
Vayne,Yorick,637,261,376,40.97
Vayne,Camille,186,111,75,59.68
Vayne,Chogath,868,479,389,55.18
Vayne,Janna,176,82,94,46.59
Vayne,Kassadin,167,70,97,41.92
Vayne,Renata,144,52,92,36.11
Vayne,Belveth,177,92,85,51.98
Vayne,Skarner,181,105,76,58.01
Vayne,Qiyana,283,155,128,54.77
Vayne,Zac,227,112,115,49.34
Vayne,Riven,228,113,115,49.56
Vayne,Lillia,419,218,201,52.03
Vayne,Corki,240,158,82,65.83
Vayne,Malphite,570,278,292,48.77
Vayne,Gnar,217,136,81,62.67
Vayne,AurelionSol,275,133,142,48.36
Vayne,Quinn,198,100,98,50.51
Vayne,Blitzcrank,461,253,208,54.88
Vayne,Nocturne,483,251,232,51.97
Vayne,Heimerdinger,284,125,159,44.01
Vayne,Lissandra,118,64,54,54.24
Vayne,Udyr,227,115,112,50.66
Vayne,Ambessa,376,214,162,56.91
Vayne,Rell,307,145,162,47.23
Vayne,Urgot,257,116,141,45.14
Vayne,Hecarim,200,81,119,40.5
Vayne,Olaf,106,54,52,50.94
Vayne,Akshan,212,109,103,51.42
Vayne,Jayce,259,153,106,59.07
Vayne,Thresh,622,320,302,51.45
Vayne,TwistedFate,210,112,98,53.33
Vayne,Ivern,135,81,54,60
Vayne,Taliyah,205,106,99,51.71
Vayne,Anivia,196,80,116,40.82
Vayne,Annie,176,61,115,34.66
Vayne,Nidalee,132,84,48,63.64
Vayne,Rumble,122,45,77,36.89
Vayne,RekSai,67,40,27,59.7
Khazix,Aurora,380,195,185,51.32
Khazix,Volibear,418,208,210,49.76
Khazix,Yasuo,737,321,416,43.55
Khazix,Vayne,288,137,151,47.57
Khazix,Shaco,349,164,185,46.99
Khazix,Poppy,236,105,131,44.49
Khazix,Diana,486,233,253,47.94
Khazix,Anivia,112,62,50,55.36
Khazix,Caitlyn,878,406,472,46.24
Khazix,Thresh,459,246,213,53.59
Khazix,Garen,586,237,349,40.44
Khazix,FiddleSticks,205,118,87,57.56
Khazix,Lux,1036,485,551,46.81
Khazix,Brand,286,126,160,44.06
Khazix,Darius,574,234,340,40.77
Khazix,Amumu,358,136,222,37.99
Khazix,MissFortune,714,267,447,37.39
Khazix,Swain,368,196,172,53.26
Khazix,Aatrox,386,219,167,56.74
Khazix,Viego,534,252,282,47.19
Khazix,Sylas,341,128,213,37.54
Khazix,Ashe,649,283,366,43.61
Khazix,Blitzcrank,274,130,144,47.45
Khazix,Evelynn,240,126,114,52.5
Khazix,Katarina,405,214,191,52.84
Khazix,Nocturne,327,140,187,42.81
Khazix,Neeko,326,160,166,49.08
Khazix,Sejuani,169,61,108,36.09
Khazix,LeeSin,332,165,167,49.7
Khazix,Irelia,321,165,156,51.4
Khazix,Twitch,370,172,198,46.49
Khazix,Pyke,462,203,259,43.94
Khazix,Sion,315,124,191,39.37
Khazix,Ezreal,669,351,318,52.47
Khazix,Zilean,133,73,60,54.89
Khazix,Belveth,75,39,36,52
Khazix,Hwei,341,143,198,41.94
Khazix,Jinx,719,292,427,40.61
Khazix,TahmKench,358,146,212,40.78
Khazix,Jax,253,78,175,30.83
Khazix,Cassiopeia,133,74,59,55.64
Khazix,Milio,206,85,121,41.26
Khazix,Ambessa,182,104,78,57.14
Khazix,Rammus,113,36,77,31.86
Khazix,Kled,73,28,45,38.36
Khazix,Kayn,636,335,301,52.67
Khazix,AurelionSol,138,70,68,50.72
Khazix,Tristana,347,183,164,52.74
Khazix,Ekko,291,127,164,43.64
Khazix,Pantheon,621,305,316,49.11
Khazix,Azir,130,62,68,47.69
Khazix,Ziggs,125,60,65,48
Khazix,Lulu,262,110,152,41.98
Khazix,KSante,158,86,72,54.43
Khazix,Riven,198,104,94,52.53
Khazix,Jhin,754,384,370,50.93
Khazix,Yuumi,323,159,164,49.23
Khazix,Sett,579,268,311,46.29
Khazix,Rengar,232,109,123,46.98
Khazix,Kennen,140,72,68,51.43
Khazix,Morgana,538,194,344,36.06
Khazix,Warwick,633,263,370,41.55
Khazix,Kaisa,552,305,247,55.25
Khazix,Jayce,145,72,73,49.66
Khazix,Senna,312,166,146,53.21
Khazix,Chogath,425,188,237,44.24
Khazix,Galio,231,85,146,36.8
Khazix,Shen,259,121,138,46.72
Khazix,Aphelios,273,156,117,57.14
Khazix,Illaoi,180,88,92,48.89
Khazix,Taliyah,84,25,59,29.76
Khazix,Sivir,175,84,91,48
Khazix,Velkoz,231,111,120,48.05
Khazix,Mordekaiser,639,306,333,47.89
Khazix,Akali,332,181,151,54.52
Khazix,Seraphine,403,204,199,50.62
Khazix,Briar,400,187,213,46.75
Khazix,Janna,131,61,70,46.56
Khazix,Gangplank,148,69,79,46.62
Khazix,Qiyana,123,68,55,55.28
Khazix,Zoe,212,119,93,56.13
Khazix,Sona,172,81,91,47.09
Khazix,Fizz,210,106,104,50.48
Khazix,Samira,414,178,236,43
Khazix,Ornn,124,45,79,36.29
Khazix,Ivern,57,34,23,59.65
Khazix,Nilah,207,97,110,46.86
Khazix,Teemo,539,224,315,41.56
Khazix,Camille,124,55,69,44.35
Khazix,Leblanc,140,56,84,40
Khazix,Singed,143,47,96,32.87
Khazix,XinZhao,184,98,86,53.26
Khazix,Yorick,294,85,209,28.91
Khazix,KogMaw,94,50,44,53.19
Khazix,Nautilus,296,101,195,34.12
Khazix,DrMundo,253,112,141,44.27
Khazix,Nasus,277,114,163,41.16
Khazix,Mel,764,358,406,46.86
Khazix,Vladimir,151,58,93,38.41
Khazix,MasterYi,417,165,252,39.57
Khazix,Lucian,184,104,80,56.52
Khazix,Maokai,153,68,85,44.44
Khazix,Rakan,210,87,123,41.43
Khazix,Renekton,161,90,71,55.9
Khazix,Veigar,395,176,219,44.56
Khazix,Ahri,524,235,289,44.85
Khazix,Talon,208,96,112,46.15
Khazix,Yone,753,364,389,48.34
Khazix,Zac,167,68,99,40.72
Khazix,Hecarim,123,71,52,57.72
Khazix,Renata,75,19,56,25.33
Khazix,Zed,325,192,133,59.08
Khazix,Trundle,240,117,123,48.75
Khazix,Xayah,222,76,146,34.23
Khazix,Lillia,300,157,143,52.33
Khazix,Vex,208,85,123,40.87
Khazix,Karma,279,135,144,48.39
Khazix,Gnar,177,92,85,51.98
Khazix,Vi,329,153,176,46.5
Khazix,Zeri,191,82,109,42.93
Khazix,Kayle,290,112,178,38.62
Khazix,Varus,287,135,152,47.04
Khazix,Malphite,243,106,137,43.62
Khazix,Udyr,99,73,26,73.74
Khazix,Bard,89,32,57,35.96
Khazix,Zyra,259,125,134,48.26
Khazix,Urgot,162,45,117,27.78
Khazix,JarvanIV,148,59,89,39.86
Khazix,MonkeyKing,287,100,187,34.84
Khazix,Nami,408,196,212,48.04
Khazix,Heimerdinger,199,79,120,39.7
Khazix,Nunu,280,150,130,53.57
Khazix,Gwen,186,96,90,51.61
Khazix,Naafiri,147,53,94,36.05
Khazix,Braum,150,77,73,51.33
Khazix,Ryze,67,42,25,62.69
Khazix,Draven,221,100,121,45.25
Khazix,Smolder,293,132,161,45.05
Khazix,Lissandra,95,39,56,41.05
Khazix,Rell,194,125,69,64.43
Khazix,Gragas,215,114,101,53.02
Khazix,Leona,232,79,153,34.05
Khazix,Orianna,216,96,120,44.44
Khazix,Corki,137,67,70,48.91
Khazix,Shyvana,106,24,82,22.64
Khazix,Soraka,158,95,63,60.13
Khazix,TwistedFate,129,66,63,51.16
Khazix,Annie,135,82,53,60.74
Khazix,Kassadin,44,6,38,13.64
Khazix,Graves,194,117,77,60.31
Khazix,Quinn,121,76,45,62.81
Khazix,Skarner,135,51,84,37.78
Khazix,Kalista,129,65,64,50.39
Khazix,Elise,243,131,112,53.91
Khazix,Viktor,326,141,185,43.25
Khazix,Nidalee,77,42,35,54.55
Khazix,Xerath,205,83,122,40.49
Khazix,Syndra,182,74,108,40.66
Khazix,Fiora,210,84,126,40
Khazix,Karthus,92,57,35,61.96
Khazix,Malzahar,266,115,151,43.23
Khazix,Alistar,101,40,61,39.6
Khazix,Kindred,213,112,101,52.58
Khazix,Olaf,66,25,41,37.88
Khazix,Akshan,115,46,69,40
Khazix,Taric,65,8,57,12.31
Khazix,Rumble,61,40,21,65.57
Khazix,Tryndamere,215,115,100,53.49
Khazix,RekSai,38,28,10,73.68
Chogath,Gwen,616,349,267,56.66
Chogath,Vi,719,352,367,48.96
Chogath,Zed,672,374,298,55.65
Chogath,Jhin,1475,677,798,45.9
Chogath,Soraka,491,279,212,56.82
Chogath,Sett,1479,615,864,41.58
Chogath,AurelionSol,418,186,232,44.5
Chogath,Corki,194,110,84,56.7
Chogath,Milio,375,164,211,43.73
Chogath,Zac,325,198,127,60.92
Chogath,Yasuo,1500,841,659,56.07
Chogath,MissFortune,1690,759,931,44.91
Chogath,Lux,2166,1010,1156,46.63
Chogath,Darius,1549,780,769,50.36
Chogath,Viego,850,417,433,49.06
Chogath,Nautilus,833,428,405,51.38
Chogath,Garen,1260,659,601,52.3
Chogath,Malzahar,657,296,361,45.05
Chogath,Seraphine,786,418,368,53.18
Chogath,Zilean,208,99,109,47.6
Chogath,Olaf,188,94,94,50
Chogath,LeeSin,854,489,365,57.26
Chogath,Diana,1078,596,482,55.29
Chogath,Karma,506,256,250,50.59
Chogath,Teemo,1197,656,541,54.8
Chogath,Poppy,361,215,146,59.56
Chogath,Akali,876,534,342,60.96
Chogath,Caitlyn,1842,1016,826,55.16
Chogath,Leona,693,368,325,53.1
Chogath,Tryndamere,394,205,189,52.03
Chogath,Velkoz,482,230,252,47.72
Chogath,Zeri,351,207,144,58.97
Chogath,Thresh,1068,530,538,49.63
Chogath,Ivern,209,111,98,53.11
Chogath,Neeko,572,312,260,54.55
Chogath,Senna,739,331,408,44.79
Chogath,Yorick,827,427,400,51.63
Chogath,Volibear,976,489,487,50.1
Chogath,Cassiopeia,302,172,130,56.95
Chogath,Rell,388,203,185,52.32
Chogath,Rammus,183,116,67,63.39
Chogath,Jinx,1623,717,906,44.18
Chogath,TahmKench,1003,513,490,51.15
Chogath,DrMundo,576,243,333,42.19
Chogath,Trundle,455,216,239,47.47
Chogath,Ahri,1090,532,558,48.81
Chogath,Ashe,1381,765,616,55.39
Chogath,Nami,806,412,394,51.12
Chogath,Camille,202,100,102,49.5
Chogath,Pantheon,1379,731,648,53.01
Chogath,Xayah,512,288,224,56.25
Chogath,Yuumi,688,331,357,48.11
Chogath,Warwick,1326,626,700,47.21
Chogath,Irelia,594,304,290,51.18
Chogath,Samira,704,441,263,62.64
Chogath,Malphite,521,310,211,59.5
Chogath,MonkeyKing,363,204,159,56.2
Chogath,Sylas,913,433,480,47.43
Chogath,Swain,929,433,496,46.61
Chogath,Fiora,430,227,203,52.79
Chogath,Amumu,787,352,435,44.73
Chogath,Vladimir,439,188,251,42.82
Chogath,Varus,617,337,280,54.62
Chogath,Janna,295,150,145,50.85
Chogath,Graves,391,228,163,58.31
Chogath,Kassadin,146,71,75,48.63
Chogath,Kalista,375,215,160,57.33
Chogath,Maokai,336,174,162,51.79
Chogath,Shaco,679,378,301,55.67
Chogath,Viktor,505,236,269,46.73
Chogath,Mordekaiser,1248,529,719,42.39
Chogath,Morgana,1038,541,497,52.12
Chogath,Kaisa,1071,500,571,46.69
Chogath,Qiyana,245,126,119,51.43
Chogath,Mel,1881,964,917,51.25
Chogath,KSante,261,149,112,57.09
Chogath,Azir,339,188,151,55.46
Chogath,Pyke,811,484,327,59.68
Chogath,Veigar,926,472,454,50.97
Chogath,Ekko,677,378,299,55.83
Chogath,Lucian,406,189,217,46.55
Chogath,XinZhao,469,256,213,54.58
Chogath,Leblanc,267,154,113,57.68
Chogath,Aatrox,712,366,346,51.4
Chogath,Ryze,255,116,139,45.49
Chogath,Jax,650,362,288,55.69
Chogath,Galio,508,270,238,53.15
Chogath,Yone,1595,793,802,49.72
Chogath,Urgot,397,171,226,43.07
Chogath,Lillia,587,234,353,39.86
Chogath,Lulu,628,334,294,53.18
Chogath,Briar,733,352,381,48.02
Chogath,Ambessa,373,177,196,47.45
Chogath,Elise,601,362,239,60.23
Chogath,Shen,474,243,231,51.27
Chogath,Brand,551,291,260,52.81
Chogath,FiddleSticks,375,203,172,54.13
Chogath,Braum,402,181,221,45.02
Chogath,Aphelios,506,233,273,46.05
Chogath,Kayle,597,252,345,42.21
Chogath,Khazix,425,237,188,55.76
Chogath,Blitzcrank,603,337,266,55.89
Chogath,Nilah,358,195,163,54.47
Chogath,Kled,179,87,92,48.6
Chogath,Vex,552,306,246,55.43
Chogath,Nocturne,575,263,312,45.74
Chogath,Draven,393,215,178,54.71
Chogath,Riven,326,192,134,58.9
Chogath,Twitch,680,405,275,59.56
Chogath,Skarner,283,101,182,35.69
Chogath,Aurora,780,412,368,52.82
Chogath,KogMaw,284,157,127,55.28
Chogath,MasterYi,864,438,426,50.69
Chogath,Orianna,273,141,132,51.65
Chogath,Rengar,319,251,68,78.68
Chogath,Smolder,720,380,340,52.78
Chogath,Kayn,1178,528,650,44.82
Chogath,Talon,506,280,226,55.34
Chogath,Ezreal,1286,673,613,52.33
Chogath,Katarina,577,340,237,58.93
Chogath,RekSai,103,66,37,64.08
Chogath,Ziggs,363,167,196,46.01
Chogath,Nasus,536,262,274,48.88
Chogath,Evelynn,437,254,183,58.12
Chogath,Zyra,442,192,250,43.44
Chogath,Hecarim,291,118,173,40.55
Chogath,Illaoi,427,220,207,51.52
Chogath,Zoe,319,186,133,58.31
Chogath,Hwei,548,254,294,46.35
Chogath,Shyvana,156,75,81,48.08
Chogath,Nunu,550,323,227,58.73
Chogath,Nidalee,189,126,63,66.67
Chogath,Tristana,724,331,393,45.72
Chogath,Fizz,338,132,206,39.05
Chogath,Lissandra,206,110,96,53.4
Chogath,Gragas,424,213,211,50.24
Chogath,Sivir,356,183,173,51.4
Chogath,Syndra,399,228,171,57.14
Chogath,Gangplank,294,126,168,42.86
Chogath,Vayne,868,389,479,44.82
Chogath,Heimerdinger,450,224,226,49.78
Chogath,Sejuani,267,131,136,49.06
Chogath,Kennen,374,175,199,46.79
Chogath,Rumble,127,63,64,49.61
Chogath,Udyr,319,160,159,50.16
Chogath,Alistar,228,115,113,50.44
Chogath,Rakan,441,220,221,49.89
Chogath,Sona,272,133,139,48.9
Chogath,Singed,218,108,110,49.54
Chogath,Kindred,348,200,148,57.47
Chogath,Anivia,230,95,135,41.3
Chogath,Karthus,208,118,90,56.73
Chogath,Taliyah,196,87,109,44.39
Chogath,Gnar,342,157,185,45.91
Chogath,Quinn,267,107,160,40.07
Chogath,Belveth,235,91,144,38.72
Chogath,Renata,174,96,78,55.17
Chogath,JarvanIV,360,152,208,42.22
Chogath,Naafiri,410,202,208,49.27
Chogath,Ornn,399,163,236,40.85
Chogath,Sion,653,353,300,54.06
Chogath,Renekton,314,159,155,50.64
Chogath,TwistedFate,287,147,140,51.22
Chogath,Bard,303,141,162,46.53
Chogath,Annie,231,136,95,58.87
Chogath,Xerath,464,234,230,50.43
Chogath,Akshan,323,114,209,35.29
Chogath,Jayce,323,174,149,53.87
Chogath,Taric,234,79,155,33.76
Gangplank,Gwen,154,82,72,53.25
Gangplank,Vi,219,107,112,48.86
Gangplank,Zed,207,101,106,48.79
Gangplank,Jhin,433,245,188,56.58
Gangplank,Soraka,156,88,68,56.41
Gangplank,Garen,319,125,194,39.18
Gangplank,Briar,297,116,181,39.06
Gangplank,Caitlyn,668,327,341,48.95
Gangplank,Morgana,324,156,168,48.15
Gangplank,DrMundo,150,68,82,45.33
Gangplank,Lillia,124,86,38,69.35
Gangplank,Viktor,152,95,57,62.5
Gangplank,Pyke,267,129,138,48.31
Gangplank,Yorick,194,82,112,42.27
Gangplank,FiddleSticks,133,45,88,33.83
Gangplank,Draven,193,74,119,38.34
Gangplank,Smolder,165,97,68,58.79
Gangplank,Nautilus,247,119,128,48.18
Gangplank,TahmKench,207,96,111,46.38
Gangplank,Malphite,198,80,118,40.4
Gangplank,Yasuo,492,251,241,51.02
Gangplank,Aphelios,140,77,63,55
Gangplank,TwistedFate,159,62,97,38.99
Gangplank,LeeSin,305,158,147,51.8
Gangplank,Yone,431,204,227,47.33
Gangplank,MissFortune,449,212,237,47.22
Gangplank,Mel,488,199,289,40.78
Gangplank,Riven,125,71,54,56.8
Gangplank,Kayn,368,165,203,44.84
Gangplank,Ahri,366,190,176,51.91
Gangplank,Jinx,566,309,257,54.59
Gangplank,Irelia,230,118,112,51.3
Gangplank,Pantheon,363,163,200,44.9
Gangplank,Kassadin,49,26,23,53.06
Gangplank,Yuumi,260,129,131,49.62
Gangplank,Fiora,128,45,83,35.16
Gangplank,Syndra,137,63,74,45.99
Gangplank,Vayne,220,116,104,52.73
Gangplank,Mordekaiser,298,122,176,40.94
Gangplank,Warwick,292,103,189,35.27
Gangplank,Akali,215,121,94,56.28
Gangplank,Velkoz,213,97,116,45.54
Gangplank,Vladimir,150,54,96,36
Gangplank,Diana,314,157,157,50
Gangplank,Karma,246,110,136,44.72
Gangplank,Shen,222,106,116,47.75
Gangplank,Teemo,384,181,203,47.14
Gangplank,Twitch,209,97,112,46.41
Gangplank,Ornn,129,71,58,55.04
Gangplank,Amumu,247,94,153,38.06
Gangplank,Katarina,259,161,98,62.16
Gangplank,Senna,252,100,152,39.68
Gangplank,Graves,172,78,94,45.35
Gangplank,Aurora,195,98,97,50.26
Gangplank,Nilah,144,77,67,53.47
Gangplank,Hwei,144,80,64,55.56
Gangplank,Olaf,47,22,25,46.81
Gangplank,Aatrox,248,134,114,54.03
Gangplank,Braum,102,64,38,62.75
Gangplank,Varus,230,92,138,40
Gangplank,Janna,113,61,52,53.98
Gangplank,Gnar,119,69,50,57.98
Gangplank,Shaco,270,150,120,55.56
Gangplank,Xayah,169,68,101,40.24
Gangplank,Seraphine,249,132,117,53.01
Gangplank,Darius,513,261,252,50.88
Gangplank,XinZhao,122,52,70,42.62
Gangplank,Zeri,102,41,61,40.2
Gangplank,Taric,58,17,41,29.31
Gangplank,Rengar,71,37,34,52.11
Gangplank,Thresh,327,124,203,37.92
Gangplank,Kalista,121,72,49,59.5
Gangplank,Nasus,221,140,81,63.35
Gangplank,Jayce,132,51,81,38.64
Gangplank,JarvanIV,96,38,58,39.58
Gangplank,Poppy,138,43,95,31.16
Gangplank,Gragas,214,104,110,48.6
Gangplank,Annie,91,55,36,60.44
Gangplank,Ekko,190,95,95,50
Gangplank,Akshan,124,64,60,51.61
Gangplank,Nami,238,118,120,49.58
Gangplank,Veigar,245,123,122,50.2
Gangplank,Malzahar,246,107,139,43.5
Gangplank,Camille,93,62,31,66.67
Gangplank,Evelynn,114,62,52,54.39
Gangplank,Taliyah,87,37,50,42.53
Gangplank,Sett,358,127,231,35.47
Gangplank,Ashe,410,196,214,47.8
Gangplank,Viego,322,183,139,56.83
Gangplank,Khazix,148,79,69,53.38
Gangplank,Nocturne,195,75,120,38.46
Gangplank,Xerath,201,103,98,51.24
Gangplank,Lux,577,337,240,58.41
Gangplank,Sona,99,42,57,42.42
Gangplank,Renekton,113,62,51,54.87
Gangplank,Leblanc,97,54,43,55.67
Gangplank,MonkeyKing,115,44,71,38.26
Gangplank,Jax,268,109,159,40.67
Gangplank,Talon,162,73,89,45.06
Gangplank,Volibear,250,117,133,46.8
Gangplank,Singed,81,50,31,61.73
Gangplank,Sejuani,100,44,56,44
Gangplank,Sylas,262,150,112,57.25
Gangplank,Illaoi,121,55,66,45.45
Gangplank,Belveth,88,44,44,50
Gangplank,Orianna,89,43,46,48.31
Gangplank,Alistar,104,51,53,49.04
Gangplank,Nidalee,41,27,14,65.85
Gangplank,Ziggs,98,45,53,45.92
Gangplank,Blitzcrank,225,103,122,45.78
Gangplank,Kled,42,17,25,40.48
Gangplank,MasterYi,231,98,133,42.42
Gangplank,Zyra,149,68,81,45.64
Gangplank,Kaisa,337,164,173,48.66
Gangplank,Urgot,139,52,87,37.41
Gangplank,Swain,277,118,159,42.6
Gangplank,Rammus,79,23,56,29.11
Gangplank,Zilean,60,32,28,53.33
Gangplank,Hecarim,68,31,37,45.59
Gangplank,Milio,178,77,101,43.26
Gangplank,Kayle,193,73,120,37.82
Gangplank,Chogath,294,168,126,57.14
Gangplank,Vex,109,38,71,34.86
Gangplank,Skarner,76,43,33,56.58
Gangplank,Renata,71,30,41,42.25
Gangplank,Zac,97,42,55,43.3
Gangplank,Rell,106,85,21,80.19
Gangplank,Leona,156,98,58,62.82
Gangplank,Tryndamere,120,75,45,62.5
Gangplank,Sivir,105,32,73,30.48
Gangplank,Rumble,48,31,17,64.58
Gangplank,Ivern,42,30,12,71.43
Gangplank,Ryze,65,35,30,53.85
Gangplank,Shyvana,100,56,44,56
Gangplank,Elise,204,112,92,54.9
Gangplank,Rakan,107,54,53,50.47
Gangplank,Kennen,108,55,53,50.93
Gangplank,Ezreal,439,219,220,49.89
Gangplank,Qiyana,132,76,56,57.58
Gangplank,Lulu,204,115,89,56.37
Gangplank,Sion,256,100,156,39.06
Gangplank,KSante,73,35,38,47.95
Gangplank,Tristana,267,94,173,35.21
Gangplank,Fizz,108,55,53,50.93
Gangplank,Lucian,165,94,71,56.97
Gangplank,Galio,141,55,86,39.01
Gangplank,Neeko,186,81,105,43.55
Gangplank,Quinn,82,45,37,54.88
Gangplank,Kindred,103,33,70,32.04
Gangplank,Zoe,124,83,41,66.94
Gangplank,Cassiopeia,107,43,64,40.19
Gangplank,Azir,108,52,56,48.15
Gangplank,Brand,117,40,77,34.19
Gangplank,Naafiri,117,42,75,35.9
Gangplank,Samira,255,109,146,42.75
Gangplank,Ambessa,128,80,48,62.5
Gangplank,Lissandra,72,44,28,61.11
Gangplank,Anivia,90,38,52,42.22
Gangplank,Maokai,89,57,32,64.04
Gangplank,Nunu,170,90,80,52.94
Gangplank,Corki,57,25,32,43.86
Gangplank,Trundle,117,55,62,47.01
Gangplank,Udyr,103,57,46,55.34
Gangplank,Bard,92,52,40,56.52
Gangplank,Heimerdinger,140,72,68,51.43
Gangplank,Karthus,54,29,25,53.7
Gangplank,AurelionSol,98,31,67,31.63
Gangplank,KogMaw,39,20,19,51.28
Gangplank,RekSai,59,11,48,18.64
Gwen,Chogath,616,267,349,43.34
Gwen,Kayn,519,245,274,47.21
Gwen,Gangplank,154,72,82,46.75
Gwen,Ezreal,622,312,310,50.16
Gwen,Hwei,301,139,162,46.18
Gwen,Jax,278,95,183,34.17
Gwen,Nidalee,109,50,59,45.87
Gwen,Ahri,590,301,289,51.02
Gwen,Jhin,624,279,345,44.71
Gwen,Senna,350,148,202,42.29
Gwen,Sett,713,277,436,38.85
Gwen,Taliyah,88,34,54,38.64
Gwen,Cassiopeia,157,82,75,52.23
Gwen,Kaisa,602,311,291,51.66
Gwen,Neeko,283,126,157,44.52
Gwen,Irelia,365,176,189,48.22
Gwen,Diana,575,248,327,43.13
Gwen,Lux,885,387,498,43.73
Gwen,Tristana,386,181,205,46.89
Gwen,Mel,813,414,399,50.92
Gwen,XinZhao,209,92,117,44.02
Gwen,Katarina,413,200,213,48.43
Gwen,Teemo,510,204,306,40
Gwen,Vayne,349,150,199,42.98
Gwen,TwistedFate,126,44,82,34.92
Gwen,Riven,235,137,98,58.3
Gwen,Nocturne,287,145,142,50.52
Gwen,Zoe,207,103,104,49.76
Gwen,Jinx,839,386,453,46.01
Gwen,Lulu,241,123,118,51.04
Gwen,Camille,95,51,44,53.68
Gwen,Warwick,704,312,392,44.32
Gwen,MissFortune,845,389,456,46.04
Gwen,Zyra,177,88,89,49.72
Gwen,LeeSin,319,179,140,56.11
Gwen,Lucian,275,138,137,50.18
Gwen,Xerath,253,105,148,41.5
Gwen,Elise,254,139,115,54.72
Gwen,Galio,317,156,161,49.21
Gwen,Twitch,368,169,199,45.92
Gwen,Soraka,295,148,147,50.17
Gwen,Illaoi,250,101,149,40.4
Gwen,Aurora,375,166,209,44.27
Gwen,Vi,397,141,256,35.52
Gwen,Briar,343,174,169,50.73
Gwen,Janna,138,37,101,26.81
Gwen,Gnar,126,54,72,42.86
Gwen,Yasuo,609,312,297,51.23
Gwen,Zeri,152,57,95,37.5
Gwen,Taric,89,37,52,41.57
Gwen,Ambessa,255,119,136,46.67
Gwen,Sejuani,124,51,73,41.13
Gwen,Veigar,403,145,258,35.98
Gwen,Nilah,190,101,89,53.16
Gwen,Karma,218,115,103,52.75
Gwen,Lillia,227,101,126,44.49
Gwen,Pyke,465,258,207,55.48
Gwen,Viego,407,207,200,50.86
Gwen,Mordekaiser,649,297,352,45.76
Gwen,Akali,392,167,225,42.6
Gwen,Sylas,321,151,170,47.04
Gwen,Draven,211,105,106,49.76
Gwen,Velkoz,228,115,113,50.44
Gwen,KSante,179,83,96,46.37
Gwen,Belveth,137,56,81,40.88
Gwen,Yuumi,417,207,210,49.64
Gwen,Rengar,177,104,73,58.76
Gwen,Ashe,672,306,366,45.54
Gwen,Kennen,134,98,36,73.13
Gwen,Shaco,285,114,171,40
Gwen,Brand,274,102,172,37.23
Gwen,Sona,155,81,74,52.26
Gwen,FiddleSticks,190,78,112,41.05
Gwen,Yone,695,327,368,47.05
Gwen,Caitlyn,793,344,449,43.38
Gwen,Tryndamere,222,121,101,54.5
Gwen,Zed,256,119,137,46.48
Gwen,Blitzcrank,286,135,151,47.2
Gwen,Garen,581,216,365,37.18
Gwen,Trundle,181,69,112,38.12
Gwen,Samira,370,187,183,50.54
Gwen,Heimerdinger,193,70,123,36.27
Gwen,Alistar,123,60,63,48.78
Gwen,Orianna,159,75,84,47.17
Gwen,Pantheon,573,302,271,52.71
Gwen,AurelionSol,197,73,124,37.06
Gwen,MasterYi,366,161,205,43.99
Gwen,Fizz,232,86,146,37.07
Gwen,Nami,355,160,195,45.07
Gwen,Malzahar,298,134,164,44.97
Gwen,Seraphine,447,188,259,42.06
Gwen,Rammus,147,77,70,52.38
Gwen,Aatrox,287,136,151,47.39
Gwen,Leona,340,168,172,49.41
Gwen,Nasus,287,143,144,49.83
Gwen,Xayah,239,97,142,40.59
Gwen,Rakan,251,48,203,19.12
Gwen,Morgana,678,255,423,37.61
Gwen,Jayce,106,63,43,59.43
Gwen,Zilean,81,47,34,58.02
Gwen,Graves,193,80,113,41.45
Gwen,Hecarim,112,58,54,51.79
Gwen,Nautilus,429,203,226,47.32
Gwen,Nunu,376,207,169,55.05
Gwen,Darius,664,335,329,50.45
Gwen,Yorick,413,132,281,31.96
Gwen,Zac,162,61,101,37.65
Gwen,Malphite,337,150,187,44.51
Gwen,Evelynn,162,72,90,44.44
Gwen,Sion,407,188,219,46.19
Gwen,Ekko,344,176,168,51.16
Gwen,Varus,296,150,146,50.68
Gwen,Leblanc,132,72,60,54.55
Gwen,Vladimir,202,85,117,42.08
Gwen,Ivern,78,31,47,39.74
Gwen,Smolder,294,141,153,47.96
Gwen,Milio,218,115,103,52.75
Gwen,Renekton,186,83,103,44.62
Gwen,Karthus,101,52,49,51.49
Gwen,Braum,166,69,97,41.57
Gwen,Fiora,256,142,114,55.47
Gwen,Corki,78,28,50,35.9
Gwen,Khazix,186,90,96,48.39
Gwen,TahmKench,470,206,264,43.83
Gwen,Amumu,420,203,217,48.33
Gwen,Volibear,396,150,246,37.88
Gwen,Gragas,248,93,155,37.5
Gwen,Naafiri,208,83,125,39.9
Gwen,Akshan,165,83,82,50.3
Gwen,Aphelios,226,102,124,45.13
Gwen,Sivir,154,56,98,36.36
Gwen,Qiyana,169,78,91,46.15
Gwen,Annie,97,58,39,59.79
Gwen,JarvanIV,132,44,88,33.33
Gwen,Ziggs,143,62,81,43.36
Gwen,Shyvana,111,63,48,56.76
Gwen,Ryze,96,47,49,48.96
Gwen,Rell,194,93,101,47.94
Gwen,Talon,162,85,77,52.47
Gwen,Thresh,460,166,294,36.09
Gwen,Azir,138,72,66,52.17
Gwen,Shen,300,127,173,42.33
Gwen,MonkeyKing,182,77,105,42.31
Gwen,Singed,106,39,67,36.79
Gwen,DrMundo,237,133,104,56.12
Gwen,Kayle,288,135,153,46.88
Gwen,Swain,295,145,150,49.15
Gwen,Maokai,131,47,84,35.88
Gwen,Anivia,131,47,84,35.88
Gwen,Renata,92,37,55,40.22
Gwen,Urgot,192,127,65,66.15
Gwen,Kassadin,68,19,49,27.94
Gwen,Syndra,150,78,72,52
Gwen,Ornn,125,46,79,36.8
Gwen,Udyr,149,51,98,34.23
Gwen,Lissandra,94,49,45,52.13
Gwen,Vex,196,101,95,51.53
Gwen,RekSai,39,27,12,69.23
Gwen,Kindred,231,127,104,54.98
Gwen,Quinn,167,54,113,32.34
Gwen,Bard,143,74,69,51.75
Gwen,Viktor,245,116,129,47.35
Gwen,Rumble,68,21,47,30.88
Gwen,KogMaw,164,85,79,51.83
Gwen,Kalista,142,57,85,40.14
Gwen,Poppy,242,72,170,29.75
Gwen,Skarner,79,28,51,35.44
Gwen,Olaf,72,43,29,59.72
Gwen,Kled,86,31,55,36.05
Vi,Chogath,719,367,352,51.04
Vi,Kayn,872,432,440,49.54
Vi,Gangplank,219,112,107,51.14
Vi,Ezreal,894,517,377,57.83
Vi,Hwei,431,239,192,55.45
Vi,Braum,249,134,115,53.82
Vi,XinZhao,265,109,156,41.13
Vi,Lux,1231,603,628,48.98
Vi,Taliyah,177,101,76,57.06
Vi,Yorick,278,111,167,39.93
Vi,Seraphine,429,190,239,44.29
Vi,Sivir,219,81,138,36.99
Vi,Xerath,373,168,205,45.04
Vi,KSante,203,93,110,45.81
Vi,Warwick,881,413,468,46.88
Vi,Diana,725,302,423,41.66
Vi,Ashe,751,411,340,54.73
Vi,Corki,152,89,63,58.55
Vi,Akali,464,224,240,48.28
Vi,Akshan,212,120,92,56.6
Vi,TahmKench,548,273,275,49.82
Vi,Urgot,243,107,136,44.03
Vi,LeeSin,577,342,235,59.27
Vi,TwistedFate,177,90,87,50.85
Vi,Yasuo,1015,517,498,50.94
Vi,Rakan,259,152,107,58.69
Vi,Kennen,192,109,83,56.77
Vi,Kaisa,642,356,286,55.45
Vi,Caitlyn,1272,672,600,52.83
Vi,Malphite,395,204,191,51.65
Vi,Vex,318,182,136,57.23
Vi,Twitch,351,217,134,61.82
Vi,Yuumi,501,230,271,45.91
Vi,Gwen,397,256,141,64.48
Vi,Udyr,194,101,93,52.06
Vi,Orianna,241,127,114,52.7
Vi,Nautilus,528,314,214,59.47
Vi,Darius,914,447,467,48.91
Vi,Zed,498,294,204,59.04
Vi,Syndra,272,105,167,38.6
Vi,Senna,459,154,305,33.55
Vi,Sejuani,152,81,71,53.29
Vi,Heimerdinger,276,91,185,32.97
Vi,Jinx,1018,513,505,50.39
Vi,Zilean,134,45,89,33.58
Vi,Garen,800,402,398,50.25
Vi,Aurora,477,272,205,57.02
Vi,MissFortune,1103,466,637,42.25
Vi,Rell,278,134,144,48.2
Vi,Fiora,231,152,79,65.8
Vi,Sylas,431,194,237,45.01
Vi,Ornn,251,125,126,49.8
Vi,Shaco,512,286,226,55.86
Vi,Annie,120,73,47,60.83
Vi,Volibear,578,312,266,53.98
Vi,Teemo,644,267,377,41.46
Vi,Tristana,454,215,239,47.36
Vi,Thresh,714,350,364,49.02
Vi,Yone,978,512,466,52.35
Vi,Rengar,180,110,70,61.11
Vi,KogMaw,202,109,93,53.96
Vi,Zoe,273,175,98,64.1
Vi,Anivia,129,80,49,62.02
Vi,JarvanIV,211,104,107,49.29
Vi,Katarina,382,235,147,61.52
Vi,Aatrox,473,224,249,47.36
Vi,FiddleSticks,229,131,98,57.21
Vi,Jayce,233,93,140,39.91
Vi,Gragas,323,180,143,55.73
Vi,Hecarim,196,119,77,60.71
Vi,Jhin,865,408,457,47.17
Vi,Velkoz,342,137,205,40.06
Vi,Irelia,455,175,280,38.46
Vi,Zyra,335,139,196,41.49
Vi,Morgana,667,329,338,49.33
Vi,Rammus,130,27,103,20.77
Vi,Alistar,152,97,55,63.82
Vi,Kassadin,103,34,69,33.01
Vi,Milio,290,140,150,48.28
Vi,Veigar,552,255,297,46.2
Vi,Kayle,461,214,247,46.42
Vi,Amumu,441,185,256,41.95
Vi,AurelionSol,278,131,147,47.12
Vi,Smolder,401,188,213,46.88
Vi,Janna,222,115,107,51.8
Vi,Pantheon,898,504,394,56.12
Vi,Lillia,361,183,178,50.69
Vi,Lulu,318,154,164,48.43
Vi,Jax,389,208,181,53.47
Vi,Nilah,286,145,141,50.7
Vi,Karma,376,196,180,52.13
Vi,Ziggs,280,123,157,43.93
Vi,Pyke,475,281,194,59.16
Vi,Mordekaiser,706,378,328,53.54
Vi,Qiyana,194,121,73,62.37
Vi,Brand,349,220,129,63.04
Vi,Poppy,352,175,177,49.72
Vi,Viego,616,264,352,42.86
Vi,Mel,1078,518,560,48.05
Vi,Gnar,251,150,101,59.76
Vi,Malzahar,378,160,218,42.33
Vi,Ryze,116,82,34,70.69
Vi,Viktor,342,210,132,61.4
Vi,Quinn,163,90,73,55.21
Vi,Xayah,289,132,157,45.67
Vi,Neeko,390,220,170,56.41
Vi,Talon,308,188,120,61.04
Vi,Leona,384,221,163,57.55
Vi,Shen,344,171,173,49.71
Vi,Nami,473,234,239,49.47
Vi,Zac,229,124,105,54.15
Vi,Camille,193,96,97,49.74
Vi,Leblanc,153,108,45,70.59
Vi,Renata,157,71,86,45.22
Vi,Vayne,433,183,250,42.26
Vi,Zeri,270,123,147,45.56
Vi,MasterYi,594,302,292,50.84
Vi,Fizz,268,156,112,58.21
Vi,Ivern,128,77,51,60.16
Vi,Sett,908,471,437,51.87
Vi,Samira,454,261,193,57.49
Vi,Briar,565,265,300,46.9
Vi,Lucian,403,230,173,57.07
Vi,Ambessa,357,204,153,57.14
Vi,Graves,250,104,146,41.6
Vi,Nunu,411,232,179,56.45
Vi,Sion,414,215,199,51.93
Vi,Skarner,186,111,75,59.68
Vi,Vladimir,195,49,146,25.13
Vi,Aphelios,368,177,191,48.1
Vi,Nidalee,129,71,58,55.04
Vi,Ekko,399,196,203,49.12
Vi,Cassiopeia,218,127,91,58.26
Vi,Tryndamere,286,147,139,51.4
Vi,Swain,598,256,342,42.81
Vi,Khazix,329,176,153,53.5
Vi,Ahri,749,368,381,49.13
Vi,Soraka,347,135,212,38.9
Vi,Renekton,255,131,124,51.37
Vi,Nocturne,483,202,281,41.82
Vi,Elise,264,168,96,63.64
Vi,Illaoi,293,156,137,53.24
Vi,Riven,237,134,103,56.54
Vi,Blitzcrank,281,149,132,53.02
Vi,Kled,75,45,30,60
Vi,Varus,428,230,198,53.74
Vi,Galio,408,158,250,38.73
Vi,Belveth,89,54,35,60.67
Vi,Evelynn,245,169,76,68.98
Vi,Taric,89,58,31,65.17
Vi,Naafiri,214,116,98,54.21
Vi,Singed,123,50,73,40.65
Vi,Lissandra,120,67,53,55.83
Vi,Kindred,270,149,121,55.19
Vi,Nasus,371,200,171,53.91
Vi,Kalista,184,91,93,49.46
Vi,DrMundo,350,161,189,46
Vi,Trundle,272,92,180,33.82
Vi,Maokai,178,113,65,63.48
Vi,MonkeyKing,253,159,94,62.85
Vi,Azir,167,98,69,58.68
Vi,Olaf,92,53,39,57.61
Vi,RekSai,68,26,42,38.24
Vi,Draven,290,137,153,47.24
Vi,Bard,159,79,80,49.69
Vi,Shyvana,76,33,43,43.42
Vi,Rumble,83,38,45,45.78
Vi,Sona,127,54,73,42.52
Vi,Karthus,56,28,28,50
Soraka,Chogath,491,212,279,43.18
Soraka,Kayn,577,324,253,56.15
Soraka,Gangplank,156,68,88,43.59
Soraka,Ezreal,535,291,244,54.39
Soraka,Hwei,293,160,133,54.61
Soraka,Zed,356,154,202,43.26
Soraka,Sona,162,89,73,54.94
Soraka,Kaisa,539,310,229,57.51
Soraka,Amumu,346,191,155,55.2
Soraka,Sett,515,246,269,47.77
Soraka,Vladimir,136,90,46,66.18
Soraka,Kindred,216,134,82,62.04
Soraka,Aphelios,301,133,168,44.19
Soraka,Pyke,405,251,154,61.98
Soraka,Teemo,513,246,267,47.95
Soraka,LeeSin,392,227,165,57.91
Soraka,Yone,617,320,297,51.86
Soraka,Jhin,741,373,368,50.34
Soraka,Nami,376,165,211,43.88
Soraka,Annie,137,75,62,54.74
Soraka,Aatrox,366,178,188,48.63
Soraka,MissFortune,738,355,383,48.1
Soraka,Diana,406,196,210,48.28
Soraka,Akali,420,260,160,61.9
Soraka,Caitlyn,891,500,391,56.12
Soraka,Karma,252,119,133,47.22
Soraka,Shaco,355,196,159,55.21
Soraka,Anivia,144,64,80,44.44
Soraka,Lux,1086,542,544,49.91
Soraka,Morgana,592,267,325,45.1
Soraka,Volibear,351,187,164,53.28
Soraka,Ambessa,275,110,165,40
Soraka,Smolder,266,139,127,52.26
Soraka,Swain,361,181,180,50.14
Soraka,Vayne,384,230,154,59.9
Soraka,Briar,364,182,182,50
Soraka,Mel,852,425,427,49.88
Soraka,Yuumi,353,167,186,47.31
Soraka,Shen,279,138,141,49.46
Soraka,Twitch,327,154,173,47.09
Soraka,Nautilus,384,208,176,54.17
Soraka,Pantheon,646,382,264,59.13
Soraka,Warwick,538,301,237,55.95
Soraka,Leblanc,112,67,45,59.82
Soraka,Leona,319,166,153,52.04
Soraka,Gwen,295,147,148,49.83
Soraka,Tristana,331,220,111,66.47
Soraka,Poppy,195,118,77,60.51
Soraka,KSante,125,63,62,50.4
Soraka,Viego,518,243,275,46.91
Soraka,Vex,252,102,150,40.48
Soraka,Jinx,796,411,385,51.63
Soraka,Senna,331,152,179,45.92
Soraka,Ivern,97,62,35,63.92
Soraka,Yasuo,687,346,341,50.36
Soraka,Evelynn,204,126,78,61.76
Soraka,Brand,227,97,130,42.73
Soraka,Udyr,106,55,51,51.89
Soraka,Orianna,116,66,50,56.9
Soraka,Ashe,576,319,257,55.38
Soraka,Irelia,397,208,189,52.39
Soraka,Quinn,120,73,47,60.83
Soraka,Thresh,476,193,283,40.55
Soraka,Renekton,174,89,85,51.15
Soraka,Lillia,254,100,154,39.37
Soraka,Xerath,260,116,144,44.62
Soraka,Rammus,154,70,84,45.45
Soraka,Garen,447,218,229,48.77
Soraka,Talon,277,161,116,58.12
Soraka,Milio,244,133,111,54.51
Soraka,Singed,119,58,61,48.74
Soraka,Galio,271,132,139,48.71
Soraka,Riven,146,82,64,56.16
Soraka,TwistedFate,131,58,73,44.27
Soraka,Fiora,141,87,54,61.7
Soraka,Varus,324,146,178,45.06
Soraka,Janna,118,62,56,52.54
Soraka,MonkeyKing,187,112,75,59.89
Soraka,Katarina,312,140,172,44.87
Soraka,Darius,775,414,361,53.42
Soraka,Jax,327,133,194,40.67
Soraka,Ekko,330,166,164,50.3
Soraka,Shyvana,113,62,51,54.87
Soraka,Taliyah,110,77,33,70
Soraka,Corki,131,97,34,74.05
Soraka,Elise,255,121,134,47.45
Soraka,Seraphine,457,224,233,49.02
Soraka,Mordekaiser,600,308,292,51.33
Soraka,Qiyana,133,76,57,57.14
Soraka,Neeko,267,113,154,42.32
Soraka,Sylas,360,169,191,46.94
Soraka,Gragas,189,138,51,73.02
Soraka,Nilah,185,75,110,40.54
Soraka,Kennen,155,90,65,58.06
Soraka,Malzahar,264,131,133,49.62
Soraka,Yorick,358,140,218,39.11
Soraka,Lulu,335,166,169,49.55
Soraka,Viktor,255,118,137,46.27
Soraka,Lucian,227,113,114,49.78
Soraka,Braum,201,108,93,53.73
Soraka,Ornn,202,95,107,47.03
Soraka,Graves,207,128,79,61.84
Soraka,MasterYi,360,161,199,44.72
Soraka,Draven,213,133,80,62.44
Soraka,Hecarim,158,77,81,48.73
Soraka,Ahri,534,279,255,52.25
Soraka,Blitzcrank,288,180,108,62.5
Soraka,Zeri,189,78,111,41.27
Soraka,Kayle,257,143,114,55.64
Soraka,Kled,77,26,51,33.77
Soraka,Veigar,420,219,201,52.14
Soraka,Sejuani,151,87,64,57.62
Soraka,Sion,294,159,135,54.08
Soraka,Alistar,126,68,58,53.97
Soraka,Malphite,231,117,114,50.65
Soraka,Nunu,321,126,195,39.25
Soraka,Nasus,297,188,109,63.3
Soraka,Rell,226,122,104,53.98
Soraka,KogMaw,150,76,74,50.67
Soraka,Aurora,378,192,186,50.79
Soraka,Bard,122,83,39,68.03
Soraka,TahmKench,388,225,163,57.99
Soraka,Rengar,176,86,90,48.86
Soraka,Cassiopeia,137,74,63,54.01
Soraka,Naafiri,181,94,87,51.93
Soraka,Trundle,212,105,107,49.53
Soraka,Zilean,114,71,43,62.28
Soraka,Velkoz,230,107,123,46.52
Soraka,Ziggs,165,73,92,44.24
Soraka,Azir,99,64,35,64.65
Soraka,Sivir,102,41,61,40.2
Soraka,Zyra,247,142,105,57.49
Soraka,Vi,347,212,135,61.1
Soraka,Zoe,223,131,92,58.74
Soraka,DrMundo,177,68,109,38.42
Soraka,FiddleSticks,166,84,82,50.6
Soraka,Camille,137,59,78,43.07
Soraka,Olaf,86,49,37,56.98
Soraka,Gnar,121,67,54,55.37
Soraka,Syndra,202,133,69,65.84
Soraka,Nidalee,121,78,43,64.46
Soraka,Fizz,172,85,87,49.42
Soraka,Taric,36,20,16,55.56
Soraka,Karthus,118,79,39,66.95
Soraka,Illaoi,238,115,123,48.32
Soraka,AurelionSol,210,85,125,40.48
Soraka,JarvanIV,124,81,43,65.32
Soraka,Heimerdinger,221,120,101,54.3
Soraka,Samira,310,131,179,42.26
Soraka,Rumble,82,60,22,73.17
Soraka,Khazix,158,63,95,39.87
Soraka,Tryndamere,212,121,91,57.08
Soraka,Kassadin,84,44,40,52.38
Soraka,Maokai,152,85,67,55.92
Soraka,Nocturne,264,138,126,52.27
Soraka,Renata,77,53,24,68.83
Soraka,Zac,131,68,63,51.91
Soraka,Rakan,204,125,79,61.27
Soraka,Jayce,153,57,96,37.25
Soraka,Ryze,64,45,19,70.31
Soraka,Kalista,180,114,66,63.33
Soraka,Belveth,104,43,61,41.35
Soraka,XinZhao,175,75,100,42.86
Soraka,Lissandra,73,44,29,60.27
Soraka,Akshan,137,67,70,48.91
Soraka,Xayah,229,118,111,51.53
Soraka,Skarner,90,34,56,37.78
Soraka,Urgot,141,43,98,30.5
Soraka,RekSai,24,15,9,62.5
Jax,Vladimir,278,135,143,48.56
Jax,Viego,546,265,281,48.53
Jax,Velkoz,203,81,122,39.9
Jax,Kaisa,694,389,305,56.05
Jax,Karma,336,140,196,41.67
Jax,Irelia,460,218,242,47.39
Jax,Zed,514,257,257,50
Jax,Galio,358,148,210,41.34
Jax,MissFortune,995,472,523,47.44
Jax,TahmKench,573,285,288,49.74
Jax,Gwen,278,183,95,65.83
Jax,Talon,295,177,118,60
Jax,Yone,1000,535,465,53.5
Jax,Taric,113,22,91,19.47
Jax,Poppy,358,180,178,50.28
Jax,Warwick,769,366,403,47.59
Jax,Katarina,379,203,176,53.56
Jax,Twitch,480,262,218,54.58
Jax,Morgana,680,322,358,47.35
Jax,Briar,525,304,221,57.9
Jax,Vex,307,183,124,59.61
Jax,Jinx,950,516,434,54.32
Jax,Milio,310,167,143,53.87
Jax,Akali,535,236,299,44.11
Jax,Rammus,196,63,133,32.14
Jax,Yasuo,1091,522,569,47.85
Jax,Zyra,262,108,154,41.22
Jax,Ryze,98,57,41,58.16
Jax,Nunu,402,178,224,44.28
Jax,Ahri,700,355,345,50.71
Jax,Lucian,247,117,130,47.37
Jax,Alistar,184,117,67,63.59
Jax,Ornn,219,92,127,42.01
Jax,TwistedFate,205,111,94,54.15
Jax,Caitlyn,1165,504,661,43.26
Jax,Pantheon,862,447,415,51.86
Jax,Leblanc,169,93,76,55.03
Jax,Aphelios,283,155,128,54.77
Jax,Leona,347,130,217,37.46
Jax,Yorick,462,198,264,42.86
Jax,Draven,216,137,79,63.43
Jax,KogMaw,208,114,94,54.81
Jax,Yuumi,416,190,226,45.67
Jax,Tryndamere,314,160,154,50.96
Jax,Sylas,448,244,204,54.46
Jax,Taliyah,157,88,69,56.05
Jax,Jhin,879,440,439,50.06
Jax,Senna,461,250,211,54.23
Jax,Malphite,289,147,142,50.87
Jax,Diana,591,283,308,47.88
Jax,Lux,1301,633,668,48.65
Jax,Fiora,238,96,142,40.34
Jax,Shaco,421,210,211,49.88
Jax,Fizz,287,145,142,50.52
Jax,Tristana,481,242,239,50.31
Jax,Rakan,247,98,149,39.68
Jax,Sett,845,383,462,45.33
Jax,FiddleSticks,231,112,119,48.48
Jax,Samira,487,249,238,51.13
Jax,Neeko,367,169,198,46.05
Jax,Volibear,563,288,275,51.15
Jax,LeeSin,546,310,236,56.78
Jax,Malzahar,353,112,241,31.73
Jax,Pyke,719,382,337,53.13
Jax,Renekton,261,125,136,47.89
Jax,Khazix,253,175,78,69.17
Jax,Quinn,159,70,89,44.03
Jax,Kayn,863,449,414,52.03
Jax,Aatrox,429,238,191,55.48
Jax,Mel,1043,600,443,57.53
Jax,Ezreal,730,387,343,53.01
Jax,Elise,285,174,111,61.05
Jax,Shen,350,185,165,52.86
Jax,Amumu,399,149,250,37.34
Jax,Ziggs,243,105,138,43.21
Jax,Jayce,228,137,91,60.09
Jax,Swain,497,210,287,42.25
Jax,Sion,339,168,171,49.56
Jax,XinZhao,275,128,147,46.55
Jax,Soraka,327,194,133,59.33
Jax,Singed,175,101,74,57.71
Jax,Garen,930,406,524,43.66
Jax,Zilean,174,76,98,43.68
Jax,Rengar,249,173,76,69.48
Jax,Aurora,450,260,190,57.78
Jax,Seraphine,575,301,274,52.35
Jax,Gragas,392,168,224,42.86
Jax,Veigar,621,345,276,55.56
Jax,Kalista,222,115,107,51.8
Jax,Trundle,310,176,134,56.77
Jax,MonkeyKing,266,149,117,56.02
Jax,Darius,911,499,412,54.77
Jax,Chogath,650,288,362,44.31
Jax,Evelynn,307,157,150,51.14
Jax,Nocturne,413,199,214,48.18
Jax,Thresh,564,280,284,49.65
Jax,Olaf,148,95,53,64.19
Jax,Ashe,897,428,469,47.71
Jax,AurelionSol,257,119,138,46.3
Jax,Nilah,249,132,117,53.01
Jax,Riven,165,93,72,56.36
Jax,Syndra,247,119,128,48.18
Jax,MasterYi,547,283,264,51.74
Jax,Xayah,368,180,188,48.91
Jax,Hwei,431,223,208,51.74
Jax,Illaoi,231,95,136,41.13
Jax,Mordekaiser,793,391,402,49.31
Jax,Nami,409,226,183,55.26
Jax,Nautilus,464,249,215,53.66
Jax,Viktor,291,159,132,54.64
Jax,DrMundo,393,183,210,46.56
Jax,Rell,239,134,105,56.07
Jax,Zoe,220,131,89,59.55
Jax,Udyr,138,68,70,49.28
Jax,Lulu,406,229,177,56.4
Jax,Teemo,635,333,302,52.44
Jax,Lillia,381,180,201,47.24
Jax,Graves,272,144,128,52.94
Jax,Kennen,170,119,51,70
Jax,Brand,346,199,147,57.51
Jax,Maokai,217,125,92,57.6
Jax,Camille,180,107,73,59.44
Jax,Skarner,184,82,102,44.57
Jax,Vi,389,181,208,46.53
Jax,Xerath,282,119,163,42.2
Jax,Kayle,432,220,212,50.93
Jax,Ekko,360,207,153,57.5
Jax,Urgot,234,95,139,40.6
Jax,Ivern,47,24,23,51.06
Jax,Kassadin,113,64,49,56.64
Jax,Gangplank,268,159,109,59.33
Jax,Hecarim,198,118,80,59.6
Jax,Annie,168,94,74,55.95
Jax,Vayne,448,260,188,58.04
Jax,Corki,171,106,65,61.99
Jax,Ambessa,336,163,173,48.51
Jax,Varus,411,204,207,49.64
Jax,Heimerdinger,278,126,152,45.32
Jax,Azir,199,104,95,52.26
Jax,Akshan,186,99,87,53.23
Jax,Sona,201,97,104,48.26
Jax,Qiyana,196,129,67,65.82
Jax,Braum,253,124,129,49.01
Jax,Cassiopeia,236,144,92,61.02
Jax,KSante,94,48,46,51.06
Jax,Janna,148,62,86,41.89
Jax,Naafiri,205,88,117,42.93
Jax,Blitzcrank,350,187,163,53.43
Jax,Nasus,366,164,202,44.81
Jax,Gnar,128,53,75,41.41
Jax,Sejuani,156,64,92,41.03
Jax,Smolder,340,174,166,51.18
Jax,Karthus,100,71,29,71
Jax,Kled,76,52,24,68.42
Jax,Anivia,151,84,67,55.63
Jax,Kindred,258,154,104,59.69
Jax,Nidalee,136,78,58,57.35
Jax,JarvanIV,178,83,95,46.63
Jax,Zac,186,142,44,76.34
Jax,Belveth,112,58,54,51.79
Jax,Renata,127,82,45,64.57
Jax,Sivir,288,124,164,43.06
Jax,Shyvana,145,63,82,43.45
Jax,Orianna,227,132,95,58.15
Jax,Bard,152,93,59,61.18
Jax,Rumble,67,35,32,52.24
Jax,Lissandra,99,58,41,58.59
Jax,Zeri,193,134,59,69.43
Jax,RekSai,61,22,39,36.07
XinZhao,Vladimir,170,86,84,50.59
XinZhao,Viego,428,214,214,50
XinZhao,Velkoz,218,114,104,52.29
XinZhao,Kaisa,425,199,226,46.82
XinZhao,Karma,271,104,167,38.38
XinZhao,Garen,492,176,316,35.77
XinZhao,Kayn,480,262,218,54.58
XinZhao,Lux,854,478,376,55.97
XinZhao,Caitlyn,741,419,322,56.55
XinZhao,Thresh,470,216,254,45.96
XinZhao,Aatrox,292,172,120,58.9
XinZhao,Gwen,209,117,92,55.98
XinZhao,Syndra,210,102,108,48.57
XinZhao,Ashe,654,300,354,45.87
XinZhao,Lulu,268,165,103,61.57
XinZhao,Sett,544,298,246,54.78
XinZhao,Vi,265,156,109,58.87
XinZhao,AurelionSol,91,34,57,37.36
XinZhao,Corki,106,78,28,73.58
XinZhao,Milio,145,85,60,58.62
XinZhao,Riven,181,107,74,59.12
XinZhao,LeeSin,352,205,147,58.24
XinZhao,Mel,709,387,322,54.58
XinZhao,Tristana,301,118,183,39.2
XinZhao,Zac,130,81,49,62.31
XinZhao,FiddleSticks,143,59,84,41.26
XinZhao,Brand,205,125,80,60.98
XinZhao,Jinx,540,261,279,48.33
XinZhao,Amumu,345,117,228,33.91
XinZhao,Akshan,89,47,42,52.81
XinZhao,Ezreal,544,331,213,60.85
XinZhao,Darius,610,333,277,54.59
XinZhao,Ivern,77,43,34,55.84
XinZhao,Katarina,310,169,141,54.52
XinZhao,Pantheon,568,290,278,51.06
XinZhao,Rammus,77,23,54,29.87
XinZhao,Yasuo,614,343,271,55.86
XinZhao,Pyke,389,244,145,62.72
XinZhao,Yone,622,351,271,56.43
XinZhao,Sivir,135,64,71,47.41
XinZhao,Ahri,497,263,234,52.92
XinZhao,Diana,387,198,189,51.16
XinZhao,Jhin,607,360,247,59.31
XinZhao,RekSai,62,31,31,50
XinZhao,Gangplank,122,70,52,57.38
XinZhao,Leona,283,151,132,53.36
XinZhao,Jax,275,147,128,53.45
XinZhao,Ekko,306,168,138,54.9
XinZhao,Trundle,228,118,110,51.75
XinZhao,Aphelios,187,98,89,52.41
XinZhao,Ambessa,183,104,79,56.83
XinZhao,Veigar,375,196,179,52.27
XinZhao,MissFortune,589,264,325,44.82
XinZhao,Nautilus,291,131,160,45.02
XinZhao,Chogath,469,213,256,45.42
XinZhao,Zed,308,176,132,57.14
XinZhao,Galio,223,121,102,54.26
XinZhao,Maokai,139,55,84,39.57
XinZhao,Fiora,215,108,107,50.23
XinZhao,DrMundo,194,87,107,44.85
XinZhao,Poppy,161,95,66,59.01
XinZhao,TwistedFate,91,43,48,47.25
XinZhao,Samira,307,175,132,57
XinZhao,Seraphine,407,231,176,56.76
XinZhao,Urgot,154,49,105,31.82
XinZhao,Sylas,352,160,192,45.45
XinZhao,Rakan,208,121,87,58.17
XinZhao,Shen,194,108,86,55.67
XinZhao,Kassadin,48,35,13,72.92
XinZhao,Blitzcrank,261,119,142,45.59
XinZhao,MonkeyKing,184,69,115,37.5
XinZhao,Vex,207,88,119,42.51
XinZhao,TahmKench,393,187,206,47.58
XinZhao,Cassiopeia,159,90,69,56.6
XinZhao,Lucian,193,133,60,68.91
XinZhao,Nami,297,183,114,61.62
XinZhao,Ornn,147,59,88,40.14
XinZhao,Aurora,301,162,139,53.82
XinZhao,Xayah,254,140,114,55.12
XinZhao,Kayle,200,87,113,43.5
XinZhao,Volibear,357,175,182,49.02
XinZhao,Shaco,299,153,146,51.17
XinZhao,Yorick,424,216,208,50.94
XinZhao,Irelia,266,147,119,55.26
XinZhao,MasterYi,348,165,183,47.41
XinZhao,Akali,405,246,159,60.74
XinZhao,Lillia,213,119,94,55.87
XinZhao,Khazix,184,86,98,46.74
XinZhao,Varus,256,140,116,54.69
XinZhao,Mordekaiser,483,238,245,49.28
XinZhao,Warwick,505,264,241,52.28
XinZhao,Naafiri,129,72,57,55.81
XinZhao,Ziggs,197,86,111,43.65
XinZhao,Kled,47,22,25,46.81
XinZhao,Gnar,151,94,57,62.25
XinZhao,Nasus,327,189,138,57.8
XinZhao,Ryze,88,43,45,48.86
XinZhao,Bard,76,55,21,72.37
XinZhao,Viktor,194,122,72,62.89
XinZhao,Draven,186,127,59,68.28
XinZhao,Elise,201,110,91,54.73
XinZhao,Udyr,111,62,49,55.86
XinZhao,Vayne,366,171,195,46.72
XinZhao,Anivia,85,45,40,52.94
XinZhao,Sejuani,124,81,43,65.32
XinZhao,Braum,166,80,86,48.19
XinZhao,Kennen,64,35,29,54.69
XinZhao,Gragas,195,101,94,51.79
XinZhao,Heimerdinger,207,99,108,47.83
XinZhao,Morgana,347,164,183,47.26
XinZhao,Briar,345,176,169,51.01
XinZhao,Taric,83,51,32,61.45
XinZhao,Belveth,110,67,43,60.91
XinZhao,Nunu,255,148,107,58.04
XinZhao,Kindred,171,107,64,62.57
XinZhao,Taliyah,102,76,26,74.51
XinZhao,Nilah,191,114,77,59.69
XinZhao,Illaoi,143,83,60,58.04
XinZhao,Xerath,229,106,123,46.29
XinZhao,Yuumi,327,162,165,49.54
XinZhao,Smolder,264,165,99,62.5
XinZhao,Twitch,251,107,144,42.63
XinZhao,Senna,298,131,167,43.96
XinZhao,Malzahar,234,101,133,43.16
XinZhao,Malphite,242,141,101,58.26
XinZhao,Nidalee,74,22,52,29.73
XinZhao,Kalista,153,83,70,54.25
XinZhao,Zyra,181,91,90,50.28
XinZhao,Skarner,94,53,41,56.38
XinZhao,Qiyana,123,62,61,50.41
XinZhao,Evelynn,183,115,68,62.84
XinZhao,Sona,103,58,45,56.31
XinZhao,Singed,87,37,50,42.53
XinZhao,Alistar,81,33,48,40.74
XinZhao,Sion,246,142,104,57.72
XinZhao,Teemo,447,204,243,45.64
XinZhao,Rengar,131,90,41,68.7
XinZhao,Hwei,177,94,83,53.11
XinZhao,KogMaw,125,46,79,36.8
XinZhao,Azir,123,61,62,49.59
XinZhao,Fizz,170,68,102,40
XinZhao,Swain,401,201,200,50.12
XinZhao,Renekton,154,79,75,51.3
XinZhao,KSante,139,80,59,57.55
XinZhao,Neeko,299,162,137,54.18
XinZhao,Tryndamere,143,70,73,48.95
XinZhao,Soraka,175,100,75,57.14
XinZhao,Leblanc,143,94,49,65.73
XinZhao,Quinn,90,58,32,64.44
XinZhao,Graves,119,76,43,63.87
XinZhao,Nocturne,265,117,148,44.15
XinZhao,Karthus,59,31,28,52.54
XinZhao,Zoe,117,81,36,69.23
XinZhao,Hecarim,134,84,50,62.69
XinZhao,Zeri,118,62,56,52.54
XinZhao,Rell,141,81,60,57.45
XinZhao,Talon,178,91,87,51.12
XinZhao,Olaf,81,60,21,74.07
XinZhao,JarvanIV,147,88,59,59.86
XinZhao,Jayce,110,60,50,54.55
XinZhao,Rumble,51,25,26,49.02
XinZhao,Orianna,133,68,65,51.13
XinZhao,Lissandra,60,28,32,46.67
XinZhao,Camille,108,65,43,60.19
XinZhao,Shyvana,131,67,64,51.15
XinZhao,Zilean,70,33,37,47.14
XinZhao,Renata,76,42,34,55.26
XinZhao,Annie,56,41,15,73.21
XinZhao,Janna,76,49,27,64.47
Kennen,Vladimir,138,81,57,58.7
Kennen,Viego,319,103,216,32.29
Kennen,Velkoz,137,44,93,32.12
Kennen,Kaisa,241,116,125,48.13
Kennen,Karma,143,57,86,39.86
Kennen,Aatrox,232,115,117,49.57
Kennen,Sylas,203,85,118,41.87
Kennen,Diana,267,120,147,44.94
Kennen,Varus,156,97,59,62.18
Kennen,Blitzcrank,178,97,81,54.49
Kennen,Vayne,293,123,170,41.98
Kennen,Briar,157,42,115,26.75
Kennen,Lux,722,336,386,46.54
Kennen,Mel,436,181,255,41.51
Kennen,Yuumi,193,68,125,35.23
Kennen,Yone,350,168,182,48
Kennen,Gragas,155,71,84,45.81
Kennen,Irelia,199,110,89,55.28
Kennen,TahmKench,225,91,134,40.44
Kennen,Rell,121,72,49,59.5
Kennen,Mordekaiser,360,156,204,43.33
Kennen,Ahri,340,157,183,46.18
Kennen,Nunu,193,97,96,50.26
Kennen,Yasuo,465,235,230,50.54
Kennen,Zyra,91,47,44,51.65
Kennen,Viktor,102,32,70,31.37
Kennen,Nocturne,163,75,88,46.01
Kennen,Annie,63,35,28,55.56
Kennen,KogMaw,87,46,41,52.87
Kennen,Alistar,65,29,36,44.62
Kennen,Vi,192,83,109,43.23
Kennen,Amumu,199,67,132,33.67
Kennen,Akshan,70,37,33,52.86
Kennen,Ezreal,349,174,175,49.86
Kennen,Zed,196,73,123,37.24
Kennen,TwistedFate,77,41,36,53.25
Kennen,Teemo,333,152,181,45.65
Kennen,Maokai,69,22,47,31.88
Kennen,Corki,63,28,35,44.44
Kennen,Taric,44,7,37,15.91
Kennen,Jayce,82,45,37,54.88
Kennen,JarvanIV,55,23,32,41.82
Kennen,Aurora,204,102,102,50
Kennen,Caitlyn,519,222,297,42.77
Kennen,Akali,217,105,112,48.39
Kennen,MasterYi,277,124,153,44.77
Kennen,Swain,258,117,141,45.35
Kennen,MissFortune,481,152,329,31.6
Kennen,Thresh,276,117,159,42.39
Kennen,Qiyana,63,41,22,65.08
Kennen,Neeko,213,108,105,50.7
Kennen,Malphite,200,93,107,46.5
Kennen,Khazix,140,68,72,48.57
Kennen,Lulu,148,78,70,52.7
Kennen,Gwen,134,36,98,26.87
Kennen,Lillia,167,89,78,53.29
Kennen,Morgana,244,112,132,45.9
Kennen,Soraka,155,65,90,41.94
Kennen,Renekton,99,44,55,44.44
Kennen,Darius,416,230,186,55.29
Kennen,FiddleSticks,111,56,55,50.45
Kennen,Ryze,58,30,28,51.72
Kennen,Kalista,118,73,45,61.86
Kennen,Janna,88,39,49,44.32
Kennen,Kayn,369,225,144,60.98
Kennen,Xayah,166,87,79,52.41
Kennen,Shaco,242,106,136,43.8
Kennen,Sett,405,170,235,41.98
Kennen,Katarina,183,93,90,50.82
Kennen,Rengar,89,64,25,71.91
Kennen,Seraphine,221,95,126,42.99
Kennen,Urgot,138,46,92,33.33
Kennen,Hwei,196,96,100,48.98
Kennen,Jhin,355,188,167,52.96
Kennen,Jax,170,51,119,30
Kennen,Zoe,100,74,26,74
Kennen,Ashe,353,122,231,34.56
Kennen,Kindred,117,58,59,49.57
Kennen,Galio,123,37,86,30.08
Kennen,Lucian,136,71,65,52.21
Kennen,Yorick,140,37,103,26.43
Kennen,Rammus,46,26,20,56.52
Kennen,Milio,128,44,84,34.38
Kennen,DrMundo,168,53,115,31.55
Kennen,Lissandra,53,28,25,52.83
Kennen,Zilean,64,20,44,31.25
Kennen,Udyr,95,38,57,40
Kennen,Orianna,58,29,29,50
Kennen,Trundle,111,51,60,45.95
Kennen,Rakan,110,46,64,41.82
Kennen,Gnar,108,55,53,50.93
Kennen,Cassiopeia,96,37,59,38.54
Kennen,Nami,209,95,114,45.45
Kennen,Evelynn,168,81,87,48.21
Kennen,Zeri,81,40,41,49.38
Kennen,Leona,159,80,79,50.31
Kennen,Leblanc,81,41,40,50.62
Kennen,Jinx,449,234,215,52.12
Kennen,Warwick,342,200,142,58.48
Kennen,Sejuani,76,33,43,43.42
Kennen,Malzahar,192,103,89,53.65
Kennen,Ekko,161,87,74,54.04
Kennen,Draven,128,50,78,39.06
Kennen,Nautilus,179,73,106,40.78
Kennen,Riven,111,42,69,37.84
Kennen,Tristana,224,104,120,46.43
Kennen,LeeSin,198,115,83,58.08
Kennen,Xerath,144,66,78,45.83
Kennen,Nasus,194,70,124,36.08
Kennen,XinZhao,64,29,35,45.31
Kennen,Syndra,114,64,50,56.14
Kennen,Nilah,100,46,54,46
Kennen,Veigar,326,143,183,43.87
Kennen,Anivia,69,28,41,40.58
Kennen,Poppy,121,72,49,59.5
Kennen,Naafiri,133,72,61,54.14
Kennen,Chogath,374,199,175,53.21
Kennen,Vex,165,71,94,43.03
Kennen,Kayle,178,71,107,39.89
Kennen,Gangplank,108,53,55,49.07
Kennen,Smolder,219,110,109,50.23
Kennen,Samira,212,88,124,41.51
Kennen,Singed,61,18,43,29.51
Kennen,Garen,300,112,188,37.33
Kennen,Hecarim,88,28,60,31.82
Kennen,Fizz,102,39,63,38.24
Kennen,Twitch,165,73,92,44.24
Kennen,Belveth,62,15,47,24.19
Kennen,Senna,192,90,102,46.88
Kennen,Camille,114,69,45,60.53
Kennen,Quinn,86,41,45,47.67
Kennen,Sona,104,40,64,38.46
Kennen,Illaoi,54,16,38,29.63
Kennen,Brand,154,44,110,28.57
Kennen,Braum,77,40,37,51.95
Kennen,Kled,48,19,29,39.58
Kennen,Aphelios,213,93,120,43.66
Kennen,Azir,45,33,12,73.33
Kennen,Elise,190,68,122,35.79
Kennen,Ambessa,121,89,32,73.55
Kennen,Pantheon,320,122,198,38.13
Kennen,Taliyah,61,27,34,44.26
Kennen,Talon,139,58,81,41.73
Kennen,Volibear,148,60,88,40.54
Kennen,Heimerdinger,132,46,86,34.85
Kennen,Sivir,81,24,57,29.63
Kennen,RekSai,19,16,3,84.21
Kennen,Ornn,109,46,63,42.2
Kennen,Graves,111,61,50,54.95
Kennen,Nidalee,58,32,26,55.17
Kennen,Tryndamere,103,43,60,41.75
Kennen,Fiora,81,44,37,54.32
Kennen,AurelionSol,101,46,55,45.54
Kennen,Bard,101,53,48,52.48
Kennen,MonkeyKing,120,40,80,33.33
Kennen,KSante,68,38,30,55.88
Kennen,Ivern,63,34,29,53.97
Kennen,Pyke,226,142,84,62.83
Kennen,Karthus,55,41,14,74.55
Kennen,Kassadin,59,20,39,33.9
Kennen,Sion,146,74,72,50.68
Kennen,Shen,122,60,62,49.18
Kennen,Renata,64,26,38,40.63
Kennen,Shyvana,66,39,27,59.09
Kennen,Zac,63,17,46,26.98
Kennen,Olaf,52,12,40,23.08
Kennen,Skarner,42,14,28,33.33
Kennen,Rumble,21,6,15,28.57
Kennen,Ziggs,50,16,34,32
Kalista,Vladimir,177,82,95,46.33
Kalista,Viego,299,114,185,38.13
Kalista,Velkoz,142,41,101,28.87
Kalista,Kaisa,354,138,216,38.98
Kalista,Karma,216,121,95,56.02
Kalista,Renekton,158,94,64,59.49
Kalista,JarvanIV,159,81,78,50.94
Kalista,Mel,703,273,430,38.83
Kalista,Jhin,511,240,271,46.97
Kalista,Sylas,275,95,180,34.55
Kalista,Mordekaiser,431,213,218,49.42
Kalista,Kindred,159,89,70,55.97
Kalista,TahmKench,345,158,187,45.8
Kalista,Yorick,212,47,165,22.17
Kalista,AurelionSol,160,44,116,27.5
Kalista,Kayn,474,235,239,49.58
Kalista,Singed,65,23,42,35.38
Kalista,Udyr,97,43,54,44.33
Kalista,Malphite,241,85,156,35.27
Kalista,Rell,124,65,59,52.42
Kalista,Jayce,165,94,71,56.97
Kalista,Rengar,133,75,58,56.39
Kalista,Swain,304,110,194,36.18
Kalista,Ezreal,502,257,245,51.2
Kalista,Sona,91,26,65,28.57
Kalista,Darius,528,218,310,41.29
Kalista,Trundle,115,32,83,27.83
Kalista,Gragas,130,71,59,54.62
Kalista,Yasuo,480,246,234,51.25
Kalista,Vex,190,81,109,42.63
Kalista,Diana,383,167,216,43.6
Kalista,Akali,324,140,184,43.21
Kalista,Jinx,525,239,286,45.52
Kalista,Lux,747,375,372,50.2
Kalista,Camille,100,37,63,37
Kalista,LeeSin,280,157,123,56.07
Kalista,Draven,177,83,94,46.89
Kalista,Senna,204,93,111,45.59
Kalista,Chogath,375,160,215,42.67
Kalista,Yuumi,318,161,157,50.63
Kalista,Ornn,139,67,72,48.2
Kalista,Briar,295,121,174,41.02
Kalista,Caitlyn,685,289,396,42.19
Kalista,Morgana,359,175,184,48.75
Kalista,Ashe,403,183,220,45.41
Kalista,Alistar,84,37,47,44.05
Kalista,Nocturne,198,105,93,53.03
Kalista,Qiyana,100,68,32,68
Kalista,Sett,437,209,228,47.83
Kalista,Jax,222,107,115,48.2
Kalista,Janna,87,41,46,47.13
Kalista,Gangplank,121,49,72,40.5
Kalista,MissFortune,672,343,329,51.04
Kalista,Aurora,281,151,130,53.74
Kalista,Aatrox,238,108,130,45.38
Kalista,Rumble,33,20,13,60.61
Kalista,Leona,196,97,99,49.49
Kalista,Urgot,143,46,97,32.17
Kalista,Twitch,281,160,121,56.94
Kalista,Teemo,366,168,198,45.9
Kalista,Pantheon,428,179,249,41.82
Kalista,Graves,112,51,61,45.54
Kalista,Leblanc,121,57,64,47.11
Kalista,Garen,490,213,277,43.47
Kalista,Syndra,111,65,46,58.56
Kalista,Rammus,64,36,28,56.25
Kalista,Fizz,112,44,68,39.29
Kalista,Sivir,82,29,53,35.37
Kalista,Shaco,320,167,153,52.19
Kalista,Taliyah,73,42,31,57.53
Kalista,Shen,185,76,109,41.08
Kalista,Volibear,256,89,167,34.77
Kalista,Tristana,299,127,172,42.47
Kalista,Nami,200,93,107,46.5
Kalista,Poppy,194,98,96,50.52
Kalista,Warwick,421,173,248,41.09
Kalista,Illaoi,126,58,68,46.03
Kalista,Nautilus,303,145,158,47.85
Kalista,Kennen,118,45,73,38.14
Kalista,Yone,566,223,343,39.4
Kalista,Ziggs,144,60,84,41.67
Kalista,Braum,115,43,72,37.39
Kalista,Irelia,260,118,142,45.38
Kalista,MasterYi,340,148,192,43.53
Kalista,Aphelios,291,163,128,56.01
Kalista,Lissandra,82,43,39,52.44
Kalista,Sion,166,63,103,37.95
Kalista,Katarina,238,119,119,50
Kalista,Talon,172,85,87,49.42
Kalista,Lillia,199,106,93,53.27
Kalista,Quinn,61,41,20,67.21
Kalista,Xayah,150,49,101,32.67
Kalista,Neeko,220,88,132,40
Kalista,Rakan,147,71,76,48.3
Kalista,Kled,73,34,39,46.58
Kalista,Malzahar,233,114,119,48.93
Kalista,Vayne,218,106,112,48.62
Kalista,Thresh,370,180,190,48.65
Kalista,Cassiopeia,103,37,66,35.92
Kalista,Heimerdinger,164,80,84,48.78
Kalista,Samira,249,86,163,34.54
Kalista,Kayle,265,127,138,47.92
Kalista,Ahri,474,203,271,42.83
Kalista,FiddleSticks,127,57,70,44.88
Kalista,Ekko,159,50,109,31.45
Kalista,Xerath,198,98,100,49.49
Kalista,Seraphine,278,116,162,41.73
Kalista,Hwei,233,94,139,40.34
Kalista,Ambessa,154,93,61,60.39
Kalista,Akshan,90,39,51,43.33
Kalista,Zoe,145,57,88,39.31
Kalista,Fiora,128,58,70,45.31
Kalista,Milio,142,73,69,51.41
Kalista,Shyvana,86,31,55,36.05
Kalista,Smolder,302,140,162,46.36
Kalista,Zeri,116,72,44,62.07
Kalista,Blitzcrank,238,62,176,26.05
Kalista,Viktor,198,61,137,30.81
Kalista,Veigar,397,147,250,37.03
Kalista,Nasus,202,79,123,39.11
Kalista,XinZhao,153,70,83,45.75
Kalista,Kassadin,92,44,48,47.83
Kalista,KogMaw,84,47,37,55.95
Kalista,Ryze,63,20,43,31.75
Kalista,Khazix,129,64,65,49.61
Kalista,Nunu,202,103,99,50.99
Kalista,Pyke,265,138,127,52.08
Kalista,Lulu,171,72,99,42.11
Kalista,Nilah,192,62,130,32.29
Kalista,Vi,184,93,91,50.54
Kalista,DrMundo,159,74,85,46.54
Kalista,Zed,245,109,136,44.49
Kalista,Corki,58,33,25,56.9
Kalista,Brand,162,80,82,49.38
Kalista,Riven,113,73,40,64.6
Kalista,KSante,117,59,58,50.43
Kalista,Karthus,62,36,26,58.06
Kalista,Hecarim,126,45,81,35.71
Kalista,Varus,260,120,140,46.15
Kalista,Elise,155,61,94,39.35
Kalista,Naafiri,106,47,59,44.34
Kalista,Soraka,180,66,114,36.67
Kalista,Belveth,116,57,59,49.14
Kalista,Sejuani,102,55,47,53.92
Kalista,Orianna,104,64,40,61.54
Kalista,Taric,82,35,47,42.68
Kalista,MonkeyKing,134,60,74,44.78
Kalista,Anivia,74,32,42,43.24
Kalista,Galio,223,96,127,43.05
Kalista,Skarner,90,51,39,56.67
Kalista,Annie,61,40,21,65.57
Kalista,Amumu,229,108,121,47.16
Kalista,Nidalee,84,36,48,42.86
Kalista,TwistedFate,75,40,35,53.33
Kalista,Azir,111,64,47,57.66
Kalista,Olaf,69,24,45,34.78
Kalista,Maokai,107,24,83,22.43
Kalista,Lucian,183,95,88,51.91
Kalista,Zilean,108,55,53,50.93
Kalista,Gnar,105,68,37,64.76
Kalista,Gwen,142,85,57,59.86
Kalista,Renata,73,10,63,13.7
Kalista,Tryndamere,222,134,88,60.36
Kalista,Bard,120,56,64,46.67
Kalista,Zyra,142,71,71,50
Kalista,Evelynn,198,104,94,52.53
Kalista,Zac,91,46,45,50.55
Kalista,Ivern,68,25,43,36.76
Kalista,RekSai,43,16,27,37.21
Lulu,Vladimir,284,162,122,57.04
Lulu,Viego,541,263,278,48.61
Lulu,Velkoz,306,136,170,44.44
Lulu,Kaisa,582,278,304,47.77
Lulu,Karma,346,164,182,47.4
Lulu,Yorick,391,156,235,39.9
Lulu,Diana,500,246,254,49.2
Lulu,Seraphine,498,208,290,41.77
Lulu,Rakan,302,147,155,48.68
Lulu,XinZhao,268,103,165,38.43
Lulu,Katarina,380,219,161,57.63
Lulu,Teemo,592,281,311,47.47
Lulu,Vayne,488,261,227,53.48
Lulu,TwistedFate,164,79,85,48.17
Lulu,Gragas,367,230,137,62.67
Lulu,Gwen,241,118,123,48.96
Lulu,Yasuo,905,449,456,49.61
Lulu,Zeri,228,101,127,44.3
Lulu,Bard,197,84,113,42.64
Lulu,Smolder,365,195,170,53.42
Lulu,Ekko,361,152,209,42.11
Lulu,Mordekaiser,635,301,334,47.4
Lulu,Yuumi,575,311,264,54.09
Lulu,Shaco,384,148,236,38.54
Lulu,Tryndamere,249,93,156,37.35
Lulu,Ezreal,1004,528,476,52.59
Lulu,Milio,325,159,166,48.92
Lulu,Ryze,151,41,110,27.15
Lulu,Nunu,389,187,202,48.07
Lulu,Ahri,649,324,325,49.92
Lulu,Lucian,304,133,171,43.75
Lulu,Alistar,164,63,101,38.41
Lulu,Nasus,321,149,172,46.42
Lulu,Kayn,634,315,319,49.68
Lulu,Neeko,249,100,149,40.16
Lulu,MissFortune,848,459,389,54.13
Lulu,Morgana,541,243,298,44.92
Lulu,Darius,894,413,481,46.2
Lulu,Sejuani,156,96,60,61.54
Lulu,Mel,974,485,489,49.79
Lulu,Jhin,916,444,472,48.47
Lulu,Rell,159,61,98,38.36
Lulu,Amumu,444,174,270,39.19
Lulu,Swain,455,190,265,41.76
Lulu,Urgot,211,115,96,54.5
Lulu,LeeSin,461,256,205,55.53
Lulu,Heimerdinger,271,182,89,67.16
Lulu,Warwick,725,337,388,46.48
Lulu,Ashe,847,418,429,49.35
Lulu,Pyke,512,271,241,52.93
Lulu,Camille,158,82,76,51.9
Lulu,MasterYi,460,269,191,58.48
Lulu,Irelia,352,176,176,50
Lulu,Pantheon,837,392,445,46.83
Lulu,DrMundo,224,96,128,42.86
Lulu,Trundle,240,94,146,39.17
Lulu,Nami,540,272,268,50.37
Lulu,Nocturne,411,191,220,46.47
Lulu,Aurora,481,220,261,45.74
Lulu,Jinx,800,374,426,46.75
Lulu,Ivern,93,61,32,65.59
Lulu,Sett,733,341,392,46.52
Lulu,Malphite,309,148,161,47.9
Lulu,Tristana,329,175,154,53.19
Lulu,Ziggs,182,55,127,30.22
Lulu,Lillia,296,148,148,50
Lulu,Lissandra,111,39,72,35.14
Lulu,FiddleSticks,217,107,110,49.31
Lulu,Ornn,137,58,79,42.34
Lulu,Hwei,401,182,219,45.39
Lulu,Caitlyn,959,452,507,47.13
Lulu,Illaoi,179,96,83,53.63
Lulu,Malzahar,398,204,194,51.26
Lulu,Khazix,262,152,110,58.02
Lulu,Leona,324,154,170,47.53
Lulu,Poppy,296,142,154,47.97
Lulu,Annie,158,90,68,56.96
Lulu,Nautilus,516,278,238,53.88
Lulu,Yone,860,450,410,52.33
Lulu,Maokai,200,107,93,53.5
Lulu,Fiora,200,102,98,51
Lulu,Riven,191,121,70,63.35
Lulu,Akshan,212,92,120,43.4
Lulu,Xerath,287,170,117,59.23
Lulu,Chogath,628,294,334,46.82
Lulu,Zed,448,223,225,49.78
Lulu,Lux,1164,567,597,48.71
Lulu,Rengar,243,167,76,68.72
Lulu,Galio,369,206,163,55.83
Lulu,Samira,411,233,178,56.69
Lulu,Sona,150,68,82,45.33
Lulu,Shen,269,137,132,50.93
Lulu,TahmKench,523,232,291,44.36
Lulu,Kennen,148,70,78,47.3
Lulu,Syndra,248,133,115,53.63
Lulu,Akali,447,250,197,55.93
Lulu,Soraka,335,169,166,50.45
Lulu,Evelynn,262,139,123,53.05
Lulu,Briar,418,179,239,42.82
Lulu,Viktor,361,139,222,38.5
Lulu,Jax,406,177,229,43.6
Lulu,Corki,173,94,79,54.34
Lulu,Volibear,545,275,270,50.46
Lulu,Rammus,116,54,62,46.55
Lulu,Cassiopeia,174,108,66,62.07
Lulu,MonkeyKing,243,112,131,46.09
Lulu,Elise,320,186,134,58.13
Lulu,Quinn,155,86,69,55.48
Lulu,Talon,311,171,140,54.98
Lulu,Varus,360,170,190,47.22
Lulu,Aatrox,483,243,240,50.31
Lulu,Olaf,104,61,43,58.65
Lulu,Vex,167,87,80,52.1
Lulu,Thresh,575,230,345,40
Lulu,Kindred,229,120,109,52.4
Lulu,Vi,318,164,154,51.57
Lulu,Sion,421,204,217,48.46
Lulu,Garen,654,299,355,45.72
Lulu,Shyvana,124,80,44,64.52
Lulu,Sivir,190,90,100,47.37
Lulu,Qiyana,164,83,81,50.61
Lulu,Ambessa,306,189,117,61.76
Lulu,Zyra,239,71,168,29.71
Lulu,Graves,232,93,139,40.09
Lulu,Nidalee,134,58,76,43.28
Lulu,Senna,432,230,202,53.24
Lulu,Fizz,202,82,120,40.59
Lulu,Sylas,385,159,226,41.3
Lulu,Xayah,357,183,174,51.26
Lulu,Leblanc,173,100,73,57.8
Lulu,Gnar,194,85,109,43.81
Lulu,Zac,204,87,117,42.65
Lulu,Singed,115,68,47,59.13
Lulu,Braum,221,117,104,52.94
Lulu,Zoe,180,101,79,56.11
Lulu,Naafiri,204,106,98,51.96
Lulu,Skarner,169,90,79,53.25
Lulu,Draven,234,109,125,46.58
Lulu,Azir,152,64,88,42.11
Lulu,Kled,78,34,44,43.59
Lulu,Belveth,131,77,54,58.78
Lulu,Hecarim,195,119,76,61.03
Lulu,Nilah,198,110,88,55.56
Lulu,Kassadin,73,35,38,47.95
Lulu,Twitch,377,155,222,41.11
Lulu,Udyr,156,68,88,43.59
Lulu,Aphelios,317,98,219,30.91
Lulu,Blitzcrank,331,174,157,52.57
Lulu,Renata,144,86,58,59.72
Lulu,Veigar,468,226,242,48.29
Lulu,KogMaw,176,73,103,41.48
Lulu,Gangplank,204,89,115,43.63
Lulu,JarvanIV,252,106,146,42.06
Lulu,Orianna,213,112,101,52.58
Lulu,Zilean,156,77,79,49.36
Lulu,Karthus,92,58,34,63.04
Lulu,Brand,324,140,184,43.21
Lulu,Taliyah,157,79,78,50.32
Lulu,Kalista,171,99,72,57.89
Lulu,Kayle,290,98,192,33.79
Lulu,RekSai,93,53,40,56.99
Lulu,Janna,203,79,124,38.92
Lulu,AurelionSol,228,138,90,60.53
Lulu,KSante,185,114,71,61.62
Lulu,Jayce,251,119,132,47.41
Lulu,Renekton,158,77,81,48.73
Lulu,Anivia,108,55,53,50.93
Lulu,Rumble,100,48,52,48
Lulu,Taric,96,44,52,45.83
Vladimir,Jax,278,143,135,51.44
Vladimir,XinZhao,170,84,86,49.41
Vladimir,Kennen,138,57,81,41.3
Vladimir,Kalista,177,95,82,53.67
Vladimir,Lulu,284,122,162,42.96
Vladimir,Illaoi,143,67,76,46.85
Vladimir,Warwick,441,201,240,45.58
Vladimir,Diana,396,164,232,41.41
Vladimir,Tristana,275,166,109,60.36
Vladimir,Milio,111,59,52,53.15
Vladimir,Ornn,133,62,71,46.62
Vladimir,Poppy,307,155,152,50.49
Vladimir,Yone,662,360,302,54.38
Vladimir,MissFortune,735,373,362,50.75
Vladimir,Brand,287,163,124,56.79
Vladimir,Singed,65,33,32,50.77
Vladimir,Ryze,86,49,37,56.98
Vladimir,Samira,308,129,179,41.88
Vladimir,Soraka,136,46,90,33.82
Vladimir,Mordekaiser,432,247,185,57.18
Vladimir,Briar,384,163,221,42.45
Vladimir,Zed,313,187,126,59.74
Vladimir,Jinx,580,267,313,46.03
Vladimir,Darius,550,248,302,45.09
Vladimir,Garen,390,196,194,50.26
Vladimir,Lux,805,390,415,48.45
Vladimir,Sivir,160,56,104,35
Vladimir,Rakan,213,120,93,56.34
Vladimir,Gangplank,150,96,54,64
Vladimir,Lillia,223,85,138,38.12
Vladimir,Sejuani,111,73,38,65.77
Vladimir,Mel,715,432,283,60.42
Vladimir,Jhin,651,317,334,48.69
Vladimir,Rell,180,111,69,61.67
Vladimir,TwistedFate,94,58,36,61.7
Vladimir,LeeSin,302,162,140,53.64
Vladimir,Yasuo,807,405,402,50.19
Vladimir,Nilah,210,98,112,46.67
Vladimir,Ahri,459,243,216,52.94
Vladimir,Nunu,337,172,165,51.04
Vladimir,Zyra,230,126,104,54.78
Vladimir,Zoe,143,102,41,71.33
Vladimir,Ezreal,491,263,228,53.56
Vladimir,Janna,90,42,48,46.67
Vladimir,Chogath,439,251,188,57.18
Vladimir,Galio,191,104,87,54.45
Vladimir,Yorick,260,107,153,41.15
Vladimir,Kindred,199,103,96,51.76
Vladimir,Ashe,617,335,282,54.29
Vladimir,Ekko,206,111,95,53.88
Vladimir,Caitlyn,755,412,343,54.57
Vladimir,Kayle,284,169,115,59.51
Vladimir,Sona,113,53,60,46.9
Vladimir,Twitch,300,172,128,57.33
Vladimir,Teemo,459,213,246,46.41
Vladimir,Aatrox,296,127,169,42.91
Vladimir,MasterYi,330,167,163,50.61
Vladimir,Yuumi,307,119,188,38.76
Vladimir,Heimerdinger,202,88,114,43.56
Vladimir,Varus,216,134,82,62.04
Vladimir,Maokai,132,66,66,50
Vladimir,Veigar,335,132,203,39.4
Vladimir,Shyvana,71,33,38,46.48
Vladimir,Morgana,414,199,215,48.07
Vladimir,Riven,166,119,47,71.69
Vladimir,Shaco,305,159,146,52.13
Vladimir,Thresh,414,247,167,59.66
Vladimir,Kayn,511,282,229,55.19
Vladimir,Seraphine,276,153,123,55.43
Vladimir,DrMundo,209,89,120,42.58
Vladimir,Irelia,324,172,152,53.09
Vladimir,Swain,370,155,215,41.89
Vladimir,Nasus,227,81,146,35.68
Vladimir,Zac,126,55,71,43.65
Vladimir,Kaisa,476,251,225,52.73
Vladimir,Anivia,102,59,43,57.84
Vladimir,JarvanIV,105,55,50,52.38
Vladimir,Katarina,299,134,165,44.82
Vladimir,TahmKench,352,198,154,56.25
Vladimir,Akali,394,199,195,50.51
Vladimir,FiddleSticks,174,65,109,37.36
Vladimir,Rengar,138,91,47,65.94
Vladimir,Belveth,132,62,70,46.97
Vladimir,Pantheon,635,303,332,47.72
Vladimir,Amumu,344,157,187,45.64
Vladimir,Nami,267,149,118,55.81
Vladimir,Aurora,335,117,218,34.93
Vladimir,Aphelios,210,95,115,45.24
Vladimir,Draven,150,78,72,52
Vladimir,Shen,159,82,77,51.57
Vladimir,Pyke,382,196,186,51.31
Vladimir,Viktor,183,90,93,49.18
Vladimir,Senna,232,127,105,54.74
Vladimir,Tryndamere,171,79,92,46.2
Vladimir,Neeko,225,99,126,44
Vladimir,KSante,145,76,69,52.41
Vladimir,Taric,68,48,20,70.59
Vladimir,Talon,248,160,88,64.52
Vladimir,Sett,524,232,292,44.27
Vladimir,Leona,213,120,93,56.34
Vladimir,Viego,446,191,255,42.83
Vladimir,Orianna,181,93,88,51.38
Vladimir,Smolder,293,142,151,48.46
Vladimir,Syndra,159,72,87,45.28
Vladimir,Velkoz,180,58,122,32.22
Vladimir,Sylas,288,144,144,50
Vladimir,KogMaw,136,75,61,55.15
Vladimir,Nautilus,342,204,138,59.65
Vladimir,Evelynn,193,103,90,53.37
Vladimir,Alistar,102,37,65,36.27
Vladimir,Karthus,55,37,18,67.27
Vladimir,Khazix,151,93,58,61.59
Vladimir,Leblanc,144,72,72,50
Vladimir,Camille,138,86,52,62.32
Vladimir,Lucian,158,85,73,53.8
Vladimir,Nidalee,67,22,45,32.84
Vladimir,Vex,130,76,54,58.46
Vladimir,Hwei,279,157,122,56.27
Vladimir,Vi,195,146,49,74.87
Vladimir,Olaf,67,40,27,59.7
Vladimir,Sion,295,139,156,47.12
Vladimir,Akshan,157,89,68,56.69
Vladimir,Urgot,138,77,61,55.8
Vladimir,Qiyana,145,58,87,40
Vladimir,Rammus,80,39,41,48.75
Vladimir,Vayne,284,127,157,44.72
Vladimir,Gnar,130,93,37,71.54
Vladimir,Zeri,134,81,53,60.45
Vladimir,Blitzcrank,219,122,97,55.71
Vladimir,Azir,108,55,53,50.93
Vladimir,Fiora,176,77,99,43.75
Vladimir,AurelionSol,130,69,61,53.08
Vladimir,Corki,127,67,60,52.76
Vladimir,Bard,128,59,69,46.09
Vladimir,Volibear,286,142,144,49.65
Vladimir,Braum,132,59,73,44.7
Vladimir,Renekton,189,60,129,31.75
Vladimir,Naafiri,117,43,74,36.75
Vladimir,Trundle,169,62,107,36.69
Vladimir,Fizz,242,116,126,47.93
Vladimir,Ziggs,145,70,75,48.28
Vladimir,Rumble,44,29,15,65.91
Vladimir,Quinn,98,56,42,57.14
Vladimir,Gwen,202,117,85,57.92
Vladimir,Elise,197,90,107,45.69
Vladimir,Ivern,101,63,38,62.38
Vladimir,Nocturne,340,203,137,59.71
Vladimir,Kassadin,84,27,57,32.14
Vladimir,Xayah,237,118,119,49.79
Vladimir,Malzahar,217,106,111,48.85
Vladimir,Ambessa,181,77,104,42.54
Vladimir,Skarner,88,50,38,56.82
Vladimir,Graves,149,83,66,55.7
Vladimir,Taliyah,117,75,42,64.1
Vladimir,Karma,273,129,144,47.25
Vladimir,Gragas,201,115,86,57.21
Vladimir,MonkeyKing,135,81,54,60
Vladimir,Malphite,268,124,144,46.27
Vladimir,Udyr,110,49,61,44.55
Vladimir,Lissandra,66,30,36,45.45
Vladimir,RekSai,38,15,23,39.47
Vladimir,Hecarim,118,54,64,45.76
Vladimir,Annie,81,36,45,44.44
Vladimir,Cassiopeia,164,113,51,68.9
Vladimir,Jayce,164,79,85,48.17
Vladimir,Renata,107,34,73,31.78
Vladimir,Xerath,148,79,69,53.38
Vladimir,Zilean,80,54,26,67.5
Vladimir,Kled,38,21,17,55.26
Viego,Jax,546,281,265,51.47
Viego,XinZhao,428,214,214,50
Viego,Kennen,319,216,103,67.71
Viego,Kalista,299,185,114,61.87
Viego,Lulu,541,278,263,51.39
Viego,Sett,1260,550,710,43.65
Viego,Ivern,139,99,40,71.22
Viego,Veigar,960,460,500,47.92
Viego,Jinx,1537,733,804,47.69
Viego,Darius,1218,641,577,52.63
Viego,Warwick,1213,584,629,48.15
Viego,Yasuo,1395,718,677,51.47
Viego,Caitlyn,1700,894,806,52.59
Viego,Morgana,895,392,503,43.8
Viego,Volibear,835,382,453,45.75
Viego,Ekko,536,273,263,50.93
Viego,Yone,1325,634,691,47.85
Viego,Pyke,887,511,376,57.61
Viego,Illaoi,313,140,173,44.73
Viego,Aatrox,792,462,330,58.33
Viego,Ashe,1217,591,626,48.56
Viego,Aphelios,484,214,270,44.21
Viego,Gragas,402,202,200,50.25
Viego,FiddleSticks,302,132,170,43.71
Viego,Shaco,743,362,381,48.72
Viego,Syndra,378,196,182,51.85
Viego,Thresh,942,482,460,51.17
Viego,Fiora,397,190,207,47.86
Viego,Galio,537,247,290,46
Viego,Ezreal,1194,638,556,53.43
Viego,Chogath,850,433,417,50.94
Viego,Naafiri,306,183,123,59.8
Viego,Nunu,615,264,351,42.93
Viego,Malzahar,522,223,299,42.72
Viego,Zeri,256,157,99,61.33
Viego,Mordekaiser,1154,531,623,46.01
Viego,Khazix,534,282,252,52.81
Viego,Akali,708,380,328,53.67
Viego,Draven,438,233,205,53.2
Viego,Mel,1560,782,778,50.13
Viego,Malphite,639,315,324,49.3
Viego,MissFortune,1501,778,723,51.83
Viego,Soraka,518,275,243,53.09
Viego,Ambessa,497,269,228,54.12
Viego,Vex,399,181,218,45.36
Viego,Blitzcrank,568,231,337,40.67
Viego,Heimerdinger,263,87,176,33.08
Viego,Seraphine,779,446,333,57.25
Viego,Ziggs,347,191,156,55.04
Viego,Yorick,695,314,381,45.18
Viego,Kayn,1277,585,692,45.81
Viego,Nasus,526,245,281,46.58
Viego,Smolder,556,282,274,50.72
Viego,JarvanIV,244,92,152,37.7
Viego,Olaf,157,117,40,74.52
Viego,Evelynn,421,232,189,55.11
Viego,Leona,506,224,282,44.27
Viego,MasterYi,877,473,404,53.93
Viego,Ahri,985,475,510,48.22
Viego,Sivir,332,175,157,52.71
Viego,Yuumi,610,318,292,52.13
Viego,Orianna,328,162,166,49.39
Viego,Nautilus,845,425,420,50.3
Viego,Gwen,407,200,207,49.14
Viego,Maokai,343,182,161,53.06
Viego,Brand,454,299,155,65.86
Viego,TahmKench,818,436,382,53.3
Viego,Leblanc,292,162,130,55.48
Viego,Samira,660,362,298,54.85
Viego,Shen,481,224,257,46.57
Viego,Graves,391,206,185,52.69
Viego,Taric,169,90,79,53.25
Viego,Rumble,143,90,53,62.94
Viego,Pantheon,1080,572,508,52.96
Viego,Urgot,338,153,185,45.27
Viego,Twitch,529,262,267,49.53
Viego,Kaisa,1081,518,563,47.92
Viego,Teemo,1124,580,544,51.6
Viego,Renekton,409,171,238,41.81
Viego,Sejuani,280,139,141,49.64
Viego,Taliyah,172,80,92,46.51
Viego,Diana,1038,548,490,52.79
Viego,MonkeyKing,439,216,223,49.2
Viego,Karma,450,180,270,40
Viego,Garen,991,467,524,47.12
Viego,Jhin,1438,713,725,49.58
Viego,Trundle,382,200,182,52.36
Viego,Zed,678,353,325,52.06
Viego,Fizz,371,169,202,45.55
Viego,Quinn,246,137,109,55.69
Viego,Sion,626,297,329,47.44
Viego,Jayce,258,137,121,53.1
Viego,KogMaw,254,118,136,46.46
Viego,Viktor,476,244,232,51.26
Viego,Riven,364,208,156,57.14
Viego,Neeko,519,285,234,54.91
Viego,Elise,468,273,195,58.33
Viego,Lux,1983,1037,946,52.29
Viego,Ornn,300,157,143,52.33
Viego,Hwei,480,251,229,52.29
Viego,Gangplank,322,139,183,43.17
Viego,Rell,365,172,193,47.12
Viego,Kindred,341,198,143,58.06
Viego,Tristana,633,309,324,48.82
Viego,Hecarim,284,146,138,51.41
Viego,Milio,346,138,208,39.88
Viego,LeeSin,831,420,411,50.54
Viego,AurelionSol,336,202,134,60.12
Viego,Annie,220,100,120,45.45
Viego,Singed,217,98,119,45.16
Viego,Nilah,362,187,175,51.66
Viego,Janna,219,126,93,57.53
Viego,Nocturne,594,301,293,50.67
Viego,Vayne,678,328,350,48.38
Viego,Kayle,389,214,175,55.01
Viego,Amumu,744,290,454,38.98
Viego,KSante,224,134,90,59.82
Viego,Vladimir,446,255,191,57.17
Viego,Vi,616,352,264,57.14
Viego,Katarina,677,342,335,50.52
Viego,Varus,564,293,271,51.95
Viego,Velkoz,406,195,211,48.03
Viego,DrMundo,453,217,236,47.9
Viego,Rengar,320,193,127,60.31
Viego,Nami,682,331,351,48.53
Viego,Belveth,246,89,157,36.18
Viego,Sylas,691,372,319,53.84
Viego,Senna,632,306,326,48.42
Viego,Swain,756,398,358,52.65
Viego,Irelia,595,292,303,49.08
Viego,Anivia,257,130,127,50.58
Viego,Kled,141,81,60,57.45
Viego,Gnar,316,199,117,62.97
Viego,TwistedFate,189,97,92,51.32
Viego,Akshan,312,132,180,42.31
Viego,Sona,249,152,97,61.04
Viego,Corki,247,134,113,54.25
Viego,Skarner,191,132,59,69.11
Viego,Lillia,586,287,299,48.98
Viego,Aurora,644,310,334,48.14
Viego,Lissandra,186,99,87,53.23
Viego,Lucian,395,195,200,49.37
Viego,Udyr,303,130,173,42.9
Viego,Talon,478,291,187,60.88
Viego,Xerath,507,266,241,52.47
Viego,Camille,161,91,70,56.52
Viego,Briar,732,372,360,50.82
Viego,Poppy,351,208,143,59.26
Viego,Kassadin,167,90,77,53.89
Viego,Zyra,493,241,252,48.88
Viego,Xayah,394,213,181,54.06
Viego,Qiyana,292,145,147,49.66
Viego,Zilean,197,128,69,64.97
Viego,Azir,280,174,106,62.14
Viego,Renata,144,81,63,56.25
Viego,Zac,318,174,144,54.72
Viego,Braum,290,103,187,35.52
Viego,Cassiopeia,259,100,159,38.61
Viego,RekSai,142,92,50,64.79
Viego,Karthus,176,88,88,50
Viego,Nidalee,103,56,47,54.37
Viego,Zoe,350,195,155,55.71
Viego,Tryndamere,503,231,272,45.92
Viego,Rakan,400,236,164,59
Viego,Rammus,240,117,123,48.75
Viego,Alistar,275,118,157,42.91
Viego,Ryze,213,131,82,61.5
Viego,Shyvana,202,85,117,42.08
Viego,Bard,204,72,132,35.29
Velkoz,Jax,203,122,81,60.1
Velkoz,XinZhao,218,104,114,47.71
Velkoz,Kennen,137,93,44,67.88
Velkoz,Kalista,142,101,41,71.13
Velkoz,Lulu,306,170,136,55.56
Velkoz,Kayle,271,149,122,54.98
Velkoz,Sylas,290,201,89,69.31
Velkoz,Qiyana,144,76,68,52.78
Velkoz,Caitlyn,933,470,463,50.38
Velkoz,Renata,80,58,22,72.5
Velkoz,Heimerdinger,155,66,89,42.58
Velkoz,Warwick,521,251,270,48.18
Velkoz,Neeko,286,168,118,58.74
Velkoz,Draven,226,128,98,56.64
Velkoz,Leona,235,111,124,47.23
Velkoz,Gangplank,213,116,97,54.46
Velkoz,Hwei,283,165,118,58.3
Velkoz,Mel,875,487,388,55.66
Velkoz,Hecarim,202,106,96,52.48
Velkoz,Milio,187,105,82,56.15
Velkoz,Teemo,555,232,323,41.8
Velkoz,Briar,357,189,168,52.94
Velkoz,Aurora,370,190,180,51.35
Velkoz,Kaisa,485,280,205,57.73
Velkoz,Karma,230,97,133,42.17
Velkoz,LeeSin,402,196,206,48.76
Velkoz,Chogath,482,252,230,52.28
Velkoz,Lucian,207,113,94,54.59
Velkoz,Xerath,314,181,133,57.64
Velkoz,Riven,161,78,83,48.45
Velkoz,Tristana,341,159,182,46.63
Velkoz,Zac,184,90,94,48.91
Velkoz,Darius,646,344,302,53.25
Velkoz,Shaco,437,250,187,57.21
Velkoz,Veigar,448,269,179,60.04
Velkoz,Ashe,610,368,242,60.33
Velkoz,Azir,115,63,52,54.78
Velkoz,Yorick,293,161,132,54.95
Velkoz,MasterYi,361,203,158,56.23
Velkoz,Irelia,354,166,188,46.89
Velkoz,Shen,276,144,132,52.17
Velkoz,Nami,366,190,176,51.91
Velkoz,Aatrox,370,218,152,58.92
Velkoz,Ezreal,633,288,345,45.5
Velkoz,Elise,218,119,99,54.59
Velkoz,Fiora,217,99,118,45.62
Velkoz,Gragas,227,155,72,68.28
Velkoz,Seraphine,499,255,244,51.1
Velkoz,Ziggs,174,93,81,53.45
Velkoz,Vayne,431,209,222,48.49
Velkoz,Jinx,738,374,364,50.68
Velkoz,Yasuo,772,387,385,50.13
Velkoz,Sejuani,129,48,81,37.21
Velkoz,TahmKench,439,239,200,54.44
Velkoz,DrMundo,284,91,193,32.04
Velkoz,Lux,1056,559,497,52.94
Velkoz,Pantheon,669,393,276,58.74
Velkoz,KSante,110,69,41,62.73
Velkoz,MonkeyKing,138,76,62,55.07
Velkoz,Ekko,278,175,103,62.95
Velkoz,Senna,320,166,154,51.88
Velkoz,Gwen,228,113,115,49.56
Velkoz,JarvanIV,154,82,72,53.25
Velkoz,Yone,746,421,325,56.43
Velkoz,Volibear,392,197,195,50.26
Velkoz,Talon,218,142,76,65.14
Velkoz,AurelionSol,181,95,86,52.49
Velkoz,Jhin,686,319,367,46.5
Velkoz,Vi,342,205,137,59.94
Velkoz,Kassadin,85,46,39,54.12
Velkoz,Corki,138,80,58,57.97
Velkoz,Blitzcrank,260,162,98,62.31
Velkoz,Mordekaiser,551,305,246,55.35
Velkoz,Nidalee,110,57,53,51.82
Velkoz,Ahri,520,256,264,49.23
Velkoz,Sona,158,92,66,58.23
Velkoz,Garen,560,293,267,52.32
Velkoz,Zed,401,254,147,63.34
Velkoz,Aphelios,278,124,154,44.6
Velkoz,Thresh,516,331,185,64.15
Velkoz,Khazix,231,120,111,51.95
Velkoz,Taric,85,38,47,44.71
Velkoz,Swain,385,199,186,51.69
Velkoz,Camille,154,110,44,71.43
Velkoz,Viktor,252,137,115,54.37
Velkoz,Kayn,592,275,317,46.45
Velkoz,Tryndamere,248,129,119,52.02
Velkoz,FiddleSticks,174,87,87,50
Velkoz,Singed,157,96,61,61.15
Velkoz,Galio,234,127,107,54.27
Velkoz,Bard,109,73,36,66.97
Velkoz,Diana,457,273,184,59.74
Velkoz,Rakan,248,108,140,43.55
Velkoz,Malzahar,245,90,155,36.73
Velkoz,TwistedFate,126,74,52,58.73
Velkoz,Maokai,185,83,102,44.86
Velkoz,Gnar,178,118,60,66.29
Velkoz,Katarina,295,165,130,55.93
Velkoz,Samira,324,162,162,50
Velkoz,Poppy,214,83,131,38.79
Velkoz,Viego,406,211,195,51.97
Velkoz,Orianna,155,68,87,43.87
Velkoz,Vladimir,180,122,58,67.78
Velkoz,Rammus,107,62,45,57.94
Velkoz,Nautilus,427,245,182,57.38
Velkoz,Naafiri,230,123,107,53.48
Velkoz,Zeri,190,100,90,52.63
Velkoz,Brand,237,94,143,39.66
Velkoz,Smolder,257,131,126,50.97
Velkoz,Shyvana,92,28,64,30.43
Velkoz,Zilean,198,99,99,50
Velkoz,Kled,84,40,44,47.62
Velkoz,Nunu,245,129,116,52.65
Velkoz,Annie,75,47,28,62.67
Velkoz,MissFortune,718,405,313,56.41
Velkoz,Yuumi,353,180,173,50.99
Velkoz,Nasus,283,171,112,60.42
Velkoz,Udyr,125,77,48,61.6
Velkoz,Quinn,149,85,64,57.05
Velkoz,Kindred,187,124,63,66.31
Velkoz,Lissandra,107,68,39,63.55
Velkoz,Renekton,206,107,99,51.94
Velkoz,Soraka,230,123,107,53.48
Velkoz,Syndra,252,136,116,53.97
Velkoz,Zyra,229,93,136,40.61
Velkoz,Cassiopeia,201,118,83,58.71
Velkoz,Alistar,124,54,70,43.55
Velkoz,Rengar,188,112,76,59.57
Velkoz,Ryze,164,88,76,53.66
Velkoz,Malphite,293,157,136,53.58
Velkoz,Leblanc,169,98,71,57.99
Velkoz,Akali,406,208,198,51.23
Velkoz,Fizz,197,77,120,39.09
Velkoz,Vex,220,129,91,58.64
Velkoz,Morgana,474,250,224,52.74
Velkoz,Illaoi,143,89,54,62.24
Velkoz,Xayah,233,104,129,44.64
Velkoz,Braum,192,111,81,57.81
Velkoz,Sett,610,296,314,48.52
Velkoz,Akshan,129,68,61,52.71
Velkoz,Varus,329,179,150,54.41
Velkoz,Olaf,53,28,25,52.83
Velkoz,Nocturne,298,135,163,45.3
Velkoz,Twitch,347,163,184,46.97
Velkoz,Ambessa,264,144,120,54.55
Velkoz,Rell,174,94,80,54.02
Velkoz,Lillia,233,137,96,58.8
Velkoz,Graves,167,93,74,55.69
Velkoz,Ornn,154,76,78,49.35
Velkoz,Skarner,108,61,47,56.48
Velkoz,Amumu,342,129,213,37.72
Velkoz,Anivia,138,80,58,57.97
Velkoz,Trundle,206,97,109,47.09
Velkoz,KogMaw,152,66,86,43.42
Velkoz,RekSai,50,19,31,38
Velkoz,Sion,316,141,175,44.62
Velkoz,Evelynn,219,117,102,53.42
Velkoz,Nilah,225,158,67,70.22
Velkoz,Belveth,107,49,58,45.79
Velkoz,Janna,86,50,36,58.14
Velkoz,Pyke,397,183,214,46.1
Velkoz,Taliyah,93,51,42,54.84
Velkoz,Sivir,182,101,81,55.49
Velkoz,Ivern,111,58,53,52.25
Velkoz,Rumble,51,34,17,66.67
Velkoz,Zoe,172,113,59,65.7
Velkoz,Karthus,82,61,21,74.39
Velkoz,Urgot,129,35,94,27.13
Velkoz,Jayce,150,75,75,50
Kaisa,Jax,694,305,389,43.95
Kaisa,XinZhao,425,226,199,53.18
Kaisa,Kennen,241,125,116,51.87
Kaisa,Kalista,354,216,138,61.02
Kaisa,Lulu,582,304,278,52.23
Kaisa,Teemo,1002,377,625,37.62
Kaisa,Warwick,1254,565,689,45.06
Kaisa,Azir,302,158,144,52.32
Kaisa,MissFortune,1758,812,946,46.19
Kaisa,Neeko,474,221,253,46.62
Kaisa,Trundle,411,176,235,42.82
Kaisa,MasterYi,757,333,424,43.99
Kaisa,Veigar,941,444,497,47.18
Kaisa,Jhin,1566,779,787,49.74
Kaisa,Soraka,539,229,310,42.49
Kaisa,TahmKench,927,488,439,52.64
Kaisa,Jinx,1800,836,964,46.44
Kaisa,Zoe,393,215,178,54.71
Kaisa,Nami,716,346,370,48.32
Kaisa,Gwen,602,291,311,48.34
Kaisa,JarvanIV,306,133,173,43.46
Kaisa,Yone,1773,860,913,48.51
Kaisa,Zyra,611,204,407,33.39
Kaisa,Seraphine,884,454,430,51.36
Kaisa,Irelia,821,377,444,45.92
Kaisa,Pantheon,1328,666,662,50.15
Kaisa,Kassadin,204,89,115,43.63
Kaisa,Yuumi,765,332,433,43.4
Kaisa,Diana,1069,510,559,47.71
Kaisa,Lux,2304,1029,1275,44.66
Kaisa,Tristana,741,335,406,45.21
Kaisa,Mel,1798,813,985,45.22
Kaisa,FiddleSticks,444,185,259,41.67
Kaisa,Shaco,791,389,402,49.18
Kaisa,Syndra,440,224,216,50.91
Kaisa,Thresh,1136,518,618,45.6
Kaisa,Mordekaiser,1259,597,662,47.42
Kaisa,Karma,531,274,257,51.6
Kaisa,Naafiri,343,152,191,44.31
Kaisa,Nunu,691,328,363,47.47
Kaisa,Malzahar,596,273,323,45.81
Kaisa,Zeri,332,154,178,46.39
Kaisa,Smolder,653,314,339,48.09
Kaisa,Yasuo,1537,797,740,51.85
Kaisa,Caitlyn,2062,922,1140,44.71
Kaisa,Velkoz,485,205,280,42.27
Kaisa,Ornn,303,134,169,44.22
Kaisa,TwistedFate,344,175,169,50.87
Kaisa,Morgana,972,435,537,44.75
Kaisa,Yorick,597,283,314,47.4
Kaisa,Samira,875,408,467,46.63
Kaisa,Zed,840,457,383,54.4
Kaisa,Viktor,593,283,310,47.72
Kaisa,Pyke,906,503,403,55.52
Kaisa,Olaf,222,118,104,53.15
Kaisa,Hecarim,357,159,198,44.54
Kaisa,Braum,421,195,226,46.32
Kaisa,Volibear,961,377,584,39.23
Kaisa,Evelynn,428,209,219,48.83
Kaisa,Katarina,727,323,404,44.43
Kaisa,Nocturne,674,326,348,48.37
Kaisa,Vi,642,286,356,44.55
Kaisa,Amumu,848,327,521,38.56
Kaisa,Akshan,321,155,166,48.29
Kaisa,Ezreal,1623,805,818,49.6
Kaisa,Orianna,329,108,221,32.83
Kaisa,Malphite,600,281,319,46.83
Kaisa,Nautilus,956,446,510,46.65
Kaisa,Akali,947,449,498,47.41
Kaisa,LeeSin,816,441,375,54.04
Kaisa,Camille,234,148,86,63.25
Kaisa,Xayah,601,260,341,43.26
Kaisa,Tryndamere,381,152,229,39.9
Kaisa,Sivir,436,221,215,50.69
Kaisa,Graves,489,258,231,52.76
Kaisa,Maokai,338,154,184,45.56
Kaisa,Gnar,299,126,173,42.14
Kaisa,Taric,195,56,139,28.72
Kaisa,Jayce,299,178,121,59.53
Kaisa,Skarner,263,124,139,47.15
Kaisa,Poppy,496,219,277,44.15
Kaisa,Chogath,1071,571,500,53.31
Kaisa,Talon,489,265,224,54.19
Kaisa,Nilah,551,234,317,42.47
Kaisa,Milio,418,187,231,44.74
Kaisa,Leona,639,317,322,49.61
Kaisa,Aurora,832,360,472,43.27
Kaisa,Kayn,1289,570,719,44.22
Kaisa,Ziggs,244,115,129,47.13
Kaisa,Senna,772,341,431,44.17
Kaisa,Sett,1288,625,663,48.52
Kaisa,Renata,208,86,122,41.35
Kaisa,Rammus,246,109,137,44.31
Kaisa,Renekton,392,196,196,50
Kaisa,Sion,638,309,329,48.43
Kaisa,Ashe,1354,665,689,49.11
Kaisa,Briar,895,401,494,44.8
Kaisa,Draven,510,242,268,47.45
Kaisa,Darius,1457,744,713,51.06
Kaisa,Viego,1081,563,518,52.08
Kaisa,Vayne,970,363,607,37.42
Kaisa,Taliyah,261,102,159,39.08
Kaisa,Singed,272,121,151,44.49
Kaisa,Brand,518,261,257,50.39
Kaisa,Nasus,588,246,342,41.84
Kaisa,Zac,250,116,134,46.4
Kaisa,Swain,1028,436,592,42.41
Kaisa,Rengar,374,222,152,59.36
Kaisa,Hwei,535,260,275,48.6
Kaisa,KogMaw,260,130,130,50
Kaisa,Heimerdinger,413,157,256,38.01
Kaisa,Urgot,419,178,241,42.48
Kaisa,Xerath,388,170,218,43.81
Kaisa,Aatrox,757,384,373,50.73
Kaisa,Ryze,199,94,105,47.24
Kaisa,Janna,293,128,165,43.69
Kaisa,Vladimir,476,225,251,47.27
Kaisa,Aphelios,605,231,374,38.18
Kaisa,Alistar,256,142,114,55.47
Kaisa,Twitch,684,286,398,41.81
Kaisa,Blitzcrank,615,268,347,43.58
Kaisa,Shen,659,281,378,42.64
Kaisa,Lillia,581,296,285,50.95
Kaisa,Khazix,552,247,305,44.75
Kaisa,Anivia,300,172,128,57.33
Kaisa,DrMundo,599,254,345,42.4
Kaisa,Kayle,567,243,324,42.86
Kaisa,Udyr,313,131,182,41.85
Kaisa,Rell,482,240,242,49.79
Kaisa,Galio,586,243,343,41.47
Kaisa,Lucian,541,275,266,50.83
Kaisa,Ekko,547,271,276,49.54
Kaisa,Riven,380,177,203,46.58
Kaisa,Ahri,1097,527,570,48.04
Kaisa,Garen,1136,430,706,37.85
Kaisa,Nidalee,198,81,117,40.91
Kaisa,Lissandra,231,126,105,54.55
Kaisa,Sylas,689,338,351,49.06
Kaisa,Bard,212,64,148,30.19
Kaisa,Kindred,513,303,210,59.06
Kaisa,Ambessa,472,259,213,54.87
Kaisa,Varus,678,329,349,48.53
Kaisa,Illaoi,405,185,220,45.68
Kaisa,Annie,252,119,133,47.22
Kaisa,Fiora,363,212,151,58.4
Kaisa,KSante,274,147,127,53.65
Kaisa,Karthus,267,118,149,44.19
Kaisa,Belveth,261,136,125,52.11
Kaisa,Leblanc,274,127,147,46.35
Kaisa,Gangplank,337,173,164,51.34
Kaisa,Elise,498,276,222,55.42
Kaisa,Corki,288,146,142,50.69
Kaisa,Cassiopeia,329,174,155,52.89
Kaisa,Rakan,491,196,295,39.92
Kaisa,Vex,421,182,239,43.23
Kaisa,Ivern,172,92,80,53.49
Kaisa,Fizz,434,185,249,42.63
Kaisa,Gragas,490,252,238,51.43
Kaisa,Sejuani,341,113,228,33.14
Kaisa,Kled,148,52,96,35.14
Kaisa,Sona,319,146,173,45.77
Kaisa,AurelionSol,432,183,249,42.36
Kaisa,Shyvana,167,55,112,32.93
Kaisa,Qiyana,213,110,103,51.64
Kaisa,Rumble,156,56,100,35.9
Kaisa,Zilean,212,79,133,37.26
Kaisa,MonkeyKing,405,140,265,34.57
Kaisa,RekSai,131,56,75,42.75
Kaisa,Quinn,327,209,118,63.91
Karma,Jax,336,196,140,58.33
Karma,XinZhao,271,167,104,61.62
Karma,Kennen,143,86,57,60.14
Karma,Kalista,216,95,121,43.98
Karma,Lulu,346,182,164,52.6
Karma,Maokai,155,53,102,34.19
Karma,Graves,204,115,89,56.37
Karma,Ahri,525,246,279,46.86
Karma,Nilah,256,116,140,45.31
Karma,Malphite,346,171,175,49.42
Karma,Nasus,306,142,164,46.41
Karma,Shaco,338,168,170,49.7
Karma,Zed,346,190,156,54.91
Karma,Varus,278,131,147,47.12
Karma,Neeko,260,115,145,44.23
Karma,Volibear,451,213,238,47.23
Karma,Ekko,299,159,140,53.18
Karma,Akshan,166,112,54,67.47
Karma,Yasuo,717,351,366,48.95
Karma,Katarina,395,222,173,56.2
Karma,Chogath,506,250,256,49.41
Karma,Leblanc,183,102,81,55.74
Karma,Caitlyn,1014,482,532,47.53
Karma,Milio,284,107,177,37.68
Karma,Sylas,324,177,147,54.63
Karma,Amumu,345,150,195,43.48
Karma,Vex,189,99,90,52.38
Karma,Kaisa,531,257,274,48.4
Karma,Rakan,220,116,104,52.73
Karma,Gangplank,246,136,110,55.28
Karma,Lillia,247,124,123,50.2
Karma,MissFortune,839,389,450,46.36
Karma,Soraka,252,133,119,52.78
Karma,Smolder,322,202,120,62.73
Karma,Warwick,575,260,315,45.22
Karma,Velkoz,230,133,97,57.83
Karma,Mordekaiser,525,256,269,48.76
Karma,Mel,972,523,449,53.81
Karma,Ashe,723,361,362,49.93
Karma,Jayce,137,71,66,51.82
Karma,Gragas,255,134,121,52.55
Karma,Darius,725,314,411,43.31
Karma,MasterYi,392,169,223,43.11
Karma,Taric,54,23,31,42.59
Karma,Garen,618,299,319,48.38
Karma,Talon,279,128,151,45.88
Karma,Tristana,338,162,176,47.93
Karma,Aurora,406,189,217,46.55
Karma,Nocturne,297,144,153,48.48
Karma,Pantheon,627,308,319,49.12
Karma,Sett,638,324,314,50.78
Karma,Samira,380,189,191,49.74
Karma,Illaoi,150,85,65,56.67
Karma,Evelynn,187,92,95,49.2
Karma,Hwei,259,149,110,57.53
Karma,Senna,354,182,172,51.41
Karma,Gwen,218,103,115,47.25
Karma,Elise,290,154,136,53.1
Karma,Aatrox,385,187,198,48.57
Karma,Twitch,344,142,202,41.28
Karma,Ryze,165,77,88,46.67
Karma,Jhin,733,397,336,54.16
Karma,Nautilus,349,177,172,50.72
Karma,Poppy,256,136,120,53.13
Karma,Nami,422,208,214,49.29
Karma,Irelia,299,155,144,51.84
Karma,Orianna,205,113,92,55.12
Karma,Ezreal,719,397,322,55.22
Karma,Bard,166,109,57,65.66
Karma,Sion,371,165,206,44.47
Karma,Yorick,400,207,193,51.75
Karma,Xerath,352,157,195,44.6
Karma,Akali,404,191,213,47.28
Karma,Kayn,663,290,373,43.74
Karma,Ziggs,185,88,97,47.57
Karma,Naafiri,154,88,66,57.14
Karma,Lux,1229,556,673,45.24
Karma,Belveth,128,42,86,32.81
Karma,Viego,450,270,180,60
Karma,Yuumi,459,170,289,37.04
Karma,Qiyana,136,66,70,48.53
Karma,Singed,133,66,67,49.62
Karma,Riven,205,108,97,52.68
Karma,LeeSin,454,257,197,56.61
Karma,Olaf,63,48,15,76.19
Karma,Draven,202,111,91,54.95
Karma,Thresh,458,233,225,50.87
Karma,Swain,490,251,239,51.22
Karma,Shen,349,194,155,55.59
Karma,Veigar,369,210,159,56.91
Karma,Blitzcrank,217,111,106,51.15
Karma,Ambessa,181,99,82,54.7
Karma,Jinx,708,313,395,44.21
Karma,Brand,213,132,81,61.97
Karma,Fizz,186,95,91,51.08
Karma,Yone,648,335,313,51.7
Karma,Karthus,84,64,20,76.19
Karma,Diana,469,188,281,40.09
Karma,Skarner,111,62,49,55.86
Karma,Malzahar,305,152,153,49.84
Karma,Vi,376,180,196,47.87
Karma,Gnar,123,97,26,78.86
Karma,FiddleSticks,203,81,122,39.9
Karma,Leona,300,131,169,43.67
Karma,Nunu,342,187,155,54.68
Karma,Zoe,209,142,67,67.94
Karma,TahmKench,402,234,168,58.21
Karma,Renekton,185,84,101,45.41
Karma,Rammus,98,42,56,42.86
Karma,Hecarim,152,84,68,55.26
Karma,Briar,350,170,180,48.57
Karma,KogMaw,146,78,68,53.42
Karma,Seraphine,405,197,208,48.64
Karma,Rell,224,119,105,53.13
Karma,Kayle,316,149,167,47.15
Karma,Vayne,386,170,216,44.04
Karma,Lissandra,76,47,29,61.84
Karma,Morgana,580,304,276,52.41
Karma,Camille,142,79,63,55.63
Karma,Lucian,211,120,91,56.87
Karma,Tryndamere,216,117,99,54.17
Karma,Sona,174,67,107,38.51
Karma,Sivir,191,76,115,39.79
Karma,Trundle,205,63,142,30.73
Karma,Khazix,279,144,135,51.61
Karma,Galio,238,117,121,49.16
Karma,Braum,230,118,112,51.3
Karma,Alistar,108,57,51,52.78
Karma,Zyra,306,148,158,48.37
Karma,Fiora,218,129,89,59.17
Karma,Cassiopeia,144,88,56,61.11
Karma,Anivia,158,75,83,47.47
Karma,Sejuani,167,69,98,41.32
Karma,Kindred,195,107,88,54.87
Karma,Viktor,340,193,147,56.76
Karma,DrMundo,215,94,121,43.72
Karma,Quinn,109,49,60,44.95
Karma,Xayah,215,122,93,56.74
Karma,Syndra,249,116,133,46.59
Karma,Zac,161,83,78,51.55
Karma,Ornn,155,48,107,30.97
Karma,Shyvana,83,45,38,54.22
Karma,Rengar,238,118,120,49.58
Karma,Ivern,99,56,43,56.57
Karma,Corki,124,59,65,47.58
Karma,RekSai,30,9,21,30
Karma,Vladimir,273,144,129,52.75
Karma,KSante,130,93,37,71.54
Karma,Udyr,164,101,63,61.59
Karma,Janna,123,47,76,38.21
Karma,Teemo,541,223,318,41.22
Karma,Kassadin,93,35,58,37.63
Karma,Zeri,166,89,77,53.61
Karma,Pyke,449,250,199,55.68
Karma,Azir,87,44,43,50.57
Karma,Urgot,208,104,104,50
Karma,TwistedFate,179,120,59,67.04
Karma,Aphelios,333,183,150,54.95
Karma,Heimerdinger,207,92,115,44.44
Karma,Annie,100,43,57,43
Karma,MonkeyKing,220,102,118,46.36
Karma,JarvanIV,135,63,72,46.67
Karma,Taliyah,111,53,58,47.75
Karma,Renata,106,52,54,49.06
Karma,Zilean,109,46,63,42.2
Karma,Nidalee,98,58,40,59.18
Karma,AurelionSol,126,38,88,30.16
Karma,Rumble,76,37,39,48.68
Karma,Kled,79,48,31,60.76
Aatrox,Kennen,232,117,115,50.43
Aatrox,Warwick,882,389,493,44.1
Aatrox,Yasuo,1238,554,684,44.75
Aatrox,Kindred,344,173,171,50.29
Aatrox,Lux,1561,731,830,46.83
Aatrox,Yorick,538,191,347,35.5
Aatrox,Kayn,942,442,500,46.92
Aatrox,Ryze,164,118,46,71.95
Aatrox,Pantheon,947,363,584,38.33
Aatrox,Naafiri,304,116,188,38.16
Aatrox,Briar,629,298,331,47.38
Aatrox,Yone,1236,604,632,48.87
Aatrox,MissFortune,1228,522,706,42.51
Aatrox,Senna,468,230,238,49.15
Aatrox,Kayle,522,245,277,46.93
Aatrox,Viego,792,330,462,41.67
Aatrox,Irelia,605,275,330,45.45
Aatrox,Jinx,1219,563,656,46.19
Aatrox,Thresh,769,406,363,52.8
Aatrox,Darius,1212,580,632,47.85
Aatrox,Rengar,299,205,94,68.56
Aatrox,Syndra,267,119,148,44.57
Aatrox,Caitlyn,1357,624,733,45.98
Aatrox,XinZhao,292,120,172,41.1
Aatrox,Katarina,506,250,256,49.41
Aatrox,Teemo,1027,420,607,40.9
Aatrox,Vayne,522,210,312,40.23
Aatrox,TwistedFate,223,111,112,49.78
Aatrox,Shen,331,133,198,40.18
Aatrox,Diana,782,389,393,49.74
Aatrox,Samira,579,285,294,49.22
Aatrox,Soraka,366,188,178,51.37
Aatrox,Garen,911,453,458,49.73
Aatrox,FiddleSticks,306,149,157,48.69
Aatrox,Brand,357,167,190,46.78
Aatrox,Tryndamere,287,157,130,54.7
Aatrox,Graves,312,148,164,47.44
Aatrox,Sylas,477,215,262,45.07
Aatrox,Leona,453,215,238,47.46
Aatrox,Mordekaiser,930,369,561,39.68
Aatrox,Janna,199,73,126,36.68
Aatrox,Volibear,610,261,349,42.79
Aatrox,Khazix,386,167,219,43.26
Aatrox,Akali,668,354,314,52.99
Aatrox,Draven,282,81,201,28.72
Aatrox,Mel,1269,648,621,51.06
Aatrox,Smolder,485,240,245,49.48
Aatrox,Rell,324,186,138,57.41
Aatrox,Sett,1014,479,535,47.24
Aatrox,Tristana,517,205,312,39.65
Aatrox,Blitzcrank,475,227,248,47.79
Aatrox,Poppy,343,168,175,48.98
Aatrox,Nunu,517,232,285,44.87
Aatrox,Zed,490,265,225,54.08
Aatrox,Rakan,374,168,206,44.92
Aatrox,Fiora,304,150,154,49.34
Aatrox,Ekko,453,224,229,49.45
Aatrox,Kassadin,131,86,45,65.65
Aatrox,TahmKench,666,339,327,50.9
Aatrox,Camille,191,115,76,60.21
Aatrox,Xayah,362,200,162,55.25
Aatrox,Yuumi,567,256,311,45.15
Aatrox,Veigar,653,319,334,48.85
Aatrox,KSante,234,152,82,64.96
Aatrox,Jax,429,191,238,44.52
Aatrox,Velkoz,370,152,218,41.08
Aatrox,Gangplank,248,114,134,45.97
Aatrox,Malzahar,403,155,248,38.46
Aatrox,Heimerdinger,273,120,153,43.96
Aatrox,Ashe,944,460,484,48.73
Aatrox,Pyke,621,375,246,60.39
Aatrox,Nasus,406,174,232,42.86
Aatrox,Azir,170,90,80,52.94
Aatrox,Nami,604,263,341,43.54
Aatrox,Shaco,577,289,288,50.09
Aatrox,Annie,216,109,107,50.46
Aatrox,Olaf,76,32,44,42.11
Aatrox,Aurora,547,280,267,51.19
Aatrox,Vladimir,296,169,127,57.09
Aatrox,Gnar,259,150,109,57.92
Aatrox,Twitch,473,233,240,49.26
Aatrox,Xerath,333,136,197,40.84
Aatrox,Morgana,742,280,462,37.74
Aatrox,Zoe,273,134,139,49.08
Aatrox,Karma,385,198,187,51.43
Aatrox,Ornn,262,134,128,51.15
Aatrox,Kalista,238,130,108,54.62
Aatrox,Chogath,712,346,366,48.6
Aatrox,Hecarim,197,100,97,50.76
Aatrox,Malphite,553,270,283,48.82
Aatrox,Maokai,248,101,147,40.73
Aatrox,Sona,184,82,102,44.57
Aatrox,Ivern,105,73,32,69.52
Aatrox,Belveth,151,78,73,51.66
Aatrox,Jhin,959,474,485,49.43
Aatrox,LeeSin,545,298,247,54.68
Aatrox,Lillia,383,192,191,50.13
Aatrox,Jayce,241,127,114,52.7
Aatrox,DrMundo,428,182,246,42.52
Aatrox,Seraphine,648,282,366,43.52
Aatrox,Galio,329,151,178,45.9
Aatrox,Nilah,370,176,194,47.57
Aatrox,Urgot,348,163,185,46.84
Aatrox,MasterYi,551,235,316,42.65
Aatrox,Sejuani,201,111,90,55.22
Aatrox,Amumu,410,165,245,40.24
Aatrox,Ahri,688,342,346,49.71
Aatrox,Nautilus,673,293,380,43.54
Aatrox,Qiyana,191,68,123,35.6
Aatrox,Rumble,129,75,54,58.14
Aatrox,Ambessa,319,112,207,35.11
Aatrox,Elise,307,158,149,51.47
Aatrox,Kaisa,757,373,384,49.27
Aatrox,Vi,473,249,224,52.64
Aatrox,Vex,381,189,192,49.61
Aatrox,Milio,365,148,217,40.55
Aatrox,Zeri,269,131,138,48.7
Aatrox,Singed,192,59,133,30.73
Aatrox,Orianna,203,71,132,34.98
Aatrox,Zilean,197,94,103,47.72
Aatrox,Lucian,362,186,176,51.38
Aatrox,Cassiopeia,212,118,94,55.66
Aatrox,Aphelios,357,175,182,49.02
Aatrox,MonkeyKing,267,115,152,43.07
Aatrox,Trundle,258,111,147,43.02
Aatrox,Illaoi,299,129,170,43.14
Aatrox,Gragas,424,169,255,39.86
Aatrox,Braum,217,103,114,47.47
Aatrox,Nidalee,193,96,97,49.74
Aatrox,Lulu,483,240,243,49.69
Aatrox,Karthus,143,61,82,42.66
Aatrox,Neeko,443,199,244,44.92
Aatrox,Ziggs,233,92,141,39.48
Aatrox,JarvanIV,233,126,107,54.08
Aatrox,Evelynn,333,169,164,50.75
Aatrox,Leblanc,220,107,113,48.64
Aatrox,Ezreal,979,450,529,45.97
Aatrox,Gwen,287,151,136,52.61
Aatrox,Skarner,177,111,66,62.71
Aatrox,Varus,442,201,241,45.48
Aatrox,Corki,158,85,73,53.8
Aatrox,Rammus,160,87,73,54.38
Aatrox,Fizz,326,159,167,48.77
Aatrox,Swain,653,338,315,51.76
Aatrox,Kled,114,49,65,42.98
Aatrox,Sivir,269,118,151,43.87
Aatrox,Udyr,256,131,125,51.17
Aatrox,Riven,249,111,138,44.58
Aatrox,Renekton,271,88,183,32.47
Aatrox,Hwei,446,198,248,44.39
Aatrox,KogMaw,195,53,142,27.18
Aatrox,RekSai,87,43,44,49.43
Aatrox,Anivia,201,99,102,49.25
Aatrox,Alistar,171,72,99,42.11
Aatrox,Sion,561,287,274,51.16
Aatrox,Talon,345,184,161,53.33
Aatrox,Akshan,167,64,103,38.32
Aatrox,Lissandra,110,47,63,42.73
Aatrox,Renata,158,57,101,36.08
Aatrox,Nocturne,462,192,270,41.56
Aatrox,Viktor,382,153,229,40.05
Aatrox,AurelionSol,258,85,173,32.95
Aatrox,Quinn,174,91,83,52.3
Aatrox,Zyra,344,151,193,43.9
Aatrox,Taliyah,129,59,70,45.74
Aatrox,Shyvana,94,17,77,18.09
Aatrox,Zac,224,137,87,61.16
Aatrox,Bard,216,118,98,54.63
Aatrox,Taric,106,83,23,78.3
Sylas,Kennen,203,118,85,58.13
Sylas,Warwick,920,423,497,45.98
Sylas,Yasuo,1258,563,695,44.75
Sylas,Kindred,301,175,126,58.14
Sylas,Lux,1430,741,689,51.82
Sylas,Maokai,245,119,126,48.57
Sylas,Graves,399,160,239,40.1
Sylas,Ahri,829,373,456,44.99
Sylas,Nilah,324,192,132,59.26
Sylas,Malphite,550,330,220,60
Sylas,Mordekaiser,909,447,462,49.17
Sylas,Qiyana,218,122,96,55.96
Sylas,Ashe,943,474,469,50.27
Sylas,Sona,220,116,104,52.73
Sylas,Illaoi,294,132,162,44.9
Sylas,Twitch,398,198,200,49.75
Sylas,Yone,1125,645,480,57.33
Sylas,Velkoz,290,89,201,30.69
Sylas,Swain,752,391,361,51.99
Sylas,Malzahar,355,155,200,43.66
Sylas,Irelia,489,271,218,55.42
Sylas,Kalista,275,180,95,65.45
Sylas,Poppy,271,126,145,46.49
Sylas,Kayle,465,242,223,52.04
Sylas,MonkeyKing,273,118,155,43.22
Sylas,RekSai,70,36,34,51.43
Sylas,Seraphine,666,375,291,56.31
Sylas,Briar,549,233,316,42.44
Sylas,Evelynn,281,176,105,62.63
Sylas,Tristana,509,245,264,48.13
Sylas,Thresh,594,286,308,48.15
Sylas,Ryze,168,70,98,41.67
Sylas,Morgana,692,315,377,45.52
Sylas,Xayah,365,165,200,45.21
Sylas,Veigar,784,403,381,51.4
Sylas,FiddleSticks,386,200,186,51.81
Sylas,Akali,594,331,263,55.72
Sylas,Senna,403,231,172,57.32
Sylas,Kayn,946,481,465,50.85
Sylas,TwistedFate,206,96,110,46.6
Sylas,Smolder,465,239,226,51.4
Sylas,Nautilus,614,301,313,49.02
Sylas,Diana,674,349,325,51.78
Sylas,MissFortune,1233,577,656,46.8
Sylas,Karma,324,147,177,45.37
Sylas,Pantheon,951,436,515,45.85
Sylas,Garen,860,366,494,42.56
Sylas,Ziggs,246,141,105,57.32
Sylas,Zeri,280,115,165,41.07
Sylas,Zyra,357,185,172,51.82
Sylas,Nocturne,435,216,219,49.66
Sylas,Lissandra,143,84,59,58.74
Sylas,Jhin,934,490,444,52.46
Sylas,Mel,1205,693,512,57.51
Sylas,Singed,146,78,68,53.42
Sylas,Pyke,804,466,338,57.96
Sylas,Aatrox,477,262,215,54.93
Sylas,Ezreal,1218,568,650,46.63
Sylas,Milio,311,169,142,54.34
Sylas,Yorick,443,230,213,51.92
Sylas,Gragas,323,175,148,54.18
Sylas,Volibear,602,333,269,55.32
Sylas,Khazix,341,213,128,62.46
Sylas,Draven,301,144,157,47.84
Sylas,Gnar,282,179,103,63.48
Sylas,Jax,448,204,244,45.54
Sylas,Aurora,550,284,266,51.64
Sylas,Bard,219,110,109,50.23
Sylas,Riven,264,124,140,46.97
Sylas,Syndra,230,105,125,45.65
Sylas,Jinx,1064,528,536,49.62
Sylas,Zed,552,313,239,56.7
Sylas,Talon,383,245,138,63.97
Sylas,Rammus,146,81,65,55.48
Sylas,Akshan,185,78,107,42.16
Sylas,Chogath,913,480,433,52.57
Sylas,Lillia,364,161,203,44.23
Sylas,Vex,351,128,223,36.47
Sylas,Janna,167,61,106,36.53
Sylas,Sett,959,459,500,47.86
Sylas,Cassiopeia,213,109,104,51.17
Sylas,Fiora,245,140,105,57.14
Sylas,LeeSin,504,288,216,57.14
Sylas,Zilean,173,88,85,50.87
Sylas,Rengar,208,117,91,56.25
Sylas,Anivia,186,84,102,45.16
Sylas,Galio,469,230,239,49.04
Sylas,Naafiri,291,142,149,48.8
Sylas,Vi,431,237,194,54.99
Sylas,Aphelios,441,228,213,51.7
Sylas,Heimerdinger,355,133,222,37.46
Sylas,Varus,372,198,174,53.23
Sylas,Gwen,321,170,151,52.96
Sylas,JarvanIV,235,130,105,55.32
Sylas,Leblanc,175,92,83,52.57
Sylas,Samira,525,267,258,50.86
Sylas,Shen,326,130,196,39.88
Sylas,Darius,1047,495,552,47.28
Sylas,Shaco,492,273,219,55.49
Sylas,Zoe,248,146,102,58.87
Sylas,Ivern,127,44,83,34.65
Sylas,Quinn,192,137,55,71.35
Sylas,TahmKench,621,282,339,45.41
Sylas,XinZhao,352,192,160,54.55
Sylas,AurelionSol,216,102,114,47.22
Sylas,Rakan,300,145,155,48.33
Sylas,Shyvana,101,56,45,55.45
Sylas,Viktor,390,215,175,55.13
Sylas,Lucian,316,160,156,50.63
Sylas,Soraka,360,191,169,53.06
Sylas,Neeko,411,210,201,51.09
Sylas,Xerath,384,188,196,48.96
Sylas,Renekton,264,166,98,62.88
Sylas,Sivir,308,130,178,42.21
Sylas,Sejuani,245,137,108,55.92
Sylas,Blitzcrank,438,219,219,50
Sylas,Ornn,284,128,156,45.07
Sylas,Vayne,565,265,300,46.9
Sylas,Nasus,467,216,251,46.25
Sylas,Amumu,571,259,312,45.36
Sylas,Caitlyn,1163,598,565,51.42
Sylas,KogMaw,206,97,109,47.09
Sylas,Ekko,443,216,227,48.76
Sylas,Yuumi,499,234,265,46.89
Sylas,Katarina,466,241,225,51.72
Sylas,Lulu,385,226,159,58.7
Sylas,Gangplank,262,112,150,42.75
Sylas,Skarner,210,113,97,53.81
Sylas,Vladimir,288,144,144,50
Sylas,Rell,277,164,113,59.21
Sylas,Viego,691,319,372,46.16
Sylas,KSante,251,88,163,35.06
Sylas,Teemo,807,356,451,44.11
Sylas,Braum,290,129,161,44.48
Sylas,Kaisa,689,351,338,50.94
Sylas,DrMundo,368,189,179,51.36
Sylas,Annie,111,53,58,47.75
Sylas,Urgot,291,131,160,45.02
Sylas,Kassadin,120,60,60,50
Sylas,Taliyah,158,95,63,60.13
Sylas,Kled,117,49,68,41.88
Sylas,Nami,530,259,271,48.87
Sylas,Udyr,177,82,95,46.33
Sylas,Camille,152,75,77,49.34
Sylas,Nidalee,137,58,79,42.34
Sylas,MasterYi,552,209,343,37.86
Sylas,Corki,141,81,60,57.45
Sylas,Orianna,289,149,140,51.56
Sylas,Elise,331,180,151,54.38
Sylas,Zac,148,65,83,43.92
Sylas,Alistar,212,121,91,57.08
Sylas,Tryndamere,299,127,172,42.47
Sylas,Leona,497,257,240,51.71
Sylas,Ambessa,261,110,151,42.15
Sylas,Nunu,537,267,270,49.72
Sylas,Azir,185,94,91,50.81
Sylas,Rumble,123,64,59,52.03
Sylas,Sion,449,233,216,51.89
Sylas,Hwei,382,172,210,45.03
Sylas,Belveth,160,88,72,55
Sylas,Brand,402,229,173,56.97
Sylas,Fizz,344,146,198,42.44
Sylas,Jayce,202,102,100,50.5
Sylas,Hecarim,184,127,57,69.02
Sylas,Trundle,317,143,174,45.11
Sylas,Olaf,116,47,69,40.52
Sylas,Karthus,134,84,50,62.69
Sylas,Taric,126,67,59,53.17
Sylas,Renata,119,40,79,33.61
Diana,Kennen,267,147,120,55.06
Diana,Warwick,1318,515,803,39.07
Diana,Yasuo,1416,732,684,51.69
Diana,Kindred,428,262,166,61.21
Diana,Lux,2186,1105,1081,50.55
Diana,Vladimir,396,232,164,58.59
Diana,Darius,1415,731,684,51.66
Diana,KogMaw,265,150,115,56.6
Diana,Yuumi,757,455,302,60.11
Diana,Sett,1309,658,651,50.27
Diana,Ivern,148,73,75,49.32
Diana,Veigar,1006,530,476,52.68
Diana,Jinx,1483,701,782,47.27
Diana,Lulu,500,254,246,50.8
Diana,Garen,1112,506,606,45.5
Diana,Briar,818,438,380,53.55
Diana,Zed,813,424,389,52.15
Diana,Caitlyn,2002,988,1014,49.35
Diana,Morgana,1246,628,618,50.4
Diana,Mordekaiser,1232,581,651,47.16
Diana,Ryze,183,101,82,55.19
Diana,Vex,519,289,230,55.68
Diana,Gwen,575,327,248,56.87
Diana,Skarner,264,125,139,47.35
Diana,Yone,1425,710,715,49.82
Diana,Kaisa,1069,559,510,52.29
Diana,Seraphine,845,434,411,51.36
Diana,Ambessa,407,196,211,48.16
Diana,Xayah,534,296,238,55.43
Diana,AurelionSol,357,158,199,44.26
Diana,Khazix,486,253,233,52.06
Diana,Nautilus,796,396,400,49.75
Diana,Vi,725,423,302,58.34
Diana,Azir,243,103,140,42.39
Diana,MissFortune,1823,966,857,52.99
Diana,Chogath,1078,482,596,44.71
Diana,Graves,419,206,213,49.16
Diana,Leblanc,321,169,152,52.65
Diana,Milio,385,150,235,38.96
Diana,Annie,239,107,132,44.77
Diana,Kayn,1572,841,731,53.5
Diana,Aatrox,782,393,389,50.26
Diana,Pyke,916,471,445,51.42
Diana,Sylas,674,325,349,48.22
Diana,Amumu,854,395,459,46.25
Diana,Rakan,349,153,196,43.84
Diana,Gangplank,314,157,157,50
Diana,Lillia,524,286,238,54.58
Diana,Soraka,406,210,196,51.72
Diana,Nasus,561,250,311,44.56
Diana,Neeko,583,323,260,55.4
Diana,Swain,743,307,436,41.32
Diana,Shen,542,257,285,47.42
Diana,Rammus,159,83,76,52.2
Diana,Cassiopeia,340,190,150,55.88
Diana,Sivir,392,167,225,42.6
Diana,Xerath,594,284,310,47.81
Diana,Jax,591,308,283,52.12
Diana,Evelynn,517,251,266,48.55
Diana,Mel,1735,871,864,50.2
Diana,Kalista,383,216,167,56.4
Diana,Renata,208,118,90,56.73
Diana,Fiora,414,231,183,55.8
Diana,Shaco,736,362,374,49.18
Diana,Fizz,430,219,211,50.93
Diana,Tristana,749,341,408,45.53
Diana,Renekton,349,174,175,49.86
Diana,Karthus,242,113,129,46.69
Diana,Ashe,1315,712,603,54.14
Diana,Maokai,329,179,150,54.41
Diana,Aurora,872,492,380,56.42
Diana,Nilah,420,193,227,45.95
Diana,Hwei,602,294,308,48.84
Diana,Volibear,968,467,501,48.24
Diana,XinZhao,387,189,198,48.84
Diana,Irelia,703,349,354,49.64
Diana,Nami,853,447,406,52.4
Diana,Samira,802,355,447,44.26
Diana,Malphite,545,276,269,50.64
Diana,Sion,601,304,297,50.58
Diana,Ahri,1204,619,585,51.41
Diana,Draven,452,274,178,60.62
Diana,Akali,921,476,445,51.68
Diana,Ezreal,1208,641,567,53.06
Diana,Senna,634,317,317,50
Diana,Yorick,662,282,380,42.6
Diana,Malzahar,641,280,361,43.68
Diana,Aphelios,624,302,322,48.4
Diana,Braum,346,189,157,54.62
Diana,Trundle,381,192,189,50.39
Diana,Blitzcrank,559,291,268,52.06
Diana,Poppy,513,217,296,42.3
Diana,Twitch,692,320,372,46.24
Diana,Viego,1038,490,548,47.21
Diana,Katarina,702,363,339,51.71
Diana,Jayce,336,221,115,65.77
Diana,Jhin,1246,563,683,45.18
Diana,Thresh,1071,528,543,49.3
Diana,Illaoi,416,154,262,37.02
Diana,MasterYi,921,460,461,49.95
Diana,Vayne,743,361,382,48.59
Diana,Sona,312,142,170,45.51
Diana,Kayle,632,313,319,49.53
Diana,JarvanIV,318,166,152,52.2
Diana,LeeSin,663,306,357,46.15
Diana,Naafiri,392,222,170,56.63
Diana,KSante,263,125,138,47.53
Diana,Nunu,682,398,284,58.36
Diana,Teemo,1176,535,641,45.49
Diana,Kassadin,216,93,123,43.06
Diana,Ziggs,410,181,229,44.15
Diana,RekSai,93,43,50,46.24
Diana,Talon,574,301,273,52.44
Diana,Rell,369,142,227,38.48
Diana,Leona,612,292,320,47.71
Diana,Elise,449,275,174,61.25
Diana,Rengar,355,217,138,61.13
Diana,Galio,548,241,307,43.98
Diana,Lucian,426,209,217,49.06
Diana,Hecarim,194,115,79,59.28
Diana,Ekko,686,379,307,55.25
Diana,Zac,310,136,174,43.87
Diana,Riven,380,213,167,56.05
Diana,Gragas,441,259,182,58.73
Diana,Olaf,134,78,56,58.21
Diana,Kled,160,70,90,43.75
Diana,Karma,469,281,188,59.91
Diana,Velkoz,457,184,273,40.26
Diana,Brand,528,232,296,43.94
Diana,Bard,171,101,70,59.06
Diana,Heimerdinger,504,222,282,44.05
Diana,TahmKench,874,484,390,55.38
Diana,Qiyana,267,146,121,54.68
Diana,Nocturne,755,311,444,41.19
Diana,Varus,605,294,311,48.6
Diana,Lissandra,200,99,101,49.5
Diana,Camille,239,113,126,47.28
Diana,Pantheon,1237,617,620,49.88
Diana,DrMundo,575,248,327,43.13
Diana,Nidalee,185,90,95,48.65
Diana,Smolder,674,292,382,43.32
Diana,Zoe,384,221,163,57.55
Diana,Udyr,282,154,128,54.61
Diana,Tryndamere,492,249,243,50.61
Diana,Alistar,272,173,99,63.6
Diana,Sejuani,240,123,117,51.25
Diana,Zyra,565,221,344,39.12
Diana,FiddleSticks,381,198,183,51.97
Diana,Ornn,347,198,149,57.06
Diana,MonkeyKing,414,178,236,43
Diana,Quinn,213,122,91,57.28
Diana,Zilean,211,117,94,55.45
Diana,Taric,189,84,105,44.44
Diana,Akshan,264,131,133,49.62
Diana,Gnar,292,186,106,63.7
Diana,Singed,179,119,60,66.48
Diana,Janna,251,156,95,62.15
Diana,Taliyah,214,139,75,64.95
Diana,Corki,208,119,89,57.21
Diana,Viktor,519,279,240,53.76
Diana,Orianna,354,212,142,59.89
Diana,TwistedFate,297,155,142,52.19
Diana,Shyvana,240,90,150,37.5
Diana,Urgot,360,169,191,46.94
Diana,Anivia,214,125,89,58.41
Diana,Syndra,535,226,309,42.24
Diana,Zeri,335,196,139,58.51
Diana,Belveth,215,123,92,57.21
Diana,Rumble,142,79,63,55.63
Varus,Kennen,156,59,97,37.82
Varus,Warwick,767,326,441,42.5
Varus,Yasuo,827,378,449,45.71
Varus,Kindred,220,129,91,58.64
Varus,Lux,1217,616,601,50.62
Varus,Fiora,195,127,68,65.13
Varus,MasterYi,496,253,243,51.01
Varus,Mel,1083,614,469,56.69
Varus,Jhin,807,348,459,43.12
Varus,Karma,278,147,131,52.88
Varus,Fizz,258,136,122,52.71
Varus,Gnar,237,134,103,56.54
Varus,Caitlyn,1321,706,615,53.44
Varus,Neeko,431,217,214,50.35
Varus,Gangplank,230,138,92,60
Varus,Chogath,617,280,337,45.38
Varus,Galio,299,151,148,50.5
Varus,MissFortune,961,492,469,51.2
Varus,Soraka,324,178,146,54.94
Varus,Kled,83,53,30,63.86
Varus,Kayn,659,314,345,47.65
Varus,AurelionSol,196,109,87,55.61
Varus,Tristana,410,177,233,43.17
Varus,Pyke,558,367,191,65.77
Varus,Nasus,304,125,179,41.12
Varus,FiddleSticks,209,106,103,50.72
Varus,Azir,175,81,94,46.29
Varus,Xayah,220,108,112,49.09
Varus,Nami,517,256,261,49.52
Varus,Olaf,104,58,46,55.77
Varus,Volibear,545,256,289,46.97
Varus,Aurora,402,200,202,49.75
Varus,Ashe,831,442,389,53.19
Varus,Smolder,367,204,163,55.59
Varus,Rengar,241,138,103,57.26
Varus,Hwei,345,220,125,63.77
Varus,Thresh,550,287,263,52.18
Varus,Pantheon,814,359,455,44.1
Varus,Xerath,320,100,220,31.25
Varus,Morgana,547,273,274,49.91
Varus,Braum,144,67,77,46.53
Varus,Skarner,153,73,80,47.71
Varus,Syndra,269,108,161,40.15
Varus,Hecarim,190,108,82,56.84
Varus,Talon,281,177,104,62.99
Varus,Samira,468,224,244,47.86
Varus,Blitzcrank,373,174,199,46.65
Varus,Garen,718,346,372,48.19
Varus,Nocturne,298,153,145,51.34
Varus,Vladimir,216,82,134,37.96
Varus,Sylas,372,174,198,46.77
Varus,Ekko,339,162,177,47.79
Varus,Malphite,303,138,165,45.54
Varus,Poppy,300,135,165,45
Varus,Ornn,214,127,87,59.35
Varus,Ambessa,376,181,195,48.14
Varus,Zoe,243,153,90,62.96
Varus,Swain,490,212,278,43.27
Varus,Mordekaiser,730,354,376,48.49
Varus,Amumu,564,264,300,46.81
Varus,Yone,862,443,419,51.39
Varus,Zyra,353,180,173,50.99
Varus,Ezreal,932,551,381,59.12
Varus,Seraphine,471,229,242,48.62
Varus,MonkeyKing,245,140,105,57.14
Varus,Rakan,268,108,160,40.3
Varus,Sett,856,426,430,49.77
Varus,Lucian,273,130,143,47.62
Varus,Veigar,480,197,283,41.04
Varus,Zilean,158,96,62,60.76
Varus,Irelia,334,190,144,56.89
Varus,Darius,901,461,440,51.17
Varus,Shaco,509,271,238,53.24
Varus,Ahri,677,379,298,55.98
Varus,Graves,209,99,110,47.37
Varus,Taliyah,128,61,67,47.66
Varus,Yuumi,510,270,240,52.94
Varus,Camille,177,95,82,53.67
Varus,Briar,402,197,205,49
Varus,Viktor,286,144,142,50.35
Varus,Jinx,978,467,511,47.75
Varus,Senna,411,197,214,47.93
Varus,Jayce,190,90,100,47.37
Varus,Malzahar,400,203,197,50.75
Varus,Lulu,360,190,170,52.78
Varus,Annie,179,82,97,45.81
Varus,Tryndamere,235,130,105,55.32
Varus,Zac,190,111,79,58.42
Varus,Alistar,145,53,92,36.55
Varus,Leona,340,171,169,50.29
Varus,Viego,564,271,293,48.05
Varus,Orianna,257,90,167,35.02
Varus,Twitch,414,212,202,51.21
Varus,LeeSin,424,232,192,54.72
Varus,Illaoi,197,93,104,47.21
Varus,XinZhao,256,116,140,45.31
Varus,Teemo,716,330,386,46.09
Varus,Akali,487,290,197,59.55
Varus,Vayne,492,248,244,50.41
Varus,Nautilus,479,234,245,48.85
Varus,Aatrox,442,241,201,54.52
Varus,Rumble,98,63,35,64.29
Varus,TahmKench,481,255,226,53.01
Varus,Kaisa,678,349,329,51.47
Varus,Ziggs,212,84,128,39.62
Varus,Jax,411,207,204,50.36
Varus,Diana,605,311,294,51.4
Varus,Heimerdinger,216,96,120,44.44
Varus,Milio,248,140,108,56.45
Varus,Urgot,245,138,107,56.33
Varus,Shen,335,172,163,51.34
Varus,KogMaw,187,82,105,43.85
Varus,Lillia,329,157,172,47.72
Varus,Khazix,287,152,135,52.96
Varus,Sion,373,172,201,46.11
Varus,Sejuani,205,91,114,44.39
Varus,KSante,211,88,123,41.71
Varus,Gwen,296,146,150,49.32
Varus,Gragas,303,145,158,47.85
Varus,Sona,183,104,79,56.83
Varus,Ivern,110,36,74,32.73
Varus,Kassadin,121,63,58,52.07
Varus,Evelynn,222,91,131,40.99
Varus,Draven,223,129,94,57.85
Varus,Zed,442,270,172,61.09
Varus,Singed,166,83,83,50
Varus,Renata,97,38,59,39.18
Varus,Trundle,207,101,106,48.79
Varus,Shyvana,128,44,84,34.38
Varus,Taric,116,52,64,44.83
Varus,Corki,134,74,60,55.22
Varus,Anivia,141,67,74,47.52
Varus,Sivir,299,171,128,57.19
Varus,Vi,428,198,230,46.26
Varus,Rammus,141,74,67,52.48
Varus,Janna,129,57,72,44.19
Varus,Karthus,148,50,98,33.78
Varus,DrMundo,321,168,153,52.34
Varus,Nunu,452,213,239,47.12
Varus,Leblanc,229,128,101,55.9
Varus,Katarina,435,277,158,63.68
Varus,Akshan,131,80,51,61.07
Varus,Brand,316,129,187,40.82
Varus,Quinn,184,100,84,54.35
Varus,Qiyana,185,108,77,58.38
Varus,Nilah,245,99,146,40.41
Varus,Vex,227,87,140,38.33
Varus,TwistedFate,178,87,91,48.88
Varus,JarvanIV,200,111,89,55.5
Varus,Riven,137,52,85,37.96
Varus,Velkoz,329,150,179,45.59
Varus,Rell,201,82,119,40.8
Varus,Cassiopeia,176,96,80,54.55
Varus,Nidalee,159,95,64,59.75
Varus,Aphelios,347,178,169,51.3
Varus,Elise,278,145,133,52.16
Varus,Ryze,177,89,88,50.28
Varus,Zeri,264,140,124,53.03
Varus,Udyr,166,92,74,55.42
Varus,Belveth,134,55,79,41.04
Varus,Yorick,541,265,276,48.98
Varus,Kalista,260,140,120,53.85
Varus,Lissandra,95,47,48,49.47
Varus,Maokai,245,134,111,54.69
Varus,Kayle,344,149,195,43.31
Varus,Naafiri,182,121,61,66.48
Varus,Renekton,225,120,105,53.33
Varus,Bard,115,56,59,48.7
Varus,RekSai,63,40,23,63.49
Kindred,Aatrox,344,171,173,49.71
Kindred,Sylas,301,126,175,41.86
Kindred,Diana,428,166,262,38.79
Kindred,Varus,220,91,129,41.36
Kindred,Blitzcrank,228,126,102,55.26
Kindred,Fiora,186,117,69,62.9
Kindred,Belveth,87,57,30,65.52
Kindred,Ezreal,581,310,271,53.36
Kindred,Yuumi,337,129,208,38.28
Kindred,Volibear,355,131,224,36.9
Kindred,Ekko,314,155,159,49.36
Kindred,Yone,635,291,344,45.83
Kindred,Kalista,159,70,89,44.03
Kindred,Pyke,479,230,249,48.02
Kindred,Warwick,528,225,303,42.61
Kindred,Singed,69,21,48,30.43
Kindred,Ryze,83,40,43,48.19
Kindred,Samira,315,110,205,34.92
Kindred,Soraka,216,82,134,37.96
Kindred,Mordekaiser,504,215,289,42.66
Kindred,Briar,405,168,237,41.48
Kindred,Zed,282,155,127,54.96
Kindred,Jinx,674,329,345,48.81
Kindred,Lillia,258,139,119,53.88
Kindred,Yasuo,663,311,352,46.91
Kindred,FiddleSticks,197,119,78,60.41
Kindred,Mel,693,320,373,46.18
Kindred,Amumu,325,112,213,34.46
Kindred,Thresh,344,164,180,47.67
Kindred,Gnar,155,78,77,50.32
Kindred,Malzahar,306,119,187,38.89
Kindred,Tristana,288,166,122,57.64
Kindred,Brand,228,114,114,50
Kindred,Quinn,94,50,44,53.19
Kindred,Talon,216,105,111,48.61
Kindred,Syndra,135,60,75,44.44
Kindred,Caitlyn,750,317,433,42.27
Kindred,Sett,652,266,386,40.8
Kindred,MasterYi,310,156,154,50.32
Kindred,AurelionSol,128,65,63,50.78
Kindred,Seraphine,360,162,198,45
Kindred,Nasus,309,93,216,30.1
Kindred,Nocturne,322,133,189,41.3
Kindred,Aurora,334,136,198,40.72
Kindred,Nunu,214,113,101,52.8
Kindred,TwistedFate,129,37,92,28.68
Kindred,Teemo,503,193,310,38.37
Kindred,Malphite,273,131,142,47.99
Kindred,Vladimir,199,96,103,48.24
Kindred,Ziggs,164,70,94,42.68
Kindred,Urgot,177,111,66,62.71
Kindred,Xerath,227,107,120,47.14
Kindred,Pantheon,602,248,354,41.2
Kindred,TahmKench,353,173,180,49.01
Kindred,Qiyana,114,62,52,54.39
Kindred,Ashe,553,216,337,39.06
Kindred,Garen,474,185,289,39.03
Kindred,Maokai,164,79,85,48.17
Kindred,Sion,225,71,154,31.56
Kindred,Akali,383,184,199,48.04
Kindred,Lux,907,427,480,47.08
Kindred,Riven,116,52,64,44.83
Kindred,Shaco,387,192,195,49.61
Kindred,Jhin,591,266,325,45.01
Kindred,Senna,327,131,196,40.06
Kindred,Milio,142,76,66,53.52
Kindred,Naafiri,168,81,87,48.21
Kindred,Orianna,170,70,100,41.18
Kindred,Zilean,120,42,78,35
Kindred,Vex,225,105,120,46.67
Kindred,Illaoi,144,83,61,57.64
Kindred,MonkeyKing,156,72,84,46.15
Kindred,Twitch,215,83,132,38.6
Kindred,Nautilus,258,140,118,54.26
Kindred,Galio,218,118,100,54.13
Kindred,Sona,168,78,90,46.43
Kindred,Hecarim,111,40,71,36.04
Kindred,Zyra,261,78,183,29.89
Kindred,Trundle,181,73,108,40.33
Kindred,Katarina,251,137,114,54.58
Kindred,Rengar,136,88,48,64.71
Kindred,Ivern,56,28,28,50
Kindred,Viego,341,143,198,41.94
Kindred,Ahri,456,218,238,47.81
Kindred,Camille,126,54,72,42.86
Kindred,Viktor,246,114,132,46.34
Kindred,Kayn,516,239,277,46.32
Kindred,Zac,121,50,71,41.32
Kindred,Rell,144,68,76,47.22
Kindred,Rammus,110,58,52,52.73
Kindred,Draven,221,83,138,37.56
Kindred,Lulu,229,109,120,47.6
Kindred,Leona,205,87,118,42.44
Kindred,Nilah,233,123,110,52.79
Kindred,Bard,141,80,61,56.74
Kindred,Taric,58,19,39,32.76
Kindred,Hwei,244,81,163,33.2
Kindred,Rakan,144,63,81,43.75
Kindred,Veigar,434,180,254,41.47
Kindred,Skarner,74,26,48,35.14
Kindred,Kennen,117,59,58,50.43
Kindred,LeeSin,329,164,165,49.85
Kindred,Cassiopeia,95,29,66,30.53
Kindred,Alistar,84,34,50,40.48
Kindred,Kaisa,513,210,303,40.94
Kindred,Zeri,154,80,74,51.95
Kindred,Jayce,167,90,77,53.89
Kindred,Irelia,282,138,144,48.94
Kindred,Vayne,339,187,152,55.16
Kindred,Aphelios,295,168,127,56.95
Kindred,Sejuani,91,11,80,12.09
Kindred,MissFortune,676,316,360,46.75
Kindred,Braum,110,38,72,34.55
Kindred,Darius,639,237,402,37.09
Kindred,Velkoz,187,63,124,33.69
Kindred,Udyr,124,68,56,54.84
Kindred,Nami,349,177,172,50.72
Kindred,JarvanIV,96,28,68,29.17
Kindred,Poppy,203,85,118,41.87
Kindred,Azir,134,58,76,43.28
Kindred,Lucian,159,82,77,51.57
Kindred,Elise,190,113,77,59.47
Kindred,Olaf,116,44,72,37.93
Kindred,Xayah,162,62,100,38.27
Kindred,Karma,195,88,107,45.13
Kindred,Gragas,192,119,73,61.98
Kindred,Renekton,121,68,53,56.2
Kindred,Tryndamere,191,71,120,37.17
Kindred,Swain,342,148,194,43.27
Kindred,Annie,87,38,49,43.68
Kindred,Morgana,432,223,209,51.62
Kindred,Akshan,90,59,31,65.56
Kindred,XinZhao,171,64,107,37.43
Kindred,Kassadin,60,29,31,48.33
Kindred,KogMaw,74,17,57,22.97
Kindred,Janna,96,27,69,28.13
Kindred,Chogath,348,148,200,42.53
Kindred,Jax,258,104,154,40.31
Kindred,Evelynn,161,68,93,42.24
Kindred,Zoe,122,74,48,60.66
Kindred,Vi,270,121,149,44.81
Kindred,Leblanc,122,46,76,37.7
Kindred,Gangplank,103,70,33,67.96
Kindred,DrMundo,164,91,73,55.49
Kindred,Kayle,255,81,174,31.76
Kindred,Kled,94,33,61,35.11
Kindred,Yorick,281,142,139,50.53
Kindred,Neeko,241,103,138,42.74
Kindred,Anivia,131,85,46,64.89
Kindred,Heimerdinger,163,68,95,41.72
Kindred,Shyvana,75,22,53,29.33
Kindred,Smolder,234,95,139,40.6
Kindred,Ambessa,150,68,82,45.33
Kindred,KSante,123,66,57,53.66
Kindred,RekSai,32,12,20,37.5
Kindred,Ornn,152,65,87,42.76
Kindred,Karthus,92,39,53,42.39
Kindred,Corki,116,69,47,59.48
Kindred,Gwen,231,104,127,45.02
Kindred,Khazix,213,101,112,47.42
Kindred,Fizz,136,72,64,52.94
Kindred,Taliyah,91,31,60,34.07
Kindred,Nidalee,107,49,58,45.79
Kindred,Shen,209,91,118,43.54
Kindred,Graves,158,94,64,59.49
Kindred,Sivir,191,101,90,52.88
Kindred,Lissandra,64,42,22,65.63
Kindred,Rumble,61,26,35,42.62
Kindred,Renata,93,71,22,76.34
Illaoi,Vladimir,143,76,67,53.15
Illaoi,Darius,618,396,222,64.08
Illaoi,Lux,784,385,399,49.11
Illaoi,KogMaw,58,28,30,48.28
Illaoi,Yuumi,289,167,122,57.79
Illaoi,Mordekaiser,536,257,279,47.95
Illaoi,Warwick,528,210,318,39.77
Illaoi,Veigar,353,175,178,49.58
Illaoi,Ashe,529,258,271,48.77
Illaoi,Nami,260,128,132,49.23
Illaoi,Kayle,258,126,132,48.84
Illaoi,Sylas,294,162,132,55.1
Illaoi,Qiyana,128,59,69,46.09
Illaoi,Caitlyn,750,448,302,59.73
Illaoi,Renata,87,59,28,67.82
Illaoi,Mel,567,328,239,57.85
Illaoi,Nautilus,264,163,101,61.74
Illaoi,Viego,313,173,140,55.27
Illaoi,Irelia,268,176,92,65.67
Illaoi,Jinx,679,327,352,48.16
Illaoi,Thresh,376,191,185,50.8
Illaoi,Volibear,357,189,168,52.94
Illaoi,Evelynn,129,80,49,62.02
Illaoi,Katarina,207,123,84,59.42
Illaoi,Nocturne,302,133,169,44.04
Illaoi,Neeko,245,118,127,48.16
Illaoi,Gwen,250,149,101,59.6
Illaoi,Karthus,48,16,32,33.33
Illaoi,Yone,682,416,266,61
Illaoi,Nilah,160,58,102,36.25
Illaoi,Braum,157,86,71,54.78
Illaoi,Shaco,323,136,187,42.11
Illaoi,Azir,96,65,31,67.71
Illaoi,Samira,356,194,162,54.49
Illaoi,Kayn,526,341,185,64.83
Illaoi,Lucian,180,85,95,47.22
Illaoi,Sett,583,305,278,52.32
Illaoi,RekSai,38,19,19,50
Illaoi,Hwei,173,80,93,46.24
Illaoi,Ekko,233,115,118,49.36
Illaoi,Yasuo,602,329,273,54.65
Illaoi,Ahri,400,241,159,60.25
Illaoi,Karma,150,65,85,43.33
Illaoi,Skarner,112,74,38,66.07
Illaoi,Syndra,115,67,48,58.26
Illaoi,Jhin,464,253,211,54.53
Illaoi,Sion,224,114,110,50.89
Illaoi,Pantheon,478,271,207,56.69
Illaoi,Ziggs,147,90,57,61.22
Illaoi,Lulu,179,83,96,46.37
Illaoi,Viktor,227,113,114,49.78
Illaoi,Briar,309,139,170,44.98
Illaoi,Teemo,373,160,213,42.9
Illaoi,Blitzcrank,280,177,103,63.21
Illaoi,Diana,416,262,154,62.98
Illaoi,Poppy,156,71,85,45.51
Illaoi,Heimerdinger,229,85,144,37.12
Illaoi,Kalista,126,68,58,53.97
Illaoi,Swain,299,174,125,58.19
Illaoi,AurelionSol,131,89,42,67.94
Illaoi,Xayah,206,104,102,50.49
Illaoi,Rakan,174,89,85,51.15
Illaoi,Jax,231,136,95,58.87
Illaoi,MissFortune,657,397,260,60.43
Illaoi,Morgana,425,187,238,44
Illaoi,Kindred,144,61,83,42.36
Illaoi,Ryze,89,41,48,46.07
Illaoi,Orianna,135,70,65,51.85
Illaoi,Shen,208,103,105,49.52
Illaoi,Aatrox,299,170,129,56.86
Illaoi,Khazix,180,92,88,51.11
Illaoi,Vex,171,61,110,35.67
Illaoi,Vayne,337,171,166,50.74
Illaoi,Malzahar,206,87,119,42.23
Illaoi,Camille,101,58,43,57.43
Illaoi,Rammus,81,35,46,43.21
Illaoi,Alistar,113,71,42,62.83
Illaoi,TwistedFate,125,63,62,50.4
Illaoi,Fiora,130,62,68,47.69
Illaoi,LeeSin,267,141,126,52.81
Illaoi,Kassadin,51,16,35,31.37
Illaoi,Milio,155,95,60,61.29
Illaoi,Malphite,240,123,117,51.25
Illaoi,Sona,141,63,78,44.68
Illaoi,Rengar,115,75,40,65.22
Illaoi,TahmKench,379,239,140,63.06
Illaoi,Garen,430,194,236,45.12
Illaoi,Lillia,181,105,76,58.01
Illaoi,Smolder,204,102,102,50
Illaoi,Tristana,267,126,141,47.19
Illaoi,Zyra,186,91,95,48.92
Illaoi,Gangplank,121,66,55,54.55
Illaoi,Varus,197,104,93,52.79
Illaoi,Pyke,301,162,139,53.82
Illaoi,Chogath,427,207,220,48.48
Illaoi,Hecarim,110,72,38,65.45
Illaoi,MonkeyKing,133,67,66,50.38
Illaoi,Ezreal,451,268,183,59.42
Illaoi,Brand,220,125,95,56.82
Illaoi,Nunu,300,152,148,50.67
Illaoi,Aurora,248,125,123,50.4
Illaoi,Leona,202,104,98,51.49
Illaoi,Xerath,227,108,119,47.58
Illaoi,Ornn,74,34,40,45.95
Illaoi,Twitch,217,108,109,49.77
Illaoi,Amumu,309,121,188,39.16
Illaoi,Kaisa,405,220,185,54.32
Illaoi,Jayce,105,37,68,35.24
Illaoi,Zeri,100,48,52,48
Illaoi,FiddleSticks,203,86,117,42.36
Illaoi,Aphelios,176,111,65,63.07
Illaoi,Draven,136,64,72,47.06
Illaoi,Ambessa,168,107,61,63.69
Illaoi,Talon,112,70,42,62.5
Illaoi,Nidalee,96,64,32,66.67
Illaoi,Zed,247,147,100,59.51
Illaoi,Yorick,311,149,162,47.91
Illaoi,Gnar,121,54,67,44.63
Illaoi,Vi,293,137,156,46.76
Illaoi,Zoe,120,59,61,49.17
Illaoi,Sejuani,81,35,46,43.21
Illaoi,Leblanc,83,26,57,31.33
Illaoi,Seraphine,295,138,157,46.78
Illaoi,Riven,133,98,35,73.68
Illaoi,Trundle,188,99,89,52.66
Illaoi,Cassiopeia,73,47,26,64.38
Illaoi,XinZhao,143,60,83,41.96
Illaoi,Taric,75,29,46,38.67
Illaoi,Ivern,71,42,29,59.15
Illaoi,Velkoz,143,54,89,37.76
Illaoi,Lissandra,72,42,30,58.33
Illaoi,Galio,179,121,58,67.6
Illaoi,Corki,107,43,64,40.19
Illaoi,Singed,70,42,28,60
Illaoi,Soraka,238,123,115,51.68
Illaoi,Annie,86,44,42,51.16
Illaoi,MasterYi,276,192,84,69.57
Illaoi,Renekton,177,109,68,61.58
Illaoi,KSante,54,31,23,57.41
Illaoi,Fizz,161,102,59,63.35
Illaoi,Kennen,54,38,16,70.37
Illaoi,Udyr,92,44,48,47.83
Illaoi,Zilean,84,41,43,48.81
Illaoi,Taliyah,95,55,40,57.89
Illaoi,Akshan,127,51,76,40.16
Illaoi,Rell,139,86,53,61.87
Illaoi,Naafiri,166,68,98,40.96
Illaoi,Nasus,266,118,148,44.36
Illaoi,Elise,193,119,74,61.66
Illaoi,Akali,341,198,143,58.06
Illaoi,Gragas,203,132,71,65.02
Illaoi,Sivir,159,83,76,52.2
Illaoi,Anivia,63,23,40,36.51
Illaoi,Rumble,66,40,26,60.61
Illaoi,Senna,250,145,105,58
Illaoi,DrMundo,239,92,147,38.49
Illaoi,Quinn,88,44,44,50
Illaoi,Graves,89,49,40,55.06
Illaoi,Bard,97,60,37,61.86
Illaoi,Maokai,111,62,49,55.86
Illaoi,Belveth,105,58,47,55.24
Illaoi,Zac,92,32,60,34.78
Illaoi,Tryndamere,174,69,105,39.66
Illaoi,Urgot,119,47,72,39.5
Illaoi,Olaf,67,34,33,50.75
Illaoi,Kled,36,20,16,55.56
Illaoi,JarvanIV,88,54,34,61.36
Illaoi,Shyvana,85,61,24,71.76
Illaoi,Janna,70,36,34,51.43
Milio,Vladimir,111,52,59,46.85
Milio,Darius,633,306,327,48.34
Milio,Lux,958,575,383,60.02
Milio,KogMaw,128,62,66,48.44
Milio,Yuumi,333,158,175,47.45
Milio,Yorick,322,153,169,47.52
Milio,Kayn,448,263,185,58.71
Milio,Ryze,54,19,35,35.19
Milio,Pantheon,510,264,246,51.76
Milio,Teemo,423,220,203,52.01
Milio,Warwick,545,288,257,52.84
Milio,Azir,112,47,65,41.96
Milio,MissFortune,627,324,303,51.67
Milio,Neeko,226,102,124,45.13
Milio,Akali,368,169,199,45.92
Milio,Kassadin,72,30,42,41.67
Milio,Sona,140,83,57,59.29
Milio,Braum,136,83,53,61.03
Milio,XinZhao,145,60,85,41.38
Milio,Chogath,375,211,164,56.27
Milio,Taliyah,95,20,75,21.05
Milio,Mordekaiser,451,224,227,49.67
Milio,Briar,296,141,155,47.64
Milio,Zed,344,193,151,56.1
Milio,Jinx,563,231,332,41.03
Milio,Lulu,325,166,159,51.08
Milio,Jax,310,143,167,46.13
Milio,Talon,202,118,84,58.42
Milio,Leblanc,106,56,50,52.83
Milio,Mel,852,465,387,54.58
Milio,Jhin,533,278,255,52.16
Milio,Velkoz,187,82,105,43.85
Milio,Olaf,96,45,51,46.88
Milio,LeeSin,325,146,179,44.92
Milio,Diana,385,235,150,61.04
Milio,Seraphine,364,233,131,64.01
Milio,Karma,284,177,107,62.32
Milio,Tryndamere,175,103,72,58.86
Milio,Graves,170,93,77,54.71
Milio,Sylas,311,142,169,45.66
Milio,Leona,255,98,157,38.43
Milio,DrMundo,179,84,95,46.93
Milio,Shaco,254,128,126,50.39
Milio,Xayah,202,116,86,57.43
Milio,Morgana,470,249,221,52.98
Milio,Ashe,658,355,303,53.95
Milio,Renekton,87,57,30,65.52
Milio,Khazix,206,121,85,58.74
Milio,Malzahar,214,106,108,49.53
Milio,Quinn,167,92,75,55.09
Milio,Vayne,231,102,129,44.16
Milio,Shyvana,90,36,54,40
Milio,Soraka,244,111,133,45.49
Milio,Fiora,185,95,90,51.35
Milio,Elise,213,127,86,59.62
Milio,Garen,504,232,272,46.03
Milio,Senna,281,149,132,53.02
Milio,Maokai,179,61,118,34.08
Milio,Corki,121,59,62,48.76
Milio,Taric,73,25,48,34.25
Milio,Camille,120,61,59,50.83
Milio,Hecarim,137,62,75,45.26
Milio,TwistedFate,114,66,48,57.89
Milio,Ezreal,565,313,252,55.4
Milio,Nautilus,419,287,132,68.5
Milio,Kaisa,418,231,187,55.26
Milio,Qiyana,140,73,67,52.14
Milio,Swain,334,149,185,44.61
Milio,Ziggs,159,79,80,49.69
Milio,Nasus,196,88,108,44.9
Milio,Xerath,194,123,71,63.4
Milio,Caitlyn,782,393,389,50.26
Milio,Irelia,264,168,96,63.64
Milio,Amumu,344,132,212,38.37
Milio,Poppy,209,118,91,56.46
Milio,Veigar,342,140,202,40.94
Milio,Gnar,133,102,31,76.69
Milio,Lucian,183,93,90,50.82
Milio,Nami,317,157,160,49.53
Milio,Aatrox,365,217,148,59.45
Milio,FiddleSticks,172,99,73,57.56
Milio,Kindred,142,66,76,46.48
Milio,Aphelios,289,170,119,58.82
Milio,Rengar,152,85,67,55.92
Milio,Sion,326,149,177,45.71
Milio,Orianna,176,72,104,40.91
Milio,Illaoi,155,60,95,38.71
Milio,Vi,290,150,140,51.72
Milio,Yasuo,621,335,286,53.95
Milio,Rell,161,90,71,55.9
Milio,Sivir,167,100,67,59.88
Milio,Aurora,387,167,220,43.15
Milio,Sett,472,237,235,50.21
Milio,Gragas,206,105,101,50.97
Milio,Viego,346,208,138,60.12
Milio,Draven,168,126,42,75
Milio,Blitzcrank,227,121,106,53.3
Milio,Ahri,395,235,160,59.49
Milio,Katarina,377,220,157,58.36
Milio,Evelynn,199,123,76,61.81
Milio,Akshan,133,71,62,53.38
Milio,Smolder,314,169,145,53.82
Milio,MasterYi,391,169,222,43.22
Milio,Tristana,244,142,102,58.2
Milio,Thresh,454,208,246,45.81
Milio,MonkeyKing,197,113,84,57.36
Milio,Urgot,131,63,68,48.09
Milio,Zac,129,73,56,56.59
Milio,Volibear,313,184,129,58.79
Milio,Kennen,128,84,44,65.63
Milio,Rammus,102,60,42,58.82
Milio,Zeri,156,77,79,49.36
Milio,Pyke,331,165,166,49.85
Milio,Viktor,259,126,133,48.65
Milio,Riven,165,101,64,61.21
Milio,Syndra,166,51,115,30.72
Milio,Kled,61,27,34,44.26
Milio,Lillia,190,106,84,55.79
Milio,Ekko,209,123,86,58.85
Milio,Anivia,99,53,46,53.54
Milio,Samira,255,138,117,54.12
Milio,Ornn,161,67,94,41.61
Milio,Lissandra,64,40,24,62.5
Milio,Varus,248,108,140,43.55
Milio,TahmKench,343,169,174,49.27
Milio,Nunu,225,115,110,51.11
Milio,Heimerdinger,145,72,73,49.66
Milio,Trundle,144,68,76,47.22
Milio,Gangplank,178,101,77,56.74
Milio,Alistar,135,61,74,45.19
Milio,Hwei,275,142,133,51.64
Milio,JarvanIV,164,92,72,56.1
Milio,KSante,137,78,59,56.93
Milio,Gwen,218,103,115,47.25
Milio,Yone,463,235,228,50.76
Milio,Janna,118,45,73,38.14
Milio,Sejuani,133,78,55,58.65
Milio,Brand,146,93,53,63.7
Milio,Renata,114,56,58,49.12
Milio,Vex,184,111,73,60.33
Milio,Udyr,132,55,77,41.67
Milio,Kalista,142,69,73,48.59
Milio,Fizz,216,129,87,59.72
Milio,AurelionSol,105,64,41,60.95
Milio,Galio,204,109,95,53.43
Milio,Naafiri,159,55,104,34.59
Milio,Ivern,102,66,36,64.71
Milio,Nilah,149,79,70,53.02
Milio,Kayle,271,124,147,45.76
Milio,Ambessa,209,107,102,51.2
Milio,Malphite,272,104,168,38.24
Milio,Bard,124,63,61,50.81
Milio,Zyra,234,103,131,44.02
Milio,Twitch,288,149,139,51.74
Milio,Rakan,156,104,52,66.67
Milio,Zoe,115,63,52,54.78
Milio,Skarner,90,52,38,57.78
Milio,Nidalee,89,62,27,69.66
Milio,Cassiopeia,78,44,34,56.41
Milio,Singed,108,50,58,46.3
Milio,Shen,191,84,107,43.98
Milio,Annie,137,106,31,77.37
Milio,Rumble,87,57,30,65.52
Milio,Nocturne,227,103,124,45.37
Milio,Jayce,109,66,43,60.55
Milio,Zilean,117,66,51,56.41
Milio,Karthus,81,45,36,55.56
Milio,Belveth,86,25,61,29.07
Milio,RekSai,34,17,17,50
KogMaw,Illaoi,58,30,28,51.72
KogMaw,Warwick,337,171,166,50.74
KogMaw,Diana,265,115,150,43.4
KogMaw,Tristana,141,76,65,53.9
KogMaw,Milio,128,66,62,51.56
KogMaw,Sion,187,108,79,57.75
KogMaw,Akshan,112,65,47,58.04
KogMaw,Jinx,423,234,189,55.32
KogMaw,Bard,83,36,47,43.37
KogMaw,Jax,208,94,114,45.19
KogMaw,Graves,98,52,46,53.06
KogMaw,Katarina,175,101,74,57.71
KogMaw,Twitch,216,109,107,50.46
KogMaw,Seraphine,224,122,102,54.46
KogMaw,Kennen,87,41,46,47.13
KogMaw,Skarner,95,44,51,46.32
KogMaw,Malzahar,146,81,65,55.48
KogMaw,Yuumi,167,100,67,59.88
KogMaw,Swain,201,103,98,51.24
KogMaw,Morgana,329,174,155,52.89
KogMaw,Caitlyn,495,253,242,51.11
KogMaw,Tryndamere,125,61,64,48.8
KogMaw,Vayne,171,109,62,63.74
KogMaw,Draven,82,38,44,46.34
KogMaw,Mel,365,143,222,39.18
KogMaw,Volibear,251,129,122,51.39
KogMaw,MasterYi,156,87,69,55.77
KogMaw,Hwei,130,93,37,71.54
KogMaw,Samira,215,121,94,56.28
KogMaw,Shyvana,85,38,47,44.71
KogMaw,Fizz,114,54,60,47.37
KogMaw,Yasuo,383,214,169,55.87
KogMaw,Taric,46,25,21,54.35
KogMaw,Gnar,48,22,26,45.83
KogMaw,Vi,202,93,109,46.04
KogMaw,Kaisa,260,130,130,50
KogMaw,Nautilus,281,162,119,57.65
KogMaw,Yone,392,218,174,55.61
KogMaw,Viego,254,136,118,53.54
KogMaw,Ezreal,351,180,171,51.28
KogMaw,Blitzcrank,131,70,61,53.44
KogMaw,Mordekaiser,321,127,194,39.56
KogMaw,Talon,117,55,62,47.01
KogMaw,Quinn,72,43,29,59.72
KogMaw,Briar,174,77,97,44.25
KogMaw,Chogath,284,127,157,44.72
KogMaw,Sylas,206,109,97,52.91
KogMaw,Smolder,162,76,86,46.91
KogMaw,Neeko,183,119,64,65.03
KogMaw,Teemo,270,136,134,50.37
KogMaw,Kayn,304,126,178,41.45
KogMaw,Renata,61,42,19,68.85
KogMaw,Darius,338,168,170,49.7
KogMaw,LeeSin,154,91,63,59.09
KogMaw,Irelia,192,116,76,60.42
KogMaw,Karma,146,68,78,46.58
KogMaw,Vladimir,136,61,75,44.85
KogMaw,Khazix,94,44,50,46.81
KogMaw,Kayle,158,102,56,64.56
KogMaw,MissFortune,500,290,210,58
KogMaw,Soraka,150,74,76,49.33
KogMaw,Zoe,108,73,35,67.59
KogMaw,Garen,336,187,149,55.65
KogMaw,Ahri,245,141,104,57.55
KogMaw,Jhin,425,230,195,54.12
KogMaw,Rakan,120,48,72,40
KogMaw,Varus,187,105,82,56.15
KogMaw,Nasus,155,77,78,49.68
KogMaw,Zyra,146,89,57,60.96
KogMaw,Aatrox,195,142,53,72.82
KogMaw,Rengar,61,48,13,78.69
KogMaw,Lux,529,290,239,54.82
KogMaw,Kindred,74,57,17,77.03
KogMaw,Veigar,183,77,106,42.08
KogMaw,Ekko,131,40,91,30.53
KogMaw,Yorick,186,74,112,39.78
KogMaw,Lillia,148,64,84,43.24
KogMaw,KSante,75,62,13,82.67
KogMaw,Zac,79,50,29,63.29
KogMaw,Galio,195,75,120,38.46
KogMaw,Sona,113,65,48,57.52
KogMaw,Nunu,123,79,44,64.23
KogMaw,Shaco,137,82,55,59.85
KogMaw,Taliyah,65,27,38,41.54
KogMaw,Xayah,140,72,68,51.43
KogMaw,Lulu,176,103,73,58.52
KogMaw,Zed,176,100,76,56.82
KogMaw,Hecarim,136,73,63,53.68
KogMaw,Sejuani,90,54,36,60
KogMaw,Ambessa,132,77,55,58.33
KogMaw,TahmKench,253,115,138,45.45
KogMaw,Urgot,103,51,52,49.51
KogMaw,Vex,98,55,43,56.12
KogMaw,FiddleSticks,142,60,82,42.25
KogMaw,Evelynn,106,54,52,50.94
KogMaw,Ivern,56,32,24,57.14
KogMaw,Aurora,193,90,103,46.63
KogMaw,Camille,75,23,52,30.67
KogMaw,Renekton,92,50,42,54.35
KogMaw,Kalista,84,37,47,44.05
KogMaw,Sivir,135,82,53,60.74
KogMaw,Nami,166,65,101,39.16
KogMaw,Sett,333,175,158,52.55
KogMaw,Pantheon,324,159,165,49.07
KogMaw,Amumu,205,102,103,49.76
KogMaw,Brand,141,50,91,35.46
KogMaw,Qiyana,54,18,36,33.33
KogMaw,Aphelios,86,54,32,62.79
KogMaw,Shen,159,94,65,59.12
KogMaw,Corki,62,40,22,64.52
KogMaw,Leblanc,83,57,26,68.67
KogMaw,Nocturne,132,70,62,53.03
KogMaw,DrMundo,133,76,57,57.14
KogMaw,Nilah,63,26,37,41.27
KogMaw,Pyke,202,117,85,57.92
KogMaw,Akali,152,85,67,55.92
KogMaw,Syndra,104,53,51,50.96
KogMaw,Kassadin,53,26,27,49.06
KogMaw,XinZhao,125,79,46,63.2
KogMaw,MonkeyKing,59,32,27,54.24
KogMaw,Poppy,125,69,56,55.2
KogMaw,Leona,142,83,59,58.45
KogMaw,Rumble,48,42,6,87.5
KogMaw,Nidalee,53,47,6,88.68
KogMaw,Annie,56,25,31,44.64
KogMaw,Ornn,69,31,38,44.93
KogMaw,Azir,49,33,16,67.35
KogMaw,Xerath,98,40,58,40.82
KogMaw,Olaf,32,22,10,68.75
KogMaw,Orianna,149,80,69,53.69
KogMaw,Alistar,78,52,26,66.67
KogMaw,Trundle,87,43,44,49.43
KogMaw,Ashe,341,183,158,53.67
KogMaw,Zeri,108,60,48,55.56
KogMaw,Velkoz,152,86,66,56.58
KogMaw,Ziggs,80,25,55,31.25
KogMaw,AurelionSol,107,61,46,57.01
KogMaw,Senna,190,94,96,49.47
KogMaw,Rell,115,68,47,59.13
KogMaw,Cassiopeia,83,40,43,48.19
KogMaw,Thresh,281,135,146,48.04
KogMaw,Maokai,104,78,26,75
KogMaw,Karthus,27,24,3,88.89
KogMaw,Lissandra,33,9,24,27.27
KogMaw,Belveth,54,48,6,88.89
KogMaw,Lucian,115,54,61,46.96
KogMaw,Riven,72,37,35,51.39
KogMaw,Malphite,136,71,65,52.21
KogMaw,Gragas,130,76,54,58.46
KogMaw,Elise,99,45,54,45.45
KogMaw,Heimerdinger,98,64,34,65.31
KogMaw,Ryze,64,39,25,60.94
KogMaw,Braum,99,57,42,57.58
KogMaw,Udyr,84,49,35,58.33
KogMaw,Rammus,64,39,25,60.94
KogMaw,Gwen,164,79,85,48.17
KogMaw,Fiora,129,62,67,48.06
KogMaw,Anivia,72,39,33,54.17
KogMaw,Viktor,160,88,72,55
KogMaw,Naafiri,108,50,58,46.3
KogMaw,Jayce,72,29,43,40.28
KogMaw,Zilean,51,32,19,62.75
KogMaw,TwistedFate,71,36,35,50.7
KogMaw,JarvanIV,60,43,17,71.67
KogMaw,Kled,62,41,21,66.13
KogMaw,Gangplank,39,19,20,48.72
KogMaw,Janna,47,14,33,29.79
KogMaw,RekSai,14,14,0,100
KogMaw,Singed,26,23,3,88.46
MasterYi,Maokai,257,118,139,45.91
MasterYi,Graves,278,148,130,53.24
MasterYi,Ahri,812,404,408,49.75
MasterYi,Nilah,396,203,193,51.26
MasterYi,Malphite,444,227,217,51.13
MasterYi,Yorick,592,254,338,42.91
MasterYi,FiddleSticks,301,132,169,43.85
MasterYi,Draven,277,145,132,52.35
MasterYi,Smolder,472,288,184,61.02
MasterYi,Nautilus,693,283,410,40.84
MasterYi,Kayn,1200,681,519,56.75
MasterYi,Zed,521,281,240,53.93
MasterYi,Sona,221,86,135,38.91
MasterYi,Kaisa,757,424,333,56.01
MasterYi,Amumu,636,297,339,46.7
MasterYi,Nasus,568,260,308,45.77
MasterYi,Shaco,546,338,208,61.9
MasterYi,Varus,496,243,253,48.99
MasterYi,Neeko,523,236,287,45.12
MasterYi,Ryze,172,91,81,52.91
MasterYi,Warwick,1176,570,606,48.47
MasterYi,Morgana,876,450,426,51.37
MasterYi,Xayah,471,204,267,43.31
MasterYi,Veigar,763,330,433,43.25
MasterYi,Sett,1182,564,618,47.72
MasterYi,Caitlyn,1388,709,679,51.08
MasterYi,Lulu,460,191,269,41.52
MasterYi,KSante,163,94,69,57.67
MasterYi,Udyr,226,110,116,48.67
MasterYi,Ashe,1191,698,493,58.61
MasterYi,Akali,738,473,265,64.09
MasterYi,Jinx,1296,683,613,52.7
MasterYi,Karma,392,223,169,56.89
MasterYi,Zac,150,96,54,64
MasterYi,Nunu,515,276,239,53.59
MasterYi,Shen,376,199,177,52.93
MasterYi,Riven,238,124,114,52.1
MasterYi,Lillia,334,190,144,56.89
MasterYi,Orianna,291,160,131,54.98
MasterYi,Velkoz,361,158,203,43.77
MasterYi,Volibear,581,283,298,48.71
MasterYi,Nocturne,550,268,282,48.73
MasterYi,Xerath,432,212,220,49.07
MasterYi,Ezreal,1002,511,491,51
MasterYi,Blitzcrank,458,222,236,48.47
MasterYi,Pantheon,1003,529,474,52.74
MasterYi,Kindred,310,154,156,49.68
MasterYi,Teemo,893,422,471,47.26
MasterYi,Lucian,297,166,131,55.89
MasterYi,Zyra,373,178,195,47.72
MasterYi,Gnar,227,105,122,46.26
MasterYi,Seraphine,765,362,403,47.32
MasterYi,TahmKench,763,374,389,49.02
MasterYi,Briar,763,410,353,53.74
MasterYi,Heimerdinger,312,159,153,50.96
MasterYi,MissFortune,1528,786,742,51.44
MasterYi,Fiora,318,181,137,56.92
MasterYi,Viego,877,404,473,46.07
MasterYi,Vladimir,330,163,167,49.39
MasterYi,Pyke,687,378,309,55.02
MasterYi,Irelia,641,302,339,47.11
MasterYi,DrMundo,351,166,185,47.29
MasterYi,Lux,1724,853,871,49.48
MasterYi,Bard,194,106,88,54.64
MasterYi,Katarina,548,289,259,52.74
MasterYi,Tristana,617,296,321,47.97
MasterYi,Yone,1061,510,551,48.07
MasterYi,Akshan,192,105,87,54.69
MasterYi,Aphelios,398,178,220,44.72
MasterYi,Braum,268,118,150,44.03
MasterYi,Kennen,277,153,124,55.23
MasterYi,Ekko,536,277,259,51.68
MasterYi,Poppy,302,147,155,48.68
MasterYi,Yasuo,1190,599,591,50.34
MasterYi,Nidalee,132,82,50,62.12
MasterYi,Mordekaiser,1098,585,513,53.28
MasterYi,KogMaw,156,69,87,44.23
MasterYi,Ornn,229,101,128,44.1
MasterYi,Ambessa,411,227,184,55.23
MasterYi,Zoe,238,153,85,64.29
MasterYi,Jhin,994,506,488,50.91
MasterYi,Swain,759,368,391,48.48
MasterYi,Samira,558,298,260,53.41
MasterYi,Mel,1360,727,633,53.46
MasterYi,Vayne,652,247,405,37.88
MasterYi,Thresh,749,406,343,54.21
MasterYi,Urgot,343,186,157,54.23
MasterYi,Galio,420,213,207,50.71
MasterYi,Rell,336,167,169,49.7
MasterYi,Diana,921,461,460,50.05
MasterYi,Aatrox,551,316,235,57.35
MasterYi,Darius,1128,524,604,46.45
MasterYi,Viktor,324,205,119,63.27
MasterYi,Alistar,174,93,81,53.45
MasterYi,Fizz,299,161,138,53.85
MasterYi,Nami,412,235,177,57.04
MasterYi,Singed,146,65,81,44.52
MasterYi,Garen,740,342,398,46.22
MasterYi,Corki,170,97,73,57.06
MasterYi,JarvanIV,207,94,113,45.41
MasterYi,Janna,203,97,106,47.78
MasterYi,Evelynn,373,171,202,45.84
MasterYi,Jax,547,264,283,48.26
MasterYi,Zeri,242,121,121,50
MasterYi,Yuumi,560,281,279,50.18
MasterYi,Gragas,348,204,144,58.62
MasterYi,LeeSin,556,348,208,62.59
MasterYi,Syndra,361,168,193,46.54
MasterYi,Kalista,340,192,148,56.47
MasterYi,Soraka,360,199,161,55.28
MasterYi,Hecarim,204,88,116,43.14
MasterYi,Ivern,144,85,59,59.03
MasterYi,Trundle,360,194,166,53.89
MasterYi,Elise,359,192,167,53.48
MasterYi,Senna,487,219,268,44.97
MasterYi,Belveth,167,95,72,56.89
MasterYi,Brand,494,278,216,56.28
MasterYi,Sion,513,249,264,48.54
MasterYi,Talon,389,226,163,58.1
MasterYi,Renata,141,73,68,51.77
MasterYi,Gwen,366,205,161,56.01
MasterYi,RekSai,56,29,27,51.79
MasterYi,Aurora,660,329,331,49.85
MasterYi,Chogath,864,426,438,49.31
MasterYi,Naafiri,275,138,137,50.18
MasterYi,XinZhao,348,183,165,52.59
MasterYi,Malzahar,376,185,191,49.2
MasterYi,Twitch,541,298,243,55.08
MasterYi,Skarner,158,105,53,66.46
MasterYi,Zilean,155,94,61,60.65
MasterYi,Annie,221,117,104,52.94
MasterYi,Tryndamere,328,166,162,50.61
MasterYi,Milio,391,222,169,56.78
MasterYi,MonkeyKing,339,132,207,38.94
MasterYi,Azir,211,124,87,58.77
MasterYi,Vi,594,292,302,49.16
MasterYi,Khazix,417,252,165,60.43
MasterYi,Rengar,258,157,101,60.85
MasterYi,Kassadin,118,63,55,53.39
MasterYi,Rakan,375,196,179,52.27
MasterYi,Sejuani,176,92,84,52.27
MasterYi,Leona,448,190,258,42.41
MasterYi,Lissandra,184,89,95,48.37
MasterYi,Gangplank,231,133,98,57.58
MasterYi,Taric,172,80,92,46.51
MasterYi,Kled,89,47,42,52.81
MasterYi,Ziggs,233,128,105,54.94
MasterYi,Cassiopeia,240,149,91,62.08
MasterYi,Rammus,424,190,234,44.81
MasterYi,Qiyana,238,146,92,61.34
MasterYi,Renekton,298,134,164,44.97
MasterYi,Taliyah,160,90,70,56.25
MasterYi,Karthus,164,63,101,38.41
MasterYi,TwistedFate,243,122,121,50.21
MasterYi,AurelionSol,284,129,155,45.42
MasterYi,Sylas,552,343,209,62.14
MasterYi,Kayle,508,253,255,49.8
MasterYi,Jayce,254,128,126,50.39
MasterYi,Rumble,108,65,43,60.19
MasterYi,Hwei,422,227,195,53.79
MasterYi,Vex,311,180,131,57.88
MasterYi,Quinn,204,94,110,46.08
MasterYi,Illaoi,276,84,192,30.43
MasterYi,Sivir,270,136,134,50.37
MasterYi,Olaf,105,63,42,60
MasterYi,Leblanc,240,127,113,52.92
MasterYi,Anivia,188,99,89,52.66
MasterYi,Camille,191,105,86,54.97
MasterYi,Shyvana,134,67,67,50
Ashe,Maokai,400,175,225,43.75
Ashe,Graves,512,244,268,47.66
Ashe,Ahri,1422,739,683,51.97
Ashe,Nilah,600,349,251,58.17
Ashe,Malphite,863,421,442,48.78
Ashe,Fiora,481,237,244,49.27
Ashe,Belveth,294,157,137,53.4
Ashe,Sylas,943,469,474,49.73
Ashe,Ezreal,1948,1047,901,53.75
Ashe,Yuumi,968,492,476,50.83
Ashe,Illaoi,529,271,258,51.23
Ashe,Nunu,795,453,342,56.98
Ashe,Irelia,976,515,461,52.77
Ashe,Jhin,1869,981,888,52.49
Ashe,Swain,1129,609,520,53.94
Ashe,Heimerdinger,583,323,260,55.4
Ashe,Warwick,1593,781,812,49.03
Ashe,Neeko,772,413,359,53.5
Ashe,Draven,657,350,307,53.27
Ashe,Leona,759,368,391,48.48
Ashe,Evelynn,605,317,288,52.4
Ashe,Yasuo,2056,1053,1003,51.22
Ashe,Yone,1970,1009,961,51.22
Ashe,Kayle,774,372,402,48.06
Ashe,Viego,1217,626,591,51.44
Ashe,Jinx,2592,1264,1328,48.77
Ashe,Thresh,1376,660,716,47.97
Ashe,XinZhao,654,354,300,54.13
Ashe,Katarina,880,517,363,58.75
Ashe,Teemo,1462,620,842,42.41
Ashe,Vayne,1034,515,519,49.81
Ashe,TwistedFate,361,175,186,48.48
Ashe,Pantheon,1653,797,856,48.22
Ashe,Kayn,1630,768,862,47.12
Ashe,Leblanc,378,138,240,36.51
Ashe,Sivir,579,276,303,47.67
Ashe,Pyke,1175,642,533,54.64
Ashe,Smolder,687,367,320,53.42
Ashe,Nautilus,903,441,462,48.84
Ashe,DrMundo,671,308,363,45.9
Ashe,Briar,1043,461,582,44.2
Ashe,Anivia,331,159,172,48.04
Ashe,Mordekaiser,1540,759,781,49.29
Ashe,Vi,751,340,411,45.27
Ashe,Azir,393,229,164,58.27
Ashe,MissFortune,2540,1183,1357,46.57
Ashe,Riven,458,297,161,64.85
Ashe,Ivern,278,157,121,56.47
Ashe,Nami,1023,515,508,50.34
Ashe,Gnar,364,175,189,48.08
Ashe,Caitlyn,2862,1361,1501,47.55
Ashe,Karma,723,362,361,50.07
Ashe,Volibear,1047,519,528,49.57
Ashe,LeeSin,995,521,474,52.36
Ashe,Morgana,1387,716,671,51.62
Ashe,Shaco,906,407,499,44.92
Ashe,Xayah,630,339,291,53.81
Ashe,Sett,1757,856,901,48.72
Ashe,Senna,966,443,523,45.86
Ashe,Yorick,845,321,524,37.99
Ashe,Gragas,585,299,286,51.11
Ashe,Lux,2876,1384,1492,48.12
Ashe,Aphelios,727,371,356,51.03
Ashe,Khazix,649,366,283,56.39
Ashe,Akali,1146,575,571,50.17
Ashe,Mel,2147,1090,1057,50.77
Ashe,Zed,904,490,414,54.2
Ashe,KSante,356,164,192,46.07
Ashe,Zeri,424,255,169,60.14
Ashe,Lulu,847,429,418,50.65
Ashe,Sion,822,348,474,42.34
Ashe,MasterYi,1191,493,698,41.39
Ashe,AurelionSol,409,183,226,44.74
Ashe,FiddleSticks,437,212,225,48.51
Ashe,Brand,722,309,413,42.8
Ashe,Milio,658,303,355,46.05
Ashe,Velkoz,610,242,368,39.67
Ashe,Soraka,576,257,319,44.62
Ashe,Chogath,1381,616,765,44.61
Ashe,Jayce,461,222,239,48.16
Ashe,Samira,987,479,508,48.53
Ashe,Quinn,357,182,175,50.98
Ashe,Shen,656,310,346,47.26
Ashe,Shyvana,243,79,164,32.51
Ashe,Seraphine,1247,580,667,46.51
Ashe,Kled,244,131,113,53.69
Ashe,Ambessa,620,303,317,48.87
Ashe,Diana,1315,603,712,45.86
Ashe,Ekko,830,469,361,56.51
Ashe,Talon,624,340,284,54.49
Ashe,Lissandra,195,82,113,42.05
Ashe,Lucian,643,357,286,55.52
Ashe,Nocturne,905,413,492,45.64
Ashe,Sejuani,374,160,214,42.78
Ashe,Rell,565,277,288,49.03
Ashe,Aatrox,944,484,460,51.27
Ashe,Fizz,497,202,295,40.64
Ashe,Taric,238,110,128,46.22
Ashe,Tristana,1014,435,579,42.9
Ashe,Alistar,283,133,150,47
Ashe,Vladimir,617,282,335,45.71
Ashe,Ziggs,498,254,244,51
Ashe,Darius,1916,942,974,49.16
Ashe,Rammus,333,128,205,38.44
Ashe,TahmKench,1022,553,469,54.11
Ashe,Rengar,485,271,214,55.88
Ashe,Galio,638,312,326,48.9
Ashe,Urgot,470,239,231,50.85
Ashe,Xerath,629,329,300,52.31
Ashe,Kalista,403,220,183,54.59
Ashe,Sona,477,211,266,44.23
Ashe,Garen,1466,637,829,43.45
Ashe,Kindred,553,337,216,60.94
Ashe,Varus,831,389,442,46.81
Ashe,Hwei,841,347,494,41.26
Ashe,Aurora,1051,508,543,48.33
Ashe,Malzahar,760,299,461,39.34
Ashe,Braum,428,164,264,38.32
Ashe,Zoe,387,234,153,60.47
Ashe,Zilean,247,130,117,52.63
Ashe,Hecarim,370,175,195,47.3
Ashe,Blitzcrank,768,427,341,55.6
Ashe,Veigar,1162,557,605,47.93
Ashe,Karthus,290,140,150,48.28
Ashe,Kaisa,1354,689,665,50.89
Ashe,Poppy,601,283,318,47.09
Ashe,Viktor,680,344,336,50.59
Ashe,Udyr,445,221,224,49.66
Ashe,Nasus,786,398,388,50.64
Ashe,Lillia,671,312,359,46.5
Ashe,Gwen,672,366,306,54.46
Ashe,Jax,897,469,428,52.29
Ashe,Amumu,948,478,470,50.42
Ashe,JarvanIV,378,184,194,48.68
Ashe,Janna,342,167,175,48.83
Ashe,Syndra,619,324,295,52.34
Ashe,Gangplank,410,214,196,52.2
Ashe,Vex,502,266,236,52.99
Ashe,Rakan,505,269,236,53.27
Ashe,MonkeyKing,461,233,228,50.54
Ashe,Bard,242,136,106,56.2
Ashe,Elise,620,344,276,55.48
Ashe,Zyra,727,293,434,40.3
Ashe,Renekton,474,222,252,46.84
Ashe,Renata,250,146,104,58.4
Ashe,Ornn,420,212,208,50.48
Ashe,Camille,404,186,218,46.04
Ashe,Zac,367,200,167,54.5
Ashe,Nidalee,283,151,132,53.36
Ashe,Taliyah,320,162,158,50.63
Ashe,Orianna,514,307,207,59.73
Ashe,Kennen,353,231,122,65.44
Ashe,Annie,380,216,164,56.84
Ashe,Twitch,1016,455,561,44.78
Ashe,Corki,320,165,155,51.56
Ashe,Singed,305,172,133,56.39
Ashe,Qiyana,401,208,193,51.87
Ashe,Tryndamere,649,315,334,48.54
Ashe,Cassiopeia,344,179,165,52.03
Ashe,Ryze,245,98,147,40
Ashe,Akshan,389,157,232,40.36
Ashe,Naafiri,449,224,225,49.89
Ashe,Olaf,204,113,91,55.39
Ashe,Skarner,391,204,187,52.17
Ashe,Trundle,559,252,307,45.08
Ashe,Kassadin,173,78,95,45.09
Ashe,KogMaw,341,158,183,46.33
Ashe,RekSai,150,83,67,55.33
Ashe,Rumble,154,86,68,55.84
Graves,Pantheon,474,211,263,44.51
Graves,MasterYi,278,130,148,46.76
Graves,Sylas,399,239,160,59.9
Graves,Ashe,512,268,244,52.34
Graves,Karma,204,89,115,43.63
Graves,Irelia,221,101,120,45.7
Graves,Kayn,566,269,297,47.53
Graves,Katarina,265,127,138,47.92
Graves,Vayne,301,138,163,45.85
Graves,DrMundo,170,108,62,63.53
Graves,Olaf,75,36,39,48
Graves,LeeSin,332,142,190,42.77
Graves,Diana,419,213,206,50.84
Graves,Seraphine,319,125,194,39.18
Graves,Aatrox,312,164,148,52.56
Graves,Twitch,254,102,152,40.16
Graves,Veigar,347,121,226,34.87
Graves,Ezreal,545,262,283,48.07
Graves,Milio,170,77,93,45.29
Graves,Yorick,284,121,163,42.61
Graves,Nunu,334,172,162,51.5
Graves,Draven,195,105,90,53.85
Graves,KogMaw,98,46,52,46.94
Graves,Yuumi,265,95,170,35.85
Graves,Gangplank,172,94,78,54.65
Graves,Aphelios,180,110,70,61.11
Graves,Leona,292,168,124,57.53
Graves,Darius,524,278,246,53.05
Graves,Chogath,391,163,228,41.69
Graves,Yasuo,653,326,327,49.92
Graves,Kaisa,489,231,258,47.24
Graves,Trundle,168,85,83,50.6
Graves,Caitlyn,744,340,404,45.7
Graves,Sett,557,261,296,46.86
Graves,Smolder,298,153,145,51.34
Graves,Rengar,194,115,79,59.28
Graves,Hwei,217,97,120,44.7
Graves,Thresh,442,254,188,57.47
Graves,Quinn,130,60,70,46.15
Graves,Viego,391,185,206,47.31
Graves,MissFortune,654,276,378,42.2
Graves,Neeko,302,162,140,53.64
Graves,Tristana,267,140,127,52.43
Graves,Lux,813,369,444,45.39
Graves,Ornn,104,61,43,58.65
Graves,Skarner,106,68,38,64.15
Graves,Ekko,243,104,139,42.8
Graves,Lucian,184,83,101,45.11
Graves,Senna,214,111,103,51.87
Graves,Briar,317,132,185,41.64
Graves,Vex,188,97,91,51.6
Graves,Morgana,405,226,179,55.8
Graves,Naafiri,142,61,81,42.96
Graves,Ziggs,146,65,81,44.52
Graves,Kalista,112,61,51,54.46
Graves,Swain,274,110,164,40.15
Graves,Warwick,466,213,253,45.71
Graves,Gragas,191,107,84,56.02
Graves,Hecarim,145,82,63,56.55
Graves,Kassadin,31,16,15,51.61
Graves,Mordekaiser,455,195,260,42.86
Graves,Jinx,650,322,328,49.54
Graves,Elise,154,92,62,59.74
Graves,Sejuani,96,28,68,29.17
Graves,MonkeyKing,195,82,113,42.05
Graves,Viktor,179,70,109,39.11
Graves,Shaco,306,152,154,49.67
Graves,Zed,315,144,171,45.71
Graves,Varus,209,110,99,52.63
Graves,Soraka,207,79,128,38.16
Graves,Yone,637,329,308,51.65
Graves,Lillia,173,86,87,49.71
Graves,Akali,285,114,171,40
Graves,Udyr,75,46,29,61.33
Graves,Jax,272,128,144,47.06
Graves,Singed,113,39,74,34.51
Graves,Braum,213,104,109,48.83
Graves,Sion,250,99,151,39.6
Graves,Jhin,531,276,255,51.98
Graves,Xerath,214,93,121,43.46
Graves,TahmKench,358,191,167,53.35
Graves,Cassiopeia,84,27,57,32.14
Graves,Garen,450,166,284,36.89
Graves,Ryze,110,47,63,42.73
Graves,Renekton,188,86,102,45.74
Graves,Zeri,116,67,49,57.76
Graves,Lulu,232,139,93,59.91
Graves,Volibear,294,127,167,43.2
Graves,Tryndamere,128,56,72,43.75
Graves,Xayah,263,136,127,51.71
Graves,Kayle,246,123,123,50
Graves,AurelionSol,163,72,91,44.17
Graves,Rell,225,115,110,51.11
Graves,Heimerdinger,130,41,89,31.54
Graves,Shyvana,71,19,52,26.76
Graves,Taric,48,26,22,54.17
Graves,Poppy,188,89,99,47.34
Graves,Rumble,42,15,27,35.71
Graves,Nautilus,344,158,186,45.93
Graves,Rakan,168,76,92,45.24
Graves,Gwen,193,113,80,58.55
Graves,Vi,250,146,104,58.4
Graves,Zoe,125,74,51,59.2
Graves,Teemo,439,193,246,43.96
Graves,Malphite,234,93,141,39.74
Graves,Alistar,113,38,75,33.63
Graves,Rammus,113,43,70,38.05
Graves,Bard,111,69,42,62.16
Graves,Zac,93,45,48,48.39
Graves,Belveth,88,37,51,42.05
Graves,Evelynn,165,64,101,38.79
Graves,Ahri,383,199,184,51.96
Graves,Orianna,120,58,62,48.33
Graves,FiddleSticks,141,55,86,39.01
Graves,Aurora,300,123,177,41
Graves,Sivir,160,53,107,33.13
Graves,Nidalee,106,65,41,61.32
Graves,Brand,207,104,103,50.24
Graves,Samira,324,137,187,42.28
Graves,Riven,134,62,72,46.27
Graves,Qiyana,105,38,67,36.19
Graves,Vladimir,149,66,83,44.3
Graves,Zilean,85,43,42,50.59
Graves,Mel,646,316,330,48.92
Graves,Nasus,251,124,127,49.4
Graves,Akshan,126,50,76,39.68
Graves,Sona,111,50,61,45.05
Graves,Pyke,384,158,226,41.15
Graves,Fiora,111,52,59,46.85
Graves,Malzahar,270,135,135,50
Graves,Gnar,141,70,71,49.65
Graves,Jayce,101,30,71,29.7
Graves,Camille,105,53,52,50.48
Graves,Annie,92,38,54,41.3
Graves,Blitzcrank,255,124,131,48.63
Graves,Galio,233,123,110,52.79
Graves,TwistedFate,116,56,60,48.28
Graves,Khazix,194,77,117,39.69
Graves,Taliyah,99,31,68,31.31
Graves,Syndra,161,81,80,50.31
Graves,Renata,78,39,39,50
Graves,Shen,194,82,112,42.27
Graves,JarvanIV,93,29,64,31.18
Graves,Velkoz,167,74,93,44.31
Graves,Fizz,143,53,90,37.06
Graves,Leblanc,96,34,62,35.42
Graves,Maokai,137,67,70,48.91
Graves,Nocturne,232,90,142,38.79
Graves,Amumu,391,179,212,45.78
Graves,Azir,83,46,37,55.42
Graves,KSante,151,70,81,46.36
Graves,Lissandra,68,40,28,58.82
Graves,Anivia,97,25,72,25.77
Graves,Nami,262,128,134,48.85
Graves,Illaoi,89,40,49,44.94
Graves,Talon,196,132,64,67.35
Graves,XinZhao,119,43,76,36.13
Graves,Ivern,91,28,63,30.77
Graves,Kennen,111,50,61,45.05
Graves,Karthus,118,57,61,48.31
Graves,Janna,53,18,35,33.96
Graves,Kled,35,13,22,37.14
Graves,Nilah,158,75,83,47.47
Graves,Urgot,149,64,85,42.95
Graves,Kindred,158,64,94,40.51
Graves,RekSai,62,31,31,50
Graves,Ambessa,229,117,112,51.09
Graves,Corki,55,15,40,27.27
Graves,Zyra,194,52,142,26.8
Ahri,Pantheon,1361,658,703,48.35
Ahri,MasterYi,812,408,404,50.25
Ahri,Sylas,829,456,373,55.01
Ahri,Ashe,1422,683,739,48.03
Ahri,Karma,525,279,246,53.14
Ahri,Gangplank,366,176,190,48.09
Ahri,Ivern,122,79,43,64.75
Ahri,Mel,1743,832,911,47.73
Ahri,Jhin,1416,704,712,49.72
Ahri,Swain,829,357,472,43.06
Ahri,Gwen,590,289,301,48.98
Ahri,Talon,547,292,255,53.38
Ahri,Yone,1587,855,732,53.88
Ahri,MissFortune,1742,829,913,47.59
Ahri,Taric,191,78,113,40.84
Ahri,Teemo,1139,521,618,45.74
Ahri,Hecarim,292,185,107,63.36
Ahri,Veigar,1049,487,562,46.43
Ahri,Thresh,967,502,465,51.91
Ahri,Poppy,485,258,227,53.2
Ahri,Warwick,1386,619,767,44.66
Ahri,Katarina,802,448,354,55.86
Ahri,Twitch,649,321,328,49.46
Ahri,Morgana,1082,523,559,48.34
Ahri,Yorick,807,291,516,36.06
Ahri,AurelionSol,408,201,207,49.26
Ahri,Kayn,1211,644,567,53.18
Ahri,Singed,211,80,131,37.91
Ahri,Udyr,291,138,153,47.42
Ahri,Jax,700,345,355,49.29
Ahri,Elise,507,258,249,50.89
Ahri,Naafiri,339,176,163,51.92
Ahri,Lulu,649,325,324,50.08
Ahri,Nasus,683,311,372,45.53
Ahri,Neeko,688,330,358,47.97
Ahri,Sett,1489,712,777,47.82
Ahri,Senna,813,402,411,49.45
Ahri,Akali,754,331,423,43.9
Ahri,Akshan,318,169,149,53.14
Ahri,TahmKench,764,365,399,47.77
Ahri,Kennen,340,183,157,53.82
Ahri,MonkeyKing,399,188,211,47.12
Ahri,Vladimir,459,216,243,47.06
Ahri,Vayne,867,433,434,49.94
Ahri,Fiora,391,234,157,59.85
Ahri,Shaco,772,381,391,49.35
Ahri,Fizz,393,146,247,37.15
Ahri,Tristana,742,331,411,44.61
Ahri,Rakan,411,212,199,51.58
Ahri,Yasuo,1718,828,890,48.2
Ahri,Belveth,217,98,119,45.16
Ahri,Mordekaiser,1246,646,600,51.85
Ahri,Alistar,237,114,123,48.1
Ahri,Chogath,1090,558,532,51.19
Ahri,Briar,865,414,451,47.86
Ahri,Jayce,311,192,119,61.74
Ahri,Samira,829,403,426,48.61
Ahri,XinZhao,497,234,263,47.08
Ahri,Brand,733,377,356,51.43
Ahri,Ambessa,414,216,198,52.17
Ahri,Rammus,255,119,136,46.67
Ahri,Aurora,868,478,390,55.07
Ahri,Caitlyn,1908,919,989,48.17
Ahri,Riven,296,183,113,61.82
Ahri,Zed,775,441,334,56.9
Ahri,Smolder,598,271,327,45.32
Ahri,Galio,549,228,321,41.53
Ahri,Sejuani,289,141,148,48.79
Ahri,Malzahar,647,262,385,40.49
Ahri,Amumu,775,325,450,41.94
Ahri,DrMundo,484,204,280,42.15
Ahri,Viktor,490,224,266,45.71
Ahri,Pyke,983,496,487,50.46
Ahri,Nocturne,638,280,358,43.89
Ahri,Leblanc,328,179,149,54.57
Ahri,Irelia,796,379,417,47.61
Ahri,Janna,224,107,117,47.77
Ahri,Jinx,1591,793,798,49.84
Ahri,Nautilus,771,429,342,55.64
Ahri,Zac,262,139,123,53.05
Ahri,Diana,1204,585,619,48.59
Ahri,Illaoi,400,159,241,39.75
Ahri,Evelynn,456,253,203,55.48
Ahri,Hwei,739,342,397,46.28
Ahri,Viego,985,510,475,51.78
Ahri,KSante,339,187,152,55.16
Ahri,Ekko,637,324,313,50.86
Ahri,Lucian,452,227,225,50.22
Ahri,Kassadin,192,82,110,42.71
Ahri,Renata,238,122,116,51.26
Ahri,Maokai,311,152,159,48.87
Ahri,Ornn,319,134,185,42.01
Ahri,Zoe,327,156,171,47.71
Ahri,Aatrox,688,346,342,50.29
Ahri,LeeSin,758,350,408,46.17
Ahri,Zyra,483,171,312,35.4
Ahri,Karthus,232,101,131,43.53
Ahri,Xayah,509,265,244,52.06
Ahri,FiddleSticks,428,214,214,50
Ahri,Lux,2326,933,1393,40.11
Ahri,Velkoz,520,264,256,50.77
Ahri,Nilah,551,253,298,45.92
Ahri,Yuumi,772,380,392,49.22
Ahri,Tryndamere,479,243,236,50.73
Ahri,Varus,677,298,379,44.02
Ahri,Seraphine,856,426,430,49.77
Ahri,Soraka,534,255,279,47.75
Ahri,Rengar,348,216,132,62.07
Ahri,Kindred,456,238,218,52.19
Ahri,Vex,536,242,294,45.15
Ahri,Darius,1428,642,786,44.96
Ahri,Anivia,287,162,125,56.45
Ahri,Blitzcrank,625,335,290,53.6
Ahri,Qiyana,268,160,108,59.7
Ahri,Sona,309,157,152,50.81
Ahri,Gragas,502,241,261,48.01
Ahri,Rell,487,248,239,50.92
Ahri,Nami,737,360,377,48.85
Ahri,Quinn,292,137,155,46.92
Ahri,RekSai,112,60,52,53.57
Ahri,Ryze,295,145,150,49.15
Ahri,Taliyah,276,117,159,42.39
Ahri,Skarner,283,167,116,59.01
Ahri,Xerath,529,264,265,49.91
Ahri,Milio,395,160,235,40.51
Ahri,Kaisa,1097,570,527,51.96
Ahri,Renekton,416,194,222,46.63
Ahri,Lillia,495,230,265,46.46
Ahri,Zeri,394,181,213,45.94
Ahri,Trundle,451,216,235,47.89
Ahri,Kayle,667,308,359,46.18
Ahri,Shen,515,268,247,52.04
Ahri,Braum,433,209,224,48.27
Ahri,Camille,310,129,181,41.61
Ahri,Volibear,977,451,526,46.16
Ahri,Azir,263,127,136,48.29
Ahri,Khazix,524,289,235,55.15
Ahri,Draven,378,197,181,52.12
Ahri,Kled,155,74,81,47.74
Ahri,KogMaw,245,104,141,42.45
Ahri,Zilean,237,111,126,46.84
Ahri,Graves,383,184,199,48.04
Ahri,Cassiopeia,370,169,201,45.68
Ahri,Ezreal,1314,687,627,52.28
Ahri,Ziggs,318,133,185,41.82
Ahri,JarvanIV,314,115,199,36.62
Ahri,Kalista,474,271,203,57.17
Ahri,Vi,749,381,368,50.87
Ahri,Nunu,783,346,437,44.19
Ahri,Aphelios,582,288,294,49.48
Ahri,Leona,505,259,246,51.29
Ahri,Gnar,335,178,157,53.13
Ahri,TwistedFate,236,122,114,51.69
Ahri,Malphite,643,325,318,50.54
Ahri,Garen,1183,584,599,49.37
Ahri,Nidalee,146,73,73,50
Ahri,Urgot,415,182,233,43.86
Ahri,Corki,192,89,103,46.35
Ahri,Lissandra,178,98,80,55.06
Ahri,Syndra,557,256,301,45.96
Ahri,Shyvana,179,95,84,53.07
Ahri,Sion,582,275,307,47.25
Ahri,Bard,265,106,159,40
Ahri,Olaf,216,100,116,46.3
Ahri,Annie,317,169,148,53.31
Ahri,Sivir,342,186,156,54.39
Ahri,Rumble,154,98,56,63.64
Ahri,Heimerdinger,503,247,256,49.11
Ahri,Orianna,323,145,178,44.89
Nilah,Pantheon,630,355,275,56.35
Nilah,MasterYi,396,193,203,48.74
Nilah,Sylas,324,132,192,40.74
Nilah,Ashe,600,251,349,41.83
Nilah,Karma,256,140,116,54.69
Nilah,Swain,365,148,217,40.55
Nilah,FiddleSticks,200,89,111,44.5
Nilah,Akali,355,188,167,52.96
Nilah,Twitch,333,169,164,50.75
Nilah,Senna,294,139,155,47.28
Nilah,Yorick,245,88,157,35.92
Nilah,Akshan,111,72,39,64.86
Nilah,Samira,533,267,266,50.09
Nilah,Pyke,397,259,138,65.24
Nilah,TahmKench,329,146,183,44.38
Nilah,Nunu,268,119,149,44.4
Nilah,Vladimir,210,112,98,53.33
Nilah,Nami,325,153,172,47.08
Nilah,Fiora,155,90,65,58.06
Nilah,LeeSin,344,163,181,47.38
Nilah,Ziggs,144,78,66,54.17
Nilah,Jinx,678,328,350,48.38
Nilah,Nasus,312,119,193,38.14
Nilah,Gragas,204,95,109,46.57
Nilah,Yasuo,794,464,330,58.44
Nilah,Smolder,235,133,102,56.6
Nilah,Mel,830,477,353,57.47
Nilah,KSante,99,62,37,62.63
Nilah,Kayn,523,252,271,48.18
Nilah,MissFortune,868,392,476,45.16
Nilah,Lux,890,444,446,49.89
Nilah,Illaoi,160,102,58,63.75
Nilah,Warwick,561,290,271,51.69
Nilah,Aurora,348,195,153,56.03
Nilah,Ezreal,492,298,194,60.57
Nilah,Neeko,224,107,117,47.77
Nilah,Yone,536,314,222,58.58
Nilah,Poppy,223,106,117,47.53
Nilah,Thresh,459,250,209,54.47
Nilah,Sett,556,229,327,41.19
Nilah,Rammus,86,32,54,37.21
Nilah,Tristana,304,124,180,40.79
Nilah,Karthus,90,36,54,40
Nilah,Zed,305,173,132,56.72
Nilah,Maokai,251,144,107,57.37
Nilah,Gangplank,144,67,77,46.53
Nilah,Diana,420,227,193,54.05
Nilah,Irelia,260,133,127,51.15
Nilah,Aphelios,247,118,129,47.77
Nilah,Leona,296,151,145,51.01
Nilah,Darius,646,315,331,48.76
Nilah,Syndra,178,93,85,52.25
Nilah,Corki,119,41,78,34.45
Nilah,Elise,210,119,91,56.67
Nilah,Katarina,286,115,171,40.21
Nilah,Kaisa,551,317,234,57.53
Nilah,Qiyana,126,71,55,56.35
Nilah,Volibear,357,209,148,58.54
Nilah,Gwen,190,89,101,46.84
Nilah,DrMundo,235,122,113,51.91
Nilah,Lucian,209,84,125,40.19
Nilah,Belveth,89,53,36,59.55
Nilah,AurelionSol,150,75,75,50
Nilah,Briar,419,213,206,50.84
Nilah,Kassadin,92,58,34,63.04
Nilah,Renata,95,52,43,54.74
Nilah,Mordekaiser,539,257,282,47.68
Nilah,Shaco,382,208,174,54.45
Nilah,Zoe,174,118,56,67.82
Nilah,Seraphine,368,184,184,50
Nilah,Olaf,72,37,35,51.39
Nilah,Morgana,492,254,238,51.63
Nilah,Teemo,456,219,237,48.03
Nilah,Aatrox,370,194,176,52.43
Nilah,Jhin,567,266,301,46.91
Nilah,Renekton,178,88,90,49.44
Nilah,Jax,249,117,132,46.99
Nilah,Soraka,185,110,75,59.46
Nilah,Nidalee,82,44,38,53.66
Nilah,Ahri,551,298,253,54.08
Nilah,Sona,133,63,70,47.37
Nilah,Amumu,295,105,190,35.59
Nilah,Caitlyn,848,384,464,45.28
Nilah,Xayah,203,91,112,44.83
Nilah,Ekko,259,126,133,48.65
Nilah,Chogath,358,163,195,45.53
Nilah,Ryze,96,36,60,37.5
Nilah,Xerath,266,126,140,47.37
Nilah,Zac,95,72,23,75.79
Nilah,Skarner,87,47,40,54.02
Nilah,Malzahar,214,88,126,41.12
Nilah,Vi,286,141,145,49.3
Nilah,Viego,362,175,187,48.34
Nilah,Vayne,350,178,172,50.86
Nilah,Zilean,48,29,19,60.42
Nilah,Singed,108,35,73,32.41
Nilah,Kindred,233,110,123,47.21
Nilah,Yuumi,310,130,180,41.94
Nilah,Garen,544,286,258,52.57
Nilah,Khazix,207,110,97,53.14
Nilah,Brand,263,141,122,53.61
Nilah,Evelynn,257,106,151,41.25
Nilah,Leblanc,93,56,37,60.22
Nilah,Kayle,236,111,125,47.03
Nilah,Viktor,179,103,76,57.54
Nilah,Veigar,422,201,221,47.63
Nilah,Shyvana,103,52,51,50.49
Nilah,Orianna,185,102,83,55.14
Nilah,Ambessa,234,144,90,61.54
Nilah,Ornn,181,54,127,29.83
Nilah,Naafiri,183,86,97,46.99
Nilah,Riven,147,100,47,68.03
Nilah,Lulu,198,88,110,44.44
Nilah,Nocturne,328,142,186,43.29
Nilah,Malphite,283,138,145,48.76
Nilah,Trundle,276,122,154,44.2
Nilah,Sejuani,150,78,72,52
Nilah,Kennen,100,54,46,54
Nilah,Blitzcrank,241,153,88,63.49
Nilah,Annie,108,64,44,59.26
Nilah,Draven,161,90,71,55.9
Nilah,Taliyah,59,6,53,10.17
Nilah,Heimerdinger,162,53,109,32.72
Nilah,XinZhao,191,77,114,40.31
Nilah,Azir,116,47,69,40.52
Nilah,Braum,180,107,73,59.44
Nilah,Cassiopeia,117,70,47,59.83
Nilah,Hwei,279,173,106,62.01
Nilah,Vex,218,95,123,43.58
Nilah,Milio,149,70,79,46.98
Nilah,Gnar,143,76,67,53.15
Nilah,Nautilus,329,206,123,62.61
Nilah,Galio,232,92,140,39.66
Nilah,Shen,193,123,70,63.73
Nilah,Hecarim,83,61,22,73.49
Nilah,Varus,245,146,99,59.59
Nilah,JarvanIV,126,46,80,36.51
Nilah,Udyr,81,43,38,53.09
Nilah,Rengar,161,106,55,65.84
Nilah,Kled,72,29,43,40.28
Nilah,Lissandra,81,38,43,46.91
Nilah,Kalista,192,130,62,67.71
Nilah,KogMaw,63,37,26,58.73
Nilah,Sion,273,122,151,44.69
Nilah,Tryndamere,307,200,107,65.15
Nilah,Taric,65,28,37,43.08
Nilah,Talon,153,52,101,33.99
Nilah,Quinn,107,42,65,39.25
Nilah,Anivia,81,46,35,56.79
Nilah,TwistedFate,115,55,60,47.83
Nilah,Zeri,142,85,57,59.86
Nilah,Zyra,241,122,119,50.62
Nilah,Fizz,128,66,62,51.56
Nilah,Velkoz,225,67,158,29.78
Nilah,Sivir,111,59,52,53.15
Nilah,MonkeyKing,177,84,93,47.46
Nilah,Rakan,165,66,99,40
Nilah,Alistar,138,66,72,47.83
Nilah,Camille,111,72,39,64.86
Nilah,Jayce,150,84,66,56
Nilah,Graves,158,83,75,52.53
Nilah,Bard,112,41,71,36.61
Nilah,Janna,89,40,49,44.94
Nilah,Lillia,246,109,137,44.31
Nilah,Rell,211,89,122,42.18
Nilah,Ivern,60,36,24,60
Nilah,Urgot,145,58,87,40
Nilah,RekSai,41,31,10,75.61
Nilah,Rumble,41,13,28,31.71
Belveth,Mordekaiser,264,145,119,54.92
Belveth,Kindred,87,30,57,34.48
Belveth,Qiyana,63,31,32,49.21
Belveth,Ashe,294,137,157,46.6
Belveth,Sona,43,26,17,60.47
Belveth,Malphite,146,37,109,25.34
Belveth,Rengar,85,41,44,48.24
Belveth,Akali,161,64,97,39.75
Belveth,Rakan,97,49,48,50.52
Belveth,Sion,160,88,72,55
Belveth,Ahri,217,119,98,54.84
Belveth,Anivia,53,40,13,75.47
Belveth,Poppy,145,55,90,37.93
Belveth,Teemo,251,119,132,47.41
Belveth,Khazix,75,36,39,48
Belveth,Smolder,136,70,66,51.47
Belveth,MissFortune,358,161,197,44.97
Belveth,Rell,95,51,44,53.68
Belveth,Warwick,272,132,140,48.53
Belveth,Briar,225,122,103,54.22
Belveth,Nilah,89,36,53,40.45
Belveth,Morgana,212,105,107,49.53
Belveth,Aatrox,151,73,78,48.34
Belveth,Veigar,207,82,125,39.61
Belveth,Ezreal,340,184,156,54.12
Belveth,Karma,128,86,42,67.19
Belveth,Gwen,137,81,56,59.12
Belveth,Katarina,130,70,60,53.85
Belveth,Aphelios,156,93,63,59.62
Belveth,Alistar,45,12,33,26.67
Belveth,Vladimir,132,70,62,53.03
Belveth,Jhin,301,168,133,55.81
Belveth,Seraphine,161,66,95,40.99
Belveth,Urgot,79,48,31,60.76
Belveth,MasterYi,167,72,95,43.11
Belveth,Hwei,117,66,51,56.41
Belveth,Xayah,156,91,65,58.33
Belveth,Darius,245,107,138,43.67
Belveth,Evelynn,58,12,46,20.69
Belveth,Renekton,77,43,34,55.84
Belveth,Lux,447,205,242,45.86
Belveth,Jinx,317,128,189,40.38
Belveth,Caitlyn,350,166,184,47.43
Belveth,Nautilus,198,112,86,56.57
Belveth,Garen,275,129,146,46.91
Belveth,Shaco,172,103,69,59.88
Belveth,Yone,286,146,140,51.05
Belveth,Yorick,177,83,94,46.89
Belveth,Irelia,145,71,74,48.97
Belveth,Yasuo,378,202,176,53.44
Belveth,TahmKench,192,83,109,43.23
Belveth,Viego,246,157,89,63.82
Belveth,Pyke,200,132,68,66
Belveth,Ekko,83,58,25,69.88
Belveth,Vex,85,47,38,55.29
Belveth,Gangplank,88,44,44,50
Belveth,Yuumi,170,80,90,47.06
Belveth,Gragas,92,40,52,43.48
Belveth,Naafiri,81,47,34,58.02
Belveth,Kayle,132,61,71,46.21
Belveth,Graves,88,51,37,57.95
Belveth,Galio,92,42,50,45.65
Belveth,Tristana,117,56,61,47.86
Belveth,Lulu,131,54,77,41.22
Belveth,Kled,33,0,33,0
Belveth,Ivern,71,44,27,61.97
Belveth,Nasus,141,71,70,50.35
Belveth,Kaisa,261,125,136,47.89
Belveth,Elise,116,58,58,50
Belveth,Ryze,35,23,12,65.71
Belveth,Vayne,177,85,92,48.02
Belveth,XinZhao,110,43,67,39.09
Belveth,Kayn,229,108,121,47.16
Belveth,Taric,55,19,36,34.55
Belveth,Amumu,195,90,105,46.15
Belveth,Annie,35,17,18,48.57
Belveth,Leona,141,65,76,46.1
Belveth,Lissandra,40,11,29,27.5
Belveth,Vi,89,35,54,39.33
Belveth,Draven,71,52,19,73.24
Belveth,Braum,92,26,66,28.26
Belveth,Udyr,58,27,31,46.55
Belveth,Kennen,62,47,15,75.81
Belveth,Nunu,160,103,57,64.38
Belveth,Leblanc,70,34,36,48.57
Belveth,Zilean,57,25,32,43.86
Belveth,Skarner,74,51,23,68.92
Belveth,Orianna,48,32,16,66.67
Belveth,Cassiopeia,76,54,22,71.05
Belveth,Renata,77,35,42,45.45
Belveth,Jax,112,54,58,48.21
Belveth,Mel,348,213,135,61.21
Belveth,Camille,41,25,16,60.98
Belveth,Pantheon,314,151,163,48.09
Belveth,Shen,114,44,70,38.6
Belveth,Chogath,235,144,91,61.28
Belveth,Quinn,52,25,27,48.08
Belveth,Rammus,73,40,33,54.79
Belveth,Sett,309,120,189,38.83
Belveth,RekSai,35,25,10,71.43
Belveth,Varus,134,79,55,58.96
Belveth,DrMundo,116,81,35,69.83
Belveth,Hecarim,54,33,21,61.11
Belveth,Sylas,160,72,88,45
Belveth,Brand,146,53,93,36.3
Belveth,Sejuani,41,31,10,75.61
Belveth,Sivir,75,33,42,44
Belveth,Nami,181,93,88,51.38
Belveth,Nidalee,43,22,21,51.16
Belveth,Samira,188,79,109,42.02
Belveth,Heimerdinger,98,35,63,35.71
Belveth,KSante,70,48,22,68.57
Belveth,Zeri,62,42,20,67.74
Belveth,Fizz,69,25,44,36.23
Belveth,Zed,109,66,43,60.55
Belveth,Thresh,213,102,111,47.89
Belveth,Tryndamere,98,44,54,44.9
Belveth,Zyra,127,61,66,48.03
Belveth,Bard,30,20,10,66.67
Belveth,Kalista,116,59,57,50.86
Belveth,Swain,168,68,100,40.48
Belveth,LeeSin,127,86,41,67.72
Belveth,Ziggs,62,29,33,46.77
Belveth,Ambessa,145,82,63,56.55
Belveth,Aurora,133,55,78,41.35
Belveth,Singed,45,29,16,64.44
Belveth,Lillia,82,31,51,37.8
Belveth,Soraka,104,61,43,58.65
Belveth,Azir,44,3,41,6.82
Belveth,Velkoz,107,58,49,54.21
Belveth,Illaoi,105,47,58,44.76
Belveth,Volibear,190,113,77,59.47
Belveth,Diana,215,92,123,42.79
Belveth,KogMaw,54,6,48,11.11
Belveth,Lucian,76,61,15,80.26
Belveth,Maokai,50,23,27,46
Belveth,Talon,99,34,65,34.34
Belveth,Milio,86,61,25,70.93
Belveth,Fiora,121,70,51,57.85
Belveth,MonkeyKing,90,43,47,47.78
Belveth,Kassadin,18,10,8,55.56
Belveth,TwistedFate,65,36,29,55.38
Belveth,Syndra,97,42,55,43.3
Belveth,Janna,57,26,31,45.61
Belveth,Corki,103,63,40,61.17
Belveth,Neeko,113,73,40,64.6
Belveth,Senna,155,67,88,43.23
Belveth,AurelionSol,63,34,29,53.97
Belveth,FiddleSticks,107,51,56,47.66
Belveth,Shyvana,53,18,35,33.96
Belveth,Riven,62,40,22,64.52
Belveth,Twitch,133,81,52,60.9
Belveth,Gnar,48,22,26,45.83
Belveth,Malzahar,145,27,118,18.62
Belveth,Rumble,30,10,20,33.33
Belveth,Nocturne,171,60,111,35.09
Belveth,Xerath,106,59,47,55.66
Belveth,Karthus,44,19,25,43.18
Belveth,Olaf,35,20,15,57.14
Belveth,Viktor,97,35,62,36.08
Belveth,Akshan,95,63,32,66.32
Belveth,Jayce,44,36,8,81.82
Belveth,Trundle,101,33,68,32.67
Belveth,Blitzcrank,107,56,51,52.34
Belveth,Ornn,65,40,25,61.54
Belveth,Zoe,66,44,22,66.67
Belveth,Zac,45,17,28,37.78
Belveth,JarvanIV,14,8,6,57.14
Belveth,Taliyah,20,14,6,70
Sona,Fiora,92,46,46,50
Sona,Belveth,43,17,26,39.53
Sona,Sylas,220,104,116,47.27
Sona,Ezreal,396,246,150,62.12
Sona,Yuumi,276,142,134,51.45
Sona,Trundle,150,72,78,48
Sona,MasterYi,221,135,86,61.09
Sona,Veigar,244,134,110,54.92
Sona,Jhin,333,197,136,59.16
Sona,Soraka,162,73,89,45.06
Sona,Yorick,205,79,126,38.54
Sona,LeeSin,150,98,52,65.33
Sona,Yone,437,253,184,57.89
Sona,MissFortune,495,202,293,40.81
Sona,Mel,585,310,275,52.99
Sona,Ornn,78,21,57,26.92
Sona,Udyr,79,27,52,34.18
Sona,Lux,640,302,338,47.19
Sona,Milio,140,57,83,40.71
Sona,Urgot,149,80,69,53.69
Sona,Kayn,371,198,173,53.37
Sona,Yasuo,425,224,201,52.71
Sona,Twitch,178,95,83,53.37
Sona,Neeko,199,141,58,70.85
Sona,Tryndamere,173,133,40,76.88
Sona,Gragas,90,28,62,31.11
Sona,Irelia,218,98,120,44.95
Sona,Kalista,91,65,26,71.43
Sona,Teemo,396,176,220,44.44
Sona,Leblanc,79,53,26,67.09
Sona,Elise,187,121,66,64.71
Sona,Rammus,53,23,30,43.4
Sona,Fizz,118,49,69,41.53
Sona,DrMundo,132,70,62,53.03
Sona,TahmKench,256,116,140,45.31
Sona,Vladimir,113,60,53,53.1
Sona,Ashe,477,266,211,55.77
Sona,Swain,308,167,141,54.22
Sona,Riven,127,73,54,57.48
Sona,Shaco,258,121,137,46.9
Sona,Ekko,222,118,104,53.15
Sona,Thresh,265,121,144,45.66
Sona,Aatrox,184,102,82,55.43
Sona,Nocturne,227,107,120,47.14
Sona,Aphelios,166,110,56,66.27
Sona,Nautilus,252,161,91,63.89
Sona,Sett,367,188,179,51.23
Sona,Katarina,218,109,109,50
Sona,Morgana,356,179,177,50.28
Sona,Diana,312,170,142,54.49
Sona,Briar,261,144,117,55.17
Sona,Pantheon,416,250,166,60.1
Sona,Caitlyn,528,290,238,54.92
Sona,Rumble,29,20,9,68.97
Sona,Malphite,239,125,114,52.3
Sona,Lulu,150,82,68,54.67
Sona,Ambessa,130,50,80,38.46
Sona,Maokai,47,12,35,25.53
Sona,Gwen,155,74,81,47.74
Sona,Lillia,234,122,112,52.14
Sona,Vayne,218,100,118,45.87
Sona,Velkoz,158,66,92,41.77
Sona,Nilah,133,70,63,52.63
Sona,Sejuani,75,38,37,50.67
Sona,Malzahar,167,111,56,66.47
Sona,Jinx,432,197,235,45.6
Sona,Smolder,142,74,68,52.11
Sona,Mordekaiser,371,187,184,50.4
Sona,Gnar,105,48,57,45.71
Sona,Kindred,168,90,78,53.57
Sona,Lucian,132,68,64,51.52
Sona,Warwick,389,193,196,49.61
Sona,TwistedFate,69,23,46,33.33
Sona,Akali,285,134,151,47.02
Sona,Taliyah,55,39,16,70.91
Sona,Hwei,128,59,69,46.09
Sona,Khazix,172,91,81,52.91
Sona,Ahri,309,152,157,49.19
Sona,Illaoi,141,78,63,55.32
Sona,Darius,426,207,219,48.59
Sona,Xayah,132,64,68,48.48
Sona,Rakan,120,60,60,50
Sona,Gangplank,99,57,42,57.58
Sona,Volibear,210,96,114,45.71
Sona,Syndra,92,32,60,34.78
Sona,Nidalee,60,37,23,61.67
Sona,Vex,188,100,88,53.19
Sona,Samira,219,111,108,50.68
Sona,Nunu,179,104,75,58.1
Sona,Cassiopeia,120,75,45,62.5
Sona,Karma,174,107,67,61.49
Sona,Xerath,156,66,90,42.31
Sona,Evelynn,129,77,52,59.69
Sona,Zed,231,154,77,66.67
Sona,JarvanIV,89,49,40,55.06
Sona,Zyra,182,75,107,41.21
Sona,Amumu,182,56,126,30.77
Sona,Heimerdinger,171,97,74,56.73
Sona,Seraphine,277,148,129,53.43
Sona,Viego,249,97,152,38.96
Sona,Nami,211,75,136,35.55
Sona,Kled,49,19,30,38.78
Sona,Rengar,84,54,30,64.29
Sona,Viktor,155,93,62,60
Sona,Tristana,162,97,65,59.88
Sona,Galio,135,73,62,54.07
Sona,KSante,70,54,16,77.14
Sona,Jax,201,104,97,51.74
Sona,Sion,132,68,64,51.52
Sona,FiddleSticks,115,65,50,56.52
Sona,Varus,183,79,104,43.17
Sona,Aurora,197,102,95,51.78
Sona,Brand,122,61,61,50
Sona,Kayle,195,91,104,46.67
Sona,Alistar,65,40,25,61.54
Sona,Camille,63,51,12,80.95
Sona,Naafiri,142,80,62,56.34
Sona,Blitzcrank,112,62,50,55.36
Sona,Rell,95,49,46,51.58
Sona,Ziggs,105,66,39,62.86
Sona,Zac,74,27,47,36.49
Sona,Renekton,83,43,40,51.81
Sona,Azir,61,30,31,49.18
Sona,Kaisa,319,173,146,54.23
Sona,Renata,50,15,35,30
Sona,Shen,140,74,66,52.86
Sona,Leona,185,81,104,43.78
Sona,Senna,238,114,124,47.9
Sona,KogMaw,113,48,65,42.48
Sona,Karthus,64,30,34,46.88
Sona,Graves,111,61,50,54.95
Sona,Chogath,272,139,133,51.1
Sona,Draven,144,106,38,73.61
Sona,Annie,66,25,41,37.88
Sona,Ivern,65,25,40,38.46
Sona,AurelionSol,91,61,30,67.03
Sona,Kassadin,48,36,12,75
Sona,Kennen,104,64,40,61.54
Sona,Talon,146,84,62,57.53
Sona,Poppy,140,87,53,62.14
Sona,XinZhao,103,45,58,43.69
Sona,MonkeyKing,121,54,67,44.63
Sona,Orianna,85,45,40,52.94
Sona,Bard,84,47,37,55.95
Sona,Zeri,68,50,18,73.53
Sona,Pyke,237,162,75,68.35
Sona,Quinn,44,26,18,59.09
Sona,Skarner,74,36,38,48.65
Sona,Nasus,166,58,108,34.94
Sona,Ryze,51,21,30,41.18
Sona,Lissandra,32,14,18,43.75
Sona,Braum,81,60,21,74.07
Sona,Akshan,69,18,51,26.09
Sona,Anivia,67,43,24,64.18
Sona,Garen,319,146,173,45.77
Sona,Olaf,45,36,9,80
Sona,Qiyana,65,36,29,55.38
Sona,Sivir,120,44,76,36.67
Sona,Zilean,71,29,42,40.85
Sona,Corki,75,40,35,53.33
Sona,Vi,127,73,54,57.48
Sona,Jayce,100,69,31,69
Sona,Hecarim,82,34,48,41.46
Sona,Janna,65,39,26,60
Sona,Taric,39,32,7,82.05
Sona,Zoe,70,38,32,54.29
Sona,RekSai,33,30,3,90.91
Sona,Shyvana,71,33,38,46.48
Sona,Singed,28,13,15,46.43
Ivern,Yorick,151,78,73,51.66
Ivern,Viego,139,40,99,28.78
Ivern,Diana,148,75,73,50.68
Ivern,Seraphine,102,48,54,47.06
Ivern,Rakan,59,11,48,18.64
Ivern,Riven,87,36,51,41.38
Ivern,Kayn,187,86,101,45.99
Ivern,Ahri,122,43,79,35.25
Ivern,Jinx,233,107,126,45.92
Ivern,Nautilus,162,82,80,50.62
Ivern,Akshan,72,30,42,41.67
Ivern,FiddleSticks,75,47,28,62.67
Ivern,Samira,110,56,54,50.91
Ivern,Pyke,127,78,49,61.42
Ivern,Shen,90,47,43,52.22
Ivern,Gragas,94,45,49,47.87
Ivern,Yone,189,87,102,46.03
Ivern,Ashe,278,121,157,43.53
Ivern,Alistar,37,27,10,72.97
Ivern,Chogath,209,98,111,46.89
Ivern,Shaco,136,53,83,38.97
Ivern,Poppy,86,39,47,45.35
Ivern,Garen,204,111,93,54.41
Ivern,Rammus,47,20,27,42.55
Ivern,Soraka,97,35,62,36.08
Ivern,TahmKench,151,82,69,54.3
Ivern,Zac,42,27,15,64.29
Ivern,XinZhao,77,34,43,44.16
Ivern,Akali,195,94,101,48.21
Ivern,Caitlyn,260,122,138,46.92
Ivern,Maokai,75,47,28,62.67
Ivern,Tryndamere,37,19,18,51.35
Ivern,Nidalee,33,23,10,69.7
Ivern,Aurora,115,48,67,41.74
Ivern,MissFortune,270,129,141,47.78
Ivern,Nami,143,77,66,53.85
Ivern,Heimerdinger,72,21,51,29.17
Ivern,Viktor,122,59,63,48.36
Ivern,Yasuo,282,134,148,47.52
Ivern,Lulu,93,32,61,34.41
Ivern,Warwick,179,78,101,43.58
Ivern,Mel,251,106,145,42.23
Ivern,Quinn,38,21,17,55.26
Ivern,Teemo,169,61,108,36.09
Ivern,Sett,237,124,113,52.32
Ivern,Lux,315,161,154,51.11
Ivern,Pantheon,165,85,80,51.52
Ivern,Nocturne,109,56,53,51.38
Ivern,Sylas,127,83,44,65.35
Ivern,Aatrox,105,32,73,30.48
Ivern,Vex,72,38,34,52.78
Ivern,Nasus,82,26,56,31.71
Ivern,Briar,72,31,41,43.06
Ivern,Ekko,111,33,78,29.73
Ivern,Zeri,45,15,30,33.33
Ivern,Xerath,83,22,61,26.51
Ivern,Olaf,20,3,17,15
Ivern,Nunu,131,39,92,29.77
Ivern,Thresh,187,66,121,35.29
Ivern,Skarner,42,9,33,21.43
Ivern,Fiora,44,27,17,61.36
Ivern,Mordekaiser,177,74,103,41.81
Ivern,Veigar,120,34,86,28.33
Ivern,Elise,61,24,37,39.34
Ivern,Lucian,81,34,47,41.98
Ivern,Senna,111,59,52,53.15
Ivern,Kindred,56,28,28,50
Ivern,Blitzcrank,89,32,57,35.96
Ivern,Annie,54,37,17,68.52
Ivern,Bard,36,16,20,44.44
Ivern,MasterYi,144,59,85,40.97
Ivern,Swain,116,46,70,39.66
Ivern,Ambessa,109,42,67,38.53
Ivern,Katarina,101,61,40,60.4
Ivern,Braum,108,30,78,27.78
Ivern,MonkeyKing,86,47,39,54.65
Ivern,Khazix,57,23,34,40.35
Ivern,Jax,47,23,24,48.94
Ivern,Karthus,33,18,15,54.55
Ivern,Malphite,92,40,52,43.48
Ivern,Vi,128,51,77,39.84
Ivern,Smolder,110,38,72,34.55
Ivern,Belveth,71,27,44,38.03
Ivern,Kassadin,37,9,28,24.32
Ivern,Lissandra,33,14,19,42.42
Ivern,Zed,182,112,70,61.54
Ivern,Brand,86,46,40,53.49
Ivern,Varus,110,74,36,67.27
Ivern,Gnar,46,22,24,47.83
Ivern,Gwen,78,47,31,60.26
Ivern,Vladimir,101,38,63,37.62
Ivern,Kaisa,172,80,92,46.51
Ivern,Kayle,59,25,34,42.37
Ivern,Rengar,70,38,32,54.29
Ivern,Ezreal,243,136,107,55.97
Ivern,Illaoi,71,29,42,40.85
Ivern,Evelynn,55,22,33,40
Ivern,Gangplank,42,12,30,28.57
Ivern,Orianna,51,22,29,43.14
Ivern,Sivir,91,45,46,49.45
Ivern,Karma,99,43,56,43.43
Ivern,Irelia,120,60,60,50
Ivern,Urgot,77,29,48,37.66
Ivern,Rumble,39,24,15,61.54
Ivern,Syndra,55,41,14,74.55
Ivern,Milio,102,36,66,35.29
Ivern,Camille,37,10,27,27.03
Ivern,Ziggs,65,45,20,69.23
Ivern,Corki,43,6,37,13.95
Ivern,Ryze,35,19,16,54.29
Ivern,Jhin,247,84,163,34.01
Ivern,Sona,65,40,25,61.54
Ivern,KogMaw,56,24,32,42.86
Ivern,Darius,294,133,161,45.24
Ivern,Leblanc,27,10,17,37.04
Ivern,Draven,100,55,45,55
Ivern,Aphelios,109,62,47,56.88
Ivern,KSante,52,36,16,69.23
Ivern,Sion,90,39,51,43.33
Ivern,Neeko,71,42,29,59.15
Ivern,Qiyana,64,27,37,42.19
Ivern,Twitch,94,45,49,47.87
Ivern,Cassiopeia,44,26,18,59.09
Ivern,Xayah,100,32,68,32
Ivern,Hwei,103,33,70,32.04
Ivern,Zyra,91,32,59,35.16
Ivern,Hecarim,26,20,6,76.92
Ivern,Galio,95,40,55,42.11
Ivern,LeeSin,103,33,70,32.04
Ivern,Vayne,135,54,81,40
Ivern,Graves,91,63,28,69.23
Ivern,Zoe,65,31,34,47.69
Ivern,Lillia,78,46,32,58.97
Ivern,Morgana,144,69,75,47.92
Ivern,DrMundo,105,50,55,47.62
Ivern,Malzahar,80,30,50,37.5
Ivern,Rell,100,51,49,51
Ivern,Amumu,122,78,44,63.93
Ivern,Volibear,155,78,77,50.32
Ivern,Taliyah,25,14,11,56
Ivern,Talon,81,38,43,46.91
Ivern,Ornn,38,29,9,76.32
Ivern,Fizz,64,22,42,34.38
Ivern,Trundle,57,28,29,49.12
Ivern,Azir,39,13,26,33.33
Ivern,Nilah,60,24,36,40
Ivern,Kled,33,10,23,30.3
Ivern,Kennen,63,29,34,46.03
Ivern,Velkoz,111,53,58,47.75
Ivern,Udyr,41,16,25,39.02
Ivern,Tristana,102,42,60,41.18
Ivern,TwistedFate,50,39,11,78
Ivern,RekSai,31,9,22,29.03
Ivern,Jayce,70,36,34,51.43
Ivern,Leona,83,69,14,83.13
Ivern,Shyvana,42,22,20,52.38
Ivern,AurelionSol,81,29,52,35.8
Ivern,Renekton,65,31,34,47.69
Ivern,Sejuani,50,17,33,34
Ivern,Yuumi,112,46,66,41.07
Ivern,JarvanIV,54,32,22,59.26
Ivern,Janna,33,12,21,36.36
Ivern,Zilean,27,3,24,11.11
Ivern,Anivia,36,28,8,77.78
Ivern,Kalista,68,43,25,63.24
Ivern,Singed,26,18,8,69.23
Ivern,Naafiri,47,6,41,12.77
Ivern,Renata,20,12,8,60
Ivern,Taric,17,6,11,35.29
Veigar,Yorick,710,305,405,42.96
Veigar,Viego,960,500,460,52.08
Veigar,Diana,1006,476,530,47.32
Veigar,Seraphine,690,374,316,54.2
Veigar,Rakan,381,181,200,47.51
Veigar,Illaoi,353,178,175,50.42
Veigar,Nunu,660,328,332,49.7
Veigar,Irelia,617,296,321,47.97
Veigar,Jhin,1180,559,621,47.37
Veigar,Swain,791,390,401,49.3
Veigar,FiddleSticks,327,148,179,45.26
Veigar,Draven,391,215,176,54.99
Veigar,Smolder,539,305,234,56.59
Veigar,Nautilus,801,444,357,55.43
Veigar,Kayn,1087,590,497,54.28
Veigar,Zed,650,307,343,47.23
Veigar,Sona,244,110,134,45.08
Veigar,Kaisa,941,497,444,52.82
Veigar,Amumu,735,353,382,48.03
Veigar,Warwick,1147,552,595,48.13
Veigar,Evelynn,336,226,110,67.26
Veigar,Ahri,1049,562,487,53.57
Veigar,Yasuo,1222,600,622,49.1
Veigar,Yone,1345,696,649,51.75
Veigar,Sylas,784,381,403,48.6
Veigar,Caitlyn,1628,837,791,51.41
Veigar,MasterYi,763,433,330,56.75
Veigar,Rell,393,208,185,52.93
Veigar,Darius,1245,628,617,50.44
Veigar,Volibear,733,338,395,46.11
Veigar,AurelionSol,354,166,188,46.89
Veigar,TahmKench,868,429,439,49.42
Veigar,Garen,1006,501,505,49.8
Veigar,Tristana,651,333,318,51.15
Veigar,Lux,1968,994,974,50.51
Veigar,Morgana,927,496,431,53.51
Veigar,Tryndamere,410,192,218,46.83
Veigar,Graves,347,226,121,65.13
Veigar,MissFortune,1474,748,726,50.75
Veigar,Leona,544,282,262,51.84
Veigar,Teemo,1061,533,528,50.24
Veigar,Trundle,355,180,175,50.7
Veigar,Mel,1282,626,656,48.83
Veigar,Leblanc,245,131,114,53.47
Veigar,Elise,466,263,203,56.44
Veigar,Fizz,421,231,190,54.87
Veigar,Pantheon,1124,651,473,57.92
Veigar,Sion,489,278,211,56.85
Veigar,Ezreal,1077,597,480,55.43
Veigar,Nami,615,301,314,48.94
Veigar,Gnar,230,107,123,46.52
Veigar,Malzahar,517,232,285,44.87
Veigar,Brand,526,245,281,46.58
Veigar,Velkoz,448,179,269,39.96
Veigar,Samira,697,359,338,51.51
Veigar,Orianna,337,210,127,62.31
Veigar,Malphite,561,302,259,53.83
Veigar,Akali,698,361,337,51.72
Veigar,Shaco,605,377,228,62.31
Veigar,Aatrox,653,334,319,51.15
Veigar,Briar,652,349,303,53.53
Veigar,Jinx,1421,723,698,50.88
Veigar,Nasus,501,241,260,48.1
Veigar,Nocturne,581,287,294,49.4
Veigar,Aurora,599,333,266,55.59
Veigar,Neeko,534,259,275,48.5
Veigar,Heimerdinger,445,236,209,53.03
Veigar,Sett,1019,524,495,51.42
Veigar,Vex,440,250,190,56.82
Veigar,Senna,630,342,288,54.29
Veigar,TwistedFate,200,105,95,52.5
Veigar,Annie,225,129,96,57.33
Veigar,Chogath,926,454,472,49.03
Veigar,Talon,391,233,158,59.59
Veigar,Maokai,256,129,127,50.39
Veigar,Gwen,403,258,145,64.02
Veigar,Katarina,681,403,278,59.18
Veigar,XinZhao,375,179,196,47.73
Veigar,Aphelios,463,236,227,50.97
Veigar,Braum,333,139,194,41.74
Veigar,Mordekaiser,1135,614,521,54.1
Veigar,Jax,621,276,345,44.44
Veigar,Janna,179,100,79,55.87
Veigar,Bard,283,159,124,56.18
Veigar,Lillia,433,213,220,49.19
Veigar,Pyke,788,485,303,61.55
Veigar,Ashe,1162,605,557,52.07
Veigar,Vladimir,335,203,132,60.6
Veigar,Thresh,834,464,370,55.64
Veigar,Naafiri,313,185,128,59.11
Veigar,Syndra,357,203,154,56.86
Veigar,Fiora,353,214,139,60.62
Veigar,Sivir,311,157,154,50.48
Veigar,Hwei,547,246,301,44.97
Veigar,Ryze,169,74,95,43.79
Veigar,Belveth,207,125,82,60.39
Veigar,Gragas,419,248,171,59.19
Veigar,Ekko,524,266,258,50.76
Veigar,Shyvana,155,76,79,49.03
Veigar,Taric,148,46,102,31.08
Veigar,Singed,142,64,78,45.07
Veigar,Milio,342,202,140,59.06
Veigar,Kayle,508,271,237,53.35
Veigar,Poppy,345,179,166,51.88
Veigar,Varus,480,283,197,58.96
Veigar,Skarner,202,113,89,55.94
Veigar,Gangplank,245,122,123,49.8
Veigar,RekSai,91,24,67,26.37
Veigar,Ivern,120,86,34,71.67
Veigar,JarvanIV,225,73,152,32.44
Veigar,KSante,220,156,64,70.91
Veigar,Rengar,267,144,123,53.93
Veigar,Twitch,569,325,244,57.12
Veigar,Karma,369,159,210,43.09
Veigar,Vi,552,297,255,53.8
Veigar,Vayne,628,347,281,55.25
Veigar,Soraka,420,201,219,47.86
Veigar,Ornn,261,154,107,59
Veigar,LeeSin,658,390,268,59.27
Veigar,Zac,227,92,135,40.53
Veigar,Renekton,341,156,185,45.75
Veigar,Zilean,192,90,102,46.88
Veigar,Jayce,211,124,87,58.77
Veigar,Ziggs,328,134,194,40.85
Veigar,Yuumi,584,363,221,62.16
Veigar,Nidalee,133,65,68,48.87
Veigar,Kindred,434,254,180,58.53
Veigar,Ambessa,395,208,187,52.66
Veigar,Qiyana,211,121,90,57.35
Veigar,Taliyah,184,119,65,64.67
Veigar,Khazix,395,219,176,55.44
Veigar,Nilah,422,221,201,52.37
Veigar,Viktor,546,333,213,60.99
Veigar,Kled,143,65,78,45.45
Veigar,DrMundo,397,211,186,53.15
Veigar,Azir,223,113,110,50.67
Veigar,Anivia,204,90,114,44.12
Veigar,Sejuani,206,115,91,55.83
Veigar,Kassadin,148,63,85,42.57
Veigar,Akshan,274,161,113,58.76
Veigar,Blitzcrank,540,283,257,52.41
Veigar,Riven,268,172,96,64.18
Veigar,Kennen,326,183,143,56.13
Veigar,Xayah,474,263,211,55.49
Veigar,Alistar,197,81,116,41.12
Veigar,Corki,226,103,123,45.58
Veigar,KogMaw,183,106,77,57.92
Veigar,Shen,527,321,206,60.91
Veigar,Galio,483,268,215,55.49
Veigar,Karthus,161,75,86,46.58
Veigar,MonkeyKing,354,166,188,46.89
Veigar,Lulu,468,242,226,51.71
Veigar,Udyr,250,138,112,55.2
Veigar,Urgot,319,153,166,47.96
Veigar,Quinn,171,87,84,50.88
Veigar,Renata,167,88,79,52.69
Veigar,Kalista,397,250,147,62.97
Veigar,Zyra,448,236,212,52.68
Veigar,Olaf,128,68,60,53.13
Veigar,Zoe,443,235,208,53.05
Veigar,Xerath,572,299,273,52.27
Veigar,Lucian,396,243,153,61.36
Veigar,Rammus,186,88,98,47.31
Veigar,Lissandra,139,65,74,46.76
Veigar,Cassiopeia,247,137,110,55.47
Veigar,Hecarim,248,164,84,66.13
Veigar,Zeri,277,167,110,60.29
Veigar,Rumble,73,37,36,50.68
Veigar,Camille,173,91,82,52.6
Jinx,Yorick,1046,470,576,44.93
Jinx,Viego,1537,804,733,52.31
Jinx,Diana,1483,782,701,52.73
Jinx,Seraphine,1356,667,689,49.19
Jinx,Rakan,680,361,319,53.09
Jinx,Fiora,616,318,298,51.62
Jinx,Lillia,834,469,365,56.24
Jinx,Aurora,1043,560,483,53.69
Jinx,Zeri,529,311,218,58.79
Jinx,Naafiri,605,286,319,47.27
Jinx,Briar,1347,723,624,53.67
Jinx,Yone,2256,1239,1017,54.92
Jinx,MissFortune,3023,1527,1496,50.51
Jinx,Senna,1070,551,519,51.5
Jinx,Gangplank,566,257,309,45.41
Jinx,Ivern,233,126,107,54.08
Jinx,Mel,2635,1320,1315,50.09
Jinx,Jhin,2353,1192,1161,50.66
Jinx,Swain,1282,622,660,48.52
Jinx,Vayne,1323,753,570,56.92
Jinx,Nocturne,1106,511,595,46.2
Jinx,Kaisa,1800,964,836,53.56
Jinx,Galio,814,437,377,53.69
Jinx,Blitzcrank,993,561,432,56.5
Jinx,Garen,1641,789,852,48.08
Jinx,Kayn,1912,932,980,48.74
Jinx,Lux,3227,1572,1655,48.71
Jinx,Caitlyn,3261,1626,1635,49.86
Jinx,Thresh,1459,727,732,49.83
Jinx,Illaoi,679,352,327,51.84
Jinx,Aatrox,1219,656,563,53.81
Jinx,Ashe,2592,1328,1264,51.23
Jinx,Aphelios,967,515,452,53.26
Jinx,Gragas,678,354,324,52.21
Jinx,Gwen,839,453,386,53.99
Jinx,Yasuo,2192,1093,1099,49.86
Jinx,Bard,368,183,185,49.73
Jinx,Vladimir,580,313,267,53.97
Jinx,Shaco,938,529,409,56.4
Jinx,Tryndamere,670,351,319,52.39
Jinx,Ezreal,2124,1129,995,53.15
Jinx,Milio,563,332,231,58.97
Jinx,Jax,950,434,516,45.68
Jinx,Talon,699,387,312,55.36
Jinx,Leblanc,452,258,194,57.08
Jinx,Yuumi,1193,633,560,53.06
Jinx,Malphite,915,448,467,48.96
Jinx,Neeko,940,491,449,52.23
Jinx,Xayah,933,515,418,55.2
Jinx,Heimerdinger,714,374,340,52.38
Jinx,Kindred,674,345,329,51.19
Jinx,Katarina,981,553,428,56.37
Jinx,Janna,394,172,222,43.65
Jinx,Lissandra,323,178,145,55.11
Jinx,Darius,2131,1132,999,53.12
Jinx,Sejuani,359,155,204,43.18
Jinx,Rell,495,300,195,60.61
Jinx,Teemo,1707,778,929,45.58
Jinx,Amumu,1300,582,718,44.77
Jinx,KogMaw,423,189,234,44.68
Jinx,FiddleSticks,591,323,268,54.65
Jinx,Soraka,796,385,411,48.37
Jinx,Mordekaiser,1874,856,1018,45.68
Jinx,Zed,1081,614,467,56.8
Jinx,Vex,791,427,364,53.98
Jinx,Samira,1362,745,617,54.7
Jinx,Viktor,768,363,405,47.27
Jinx,Nilah,678,350,328,51.62
Jinx,Akali,1323,703,620,53.14
Jinx,Tristana,1101,512,589,46.5
Jinx,Evelynn,700,413,287,59
Jinx,Kalista,525,286,239,54.48
Jinx,Renata,279,124,155,44.44
Jinx,Chogath,1623,906,717,55.82
Jinx,Azir,377,195,182,51.72
Jinx,Sylas,1064,536,528,50.38
Jinx,Lucian,664,347,317,52.26
Jinx,MasterYi,1296,613,683,47.3
Jinx,Taric,280,110,170,39.29
Jinx,XinZhao,540,279,261,51.67
Jinx,Morgana,1863,844,1019,45.3
Jinx,Braum,496,259,237,52.22
Jinx,Annie,303,155,148,51.16
Jinx,Alistar,382,220,162,57.59
Jinx,Pantheon,2076,1166,910,56.17
Jinx,Khazix,719,427,292,59.39
Jinx,Smolder,1076,595,481,55.3
Jinx,Sett,2024,997,1027,49.26
Jinx,Ekko,949,517,432,54.48
Jinx,Veigar,1421,698,723,49.12
Jinx,Nasus,949,487,462,51.32
Jinx,Zoe,621,370,251,59.58
Jinx,Jayce,530,296,234,55.85
Jinx,Rammus,315,172,143,54.6
Jinx,Sion,903,449,454,49.72
Jinx,Kayle,893,448,445,50.17
Jinx,Lulu,800,426,374,53.25
Jinx,Udyr,482,259,223,53.73
Jinx,TahmKench,1325,616,709,46.49
Jinx,Shyvana,399,209,190,52.38
Jinx,Taliyah,337,176,161,52.23
Jinx,Ziggs,615,299,316,48.62
Jinx,LeeSin,1103,595,508,53.94
Jinx,Pyke,1491,796,695,53.39
Jinx,Irelia,1158,571,587,49.31
Jinx,Velkoz,738,364,374,49.32
Jinx,Ahri,1591,798,793,50.16
Jinx,Rengar,506,280,226,55.34
Jinx,Hwei,849,472,377,55.59
Jinx,Sivir,594,259,335,43.6
Jinx,Vi,1018,505,513,49.61
Jinx,DrMundo,754,380,374,50.4
Jinx,Twitch,1100,539,561,49
Jinx,Ryze,297,146,151,49.16
Jinx,Nautilus,1278,650,628,50.86
Jinx,Olaf,269,129,140,47.96
Jinx,Orianna,603,326,277,54.06
Jinx,Urgot,567,297,270,52.38
Jinx,Hecarim,457,246,211,53.83
Jinx,Xerath,860,449,411,52.21
Jinx,Nunu,977,482,495,49.33
Jinx,Syndra,578,287,291,49.65
Jinx,Maokai,481,214,267,44.49
Jinx,Akshan,478,217,261,45.4
Jinx,Zyra,807,392,415,48.57
Jinx,Warwick,2014,1046,968,51.94
Jinx,Karthus,349,181,168,51.86
Jinx,Gnar,564,297,267,52.66
Jinx,Nami,1035,558,477,53.91
Jinx,Trundle,667,316,351,47.38
Jinx,RekSai,187,86,101,45.99
Jinx,Graves,650,328,322,50.46
Jinx,Malzahar,1004,500,504,49.8
Jinx,KSante,453,254,199,56.07
Jinx,Sona,432,235,197,54.4
Jinx,Cassiopeia,406,260,146,64.04
Jinx,Qiyana,521,285,236,54.7
Jinx,MonkeyKing,662,311,351,46.98
Jinx,Varus,978,511,467,52.25
Jinx,Singed,265,132,133,49.81
Jinx,Riven,513,314,199,61.21
Jinx,TwistedFate,339,169,170,49.85
Jinx,Shen,826,430,396,52.06
Jinx,Ornn,513,243,270,47.37
Jinx,Karma,708,395,313,55.79
Jinx,Kled,222,100,122,45.05
Jinx,Renekton,481,236,245,49.06
Jinx,Volibear,1270,647,623,50.94
Jinx,Belveth,317,189,128,59.62
Jinx,AurelionSol,559,279,280,49.91
Jinx,Brand,773,399,374,51.62
Jinx,Nidalee,286,191,95,66.78
Jinx,Camille,348,179,169,51.44
Jinx,Leona,859,433,426,50.41
Jinx,Poppy,695,333,362,47.91
Jinx,Kassadin,298,114,184,38.26
Jinx,Draven,664,333,331,50.15
Jinx,Ambessa,732,359,373,49.04
Jinx,Zilean,363,181,182,49.86
Jinx,Elise,658,374,284,56.84
Jinx,Zac,432,196,236,45.37
Jinx,Kennen,449,215,234,47.88
Jinx,Corki,304,187,117,61.51
Jinx,Skarner,368,231,137,62.77
Jinx,Anivia,298,167,131,56.04
Jinx,JarvanIV,456,234,222,51.32
Jinx,Fizz,556,255,301,45.86
Jinx,Quinn,406,204,202,50.25
Jinx,Rumble,248,108,140,43.55
Yorick,Sett,817,454,363,55.57
Yorick,Ivern,151,73,78,48.34
Yorick,Veigar,710,405,305,57.04
Yorick,Jinx,1046,576,470,55.07
Yorick,Lulu,391,235,156,60.1
Yorick,Aatrox,538,347,191,64.5
Yorick,Brand,435,211,224,48.51
Yorick,Irelia,530,318,212,60
Yorick,Caitlyn,1437,869,568,60.47
Yorick,Milio,322,169,153,52.48
Yorick,Gangplank,194,112,82,57.73
Yorick,MasterYi,592,338,254,57.09
Yorick,Mel,1320,706,614,53.48
Yorick,Swain,505,254,251,50.3
Yorick,Warwick,1022,564,458,55.19
Yorick,Akali,531,307,224,57.82
Yorick,Sona,205,126,79,61.46
Yorick,Heimerdinger,352,192,160,54.55
Yorick,Talon,307,186,121,60.59
Yorick,Ahri,807,516,291,63.94
Yorick,Kalista,212,165,47,77.83
Yorick,FiddleSticks,248,127,121,51.21
Yorick,Shaco,550,332,218,60.36
Yorick,Syndra,349,190,159,54.44
Yorick,Thresh,734,377,357,51.36
Yorick,Urgot,283,157,126,55.48
Yorick,Rengar,238,133,105,55.88
Yorick,Ziggs,289,183,106,63.32
Yorick,Trundle,373,211,162,56.57
Yorick,Fiora,225,125,100,55.56
Yorick,Mordekaiser,904,487,417,53.87
Yorick,Vi,278,167,111,60.07
Yorick,Cassiopeia,191,104,87,54.45
Yorick,Ezreal,903,500,403,55.37
Yorick,Lux,1469,883,586,60.11
Yorick,DrMundo,286,160,126,55.94
Yorick,Nilah,245,157,88,64.08
Yorick,Yuumi,469,245,224,52.24
Yorick,Teemo,856,430,426,50.23
Yorick,Leblanc,196,104,92,53.06
Yorick,Elise,280,189,91,67.5
Yorick,Sylas,443,213,230,48.08
Yorick,Nocturne,433,213,220,49.19
Yorick,Rell,290,203,87,70
Yorick,Ashe,845,524,321,62.01
Yorick,Briar,575,321,254,55.83
Yorick,Hwei,415,234,181,56.39
Yorick,Kaisa,597,314,283,52.6
Yorick,TahmKench,561,307,254,54.72
Yorick,Zac,201,118,83,58.71
Yorick,Amumu,448,244,204,54.46
Yorick,Chogath,827,400,427,48.37
Yorick,Twitch,516,279,237,54.07
Yorick,Jax,462,264,198,57.14
Yorick,Graves,284,163,121,57.39
Yorick,Katarina,523,315,208,60.23
Yorick,Seraphine,667,387,280,58.02
Yorick,Darius,1061,581,480,54.76
Yorick,Neeko,439,290,149,66.06
Yorick,Taric,92,48,44,52.17
Yorick,Riven,226,120,106,53.1
Yorick,Lillia,360,166,194,46.11
Yorick,Orianna,275,162,113,58.91
Yorick,Velkoz,293,132,161,45.05
Yorick,Ambessa,315,164,151,52.06
Yorick,Qiyana,169,86,83,50.89
Yorick,LeeSin,453,267,186,58.94
Yorick,Nasus,501,318,183,63.47
Yorick,Pantheon,843,460,383,54.57
Yorick,Zoe,240,159,81,66.25
Yorick,Senna,513,301,212,58.67
Yorick,Viego,695,381,314,54.82
Yorick,Skarner,145,76,69,52.41
Yorick,Malphite,367,232,135,63.22
Yorick,Vladimir,260,153,107,58.85
Yorick,Tristana,479,311,168,64.93
Yorick,Aurora,451,251,200,55.65
Yorick,MissFortune,1126,638,488,56.66
Yorick,Gragas,342,186,156,54.39
Yorick,Rammus,185,62,123,33.51
Yorick,Nami,540,282,258,52.22
Yorick,Lissandra,139,70,69,50.36
Yorick,Pyke,595,372,223,62.52
Yorick,Sejuani,212,128,84,60.38
Yorick,Shen,286,177,109,61.89
Yorick,MonkeyKing,291,159,132,54.64
Yorick,Naafiri,280,164,116,58.57
Yorick,Diana,662,380,282,57.4
Yorick,Morgana,642,342,300,53.27
Yorick,Ornn,220,132,88,60
Yorick,Karma,400,193,207,48.25
Yorick,Yone,991,583,408,58.83
Yorick,Jhin,974,560,414,57.49
Yorick,Volibear,582,348,234,59.79
Yorick,Samira,514,294,220,57.2
Yorick,Rumble,94,49,45,52.13
Yorick,Leona,379,203,176,53.56
Yorick,Maokai,295,135,160,45.76
Yorick,KSante,154,96,58,62.34
Yorick,Kled,136,75,61,55.15
Yorick,Taliyah,148,89,59,60.14
Yorick,Annie,161,90,71,55.9
Yorick,Blitzcrank,341,230,111,67.45
Yorick,Viktor,281,177,104,62.99
Yorick,Karthus,130,90,40,69.23
Yorick,Xayah,315,195,120,61.9
Yorick,Rakan,259,139,120,53.67
Yorick,Fizz,344,207,137,60.17
Yorick,Sivir,248,97,151,39.11
Yorick,Zed,570,400,170,70.18
Yorick,Nautilus,612,298,314,48.69
Yorick,Zyra,301,166,135,55.15
Yorick,Vex,305,182,123,59.67
Yorick,Lucian,274,138,136,50.36
Yorick,Braum,286,156,130,54.55
Yorick,Kayn,848,519,329,61.2
Yorick,Yasuo,948,492,456,51.9
Yorick,Soraka,358,218,140,60.89
Yorick,Jayce,251,168,83,66.93
Yorick,AurelionSol,267,137,130,51.31
Yorick,Kayle,407,216,191,53.07
Yorick,Hecarim,171,107,64,62.57
Yorick,Smolder,412,225,187,54.61
Yorick,Janna,176,112,64,63.64
Yorick,Tryndamere,378,231,147,61.11
Yorick,Corki,142,96,46,67.61
Yorick,Aphelios,441,253,188,57.37
Yorick,TwistedFate,152,93,59,61.18
Yorick,Malzahar,406,217,189,53.45
Yorick,XinZhao,424,208,216,49.06
Yorick,Evelynn,293,191,102,65.19
Yorick,Xerath,390,198,192,50.77
Yorick,Zeri,246,105,141,42.68
Yorick,Belveth,177,94,83,53.11
Yorick,Khazix,294,209,85,71.09
Yorick,Draven,295,174,121,58.98
Yorick,Renata,149,71,78,47.65
Yorick,Zilean,142,72,70,50.7
Yorick,Kennen,140,103,37,73.57
Yorick,Bard,180,100,80,55.56
Yorick,Sion,414,211,203,50.97
Yorick,Gwen,413,281,132,68.04
Yorick,Galio,416,245,171,58.89
Yorick,Shyvana,179,87,92,48.6
Yorick,Camille,191,153,38,80.1
Yorick,Poppy,274,155,119,56.57
Yorick,Azir,135,63,72,46.67
Yorick,Illaoi,311,162,149,52.09
Yorick,Vayne,637,376,261,59.03
Yorick,Ekko,397,245,152,61.71
Yorick,Alistar,139,73,66,52.52
Yorick,KogMaw,186,112,74,60.22
Yorick,Gnar,253,167,86,66.01
Yorick,JarvanIV,263,112,151,42.59
Yorick,Anivia,187,96,91,51.34
Yorick,Kassadin,99,52,47,52.53
Yorick,Udyr,199,132,67,66.33
Yorick,Nidalee,85,53,32,62.35
Yorick,Quinn,183,94,89,51.37
Yorick,Garen,763,405,358,53.08
Yorick,Singed,136,88,48,64.71
Yorick,Varus,541,276,265,51.02
Yorick,Akshan,247,154,93,62.35
Yorick,Kindred,281,139,142,49.47
Yorick,Renekton,293,158,135,53.92
Yorick,Ryze,178,114,64,64.04
Yorick,Olaf,86,44,42,51.16
Yorick,Nunu,460,253,207,55
Yorick,RekSai,104,58,46,55.77
Seraphine,Sett,1115,503,612,45.11
Seraphine,Ivern,102,54,48,52.94
Seraphine,Veigar,690,316,374,45.8
Seraphine,Jinx,1356,689,667,50.81
Seraphine,Lulu,498,290,208,58.23
Seraphine,Taliyah,117,54,63,46.15
Seraphine,Cassiopeia,251,114,137,45.42
Seraphine,Kaisa,884,430,454,48.64
Seraphine,Neeko,634,330,304,52.05
Seraphine,Sylas,666,291,375,43.69
Seraphine,Ezreal,1079,569,510,52.73
Seraphine,Morgana,1011,460,551,45.5
Seraphine,Irelia,670,390,280,58.21
Seraphine,Diana,845,411,434,48.64
Seraphine,Lux,2298,1129,1169,49.13
Seraphine,Tristana,560,247,313,44.11
Seraphine,Mel,1305,673,632,51.57
Seraphine,Mordekaiser,1069,534,535,49.95
Seraphine,Vi,429,239,190,55.71
Seraphine,Chogath,786,368,418,46.82
Seraphine,Yasuo,1325,693,632,52.3
Seraphine,Jhin,1069,504,565,47.15
Seraphine,Graves,319,194,125,60.82
Seraphine,Leblanc,253,159,94,62.85
Seraphine,Caitlyn,1627,901,726,55.38
Seraphine,Milio,364,131,233,35.99
Seraphine,Teemo,865,396,469,45.78
Seraphine,Poppy,341,183,158,53.67
Seraphine,Akali,657,357,300,54.34
Seraphine,Leona,529,233,296,44.05
Seraphine,Thresh,808,487,321,60.27
Seraphine,FiddleSticks,347,152,195,43.8
Seraphine,Zed,546,257,289,47.07
Seraphine,Viktor,411,206,205,50.12
Seraphine,Pyke,660,341,319,51.67
Seraphine,Yorick,667,280,387,41.98
Seraphine,Nunu,582,286,296,49.14
Seraphine,Draven,325,168,157,51.69
Seraphine,KogMaw,224,102,122,45.54
Seraphine,Yuumi,618,330,288,53.4
Seraphine,Riven,268,148,120,55.22
Seraphine,Volibear,824,392,432,47.57
Seraphine,Syndra,292,151,141,51.71
Seraphine,Sejuani,240,115,125,47.92
Seraphine,LeeSin,630,341,289,54.13
Seraphine,Twitch,594,278,316,46.8
Seraphine,Sion,507,198,309,39.05
Seraphine,Zac,188,112,76,59.57
Seraphine,AurelionSol,343,176,167,51.31
Seraphine,Gnar,230,118,112,51.3
Seraphine,Rammus,187,67,120,35.83
Seraphine,Akshan,251,114,137,45.42
Seraphine,Ashe,1247,667,580,53.49
Seraphine,RekSai,135,74,61,54.81
Seraphine,Hwei,520,221,299,42.5
Seraphine,Braum,348,203,145,58.33
Seraphine,Pantheon,1090,529,561,48.53
Seraphine,Kindred,360,198,162,55
Seraphine,Lucian,338,190,148,56.21
Seraphine,Zyra,421,204,217,48.46
Seraphine,Gangplank,249,117,132,46.99
Seraphine,MasterYi,765,403,362,52.68
Seraphine,Yone,1250,646,604,51.68
Seraphine,Swain,707,375,332,53.04
Seraphine,Kayle,572,266,306,46.5
Seraphine,Aurora,631,342,289,54.2
Seraphine,Viego,779,333,446,42.75
Seraphine,Velkoz,499,244,255,48.9
Seraphine,Briar,705,368,337,52.2
Seraphine,Soraka,457,233,224,50.98
Seraphine,DrMundo,434,192,242,44.24
Seraphine,Jax,575,274,301,47.65
Seraphine,Vayne,693,375,318,54.11
Seraphine,Malzahar,491,253,238,51.53
Seraphine,Darius,1242,629,613,50.64
Seraphine,Warwick,1163,568,595,48.84
Seraphine,Zilean,163,66,97,40.49
Seraphine,Shaco,603,274,329,45.44
Seraphine,Ekko,536,269,267,50.19
Seraphine,Shyvana,232,94,138,40.52
Seraphine,Garen,1006,479,527,47.61
Seraphine,KSante,276,167,109,60.51
Seraphine,Evelynn,349,180,169,51.58
Seraphine,Sivir,305,136,169,44.59
Seraphine,Vladimir,276,123,153,44.57
Seraphine,Talon,373,209,164,56.03
Seraphine,Varus,471,242,229,51.38
Seraphine,Nilah,368,184,184,50
Seraphine,Nasus,590,261,329,44.24
Seraphine,Zeri,176,92,84,52.27
Seraphine,Xerath,414,212,202,51.21
Seraphine,Aatrox,648,366,282,56.48
Seraphine,XinZhao,407,176,231,43.24
Seraphine,Rell,319,143,176,44.83
Seraphine,Camille,184,87,97,47.28
Seraphine,Rengar,281,181,100,64.41
Seraphine,Amumu,578,226,352,39.1
Seraphine,MissFortune,1564,738,826,47.19
Seraphine,Heimerdinger,461,177,284,38.39
Seraphine,Katarina,556,306,250,55.04
Seraphine,Belveth,161,95,66,59.01
Seraphine,Ahri,856,430,426,50.23
Seraphine,Aphelios,423,212,211,50.12
Seraphine,Anivia,261,133,128,50.96
Seraphine,Urgot,255,117,138,45.88
Seraphine,Trundle,506,237,269,46.84
Seraphine,Xayah,434,197,237,45.39
Seraphine,Blitzcrank,511,212,299,41.49
Seraphine,Zoe,279,145,134,51.97
Seraphine,Rakan,380,194,186,51.05
Seraphine,Rumble,112,65,47,58.04
Seraphine,Nautilus,641,313,328,48.83
Seraphine,Samira,854,398,456,46.6
Seraphine,Galio,461,230,231,49.89
Seraphine,Senna,557,264,293,47.4
Seraphine,Kennen,221,126,95,57.01
Seraphine,Khazix,403,199,204,49.38
Seraphine,Orianna,251,122,129,48.61
Seraphine,Nocturne,607,288,319,47.45
Seraphine,Elise,356,216,140,60.67
Seraphine,Maokai,339,197,142,58.11
Seraphine,Smolder,515,277,238,53.79
Seraphine,Gragas,313,171,142,54.63
Seraphine,Ryze,166,122,44,73.49
Seraphine,Tryndamere,360,178,182,49.44
Seraphine,Ambessa,358,173,185,48.32
Seraphine,Fiora,333,163,170,48.95
Seraphine,Brand,444,210,234,47.3
Seraphine,Fizz,320,149,171,46.56
Seraphine,Gwen,447,259,188,57.94
Seraphine,Karma,405,208,197,51.36
Seraphine,Shen,402,197,205,49
Seraphine,Malphite,498,218,280,43.78
Seraphine,Kayn,998,515,483,51.6
Seraphine,Kled,152,80,72,52.63
Seraphine,Janna,193,97,96,50.26
Seraphine,Nami,579,296,283,51.12
Seraphine,Kassadin,159,70,89,44.03
Seraphine,MonkeyKing,331,193,138,58.31
Seraphine,Lissandra,166,71,95,42.77
Seraphine,JarvanIV,190,67,123,35.26
Seraphine,Sona,277,129,148,46.57
Seraphine,Lillia,403,184,219,45.66
Seraphine,Udyr,240,120,120,50
Seraphine,Vex,426,195,231,45.77
Seraphine,Ziggs,339,151,188,44.54
Seraphine,Quinn,238,119,119,50
Seraphine,Renekton,276,138,138,50
Seraphine,Singed,191,75,116,39.27
Seraphine,Skarner,235,118,117,50.21
Seraphine,Illaoi,295,157,138,53.22
Seraphine,Qiyana,195,111,84,56.92
Seraphine,TahmKench,737,357,380,48.44
Seraphine,Kalista,278,162,116,58.27
Seraphine,Annie,148,69,79,46.62
Seraphine,Renata,129,60,69,46.51
Seraphine,Nidalee,170,102,68,60
Seraphine,Karthus,157,101,56,64.33
Seraphine,Corki,169,74,95,43.79
Seraphine,Jayce,260,151,109,58.08
Seraphine,TwistedFate,196,110,86,56.12
Seraphine,Hecarim,178,92,86,51.69
Seraphine,Azir,199,115,84,57.79
Seraphine,Taric,158,80,78,50.63
Seraphine,Naafiri,344,182,162,52.91
Seraphine,Olaf,133,65,68,48.87
Seraphine,Bard,201,105,96,52.24
Seraphine,Alistar,155,70,85,45.16
Seraphine,Ornn,293,136,157,46.42
Rakan,Sett,536,275,261,51.31
Rakan,Ivern,59,48,11,81.36
Rakan,Veigar,381,200,181,52.49
Rakan,Jinx,680,319,361,46.91
Rakan,Lulu,302,155,147,51.32
Rakan,Leblanc,126,38,88,30.16
Rakan,Briar,336,180,156,53.57
Rakan,Zoe,122,71,51,58.2
Rakan,Poppy,254,160,94,62.99
Rakan,DrMundo,199,102,97,51.26
Rakan,Belveth,97,48,49,49.48
Rakan,Anivia,109,74,35,67.89
Rakan,Vladimir,213,93,120,43.66
Rakan,Evelynn,229,129,100,56.33
Rakan,Yasuo,599,324,275,54.09
Rakan,Tristana,261,115,146,44.06
Rakan,Yuumi,370,189,181,51.08
Rakan,Akali,353,195,158,55.24
Rakan,Rammus,97,48,49,49.48
Rakan,Zyra,149,45,104,30.2
Rakan,Mordekaiser,427,161,266,37.7
Rakan,Diana,349,196,153,56.16
Rakan,Lux,859,470,389,54.71
Rakan,MissFortune,745,325,420,43.62
Rakan,Karma,220,104,116,47.27
Rakan,Caitlyn,801,391,410,48.81
Rakan,Vi,259,107,152,41.31
Rakan,Orianna,134,78,56,58.21
Rakan,Draven,140,71,69,50.71
Rakan,Xayah,180,91,89,50.56
Rakan,Senna,341,144,197,42.23
Rakan,Jax,247,149,98,60.32
Rakan,Ahri,411,199,212,48.42
Rakan,Aphelios,182,85,97,46.7
Rakan,Aurora,293,173,120,59.04
Rakan,FiddleSticks,152,70,82,46.05
Rakan,Jhin,527,300,227,56.93
Rakan,Vex,232,117,115,50.43
Rakan,Samira,294,194,100,65.99
Rakan,Neeko,236,131,105,55.51
Rakan,Aatrox,374,206,168,55.08
Rakan,Gragas,171,95,76,55.56
Rakan,Cassiopeia,110,49,61,44.55
Rakan,Irelia,233,124,109,53.22
Rakan,Yone,622,272,350,43.73
Rakan,Mel,708,341,367,48.16
Rakan,Ezreal,427,246,181,57.61
Rakan,Elise,227,121,106,53.3
Rakan,Nasus,266,129,137,48.5
Rakan,Amumu,280,121,159,43.21
Rakan,Naafiri,137,74,63,54.01
Rakan,Xerath,193,94,99,48.7
Rakan,Malphite,269,131,138,48.7
Rakan,Blitzcrank,248,160,88,64.52
Rakan,XinZhao,208,87,121,41.83
Rakan,Qiyana,145,91,54,62.76
Rakan,AurelionSol,115,55,60,47.83
Rakan,Teemo,372,184,188,49.46
Rakan,Sylas,300,155,145,51.67
Rakan,Varus,268,160,108,59.7
Rakan,Yorick,259,120,139,46.33
Rakan,Volibear,317,168,149,53
Rakan,Azir,115,43,72,37.39
Rakan,Thresh,500,235,265,47
Rakan,Illaoi,174,85,89,48.85
Rakan,Nocturne,203,124,79,61.08
Rakan,Ryze,82,56,26,68.29
Rakan,Kayn,574,318,256,55.4
Rakan,Morgana,386,198,188,51.3
Rakan,Darius,605,343,262,56.69
Rakan,Taliyah,55,26,29,47.27
Rakan,LeeSin,283,152,131,53.71
Rakan,Kayle,246,147,99,59.76
Rakan,Seraphine,380,186,194,48.95
Rakan,Garen,590,268,322,45.42
Rakan,Nunu,289,156,133,53.98
Rakan,Rell,160,87,73,54.38
Rakan,Ashe,505,236,269,46.73
Rakan,Swain,385,162,223,42.08
Rakan,Riven,122,46,76,37.7
Rakan,Talon,207,125,82,60.39
Rakan,Viktor,147,67,80,45.58
Rakan,Sona,120,60,60,50
Rakan,Ornn,114,51,63,44.74
Rakan,Ziggs,137,79,58,57.66
Rakan,Galio,217,100,117,46.08
Rakan,Velkoz,248,140,108,56.45
Rakan,Leona,184,82,102,44.57
Rakan,Twitch,254,150,104,59.06
Rakan,Brand,203,104,99,51.23
Rakan,Shaco,261,151,110,57.85
Rakan,Kalista,147,76,71,51.7
Rakan,Gwen,251,203,48,80.88
Rakan,Kindred,144,81,63,56.25
Rakan,JarvanIV,92,66,26,71.74
Rakan,Gnar,113,57,56,50.44
Rakan,Renekton,139,49,90,35.25
Rakan,Graves,168,92,76,54.76
Rakan,Lucian,241,112,129,46.47
Rakan,Pantheon,524,260,264,49.62
Rakan,Warwick,486,230,256,47.33
Rakan,Zed,349,240,109,68.77
Rakan,Vayne,381,216,165,56.69
Rakan,Janna,91,26,65,28.57
Rakan,Katarina,278,158,120,56.83
Rakan,Khazix,210,123,87,58.57
Rakan,Zilean,73,41,32,56.16
Rakan,Kennen,110,64,46,58.18
Rakan,TahmKench,365,175,190,47.95
Rakan,Kled,60,28,32,46.67
Rakan,KogMaw,120,72,48,60
Rakan,Quinn,94,35,59,37.23
Rakan,MasterYi,375,179,196,47.73
Rakan,Kassadin,70,40,30,57.14
Rakan,Kaisa,491,295,196,60.08
Rakan,Fizz,190,80,110,42.11
Rakan,Sivir,141,68,73,48.23
Rakan,Taric,39,17,22,43.59
Rakan,Urgot,148,81,67,54.73
Rakan,Nautilus,313,175,138,55.91
Rakan,Singed,76,20,56,26.32
Rakan,Shyvana,110,57,53,51.82
Rakan,Pyke,332,191,141,57.53
Rakan,Fiora,122,88,34,72.13
Rakan,Smolder,256,117,139,45.7
Rakan,Lillia,192,101,91,52.6
Rakan,Lissandra,91,39,52,42.86
Rakan,Braum,136,81,55,59.56
Rakan,Gangplank,107,53,54,49.53
Rakan,Chogath,441,221,220,50.11
Rakan,Rengar,171,104,67,60.82
Rakan,RekSai,59,20,39,33.9
Rakan,Sion,294,143,151,48.64
Rakan,Sejuani,100,35,65,35
Rakan,Ambessa,217,165,52,76.04
Rakan,KSante,104,31,73,29.81
Rakan,Nami,367,201,166,54.77
Rakan,Ekko,257,152,105,59.14
Rakan,Heimerdinger,136,59,77,43.38
Rakan,Camille,85,59,26,69.41
Rakan,Shen,213,104,109,48.83
Rakan,Skarner,106,51,55,48.11
Rakan,Syndra,194,58,136,29.9
Rakan,Milio,156,52,104,33.33
Rakan,Zeri,123,57,66,46.34
Rakan,Viego,400,164,236,41
Rakan,Soraka,204,79,125,38.73
Rakan,Renata,61,11,50,18.03
Rakan,Olaf,74,54,20,72.97
Rakan,Corki,109,64,45,58.72
Rakan,Malzahar,254,135,119,53.15
Rakan,MonkeyKing,176,93,83,52.84
Rakan,Akshan,178,96,82,53.93
Rakan,TwistedFate,139,84,55,60.43
Rakan,Hecarim,79,20,59,25.32
Rakan,Hwei,230,110,120,47.83
Rakan,Nidalee,87,64,23,73.56
Rakan,Maokai,120,65,55,54.17
Rakan,Nilah,165,99,66,60
Rakan,Tryndamere,210,78,132,37.14
Rakan,Bard,114,59,55,51.75
Rakan,Trundle,147,84,63,57.14
Rakan,Karthus,104,71,33,68.27
Rakan,Udyr,123,53,70,43.09
Rakan,Zac,94,36,58,38.3
Rakan,Jayce,156,72,84,46.15
Rakan,Alistar,131,64,67,48.85
Rakan,Rumble,77,45,32,58.44
Rakan,Annie,119,53,66,44.54
Lillia,Leblanc,168,86,82,51.19
Lillia,Briar,470,186,284,39.57
Lillia,Zoe,165,93,72,56.36
Lillia,Jinx,834,365,469,43.76
Lillia,Poppy,244,141,103,57.79
Lillia,Gangplank,124,38,86,30.65
Lillia,Gragas,222,144,78,64.86
Lillia,TwistedFate,189,83,106,43.92
Lillia,Lucian,189,117,72,61.9
Lillia,Leona,267,118,149,44.19
Lillia,Heimerdinger,218,103,115,47.25
Lillia,Kindred,258,119,139,46.12
Lillia,Katarina,311,173,138,55.63
Lillia,Caitlyn,1013,502,511,49.56
Lillia,Janna,127,57,70,44.88
Lillia,Vladimir,223,138,85,61.88
Lillia,Diana,524,238,286,45.42
Lillia,Akali,395,190,205,48.1
Lillia,Karma,247,123,124,49.8
Lillia,Pantheon,645,298,347,46.2
Lillia,Garen,580,317,263,54.66
Lillia,Ziggs,195,76,119,38.97
Lillia,Zeri,136,58,78,42.65
Lillia,Zyra,197,72,125,36.55
Lillia,Darius,843,409,434,48.52
Lillia,Sejuani,165,107,58,64.85
Lillia,Mel,870,473,397,54.37
Lillia,Jhin,677,339,338,50.07
Lillia,Rell,214,90,124,42.06
Lillia,Yorick,360,194,166,53.89
Lillia,MasterYi,334,144,190,43.11
Lillia,Irelia,331,189,142,57.1
Lillia,Shen,280,142,138,50.71
Lillia,Nami,326,122,204,37.42
Lillia,Teemo,532,262,270,49.25
Lillia,Warwick,579,306,273,52.85
Lillia,Samira,324,176,148,54.32
Lillia,Lux,1077,467,610,43.36
Lillia,Tryndamere,260,152,108,58.46
Lillia,Sivir,157,77,80,49.04
Lillia,Soraka,254,154,100,60.63
Lillia,Malphite,343,196,147,57.14
Lillia,MonkeyKing,170,67,103,39.41
Lillia,Sylas,364,203,161,55.77
Lillia,Swain,492,222,270,45.12
Lillia,Senna,425,191,234,44.94
Lillia,Kayle,272,103,169,37.87
Lillia,Kayn,624,319,305,51.12
Lillia,Yasuo,765,449,316,58.69
Lillia,Ezreal,601,346,255,57.57
Lillia,Morgana,500,244,256,48.8
Lillia,DrMundo,378,171,207,45.24
Lillia,Ekko,360,154,206,42.78
Lillia,Zed,508,276,232,54.33
Lillia,Lulu,296,148,148,50
Lillia,Gwen,227,126,101,55.51
Lillia,Maokai,163,65,98,39.88
Lillia,Veigar,433,220,213,50.81
Lillia,Brand,280,124,156,44.29
Lillia,Aatrox,383,191,192,49.87
Lillia,Ashe,671,359,312,53.5
Lillia,Chogath,587,353,234,60.14
Lillia,Kennen,167,78,89,46.71
Lillia,Shaco,340,142,198,41.76
Lillia,Kaisa,581,285,296,49.05
Lillia,Sona,234,112,122,47.86
Lillia,Fiora,167,67,100,40.12
Lillia,Nunu,437,234,203,53.55
Lillia,Aphelios,272,127,145,46.69
Lillia,LeeSin,299,180,119,60.2
Lillia,MissFortune,917,414,503,45.15
Lillia,Xayah,213,135,78,63.38
Lillia,Volibear,527,251,276,47.63
Lillia,Jax,381,201,180,52.76
Lillia,Taliyah,121,58,63,47.93
Lillia,Twitch,303,143,160,47.19
Lillia,KSante,114,70,44,61.4
Lillia,Graves,173,87,86,50.29
Lillia,Taric,89,40,49,44.94
Lillia,Vi,361,178,183,49.31
Lillia,Sion,350,164,186,46.86
Lillia,Skarner,132,84,48,63.64
Lillia,Xerath,273,128,145,46.89
Lillia,Jayce,134,80,54,59.7
Lillia,Kalista,199,93,106,46.73
Lillia,Neeko,284,141,143,49.65
Lillia,XinZhao,213,94,119,44.13
Lillia,Tristana,360,203,157,56.39
Lillia,Hecarim,145,73,72,50.34
Lillia,Malzahar,273,117,156,42.86
Lillia,Fizz,208,101,107,48.56
Lillia,Pyke,420,248,172,59.05
Lillia,Illaoi,181,76,105,41.99
Lillia,Ahri,495,265,230,53.54
Lillia,Talon,245,89,156,36.33
Lillia,Nocturne,246,122,124,49.59
Lillia,Trundle,142,59,83,41.55
Lillia,Yone,734,377,357,51.36
Lillia,Kled,51,25,26,49.02
Lillia,Aurora,358,144,214,40.22
Lillia,Thresh,567,332,235,58.55
Lillia,Zilean,112,53,59,47.32
Lillia,Gnar,144,97,47,67.36
Lillia,Viktor,206,97,109,47.09
Lillia,Syndra,255,108,147,42.35
Lillia,Mordekaiser,589,245,344,41.6
Lillia,Akshan,178,89,89,50
Lillia,Amumu,387,186,201,48.06
Lillia,Azir,151,87,64,57.62
Lillia,AurelionSol,187,116,71,62.03
Lillia,Milio,190,84,106,44.21
Lillia,Ambessa,241,110,131,45.64
Lillia,Khazix,300,143,157,47.67
Lillia,Viego,586,299,287,51.02
Lillia,Olaf,121,50,71,41.32
Lillia,Yuumi,322,140,182,43.48
Lillia,Naafiri,179,65,114,36.31
Lillia,Orianna,140,95,45,67.86
Lillia,Renekton,168,86,82,51.19
Lillia,Seraphine,403,219,184,54.34
Lillia,JarvanIV,216,116,100,53.7
Lillia,Galio,269,85,184,31.6
Lillia,FiddleSticks,225,104,121,46.22
Lillia,Varus,329,172,157,52.28
Lillia,Elise,195,96,99,49.23
Lillia,Ryze,109,58,51,53.21
Lillia,TahmKench,538,313,225,58.18
Lillia,Kassadin,116,56,60,48.28
Lillia,Lissandra,93,36,57,38.71
Lillia,Sett,611,326,285,53.36
Lillia,Alistar,119,57,62,47.9
Lillia,Draven,246,133,113,54.07
Lillia,Singed,119,66,53,55.46
Lillia,Annie,143,71,72,49.65
Lillia,Vayne,419,201,218,47.97
Lillia,Braum,143,77,66,53.85
Lillia,Evelynn,269,143,126,53.16
Lillia,Zac,193,107,86,55.44
Lillia,Udyr,157,61,96,38.85
Lillia,KogMaw,148,84,64,56.76
Lillia,Vex,244,128,116,52.46
Lillia,Smolder,318,136,182,42.77
Lillia,Rakan,192,91,101,47.4
Lillia,Corki,127,86,41,67.72
Lillia,Hwei,270,147,123,54.44
Lillia,Anivia,87,25,62,28.74
Lillia,Rammus,115,59,56,51.3
Lillia,Nautilus,412,244,168,59.22
Lillia,Riven,149,92,57,61.74
Lillia,Renata,84,41,43,48.81
Lillia,Shyvana,134,64,70,47.76
Lillia,Blitzcrank,369,194,175,52.57
Lillia,Cassiopeia,161,74,87,45.96
Lillia,Rengar,141,74,67,52.48
Lillia,Nasus,320,170,150,53.13
Lillia,Velkoz,233,96,137,41.2
Lillia,Rumble,47,12,35,25.53
Lillia,Karthus,65,22,43,33.85
Lillia,Nidalee,107,62,45,57.94
Lillia,Urgot,139,77,62,55.4
Lillia,Bard,111,61,50,54.95
Lillia,Belveth,82,51,31,62.2
Lillia,RekSai,61,34,27,55.74
Lillia,Ornn,165,84,81,50.91
Lillia,Ivern,78,32,46,41.03
Lillia,Qiyana,159,62,97,38.99
Lillia,Nilah,246,137,109,55.69
Lillia,Camille,134,67,67,50
Lillia,Quinn,147,70,77,47.62
Zeri,Leblanc,102,52,50,50.98
Zeri,Briar,279,124,155,44.44
Zeri,Zoe,143,81,62,56.64
Zeri,Jinx,529,218,311,41.21
Zeri,Poppy,241,128,113,53.11
Zeri,Warwick,433,185,248,42.73
Zeri,Katarina,208,78,130,37.5
Zeri,Twitch,252,111,141,44.05
Zeri,Morgana,326,115,211,35.28
Zeri,Riven,116,68,48,58.62
Zeri,Nocturne,195,106,89,54.36
Zeri,Lulu,228,127,101,55.7
Zeri,Gnar,115,70,45,60.87
Zeri,Viego,256,99,157,38.67
Zeri,Yone,510,265,245,51.96
Zeri,Kaisa,332,178,154,53.61
Zeri,TahmKench,277,134,143,48.38
Zeri,Irelia,268,129,139,48.13
Zeri,Lillia,136,78,58,57.35
Zeri,Sylas,280,165,115,58.93
Zeri,Caitlyn,568,293,275,51.58
Zeri,Lux,560,276,284,49.29
Zeri,Teemo,417,222,195,53.24
Zeri,LeeSin,248,124,124,50
Zeri,Chogath,351,144,207,41.03
Zeri,Lucian,222,106,116,47.75
Zeri,Xerath,106,37,69,34.91
Zeri,Gragas,152,96,56,63.16
Zeri,Rell,111,61,50,54.95
Zeri,Heimerdinger,132,64,68,48.48
Zeri,Mordekaiser,368,150,218,40.76
Zeri,Ashe,424,169,255,39.86
Zeri,Pyke,336,162,174,48.21
Zeri,Gwen,152,95,57,62.5
Zeri,RekSai,26,10,16,38.46
Zeri,Gangplank,102,61,41,59.8
Zeri,Leona,289,145,144,50.17
Zeri,Sett,426,200,226,46.95
Zeri,Orianna,150,85,65,56.67
Zeri,Draven,162,93,69,57.41
Zeri,Nautilus,298,164,134,55.03
Zeri,Urgot,165,81,84,49.09
Zeri,Shaco,285,160,125,56.14
Zeri,Annie,101,59,42,58.42
Zeri,Ezreal,409,204,205,49.88
Zeri,Quinn,79,39,40,49.37
Zeri,Yasuo,392,189,203,48.21
Zeri,MissFortune,574,306,268,53.31
Zeri,Neeko,248,144,104,58.06
Zeri,Renekton,134,60,74,44.78
Zeri,Hecarim,98,45,53,45.92
Zeri,Viktor,152,72,80,47.37
Zeri,Jhin,514,253,261,49.22
Zeri,Tryndamere,158,76,82,48.1
Zeri,Ivern,45,30,15,66.67
Zeri,Seraphine,176,84,92,47.73
Zeri,Kayle,208,75,133,36.06
Zeri,FiddleSticks,121,80,41,66.12
Zeri,Taric,70,48,22,68.57
Zeri,Camille,119,65,54,54.62
Zeri,Rengar,141,84,57,59.57
Zeri,Aatrox,269,138,131,51.3
Zeri,MasterYi,242,121,121,50
Zeri,Xayah,188,102,86,54.26
Zeri,Hwei,211,99,112,46.92
Zeri,Zed,240,103,137,42.92
Zeri,Blitzcrank,189,92,97,48.68
Zeri,Ambessa,229,122,107,53.28
Zeri,Singed,87,35,52,40.23
Zeri,Talon,156,51,105,32.69
Zeri,Ekko,198,118,80,59.6
Zeri,Tristana,247,95,152,38.46
Zeri,Soraka,189,111,78,58.73
Zeri,Nasus,260,98,162,37.69
Zeri,Aurora,259,109,150,42.08
Zeri,Vayne,221,99,122,44.8
Zeri,MonkeyKing,89,34,55,38.2
Zeri,Samira,272,150,122,55.15
Zeri,Volibear,334,150,184,44.91
Zeri,Graves,116,49,67,42.24
Zeri,Ahri,394,213,181,54.06
Zeri,Yorick,246,141,105,57.32
Zeri,Velkoz,190,90,100,47.37
Zeri,DrMundo,137,72,65,52.55
Zeri,Shen,182,64,118,35.16
Zeri,Fizz,136,68,68,50
Zeri,Yuumi,244,103,141,42.21
Zeri,Vi,270,147,123,54.44
Zeri,Swain,235,94,141,40
Zeri,Akali,256,116,140,45.31
Zeri,Kindred,154,74,80,48.05
Zeri,Naafiri,82,36,46,43.9
Zeri,Milio,156,79,77,50.64
Zeri,Fiora,106,67,39,63.21
Zeri,Elise,147,59,88,40.14
Zeri,Pantheon,395,159,236,40.25
Zeri,Malzahar,216,90,126,41.67
Zeri,Darius,480,237,243,49.38
Zeri,Udyr,129,72,57,55.81
Zeri,Cassiopeia,102,42,60,41.18
Zeri,Nami,251,130,121,51.79
Zeri,Illaoi,100,52,48,52
Zeri,Rammus,94,68,26,72.34
Zeri,Kennen,81,41,40,50.62
Zeri,Mel,624,299,325,47.92
Zeri,Zyra,155,81,74,52.26
Zeri,Vladimir,134,53,81,39.55
Zeri,Khazix,191,109,82,57.07
Zeri,Thresh,277,163,114,58.84
Zeri,Sejuani,59,18,41,30.51
Zeri,Renata,71,35,36,49.3
Zeri,Corki,87,47,40,54.02
Zeri,Bard,117,66,51,56.41
Zeri,Zac,72,23,49,31.94
Zeri,Akshan,119,51,68,42.86
Zeri,Ziggs,95,51,44,53.68
Zeri,Kayn,363,168,195,46.28
Zeri,Smolder,211,90,121,42.65
Zeri,AurelionSol,136,59,77,43.38
Zeri,Garen,358,148,210,41.34
Zeri,Evelynn,111,68,43,61.26
Zeri,Karma,166,77,89,46.39
Zeri,Kalista,116,44,72,37.93
Zeri,Azir,124,81,43,65.32
Zeri,Vex,170,77,93,45.29
Zeri,Galio,229,96,133,41.92
Zeri,Varus,264,124,140,46.97
Zeri,Rakan,123,66,57,53.66
Zeri,JarvanIV,127,54,73,42.52
Zeri,Ryze,118,57,61,48.31
Zeri,Kassadin,60,32,28,53.33
Zeri,Malphite,196,93,103,47.45
Zeri,Diana,335,139,196,41.49
Zeri,Maokai,102,53,49,51.96
Zeri,Jayce,81,33,48,40.74
Zeri,KSante,127,77,50,60.63
Zeri,TwistedFate,77,55,22,71.43
Zeri,Sona,68,18,50,26.47
Zeri,Nunu,238,96,142,40.34
Zeri,Belveth,62,20,42,32.26
Zeri,Nidalee,53,29,24,54.72
Zeri,Janna,112,56,56,50
Zeri,KogMaw,108,48,60,44.44
Zeri,Syndra,190,107,83,56.32
Zeri,Nilah,142,57,85,40.14
Zeri,Ornn,86,33,53,38.37
Zeri,Lissandra,40,6,34,15
Zeri,Zilean,57,18,39,31.58
Zeri,XinZhao,118,56,62,47.46
Zeri,Qiyana,103,47,56,45.63
Zeri,Skarner,95,53,42,55.79
Zeri,Aphelios,177,96,81,54.24
Zeri,Amumu,262,94,168,35.88
Zeri,Jax,193,59,134,30.57
Zeri,Kled,47,15,32,31.91
Zeri,Sion,250,140,110,56
Zeri,Veigar,277,110,167,39.71
Zeri,Taliyah,62,31,31,50
Zeri,Alistar,91,38,53,41.76
Zeri,Senna,271,125,146,46.13
Zeri,Rumble,79,40,39,50.63
Zeri,Anivia,81,37,44,45.68
Zeri,Brand,127,40,87,31.5
Zeri,Trundle,99,54,45,54.55
Zeri,Karthus,87,53,34,60.92
Zeri,Shyvana,65,47,18,72.31
Zeri,Braum,106,55,51,51.89
Zeri,Sivir,87,19,68,21.84
Zeri,Olaf,68,39,29,57.35
Leblanc,Fiora,68,32,36,47.06
Leblanc,Lillia,168,82,86,48.81
Leblanc,Aurora,248,131,117,52.82
Leblanc,Zeri,102,50,52,49.02
Leblanc,Rakan,126,88,38,69.84
Leblanc,Irelia,159,59,100,37.11
Leblanc,Warwick,350,130,220,37.14
Leblanc,Galio,250,91,159,36.4
Leblanc,Sivir,104,39,65,37.5
Leblanc,Rell,106,57,49,53.77
Leblanc,Sett,284,152,132,53.52
Leblanc,Talon,108,57,51,52.78
Leblanc,FiddleSticks,127,66,61,51.97
Leblanc,Ashe,378,240,138,63.49
Leblanc,Blitzcrank,163,100,63,61.35
Leblanc,Malphite,157,68,89,43.31
Leblanc,Rengar,125,86,39,68.8
Leblanc,Akali,232,119,113,51.29
Leblanc,Yone,331,153,178,46.22
Leblanc,Briar,181,74,107,40.88
Leblanc,Vex,147,65,82,44.22
Leblanc,Jinx,452,194,258,42.92
Leblanc,Milio,106,50,56,47.17
Leblanc,Olaf,45,24,21,53.33
Leblanc,LeeSin,232,126,106,54.31
Leblanc,Diana,321,152,169,47.35
Leblanc,Seraphine,253,94,159,37.15
Leblanc,Karma,183,81,102,44.26
Leblanc,Mordekaiser,320,143,177,44.69
Leblanc,Volibear,255,119,136,46.67
Leblanc,Mel,615,276,339,44.88
Leblanc,Neeko,182,99,83,54.4
Leblanc,Yorick,196,92,104,46.94
Leblanc,Veigar,245,114,131,46.53
Leblanc,Caitlyn,442,180,262,40.72
Leblanc,Sona,79,26,53,32.91
Leblanc,Jayce,83,40,43,48.19
Leblanc,Amumu,185,85,100,45.95
Leblanc,Yasuo,412,189,223,45.87
Leblanc,Jax,169,76,93,44.97
Leblanc,Heimerdinger,105,26,79,24.76
Leblanc,Soraka,112,45,67,40.18
Leblanc,Zed,200,111,89,55.5
Leblanc,Samira,273,136,137,49.82
Leblanc,Ambessa,163,59,104,36.2
Leblanc,Nunu,189,97,92,51.32
Leblanc,Kayle,203,88,115,43.35
Leblanc,Katarina,182,100,82,54.95
Leblanc,Jhin,406,161,245,39.66
Leblanc,Lux,626,288,338,46.01
Leblanc,Ekko,142,71,71,50
Leblanc,Kassadin,27,13,14,48.15
Leblanc,TahmKench,199,84,115,42.21
Leblanc,Gnar,104,58,46,55.77
Leblanc,KSante,129,49,80,37.98
Leblanc,Ahri,328,149,179,45.43
Leblanc,Anivia,91,55,36,60.44
Leblanc,Xayah,149,97,52,65.1
Leblanc,Chogath,267,113,154,42.32
Leblanc,MissFortune,486,242,244,49.79
Leblanc,Malzahar,165,62,103,37.58
Leblanc,Viego,292,130,162,44.52
Leblanc,Vayne,197,102,95,51.78
Leblanc,Sylas,175,83,92,47.43
Leblanc,Camille,100,61,39,61
Leblanc,Kayn,287,132,155,45.99
Leblanc,Yuumi,197,97,100,49.24
Leblanc,Lucian,118,49,69,41.53
Leblanc,Nami,221,115,106,52.04
Leblanc,Teemo,282,119,163,42.2
Leblanc,Shaco,238,98,140,41.18
Leblanc,Naafiri,132,47,85,35.61
Leblanc,Ziggs,76,29,47,38.16
Leblanc,Kalista,121,64,57,52.89
Leblanc,Swain,157,58,99,36.94
Leblanc,Renekton,130,66,64,50.77
Leblanc,Leona,222,77,145,34.68
Leblanc,Janna,86,29,57,33.72
Leblanc,JarvanIV,88,40,48,45.45
Leblanc,Udyr,101,50,51,49.5
Leblanc,Skarner,90,47,43,52.22
Leblanc,Ezreal,407,202,205,49.63
Leblanc,Trundle,109,59,50,54.13
Leblanc,Rammus,66,25,41,37.88
Leblanc,MonkeyKing,106,62,44,58.49
Leblanc,Nautilus,250,115,135,46
Leblanc,Garen,350,167,183,47.71
Leblanc,Singed,77,36,41,46.75
Leblanc,Bard,70,47,23,67.14
Leblanc,Nocturne,142,67,75,47.18
Leblanc,Darius,428,227,201,53.04
Leblanc,Gragas,158,95,63,60.13
Leblanc,Gangplank,97,43,54,44.33
Leblanc,Tristana,182,107,75,58.79
Leblanc,Pyke,236,137,99,58.05
Leblanc,Aatrox,220,113,107,51.36
Leblanc,Riven,111,45,66,40.54
Leblanc,Aphelios,154,80,74,51.95
Leblanc,DrMundo,164,72,92,43.9
Leblanc,Thresh,361,228,133,63.16
Leblanc,Khazix,140,84,56,60
Leblanc,Shen,177,90,87,50.85
Leblanc,Nilah,93,37,56,39.78
Leblanc,Kled,42,9,33,21.43
Leblanc,Vi,153,45,108,29.41
Leblanc,Draven,154,72,82,46.75
Leblanc,Lulu,173,73,100,42.2
Leblanc,Vladimir,144,72,72,50
Leblanc,Brand,138,64,74,46.38
Leblanc,Zoe,128,58,70,45.31
Leblanc,Pantheon,393,159,234,40.46
Leblanc,Evelynn,133,64,69,48.12
Leblanc,Azir,94,43,51,45.74
Leblanc,Fizz,129,59,70,45.74
Leblanc,Kaisa,274,147,127,53.65
Leblanc,Tryndamere,127,53,74,41.73
Leblanc,Kennen,81,40,41,49.38
Leblanc,Qiyana,45,25,20,55.56
Leblanc,Karthus,90,43,47,47.78
Leblanc,Twitch,210,101,109,48.1
Leblanc,Gwen,132,60,72,45.45
Leblanc,AurelionSol,73,31,42,42.47
Leblanc,Morgana,214,81,133,37.85
Leblanc,Velkoz,169,71,98,42.01
Leblanc,Smolder,222,78,144,35.14
Leblanc,Illaoi,83,57,26,68.67
Leblanc,Sejuani,96,43,53,44.79
Leblanc,Ornn,87,31,56,35.63
Leblanc,Zac,90,43,47,47.78
Leblanc,Elise,165,89,76,53.94
Leblanc,Hwei,188,80,108,42.55
Leblanc,Braum,142,40,102,28.17
Leblanc,Poppy,116,55,61,47.41
Leblanc,Shyvana,53,18,35,33.96
Leblanc,Lissandra,69,27,42,39.13
Leblanc,Orianna,118,65,53,55.08
Leblanc,Nasus,184,109,75,59.24
Leblanc,MasterYi,240,113,127,47.08
Leblanc,TwistedFate,86,51,35,59.3
Leblanc,Belveth,70,36,34,51.43
Leblanc,Senna,166,100,66,60.24
Leblanc,Varus,229,101,128,44.1
Leblanc,Sion,188,96,92,51.06
Leblanc,Hecarim,54,17,37,31.48
Leblanc,Kindred,122,76,46,62.3
Leblanc,Ivern,27,17,10,62.96
Leblanc,Nidalee,47,12,35,25.53
Leblanc,Alistar,93,46,47,49.46
Leblanc,Urgot,108,36,72,33.33
Leblanc,KogMaw,83,26,57,31.33
Leblanc,Graves,96,62,34,64.58
Leblanc,Syndra,161,63,98,39.13
Leblanc,Corki,104,66,38,63.46
Leblanc,Quinn,88,36,52,40.91
Leblanc,Cassiopeia,63,32,31,50.79
Leblanc,Viktor,114,50,64,43.86
Leblanc,XinZhao,143,49,94,34.27
Leblanc,Akshan,94,32,62,34.04
Leblanc,Annie,46,19,27,41.3
Leblanc,Maokai,107,29,78,27.1
Leblanc,Zyra,129,29,100,22.48
Leblanc,RekSai,19,3,16,15.79
Leblanc,Xerath,106,29,77,27.36
Leblanc,Renata,48,36,12,75
Leblanc,Ryze,39,17,22,43.59
Leblanc,Rumble,68,26,42,38.24
Leblanc,Taliyah,52,17,35,32.69
Leblanc,Zilean,52,24,28,46.15
Leblanc,Taric,16,10,6,62.5
Briar,Fiora,364,219,145,60.16
Briar,Lillia,470,284,186,60.43
Briar,Aurora,597,328,269,54.94
Briar,Zeri,279,155,124,55.56
Briar,Rakan,336,156,180,46.43
Briar,Pantheon,949,505,444,53.21
Briar,Diana,818,380,438,46.45
Briar,Gangplank,297,181,116,60.94
Briar,Ezreal,949,550,399,57.96
Briar,Yuumi,512,260,252,50.78
Briar,Garen,790,395,395,50
Briar,Yasuo,1142,555,587,48.6
Briar,Caitlyn,1451,680,771,46.86
Briar,Pyke,750,449,301,59.87
Briar,Aatrox,629,331,298,52.62
Briar,Sejuani,190,104,86,54.74
Briar,Jinx,1347,624,723,46.33
Briar,Sett,1002,457,545,45.61
Briar,Amumu,578,238,340,41.18
Briar,Sylas,549,316,233,57.56
Briar,Poppy,418,194,224,46.41
Briar,Warwick,1075,589,486,54.79
Briar,Katarina,569,308,261,54.13
Briar,Twitch,519,244,275,47.01
Briar,Morgana,810,390,420,48.15
Briar,Malphite,503,205,298,40.76
Briar,Rengar,251,177,74,70.52
Briar,Akali,674,312,362,46.29
Briar,Ashe,1043,582,461,55.8
Briar,Vladimir,384,221,163,57.55
Briar,Shaco,504,229,275,45.44
Briar,Tryndamere,317,163,154,51.42
Briar,Milio,296,155,141,52.36
Briar,Jax,525,221,304,42.1
Briar,Talon,298,184,114,61.74
Briar,Leblanc,181,107,74,59.12
Briar,Mel,1374,738,636,53.71
Briar,Heimerdinger,306,184,122,60.13
Briar,Kindred,405,237,168,58.52
Briar,Janna,182,92,90,50.55
Briar,Smolder,412,219,193,53.16
Briar,Velkoz,357,168,189,47.06
Briar,Darius,1236,619,617,50.08
Briar,Brand,517,246,271,47.58
Briar,Kennen,157,115,42,73.25
Briar,Kayn,1046,529,517,50.57
Briar,Naafiri,329,173,156,52.58
Briar,Xayah,341,159,182,46.63
Briar,Soraka,364,182,182,50
Briar,Yorick,575,254,321,44.17
Briar,Irelia,461,255,206,55.31
Briar,Samira,617,317,300,51.38
Briar,Nami,556,255,301,45.86
Briar,DrMundo,456,209,247,45.83
Briar,Trundle,395,187,208,47.34
Briar,Ahri,865,451,414,52.14
Briar,Gwen,343,169,174,49.27
Briar,Nunu,583,290,293,49.74
Briar,Lux,1616,865,751,53.53
Briar,Mordekaiser,1006,517,489,51.39
Briar,Zed,574,330,244,57.49
Briar,MissFortune,1261,686,575,54.4
Briar,Veigar,652,303,349,46.47
Briar,KSante,166,84,82,50.6
Briar,Gragas,287,172,115,59.93
Briar,MasterYi,763,353,410,46.26
Briar,Shyvana,169,99,70,58.58
Briar,Taliyah,165,69,96,41.82
Briar,Swain,574,263,311,45.82
Briar,Kayle,466,252,214,54.08
Briar,Nocturne,589,309,280,52.46
Briar,Lucian,338,189,149,55.92
Briar,Seraphine,705,337,368,47.8
Briar,Ambessa,356,185,171,51.97
Briar,Zac,212,97,115,45.75
Briar,Kalista,295,174,121,58.98
Briar,Olaf,134,66,68,49.25
Briar,Yone,1121,617,504,55.04
Briar,Belveth,225,103,122,45.78
Briar,AurelionSol,327,115,212,35.17
Briar,Neeko,436,223,213,51.15
Briar,Nilah,419,206,213,49.16
Briar,Zyra,380,209,171,55
Briar,Volibear,632,339,293,53.64
Briar,Vex,355,195,160,54.93
Briar,Kaisa,895,494,401,55.2
Briar,Ivern,72,41,31,56.94
Briar,Syndra,290,119,171,41.03
Briar,Maokai,250,114,136,45.6
Briar,Illaoi,309,170,139,55.02
Briar,Hwei,496,246,250,49.6
Briar,Graves,317,185,132,58.36
Briar,Zoe,281,157,124,55.87
Briar,Tristana,479,223,256,46.56
Briar,Vayne,692,407,285,58.82
Briar,Sona,261,117,144,44.83
Briar,Chogath,733,381,352,51.98
Briar,Draven,344,181,163,52.62
Briar,Teemo,873,325,548,37.23
Briar,Xerath,451,237,214,52.55
Briar,Nasus,462,264,198,57.14
Briar,Riven,239,144,95,60.25
Briar,Rell,242,117,125,48.35
Briar,Nidalee,145,102,43,70.34
Briar,Hecarim,170,99,71,58.24
Briar,Varus,402,205,197,51
Briar,Lulu,418,239,179,57.18
Briar,Ornn,249,89,160,35.74
Briar,Jhin,1002,520,482,51.9
Briar,Nautilus,558,310,248,55.56
Briar,Sion,456,191,265,41.89
Briar,Khazix,400,213,187,53.25
Briar,Ekko,499,249,250,49.9
Briar,Singed,130,53,77,40.77
Briar,Leona,542,281,261,51.85
Briar,KogMaw,174,97,77,55.75
Briar,Thresh,813,460,353,56.58
Briar,Fizz,313,161,152,51.44
Briar,Jayce,239,124,115,51.88
Briar,Ziggs,247,140,107,56.68
Briar,TahmKench,702,373,329,53.13
Briar,Cassiopeia,285,136,149,47.72
Briar,Braum,307,147,160,47.88
Briar,Renekton,230,130,100,56.52
Briar,Galio,511,299,212,58.51
Briar,Malzahar,453,244,209,53.86
Briar,Karma,350,180,170,51.43
Briar,MonkeyKing,224,108,116,48.21
Briar,Aphelios,432,213,219,49.31
Briar,Viktor,378,186,192,49.21
Briar,Shen,414,204,210,49.28
Briar,Renata,172,87,85,50.58
Briar,Vi,565,300,265,53.1
Briar,Camille,234,123,111,52.56
Briar,Quinn,268,135,133,50.37
Briar,Lissandra,209,119,90,56.94
Briar,Elise,306,190,116,62.09
Briar,Kassadin,103,66,37,64.08
Briar,Evelynn,358,221,137,61.73
Briar,Karthus,120,80,40,66.67
Briar,Annie,156,122,34,78.21
Briar,LeeSin,530,295,235,55.66
Briar,Senna,532,270,262,50.75
Briar,Skarner,193,107,86,55.44
Briar,Corki,148,68,80,45.95
Briar,Viego,732,360,372,49.18
Briar,XinZhao,345,169,176,48.99
Briar,Ryze,236,135,101,57.2
Briar,Udyr,212,91,121,42.92
Briar,Qiyana,241,145,96,60.17
Briar,Taric,128,43,85,33.59
Briar,FiddleSticks,335,177,158,52.84
Briar,Bard,183,84,99,45.9
Briar,Rumble,92,45,47,48.91
Briar,JarvanIV,188,88,100,46.81
Briar,Sivir,276,111,165,40.22
Briar,Urgot,273,117,156,42.86
Briar,Azir,206,116,90,56.31
Briar,TwistedFate,160,92,68,57.5
Briar,Alistar,198,97,101,48.99
Briar,Orianna,269,129,140,47.96
Briar,Blitzcrank,456,282,174,61.84
Briar,Anivia,206,106,100,51.46
Briar,Akshan,230,119,111,51.74
Briar,Kled,162,80,82,49.38
Briar,Zilean,178,90,88,50.56
Briar,Rammus,275,147,128,53.45
Briar,Gnar,249,135,114,54.22
Briar,RekSai,86,51,35,59.3
Zoe,Fiora,128,61,67,47.66
Zoe,Lillia,165,72,93,43.64
Zoe,Aurora,284,111,173,39.08
Zoe,Zeri,143,62,81,43.36
Zoe,Rakan,122,51,71,41.8
Zoe,Vayne,331,116,215,35.05
Zoe,Nocturne,193,70,123,36.27
Zoe,Kaisa,393,178,215,45.29
Zoe,Galio,216,97,119,44.91
Zoe,Blitzcrank,239,111,128,46.44
Zoe,Urgot,175,61,114,34.86
Zoe,Kayn,453,235,218,51.88
Zoe,Yasuo,523,197,326,37.67
Zoe,Twitch,238,98,140,41.18
Zoe,Neeko,215,109,106,50.7
Zoe,Gragas,150,63,87,42
Zoe,Gwen,207,104,103,50.24
Zoe,Bard,118,59,59,50
Zoe,Tryndamere,159,64,95,40.25
Zoe,Lux,812,348,464,42.86
Zoe,Nunu,187,81,106,43.32
Zoe,Caitlyn,670,287,383,42.84
Zoe,Vladimir,143,41,102,28.67
Zoe,Yorick,240,81,159,33.75
Zoe,Ekko,308,131,177,42.53
Zoe,Katarina,277,125,152,45.13
Zoe,Jinx,621,251,370,40.42
Zoe,Sion,238,96,142,40.34
Zoe,Evelynn,146,70,76,47.95
Zoe,Akali,262,115,147,43.89
Zoe,Ezreal,437,225,212,51.49
Zoe,Aatrox,273,139,134,50.92
Zoe,Naafiri,144,94,50,65.28
Zoe,Ashe,387,153,234,39.53
Zoe,Morgana,415,181,234,43.61
Zoe,Trundle,158,52,106,32.91
Zoe,MasterYi,238,85,153,35.71
Zoe,Ahri,327,171,156,52.29
Zoe,Varus,243,90,153,37.04
Zoe,KSante,75,30,45,40
Zoe,Sivir,120,71,49,59.17
Zoe,Mel,515,205,310,39.81
Zoe,DrMundo,196,87,109,44.39
Zoe,Sylas,248,102,146,41.13
Zoe,Nilah,174,56,118,32.18
Zoe,Darius,548,208,340,37.96
Zoe,Shaco,295,138,157,46.78
Zoe,Zed,299,121,178,40.47
Zoe,Braum,150,74,76,49.33
Zoe,Kled,65,36,29,55.38
Zoe,Warwick,378,129,249,34.13
Zoe,Taliyah,68,19,49,27.94
Zoe,TahmKench,231,115,116,49.78
Zoe,Ornn,129,66,63,51.16
Zoe,Skarner,106,48,58,45.28
Zoe,Lucian,134,59,75,44.03
Zoe,Senna,234,88,146,37.61
Zoe,Nasus,181,39,142,21.55
Zoe,Briar,281,124,157,44.13
Zoe,AurelionSol,135,64,71,47.41
Zoe,Singed,114,34,80,29.82
Zoe,TwistedFate,118,37,81,31.36
Zoe,Brand,197,56,141,28.43
Zoe,Gnar,129,47,82,36.43
Zoe,Vi,273,98,175,35.9
Zoe,Nautilus,244,104,140,42.62
Zoe,Olaf,48,26,22,54.17
Zoe,Pantheon,405,168,237,41.48
Zoe,Renekton,98,58,40,59.18
Zoe,MissFortune,492,213,279,43.29
Zoe,Thresh,338,136,202,40.24
Zoe,Yone,488,219,269,44.88
Zoe,Draven,169,55,114,32.54
Zoe,Shen,149,54,95,36.24
Zoe,Jax,220,89,131,40.45
Zoe,Hecarim,94,42,52,44.68
Zoe,Seraphine,279,134,145,48.03
Zoe,Sett,397,146,251,36.78
Zoe,Khazix,212,93,119,43.87
Zoe,Jhin,496,218,278,43.95
Zoe,Yuumi,318,140,178,44.03
Zoe,Xayah,200,86,114,43
Zoe,Kennen,100,26,74,26
Zoe,Karma,209,67,142,32.06
Zoe,Corki,116,61,55,52.59
Zoe,Hwei,263,120,143,45.63
Zoe,Mordekaiser,394,171,223,43.4
Zoe,Chogath,319,133,186,41.69
Zoe,Pyke,330,161,169,48.79
Zoe,Garen,325,120,205,36.92
Zoe,Rengar,168,75,93,44.64
Zoe,Xerath,197,81,116,41.12
Zoe,Samira,265,115,150,43.4
Zoe,Malphite,263,86,177,32.7
Zoe,Amumu,278,106,172,38.13
Zoe,MonkeyKing,122,63,59,51.64
Zoe,Quinn,123,69,54,56.1
Zoe,Ambessa,177,66,111,37.29
Zoe,Graves,125,51,74,40.8
Zoe,Irelia,280,130,150,46.43
Zoe,Lulu,180,79,101,43.89
Zoe,KogMaw,108,35,73,32.41
Zoe,Nami,295,120,175,40.68
Zoe,Viktor,177,89,88,50.28
Zoe,Leblanc,128,70,58,54.69
Zoe,Ryze,103,50,53,48.54
Zoe,Leona,202,70,132,34.65
Zoe,Malzahar,237,58,179,24.47
Zoe,Zyra,203,80,123,39.41
Zoe,Riven,122,72,50,59.02
Zoe,Shyvana,101,46,55,45.54
Zoe,Cassiopeia,124,70,54,56.45
Zoe,Soraka,223,92,131,41.26
Zoe,Diana,384,163,221,42.45
Zoe,Kassadin,50,14,36,28
Zoe,LeeSin,262,119,143,45.42
Zoe,Swain,331,111,220,33.53
Zoe,Sejuani,126,36,90,28.57
Zoe,Illaoi,120,61,59,50.83
Zoe,Poppy,168,75,93,44.64
Zoe,Elise,142,68,74,47.89
Zoe,Smolder,171,80,91,46.78
Zoe,Maokai,102,19,83,18.63
Zoe,Orianna,117,82,35,70.09
Zoe,Volibear,274,103,171,37.59
Zoe,Aphelios,242,110,132,45.45
Zoe,Kalista,145,88,57,60.69
Zoe,Teemo,456,181,275,39.69
Zoe,Tristana,213,55,158,25.82
Zoe,Syndra,234,124,110,52.99
Zoe,Azir,121,65,56,53.72
Zoe,Ziggs,166,89,77,53.61
Zoe,JarvanIV,76,25,51,32.89
Zoe,Viego,350,155,195,44.29
Zoe,Kindred,122,48,74,39.34
Zoe,Janna,120,42,78,35
Zoe,Gangplank,124,41,83,33.06
Zoe,Veigar,443,208,235,46.95
Zoe,Milio,115,52,63,45.22
Zoe,Anivia,70,31,39,44.29
Zoe,Kayle,196,71,125,36.22
Zoe,FiddleSticks,114,55,59,48.25
Zoe,Jayce,127,74,53,58.27
Zoe,Zac,107,46,61,42.99
Zoe,Taric,39,6,33,15.38
Zoe,Zilean,100,26,74,26
Zoe,Karthus,83,35,48,42.17
Zoe,Ivern,65,34,31,52.31
Zoe,XinZhao,117,36,81,30.77
Zoe,Heimerdinger,116,42,74,36.21
Zoe,Akshan,132,48,84,36.36
Zoe,Camille,105,27,78,25.71
Zoe,Nidalee,70,43,27,61.43
Zoe,Lissandra,75,18,57,24
Zoe,Qiyana,101,51,50,50.5
Zoe,Renata,82,51,31,62.2
Zoe,Talon,162,58,104,35.8
Zoe,Fizz,152,63,89,41.45
Zoe,Rell,151,71,80,47.02
Zoe,Velkoz,172,59,113,34.3
Zoe,Udyr,92,54,38,58.7
Zoe,Alistar,96,42,54,43.75
Zoe,Vex,108,55,53,50.93
Zoe,Sona,70,32,38,45.71
Zoe,RekSai,45,13,32,28.89
Zoe,Belveth,66,22,44,33.33
Zoe,Rumble,33,19,14,57.58
Zoe,Annie,64,32,32,50
Zoe,Rammus,51,13,38,25.49
Nunu,Mordekaiser,875,392,483,44.8
Nunu,Warwick,810,387,423,47.78
Nunu,Veigar,660,332,328,50.3
Nunu,Ashe,795,342,453,43.02
Nunu,Nami,449,247,202,55.01
Nunu,Gnar,176,88,88,50
Nunu,Viego,615,351,264,57.07
Nunu,Yone,1117,578,539,51.75
Nunu,Kaisa,691,363,328,52.53
Nunu,TahmKench,495,213,282,43.03
Nunu,Jax,402,224,178,55.72
Nunu,Elise,276,172,104,62.32
Nunu,Naafiri,247,123,124,49.8
Nunu,Jhin,959,472,487,49.22
Nunu,Lulu,389,202,187,51.93
Nunu,Sett,825,351,474,42.55
Nunu,Brand,352,181,171,51.42
Nunu,Twitch,397,197,200,49.62
Nunu,Morgana,705,319,386,45.25
Nunu,TwistedFate,167,81,86,48.5
Nunu,LeeSin,563,292,271,51.87
Nunu,Yasuo,1054,469,585,44.5
Nunu,Nilah,268,149,119,55.6
Nunu,Kennen,193,96,97,49.74
Nunu,MonkeyKing,243,140,103,57.61
Nunu,Vladimir,337,165,172,48.96
Nunu,Vayne,471,246,225,52.23
Nunu,Thresh,728,353,375,48.49
Nunu,Akali,594,282,312,47.47
Nunu,Leblanc,189,92,97,48.68
Nunu,Tristana,381,219,162,57.48
Nunu,Graves,334,162,172,48.5
Nunu,Katarina,396,251,145,63.38
Nunu,Seraphine,582,296,286,50.86
Nunu,Heimerdinger,383,234,149,61.1
Nunu,Pyke,589,322,267,54.67
Nunu,Samira,509,289,220,56.78
Nunu,MasterYi,515,239,276,46.41
Nunu,Orianna,209,98,111,46.89
Nunu,Malphite,338,160,178,47.34
Nunu,Nautilus,539,257,282,47.68
Nunu,Aatrox,517,285,232,55.13
Nunu,Gragas,310,148,162,47.74
Nunu,Cassiopeia,146,70,76,47.95
Nunu,Irelia,478,230,248,48.12
Nunu,Briar,583,293,290,50.26
Nunu,Zoe,187,106,81,56.68
Nunu,Ezreal,816,459,357,56.25
Nunu,Janna,138,84,54,60.87
Nunu,Kindred,214,101,113,47.2
Nunu,Yuumi,533,270,263,50.66
Nunu,Darius,852,424,428,49.77
Nunu,Senna,491,211,280,42.97
Nunu,Azir,194,96,98,49.48
Nunu,Taric,72,36,36,50
Nunu,Rammus,120,62,58,51.67
Nunu,Renekton,212,95,117,44.81
Nunu,Zyra,337,151,186,44.81
Nunu,KSante,155,68,87,43.87
Nunu,Olaf,107,59,48,55.14
Nunu,Aurora,607,300,307,49.42
Nunu,Jinx,977,495,482,50.67
Nunu,Lux,1473,750,723,50.92
Nunu,Nasus,405,216,189,53.33
Nunu,AurelionSol,216,97,119,44.91
Nunu,Rengar,277,131,146,47.29
Nunu,Ivern,131,92,39,70.23
Nunu,Garen,764,373,391,48.82
Nunu,Diana,682,284,398,41.64
Nunu,Ryze,123,60,63,48.78
Nunu,Pantheon,944,439,505,46.5
Nunu,Camille,192,94,98,48.96
Nunu,Lillia,437,203,234,46.45
Nunu,Udyr,200,120,80,60
Nunu,Skarner,192,93,99,48.44
Nunu,Rell,252,126,126,50
Nunu,Evelynn,263,157,106,59.7
Nunu,Taliyah,170,92,78,54.12
Nunu,Kayle,361,176,185,48.75
Nunu,Volibear,590,281,309,47.63
Nunu,Rakan,289,133,156,46.02
Nunu,Singed,170,91,79,53.53
Nunu,Smolder,354,187,167,52.82
Nunu,Zed,408,209,199,51.23
Nunu,Shen,282,140,142,49.65
Nunu,MissFortune,1153,593,560,51.43
Nunu,Blitzcrank,419,168,251,40.1
Nunu,Riven,217,129,88,59.45
Nunu,Akshan,242,114,128,47.11
Nunu,Poppy,323,139,184,43.03
Nunu,Anivia,121,67,54,55.37
Nunu,Kayn,803,338,465,42.09
Nunu,Lucian,274,103,171,37.59
Nunu,Karma,342,155,187,45.32
Nunu,Tryndamere,315,201,114,63.81
Nunu,Shaco,459,261,198,56.86
Nunu,Talon,349,202,147,57.88
Nunu,Caitlyn,1221,543,678,44.47
Nunu,Malzahar,451,213,238,47.23
Nunu,Teemo,689,343,346,49.78
Nunu,Soraka,321,195,126,60.75
Nunu,Illaoi,300,148,152,49.33
Nunu,Chogath,550,227,323,41.27
Nunu,Leona,368,192,176,52.17
Nunu,Fiora,269,171,98,63.57
Nunu,Draven,210,95,115,45.24
Nunu,Vi,411,179,232,43.55
Nunu,Kassadin,73,40,33,54.79
Nunu,Mel,945,507,438,53.65
Nunu,Nidalee,160,97,63,60.63
Nunu,Vex,330,152,178,46.06
Nunu,Velkoz,245,116,129,47.35
Nunu,Hwei,404,175,229,43.32
Nunu,Sona,179,75,104,41.9
Nunu,Neeko,388,224,164,57.73
Nunu,Gwen,376,169,207,44.95
Nunu,Braum,224,105,119,46.88
Nunu,Ekko,355,164,191,46.2
Nunu,Galio,314,144,170,45.86
Nunu,Milio,225,110,115,48.89
Nunu,Alistar,116,55,61,47.41
Nunu,FiddleSticks,273,113,160,41.39
Nunu,Corki,214,107,107,50
Nunu,Swain,535,182,353,34.02
Nunu,Amumu,585,305,280,52.14
Nunu,Ahri,783,437,346,55.81
Nunu,Xayah,390,216,174,55.38
Nunu,Sejuani,193,108,85,55.96
Nunu,Ziggs,160,91,69,56.88
Nunu,DrMundo,319,152,167,47.65
Nunu,Qiyana,137,65,72,47.45
Nunu,XinZhao,255,107,148,41.96
Nunu,Khazix,280,130,150,46.43
Nunu,Zac,125,76,49,60.8
Nunu,KogMaw,123,44,79,35.77
Nunu,Karthus,120,71,49,59.17
Nunu,Sion,397,167,230,42.07
Nunu,Viktor,346,187,159,54.05
Nunu,Sivir,281,133,148,47.33
Nunu,Varus,452,239,213,52.88
Nunu,Belveth,160,57,103,35.63
Nunu,Shyvana,132,72,60,54.55
Nunu,Sylas,537,270,267,50.28
Nunu,Nocturne,457,240,217,52.52
Nunu,Aphelios,316,163,153,51.58
Nunu,Xerath,295,121,174,41.02
Nunu,Bard,182,111,71,60.99
Nunu,Quinn,169,88,81,52.07
Nunu,Kalista,202,99,103,49.01
Nunu,Maokai,241,125,116,51.87
Nunu,Kled,78,30,48,38.46
Nunu,Annie,147,68,79,46.26
Nunu,Syndra,292,163,129,55.82
Nunu,Trundle,329,155,174,47.11
Nunu,Fizz,262,144,118,54.96
Nunu,Ornn,216,98,118,45.37
Nunu,Hecarim,246,146,100,59.35
Nunu,Zeri,238,142,96,59.66
Nunu,Ambessa,243,103,140,42.39
Nunu,Yorick,460,207,253,45
Nunu,JarvanIV,199,96,103,48.24
Nunu,Lissandra,109,51,58,46.79
Nunu,Zilean,157,101,56,64.33
Nunu,Gangplank,170,80,90,47.06
Nunu,Urgot,188,68,120,36.17
Nunu,RekSai,91,49,42,53.85
Nunu,Rumble,93,51,42,54.84
Nunu,Renata,96,63,33,65.63
Nunu,Jayce,233,142,91,60.94
Swain,Mordekaiser,1047,463,584,44.22
Swain,Warwick,1132,494,638,43.64
Swain,Veigar,791,401,390,50.7
Swain,Ashe,1129,520,609,46.06
Swain,Nami,588,267,321,45.41
Swain,Yorick,505,251,254,49.7
Swain,FiddleSticks,336,197,139,58.63
Swain,Draven,361,226,135,62.6
Swain,Smolder,493,277,216,56.19
Swain,Nautilus,701,401,300,57.2
Swain,Riven,319,187,132,58.62
Swain,Kayn,1006,501,505,49.8
Swain,Ahri,829,472,357,56.94
Swain,Jinx,1282,660,622,51.48
Swain,Renekton,260,161,99,61.92
Swain,JarvanIV,267,137,130,51.31
Swain,Mel,1404,771,633,54.91
Swain,Jhin,1137,631,506,55.5
Swain,Sylas,752,361,391,48.01
Swain,Samira,684,342,342,50
Swain,Nilah,365,217,148,59.45
Swain,Leona,491,257,234,52.34
Swain,Shen,460,220,240,47.83
Swain,Gragas,372,202,170,54.3
Swain,Yone,1213,656,557,54.08
Swain,Alistar,186,119,67,63.98
Swain,Tryndamere,351,217,134,61.82
Swain,Irelia,572,291,281,50.87
Swain,Kalista,304,194,110,63.82
Swain,Twitch,510,244,266,47.84
Swain,Nasus,481,240,241,49.9
Swain,Khazix,368,172,196,46.74
Swain,Diana,743,436,307,58.68
Swain,Urgot,326,161,165,49.39
Swain,Lulu,455,265,190,58.24
Swain,KSante,246,92,154,37.4
Swain,Darius,1225,673,552,54.94
Swain,Azir,207,118,89,57
Swain,Aphelios,476,272,204,57.14
Swain,Soraka,361,180,181,49.86
Swain,Taliyah,160,68,92,42.5
Swain,Senna,580,294,286,50.69
Swain,Sett,1015,599,416,59.01
Swain,Akali,666,398,268,59.76
Swain,Tristana,617,327,290,53
Swain,Blitzcrank,604,369,235,61.09
Swain,Nidalee,112,87,25,77.68
Swain,Aurora,652,368,284,56.44
Swain,MissFortune,1292,697,595,53.95
Swain,Chogath,929,496,433,53.39
Swain,Lillia,492,270,222,54.88
Swain,Vex,341,187,154,54.84
Swain,Janna,194,82,112,42.27
Swain,TahmKench,765,463,302,60.52
Swain,Jax,497,287,210,57.75
Swain,Malzahar,620,315,305,50.81
Swain,Pantheon,1050,563,487,53.62
Swain,Yasuo,1245,666,579,53.49
Swain,Braum,322,193,129,59.94
Swain,Maokai,313,195,118,62.3
Swain,Gnar,242,177,65,73.14
Swain,Shaco,605,319,286,52.73
Swain,Xayah,379,192,187,50.66
Swain,Seraphine,707,332,375,46.96
Swain,Briar,574,311,263,54.18
Swain,Fizz,285,159,126,55.79
Swain,Singed,160,52,108,32.5
Swain,Garen,950,551,399,58
Swain,Zed,588,318,270,54.08
Swain,KogMaw,201,98,103,48.76
Swain,Lux,1775,922,853,51.94
Swain,Katarina,535,309,226,57.76
Swain,Neeko,541,335,206,61.92
Swain,Caitlyn,1589,811,778,51.04
Swain,Yuumi,649,328,321,50.54
Swain,Talon,368,204,164,55.43
Swain,Milio,334,185,149,55.39
Swain,Ornn,291,170,121,58.42
Swain,Morgana,840,334,506,39.76
Swain,TwistedFate,251,158,93,62.95
Swain,Annie,218,126,92,57.8
Swain,Kayle,477,281,196,58.91
Swain,Sona,308,141,167,45.78
Swain,Rengar,297,215,82,72.39
Swain,Malphite,410,222,188,54.15
Swain,Zyra,474,247,227,52.11
Swain,Kennen,258,141,117,54.65
Swain,Ekko,476,250,226,52.52
Swain,Ezreal,1127,629,498,55.81
Swain,Trundle,365,151,214,41.37
Swain,MasterYi,759,391,368,51.52
Swain,Varus,490,278,212,56.73
Swain,Heimerdinger,308,161,147,52.27
Swain,DrMundo,432,227,205,52.55
Swain,Graves,274,164,110,59.85
Swain,Leblanc,157,99,58,63.06
Swain,Vladimir,370,215,155,58.11
Swain,Volibear,825,367,458,44.48
Swain,Qiyana,292,178,114,60.96
Swain,Teemo,822,407,415,49.51
Swain,Kaisa,1028,592,436,57.59
Swain,Xerath,338,174,164,51.48
Swain,Illaoi,299,125,174,41.81
Swain,Naafiri,341,229,112,67.16
Swain,Orianna,255,138,117,54.12
Swain,Zilean,175,79,96,45.14
Swain,Ivern,116,70,46,60.34
Swain,Velkoz,385,186,199,48.31
Swain,Rakan,385,223,162,57.92
Swain,Karma,490,239,251,48.78
Swain,Jayce,247,119,128,48.18
Swain,Vayne,656,363,293,55.34
Swain,MonkeyKing,291,152,139,52.23
Swain,Brand,493,290,203,58.82
Swain,Fiora,312,154,158,49.36
Swain,Camille,215,161,54,74.88
Swain,LeeSin,604,365,239,60.43
Swain,Syndra,327,123,204,37.61
Swain,Hwei,537,321,216,59.78
Swain,Thresh,903,471,432,52.16
Swain,Ryze,146,85,61,58.22
Swain,Zeri,235,141,94,60
Swain,Zac,221,136,85,61.54
Swain,Viego,756,358,398,47.35
Swain,Bard,187,126,61,67.38
Swain,Cassiopeia,246,119,127,48.37
Swain,Poppy,349,181,168,51.86
Swain,Kassadin,170,65,105,38.24
Swain,Karthus,168,102,66,60.71
Swain,Pyke,711,426,285,59.92
Swain,Nocturne,523,311,212,59.46
Swain,Galio,534,265,269,49.63
Swain,Sion,514,271,243,52.72
Swain,Aatrox,653,315,338,48.24
Swain,Rammus,161,55,106,34.16
Swain,Rell,367,225,142,61.31
Swain,Corki,196,117,79,59.69
Swain,Skarner,217,113,104,52.07
Swain,Gangplank,277,159,118,57.4
Swain,Udyr,225,109,116,48.44
Swain,Vi,598,342,256,57.19
Swain,Nunu,535,353,182,65.98
Swain,Taric,129,58,71,44.96
Swain,Zoe,331,220,111,66.47
Swain,Elise,301,161,140,53.49
Swain,Kindred,342,194,148,56.73
Swain,Sejuani,252,144,108,57.14
Swain,Ziggs,272,170,102,62.5
Swain,Evelynn,317,193,124,60.88
Swain,Amumu,600,301,299,50.17
Swain,Shyvana,205,89,116,43.41
Swain,Lissandra,181,105,76,58.01
Swain,Viktor,472,275,197,58.26
Swain,Olaf,158,72,86,45.57
Swain,Ambessa,399,239,160,59.9
Swain,Sivir,295,138,157,46.78
Swain,Quinn,207,103,104,49.76
Swain,Akshan,248,122,126,49.19
Swain,Gwen,295,150,145,50.85
Swain,Lucian,265,148,117,55.85
Swain,Rumble,128,53,75,41.41
Swain,XinZhao,401,200,201,49.88
Swain,AurelionSol,276,117,159,42.39
Swain,Anivia,228,103,125,45.18
Swain,Belveth,168,100,68,59.52
Swain,Hecarim,228,127,101,55.7
Swain,Renata,165,107,58,64.85
Swain,RekSai,115,51,64,44.35
Swain,Kled,127,62,65,48.82
Nami,Illaoi,260,132,128,50.77
Nami,Nunu,449,202,247,44.99
Nami,Irelia,483,296,187,61.28
Nami,Jhin,979,425,554,43.41
Nami,Swain,588,321,267,54.59
Nami,Vayne,529,254,275,48.02
Nami,Nocturne,450,224,226,49.78
Nami,Kaisa,716,370,346,51.68
Nami,Galio,365,147,218,40.27
Nami,Blitzcrank,406,175,231,43.1
Nami,Mordekaiser,789,418,371,52.98
Nami,Amumu,586,279,307,47.61
Nami,Yasuo,1006,524,482,52.09
Nami,Caitlyn,1297,633,664,48.8
Nami,Soraka,376,211,165,56.12
Nami,Shen,344,231,113,67.15
Nami,Gragas,344,182,162,52.91
Nami,Yone,986,494,492,50.1
Nami,Ashe,1023,508,515,49.66
Nami,Alistar,144,91,53,63.19
Nami,TwistedFate,227,128,99,56.39
Nami,LeeSin,526,343,183,65.21
Nami,Nilah,325,172,153,52.92
Nami,Brand,384,183,201,47.66
Nami,Sett,1006,484,522,48.11
Nami,Briar,556,301,255,54.14
Nami,Hwei,512,269,243,52.54
Nami,TahmKench,582,319,263,54.81
Nami,KSante,208,109,99,52.4
Nami,Udyr,216,137,79,63.43
Nami,Veigar,615,314,301,51.06
Nami,Nautilus,466,259,207,55.58
Nami,Kayn,968,455,513,47
Nami,MissFortune,1143,585,558,51.18
Nami,Lux,1650,819,831,49.64
Nami,Volibear,667,322,345,48.28
Nami,Ivern,143,66,77,46.15
Nami,Chogath,806,394,412,48.88
Nami,Jayce,248,179,69,72.18
Nami,Samira,561,306,255,54.55
Nami,Lulu,540,268,272,49.63
Nami,Zed,612,376,236,61.44
Nami,Ekko,428,250,178,58.41
Nami,Tristana,409,190,219,46.45
Nami,Kayle,432,227,205,52.55
Nami,FiddleSticks,260,110,150,42.31
Nami,Katarina,378,215,163,56.88
Nami,Riven,253,181,72,71.54
Nami,Lillia,326,204,122,62.58
Nami,Orianna,275,144,131,52.36
Nami,Velkoz,366,176,190,48.09
Nami,Garen,736,299,437,40.63
Nami,Aurora,439,209,230,47.61
Nami,Heimerdinger,289,119,170,41.18
Nami,Viktor,430,237,193,55.12
Nami,Aatrox,604,341,263,56.46
Nami,Cassiopeia,179,69,110,38.55
Nami,Varus,517,261,256,50.48
Nami,Morgana,780,379,401,48.59
Nami,Olaf,125,62,63,49.6
Nami,Yorick,540,258,282,47.78
Nami,Diana,853,406,447,47.6
Nami,Akali,540,274,266,50.74
Nami,Twitch,408,169,239,41.42
Nami,Zilean,162,66,96,40.74
Nami,Fiora,288,137,151,47.57
Nami,Rammus,143,73,70,51.05
Nami,Renekton,242,142,100,58.68
Nami,Zyra,374,143,231,38.24
Nami,Nidalee,163,93,70,57.06
Nami,Vex,246,124,122,50.41
Nami,Sivir,263,147,116,55.89
Nami,Karma,422,214,208,50.71
Nami,Sion,535,239,296,44.67
Nami,Evelynn,257,103,154,40.08
Nami,Rell,299,164,135,54.85
Nami,Leblanc,221,106,115,47.96
Nami,Aphelios,361,180,181,49.86
Nami,Warwick,818,414,404,50.61
Nami,Ezreal,969,526,443,54.28
Nami,Teemo,789,370,419,46.89
Nami,Shaco,601,326,275,54.24
Nami,Nasus,367,191,176,52.04
Nami,Mel,1279,609,670,47.62
Nami,Thresh,763,430,333,56.36
Nami,Fizz,300,174,126,58
Nami,Jinx,1035,477,558,46.09
Nami,Milio,317,160,157,50.47
Nami,Talon,312,147,165,47.12
Nami,Kalista,200,107,93,53.5
Nami,Pyke,624,318,306,50.96
Nami,MasterYi,412,177,235,42.96
Nami,Darius,1158,557,601,48.1
Nami,Gangplank,238,120,118,50.42
Nami,Poppy,260,154,106,59.23
Nami,Tryndamere,271,130,141,47.97
Nami,Singed,153,75,78,49.02
Nami,Draven,369,202,167,54.74
Nami,Neeko,405,191,214,47.16
Nami,Camille,182,100,82,54.95
Nami,Jax,409,183,226,44.74
Nami,Vladimir,267,118,149,44.19
Nami,Skarner,180,104,76,57.78
Nami,Rengar,210,123,87,58.57
Nami,Naafiri,276,165,111,59.78
Nami,Lucian,334,190,144,56.89
Nami,Ahri,737,377,360,51.15
Nami,Ziggs,243,145,98,59.67
Nami,XinZhao,297,114,183,38.38
Nami,Taric,149,36,113,24.16
Nami,Yuumi,669,328,341,49.03
Nami,Leona,396,197,199,49.75
Nami,AurelionSol,251,126,125,50.2
Nami,Gwen,355,195,160,54.93
Nami,Urgot,293,143,150,48.81
Nami,Kassadin,131,50,81,38.17
Nami,Senna,544,303,241,55.7
Nami,Renata,148,72,76,48.65
Nami,Viego,682,351,331,51.47
Nami,Braum,269,136,133,50.56
Nami,Vi,473,239,234,50.53
Nami,Syndra,364,170,194,46.7
Nami,Gnar,243,138,105,56.79
Nami,Xayah,411,233,178,56.69
Nami,DrMundo,355,134,221,37.75
Nami,Lissandra,159,90,69,56.6
Nami,Ornn,222,131,91,59.01
Nami,Seraphine,579,283,296,48.88
Nami,Corki,193,125,68,64.77
Nami,Zoe,295,175,120,59.32
Nami,Kennen,209,114,95,54.55
Nami,Kindred,349,172,177,49.28
Nami,Zeri,251,121,130,48.21
Nami,Akshan,194,116,78,59.79
Nami,Sona,211,136,75,64.45
Nami,Maokai,172,87,85,50.58
Nami,Pantheon,803,387,416,48.19
Nami,Malphite,511,282,229,55.19
Nami,Sylas,530,271,259,51.13
Nami,Janna,207,97,110,46.86
Nami,Ryze,165,66,99,40
Nami,Trundle,262,111,151,42.37
Nami,Quinn,161,81,80,50.31
Nami,Khazix,408,212,196,51.96
Nami,Qiyana,205,145,60,70.73
Nami,Taliyah,177,115,62,64.97
Nami,Elise,351,216,135,61.54
Nami,Ambessa,370,189,181,51.08
Nami,Zac,190,119,71,62.63
Nami,RekSai,92,52,40,56.52
Nami,Malzahar,455,206,249,45.27
Nami,Smolder,476,228,248,47.9
Nami,JarvanIV,180,91,89,50.56
Nami,Rakan,367,166,201,45.23
Nami,Hecarim,157,54,103,34.39
Nami,Kled,133,64,69,48.12
Nami,Xerath,385,204,181,52.99
Nami,KogMaw,166,101,65,60.84
Nami,Annie,163,100,63,61.35
Nami,Sejuani,245,132,113,53.88
Nami,Belveth,181,88,93,48.62
Nami,Bard,204,114,90,55.88
Nami,Karthus,94,68,26,72.34
Nami,Graves,262,134,128,51.15
Nami,Anivia,179,98,81,54.75
Nami,MonkeyKing,257,131,126,50.97
Nami,Shyvana,145,64,81,44.14
Nami,Rumble,92,46,46,50
Nami,Azir,126,62,64,49.21
Kayle,Illaoi,258,132,126,51.16
Kayle,Twitch,343,194,149,56.56
Kayle,Yone,764,389,375,50.92
Kayle,Lux,1158,606,552,52.33
Kayle,Velkoz,271,122,149,45.02
Kayle,Sett,742,363,379,48.92
Kayle,Taliyah,119,58,61,48.74
Kayle,Sylas,465,223,242,47.96
Kayle,Ezreal,825,471,354,57.09
Kayle,Morgana,591,333,258,56.35
Kayle,Aatrox,522,277,245,53.07
Kayle,Ashe,774,402,372,51.94
Kayle,Aphelios,334,174,160,52.1
Kayle,Gragas,282,151,131,53.55
Kayle,KSante,171,105,66,61.4
Kayle,Nasus,430,221,209,51.4
Kayle,TahmKench,409,179,230,43.77
Kayle,Fizz,201,111,90,55.22
Kayle,Irelia,455,201,254,44.18
Kayle,Nocturne,362,217,145,59.94
Kayle,Jayce,174,84,90,48.28
Kayle,Jhin,716,400,316,55.87
Kayle,Senna,491,248,243,50.51
Kayle,Yasuo,984,532,452,54.07
Kayle,Naafiri,222,107,115,48.2
Kayle,Leblanc,203,115,88,56.65
Kayle,MissFortune,978,479,499,48.98
Kayle,Nami,432,205,227,47.45
Kayle,Singed,154,99,55,64.29
Kayle,Galio,293,126,167,43
Kayle,Smolder,389,193,196,49.61
Kayle,Brand,285,165,120,57.89
Kayle,Aurora,385,206,179,53.51
Kayle,Jinx,893,445,448,49.83
Kayle,Seraphine,572,306,266,53.5
Kayle,MonkeyKing,212,125,87,58.96
Kayle,Vex,255,144,111,56.47
Kayle,Vayne,417,199,218,47.72
Kayle,Briar,466,214,252,45.92
Kayle,Fiora,198,112,86,56.57
Kayle,Cassiopeia,183,81,102,44.26
Kayle,Darius,963,447,516,46.42
Kayle,Warwick,742,350,392,47.17
Kayle,Shen,274,129,145,47.08
Kayle,Lillia,272,169,103,62.13
Kayle,Sivir,179,73,106,40.78
Kayle,Neeko,310,181,129,58.39
Kayle,Vladimir,284,115,169,40.49
Kayle,Rammus,120,64,56,53.33
Kayle,Swain,477,196,281,41.09
Kayle,Ekko,348,186,162,53.45
Kayle,Qiyana,130,73,57,56.15
Kayle,Zeri,208,133,75,63.94
Kayle,TwistedFate,161,88,73,54.66
Kayle,Gnar,98,81,17,82.65
Kayle,Diana,632,319,313,50.47
Kayle,Veigar,508,237,271,46.65
Kayle,Lucian,216,112,104,51.85
Kayle,Renekton,151,61,90,40.4
Kayle,Kayn,619,291,328,47.01
Kayle,Caitlyn,1151,548,603,47.61
Kayle,Mel,1041,570,471,54.76
Kayle,Pantheon,871,367,504,42.14
Kayle,Zed,357,244,113,68.35
Kayle,Nautilus,461,262,199,56.83
Kayle,Mordekaiser,802,430,372,53.62
Kayle,Anivia,196,92,104,46.94
Kayle,Pyke,557,305,252,54.76
Kayle,Chogath,597,345,252,57.79
Kayle,Kaisa,567,324,243,57.14
Kayle,Yorick,407,191,216,46.93
Kayle,Nunu,361,185,176,51.25
Kayle,Rakan,246,99,147,40.24
Kayle,Rumble,73,42,31,57.53
Kayle,Shaco,380,229,151,60.26
Kayle,Talon,302,185,117,61.26
Kayle,Tristana,393,158,235,40.2
Kayle,Soraka,257,114,143,44.36
Kayle,JarvanIV,192,65,127,33.85
Kayle,LeeSin,391,221,170,56.52
Kayle,Hwei,374,178,196,47.59
Kayle,Ornn,192,120,72,62.5
Kayle,Xayah,235,98,137,41.7
Kayle,Zyra,259,112,147,43.24
Kayle,Corki,109,59,50,54.13
Kayle,Ziggs,172,80,92,46.51
Kayle,Vi,461,247,214,53.58
Kayle,Katarina,448,281,167,62.72
Kayle,Draven,238,136,102,57.14
Kayle,XinZhao,200,113,87,56.5
Kayle,Viego,389,175,214,44.99
Kayle,Quinn,148,83,65,56.08
Kayle,DrMundo,300,158,142,52.67
Kayle,Jax,432,212,220,49.07
Kayle,Malphite,398,180,218,45.23
Kayle,Ahri,667,359,308,53.82
Kayle,Renata,115,62,53,53.91
Kayle,Teemo,732,380,352,51.91
Kayle,Samira,445,239,206,53.71
Kayle,Graves,246,123,123,50
Kayle,Shyvana,143,41,102,28.67
Kayle,Amumu,441,210,231,47.62
Kayle,Garen,768,416,352,54.17
Kayle,KogMaw,158,56,102,35.44
Kayle,Karma,316,167,149,52.85
Kayle,Evelynn,297,169,128,56.9
Kayle,Nilah,236,125,111,52.97
Kayle,Leona,309,118,191,38.19
Kayle,Akali,491,268,223,54.58
Kayle,Blitzcrank,316,174,142,55.06
Kayle,Malzahar,347,167,180,48.13
Kayle,Rell,176,86,90,48.86
Kayle,Belveth,132,71,61,53.79
Kayle,Kled,103,43,60,41.75
Kayle,Kalista,265,138,127,52.08
Kayle,Khazix,290,178,112,61.38
Kayle,AurelionSol,219,110,109,50.23
Kayle,Thresh,568,288,280,50.7
Kayle,Gangplank,193,120,73,62.18
Kayle,Volibear,442,228,214,51.58
Kayle,Sona,195,104,91,53.33
Kayle,Braum,229,109,120,47.6
Kayle,Ryze,135,57,78,42.22
Kayle,Annie,130,62,68,47.69
Kayle,Udyr,156,89,67,57.05
Kayle,Hecarim,170,96,74,56.47
Kayle,Janna,126,69,57,54.76
Kayle,Poppy,263,87,176,33.08
Kayle,Viktor,338,183,155,54.14
Kayle,Ivern,59,34,25,57.63
Kayle,MasterYi,508,255,253,50.2
Kayle,Camille,151,87,64,57.62
Kayle,Kennen,178,107,71,60.11
Kayle,FiddleSticks,235,105,130,44.68
Kayle,Kassadin,119,56,63,47.06
Kayle,Heimerdinger,194,101,93,52.06
Kayle,Akshan,216,89,127,41.2
Kayle,Milio,271,147,124,54.24
Kayle,Olaf,94,62,32,65.96
Kayle,Xerath,328,156,172,47.56
Kayle,Ambessa,230,119,111,51.74
Kayle,Tryndamere,249,101,148,40.56
Kayle,Sejuani,149,69,80,46.31
Kayle,Elise,287,130,157,45.3
Kayle,Orianna,176,50,126,28.41
Kayle,Nidalee,122,97,25,79.51
Kayle,Azir,153,98,55,64.05
Kayle,Gwen,288,153,135,53.13
Kayle,Maokai,214,92,122,42.99
Kayle,Zoe,196,125,71,63.78
Kayle,Lulu,290,192,98,66.21
Kayle,Kindred,255,174,81,68.24
Kayle,Yuumi,443,227,216,51.24
Kayle,Bard,144,56,88,38.89
Kayle,Varus,344,195,149,56.69
Kayle,Riven,131,82,49,62.6
Kayle,Syndra,177,95,82,53.67
Kayle,Trundle,223,107,116,47.98
Kayle,Karthus,121,78,43,64.46
Kayle,RekSai,55,21,34,38.18
Kayle,Sion,322,153,169,47.52
Kayle,Skarner,140,97,43,69.29
Kayle,Zac,163,109,54,66.87
Kayle,Lissandra,103,48,55,46.6
Kayle,Rengar,163,99,64,60.74
Kayle,Urgot,258,132,126,51.16
Kayle,Zilean,113,60,53,53.1
Kayle,Alistar,125,50,75,40
Kayle,Taric,84,28,56,33.33
Caitlyn,Illaoi,750,302,448,40.27
Caitlyn,Twitch,1060,517,543,48.77
Caitlyn,Yone,2722,1341,1381,49.27
Caitlyn,Lux,3603,1792,1811,49.74
Caitlyn,Velkoz,933,463,470,49.62
Caitlyn,Pantheon,2071,1067,1004,51.52
Caitlyn,Diana,2002,1014,988,50.65
Caitlyn,Gangplank,668,341,327,51.05
Caitlyn,Ezreal,2944,1536,1408,52.17
Caitlyn,Yuumi,1243,628,615,50.52
Caitlyn,Mordekaiser,2333,1155,1178,49.51
Caitlyn,Viego,1700,806,894,47.41
Caitlyn,Irelia,1295,616,679,47.57
Caitlyn,Jhin,2857,1412,1445,49.42
Caitlyn,Yorick,1437,568,869,39.53
Caitlyn,Kayn,2160,1130,1030,52.31
Caitlyn,Ryze,397,197,200,49.62
Caitlyn,Briar,1451,771,680,53.14
Caitlyn,Vex,850,440,410,51.76
Caitlyn,LeeSin,1304,752,552,57.67
Caitlyn,MissFortune,3607,1682,1925,46.63
Caitlyn,Mel,2976,1485,1491,49.9
Caitlyn,Zed,1394,821,573,58.9
Caitlyn,Galio,833,482,351,57.86
Caitlyn,TahmKench,1669,895,774,53.62
Caitlyn,Warwick,2268,1180,1088,52.03
Caitlyn,Yasuo,2763,1298,1465,46.98
Caitlyn,Teemo,2103,1023,1080,48.64
Caitlyn,XinZhao,741,322,419,43.45
Caitlyn,Jinx,3261,1635,1626,50.14
Caitlyn,Neeko,1178,610,568,51.78
Caitlyn,Morgana,1741,916,825,52.61
Caitlyn,Xayah,1047,527,520,50.33
Caitlyn,Veigar,1628,791,837,48.59
Caitlyn,Aatrox,1357,733,624,54.02
Caitlyn,Ekko,1153,623,530,54.03
Caitlyn,Orianna,659,366,293,55.54
Caitlyn,Malzahar,1066,453,613,42.5
Caitlyn,Maokai,655,313,342,47.79
Caitlyn,Ambessa,814,418,396,51.35
Caitlyn,AurelionSol,690,329,361,47.68
Caitlyn,Khazix,878,472,406,53.76
Caitlyn,Nautilus,1429,645,784,45.14
Caitlyn,Lillia,1013,511,502,50.44
Caitlyn,Tristana,1344,664,680,49.4
Caitlyn,Poppy,867,459,408,52.94
Caitlyn,Heimerdinger,717,331,386,46.16
Caitlyn,Ziggs,714,371,343,51.96
Caitlyn,Olaf,226,102,124,45.13
Caitlyn,Seraphine,1627,726,901,44.62
Caitlyn,Karma,1014,532,482,52.47
Caitlyn,Nami,1297,664,633,51.2
Caitlyn,Rakan,801,410,391,51.19
Caitlyn,Soraka,891,391,500,43.88
Caitlyn,Aurora,1313,734,579,55.9
Caitlyn,Kaisa,2062,1140,922,55.29
Caitlyn,Chogath,1842,826,1016,44.84
Caitlyn,Talon,915,553,362,60.44
Caitlyn,Qiyana,516,298,218,57.75
Caitlyn,Shaco,1405,719,686,51.17
Caitlyn,Anivia,446,223,223,50
Caitlyn,Garen,1986,1049,937,52.82
Caitlyn,Zeri,568,275,293,48.42
Caitlyn,Zyra,886,444,442,50.11
Caitlyn,Volibear,1578,818,760,51.84
Caitlyn,Ashe,2862,1501,1361,52.45
Caitlyn,Trundle,833,451,382,54.14
Caitlyn,Leblanc,442,262,180,59.28
Caitlyn,Elise,892,478,414,53.59
Caitlyn,Amumu,1287,590,697,45.84
Caitlyn,Pyke,1631,850,781,52.12
Caitlyn,Varus,1321,615,706,46.56
Caitlyn,Thresh,1748,989,759,56.58
Caitlyn,Jax,1165,661,504,56.74
Caitlyn,Gragas,798,471,327,59.02
Caitlyn,Rell,745,362,383,48.59
Caitlyn,Camille,414,251,163,60.63
Caitlyn,MasterYi,1388,679,709,48.92
Caitlyn,Malphite,1011,470,541,46.49
Caitlyn,Udyr,502,274,228,54.58
Caitlyn,Evelynn,684,349,335,51.02
Caitlyn,Akali,1474,838,636,56.85
Caitlyn,Vi,1272,600,672,47.17
Caitlyn,Akshan,536,243,293,45.34
Caitlyn,Darius,2764,1383,1381,50.04
Caitlyn,Azir,560,284,276,50.71
Caitlyn,Ivern,260,138,122,53.08
Caitlyn,Katarina,1268,732,536,57.73
Caitlyn,JarvanIV,458,175,283,38.21
Caitlyn,Hwei,1043,473,570,45.35
Caitlyn,Bard,519,298,221,57.42
Caitlyn,Tryndamere,792,415,377,52.4
Caitlyn,Nidalee,297,166,131,55.89
Caitlyn,Draven,729,392,337,53.77
Caitlyn,Renekton,584,269,315,46.06
Caitlyn,Quinn,466,224,242,48.07
Caitlyn,Zoe,670,383,287,57.16
Caitlyn,Janna,364,211,153,57.97
Caitlyn,Lucian,772,406,366,52.59
Caitlyn,Nasus,1140,613,527,53.77
Caitlyn,Kindred,750,433,317,57.73
Caitlyn,Riven,619,401,218,64.78
Caitlyn,TwistedFate,559,318,241,56.89
Caitlyn,Sett,2384,1075,1309,45.09
Caitlyn,Blitzcrank,1044,563,481,53.93
Caitlyn,Shen,888,359,529,40.43
Caitlyn,Ahri,1908,989,919,51.83
Caitlyn,Samira,1478,863,615,58.39
Caitlyn,MonkeyKing,673,357,316,53.05
Caitlyn,Smolder,1304,715,589,54.83
Caitlyn,Brand,1056,522,534,49.43
Caitlyn,Skarner,388,213,175,54.9
Caitlyn,Singed,420,196,224,46.67
Caitlyn,KogMaw,495,242,253,48.89
Caitlyn,Vladimir,755,343,412,45.43
Caitlyn,Corki,452,264,188,58.41
Caitlyn,Cassiopeia,626,321,305,51.28
Caitlyn,Swain,1589,778,811,48.96
Caitlyn,Zilean,382,180,202,47.12
Caitlyn,Rammus,421,206,215,48.93
Caitlyn,Hecarim,505,263,242,52.08
Caitlyn,Zac,584,316,268,54.11
Caitlyn,Kalista,685,396,289,57.81
Caitlyn,Nocturne,1239,602,637,48.59
Caitlyn,Sion,969,454,515,46.85
Caitlyn,Gnar,634,286,348,45.11
Caitlyn,Graves,744,404,340,54.3
Caitlyn,Sejuani,490,260,230,53.06
Caitlyn,Lissandra,340,176,164,51.76
Caitlyn,FiddleSticks,770,392,378,50.91
Caitlyn,Milio,782,389,393,49.74
Caitlyn,Xerath,1114,514,600,46.14
Caitlyn,Lulu,959,507,452,52.87
Caitlyn,Rengar,630,323,307,51.27
Caitlyn,Kennen,519,297,222,57.23
Caitlyn,Annie,410,192,218,46.83
Caitlyn,Senna,1424,722,702,50.7
Caitlyn,Aphelios,1042,549,493,52.69
Caitlyn,Vayne,1393,749,644,53.77
Caitlyn,Sona,528,238,290,45.08
Caitlyn,Kayle,1151,603,548,52.39
Caitlyn,Fiora,612,348,264,56.86
Caitlyn,Gwen,793,449,344,56.62
Caitlyn,Braum,705,372,333,52.77
Caitlyn,Leona,966,492,474,50.93
Caitlyn,Karthus,288,168,120,58.33
Caitlyn,Kassadin,274,145,129,52.92
Caitlyn,Viktor,930,485,445,52.15
Caitlyn,Urgot,615,223,392,36.26
Caitlyn,Nilah,848,464,384,54.72
Caitlyn,Taliyah,348,187,161,53.74
Caitlyn,Sivir,675,332,343,49.19
Caitlyn,Syndra,821,384,437,46.77
Caitlyn,Shyvana,376,145,231,38.56
Caitlyn,KSante,567,315,252,55.56
Caitlyn,RekSai,189,108,81,57.14
Caitlyn,Sylas,1163,565,598,48.58
Caitlyn,Naafiri,700,355,345,50.71
Caitlyn,Belveth,350,184,166,52.57
Caitlyn,Alistar,437,268,169,61.33
Caitlyn,Nunu,1221,678,543,55.53
Caitlyn,Jayce,520,318,202,61.15
Caitlyn,Ornn,563,254,309,45.12
Caitlyn,Fizz,684,350,334,51.17
Caitlyn,Taric,313,133,180,42.49
Caitlyn,DrMundo,899,377,522,41.94
Caitlyn,Renata,388,223,165,57.47
Caitlyn,Rumble,192,108,84,56.25
Caitlyn,Kled,291,137,154,47.08
Renata,Illaoi,87,28,59,32.18
Renata,Twitch,136,86,50,63.24
Renata,Yone,268,153,115,57.09
Renata,Lux,387,208,179,53.75
Renata,Velkoz,80,22,58,27.5
Renata,Malphite,166,65,101,39.16
Renata,Diana,208,90,118,43.27
Renata,Akali,171,84,87,49.12
Renata,Jinx,279,155,124,55.56
Renata,Warwick,188,104,84,55.32
Renata,Vex,44,21,23,47.73
Renata,Yuumi,154,73,81,47.4
Renata,Camille,79,29,50,36.71
Renata,Azir,77,40,37,51.95
Renata,Kaisa,208,122,86,58.65
Renata,Braum,80,22,58,27.5
Renata,Naafiri,75,47,28,62.67
Renata,Zac,58,38,20,65.52
Renata,Ahri,238,116,122,48.74
Renata,Nilah,95,43,52,45.26
Renata,Zyra,99,43,56,43.43
Renata,Darius,273,115,158,42.12
Renata,Mel,312,155,157,49.68
Renata,TwistedFate,56,27,29,48.21
Renata,Maokai,78,43,35,55.13
Renata,Shaco,153,99,54,64.71
Renata,Qiyana,49,35,14,71.43
Renata,Ziggs,42,19,23,45.24
Renata,Kayn,254,109,145,42.91
Renata,Senna,176,79,97,44.89
Renata,Ashe,250,104,146,41.6
Renata,Irelia,140,67,73,47.86
Renata,Teemo,202,109,93,53.96
Renata,MasterYi,141,68,73,48.23
Renata,Yasuo,339,150,189,44.25
Renata,Aphelios,129,67,62,51.94
Renata,Janna,39,19,20,48.72
Renata,LeeSin,141,104,37,73.76
Renata,Zed,147,86,61,58.5
Renata,KogMaw,61,19,42,31.15
Renata,Nami,148,76,72,51.35
Renata,Garen,185,106,79,57.3
Renata,Kayle,115,53,62,46.09
Renata,Kled,45,18,27,40
Renata,Vi,157,86,71,54.78
Renata,Aurora,109,57,52,52.29
Renata,Thresh,207,103,104,49.76
Renata,Yorick,149,78,71,52.35
Renata,Briar,172,85,87,49.42
Renata,Neeko,129,88,41,68.22
Renata,Nautilus,184,83,101,45.11
Renata,Mordekaiser,248,150,98,60.48
Renata,Ekko,99,48,51,48.48
Renata,Heimerdinger,98,53,45,54.08
Renata,Blitzcrank,75,36,39,48
Renata,Singed,24,8,16,33.33
Renata,Ezreal,245,103,142,42.04
Renata,Volibear,183,91,92,49.73
Renata,Khazix,75,56,19,74.67
Renata,Lucian,55,12,43,21.82
Renata,Ambessa,95,49,46,51.58
Renata,Pantheon,239,130,109,54.39
Renata,Zeri,71,36,35,50.7
Renata,Elise,77,35,42,45.45
Renata,Fizz,73,19,54,26.03
Renata,Samira,186,99,87,53.23
Renata,Rell,128,79,49,61.72
Renata,Cassiopeia,41,18,23,43.9
Renata,Riven,89,63,26,70.79
Renata,Vayne,144,92,52,63.89
Renata,JarvanIV,99,49,50,49.49
Renata,Katarina,111,46,65,41.44
Renata,Morgana,206,133,73,64.56
Renata,Milio,114,58,56,50.88
Renata,Gangplank,71,41,30,57.75
Renata,Varus,97,59,38,60.82
Renata,Lulu,144,58,86,40.28
Renata,Viego,144,63,81,43.75
Renata,Sona,50,35,15,70
Renata,Zilean,44,21,23,47.73
Renata,Jhin,203,106,97,52.22
Renata,Sett,168,52,116,30.95
Renata,Caitlyn,388,165,223,42.53
Renata,Seraphine,129,69,60,53.49
Renata,Aatrox,158,101,57,63.92
Renata,Lillia,84,43,41,51.19
Renata,Taliyah,57,17,40,29.82
Renata,Poppy,101,63,38,62.38
Renata,MissFortune,331,140,191,42.3
Renata,Karthus,26,18,8,69.23
Renata,Gnar,97,46,51,47.42
Renata,Fiora,80,57,23,71.25
Renata,Olaf,29,9,20,31.03
Renata,Veigar,167,79,88,47.31
Renata,FiddleSticks,81,22,59,27.16
Renata,Xayah,102,52,50,50.98
Renata,Belveth,77,42,35,54.55
Renata,Syndra,46,26,20,56.52
Renata,Jax,127,45,82,35.43
Renata,Amumu,133,67,66,50.38
Renata,Corki,36,11,25,30.56
Renata,Alistar,59,23,36,38.98
Renata,Shen,126,53,73,42.06
Renata,Lissandra,37,9,28,24.32
Renata,RekSai,26,7,19,26.92
Renata,Evelynn,76,31,45,40.79
Renata,Soraka,77,24,53,31.17
Renata,Trundle,79,40,39,50.63
Renata,Graves,78,39,39,50
Renata,Malzahar,167,58,109,34.73
Renata,Chogath,174,78,96,44.83
Renata,Nasus,97,52,45,53.61
Renata,DrMundo,76,32,44,42.11
Renata,Rakan,61,50,11,81.97
Renata,KSante,55,26,29,47.27
Renata,Bard,59,23,36,38.98
Renata,Xerath,103,41,62,39.81
Renata,Gwen,92,55,37,59.78
Renata,Nocturne,102,51,51,50
Renata,Vladimir,107,73,34,68.22
Renata,Akshan,86,51,35,59.3
Renata,Leona,85,62,23,72.94
Renata,Shyvana,20,11,9,55
Renata,TahmKench,174,83,91,47.7
Renata,Ryze,34,19,15,55.88
Renata,Rengar,99,57,42,57.58
Renata,Orianna,55,38,17,69.09
Renata,Talon,97,57,40,58.76
Renata,Quinn,34,25,9,73.53
Renata,Hecarim,28,13,15,46.43
Renata,Viktor,98,46,52,46.94
Renata,Galio,73,40,33,54.79
Renata,Renekton,68,17,51,25
Renata,Swain,165,58,107,35.15
Renata,Karma,106,54,52,50.94
Renata,Jayce,41,13,28,31.71
Renata,Hwei,99,37,62,37.37
Renata,Zoe,82,31,51,37.8
Renata,Kassadin,33,3,30,9.09
Renata,Sivir,88,45,43,51.14
Renata,Pyke,124,46,78,37.1
Renata,Smolder,159,102,57,64.15
Renata,MonkeyKing,58,25,33,43.1
Renata,Brand,68,46,22,67.65
Renata,Urgot,66,29,37,43.94
Renata,Nunu,96,33,63,34.38
Renata,Gragas,90,44,46,48.89
Renata,Annie,43,10,33,23.26
Renata,Kalista,73,63,10,86.3
Renata,Tristana,147,75,72,51.02
Renata,Leblanc,48,12,36,25
Renata,Draven,78,30,48,38.46
Renata,Sion,112,53,59,47.32
Renata,Nidalee,28,20,8,71.43
Renata,Kennen,64,38,26,59.38
Renata,Kindred,93,22,71,23.66
Renata,AurelionSol,52,18,34,34.62
Renata,Sejuani,81,45,36,55.56
Renata,Sylas,119,79,40,66.39
Renata,XinZhao,76,34,42,44.74
Renata,Taric,22,13,9,59.09
Renata,Tryndamere,78,54,24,69.23
Renata,Rammus,23,23,0,100
Renata,Ornn,63,32,31,50.79
Renata,Anivia,24,11,13,45.83
Renata,Ivern,20,8,12,40
Renata,Skarner,50,29,21,58
Renata,Rumble,20,6,14,30
Renata,Udyr,20,9,11,45
Ambessa,Talon,220,131,89,59.55
Ambessa,Aurora,355,174,181,49.01
Ambessa,Yasuo,770,401,369,52.08
Ambessa,Tristana,319,186,133,58.31
Ambessa,Alistar,94,46,48,48.94
Ambessa,Poppy,272,148,124,54.41
Ambessa,Diana,407,211,196,51.84
Ambessa,Anivia,126,99,27,78.57
Ambessa,Caitlyn,814,396,418,48.65
Ambessa,Thresh,531,263,268,49.53
Ambessa,KSante,186,99,87,53.23
Ambessa,Darius,534,247,287,46.25
Ambessa,Azir,182,94,88,51.65
Ambessa,Aphelios,233,122,111,52.36
Ambessa,Soraka,275,165,110,60
Ambessa,Akali,349,168,181,48.14
Ambessa,Viego,497,228,269,45.88
Ambessa,Leblanc,163,104,59,63.8
Ambessa,Sett,616,278,338,45.13
Ambessa,Rammus,128,79,49,61.72
Ambessa,Pyke,363,205,158,56.47
Ambessa,Yorick,315,151,164,47.94
Ambessa,Shaco,252,137,115,54.37
Ambessa,Katarina,282,166,116,58.87
Ambessa,Lucian,179,100,79,55.87
Ambessa,Nautilus,309,154,155,49.84
Ambessa,Karthus,65,39,26,60
Ambessa,Zed,369,158,211,42.82
Ambessa,Ashe,620,317,303,51.13
Ambessa,Maokai,184,91,93,49.46
Ambessa,Garen,522,210,312,40.23
Ambessa,Shen,257,73,184,28.4
Ambessa,Khazix,182,78,104,42.86
Ambessa,Ahri,414,198,216,47.83
Ambessa,Samira,373,150,223,40.21
Ambessa,Ornn,184,95,89,51.63
Ambessa,Briar,356,171,185,48.03
Ambessa,Morgana,358,166,192,46.37
Ambessa,Volibear,392,181,211,46.17
Ambessa,Gwen,255,136,119,53.33
Ambessa,Elise,186,99,87,53.23
Ambessa,Smolder,341,186,155,54.55
Ambessa,Rengar,188,106,82,56.38
Ambessa,Hwei,246,103,143,41.87
Ambessa,XinZhao,183,79,104,43.17
Ambessa,Ezreal,675,347,328,51.41
Ambessa,Leona,303,149,154,49.17
Ambessa,Trundle,184,72,112,39.13
Ambessa,MasterYi,411,184,227,44.77
Ambessa,Varus,376,195,181,51.86
Ambessa,Lux,939,442,497,47.07
Ambessa,Aatrox,319,207,112,64.89
Ambessa,Chogath,373,196,177,52.55
Ambessa,Ryze,95,48,47,50.53
Ambessa,Janna,102,35,67,34.31
Ambessa,Nasus,300,160,140,53.33
Ambessa,Kayn,553,241,312,43.58
Ambessa,MissFortune,634,316,318,49.84
Ambessa,Sona,130,80,50,61.54
Ambessa,Nocturne,318,136,182,42.77
Ambessa,Neeko,220,94,126,42.73
Ambessa,LeeSin,357,166,191,46.5
Ambessa,Zeri,229,107,122,46.72
Ambessa,Pantheon,600,338,262,56.33
Ambessa,Sejuani,157,56,101,35.67
Ambessa,Ivern,109,67,42,61.47
Ambessa,Urgot,118,38,80,32.2
Ambessa,Jhin,652,331,321,50.77
Ambessa,Karma,181,82,99,45.3
Ambessa,Taric,85,36,49,42.35
Ambessa,Kled,69,28,41,40.58
Ambessa,Warwick,520,271,249,52.12
Ambessa,Seraphine,358,185,173,51.68
Ambessa,Teemo,422,163,259,38.63
Ambessa,Mel,828,425,403,51.33
Ambessa,Viktor,285,140,145,49.12
Ambessa,Twitch,271,126,145,46.49
Ambessa,Lulu,306,117,189,38.24
Ambessa,Renekton,221,103,118,46.61
Ambessa,Udyr,138,72,66,52.17
Ambessa,Annie,107,49,58,45.79
Ambessa,Amumu,283,158,125,55.83
Ambessa,Braum,172,89,83,51.74
Ambessa,Shyvana,105,50,55,47.62
Ambessa,TahmKench,429,239,190,55.71
Ambessa,Veigar,395,187,208,47.34
Ambessa,Zilean,86,29,57,33.72
Ambessa,Vi,357,153,204,42.86
Ambessa,Zoe,177,111,66,62.71
Ambessa,Kaisa,472,213,259,45.13
Ambessa,Jax,336,173,163,51.49
Ambessa,Evelynn,153,79,74,51.63
Ambessa,Draven,213,76,137,35.68
Ambessa,Jinx,732,373,359,50.96
Ambessa,Xayah,220,91,129,41.36
Ambessa,Renata,95,46,49,48.42
Ambessa,Quinn,112,55,57,49.11
Ambessa,Irelia,311,140,171,45.02
Ambessa,Lillia,241,131,110,54.36
Ambessa,Nilah,234,90,144,38.46
Ambessa,Hecarim,125,88,37,70.4
Ambessa,Rell,173,88,85,50.87
Ambessa,Fiora,172,90,82,52.33
Ambessa,Naafiri,108,45,63,41.67
Ambessa,Orianna,222,114,108,51.35
Ambessa,Illaoi,168,61,107,36.31
Ambessa,Heimerdinger,137,52,85,37.96
Ambessa,Brand,195,90,105,46.15
Ambessa,Cassiopeia,104,60,44,57.69
Ambessa,Riven,204,83,121,40.69
Ambessa,Gnar,180,95,85,52.78
Ambessa,DrMundo,229,115,114,50.22
Ambessa,Mordekaiser,477,218,259,45.7
Ambessa,Gragas,238,109,129,45.8
Ambessa,Galio,218,74,144,33.94
Ambessa,Tryndamere,282,171,111,60.64
Ambessa,Sion,202,121,81,59.9
Ambessa,Senna,272,117,155,43.01
Ambessa,Syndra,186,94,92,50.54
Ambessa,Zyra,218,79,139,36.24
Ambessa,Vladimir,181,104,77,57.46
Ambessa,Singed,91,61,30,67.03
Ambessa,Ziggs,128,72,56,56.25
Ambessa,Nami,370,181,189,48.92
Ambessa,Malzahar,242,108,134,44.63
Ambessa,Kalista,154,61,93,39.61
Ambessa,Qiyana,153,115,38,75.16
Ambessa,Yone,681,369,312,54.19
Ambessa,TwistedFate,99,37,62,37.37
Ambessa,Rakan,217,52,165,23.96
Ambessa,Sylas,261,151,110,57.85
Ambessa,Swain,399,160,239,40.1
Ambessa,Bard,142,76,66,53.52
Ambessa,KogMaw,132,55,77,41.67
Ambessa,Vayne,376,162,214,43.09
Ambessa,FiddleSticks,207,114,93,55.07
Ambessa,Blitzcrank,318,174,144,54.72
Ambessa,Milio,209,102,107,48.8
Ambessa,JarvanIV,144,68,76,47.22
Ambessa,Kassadin,55,31,24,56.36
Ambessa,Fizz,100,28,72,28
Ambessa,Velkoz,264,120,144,45.45
Ambessa,Kayle,230,111,119,48.26
Ambessa,Camille,143,51,92,35.66
Ambessa,Yuumi,365,178,187,48.77
Ambessa,Kennen,121,32,89,26.45
Ambessa,RekSai,41,14,27,34.15
Ambessa,Nunu,243,140,103,57.61
Ambessa,Ekko,327,152,175,46.48
Ambessa,Belveth,145,63,82,43.45
Ambessa,Kindred,150,82,68,54.67
Ambessa,Gangplank,128,48,80,37.5
Ambessa,MonkeyKing,177,84,93,47.46
Ambessa,Akshan,173,86,87,49.71
Ambessa,Xerath,189,69,120,36.51
Ambessa,Nidalee,107,58,49,54.21
Ambessa,Sivir,187,84,103,44.92
Ambessa,Skarner,151,86,65,56.95
Ambessa,Taliyah,113,45,68,39.82
Ambessa,Jayce,163,121,42,74.23
Ambessa,Lissandra,121,70,51,57.85
Ambessa,Vex,209,98,111,46.89
Ambessa,Malphite,309,98,211,31.72
Ambessa,Olaf,68,43,25,63.24
Ambessa,Graves,229,112,117,48.91
Ambessa,AurelionSol,164,79,85,48.17
Ambessa,Zac,138,61,77,44.2
Ambessa,Corki,104,75,29,72.12
Ambessa,Rumble,63,32,31,50.79
Rammus,Talon,115,88,27,76.52
Rammus,Aurora,138,55,83,39.86
Rammus,Yasuo,459,280,179,61
Rammus,Tristana,231,113,118,48.92
Rammus,Alistar,42,16,26,38.1
Rammus,Malphite,149,84,65,56.38
Rammus,Jax,196,133,63,67.86
Rammus,Neeko,115,64,51,55.65
Rammus,Xayah,163,102,61,62.58
Rammus,Rakan,97,49,48,50.52
Rammus,Volibear,173,71,102,41.04
Rammus,Ekko,159,78,81,49.06
Rammus,Akshan,79,48,31,60.76
Rammus,Katarina,183,110,73,60.11
Rammus,Yone,480,318,162,66.25
Rammus,Gragas,74,52,22,70.27
Rammus,Irelia,186,99,87,53.23
Rammus,TahmKench,153,60,93,39.22
Rammus,Rell,92,56,36,60.87
Rammus,Mordekaiser,276,132,144,47.83
Rammus,Kayn,346,162,184,46.82
Rammus,Diana,159,76,83,47.8
Rammus,Ezreal,248,137,111,55.24
Rammus,Thresh,205,103,102,50.24
Rammus,Chogath,183,67,116,36.61
Rammus,Ivern,47,27,20,57.45
Rammus,Lux,453,193,260,42.6
Rammus,Ambessa,128,49,79,38.28
Rammus,XinZhao,77,54,23,70.13
Rammus,Nilah,86,54,32,62.79
Rammus,Soraka,154,84,70,54.55
Rammus,Teemo,209,116,93,55.5
Rammus,Evelynn,72,22,50,30.56
Rammus,Sylas,146,65,81,44.52
Rammus,Seraphine,187,120,67,64.17
Rammus,Malzahar,188,77,111,40.96
Rammus,Jinx,315,143,172,45.4
Rammus,Shen,100,49,51,49
Rammus,Khazix,113,77,36,68.14
Rammus,Ahri,255,136,119,53.33
Rammus,Samira,163,89,74,54.6
Rammus,Maokai,71,16,55,22.54
Rammus,DrMundo,88,47,41,53.41
Rammus,Shaco,97,41,56,42.27
Rammus,Viktor,101,39,62,38.61
Rammus,Jhin,294,157,137,53.4
Rammus,Poppy,147,72,75,48.98
Rammus,Garen,265,127,138,47.92
Rammus,Sett,278,145,133,52.16
Rammus,Lucian,76,61,15,80.26
Rammus,Sona,53,30,23,56.6
Rammus,Yorick,185,123,62,66.49
Rammus,Akali,191,112,79,58.64
Rammus,Twitch,166,80,86,48.19
Rammus,Zilean,63,28,35,44.44
Rammus,LeeSin,164,89,75,54.27
Rammus,Caitlyn,421,215,206,51.07
Rammus,Ashe,333,205,128,61.56
Rammus,Camille,90,38,52,42.22
Rammus,Hecarim,80,43,37,53.75
Rammus,TwistedFate,77,48,29,62.34
Rammus,Nautilus,170,88,82,51.76
Rammus,Rengar,110,68,42,61.82
Rammus,Galio,159,81,78,50.94
Rammus,Kayle,120,56,64,46.67
Rammus,Nunu,120,58,62,48.33
Rammus,Kaisa,246,137,109,55.69
Rammus,Nami,143,70,73,48.95
Rammus,Smolder,113,58,55,51.33
Rammus,MonkeyKing,82,57,25,69.51
Rammus,Sejuani,70,37,33,52.86
Rammus,Kalista,64,28,36,43.75
Rammus,Yuumi,187,114,73,60.96
Rammus,Amumu,202,107,95,52.97
Rammus,MissFortune,352,208,144,59.09
Rammus,Renekton,90,65,25,72.22
Rammus,Leblanc,66,41,25,62.12
Rammus,Corki,58,31,27,53.45
Rammus,Morgana,236,111,125,47.03
Rammus,Illaoi,81,46,35,56.79
Rammus,Vi,130,103,27,79.23
Rammus,Syndra,83,43,40,51.81
Rammus,Lulu,116,62,54,53.45
Rammus,Darius,339,160,179,47.2
Rammus,Quinn,83,48,35,57.83
Rammus,Orianna,114,48,66,42.11
Rammus,Pantheon,346,188,158,54.34
Rammus,Tryndamere,86,53,33,61.63
Rammus,FiddleSticks,74,29,45,39.19
Rammus,Vayne,195,105,90,53.85
Rammus,Kindred,110,52,58,47.27
Rammus,Riven,109,61,48,55.96
Rammus,Karma,98,56,42,57.14
Rammus,Velkoz,107,45,62,42.06
Rammus,Pyke,291,166,125,57.04
Rammus,Gwen,147,70,77,47.62
Rammus,Brand,114,62,52,54.39
Rammus,Karthus,51,20,31,39.22
Rammus,Senna,183,123,60,67.21
Rammus,Kennen,46,20,26,43.48
Rammus,Leona,166,58,108,34.94
Rammus,Naafiri,71,53,18,74.65
Rammus,Milio,102,42,60,41.18
Rammus,Aatrox,160,73,87,45.63
Rammus,JarvanIV,108,67,41,62.04
Rammus,Cassiopeia,95,19,76,20
Rammus,Zyra,119,67,52,56.3
Rammus,Graves,113,70,43,61.95
Rammus,Swain,161,106,55,65.84
Rammus,Jayce,72,22,50,30.56
Rammus,Zeri,94,26,68,27.66
Rammus,Zed,175,100,75,57.14
Rammus,Gangplank,79,56,23,70.89
Rammus,Vex,114,76,38,66.67
Rammus,Singed,58,38,20,65.52
Rammus,Mel,326,142,184,43.56
Rammus,Warwick,366,183,183,50
Rammus,Vladimir,80,41,39,51.25
Rammus,Gnar,67,54,13,80.6
Rammus,MasterYi,424,234,190,55.19
Rammus,Fizz,99,62,37,62.63
Rammus,Kled,47,30,17,63.83
Rammus,Varus,141,67,74,47.52
Rammus,Lillia,115,56,59,48.7
Rammus,Qiyana,43,33,10,76.74
Rammus,Nasus,149,76,73,51.01
Rammus,Xerath,96,61,35,63.54
Rammus,Trundle,129,63,66,48.84
Rammus,Belveth,73,33,40,45.21
Rammus,Viego,240,123,117,51.25
Rammus,Aphelios,142,75,67,52.82
Rammus,Heimerdinger,50,22,28,44
Rammus,Sivir,58,36,22,62.07
Rammus,Ryze,46,22,24,47.83
Rammus,Zac,70,40,30,57.14
Rammus,Nocturne,142,56,86,39.44
Rammus,Veigar,186,98,88,52.69
Rammus,Fiora,85,40,45,47.06
Rammus,Taric,52,14,38,26.92
Rammus,Briar,275,128,147,46.55
Rammus,Skarner,16,10,6,62.5
Rammus,Rumble,31,19,12,61.29
Rammus,Draven,131,58,73,44.27
Rammus,Hwei,138,61,77,44.2
Rammus,Bard,37,13,24,35.14
Rammus,Shyvana,72,25,47,34.72
Rammus,Anivia,36,20,16,55.56
Rammus,Blitzcrank,137,61,76,44.53
Rammus,Elise,65,37,28,56.92
Rammus,Braum,72,41,31,56.94
Rammus,Nidalee,43,24,19,55.81
Rammus,Lissandra,56,29,27,51.79
Rammus,Ziggs,125,51,74,40.8
Rammus,KogMaw,64,25,39,39.06
Rammus,Udyr,67,44,23,65.67
Rammus,AurelionSol,74,39,35,52.7
Rammus,Urgot,117,74,43,63.25
Rammus,KSante,55,35,20,63.64
Rammus,Sion,132,70,62,53.03
Rammus,Ornn,85,32,53,37.65
Rammus,Taliyah,37,28,9,75.68
Rammus,Olaf,46,22,24,47.83
Rammus,RekSai,36,22,14,61.11
Rammus,Azir,49,31,18,63.27
Rammus,Kassadin,34,24,10,70.59
Rammus,Renata,23,0,23,0
Rammus,Annie,32,10,22,31.25
Rammus,Janna,46,21,25,45.65
Rammus,Zoe,51,38,13,74.51
Talon,Ambessa,220,89,131,40.45
Talon,Rammus,115,27,88,23.48
Talon,Mel,761,378,383,49.67
Talon,Draven,228,136,92,59.65
Talon,Blitzcrank,272,126,146,46.32
Talon,Jax,295,118,177,40
Talon,Nidalee,93,69,24,74.19
Talon,Ahri,547,255,292,46.62
Talon,Jhin,587,297,290,50.6
Talon,Senna,336,145,191,43.15
Talon,Yorick,307,121,186,39.41
Talon,AurelionSol,161,63,98,39.13
Talon,Kayn,618,253,365,40.94
Talon,Singed,111,49,62,44.14
Talon,Udyr,125,69,56,55.2
Talon,Pantheon,625,302,323,48.32
Talon,Leblanc,108,51,57,47.22
Talon,Sivir,167,81,86,48.5
Talon,Pyke,393,219,174,55.73
Talon,Yone,707,373,334,52.76
Talon,Briar,298,114,184,38.26
Talon,Vex,199,104,95,52.26
Talon,Jinx,699,312,387,44.64
Talon,Milio,202,84,118,41.58
Talon,Teemo,468,196,272,41.88
Talon,Poppy,259,121,138,46.72
Talon,Akali,390,170,220,43.59
Talon,Caitlyn,915,362,553,39.56
Talon,Leona,268,131,137,48.88
Talon,Nocturne,304,179,125,58.88
Talon,Lissandra,94,57,37,60.64
Talon,Lux,960,378,582,39.38
Talon,Vayne,342,184,158,53.8
Talon,Shyvana,83,23,60,27.71
Talon,Sylas,383,138,245,36.03
Talon,Karma,279,151,128,54.12
Talon,Soraka,277,116,161,41.88
Talon,Nasus,178,104,74,58.43
Talon,Kindred,216,111,105,51.39
Talon,Malzahar,327,128,199,39.14
Talon,Tristana,337,130,207,38.58
Talon,Nautilus,420,208,212,49.52
Talon,Fiora,178,107,71,60.11
Talon,Elise,296,148,148,50
Talon,Garen,391,180,211,46.04
Talon,Ashe,624,284,340,45.51
Talon,Trundle,193,85,108,44.04
Talon,Naafiri,193,110,83,56.99
Talon,Aphelios,245,107,138,43.67
Talon,Shen,221,90,131,40.72
Talon,Amumu,345,131,214,37.97
Talon,MissFortune,720,331,389,45.97
Talon,Xerath,197,89,108,45.18
Talon,LeeSin,407,235,172,57.74
Talon,Kaisa,489,224,265,45.81
Talon,Qiyana,145,84,61,57.93
Talon,Swain,368,164,204,44.57
Talon,Sett,601,258,343,42.93
Talon,Mordekaiser,474,197,277,41.56
Talon,Veigar,391,158,233,40.41
Talon,Thresh,464,198,266,42.67
Talon,Varus,281,104,177,37.01
Talon,Zyra,239,117,122,48.95
Talon,Galio,225,102,123,45.33
Talon,Ezreal,560,225,335,40.18
Talon,Seraphine,373,164,209,43.97
Talon,Darius,636,330,306,51.89
Talon,Shaco,477,242,235,50.73
Talon,Zed,371,161,210,43.4
Talon,Braum,187,79,108,42.25
Talon,Volibear,394,176,218,44.67
Talon,Nami,312,165,147,52.88
Talon,Rengar,231,133,98,57.58
Talon,Lucian,263,148,115,56.27
Talon,Ekko,344,187,157,54.36
Talon,Velkoz,218,76,142,34.86
Talon,Yasuo,748,290,458,38.77
Talon,Diana,574,273,301,47.56
Talon,Sion,346,134,212,38.73
Talon,Orianna,153,75,78,49.02
Talon,Camille,163,59,104,36.2
Talon,Viktor,259,123,136,47.49
Talon,Zeri,156,105,51,67.31
Talon,Kayle,302,117,185,38.74
Talon,Brand,248,92,156,37.1
Talon,Rakan,207,82,125,39.61
Talon,Lulu,311,140,171,45.02
Talon,KogMaw,117,62,55,52.99
Talon,MasterYi,389,163,226,41.9
Talon,Janna,146,50,96,34.25
Talon,Vladimir,248,88,160,35.48
Talon,Alistar,122,45,77,36.89
Talon,Gangplank,162,89,73,54.94
Talon,Nunu,349,147,202,42.12
Talon,Jayce,177,109,68,61.58
Talon,Kalista,172,87,85,50.58
Talon,Neeko,297,150,147,50.51
Talon,Chogath,506,226,280,44.66
Talon,Quinn,145,69,76,47.59
Talon,Lillia,245,156,89,63.67
Talon,Gragas,255,87,168,34.12
Talon,Xayah,279,116,163,41.58
Talon,Vi,308,120,188,38.96
Talon,Evelynn,250,118,132,47.2
Talon,Rell,188,82,106,43.62
Talon,Anivia,97,58,39,59.79
Talon,Urgot,187,77,110,41.18
Talon,Olaf,53,20,33,37.74
Talon,Irelia,337,150,187,44.51
Talon,Warwick,551,240,311,43.56
Talon,Khazix,208,112,96,53.85
Talon,Aurora,338,188,150,55.62
Talon,Karthus,74,26,48,35.14
Talon,Gnar,129,68,61,52.71
Talon,Morgana,408,179,229,43.87
Talon,Syndra,239,96,143,40.17
Talon,Kled,107,57,50,53.27
Talon,DrMundo,240,77,163,32.08
Talon,Smolder,298,174,124,58.39
Talon,Illaoi,112,42,70,37.5
Talon,Viego,478,187,291,39.12
Talon,Fizz,225,120,105,53.33
Talon,Samira,324,161,163,49.69
Talon,Akshan,140,70,70,50
Talon,Taric,51,35,16,68.63
Talon,Malphite,321,134,187,41.74
Talon,Aatrox,345,161,184,46.67
Talon,Katarina,308,161,147,52.27
Talon,TahmKench,355,138,217,38.87
Talon,Ziggs,187,119,68,63.64
Talon,Twitch,370,161,209,43.51
Talon,Sona,146,62,84,42.47
Talon,Heimerdinger,192,54,138,28.13
Talon,Gwen,162,77,85,47.53
Talon,Sejuani,120,39,81,32.5
Talon,Yuumi,326,180,146,55.21
Talon,TwistedFate,129,65,64,50.39
Talon,FiddleSticks,221,88,133,39.82
Talon,Cassiopeia,140,71,69,50.71
Talon,Hwei,276,134,142,48.55
Talon,MonkeyKing,203,56,147,27.59
Talon,Azir,104,51,53,49.04
Talon,Nilah,153,101,52,66.01
Talon,Tryndamere,239,145,94,60.67
Talon,Ryze,104,52,52,50
Talon,Graves,196,64,132,32.65
Talon,Maokai,160,57,103,35.63
Talon,Kennen,139,81,58,58.27
Talon,Annie,152,81,71,53.29
Talon,Zilean,94,53,41,56.38
Talon,Ornn,175,61,114,34.86
Talon,Renekton,194,76,118,39.18
Talon,XinZhao,178,87,91,48.88
Talon,Renata,97,40,57,41.24
Talon,Skarner,108,60,48,55.56
Talon,Taliyah,122,69,53,56.56
Talon,Ivern,81,43,38,53.09
Talon,Corki,109,65,44,59.63
Talon,Bard,100,25,75,25
Talon,Belveth,99,65,34,65.66
Talon,JarvanIV,99,63,36,63.64
Talon,Zac,103,31,72,30.1
Talon,Zoe,162,104,58,64.2
Talon,Kassadin,88,52,36,59.09
Talon,RekSai,65,42,23,64.62
Talon,Riven,180,74,106,41.11
Talon,Rumble,73,32,41,43.84
Talon,KSante,124,83,41,66.94
Talon,Hecarim,126,51,75,40.48
Alistar,Ambessa,94,48,46,51.06
Alistar,Rammus,42,26,16,61.9
Alistar,Mel,448,217,231,48.44
Alistar,Draven,118,62,56,52.54
Alistar,Blitzcrank,136,71,65,52.21
Alistar,Jax,184,67,117,36.41
Alistar,Elise,112,67,45,59.82
Alistar,Naafiri,75,26,49,34.67
Alistar,Jhin,268,147,121,54.85
Alistar,Lulu,164,101,63,61.59
Alistar,Riven,71,46,25,64.79
Alistar,Ivern,37,10,27,27.03
Alistar,Yasuo,400,158,242,39.5
Alistar,Swain,186,67,119,36.02
Alistar,Nami,144,53,91,36.81
Alistar,Fiora,98,52,46,53.06
Alistar,Kayn,232,87,145,37.5
Alistar,Malzahar,136,67,69,49.26
Alistar,Aphelios,91,52,39,57.14
Alistar,Zilean,62,23,39,37.1
Alistar,Sion,157,80,77,50.96
Alistar,Rengar,130,78,52,60
Alistar,Ahri,237,123,114,51.9
Alistar,Anivia,66,32,34,48.48
Alistar,Poppy,146,91,55,62.33
Alistar,Kennen,65,36,29,55.38
Alistar,Skarner,96,31,65,32.29
Alistar,Jinx,382,162,220,42.41
Alistar,Yuumi,120,52,68,43.33
Alistar,Warwick,273,143,130,52.38
Alistar,Malphite,127,52,75,40.94
Alistar,Lux,439,234,205,53.3
Alistar,Kled,31,20,11,64.52
Alistar,Gragas,117,49,68,41.88
Alistar,Rell,130,54,76,41.54
Alistar,Sett,350,189,161,54
Alistar,Sejuani,106,68,38,64.15
Alistar,Yone,370,193,177,52.16
Alistar,Ashe,283,150,133,53
Alistar,Urgot,101,37,64,36.63
Alistar,Ekko,243,135,108,55.56
Alistar,Xerath,104,46,58,44.23
Alistar,Kalista,84,47,37,55.95
Alistar,Pantheon,300,146,154,48.67
Alistar,Orianna,86,56,30,65.12
Alistar,Nautilus,332,168,164,50.6
Alistar,KSante,74,35,39,47.3
Alistar,Belveth,45,33,12,73.33
Alistar,MasterYi,174,81,93,46.55
Alistar,Kaisa,256,114,142,44.53
Alistar,Gwen,123,63,60,51.22
Alistar,Illaoi,113,42,71,37.17
Alistar,Vi,152,55,97,36.18
Alistar,Syndra,85,51,34,60
Alistar,Camille,32,6,26,18.75
Alistar,Varus,145,92,53,63.45
Alistar,Braum,72,39,33,54.17
Alistar,Talon,122,77,45,63.11
Alistar,Thresh,374,196,178,52.41
Alistar,MonkeyKing,144,61,83,42.36
Alistar,Akshan,79,51,28,64.56
Alistar,Caitlyn,437,169,268,38.67
Alistar,Soraka,126,58,68,46.03
Alistar,Katarina,162,65,97,40.12
Alistar,Samira,182,93,89,51.1
Alistar,Ezreal,337,148,189,43.92
Alistar,Zac,75,48,27,64
Alistar,Zed,177,88,89,49.72
Alistar,Bard,75,43,32,57.33
Alistar,Volibear,178,97,81,54.49
Alistar,Smolder,144,67,77,46.53
Alistar,Teemo,260,74,186,28.46
Alistar,AurelionSol,87,38,49,43.68
Alistar,Lissandra,60,27,33,45
Alistar,Senna,163,82,81,50.31
Alistar,Vladimir,102,65,37,63.73
Alistar,Hecarim,77,40,37,51.95
Alistar,Akali,214,140,74,65.42
Alistar,TwistedFate,73,33,40,45.21
Alistar,Aurora,136,56,80,41.18
Alistar,Kindred,84,50,34,59.52
Alistar,Viktor,136,60,76,44.12
Alistar,Vayne,238,135,103,56.72
Alistar,Gangplank,104,53,51,50.96
Alistar,Brand,127,58,69,45.67
Alistar,Trundle,106,66,40,62.26
Alistar,Darius,271,132,139,48.71
Alistar,Graves,113,75,38,66.37
Alistar,Neeko,141,96,45,68.09
Alistar,Gnar,103,48,55,46.6
Alistar,Karma,108,51,57,47.22
Alistar,Mordekaiser,258,104,154,40.31
Alistar,Nunu,116,61,55,52.59
Alistar,Shen,132,74,58,56.06
Alistar,Tristana,184,109,75,59.24
Alistar,Velkoz,124,70,54,56.45
Alistar,LeeSin,152,66,86,43.42
Alistar,Milio,135,74,61,54.81
Alistar,Diana,272,99,173,36.4
Alistar,Irelia,189,105,84,55.56
Alistar,Lillia,119,62,57,52.1
Alistar,Sona,65,25,40,38.46
Alistar,Leona,137,73,64,53.28
Alistar,Yorick,139,66,73,47.48
Alistar,Veigar,197,116,81,58.88
Alistar,MissFortune,386,189,197,48.96
Alistar,Renekton,91,23,68,25.27
Alistar,Twitch,106,56,50,52.83
Alistar,Jayce,79,46,33,58.23
Alistar,Singed,49,25,24,51.02
Alistar,TahmKench,215,100,115,46.51
Alistar,Shaco,183,91,92,49.73
Alistar,Sylas,212,91,121,42.92
Alistar,Chogath,228,113,115,49.56
Alistar,Taliyah,79,30,49,37.97
Alistar,Xayah,153,84,69,54.9
Alistar,Aatrox,171,99,72,57.89
Alistar,Galio,99,37,62,37.37
Alistar,Evelynn,67,41,26,61.19
Alistar,FiddleSticks,64,35,29,54.69
Alistar,Fizz,74,42,32,56.76
Alistar,Lucian,110,49,61,44.55
Alistar,Morgana,243,98,145,40.33
Alistar,Renata,59,36,23,61.02
Alistar,XinZhao,81,48,33,59.26
Alistar,Rumble,52,25,27,48.08
Alistar,Azir,87,34,53,39.08
Alistar,Nocturne,151,68,83,45.03
Alistar,Leblanc,93,47,46,50.54
Alistar,Cassiopeia,72,29,43,40.28
Alistar,Ornn,92,45,47,48.91
Alistar,Pyke,222,100,122,45.05
Alistar,Briar,198,101,97,51.01
Alistar,Vex,79,40,39,50.63
Alistar,Viego,275,157,118,57.09
Alistar,Taric,50,14,36,28
Alistar,Amumu,148,86,62,58.11
Alistar,JarvanIV,90,33,57,36.67
Alistar,KogMaw,78,26,52,33.33
Alistar,Hwei,105,50,55,47.62
Alistar,Garen,343,119,224,34.69
Alistar,Seraphine,155,85,70,54.84
Alistar,Heimerdinger,109,33,76,30.28
Alistar,Quinn,90,47,43,52.22
Alistar,Nasus,105,53,52,50.48
Alistar,Ziggs,88,33,55,37.5
Alistar,Khazix,101,61,40,60.4
Alistar,Sivir,76,38,38,50
Alistar,Nilah,138,72,66,52.17
Alistar,Tryndamere,69,22,47,31.88
Alistar,Nidalee,40,18,22,45
Alistar,Zyra,109,42,67,38.53
Alistar,DrMundo,134,61,73,45.52
Alistar,Corki,93,59,34,63.44
Alistar,Zeri,91,53,38,58.24
Alistar,Maokai,89,47,42,52.81
Alistar,Kayle,125,75,50,60
Alistar,Annie,69,16,53,23.19
Alistar,Udyr,91,41,50,45.05
Alistar,Kassadin,49,38,11,77.55
Alistar,Rakan,131,67,64,51.15
Alistar,Zoe,96,54,42,56.25
Alistar,Qiyana,109,38,71,34.86
Alistar,Ryze,36,19,17,52.78
Alistar,Olaf,27,10,17,37.04
Alistar,Shyvana,60,10,50,16.67
Alistar,Janna,58,34,24,58.62
Alistar,Karthus,41,14,27,34.15
Alistar,RekSai,34,19,15,55.88
Garen,Pantheon,1511,760,751,50.3
Garen,Diana,1112,606,506,54.5
Garen,Gangplank,319,194,125,60.82
Garen,Ezreal,1454,820,634,56.4
Garen,Yuumi,805,420,385,52.17
Garen,Mordekaiser,1470,641,829,43.61
Garen,Briar,790,395,395,50
Garen,Ryze,305,151,154,49.51
Garen,Vex,534,310,224,58.05
Garen,Teemo,1286,513,773,39.89
Garen,XinZhao,492,316,176,64.23
Garen,Yasuo,1848,974,874,52.71
Garen,Jinx,1641,852,789,51.92
Garen,Neeko,755,423,332,56.03
Garen,Vladimir,390,194,196,49.74
Garen,Evelynn,494,282,212,57.09
Garen,Tristana,725,333,392,45.93
Garen,Chogath,1260,601,659,47.7
Garen,Morgana,1039,526,513,50.63
Garen,Jhin,1447,698,749,48.24
Garen,Mel,1917,972,945,50.7
Garen,Heimerdinger,454,241,213,53.08
Garen,LeeSin,827,485,342,58.65
Garen,Veigar,1006,505,501,50.2
Garen,Irelia,771,403,368,52.27
Garen,Lillia,580,263,317,45.34
Garen,Sylas,860,494,366,57.44
Garen,Caitlyn,1986,937,1049,47.18
Garen,Lux,2280,1107,1173,48.55
Garen,Aatrox,911,458,453,50.27
Garen,Khazix,586,349,237,59.56
Garen,Qiyana,240,135,105,56.25
Garen,MissFortune,1906,997,909,52.31
Garen,Nautilus,985,498,487,50.56
Garen,Sion,643,344,299,53.5
Garen,Warwick,1309,590,719,45.07
Garen,Akshan,392,236,156,60.2
Garen,Bard,278,162,116,58.27
Garen,Ivern,204,93,111,45.59
Garen,Vayne,1060,470,590,44.34
Garen,Shyvana,259,97,162,37.45
Garen,Karma,618,319,299,51.62
Garen,Soraka,447,229,218,51.23
Garen,Sett,1422,787,635,55.34
Garen,Talon,391,211,180,53.96
Garen,Lissandra,229,135,94,58.95
Garen,Milio,504,272,232,53.97
Garen,Aphelios,649,269,380,41.45
Garen,Leona,689,311,378,45.14
Garen,Riven,462,332,130,71.86
Garen,Ambessa,522,312,210,59.77
Garen,TwistedFate,329,182,147,55.32
Garen,Nami,736,437,299,59.38
Garen,Yone,1706,825,881,48.36
Garen,Trundle,515,265,250,51.46
Garen,Naafiri,393,208,185,52.93
Garen,Shen,718,383,335,53.34
Garen,Aurora,793,423,370,53.34
Garen,Fizz,531,278,253,52.35
Garen,Swain,950,399,551,42
Garen,Jax,930,524,406,56.34
Garen,Tryndamere,681,323,358,47.43
Garen,Corki,333,230,103,69.07
Garen,Pyke,981,601,380,61.26
Garen,Rammus,265,138,127,52.08
Garen,DrMundo,592,325,267,54.9
Garen,TahmKench,958,522,436,54.49
Garen,Camille,368,171,197,46.47
Garen,Hecarim,350,189,161,54
Garen,Kayn,1392,726,666,52.16
Garen,Nocturne,724,384,340,53.04
Garen,Ashe,1466,829,637,56.55
Garen,Ornn,401,184,217,45.89
Garen,Vi,800,398,402,49.75
Garen,Anivia,269,142,127,52.79
Garen,Kindred,474,289,185,60.97
Garen,Varus,718,372,346,51.81
Garen,Maokai,354,130,224,36.72
Garen,Katarina,744,438,306,58.87
Garen,Fiora,369,246,123,66.67
Garen,Amumu,899,419,480,46.61
Garen,Samira,796,442,354,55.53
Garen,Seraphine,1006,527,479,52.39
Garen,Thresh,1152,598,554,51.91
Garen,Viego,991,524,467,52.88
Garen,Ekko,718,366,352,50.97
Garen,Senna,666,338,328,50.75
Garen,Kalista,490,277,213,56.53
Garen,Zed,784,414,370,52.81
Garen,Draven,471,252,219,53.5
Garen,Volibear,1000,509,491,50.9
Garen,Cassiopeia,368,209,159,56.79
Garen,JarvanIV,365,209,156,57.26
Garen,Twitch,677,307,370,45.35
Garen,KSante,426,248,178,58.22
Garen,Nunu,764,391,373,51.18
Garen,Nasus,661,359,302,54.31
Garen,MasterYi,740,398,342,53.78
Garen,Rell,532,251,281,47.18
Garen,Renekton,439,231,208,52.62
Garen,Azir,330,181,149,54.85
Garen,Xayah,653,335,318,51.3
Garen,Akali,944,502,442,53.18
Garen,FiddleSticks,380,190,190,50
Garen,Zac,352,180,172,51.14
Garen,Darius,2022,1100,922,54.4
Garen,Velkoz,560,267,293,47.68
Garen,Rakan,590,322,268,54.58
Garen,Shaco,707,370,337,52.33
Garen,Gwen,581,365,216,62.82
Garen,Rengar,431,247,184,57.31
Garen,Malphite,696,376,320,54.02
Garen,Annie,219,117,102,53.42
Garen,Jayce,354,223,131,62.99
Garen,MonkeyKing,466,238,228,51.07
Garen,Lucian,483,296,187,61.28
Garen,Elise,456,285,171,62.5
Garen,Xerath,520,265,255,50.96
Garen,Sejuani,315,147,168,46.67
Garen,Leblanc,350,183,167,52.29
Garen,Lulu,654,355,299,54.28
Garen,AurelionSol,384,199,185,51.82
Garen,Nilah,544,258,286,47.43
Garen,Kassadin,143,56,87,39.16
Garen,Graves,450,284,166,63.11
Garen,Illaoi,430,236,194,54.88
Garen,Kaisa,1136,706,430,62.15
Garen,Renata,185,79,106,42.7
Garen,Brand,605,342,263,56.53
Garen,Belveth,275,146,129,53.09
Garen,Nidalee,219,132,87,60.27
Garen,Taric,202,96,106,47.52
Garen,Kayle,768,352,416,45.83
Garen,Malzahar,644,305,339,47.36
Garen,Zoe,325,205,120,63.08
Garen,Gnar,310,144,166,46.45
Garen,Smolder,647,344,303,53.17
Garen,Kled,178,56,122,31.46
Garen,Syndra,465,279,186,60
Garen,KogMaw,336,149,187,44.35
Garen,Galio,635,310,325,48.82
Garen,Zyra,578,260,318,44.98
Garen,Skarner,207,116,91,56.04
Garen,Ziggs,394,207,187,52.54
Garen,Poppy,402,169,233,42.04
Garen,Blitzcrank,637,383,254,60.13
Garen,Singed,205,99,106,48.29
Garen,Gragas,472,263,209,55.72
Garen,Hwei,613,312,301,50.9
Garen,Ahri,1183,599,584,50.63
Garen,Sivir,430,215,215,50
Garen,Karthus,259,145,114,55.98
Garen,Braum,467,243,224,52.03
Garen,Udyr,417,203,214,48.68
Garen,Kennen,300,188,112,62.67
Garen,Zeri,358,210,148,58.66
Garen,Urgot,470,249,221,52.98
Garen,Janna,262,140,122,53.44
Garen,Quinn,342,174,168,50.88
Garen,Yorick,763,358,405,46.92
Garen,Viktor,475,242,233,50.95
Garen,Zilean,228,110,118,48.25
Garen,Olaf,182,112,70,61.54
Garen,RekSai,61,41,20,67.21
Garen,Taliyah,254,160,94,62.99
Garen,Alistar,343,224,119,65.31
Garen,Orianna,344,173,171,50.29
Garen,Sona,319,173,146,54.23
Garen,Rumble,122,78,44,63.93
Morgana,Pantheon,1346,657,689,48.81
Morgana,Diana,1246,618,628,49.6
Morgana,Gangplank,324,168,156,51.85
Morgana,Ezreal,1402,683,719,48.72
Morgana,Yuumi,856,477,379,55.72
Morgana,Mordekaiser,1460,707,753,48.42
Morgana,Viego,895,503,392,56.2
Morgana,Irelia,671,379,292,56.48
Morgana,Jhin,1545,772,773,49.97
Morgana,Lux,2671,1454,1217,54.44
Morgana,Qiyana,289,165,124,57.09
Morgana,Warwick,1460,752,708,51.51
Morgana,Mel,1620,818,802,50.49
Morgana,Nautilus,901,473,428,52.5
Morgana,Kayle,591,258,333,43.65
Morgana,MonkeyKing,357,168,189,47.06
Morgana,RekSai,102,50,52,49.02
Morgana,Yone,1606,875,731,54.48
Morgana,Seraphine,1011,551,460,54.5
Morgana,Sylas,692,377,315,54.48
Morgana,Caitlyn,1741,825,916,47.39
Morgana,Zed,784,436,348,55.61
Morgana,MasterYi,876,426,450,48.63
Morgana,Rell,398,214,184,53.77
Morgana,Jax,680,358,322,52.65
Morgana,Briar,810,420,390,51.85
Morgana,Ahri,1082,559,523,51.66
Morgana,Zeri,326,211,115,64.72
Morgana,Karthus,222,126,96,56.76
Morgana,Aurora,707,362,345,51.2
Morgana,Senna,666,301,365,45.2
Morgana,Garen,1039,513,526,49.37
Morgana,Darius,1508,728,780,48.28
Morgana,Malzahar,560,236,324,42.14
Morgana,Zilean,206,72,134,34.95
Morgana,Heimerdinger,534,242,292,45.32
Morgana,LeeSin,707,416,291,58.84
Morgana,Veigar,927,431,496,46.49
Morgana,Teemo,977,433,544,44.32
Morgana,Gragas,503,298,205,59.24
Morgana,Soraka,592,325,267,54.9
Morgana,Twitch,692,352,340,50.87
Morgana,Lulu,541,298,243,55.08
Morgana,KSante,272,141,131,51.84
Morgana,Ashe,1387,671,716,48.38
Morgana,Nasus,603,288,315,47.76
Morgana,TahmKench,826,487,339,58.96
Morgana,Fizz,433,203,230,46.88
Morgana,Gnar,318,169,149,53.14
Morgana,Nunu,705,386,319,54.75
Morgana,Lucian,367,208,159,56.68
Morgana,Elise,405,272,133,67.16
Morgana,Kaisa,972,537,435,55.25
Morgana,Riven,320,178,142,55.63
Morgana,FiddleSticks,425,220,205,51.76
Morgana,Brand,638,294,344,46.08
Morgana,Jinx,1863,1019,844,54.7
Morgana,Milio,470,221,249,47.02
Morgana,Camille,244,138,106,56.56
Morgana,Xayah,491,278,213,56.62
Morgana,Evelynn,622,376,246,60.45
Morgana,Lissandra,259,167,92,64.48
Morgana,MissFortune,1796,965,831,53.73
Morgana,Pyke,883,489,394,55.38
Morgana,Kayn,1288,679,609,52.72
Morgana,Katarina,707,391,316,55.3
Morgana,Ekko,602,280,322,46.51
Morgana,Yasuo,1474,755,719,51.22
Morgana,Singed,209,123,86,58.85
Morgana,KogMaw,329,155,174,47.11
Morgana,Azir,307,211,96,68.73
Morgana,Nami,780,401,379,51.41
Morgana,Chogath,1038,497,541,47.88
Morgana,Shen,582,313,269,53.78
Morgana,Lillia,500,256,244,51.2
Morgana,Sivir,419,203,216,48.45
Morgana,Neeko,719,391,328,54.38
Morgana,Ambessa,358,192,166,53.63
Morgana,Zac,206,100,106,48.54
Morgana,Kalista,359,184,175,51.25
Morgana,Swain,840,506,334,60.24
Morgana,Rengar,308,164,144,53.25
Morgana,Anivia,270,98,172,36.3
Morgana,Galio,586,320,266,54.61
Morgana,Aatrox,742,462,280,62.26
Morgana,Varus,547,274,273,50.09
Morgana,Shaco,788,416,372,52.79
Morgana,Tristana,743,389,354,52.36
Morgana,Zoe,415,234,181,56.39
Morgana,Belveth,212,107,105,50.47
Morgana,AurelionSol,262,138,124,52.67
Morgana,Yorick,642,300,342,46.73
Morgana,Maokai,428,208,220,48.6
Morgana,Sion,522,236,286,45.21
Morgana,Akali,805,468,337,58.14
Morgana,Sejuani,281,111,170,39.5
Morgana,Vladimir,414,215,199,51.93
Morgana,Fiora,430,210,220,48.84
Morgana,Nilah,492,238,254,48.37
Morgana,Rumble,110,69,41,62.73
Morgana,Akshan,338,145,193,42.9
Morgana,Sona,356,177,179,49.72
Morgana,Samira,809,477,332,58.96
Morgana,Sett,1273,666,607,52.32
Morgana,Graves,405,179,226,44.2
Morgana,Urgot,394,162,232,41.12
Morgana,Poppy,468,236,232,50.43
Morgana,Malphite,545,306,239,56.15
Morgana,Khazix,538,344,194,63.94
Morgana,Jayce,301,185,116,61.46
Morgana,Kennen,244,132,112,54.1
Morgana,Taric,198,85,113,42.93
Morgana,Braum,308,167,141,54.22
Morgana,Aphelios,524,269,255,51.34
Morgana,DrMundo,566,286,280,50.53
Morgana,Cassiopeia,333,191,142,57.36
Morgana,Rakan,386,188,198,48.7
Morgana,Illaoi,425,238,187,56
Morgana,Amumu,750,388,362,51.73
Morgana,Vi,667,338,329,50.67
Morgana,Bard,266,151,115,56.77
Morgana,Rammus,236,125,111,52.97
Morgana,Vex,492,266,226,54.07
Morgana,Volibear,888,459,429,51.69
Morgana,Vayne,792,398,394,50.25
Morgana,Skarner,236,147,89,62.29
Morgana,Nocturne,711,352,359,49.51
Morgana,Ryze,259,125,134,48.26
Morgana,Thresh,931,485,446,52.09
Morgana,Blitzcrank,705,381,324,54.04
Morgana,Nidalee,199,104,95,52.26
Morgana,Hwei,586,307,279,52.39
Morgana,Xerath,659,307,352,46.59
Morgana,Ornn,344,185,159,53.78
Morgana,Trundle,418,207,211,49.52
Morgana,Tryndamere,505,279,226,55.25
Morgana,TwistedFate,248,141,107,56.85
Morgana,Orianna,318,171,147,53.77
Morgana,Hecarim,244,87,157,35.66
Morgana,Gwen,678,423,255,62.39
Morgana,Smolder,580,279,301,48.1
Morgana,Karma,580,276,304,47.59
Morgana,Naafiri,358,189,169,52.79
Morgana,Leona,585,307,278,52.48
Morgana,Udyr,303,162,141,53.47
Morgana,Syndra,411,250,161,60.83
Morgana,Draven,426,210,216,49.3
Morgana,Ziggs,378,199,179,52.65
Morgana,Talon,408,229,179,56.13
Morgana,Quinn,273,126,147,46.15
Morgana,Viktor,555,293,262,52.79
Morgana,Zyra,556,253,303,45.5
Morgana,Annie,287,160,127,55.75
Morgana,Renekton,356,143,213,40.17
Morgana,Corki,220,117,103,53.18
Morgana,Leblanc,214,133,81,62.15
Morgana,XinZhao,347,183,164,52.74
Morgana,Shyvana,211,85,126,40.28
Morgana,Renata,206,73,133,35.44
Morgana,Kindred,432,209,223,48.38
Morgana,Velkoz,474,224,250,47.26
Morgana,Janna,231,125,106,54.11
Morgana,Kled,188,88,100,46.81
Morgana,Taliyah,149,88,61,59.06
Morgana,Alistar,243,145,98,59.67
Morgana,Kassadin,158,84,74,53.16
Morgana,JarvanIV,222,74,148,33.33
Morgana,Olaf,171,64,107,37.43
Morgana,Ivern,144,75,69,52.08
Ryze,Aatrox,164,46,118,28.05
Ryze,Brand,82,35,47,42.68
Ryze,Irelia,139,56,83,40.29
Ryze,Caitlyn,397,200,197,50.38
Ryze,Milio,54,35,19,64.81
Ryze,Garen,305,154,151,50.49
Ryze,Diana,183,82,101,44.81
Ryze,Yasuo,378,143,235,37.83
Ryze,Pyke,194,124,70,63.92
Ryze,Sylas,168,98,70,58.33
Ryze,Zed,162,98,64,60.49
Ryze,MasterYi,172,81,91,47.09
Ryze,Rell,97,38,59,39.18
Ryze,Sett,262,134,128,51.15
Ryze,Vladimir,86,37,49,43.02
Ryze,Kindred,83,43,40,51.81
Ryze,Aphelios,92,49,43,53.26
Ryze,Jax,98,41,57,41.84
Ryze,Elise,110,70,40,63.64
Ryze,Naafiri,67,42,25,62.69
Ryze,Jhin,264,134,130,50.76
Ryze,Lulu,151,110,41,72.85
Ryze,Camille,80,51,29,63.75
Ryze,LeeSin,136,102,34,75
Ryze,Pantheon,292,153,139,52.4
Ryze,Samira,235,107,128,45.53
Ryze,Ekko,137,77,60,56.2
Ryze,Tristana,154,69,85,44.81
Ryze,Kayn,208,133,75,63.94
Ryze,Lux,537,190,347,35.38
Ryze,Jinx,297,151,146,50.84
Ryze,Karma,165,88,77,53.33
Ryze,Chogath,255,139,116,54.51
Ryze,Hwei,131,55,76,41.98
Ryze,Draven,83,59,24,71.08
Ryze,Warwick,349,195,154,55.87
Ryze,Veigar,169,95,74,56.21
Ryze,Ezreal,366,216,150,59.02
Ryze,Ambessa,95,47,48,49.47
Ryze,Shen,142,60,82,42.25
Ryze,Kaisa,199,105,94,52.76
Ryze,KSante,71,49,22,69.01
Ryze,Nunu,123,63,60,51.22
Ryze,Yone,272,131,141,48.16
Ryze,Thresh,219,148,71,67.58
Ryze,Mordekaiser,204,72,132,35.29
Ryze,Teemo,291,151,140,51.89
Ryze,AurelionSol,92,49,43,53.26
Ryze,Xayah,81,32,49,39.51
Ryze,Rakan,82,26,56,31.71
Ryze,Kennen,58,28,30,48.28
Ryze,Shaco,180,122,58,67.78
Ryze,Twitch,161,115,46,71.43
Ryze,Yuumi,155,93,62,60
Ryze,Illaoi,89,48,41,53.93
Ryze,MonkeyKing,100,53,47,53
Ryze,Vex,106,55,51,51.89
Ryze,Mel,483,190,293,39.34
Ryze,Darius,322,116,206,36.02
Ryze,FiddleSticks,82,51,31,62.2
Ryze,Azir,87,59,28,67.82
Ryze,Volibear,150,84,66,56
Ryze,Trundle,86,54,32,62.79
Ryze,TahmKench,197,84,113,42.64
Ryze,Amumu,184,89,95,48.37
Ryze,Ziggs,59,33,26,55.93
Ryze,Malphite,133,73,60,54.89
Ryze,Katarina,163,68,95,41.72
Ryze,Nilah,96,60,36,62.5
Ryze,Seraphine,166,44,122,26.51
Ryze,Karthus,34,21,13,61.76
Ryze,Taliyah,46,37,9,80.43
Ryze,Morgana,259,134,125,51.74
Ryze,Ahri,295,150,145,50.85
Ryze,Nautilus,176,116,60,65.91
Ryze,Cassiopeia,62,37,25,59.68
Ryze,MissFortune,343,152,191,44.31
Ryze,Braum,83,43,40,51.81
Ryze,Graves,110,63,47,57.27
Ryze,Fizz,57,26,31,45.61
Ryze,Vi,116,34,82,29.31
Ryze,Akshan,69,39,30,56.52
Ryze,Corki,58,36,22,62.07
Ryze,Zyra,119,39,80,32.77
Ryze,Senna,151,82,69,54.3
Ryze,DrMundo,153,78,75,50.98
Ryze,Swain,146,61,85,41.78
Ryze,Sejuani,25,12,13,48
Ryze,Neeko,88,38,50,43.18
Ryze,Akali,158,78,80,49.37
Ryze,Sion,151,68,83,45.03
Ryze,XinZhao,88,45,43,51.14
Ryze,Tryndamere,172,84,88,48.84
Ryze,Vayne,199,92,107,46.23
Ryze,Blitzcrank,121,37,84,30.58
Ryze,Kled,30,12,18,40
Ryze,Zoe,103,53,50,51.46
Ryze,Renekton,61,22,39,36.07
Ryze,Udyr,95,39,56,41.05
Ryze,Lillia,109,51,58,46.79
Ryze,Malzahar,148,49,99,33.11
Ryze,Ashe,245,147,98,60
Ryze,Riven,49,30,19,61.22
Ryze,Nocturne,147,57,90,38.78
Ryze,Hecarim,81,35,46,43.21
Ryze,Velkoz,164,76,88,46.34
Ryze,Lucian,127,59,68,46.46
Ryze,Nami,165,99,66,60
Ryze,Belveth,35,12,23,34.29
Ryze,Heimerdinger,81,52,29,64.2
Ryze,Kayle,135,78,57,57.78
Ryze,Briar,236,101,135,42.8
Ryze,Aurora,188,104,84,55.32
Ryze,Taric,31,12,19,38.71
Ryze,Qiyana,77,44,33,57.14
Ryze,Gragas,108,55,53,50.93
Ryze,Gangplank,65,30,35,46.15
Ryze,Khazix,67,25,42,37.31
Ryze,Jayce,67,42,25,62.69
Ryze,Leona,102,52,50,50.98
Ryze,Urgot,62,25,37,40.32
Ryze,Kassadin,60,38,22,63.33
Ryze,Xerath,96,60,36,62.5
Ryze,Annie,46,19,27,41.3
Ryze,Ivern,35,16,19,45.71
Ryze,Fiora,106,74,32,69.81
Ryze,TwistedFate,54,23,31,42.59
Ryze,Rengar,100,44,56,44
Ryze,Gwen,96,49,47,51.04
Ryze,Olaf,40,20,20,50
Ryze,Viktor,125,52,73,41.6
Ryze,Kalista,63,43,20,68.25
Ryze,Sivir,88,43,45,48.86
Ryze,Varus,177,88,89,49.72
Ryze,Galio,114,78,36,68.42
Ryze,Singed,50,31,19,62
Ryze,Zeri,118,61,57,51.69
Ryze,Soraka,64,19,45,29.69
Ryze,Ornn,74,33,41,44.59
Ryze,Viego,213,82,131,38.5
Ryze,Maokai,86,34,52,39.53
Ryze,Yorick,178,64,114,35.96
Ryze,Talon,104,52,52,50
Ryze,Sona,51,30,21,58.82
Ryze,Rumble,30,6,24,20
Ryze,Smolder,143,83,60,58.04
Ryze,Renata,34,15,19,44.12
Ryze,JarvanIV,62,9,53,14.52
Ryze,Evelynn,83,39,44,46.99
Ryze,Rammus,46,24,22,52.17
Ryze,Orianna,76,23,53,30.26
Ryze,Nasus,100,48,52,48
Ryze,Poppy,93,56,37,60.22
Ryze,Nidalee,30,27,3,90
Ryze,KogMaw,64,25,39,39.06
Ryze,Syndra,60,22,38,36.67
Ryze,Skarner,52,30,22,57.69
Ryze,Janna,114,60,54,52.63
Ryze,Gnar,56,20,36,35.71
Ryze,Leblanc,39,22,17,56.41
Ryze,Anivia,59,39,20,66.1
Ryze,Alistar,36,17,19,47.22
Ryze,Zilean,52,27,25,51.92
Ryze,Shyvana,36,23,13,63.89
Ryze,Zac,61,21,40,34.43
Ryze,RekSai,25,15,10,60
Ryze,Bard,56,37,19,66.07
Ryze,Quinn,55,36,19,65.45
Ryze,Lissandra,28,8,20,28.57
Brand,Yorick,435,224,211,51.49
Brand,Kayn,746,344,402,46.11
Brand,Ryze,82,47,35,57.32
Brand,Lux,1453,690,763,47.49
Brand,Pantheon,708,365,343,51.55
Brand,TahmKench,539,266,273,49.35
Brand,Malphite,312,162,150,51.92
Brand,Yasuo,772,365,407,47.28
Brand,Aphelios,288,167,121,57.99
Brand,TwistedFate,83,42,41,50.6
Brand,Vladimir,287,124,163,43.21
Brand,Zac,179,110,69,61.45
Brand,Cassiopeia,138,59,79,42.75
Brand,Irelia,358,175,183,48.88
Brand,AurelionSol,187,74,113,39.57
Brand,Singed,107,24,83,22.43
Brand,Udyr,162,86,76,53.09
Brand,Sett,674,331,343,49.11
Brand,MissFortune,1043,542,501,51.97
Brand,Aatrox,357,190,167,53.22
Brand,Khazix,286,160,126,55.94
Brand,Qiyana,101,54,47,53.47
Brand,Nautilus,523,301,222,57.55
Brand,Tryndamere,279,143,136,51.25
Brand,Briar,517,271,246,52.42
Brand,Mordekaiser,709,355,354,50.07
Brand,Janna,111,51,60,45.95
Brand,Gnar,184,120,64,65.22
Brand,Nunu,352,171,181,48.58
Brand,Lucian,202,79,123,39.11
Brand,Jhin,708,344,364,48.59
Brand,Samira,449,200,249,44.54
Brand,Nami,384,201,183,52.34
Brand,XinZhao,205,80,125,39.02
Brand,Morgana,638,344,294,53.92
Brand,Ashe,722,413,309,57.2
Brand,Braum,201,120,81,59.7
Brand,Darius,774,425,349,54.91
Brand,Kindred,228,114,114,50
Brand,Veigar,526,281,245,53.42
Brand,Corki,123,57,66,46.34
Brand,Nocturne,429,244,185,56.88
Brand,Aurora,369,152,217,41.19
Brand,Soraka,227,130,97,57.27
Brand,Kayle,285,120,165,42.11
Brand,Akali,374,219,155,58.56
Brand,Yone,852,432,420,50.7
Brand,Tristana,408,219,189,53.68
Brand,Sivir,212,77,135,36.32
Brand,Ahri,733,356,377,48.57
Brand,Neeko,392,210,182,53.57
Brand,Heimerdinger,265,151,114,56.98
Brand,Renekton,161,68,93,42.24
Brand,Caitlyn,1056,534,522,50.57
Brand,Lillia,280,156,124,55.71
Brand,Pyke,516,280,236,54.26
Brand,Viego,454,155,299,34.14
Brand,Urgot,205,93,112,45.37
Brand,Amumu,338,159,179,47.04
Brand,Shaco,384,172,212,44.79
Brand,FiddleSticks,170,86,84,50.59
Brand,Zoe,197,141,56,71.57
Brand,Kaisa,518,257,261,49.61
Brand,Taric,80,41,39,51.25
Brand,Chogath,551,260,291,47.19
Brand,Ezreal,648,365,283,56.33
Brand,Gwen,274,172,102,62.77
Brand,Vayne,364,172,192,47.25
Brand,LeeSin,363,139,224,38.29
Brand,Thresh,539,302,237,56.03
Brand,DrMundo,393,166,227,42.24
Brand,Draven,227,84,143,37
Brand,Rell,224,113,111,50.45
Brand,Talon,248,156,92,62.9
Brand,Ekko,336,166,170,49.4
Brand,Volibear,469,228,241,48.61
Brand,MasterYi,494,216,278,43.72
Brand,Hwei,347,198,149,57.06
Brand,Karma,213,81,132,38.03
Brand,Katarina,337,159,178,47.18
Brand,Jax,346,147,199,42.49
Brand,Kled,68,25,43,36.76
Brand,Xerath,364,155,209,42.58
Brand,Nidalee,73,48,25,65.75
Brand,Swain,493,203,290,41.18
Brand,Vi,349,129,220,36.96
Brand,Jinx,773,374,399,48.38
Brand,Riven,124,67,57,54.03
Brand,Nilah,263,122,141,46.39
Brand,Trundle,214,98,116,45.79
Brand,Diana,528,296,232,56.06
Brand,Seraphine,444,234,210,52.7
Brand,Velkoz,237,143,94,60.34
Brand,Teemo,653,310,343,47.47
Brand,Senna,405,163,242,40.25
Brand,Shen,336,175,161,52.08
Brand,Rakan,203,99,104,48.77
Brand,Garen,605,263,342,43.47
Brand,Rammus,114,52,62,45.61
Brand,Ornn,157,57,100,36.31
Brand,Poppy,223,105,118,47.09
Brand,Warwick,692,298,394,43.06
Brand,KSante,135,97,38,71.85
Brand,Illaoi,220,95,125,43.18
Brand,Rengar,157,107,50,68.15
Brand,Mel,834,431,403,51.68
Brand,Leblanc,138,74,64,53.62
Brand,Twitch,338,162,176,47.93
Brand,Jayce,141,78,63,55.32
Brand,Orianna,151,55,96,36.42
Brand,Alistar,127,69,58,54.33
Brand,Karthus,109,59,50,54.13
Brand,Leona,248,107,141,43.15
Brand,Fizz,208,134,74,64.42
Brand,Zyra,275,120,155,43.64
Brand,Viktor,331,156,175,47.13
Brand,Camille,130,73,57,56.15
Brand,Azir,131,75,56,57.25
Brand,Blitzcrank,331,131,200,39.58
Brand,Ambessa,195,105,90,53.85
Brand,Malzahar,310,130,180,41.94
Brand,Yuumi,394,174,220,44.16
Brand,Sona,122,61,61,50
Brand,Ivern,86,40,46,46.51
Brand,Kassadin,107,44,63,41.12
Brand,Elise,245,118,127,48.16
Brand,Graves,207,103,104,49.76
Brand,Milio,146,53,93,36.3
Brand,Bard,118,62,56,52.54
Brand,Sejuani,86,40,46,46.51
Brand,MonkeyKing,237,95,142,40.08
Brand,Galio,367,194,173,52.86
Brand,Nasus,314,192,122,61.15
Brand,Fiora,198,125,73,63.13
Brand,Gragas,228,138,90,60.53
Brand,Anivia,119,48,71,40.34
Brand,Xayah,229,137,92,59.83
Brand,Varus,316,187,129,59.18
Brand,Zed,440,240,200,54.55
Brand,Quinn,156,77,79,49.36
Brand,Kennen,154,110,44,71.43
Brand,KogMaw,141,91,50,64.54
Brand,Ziggs,141,66,75,46.81
Brand,Lulu,324,184,140,56.79
Brand,Belveth,146,93,53,63.7
Brand,Gangplank,117,77,40,65.81
Brand,Kalista,162,82,80,50.62
Brand,Akshan,159,78,81,49.06
Brand,Sion,269,117,152,43.49
Brand,Sylas,402,173,229,43.03
Brand,Maokai,206,99,107,48.06
Brand,Smolder,345,168,177,48.7
Brand,Syndra,173,104,69,60.12
Brand,Taliyah,78,48,30,61.54
Brand,Vex,285,151,134,52.98
Brand,Lissandra,95,51,44,53.68
Brand,Hecarim,157,85,72,54.14
Brand,Annie,96,41,55,42.71
Brand,Naafiri,162,81,81,50
Brand,Evelynn,216,126,90,58.33
Brand,Renata,68,22,46,32.35
Brand,Zeri,127,87,40,68.5
Brand,Shyvana,81,29,52,35.8
Brand,Olaf,68,38,30,55.88
Brand,JarvanIV,140,73,67,52.14
Brand,Zilean,146,62,84,42.47
Brand,Rumble,49,33,16,67.35
Brand,Skarner,106,55,51,51.89
Brand,RekSai,30,17,13,56.67
DrMundo,Gangplank,150,82,68,54.67
DrMundo,Gragas,254,165,89,64.96
DrMundo,TwistedFate,143,65,78,45.45
DrMundo,Lucian,198,125,73,63.13
DrMundo,Leona,318,161,157,50.63
DrMundo,Singed,111,45,66,40.54
DrMundo,Graves,170,62,108,36.47
DrMundo,Fizz,199,114,85,57.29
DrMundo,Ziggs,170,76,94,44.71
DrMundo,Pantheon,617,366,251,59.32
DrMundo,Malphite,223,136,87,60.99
DrMundo,Rengar,157,80,77,50.96
DrMundo,Akali,405,229,176,56.54
DrMundo,Ashe,671,363,308,54.1
DrMundo,Rakan,199,97,102,48.74
DrMundo,Yorick,286,126,160,44.06
DrMundo,Akshan,155,85,70,54.84
DrMundo,FiddleSticks,195,124,71,63.59
DrMundo,Samira,442,263,179,59.5
DrMundo,Pyke,389,234,155,60.15
DrMundo,Jayce,192,117,75,60.94
DrMundo,Amumu,400,175,225,43.75
DrMundo,Yasuo,705,337,368,47.8
DrMundo,Milio,179,95,84,53.07
DrMundo,Chogath,576,333,243,57.81
DrMundo,Briar,456,247,209,54.17
DrMundo,Lulu,224,128,96,57.14
DrMundo,Sett,768,429,339,55.86
DrMundo,Rammus,88,41,47,46.59
DrMundo,Nautilus,419,247,172,58.95
DrMundo,Kayn,604,334,270,55.3
DrMundo,Zed,331,185,146,55.89
DrMundo,Yone,840,447,393,53.21
DrMundo,MissFortune,784,471,313,60.08
DrMundo,Senna,311,147,164,47.27
DrMundo,Garen,592,267,325,45.1
DrMundo,Ahri,484,280,204,57.85
DrMundo,Sona,132,62,70,46.97
DrMundo,Teemo,480,240,240,50
DrMundo,Jhin,610,327,283,53.61
DrMundo,Volibear,415,223,192,53.73
DrMundo,MasterYi,351,185,166,52.71
DrMundo,Seraphine,434,242,192,55.76
DrMundo,Nilah,235,113,122,48.09
DrMundo,Velkoz,284,193,91,67.96
DrMundo,Shaco,369,213,156,57.72
DrMundo,Lillia,378,207,171,54.76
DrMundo,Lissandra,63,41,22,65.08
DrMundo,Jinx,754,374,380,49.6
DrMundo,Mordekaiser,507,259,248,51.08
DrMundo,Zoe,196,109,87,55.61
DrMundo,Ezreal,638,353,285,55.33
DrMundo,Darius,732,390,342,53.28
DrMundo,Aphelios,253,122,131,48.22
DrMundo,Neeko,265,145,120,54.72
DrMundo,Aatrox,428,246,182,57.48
DrMundo,XinZhao,194,107,87,55.15
DrMundo,Vladimir,209,120,89,57.42
DrMundo,Tristana,371,216,155,58.22
DrMundo,Rell,167,74,93,44.31
DrMundo,Swain,432,205,227,47.45
DrMundo,Shen,174,115,59,66.09
DrMundo,Lux,1100,665,435,60.45
DrMundo,TahmKench,517,289,228,55.9
DrMundo,Morgana,566,280,286,49.47
DrMundo,Urgot,140,94,46,67.14
DrMundo,Skarner,106,72,34,67.92
DrMundo,Ekko,274,123,151,44.89
DrMundo,Kaisa,599,345,254,57.6
DrMundo,Mel,796,471,325,59.17
DrMundo,Jax,393,210,183,53.44
DrMundo,RekSai,53,21,32,39.62
DrMundo,Brand,393,227,166,57.76
DrMundo,Smolder,296,153,143,51.69
DrMundo,Riven,129,79,50,61.24
DrMundo,Hwei,245,138,107,56.33
DrMundo,Blitzcrank,273,97,176,35.53
DrMundo,Draven,176,112,64,63.64
DrMundo,Warwick,557,276,281,49.55
DrMundo,Qiyana,117,84,33,71.79
DrMundo,Xayah,239,124,115,51.88
DrMundo,Evelynn,224,129,95,57.59
DrMundo,Kayle,300,142,158,47.33
DrMundo,Leblanc,164,92,72,56.1
DrMundo,Sion,216,132,84,61.11
DrMundo,Viego,453,236,217,52.1
DrMundo,Braum,162,94,68,58.02
DrMundo,Zyra,307,166,141,54.07
DrMundo,Zeri,137,65,72,47.45
DrMundo,Vayne,425,201,224,47.29
DrMundo,Ryze,153,75,78,49.02
DrMundo,Karthus,119,83,36,69.75
DrMundo,Udyr,114,60,54,52.63
DrMundo,AurelionSol,179,87,92,48.6
DrMundo,Khazix,253,141,112,55.73
DrMundo,Irelia,301,176,125,58.47
DrMundo,Malzahar,263,142,121,53.99
DrMundo,Hecarim,179,137,42,76.54
DrMundo,Sylas,368,179,189,48.64
DrMundo,Nami,355,221,134,62.25
DrMundo,Kennen,168,115,53,68.45
DrMundo,MonkeyKing,217,91,126,41.94
DrMundo,Veigar,397,186,211,46.85
DrMundo,KSante,130,72,58,55.38
DrMundo,Diana,575,327,248,56.87
DrMundo,Talon,240,163,77,67.92
DrMundo,Quinn,148,64,84,43.24
DrMundo,Aurora,405,248,157,61.23
DrMundo,Yuumi,375,193,182,51.47
DrMundo,Corki,127,66,61,51.97
DrMundo,Poppy,262,158,104,60.31
DrMundo,Katarina,321,216,105,67.29
DrMundo,LeeSin,368,151,217,41.03
DrMundo,Vex,185,91,94,49.19
DrMundo,Xerath,270,147,123,54.44
DrMundo,Caitlyn,899,522,377,58.06
DrMundo,Soraka,177,109,68,61.58
DrMundo,Ambessa,229,114,115,49.78
DrMundo,Kassadin,86,55,31,63.95
DrMundo,Nunu,319,167,152,52.35
DrMundo,Karma,215,121,94,56.28
DrMundo,Gnar,149,82,67,55.03
DrMundo,Zac,110,50,60,45.45
DrMundo,Zilean,102,41,61,40.2
DrMundo,Renekton,140,54,86,38.57
DrMundo,Twitch,327,190,137,58.1
DrMundo,Varus,321,153,168,47.66
DrMundo,Sejuani,156,82,74,52.56
DrMundo,Nidalee,102,68,34,66.67
DrMundo,Naafiri,170,84,86,49.41
DrMundo,Heimerdinger,231,119,112,51.52
DrMundo,Taliyah,102,51,51,50
DrMundo,Galio,276,152,124,55.07
DrMundo,Belveth,116,35,81,30.17
DrMundo,Kindred,164,73,91,44.51
DrMundo,Gwen,237,104,133,43.88
DrMundo,Nocturne,314,183,131,58.28
DrMundo,Renata,76,44,32,57.89
DrMundo,Azir,113,52,61,46.02
DrMundo,Trundle,265,107,158,40.38
DrMundo,Kalista,159,85,74,53.46
DrMundo,Thresh,390,185,205,47.44
DrMundo,Bard,141,65,76,46.1
DrMundo,KogMaw,133,57,76,42.86
DrMundo,Fiora,174,127,47,72.99
DrMundo,Viktor,241,128,113,53.11
DrMundo,Janna,72,52,20,72.22
DrMundo,Vi,350,189,161,54
DrMundo,Illaoi,239,147,92,61.51
DrMundo,Syndra,212,154,58,72.64
DrMundo,Olaf,73,47,26,64.38
DrMundo,Tryndamere,191,115,76,60.21
DrMundo,Kled,103,66,37,64.08
DrMundo,Cassiopeia,149,68,81,45.64
DrMundo,Maokai,188,79,109,42.02
DrMundo,JarvanIV,107,51,56,47.66
DrMundo,Orianna,237,151,86,63.71
DrMundo,Annie,132,76,56,57.58
DrMundo,Taric,91,50,41,54.95
DrMundo,Ivern,105,55,50,52.38
DrMundo,Alistar,134,73,61,54.48
DrMundo,Ornn,183,112,71,61.2
DrMundo,Anivia,126,65,61,51.59
DrMundo,Elise,227,160,67,70.48
DrMundo,Sivir,165,103,62,62.42
DrMundo,Camille,105,56,49,53.33
DrMundo,Nasus,201,105,96,52.24
DrMundo,Shyvana,95,55,40,57.89
DrMundo,Rumble,66,47,19,71.21
Gragas,DrMundo,254,89,165,35.04
Gragas,Lillia,222,78,144,35.14
Gragas,Viktor,304,142,162,46.71
Gragas,Jhin,565,255,310,45.13
Gragas,Pyke,353,218,135,61.76
Gragas,Kayle,282,131,151,46.45
Gragas,Viego,402,200,202,49.75
Gragas,Irelia,323,147,176,45.51
Gragas,Jinx,678,324,354,47.79
Gragas,Thresh,549,252,297,45.9
Gragas,Riven,157,83,74,52.87
Gragas,Nocturne,257,104,153,40.47
Gragas,Zoe,150,87,63,58
Gragas,Lulu,367,137,230,37.33
Gragas,Zed,346,157,189,45.38
Gragas,Shaco,404,125,279,30.94
Gragas,Anivia,128,60,68,46.88
Gragas,Lux,1005,453,552,45.07
Gragas,Morgana,503,205,298,40.76
Gragas,Ivern,94,49,45,52.13
Gragas,Yasuo,664,283,381,42.62
Gragas,Swain,372,170,202,45.7
Gragas,Nami,344,162,182,47.09
Gragas,Jayce,159,92,67,57.86
Gragas,Rengar,205,120,85,58.54
Gragas,Ezreal,590,307,283,52.03
Gragas,Sona,90,62,28,68.89
Gragas,LeeSin,398,215,183,54.02
Gragas,Mel,716,352,364,49.16
Gragas,Tristana,311,143,168,45.98
Gragas,Zac,94,50,44,53.19
Gragas,Sylas,323,148,175,45.82
Gragas,Rell,214,93,121,43.46
Gragas,Ashe,585,286,299,48.89
Gragas,Mordekaiser,456,154,302,33.77
Gragas,Warwick,649,290,359,44.68
Gragas,Yone,679,306,373,45.07
Gragas,Kalista,130,59,71,45.38
Gragas,Kennen,155,84,71,54.19
Gragas,Rammus,74,22,52,29.73
Gragas,Caitlyn,798,327,471,40.98
Gragas,Zeri,152,56,96,36.84
Gragas,Kayn,583,264,319,45.28
Gragas,Aurora,286,135,151,47.2
Gragas,Nilah,204,109,95,53.43
Gragas,Karma,255,121,134,47.45
Gragas,Camille,148,52,96,35.14
Gragas,Draven,289,178,111,61.59
Gragas,Senna,323,128,195,39.63
Gragas,Poppy,156,74,82,47.44
Gragas,Nunu,310,162,148,52.26
Gragas,MissFortune,757,308,449,40.69
Gragas,Rakan,171,76,95,44.44
Gragas,Nasus,266,90,176,33.83
Gragas,Udyr,182,67,115,36.81
Gragas,Alistar,117,68,49,58.12
Gragas,TahmKench,341,180,161,52.79
Gragas,Briar,287,115,172,40.07
Gragas,Heimerdinger,202,96,106,47.52
Gragas,Blitzcrank,264,149,115,56.44
Gragas,Velkoz,227,72,155,31.72
Gragas,Yorick,342,156,186,45.61
Gragas,Evelynn,138,69,69,50
Gragas,Akali,368,175,193,47.55
Gragas,Neeko,283,140,143,49.47
Gragas,Jax,392,224,168,57.14
Gragas,Janna,158,57,101,36.08
Gragas,Sett,585,245,340,41.88
Gragas,Nautilus,407,245,162,60.2
Gragas,Elise,262,135,127,51.53
Gragas,Annie,123,56,67,45.53
Gragas,Ziggs,151,60,91,39.74
Gragas,Naafiri,134,51,83,38.06
Gragas,Gangplank,214,110,104,51.4
Gragas,Ornn,146,75,71,51.37
Gragas,Sivir,175,76,99,43.43
Gragas,Veigar,419,171,248,40.81
Gragas,Samira,355,169,186,47.61
Gragas,Tryndamere,218,109,109,50
Gragas,Shyvana,122,40,82,32.79
Gragas,Fizz,157,61,96,38.85
Gragas,Taric,83,21,62,25.3
Gragas,Singed,106,49,57,46.23
Gragas,Darius,640,326,314,50.94
Gragas,Shen,312,139,173,44.55
Gragas,Vi,323,143,180,44.27
Gragas,Yuumi,346,146,200,42.2
Gragas,Graves,191,84,107,43.98
Gragas,Renekton,148,72,76,48.65
Gragas,Soraka,189,51,138,26.98
Gragas,Katarina,283,166,117,58.66
Gragas,Gnar,142,78,64,54.93
Gragas,Xerath,249,115,134,46.18
Gragas,Leona,253,140,113,55.34
Gragas,Aphelios,252,138,114,54.76
Gragas,MasterYi,348,144,204,41.38
Gragas,Zyra,221,90,131,40.72
Gragas,Aatrox,424,255,169,60.14
Gragas,TwistedFate,132,54,78,40.91
Gragas,Seraphine,313,142,171,45.37
Gragas,Teemo,478,157,321,32.85
Gragas,Volibear,477,257,220,53.88
Gragas,Ahri,502,261,241,51.99
Gragas,Diana,441,182,259,41.27
Gragas,Milio,206,101,105,49.03
Gragas,Sion,287,122,165,42.51
Gragas,Nidalee,109,49,60,44.95
Gragas,Hwei,239,150,89,62.76
Gragas,Leblanc,158,63,95,39.87
Gragas,Smolder,409,186,223,45.48
Gragas,Syndra,205,100,105,48.78
Gragas,Malzahar,239,116,123,48.54
Gragas,Talon,255,168,87,65.88
Gragas,Lucian,234,122,112,52.14
Gragas,Twitch,283,121,162,42.76
Gragas,Orianna,163,101,62,61.96
Gragas,Sejuani,167,68,99,40.72
Gragas,FiddleSticks,169,66,103,39.05
Gragas,Fiora,195,81,114,41.54
Gragas,Vayne,413,212,201,51.33
Gragas,Belveth,92,52,40,56.52
Gragas,Corki,149,73,76,48.99
Gragas,Karthus,131,90,41,68.7
Gragas,KSante,160,66,94,41.25
Gragas,Olaf,84,30,54,35.71
Gragas,Ekko,307,144,163,46.91
Gragas,Galio,292,93,199,31.85
Gragas,Chogath,424,211,213,49.76
Gragas,Qiyana,161,66,95,40.99
Gragas,Hecarim,139,92,47,66.19
Gragas,Xayah,228,90,138,39.47
Gragas,Varus,303,158,145,52.15
Gragas,Garen,472,209,263,44.28
Gragas,Kindred,192,73,119,38.02
Gragas,Malphite,260,107,153,41.15
Gragas,Ambessa,238,129,109,54.2
Gragas,XinZhao,195,94,101,48.21
Gragas,Kaisa,490,238,252,48.57
Gragas,Ryze,108,53,55,49.07
Gragas,Gwen,248,155,93,62.5
Gragas,Pantheon,614,321,293,52.28
Gragas,Akshan,153,60,93,39.22
Gragas,Quinn,129,88,41,68.22
Gragas,Bard,133,63,70,47.37
Gragas,Khazix,215,101,114,46.98
Gragas,Skarner,72,26,46,36.11
Gragas,Vladimir,201,86,115,42.79
Gragas,MonkeyKing,162,100,62,61.73
Gragas,Trundle,162,60,102,37.04
Gragas,Braum,207,79,128,38.16
Gragas,Azir,151,70,81,46.36
Gragas,Brand,228,90,138,39.47
Gragas,Zilean,108,35,73,32.41
Gragas,Urgot,165,46,119,27.88
Gragas,Kassadin,100,72,28,72
Gragas,Vex,234,104,130,44.44
Gragas,Lissandra,104,35,69,33.65
Gragas,Taliyah,98,43,55,43.88
Gragas,Illaoi,203,71,132,34.98
Gragas,Amumu,358,155,203,43.3
Gragas,Maokai,201,62,139,30.85
Gragas,Kled,56,36,20,64.29
Gragas,Cassiopeia,129,42,87,32.56
Gragas,KogMaw,130,54,76,41.54
Gragas,RekSai,24,3,21,12.5
Gragas,JarvanIV,124,78,46,62.9
Gragas,Renata,90,46,44,51.11
Gragas,AurelionSol,146,51,95,34.93
Gragas,Rumble,58,34,24,58.62
TwistedFate,DrMundo,143,78,65,54.55
TwistedFate,Lillia,189,106,83,56.08
TwistedFate,Viktor,162,75,87,46.3
TwistedFate,Jhin,388,157,231,40.46
TwistedFate,Pyke,267,115,152,43.07
TwistedFate,Gangplank,159,97,62,61.01
TwistedFate,Brand,83,41,42,49.4
TwistedFate,Irelia,178,81,97,45.51
TwistedFate,Malzahar,208,103,105,49.52
TwistedFate,Aatrox,223,112,111,50.22
TwistedFate,Gwen,126,82,44,65.08
TwistedFate,Syndra,102,43,59,42.16
TwistedFate,Ashe,361,186,175,51.52
TwistedFate,Lulu,164,85,79,51.83
TwistedFate,Mordekaiser,252,112,140,44.44
TwistedFate,Amumu,180,72,108,40
TwistedFate,Sylas,206,110,96,53.4
TwistedFate,Xayah,145,68,77,46.9
TwistedFate,TahmKench,196,91,105,46.43
TwistedFate,Nunu,167,86,81,51.5
TwistedFate,Vladimir,94,36,58,38.3
TwistedFate,Samira,179,98,81,54.75
TwistedFate,Nami,227,99,128,43.61
TwistedFate,Jax,205,94,111,45.85
TwistedFate,Elise,131,72,59,54.96
TwistedFate,Kaisa,344,169,175,49.13
TwistedFate,Twitch,186,74,112,39.78
TwistedFate,Yuumi,188,72,116,38.3
TwistedFate,Vi,177,87,90,49.15
TwistedFate,Orianna,148,86,62,58.11
TwistedFate,Draven,140,73,67,52.14
TwistedFate,Garen,329,147,182,44.68
TwistedFate,Zed,248,142,106,57.26
TwistedFate,Aurora,170,71,99,41.76
TwistedFate,Caitlyn,559,241,318,43.11
TwistedFate,Soraka,131,73,58,55.73
TwistedFate,Kindred,129,92,37,71.32
TwistedFate,Kennen,77,36,41,46.75
TwistedFate,Tristana,168,95,73,56.55
TwistedFate,Teemo,312,118,194,37.82
TwistedFate,Maokai,115,51,64,44.35
TwistedFate,Corki,81,38,43,46.91
TwistedFate,Taric,56,23,33,41.07
TwistedFate,Rammus,77,29,48,37.66
TwistedFate,Katarina,169,84,85,49.7
TwistedFate,Milio,114,48,66,42.11
TwistedFate,Kayn,354,193,161,54.52
TwistedFate,Veigar,200,95,105,47.5
TwistedFate,Swain,251,93,158,37.05
TwistedFate,Renata,56,29,27,51.79
TwistedFate,XinZhao,91,48,43,52.75
TwistedFate,Rell,122,54,68,44.26
TwistedFate,Kayle,161,73,88,45.34
TwistedFate,FiddleSticks,85,50,35,58.82
TwistedFate,Zoe,118,81,37,68.64
TwistedFate,Camille,112,59,53,52.68
TwistedFate,Rengar,108,57,51,52.78
TwistedFate,Sett,350,145,205,41.43
TwistedFate,MissFortune,425,223,202,52.47
TwistedFate,Sona,69,46,23,66.67
TwistedFate,Jinx,339,170,169,50.15
TwistedFate,Yone,301,153,148,50.83
TwistedFate,Illaoi,125,62,63,49.6
TwistedFate,Gragas,132,78,54,59.09
TwistedFate,Lux,621,296,325,47.67
TwistedFate,Leona,155,59,96,38.06
TwistedFate,Pantheon,393,190,203,48.35
TwistedFate,Akali,206,69,137,33.5
TwistedFate,Shaco,214,62,152,28.97
TwistedFate,Velkoz,126,52,74,41.27
TwistedFate,Yorick,152,59,93,38.82
TwistedFate,Zyra,160,50,110,31.25
TwistedFate,Karthus,60,10,50,16.67
TwistedFate,Mel,438,206,232,47.03
TwistedFate,Morgana,248,107,141,43.15
TwistedFate,Darius,419,163,256,38.9
TwistedFate,Poppy,163,73,90,44.79
TwistedFate,Bard,50,21,29,42
TwistedFate,Galio,140,61,79,43.57
TwistedFate,Alistar,73,40,33,54.79
TwistedFate,LeeSin,266,132,134,49.62
TwistedFate,Kassadin,53,19,34,35.85
TwistedFate,Viego,189,92,97,48.68
TwistedFate,Hecarim,106,49,57,46.23
TwistedFate,Thresh,292,131,161,44.86
TwistedFate,MonkeyKing,97,40,57,41.24
TwistedFate,Ekko,186,104,82,55.91
TwistedFate,Ahri,236,114,122,48.31
TwistedFate,MasterYi,243,121,122,49.79
TwistedFate,Nautilus,167,83,84,49.7
TwistedFate,Vex,101,37,64,36.63
TwistedFate,Yasuo,376,166,210,44.15
TwistedFate,Trundle,133,45,88,33.83
TwistedFate,Ezreal,373,190,183,50.94
TwistedFate,Ambessa,99,62,37,62.63
TwistedFate,AurelionSol,99,47,52,47.47
TwistedFate,Udyr,90,56,34,62.22
TwistedFate,Leblanc,86,35,51,40.7
TwistedFate,Renekton,106,77,29,72.64
TwistedFate,Kled,40,16,24,40
TwistedFate,Ryze,54,31,23,57.41
TwistedFate,Diana,297,142,155,47.81
TwistedFate,Fizz,154,55,99,35.71
TwistedFate,Varus,178,91,87,51.12
TwistedFate,Khazix,129,63,66,48.84
TwistedFate,Naafiri,95,33,62,34.74
TwistedFate,Quinn,66,25,41,37.88
TwistedFate,Blitzcrank,163,68,95,41.72
TwistedFate,Volibear,188,100,88,53.19
TwistedFate,Graves,116,60,56,51.72
TwistedFate,Seraphine,196,86,110,43.88
TwistedFate,Briar,160,68,92,42.5
TwistedFate,Nocturne,193,83,110,43.01
TwistedFate,Talon,129,64,65,49.61
TwistedFate,Akshan,97,34,63,35.05
TwistedFate,Nasus,170,61,109,35.88
TwistedFate,Karma,179,59,120,32.96
TwistedFate,Sion,158,76,82,48.1
TwistedFate,Annie,98,53,45,54.08
TwistedFate,Zeri,77,22,55,28.57
TwistedFate,Hwei,136,72,64,52.94
TwistedFate,Azir,90,27,63,30
TwistedFate,Ornn,39,25,14,64.1
TwistedFate,RekSai,36,17,19,47.22
TwistedFate,Rakan,139,55,84,39.57
TwistedFate,Chogath,287,140,147,48.78
TwistedFate,Vayne,210,98,112,46.67
TwistedFate,Smolder,154,75,79,48.7
TwistedFate,Olaf,29,12,17,41.38
TwistedFate,Riven,91,53,38,58.24
TwistedFate,Sejuani,75,29,46,38.67
TwistedFate,Nilah,115,60,55,52.17
TwistedFate,Neeko,146,72,74,49.32
TwistedFate,KSante,65,34,31,52.31
TwistedFate,Tryndamere,117,55,62,47.01
TwistedFate,Warwick,286,123,163,43.01
TwistedFate,Lucian,136,61,75,44.85
TwistedFate,Urgot,99,38,61,38.38
TwistedFate,Skarner,60,35,25,58.33
TwistedFate,Aphelios,190,86,104,45.26
TwistedFate,Malphite,159,63,96,39.62
TwistedFate,Zac,78,20,58,25.64
TwistedFate,Shyvana,45,12,33,26.67
TwistedFate,Senna,171,94,77,54.97
TwistedFate,Anivia,51,36,15,70.59
TwistedFate,Fiora,103,76,27,73.79
TwistedFate,Heimerdinger,109,51,58,46.79
TwistedFate,Jayce,113,64,49,56.64
TwistedFate,Kalista,75,35,40,46.67
TwistedFate,Belveth,65,29,36,44.62
TwistedFate,Cassiopeia,75,49,26,65.33
TwistedFate,Braum,146,74,72,50.68
TwistedFate,Nidalee,71,25,46,35.21
TwistedFate,JarvanIV,65,37,28,56.92
TwistedFate,Singed,43,11,32,25.58
TwistedFate,Rumble,42,23,19,54.76
TwistedFate,Ivern,50,11,39,22
TwistedFate,Sivir,112,52,60,46.43
TwistedFate,Shen,86,44,42,51.16
TwistedFate,Xerath,143,26,117,18.18
TwistedFate,Gnar,89,47,42,52.81
TwistedFate,Qiyana,70,32,38,45.71
TwistedFate,Janna,47,29,18,61.7
TwistedFate,Ziggs,87,43,44,49.43
TwistedFate,Lissandra,53,17,36,32.08
TwistedFate,Taliyah,48,22,26,45.83
TwistedFate,KogMaw,71,35,36,49.3
TwistedFate,Evelynn,80,29,51,36.25
TwistedFate,Zilean,33,17,16,51.52
Leona,DrMundo,318,157,161,49.37
Leona,Lillia,267,149,118,55.81
Leona,Viktor,296,154,142,52.03
Leona,Jhin,796,442,354,55.53
Leona,Pyke,572,305,267,53.32
Leona,Yone,696,372,324,53.45
Leona,Shaco,378,150,228,39.68
Leona,AurelionSol,219,84,135,38.36
Leona,Ashe,759,391,368,51.52
Leona,Velkoz,235,124,111,52.77
Leona,Swain,491,234,257,47.66
Leona,FiddleSticks,256,121,135,47.27
Leona,Akali,473,215,258,45.45
Leona,Twitch,391,193,198,49.36
Leona,Senna,466,259,207,55.58
Leona,Chogath,693,325,368,46.9
Leona,Talon,268,137,131,51.12
Leona,Qiyana,177,102,75,57.63
Leona,Mel,1099,656,443,59.69
Leona,Seraphine,529,296,233,55.95
Leona,Aatrox,453,238,215,52.54
Leona,Veigar,544,262,282,48.16
Leona,Ezreal,868,476,392,54.84
Leona,Milio,255,157,98,61.57
Leona,Jax,347,217,130,62.54
Leona,Heimerdinger,245,110,135,44.9
Leona,Soraka,319,153,166,47.96
Leona,Sett,836,414,422,49.52
Leona,Karthus,80,25,55,31.25
Leona,Zed,346,203,143,58.67
Leona,Maokai,186,104,82,55.91
Leona,Samira,425,259,166,60.94
Leona,Kayn,779,443,336,56.87
Leona,Lucian,207,106,101,51.21
Leona,Thresh,568,246,322,43.31
Leona,Garen,689,378,311,54.86
Leona,Graves,292,124,168,42.47
Leona,Aurora,440,234,206,53.18
Leona,Nilah,296,145,151,48.99
Leona,Hwei,351,178,173,50.71
Leona,Katarina,363,228,135,62.81
Leona,Gnar,200,118,82,59
Leona,XinZhao,283,132,151,46.64
Leona,Yasuo,784,481,303,61.35
Leona,Zeri,289,144,145,49.83
Leona,Taric,93,28,65,30.11
Leona,Nasus,413,158,255,38.26
Leona,Galio,333,151,182,45.35
Leona,Smolder,381,179,202,46.98
Leona,JarvanIV,194,118,76,60.82
Leona,Mordekaiser,716,298,418,41.62
Leona,Viego,506,282,224,55.73
Leona,Irelia,430,256,174,59.53
Leona,Kaisa,639,322,317,50.39
Leona,Udyr,144,81,63,56.25
Leona,Volibear,484,262,222,54.13
Leona,Rengar,167,107,60,64.07
Leona,Vayne,514,284,230,55.25
Leona,Blitzcrank,488,264,224,54.1
Leona,KSante,124,50,74,40.32
Leona,Zac,138,83,55,60.14
Leona,Azir,211,92,119,43.6
Leona,Ambessa,303,154,149,50.83
Leona,MissFortune,972,464,508,47.74
Leona,Nautilus,566,289,277,51.06
Leona,Warwick,778,364,414,46.79
Leona,Tryndamere,222,127,95,57.21
Leona,LeeSin,324,192,132,59.26
Leona,Ekko,419,252,167,60.14
Leona,Sion,336,175,161,52.08
Leona,Pantheon,716,422,294,58.94
Leona,Ziggs,111,45,66,40.54
Leona,Lulu,324,170,154,52.47
Leona,Hecarim,123,75,48,60.98
Leona,Yorick,379,176,203,46.44
Leona,Kalista,196,99,97,50.51
Leona,Renekton,193,103,90,53.37
Leona,Sejuani,141,64,77,45.39
Leona,Taliyah,190,87,103,45.79
Leona,Kled,90,48,42,53.33
Leona,Shen,234,122,112,52.14
Leona,Leblanc,222,145,77,65.32
Leona,Yuumi,431,253,178,58.7
Leona,Teemo,579,291,288,50.26
Leona,Gragas,253,113,140,44.66
Leona,Diana,612,320,292,52.29
Leona,Caitlyn,966,474,492,49.07
Leona,TwistedFate,155,96,59,61.94
Leona,MonkeyKing,189,112,77,59.26
Leona,Briar,542,261,281,48.15
Leona,TahmKench,486,272,214,55.97
Leona,Evelynn,222,138,84,62.16
Leona,Varus,340,169,171,49.71
Leona,Nami,396,199,197,50.25
Leona,Kindred,205,118,87,57.56
Leona,Vladimir,213,93,120,43.66
Leona,Nocturne,379,183,196,48.28
Leona,Karma,300,169,131,56.33
Leona,Rakan,184,102,82,55.43
Leona,Lux,1090,588,502,53.94
Leona,Syndra,281,169,112,60.14
Leona,Zyra,329,164,165,49.85
Leona,Rell,332,166,166,50
Leona,Vi,384,163,221,42.45
Leona,Gwen,340,172,168,50.59
Leona,Kayle,309,191,118,61.81
Leona,Darius,741,417,324,56.28
Leona,Rammus,166,108,58,65.06
Leona,Illaoi,202,98,104,48.51
Leona,Nunu,368,176,192,47.83
Leona,Amumu,402,139,263,34.58
Leona,Jinx,859,426,433,49.59
Leona,Morgana,585,278,307,47.52
Leona,Draven,206,127,79,61.65
Leona,Malzahar,314,125,189,39.81
Leona,Tristana,411,237,174,57.66
Leona,Poppy,351,157,194,44.73
Leona,Orianna,188,102,86,54.26
Leona,Aphelios,281,146,135,51.96
Leona,Brand,248,141,107,56.85
Leona,Kennen,159,79,80,49.69
Leona,Neeko,251,115,136,45.82
Leona,MasterYi,448,258,190,57.59
Leona,Zoe,202,132,70,65.35
Leona,Fiora,156,105,51,67.31
Leona,Ahri,505,246,259,48.71
Leona,Xerath,267,147,120,55.06
Leona,Malphite,457,245,212,53.61
Leona,Anivia,132,55,77,41.67
Leona,Alistar,137,64,73,46.72
Leona,Gangplank,156,58,98,37.18
Leona,Belveth,141,76,65,53.9
Leona,Sona,185,104,81,56.22
Leona,Urgot,183,98,85,53.55
Leona,Janna,176,127,49,72.16
Leona,Ryze,102,50,52,49.02
Leona,Riven,132,79,53,59.85
Leona,Elise,249,127,122,51
Leona,Sylas,497,240,257,48.29
Leona,Khazix,232,153,79,65.95
Leona,Sivir,229,115,114,50.22
Leona,Shyvana,111,71,40,63.96
Leona,Zilean,150,87,63,58
Leona,Skarner,134,68,66,50.75
Leona,Vex,305,161,144,52.79
Leona,Quinn,144,73,71,50.69
Leona,Trundle,228,107,121,46.93
Leona,Cassiopeia,198,131,67,66.16
Leona,Singed,104,51,53,49.04
Leona,Lissandra,137,71,66,51.82
Leona,Naafiri,175,94,81,53.71
Leona,Ornn,197,104,93,52.79
Leona,Rumble,85,43,42,50.59
Leona,Fizz,176,90,86,51.14
Leona,Xayah,226,118,108,52.21
Leona,KogMaw,142,59,83,41.55
Leona,Renata,85,23,62,27.06
Leona,Akshan,156,87,69,55.77
Leona,Olaf,67,34,33,50.75
Leona,RekSai,99,56,43,56.57
Leona,Braum,154,62,92,40.26
Leona,Jayce,142,85,57,59.86
Leona,Kassadin,95,63,32,66.32
Leona,Camille,145,96,49,66.21
Leona,Ivern,83,14,69,16.87
Leona,Corki,162,85,77,52.47
Leona,Annie,104,66,38,63.46
Leona,Bard,129,43,86,33.33
Leona,Nidalee,69,38,31,55.07
MonkeyKing,Teemo,389,209,180,53.73
MonkeyKing,Warwick,520,238,282,45.77
MonkeyKing,Azir,126,95,31,75.4
MonkeyKing,MissFortune,681,334,347,49.05
MonkeyKing,Neeko,223,110,113,49.33
MonkeyKing,Mordekaiser,486,222,264,45.68
MonkeyKing,Qiyana,81,47,34,58.02
MonkeyKing,Mel,668,289,379,43.26
MonkeyKing,Nautilus,289,152,137,52.6
MonkeyKing,Sett,455,222,233,48.79
MonkeyKing,Taliyah,98,53,45,54.08
MonkeyKing,Sylas,273,155,118,56.78
MonkeyKing,Ezreal,512,245,267,47.85
MonkeyKing,Morgana,357,189,168,52.94
MonkeyKing,Tryndamere,170,86,84,50.59
MonkeyKing,Kayn,462,259,203,56.06
MonkeyKing,Aurora,305,170,135,55.74
MonkeyKing,Twitch,264,111,153,42.05
MonkeyKing,Lux,760,371,389,48.82
MonkeyKing,Ahri,399,211,188,52.88
MonkeyKing,Nunu,243,103,140,42.39
MonkeyKing,Yasuo,651,344,307,52.84
MonkeyKing,Zyra,224,104,120,46.43
MonkeyKing,Chogath,363,159,204,43.8
MonkeyKing,Lillia,170,103,67,60.59
MonkeyKing,Vex,167,84,83,50.3
MonkeyKing,Jhin,465,265,200,56.99
MonkeyKing,Janna,97,57,40,58.76
MonkeyKing,LeeSin,256,166,90,64.84
MonkeyKing,Caitlyn,673,316,357,46.95
MonkeyKing,Soraka,187,75,112,40.11
MonkeyKing,Kayle,212,87,125,41.04
MonkeyKing,Ekko,228,125,103,54.82
MonkeyKing,Irelia,279,156,123,55.91
MonkeyKing,Yuumi,224,151,73,67.41
MonkeyKing,Yorick,291,132,159,45.36
MonkeyKing,Volibear,338,177,161,52.37
MonkeyKing,Lucian,143,94,49,65.73
MonkeyKing,Blitzcrank,208,110,98,52.88
MonkeyKing,Akali,275,159,116,57.82
MonkeyKing,Evelynn,157,63,94,40.13
MonkeyKing,Velkoz,138,62,76,44.93
MonkeyKing,Jax,266,117,149,43.98
MonkeyKing,Braum,169,81,88,47.93
MonkeyKing,Viego,439,223,216,50.8
MonkeyKing,Heimerdinger,168,71,97,42.26
MonkeyKing,Udyr,126,66,60,52.38
MonkeyKing,Malzahar,215,95,120,44.19
MonkeyKing,Xayah,207,120,87,57.97
MonkeyKing,Rammus,82,25,57,30.49
MonkeyKing,Varus,245,105,140,42.86
MonkeyKing,Yone,581,317,264,54.56
MonkeyKing,Graves,195,113,82,57.95
MonkeyKing,Aatrox,267,152,115,56.93
MonkeyKing,Ziggs,142,74,68,52.11
MonkeyKing,Kindred,156,84,72,53.85
MonkeyKing,Ryze,100,47,53,47
MonkeyKing,Karthus,63,35,28,55.56
MonkeyKing,Kassadin,65,47,18,72.31
MonkeyKing,Renekton,103,56,47,54.37
MonkeyKing,XinZhao,184,115,69,62.5
MonkeyKing,Leblanc,106,44,62,41.51
MonkeyKing,Jinx,662,351,311,53.02
MonkeyKing,Shen,195,98,97,50.26
MonkeyKing,Pyke,294,187,107,63.61
MonkeyKing,Viktor,171,88,83,51.46
MonkeyKing,Ashe,461,228,233,49.46
MonkeyKing,Senna,282,159,123,56.38
MonkeyKing,Garen,466,228,238,48.93
MonkeyKing,JarvanIV,109,70,39,64.22
MonkeyKing,Hwei,210,119,91,56.67
MonkeyKing,Lulu,243,131,112,53.91
MonkeyKing,Leona,189,77,112,40.74
MonkeyKing,Ivern,86,39,47,45.35
MonkeyKing,Olaf,59,28,31,47.46
MonkeyKing,Katarina,356,201,155,56.46
MonkeyKing,Kled,86,42,44,48.84
MonkeyKing,Poppy,162,72,90,44.44
MonkeyKing,Swain,291,139,152,47.77
MonkeyKing,Zeri,89,55,34,61.8
MonkeyKing,Gangplank,115,71,44,61.74
MonkeyKing,Smolder,207,129,78,62.32
MonkeyKing,Alistar,144,83,61,57.64
MonkeyKing,Urgot,147,60,87,40.82
MonkeyKing,MasterYi,339,207,132,61.06
MonkeyKing,Zed,270,143,127,52.96
MonkeyKing,Milio,197,84,113,42.64
MonkeyKing,Briar,224,116,108,51.79
MonkeyKing,Illaoi,133,66,67,49.62
MonkeyKing,Shaco,302,159,143,52.65
MonkeyKing,Draven,174,84,90,48.28
MonkeyKing,Vayne,288,165,123,57.29
MonkeyKing,Nasus,184,66,118,35.87
MonkeyKing,Zoe,122,59,63,48.36
MonkeyKing,Pantheon,479,263,216,54.91
MonkeyKing,DrMundo,217,126,91,58.06
MonkeyKing,Seraphine,331,138,193,41.69
MonkeyKing,Zac,104,51,53,49.04
MonkeyKing,AurelionSol,133,79,54,59.4
MonkeyKing,Aphelios,173,68,105,39.31
MonkeyKing,Tristana,243,96,147,39.51
MonkeyKing,TwistedFate,97,57,40,58.76
MonkeyKing,Taric,31,13,18,41.94
MonkeyKing,Khazix,287,187,100,65.16
MonkeyKing,Fiora,141,58,83,41.13
MonkeyKing,Diana,414,236,178,57
MonkeyKing,Brand,237,142,95,59.92
MonkeyKing,Veigar,354,188,166,53.11
MonkeyKing,Camille,93,63,30,67.74
MonkeyKing,Vladimir,135,54,81,40
MonkeyKing,Gragas,162,62,100,38.27
MonkeyKing,FiddleSticks,180,97,83,53.89
MonkeyKing,Orianna,131,70,61,53.44
MonkeyKing,Elise,175,116,59,66.29
MonkeyKing,Riven,132,81,51,61.36
MonkeyKing,Darius,479,261,218,54.49
MonkeyKing,KSante,95,42,53,44.21
MonkeyKing,Thresh,375,180,195,48
MonkeyKing,Xerath,133,77,56,57.89
MonkeyKing,Fizz,134,53,81,39.55
MonkeyKing,Annie,67,26,41,38.81
MonkeyKing,Maokai,129,40,89,31.01
MonkeyKing,Kaisa,405,265,140,65.43
MonkeyKing,Rell,152,90,62,59.21
MonkeyKing,Talon,203,147,56,72.41
MonkeyKing,Gwen,182,105,77,57.69
MonkeyKing,Naafiri,124,57,67,45.97
MonkeyKing,Samira,314,184,130,58.6
MonkeyKing,Sona,121,67,54,55.37
MonkeyKing,Ornn,116,65,51,56.03
MonkeyKing,Skarner,144,105,39,72.92
MonkeyKing,Anivia,116,40,76,34.48
MonkeyKing,Gnar,87,41,46,47.13
MonkeyKing,Rakan,176,83,93,47.16
MonkeyKing,KogMaw,59,27,32,45.76
MonkeyKing,Vi,253,94,159,37.15
MonkeyKing,Sion,195,88,107,45.13
MonkeyKing,TahmKench,374,198,176,52.94
MonkeyKing,Trundle,150,59,91,39.33
MonkeyKing,Nocturne,215,122,93,56.74
MonkeyKing,Cassiopeia,112,30,82,26.79
MonkeyKing,Quinn,104,62,42,59.62
MonkeyKing,Hecarim,105,49,56,46.67
MonkeyKing,Akshan,99,63,36,63.64
MonkeyKing,Ambessa,177,93,84,52.54
MonkeyKing,Malphite,181,107,74,59.12
MonkeyKing,Karma,220,118,102,53.64
MonkeyKing,Amumu,284,154,130,54.23
MonkeyKing,Rengar,113,88,25,77.88
MonkeyKing,Nilah,177,93,84,52.54
MonkeyKing,Kalista,134,74,60,55.22
MonkeyKing,Zilean,80,47,33,58.75
MonkeyKing,Singed,76,27,49,35.53
MonkeyKing,Lissandra,122,62,60,50.82
MonkeyKing,Bard,89,46,43,51.69
MonkeyKing,Nami,257,126,131,49.03
MonkeyKing,Shyvana,116,44,72,37.93
MonkeyKing,Rumble,57,40,17,70.18
MonkeyKing,Jayce,123,54,69,43.9
MonkeyKing,Galio,150,52,98,34.67
MonkeyKing,Syndra,123,68,55,55.28
MonkeyKing,Belveth,90,47,43,52.22
MonkeyKing,Kennen,120,80,40,66.67
MonkeyKing,Renata,58,33,25,56.9
MonkeyKing,Corki,119,82,37,68.91
MonkeyKing,Sejuani,91,42,49,46.15
MonkeyKing,Sivir,155,59,96,38.06
MonkeyKing,Nidalee,65,27,38,41.54
MonkeyKing,RekSai,18,6,12,33.33
Teemo,MonkeyKing,389,180,209,46.27
Teemo,Kayn,1285,680,605,52.92
Teemo,Yasuo,1615,887,728,54.92
Teemo,Kaisa,1002,625,377,62.38
Teemo,Milio,423,203,220,47.99
Teemo,Vayne,758,416,342,54.88
Teemo,Nocturne,735,382,353,51.97
Teemo,Galio,500,238,262,47.6
Teemo,Blitzcrank,657,376,281,57.23
Teemo,Warwick,1290,683,607,52.95
Teemo,Evelynn,563,359,204,63.77
Teemo,Ahri,1139,618,521,54.26
Teemo,Yone,1612,926,686,57.44
Teemo,Garen,1286,773,513,60.11
Teemo,Lux,2212,1247,965,56.37
Teemo,Caitlyn,2103,1080,1023,51.36
Teemo,Thresh,1068,586,482,54.87
Teemo,Irelia,598,342,256,57.19
Teemo,Sivir,403,214,189,53.1
Teemo,Rell,477,255,222,53.46
Teemo,Aatrox,1027,607,420,59.1
Teemo,Gwen,510,306,204,60
Teemo,Syndra,468,246,222,52.56
Teemo,Ashe,1462,842,620,57.59
Teemo,Lulu,592,311,281,52.53
Teemo,Mordekaiser,1280,632,648,49.38
Teemo,Amumu,830,422,408,50.84
Teemo,Soraka,513,267,246,52.05
Teemo,Smolder,662,357,305,53.93
Teemo,Velkoz,555,323,232,58.2
Teemo,Chogath,1197,541,656,45.2
Teemo,Talon,468,272,196,58.12
Teemo,Qiyana,258,156,102,60.47
Teemo,Mel,1651,881,770,53.36
Teemo,Seraphine,865,469,396,54.22
Teemo,Zed,739,441,298,59.68
Teemo,Shaco,681,421,260,61.82
Teemo,Anivia,234,81,153,34.62
Teemo,Morgana,977,544,433,55.68
Teemo,Tryndamere,466,265,201,56.87
Teemo,Zeri,417,195,222,46.76
Teemo,Yorick,856,426,430,49.77
Teemo,Volibear,908,498,410,54.85
Teemo,Veigar,1061,528,533,49.76
Teemo,Sona,396,220,176,55.56
Teemo,Sion,717,334,383,46.58
Teemo,Akshan,302,142,160,47.02
Teemo,Jinx,1707,929,778,54.42
Teemo,Bard,279,155,124,55.56
Teemo,Gangplank,384,203,181,52.86
Teemo,Taliyah,270,170,100,62.96
Teemo,Akali,883,480,403,54.36
Teemo,Ezreal,1330,761,569,57.22
Teemo,Belveth,251,132,119,52.59
Teemo,Hwei,637,306,331,48.04
Teemo,TahmKench,810,450,360,55.56
Teemo,MissFortune,1924,1024,900,53.22
Teemo,Lillia,532,270,262,50.75
Teemo,Gnar,367,225,142,61.31
Teemo,Rammus,209,93,116,44.5
Teemo,Poppy,404,193,211,47.77
Teemo,Sett,1253,625,628,49.88
Teemo,MasterYi,893,471,422,52.74
Teemo,AurelionSol,414,249,165,60.14
Teemo,Kindred,503,310,193,61.63
Teemo,Kennen,333,181,152,54.35
Teemo,Tristana,748,411,337,54.95
Teemo,Yuumi,822,407,415,49.51
Teemo,Ekko,625,360,265,57.6
Teemo,Lucian,410,202,208,49.27
Teemo,TwistedFate,312,194,118,62.18
Teemo,Cassiopeia,439,228,211,51.94
Teemo,LeeSin,678,405,273,59.73
Teemo,DrMundo,480,240,240,50
Teemo,Nautilus,956,537,419,56.17
Teemo,Trundle,415,214,201,51.57
Teemo,Aphelios,598,362,236,60.54
Teemo,Malphite,894,432,462,48.32
Teemo,Vladimir,459,246,213,53.59
Teemo,Senna,784,408,376,52.04
Teemo,Ziggs,452,258,194,57.08
Teemo,Sejuani,338,214,124,63.31
Teemo,Heimerdinger,514,250,264,48.64
Teemo,Zilean,218,115,103,52.75
Teemo,Hecarim,306,142,164,46.41
Teemo,Twitch,647,344,303,53.17
Teemo,Ivern,169,108,61,63.91
Teemo,Jhin,1499,821,678,54.77
Teemo,Pyke,1077,588,489,54.6
Teemo,Viego,1124,544,580,48.4
Teemo,Kalista,366,198,168,54.1
Teemo,FiddleSticks,465,237,228,50.97
Teemo,Udyr,355,169,186,47.61
Teemo,Leblanc,282,163,119,57.8
Teemo,Nami,789,419,370,53.11
Teemo,Vi,644,377,267,58.54
Teemo,Nilah,456,237,219,51.97
Teemo,Samira,823,435,388,52.86
Teemo,Taric,198,97,101,48.99
Teemo,Ornn,398,172,226,43.22
Teemo,Skarner,214,86,128,40.19
Teemo,Illaoi,373,213,160,57.1
Teemo,Naafiri,336,191,145,56.85
Teemo,Xayah,488,272,216,55.74
Teemo,Rakan,372,188,184,50.54
Teemo,Nasus,740,410,330,55.41
Teemo,Zac,274,147,127,53.65
Teemo,Swain,822,415,407,50.49
Teemo,Briar,873,548,325,62.77
Teemo,Urgot,368,200,168,54.35
Teemo,Draven,474,226,248,47.68
Teemo,Vex,552,299,253,54.17
Teemo,Diana,1176,641,535,54.51
Teemo,Leona,579,288,291,49.74
Teemo,Ryze,291,140,151,48.11
Teemo,Aurora,818,468,350,57.21
Teemo,Braum,435,193,242,44.37
Teemo,Jax,635,302,333,47.56
Teemo,Zyra,618,286,332,46.28
Teemo,Gragas,478,321,157,67.15
Teemo,Xerath,572,365,207,63.81
Teemo,Quinn,343,194,149,56.56
Teemo,Darius,1635,874,761,53.46
Teemo,Renata,202,93,109,46.04
Teemo,Ambessa,422,259,163,61.37
Teemo,KogMaw,270,134,136,49.63
Teemo,Nunu,689,346,343,50.22
Teemo,Azir,258,137,121,53.1
Teemo,Renekton,279,172,107,61.65
Teemo,Khazix,539,315,224,58.44
Teemo,Brand,653,343,310,52.53
Teemo,Neeko,661,376,285,56.88
Teemo,Fiora,286,157,129,54.9
Teemo,Malzahar,705,352,353,49.93
Teemo,Kayle,732,352,380,48.09
Teemo,Corki,211,118,93,55.92
Teemo,Janna,197,122,75,61.93
Teemo,Fizz,436,204,232,46.79
Teemo,Alistar,260,186,74,71.54
Teemo,Sylas,807,451,356,55.89
Teemo,Varus,716,386,330,53.91
Teemo,Shyvana,235,107,128,45.53
Teemo,Lissandra,246,129,117,52.44
Teemo,Kled,205,104,101,50.73
Teemo,Graves,439,246,193,56.04
Teemo,Orianna,318,190,128,59.75
Teemo,Shen,452,197,255,43.58
Teemo,Elise,473,264,209,55.81
Teemo,Rengar,339,210,129,61.95
Teemo,Maokai,373,173,200,46.38
Teemo,Singed,181,56,125,30.94
Teemo,Riven,358,200,158,55.87
Teemo,Katarina,684,359,325,52.49
Teemo,Olaf,228,148,80,64.91
Teemo,KSante,235,153,82,65.11
Teemo,Kassadin,147,88,59,59.86
Teemo,Karthus,209,98,111,46.89
Teemo,Annie,278,164,114,58.99
Teemo,Viktor,508,306,202,60.24
Teemo,Pantheon,1357,756,601,55.71
Teemo,Nidalee,208,120,88,57.69
Teemo,JarvanIV,302,137,165,45.36
Teemo,Zoe,456,275,181,60.31
Teemo,Karma,541,318,223,58.78
Teemo,Rumble,277,133,144,48.01
Teemo,XinZhao,447,243,204,54.36
Teemo,RekSai,117,82,35,70.09
Teemo,Camille,270,156,114,57.78
Teemo,Jayce,368,180,188,48.91
Azir,MonkeyKing,126,31,95,24.6
Azir,Kayn,261,87,174,33.33
Azir,Yasuo,427,235,192,55.04
Azir,Kaisa,302,144,158,47.68
Azir,Milio,112,65,47,58.04
Azir,KSante,55,35,20,63.64
Azir,Warwick,351,154,197,43.87
Azir,Diana,243,140,103,57.61
Azir,Ashe,393,164,229,41.73
Azir,Corki,92,47,45,51.09
Azir,Sett,396,189,207,47.73
Azir,Volibear,277,152,125,54.87
Azir,Ambessa,182,88,94,48.35
Azir,Smolder,163,81,82,49.69
Azir,Swain,207,89,118,43
Azir,Riven,73,42,31,57.53
Azir,Syndra,126,44,82,34.92
Azir,Jinx,377,182,195,48.28
Azir,Pyke,257,130,127,50.58
Azir,Illaoi,96,31,65,32.29
Azir,Caitlyn,560,276,284,49.29
Azir,Velkoz,115,52,63,45.22
Azir,Nocturne,192,82,110,42.71
Azir,Xerath,196,79,117,40.31
Azir,Ezreal,375,203,172,54.13
Azir,Blitzcrank,177,69,108,38.98
Azir,Aatrox,170,80,90,47.06
Azir,Cassiopeia,127,72,55,56.69
Azir,Varus,175,94,81,53.71
Azir,Morgana,307,96,211,31.27
Azir,Chogath,339,151,188,44.54
Azir,Poppy,165,66,99,40
Azir,Irelia,187,99,88,52.94
Azir,Jhin,348,151,197,43.39
Azir,Leona,211,119,92,56.4
Azir,Shaco,208,113,95,54.33
Azir,Akali,207,121,86,58.45
Azir,Sivir,109,48,61,44.04
Azir,Renata,77,37,40,48.05
Azir,Nunu,194,98,96,50.52
Azir,Yone,387,210,177,54.26
Azir,Malzahar,173,83,90,47.98
Azir,Khazix,130,68,62,52.31
Azir,Nasus,152,62,90,40.79
Azir,Maokai,94,50,44,53.19
Azir,Elise,115,54,61,46.96
Azir,Vex,172,74,98,43.02
Azir,Lucian,151,68,83,45.03
Azir,Senna,238,125,113,52.52
Azir,Malphite,156,61,95,39.1
Azir,Xayah,153,84,69,54.9
Azir,Rakan,115,72,43,62.61
Azir,Garen,330,149,181,45.15
Azir,Lux,570,220,350,38.6
Azir,Ryze,87,28,59,32.18
Azir,Pantheon,410,203,207,49.51
Azir,Darius,384,186,198,48.44
Azir,Mordekaiser,316,119,197,37.66
Azir,Evelynn,86,37,49,43.02
Azir,Aurora,296,135,161,45.61
Azir,Naafiri,103,49,54,47.57
Azir,MasterYi,211,87,124,41.23
Azir,Twitch,128,64,64,50
Azir,Teemo,258,121,137,46.9
Azir,Vayne,199,103,96,51.76
Azir,Ahri,263,136,127,51.71
Azir,Katarina,250,144,106,57.6
Azir,Yuumi,219,68,151,31.05
Azir,Gnar,120,63,57,52.5
Azir,Annie,68,29,39,42.65
Azir,Tristana,239,114,125,47.7
Azir,Ekko,202,104,98,51.49
Azir,Lillia,151,64,87,42.38
Azir,Draven,111,56,55,50.45
Azir,Lulu,152,88,64,57.89
Azir,Leblanc,94,51,43,54.26
Azir,Jax,199,95,104,47.74
Azir,Trundle,144,74,70,51.39
Azir,Soraka,99,35,64,35.35
Azir,TahmKench,219,76,143,34.7
Azir,Udyr,84,53,31,63.1
Azir,Orianna,112,63,49,56.25
Azir,Mel,541,297,244,54.9
Azir,Veigar,223,110,113,49.33
Azir,Braum,118,58,60,49.15
Azir,Rengar,138,80,58,57.97
Azir,Yorick,135,72,63,53.33
Azir,Kindred,134,76,58,56.72
Azir,Vladimir,108,53,55,49.07
Azir,Brand,131,56,75,42.75
Azir,FiddleSticks,121,44,77,36.36
Azir,Shen,181,107,74,59.12
Azir,Skarner,72,20,52,27.78
Azir,Samira,206,105,101,50.97
Azir,Qiyana,102,41,61,40.2
Azir,Zyra,110,78,32,70.91
Azir,Viego,280,106,174,37.86
Azir,Nilah,116,69,47,59.48
Azir,Sona,61,31,30,50.82
Azir,Zac,78,57,21,73.08
Azir,Galio,151,85,66,56.29
Azir,Fiora,74,30,44,40.54
Azir,Lissandra,75,41,34,54.67
Azir,Thresh,303,209,94,68.98
Azir,MissFortune,425,189,236,44.47
Azir,Sion,171,67,104,39.18
Azir,Zed,231,97,134,41.99
Azir,Taric,58,21,37,36.21
Azir,Amumu,160,78,82,48.75
Azir,Zoe,121,56,65,46.28
Azir,Zeri,124,43,81,34.68
Azir,Gragas,151,81,70,53.64
Azir,Sylas,185,91,94,49.19
Azir,Taliyah,49,31,18,63.27
Azir,Karma,87,43,44,49.43
Azir,Aphelios,130,58,72,44.62
Azir,Seraphine,199,84,115,42.21
Azir,Alistar,87,53,34,60.92
Azir,Briar,206,90,116,43.69
Azir,Nautilus,242,137,105,56.61
Azir,Gwen,138,66,72,47.83
Azir,Gangplank,108,56,52,51.85
Azir,Kayle,153,55,98,35.95
Azir,Heimerdinger,109,36,73,33.03
Azir,Ziggs,40,23,17,57.5
Azir,Talon,104,53,51,50.96
Azir,Kennen,45,12,33,26.67
Azir,Quinn,74,47,27,63.51
Azir,DrMundo,113,61,52,53.98
Azir,Viktor,94,39,55,41.49
Azir,Janna,56,25,31,44.64
Azir,Fizz,60,24,36,40
Azir,Neeko,159,75,84,47.17
Azir,XinZhao,123,62,61,50.41
Azir,TwistedFate,90,63,27,70
Azir,Vi,167,69,98,41.32
Azir,Graves,83,37,46,44.58
Azir,KogMaw,49,16,33,32.65
Azir,Rell,116,44,72,37.93
Azir,Olaf,32,19,13,59.38
Azir,Tryndamere,116,79,37,68.1
Azir,Bard,52,22,30,42.31
Azir,Belveth,44,41,3,93.18
Azir,Shyvana,44,11,33,25
Azir,Ornn,97,52,45,53.61
Azir,LeeSin,248,110,138,44.35
Azir,Anivia,71,47,24,66.2
Azir,Singed,39,9,30,23.08
Azir,Karthus,41,24,17,58.54
Azir,AurelionSol,73,20,53,27.4
Azir,Zilean,51,34,17,66.67
Azir,JarvanIV,85,48,37,56.47
Azir,Hecarim,62,25,37,40.32
Azir,Akshan,75,34,41,45.33
Azir,Camille,59,43,16,72.88
Azir,Hwei,171,86,85,50.29
Azir,Ivern,39,26,13,66.67
Azir,Kalista,111,47,64,42.34
Azir,Jayce,103,53,50,51.46
Azir,Urgot,120,70,50,58.33
Azir,Rumble,31,10,21,32.26
Azir,Nami,126,64,62,50.79
Azir,Sejuani,66,53,13,80.3
Azir,Renekton,72,25,47,34.72
Azir,RekSai,51,28,23,54.9
Azir,Nidalee,45,39,6,86.67
Azir,Rammus,49,18,31,36.73
Azir,Kled,51,15,36,29.41
Azir,Kassadin,21,15,6,71.43
MissFortune,MonkeyKing,681,347,334,50.95
MissFortune,Kayn,2017,969,1048,48.04
MissFortune,Yasuo,2712,1347,1365,49.67
MissFortune,Kaisa,1758,946,812,53.81
MissFortune,Milio,627,303,324,48.33
MissFortune,Gangplank,449,237,212,52.78
MissFortune,Warwick,2301,1092,1209,47.46
MissFortune,Akali,1462,679,783,46.44
MissFortune,Caitlyn,3607,1925,1682,53.37
MissFortune,Sona,495,293,202,59.19
MissFortune,Aatrox,1228,706,522,57.49
MissFortune,Sejuani,505,271,234,53.66
MissFortune,Jinx,3023,1496,1527,49.49
MissFortune,Pyke,1434,748,686,52.16
MissFortune,Gnar,554,284,270,51.26
MissFortune,Jax,995,523,472,52.56
MissFortune,Neeko,1126,652,474,57.9
MissFortune,Ornn,440,195,245,44.32
MissFortune,Udyr,457,242,215,52.95
MissFortune,Lux,3948,1998,1950,50.61
MissFortune,Ezreal,2156,1183,973,54.87
MissFortune,Nidalee,305,175,130,57.38
MissFortune,Ahri,1742,913,829,52.41
MissFortune,Jhin,2320,1083,1237,46.68
MissFortune,Senna,998,503,495,50.4
MissFortune,Urgot,626,294,332,46.96
MissFortune,Twitch,1222,647,575,52.95
MissFortune,Vladimir,735,362,373,49.25
MissFortune,Zac,484,229,255,47.31
MissFortune,Cassiopeia,535,297,238,55.51
MissFortune,Irelia,1118,570,548,50.98
MissFortune,Darius,2303,1258,1045,54.62
MissFortune,Volibear,1515,793,722,52.34
MissFortune,Chogath,1690,931,759,55.09
MissFortune,Brand,1043,501,542,48.03
MissFortune,Fiora,616,326,290,52.92
MissFortune,Yone,2527,1418,1109,56.11
MissFortune,Galio,777,349,428,44.92
MissFortune,KSante,355,184,171,51.83
MissFortune,Diana,1823,857,966,47.01
MissFortune,Ashe,2540,1357,1183,53.43
MissFortune,Corki,417,248,169,59.47
MissFortune,Shen,793,405,388,51.07
MissFortune,Samira,1276,568,708,44.51
MissFortune,Soraka,738,383,355,51.9
MissFortune,Sylas,1233,656,577,53.2
MissFortune,Amumu,1262,581,681,46.04
MissFortune,Vex,807,395,412,48.95
MissFortune,Rakan,745,420,325,56.38
MissFortune,Gwen,845,456,389,53.96
MissFortune,Thresh,1514,874,640,57.73
MissFortune,Yuumi,1193,598,595,50.13
MissFortune,Karma,839,450,389,53.64
MissFortune,Garen,1906,909,997,47.69
MissFortune,FiddleSticks,610,287,323,47.05
MissFortune,Mordekaiser,2199,1081,1118,49.16
MissFortune,Lulu,848,389,459,45.87
MissFortune,Veigar,1474,726,748,49.25
MissFortune,Nasus,1099,579,520,52.68
MissFortune,Khazix,714,447,267,62.61
MissFortune,Aurora,1236,621,615,50.24
MissFortune,Viego,1501,723,778,48.17
MissFortune,Nocturne,1102,563,539,51.09
MissFortune,Jayce,373,214,159,57.37
MissFortune,Sett,2253,1147,1106,50.91
MissFortune,Shyvana,300,158,142,52.67
MissFortune,Fizz,746,408,338,54.69
MissFortune,Nilah,868,476,392,54.84
MissFortune,Nami,1143,558,585,48.82
MissFortune,LeeSin,1052,566,486,53.8
MissFortune,Evelynn,695,350,345,50.36
MissFortune,Belveth,358,197,161,55.03
MissFortune,Hwei,925,482,443,52.11
MissFortune,TahmKench,1459,732,727,50.17
MissFortune,Orianna,437,238,199,54.46
MissFortune,Nautilus,1354,707,647,52.22
MissFortune,Ivern,270,141,129,52.22
MissFortune,Swain,1292,595,697,46.05
MissFortune,Kayle,978,499,479,51.02
MissFortune,Katarina,1222,780,442,63.83
MissFortune,Gragas,757,449,308,59.31
MissFortune,Teemo,1924,900,1024,46.78
MissFortune,Morgana,1796,831,965,46.27
MissFortune,Briar,1261,575,686,45.6
MissFortune,RekSai,129,58,71,44.96
MissFortune,Braum,666,329,337,49.4
MissFortune,Varus,961,469,492,48.8
MissFortune,Janna,348,192,156,55.17
MissFortune,Shaco,1078,546,532,50.65
MissFortune,Riven,467,290,177,62.1
MissFortune,Pantheon,2130,1123,1007,52.72
MissFortune,Zed,1084,562,522,51.85
MissFortune,MasterYi,1528,742,786,48.56
MissFortune,Trundle,808,358,450,44.31
MissFortune,Malzahar,908,404,504,44.49
MissFortune,Talon,720,389,331,54.03
MissFortune,DrMundo,784,313,471,39.92
MissFortune,Yorick,1126,488,638,43.34
MissFortune,Blitzcrank,926,487,439,52.59
MissFortune,Smolder,890,515,375,57.87
MissFortune,JarvanIV,356,189,167,53.09
MissFortune,Rengar,562,350,212,62.28
MissFortune,Vayne,1278,620,658,48.51
MissFortune,XinZhao,589,325,264,55.18
MissFortune,Leona,972,508,464,52.26
MissFortune,Vi,1103,637,466,57.75
MissFortune,Anivia,408,207,201,50.74
MissFortune,Leblanc,486,244,242,50.21
MissFortune,Maokai,518,237,281,45.75
MissFortune,Mel,2667,1404,1263,52.64
MissFortune,Kalista,672,329,343,48.96
MissFortune,Kennen,481,329,152,68.4
MissFortune,Ekko,971,508,463,52.32
MissFortune,Graves,654,378,276,57.8
MissFortune,Zeri,574,268,306,46.69
MissFortune,Taric,265,150,115,56.6
MissFortune,Rumble,207,109,98,52.66
MissFortune,Akshan,477,218,259,45.7
MissFortune,Tryndamere,806,445,361,55.21
MissFortune,Malphite,1050,530,520,50.48
MissFortune,Zoe,492,279,213,56.71
MissFortune,Heimerdinger,912,454,458,49.78
MissFortune,Ambessa,634,318,316,50.16
MissFortune,Rammus,352,144,208,40.91
MissFortune,Seraphine,1564,826,738,52.81
MissFortune,Ziggs,569,273,296,47.98
MissFortune,Karthus,310,162,148,52.26
MissFortune,AurelionSol,714,286,428,40.06
MissFortune,Rell,655,377,278,57.56
MissFortune,Xayah,914,512,402,56.02
MissFortune,Lucian,628,369,259,58.76
MissFortune,Singed,286,118,168,41.26
MissFortune,Draven,769,344,425,44.73
MissFortune,Lillia,917,503,414,54.85
MissFortune,Illaoi,657,260,397,39.57
MissFortune,Hecarim,459,266,193,57.95
MissFortune,Tristana,1469,767,702,52.21
MissFortune,Aphelios,899,470,429,52.28
MissFortune,TwistedFate,425,202,223,47.53
MissFortune,Viktor,776,440,336,56.7
MissFortune,Olaf,275,165,110,60
MissFortune,Nunu,1153,560,593,48.57
MissFortune,Camille,346,201,145,58.09
MissFortune,Kled,274,155,119,56.57
MissFortune,Poppy,701,321,380,45.79
MissFortune,Skarner,348,212,136,60.92
MissFortune,Xerath,942,404,538,42.89
MissFortune,Elise,732,441,291,60.25
MissFortune,Quinn,521,274,247,52.59
MissFortune,Kassadin,221,87,134,39.37
MissFortune,Annie,301,182,119,60.47
MissFortune,Ryze,343,191,152,55.69
MissFortune,Zyra,771,313,458,40.6
MissFortune,Sivir,675,329,346,48.74
MissFortune,KogMaw,500,210,290,42
MissFortune,Sion,955,404,551,42.3
MissFortune,Naafiri,578,295,283,51.04
MissFortune,Velkoz,718,313,405,43.59
MissFortune,Zilean,314,185,129,58.92
MissFortune,Kindred,676,360,316,53.25
MissFortune,Syndra,623,353,270,56.66
MissFortune,Qiyana,438,254,184,57.99
MissFortune,Renekton,513,260,253,50.68
MissFortune,Bard,362,180,182,49.72
MissFortune,Alistar,386,197,189,51.04
MissFortune,Taliyah,307,160,147,52.12
MissFortune,Azir,425,236,189,55.53
MissFortune,Renata,331,191,140,57.7
MissFortune,Lissandra,278,132,146,47.48
Neeko,MonkeyKing,223,113,110,50.67
Neeko,Kayn,814,378,436,46.44
Neeko,Yasuo,877,370,507,42.19
Neeko,Kaisa,474,253,221,53.38
Neeko,Milio,226,124,102,54.87
Neeko,Irelia,432,226,206,52.31
Neeko,Zed,392,199,193,50.77
Neeko,Galio,293,104,189,35.49
Neeko,MissFortune,1126,474,652,42.1
Neeko,TahmKench,468,213,255,45.51
Neeko,Yone,911,461,450,50.6
Neeko,Shaco,348,180,168,51.72
Neeko,AurelionSol,219,85,134,38.81
Neeko,Ashe,772,359,413,46.5
Neeko,Velkoz,286,118,168,41.26
Neeko,Fiora,212,106,106,50
Neeko,MasterYi,523,287,236,54.88
Neeko,Mel,1022,440,582,43.05
Neeko,Jhin,847,409,438,48.29
Neeko,Karma,260,145,115,55.77
Neeko,Gwen,283,157,126,55.48
Neeko,JarvanIV,108,40,68,37.04
Neeko,Zyra,334,144,190,43.11
Neeko,Seraphine,634,304,330,47.95
Neeko,Garen,755,332,423,43.97
Neeko,Lux,1388,607,781,43.73
Neeko,Caitlyn,1178,568,610,48.22
Neeko,Thresh,577,297,280,51.47
Neeko,Riven,193,103,90,53.37
Neeko,Amumu,473,220,253,46.51
Neeko,Zoe,215,106,109,49.3
Neeko,Sona,199,58,141,29.15
Neeko,Akali,458,217,241,47.38
Neeko,Rammus,115,51,64,44.35
Neeko,Jinx,940,449,491,47.77
Neeko,Mordekaiser,732,392,340,53.55
Neeko,Diana,583,260,323,44.6
Neeko,Ahri,688,358,330,52.03
Neeko,Twitch,308,140,168,45.45
Neeko,Lulu,249,149,100,59.84
Neeko,Gnar,159,77,82,48.43
Neeko,Leblanc,182,83,99,45.6
Neeko,Pyke,534,313,221,58.61
Neeko,Varus,431,214,217,49.65
Neeko,Chogath,572,260,312,45.45
Neeko,Poppy,281,125,156,44.48
Neeko,Illaoi,245,127,118,51.84
Neeko,Khazix,326,166,160,50.92
Neeko,Syndra,219,66,153,30.14
Neeko,Udyr,152,55,97,36.18
Neeko,Yorick,439,149,290,33.94
Neeko,Jax,367,198,169,53.95
Neeko,Naafiri,206,114,92,55.34
Neeko,Tristana,362,189,173,52.21
Neeko,Rakan,236,105,131,44.49
Neeko,Karthus,101,49,52,48.51
Neeko,Nilah,224,117,107,52.23
Neeko,Braum,179,73,106,40.78
Neeko,Sion,397,159,238,40.05
Neeko,FiddleSticks,168,85,83,50.6
Neeko,Ezreal,675,407,268,60.3
Neeko,Zilean,109,49,60,44.95
Neeko,Trundle,238,111,127,46.64
Neeko,Nocturne,451,224,227,49.67
Neeko,Orianna,195,92,103,47.18
Neeko,Veigar,534,275,259,51.5
Neeko,Brand,392,182,210,46.43
Neeko,Cassiopeia,220,97,123,44.09
Neeko,Pantheon,843,425,418,50.42
Neeko,Swain,541,206,335,38.08
Neeko,Gragas,283,143,140,50.53
Neeko,LeeSin,364,176,188,48.35
Neeko,Kayle,310,129,181,41.61
Neeko,Morgana,719,328,391,45.62
Neeko,Sejuani,154,72,82,46.75
Neeko,Smolder,290,118,172,40.69
Neeko,Rengar,187,108,79,57.75
Neeko,Hwei,354,169,185,47.74
Neeko,Singed,82,30,52,36.59
Neeko,Yuumi,365,195,170,53.42
Neeko,Blitzcrank,327,226,101,69.11
Neeko,Warwick,743,362,381,48.72
Neeko,Briar,436,213,223,48.85
Neeko,Senna,400,198,202,49.5
Neeko,Urgot,285,106,179,37.19
Neeko,Annie,134,64,70,47.76
Neeko,Graves,302,140,162,46.36
Neeko,Zeri,248,104,144,41.94
Neeko,Taric,118,36,82,30.51
Neeko,DrMundo,265,120,145,45.28
Neeko,Samira,483,209,274,43.27
Neeko,Kennen,213,105,108,49.3
Neeko,Katarina,368,220,148,59.78
Neeko,Soraka,267,154,113,57.68
Neeko,Ambessa,220,126,94,57.27
Neeko,Darius,737,325,412,44.1
Neeko,Viego,519,234,285,45.09
Neeko,Sylas,411,201,210,48.91
Neeko,Nami,405,214,191,52.84
Neeko,Aphelios,327,128,199,39.14
Neeko,Lissandra,99,43,56,43.43
Neeko,Vladimir,225,126,99,56
Neeko,Corki,96,65,31,67.71
Neeko,Ziggs,191,76,115,39.79
Neeko,Aatrox,443,244,199,55.08
Neeko,Xayah,335,124,211,37.01
Neeko,Skarner,136,98,38,72.06
Neeko,Xerath,281,125,156,44.48
Neeko,Zac,157,70,87,44.59
Neeko,Renekton,198,90,108,45.45
Neeko,Sett,730,296,434,40.55
Neeko,KogMaw,183,64,119,34.97
Neeko,Janna,138,66,72,47.83
Neeko,Talon,297,147,150,49.49
Neeko,Lillia,284,143,141,50.35
Neeko,Hecarim,177,102,75,57.63
Neeko,Malzahar,332,173,159,52.11
Neeko,Fizz,212,102,110,48.11
Neeko,Kalista,220,132,88,60
Neeko,Vi,390,170,220,43.59
Neeko,Teemo,661,285,376,43.12
Neeko,Aurora,457,205,252,44.86
Neeko,Rell,208,77,131,37.02
Neeko,Nasus,430,205,225,47.67
Neeko,Draven,230,117,113,50.87
Neeko,Renata,129,41,88,31.78
Neeko,Lucian,251,134,117,53.39
Neeko,Vex,279,150,129,53.76
Neeko,Ryze,88,50,38,56.82
Neeko,Olaf,125,60,65,48
Neeko,Vayne,419,183,236,43.68
Neeko,Ekko,316,140,176,44.3
Neeko,Nunu,388,164,224,42.27
Neeko,Evelynn,270,119,151,44.07
Neeko,Malphite,307,161,146,52.44
Neeko,Alistar,141,45,96,31.91
Neeko,Camille,145,96,49,66.21
Neeko,Leona,251,136,115,54.18
Neeko,Shen,238,97,141,40.76
Neeko,Nautilus,494,206,288,41.7
Neeko,Sivir,222,118,104,53.15
Neeko,Nidalee,91,58,33,63.74
Neeko,Kassadin,97,34,63,35.05
Neeko,Maokai,247,137,110,55.47
Neeko,Volibear,539,243,296,45.08
Neeko,Taliyah,108,47,61,43.52
Neeko,Elise,294,139,155,47.28
Neeko,Bard,124,91,33,73.39
Neeko,Heimerdinger,289,109,180,37.72
Neeko,Viktor,303,144,159,47.52
Neeko,Jayce,164,75,89,45.73
Neeko,Gangplank,186,105,81,56.45
Neeko,Akshan,180,62,118,34.44
Neeko,Ivern,71,29,42,40.85
Neeko,Quinn,177,65,112,36.72
Neeko,Azir,159,84,75,52.83
Neeko,Anivia,124,49,75,39.52
Neeko,Tryndamere,261,102,159,39.08
Neeko,Kindred,241,138,103,57.26
Neeko,Qiyana,113,67,46,59.29
Neeko,TwistedFate,146,74,72,50.68
Neeko,XinZhao,299,137,162,45.82
Neeko,RekSai,60,31,29,51.67
Neeko,Kled,72,44,28,61.11
Neeko,KSante,119,57,62,47.9
Neeko,Shyvana,153,69,84,45.1
Neeko,Ornn,151,77,74,50.99
Neeko,Belveth,113,40,73,35.4
Neeko,Rumble,52,17,35,32.69
FiddleSticks,Gangplank,133,88,45,66.17
FiddleSticks,MasterYi,301,169,132,56.15
FiddleSticks,Veigar,327,179,148,54.74
FiddleSticks,Mel,684,309,375,45.18
FiddleSticks,Swain,336,139,197,41.37
FiddleSticks,Samira,317,180,137,56.78
FiddleSticks,Kayn,495,271,224,54.75
FiddleSticks,Sylas,386,186,200,48.19
FiddleSticks,Nilah,200,111,89,55.5
FiddleSticks,Leona,256,135,121,52.73
FiddleSticks,Pantheon,580,279,301,48.1
FiddleSticks,Leblanc,127,61,66,48.03
FiddleSticks,Sivir,148,91,57,61.49
FiddleSticks,Pyke,385,194,191,50.39
FiddleSticks,Yorick,248,121,127,48.79
FiddleSticks,Viego,302,170,132,56.29
FiddleSticks,Malphite,254,136,118,53.54
FiddleSticks,Kaisa,444,259,185,58.33
FiddleSticks,Rell,179,93,86,51.96
FiddleSticks,Karthus,101,55,46,54.46
FiddleSticks,Aurora,358,222,136,62.01
FiddleSticks,Ezreal,461,258,203,55.97
FiddleSticks,Senna,297,141,156,47.47
FiddleSticks,DrMundo,195,71,124,36.41
FiddleSticks,Ivern,75,28,47,37.33
FiddleSticks,Mordekaiser,498,205,293,41.16
FiddleSticks,Yuumi,328,170,158,51.83
FiddleSticks,Aatrox,306,157,149,51.31
FiddleSticks,Khazix,205,87,118,42.44
FiddleSticks,Qiyana,94,51,43,54.26
FiddleSticks,MissFortune,610,323,287,52.95
FiddleSticks,Nautilus,390,190,200,48.72
FiddleSticks,Darius,419,200,219,47.73
FiddleSticks,Poppy,213,137,76,64.32
FiddleSticks,Kindred,197,78,119,39.59
FiddleSticks,Warwick,476,244,232,51.26
FiddleSticks,Aphelios,221,101,120,45.7
FiddleSticks,KSante,78,55,23,70.51
FiddleSticks,Vex,206,123,83,59.71
FiddleSticks,Jinx,591,268,323,45.35
FiddleSticks,Tryndamere,167,86,81,51.5
FiddleSticks,Amumu,296,117,179,39.53
FiddleSticks,Seraphine,347,195,152,56.2
FiddleSticks,Udyr,128,63,65,49.22
FiddleSticks,Jhin,563,283,280,50.27
FiddleSticks,Evelynn,173,96,77,55.49
FiddleSticks,XinZhao,143,84,59,58.74
FiddleSticks,Morgana,425,205,220,48.24
FiddleSticks,Ashe,437,225,212,51.49
FiddleSticks,Braum,155,103,52,66.45
FiddleSticks,Riven,199,107,92,53.77
FiddleSticks,Sejuani,125,51,74,40.8
FiddleSticks,AurelionSol,118,49,69,41.53
FiddleSticks,Tristana,318,141,177,44.34
FiddleSticks,Rakan,152,82,70,53.95
FiddleSticks,Jax,231,119,112,51.52
FiddleSticks,Naafiri,153,74,79,48.37
FiddleSticks,Irelia,237,131,106,55.27
FiddleSticks,Neeko,168,83,85,49.4
FiddleSticks,Yone,576,322,254,55.9
FiddleSticks,Nocturne,239,113,126,47.28
FiddleSticks,Lucian,164,78,86,47.56
FiddleSticks,Yasuo,546,267,279,48.9
FiddleSticks,Nami,260,150,110,57.69
FiddleSticks,Renekton,93,55,38,59.14
FiddleSticks,Malzahar,255,104,151,40.78
FiddleSticks,Lux,858,405,453,47.2
FiddleSticks,Quinn,102,48,54,47.06
FiddleSticks,Cassiopeia,89,29,60,32.58
FiddleSticks,Varus,209,103,106,49.28
FiddleSticks,Janna,129,72,57,55.81
FiddleSticks,Rengar,141,101,40,71.63
FiddleSticks,Anivia,97,68,29,70.1
FiddleSticks,Xayah,228,120,108,52.63
FiddleSticks,Galio,176,75,101,42.61
FiddleSticks,Ekko,283,178,105,62.9
FiddleSticks,Zed,270,179,91,66.3
FiddleSticks,Caitlyn,770,378,392,49.09
FiddleSticks,Lulu,217,110,107,50.69
FiddleSticks,Akali,275,166,109,60.36
FiddleSticks,Ziggs,117,49,68,41.88
FiddleSticks,Volibear,325,158,167,48.62
FiddleSticks,Hwei,262,161,101,61.45
FiddleSticks,Urgot,143,62,81,43.36
FiddleSticks,Twitch,250,102,148,40.8
FiddleSticks,Teemo,465,228,237,49.03
FiddleSticks,Singed,90,43,47,47.78
FiddleSticks,Zeri,121,41,80,33.88
FiddleSticks,TwistedFate,85,35,50,41.18
FiddleSticks,Brand,170,84,86,49.41
FiddleSticks,Vladimir,174,109,65,62.64
FiddleSticks,Vi,229,98,131,42.79
FiddleSticks,Ahri,428,214,214,50
FiddleSticks,Milio,172,73,99,42.44
FiddleSticks,Chogath,375,172,203,45.87
FiddleSticks,TahmKench,311,167,144,53.7
FiddleSticks,Gwen,190,112,78,58.95
FiddleSticks,Elise,185,62,123,33.51
FiddleSticks,Kennen,111,55,56,49.55
FiddleSticks,Shaco,279,163,116,58.42
FiddleSticks,Hecarim,156,71,85,45.51
FiddleSticks,Garen,380,190,190,50
FiddleSticks,Ryze,82,31,51,37.8
FiddleSticks,Blitzcrank,229,101,128,44.1
FiddleSticks,Rammus,74,45,29,60.81
FiddleSticks,Velkoz,174,87,87,50
FiddleSticks,Sett,577,298,279,51.65
FiddleSticks,Karma,203,122,81,60.1
FiddleSticks,Shen,180,99,81,55
FiddleSticks,LeeSin,294,173,121,58.84
FiddleSticks,Syndra,169,68,101,40.24
FiddleSticks,Zyra,170,79,91,46.47
FiddleSticks,Maokai,103,52,51,50.49
FiddleSticks,Gragas,169,103,66,60.95
FiddleSticks,Thresh,358,195,163,54.47
FiddleSticks,Katarina,189,64,125,33.86
FiddleSticks,Nasus,281,136,145,48.4
FiddleSticks,Xerath,127,55,72,43.31
FiddleSticks,Graves,141,86,55,60.99
FiddleSticks,Illaoi,203,117,86,57.64
FiddleSticks,Vayne,313,146,167,46.65
FiddleSticks,Trundle,199,118,81,59.3
FiddleSticks,Camille,104,48,56,46.15
FiddleSticks,Azir,121,77,44,63.64
FiddleSticks,Kalista,127,70,57,55.12
FiddleSticks,Lillia,225,121,104,53.78
FiddleSticks,Nunu,273,160,113,58.61
FiddleSticks,Sona,115,50,65,43.48
FiddleSticks,Taric,84,35,49,41.67
FiddleSticks,Viktor,192,81,111,42.19
FiddleSticks,Nidalee,89,57,32,64.04
FiddleSticks,Soraka,166,82,84,49.4
FiddleSticks,Diana,381,183,198,48.03
FiddleSticks,Zac,163,82,81,50.31
FiddleSticks,Corki,100,56,44,56
FiddleSticks,Heimerdinger,180,91,89,50.56
FiddleSticks,Akshan,121,72,49,59.5
FiddleSticks,Taliyah,104,35,69,33.65
FiddleSticks,Kayle,235,130,105,55.32
FiddleSticks,Orianna,114,64,50,56.14
FiddleSticks,Briar,335,158,177,47.16
FiddleSticks,Ambessa,207,93,114,44.93
FiddleSticks,MonkeyKing,180,83,97,46.11
FiddleSticks,Shyvana,64,41,23,64.06
FiddleSticks,Alistar,64,29,35,45.31
FiddleSticks,Smolder,250,143,107,57.2
FiddleSticks,Gnar,139,70,69,50.36
FiddleSticks,Renata,81,59,22,72.84
FiddleSticks,KogMaw,142,82,60,57.75
FiddleSticks,Ornn,104,46,58,44.23
FiddleSticks,Talon,221,133,88,60.18
FiddleSticks,Fiora,132,57,75,43.18
FiddleSticks,Kassadin,67,24,43,35.82
FiddleSticks,Draven,142,82,60,57.75
FiddleSticks,Jayce,116,57,59,49.14
FiddleSticks,Lissandra,60,17,43,28.33
FiddleSticks,Zoe,114,59,55,51.75
FiddleSticks,Olaf,68,22,46,32.35
FiddleSticks,Sion,218,130,88,59.63
FiddleSticks,Bard,120,54,66,45
FiddleSticks,JarvanIV,91,45,46,49.45
FiddleSticks,Fizz,152,77,75,50.66
FiddleSticks,Skarner,103,33,70,32.04
FiddleSticks,Zilean,62,25,37,40.32
FiddleSticks,Kled,54,37,17,68.52
FiddleSticks,Belveth,107,56,51,52.34
FiddleSticks,Annie,104,54,50,51.92
FiddleSticks,Rumble,61,34,27,55.74
FiddleSticks,RekSai,32,22,10,68.75
Smolder,Gangplank,165,68,97,41.21
Smolder,MasterYi,472,184,288,38.98
Smolder,Veigar,539,234,305,43.41
Smolder,Mel,984,491,493,49.9
Smolder,Swain,493,216,277,43.81
Smolder,Mordekaiser,738,304,434,41.19
Smolder,Amumu,431,179,252,41.53
Smolder,Sylas,465,226,239,48.6
Smolder,Xayah,252,138,114,54.76
Smolder,Ashe,687,320,367,46.58
Smolder,Renekton,261,116,145,44.44
Smolder,Kayn,709,346,363,48.8
Smolder,Vex,227,130,97,57.27
Smolder,Samira,503,278,225,55.27
Smolder,Lulu,365,170,195,46.58
Smolder,Teemo,662,305,357,46.07
Smolder,Briar,412,193,219,46.84
Smolder,Aurora,385,168,217,43.64
Smolder,Kaisa,653,339,314,51.91
Smolder,Karma,322,120,202,37.27
Smolder,KSante,173,75,98,43.35
Smolder,Darius,856,425,431,49.65
Smolder,Azir,163,82,81,50.31
Smolder,Aphelios,411,227,184,55.23
Smolder,Soraka,266,127,139,47.74
Smolder,Yone,893,419,474,46.92
Smolder,Nilah,235,102,133,43.4
Smolder,Irelia,419,236,183,56.32
Smolder,Nocturne,406,182,224,44.83
Smolder,Jayce,172,99,73,57.56
Smolder,Jhin,885,396,489,44.75
Smolder,Senna,368,172,196,46.74
Smolder,Tryndamere,260,138,122,53.08
Smolder,Zyra,283,142,141,50.18
Smolder,TahmKench,522,286,236,54.79
Smolder,Aatrox,485,245,240,50.52
Smolder,Belveth,136,66,70,48.53
Smolder,Hwei,329,186,143,56.53
Smolder,Jinx,1076,481,595,44.7
Smolder,Kayle,389,196,193,50.39
Smolder,Akali,384,198,186,51.56
Smolder,Yasuo,824,429,395,52.06
Smolder,Warwick,722,292,430,40.44
Smolder,Malzahar,473,222,251,46.93
Smolder,Tristana,438,209,229,47.72
Smolder,Sejuani,144,81,63,56.25
Smolder,Ahri,598,327,271,54.68
Smolder,Caitlyn,1304,589,715,45.17
Smolder,Lux,1257,577,680,45.9
Smolder,Maokai,201,99,102,49.25
Smolder,Corki,98,56,42,57.14
Smolder,Taric,141,56,85,39.72
Smolder,Singed,115,30,85,26.09
Smolder,Viego,556,274,282,49.28
Smolder,Vayne,506,298,208,58.89
Smolder,MissFortune,890,375,515,42.13
Smolder,Leona,381,202,179,53.02
Smolder,Ambessa,341,155,186,45.45
Smolder,Varus,367,163,204,44.41
Smolder,Graves,298,145,153,48.66
Smolder,Neeko,290,172,118,59.31
Smolder,Nasus,317,172,145,54.26
Smolder,Thresh,629,311,318,49.44
Smolder,Rammus,113,55,58,48.67
Smolder,Yuumi,454,221,233,48.68
Smolder,LeeSin,443,206,237,46.5
Smolder,Sona,142,68,74,47.89
Smolder,Anivia,150,70,80,46.67
Smolder,Braum,216,106,110,49.07
Smolder,DrMundo,296,143,153,48.31
Smolder,Nunu,354,167,187,47.18
Smolder,Malphite,364,166,198,45.6
Smolder,Pyke,527,273,254,51.8
Smolder,Skarner,120,57,63,47.5
Smolder,Ezreal,839,439,400,52.32
Smolder,Seraphine,515,238,277,46.21
Smolder,Draven,244,116,128,47.54
Smolder,Yorick,412,187,225,45.39
Smolder,Vi,401,213,188,53.12
Smolder,Katarina,466,277,189,59.44
Smolder,Nautilus,530,283,247,53.4
Smolder,Ziggs,224,92,132,41.07
Smolder,Sion,404,209,195,51.73
Smolder,Gragas,409,223,186,54.52
Smolder,MonkeyKing,207,78,129,37.68
Smolder,Akshan,152,47,105,30.92
Smolder,Sett,794,325,469,40.93
Smolder,Shaco,502,259,243,51.59
Smolder,KogMaw,162,86,76,53.09
Smolder,Milio,314,145,169,46.18
Smolder,Vladimir,293,151,142,51.54
Smolder,Gnar,203,94,109,46.31
Smolder,Chogath,720,340,380,47.22
Smolder,Illaoi,204,102,102,50
Smolder,Fizz,247,103,144,41.7
Smolder,Lucian,221,102,119,46.15
Smolder,Urgot,266,127,139,47.74
Smolder,Zed,491,246,245,50.1
Smolder,Alistar,144,77,67,53.47
Smolder,Evelynn,248,113,135,45.56
Smolder,Heimerdinger,240,136,104,56.67
Smolder,Morgana,580,301,279,51.9
Smolder,Garen,647,303,344,46.83
Smolder,Trundle,274,157,117,57.3
Smolder,Velkoz,257,126,131,49.03
Smolder,Kled,46,12,34,26.09
Smolder,Ekko,384,182,202,47.4
Smolder,Sivir,240,145,95,60.42
Smolder,Rengar,274,162,112,59.12
Smolder,Galio,381,144,237,37.8
Smolder,Ivern,110,72,38,65.45
Smolder,Shen,311,153,158,49.2
Smolder,Cassiopeia,189,95,94,50.26
Smolder,Rell,248,139,109,56.05
Smolder,Diana,674,382,292,56.68
Smolder,Talon,298,124,174,41.61
Smolder,Blitzcrank,331,169,162,51.06
Smolder,Lissandra,102,72,30,70.59
Smolder,Fiora,168,91,77,54.17
Smolder,Gwen,294,153,141,52.04
Smolder,Viktor,306,129,177,42.16
Smolder,Leblanc,222,144,78,64.86
Smolder,Ornn,243,127,116,52.26
Smolder,Jax,340,166,174,48.82
Smolder,Zoe,171,91,80,53.22
Smolder,Camille,157,81,76,51.59
Smolder,Taliyah,140,60,80,42.86
Smolder,Zeri,211,121,90,57.35
Smolder,Elise,264,135,129,51.14
Smolder,Twitch,408,180,228,44.12
Smolder,XinZhao,264,99,165,37.5
Smolder,Lillia,318,182,136,57.23
Smolder,Rakan,256,139,117,54.3
Smolder,Khazix,293,161,132,54.95
Smolder,Kennen,219,109,110,49.77
Smolder,Kalista,302,162,140,53.64
Smolder,Karthus,125,73,52,58.4
Smolder,Nami,476,248,228,52.1
Smolder,Pantheon,760,364,396,47.89
Smolder,FiddleSticks,250,107,143,42.8
Smolder,Annie,137,69,68,50.36
Smolder,Quinn,206,75,131,36.41
Smolder,Riven,194,100,94,51.55
Smolder,Volibear,492,232,260,47.15
Smolder,Kassadin,115,63,52,54.78
Smolder,Xerath,336,143,193,42.56
Smolder,Naafiri,204,94,110,46.08
Smolder,JarvanIV,210,98,112,46.67
Smolder,Orianna,130,71,59,54.62
Smolder,Nidalee,126,58,68,46.03
Smolder,Zac,162,93,69,57.41
Smolder,Brand,345,177,168,51.3
Smolder,TwistedFate,154,79,75,51.3
Smolder,Rumble,86,30,56,34.88
Smolder,Kindred,234,139,95,59.4
Smolder,Ryze,143,60,83,41.96
Smolder,Bard,145,48,97,33.1
Smolder,Syndra,298,155,143,52.01
Smolder,Hecarim,217,132,85,60.83
Smolder,Janna,127,66,61,51.97
Smolder,Poppy,249,137,112,55.02
Smolder,AurelionSol,179,81,98,45.25
Smolder,Shyvana,162,87,75,53.7
Smolder,Zilean,150,76,74,50.67
Smolder,Udyr,142,53,89,37.32
Smolder,Olaf,105,44,61,41.9
Smolder,Renata,159,57,102,35.85
Smolder,Qiyana,115,60,55,52.17
Smolder,RekSai,68,39,29,57.35
Nautilus,Gangplank,247,128,119,51.82
Nautilus,MasterYi,693,410,283,59.16
Nautilus,Veigar,801,357,444,44.57
Nautilus,Mel,1395,678,717,48.6
Nautilus,Swain,701,300,401,42.8
Nautilus,Illaoi,264,101,163,38.26
Nautilus,MonkeyKing,289,137,152,47.4
Nautilus,Yone,1228,572,656,46.58
Nautilus,Tristana,561,311,250,55.44
Nautilus,Morgana,901,428,473,47.5
Nautilus,Ivern,162,80,82,49.38
Nautilus,Jhin,1116,534,582,47.85
Nautilus,Mordekaiser,985,464,521,47.11
Nautilus,Amumu,665,298,367,44.81
Nautilus,Sylas,614,313,301,50.98
Nautilus,Xayah,454,212,242,46.7
Nautilus,Ashe,903,462,441,51.16
Nautilus,Urgot,323,147,176,45.51
Nautilus,Rengar,272,167,105,61.4
Nautilus,Ziggs,271,121,150,44.65
Nautilus,Trundle,366,127,239,34.7
Nautilus,Fiora,422,227,195,53.79
Nautilus,Poppy,469,218,251,46.48
Nautilus,Diana,796,400,396,50.25
Nautilus,Anivia,202,91,111,45.05
Nautilus,Caitlyn,1429,784,645,54.86
Nautilus,Thresh,977,530,447,54.25
Nautilus,Galio,518,247,271,47.68
Nautilus,Ezreal,1125,593,532,52.71
Nautilus,Chogath,833,405,428,48.62
Nautilus,KSante,219,108,111,49.32
Nautilus,Warwick,1038,481,557,46.34
Nautilus,Corki,184,83,101,45.11
Nautilus,Garen,985,487,498,49.44
Nautilus,FiddleSticks,390,200,190,51.28
Nautilus,Lux,1751,832,919,47.52
Nautilus,Brand,523,222,301,42.45
Nautilus,Kayn,953,438,515,45.96
Nautilus,Taliyah,221,113,108,51.13
Nautilus,Sivir,364,127,237,34.89
Nautilus,Soraka,384,176,208,45.83
Nautilus,Sion,474,213,261,44.94
Nautilus,AurelionSol,317,156,161,49.21
Nautilus,Nami,466,207,259,44.42
Nautilus,Zac,262,129,133,49.24
Nautilus,Nunu,539,282,257,52.32
Nautilus,Kaisa,956,510,446,53.35
Nautilus,Shen,411,205,206,49.88
Nautilus,Riven,281,168,113,59.79
Nautilus,Vi,528,214,314,40.53
Nautilus,MissFortune,1354,647,707,47.78
Nautilus,Ambessa,309,155,154,50.16
Nautilus,Yuumi,576,264,312,45.83
Nautilus,Qiyana,246,147,99,59.76
Nautilus,LeeSin,676,343,333,50.74
Nautilus,Quinn,190,92,98,48.42
Nautilus,Talon,420,212,208,50.48
Nautilus,Syndra,402,195,207,48.51
Nautilus,Sett,1054,475,579,45.07
Nautilus,DrMundo,419,172,247,41.05
Nautilus,Shaco,540,284,256,52.59
Nautilus,Viktor,383,189,194,49.35
Nautilus,Rammus,170,82,88,48.24
Nautilus,Katarina,532,303,229,56.95
Nautilus,Milio,419,132,287,31.5
Nautilus,Teemo,956,419,537,43.83
Nautilus,Ahri,771,342,429,44.36
Nautilus,Senna,589,283,306,48.05
Nautilus,Ekko,491,240,251,48.88
Nautilus,Aphelios,487,212,275,43.53
Nautilus,Nasus,454,197,257,43.39
Nautilus,Zilean,161,65,96,40.37
Nautilus,Volibear,666,273,393,40.99
Nautilus,XinZhao,291,160,131,54.98
Nautilus,Leona,566,277,289,48.94
Nautilus,Yasuo,1068,493,575,46.16
Nautilus,Jinx,1278,628,650,49.14
Nautilus,Karma,349,172,177,49.28
Nautilus,Braum,346,144,202,41.62
Nautilus,Skarner,258,140,118,54.26
Nautilus,Viego,845,420,425,49.7
Nautilus,Irelia,611,334,277,54.66
Nautilus,Zeri,298,134,164,44.97
Nautilus,Alistar,332,164,168,49.4
Nautilus,Akali,609,302,307,49.59
Nautilus,Pantheon,1084,494,590,45.57
Nautilus,Vex,390,208,182,53.33
Nautilus,Gragas,407,162,245,39.8
Nautilus,Lulu,516,238,278,46.12
Nautilus,Malphite,464,218,246,46.98
Nautilus,Samira,646,302,344,46.75
Nautilus,Blitzcrank,520,299,221,57.5
Nautilus,Hwei,416,193,223,46.39
Nautilus,Darius,1098,480,618,43.72
Nautilus,Malzahar,423,205,218,48.46
Nautilus,Sona,252,91,161,36.11
Nautilus,Zed,589,279,310,47.37
Nautilus,Heimerdinger,316,175,141,55.38
Nautilus,Udyr,277,150,127,54.15
Nautilus,Aatrox,673,380,293,56.46
Nautilus,Akshan,225,108,117,48
Nautilus,Zyra,388,174,214,44.85
Nautilus,KogMaw,281,119,162,42.35
Nautilus,Zoe,244,140,104,57.38
Nautilus,RekSai,69,31,38,44.93
Nautilus,Twitch,500,263,237,52.6
Nautilus,Yorick,612,314,298,51.31
Nautilus,Kalista,303,158,145,52.15
Nautilus,JarvanIV,261,102,159,39.08
Nautilus,Aurora,608,315,293,51.81
Nautilus,TahmKench,717,333,384,46.44
Nautilus,Kayle,461,199,262,43.17
Nautilus,Kindred,258,118,140,45.74
Nautilus,Jax,464,215,249,46.34
Nautilus,Xerath,394,143,251,36.29
Nautilus,Pyke,812,479,333,58.99
Nautilus,Fizz,307,152,155,49.51
Nautilus,Seraphine,641,328,313,51.17
Nautilus,Renekton,268,131,137,48.88
Nautilus,Leblanc,250,135,115,54
Nautilus,Vayne,718,388,330,54.04
Nautilus,Briar,558,248,310,44.44
Nautilus,Orianna,290,136,154,46.9
Nautilus,Draven,353,196,157,55.52
Nautilus,Ornn,327,148,179,45.26
Nautilus,Camille,174,105,69,60.34
Nautilus,Smolder,530,247,283,46.6
Nautilus,Janna,236,135,101,57.2
Nautilus,Ryze,176,60,116,34.09
Nautilus,Lucian,299,158,141,52.84
Nautilus,Singed,128,45,83,35.16
Nautilus,Elise,349,196,153,56.16
Nautilus,Belveth,198,86,112,43.43
Nautilus,Maokai,314,87,227,27.71
Nautilus,Cassiopeia,303,153,150,50.5
Nautilus,Velkoz,427,182,245,42.62
Nautilus,Gnar,277,112,165,40.43
Nautilus,Taric,147,71,76,48.3
Nautilus,Bard,218,91,127,41.74
Nautilus,Vladimir,342,138,204,40.35
Nautilus,Khazix,296,195,101,65.88
Nautilus,Renata,184,101,83,54.89
Nautilus,Varus,479,245,234,51.15
Nautilus,Graves,344,186,158,54.07
Nautilus,Evelynn,283,181,102,63.96
Nautilus,Kassadin,164,88,76,53.66
Nautilus,Gwen,429,226,203,52.68
Nautilus,Sejuani,255,109,146,42.75
Nautilus,Kennen,179,106,73,59.22
Nautilus,Neeko,494,288,206,58.3
Nautilus,Nocturne,552,303,249,54.89
Nautilus,Rakan,313,138,175,44.09
Nautilus,Naafiri,245,138,107,56.33
Nautilus,Hecarim,245,108,137,44.08
Nautilus,Karthus,169,59,110,34.91
Nautilus,Tryndamere,388,211,177,54.38
Nautilus,TwistedFate,167,84,83,50.3
Nautilus,Lillia,412,168,244,40.78
Nautilus,Nidalee,188,134,54,71.28
Nautilus,Annie,181,99,82,54.7
Nautilus,Nilah,329,123,206,37.39
Nautilus,Olaf,195,76,119,38.97
Nautilus,Azir,242,105,137,43.39
Nautilus,Kled,121,74,47,61.16
Nautilus,Lissandra,171,69,102,40.35
Nautilus,Shyvana,177,69,108,38.98
Nautilus,Rell,393,199,194,50.64
Nautilus,Jayce,252,144,108,57.14
Nautilus,Rumble,121,77,44,63.64
TahmKench,Gangplank,207,111,96,53.62
TahmKench,Brand,539,273,266,50.65
TahmKench,Irelia,630,329,301,52.22
TahmKench,Malzahar,510,200,310,39.22
TahmKench,Pyke,824,440,384,53.4
TahmKench,Gnar,345,187,158,54.2
TahmKench,Jax,573,288,285,50.26
TahmKench,Yasuo,1240,612,628,49.35
TahmKench,Caitlyn,1669,774,895,46.38
TahmKench,Neeko,468,255,213,54.49
TahmKench,Vayne,890,390,500,43.82
TahmKench,Nocturne,492,248,244,50.41
TahmKench,Kaisa,927,439,488,47.36
TahmKench,Galio,435,173,262,39.77
TahmKench,Blitzcrank,514,272,242,52.92
TahmKench,Volibear,772,330,442,42.75
TahmKench,Ekko,573,257,316,44.85
TahmKench,Yone,1282,635,647,49.53
TahmKench,Kalista,345,187,158,54.2
TahmKench,Tristana,637,304,333,47.72
TahmKench,Poppy,417,185,232,44.36
TahmKench,Veigar,868,439,429,50.58
TahmKench,Heimerdinger,382,191,191,50
TahmKench,Ziggs,298,135,163,45.3
TahmKench,Naafiri,312,126,186,40.38
TahmKench,Nunu,495,282,213,56.97
TahmKench,Zeri,277,143,134,51.62
TahmKench,Mordekaiser,1123,545,578,48.53
TahmKench,LeeSin,618,341,277,55.18
TahmKench,Kayle,409,230,179,56.23
TahmKench,Ezreal,1119,664,455,59.34
TahmKench,Morgana,826,339,487,41.04
TahmKench,TwistedFate,196,105,91,53.57
TahmKench,Nilah,329,183,146,55.62
TahmKench,Vi,548,275,273,50.18
TahmKench,Ahri,764,399,365,52.23
TahmKench,Darius,1477,710,767,48.07
TahmKench,Maokai,255,110,145,43.14
TahmKench,Yorick,561,254,307,45.28
TahmKench,Pantheon,1108,567,541,51.17
TahmKench,Samira,597,236,361,39.53
TahmKench,Nami,582,263,319,45.19
TahmKench,Kennen,225,134,91,59.56
TahmKench,Rammus,153,93,60,60.78
TahmKench,Chogath,1003,490,513,48.85
TahmKench,Ivern,151,69,82,45.7
TahmKench,Lux,2110,1007,1103,47.73
TahmKench,Kayn,978,482,496,49.28
TahmKench,Smolder,522,236,286,45.21
TahmKench,Thresh,789,395,394,50.06
TahmKench,Teemo,810,360,450,44.44
TahmKench,Khazix,358,212,146,59.22
TahmKench,MissFortune,1459,727,732,49.83
TahmKench,Rell,384,164,220,42.71
TahmKench,Aatrox,666,327,339,49.1
TahmKench,Shaco,507,271,236,53.45
TahmKench,Leblanc,199,115,84,57.79
TahmKench,Draven,296,155,141,52.36
TahmKench,Hwei,503,254,249,50.5
TahmKench,Cassiopeia,244,93,151,38.11
TahmKench,Riven,220,124,96,56.36
TahmKench,Senna,531,265,266,49.91
TahmKench,Jayce,264,156,108,59.09
TahmKench,Swain,765,302,463,39.48
TahmKench,Sion,571,310,261,54.29
TahmKench,Gragas,341,161,180,47.21
TahmKench,Zed,647,363,284,56.11
TahmKench,Jinx,1325,709,616,53.51
TahmKench,MasterYi,763,389,374,50.98
TahmKench,Garen,958,436,522,45.51
TahmKench,Sett,1061,498,563,46.94
TahmKench,Lucian,384,237,147,61.72
TahmKench,Sona,256,140,116,54.69
TahmKench,Vex,358,179,179,50
TahmKench,Malphite,564,288,276,51.06
TahmKench,Amumu,565,202,363,35.75
TahmKench,Ashe,1022,469,553,45.89
TahmKench,Velkoz,439,200,239,45.56
TahmKench,Kindred,353,180,173,50.99
TahmKench,AurelionSol,326,129,197,39.57
TahmKench,Urgot,341,160,181,46.92
TahmKench,Viego,818,382,436,46.7
TahmKench,Katarina,497,300,197,60.36
TahmKench,Elise,379,210,169,55.41
TahmKench,Annie,213,106,107,49.77
TahmKench,Nasus,521,218,303,41.84
TahmKench,Mel,1451,730,721,50.31
TahmKench,Rengar,334,199,135,59.58
TahmKench,Akali,615,317,298,51.54
TahmKench,KSante,228,138,90,60.53
TahmKench,Sylas,621,339,282,54.59
TahmKench,Trundle,474,212,262,44.73
TahmKench,Akshan,252,114,138,45.24
TahmKench,Corki,243,145,98,59.67
TahmKench,Ornn,314,144,170,45.86
TahmKench,Zoe,231,116,115,50.22
TahmKench,DrMundo,517,228,289,44.1
TahmKench,Viktor,516,278,238,53.88
TahmKench,Lulu,523,291,232,55.64
TahmKench,Vladimir,352,154,198,43.75
TahmKench,Evelynn,327,197,130,60.24
TahmKench,Aurora,580,300,280,51.72
TahmKench,Warwick,1010,501,509,49.6
TahmKench,FiddleSticks,311,144,167,46.3
TahmKench,Nautilus,717,384,333,53.56
TahmKench,Yuumi,568,323,245,56.87
TahmKench,Ryze,197,113,84,57.36
TahmKench,Twitch,498,256,242,51.41
TahmKench,Xerath,399,192,207,48.12
TahmKench,XinZhao,393,206,187,52.42
TahmKench,JarvanIV,243,121,122,49.79
TahmKench,Zyra,446,211,235,47.31
TahmKench,Sivir,271,126,145,46.49
TahmKench,Leona,486,214,272,44.03
TahmKench,Karma,402,168,234,41.79
TahmKench,Illaoi,379,140,239,36.94
TahmKench,Jhin,1094,453,641,41.41
TahmKench,Aphelios,422,208,214,49.29
TahmKench,Graves,358,167,191,46.65
TahmKench,Briar,702,329,373,46.87
TahmKench,Singed,211,79,132,37.44
TahmKench,Belveth,192,109,83,56.77
TahmKench,Janna,216,84,132,38.89
TahmKench,Zac,212,80,132,37.74
TahmKench,Bard,237,142,95,59.92
TahmKench,Diana,874,390,484,44.62
TahmKench,Soraka,388,163,225,42.01
TahmKench,Ambessa,429,190,239,44.29
TahmKench,Qiyana,208,104,104,50
TahmKench,Fiora,359,173,186,48.19
TahmKench,Varus,481,226,255,46.99
TahmKench,Rakan,365,190,175,52.05
TahmKench,Azir,219,143,76,65.3
TahmKench,Tryndamere,341,197,144,57.77
TahmKench,Milio,343,174,169,50.73
TahmKench,Hecarim,311,187,124,60.13
TahmKench,Udyr,203,86,117,42.36
TahmKench,Lillia,538,225,313,41.82
TahmKench,Lissandra,177,96,81,54.24
TahmKench,Nidalee,206,108,98,52.43
TahmKench,Sejuani,210,94,116,44.76
TahmKench,Olaf,193,107,86,55.44
TahmKench,Camille,239,110,129,46.03
TahmKench,Kassadin,149,64,85,42.95
TahmKench,Syndra,341,173,168,50.73
TahmKench,Seraphine,737,380,357,51.56
TahmKench,Braum,386,174,212,45.08
TahmKench,Xayah,407,191,216,46.93
TahmKench,Alistar,215,115,100,53.49
TahmKench,Gwen,470,264,206,56.17
TahmKench,Skarner,169,98,71,57.99
TahmKench,Karthus,157,87,70,55.41
TahmKench,Talon,355,217,138,61.13
TahmKench,Taliyah,207,119,88,57.49
TahmKench,Shyvana,119,49,70,41.18
TahmKench,Fizz,290,123,167,42.41
TahmKench,KogMaw,253,138,115,54.55
TahmKench,Anivia,158,79,79,50
TahmKench,Renekton,281,131,150,46.62
TahmKench,Orianna,255,139,116,54.51
TahmKench,Shen,410,184,226,44.88
TahmKench,MonkeyKing,374,176,198,47.06
TahmKench,Quinn,200,97,103,48.5
TahmKench,Renata,174,91,83,52.3
TahmKench,Kled,148,51,97,34.46
TahmKench,RekSai,65,26,39,40
TahmKench,Rumble,110,62,48,56.36
TahmKench,Zilean,177,106,71,59.89
TahmKench,Taric,150,63,87,42
Aphelios,Gangplank,140,63,77,45
Aphelios,Brand,288,121,167,42.01
Aphelios,Irelia,447,231,216,51.68
Aphelios,Malzahar,404,139,265,34.41
Aphelios,Pyke,531,282,249,53.11
Aphelios,Kayle,334,160,174,47.9
Aphelios,Viego,484,270,214,55.79
Aphelios,Jinx,967,452,515,46.74
Aphelios,Thresh,561,281,280,50.09
Aphelios,Warwick,747,314,433,42.03
Aphelios,Singed,98,48,50,48.98
Aphelios,Ryze,92,43,49,46.74
Aphelios,Samira,443,223,220,50.34
Aphelios,Soraka,301,168,133,55.81
Aphelios,Sett,598,253,345,42.31
Aphelios,Volibear,417,271,146,64.99
Aphelios,Ambessa,233,111,122,47.64
Aphelios,Smolder,411,184,227,44.77
Aphelios,Swain,476,204,272,42.86
Aphelios,Malphite,328,147,181,44.82
Aphelios,Sion,416,177,239,42.55
Aphelios,Alistar,91,39,52,42.86
Aphelios,Jax,283,128,155,45.23
Aphelios,FiddleSticks,221,120,101,54.3
Aphelios,Heimerdinger,252,113,139,44.84
Aphelios,Ashe,727,356,371,48.97
Aphelios,Fiora,206,102,104,49.51
Aphelios,Shaco,351,151,200,43.02
Aphelios,Fizz,224,150,74,66.96
Aphelios,Tristana,350,181,169,51.71
Aphelios,Rakan,182,97,85,53.3
Aphelios,Garen,649,380,269,58.55
Aphelios,Graves,180,70,110,38.89
Aphelios,Aurora,369,150,219,40.65
Aphelios,Nilah,247,129,118,52.23
Aphelios,Hwei,350,185,165,52.86
Aphelios,Talon,245,138,107,56.33
Aphelios,LeeSin,487,239,248,49.08
Aphelios,Jhin,739,367,372,49.66
Aphelios,Senna,425,186,239,43.76
Aphelios,XinZhao,187,89,98,47.59
Aphelios,Nautilus,487,275,212,56.47
Aphelios,Teemo,598,236,362,39.46
Aphelios,Yasuo,845,404,441,47.81
Aphelios,Rengar,165,99,66,60
Aphelios,Anivia,77,41,36,53.25
Aphelios,Xayah,245,153,92,62.45
Aphelios,Galio,244,100,144,40.98
Aphelios,Diana,624,322,302,51.6
Aphelios,Veigar,463,227,236,49.03
Aphelios,Sejuani,177,92,85,51.98
Aphelios,Sylas,441,213,228,48.3
Aphelios,Lux,1057,496,561,46.93
Aphelios,Tryndamere,241,135,106,56.02
Aphelios,MasterYi,398,220,178,55.28
Aphelios,Orianna,248,119,129,47.98
Aphelios,Darius,741,405,336,54.66
Aphelios,Caitlyn,1042,493,549,47.31
Aphelios,Sona,166,56,110,33.73
Aphelios,DrMundo,253,131,122,51.78
Aphelios,Mordekaiser,693,336,357,48.48
Aphelios,Akali,453,265,188,58.5
Aphelios,Lucian,292,138,154,47.26
Aphelios,Nami,361,181,180,50.14
Aphelios,KSante,189,116,73,61.38
Aphelios,Belveth,156,63,93,40.38
Aphelios,Riven,147,79,68,53.74
Aphelios,Yuumi,370,177,193,47.84
Aphelios,Kaisa,605,374,231,61.82
Aphelios,Kayn,623,278,345,44.62
Aphelios,Amumu,455,168,287,36.92
Aphelios,Chogath,506,273,233,53.95
Aphelios,Morgana,524,255,269,48.66
Aphelios,Camille,158,79,79,50
Aphelios,Lillia,272,145,127,53.31
Aphelios,Aatrox,357,182,175,50.98
Aphelios,Elise,222,121,101,54.5
Aphelios,Seraphine,423,211,212,49.88
Aphelios,Gragas,252,114,138,45.24
Aphelios,Milio,289,119,170,41.18
Aphelios,Vladimir,210,115,95,54.76
Aphelios,Velkoz,278,154,124,55.4
Aphelios,Khazix,273,117,156,42.86
Aphelios,Mel,971,542,429,55.82
Aphelios,Vex,251,147,104,58.57
Aphelios,MissFortune,899,429,470,47.72
Aphelios,Viktor,238,106,132,44.54
Aphelios,Nocturne,352,146,206,41.48
Aphelios,Yone,798,454,344,56.89
Aphelios,Draven,211,118,93,55.92
Aphelios,Poppy,218,115,103,52.75
Aphelios,Kalista,291,128,163,43.99
Aphelios,Neeko,327,199,128,60.86
Aphelios,Renata,129,62,67,48.06
Aphelios,Yorick,441,188,253,42.63
Aphelios,Zed,534,300,234,56.18
Aphelios,Evelynn,260,139,121,53.46
Aphelios,Leblanc,154,74,80,48.05
Aphelios,TahmKench,422,214,208,50.71
Aphelios,RekSai,44,20,24,45.45
Aphelios,Pantheon,611,340,271,55.65
Aphelios,Ekko,306,113,193,36.93
Aphelios,Urgot,153,71,82,46.41
Aphelios,Briar,432,219,213,50.69
Aphelios,Ezreal,757,379,378,50.07
Aphelios,Zac,152,90,62,59.21
Aphelios,Bard,222,117,105,52.7
Aphelios,Jayce,201,117,84,58.21
Aphelios,Twitch,383,214,169,55.87
Aphelios,Shyvana,114,54,60,47.37
Aphelios,Zilean,110,54,56,49.09
Aphelios,Gnar,110,61,49,55.45
Aphelios,Kindred,295,127,168,43.05
Aphelios,Cassiopeia,196,97,99,49.49
Aphelios,Karthus,139,89,50,64.03
Aphelios,Leona,281,135,146,48.04
Aphelios,Kled,87,43,44,49.43
Aphelios,MonkeyKing,173,105,68,60.69
Aphelios,Vi,368,191,177,51.9
Aphelios,Nasus,359,157,202,43.73
Aphelios,Rell,237,123,114,51.9
Aphelios,Illaoi,176,65,111,36.93
Aphelios,Maokai,187,110,77,58.82
Aphelios,Qiyana,149,86,63,57.72
Aphelios,Ahri,582,294,288,50.52
Aphelios,Vayne,467,238,229,50.96
Aphelios,Annie,137,65,72,47.45
Aphelios,Hecarim,114,76,38,66.67
Aphelios,Naafiri,182,72,110,39.56
Aphelios,Lulu,317,219,98,69.09
Aphelios,Olaf,111,54,57,48.65
Aphelios,Katarina,309,153,156,49.51
Aphelios,Quinn,133,71,62,53.38
Aphelios,Ziggs,229,107,122,46.72
Aphelios,Braum,146,62,84,42.47
Aphelios,Xerath,239,106,133,44.35
Aphelios,Shen,250,134,116,53.6
Aphelios,Zoe,242,132,110,54.55
Aphelios,Zyra,298,119,179,39.93
Aphelios,AurelionSol,155,77,78,49.68
Aphelios,Gwen,226,124,102,54.87
Aphelios,JarvanIV,125,64,61,51.2
Aphelios,Taliyah,122,97,25,79.51
Aphelios,Corki,150,90,60,60
Aphelios,Nunu,316,153,163,48.42
Aphelios,Udyr,135,69,66,51.11
Aphelios,Rumble,72,35,37,48.61
Aphelios,Sivir,223,88,135,39.46
Aphelios,Varus,347,169,178,48.7
Aphelios,Kennen,213,120,93,56.34
Aphelios,Azir,130,72,58,55.38
Aphelios,Blitzcrank,260,120,140,46.15
Aphelios,Ivern,109,47,62,43.12
Aphelios,KogMaw,86,32,54,37.21
Aphelios,Trundle,253,147,106,58.1
Aphelios,Karma,333,150,183,45.05
Aphelios,Rammus,142,67,75,47.18
Aphelios,Janna,165,49,116,29.7
Aphelios,Syndra,173,74,99,42.77
Aphelios,Lissandra,119,41,78,34.45
Aphelios,Akshan,159,69,90,43.4
Aphelios,TwistedFate,190,104,86,54.74
Aphelios,Zeri,177,81,96,45.76
Aphelios,Nidalee,147,88,59,59.86
Aphelios,Skarner,125,60,65,48
Aphelios,Ornn,169,61,108,36.09
Aphelios,Kassadin,94,33,61,35.11
Aphelios,Renekton,175,89,86,50.86
Aphelios,Taric,100,61,39,61
Malzahar,TahmKench,510,310,200,60.78
Malzahar,Malphite,367,186,181,50.68
Malzahar,Yasuo,988,493,495,49.9
Malzahar,Aphelios,404,265,139,65.59
Malzahar,TwistedFate,208,105,103,50.48
Malzahar,Renekton,190,94,96,49.47
Malzahar,JarvanIV,188,74,114,39.36
Malzahar,Mel,995,536,459,53.87
Malzahar,Jhin,811,409,402,50.43
Malzahar,Sylas,355,200,155,56.34
Malzahar,Darius,809,480,329,59.33
Malzahar,Rengar,205,132,73,64.39
Malzahar,Syndra,267,125,142,46.82
Malzahar,Caitlyn,1066,613,453,57.5
Malzahar,Lux,1189,675,514,56.77
Malzahar,Chogath,657,361,296,54.95
Malzahar,Morgana,560,324,236,57.86
Malzahar,Gnar,196,115,81,58.67
Malzahar,Viego,522,299,223,57.28
Malzahar,Yone,755,413,342,54.7
Malzahar,Kaisa,596,323,273,54.19
Malzahar,Sett,797,442,355,55.46
Malzahar,Sion,337,156,181,46.29
Malzahar,Samira,381,260,121,68.24
Malzahar,Alistar,136,69,67,50.74
Malzahar,Viktor,333,209,124,62.76
Malzahar,Nocturne,374,207,167,55.35
Malzahar,Annie,112,74,38,66.07
Malzahar,KogMaw,146,65,81,44.52
Malzahar,Kindred,306,187,119,61.11
Malzahar,Veigar,517,285,232,55.13
Malzahar,Corki,142,94,48,66.2
Malzahar,Pantheon,800,475,325,59.38
Malzahar,Jax,353,241,112,68.27
Malzahar,Hwei,368,192,176,52.17
Malzahar,Bard,126,91,35,72.22
Malzahar,FiddleSticks,255,151,104,59.22
Malzahar,Cassiopeia,189,89,100,47.09
Malzahar,Milio,214,108,106,50.47
Malzahar,Quinn,149,73,76,48.99
Malzahar,Talon,327,199,128,60.86
Malzahar,Olaf,112,58,54,51.79
Malzahar,Aatrox,403,248,155,61.54
Malzahar,Katarina,381,262,119,68.77
Malzahar,Smolder,473,251,222,53.07
Malzahar,Braum,183,78,105,42.62
Malzahar,Shaco,441,260,181,58.96
Malzahar,Riven,131,86,45,65.65
Malzahar,Senna,449,240,209,53.45
Malzahar,Jayce,221,136,85,61.54
Malzahar,Rammus,188,111,77,59.04
Malzahar,Swain,620,305,315,49.19
Malzahar,Kayn,717,441,276,61.51
Malzahar,Ahri,647,385,262,59.51
Malzahar,Tristana,382,216,166,56.54
Malzahar,Nasus,308,193,115,62.66
Malzahar,Amumu,434,220,214,50.69
Malzahar,Naafiri,284,122,162,42.96
Malzahar,MissFortune,908,504,404,55.51
Malzahar,Xerath,336,182,154,54.17
Malzahar,Trundle,214,98,116,45.79
Malzahar,Irelia,410,210,200,51.22
Malzahar,Evelynn,239,166,73,69.46
Malzahar,Anivia,152,101,51,66.45
Malzahar,Poppy,293,125,168,42.66
Malzahar,Fiora,213,128,85,60.09
Malzahar,Diana,641,361,280,56.32
Malzahar,Ashe,760,461,299,60.66
Malzahar,Volibear,538,293,245,54.46
Malzahar,Seraphine,491,238,253,48.47
Malzahar,Azir,173,90,83,52.02
Malzahar,Ziggs,198,104,94,52.53
Malzahar,Lulu,398,194,204,48.74
Malzahar,Mordekaiser,651,322,329,49.46
Malzahar,Leblanc,165,103,62,62.42
Malzahar,Shen,355,168,187,47.32
Malzahar,Pyke,487,309,178,63.45
Malzahar,Nautilus,423,218,205,51.54
Malzahar,MonkeyKing,215,120,95,55.81
Malzahar,Akali,499,321,178,64.33
Malzahar,Ezreal,829,482,347,58.14
Malzahar,Zed,431,223,208,51.74
Malzahar,Draven,237,145,92,61.18
Malzahar,Yuumi,385,192,193,49.87
Malzahar,Jinx,1004,504,500,50.2
Malzahar,Elise,189,108,81,57.14
Malzahar,Gangplank,246,139,107,56.5
Malzahar,Xayah,298,174,124,58.39
Malzahar,Sona,167,56,111,33.53
Malzahar,Soraka,264,133,131,50.38
Malzahar,Akshan,214,96,118,44.86
Malzahar,Illaoi,206,119,87,57.77
Malzahar,Nidalee,134,78,56,58.21
Malzahar,Orianna,225,124,101,55.11
Malzahar,Zyra,219,117,102,53.42
Malzahar,Varus,400,197,203,49.25
Malzahar,Nilah,214,126,88,58.88
Malzahar,Karma,305,153,152,50.16
Malzahar,Velkoz,245,155,90,63.27
Malzahar,Yorick,406,189,217,46.55
Malzahar,Warwick,681,347,334,50.95
Malzahar,MasterYi,376,191,185,50.8
Malzahar,Nunu,451,238,213,52.77
Malzahar,Gragas,239,123,116,51.46
Malzahar,Gwen,298,164,134,55.03
Malzahar,Vi,378,218,160,57.67
Malzahar,Lillia,273,156,117,57.14
Malzahar,Neeko,332,159,173,47.89
Malzahar,Briar,453,209,244,46.14
Malzahar,Urgot,206,98,108,47.57
Malzahar,Camille,114,58,56,50.88
Malzahar,Tryndamere,275,187,88,68
Malzahar,Teemo,705,353,352,50.07
Malzahar,Heimerdinger,215,124,91,57.67
Malzahar,Lissandra,101,74,27,73.27
Malzahar,Kalista,233,119,114,51.07
Malzahar,DrMundo,263,121,142,46.01
Malzahar,Shyvana,159,74,85,46.54
Malzahar,Garen,644,339,305,52.64
Malzahar,Singed,148,100,48,67.57
Malzahar,Thresh,686,404,282,58.89
Malzahar,Udyr,167,89,78,53.29
Malzahar,Kayle,347,180,167,51.87
Malzahar,Leona,314,189,125,60.19
Malzahar,Zeri,216,126,90,58.33
Malzahar,Kassadin,86,52,34,60.47
Malzahar,Rell,280,131,149,46.79
Malzahar,Ornn,198,131,67,66.16
Malzahar,Zoe,237,179,58,75.53
Malzahar,Ekko,325,186,139,57.23
Malzahar,Vayne,403,197,206,48.88
Malzahar,Kennen,192,89,103,46.35
Malzahar,Aurora,469,278,191,59.28
Malzahar,Brand,310,180,130,58.06
Malzahar,KSante,168,102,66,60.71
Malzahar,Twitch,323,182,141,56.35
Malzahar,Ryze,148,99,49,66.89
Malzahar,Lucian,251,138,113,54.98
Malzahar,Blitzcrank,392,252,140,64.29
Malzahar,LeeSin,423,265,158,62.65
Malzahar,Taric,86,35,51,40.7
Malzahar,Vladimir,217,111,106,51.15
Malzahar,Maokai,213,87,126,40.85
Malzahar,Vex,234,137,97,58.55
Malzahar,Zilean,146,101,45,69.18
Malzahar,Ambessa,242,134,108,55.37
Malzahar,Karthus,123,86,37,69.92
Malzahar,Hecarim,133,66,67,49.62
Malzahar,Sejuani,191,101,90,52.88
Malzahar,Galio,367,214,153,58.31
Malzahar,Nami,455,249,206,54.73
Malzahar,Graves,270,135,135,50
Malzahar,XinZhao,234,133,101,56.84
Malzahar,Skarner,127,76,51,59.84
Malzahar,Qiyana,144,96,48,66.67
Malzahar,Rumble,59,33,26,55.93
Malzahar,Sivir,180,90,90,50
Malzahar,Fizz,258,129,129,50
Malzahar,AurelionSol,286,146,140,51.05
Malzahar,Renata,167,109,58,65.27
Malzahar,Rakan,254,119,135,46.85
Malzahar,Khazix,266,151,115,56.77
Malzahar,Ivern,80,50,30,62.5
Malzahar,Zac,136,87,49,63.97
Malzahar,Kled,69,38,31,55.07
Malzahar,RekSai,90,58,32,64.44
Malzahar,Belveth,145,118,27,81.38
Malzahar,Taliyah,104,58,46,55.77
Malzahar,Janna,124,70,54,56.45
Amumu,Trundle,414,183,231,44.2
Amumu,MasterYi,636,339,297,53.3
Amumu,Veigar,735,382,353,51.97
Amumu,Jhin,1009,508,501,50.35
Amumu,Soraka,346,155,191,44.8
Amumu,Warwick,1104,573,531,51.9
Amumu,Briar,578,340,238,58.82
Amumu,Yasuo,962,495,467,51.46
Amumu,Irelia,536,315,221,58.77
Amumu,Lux,1681,927,754,55.15
Amumu,Urgot,263,162,101,61.6
Amumu,Kayn,815,452,363,55.46
Amumu,Twitch,481,272,209,56.55
Amumu,Neeko,473,253,220,53.49
Amumu,Yone,1113,672,441,60.38
Amumu,TwistedFate,180,108,72,60
Amumu,Smolder,431,252,179,58.47
Amumu,Nautilus,665,367,298,55.19
Amumu,Teemo,830,408,422,49.16
Amumu,LeeSin,456,242,214,53.07
Amumu,Nami,586,307,279,52.39
Amumu,Mordekaiser,914,426,488,46.61
Amumu,Diana,854,459,395,53.75
Amumu,MissFortune,1262,681,581,53.96
Amumu,Karma,345,195,150,56.52
Amumu,Nasus,412,191,221,46.36
Amumu,Khazix,358,222,136,62.01
Amumu,Lulu,444,270,174,60.81
Amumu,Kindred,325,213,112,65.54
Amumu,Fizz,277,149,128,53.79
Amumu,Gnar,234,165,69,70.51
Amumu,Caitlyn,1287,697,590,54.16
Amumu,Sion,481,268,213,55.72
Amumu,Akshan,188,136,52,72.34
Amumu,Jinx,1300,718,582,55.23
Amumu,Bard,217,102,115,47
Amumu,DrMundo,400,225,175,56.25
Amumu,Shaco,498,308,190,61.85
Amumu,Leblanc,185,100,85,54.05
Amumu,Xayah,385,243,142,63.12
Amumu,Yorick,448,204,244,45.54
Amumu,Volibear,633,358,275,56.56
Amumu,Cassiopeia,281,156,125,55.52
Amumu,Rell,399,219,180,54.89
Amumu,Thresh,623,361,262,57.95
Amumu,FiddleSticks,296,179,117,60.47
Amumu,Zed,559,306,253,54.74
Amumu,Viktor,421,242,179,57.48
Amumu,Pyke,699,371,328,53.08
Amumu,Olaf,174,116,58,66.67
Amumu,Hecarim,246,158,88,64.23
Amumu,Tristana,480,247,233,51.46
Amumu,Braum,254,149,105,58.66
Amumu,Kennen,199,132,67,66.33
Amumu,XinZhao,345,228,117,66.09
Amumu,Akali,634,396,238,62.46
Amumu,Kaisa,848,521,327,61.44
Amumu,Gangplank,247,153,94,61.94
Amumu,Nocturne,587,299,288,50.94
Amumu,Corki,160,85,75,53.13
Amumu,Jax,399,250,149,62.66
Amumu,Katarina,424,254,170,59.91
Amumu,Chogath,787,435,352,55.27
Amumu,Galio,393,207,186,52.67
Amumu,Hwei,393,192,201,48.85
Amumu,Ahri,775,450,325,58.06
Amumu,Malzahar,434,214,220,49.31
Amumu,Talon,345,214,131,62.03
Amumu,Rakan,280,159,121,56.79
Amumu,Senna,552,279,273,50.54
Amumu,Vayne,567,279,288,49.21
Amumu,Sejuani,230,110,120,47.83
Amumu,TahmKench,565,363,202,64.25
Amumu,Brand,338,179,159,52.96
Amumu,Mel,1186,644,542,54.3
Amumu,Zyra,378,211,167,55.82
Amumu,Varus,564,300,264,53.19
Amumu,Shyvana,185,81,104,43.78
Amumu,Garen,899,480,419,53.39
Amumu,Singed,146,72,74,49.32
Amumu,Ezreal,852,463,389,54.34
Amumu,Jayce,193,107,86,55.44
Amumu,Aatrox,410,245,165,59.76
Amumu,JarvanIV,220,94,126,42.73
Amumu,Karthus,162,98,64,60.49
Amumu,Orianna,276,159,117,57.61
Amumu,Milio,344,212,132,61.63
Amumu,Rammus,202,95,107,47.03
Amumu,Ashe,948,470,478,49.58
Amumu,Seraphine,578,352,226,60.9
Amumu,Aurora,533,284,249,53.28
Amumu,Aphelios,455,287,168,63.08
Amumu,KSante,178,115,63,64.61
Amumu,Vladimir,344,187,157,54.36
Amumu,Nilah,295,190,105,64.41
Amumu,Yuumi,536,243,293,45.34
Amumu,Vex,369,177,192,47.97
Amumu,Morgana,750,362,388,48.27
Amumu,Skarner,140,101,39,72.14
Amumu,Ryze,184,95,89,51.63
Amumu,Elise,308,211,97,68.51
Amumu,Vi,441,256,185,58.05
Amumu,Draven,250,131,119,52.4
Amumu,Kled,130,66,64,50.77
Amumu,Poppy,298,189,109,63.42
Amumu,AurelionSol,330,191,139,57.88
Amumu,Sylas,571,312,259,54.64
Amumu,Xerath,423,242,181,57.21
Amumu,Darius,1050,596,454,56.76
Amumu,Malphite,425,217,208,51.06
Amumu,Viego,744,454,290,61.02
Amumu,Maokai,253,98,155,38.74
Amumu,Rengar,216,98,118,45.37
Amumu,Syndra,256,108,148,42.19
Amumu,Lucian,335,173,162,51.64
Amumu,Lissandra,102,47,55,46.08
Amumu,Samira,563,316,247,56.13
Amumu,Kayle,441,231,210,52.38
Amumu,Ambessa,283,125,158,44.17
Amumu,Taliyah,171,103,68,60.23
Amumu,Ekko,418,228,190,54.55
Amumu,Heimerdinger,353,194,159,54.96
Amumu,Blitzcrank,437,240,197,54.92
Amumu,Zoe,278,172,106,61.87
Amumu,Evelynn,277,168,109,60.65
Amumu,Ornn,226,122,104,53.98
Amumu,Naafiri,248,137,111,55.24
Amumu,Leona,402,263,139,65.42
Amumu,Tryndamere,290,144,146,49.66
Amumu,Illaoi,309,188,121,60.84
Amumu,Annie,230,119,111,51.74
Amumu,Sona,182,126,56,69.23
Amumu,Lillia,387,201,186,51.94
Amumu,Shen,361,195,166,54.02
Amumu,Riven,238,137,101,57.56
Amumu,Ziggs,238,110,128,46.22
Amumu,Fiora,267,116,151,43.45
Amumu,Nunu,585,280,305,47.86
Amumu,Janna,152,56,96,36.84
Amumu,Sett,1011,580,431,57.37
Amumu,Gwen,420,217,203,51.67
Amumu,Swain,600,299,301,49.83
Amumu,Belveth,195,105,90,53.85
Amumu,Camille,162,103,59,63.58
Amumu,Sivir,277,180,97,64.98
Amumu,Zac,257,130,127,50.58
Amumu,Kassadin,107,67,40,62.62
Amumu,Nidalee,166,107,59,64.46
Amumu,Qiyana,210,145,65,69.05
Amumu,Azir,160,82,78,51.25
Amumu,Renata,133,66,67,49.62
Amumu,Pantheon,954,500,454,52.41
Amumu,Taric,138,67,71,48.55
Amumu,KogMaw,205,103,102,50.24
Amumu,Zilean,145,77,68,53.1
Amumu,Quinn,179,110,69,61.45
Amumu,Gragas,358,203,155,56.7
Amumu,Velkoz,342,213,129,62.28
Amumu,Graves,391,212,179,54.22
Amumu,Alistar,148,62,86,41.89
Amumu,Renekton,260,123,137,47.31
Amumu,Anivia,185,104,81,56.22
Amumu,Rumble,116,52,64,44.83
Amumu,Udyr,203,104,99,51.23
Amumu,MonkeyKing,284,130,154,45.77
Amumu,Ivern,122,44,78,36.07
Amumu,Kalista,229,121,108,52.84
Amumu,Zeri,262,168,94,64.12
Amumu,RekSai,41,32,9,78.05
Trundle,Kayn,470,246,224,52.34
Trundle,Zed,286,188,98,65.73
Trundle,Sona,150,78,72,52
Trundle,Kaisa,411,235,176,57.18
Trundle,Amumu,414,231,183,55.8
Trundle,Mordekaiser,609,332,277,54.52
Trundle,Udyr,121,60,61,49.59
Trundle,Yorick,373,162,211,43.43
Trundle,Sivir,120,60,60,50
Trundle,Nautilus,366,239,127,65.3
Trundle,Volibear,471,251,220,53.29
Trundle,Veigar,355,175,180,49.3
Trundle,Caitlyn,833,382,451,45.86
Trundle,Warwick,607,322,285,53.05
Trundle,Yone,628,332,296,52.87
Trundle,Kalista,115,83,32,72.17
Trundle,Thresh,421,236,185,56.06
Trundle,Olaf,86,44,42,51.16
Trundle,Hecarim,123,75,48,60.98
Trundle,Tristana,221,127,94,57.47
Trundle,Braum,210,116,94,55.24
Trundle,Chogath,455,239,216,52.53
Trundle,Briar,395,208,187,52.66
Trundle,Jayce,155,83,72,53.55
Trundle,Samira,350,187,163,53.43
Trundle,Lulu,240,146,94,60.83
Trundle,MissFortune,808,450,358,55.69
Trundle,Neeko,238,127,111,53.36
Trundle,Heimerdinger,153,96,57,62.75
Trundle,Talon,193,108,85,55.96
Trundle,LeeSin,229,132,97,57.64
Trundle,Garen,515,250,265,48.54
Trundle,Jhin,567,294,273,51.85
Trundle,Senna,272,147,125,54.04
Trundle,Pyke,300,159,141,53
Trundle,XinZhao,228,110,118,48.25
Trundle,Teemo,415,201,214,48.43
Trundle,Yasuo,556,307,249,55.22
Trundle,Gnar,112,58,54,51.79
Trundle,Graves,168,83,85,49.4
Trundle,Twitch,339,164,175,48.38
Trundle,Malzahar,214,116,98,54.21
Trundle,Ekko,314,201,113,64.01
Trundle,Galio,223,135,88,60.54
Trundle,Lux,975,524,451,53.74
Trundle,Darius,695,384,311,55.25
Trundle,Diana,381,189,192,49.61
Trundle,Pantheon,477,253,224,53.04
Trundle,Jax,310,134,176,43.23
Trundle,Ornn,152,83,69,54.61
Trundle,Ambessa,184,112,72,60.87
Trundle,Zoe,158,106,52,67.09
Trundle,Swain,365,214,151,58.63
Trundle,Mel,797,415,382,52.07
Trundle,Yuumi,320,187,133,58.44
Trundle,TahmKench,474,262,212,55.27
Trundle,Irelia,259,114,145,44.02
Trundle,Poppy,223,129,94,57.85
Trundle,Kled,102,68,34,66.67
Trundle,Viego,382,182,200,47.64
Trundle,Lucian,172,101,71,58.72
Trundle,Sejuani,180,82,98,45.56
Trundle,Jinx,667,351,316,52.62
Trundle,Shaco,281,147,134,52.31
Trundle,Aurora,243,110,133,45.27
Trundle,Aatrox,258,147,111,56.98
Trundle,Anivia,112,58,54,51.79
Trundle,Kindred,181,108,73,59.67
Trundle,Blitzcrank,295,186,109,63.05
Trundle,Renekton,179,79,100,44.13
Trundle,Rengar,138,74,64,53.62
Trundle,Leblanc,109,50,59,45.87
Trundle,Seraphine,506,269,237,53.16
Trundle,Gwen,181,112,69,61.88
Trundle,MasterYi,360,166,194,46.11
Trundle,Ryze,86,32,54,37.21
Trundle,Katarina,306,203,103,66.34
Trundle,Brand,214,116,98,54.21
Trundle,Tryndamere,249,117,132,46.99
Trundle,Ahri,451,235,216,52.11
Trundle,Draven,170,90,80,52.94
Trundle,Bard,133,77,56,57.89
Trundle,Morgana,418,211,207,50.48
Trundle,Lillia,142,83,59,58.45
Trundle,Shen,223,125,98,56.05
Trundle,Nocturne,364,205,159,56.32
Trundle,Zilean,54,37,17,68.52
Trundle,Zac,102,59,43,57.84
Trundle,Smolder,274,117,157,42.7
Trundle,Alistar,106,40,66,37.74
Trundle,JarvanIV,99,53,46,53.54
Trundle,Cassiopeia,120,57,63,47.5
Trundle,Zyra,206,95,111,46.12
Trundle,Kennen,111,60,51,54.05
Trundle,Riven,138,89,49,64.49
Trundle,Syndra,150,87,63,58
Trundle,Ezreal,478,295,183,61.72
Trundle,Viktor,230,115,115,50
Trundle,Nasus,279,166,113,59.5
Trundle,Soraka,212,107,105,50.47
Trundle,Akali,330,211,119,63.94
Trundle,Khazix,240,123,117,51.25
Trundle,Azir,144,70,74,48.61
Trundle,Rell,146,60,86,41.1
Trundle,Lissandra,82,53,29,64.63
Trundle,Ziggs,125,62,63,49.6
Trundle,Karma,205,142,63,69.27
Trundle,Evelynn,191,108,83,56.54
Trundle,Taric,83,53,30,63.86
Trundle,FiddleSticks,199,81,118,40.7
Trundle,Vex,202,80,122,39.6
Trundle,Milio,144,76,68,52.78
Trundle,Hwei,213,111,102,52.11
Trundle,Corki,133,107,26,80.45
Trundle,KSante,138,97,41,70.29
Trundle,Vayne,405,194,211,47.9
Trundle,Vladimir,169,107,62,63.31
Trundle,Xayah,227,127,100,55.95
Trundle,Sett,565,313,252,55.4
Trundle,Nami,262,151,111,57.63
Trundle,Nilah,276,154,122,55.8
Trundle,Malphite,239,106,133,44.35
Trundle,Sion,292,151,141,51.71
Trundle,Camille,84,49,35,58.33
Trundle,Varus,207,106,101,51.21
Trundle,Illaoi,188,89,99,47.34
Trundle,Ashe,559,307,252,54.92
Trundle,Elise,176,95,81,53.98
Trundle,Orianna,119,80,39,67.23
Trundle,TwistedFate,133,88,45,66.17
Trundle,Gragas,162,102,60,62.96
Trundle,Kassadin,81,49,32,60.49
Trundle,Leona,228,121,107,53.07
Trundle,Rammus,129,66,63,51.16
Trundle,Qiyana,127,75,52,59.06
Trundle,Karthus,74,58,16,78.38
Trundle,Renata,79,39,40,49.37
Trundle,Fiora,115,81,34,70.43
Trundle,Akshan,175,110,65,62.86
Trundle,Naafiri,123,63,60,51.22
Trundle,DrMundo,265,158,107,59.62
Trundle,Skarner,101,58,43,57.43
Trundle,Aphelios,253,106,147,41.9
Trundle,Nunu,329,174,155,52.89
Trundle,Vi,272,180,92,66.18
Trundle,Velkoz,206,109,97,52.91
Trundle,Fizz,122,55,67,45.08
Trundle,Xerath,181,85,96,46.96
Trundle,KogMaw,87,44,43,50.57
Trundle,MonkeyKing,150,91,59,60.67
Trundle,Kayle,223,116,107,52.02
Trundle,Quinn,94,52,42,55.32
Trundle,Urgot,165,41,124,24.85
Trundle,Sylas,317,174,143,54.89
Trundle,Rumble,65,31,34,47.69
Trundle,Rakan,147,63,84,42.86
Trundle,Taliyah,84,63,21,75
Trundle,RekSai,41,25,16,60.98
Trundle,Ivern,57,29,28,50.88
Trundle,Gangplank,117,62,55,52.99
Trundle,Shyvana,45,25,20,55.56
Trundle,Maokai,149,57,92,38.26
Trundle,Singed,55,25,30,45.45
Trundle,Janna,98,40,58,40.82
Trundle,Zeri,99,45,54,45.45
Trundle,AurelionSol,181,81,100,44.75
Trundle,Nidalee,88,59,29,67.05
Trundle,Annie,89,47,42,52.81
Trundle,Belveth,101,68,33,67.33
Vex,Garen,534,224,310,41.95
Vex,Diana,519,230,289,44.32
Vex,Yasuo,752,393,359,52.26
Vex,Caitlyn,850,410,440,48.24
Vex,Pyke,321,213,108,66.36
Vex,Smolder,227,97,130,42.73
Vex,Ekko,323,172,151,53.25
Vex,Mordekaiser,573,271,302,47.29
Vex,Yuumi,352,173,179,49.15
Vex,Jax,307,124,183,40.39
Vex,Talon,199,95,104,47.74
Vex,Leblanc,147,82,65,55.78
Vex,Mel,556,273,283,49.1
Vex,Lux,1064,546,518,51.32
Vex,MissFortune,807,412,395,51.05
Vex,Karma,189,90,99,47.62
Vex,Warwick,539,282,257,52.32
Vex,Yone,838,431,407,51.43
Vex,Kalista,190,109,81,57.37
Vex,Thresh,432,227,205,52.55
Vex,Malphite,278,131,147,47.12
Vex,FiddleSticks,206,83,123,40.29
Vex,Soraka,252,150,102,59.52
Vex,Akali,404,200,204,49.5
Vex,Jinx,791,364,427,46.02
Vex,Xayah,266,152,114,57.14
Vex,Senna,342,175,167,51.17
Vex,Viego,399,218,181,54.64
Vex,Tristana,386,213,173,55.18
Vex,Riven,142,74,68,52.11
Vex,Sejuani,110,61,49,55.45
Vex,AurelionSol,117,56,61,47.86
Vex,Rakan,232,115,117,49.57
Vex,Nasus,182,74,108,40.66
Vex,Vi,318,136,182,42.77
Vex,Renata,44,23,21,52.27
Vex,MonkeyKing,167,83,84,49.7
Vex,Sylas,351,223,128,63.53
Vex,Swain,341,154,187,45.16
Vex,Darius,601,286,315,47.59
Vex,Kayn,574,320,254,55.75
Vex,Zed,332,187,145,56.33
Vex,Syndra,192,105,87,54.69
Vex,Kayle,255,111,144,43.53
Vex,Irelia,297,146,151,49.16
Vex,TahmKench,358,179,179,50
Vex,Veigar,440,190,250,43.18
Vex,Jhin,647,333,314,51.47
Vex,Poppy,220,114,106,51.82
Vex,Elise,184,110,74,59.78
Vex,Aurora,399,182,217,45.61
Vex,Nami,246,122,124,49.59
Vex,Sett,628,334,294,53.18
Vex,Briar,355,160,195,45.07
Vex,Draven,171,88,83,51.46
Vex,Nautilus,390,182,208,46.67
Vex,Rengar,138,89,49,64.49
Vex,Ivern,72,34,38,47.22
Vex,Graves,188,91,97,48.4
Vex,Ezreal,502,227,275,45.22
Vex,Teemo,552,253,299,45.83
Vex,Aatrox,381,192,189,50.39
Vex,Shaco,380,189,191,49.74
Vex,Azir,172,98,74,56.98
Vex,Yorick,305,123,182,40.33
Vex,Kindred,225,120,105,53.33
Vex,Heimerdinger,222,134,88,60.36
Vex,Ryze,106,51,55,48.11
Vex,KSante,93,59,34,63.44
Vex,Volibear,304,148,156,48.68
Vex,Karthus,108,59,49,54.63
Vex,Kassadin,71,22,49,30.99
Vex,Illaoi,171,110,61,64.33
Vex,Amumu,369,192,177,52.03
Vex,Ashe,502,236,266,47.01
Vex,Vayne,345,176,169,51.01
Vex,Renekton,156,85,71,54.49
Vex,XinZhao,207,119,88,57.49
Vex,Ahri,536,294,242,54.85
Vex,Corki,81,31,50,38.27
Vex,Morgana,492,226,266,45.93
Vex,Hwei,290,130,160,44.83
Vex,Aphelios,251,104,147,41.43
Vex,Nidalee,89,49,40,55.06
Vex,Orianna,137,74,63,54.01
Vex,Chogath,552,246,306,44.57
Vex,Nocturne,333,191,142,57.36
Vex,Cassiopeia,232,126,106,54.31
Vex,Ornn,145,74,71,51.03
Vex,Lulu,167,80,87,47.9
Vex,Skarner,89,45,44,50.56
Vex,Katarina,291,214,77,73.54
Vex,Quinn,117,42,75,35.9
Vex,Camille,92,58,34,63.04
Vex,LeeSin,279,160,119,57.35
Vex,Hecarim,103,43,60,41.75
Vex,Maokai,113,59,54,52.21
Vex,Fiora,145,64,81,44.14
Vex,Naafiri,155,75,80,48.39
Vex,Belveth,85,38,47,44.71
Vex,Twitch,269,120,149,44.61
Vex,Zac,117,60,57,51.28
Vex,Neeko,279,129,150,46.24
Vex,Shen,216,75,141,34.72
Vex,Vladimir,130,54,76,41.54
Vex,Nunu,330,178,152,53.94
Vex,Annie,117,44,73,37.61
Vex,Sona,188,88,100,46.81
Vex,Kled,60,25,35,41.67
Vex,Khazix,208,123,85,59.13
Vex,Galio,219,72,147,32.88
Vex,Braum,159,77,82,48.43
Vex,Trundle,202,122,80,60.4
Vex,Rammus,114,38,76,33.33
Vex,Seraphine,426,231,195,54.23
Vex,DrMundo,185,94,91,50.81
Vex,Kaisa,421,239,182,56.77
Vex,Gangplank,109,71,38,65.14
Vex,Blitzcrank,228,97,131,42.54
Vex,Olaf,72,21,51,29.17
Vex,JarvanIV,133,52,81,39.1
Vex,Tryndamere,215,118,97,54.88
Vex,Sion,371,164,207,44.2
Vex,Malzahar,234,97,137,41.45
Vex,Samira,310,177,133,57.1
Vex,Xerath,276,130,146,47.1
Vex,Viktor,308,151,157,49.03
Vex,Milio,184,73,111,39.67
Vex,Velkoz,220,91,129,41.36
Vex,TwistedFate,101,64,37,63.37
Vex,Lillia,244,116,128,47.54
Vex,Kennen,165,94,71,56.97
Vex,MasterYi,311,131,180,42.12
Vex,Singed,89,28,61,31.46
Vex,Nilah,218,123,95,56.42
Vex,Taliyah,79,40,39,50.63
Vex,Qiyana,144,94,50,65.28
Vex,Lucian,229,120,109,52.4
Vex,Rumble,36,20,16,55.56
Vex,KogMaw,98,43,55,43.88
Vex,Leona,305,144,161,47.21
Vex,Varus,227,140,87,61.67
Vex,Sivir,134,61,73,45.52
Vex,Gragas,234,130,104,55.56
Vex,Zeri,170,93,77,54.71
Vex,Gnar,156,82,74,52.56
Vex,Ziggs,164,45,119,27.44
Vex,RekSai,39,34,5,87.18
Vex,Alistar,79,39,40,49.37
Vex,Akshan,129,75,54,58.14
Vex,Pantheon,662,324,338,48.94
Vex,Zyra,225,116,109,51.56
Vex,Brand,285,134,151,47.02
Vex,Anivia,127,70,57,55.12
Vex,Evelynn,175,85,90,48.57
Vex,Bard,123,66,57,53.66
Vex,Gwen,196,95,101,48.47
Vex,Shyvana,80,48,32,60
Vex,Lissandra,79,43,36,54.43
Vex,Jayce,142,95,47,66.9
Vex,Fizz,176,101,75,57.39
Vex,Zilean,87,53,34,60.92
Vex,Urgot,119,55,64,46.22
Vex,Ambessa,209,111,98,53.11
Vex,Janna,113,34,79,30.09
Vex,Udyr,116,80,36,68.97
Vex,Taric,55,23,32,41.82
Vex,Rell,218,119,99,54.59
Vex,Zoe,108,53,55,49.07
LeeSin,Gangplank,305,147,158,48.2
LeeSin,Warwick,978,451,527,46.11
LeeSin,Akali,510,232,278,45.49
LeeSin,Caitlyn,1304,552,752,42.33
LeeSin,Sona,150,52,98,34.67
LeeSin,Garen,827,342,485,41.35
LeeSin,Volibear,613,326,287,53.18
LeeSin,Tristana,540,260,280,48.15
LeeSin,Lux,1607,789,818,49.1
LeeSin,Morgana,707,291,416,41.16
LeeSin,Chogath,854,365,489,42.74
LeeSin,Graves,332,190,142,57.23
LeeSin,Leblanc,232,106,126,45.69
LeeSin,Milio,325,179,146,55.08
LeeSin,Mordekaiser,755,362,393,47.95
LeeSin,Amumu,456,214,242,46.93
LeeSin,Yasuo,1073,487,586,45.39
LeeSin,Soraka,392,165,227,42.09
LeeSin,Gwen,319,140,179,43.89
LeeSin,Tryndamere,318,142,176,44.65
LeeSin,Velkoz,402,206,196,51.24
LeeSin,Zeri,248,124,124,50
LeeSin,Thresh,794,404,390,50.88
LeeSin,KSante,311,184,127,59.16
LeeSin,Ashe,995,474,521,47.64
LeeSin,Nasus,372,154,218,41.4
LeeSin,TahmKench,618,277,341,44.82
LeeSin,Fizz,269,115,154,42.75
LeeSin,Nunu,563,271,292,48.13
LeeSin,Vladimir,302,140,162,46.36
LeeSin,Samira,572,288,284,50.35
LeeSin,Nami,526,183,343,34.79
LeeSin,Gragas,398,183,215,45.98
LeeSin,XinZhao,352,147,205,41.76
LeeSin,Lucian,329,152,177,46.2
LeeSin,Vi,577,235,342,40.73
LeeSin,Orianna,321,149,172,46.42
LeeSin,Draven,358,179,179,50
LeeSin,Lulu,461,205,256,44.47
LeeSin,Viktor,384,152,232,39.58
LeeSin,Nocturne,528,228,300,43.18
LeeSin,Nilah,344,181,163,52.62
LeeSin,Bard,246,114,132,46.34
LeeSin,Sett,890,411,479,46.18
LeeSin,Kayn,1029,404,625,39.26
LeeSin,Ryze,136,34,102,25
LeeSin,Khazix,332,167,165,50.3
LeeSin,MissFortune,1052,486,566,46.2
LeeSin,Seraphine,630,289,341,45.87
LeeSin,Kalista,280,123,157,43.93
LeeSin,Gnar,194,105,89,54.12
LeeSin,Pyke,688,328,360,47.67
LeeSin,Pantheon,1008,471,537,46.73
LeeSin,Aurora,567,301,266,53.09
LeeSin,Jax,546,236,310,43.22
LeeSin,JarvanIV,237,87,150,36.71
LeeSin,Hwei,457,173,284,37.86
LeeSin,Kaisa,816,375,441,45.96
LeeSin,Yorick,453,186,267,41.06
LeeSin,Shaco,549,267,282,48.63
LeeSin,Katarina,531,252,279,47.46
LeeSin,Nautilus,676,333,343,49.26
LeeSin,Riven,211,99,112,46.92
LeeSin,MonkeyKing,256,90,166,35.16
LeeSin,Yone,1111,513,598,46.17
LeeSin,Trundle,229,97,132,42.36
LeeSin,Naafiri,280,104,176,37.14
LeeSin,Aphelios,487,248,239,50.92
LeeSin,Shen,322,136,186,42.24
LeeSin,Rammus,164,75,89,45.73
LeeSin,Teemo,678,273,405,40.27
LeeSin,Jayce,242,124,118,51.24
LeeSin,Skarner,158,67,91,42.41
LeeSin,Jinx,1103,508,595,46.06
LeeSin,Poppy,459,204,255,44.44
LeeSin,Neeko,364,188,176,51.65
LeeSin,Sylas,504,216,288,42.86
LeeSin,Lissandra,107,42,65,39.25
LeeSin,Ezreal,1013,458,555,45.21
LeeSin,Mel,1269,646,623,50.91
LeeSin,Talon,407,172,235,42.26
LeeSin,RekSai,101,49,52,48.51
LeeSin,Leona,324,132,192,40.74
LeeSin,Ornn,280,134,146,47.86
LeeSin,Anivia,174,78,96,44.83
LeeSin,Yuumi,533,281,252,52.72
LeeSin,Fiora,249,133,116,53.41
LeeSin,Hecarim,202,85,117,42.08
LeeSin,Blitzcrank,514,268,246,52.14
LeeSin,Ziggs,198,78,120,39.39
LeeSin,Evelynn,373,182,191,48.79
LeeSin,Sivir,272,109,163,40.07
LeeSin,Aatrox,545,247,298,45.32
LeeSin,Xerath,351,154,197,43.87
LeeSin,Sejuani,217,111,106,51.15
LeeSin,Ahri,758,408,350,53.83
LeeSin,Camille,203,92,111,45.32
LeeSin,Rengar,279,171,108,61.29
LeeSin,Diana,663,357,306,53.85
LeeSin,Singed,132,57,75,43.18
LeeSin,Zed,530,253,277,47.74
LeeSin,Urgot,203,101,102,49.75
LeeSin,Ekko,492,256,236,52.03
LeeSin,Lillia,299,119,180,39.8
LeeSin,Smolder,443,237,206,53.5
LeeSin,Braum,199,108,91,54.27
LeeSin,Brand,363,224,139,61.71
LeeSin,Xayah,302,143,159,47.35
LeeSin,Irelia,449,205,244,45.66
LeeSin,MasterYi,556,208,348,37.41
LeeSin,Rakan,283,131,152,46.29
LeeSin,Darius,1137,503,634,44.24
LeeSin,Karma,454,197,257,43.39
LeeSin,Taliyah,231,109,122,47.19
LeeSin,Ambessa,357,191,166,53.5
LeeSin,Olaf,137,59,78,43.07
LeeSin,Kayle,391,170,221,43.48
LeeSin,Illaoi,267,126,141,47.19
LeeSin,Rell,303,182,121,60.07
LeeSin,Viego,831,411,420,49.46
LeeSin,Veigar,658,268,390,40.73
LeeSin,Quinn,242,116,126,47.93
LeeSin,Cassiopeia,256,104,152,40.63
LeeSin,Renata,141,37,104,26.24
LeeSin,Twitch,448,220,228,49.11
LeeSin,Sion,434,191,243,44.01
LeeSin,KogMaw,154,63,91,40.91
LeeSin,Vex,279,119,160,42.65
LeeSin,Swain,604,239,365,39.57
LeeSin,Heimerdinger,276,124,152,44.93
LeeSin,Varus,424,192,232,45.28
LeeSin,FiddleSticks,294,121,173,41.16
LeeSin,Maokai,261,67,194,25.67
LeeSin,Kindred,329,165,164,50.15
LeeSin,Vayne,544,236,308,43.38
LeeSin,Renekton,268,149,119,55.6
LeeSin,Udyr,222,88,134,39.64
LeeSin,Shyvana,169,95,74,56.21
LeeSin,Kassadin,122,76,46,62.3
LeeSin,Corki,248,117,131,47.18
LeeSin,Elise,375,174,201,46.4
LeeSin,TwistedFate,266,134,132,50.38
LeeSin,Jhin,990,438,552,44.24
LeeSin,Kled,99,55,44,55.56
LeeSin,DrMundo,368,217,151,58.97
LeeSin,Briar,530,235,295,44.34
LeeSin,AurelionSol,303,132,171,43.56
LeeSin,Janna,199,83,116,41.71
LeeSin,Zyra,343,131,212,38.19
LeeSin,Alistar,152,86,66,56.58
LeeSin,Zoe,262,143,119,54.58
LeeSin,Senna,445,196,249,44.04
LeeSin,Karthus,142,83,59,58.45
LeeSin,Malzahar,423,158,265,37.35
LeeSin,Rumble,117,70,47,59.83
LeeSin,Kennen,198,83,115,41.92
LeeSin,Annie,162,52,110,32.1
LeeSin,Galio,365,143,222,39.18
LeeSin,Qiyana,174,124,50,71.26
LeeSin,Syndra,284,125,159,44.01
LeeSin,Taric,122,55,67,45.08
LeeSin,Malphite,439,164,275,37.36
LeeSin,Akshan,192,73,119,38.02
LeeSin,Zac,175,71,104,40.57
LeeSin,Belveth,127,41,86,32.28
LeeSin,Ivern,103,70,33,67.96
LeeSin,Azir,248,138,110,55.65
LeeSin,Zilean,146,62,84,42.47
LeeSin,Nidalee,136,73,63,53.68
Akali,Yorick,531,224,307,42.18
Akali,LeeSin,510,278,232,54.51
Akali,Yone,1402,754,648,53.78
Akali,MissFortune,1462,783,679,53.56
Akali,Mel,1410,718,692,50.92
Akali,Ornn,287,140,147,48.78
Akali,Udyr,164,88,76,53.66
Akali,Lux,1885,938,947,49.76
Akali,Ezreal,1071,580,491,54.15
Akali,Milio,368,199,169,54.08
Akali,Samira,613,267,346,43.56
Akali,Kayn,1003,448,555,44.67
Akali,Sylas,594,263,331,44.28
Akali,Nilah,355,167,188,47.04
Akali,Leona,473,258,215,54.55
Akali,DrMundo,405,176,229,43.46
Akali,Belveth,161,97,64,60.25
Akali,Leblanc,232,113,119,48.71
Akali,Briar,674,362,312,53.71
Akali,Anivia,195,79,116,40.51
Akali,Malphite,478,226,252,47.28
Akali,Jax,535,299,236,55.89
Akali,Neeko,458,241,217,52.62
Akali,Xayah,398,189,209,47.49
Akali,Rakan,353,158,195,44.76
Akali,Gangplank,215,94,121,43.72
Akali,Hwei,495,228,267,46.06
Akali,Hecarim,254,108,146,42.52
Akali,Lillia,395,205,190,51.9
Akali,Soraka,420,160,260,38.1
Akali,Chogath,876,342,534,39.04
Akali,Talon,390,220,170,56.41
Akali,Qiyana,213,96,117,45.07
Akali,Seraphine,657,300,357,45.66
Akali,Heimerdinger,363,126,237,34.71
Akali,Vi,464,240,224,51.72
Akali,Ahri,754,423,331,56.1
Akali,Darius,1050,535,515,50.95
Akali,Maokai,245,128,117,52.24
Akali,Aatrox,668,314,354,47.01
Akali,Viego,708,328,380,46.33
Akali,Ashe,1146,571,575,49.83
Akali,Blitzcrank,525,279,246,53.14
Akali,Mordekaiser,879,407,472,46.3
Akali,Zed,553,282,271,50.99
Akali,Vex,404,204,200,50.5
Akali,Ambessa,349,181,168,51.86
Akali,Nunu,594,312,282,52.53
Akali,Jinx,1323,620,703,46.86
Akali,Evelynn,403,225,178,55.83
Akali,Kalista,324,184,140,56.79
Akali,Renata,171,87,84,50.88
Akali,MasterYi,738,265,473,35.91
Akali,Caitlyn,1474,636,838,43.15
Akali,Taric,131,38,93,29.01
Akali,Amumu,634,238,396,37.54
Akali,Akshan,255,80,175,31.37
Akali,Irelia,587,286,301,48.72
Akali,Nocturne,443,220,223,49.66
Akali,Jayce,187,107,80,57.22
Akali,Jhin,1166,545,621,46.74
Akali,Senna,599,280,319,46.74
Akali,Riven,278,179,99,64.39
Akali,Naafiri,331,124,207,37.46
Akali,Tristana,567,282,285,49.74
Akali,Ivern,195,101,94,51.79
Akali,Katarina,614,341,273,55.54
Akali,Pantheon,994,503,491,50.6
Akali,Teemo,883,403,480,45.64
Akali,Warwick,1013,421,592,41.56
Akali,Veigar,698,337,361,48.28
Akali,Kaisa,947,498,449,52.59
Akali,Yuumi,672,280,392,41.67
Akali,Lucian,308,165,143,53.57
Akali,Swain,666,268,398,40.24
Akali,Singed,174,66,108,37.93
Akali,Galio,507,206,301,40.63
Akali,Smolder,384,186,198,48.44
Akali,Brand,374,155,219,41.44
Akali,Yasuo,1415,707,708,49.96
Akali,Thresh,788,393,395,49.87
Akali,Skarner,233,107,126,45.92
Akali,Aurora,668,330,338,49.4
Akali,Zoe,262,147,115,56.11
Akali,Gragas,368,193,175,52.45
Akali,Rammus,191,79,112,41.36
Akali,Nami,540,266,274,49.26
Akali,Zac,166,95,71,57.23
Akali,Sion,540,250,290,46.3
Akali,Draven,335,144,191,42.99
Akali,Nasus,562,257,305,45.73
Akali,Diana,921,445,476,48.32
Akali,Zilean,124,68,56,54.84
Akali,Camille,204,110,94,53.92
Akali,Azir,207,86,121,41.55
Akali,Braum,266,142,124,53.38
Akali,KSante,267,165,102,61.8
Akali,MonkeyKing,275,116,159,42.18
Akali,Ekko,527,237,290,44.97
Akali,Fiora,279,122,157,43.73
Akali,Kindred,383,199,184,51.96
Akali,Morgana,805,337,468,41.86
Akali,Gwen,392,225,167,57.4
Akali,JarvanIV,232,99,133,42.67
Akali,Kennen,217,112,105,51.61
Akali,Nautilus,609,307,302,50.41
Akali,FiddleSticks,275,109,166,39.64
Akali,Karma,404,213,191,52.72
Akali,Quinn,271,117,154,43.17
Akali,Sivir,314,144,170,45.86
Akali,Gnar,268,144,124,53.73
Akali,AurelionSol,238,74,164,31.09
Akali,Renekton,251,119,132,47.41
Akali,Aphelios,453,188,265,41.5
Akali,TahmKench,615,298,317,48.46
Akali,Malzahar,499,178,321,35.67
Akali,Sett,1025,455,570,44.39
Akali,Vayne,589,240,349,40.75
Akali,Tryndamere,334,188,146,56.29
Akali,Fizz,324,153,171,47.22
Akali,Vladimir,394,195,199,49.49
Akali,Garen,944,442,502,46.82
Akali,Lulu,447,197,250,44.07
Akali,RekSai,80,34,46,42.5
Akali,Pyke,754,410,344,54.38
Akali,Volibear,638,284,354,44.51
Akali,Sona,285,151,134,52.98
Akali,Annie,179,77,102,43.02
Akali,Khazix,332,151,181,45.48
Akali,Orianna,229,113,116,49.34
Akali,Janna,199,80,119,40.2
Akali,Zyra,324,143,181,44.14
Akali,Corki,167,78,89,46.71
Akali,Ziggs,308,137,171,44.48
Akali,Graves,285,171,114,60
Akali,TwistedFate,206,137,69,66.5
Akali,Rell,308,143,165,46.43
Akali,Syndra,281,139,142,49.47
Akali,XinZhao,405,159,246,39.26
Akali,Twitch,498,197,301,39.56
Akali,Shaco,641,292,349,45.55
Akali,Varus,487,197,290,40.45
Akali,Zeri,256,140,116,54.69
Akali,Alistar,214,74,140,34.58
Akali,Ryze,158,80,78,50.63
Akali,Kayle,491,223,268,45.42
Akali,Sejuani,223,118,105,52.91
Akali,Kassadin,141,50,91,35.46
Akali,Trundle,330,119,211,36.06
Akali,Xerath,428,201,227,46.96
Akali,Viktor,437,244,193,55.84
Akali,Urgot,249,89,160,35.74
Akali,Poppy,324,138,186,42.59
Akali,Velkoz,406,198,208,48.77
Akali,Rengar,246,158,88,64.23
Akali,Nidalee,124,71,53,57.26
Akali,Shyvana,156,74,82,47.44
Akali,Lissandra,171,119,52,69.59
Akali,Rumble,115,62,53,53.91
Akali,Olaf,141,72,69,51.06
Akali,Cassiopeia,254,115,139,45.28
Akali,Bard,204,115,89,56.37
Akali,Illaoi,341,143,198,41.94
Akali,Elise,282,149,133,52.84
Akali,KogMaw,152,67,85,44.08
Akali,Shen,343,142,201,41.4
Akali,Taliyah,214,120,94,56.07
Akali,Karthus,169,80,89,47.34
Akali,Kled,145,65,80,44.83
Naafiri,Aatrox,304,188,116,61.84
Naafiri,Sejuani,73,45,28,61.64
Naafiri,Yasuo,514,226,288,43.97
Naafiri,Jinx,605,319,286,52.73
Naafiri,Pyke,369,190,179,51.49
Naafiri,Gnar,108,56,52,51.85
Naafiri,Viego,306,123,183,40.2
Naafiri,Yone,659,270,389,40.97
Naafiri,Kaisa,343,191,152,55.69
Naafiri,TahmKench,312,186,126,59.62
Naafiri,Ryze,67,25,42,37.31
Naafiri,Nunu,247,124,123,50.2
Naafiri,Ahri,339,163,176,48.08
Naafiri,Lucian,138,82,56,59.42
Naafiri,Alistar,75,49,26,65.33
Naafiri,Vayne,248,139,109,56.05
Naafiri,Briar,329,156,173,47.42
Naafiri,Lux,846,482,364,56.97
Naafiri,Mel,582,283,299,48.63
Naafiri,Yuumi,220,120,100,54.55
Naafiri,Irelia,243,115,128,47.33
Naafiri,Nocturne,235,124,111,52.77
Naafiri,Jayce,95,59,36,62.11
Naafiri,Jhin,540,232,308,42.96
Naafiri,Senna,248,111,137,44.76
Naafiri,Sett,461,212,249,45.99
Naafiri,FiddleSticks,153,79,74,51.63
Naafiri,Akali,331,207,124,62.54
Naafiri,Samira,274,133,141,48.54
Naafiri,Neeko,206,92,114,44.66
Naafiri,Kayle,222,115,107,51.8
Naafiri,Katarina,198,113,85,57.07
Naafiri,KSante,86,54,32,62.79
Naafiri,Kayn,429,220,209,51.28
Naafiri,Quinn,115,43,72,37.39
Naafiri,Thresh,298,145,153,48.66
Naafiri,Talon,193,83,110,43.01
Naafiri,LeeSin,280,176,104,62.86
Naafiri,Garen,393,185,208,47.07
Naafiri,Malzahar,284,162,122,57.04
Naafiri,Twitch,247,99,148,40.08
Naafiri,Rakan,137,63,74,45.99
Naafiri,Yorick,280,116,164,41.43
Naafiri,Volibear,308,138,170,44.81
Naafiri,Blitzcrank,235,126,109,53.62
Naafiri,Shaco,249,139,110,55.82
Naafiri,Darius,597,256,341,42.88
Naafiri,Sylas,291,149,142,51.2
Naafiri,Tristana,205,73,132,35.61
Naafiri,Zoe,144,50,94,34.72
Naafiri,Kassadin,47,29,18,61.7
Naafiri,Renata,75,28,47,37.33
Naafiri,Gragas,134,83,51,61.94
Naafiri,Karma,154,66,88,42.86
Naafiri,Veigar,313,128,185,40.89
Naafiri,Viktor,169,89,80,52.66
Naafiri,Teemo,336,145,191,43.15
Naafiri,Graves,142,81,61,57.04
Naafiri,Leblanc,132,85,47,64.39
Naafiri,Mordekaiser,454,166,288,36.56
Naafiri,Diana,392,170,222,43.37
Naafiri,Kindred,168,87,81,51.79
Naafiri,Swain,341,112,229,32.84
Naafiri,JarvanIV,126,53,73,42.06
Naafiri,Hwei,150,90,60,60
Naafiri,Riven,79,59,20,74.68
Naafiri,Nami,276,111,165,40.22
Naafiri,Xayah,178,77,101,43.26
Naafiri,Evelynn,199,137,62,68.84
Naafiri,Zac,88,44,44,50
Naafiri,Renekton,170,110,60,64.71
Naafiri,Caitlyn,700,345,355,49.29
Naafiri,Zilean,69,44,25,63.77
Naafiri,MasterYi,275,137,138,49.82
Naafiri,Azir,103,54,49,52.43
Naafiri,Ezreal,362,203,159,56.08
Naafiri,Velkoz,230,107,123,46.52
Naafiri,Vex,155,80,75,51.61
Naafiri,Bard,101,54,47,53.47
Naafiri,Ekko,194,99,95,51.03
Naafiri,Fiora,108,74,34,68.52
Naafiri,XinZhao,129,57,72,44.19
Naafiri,Draven,116,70,46,60.34
Naafiri,Rammus,71,18,53,25.35
Naafiri,Zeri,82,46,36,56.1
Naafiri,Amumu,248,111,137,44.76
Naafiri,MissFortune,578,283,295,48.96
Naafiri,Morgana,358,169,189,47.21
Naafiri,Syndra,168,94,74,55.95
Naafiri,Lulu,204,98,106,48.04
Naafiri,Belveth,81,34,47,41.98
Naafiri,Soraka,181,87,94,48.07
Naafiri,Ambessa,108,63,45,58.33
Naafiri,Lillia,179,114,65,63.69
Naafiri,Aurora,284,128,156,45.07
Naafiri,Cassiopeia,80,40,40,50
Naafiri,Nilah,183,97,86,53.01
Naafiri,Ornn,156,53,103,33.97
Naafiri,Heimerdinger,171,69,102,40.35
Naafiri,Anivia,68,39,29,57.35
Naafiri,Udyr,98,46,52,46.94
Naafiri,Nasus,221,90,131,40.72
Naafiri,Warwick,484,229,255,47.31
Naafiri,Elise,196,112,84,57.14
Naafiri,Jax,205,117,88,57.07
Naafiri,Vladimir,117,74,43,63.25
Naafiri,Nautilus,245,107,138,43.67
Naafiri,Ashe,449,225,224,50.11
Naafiri,Rengar,97,51,46,52.58
Naafiri,Poppy,132,55,77,41.67
Naafiri,Galio,143,61,82,42.66
Naafiri,Ziggs,123,65,58,52.85
Naafiri,Sona,142,62,80,43.66
Naafiri,Aphelios,182,110,72,60.44
Naafiri,Pantheon,427,179,248,41.92
Naafiri,Kennen,133,61,72,45.86
Naafiri,Khazix,147,94,53,63.95
Naafiri,Gwen,208,125,83,60.1
Naafiri,Xerath,149,71,78,47.65
Naafiri,Malphite,197,81,116,41.12
Naafiri,Camille,102,58,44,56.86
Naafiri,Fizz,133,62,71,46.62
Naafiri,Singed,94,41,53,43.62
Naafiri,RekSai,18,9,9,50
Naafiri,AurelionSol,151,81,70,53.64
Naafiri,Milio,159,104,55,65.41
Naafiri,Vi,214,98,116,45.79
Naafiri,Orianna,112,35,77,31.25
Naafiri,Shen,218,94,124,43.12
Naafiri,DrMundo,170,86,84,50.59
Naafiri,Corki,94,67,27,71.28
Naafiri,TwistedFate,95,62,33,65.26
Naafiri,Qiyana,106,55,51,51.89
Naafiri,Illaoi,166,98,68,59.04
Naafiri,Zed,282,164,118,58.16
Naafiri,Chogath,410,208,202,50.73
Naafiri,Braum,121,58,63,47.93
Naafiri,Leona,175,81,94,46.29
Naafiri,MonkeyKing,124,67,57,54.03
Naafiri,Trundle,123,60,63,48.78
Naafiri,Rell,141,99,42,70.21
Naafiri,Tryndamere,196,108,88,55.1
Naafiri,Hecarim,108,64,44,59.26
Naafiri,Seraphine,344,162,182,47.09
Naafiri,Smolder,204,110,94,53.92
Naafiri,Gangplank,117,75,42,64.1
Naafiri,Zyra,192,94,98,48.96
Naafiri,Varus,182,61,121,33.52
Naafiri,Kalista,106,59,47,55.66
Naafiri,Sion,171,71,100,41.52
Naafiri,Janna,83,43,40,51.81
Naafiri,Lissandra,71,44,27,61.97
Naafiri,Karthus,80,42,38,52.5
Naafiri,Maokai,108,45,63,41.67
Naafiri,Akshan,131,76,55,58.02
Naafiri,Sivir,123,75,48,60.98
Naafiri,Skarner,117,61,56,52.14
Naafiri,Brand,162,81,81,50
Naafiri,Taric,58,42,16,72.41
Naafiri,Olaf,44,29,15,65.91
Naafiri,Shyvana,119,43,76,36.13
Naafiri,Annie,115,52,63,45.22
Naafiri,Rumble,61,45,16,73.77
Naafiri,KogMaw,108,58,50,53.7
Naafiri,Taliyah,74,36,38,48.65
Naafiri,Nidalee,71,42,29,59.15
Naafiri,Kled,66,22,44,33.33
Naafiri,Urgot,103,44,59,42.72
Naafiri,Ivern,47,41,6,87.23
Senna,Aatrox,468,238,230,50.85
Senna,Sejuani,171,98,73,57.31
Senna,Yasuo,1067,564,503,52.86
Senna,Jinx,1070,519,551,48.5
Senna,Pyke,636,347,289,54.56
Senna,Gwen,350,202,148,57.71
Senna,Talon,336,191,145,56.85
Senna,Yone,990,603,387,60.91
Senna,MissFortune,998,495,503,49.6
Senna,Taric,110,44,66,40
Senna,Samira,508,294,214,57.87
Senna,Kayn,706,355,351,50.28
Senna,Sylas,403,172,231,42.68
Senna,Nilah,294,155,139,52.72
Senna,Leona,466,207,259,44.42
Senna,Fiora,211,128,83,60.66
Senna,FiddleSticks,297,156,141,52.53
Senna,Syndra,226,112,114,49.56
Senna,Vayne,514,283,231,55.06
Senna,Morgana,666,365,301,54.8
Senna,Chogath,739,408,331,55.21
Senna,Shaco,587,299,288,50.94
Senna,Ahri,813,411,402,50.55
Senna,Ashe,966,523,443,54.14
Senna,Poppy,398,223,175,56.03
Senna,Malphite,450,217,233,48.22
Senna,Mel,1198,613,585,51.17
Senna,Soraka,331,179,152,54.08
Senna,Mordekaiser,804,429,375,53.36
Senna,Zed,447,241,206,53.91
Senna,Vex,342,167,175,48.83
Senna,Rakan,341,197,144,57.77
Senna,Viktor,359,192,167,53.48
Senna,Nocturne,478,235,243,49.16
Senna,Bard,183,95,88,51.91
Senna,Gnar,240,127,113,52.92
Senna,Jax,461,211,250,45.77
Senna,Aurora,454,285,169,62.78
Senna,Swain,580,286,294,49.31
Senna,Fizz,238,115,123,48.32
Senna,Tristana,501,266,235,53.09
Senna,Akali,599,319,280,53.26
Senna,Naafiri,248,137,111,55.24
Senna,Kayle,491,243,248,49.49
Senna,Smolder,368,196,172,53.26
Senna,Kalista,204,111,93,54.41
Senna,Gragas,323,195,128,60.37
Senna,Orianna,247,128,119,51.82
Senna,Gangplank,252,152,100,60.32
Senna,Corki,156,63,93,40.38
Senna,Lux,1407,726,681,51.6
Senna,Yorick,513,212,301,41.33
Senna,Ekko,377,199,178,52.79
Senna,Katarina,448,268,180,59.82
Senna,Sion,427,200,227,46.84
Senna,Sett,811,369,442,45.5
Senna,Lissandra,104,62,42,59.62
Senna,Milio,281,132,149,46.98
Senna,Lillia,425,234,191,55.06
Senna,Jhin,842,413,429,49.05
Senna,Janna,134,40,94,29.85
Senna,Olaf,120,78,42,65
Senna,Braum,201,109,92,54.23
Senna,TahmKench,531,266,265,50.09
Senna,Malzahar,449,209,240,46.55
Senna,Blitzcrank,443,251,192,56.66
Senna,Vi,459,305,154,66.45
Senna,Thresh,734,329,405,44.82
Senna,Trundle,272,125,147,45.96
Senna,Aphelios,425,239,186,56.24
Senna,Shen,414,185,229,44.69
Senna,Nunu,491,280,211,57.03
Senna,DrMundo,311,164,147,52.73
Senna,Amumu,552,273,279,49.46
Senna,Irelia,466,229,237,49.14
Senna,Warwick,846,431,415,50.95
Senna,Veigar,630,288,342,45.71
Senna,Nautilus,589,306,283,51.95
Senna,Darius,1084,576,508,53.14
Senna,Karma,354,172,182,48.59
Senna,Diana,634,317,317,50
Senna,Twitch,476,231,245,48.53
Senna,Teemo,784,376,408,47.96
Senna,Kaisa,772,431,341,55.83
Senna,Evelynn,236,132,104,55.93
Senna,Velkoz,320,154,166,48.13
Senna,Nasus,425,242,183,56.94
Senna,Neeko,400,202,198,50.5
Senna,Draven,335,145,190,43.28
Senna,Shyvana,149,83,66,55.7
Senna,Galio,357,168,189,47.06
Senna,Caitlyn,1424,702,722,49.3
Senna,Garen,666,328,338,49.25
Senna,Graves,214,103,111,48.13
Senna,Zoe,234,146,88,62.39
Senna,Jayce,212,101,111,47.64
Senna,Ezreal,949,546,403,57.53
Senna,Kindred,327,196,131,59.94
Senna,Yuumi,536,245,291,45.71
Senna,Azir,238,113,125,47.48
Senna,Ivern,111,52,59,46.85
Senna,Anivia,157,82,75,52.23
Senna,Hecarim,185,91,94,49.19
Senna,Khazix,312,146,166,46.79
Senna,Sivir,218,90,128,41.28
Senna,Seraphine,557,293,264,52.6
Senna,MonkeyKing,282,123,159,43.62
Senna,Vladimir,232,105,127,45.26
Senna,Varus,411,214,197,52.07
Senna,Urgot,295,165,130,55.93
Senna,MasterYi,487,268,219,55.03
Senna,Renekton,282,123,159,43.62
Senna,Renata,176,97,79,55.11
Senna,Karthus,131,59,72,45.04
Senna,Lucian,262,148,114,56.49
Senna,Nami,544,241,303,44.3
Senna,Volibear,601,236,365,39.27
Senna,Lulu,432,202,230,46.76
Senna,Brand,405,242,163,59.75
Senna,Ryze,151,69,82,45.7
Senna,Zac,159,82,77,51.57
Senna,Ziggs,242,106,136,43.8
Senna,Viego,632,326,306,51.58
Senna,Alistar,163,81,82,49.69
Senna,Rammus,183,60,123,32.79
Senna,Nidalee,136,81,55,59.56
Senna,Kled,85,30,55,35.29
Senna,Udyr,175,86,89,49.14
Senna,Xerath,367,167,200,45.5
Senna,Ornn,264,148,116,56.06
Senna,Singed,193,95,98,49.22
Senna,Kassadin,109,55,54,50.46
Senna,Tryndamere,296,150,146,50.68
Senna,Riven,260,131,129,50.38
Senna,Rell,265,137,128,51.7
Senna,Briar,532,262,270,49.25
Senna,LeeSin,445,249,196,55.96
Senna,Pantheon,811,398,413,49.08
Senna,Camille,136,90,46,66.18
Senna,Ambessa,272,155,117,56.99
Senna,Skarner,141,94,47,66.67
Senna,Hwei,369,218,151,59.08
Senna,Heimerdinger,220,109,111,49.55
Senna,Rengar,170,85,85,50
Senna,Sona,238,124,114,52.1
Senna,KSante,168,113,55,67.26
Senna,Xayah,355,180,175,50.7
Senna,Kennen,192,102,90,53.13
Senna,Leblanc,166,66,100,39.76
Senna,Elise,350,170,180,48.57
Senna,XinZhao,298,167,131,56.04
Senna,Quinn,168,73,95,43.45
Senna,Qiyana,270,167,103,61.85
Senna,Annie,134,80,54,59.7
Senna,RekSai,66,48,18,72.73
Senna,Cassiopeia,215,106,109,49.3
Senna,Zyra,406,202,204,49.75
Senna,Maokai,275,119,156,43.27
Senna,Illaoi,250,105,145,42
Senna,Akshan,249,160,89,64.26
Senna,AurelionSol,287,157,130,54.7
Senna,KogMaw,190,96,94,50.53
Senna,JarvanIV,186,75,111,40.32
Senna,Zilean,125,87,38,69.6
Senna,TwistedFate,171,77,94,45.03
Senna,Zeri,271,146,125,53.87
Senna,Belveth,155,88,67,56.77
Senna,Taliyah,187,98,89,52.41
Senna,Rumble,94,51,43,54.26
Galio,Gnar,164,88,76,53.66
Galio,Jax,358,210,148,58.66
Galio,Yasuo,814,421,393,51.72
Galio,Caitlyn,833,351,482,42.14
Galio,Neeko,293,189,104,64.51
Galio,Teemo,500,262,238,52.4
Galio,TahmKench,435,262,173,60.23
Galio,Jinx,814,377,437,46.31
Galio,Zoe,216,119,97,55.09
Galio,Nami,365,218,147,59.73
Galio,Irelia,342,154,188,45.03
Galio,Pantheon,661,379,282,57.34
Galio,Kassadin,109,61,48,55.96
Galio,Jhin,693,388,305,55.99
Galio,Yuumi,336,187,149,55.65
Galio,Shaco,359,203,156,56.55
Galio,Leblanc,250,159,91,63.6
Galio,Ezreal,733,407,326,55.53
Galio,Thresh,506,259,247,51.19
Galio,Darius,765,373,392,48.76
Galio,Viego,537,290,247,54
Galio,AurelionSol,234,147,87,62.82
Galio,MissFortune,777,428,349,55.08
Galio,Nautilus,518,271,247,52.32
Galio,Gwen,317,161,156,50.79
Galio,Mel,1065,581,484,54.55
Galio,Tristana,334,182,152,54.49
Galio,Poppy,272,144,128,52.94
Galio,Kayle,293,167,126,57
Galio,Kayn,632,346,286,54.75
Galio,Akali,507,301,206,59.37
Galio,Soraka,271,139,132,51.29
Galio,Fiora,263,172,91,65.4
Galio,Amumu,393,186,207,47.33
Galio,Vladimir,191,87,104,45.55
Galio,Varus,299,148,151,49.5
Galio,Janna,130,70,60,53.85
Galio,Warwick,681,345,336,50.66
Galio,Sejuani,119,55,64,46.22
Galio,Ahri,549,321,228,58.47
Galio,Lux,1044,531,513,50.86
Galio,Singed,141,74,67,52.48
Galio,Vayne,348,172,176,49.43
Galio,Leona,333,182,151,54.65
Galio,Volibear,395,213,182,53.92
Galio,Rammus,159,78,81,49.06
Galio,Aurora,525,310,215,59.05
Galio,Ashe,638,326,312,51.1
Galio,Sylas,469,239,230,50.96
Galio,FiddleSticks,176,101,75,57.39
Galio,Aphelios,244,144,100,59.02
Galio,Morgana,586,266,320,45.39
Galio,Trundle,223,88,135,39.46
Galio,XinZhao,223,102,121,45.74
Galio,Mordekaiser,690,343,347,49.71
Galio,Samira,293,150,143,51.19
Galio,Shen,254,124,130,48.82
Galio,Ekko,359,190,169,52.92
Galio,Qiyana,105,57,48,54.29
Galio,Twitch,293,149,144,50.85
Galio,Senna,357,189,168,52.94
Galio,Talon,225,123,102,54.67
Galio,Chogath,508,238,270,46.85
Galio,MasterYi,420,207,213,49.29
Galio,Zed,337,215,122,63.8
Galio,Aatrox,329,178,151,54.1
Galio,Pyke,446,206,240,46.19
Galio,Malphite,351,186,165,52.99
Galio,Yone,808,430,378,53.22
Galio,Lulu,369,163,206,44.17
Galio,Skarner,160,106,54,66.25
Galio,Zilean,121,49,72,40.5
Galio,Viktor,266,138,128,51.88
Galio,Kindred,218,100,118,45.87
Galio,Lucian,234,161,73,68.8
Galio,Sion,347,201,146,57.93
Galio,Diana,548,307,241,56.02
Galio,Orianna,167,114,53,68.26
Galio,Kaisa,586,343,243,58.53
Galio,Khazix,231,146,85,63.2
Galio,Rell,213,146,67,68.54
Galio,Seraphine,461,231,230,50.11
Galio,Rengar,183,120,63,65.57
Galio,Hwei,365,215,150,58.9
Galio,Katarina,399,246,153,61.65
Galio,Velkoz,234,107,127,45.73
Galio,Camille,135,82,53,60.74
Galio,Braum,176,119,57,67.61
Galio,Xayah,313,135,178,43.13
Galio,Rakan,217,117,100,53.92
Galio,Briar,511,212,299,41.49
Galio,Heimerdinger,220,131,89,59.55
Galio,Zyra,273,152,121,55.68
Galio,Fizz,265,143,122,53.96
Galio,Sivir,227,109,118,48.02
Galio,Xerath,228,129,99,56.58
Galio,Kennen,123,86,37,69.92
Galio,TwistedFate,140,79,61,56.43
Galio,Nocturne,369,164,205,44.44
Galio,Annie,115,90,25,78.26
Galio,Swain,534,269,265,50.37
Galio,Shyvana,135,69,66,51.11
Galio,Belveth,92,50,42,54.35
Galio,Smolder,381,237,144,62.2
Galio,Sett,687,369,318,53.71
Galio,Garen,635,325,310,51.18
Galio,Yorick,416,171,245,41.11
Galio,Vex,219,147,72,67.12
Galio,Karma,238,121,117,50.84
Galio,Gragas,292,199,93,68.15
Galio,Nunu,314,170,144,54.14
Galio,Sona,135,62,73,45.93
Galio,Lillia,269,184,85,68.4
Galio,Ziggs,212,121,91,57.08
Galio,Nasus,325,188,137,57.85
Galio,Naafiri,143,82,61,57.34
Galio,Syndra,184,85,99,46.2
Galio,Blitzcrank,234,120,114,51.28
Galio,LeeSin,365,222,143,60.82
Galio,Ambessa,218,144,74,66.06
Galio,Brand,367,173,194,47.14
Galio,Azir,151,66,85,43.71
Galio,KogMaw,195,120,75,61.54
Galio,Nidalee,118,62,56,52.54
Galio,Evelynn,238,152,86,63.87
Galio,Riven,167,91,76,54.49
Galio,Vi,408,250,158,61.27
Galio,Veigar,483,215,268,44.51
Galio,Jayce,150,78,72,52
Galio,Illaoi,179,58,121,32.4
Galio,Malzahar,367,153,214,41.69
Galio,Anivia,131,78,53,59.54
Galio,Draven,285,174,111,61.05
Galio,Alistar,99,62,37,62.63
Galio,RekSai,56,27,29,48.21
Galio,Taliyah,114,54,60,47.37
Galio,Renekton,183,92,91,50.27
Galio,Milio,204,95,109,46.57
Galio,Olaf,101,33,68,32.67
Galio,Tryndamere,221,132,89,59.73
Galio,Nilah,232,140,92,60.34
Galio,Gangplank,141,86,55,60.99
Galio,Graves,233,110,123,47.21
Galio,Elise,244,139,105,56.97
Galio,Cassiopeia,166,60,106,36.14
Galio,Corki,168,95,73,56.55
Galio,KSante,156,84,72,53.85
Galio,Zeri,229,133,96,58.08
Galio,Zac,113,46,67,40.71
Galio,Ryze,114,36,78,31.58
Galio,DrMundo,276,124,152,44.93
Galio,Hecarim,126,93,33,73.81
Galio,JarvanIV,161,85,76,52.8
Galio,Quinn,164,98,66,59.76
Galio,Akshan,151,85,66,56.29
Galio,Karthus,88,63,25,71.59
Galio,Maokai,111,50,61,45.05
Galio,Ivern,95,55,40,57.89
Galio,Bard,143,78,65,54.55
Galio,Ornn,192,98,94,51.04
Galio,Lissandra,100,60,40,60
Galio,Kalista,223,127,96,56.95
Galio,MonkeyKing,150,98,52,65.33
Galio,Renata,73,33,40,45.21
Galio,Udyr,170,114,56,67.06
Galio,Urgot,135,68,67,50.37
Galio,Taric,115,53,62,46.09
Galio,Kled,67,29,38,43.28
Galio,Rumble,93,50,43,53.76
Gnar,Irelia,289,127,162,43.94
Gnar,Zed,246,138,108,56.1
Gnar,Galio,164,76,88,46.34
Gnar,MissFortune,554,270,284,48.74
Gnar,TahmKench,345,158,187,45.8
Gnar,Naafiri,108,52,56,48.15
Gnar,Nunu,176,88,88,50
Gnar,Malzahar,196,81,115,41.33
Gnar,Zeri,115,45,70,39.13
Gnar,Mordekaiser,313,139,174,44.41
Gnar,Volibear,248,111,137,44.76
Gnar,Mel,598,270,328,45.15
Gnar,Ashe,364,189,175,51.92
Gnar,Neeko,159,82,77,51.57
Gnar,Amumu,234,69,165,29.49
Gnar,Pyke,234,124,110,52.99
Gnar,Varus,237,103,134,43.46
Gnar,Thresh,338,188,150,55.62
Gnar,Sett,468,222,246,47.44
Gnar,Warwick,400,172,228,43
Gnar,Brand,184,64,120,34.78
Gnar,Twitch,219,95,124,43.38
Gnar,Morgana,318,149,169,46.86
Gnar,Tryndamere,160,76,84,47.5
Gnar,Sylas,282,103,179,36.52
Gnar,Taliyah,92,41,51,44.57
Gnar,Jhin,453,199,254,43.93
Gnar,Senna,240,113,127,47.08
Gnar,Darius,432,187,245,43.29
Gnar,Kindred,155,77,78,49.68
Gnar,Veigar,230,123,107,53.48
Gnar,Corki,103,31,72,30.1
Gnar,Pantheon,447,177,270,39.6
Gnar,Camille,57,24,33,42.11
Gnar,LeeSin,194,89,105,45.88
Gnar,Draven,108,41,67,37.96
Gnar,Sion,222,94,128,42.34
Gnar,Zac,111,80,31,72.07
Gnar,AurelionSol,139,49,90,35.25
Gnar,Lux,615,308,307,50.08
Gnar,Teemo,367,142,225,38.69
Gnar,Evelynn,156,67,89,42.95
Gnar,Ezreal,444,159,285,35.81
Gnar,Seraphine,230,112,118,48.7
Gnar,Gangplank,119,50,69,42.02
Gnar,MasterYi,227,122,105,53.74
Gnar,Yone,471,234,237,49.68
Gnar,Swain,242,65,177,26.86
Gnar,Gwen,126,72,54,57.14
Gnar,RekSai,49,30,19,61.22
Gnar,Kaisa,299,173,126,57.86
Gnar,Leona,200,82,118,41
Gnar,Leblanc,104,46,58,44.23
Gnar,Aatrox,259,109,150,42.08
Gnar,Trundle,112,54,58,48.21
Gnar,Caitlyn,634,348,286,54.89
Gnar,Lucian,126,61,65,48.41
Gnar,Karthus,95,60,35,63.16
Gnar,Kayn,311,145,166,46.62
Gnar,Akali,268,124,144,46.27
Gnar,Sivir,98,60,38,61.22
Gnar,Hwei,190,77,113,40.53
Gnar,Poppy,133,65,68,48.87
Gnar,Kayle,98,17,81,17.35
Gnar,Fizz,100,58,42,58
Gnar,Jinx,564,267,297,47.34
Gnar,Milio,133,31,102,23.31
Gnar,Rengar,99,58,41,58.59
Gnar,KogMaw,48,26,22,54.17
Gnar,Zoe,129,82,47,63.57
Gnar,Gragas,142,64,78,45.07
Gnar,Xayah,187,96,91,51.34
Gnar,Tristana,211,89,122,42.18
Gnar,Sona,105,57,48,54.29
Gnar,Nocturne,197,104,93,52.79
Gnar,Velkoz,178,60,118,33.71
Gnar,Karma,123,26,97,21.14
Gnar,Smolder,203,109,94,53.69
Gnar,Syndra,128,63,65,49.22
Gnar,Vi,251,101,150,40.24
Gnar,Nautilus,277,165,112,59.57
Gnar,Shaco,199,65,134,32.66
Gnar,Katarina,237,106,131,44.73
Gnar,Nami,243,105,138,43.21
Gnar,Yasuo,477,238,239,49.9
Gnar,Lillia,144,47,97,32.64
Gnar,Malphite,343,144,199,41.98
Gnar,Rakan,113,56,57,49.56
Gnar,Rell,104,45,59,43.27
Gnar,Garen,310,166,144,53.55
Gnar,Lulu,194,109,85,56.19
Gnar,Aphelios,110,49,61,44.55
Gnar,Azir,120,57,63,47.5
Gnar,Kennen,108,53,55,49.07
Gnar,Aurora,204,108,96,52.94
Gnar,XinZhao,151,57,94,37.75
Gnar,Viktor,169,106,63,62.72
Gnar,Kassadin,80,44,36,55
Gnar,Viego,316,117,199,37.03
Gnar,Alistar,103,55,48,53.4
Gnar,Shen,178,75,103,42.13
Gnar,Maokai,73,45,28,61.64
Gnar,Nasus,206,118,88,57.28
Gnar,Talon,129,61,68,47.29
Gnar,Cassiopeia,126,48,78,38.1
Gnar,Vladimir,130,37,93,28.46
Gnar,Khazix,177,85,92,48.02
Gnar,Yuumi,233,121,112,51.93
Gnar,Sejuani,78,42,36,53.85
Gnar,Annie,95,63,32,66.32
Gnar,Lissandra,42,13,29,30.95
Gnar,Ivern,46,24,22,52.17
Gnar,Ambessa,180,85,95,47.22
Gnar,Zyra,166,78,88,46.99
Gnar,Illaoi,121,67,54,55.37
Gnar,Ekko,170,67,103,39.41
Gnar,Ahri,335,157,178,46.87
Gnar,Samira,207,81,126,39.13
Gnar,Renekton,127,64,63,50.39
Gnar,Rammus,67,13,54,19.4
Gnar,Qiyana,79,55,24,69.62
Gnar,Udyr,74,34,40,45.95
Gnar,Soraka,121,54,67,44.63
Gnar,DrMundo,149,67,82,44.97
Gnar,Blitzcrank,193,115,78,59.59
Gnar,Jax,128,75,53,58.59
Gnar,Quinn,78,33,45,42.31
Gnar,Xerath,137,39,98,28.47
Gnar,Vayne,217,81,136,37.33
Gnar,KSante,72,48,24,66.67
Gnar,Diana,292,106,186,36.3
Gnar,Bard,33,30,3,90.91
Gnar,Yorick,253,86,167,33.99
Gnar,Skarner,122,63,59,51.64
Gnar,Nilah,143,67,76,46.85
Gnar,JarvanIV,100,55,45,55
Gnar,Riven,97,51,46,52.58
Gnar,Graves,141,71,70,50.35
Gnar,Braum,103,51,52,49.51
Gnar,Renata,97,51,46,52.58
Gnar,Ziggs,87,12,75,13.79
Gnar,Janna,120,48,72,40
Gnar,Fiora,72,46,26,63.89
Gnar,FiddleSticks,139,69,70,49.64
Gnar,Chogath,342,185,157,54.09
Gnar,Ornn,130,42,88,32.31
Gnar,Vex,156,74,82,47.44
Gnar,Heimerdinger,121,61,60,50.41
Gnar,MonkeyKing,87,46,41,52.87
Gnar,Singed,73,22,51,30.14
Gnar,Jayce,130,76,54,58.46
Gnar,Shyvana,79,38,41,48.1
Gnar,Elise,128,37,91,28.91
Gnar,Briar,249,114,135,45.78
Gnar,Urgot,125,46,79,36.8
Gnar,Olaf,51,31,20,60.78
Gnar,Orianna,63,24,39,38.1
Gnar,Zilean,57,23,34,40.35
Gnar,Hecarim,62,38,24,61.29
Gnar,Kled,56,29,27,51.79
Gnar,Kalista,105,37,68,35.24
Gnar,Ryze,56,36,20,64.29
Gnar,Belveth,48,26,22,54.17
Gnar,Rumble,41,9,32,21.95
Gnar,Taric,69,28,41,40.58
Gnar,TwistedFate,89,42,47,47.19
Gnar,Anivia,109,50,59,45.87
Gnar,Akshan,68,32,36,47.06
Gnar,Nidalee,53,27,26,50.94
Riven,Gangplank,125,54,71,43.2
Riven,Ivern,87,51,36,58.62
Riven,Mel,679,295,384,43.45
Riven,Jhin,540,229,311,42.41
Riven,Swain,319,132,187,41.38
Riven,Urgot,139,54,85,38.85
Riven,Kayn,391,161,230,41.18
Riven,Yasuo,534,237,297,44.38
Riven,Twitch,237,94,143,39.66
Riven,Neeko,193,90,103,46.63
Riven,Gragas,157,74,83,47.13
Riven,Gwen,235,98,137,41.7
Riven,Zeri,116,48,68,41.38
Riven,Bard,71,28,43,39.44
Riven,Shen,167,70,97,41.92
Riven,Yone,505,261,244,51.68
Riven,Ashe,458,161,297,35.15
Riven,Alistar,71,25,46,35.21
Riven,XinZhao,181,74,107,40.88
Riven,Lucian,188,101,87,53.72
Riven,Velkoz,161,83,78,51.55
Riven,Evelynn,189,82,107,43.39
Riven,Irelia,188,63,125,33.51
Riven,Tristana,251,87,164,34.66
Riven,Lux,727,307,420,42.23
Riven,Azir,73,31,42,42.47
Riven,Sejuani,73,45,28,61.64
Riven,Sylas,264,140,124,53.03
Riven,Seraphine,268,120,148,44.78
Riven,Mordekaiser,422,165,257,39.1
Riven,Morgana,320,142,178,44.38
Riven,Braum,102,47,55,46.08
Riven,Aurora,230,89,141,38.7
Riven,FiddleSticks,199,92,107,46.23
Riven,Vex,142,68,74,47.89
Riven,Sett,453,208,245,45.92
Riven,Akali,278,99,179,35.61
Riven,Samira,339,182,157,53.69
Riven,Udyr,79,22,57,27.85
Riven,Orianna,107,68,39,63.55
Riven,Nautilus,281,113,168,40.21
Riven,Yorick,226,106,120,46.9
Riven,MasterYi,238,114,124,47.9
Riven,Nami,253,72,181,28.46
Riven,Garen,462,130,332,28.14
Riven,Zed,293,139,154,47.44
Riven,Caitlyn,619,218,401,35.22
Riven,Soraka,146,64,82,43.84
Riven,TahmKench,220,96,124,43.64
Riven,Malzahar,131,45,86,34.35
Riven,MissFortune,467,177,290,37.9
Riven,Blitzcrank,190,74,116,38.95
Riven,LeeSin,211,112,99,53.08
Riven,Ahri,296,113,183,38.18
Riven,Darius,574,223,351,38.85
Riven,Vladimir,166,47,119,28.31
Riven,Kindred,116,64,52,55.17
Riven,Sona,127,54,73,42.52
Riven,Khazix,198,94,104,47.47
Riven,Katarina,217,121,96,55.76
Riven,Aphelios,147,68,79,46.26
Riven,Lulu,191,70,121,36.65
Riven,Briar,239,95,144,39.75
Riven,Corki,108,44,64,40.74
Riven,Pantheon,432,134,298,31.02
Riven,Warwick,328,139,189,42.38
Riven,Heimerdinger,126,74,52,58.73
Riven,Anivia,125,55,70,44
Riven,Viego,364,156,208,42.86
Riven,Jax,165,72,93,43.64
Riven,Xayah,173,77,96,44.51
Riven,Fiora,165,78,87,47.27
Riven,Ezreal,420,204,216,48.57
Riven,Akshan,80,41,39,51.25
Riven,Syndra,163,62,101,38.04
Riven,Xerath,144,70,74,48.61
Riven,Karma,205,97,108,47.32
Riven,Rengar,144,62,82,43.06
Riven,Naafiri,79,20,59,25.32
Riven,DrMundo,129,50,79,38.76
Riven,Jinx,513,199,314,38.79
Riven,Ekko,331,134,197,40.48
Riven,Rakan,122,76,46,62.3
Riven,Diana,380,167,213,43.95
Riven,Chogath,326,134,192,41.1
Riven,Nunu,217,88,129,40.55
Riven,Viktor,157,57,100,36.31
Riven,Poppy,185,59,126,31.89
Riven,Zac,99,48,51,48.48
Riven,Kaisa,380,203,177,53.42
Riven,Leblanc,111,66,45,59.46
Riven,Renekton,172,56,116,32.56
Riven,Rammus,109,48,61,44.04
Riven,Brand,124,57,67,45.97
Riven,Hecarim,113,42,71,37.17
Riven,Camille,105,48,57,45.71
Riven,Rell,158,61,97,38.61
Riven,JarvanIV,85,33,52,38.82
Riven,Zilean,84,46,38,54.76
Riven,KSante,85,27,58,31.76
Riven,Trundle,138,49,89,35.51
Riven,Kassadin,49,20,29,40.82
Riven,Milio,165,64,101,38.79
Riven,Nidalee,75,43,32,57.33
Riven,Pyke,292,100,192,34.25
Riven,Teemo,358,158,200,44.13
Riven,Senna,260,129,131,49.62
Riven,Amumu,238,101,137,42.44
Riven,Qiyana,70,51,19,72.86
Riven,Zoe,122,50,72,40.98
Riven,Kled,54,20,34,37.04
Riven,Draven,140,69,71,49.29
Riven,Volibear,272,117,155,43.01
Riven,Yuumi,204,61,143,29.9
Riven,Annie,112,44,68,39.29
Riven,Nilah,147,47,100,31.97
Riven,Aatrox,249,138,111,55.42
Riven,Shaco,257,115,142,44.75
Riven,Thresh,397,148,249,37.28
Riven,Kennen,111,69,42,62.16
Riven,Ryze,49,19,30,38.78
Riven,Taric,80,22,58,27.5
Riven,Malphite,253,70,183,27.67
Riven,Ambessa,204,121,83,59.31
Riven,Singed,74,15,59,20.27
Riven,Renata,89,26,63,29.21
Riven,Vi,237,103,134,43.46
Riven,Ziggs,161,73,88,45.34
Riven,Veigar,268,96,172,35.82
Riven,Graves,134,72,62,53.73
Riven,Cassiopeia,107,40,67,37.38
Riven,Maokai,120,31,89,25.83
Riven,Vayne,228,115,113,50.44
Riven,Zyra,147,47,100,31.97
Riven,Illaoi,133,35,98,26.32
Riven,Galio,167,76,91,45.51
Riven,Tryndamere,154,72,82,46.75
Riven,Lillia,149,57,92,38.26
Riven,Leona,132,53,79,40.15
Riven,Sion,278,97,181,34.89
Riven,Skarner,85,38,47,44.71
Riven,Lissandra,50,26,24,52
Riven,Karthus,65,21,44,32.31
Riven,Gnar,97,46,51,47.42
Riven,MonkeyKing,132,51,81,38.64
Riven,Sivir,110,45,65,40.91
Riven,Varus,137,85,52,62.04
Riven,Shyvana,54,24,30,44.44
Riven,Smolder,194,94,100,48.45
Riven,Hwei,180,75,105,41.67
Riven,Kalista,113,40,73,35.4
Riven,Nasus,245,96,149,39.18
Riven,Nocturne,151,67,84,44.37
Riven,Elise,161,89,72,55.28
Riven,Kayle,131,49,82,37.4
Riven,Fizz,134,40,94,29.85
Riven,TwistedFate,91,38,53,41.76
Riven,KogMaw,72,35,37,48.61
Riven,AurelionSol,78,30,48,38.46
Riven,Taliyah,87,31,56,35.63
Riven,Olaf,54,27,27,50
Riven,Jayce,123,63,60,51.22
Riven,Ornn,113,19,94,16.81
Riven,Talon,180,106,74,58.89
Riven,Belveth,62,22,40,35.48
Riven,Janna,90,26,64,28.89
Riven,Quinn,99,55,44,55.56
Riven,RekSai,50,13,37,26
Riven,Rumble,66,21,45,31.82
AurelionSol,Heimerdinger,181,103,78,56.91
AurelionSol,Warwick,405,256,149,63.21
AurelionSol,Neeko,219,134,85,61.19
AurelionSol,Draven,126,81,45,64.29
AurelionSol,Leona,219,135,84,61.64
AurelionSol,Talon,161,98,63,60.87
AurelionSol,Ahri,408,207,201,50.74
AurelionSol,Kalista,160,116,44,72.5
AurelionSol,Brand,187,113,74,60.43
AurelionSol,Braum,146,66,80,45.21
AurelionSol,XinZhao,91,57,34,62.64
AurelionSol,Lux,849,481,368,56.65
AurelionSol,Chogath,418,232,186,55.5
AurelionSol,Taliyah,86,63,23,73.26
AurelionSol,Poppy,181,105,76,58.01
AurelionSol,Diana,357,199,158,55.74
AurelionSol,Anivia,88,46,42,52.27
AurelionSol,Caitlyn,690,361,329,52.32
AurelionSol,Thresh,361,156,205,43.21
AurelionSol,Fiora,132,78,54,59.09
AurelionSol,Yone,509,264,245,51.87
AurelionSol,Galio,234,87,147,37.18
AurelionSol,Ezreal,433,242,191,55.89
AurelionSol,Tristana,273,123,150,45.05
AurelionSol,Veigar,354,188,166,53.11
AurelionSol,Ziggs,149,50,99,33.56
AurelionSol,KSante,85,41,44,48.24
AurelionSol,Udyr,110,75,35,68.18
AurelionSol,Ashe,409,226,183,55.26
AurelionSol,Nautilus,317,161,156,50.79
AurelionSol,Aurora,249,139,110,55.82
AurelionSol,FiddleSticks,118,69,49,58.47
AurelionSol,Yasuo,516,234,282,45.35
AurelionSol,Jhin,437,202,235,46.22
AurelionSol,Vex,117,61,56,52.14
AurelionSol,Gnar,139,90,49,64.75
AurelionSol,Volibear,229,153,76,66.81
AurelionSol,Mel,760,372,388,48.95
AurelionSol,Samira,251,109,142,43.43
AurelionSol,Seraphine,343,167,176,48.69
AurelionSol,Pantheon,424,215,209,50.71
AurelionSol,Kindred,128,63,65,49.22
AurelionSol,Teemo,414,165,249,39.86
AurelionSol,Lucian,198,125,73,63.13
AurelionSol,Zyra,182,92,90,50.55
AurelionSol,Khazix,138,68,70,49.28
AurelionSol,Varus,196,87,109,44.39
AurelionSol,Yuumi,227,138,89,60.79
AurelionSol,TahmKench,326,197,129,60.43
AurelionSol,Nocturne,256,129,127,50.39
AurelionSol,Qiyana,91,46,45,50.55
AurelionSol,Sett,452,248,204,54.87
AurelionSol,Briar,327,212,115,64.83
AurelionSol,Nilah,150,75,75,50
AurelionSol,Morgana,262,124,138,47.33
AurelionSol,Kayn,361,183,178,50.69
AurelionSol,Akali,238,164,74,68.91
AurelionSol,Sivir,127,51,76,40.16
AurelionSol,Hwei,223,104,119,46.64
AurelionSol,Urgot,132,51,81,38.64
AurelionSol,Sylas,216,114,102,52.78
AurelionSol,Zed,236,125,111,52.97
AurelionSol,Rakan,115,60,55,52.17
AurelionSol,Zoe,135,71,64,52.59
AurelionSol,Nunu,216,119,97,55.09
AurelionSol,Katarina,178,98,80,55.06
AurelionSol,Pyke,351,212,139,60.4
AurelionSol,Ekko,159,77,82,48.43
AurelionSol,Shaco,285,170,115,59.65
AurelionSol,Velkoz,181,86,95,47.51
AurelionSol,Darius,504,249,255,49.4
AurelionSol,Jax,257,138,119,53.7
AurelionSol,MissFortune,714,428,286,59.94
AurelionSol,Illaoi,131,42,89,32.06
AurelionSol,Ryze,92,43,49,46.74
AurelionSol,Blitzcrank,208,119,89,57.21
AurelionSol,Yorick,267,130,137,48.69
AurelionSol,Viego,336,134,202,39.88
AurelionSol,Vi,278,147,131,52.88
AurelionSol,Singed,107,64,43,59.81
AurelionSol,Gwen,197,124,73,62.94
AurelionSol,Amumu,330,139,191,42.12
AurelionSol,Garen,384,185,199,48.18
AurelionSol,Jinx,559,280,279,50.09
AurelionSol,Nami,251,125,126,49.8
AurelionSol,Mordekaiser,432,201,231,46.53
AurelionSol,Rengar,127,84,43,66.14
AurelionSol,Hecarim,120,57,63,47.5
AurelionSol,Twitch,227,112,115,49.34
AurelionSol,DrMundo,179,92,87,51.4
AurelionSol,Graves,163,91,72,55.83
AurelionSol,Zac,119,80,39,67.23
AurelionSol,Irelia,223,143,80,64.13
AurelionSol,Alistar,87,49,38,56.32
AurelionSol,Evelynn,184,130,54,70.65
AurelionSol,Syndra,202,120,82,59.41
AurelionSol,Kled,66,42,24,63.64
AurelionSol,Lillia,187,71,116,37.97
AurelionSol,MonkeyKing,133,54,79,40.6
AurelionSol,Elise,217,137,80,63.13
AurelionSol,Kayle,219,109,110,49.77
AurelionSol,Vladimir,130,61,69,46.92
AurelionSol,Malphite,186,66,120,35.48
AurelionSol,Kassadin,32,23,9,71.88
AurelionSol,Sion,226,109,117,48.23
AurelionSol,Leblanc,73,42,31,57.53
AurelionSol,LeeSin,303,171,132,56.44
AurelionSol,MasterYi,284,155,129,54.58
AurelionSol,Kaisa,432,249,183,57.64
AurelionSol,Vayne,275,142,133,51.64
AurelionSol,Nidalee,90,45,45,50
AurelionSol,Aphelios,155,78,77,50.32
AurelionSol,Xerath,159,99,60,62.26
AurelionSol,Soraka,210,125,85,59.52
AurelionSol,Jayce,170,91,79,53.53
AurelionSol,Milio,105,41,64,39.05
AurelionSol,Shen,191,121,70,63.35
AurelionSol,Naafiri,151,70,81,46.36
AurelionSol,Zeri,136,77,59,56.62
AurelionSol,TwistedFate,99,52,47,52.53
AurelionSol,Sona,91,30,61,32.97
AurelionSol,Malzahar,286,140,146,48.95
AurelionSol,Aatrox,258,173,85,67.05
AurelionSol,Karthus,86,32,54,37.21
AurelionSol,JarvanIV,124,70,54,56.45
AurelionSol,Bard,81,51,30,62.96
AurelionSol,Swain,276,159,117,57.61
AurelionSol,KogMaw,107,46,61,42.99
AurelionSol,Senna,287,130,157,45.3
AurelionSol,Rell,208,133,75,63.94
AurelionSol,Xayah,142,100,42,70.42
AurelionSol,Nasus,247,129,118,52.23
AurelionSol,Akshan,100,49,51,49
AurelionSol,Lulu,228,90,138,39.47
AurelionSol,Cassiopeia,95,41,54,43.16
AurelionSol,Camille,81,49,32,60.49
AurelionSol,Azir,73,53,20,72.6
AurelionSol,Smolder,179,98,81,54.75
AurelionSol,Riven,78,48,30,61.54
AurelionSol,Zilean,64,36,28,56.25
AurelionSol,Skarner,73,31,42,42.47
AurelionSol,Kennen,101,55,46,54.46
AurelionSol,Orianna,146,78,68,53.42
AurelionSol,Belveth,63,29,34,46.03
AurelionSol,Fizz,161,86,75,53.42
AurelionSol,Tryndamere,186,104,82,55.91
AurelionSol,Quinn,85,61,24,71.76
AurelionSol,Viktor,192,97,95,50.52
AurelionSol,Rammus,74,35,39,47.3
AurelionSol,Karma,126,88,38,69.84
AurelionSol,Sejuani,84,36,48,42.86
AurelionSol,Corki,89,69,20,77.53
AurelionSol,Trundle,181,100,81,55.25
AurelionSol,Gragas,146,95,51,65.07
AurelionSol,Ambessa,164,85,79,51.83
AurelionSol,Ivern,81,52,29,64.2
AurelionSol,Gangplank,98,67,31,68.37
AurelionSol,Annie,93,68,25,73.12
AurelionSol,Lissandra,88,41,47,46.59
AurelionSol,Maokai,123,55,68,44.72
AurelionSol,Ornn,118,57,61,48.31
AurelionSol,Taric,74,64,10,86.49
AurelionSol,Janna,67,45,22,67.16
AurelionSol,Renata,52,34,18,65.38
AurelionSol,Rumble,50,11,39,22
AurelionSol,Olaf,72,38,34,52.78
AurelionSol,Shyvana,84,29,55,34.52
AurelionSol,Renekton,121,52,69,42.98
AurelionSol,RekSai,39,16,23,41.03
Heimerdinger,Yone,662,380,282,57.4
Heimerdinger,Shaco,335,209,126,62.39
Heimerdinger,AurelionSol,181,78,103,43.09
Heimerdinger,Ashe,583,260,323,44.6
Heimerdinger,Velkoz,155,89,66,57.42
Heimerdinger,Yorick,352,160,192,45.45
Heimerdinger,Kayn,507,272,235,53.65
Heimerdinger,Singed,123,43,80,34.96
Heimerdinger,Udyr,106,50,56,47.17
Heimerdinger,Mordekaiser,583,314,269,53.86
Heimerdinger,Briar,306,122,184,39.87
Heimerdinger,Zed,279,155,124,55.56
Heimerdinger,Jinx,714,340,374,47.62
Heimerdinger,Lillia,218,115,103,52.75
Heimerdinger,Darius,639,371,268,58.06
Heimerdinger,Volibear,369,154,215,41.73
Heimerdinger,Caitlyn,717,386,331,53.84
Heimerdinger,TahmKench,382,191,191,50
Heimerdinger,Garen,454,213,241,46.92
Heimerdinger,Tristana,317,176,141,55.52
Heimerdinger,Lux,872,459,413,52.64
Heimerdinger,Morgana,534,292,242,54.68
Heimerdinger,Warwick,541,293,248,54.16
Heimerdinger,Akali,363,237,126,65.29
Heimerdinger,Akshan,192,98,94,51.04
Heimerdinger,Pantheon,530,287,243,54.15
Heimerdinger,Leblanc,105,79,26,75.24
Heimerdinger,Aphelios,252,139,113,55.16
Heimerdinger,Leona,245,135,110,55.1
Heimerdinger,Nunu,383,149,234,38.9
Heimerdinger,KSante,108,75,33,69.44
Heimerdinger,Zeri,132,68,64,51.52
Heimerdinger,Lulu,271,89,182,32.84
Heimerdinger,Malphite,177,88,89,49.72
Heimerdinger,Jhin,589,281,308,47.71
Heimerdinger,Evelynn,143,89,54,62.24
Heimerdinger,Gragas,202,106,96,52.48
Heimerdinger,Pyke,441,237,204,53.74
Heimerdinger,MasterYi,312,153,159,49.04
Heimerdinger,Aatrox,273,153,120,56.04
Heimerdinger,Viego,263,176,87,66.92
Heimerdinger,Fizz,178,83,95,46.63
Heimerdinger,Taric,54,33,21,61.11
Heimerdinger,Trundle,153,57,96,37.25
Heimerdinger,Nocturne,299,146,153,48.83
Heimerdinger,Orianna,141,68,73,48.23
Heimerdinger,Veigar,445,209,236,46.97
Heimerdinger,Brand,265,114,151,43.02
Heimerdinger,Ivern,72,51,21,70.83
Heimerdinger,Katarina,294,167,127,56.8
Heimerdinger,Nami,289,170,119,58.82
Heimerdinger,Teemo,514,264,250,51.36
Heimerdinger,Vi,276,185,91,67.03
Heimerdinger,Bard,88,41,47,46.59
Heimerdinger,Vladimir,202,114,88,56.44
Heimerdinger,Sylas,355,222,133,62.54
Heimerdinger,Ekko,271,136,135,50.18
Heimerdinger,Syndra,209,103,106,49.28
Heimerdinger,Samira,261,138,123,52.87
Heimerdinger,Maokai,129,75,54,58.14
Heimerdinger,Swain,308,147,161,47.73
Heimerdinger,MonkeyKing,168,97,71,57.74
Heimerdinger,Ezreal,641,340,301,53.04
Heimerdinger,Tryndamere,213,136,77,63.85
Heimerdinger,Irelia,278,163,115,58.63
Heimerdinger,Nautilus,316,141,175,44.62
Heimerdinger,Olaf,115,43,72,37.39
Heimerdinger,Aurora,394,222,172,56.35
Heimerdinger,Kaisa,413,256,157,61.99
Heimerdinger,Poppy,142,92,50,64.79
Heimerdinger,Illaoi,229,144,85,62.88
Heimerdinger,Anivia,93,38,55,40.86
Heimerdinger,JarvanIV,50,18,32,36
Heimerdinger,MissFortune,912,458,454,50.22
Heimerdinger,RekSai,54,26,28,48.15
Heimerdinger,Seraphine,461,284,177,61.61
Heimerdinger,Riven,126,52,74,41.27
Heimerdinger,Hwei,186,98,88,52.69
Heimerdinger,Vex,222,88,134,39.64
Heimerdinger,Mel,695,420,275,60.43
Heimerdinger,Twitch,304,141,163,46.38
Heimerdinger,Xayah,203,150,53,73.89
Heimerdinger,Rengar,106,58,48,54.72
Heimerdinger,Shen,232,123,109,53.02
Heimerdinger,Thresh,372,235,137,63.17
Heimerdinger,Gwen,193,123,70,63.73
Heimerdinger,Blitzcrank,315,167,148,53.02
Heimerdinger,Xerath,188,91,97,48.4
Heimerdinger,Yasuo,703,369,334,52.49
Heimerdinger,Sett,595,312,283,52.44
Heimerdinger,Lucian,171,85,86,49.71
Heimerdinger,LeeSin,276,152,124,55.07
Heimerdinger,Malzahar,215,91,124,42.33
Heimerdinger,Galio,220,89,131,40.45
Heimerdinger,Yuumi,274,162,112,59.12
Heimerdinger,Viktor,152,89,63,58.55
Heimerdinger,Graves,130,89,41,68.46
Heimerdinger,Diana,504,282,222,55.95
Heimerdinger,Draven,141,88,53,62.41
Heimerdinger,Nidalee,60,33,27,55
Heimerdinger,Amumu,353,159,194,45.04
Heimerdinger,Renata,98,45,53,45.92
Heimerdinger,Smolder,240,104,136,43.33
Heimerdinger,Rell,169,81,88,47.93
Heimerdinger,Varus,216,120,96,55.56
Heimerdinger,Jax,278,152,126,54.68
Heimerdinger,Sivir,156,85,71,54.49
Heimerdinger,Sona,171,74,97,43.27
Heimerdinger,Kled,81,52,29,64.2
Heimerdinger,Nasus,318,163,155,51.26
Heimerdinger,Kalista,164,84,80,51.22
Heimerdinger,Ambessa,137,85,52,62.04
Heimerdinger,Naafiri,171,102,69,59.65
Heimerdinger,Milio,145,73,72,50.34
Heimerdinger,Ryze,81,29,52,35.8
Heimerdinger,XinZhao,207,108,99,52.17
Heimerdinger,Chogath,450,226,224,50.22
Heimerdinger,Khazix,199,120,79,60.3
Heimerdinger,Nilah,162,109,53,67.28
Heimerdinger,Senna,220,111,109,50.45
Heimerdinger,Zyra,205,91,114,44.39
Heimerdinger,Ziggs,199,100,99,50.25
Heimerdinger,FiddleSticks,180,89,91,49.44
Heimerdinger,Braum,132,91,41,68.94
Heimerdinger,Camille,83,56,27,67.47
Heimerdinger,Vayne,284,159,125,55.99
Heimerdinger,Neeko,289,180,109,62.28
Heimerdinger,Qiyana,96,56,40,58.33
Heimerdinger,Soraka,221,101,120,45.7
Heimerdinger,Kayle,194,93,101,47.94
Heimerdinger,Corki,74,36,38,48.65
Heimerdinger,Taliyah,103,49,54,47.57
Heimerdinger,Rakan,136,77,59,56.62
Heimerdinger,Annie,74,50,24,67.57
Heimerdinger,Talon,192,138,54,71.88
Heimerdinger,Quinn,134,87,47,64.93
Heimerdinger,DrMundo,231,112,119,48.48
Heimerdinger,Elise,225,116,109,51.56
Heimerdinger,Shyvana,106,34,72,32.08
Heimerdinger,Renekton,109,36,73,33.03
Heimerdinger,Urgot,128,64,64,50
Heimerdinger,Lissandra,70,33,37,47.14
Heimerdinger,Azir,109,73,36,66.97
Heimerdinger,Gnar,121,60,61,49.59
Heimerdinger,Hecarim,97,50,47,51.55
Heimerdinger,Cassiopeia,113,63,50,55.75
Heimerdinger,Fiora,161,82,79,50.93
Heimerdinger,Belveth,98,63,35,64.29
Heimerdinger,Karthus,76,12,64,15.79
Heimerdinger,Rammus,50,28,22,56
Heimerdinger,Kindred,163,95,68,58.28
Heimerdinger,Zilean,94,47,47,50
Heimerdinger,Sion,270,145,125,53.7
Heimerdinger,Karma,207,115,92,55.56
Heimerdinger,Alistar,109,76,33,69.72
Heimerdinger,Kennen,132,86,46,65.15
Heimerdinger,Jayce,171,145,26,84.8
Heimerdinger,Janna,88,53,35,60.23
Heimerdinger,Zoe,116,74,42,63.79
Heimerdinger,Kassadin,85,30,55,35.29
Heimerdinger,Skarner,108,70,38,64.81
Heimerdinger,Ahri,503,256,247,50.89
Heimerdinger,KogMaw,98,34,64,34.69
Heimerdinger,TwistedFate,109,58,51,53.21
Heimerdinger,Sejuani,135,81,54,60
Heimerdinger,Zac,116,60,56,51.72
Heimerdinger,Gangplank,140,68,72,48.57
Heimerdinger,Ornn,128,78,50,60.94
Heimerdinger,Rumble,47,19,28,40.43
Nocturne,Teemo,735,353,382,48.03
Nocturne,TahmKench,492,244,248,49.59
Nocturne,Jinx,1106,595,511,53.8
Nocturne,Zoe,193,123,70,63.73
Nocturne,Nami,450,226,224,50.22
Nocturne,Gragas,257,153,104,59.53
Nocturne,Gwen,287,142,145,49.48
Nocturne,Yasuo,1067,610,457,57.17
Nocturne,Zeri,195,89,106,45.64
Nocturne,Bard,132,59,73,44.7
Nocturne,Sylas,435,219,216,50.34
Nocturne,Ekko,412,197,215,47.82
Nocturne,Talon,304,125,179,41.12
Nocturne,Pyke,527,249,278,47.25
Nocturne,Yorick,433,220,213,50.81
Nocturne,Ezreal,736,345,391,46.88
Nocturne,Lux,1382,730,652,52.82
Nocturne,Fiora,224,160,64,71.43
Nocturne,LeeSin,528,300,228,56.82
Nocturne,Ziggs,174,97,77,55.75
Nocturne,Senna,478,243,235,50.84
Nocturne,Illaoi,302,169,133,55.96
Nocturne,Khazix,327,187,140,57.19
Nocturne,Syndra,237,122,115,51.48
Nocturne,Kaisa,674,348,326,51.63
Nocturne,Kennen,163,88,75,53.99
Nocturne,Skarner,164,102,62,62.2
Nocturne,Malzahar,374,167,207,44.65
Nocturne,Yuumi,505,273,232,54.06
Nocturne,Akali,443,223,220,50.34
Nocturne,Naafiri,235,111,124,47.23
Nocturne,Kayle,362,145,217,40.06
Nocturne,MissFortune,1102,539,563,48.91
Nocturne,Smolder,406,224,182,55.17
Nocturne,Evelynn,304,144,160,47.37
Nocturne,Brand,429,185,244,43.12
Nocturne,Sett,882,448,434,50.79
Nocturne,FiddleSticks,239,126,113,52.72
Nocturne,Tristana,503,255,248,50.7
Nocturne,Blitzcrank,420,251,169,59.76
Nocturne,Ornn,300,152,148,50.67
Nocturne,Amumu,587,288,299,49.06
Nocturne,Katarina,359,200,159,55.71
Nocturne,Twitch,461,254,207,55.1
Nocturne,RekSai,60,23,37,38.33
Nocturne,Hwei,386,225,161,58.29
Nocturne,Ashe,905,492,413,54.36
Nocturne,Braum,305,176,129,57.7
Nocturne,MasterYi,550,282,268,51.27
Nocturne,Shaco,465,262,203,56.34
Nocturne,Azir,192,110,82,57.29
Nocturne,Rengar,228,159,69,69.74
Nocturne,Kindred,322,189,133,58.7
Nocturne,Veigar,581,294,287,50.6
Nocturne,Yone,890,453,437,50.9
Nocturne,Lulu,411,220,191,53.53
Nocturne,Neeko,451,227,224,50.33
Nocturne,Kayn,897,463,434,51.62
Nocturne,Heimerdinger,299,153,146,51.17
Nocturne,Corki,181,126,55,69.61
Nocturne,Elise,385,224,161,58.18
Nocturne,Darius,931,494,437,53.06
Nocturne,Karma,297,153,144,51.52
Nocturne,Briar,589,280,309,47.54
Nocturne,Cassiopeia,201,106,95,52.74
Nocturne,Jhin,939,455,484,48.46
Nocturne,KSante,185,93,92,50.27
Nocturne,Ahri,638,358,280,56.11
Nocturne,Caitlyn,1239,637,602,51.41
Nocturne,Garen,724,340,384,46.96
Nocturne,AurelionSol,256,127,129,49.61
Nocturne,Kalista,198,93,105,46.97
Nocturne,Singed,166,78,88,46.99
Nocturne,Varus,298,145,153,48.66
Nocturne,Maokai,208,102,106,49.04
Nocturne,Warwick,858,393,465,45.8
Nocturne,Lucian,311,153,158,49.2
Nocturne,Zilean,221,134,87,60.63
Nocturne,Sona,227,120,107,52.86
Nocturne,Ivern,109,53,56,48.62
Nocturne,Irelia,534,343,191,64.23
Nocturne,Poppy,300,152,148,50.67
Nocturne,Mordekaiser,689,303,386,43.98
Nocturne,Akshan,165,47,118,28.48
Nocturne,Jax,413,214,199,51.82
Nocturne,Volibear,615,325,290,52.85
Nocturne,Ambessa,318,182,136,57.23
Nocturne,Mel,1113,575,538,51.66
Nocturne,Xayah,341,177,164,51.91
Nocturne,Rakan,203,79,124,38.92
Nocturne,Sejuani,177,91,86,51.41
Nocturne,Urgot,270,131,139,48.52
Nocturne,Seraphine,607,319,288,52.55
Nocturne,Gangplank,195,120,75,61.54
Nocturne,Kled,81,47,34,58.02
Nocturne,Pantheon,810,356,454,43.95
Nocturne,Vex,333,142,191,42.64
Nocturne,Chogath,575,312,263,54.26
Nocturne,Aphelios,352,206,146,58.52
Nocturne,Karthus,127,55,72,43.31
Nocturne,Taliyah,144,108,36,75
Nocturne,Morgana,711,359,352,50.49
Nocturne,Viego,594,293,301,49.33
Nocturne,Leblanc,142,75,67,52.82
Nocturne,Gnar,197,93,104,47.21
Nocturne,Samira,413,184,229,44.55
Nocturne,Leona,379,196,183,51.72
Nocturne,Draven,271,175,96,64.58
Nocturne,Zed,441,238,203,53.97
Nocturne,Lillia,246,124,122,50.41
Nocturne,Trundle,364,159,205,43.68
Nocturne,Lissandra,141,73,68,51.77
Nocturne,JarvanIV,156,81,75,51.92
Nocturne,Tryndamere,262,168,94,64.12
Nocturne,Orianna,270,149,121,55.19
Nocturne,Diana,755,444,311,58.81
Nocturne,Kassadin,123,54,69,43.9
Nocturne,Galio,369,205,164,55.56
Nocturne,Swain,523,212,311,40.54
Nocturne,Nilah,328,186,142,56.71
Nocturne,Nautilus,552,249,303,45.11
Nocturne,Nasus,362,199,163,54.97
Nocturne,Zyra,296,163,133,55.07
Nocturne,Ryze,147,90,57,61.22
Nocturne,Janna,129,59,70,45.74
Nocturne,Vi,483,281,202,58.18
Nocturne,Vladimir,340,137,203,40.29
Nocturne,Malphite,364,188,176,51.65
Nocturne,Thresh,671,346,325,51.56
Nocturne,Quinn,157,68,89,43.31
Nocturne,Hecarim,168,80,88,47.62
Nocturne,Renekton,173,81,92,46.82
Nocturne,Qiyana,142,70,72,49.3
Nocturne,Vayne,483,232,251,48.03
Nocturne,Viktor,288,116,172,40.28
Nocturne,Annie,121,88,33,72.73
Nocturne,Shen,246,112,134,45.53
Nocturne,Jayce,179,97,82,54.19
Nocturne,Aatrox,462,270,192,58.44
Nocturne,Nunu,457,217,240,47.48
Nocturne,Fizz,270,131,139,48.52
Nocturne,Rell,284,164,120,57.75
Nocturne,Sivir,316,142,174,44.94
Nocturne,Velkoz,298,163,135,54.7
Nocturne,Camille,173,125,48,72.25
Nocturne,Soraka,264,126,138,47.73
Nocturne,Alistar,151,83,68,54.97
Nocturne,TwistedFate,193,110,83,56.99
Nocturne,Aurora,516,271,245,52.52
Nocturne,Zac,137,65,72,47.45
Nocturne,DrMundo,314,131,183,41.72
Nocturne,KogMaw,132,62,70,46.97
Nocturne,Riven,151,84,67,55.63
Nocturne,Graves,232,142,90,61.21
Nocturne,Udyr,138,64,74,46.38
Nocturne,Renata,102,51,51,50
Nocturne,Nidalee,120,81,39,67.5
Nocturne,Xerath,345,185,160,53.62
Nocturne,MonkeyKing,215,93,122,43.26
Nocturne,Anivia,143,78,65,54.55
Nocturne,Sion,357,158,199,44.26
Nocturne,XinZhao,265,148,117,55.85
Nocturne,Rammus,142,86,56,60.56
Nocturne,Rumble,65,37,28,56.92
Nocturne,Olaf,119,73,46,61.34
Nocturne,Milio,227,124,103,54.63
Nocturne,Shyvana,108,70,38,64.81
Nocturne,Belveth,171,111,60,64.91
Nocturne,Taric,82,35,47,42.68
Ornn,Akali,287,147,140,51.22
Ornn,MissFortune,440,245,195,55.68
Ornn,Kassadin,62,37,25,59.68
Ornn,Kayn,413,249,164,60.29
Ornn,Sona,78,57,21,73.08
Ornn,Vladimir,133,71,62,53.38
Ornn,Zac,49,20,29,40.82
Ornn,Cassiopeia,69,32,37,46.38
Ornn,Irelia,249,121,128,48.59
Ornn,Lux,648,358,290,55.25
Ornn,Jax,219,127,92,57.99
Ornn,Elise,163,100,63,61.35
Ornn,Kaisa,303,169,134,55.78
Ornn,Twitch,193,101,92,52.33
Ornn,Yuumi,207,117,90,56.52
Ornn,Gangplank,129,58,71,44.96
Ornn,Nocturne,300,148,152,49.33
Ornn,Yasuo,501,244,257,48.7
Ornn,Corki,68,22,46,32.35
Ornn,Ambessa,184,89,95,48.37
Ornn,Kalista,139,72,67,51.8
Ornn,Swain,291,121,170,41.58
Ornn,Garen,401,217,184,54.11
Ornn,LeeSin,280,146,134,52.14
Ornn,Aurora,232,120,112,51.72
Ornn,Rell,114,54,60,47.37
Ornn,Aatrox,262,128,134,48.85
Ornn,Vi,251,126,125,50.2
Ornn,Yone,462,278,184,60.17
Ornn,Nasus,183,110,73,60.11
Ornn,Sion,235,155,80,65.96
Ornn,Yorick,220,88,132,40
Ornn,Xerath,162,83,79,51.23
Ornn,Jhin,544,252,292,46.32
Ornn,Lulu,137,79,58,57.66
Ornn,Trundle,152,69,83,45.39
Ornn,MasterYi,229,128,101,55.9
Ornn,Ahri,319,185,134,57.99
Ornn,Varus,214,87,127,40.65
Ornn,Gragas,146,71,75,48.63
Ornn,Syndra,192,120,72,62.5
Ornn,Sett,397,188,209,47.36
Ornn,Kled,69,29,40,42.03
Ornn,Warwick,457,228,229,49.89
Ornn,Taliyah,62,34,28,54.84
Ornn,Ezreal,397,259,138,65.24
Ornn,TahmKench,314,170,144,54.14
Ornn,Teemo,398,226,172,56.78
Ornn,Graves,104,43,61,41.35
Ornn,Zoe,129,63,66,48.84
Ornn,Katarina,164,80,84,48.78
Ornn,Quinn,80,46,34,57.5
Ornn,Shaco,212,121,91,57.08
Ornn,Darius,412,221,191,53.64
Ornn,Braum,122,59,63,48.36
Ornn,Viego,300,143,157,47.67
Ornn,Zed,190,108,82,56.84
Ornn,Soraka,202,107,95,52.97
Ornn,Vayne,315,165,150,52.38
Ornn,Briar,249,160,89,64.26
Ornn,Orianna,149,77,72,51.68
Ornn,Mel,546,310,236,56.78
Ornn,Jinx,513,270,243,52.63
Ornn,Thresh,316,137,179,43.35
Ornn,Kayle,192,72,120,37.5
Ornn,XinZhao,147,88,59,59.86
Ornn,Vex,145,71,74,48.97
Ornn,Ashe,420,208,212,49.52
Ornn,Veigar,261,107,154,41
Ornn,Tristana,277,156,121,56.32
Ornn,Nautilus,327,179,148,54.74
Ornn,Khazix,124,79,45,63.71
Ornn,Sylas,284,156,128,54.93
Ornn,Xayah,167,76,91,45.51
Ornn,Rakan,114,63,51,55.26
Ornn,Fizz,110,47,63,42.73
Ornn,Pantheon,396,199,197,50.25
Ornn,Volibear,284,134,150,47.18
Ornn,Morgana,344,159,185,46.22
Ornn,Ekko,189,109,80,57.67
Ornn,Caitlyn,563,309,254,54.88
Ornn,Brand,157,100,57,63.69
Ornn,KSante,151,66,85,43.71
Ornn,Poppy,116,73,43,62.93
Ornn,Bard,105,52,53,49.52
Ornn,Nami,222,91,131,40.99
Ornn,Amumu,226,104,122,46.02
Ornn,Qiyana,118,51,67,43.22
Ornn,Mordekaiser,415,226,189,54.46
Ornn,Illaoi,74,40,34,54.05
Ornn,Hwei,160,90,70,56.25
Ornn,Evelynn,148,85,63,57.43
Ornn,Senna,264,116,148,43.94
Ornn,Zilean,94,52,42,55.32
Ornn,Malphite,140,90,50,64.29
Ornn,Fiora,212,122,90,57.55
Ornn,Milio,161,94,67,58.39
Ornn,Shen,184,88,96,47.83
Ornn,Malzahar,198,67,131,33.84
Ornn,Nilah,181,127,54,70.17
Ornn,Ziggs,120,76,44,63.33
Ornn,JarvanIV,99,66,33,66.67
Ornn,Naafiri,156,103,53,66.03
Ornn,Leblanc,87,56,31,64.37
Ornn,Smolder,243,116,127,47.74
Ornn,Janna,67,28,39,41.79
Ornn,Diana,347,149,198,42.94
Ornn,Samira,249,121,128,48.59
Ornn,Zyra,159,90,69,56.6
Ornn,Olaf,81,33,48,40.74
Ornn,Annie,91,33,58,36.26
Ornn,Karma,155,107,48,69.03
Ornn,Hecarim,79,28,51,35.44
Ornn,Lissandra,65,38,27,58.46
Ornn,Anivia,77,39,38,50.65
Ornn,Sivir,130,87,43,66.92
Ornn,Taric,40,16,24,40
Ornn,Udyr,77,34,43,44.16
Ornn,FiddleSticks,104,58,46,55.77
Ornn,Gnar,130,88,42,67.69
Ornn,Rengar,117,80,37,68.38
Ornn,Alistar,92,47,45,51.09
Ornn,Lucian,157,74,83,47.13
Ornn,Chogath,399,236,163,59.15
Ornn,Leona,197,93,104,47.21
Ornn,Velkoz,154,78,76,50.65
Ornn,MonkeyKing,116,51,65,43.97
Ornn,Blitzcrank,185,107,78,57.84
Ornn,Sejuani,40,19,21,47.5
Ornn,Pyke,278,172,106,61.87
Ornn,Nunu,216,118,98,54.63
Ornn,TwistedFate,39,14,25,35.9
Ornn,KogMaw,69,38,31,55.07
Ornn,Camille,92,55,37,59.78
Ornn,Ryze,74,41,33,55.41
Ornn,Gwen,125,79,46,63.2
Ornn,Jayce,67,48,19,71.64
Ornn,Shyvana,54,24,30,44.44
Ornn,Azir,97,45,52,46.39
Ornn,Seraphine,293,157,136,53.58
Ornn,Zeri,86,53,33,61.63
Ornn,Lillia,165,81,84,49.09
Ornn,Galio,192,94,98,48.96
Ornn,Talon,175,114,61,65.14
Ornn,Kindred,152,87,65,57.24
Ornn,Akshan,95,65,30,68.42
Ornn,Kennen,109,63,46,57.8
Ornn,Draven,146,90,56,61.64
Ornn,Tryndamere,174,89,85,51.15
Ornn,Nidalee,88,66,22,75
Ornn,RekSai,46,19,27,41.3
Ornn,DrMundo,183,71,112,38.8
Ornn,Neeko,151,74,77,49.01
Ornn,Ivern,38,9,29,23.68
Ornn,Maokai,101,42,59,41.58
Ornn,Renekton,88,58,30,65.91
Ornn,Viktor,181,84,97,46.41
Ornn,Riven,113,94,19,83.19
Ornn,Aphelios,169,108,61,63.91
Ornn,Skarner,57,21,36,36.84
Ornn,Heimerdinger,128,50,78,39.06
Ornn,Rammus,85,53,32,62.35
Ornn,Singed,65,46,19,70.77
Ornn,Urgot,82,40,42,48.78
Ornn,AurelionSol,118,61,57,51.69
Ornn,Karthus,45,15,30,33.33
Ornn,Rumble,61,29,32,47.54
Ornn,Belveth,65,25,40,38.46
Ornn,Renata,63,31,32,49.21
Udyr,Akali,164,76,88,46.34
Udyr,MissFortune,457,215,242,47.05
Udyr,Kassadin,28,17,11,60.71
Udyr,Kayn,402,197,205,49
Udyr,Sona,79,52,27,65.82
Udyr,Heimerdinger,106,56,50,52.83
Udyr,Talon,125,56,69,44.8
Udyr,Ahri,291,153,138,52.58
Udyr,Kalista,97,54,43,55.67
Udyr,Brand,162,76,86,46.91
Udyr,Urgot,136,72,64,52.94
Udyr,Rengar,118,56,62,47.46
Udyr,Ziggs,104,63,41,60.58
Udyr,Trundle,121,61,60,50.41
Udyr,Fiora,138,59,79,42.75
Udyr,Sion,233,140,93,60.09
Udyr,MasterYi,226,116,110,51.33
Udyr,AurelionSol,110,35,75,31.82
Udyr,Ezreal,409,220,189,53.79
Udyr,Nami,216,79,137,36.57
Udyr,FiddleSticks,128,65,63,50.78
Udyr,Katarina,256,143,113,55.86
Udyr,Caitlyn,502,228,274,45.42
Udyr,Pyke,276,156,120,56.52
Udyr,Darius,500,228,272,45.6
Udyr,Neeko,152,97,55,63.82
Udyr,Taric,67,41,26,61.19
Udyr,Riven,79,57,22,72.15
Udyr,Vi,194,93,101,47.94
Udyr,Mel,479,270,209,56.37
Udyr,Soraka,106,51,55,48.11
Udyr,Kled,44,21,23,47.73
Udyr,Warwick,303,142,161,46.86
Udyr,Gragas,182,115,67,63.19
Udyr,Jinx,482,223,259,46.27
Udyr,Rell,132,66,66,50
Udyr,Olaf,62,42,20,67.74
Udyr,Evelynn,117,48,69,41.03
Udyr,Volibear,293,143,150,48.81
Udyr,Leona,144,63,81,43.75
Udyr,Teemo,355,186,169,52.39
Udyr,Shaco,215,103,112,47.91
Udyr,Yasuo,422,236,186,55.92
Udyr,Ashe,445,224,221,50.34
Udyr,Lux,624,351,273,56.25
Udyr,Akshan,112,76,36,67.86
Udyr,Hwei,134,71,63,52.99
Udyr,Xerath,112,60,52,53.57
Udyr,Mordekaiser,328,131,197,39.94
Udyr,MonkeyKing,126,60,66,47.62
Udyr,Tryndamere,147,75,72,51.02
Udyr,Irelia,148,76,72,51.35
Udyr,Nautilus,277,127,150,45.85
Udyr,Nunu,200,80,120,40
Udyr,Leblanc,101,51,50,50.5
Udyr,Kaisa,313,182,131,58.15
Udyr,Jax,138,70,68,50.72
Udyr,Yone,401,195,206,48.63
Udyr,Samira,232,121,111,52.16
Udyr,Thresh,356,178,178,50
Udyr,Pantheon,414,195,219,47.1
Udyr,Graves,75,29,46,38.67
Udyr,Tristana,202,79,123,39.11
Udyr,Ambessa,138,66,72,47.83
Udyr,Zed,216,78,138,36.11
Udyr,Draven,165,110,55,66.67
Udyr,Bard,84,34,50,40.48
Udyr,DrMundo,114,54,60,47.37
Udyr,Sett,364,182,182,50
Udyr,Sejuani,77,31,46,40.26
Udyr,LeeSin,222,134,88,60.36
Udyr,Cassiopeia,101,54,47,53.47
Udyr,Senna,175,89,86,50.86
Udyr,Kennen,95,57,38,60
Udyr,Malzahar,167,78,89,46.71
Udyr,Morgana,303,141,162,46.53
Udyr,Singed,56,29,27,51.79
Udyr,Velkoz,125,48,77,38.4
Udyr,Kindred,124,56,68,45.16
Udyr,Aurora,241,122,119,50.62
Udyr,Zeri,129,57,72,44.19
Udyr,Azir,84,31,53,36.9
Udyr,Swain,225,116,109,51.56
Udyr,Aatrox,256,125,131,48.83
Udyr,Seraphine,240,120,120,50
Udyr,Jhin,395,220,175,55.7
Udyr,Ekko,177,74,103,41.81
Udyr,XinZhao,111,49,62,44.14
Udyr,Sylas,177,95,82,53.67
Udyr,Naafiri,98,52,46,53.06
Udyr,Poppy,134,58,76,43.28
Udyr,Twitch,206,58,148,28.16
Udyr,Ryze,95,56,39,58.95
Udyr,TahmKench,203,117,86,57.64
Udyr,Diana,282,128,154,45.39
Udyr,Viego,303,173,130,57.1
Udyr,Maokai,124,32,92,25.81
Udyr,Khazix,99,26,73,26.26
Udyr,Qiyana,65,44,21,67.69
Udyr,Lulu,156,88,68,56.41
Udyr,Malphite,165,76,89,46.06
Udyr,Kayle,156,67,89,42.95
Udyr,Zac,79,57,22,72.15
Udyr,Renekton,106,55,51,51.89
Udyr,Gnar,74,40,34,54.05
Udyr,Shen,222,91,131,40.99
Udyr,Lillia,157,96,61,61.15
Udyr,Orianna,60,22,38,36.67
Udyr,Briar,212,121,91,57.08
Udyr,Chogath,319,159,160,49.84
Udyr,Blitzcrank,157,73,84,46.5
Udyr,Milio,132,77,55,58.33
Udyr,Veigar,250,112,138,44.8
Udyr,Skarner,79,32,47,40.51
Udyr,Karma,164,63,101,38.41
Udyr,Vayne,227,112,115,49.34
Udyr,Garen,417,214,203,51.32
Udyr,Quinn,72,19,53,26.39
Udyr,Belveth,58,31,27,53.45
Udyr,Nasus,154,86,68,55.84
Udyr,TwistedFate,90,34,56,37.78
Udyr,Xayah,120,69,51,57.5
Udyr,Hecarim,72,43,29,59.72
Udyr,Yuumi,215,125,90,58.14
Udyr,Yorick,199,67,132,33.67
Udyr,KSante,114,57,57,50
Udyr,Ornn,77,43,34,55.84
Udyr,Zyra,103,42,61,40.78
Udyr,Vladimir,110,61,49,55.45
Udyr,Aphelios,135,66,69,48.89
Udyr,Illaoi,92,48,44,52.17
Udyr,Corki,76,51,25,67.11
Udyr,Karthus,58,21,37,36.21
Udyr,Nilah,81,38,43,46.91
Udyr,Janna,57,15,42,26.32
Udyr,Lucian,135,61,74,45.19
Udyr,Varus,166,74,92,44.58
Udyr,Sivir,117,42,75,35.9
Udyr,Fizz,104,54,50,51.92
Udyr,Nocturne,138,74,64,53.62
Udyr,Elise,149,79,70,53.02
Udyr,Amumu,203,99,104,48.77
Udyr,Syndra,140,72,68,51.43
Udyr,Gwen,149,98,51,65.77
Udyr,Annie,81,42,39,51.85
Udyr,Viktor,116,50,66,43.1
Udyr,Nidalee,93,73,20,78.49
Udyr,Zilean,78,28,50,35.9
Udyr,Taliyah,67,34,33,50.75
Udyr,Smolder,142,89,53,62.68
Udyr,Galio,170,56,114,32.94
Udyr,Rakan,123,70,53,56.91
Udyr,Vex,116,36,80,31.03
Udyr,Anivia,74,35,39,47.3
Udyr,KogMaw,84,35,49,41.67
Udyr,Gangplank,103,46,57,44.66
Udyr,Braum,103,72,31,69.9
Udyr,Ivern,41,25,16,60.98
Udyr,Rammus,67,23,44,34.33
Udyr,RekSai,38,24,14,63.16
Udyr,Zoe,92,38,54,41.3
Udyr,Alistar,91,50,41,54.95
Udyr,Camille,90,60,30,66.67
Udyr,Jayce,100,63,37,63
Udyr,Shyvana,55,21,34,38.18
Udyr,Rumble,50,19,31,38
Udyr,JarvanIV,76,33,43,43.42
Udyr,Lissandra,37,23,14,62.16
Udyr,Renata,20,11,9,55
Kassadin,Ornn,62,25,37,40.32
Kassadin,Udyr,28,11,17,39.29
Kassadin,Lux,347,159,188,45.82
Kassadin,Ezreal,236,92,144,38.98
Kassadin,Milio,72,42,30,58.33
Kassadin,Gangplank,49,23,26,46.94
Kassadin,Kaisa,204,115,89,56.37
Kassadin,Galio,109,48,61,44.04
Kassadin,Cassiopeia,38,19,19,50
Kassadin,Hwei,75,49,26,65.33
Kassadin,Aatrox,131,45,86,34.35
Kassadin,Shaco,188,118,70,62.77
Kassadin,Leblanc,27,14,13,51.85
Kassadin,Draven,49,23,26,46.94
Kassadin,Darius,258,131,127,50.78
Kassadin,Chogath,146,75,71,51.37
Kassadin,Yasuo,219,96,123,43.84
Kassadin,Yuumi,123,72,51,58.54
Kassadin,Naafiri,47,18,29,38.3
Kassadin,Zac,76,57,19,75
Kassadin,Ahri,192,110,82,57.29
Kassadin,Nilah,92,34,58,36.96
Kassadin,Zyra,76,48,28,63.16
Kassadin,XinZhao,48,13,35,27.08
Kassadin,Hecarim,64,36,28,56.25
Kassadin,Jhin,261,117,144,44.83
Kassadin,Velkoz,85,39,46,45.88
Kassadin,Mordekaiser,146,83,63,56.85
Kassadin,Diana,216,123,93,56.94
Kassadin,Tristana,105,50,55,47.62
Kassadin,Taric,39,17,22,43.59
Kassadin,Warwick,196,99,97,50.51
Kassadin,Graves,31,15,16,48.39
Kassadin,Aurora,136,78,58,57.35
Kassadin,Mel,333,211,122,63.36
Kassadin,Irelia,130,64,66,49.23
Kassadin,MonkeyKing,65,18,47,27.69
Kassadin,Vex,71,49,22,69.01
Kassadin,Caitlyn,274,129,145,47.08
Kassadin,Rell,97,49,48,50.52
Kassadin,Illaoi,51,35,16,68.63
Kassadin,Vi,103,69,34,66.99
Kassadin,Sivir,50,25,25,50
Kassadin,Jax,113,49,64,43.36
Kassadin,Karthus,27,21,6,77.78
Kassadin,Lucian,43,26,17,60.47
Kassadin,Nami,131,81,50,61.83
Kassadin,Garen,143,87,56,60.84
Kassadin,Skarner,30,13,17,43.33
Kassadin,Zilean,21,13,8,61.9
Kassadin,MissFortune,221,134,87,60.63
Kassadin,Tryndamere,90,51,39,56.67
Kassadin,Evelynn,109,47,62,43.12
Kassadin,Syndra,76,53,23,69.74
Kassadin,Xerath,46,18,28,39.13
Kassadin,Nunu,73,33,40,45.21
Kassadin,Seraphine,159,89,70,55.97
Kassadin,Nautilus,164,76,88,46.34
Kassadin,Zed,95,56,39,58.95
Kassadin,Pantheon,220,109,111,49.55
Kassadin,Nocturne,123,69,54,56.1
Kassadin,Akali,141,91,50,64.54
Kassadin,Jinx,298,184,114,61.74
Kassadin,Annie,11,8,3,72.73
Kassadin,Sett,208,133,75,63.94
Kassadin,Ekko,137,88,49,64.23
Kassadin,Swain,170,105,65,61.76
Kassadin,LeeSin,122,46,76,37.7
Kassadin,Riven,49,29,20,59.18
Kassadin,Rengar,63,52,11,82.54
Kassadin,Gnar,80,36,44,45
Kassadin,MasterYi,118,55,63,46.61
Kassadin,TwistedFate,53,34,19,64.15
Kassadin,Senna,109,54,55,49.54
Kassadin,Kayn,190,84,106,44.21
Kassadin,Malzahar,86,34,52,39.53
Kassadin,Malphite,88,31,57,35.23
Kassadin,Sylas,120,60,60,50
Kassadin,Rakan,70,30,40,42.86
Kassadin,Ivern,37,28,9,75.68
Kassadin,Katarina,117,72,45,61.54
Kassadin,Teemo,147,59,88,40.14
Kassadin,Briar,103,37,66,35.92
Kassadin,Twitch,137,76,61,55.47
Kassadin,Poppy,43,28,15,65.12
Kassadin,AurelionSol,32,9,23,28.13
Kassadin,Zoe,50,36,14,72
Kassadin,Lillia,116,60,56,51.72
Kassadin,Lulu,73,38,35,52.05
Kassadin,Veigar,148,85,63,57.43
Kassadin,Brand,107,63,44,58.88
Kassadin,Pyke,143,85,58,59.44
Kassadin,Varus,121,58,63,47.93
Kassadin,DrMundo,86,31,55,36.05
Kassadin,Vladimir,84,57,27,67.86
Kassadin,Neeko,97,63,34,64.95
Kassadin,KSante,61,34,27,55.74
Kassadin,Vayne,167,97,70,58.08
Kassadin,TahmKench,149,85,64,57.05
Kassadin,Maokai,77,43,34,55.84
Kassadin,Orianna,38,11,27,28.95
Kassadin,Viego,167,77,90,46.11
Kassadin,Xayah,88,37,51,42.05
Kassadin,Kindred,60,31,29,51.67
Kassadin,Urgot,105,41,64,39.05
Kassadin,Elise,83,56,27,67.47
Kassadin,Braum,74,34,40,45.95
Kassadin,Nasus,124,73,51,58.87
Kassadin,Yone,188,91,97,48.4
Kassadin,Blitzcrank,97,57,40,58.76
Kassadin,Qiyana,50,19,31,38
Kassadin,Ziggs,55,43,12,78.18
Kassadin,Amumu,107,40,67,37.38
Kassadin,Viktor,64,43,21,67.19
Kassadin,Thresh,182,88,94,48.35
Kassadin,Volibear,115,61,54,53.04
Kassadin,Yorick,99,47,52,47.47
Kassadin,Kayle,119,63,56,52.94
Kassadin,Ashe,173,95,78,54.91
Kassadin,Ryze,60,22,38,36.67
Kassadin,Camille,56,37,19,66.07
Kassadin,Corki,69,53,16,76.81
Kassadin,Karma,93,58,35,62.37
Kassadin,Sona,48,12,36,25
Kassadin,Fizz,48,19,29,39.58
Kassadin,Trundle,81,32,49,39.51
Kassadin,Soraka,84,40,44,47.62
Kassadin,Gragas,100,28,72,28
Kassadin,Ambessa,55,24,31,43.64
Kassadin,Kled,17,14,3,82.35
Kassadin,Khazix,44,38,6,86.36
Kassadin,Renekton,58,47,11,81.03
Kassadin,Kalista,92,48,44,52.17
Kassadin,Morgana,158,74,84,46.84
Kassadin,Singed,47,25,22,53.19
Kassadin,Bard,57,32,25,56.14
Kassadin,Samira,102,49,53,48.04
Kassadin,Zeri,60,28,32,46.67
Kassadin,FiddleSticks,67,43,24,64.18
Kassadin,Smolder,115,52,63,45.22
Kassadin,Akshan,26,10,16,38.46
Kassadin,KogMaw,53,27,26,50.94
Kassadin,Gwen,68,49,19,72.06
Kassadin,Quinn,45,13,32,28.89
Kassadin,Heimerdinger,85,55,30,64.71
Kassadin,JarvanIV,25,13,12,52
Kassadin,Sejuani,38,16,22,42.11
Kassadin,Shen,66,21,45,31.82
Kassadin,Sion,111,32,79,28.83
Kassadin,Fiora,55,34,21,61.82
Kassadin,Belveth,18,8,10,44.44
Kassadin,RekSai,16,6,10,37.5
Kassadin,Renata,33,30,3,90.91
Kassadin,Talon,88,36,52,40.91
Kassadin,Rumble,19,13,6,68.42
Kassadin,Leona,95,32,63,33.68
Kassadin,Aphelios,94,61,33,64.89
Kassadin,Kennen,59,39,20,66.1
Kassadin,Shyvana,35,15,20,42.86
Kassadin,Alistar,49,11,38,22.45
Kassadin,Taliyah,32,13,19,40.63
Kassadin,Nidalee,40,30,10,75
Kassadin,Janna,33,16,17,48.48
Kassadin,Anivia,67,38,29,56.72
Kassadin,Jayce,22,6,16,27.27
Kassadin,Rammus,34,10,24,29.41
Kassadin,Azir,21,6,15,28.57
Kassadin,Olaf,20,8,12,40
Kassadin,Lissandra,22,9,13,40.91
Taric,Jax,113,91,22,80.53
Taric,Nidalee,28,16,12,57.14
Taric,Ahri,191,113,78,59.16
Taric,Jhin,183,97,86,53.01
Taric,Senna,110,66,44,60
Taric,Udyr,67,26,41,38.81
Taric,Yorick,92,44,48,47.83
Taric,Akali,131,93,38,70.99
Taric,Jinx,280,170,110,60.71
Taric,Karma,54,31,23,57.41
Taric,Heimerdinger,54,21,33,38.89
Taric,Warwick,196,124,72,63.27
Taric,Mordekaiser,233,114,119,48.93
Taric,Ashe,238,128,110,53.78
Taric,Pyke,133,100,33,75.19
Taric,Gwen,89,52,37,58.43
Taric,RekSai,15,12,3,80
Taric,Gangplank,58,41,17,70.69
Taric,Kaisa,195,139,56,71.28
Taric,Leona,93,65,28,69.89
Taric,Kennen,44,37,7,84.09
Taric,TwistedFate,56,33,23,58.93
Taric,Cassiopeia,76,52,24,68.42
Taric,Smolder,141,85,56,60.28
Taric,Milio,73,48,25,65.75
Taric,Sett,214,117,97,54.67
Taric,Nunu,72,36,36,50
Taric,Yone,254,159,95,62.6
Taric,Quinn,84,33,51,39.29
Taric,Viego,169,79,90,46.75
Taric,Yasuo,337,175,162,51.93
Taric,MissFortune,265,115,150,43.4
Taric,Neeko,118,82,36,69.49
Taric,Teemo,198,101,97,51.01
Taric,Akshan,49,29,20,59.18
Taric,Corki,41,25,16,60.98
Taric,Lux,354,164,190,46.33
Taric,Singed,44,18,26,40.91
Taric,Zeri,70,22,48,31.43
Taric,Brand,80,39,41,48.75
Taric,Darius,254,137,117,53.94
Taric,Gragas,83,62,21,74.7
Taric,Veigar,148,102,46,68.92
Taric,KogMaw,46,21,25,45.65
Taric,Thresh,200,128,72,64
Taric,Kayn,171,101,70,59.06
Taric,Kassadin,39,22,17,56.41
Taric,Ziggs,59,25,34,42.37
Taric,Morgana,198,113,85,57.07
Taric,Shaco,102,59,43,57.84
Taric,Hwei,84,57,27,67.86
Taric,Sejuani,52,26,26,50
Taric,Taliyah,56,30,26,53.57
Taric,Sivir,88,54,34,61.36
Taric,Velkoz,85,47,38,55.29
Taric,Ambessa,85,49,36,57.65
Taric,Lillia,89,49,40,55.06
Taric,Vladimir,68,20,48,29.41
Taric,Vayne,97,41,56,42.27
Taric,Nami,149,113,36,75.84
Taric,Viktor,98,64,34,65.31
Taric,Xayah,67,27,40,40.3
Taric,Nautilus,147,76,71,51.7
Taric,Garen,202,106,96,52.48
Taric,Kindred,58,39,19,67.24
Taric,Graves,48,22,26,45.83
Taric,Twitch,69,35,34,50.72
Taric,Volibear,122,61,61,50
Taric,Evelynn,84,41,43,48.81
Taric,Trundle,83,30,53,36.14
Taric,JarvanIV,43,27,16,62.79
Taric,Aurora,143,91,52,63.64
Taric,MasterYi,172,92,80,53.49
Taric,Lissandra,27,17,10,62.96
Taric,Caitlyn,313,180,133,57.51
Taric,Rakan,39,22,17,56.41
Taric,Riven,80,58,22,72.5
Taric,FiddleSticks,84,49,35,58.33
Taric,Tristana,117,36,81,30.77
Taric,Swain,129,71,58,55.04
Taric,Talon,51,16,35,31.37
Taric,Orianna,48,19,29,39.58
Taric,MonkeyKing,31,18,13,58.06
Taric,Malzahar,86,51,35,59.3
Taric,Poppy,118,62,56,52.54
Taric,XinZhao,83,32,51,38.55
Taric,Ryze,31,19,12,61.29
Taric,Varus,116,64,52,55.17
Taric,Belveth,55,36,19,65.45
Taric,Illaoi,75,46,29,61.33
Taric,Urgot,82,48,34,58.54
Taric,Diana,189,105,84,55.56
Taric,Soraka,36,16,20,44.44
Taric,Mel,249,123,126,49.4
Taric,LeeSin,122,67,55,54.92
Taric,Zac,98,44,54,44.9
Taric,Pantheon,235,153,82,65.11
Taric,Briar,128,85,43,66.41
Taric,Irelia,79,42,37,53.16
Taric,Nasus,94,45,49,47.87
Taric,Vi,89,31,58,34.83
Taric,Azir,58,37,21,63.79
Taric,Draven,40,15,25,37.5
Taric,Ornn,40,24,16,60
Taric,KSante,42,30,12,71.43
Taric,Zed,123,59,64,47.97
Taric,Samira,105,75,30,71.43
Taric,Amumu,138,71,67,51.45
Taric,Lucian,58,38,20,65.52
Taric,Annie,29,20,9,68.97
Taric,Seraphine,158,78,80,49.37
Taric,Ezreal,250,146,104,58.4
Taric,Zyra,66,32,34,48.48
Taric,Maokai,76,43,33,56.58
Taric,Nilah,65,37,28,56.92
Taric,Alistar,50,36,14,72
Taric,Tryndamere,72,47,25,65.28
Taric,Fizz,112,57,55,50.89
Taric,Jayce,89,52,37,58.43
Taric,Elise,119,78,41,65.55
Taric,Ekko,101,59,42,58.42
Taric,Blitzcrank,86,52,34,60.47
Taric,Zoe,39,33,6,84.62
Taric,Kalista,82,47,35,57.32
Taric,Katarina,104,47,57,45.19
Taric,Renekton,66,32,34,48.48
Taric,Qiyana,35,6,29,17.14
Taric,Rammus,52,38,14,73.08
Taric,Yuumi,136,59,77,43.38
Taric,DrMundo,91,41,50,45.05
Taric,Shyvana,20,6,14,30
Taric,Karthus,35,13,22,37.14
Taric,Anivia,51,12,39,23.53
Taric,Xerath,100,38,62,38
Taric,Chogath,234,155,79,66.24
Taric,Naafiri,58,16,42,27.59
Taric,Galio,115,62,53,53.91
Taric,Rengar,65,41,24,63.08
Taric,Sion,97,54,43,55.67
Taric,Sylas,126,59,67,46.83
Taric,Khazix,65,57,8,87.69
Taric,Rell,57,41,16,71.93
Taric,Shen,94,64,30,68.09
Taric,Syndra,67,29,38,43.28
Taric,Vex,55,32,23,58.18
Taric,Gnar,69,41,28,59.42
Taric,Janna,41,34,7,82.93
Taric,Lulu,96,52,44,54.17
Taric,Nocturne,82,47,35,57.32
Taric,Skarner,48,32,16,66.67
Taric,Rumble,32,5,27,15.63
Taric,Malphite,71,27,44,38.03
Taric,AurelionSol,74,10,64,13.51
Taric,Bard,35,12,23,34.29
Taric,Kayle,84,56,28,66.67
Taric,TahmKench,150,87,63,58
Taric,Camille,41,26,15,63.41
Taric,Sona,39,7,32,17.95
Taric,Aatrox,106,23,83,21.7
Taric,Fiora,44,31,13,70.45
Taric,Aphelios,100,39,61,39
Taric,Olaf,20,10,10,50
Taric,Renata,22,9,13,40.91
Taric,Braum,44,8,36,18.18
Taric,Hecarim,33,30,3,90.91
Taric,Kled,19,7,12,36.84
Taric,Leblanc,16,6,10,37.5
Taric,Ivern,17,11,6,64.71
Taric,Zilean,6,3,3,50
Nidalee,Gwen,109,59,50,54.13
Nidalee,Talon,93,24,69,25.81
Nidalee,Yone,273,122,151,44.69
Nidalee,MissFortune,305,130,175,42.62
Nidalee,Taric,28,12,16,42.86
Nidalee,Volibear,162,61,101,37.65
Nidalee,Ivern,33,10,23,30.3
Nidalee,Irelia,125,47,78,37.6
Nidalee,Caitlyn,297,131,166,44.11
Nidalee,Swain,112,25,87,22.32
Nidalee,Poppy,111,55,56,49.55
Nidalee,Elise,98,53,45,54.08
Nidalee,Aurora,157,70,87,44.59
Nidalee,Tristana,109,40,69,36.7
Nidalee,Nami,163,70,93,42.94
Nidalee,MasterYi,132,50,82,37.88
Nidalee,Hwei,100,30,70,30
Nidalee,Samira,173,69,104,39.88
Nidalee,Kayn,242,93,149,38.43
Nidalee,Briar,145,43,102,29.66
Nidalee,Velkoz,110,53,57,48.18
Nidalee,Nilah,82,38,44,46.34
Nidalee,Yuumi,146,59,87,40.41
Nidalee,Aatrox,193,97,96,50.26
Nidalee,Shyvana,48,14,34,29.17
Nidalee,Vex,89,40,49,44.94
Nidalee,Ezreal,234,100,134,42.74
Nidalee,Malzahar,134,56,78,41.79
Nidalee,Renekton,41,13,28,31.71
Nidalee,Gragas,109,60,49,55.05
Nidalee,Viktor,97,38,59,39.18
Nidalee,Ashe,283,132,151,46.64
Nidalee,Morgana,199,95,104,47.74
Nidalee,Tryndamere,86,38,48,44.19
Nidalee,Shaco,141,33,108,23.4
Nidalee,Brand,73,25,48,34.25
Nidalee,Lux,361,118,243,32.69
Nidalee,Blitzcrank,99,40,59,40.4
Nidalee,Kaisa,198,117,81,59.09
Nidalee,Lulu,134,76,58,56.72
Nidalee,Katarina,129,63,66,48.84
Nidalee,Jinx,286,95,191,33.22
Nidalee,Garen,219,87,132,39.73
Nidalee,Veigar,133,68,65,51.13
Nidalee,Bard,64,31,33,48.44
Nidalee,Heimerdinger,60,27,33,45
Nidalee,Zed,161,77,84,47.83
Nidalee,Senna,136,55,81,40.44
Nidalee,Gangplank,41,14,27,34.15
Nidalee,Pyke,157,87,70,55.41
Nidalee,Vladimir,67,45,22,67.16
Nidalee,Nunu,160,63,97,39.38
Nidalee,Annie,26,7,19,26.92
Nidalee,Sona,60,23,37,38.33
Nidalee,Riven,75,32,43,42.67
Nidalee,Vi,129,58,71,44.96
Nidalee,Chogath,189,63,126,33.33
Nidalee,Fizz,49,13,36,26.53
Nidalee,Ziggs,105,34,71,32.38
Nidalee,Darius,292,115,177,39.38
Nidalee,Diana,185,95,90,51.35
Nidalee,Mordekaiser,192,84,108,43.75
Nidalee,Shen,97,37,60,38.14
Nidalee,Zac,54,34,20,62.96
Nidalee,Yasuo,320,114,206,35.63
Nidalee,TahmKench,206,98,108,47.57
Nidalee,Graves,106,41,65,38.68
Nidalee,Illaoi,96,32,64,33.33
Nidalee,FiddleSticks,89,32,57,35.96
Nidalee,Singed,30,6,24,20
Nidalee,Orianna,57,23,34,40.35
Nidalee,Corki,31,9,22,29.03
Nidalee,Neeko,91,33,58,36.26
Nidalee,Rell,76,40,36,52.63
Nidalee,Pantheon,280,141,139,50.36
Nidalee,Sylas,137,79,58,57.66
Nidalee,Galio,118,56,62,47.46
Nidalee,Zyra,86,46,40,53.49
Nidalee,AurelionSol,90,45,45,50
Nidalee,Soraka,121,43,78,35.54
Nidalee,Viego,103,47,56,45.63
Nidalee,Teemo,208,88,120,42.31
Nidalee,Ekko,83,38,45,45.78
Nidalee,Mel,420,189,231,45
Nidalee,Sion,162,62,100,38.27
Nidalee,Sett,200,98,102,49
Nidalee,Nautilus,188,54,134,28.72
Nidalee,DrMundo,102,34,68,33.33
Nidalee,JarvanIV,52,30,22,57.69
Nidalee,Amumu,166,59,107,35.54
Nidalee,Akali,124,53,71,42.74
Nidalee,Ahri,146,73,73,50
Nidalee,KSante,43,18,25,41.86
Nidalee,Jax,136,58,78,42.65
Nidalee,Seraphine,170,68,102,40
Nidalee,Nasus,143,50,93,34.97
Nidalee,XinZhao,74,52,22,70.27
Nidalee,Jhin,240,98,142,40.83
Nidalee,Yorick,85,32,53,37.65
Nidalee,Olaf,45,11,34,24.44
Nidalee,Varus,159,64,95,40.25
Nidalee,Quinn,56,23,33,41.07
Nidalee,Leblanc,47,35,12,74.47
Nidalee,Kayle,122,25,97,20.49
Nidalee,Qiyana,57,25,32,43.86
Nidalee,Lucian,113,50,63,44.25
Nidalee,Belveth,43,21,22,48.84
Nidalee,Draven,73,29,44,39.73
Nidalee,Warwick,223,80,143,35.87
Nidalee,Lillia,107,45,62,42.06
Nidalee,KogMaw,53,6,47,11.32
Nidalee,Khazix,77,35,42,45.45
Nidalee,Smolder,126,68,58,53.97
Nidalee,Milio,89,27,62,30.34
Nidalee,RekSai,16,3,13,18.75
Nidalee,Malphite,118,35,83,29.66
Nidalee,Nocturne,120,39,81,32.5
Nidalee,Zeri,53,24,29,45.28
Nidalee,Braum,102,42,60,41.18
Nidalee,Xayah,81,27,54,33.33
Nidalee,Rakan,87,23,64,26.44
Nidalee,Ambessa,107,49,58,45.79
Nidalee,Akshan,94,45,49,47.87
Nidalee,LeeSin,136,63,73,46.32
Nidalee,Vayne,132,48,84,36.36
Nidalee,Twitch,91,37,54,40.66
Nidalee,Alistar,40,22,18,55
Nidalee,Thresh,220,89,131,40.45
Nidalee,Evelynn,91,38,53,41.76
Nidalee,Udyr,93,20,73,21.51
Nidalee,Zoe,70,27,43,38.57
Nidalee,Ornn,88,22,66,25
Nidalee,Kennen,58,26,32,44.83
Nidalee,Ryze,30,3,27,10
Nidalee,Maokai,87,35,52,40.23
Nidalee,Hecarim,53,17,36,32.08
Nidalee,Syndra,81,34,47,41.98
Nidalee,Camille,67,34,33,50.75
Nidalee,Xerath,116,52,64,44.83
Nidalee,Kalista,84,48,36,57.14
Nidalee,Janna,24,9,15,37.5
Nidalee,Cassiopeia,51,24,27,47.06
Nidalee,Kindred,107,58,49,54.21
Nidalee,Aphelios,147,59,88,40.14
Nidalee,Karma,98,40,58,40.82
Nidalee,Karthus,60,29,31,48.33
Nidalee,TwistedFate,71,46,25,64.79
Nidalee,Kled,26,13,13,50
Nidalee,Rammus,43,19,24,44.19
Nidalee,Lissandra,34,13,21,38.24
Nidalee,Skarner,29,19,10,65.52
Nidalee,Kassadin,40,10,30,25
Nidalee,MonkeyKing,65,38,27,58.46
Nidalee,Renata,28,8,20,28.57
Nidalee,Leona,69,31,38,44.93
Nidalee,Sivir,82,23,59,28.05
Nidalee,Naafiri,71,29,42,40.85
Nidalee,Trundle,88,29,59,32.95
Nidalee,Urgot,115,63,52,54.78
Nidalee,Gnar,53,26,27,49.06
Nidalee,Fiora,43,12,31,27.91
Nidalee,Taliyah,53,24,29,45.28
Nidalee,Azir,45,6,39,13.33
Nidalee,Zilean,45,29,16,64.44
Nidalee,Rumble,32,6,26,18.75
Nidalee,Anivia,40,6,34,15
Nidalee,Jayce,85,46,39,54.12
Nidalee,Rengar,55,31,24,56.36
Nidalee,Sejuani,32,16,16,50
Nasus,Fiora,259,139,120,53.67
Nasus,MasterYi,568,308,260,54.23
Nasus,Mel,989,514,475,51.97
Nasus,Jhin,693,336,357,48.48
Nasus,Karma,306,164,142,53.59
Nasus,Tryndamere,270,145,125,53.7
Nasus,Kayn,798,425,373,53.26
Nasus,Aurora,495,319,176,64.44
Nasus,Twitch,401,207,194,51.62
Nasus,Lux,1257,625,632,49.72
Nasus,Mordekaiser,855,406,449,47.49
Nasus,Diana,561,311,250,55.44
Nasus,Ahri,683,372,311,54.47
Nasus,Lulu,321,172,149,53.58
Nasus,Darius,890,430,460,48.31
Nasus,Amumu,412,221,191,53.64
Nasus,Yasuo,964,463,501,48.03
Nasus,MissFortune,1099,520,579,47.32
Nasus,Swain,481,241,240,50.1
Nasus,Volibear,636,318,318,50
Nasus,LeeSin,372,218,154,58.6
Nasus,Kayle,430,209,221,48.6
Nasus,Ezreal,722,391,331,54.16
Nasus,Morgana,603,315,288,52.24
Nasus,Yone,955,544,411,56.96
Nasus,Nilah,312,193,119,61.86
Nasus,Malphite,387,182,205,47.03
Nasus,Warwick,950,489,461,51.47
Nasus,Vex,182,108,74,59.34
Nasus,Yuumi,378,189,189,50
Nasus,Yorick,501,183,318,36.53
Nasus,Ekko,385,223,162,57.92
Nasus,Katarina,480,340,140,70.83
Nasus,Jinx,949,462,487,48.68
Nasus,Sion,334,165,169,49.4
Nasus,Quinn,107,56,51,52.34
Nasus,Talon,178,74,104,41.57
Nasus,Syndra,297,124,173,41.75
Nasus,Caitlyn,1140,527,613,46.23
Nasus,Sett,761,431,330,56.64
Nasus,Kindred,309,216,93,69.9
Nasus,Veigar,501,260,241,51.9
Nasus,Kled,75,44,31,58.67
Nasus,Gragas,266,176,90,66.17
Nasus,Rell,225,125,100,55.56
Nasus,Sejuani,151,90,61,59.6
Nasus,Malzahar,308,115,193,37.34
Nasus,Rakan,266,137,129,51.5
Nasus,Aatrox,406,232,174,57.14
Nasus,Cassiopeia,219,103,116,47.03
Nasus,Varus,304,179,125,58.88
Nasus,Jayce,190,132,58,69.47
Nasus,Skarner,142,78,64,54.93
Nasus,Poppy,300,182,118,60.67
Nasus,Singed,185,111,74,60
Nasus,Viego,526,281,245,53.42
Nasus,Vayne,528,319,209,60.42
Nasus,Leona,413,255,158,61.74
Nasus,Akali,562,305,257,54.27
Nasus,Xayah,306,168,138,54.9
Nasus,Nautilus,454,257,197,56.61
Nasus,Milio,196,108,88,55.1
Nasus,Irelia,392,203,189,51.79
Nasus,Evelynn,265,127,138,47.92
Nasus,Anivia,112,62,50,55.36
Nasus,Ornn,183,73,110,39.89
Nasus,Gangplank,221,81,140,36.65
Nasus,Senna,425,183,242,43.06
Nasus,Smolder,317,145,172,45.74
Nasus,TahmKench,521,303,218,58.16
Nasus,Azir,152,90,62,59.21
Nasus,Pantheon,781,406,375,51.98
Nasus,Nami,367,176,191,47.96
Nasus,Xerath,316,168,148,53.16
Nasus,Ashe,786,388,398,49.36
Nasus,Ivern,82,56,26,68.29
Nasus,Seraphine,590,329,261,55.76
Nasus,Zoe,181,142,39,78.45
Nasus,Nunu,405,189,216,46.67
Nasus,Tristana,332,174,158,52.41
Nasus,Pyke,529,323,206,61.06
Nasus,Teemo,740,330,410,44.59
Nasus,Rengar,180,119,61,66.11
Nasus,Vladimir,227,146,81,64.32
Nasus,Kaisa,588,342,246,58.16
Nasus,Ambessa,300,140,160,46.67
Nasus,Maokai,211,97,114,45.97
Nasus,Garen,661,302,359,45.69
Nasus,Briar,462,198,264,42.86
Nasus,Zed,409,238,171,58.19
Nasus,Corki,130,54,76,41.54
Nasus,Karthus,92,59,33,64.13
Nasus,KSante,130,81,49,62.31
Nasus,Zeri,260,162,98,62.31
Nasus,Sylas,467,251,216,53.75
Nasus,Zac,126,55,71,43.65
Nasus,Renekton,285,136,149,47.72
Nasus,Zilean,112,66,46,58.93
Nasus,Ziggs,167,83,84,49.7
Nasus,JarvanIV,165,84,81,50.91
Nasus,Lucian,292,121,171,41.44
Nasus,Soraka,297,109,188,36.7
Nasus,Shen,284,132,152,46.48
Nasus,Chogath,536,274,262,51.12
Nasus,Braum,216,103,113,47.69
Nasus,Janna,105,57,48,54.29
Nasus,Gwen,287,144,143,50.17
Nasus,Neeko,430,225,205,52.33
Nasus,Taliyah,91,32,59,35.16
Nasus,Khazix,277,163,114,58.84
Nasus,Viktor,395,198,197,50.13
Nasus,Thresh,661,357,304,54.01
Nasus,MonkeyKing,184,118,66,64.13
Nasus,Samira,570,357,213,62.63
Nasus,FiddleSticks,281,145,136,51.6
Nasus,Velkoz,283,112,171,39.58
Nasus,XinZhao,327,138,189,42.2
Nasus,Trundle,279,113,166,40.5
Nasus,Fizz,194,100,94,51.55
Nasus,Aphelios,359,202,157,56.27
Nasus,Blitzcrank,344,200,144,58.14
Nasus,Belveth,141,70,71,49.65
Nasus,Heimerdinger,318,155,163,48.74
Nasus,Gnar,206,88,118,42.72
Nasus,Hecarim,141,78,63,55.32
Nasus,Zyra,253,152,101,60.08
Nasus,Nocturne,362,163,199,45.03
Nasus,KogMaw,155,78,77,50.32
Nasus,Naafiri,221,131,90,59.28
Nasus,Galio,325,137,188,42.15
Nasus,Elise,262,117,145,44.66
Nasus,Kennen,194,124,70,63.92
Nasus,Qiyana,204,114,90,55.88
Nasus,Jax,366,202,164,55.19
Nasus,Kassadin,124,51,73,41.13
Nasus,Urgot,295,155,140,52.54
Nasus,Akshan,159,64,95,40.25
Nasus,Bard,89,57,32,64.04
Nasus,Graves,251,127,124,50.6
Nasus,Annie,161,68,93,42.24
Nasus,Brand,314,122,192,38.85
Nasus,Taric,94,49,45,52.13
Nasus,Shaco,389,177,212,45.5
Nasus,Hwei,310,151,159,48.71
Nasus,Udyr,154,68,86,44.16
Nasus,Leblanc,184,75,109,40.76
Nasus,Shyvana,103,47,56,45.63
Nasus,Vi,371,171,200,46.09
Nasus,Draven,260,172,88,66.15
Nasus,Olaf,114,54,60,47.37
Nasus,Sivir,195,110,85,56.41
Nasus,Nidalee,143,93,50,65.03
Nasus,Kalista,202,123,79,60.89
Nasus,Rammus,149,73,76,48.99
Nasus,Rumble,85,47,38,55.29
Nasus,Illaoi,266,148,118,55.64
Nasus,Lillia,320,150,170,46.88
Nasus,Camille,172,109,63,63.37
Nasus,Renata,97,45,52,46.39
Nasus,TwistedFate,170,109,61,64.12
Nasus,Riven,245,149,96,60.82
Nasus,Lissandra,100,69,31,69
Nasus,Sona,166,108,58,65.06
Nasus,AurelionSol,247,118,129,47.77
Nasus,Alistar,105,52,53,49.52
Nasus,Orianna,141,73,68,51.77
Nasus,Ryze,100,52,48,52
Nasus,RekSai,52,46,6,88.46
Nasus,DrMundo,201,96,105,47.76
JarvanIV,Swain,267,130,137,48.69
JarvanIV,Malzahar,188,114,74,60.64
JarvanIV,Irelia,212,99,113,46.7
JarvanIV,Kalista,159,78,81,49.06
JarvanIV,Poppy,129,74,55,57.36
JarvanIV,Sett,371,179,192,48.25
JarvanIV,Taliyah,42,12,30,28.57
JarvanIV,Cassiopeia,85,43,42,50.59
JarvanIV,Kaisa,306,173,133,56.54
JarvanIV,Neeko,108,68,40,62.96
JarvanIV,Yasuo,426,239,187,56.1
JarvanIV,Evelynn,90,52,38,57.78
JarvanIV,Tristana,204,99,105,48.53
JarvanIV,Lux,587,338,249,57.58
JarvanIV,Volibear,205,100,105,48.78
JarvanIV,LeeSin,237,150,87,63.29
JarvanIV,Caitlyn,458,283,175,61.79
JarvanIV,Pyke,211,110,101,52.13
JarvanIV,Singed,76,43,33,56.58
JarvanIV,Viego,244,152,92,62.3
JarvanIV,Vayne,287,172,115,59.93
JarvanIV,MissFortune,356,167,189,46.91
JarvanIV,Leona,194,76,118,39.18
JarvanIV,Gangplank,96,58,38,60.42
JarvanIV,Rengar,107,72,35,67.29
JarvanIV,Kennen,55,32,23,58.18
JarvanIV,Akali,232,133,99,57.33
JarvanIV,Kayn,345,173,172,50.14
JarvanIV,Sylas,235,105,130,44.68
JarvanIV,Draven,100,59,41,59
JarvanIV,Velkoz,154,72,82,46.75
JarvanIV,Mordekaiser,285,130,155,45.61
JarvanIV,Amumu,220,126,94,57.27
JarvanIV,Qiyana,87,45,42,51.72
JarvanIV,Garen,365,156,209,42.74
JarvanIV,Diana,318,152,166,47.8
JarvanIV,Heimerdinger,50,32,18,64
JarvanIV,Vi,211,107,104,50.71
JarvanIV,Vladimir,105,50,55,47.62
JarvanIV,Leblanc,88,48,40,54.55
JarvanIV,Veigar,225,152,73,67.56
JarvanIV,Ashe,378,194,184,51.32
JarvanIV,Nautilus,261,159,102,60.92
JarvanIV,KSante,85,45,40,52.94
JarvanIV,MasterYi,207,113,94,54.59
JarvanIV,Mel,500,276,224,55.2
JarvanIV,Ekko,143,76,67,53.15
JarvanIV,Naafiri,126,73,53,57.94
JarvanIV,Kayle,192,127,65,66.15
JarvanIV,Tryndamere,130,78,52,60
JarvanIV,MonkeyKing,109,39,70,35.78
JarvanIV,Lucian,123,59,64,47.97
JarvanIV,Elise,164,99,65,60.37
JarvanIV,TahmKench,243,122,121,50.21
JarvanIV,Shaco,230,133,97,57.83
JarvanIV,Aurora,185,102,83,55.14
JarvanIV,Xayah,176,90,86,51.14
JarvanIV,Aatrox,233,107,126,45.92
JarvanIV,Skarner,61,43,18,70.49
JarvanIV,Nasus,165,81,84,49.09
JarvanIV,Katarina,184,114,70,61.96
JarvanIV,Rell,92,59,33,64.13
JarvanIV,Kled,62,31,31,50
JarvanIV,Nocturne,156,75,81,48.08
JarvanIV,Malphite,212,119,93,56.13
JarvanIV,Warwick,305,189,116,61.97
JarvanIV,Rakan,92,26,66,28.26
JarvanIV,Riven,85,52,33,61.18
JarvanIV,Jhin,374,181,193,48.4
JarvanIV,Thresh,291,164,127,56.36
JarvanIV,Trundle,99,46,53,46.46
JarvanIV,Rammus,108,41,67,37.96
JarvanIV,Fizz,111,61,50,54.95
JarvanIV,Sona,89,40,49,44.94
JarvanIV,Kindred,96,68,28,70.83
JarvanIV,Ezreal,410,265,145,64.63
JarvanIV,Seraphine,190,123,67,64.74
JarvanIV,Yone,342,194,148,56.73
JarvanIV,Taric,43,16,27,37.21
JarvanIV,Lillia,216,100,116,46.3
JarvanIV,Ahri,314,199,115,63.38
JarvanIV,Ornn,99,33,66,33.33
JarvanIV,Hwei,159,109,50,68.55
JarvanIV,Darius,349,202,147,57.88
JarvanIV,Hecarim,97,53,44,54.64
JarvanIV,Twitch,142,78,64,54.93
JarvanIV,Blitzcrank,187,118,69,63.1
JarvanIV,Camille,98,66,32,67.35
JarvanIV,Khazix,148,89,59,60.14
JarvanIV,Milio,164,72,92,43.9
JarvanIV,Renekton,130,75,55,57.69
JarvanIV,Renata,99,50,49,50.51
JarvanIV,Vex,133,81,52,60.9
JarvanIV,Sejuani,115,45,70,39.13
JarvanIV,Teemo,302,165,137,54.64
JarvanIV,Nidalee,52,22,30,42.31
JarvanIV,Lulu,252,146,106,57.94
JarvanIV,Yorick,263,151,112,57.41
JarvanIV,Aphelios,125,61,64,48.8
JarvanIV,Janna,59,39,20,66.1
JarvanIV,Soraka,124,43,81,34.68
JarvanIV,Gnar,100,45,55,45
JarvanIV,Zoe,76,51,25,67.11
JarvanIV,Gwen,132,88,44,66.67
JarvanIV,Jinx,456,222,234,48.68
JarvanIV,Nami,180,89,91,49.44
JarvanIV,Sion,190,106,84,55.79
JarvanIV,Jax,178,95,83,53.37
JarvanIV,Ambessa,144,76,68,52.78
JarvanIV,Rumble,47,12,35,25.53
JarvanIV,Briar,188,100,88,53.19
JarvanIV,Nilah,126,80,46,63.49
JarvanIV,Akshan,77,38,39,49.35
JarvanIV,Varus,200,89,111,44.5
JarvanIV,Braum,95,47,48,49.47
JarvanIV,Yuumi,218,93,125,42.66
JarvanIV,Bard,102,62,40,60.78
JarvanIV,Graves,93,64,29,68.82
JarvanIV,AurelionSol,124,54,70,43.55
JarvanIV,Chogath,360,208,152,57.78
JarvanIV,Viktor,133,41,92,30.83
JarvanIV,Zed,153,87,66,56.86
JarvanIV,Pantheon,379,219,160,57.78
JarvanIV,Galio,161,76,85,47.2
JarvanIV,Zeri,127,73,54,57.48
JarvanIV,Samira,191,96,95,50.26
JarvanIV,Shen,162,68,94,41.98
JarvanIV,Olaf,15,9,6,60
JarvanIV,Smolder,210,112,98,53.33
JarvanIV,Syndra,120,63,57,52.5
JarvanIV,Xerath,124,58,66,46.77
JarvanIV,Alistar,90,57,33,63.33
JarvanIV,FiddleSticks,91,46,45,50.55
JarvanIV,Corki,96,57,39,59.38
JarvanIV,Morgana,222,148,74,66.67
JarvanIV,Zac,74,37,37,50
JarvanIV,Maokai,111,66,45,59.46
JarvanIV,Ryze,62,53,9,85.48
JarvanIV,Karma,135,72,63,53.33
JarvanIV,Senna,186,111,75,59.68
JarvanIV,DrMundo,107,56,51,52.34
JarvanIV,Nunu,199,103,96,51.76
JarvanIV,Karthus,50,22,28,44
JarvanIV,Kassadin,25,12,13,48
JarvanIV,Sivir,108,76,32,70.37
JarvanIV,Azir,85,37,48,43.53
JarvanIV,Lissandra,59,26,33,44.07
JarvanIV,Talon,99,36,63,36.36
JarvanIV,XinZhao,147,59,88,40.14
JarvanIV,Zilean,49,31,18,63.27
JarvanIV,Gragas,124,46,78,37.1
JarvanIV,Shyvana,62,35,27,56.45
JarvanIV,Anivia,91,42,49,46.15
JarvanIV,RekSai,34,19,15,55.88
JarvanIV,TwistedFate,65,28,37,43.08
JarvanIV,Urgot,80,38,42,47.5
JarvanIV,Orianna,98,50,48,51.02
JarvanIV,Brand,140,67,73,47.86
JarvanIV,Jayce,103,69,34,66.99
JarvanIV,Fiora,82,49,33,59.76
JarvanIV,Udyr,76,43,33,56.58
JarvanIV,Illaoi,88,34,54,38.64
JarvanIV,KogMaw,60,17,43,28.33
JarvanIV,Ivern,54,22,32,40.74
JarvanIV,Annie,73,49,24,67.12
JarvanIV,Ziggs,92,16,76,17.39
JarvanIV,Quinn,82,42,40,51.22
JarvanIV,Zyra,107,52,55,48.6
JarvanIV,Belveth,14,6,8,42.86
Fizz,Irelia,276,171,105,61.96
Fizz,Kayn,595,315,280,52.94
Fizz,Katarina,313,193,120,61.66
Fizz,Vayne,275,126,149,45.82
Fizz,DrMundo,199,85,114,42.71
Fizz,Mordekaiser,565,277,288,49.03
Fizz,Amumu,277,128,149,46.21
Fizz,Pyke,357,219,138,61.34
Fizz,Varus,258,122,136,47.29
Fizz,Thresh,415,228,187,54.94
Fizz,Volibear,351,170,181,48.43
Fizz,LeeSin,269,154,115,57.25
Fizz,Kayle,201,90,111,44.78
Fizz,Ezreal,496,264,232,53.23
Fizz,Morgana,433,230,203,53.12
Fizz,Olaf,54,31,23,57.41
Fizz,Hecarim,122,67,55,54.92
Fizz,Veigar,421,190,231,45.13
Fizz,Tristana,264,116,148,43.94
Fizz,Braum,121,52,69,42.98
Fizz,Jax,287,142,145,49.48
Fizz,Diana,430,211,219,49.07
Fizz,Ahri,393,247,146,62.85
Fizz,Aphelios,224,74,150,33.04
Fizz,Senna,238,123,115,51.68
Fizz,KSante,100,55,45,55
Fizz,Yasuo,559,261,298,46.69
Fizz,MissFortune,746,338,408,45.31
Fizz,Lux,836,384,452,45.93
Fizz,Heimerdinger,178,95,83,53.37
Fizz,Warwick,586,279,307,47.61
Fizz,Ashe,497,295,202,59.36
Fizz,Garen,531,253,278,47.65
Fizz,Shyvana,115,52,63,45.22
Fizz,Mel,821,396,425,48.23
Fizz,Taliyah,76,42,34,55.26
Fizz,Swain,285,126,159,44.21
Fizz,Sett,449,225,224,50.11
Fizz,Lucian,205,119,86,58.05
Fizz,Sona,118,69,49,58.47
Fizz,Darius,577,278,299,48.18
Fizz,Gragas,157,96,61,61.15
Fizz,KogMaw,114,60,54,52.63
Fizz,Gnar,100,42,58,42
Fizz,Nami,300,126,174,42
Fizz,Yorick,344,137,207,39.83
Fizz,Sejuani,77,36,41,46.75
Fizz,Kalista,112,68,44,60.71
Fizz,Yuumi,332,188,144,56.63
Fizz,Urgot,161,37,124,22.98
Fizz,Viego,371,202,169,54.45
Fizz,Qiyana,122,63,59,51.64
Fizz,Draven,188,110,78,58.51
Fizz,MasterYi,299,138,161,46.15
Fizz,Akali,324,171,153,52.78
Fizz,Twitch,224,128,96,57.14
Fizz,Blitzcrank,275,128,147,46.55
Fizz,Shaco,324,208,116,64.2
Fizz,Ziggs,148,80,68,54.05
Fizz,Rumble,62,35,27,56.45
Fizz,Aurora,280,104,176,37.14
Fizz,Nautilus,307,155,152,50.49
Fizz,Xerath,244,128,116,52.46
Fizz,Khazix,210,104,106,49.52
Fizz,Karma,186,91,95,48.92
Fizz,Gwen,232,146,86,62.93
Fizz,Briar,313,152,161,48.56
Fizz,Zilean,78,37,41,47.44
Fizz,RekSai,45,3,42,6.67
Fizz,Ornn,110,63,47,57.27
Fizz,Seraphine,320,171,149,53.44
Fizz,Lillia,208,107,101,51.44
Fizz,Samira,330,175,155,53.03
Fizz,Neeko,212,110,102,51.89
Fizz,Ryze,57,31,26,54.39
Fizz,Smolder,247,144,103,58.3
Fizz,Zyra,210,126,84,60
Fizz,Zeri,136,68,68,50
Fizz,Zed,346,175,171,50.58
Fizz,Lulu,202,120,82,59.41
Fizz,Teemo,436,232,204,53.21
Fizz,Vi,268,112,156,41.79
Fizz,Galio,265,122,143,46.04
Fizz,Rell,125,79,46,63.2
Fizz,Yone,589,341,248,57.89
Fizz,Aatrox,326,167,159,51.23
Fizz,JarvanIV,111,50,61,45.05
Fizz,Cassiopeia,123,65,58,52.85
Fizz,Nasus,194,94,100,48.45
Fizz,Pantheon,535,251,284,46.92
Fizz,Singed,79,32,47,40.51
Fizz,Caitlyn,684,334,350,48.83
Fizz,Chogath,338,206,132,60.95
Fizz,Ekko,223,132,91,59.19
Fizz,Leblanc,129,70,59,54.26
Fizz,Jhin,569,312,257,54.83
Fizz,Nidalee,49,36,13,73.47
Fizz,Brand,208,74,134,35.58
Fizz,Renekton,125,72,53,57.6
Fizz,Rakan,190,110,80,57.89
Fizz,Vladimir,242,126,116,52.07
Fizz,Xayah,264,133,131,50.38
Fizz,Talon,225,105,120,46.67
Fizz,Renata,73,54,19,73.97
Fizz,Kaisa,434,249,185,57.37
Fizz,Evelynn,173,94,79,54.34
Fizz,Syndra,202,75,127,37.13
Fizz,Annie,105,83,22,79.05
Fizz,Rammus,99,37,62,37.37
Fizz,Velkoz,197,120,77,60.91
Fizz,Viktor,206,84,122,40.78
Fizz,Soraka,172,87,85,50.58
Fizz,Corki,55,16,39,29.09
Fizz,Akshan,111,61,50,54.95
Fizz,Milio,216,87,129,40.28
Fizz,Naafiri,133,71,62,53.38
Fizz,Hwei,223,116,107,52.02
Fizz,Kennen,102,63,39,61.76
Fizz,TahmKench,290,167,123,57.59
Fizz,Gangplank,108,53,55,49.07
Fizz,Alistar,74,32,42,43.24
Fizz,Illaoi,161,59,102,36.65
Fizz,Nocturne,270,139,131,51.48
Fizz,Kassadin,48,29,19,60.42
Fizz,TwistedFate,154,99,55,64.29
Fizz,Jinx,556,301,255,54.14
Fizz,Ambessa,100,72,28,72
Fizz,Malzahar,258,129,129,50
Fizz,Sion,249,128,121,51.41
Fizz,MonkeyKing,134,81,53,60.45
Fizz,Orianna,143,70,73,48.95
Fizz,Tryndamere,234,82,152,35.04
Fizz,Rengar,85,59,26,69.41
Fizz,Graves,143,90,53,62.94
Fizz,Udyr,104,50,54,48.08
Fizz,Maokai,138,80,58,57.97
Fizz,Sivir,135,64,71,47.41
Fizz,Anivia,124,80,44,64.52
Fizz,Azir,60,36,24,60
Fizz,Leona,176,86,90,48.86
Fizz,Skarner,80,42,38,52.5
Fizz,Sylas,344,198,146,57.56
Fizz,Quinn,90,28,62,31.11
Fizz,Nunu,262,118,144,45.04
Fizz,XinZhao,170,102,68,60
Fizz,Riven,134,94,40,70.15
Fizz,Belveth,69,44,25,63.77
Fizz,Trundle,122,67,55,54.92
Fizz,Taric,112,55,57,49.11
Fizz,Elise,180,98,82,54.44
Fizz,Fiora,102,54,48,52.94
Fizz,Camille,110,86,24,78.18
Fizz,Nilah,128,62,66,48.44
Fizz,Karthus,63,9,54,14.29
Fizz,Lissandra,83,33,50,39.76
Fizz,Malphite,184,117,67,63.59
Fizz,Janna,93,41,52,44.09
Fizz,Zac,104,67,37,64.42
Fizz,FiddleSticks,152,75,77,49.34
Fizz,Shen,180,69,111,38.33
Fizz,Poppy,176,91,85,51.7
Fizz,Kindred,136,64,72,47.06
Fizz,Vex,176,75,101,42.61
Fizz,Ivern,64,42,22,65.63
Fizz,Zoe,152,89,63,58.55
Fizz,AurelionSol,161,75,86,46.58
Fizz,Kled,67,38,29,56.72
Fizz,Jayce,157,116,41,73.89
Fizz,Bard,87,18,69,20.69
Ziggs,Irelia,225,119,106,52.89
Ziggs,Kayn,377,217,160,57.56
Ziggs,Katarina,228,129,99,56.58
Ziggs,Vayne,250,152,98,60.8
Ziggs,DrMundo,170,94,76,55.29
Ziggs,Mordekaiser,469,263,206,56.08
Ziggs,Udyr,104,41,63,39.42
Ziggs,Yorick,289,106,183,36.68
Ziggs,Sivir,141,82,59,58.16
Ziggs,Nautilus,271,150,121,55.35
Ziggs,Darius,503,269,234,53.48
Ziggs,Volibear,326,194,132,59.51
Ziggs,AurelionSol,149,99,50,66.44
Ziggs,Caitlyn,714,343,371,48.04
Ziggs,TahmKench,298,163,135,54.7
Ziggs,Lillia,195,119,76,61.03
Ziggs,Sylas,246,105,141,42.68
Ziggs,Lux,724,316,408,43.65
Ziggs,Viktor,158,91,67,57.59
Ziggs,Nocturne,174,77,97,44.25
Ziggs,Yasuo,421,202,219,47.98
Ziggs,Nilah,144,66,78,45.83
Ziggs,Bard,101,66,35,65.35
Ziggs,Jax,243,138,105,56.79
Ziggs,Jhin,505,268,237,53.07
Ziggs,Thresh,345,210,135,60.87
Ziggs,Aurora,217,134,83,61.75
Ziggs,Viego,347,156,191,44.96
Ziggs,Mel,605,352,253,58.18
Ziggs,Jinx,615,316,299,51.38
Ziggs,Velkoz,174,81,93,46.55
Ziggs,Kindred,164,94,70,57.32
Ziggs,Lulu,182,127,55,69.78
Ziggs,Ashe,498,244,254,49
Ziggs,Fiora,119,64,55,53.78
Ziggs,Teemo,452,194,258,42.92
Ziggs,Kaisa,244,129,115,52.87
Ziggs,Milio,159,80,79,50.31
Ziggs,Illaoi,147,57,90,38.78
Ziggs,Malzahar,198,94,104,47.47
Ziggs,Khazix,125,65,60,52
Ziggs,Leona,111,66,45,59.46
Ziggs,FiddleSticks,117,68,49,58.12
Ziggs,Gragas,151,91,60,60.26
Ziggs,LeeSin,198,120,78,60.61
Ziggs,Karma,185,97,88,52.43
Ziggs,Sett,451,210,241,46.56
Ziggs,Graves,146,81,65,55.48
Ziggs,Leblanc,76,47,29,61.84
Ziggs,Yuumi,223,101,122,45.29
Ziggs,KSante,90,47,43,52.22
Ziggs,Zed,249,148,101,59.44
Ziggs,Fizz,148,68,80,45.95
Ziggs,Draven,153,82,71,53.59
Ziggs,Renata,42,23,19,54.76
Ziggs,Warwick,402,218,184,54.23
Ziggs,MissFortune,569,296,273,52.02
Ziggs,Diana,410,229,181,55.85
Ziggs,Tristana,161,94,67,58.39
Ziggs,Taric,59,34,25,57.63
Ziggs,Sejuani,80,51,29,63.75
Ziggs,MonkeyKing,142,68,74,47.89
Ziggs,Kalista,144,84,60,58.33
Ziggs,Ezreal,442,256,186,57.92
Ziggs,Ekko,190,94,96,49.47
Ziggs,Nami,243,98,145,40.33
Ziggs,Cassiopeia,147,105,42,71.43
Ziggs,Lucian,134,71,63,52.99
Ziggs,Skarner,105,54,51,51.43
Ziggs,Ryze,59,26,33,44.07
Ziggs,Elise,198,121,77,61.11
Ziggs,Kayle,172,92,80,53.49
Ziggs,Tryndamere,166,86,80,51.81
Ziggs,Akali,308,171,137,55.52
Ziggs,Neeko,191,115,76,60.21
Ziggs,Yone,548,265,283,48.36
Ziggs,Singed,46,15,31,32.61
Ziggs,Smolder,224,132,92,58.93
Ziggs,Pyke,286,163,123,56.99
Ziggs,Aatrox,233,141,92,60.52
Ziggs,Xayah,194,105,89,54.12
Ziggs,Rakan,137,58,79,42.34
Ziggs,Rengar,100,61,39,61
Ziggs,Vi,280,157,123,56.07
Ziggs,Pantheon,404,197,207,48.76
Ziggs,Evelynn,163,108,55,66.26
Ziggs,Nasus,167,84,83,50.3
Ziggs,Briar,247,107,140,43.32
Ziggs,Veigar,328,194,134,59.15
Ziggs,Shen,227,125,102,55.07
Ziggs,Shaco,226,103,123,45.58
Ziggs,Chogath,363,196,167,53.99
Ziggs,Poppy,77,41,36,53.25
Ziggs,Senna,242,136,106,56.2
Ziggs,XinZhao,197,111,86,56.35
Ziggs,Taliyah,77,50,27,64.94
Ziggs,Samira,270,146,124,54.07
Ziggs,Kled,62,39,23,62.9
Ziggs,Varus,212,128,84,60.38
Ziggs,Gangplank,98,53,45,54.08
Ziggs,Olaf,52,29,23,55.77
Ziggs,Nidalee,105,71,34,67.62
Ziggs,Morgana,378,179,199,47.35
Ziggs,Soraka,165,92,73,55.76
Ziggs,Trundle,125,63,62,50.4
Ziggs,Ahri,318,185,133,58.18
Ziggs,Ornn,120,44,76,36.67
Ziggs,Amumu,238,128,110,53.78
Ziggs,Galio,212,91,121,42.92
Ziggs,Seraphine,339,188,151,55.46
Ziggs,Zyra,181,99,82,54.7
Ziggs,Malphite,244,163,81,66.8
Ziggs,Garen,394,187,207,47.46
Ziggs,Vladimir,145,75,70,51.72
Ziggs,MasterYi,233,105,128,45.06
Ziggs,Camille,79,52,27,65.82
Ziggs,Naafiri,123,58,65,47.15
Ziggs,Syndra,231,126,105,54.55
Ziggs,Blitzcrank,220,108,112,49.09
Ziggs,Riven,161,88,73,54.66
Ziggs,Hwei,214,100,114,46.73
Ziggs,Nunu,160,69,91,43.13
Ziggs,Zac,74,20,54,27.03
Ziggs,Annie,89,47,42,52.81
Ziggs,Renekton,122,61,61,50
Ziggs,Swain,272,102,170,37.5
Ziggs,Aphelios,229,122,107,53.28
Ziggs,Ambessa,128,56,72,43.75
Ziggs,Sona,105,39,66,37.14
Ziggs,Xerath,171,88,83,51.46
Ziggs,Zeri,95,44,51,46.32
Ziggs,Zilean,56,28,28,50
Ziggs,Akshan,89,39,50,43.82
Ziggs,Heimerdinger,199,99,100,49.75
Ziggs,Kassadin,55,12,43,21.82
Ziggs,Karthus,44,22,22,50
Ziggs,Twitch,198,79,119,39.9
Ziggs,Janna,70,32,38,45.71
Ziggs,Urgot,152,78,74,51.32
Ziggs,Ivern,65,20,45,30.77
Ziggs,Sion,149,87,62,58.39
Ziggs,Zoe,166,77,89,46.39
Ziggs,Talon,187,68,119,36.36
Ziggs,Gnar,87,75,12,86.21
Ziggs,Braum,129,56,73,43.41
Ziggs,Gwen,143,81,62,56.64
Ziggs,Corki,92,45,47,48.91
Ziggs,Brand,141,75,66,53.19
Ziggs,Qiyana,49,20,29,40.82
Ziggs,Vex,164,119,45,72.56
Ziggs,Shyvana,95,34,61,35.79
Ziggs,Maokai,86,43,43,50
Ziggs,Azir,40,17,23,42.5
Ziggs,Orianna,123,65,58,52.85
Ziggs,KogMaw,80,55,25,68.75
Ziggs,Belveth,62,33,29,53.23
Ziggs,Alistar,88,55,33,62.5
Ziggs,Hecarim,91,51,40,56.04
Ziggs,Lissandra,71,31,40,43.66
Ziggs,Rell,122,59,63,48.36
Ziggs,Rammus,125,74,51,59.2
Ziggs,Jayce,111,77,34,69.37
Ziggs,TwistedFate,87,44,43,50.57
Ziggs,Anivia,71,44,27,61.97
Ziggs,Quinn,58,20,38,34.48
Ziggs,Rumble,48,35,13,72.92
Ziggs,JarvanIV,92,76,16,82.61
Ziggs,RekSai,42,24,18,57.14
Ziggs,Kennen,50,34,16,68
Zyra,Sett,601,296,305,49.25
Zyra,Taliyah,78,21,57,26.92
Zyra,Cassiopeia,135,84,51,62.22
Zyra,Kaisa,611,407,204,66.61
Zyra,Neeko,334,190,144,56.89
Zyra,Malphite,243,135,108,55.56
Zyra,Jax,262,154,108,58.78
Zyra,Xayah,258,162,96,62.79
Zyra,Rakan,149,104,45,69.8
Zyra,Gwen,177,89,88,50.28
Zyra,Kayn,590,325,265,55.08
Zyra,Thresh,522,312,210,59.77
Zyra,Ezreal,650,370,280,56.92
Zyra,Yuumi,324,163,161,50.31
Zyra,Irelia,402,190,212,47.26
Zyra,Lillia,197,125,72,63.45
Zyra,Sylas,357,172,185,48.18
Zyra,Caitlyn,886,442,444,49.89
Zyra,Lux,1035,613,422,59.23
Zyra,Kennen,91,44,47,48.35
Zyra,MonkeyKing,224,120,104,53.57
Zyra,Vladimir,230,104,126,45.22
Zyra,Vayne,309,172,137,55.66
Zyra,Yone,748,438,310,58.56
Zyra,Smolder,283,141,142,49.82
Zyra,Poppy,251,137,114,54.58
Zyra,MasterYi,373,195,178,52.28
Zyra,AurelionSol,182,90,92,49.45
Zyra,Seraphine,421,217,204,51.54
Zyra,Mordekaiser,592,290,302,48.99
Zyra,Nunu,337,186,151,55.19
Zyra,Aurora,384,211,173,54.95
Zyra,Nami,374,231,143,61.76
Zyra,Swain,474,227,247,47.89
Zyra,Janna,129,56,73,43.41
Zyra,Briar,380,171,209,45
Zyra,Kassadin,76,28,48,36.84
Zyra,Yasuo,763,354,409,46.4
Zyra,Renata,99,56,43,56.57
Zyra,Amumu,378,167,211,44.18
Zyra,Tristana,311,165,146,53.05
Zyra,Pyke,448,269,179,60.04
Zyra,Fiora,149,92,57,61.74
Zyra,Samira,365,205,160,56.16
Zyra,Talon,239,122,117,51.05
Zyra,Varus,353,173,180,49.01
Zyra,Urgot,176,113,63,64.2
Zyra,Zed,385,275,110,71.43
Zyra,Mel,736,403,333,54.76
Zyra,Sejuani,117,65,52,55.56
Zyra,Ahri,483,312,171,64.6
Zyra,Jinx,807,415,392,51.43
Zyra,Nautilus,388,214,174,55.15
Zyra,Yorick,301,135,166,44.85
Zyra,Vi,335,196,139,58.51
Zyra,Shen,203,89,114,43.84
Zyra,Kindred,261,183,78,70.11
Zyra,Ekko,319,208,111,65.2
Zyra,Rell,228,122,106,53.51
Zyra,Gragas,221,131,90,59.28
Zyra,Blitzcrank,305,160,145,52.46
Zyra,Teemo,618,332,286,53.72
Zyra,Shaco,388,218,170,56.19
Zyra,Malzahar,219,102,117,46.58
Zyra,Ashe,727,434,293,59.7
Zyra,TahmKench,446,235,211,52.69
Zyra,Kayle,259,147,112,56.76
Zyra,Tryndamere,253,133,120,52.57
Zyra,Akali,324,181,143,55.86
Zyra,Jhin,558,289,269,51.79
Zyra,Maokai,153,66,87,43.14
Zyra,Ryze,119,80,39,67.23
Zyra,Viktor,311,150,161,48.23
Zyra,Twitch,243,129,114,53.09
Zyra,Lulu,239,168,71,70.29
Zyra,DrMundo,307,141,166,45.93
Zyra,Fizz,210,84,126,40
Zyra,Leona,329,165,164,50.15
Zyra,Darius,755,414,341,54.83
Zyra,FiddleSticks,170,91,79,53.53
Zyra,Hwei,270,136,134,50.37
Zyra,Anivia,136,67,69,49.26
Zyra,Illaoi,186,95,91,51.08
Zyra,Chogath,442,250,192,56.56
Zyra,MissFortune,771,458,313,59.4
Zyra,Braum,163,95,68,58.28
Zyra,Galio,273,121,152,44.32
Zyra,TwistedFate,160,110,50,68.75
Zyra,Singed,101,37,64,36.63
Zyra,Trundle,206,111,95,53.88
Zyra,Rammus,119,52,67,43.7
Zyra,Sona,182,107,75,58.79
Zyra,Kled,79,45,34,56.96
Zyra,Zeri,155,74,81,47.74
Zyra,Pantheon,620,366,254,59.03
Zyra,Gangplank,149,81,68,54.36
Zyra,Zoe,203,123,80,60.59
Zyra,Draven,209,123,86,58.85
Zyra,Katarina,392,277,115,70.66
Zyra,Garen,578,318,260,55.02
Zyra,Brand,275,155,120,56.36
Zyra,Zac,121,47,74,38.84
Zyra,Karma,306,158,148,51.63
Zyra,Velkoz,229,136,93,59.39
Zyra,Hecarim,155,80,75,51.61
Zyra,Soraka,247,105,142,42.51
Zyra,Evelynn,157,102,55,64.97
Zyra,Morgana,556,303,253,54.5
Zyra,Nasus,253,101,152,39.92
Zyra,Skarner,100,52,48,52
Zyra,Ziggs,181,82,99,45.3
Zyra,Sivir,230,128,102,55.65
Zyra,Nocturne,296,133,163,44.93
Zyra,KogMaw,146,57,89,39.04
Zyra,LeeSin,343,212,131,61.81
Zyra,Orianna,159,77,82,48.43
Zyra,Gnar,166,88,78,53.01
Zyra,Khazix,259,134,125,51.74
Zyra,Diana,565,344,221,60.88
Zyra,KSante,146,97,49,66.44
Zyra,Syndra,299,146,153,48.83
Zyra,Ambessa,218,139,79,63.76
Zyra,Elise,209,109,100,52.15
Zyra,Akshan,93,43,50,46.24
Zyra,Sion,320,153,167,47.81
Zyra,Renekton,176,83,93,47.16
Zyra,Viego,493,252,241,51.12
Zyra,Riven,147,100,47,68.03
Zyra,Azir,110,32,78,29.09
Zyra,Ornn,159,69,90,43.4
Zyra,Lucian,215,126,89,58.6
Zyra,Karthus,131,94,37,71.76
Zyra,Heimerdinger,205,114,91,55.61
Zyra,Camille,85,45,40,52.94
Zyra,Nidalee,86,40,46,46.51
Zyra,Aphelios,298,179,119,60.07
Zyra,Xerath,300,150,150,50
Zyra,RekSai,63,23,40,36.51
Zyra,Warwick,735,384,351,52.24
Zyra,Shyvana,81,59,22,72.84
Zyra,Udyr,103,61,42,59.22
Zyra,Milio,234,131,103,55.98
Zyra,XinZhao,181,90,91,49.72
Zyra,Veigar,448,212,236,47.32
Zyra,Senna,406,204,202,50.25
Zyra,Olaf,159,74,85,46.54
Zyra,Taric,66,34,32,51.52
Zyra,Volibear,415,224,191,53.98
Zyra,Bard,142,81,61,57.04
Zyra,Jayce,201,137,64,68.16
Zyra,Rengar,131,68,63,51.91
Zyra,Qiyana,126,78,48,61.9
Zyra,Ivern,91,59,32,64.84
Zyra,Naafiri,192,98,94,51.04
Zyra,Aatrox,344,193,151,56.1
Zyra,Vex,225,109,116,48.44
Zyra,Belveth,127,66,61,51.97
Zyra,Nilah,241,119,122,49.38
Zyra,Alistar,109,67,42,61.47
Zyra,Annie,124,78,46,62.9
Zyra,Corki,114,51,63,44.74
Zyra,Lissandra,105,60,45,57.14
Zyra,Quinn,145,72,73,49.66
Zyra,Leblanc,129,100,29,77.52
Zyra,Zilean,98,60,38,61.22
Zyra,Rumble,72,34,38,47.22
Zyra,Kalista,142,71,71,50
Zyra,Graves,194,142,52,73.2
Zyra,JarvanIV,107,55,52,51.4
Taliyah,Gwen,88,54,34,61.36
Taliyah,JarvanIV,42,30,12,71.43
Taliyah,Yone,275,127,148,46.18
Taliyah,Zyra,78,57,21,73.08
Taliyah,Seraphine,117,63,54,53.85
Taliyah,Kayle,119,61,58,51.26
Taliyah,MonkeyKing,98,45,53,45.92
Taliyah,RekSai,25,6,19,24
Taliyah,Sett,254,127,127,50
Taliyah,Vi,177,76,101,42.94
Taliyah,AurelionSol,86,23,63,26.74
Taliyah,Corki,43,13,30,30.23
Taliyah,Milio,95,75,20,78.95
Taliyah,Shen,110,48,62,43.64
Taliyah,Teemo,270,100,170,37.04
Taliyah,Twitch,100,19,81,19
Taliyah,Nautilus,221,108,113,48.87
Taliyah,Yasuo,449,179,270,39.87
Taliyah,Evelynn,57,31,26,54.39
Taliyah,Irelia,128,58,70,45.31
Taliyah,Tristana,147,83,64,56.46
Taliyah,Lux,409,183,226,44.74
Taliyah,Gnar,92,51,41,55.43
Taliyah,Jax,157,69,88,43.95
Taliyah,Aurora,82,47,35,57.32
Taliyah,Swain,160,92,68,57.5
Taliyah,Bard,57,24,33,42.11
Taliyah,Briar,165,96,69,58.18
Taliyah,Fizz,76,34,42,44.74
Taliyah,Jinx,337,161,176,47.77
Taliyah,Soraka,110,33,77,30
Taliyah,Volibear,172,91,81,52.91
Taliyah,Viego,172,92,80,53.49
Taliyah,Samira,119,79,40,66.39
Taliyah,Leona,190,103,87,54.21
Taliyah,Darius,324,180,144,55.56
Taliyah,Shaco,119,50,69,42.02
Taliyah,Zed,122,59,63,48.36
Taliyah,Kaisa,261,159,102,60.92
Taliyah,Braum,89,58,31,65.17
Taliyah,Ornn,62,28,34,45.16
Taliyah,Yorick,148,59,89,39.86
Taliyah,Zoe,68,49,19,72.06
Taliyah,Blitzcrank,161,76,85,47.2
Taliyah,Pantheon,266,132,134,49.62
Taliyah,Rengar,99,56,43,56.57
Taliyah,Ekko,130,78,52,60
Taliyah,Kalista,73,31,42,42.47
Taliyah,Thresh,262,124,138,47.33
Taliyah,Gangplank,87,50,37,57.47
Taliyah,Nunu,170,78,92,45.88
Taliyah,Rakan,55,29,26,52.73
Taliyah,Varus,128,67,61,52.34
Taliyah,Khazix,84,59,25,70.24
Taliyah,Caitlyn,348,161,187,46.26
Taliyah,Taric,56,26,30,46.43
Taliyah,LeeSin,231,122,109,52.81
Taliyah,Sona,55,16,39,29.09
Taliyah,Mordekaiser,237,106,131,44.73
Taliyah,Lillia,121,63,58,52.07
Taliyah,Fiora,60,36,24,60
Taliyah,Nocturne,144,36,108,25
Taliyah,Ryze,46,9,37,19.57
Taliyah,Sion,177,55,122,31.07
Taliyah,Ahri,276,159,117,57.61
Taliyah,Ashe,320,158,162,49.38
Taliyah,Singed,59,20,39,33.9
Taliyah,Nasus,91,59,32,64.84
Taliyah,Amumu,171,68,103,39.77
Taliyah,Ezreal,270,141,129,52.22
Taliyah,Veigar,184,65,119,35.33
Taliyah,Ziggs,77,27,50,35.06
Taliyah,Sylas,158,63,95,39.87
Taliyah,Viktor,92,44,48,47.83
Taliyah,Draven,111,54,57,48.65
Taliyah,Katarina,139,49,90,35.25
Taliyah,MasterYi,160,70,90,43.75
Taliyah,Nilah,59,53,6,89.83
Taliyah,Nami,177,62,115,35.03
Taliyah,Kayn,248,122,126,49.19
Taliyah,Akshan,51,24,27,47.06
Taliyah,XinZhao,102,26,76,25.49
Taliyah,MissFortune,307,147,160,47.88
Taliyah,Jhin,274,127,147,46.35
Taliyah,Neeko,108,61,47,56.48
Taliyah,Vladimir,117,42,75,35.9
Taliyah,Smolder,140,80,60,57.14
Taliyah,Malphite,142,54,88,38.03
Taliyah,Annie,54,16,38,29.63
Taliyah,KogMaw,65,38,27,58.46
Taliyah,Alistar,79,49,30,62.03
Taliyah,Galio,114,60,54,52.63
Taliyah,FiddleSticks,104,69,35,66.35
Taliyah,Xerath,109,51,58,46.79
Taliyah,Lucian,90,43,47,47.78
Taliyah,Skarner,72,35,37,48.61
Taliyah,Diana,214,75,139,35.05
Taliyah,Vex,79,39,40,49.37
Taliyah,Karthus,67,41,26,61.19
Taliyah,TahmKench,207,88,119,42.51
Taliyah,Camille,68,25,43,36.76
Taliyah,Aphelios,122,25,97,20.49
Taliyah,Renata,57,40,17,70.18
Taliyah,Warwick,212,109,103,51.42
Taliyah,Morgana,149,61,88,40.94
Taliyah,Yuumi,121,69,52,57.02
Taliyah,Mel,394,201,193,51.02
Taliyah,Cassiopeia,46,40,6,86.96
Taliyah,Heimerdinger,103,54,49,52.43
Taliyah,Azir,49,18,31,36.73
Taliyah,Chogath,196,109,87,55.61
Taliyah,Poppy,77,38,39,49.35
Taliyah,Illaoi,95,40,55,42.11
Taliyah,Graves,99,68,31,68.69
Taliyah,Gragas,98,55,43,56.12
Taliyah,DrMundo,102,51,51,50
Taliyah,Lulu,157,78,79,49.68
Taliyah,Qiyana,60,24,36,40
Taliyah,Garen,254,94,160,37.01
Taliyah,KSante,60,25,35,41.67
Taliyah,Rell,97,39,58,40.21
Taliyah,Kennen,61,34,27,55.74
Taliyah,Hwei,136,85,51,62.5
Taliyah,Brand,78,30,48,38.46
Taliyah,Urgot,80,42,38,52.5
Taliyah,Akali,214,94,120,43.93
Taliyah,Vayne,205,99,106,48.29
Taliyah,Aatrox,129,70,59,54.26
Taliyah,Ambessa,113,68,45,60.18
Taliyah,Tryndamere,104,48,56,46.15
Taliyah,Janna,76,16,60,21.05
Taliyah,Talon,122,53,69,43.44
Taliyah,Hecarim,50,24,26,48
Taliyah,Elise,93,37,56,39.78
Taliyah,Sivir,42,16,26,38.1
Taliyah,Udyr,67,33,34,49.25
Taliyah,Ivern,25,11,14,44
Taliyah,Velkoz,93,42,51,45.16
Taliyah,Xayah,81,25,56,30.86
Taliyah,Trundle,84,21,63,25
Taliyah,Karma,111,58,53,52.25
Taliyah,Kindred,91,60,31,65.93
Taliyah,Riven,87,56,31,64.37
Taliyah,Zeri,62,31,31,50
Taliyah,Pyke,148,90,58,60.81
Taliyah,Jayce,88,47,41,53.41
Taliyah,Zac,91,57,34,62.64
Taliyah,Sejuani,37,30,7,81.08
Taliyah,Zilean,84,50,34,59.52
Taliyah,Senna,187,89,98,47.59
Taliyah,Kassadin,32,19,13,59.38
Taliyah,Lissandra,23,6,17,26.09
Taliyah,Shyvana,67,28,39,41.79
Taliyah,Kled,46,27,19,58.7
Taliyah,Malzahar,104,46,58,44.23
Taliyah,Naafiri,74,38,36,51.35
Taliyah,Orianna,91,45,46,49.45
Taliyah,Syndra,54,33,21,61.11
Taliyah,TwistedFate,48,26,22,54.17
Taliyah,Olaf,48,30,18,62.5
Taliyah,Rammus,37,9,28,24.32
Taliyah,Leblanc,52,35,17,67.31
Taliyah,Maokai,87,47,40,54.02
Taliyah,Nidalee,53,29,24,54.72
Taliyah,Quinn,52,43,9,82.69
Taliyah,Anivia,48,25,23,52.08
Taliyah,Renekton,65,20,45,30.77
Taliyah,Rumble,32,20,12,62.5
Taliyah,Belveth,20,6,14,30
Cassiopeia,Gwen,157,75,82,47.77
Cassiopeia,JarvanIV,85,42,43,49.41
Cassiopeia,Yone,508,253,255,49.8
Cassiopeia,Zyra,135,51,84,37.78
Cassiopeia,Seraphine,251,137,114,54.58
Cassiopeia,Irelia,222,105,117,47.3
Cassiopeia,Pantheon,368,173,195,47.01
Cassiopeia,Kassadin,38,19,19,50
Cassiopeia,Jhin,376,205,171,54.52
Cassiopeia,Yuumi,143,76,67,53.15
Cassiopeia,Ornn,69,37,32,53.62
Cassiopeia,Poppy,168,63,105,37.5
Cassiopeia,MissFortune,535,238,297,44.49
Cassiopeia,Brand,138,79,59,57.25
Cassiopeia,Yorick,191,87,104,45.55
Cassiopeia,Kayn,345,138,207,40
Cassiopeia,Sivir,125,66,59,52.8
Cassiopeia,Xerath,239,124,115,51.88
Cassiopeia,Zac,97,35,62,36.08
Cassiopeia,Amumu,281,125,156,44.48
Cassiopeia,Chogath,302,130,172,43.05
Cassiopeia,Twitch,172,105,67,61.05
Cassiopeia,Mel,579,308,271,53.2
Cassiopeia,Mordekaiser,396,198,198,50
Cassiopeia,Diana,340,150,190,44.12
Cassiopeia,Ezreal,377,204,173,54.11
Cassiopeia,Thresh,312,180,132,57.69
Cassiopeia,Nunu,146,76,70,52.05
Cassiopeia,Zed,187,112,75,59.89
Cassiopeia,Rakan,110,61,49,55.45
Cassiopeia,Renekton,103,55,48,53.4
Cassiopeia,Khazix,133,59,74,44.36
Cassiopeia,Malzahar,189,100,89,52.91
Cassiopeia,Lux,570,297,273,52.11
Cassiopeia,Quinn,67,35,32,52.24
Cassiopeia,TahmKench,244,151,93,61.89
Cassiopeia,Sett,365,167,198,45.75
Cassiopeia,Blitzcrank,233,79,154,33.91
Cassiopeia,Katarina,167,79,88,47.31
Cassiopeia,Shaco,218,114,104,52.29
Cassiopeia,Neeko,220,123,97,55.91
Cassiopeia,Caitlyn,626,305,321,48.72
Cassiopeia,Nasus,219,116,103,52.97
Cassiopeia,FiddleSticks,89,60,29,67.42
Cassiopeia,Azir,127,55,72,43.31
Cassiopeia,Xayah,119,65,54,54.62
Cassiopeia,Nami,179,110,69,61.45
Cassiopeia,Teemo,439,211,228,48.06
Cassiopeia,Maokai,92,34,58,36.96
Cassiopeia,Sylas,213,104,109,48.83
Cassiopeia,Corki,83,52,31,62.65
Cassiopeia,Taric,76,24,52,31.58
Cassiopeia,Kayle,183,102,81,55.74
Cassiopeia,Nocturne,201,95,106,47.26
Cassiopeia,Lucian,91,41,50,45.05
Cassiopeia,Garen,368,159,209,43.21
Cassiopeia,Darius,413,204,209,49.39
Cassiopeia,Aatrox,212,94,118,44.34
Cassiopeia,Jinx,406,146,260,35.96
Cassiopeia,Morgana,333,142,191,42.64
Cassiopeia,Olaf,71,28,43,39.44
Cassiopeia,Draven,136,57,79,41.91
Cassiopeia,Kled,54,20,34,37.04
Cassiopeia,Vex,232,106,126,45.69
Cassiopeia,Yasuo,378,202,176,53.44
Cassiopeia,Lulu,174,66,108,37.93
Cassiopeia,XinZhao,159,69,90,43.4
Cassiopeia,Ziggs,147,42,105,28.57
Cassiopeia,LeeSin,256,152,104,59.38
Cassiopeia,Graves,84,57,27,67.86
Cassiopeia,Briar,285,149,136,52.28
Cassiopeia,Ryze,62,25,37,40.32
Cassiopeia,Singed,31,26,5,83.87
Cassiopeia,Nautilus,303,150,153,49.5
Cassiopeia,Aurora,252,128,124,50.79
Cassiopeia,Kindred,95,66,29,69.47
Cassiopeia,Viktor,161,72,89,44.72
Cassiopeia,Vayne,237,131,106,55.27
Cassiopeia,Tryndamere,139,68,71,48.92
Cassiopeia,Hwei,172,83,89,48.26
Cassiopeia,Sona,120,45,75,37.5
Cassiopeia,Udyr,101,47,54,46.53
Cassiopeia,Swain,246,127,119,51.63
Cassiopeia,Kalista,103,66,37,64.08
Cassiopeia,Aphelios,196,99,97,50.51
Cassiopeia,Soraka,137,63,74,45.99
Cassiopeia,Trundle,120,63,57,52.5
Cassiopeia,Rammus,95,76,19,80
Cassiopeia,Fizz,123,58,65,47.15
Cassiopeia,Ashe,344,165,179,47.97
Cassiopeia,Kennen,96,59,37,61.46
Cassiopeia,Zeri,102,60,42,58.82
Cassiopeia,Rengar,105,46,59,43.81
Cassiopeia,Ahri,370,201,169,54.32
Cassiopeia,Orianna,95,55,40,57.89
Cassiopeia,Smolder,189,94,95,49.74
Cassiopeia,Gnar,126,78,48,61.9
Cassiopeia,Vi,218,91,127,41.74
Cassiopeia,Rell,174,82,92,47.13
Cassiopeia,Kaisa,329,155,174,47.11
Cassiopeia,Zoe,124,54,70,43.55
Cassiopeia,Naafiri,80,40,40,50
Cassiopeia,Hecarim,112,60,52,53.57
Cassiopeia,Velkoz,201,83,118,41.29
Cassiopeia,Warwick,423,190,233,44.92
Cassiopeia,Ambessa,104,44,60,42.31
Cassiopeia,Karma,144,56,88,38.89
Cassiopeia,Jax,236,92,144,38.98
Cassiopeia,Samira,244,122,122,50
Cassiopeia,Elise,159,94,65,59.12
Cassiopeia,Sejuani,79,25,54,31.65
Cassiopeia,MasterYi,240,91,149,37.92
Cassiopeia,Annie,64,29,35,45.31
Cassiopeia,Renata,41,23,18,56.1
Cassiopeia,Riven,107,67,40,62.62
Cassiopeia,Illaoi,73,26,47,35.62
Cassiopeia,Urgot,136,70,66,51.47
Cassiopeia,Viego,259,159,100,61.39
Cassiopeia,Fiora,108,45,63,41.67
Cassiopeia,Akshan,105,49,56,46.67
Cassiopeia,Nilah,117,47,70,40.17
Cassiopeia,Qiyana,82,44,38,53.66
Cassiopeia,Malphite,188,75,113,39.89
Cassiopeia,Lillia,161,87,74,54.04
Cassiopeia,Taliyah,46,6,40,13.04
Cassiopeia,Belveth,76,22,54,28.95
Cassiopeia,Syndra,198,85,113,42.93
Cassiopeia,Camille,55,40,15,72.73
Cassiopeia,Galio,166,106,60,63.86
Cassiopeia,Varus,176,80,96,45.45
Cassiopeia,Gangplank,107,64,43,59.81
Cassiopeia,Akali,254,139,115,54.72
Cassiopeia,Vladimir,164,51,113,31.1
Cassiopeia,Leona,198,67,131,33.84
Cassiopeia,Senna,215,109,106,50.7
Cassiopeia,Alistar,72,43,29,59.72
Cassiopeia,Talon,140,69,71,49.29
Cassiopeia,Volibear,249,137,112,55.02
Cassiopeia,Anivia,102,72,30,70.59
Cassiopeia,Heimerdinger,113,50,63,44.25
Cassiopeia,KSante,75,24,51,32
Cassiopeia,Karthus,66,28,38,42.42
Cassiopeia,Ekko,174,55,119,31.61
Cassiopeia,Sion,209,87,122,41.63
Cassiopeia,Pyke,271,141,130,52.03
Cassiopeia,Ivern,44,18,26,40.91
Cassiopeia,Lissandra,48,18,30,37.5
Cassiopeia,Evelynn,113,65,48,57.52
Cassiopeia,Milio,78,34,44,43.59
Cassiopeia,Skarner,93,54,39,58.06
Cassiopeia,MonkeyKing,112,82,30,73.21
Cassiopeia,Leblanc,63,31,32,49.21
Cassiopeia,KogMaw,83,43,40,51.81
Cassiopeia,DrMundo,149,81,68,54.36
Cassiopeia,Zilean,33,13,20,39.39
Cassiopeia,RekSai,33,23,10,69.7
Cassiopeia,AurelionSol,95,54,41,56.84
Cassiopeia,Shen,80,38,42,47.5
Cassiopeia,Gragas,129,87,42,67.44
Cassiopeia,Tristana,271,130,141,47.97
Cassiopeia,Janna,44,21,23,47.73
Cassiopeia,Veigar,247,110,137,44.53
Cassiopeia,Bard,62,22,40,35.48
Cassiopeia,Nidalee,51,27,24,52.94
Cassiopeia,TwistedFate,75,26,49,34.67
Cassiopeia,Shyvana,57,14,43,24.56
Cassiopeia,Braum,80,33,47,41.25
Cassiopeia,Jayce,99,37,62,37.37
Cassiopeia,Rumble,26,10,16,38.46
Evelynn,Teemo,563,204,359,36.23
Evelynn,Hecarim,102,54,48,52.94
Evelynn,Veigar,336,110,226,32.74
Evelynn,Ashe,605,288,317,47.6
Evelynn,Thresh,294,118,176,40.14
Evelynn,Yasuo,672,321,351,47.77
Evelynn,Sylas,281,105,176,37.37
Evelynn,Zed,321,170,151,52.96
Evelynn,Sivir,134,52,82,38.81
Evelynn,Blitzcrank,274,135,139,49.27
Evelynn,Darius,572,308,264,53.85
Evelynn,Garen,494,212,282,42.91
Evelynn,Lux,972,515,457,52.98
Evelynn,Rakan,229,100,129,43.67
Evelynn,Riven,189,107,82,56.61
Evelynn,JarvanIV,90,38,52,42.22
Evelynn,Taliyah,57,26,31,45.61
Evelynn,Draven,153,70,83,45.75
Evelynn,Malphite,204,76,128,37.25
Evelynn,Diana,517,266,251,51.45
Evelynn,Akali,403,178,225,44.17
Evelynn,Jinx,700,287,413,41
Evelynn,Illaoi,129,49,80,37.98
Evelynn,Khazix,240,114,126,47.5
Evelynn,Syndra,174,114,60,65.52
Evelynn,Kaisa,428,219,209,51.17
Evelynn,Heimerdinger,143,54,89,37.76
Evelynn,FiddleSticks,173,77,96,44.51
Evelynn,Katarina,286,157,129,54.9
Evelynn,Caitlyn,684,335,349,48.98
Evelynn,Pyke,485,271,214,55.88
Evelynn,Pantheon,554,256,298,46.21
Evelynn,Nocturne,304,160,144,52.63
Evelynn,Aurora,317,142,175,44.79
Evelynn,MissFortune,695,345,350,49.64
Evelynn,Soraka,204,78,126,38.24
Evelynn,Yone,656,315,341,48.02
Evelynn,Irelia,293,127,166,43.34
Evelynn,Morgana,622,246,376,39.55
Evelynn,Gnar,156,89,67,57.05
Evelynn,Rammus,72,50,22,69.44
Evelynn,Akshan,94,42,52,44.68
Evelynn,Poppy,189,93,96,49.21
Evelynn,Warwick,558,231,327,41.4
Evelynn,Zoe,146,76,70,52.05
Evelynn,Gragas,138,69,69,50
Evelynn,Mordekaiser,559,195,364,34.88
Evelynn,Viego,421,189,232,44.89
Evelynn,Udyr,117,69,48,58.97
Evelynn,Ahri,456,203,253,44.52
Evelynn,Karma,187,95,92,50.8
Evelynn,Sett,495,238,257,48.08
Evelynn,KSante,107,62,45,57.94
Evelynn,MonkeyKing,157,94,63,59.87
Evelynn,Ekko,284,129,155,45.42
Evelynn,Lucian,139,59,80,42.45
Evelynn,Senna,236,104,132,44.07
Evelynn,Nasus,265,138,127,52.08
Evelynn,Malzahar,239,73,166,30.54
Evelynn,Ezreal,490,243,247,49.59
Evelynn,Mel,667,272,395,40.78
Evelynn,Jhin,559,235,324,42.04
Evelynn,Nami,257,154,103,59.92
Evelynn,Vayne,338,156,182,46.15
Evelynn,LeeSin,373,191,182,51.21
Evelynn,Seraphine,349,169,180,48.42
Evelynn,Shyvana,116,63,53,54.31
Evelynn,Viktor,236,119,117,50.42
Evelynn,Janna,72,31,41,43.06
Evelynn,Jax,307,150,157,48.86
Evelynn,Olaf,39,18,21,46.15
Evelynn,Shaco,304,161,143,52.96
Evelynn,TahmKench,327,130,197,39.76
Evelynn,RekSai,29,9,20,31.03
Evelynn,Tristana,374,161,213,43.05
Evelynn,Xayah,266,136,130,51.13
Evelynn,MasterYi,373,202,171,54.16
Evelynn,Renekton,105,29,76,27.62
Evelynn,Fiora,155,64,91,41.29
Evelynn,Kayn,459,206,253,44.88
Evelynn,Gangplank,114,52,62,45.61
Evelynn,Nunu,263,106,157,40.3
Evelynn,Hwei,293,164,129,55.97
Evelynn,Lulu,262,123,139,46.95
Evelynn,Quinn,111,57,54,51.35
Evelynn,Kled,30,11,19,36.67
Evelynn,Samira,336,160,176,47.62
Evelynn,Leona,222,84,138,37.84
Evelynn,DrMundo,224,95,129,42.41
Evelynn,Belveth,58,46,12,79.31
Evelynn,Azir,86,49,37,56.98
Evelynn,Aphelios,260,121,139,46.54
Evelynn,Naafiri,199,62,137,31.16
Evelynn,Aatrox,333,164,169,49.25
Evelynn,Milio,199,76,123,38.19
Evelynn,Ziggs,163,55,108,33.74
Evelynn,Nilah,257,151,106,58.75
Evelynn,Yorick,293,102,191,34.81
Evelynn,Kassadin,109,62,47,56.88
Evelynn,Shen,199,109,90,54.77
Evelynn,Talon,250,132,118,52.8
Evelynn,Chogath,437,183,254,41.88
Evelynn,Braum,165,92,73,55.76
Evelynn,Anivia,99,51,48,51.52
Evelynn,Corki,60,19,41,31.67
Evelynn,Vladimir,193,90,103,46.63
Evelynn,Nautilus,283,102,181,36.04
Evelynn,Twitch,310,133,177,42.9
Evelynn,Kayle,297,128,169,43.1
Evelynn,Zac,114,39,75,34.21
Evelynn,Amumu,277,109,168,39.35
Evelynn,Smolder,248,135,113,54.44
Evelynn,Rell,196,102,94,52.04
Evelynn,Ornn,148,63,85,42.57
Evelynn,Singed,67,17,50,25.37
Evelynn,Sona,129,52,77,40.31
Evelynn,Neeko,270,151,119,55.93
Evelynn,AurelionSol,184,54,130,29.35
Evelynn,Ambessa,153,74,79,48.37
Evelynn,Taric,84,43,41,51.19
Evelynn,Kennen,168,87,81,51.79
Evelynn,Yuumi,281,124,157,44.13
Evelynn,Graves,165,101,64,61.21
Evelynn,Leblanc,133,69,64,51.88
Evelynn,Trundle,191,83,108,43.46
Evelynn,Gwen,162,90,72,55.56
Evelynn,Briar,358,137,221,38.27
Evelynn,Zyra,157,55,102,35.03
Evelynn,Rengar,123,90,33,73.17
Evelynn,Varus,222,131,91,59.01
Evelynn,Fizz,173,79,94,45.66
Evelynn,Lillia,269,126,143,46.84
Evelynn,Qiyana,141,96,45,68.09
Evelynn,Swain,317,124,193,39.12
Evelynn,Ivern,55,33,22,60
Evelynn,Galio,238,86,152,36.13
Evelynn,Annie,104,60,44,57.69
Evelynn,Vi,245,76,169,31.02
Evelynn,Alistar,67,26,41,38.81
Evelynn,Rumble,63,28,35,44.44
Evelynn,Zeri,111,43,68,38.74
Evelynn,Kindred,161,93,68,57.76
Evelynn,Volibear,387,145,242,37.47
Evelynn,XinZhao,183,68,115,37.16
Evelynn,KogMaw,106,52,54,49.06
Evelynn,Renata,76,45,31,59.21
Evelynn,Xerath,184,93,91,50.54
Evelynn,Cassiopeia,113,48,65,42.48
Evelynn,Urgot,166,88,78,53.01
Evelynn,Elise,205,129,76,62.93
Evelynn,Ryze,83,44,39,53.01
Evelynn,Velkoz,219,102,117,46.58
Evelynn,Vex,175,90,85,51.43
Evelynn,Sion,271,117,154,43.17
Evelynn,Tryndamere,174,70,104,40.23
Evelynn,Bard,90,53,37,58.89
Evelynn,Zilean,81,39,42,48.15
Evelynn,Nidalee,91,53,38,58.24
Evelynn,Karthus,92,39,53,42.39
Evelynn,Maokai,142,64,78,45.07
Evelynn,Brand,216,90,126,41.67
Evelynn,Skarner,111,59,52,53.15
Evelynn,Sejuani,121,54,67,44.63
Evelynn,Lissandra,94,46,48,48.94
Evelynn,Orianna,128,65,63,50.78
Evelynn,Kalista,198,94,104,47.47
Evelynn,Camille,45,24,21,53.33
Evelynn,Jayce,86,42,44,48.84
Evelynn,TwistedFate,80,51,29,63.75
Hecarim,Warwick,373,175,198,46.92
Hecarim,Evelynn,102,48,54,47.06
Hecarim,Ahri,292,107,185,36.64
Hecarim,Yasuo,441,248,193,56.24
Hecarim,Yone,422,248,174,58.77
Hecarim,Mordekaiser,371,173,198,46.63
Hecarim,Akali,254,146,108,57.48
Hecarim,Jhin,357,150,207,42.02
Hecarim,Velkoz,202,96,106,47.52
Hecarim,Trundle,123,48,75,39.02
Hecarim,Amumu,246,88,158,35.77
Hecarim,Fizz,122,55,67,45.08
Hecarim,Kaisa,357,198,159,55.46
Hecarim,Pantheon,357,175,182,49.02
Hecarim,Garen,350,161,189,46
Hecarim,Rammus,80,37,43,46.25
Hecarim,Katarina,235,117,118,49.79
Hecarim,Caitlyn,505,242,263,47.92
Hecarim,Milio,137,75,62,54.74
Hecarim,Ashe,370,195,175,52.7
Hecarim,LeeSin,202,117,85,57.92
Hecarim,Varus,190,82,108,43.16
Hecarim,Lux,695,301,394,43.31
Hecarim,Aatrox,197,97,100,49.24
Hecarim,Volibear,228,114,114,50
Hecarim,Teemo,306,164,142,53.59
Hecarim,Jinx,457,211,246,46.17
Hecarim,Leona,123,48,75,39.02
Hecarim,Camille,60,23,37,38.33
Hecarim,Kayn,427,240,187,56.21
Hecarim,Zeri,98,53,45,54.08
Hecarim,Yuumi,204,82,122,40.2
Hecarim,Shen,152,77,75,50.66
Hecarim,Vi,196,77,119,39.29
Hecarim,Kassadin,64,28,36,43.75
Hecarim,Corki,63,39,24,61.9
Hecarim,Blitzcrank,153,76,77,49.67
Hecarim,Graves,145,63,82,43.45
Hecarim,Aurora,230,112,118,48.7
Hecarim,Mel,476,276,200,57.98
Hecarim,KSante,105,63,42,60
Hecarim,FiddleSticks,156,85,71,54.49
Hecarim,Irelia,168,85,83,50.6
Hecarim,Senna,185,94,91,50.81
Hecarim,Kindred,111,71,40,63.96
Hecarim,Ekko,176,87,89,49.43
Hecarim,Rell,91,34,57,37.36
Hecarim,Briar,170,71,99,41.76
Hecarim,Zoe,94,52,42,55.32
Hecarim,MissFortune,459,193,266,42.05
Hecarim,Soraka,158,81,77,51.27
Hecarim,MasterYi,204,116,88,56.86
Hecarim,Zed,215,100,115,46.51
Hecarim,Pyke,252,142,110,56.35
Hecarim,Yorick,171,64,107,37.43
Hecarim,Diana,194,79,115,40.72
Hecarim,Viego,284,138,146,48.59
Hecarim,Samira,205,80,125,39.02
Hecarim,Thresh,283,141,142,49.82
Hecarim,Sett,300,131,169,43.67
Hecarim,Riven,113,71,42,62.83
Hecarim,Darius,453,194,259,42.83
Hecarim,AurelionSol,120,63,57,52.5
Hecarim,Karma,152,68,84,44.74
Hecarim,Lillia,145,72,73,49.66
Hecarim,Jax,198,80,118,40.4
Hecarim,Neeko,177,75,102,42.37
Hecarim,Chogath,291,173,118,59.45
Hecarim,Vex,103,60,43,58.25
Hecarim,DrMundo,179,42,137,23.46
Hecarim,Ezreal,349,209,140,59.89
Hecarim,Morgana,244,157,87,64.34
Hecarim,Illaoi,110,38,72,34.55
Hecarim,Shaco,267,130,137,48.69
Hecarim,Draven,177,85,92,48.02
Hecarim,Alistar,77,37,40,48.05
Hecarim,Shyvana,75,40,35,53.33
Hecarim,Gwen,112,54,58,48.21
Hecarim,Zac,63,34,29,53.97
Hecarim,Khazix,123,52,71,42.28
Hecarim,Lucian,127,80,47,62.99
Hecarim,Ambessa,125,37,88,29.6
Hecarim,Nasus,141,63,78,44.68
Hecarim,TwistedFate,106,57,49,53.77
Hecarim,Gangplank,68,37,31,54.41
Hecarim,Lulu,195,76,119,38.97
Hecarim,TahmKench,311,124,187,39.87
Hecarim,Cassiopeia,112,52,60,46.43
Hecarim,Gragas,139,47,92,33.81
Hecarim,Bard,84,36,48,42.86
Hecarim,Zyra,155,75,80,48.39
Hecarim,JarvanIV,97,44,53,45.36
Hecarim,Aphelios,114,38,76,33.33
Hecarim,Ryze,81,46,35,56.79
Hecarim,Nautilus,245,137,108,55.92
Hecarim,Kayle,170,74,96,43.53
Hecarim,Akshan,132,62,70,46.97
Hecarim,Skarner,67,50,17,74.63
Hecarim,Qiyana,124,61,63,49.19
Hecarim,Nocturne,168,88,80,52.38
Hecarim,Malzahar,133,67,66,50.38
Hecarim,Ornn,79,51,28,64.56
Hecarim,Twitch,184,57,127,30.98
Hecarim,Rengar,122,83,39,68.03
Hecarim,KogMaw,136,63,73,46.32
Hecarim,Kennen,88,60,28,68.18
Hecarim,Udyr,72,29,43,40.28
Hecarim,Leblanc,54,37,17,68.52
Hecarim,Nilah,83,22,61,26.51
Hecarim,Nami,157,103,54,65.61
Hecarim,Vayne,200,119,81,59.5
Hecarim,Tristana,181,70,111,38.67
Hecarim,Kled,34,8,26,23.53
Hecarim,Seraphine,178,86,92,48.31
Hecarim,Vladimir,118,64,54,54.24
Hecarim,Poppy,115,28,87,24.35
Hecarim,Galio,126,33,93,26.19
Hecarim,Belveth,54,21,33,38.89
Hecarim,Hwei,180,96,84,53.33
Hecarim,Quinn,52,30,22,57.69
Hecarim,Janna,63,29,34,46.03
Hecarim,Xerath,178,74,104,41.57
Hecarim,Renekton,99,50,49,50.51
Hecarim,Heimerdinger,97,47,50,48.45
Hecarim,Maokai,83,53,30,63.86
Hecarim,Viktor,125,72,53,57.6
Hecarim,Naafiri,108,44,64,40.74
Hecarim,Syndra,150,66,84,44
Hecarim,Kalista,126,81,45,64.29
Hecarim,Lissandra,41,13,28,31.71
Hecarim,Malphite,183,75,108,40.98
Hecarim,Tryndamere,142,81,61,57.04
Hecarim,Nunu,246,100,146,40.65
Hecarim,Sylas,184,57,127,30.98
Hecarim,Fiora,114,64,50,56.14
Hecarim,Olaf,44,25,19,56.82
Hecarim,Orianna,73,51,22,69.86
Hecarim,Braum,95,54,41,56.84
Hecarim,Ivern,26,6,20,23.08
Hecarim,Xayah,118,54,64,45.76
Hecarim,Rakan,79,59,20,74.68
Hecarim,MonkeyKing,105,56,49,53.33
Hecarim,Sivir,105,48,57,45.71
Hecarim,Brand,157,72,85,45.86
Hecarim,XinZhao,134,50,84,37.31
Hecarim,Swain,228,101,127,44.3
Hecarim,Smolder,217,85,132,39.17
Hecarim,Veigar,248,84,164,33.87
Hecarim,Annie,71,46,25,64.79
Hecarim,Renata,28,15,13,53.57
Hecarim,Sion,163,58,105,35.58
Hecarim,Taliyah,50,26,24,52
Hecarim,Elise,113,61,52,53.98
Hecarim,Zilean,55,19,36,34.55
Hecarim,Karthus,61,40,21,65.57
Hecarim,Sejuani,66,24,42,36.36
Hecarim,Ziggs,91,40,51,43.96
Hecarim,Azir,62,37,25,59.68
Hecarim,Nidalee,53,36,17,67.92
Hecarim,Singed,74,37,37,50
Hecarim,Anivia,39,30,9,76.92
Hecarim,Gnar,62,24,38,38.71
Hecarim,Jayce,85,31,54,36.47
Hecarim,RekSai,31,10,21,32.26
Hecarim,Urgot,83,37,46,44.58
Hecarim,Talon,126,75,51,59.52
Hecarim,Sona,82,48,34,58.54
Hecarim,Rumble,41,18,23,43.9
Hecarim,Taric,33,3,30,9.09
Thresh,Warwick,1211,502,709,41.45
Thresh,Evelynn,294,176,118,59.86
Thresh,Ahri,967,465,502,48.09
Thresh,Yasuo,1504,757,747,50.33
Thresh,Yone,1457,750,707,51.48
Thresh,Sylas,594,308,286,51.85
Thresh,Zed,776,464,312,59.79
Thresh,Sivir,351,178,173,50.71
Thresh,Blitzcrank,694,361,333,52.02
Thresh,Teemo,1068,482,586,45.13
Thresh,XinZhao,470,254,216,54.04
Thresh,Jinx,1459,732,727,50.17
Thresh,Neeko,577,280,297,48.53
Thresh,Irelia,634,316,318,49.84
Thresh,Galio,506,247,259,48.81
Thresh,Rell,500,233,267,46.6
Thresh,Illaoi,376,185,191,49.2
Thresh,Aatrox,769,363,406,47.2
Thresh,Ashe,1376,716,660,52.03
Thresh,Aphelios,561,280,281,49.91
Thresh,Gragas,549,297,252,54.1
Thresh,Yorick,734,357,377,48.64
Thresh,Viego,942,460,482,48.83
Thresh,Malphite,601,238,363,39.6
Thresh,Kaisa,1136,618,518,54.4
Thresh,Ambessa,531,268,263,50.47
Thresh,Xayah,484,252,232,52.07
Thresh,AurelionSol,361,205,156,56.79
Thresh,Khazix,459,213,246,46.41
Thresh,Nautilus,977,447,530,45.75
Thresh,Camille,260,129,131,49.62
Thresh,Katarina,654,350,304,53.52
Thresh,MissFortune,1514,640,874,42.27
Thresh,Zyra,522,210,312,40.23
Thresh,LeeSin,794,390,404,49.12
Thresh,Chogath,1068,538,530,50.37
Thresh,Lucian,473,236,237,49.89
Thresh,Xerath,475,220,255,46.32
Thresh,Kindred,344,180,164,52.33
Thresh,Fizz,415,187,228,45.06
Thresh,Gnar,338,150,188,44.38
Thresh,Caitlyn,1748,759,989,43.42
Thresh,Ezreal,1350,757,593,56.07
Thresh,Lux,2288,1110,1178,48.51
Thresh,Darius,1388,675,713,48.63
Thresh,Trundle,421,185,236,43.94
Thresh,Vex,432,205,227,47.45
Thresh,Mordekaiser,1209,567,642,46.9
Thresh,Nunu,728,375,353,51.51
Thresh,Shen,590,309,281,52.37
Thresh,Rammus,205,102,103,49.76
Thresh,Cassiopeia,312,132,180,42.31
Thresh,Tryndamere,496,222,274,44.76
Thresh,Amumu,623,262,361,42.05
Thresh,Mel,1697,885,812,52.15
Thresh,Seraphine,808,321,487,39.73
Thresh,Tristana,685,313,372,45.69
Thresh,Nilah,459,209,250,45.53
Thresh,TahmKench,789,394,395,49.94
Thresh,Naafiri,298,153,145,51.34
Thresh,Volibear,798,377,421,47.24
Thresh,Soraka,476,283,193,59.45
Thresh,Ekko,539,270,269,50.09
Thresh,Leona,568,322,246,56.69
Thresh,Ziggs,345,135,210,39.13
Thresh,Kayn,1103,576,527,52.22
Thresh,Syndra,427,196,231,45.9
Thresh,Senna,734,405,329,55.18
Thresh,Akali,788,395,393,50.13
Thresh,Akshan,326,93,233,28.53
Thresh,Skarner,244,135,109,55.33
Thresh,Shaco,685,392,293,57.23
Thresh,Lissandra,174,73,101,41.95
Thresh,Pyke,1014,483,531,47.63
Thresh,Talon,464,266,198,57.33
Thresh,Maokai,343,164,179,47.81
Thresh,Varus,550,263,287,47.82
Thresh,Graves,442,188,254,42.53
Thresh,Gangplank,327,203,124,62.08
Thresh,Hwei,559,279,280,49.91
Thresh,Jhin,1329,724,605,54.48
Thresh,Kennen,276,159,117,57.61
Thresh,Karthus,210,115,95,54.76
Thresh,Veigar,834,370,464,44.36
Thresh,Vladimir,414,167,247,40.34
Thresh,Sona,265,144,121,54.34
Thresh,Urgot,330,168,162,50.91
Thresh,Twitch,684,371,313,54.24
Thresh,MasterYi,749,343,406,45.79
Thresh,Smolder,629,318,311,50.56
Thresh,Yuumi,647,271,376,41.89
Thresh,Garen,1152,554,598,48.09
Thresh,Vi,714,364,350,50.98
Thresh,Diana,1071,543,528,50.7
Thresh,Annie,185,77,108,41.62
Thresh,Shyvana,189,84,105,44.44
Thresh,Taric,200,72,128,36
Thresh,Nami,763,333,430,43.64
Thresh,Singed,277,117,160,42.24
Thresh,Taliyah,262,138,124,52.67
Thresh,Jax,564,284,280,50.35
Thresh,Zoe,338,202,136,59.76
Thresh,Poppy,546,261,285,47.8
Thresh,Sett,1170,516,654,44.1
Thresh,Rengar,352,212,140,60.23
Thresh,Ivern,187,121,66,64.71
Thresh,Ryze,219,71,148,32.42
Thresh,Pantheon,1347,705,642,52.34
Thresh,Renekton,429,203,226,47.32
Thresh,Fiora,321,190,131,59.19
Thresh,Rakan,500,265,235,53
Thresh,Brand,539,237,302,43.97
Thresh,Velkoz,516,185,331,35.85
Thresh,Heimerdinger,372,137,235,36.83
Thresh,Qiyana,255,159,96,62.35
Thresh,Udyr,356,178,178,50
Thresh,Karma,458,225,233,49.13
Thresh,Ornn,316,179,137,56.65
Thresh,KSante,318,175,143,55.03
Thresh,Sion,646,260,386,40.25
Thresh,Hecarim,283,142,141,50.18
Thresh,Lulu,575,345,230,60
Thresh,Samira,732,334,398,45.63
Thresh,Morgana,931,446,485,47.91
Thresh,Alistar,374,178,196,47.59
Thresh,Briar,813,353,460,43.42
Thresh,Anivia,251,144,107,57.37
Thresh,Leblanc,361,133,228,36.84
Thresh,Milio,454,246,208,54.19
Thresh,Sejuani,351,181,170,51.57
Thresh,Corki,262,147,115,56.11
Thresh,Swain,903,432,471,47.84
Thresh,Aurora,741,388,353,52.36
Thresh,Lillia,567,235,332,41.45
Thresh,Renata,207,104,103,50.24
Thresh,FiddleSticks,358,163,195,45.53
Thresh,Kalista,370,190,180,51.35
Thresh,Zilean,261,139,122,53.26
Thresh,JarvanIV,291,127,164,43.64
Thresh,Malzahar,686,282,404,41.11
Thresh,Draven,500,301,199,60.2
Thresh,Nasus,661,304,357,45.99
Thresh,Rumble,150,60,90,40
Thresh,Kled,152,86,66,56.58
Thresh,Quinn,259,109,150,42.08
Thresh,Viktor,525,243,282,46.29
Thresh,TwistedFate,292,161,131,55.14
Thresh,Zeri,277,114,163,41.16
Thresh,Kayle,568,280,288,49.3
Thresh,Elise,470,240,230,51.06
Thresh,Riven,397,249,148,62.72
Thresh,Nocturne,671,325,346,48.44
Thresh,Janna,303,141,162,46.53
Thresh,Zac,295,112,183,37.97
Thresh,Braum,427,206,221,48.24
Thresh,Olaf,154,53,101,34.42
Thresh,Kassadin,182,94,88,51.65
Thresh,Orianna,351,168,183,47.86
Thresh,Azir,303,94,209,31.02
Thresh,Jayce,336,168,168,50
Thresh,MonkeyKing,375,195,180,52
Thresh,Gwen,460,294,166,63.91
Thresh,Bard,204,78,126,38.24
Thresh,RekSai,105,52,53,49.52
Thresh,DrMundo,390,205,185,52.56
Thresh,Vayne,622,302,320,48.55
Thresh,Belveth,213,111,102,52.11
Thresh,KogMaw,281,146,135,51.96
Thresh,Nidalee,220,131,89,59.55
RekSai,Sett,93,26,67,27.96
RekSai,Taliyah,25,19,6,76
RekSai,Sylas,70,34,36,48.57
RekSai,Ezreal,100,58,42,58
RekSai,Morgana,102,52,50,50.98
RekSai,Illaoi,38,19,19,50
RekSai,Nocturne,60,37,23,61.67
RekSai,Ekko,65,49,16,75.38
RekSai,MissFortune,129,71,58,55.04
RekSai,Seraphine,135,61,74,45.19
RekSai,Gnar,49,19,30,38.78
RekSai,XinZhao,62,31,31,50
RekSai,Yasuo,173,100,73,57.8
RekSai,Zeri,26,16,10,61.54
RekSai,Taric,15,3,12,20
RekSai,Tryndamere,51,27,24,52.94
RekSai,LeeSin,101,52,49,51.49
RekSai,Aurora,41,22,19,53.66
RekSai,Mel,168,66,102,39.29
RekSai,Rumble,24,15,9,62.5
RekSai,Pantheon,150,92,58,61.33
RekSai,Jhin,158,85,73,53.8
RekSai,Nautilus,69,38,31,55.07
RekSai,Darius,168,76,92,45.24
RekSai,Evelynn,29,20,9,68.97
RekSai,Heimerdinger,54,28,26,51.85
RekSai,Jinx,187,101,86,54.01
RekSai,Pyke,106,32,74,30.19
RekSai,Diana,93,50,43,53.76
RekSai,Yone,129,52,77,40.31
RekSai,Veigar,91,67,24,73.63
RekSai,DrMundo,53,32,21,60.38
RekSai,Kayn,105,69,36,65.71
RekSai,Akali,80,46,34,57.5
RekSai,Draven,46,20,26,43.48
RekSai,Rell,48,34,14,70.83
RekSai,Camille,19,19,0,100
RekSai,Ahri,112,52,60,46.43
RekSai,Caitlyn,189,81,108,42.86
RekSai,Fizz,45,42,3,93.33
RekSai,MasterYi,56,27,29,48.21
RekSai,Aphelios,44,24,20,54.55
RekSai,Shaco,86,44,42,51.16
RekSai,Chogath,103,37,66,35.92
RekSai,Poppy,64,26,38,40.63
RekSai,Shyvana,31,21,10,67.74
RekSai,Maokai,15,6,9,40
RekSai,Warwick,91,52,39,57.14
RekSai,Irelia,95,72,23,75.79
RekSai,Sivir,31,9,22,29.03
RekSai,Annie,45,23,22,51.11
RekSai,Renekton,19,6,13,31.58
RekSai,Sejuani,18,9,9,50
RekSai,Urgot,43,17,26,39.53
RekSai,Viego,142,50,92,35.21
RekSai,Aatrox,87,44,43,50.57
RekSai,Zed,112,69,43,61.61
RekSai,Karma,30,21,9,70
RekSai,Galio,56,29,27,51.79
RekSai,Nami,92,40,52,43.48
RekSai,Naafiri,18,9,9,50
RekSai,Zyra,63,40,23,63.49
RekSai,Xayah,66,42,24,63.64
RekSai,Rakan,59,39,20,66.1
RekSai,Vladimir,38,23,15,60.53
RekSai,Renata,26,19,7,73.08
RekSai,Teemo,117,35,82,29.91
RekSai,Belveth,35,10,25,28.57
RekSai,Vex,39,5,34,12.82
RekSai,Kaisa,131,75,56,57.25
RekSai,Senna,66,18,48,27.27
RekSai,Karthus,29,14,15,48.28
RekSai,Thresh,105,53,52,50.48
RekSai,Garen,61,20,41,32.79
RekSai,KSante,50,28,22,56
RekSai,Lulu,93,40,53,43.01
RekSai,TwistedFate,36,19,17,52.78
RekSai,Ambessa,41,27,14,65.85
RekSai,Nidalee,16,13,3,81.25
RekSai,Akshan,39,14,25,35.9
RekSai,Qiyana,39,23,16,58.97
RekSai,Ashe,150,67,83,44.67
RekSai,Mordekaiser,128,70,58,54.69
RekSai,Velkoz,50,31,19,62
RekSai,Volibear,111,49,62,44.14
RekSai,Lillia,61,27,34,44.26
RekSai,Lucian,45,26,19,57.78
RekSai,Braum,61,10,51,16.39
RekSai,Kayle,55,34,21,61.82
RekSai,Neeko,60,29,31,48.33
RekSai,Vi,68,42,26,61.76
RekSai,TahmKench,65,39,26,60
RekSai,Cassiopeia,33,10,23,30.3
RekSai,Yuumi,75,46,29,61.33
RekSai,Kennen,19,3,16,15.79
RekSai,Kindred,32,20,12,62.5
RekSai,Hwei,65,33,32,50.77
RekSai,Leona,99,43,56,43.43
RekSai,Tristana,70,20,50,28.57
RekSai,Gwen,39,12,27,30.77
RekSai,Ornn,46,27,19,58.7
RekSai,Trundle,41,16,25,39.02
RekSai,Gragas,24,21,3,87.5
RekSai,Blitzcrank,73,32,41,43.84
RekSai,Amumu,41,9,32,21.95
RekSai,Malzahar,90,32,58,35.56
RekSai,Singed,31,13,18,41.94
RekSai,Kassadin,16,10,6,62.5
RekSai,Kled,32,10,22,31.25
RekSai,Leblanc,19,16,3,84.21
RekSai,Hecarim,31,21,10,67.74
RekSai,Nasus,52,6,46,11.54
RekSai,Talon,65,23,42,35.38
RekSai,Nunu,91,42,49,46.15
RekSai,JarvanIV,34,15,19,44.12
RekSai,Elise,74,50,24,67.57
RekSai,Janna,36,25,11,69.44
RekSai,Sion,99,59,40,59.6
RekSai,Graves,62,31,31,50
RekSai,Udyr,38,14,24,36.84
RekSai,Zilean,15,8,7,53.33
RekSai,Yorick,104,46,58,44.23
RekSai,Swain,115,64,51,55.65
RekSai,Jax,61,39,22,63.93
RekSai,Lux,179,65,114,36.31
RekSai,Ivern,31,22,9,70.97
RekSai,Skarner,21,9,12,42.86
RekSai,Smolder,68,29,39,42.65
RekSai,Zac,35,12,23,34.29
RekSai,Shen,57,27,30,47.37
RekSai,Rengar,70,27,43,38.57
RekSai,Azir,51,23,28,45.1
RekSai,Malphite,54,25,29,46.3
RekSai,Varus,63,23,40,36.51
RekSai,Viktor,59,42,17,71.19
RekSai,Vayne,67,27,40,40.3
RekSai,Twitch,81,48,33,59.26
RekSai,Katarina,51,31,20,60.78
RekSai,Samira,98,44,54,44.9
RekSai,Lissandra,28,10,18,35.71
RekSai,Quinn,30,0,30,0
RekSai,Syndra,43,20,23,46.51
RekSai,Corki,26,7,19,26.92
RekSai,Riven,50,37,13,74
RekSai,Nilah,41,10,31,24.39
RekSai,Soraka,24,9,15,37.5
RekSai,Brand,30,13,17,43.33
RekSai,Rammus,36,14,22,38.89
RekSai,Briar,86,35,51,40.7
RekSai,Sona,33,3,30,9.09
RekSai,AurelionSol,39,23,16,58.97
RekSai,Zoe,45,32,13,71.11
RekSai,Gangplank,59,48,11,81.36
RekSai,Khazix,38,10,28,26.32
RekSai,FiddleSticks,32,10,22,31.25
RekSai,Ryze,25,10,15,40
RekSai,Anivia,26,10,16,38.46
RekSai,Kalista,43,27,16,62.79
RekSai,Ziggs,42,18,24,42.86
RekSai,Orianna,37,18,19,48.65
RekSai,Xerath,19,9,10,47.37
RekSai,Alistar,34,15,19,44.12
RekSai,Jayce,34,10,24,29.41
RekSai,KogMaw,14,0,14,0
RekSai,MonkeyKing,18,12,6,66.67
RekSai,Milio,34,17,17,50
RekSai,Fiora,14,8,6,57.14
RekSai,Olaf,6,3,3,50
RekSai,Bard,3,3,0,100
Sivir,Malphite,282,156,126,55.32
Sivir,Evelynn,134,82,52,61.19
Sivir,Irelia,207,110,97,53.14
Sivir,Tristana,204,91,113,44.61
Sivir,Thresh,351,173,178,49.29
Sivir,Teemo,403,189,214,46.9
Sivir,Shaco,310,133,177,42.9
Sivir,Leblanc,104,65,39,62.5
Sivir,Ezreal,516,331,185,64.15
Sivir,Sett,425,259,166,60.94
Sivir,Talon,167,86,81,51.5
Sivir,FiddleSticks,148,57,91,38.51
Sivir,Ashe,579,303,276,52.33
Sivir,Blitzcrank,292,139,153,47.6
Sivir,Urgot,147,75,72,51.02
Sivir,Rengar,96,84,12,87.5
Sivir,Ziggs,141,59,82,41.84
Sivir,Trundle,120,60,60,50
Sivir,Fiora,168,86,82,51.19
Sivir,Mordekaiser,387,202,185,52.2
Sivir,Vi,219,138,81,63.01
Sivir,Cassiopeia,125,59,66,47.2
Sivir,Lux,742,382,360,51.48
Sivir,Vladimir,160,104,56,65
Sivir,Yasuo,540,270,270,50
Sivir,Yuumi,180,77,103,42.78
Sivir,Shen,185,96,89,51.89
Sivir,Yone,530,256,274,48.3
Sivir,Twitch,209,67,142,32.06
Sivir,Nautilus,364,237,127,65.11
Sivir,Kayn,411,213,198,51.82
Sivir,Diana,392,225,167,57.4
Sivir,Renekton,105,52,53,49.52
Sivir,Lillia,157,80,77,50.96
Sivir,Annie,81,51,30,62.96
Sivir,Kaisa,436,215,221,49.31
Sivir,Xerath,177,128,49,72.32
Sivir,XinZhao,135,71,64,52.59
Sivir,Vayne,293,118,175,40.27
Sivir,Brand,212,135,77,63.68
Sivir,Kayle,179,106,73,59.22
Sivir,Morgana,419,216,203,51.55
Sivir,Viego,332,157,175,47.29
Sivir,Jinx,594,335,259,56.4
Sivir,Pyke,387,228,159,58.91
Sivir,Camille,110,56,54,50.91
Sivir,Warwick,413,154,259,37.29
Sivir,Azir,109,61,48,55.96
Sivir,Braum,126,77,49,61.11
Sivir,Poppy,171,106,65,61.99
Sivir,Elise,170,80,90,47.06
Sivir,Aurora,312,166,146,53.21
Sivir,Nami,263,116,147,44.11
Sivir,Akali,314,170,144,54.14
Sivir,Gragas,175,99,76,56.57
Sivir,Syndra,200,125,75,62.5
Sivir,Veigar,311,154,157,49.52
Sivir,Gnar,98,38,60,38.78
Sivir,AurelionSol,127,76,51,59.84
Sivir,LeeSin,272,163,109,59.93
Sivir,Zoe,120,49,71,40.83
Sivir,Jhin,483,266,217,55.07
Sivir,Seraphine,305,169,136,55.41
Sivir,Yorick,248,151,97,60.89
Sivir,Sejuani,96,62,34,64.58
Sivir,Kalista,82,53,29,64.63
Sivir,Khazix,175,91,84,52
Sivir,Caitlyn,675,343,332,50.81
Sivir,Taric,88,34,54,38.64
Sivir,Mel,654,383,271,58.56
Sivir,Sylas,308,178,130,57.79
Sivir,Senna,218,128,90,58.72
Sivir,Pantheon,553,266,287,48.1
Sivir,Kassadin,50,25,25,50
Sivir,Milio,167,67,100,40.12
Sivir,TahmKench,271,145,126,53.51
Sivir,Qiyana,68,34,34,50
Sivir,Rell,147,67,80,45.58
Sivir,Volibear,401,188,213,46.88
Sivir,Lulu,190,100,90,52.63
Sivir,Katarina,204,125,79,61.27
Sivir,Galio,227,118,109,51.98
Sivir,MissFortune,675,346,329,51.26
Sivir,Smolder,240,95,145,39.58
Sivir,Zed,201,88,113,43.78
Sivir,Darius,452,240,212,53.1
Sivir,Karma,191,115,76,60.21
Sivir,Ekko,168,85,83,50.6
Sivir,Lucian,184,132,52,71.74
Sivir,Draven,149,61,88,40.94
Sivir,Heimerdinger,156,71,85,45.51
Sivir,Aatrox,269,151,118,56.13
Sivir,Hwei,226,100,126,44.25
Sivir,Chogath,356,173,183,48.6
Sivir,Soraka,102,61,41,59.8
Sivir,Kled,40,24,16,60
Sivir,Zac,115,32,83,27.83
Sivir,Rakan,141,73,68,51.77
Sivir,Zyra,230,102,128,44.35
Sivir,Graves,160,107,53,66.88
Sivir,Neeko,222,104,118,46.85
Sivir,RekSai,31,22,9,70.97
Sivir,Maokai,114,47,67,41.23
Sivir,Orianna,129,57,72,44.19
Sivir,Varus,299,128,171,42.81
Sivir,Gangplank,105,73,32,69.52
Sivir,Gwen,154,98,56,63.64
Sivir,Ivern,91,46,45,50.55
Sivir,Garen,430,215,215,50
Sivir,Amumu,277,97,180,35.02
Sivir,MasterYi,270,134,136,49.63
Sivir,Nunu,281,148,133,52.67
Sivir,Leona,229,114,115,49.78
Sivir,Ornn,130,43,87,33.08
Sivir,Swain,295,157,138,53.22
Sivir,Vex,134,73,61,54.48
Sivir,Riven,110,65,45,59.09
Sivir,Nocturne,316,174,142,55.06
Sivir,Rumble,37,23,14,62.16
Sivir,Nasus,195,85,110,43.59
Sivir,Karthus,76,49,27,64.47
Sivir,Malzahar,180,90,90,50
Sivir,Aphelios,223,135,88,60.54
Sivir,Jax,288,164,124,56.94
Sivir,Briar,276,165,111,59.78
Sivir,Corki,103,56,47,54.37
Sivir,Ryze,88,45,43,51.14
Sivir,KogMaw,135,53,82,39.26
Sivir,Udyr,117,75,42,64.1
Sivir,Sion,223,123,100,55.16
Sivir,Illaoi,159,76,83,47.8
Sivir,Belveth,75,42,33,56
Sivir,Fizz,135,71,64,52.59
Sivir,Viktor,206,104,102,50.49
Sivir,Xayah,165,75,90,45.45
Sivir,Tryndamere,165,94,71,56.97
Sivir,Shyvana,91,50,41,54.95
Sivir,Quinn,102,66,36,64.71
Sivir,Hecarim,105,57,48,54.29
Sivir,Samira,292,158,134,54.11
Sivir,Skarner,81,59,22,72.84
Sivir,Rammus,58,22,36,37.93
Sivir,Kennen,81,57,24,70.37
Sivir,Akshan,116,27,89,23.28
Sivir,Ambessa,187,103,84,55.08
Sivir,Nilah,111,52,59,46.85
Sivir,Alistar,76,38,38,50
Sivir,Olaf,58,26,32,44.83
Sivir,Naafiri,123,48,75,39.02
Sivir,Anivia,113,74,39,65.49
Sivir,Ahri,342,156,186,45.61
Sivir,JarvanIV,108,32,76,29.63
Sivir,Bard,111,49,62,44.14
Sivir,Taliyah,42,26,16,61.9
Sivir,Sona,120,76,44,63.33
Sivir,Renata,88,43,45,48.86
Sivir,Velkoz,182,81,101,44.51
Sivir,Lissandra,35,10,25,28.57
Sivir,Kindred,191,90,101,47.12
Sivir,TwistedFate,112,60,52,53.57
Sivir,DrMundo,165,62,103,37.58
Sivir,KSante,76,51,25,67.11
Sivir,Zilean,107,54,53,50.47
Sivir,MonkeyKing,155,96,59,61.94
Sivir,Jayce,123,72,51,58.54
Sivir,Janna,108,65,43,60.19
Sivir,Nidalee,82,59,23,71.95
Sivir,Singed,88,63,25,71.59
Sivir,Zeri,87,68,19,78.16
Xayah,Sylas,365,200,165,54.79
Xayah,Caitlyn,1047,520,527,49.67
Xayah,Zed,450,327,123,72.67
Xayah,MasterYi,471,267,204,56.69
Xayah,Rell,243,152,91,62.55
Xayah,Yone,709,374,335,52.75
Xayah,Kayn,712,419,293,58.85
Xayah,TwistedFate,145,77,68,53.1
Xayah,Smolder,252,114,138,45.24
Xayah,Nautilus,454,242,212,53.3
Xayah,Poppy,255,147,108,57.65
Xayah,Diana,534,238,296,44.57
Xayah,Anivia,96,57,39,59.38
Xayah,Thresh,484,232,252,47.93
Xayah,Akali,398,209,189,52.51
Xayah,Rammus,163,61,102,37.42
Xayah,Yasuo,757,399,358,52.71
Xayah,Jinx,933,418,515,44.8
Xayah,Zyra,258,96,162,37.21
Xayah,Tryndamere,229,120,109,52.4
Xayah,Aurora,403,191,212,47.39
Xayah,Twitch,331,195,136,58.91
Xayah,Lux,978,461,517,47.14
Xayah,Jayce,191,102,89,53.4
Xayah,Amumu,385,142,243,36.88
Xayah,Ashe,630,291,339,46.19
Xayah,Milio,202,86,116,42.57
Xayah,Vayne,439,220,219,50.11
Xayah,Briar,341,182,159,53.37
Xayah,Mel,888,421,467,47.41
Xayah,Yuumi,440,219,221,49.77
Xayah,Mordekaiser,618,271,347,43.85
Xayah,Vex,266,114,152,42.86
Xayah,Samira,368,220,148,59.78
Xayah,Rakan,180,89,91,49.44
Xayah,Aatrox,362,162,200,44.75
Xayah,Chogath,512,224,288,43.75
Xayah,Kaisa,601,341,260,56.74
Xayah,Morgana,491,213,278,43.38
Xayah,Ezreal,604,300,304,49.67
Xayah,Elise,235,107,128,45.53
Xayah,Gangplank,169,101,68,59.76
Xayah,Swain,379,187,192,49.34
Xayah,Cassiopeia,119,54,65,45.38
Xayah,Varus,220,112,108,50.91
Xayah,Nasus,306,138,168,45.1
Xayah,Zilean,86,34,52,39.53
Xayah,FiddleSticks,228,108,120,47.37
Xayah,Leblanc,149,52,97,34.9
Xayah,Aphelios,245,92,153,37.55
Xayah,Hwei,306,136,170,44.44
Xayah,Jhin,773,411,362,53.17
Xayah,MonkeyKing,207,87,120,42.03
Xayah,Teemo,488,216,272,44.26
Xayah,Yorick,315,120,195,38.1
Xayah,Ahri,509,244,265,47.94
Xayah,Riven,173,96,77,55.49
Xayah,Malzahar,298,124,174,41.61
Xayah,Syndra,221,107,114,48.42
Xayah,Volibear,392,189,203,48.21
Xayah,Evelynn,266,130,136,48.87
Xayah,Azir,153,69,84,45.1
Xayah,Illaoi,206,102,104,49.51
Xayah,Nocturne,341,164,177,48.09
Xayah,Ryze,81,49,32,60.49
Xayah,MissFortune,914,402,512,43.98
Xayah,Blitzcrank,313,188,125,60.06
Xayah,Garen,653,318,335,48.7
Xayah,Jax,368,188,180,51.09
Xayah,Gnar,187,91,96,48.66
Xayah,Zeri,188,86,102,45.74
Xayah,Xerath,261,116,145,44.44
Xayah,Urgot,122,73,49,59.84
Xayah,Skarner,101,51,50,50.5
Xayah,Ekko,262,120,142,45.8
Xayah,Heimerdinger,203,53,150,26.11
Xayah,Zac,182,108,74,59.34
Xayah,LeeSin,302,159,143,52.65
Xayah,Fiora,164,99,65,60.37
Xayah,Pantheon,630,323,307,51.27
Xayah,Annie,133,71,62,53.38
Xayah,Bard,121,63,58,52.07
Xayah,Renekton,193,97,96,50.26
Xayah,Rengar,196,133,63,67.86
Xayah,Seraphine,434,237,197,54.61
Xayah,Kennen,166,79,87,47.59
Xayah,Lillia,213,78,135,36.62
Xayah,Irelia,324,191,133,58.95
Xayah,Nilah,203,112,91,55.17
Xayah,Malphite,331,179,152,54.08
Xayah,JarvanIV,176,86,90,48.86
Xayah,Lucian,226,113,113,50
Xayah,Kayle,235,137,98,58.3
Xayah,XinZhao,254,114,140,44.88
Xayah,Darius,692,391,301,56.5
Xayah,Warwick,530,295,235,55.66
Xayah,Viktor,235,110,125,46.81
Xayah,Sona,132,68,64,51.52
Xayah,Ornn,167,91,76,54.49
Xayah,Neeko,335,211,124,62.99
Xayah,Ziggs,194,89,105,45.88
Xayah,Galio,313,178,135,56.87
Xayah,Zoe,200,114,86,57
Xayah,DrMundo,239,115,124,48.12
Xayah,Belveth,156,65,91,41.67
Xayah,Naafiri,178,101,77,56.74
Xayah,Pyke,372,185,187,49.73
Xayah,Kalista,150,101,49,67.33
Xayah,Vi,289,157,132,54.33
Xayah,Talon,279,163,116,58.42
Xayah,Shaco,384,174,210,45.31
Xayah,Graves,263,127,136,48.29
Xayah,Lulu,357,174,183,48.74
Xayah,Katarina,367,193,174,52.59
Xayah,Taric,67,40,27,59.7
Xayah,Gwen,239,142,97,59.41
Xayah,Sett,692,302,390,43.64
Xayah,Nami,411,178,233,43.31
Xayah,Maokai,115,49,66,42.61
Xayah,Janna,124,56,68,45.16
Xayah,Ambessa,220,129,91,58.64
Xayah,Khazix,222,146,76,65.77
Xayah,KSante,160,67,93,41.88
Xayah,Gragas,228,138,90,60.53
Xayah,Nunu,390,174,216,44.62
Xayah,Tristana,262,114,148,43.51
Xayah,Trundle,227,100,127,44.05
Xayah,Fizz,264,131,133,49.62
Xayah,Kindred,162,100,62,61.73
Xayah,Vladimir,237,119,118,50.21
Xayah,Kassadin,88,51,37,57.95
Xayah,Viego,394,181,213,45.94
Xayah,Veigar,474,211,263,44.51
Xayah,TahmKench,407,216,191,53.07
Xayah,Karma,215,93,122,43.26
Xayah,Shen,253,133,120,52.57
Xayah,Senna,355,175,180,49.3
Xayah,Lissandra,96,48,48,50
Xayah,Draven,181,106,75,58.56
Xayah,Braum,161,85,76,52.8
Xayah,KogMaw,140,68,72,48.57
Xayah,Alistar,153,69,84,45.1
Xayah,Akshan,209,117,92,55.98
Xayah,RekSai,66,24,42,36.36
Xayah,Velkoz,233,129,104,55.36
Xayah,Sion,323,152,171,47.06
Xayah,Udyr,120,51,69,42.5
Xayah,Sejuani,137,59,78,43.07
Xayah,Brand,229,92,137,40.17
Xayah,Orianna,164,70,94,42.68
Xayah,Singed,119,49,70,41.18
Xayah,Renata,102,50,52,49.02
Xayah,Ivern,100,68,32,68
Xayah,Leona,226,108,118,47.79
Xayah,Sivir,165,90,75,54.55
Xayah,Karthus,130,60,70,46.15
Xayah,Hecarim,118,64,54,54.24
Xayah,Shyvana,101,35,66,34.65
Xayah,AurelionSol,142,42,100,29.58
Xayah,Nidalee,81,54,27,66.67
Xayah,Camille,117,84,33,71.79
Xayah,Kled,79,29,50,36.71
Xayah,Olaf,74,37,37,50
Xayah,Soraka,229,111,118,48.47
Xayah,Corki,139,73,66,52.52
Xayah,Taliyah,81,56,25,69.14
Xayah,Qiyana,139,74,65,53.24
Xayah,Rumble,70,33,37,47.14
Xayah,Quinn,103,59,44,57.28
Samira,Swain,684,342,342,50
Samira,FiddleSticks,317,137,180,43.22
Samira,Akali,613,346,267,56.44
Samira,Twitch,414,210,204,50.72
Samira,Senna,508,214,294,42.13
Samira,Smolder,503,225,278,44.73
Samira,Ekko,536,294,242,54.85
Samira,Mordekaiser,968,417,551,43.08
Samira,Yasuo,999,501,498,50.15
Samira,Yuumi,608,262,346,43.09
Samira,Sett,1018,454,564,44.6
Samira,Vladimir,308,179,129,58.12
Samira,Kindred,315,205,110,65.08
Samira,Aphelios,443,220,223,49.66
Samira,Pyke,589,299,290,50.76
Samira,Volibear,611,265,346,43.37
Samira,Akshan,269,95,174,35.32
Samira,Katarina,539,284,255,52.69
Samira,Annie,155,86,69,55.48
Samira,Kayn,951,474,477,49.84
Samira,Aatrox,579,294,285,50.78
Samira,MissFortune,1276,708,568,55.49
Samira,DrMundo,442,179,263,40.5
Samira,Ivern,110,54,56,49.09
Samira,Nilah,533,266,267,49.91
Samira,TwistedFate,179,81,98,45.25
Samira,LeeSin,572,284,288,49.65
Samira,Brand,449,249,200,55.46
Samira,Briar,617,300,317,48.62
Samira,Hwei,484,230,254,47.52
Samira,Kaisa,875,467,408,53.37
Samira,TahmKench,597,361,236,60.47
Samira,Fiora,322,179,143,55.59
Samira,Malzahar,381,121,260,31.76
Samira,Zilean,157,61,96,38.85
Samira,Jinx,1362,617,745,45.3
Samira,Leblanc,273,137,136,50.18
Samira,Xayah,368,148,220,40.22
Samira,Riven,339,157,182,46.31
Samira,Jax,487,238,249,48.87
Samira,Naafiri,274,141,133,51.46
Samira,Tristana,564,284,280,50.35
Samira,Rakan,294,100,194,34.01
Samira,Zac,197,101,96,51.27
Samira,Nunu,509,220,289,43.22
Samira,Veigar,697,338,359,48.49
Samira,Shen,352,159,193,45.17
Samira,Sion,476,213,263,44.75
Samira,AurelionSol,251,142,109,56.57
Samira,Jhin,1067,541,526,50.7
Samira,Lux,1562,775,787,49.62
Samira,Trundle,350,163,187,46.57
Samira,Ahri,829,426,403,51.39
Samira,Ashe,987,508,479,51.47
Samira,Nami,561,255,306,45.45
Samira,Darius,1089,542,547,49.77
Samira,Pantheon,863,409,454,47.39
Samira,Ryze,235,128,107,54.47
Samira,Lillia,324,148,176,45.68
Samira,Chogath,704,263,441,37.36
Samira,Mel,1221,572,649,46.85
Samira,Warwick,988,444,544,44.94
Samira,Malphite,487,224,263,46
Samira,Illaoi,356,162,194,45.51
Samira,Leona,425,166,259,39.06
Samira,Ambessa,373,223,150,59.79
Samira,Rammus,163,74,89,45.4
Samira,Aurora,569,252,317,44.29
Samira,Caitlyn,1478,615,863,41.61
Samira,Kled,125,54,71,43.2
Samira,Diana,802,447,355,55.74
Samira,Karma,380,191,189,50.26
Samira,Singed,176,64,112,36.36
Samira,Blitzcrank,448,245,203,54.69
Samira,Varus,468,244,224,52.14
Samira,Irelia,505,256,249,50.69
Samira,Elise,263,156,107,59.32
Samira,Viego,660,298,362,45.15
Samira,Galio,293,143,150,48.81
Samira,Vayne,515,284,231,55.15
Samira,Sylas,525,258,267,49.14
Samira,Tryndamere,318,132,186,41.51
Samira,Nautilus,646,344,302,53.25
Samira,Yorick,514,220,294,42.8
Samira,Nidalee,173,104,69,60.12
Samira,KogMaw,215,94,121,43.72
Samira,Poppy,379,195,184,51.45
Samira,Zed,559,295,264,52.77
Samira,Shyvana,122,54,68,44.26
Samira,MasterYi,558,260,298,46.59
Samira,Garen,796,354,442,44.47
Samira,Zyra,365,160,205,43.84
Samira,Neeko,483,274,209,56.73
Samira,Renekton,231,119,112,51.52
Samira,Sejuani,248,134,114,54.03
Samira,Taliyah,119,40,79,33.61
Samira,Teemo,823,388,435,47.14
Samira,Corki,231,93,138,40.26
Samira,Heimerdinger,261,123,138,47.13
Samira,Gragas,355,186,169,52.39
Samira,Morgana,809,332,477,41.04
Samira,XinZhao,307,132,175,43
Samira,Rell,377,171,206,45.36
Samira,Shaco,553,286,267,51.72
Samira,Yone,1211,604,607,49.88
Samira,Lulu,411,178,233,43.31
Samira,Viktor,349,181,168,51.86
Samira,KSante,223,129,94,57.85
Samira,Gwen,370,183,187,49.46
Samira,Seraphine,854,456,398,53.4
Samira,Udyr,232,111,121,47.84
Samira,Hecarim,205,125,80,60.98
Samira,Khazix,414,236,178,57
Samira,Karthus,121,82,39,67.77
Samira,Thresh,732,398,334,54.37
Samira,Braum,208,95,113,45.67
Samira,Evelynn,336,176,160,52.38
Samira,Nocturne,413,229,184,55.45
Samira,Velkoz,324,162,162,50
Samira,Urgot,260,89,171,34.23
Samira,Zeri,272,122,150,44.85
Samira,Fizz,330,155,175,46.97
Samira,Draven,365,174,191,47.67
Samira,Bard,192,99,93,51.56
Samira,Alistar,182,89,93,48.9
Samira,Kayle,445,206,239,46.29
Samira,Amumu,563,247,316,43.87
Samira,Ezreal,945,489,456,51.75
Samira,Vi,454,193,261,42.51
Samira,Zoe,265,150,115,56.6
Samira,Sona,219,108,111,49.32
Samira,Nasus,570,213,357,37.37
Samira,Ziggs,270,124,146,45.93
Samira,Milio,255,117,138,45.88
Samira,Quinn,156,80,76,51.28
Samira,Kalista,249,163,86,65.46
Samira,Xerath,382,195,187,51.05
Samira,Cassiopeia,244,122,122,50
Samira,Orianna,279,149,130,53.41
Samira,Talon,324,163,161,50.31
Samira,Renata,186,87,99,46.77
Samira,Rengar,203,124,79,61.08
Samira,Graves,324,187,137,57.72
Samira,Gnar,207,126,81,60.87
Samira,Azir,206,101,105,49.03
Samira,Ornn,249,128,121,51.41
Samira,Camille,170,82,88,48.24
Samira,Vex,310,133,177,42.9
Samira,Janna,193,107,86,55.44
Samira,Lucian,288,145,143,50.35
Samira,Soraka,310,179,131,57.74
Samira,Kennen,212,124,88,58.49
Samira,Skarner,232,97,135,41.81
Samira,Olaf,74,40,34,54.05
Samira,Syndra,310,129,181,41.61
Samira,Jayce,219,117,102,53.42
Samira,Taric,105,30,75,28.57
Samira,Maokai,272,134,138,49.26
Samira,Anivia,193,103,90,53.37
Samira,Kassadin,102,53,49,51.96
Samira,MonkeyKing,314,130,184,41.4
Samira,JarvanIV,191,95,96,49.74
Samira,Belveth,188,109,79,57.98
Samira,Lissandra,146,70,76,47.95
Samira,Qiyana,160,87,73,54.38
Samira,Gangplank,255,146,109,57.25
Samira,Sivir,292,134,158,45.89
Samira,Rumble,70,49,21,70
Samira,RekSai,98,54,44,55.1
Skarner,Irelia,164,74,90,45.12
Skarner,Diana,264,139,125,52.65
Skarner,Lux,509,281,228,55.21
Skarner,Tristana,181,73,108,40.33
Skarner,Mel,430,218,212,50.7
Skarner,Viktor,156,70,86,44.87
Skarner,Nocturne,164,62,102,37.8
Skarner,Annie,77,45,32,58.44
Skarner,KogMaw,95,51,44,53.68
Skarner,Alistar,96,65,31,67.71
Skarner,Yorick,145,69,76,47.59
Skarner,Kayn,280,131,149,46.79
Skarner,Akali,233,126,107,54.08
Skarner,Caitlyn,388,175,213,45.1
Skarner,Sett,313,160,153,51.12
Skarner,LeeSin,158,91,67,57.59
Skarner,Nasus,142,64,78,45.07
Skarner,Kaisa,263,139,124,52.85
Skarner,Bard,85,44,41,51.76
Skarner,Yasuo,358,157,201,43.85
Skarner,Jhin,369,159,210,43.09
Skarner,Thresh,244,109,135,44.67
Skarner,Illaoi,112,38,74,33.93
Skarner,Volibear,270,111,159,41.11
Skarner,Varus,153,80,73,52.29
Skarner,Nautilus,258,118,140,45.74
Skarner,Teemo,214,128,86,59.81
Skarner,Graves,106,38,68,35.85
Skarner,Zoe,106,58,48,54.72
Skarner,Katarina,208,100,108,48.08
Skarner,Galio,160,54,106,33.75
Skarner,Warwick,307,129,178,42.02
Skarner,Veigar,202,89,113,44.06
Skarner,Ivern,42,33,9,78.57
Skarner,Ezreal,269,169,100,62.83
Skarner,Xayah,101,50,51,49.5
Skarner,DrMundo,106,34,72,32.08
Skarner,Nunu,192,99,93,51.56
Skarner,Leblanc,90,43,47,47.78
Skarner,Nami,180,76,104,42.22
Skarner,Smolder,120,63,57,52.5
Skarner,Zed,162,74,88,45.68
Skarner,Morgana,236,89,147,37.71
Skarner,Pantheon,312,148,164,47.44
Skarner,Amumu,140,39,101,27.86
Skarner,Ziggs,105,51,54,48.57
Skarner,Malphite,117,58,59,49.57
Skarner,Sion,161,53,108,32.92
Skarner,Shen,140,88,52,62.86
Skarner,Jax,184,102,82,55.43
Skarner,Rengar,126,74,52,58.73
Skarner,Nilah,87,40,47,45.98
Skarner,Karma,111,49,62,44.14
Skarner,Chogath,283,182,101,64.31
Skarner,JarvanIV,61,18,43,29.51
Skarner,Vex,89,44,45,49.44
Skarner,Mordekaiser,309,112,197,36.25
Skarner,Lucian,120,50,70,41.67
Skarner,Yuumi,202,112,90,55.45
Skarner,Kled,47,24,23,51.06
Skarner,Lillia,132,48,84,36.36
Skarner,Ahri,283,116,167,40.99
Skarner,MissFortune,348,136,212,39.08
Skarner,Neeko,136,38,98,27.94
Skarner,Darius,359,185,174,51.53
Skarner,MasterYi,158,53,105,33.54
Skarner,Kassadin,30,17,13,56.67
Skarner,Rell,145,79,66,54.48
Skarner,Aatrox,177,66,111,37.29
Skarner,Sylas,210,97,113,46.19
Skarner,Kindred,74,48,26,64.86
Skarner,Singed,41,9,32,21.95
Skarner,Vi,186,75,111,40.32
Skarner,Lulu,169,79,90,46.75
Skarner,Viego,191,59,132,30.89
Skarner,Swain,217,104,113,47.93
Skarner,Aurora,166,81,85,48.8
Skarner,Zyra,100,48,52,48
Skarner,Garen,207,91,116,43.96
Skarner,Azir,72,52,20,72.22
Skarner,Briar,193,86,107,44.56
Skarner,Gangplank,76,33,43,43.42
Skarner,Urgot,66,34,32,51.52
Skarner,Jinx,368,137,231,37.23
Skarner,Seraphine,235,117,118,49.79
Skarner,Hecarim,67,17,50,25.37
Skarner,Ashe,391,187,204,47.83
Skarner,Vayne,181,76,105,41.99
Skarner,Vladimir,88,38,50,43.18
Skarner,Senna,141,47,94,33.33
Skarner,Twitch,139,70,69,50.36
Skarner,Pyke,240,78,162,32.5
Skarner,Shaco,151,99,52,65.56
Skarner,Tryndamere,109,50,59,45.87
Skarner,Udyr,79,47,32,59.49
Skarner,Syndra,107,41,66,38.32
Skarner,TahmKench,169,71,98,42.01
Skarner,Taliyah,72,37,35,51.39
Skarner,Zilean,49,38,11,77.55
Skarner,Gragas,72,46,26,63.89
Skarner,Elise,123,54,69,43.9
Skarner,Gnar,122,59,63,48.36
Skarner,Orianna,111,47,64,42.34
Skarner,Ekko,151,63,88,41.72
Skarner,Riven,85,47,38,55.29
Skarner,Samira,232,135,97,58.19
Skarner,Draven,76,30,46,39.47
Skarner,Belveth,74,23,51,31.08
Skarner,Leona,134,66,68,49.25
Skarner,Quinn,94,32,62,34.04
Skarner,XinZhao,94,41,53,43.62
Skarner,Malzahar,127,51,76,40.16
Skarner,Sejuani,99,45,54,45.45
Skarner,Rakan,106,55,51,51.89
Skarner,Khazix,135,84,51,62.22
Skarner,Braum,100,39,61,39
Skarner,Renekton,149,65,84,43.62
Skarner,MonkeyKing,144,39,105,27.08
Skarner,Shyvana,76,28,48,36.84
Skarner,Velkoz,108,47,61,43.52
Skarner,Milio,90,38,52,42.22
Skarner,Trundle,101,43,58,42.57
Skarner,Fizz,80,38,42,47.5
Skarner,Sona,74,38,36,51.35
Skarner,Yone,291,134,157,46.05
Skarner,Blitzcrank,135,61,74,45.19
Skarner,Cassiopeia,93,39,54,41.94
Skarner,Poppy,76,39,37,51.32
Skarner,Sivir,81,22,59,27.16
Skarner,Camille,72,33,39,45.83
Skarner,Akshan,115,40,75,34.78
Skarner,Anivia,54,31,23,57.41
Skarner,Kayle,140,43,97,30.71
Skarner,Janna,50,13,37,26
Skarner,Naafiri,117,56,61,47.86
Skarner,Ambessa,151,65,86,43.05
Skarner,Hwei,113,57,56,50.44
Skarner,Rammus,16,6,10,37.5
Skarner,Heimerdinger,108,38,70,35.19
Skarner,Talon,108,48,60,44.44
Skarner,FiddleSticks,103,70,33,67.96
Skarner,TwistedFate,60,25,35,41.67
Skarner,Rumble,57,33,24,57.89
Skarner,Soraka,90,56,34,62.22
Skarner,Kalista,90,39,51,43.33
Skarner,Zeri,95,42,53,44.21
Skarner,Xerath,126,85,41,67.46
Skarner,KSante,76,34,42,44.74
Skarner,AurelionSol,73,42,31,57.53
Skarner,Corki,62,36,26,58.06
Skarner,Evelynn,111,52,59,46.85
Skarner,Aphelios,125,65,60,52
Skarner,Ryze,52,22,30,42.31
Skarner,Jayce,73,10,63,13.7
Skarner,Ornn,57,36,21,63.16
Skarner,Zac,93,45,48,48.39
Skarner,Nidalee,29,10,19,34.48
Skarner,Gwen,79,51,28,64.56
Skarner,Fiora,77,33,44,42.86
Skarner,Maokai,47,29,18,61.7
Skarner,RekSai,21,12,9,57.14
Skarner,Taric,48,16,32,33.33
Skarner,Qiyana,68,45,23,66.18
Skarner,Brand,106,51,55,48.11
Skarner,Kennen,42,28,14,66.67
Skarner,Olaf,48,20,28,41.67
Skarner,Lissandra,50,18,32,36
Skarner,Renata,50,21,29,42
Skarner,Karthus,21,8,13,38.1
Urgot,Riven,139,85,54,61.15
Urgot,Amumu,263,101,162,38.4
Urgot,Zoe,175,114,61,65.14
Urgot,MissFortune,626,332,294,53.04
Urgot,Sona,149,69,80,46.31
Urgot,Mordekaiser,564,297,267,52.66
Urgot,Udyr,136,64,72,47.06
Urgot,Yorick,283,126,157,44.52
Urgot,Sivir,147,72,75,48.98
Urgot,Nautilus,323,176,147,54.49
Urgot,Darius,488,262,226,53.69
Urgot,Yasuo,518,292,226,56.37
Urgot,Swain,326,165,161,50.61
Urgot,Vi,243,136,107,55.97
Urgot,Orianna,97,55,42,56.7
Urgot,Draven,182,102,80,56.04
Urgot,Lulu,211,96,115,45.5
Urgot,Singed,133,61,72,45.86
Urgot,Kindred,177,66,111,37.29
Urgot,Ashe,470,231,239,49.15
Urgot,Alistar,101,64,37,63.37
Urgot,Kled,79,35,44,44.3
Urgot,Zeri,165,84,81,50.91
Urgot,Neeko,285,179,106,62.81
Urgot,TahmKench,341,181,160,53.08
Urgot,Brand,205,112,93,54.63
Urgot,Mel,606,309,297,50.99
Urgot,Jinx,567,270,297,47.62
Urgot,Pyke,309,171,138,55.34
Urgot,Thresh,330,162,168,49.09
Urgot,Viego,338,185,153,54.73
Urgot,Kalista,143,97,46,67.83
Urgot,FiddleSticks,143,81,62,56.64
Urgot,Chogath,397,226,171,56.93
Urgot,MasterYi,343,157,186,45.77
Urgot,Zed,229,128,101,55.9
Urgot,Lux,714,325,389,45.52
Urgot,Morgana,394,232,162,58.88
Urgot,Aatrox,348,185,163,53.16
Urgot,XinZhao,154,105,49,68.18
Urgot,Qiyana,98,52,46,53.06
Urgot,AurelionSol,132,81,51,61.36
Urgot,Zyra,176,63,113,35.8
Urgot,Warwick,514,288,226,56.03
Urgot,Fizz,161,124,37,77.02
Urgot,Teemo,368,168,200,45.65
Urgot,Poppy,156,97,59,62.18
Urgot,Ekko,191,118,73,61.78
Urgot,Kaisa,419,241,178,57.52
Urgot,Rell,150,87,63,58
Urgot,Sett,531,271,260,51.04
Urgot,LeeSin,203,102,101,50.25
Urgot,Ezreal,453,283,170,62.47
Urgot,Xayah,122,49,73,40.16
Urgot,DrMundo,140,46,94,32.86
Urgot,Shen,153,86,67,56.21
Urgot,Tryndamere,165,92,73,55.76
Urgot,Katarina,245,127,118,51.84
Urgot,Seraphine,255,138,117,54.12
Urgot,Caitlyn,615,392,223,63.74
Urgot,Nocturne,270,139,131,51.48
Urgot,Elise,156,108,48,69.23
Urgot,Senna,295,130,165,44.07
Urgot,Maokai,137,72,65,52.55
Urgot,Kennen,138,92,46,66.67
Urgot,Belveth,79,31,48,39.24
Urgot,Ambessa,118,80,38,67.8
Urgot,Irelia,248,144,104,58.06
Urgot,Samira,260,171,89,65.77
Urgot,Yuumi,266,139,127,52.26
Urgot,Jax,234,139,95,59.4
Urgot,Karthus,48,40,8,83.33
Urgot,MonkeyKing,147,87,60,59.18
Urgot,Lucian,170,105,65,61.76
Urgot,Nami,293,150,143,51.19
Urgot,Malzahar,206,108,98,52.43
Urgot,Aphelios,153,82,71,53.59
Urgot,Milio,131,68,63,51.91
Urgot,Kayn,469,279,190,59.49
Urgot,Volibear,286,162,124,56.64
Urgot,Smolder,266,139,127,52.26
Urgot,Talon,187,110,77,58.82
Urgot,Sylas,291,160,131,54.98
Urgot,Vladimir,138,61,77,44.2
Urgot,Gangplank,139,87,52,62.59
Urgot,Varus,245,107,138,43.67
Urgot,Rakan,148,67,81,45.27
Urgot,Aurora,233,122,111,52.36
Urgot,Braum,147,57,90,38.78
Urgot,Yone,485,264,221,54.43
Urgot,Camille,73,62,11,84.93
Urgot,Khazix,162,117,45,72.22
Urgot,Akali,249,160,89,64.26
Urgot,Skarner,66,32,34,48.48
Urgot,Shaco,245,132,113,53.88
Urgot,Zac,104,47,57,45.19
Urgot,Kassadin,105,64,41,60.95
Urgot,Twitch,177,107,70,60.45
Urgot,Nasus,295,140,155,47.46
Urgot,Cassiopeia,136,66,70,48.53
Urgot,RekSai,43,26,17,60.47
Urgot,Leona,183,85,98,46.45
Urgot,Taric,82,34,48,41.46
Urgot,Anivia,124,69,55,55.65
Urgot,KSante,79,37,42,46.84
Urgot,Fiora,101,67,34,66.34
Urgot,Veigar,319,166,153,52.04
Urgot,Ivern,77,48,29,62.34
Urgot,Jhin,485,251,234,51.75
Urgot,Ryze,62,37,25,59.68
Urgot,Ziggs,152,74,78,48.68
Urgot,Tristana,213,107,106,50.23
Urgot,Garen,470,221,249,47.02
Urgot,Ahri,415,233,182,56.14
Urgot,Vayne,257,141,116,54.86
Urgot,KogMaw,103,52,51,50.49
Urgot,Xerath,179,115,64,64.25
Urgot,Gragas,165,119,46,72.12
Urgot,Akshan,110,56,54,50.91
Urgot,Briar,273,156,117,57.14
Urgot,Hwei,200,95,105,47.5
Urgot,Blitzcrank,184,73,111,39.67
Urgot,Leblanc,108,72,36,66.67
Urgot,Quinn,91,75,16,82.42
Urgot,Diana,360,191,169,53.06
Urgot,Pantheon,534,308,226,57.68
Urgot,Malphite,166,87,79,52.41
Urgot,Heimerdinger,128,64,64,50
Urgot,Karma,208,104,104,50
Urgot,Gwen,192,65,127,33.85
Urgot,Evelynn,166,78,88,46.99
Urgot,Corki,112,47,65,41.96
Urgot,Lillia,139,62,77,44.6
Urgot,Taliyah,80,38,42,47.5
Urgot,Viktor,197,98,99,49.75
Urgot,Trundle,165,124,41,75.15
Urgot,Sejuani,85,49,36,57.65
Urgot,Syndra,146,66,80,45.21
Urgot,Renekton,141,89,52,63.12
Urgot,TwistedFate,99,61,38,61.62
Urgot,Bard,91,51,40,56.04
Urgot,Olaf,49,22,27,44.9
Urgot,Gnar,125,79,46,63.2
Urgot,Rumble,36,21,15,58.33
Urgot,Nunu,188,120,68,63.83
Urgot,Zilean,98,49,49,50
Urgot,Sion,235,94,141,40
Urgot,Kayle,258,126,132,48.84
Urgot,Vex,119,64,55,53.78
Urgot,Galio,135,67,68,49.63
Urgot,Rengar,103,72,31,69.9
Urgot,Illaoi,119,72,47,60.5
Urgot,Azir,120,50,70,41.67
Urgot,Graves,149,85,64,57.05
Urgot,Renata,66,37,29,56.06
Urgot,Hecarim,83,46,37,55.42
Urgot,JarvanIV,80,42,38,52.5
Urgot,Soraka,141,98,43,69.5
Urgot,Rammus,117,43,74,36.75
Urgot,Lissandra,73,35,38,47.95
Urgot,Nilah,145,87,58,60
Urgot,Jayce,92,53,39,57.61
Urgot,Annie,76,42,34,55.26
Urgot,Velkoz,129,94,35,72.87
Urgot,Ornn,82,42,40,51.22
Urgot,Nidalee,115,52,63,45.22
Urgot,Janna,93,77,16,82.8
Urgot,Naafiri,103,59,44,57.28
Urgot,Shyvana,69,39,30,56.52
Orianna,Darius,527,255,272,48.39
Orianna,Rengar,132,101,31,76.52
Orianna,Syndra,234,121,113,51.71
Orianna,Caitlyn,659,293,366,44.46
Orianna,Lux,752,346,406,46.01
Orianna,Urgot,97,42,55,43.3
Orianna,LeeSin,321,172,149,53.58
Orianna,TwistedFate,148,62,86,41.89
Orianna,Yasuo,487,263,224,54
Orianna,Rakan,134,56,78,41.79
Orianna,Camille,82,50,32,60.98
Orianna,Mel,801,389,412,48.56
Orianna,Draven,128,52,76,40.63
Orianna,Senna,247,119,128,48.18
Orianna,Zac,50,23,27,46
Orianna,Nunu,209,111,98,53.11
Orianna,Veigar,337,127,210,37.69
Orianna,Kaisa,329,221,108,67.17
Orianna,Shen,238,142,96,59.66
Orianna,Riven,107,39,68,36.45
Orianna,Vi,241,114,127,47.3
Orianna,MissFortune,437,199,238,45.54
Orianna,Soraka,116,50,66,43.1
Orianna,Yorick,275,113,162,41.09
Orianna,MasterYi,291,131,160,45.02
Orianna,Irelia,189,115,74,60.85
Orianna,Nami,275,131,144,47.64
Orianna,Yone,467,222,245,47.54
Orianna,Neeko,195,103,92,52.82
Orianna,Kayn,381,196,185,51.44
Orianna,Heimerdinger,141,73,68,51.77
Orianna,Mordekaiser,314,161,153,51.27
Orianna,Viego,328,166,162,50.61
Orianna,Zeri,150,65,85,43.33
Orianna,Alistar,86,30,56,34.88
Orianna,Singed,109,64,45,58.72
Orianna,Karma,205,92,113,44.88
Orianna,Jinx,603,277,326,45.94
Orianna,Akshan,112,46,66,41.07
Orianna,Aphelios,248,129,119,52.02
Orianna,Braum,135,58,77,42.96
Orianna,Amumu,276,117,159,42.39
Orianna,Zed,226,112,114,49.56
Orianna,Poppy,144,86,58,59.72
Orianna,Pyke,305,154,151,50.49
Orianna,Aurora,343,194,149,56.56
Orianna,Aatrox,203,132,71,65.02
Orianna,Kindred,170,100,70,58.82
Orianna,Swain,255,117,138,45.88
Orianna,Blitzcrank,243,118,125,48.56
Orianna,Ekko,198,94,104,47.47
Orianna,Rell,208,103,105,49.52
Orianna,Illaoi,135,65,70,48.15
Orianna,Jhin,383,190,193,49.61
Orianna,Talon,153,78,75,50.98
Orianna,Galio,167,53,114,31.74
Orianna,Lucian,148,80,68,54.05
Orianna,Milio,176,104,72,59.09
Orianna,Ornn,149,72,77,48.32
Orianna,Pantheon,471,276,195,58.6
Orianna,Nautilus,290,154,136,53.1
Orianna,Akali,229,116,113,50.66
Orianna,Vayne,251,115,136,45.82
Orianna,Seraphine,251,129,122,51.39
Orianna,Shyvana,93,48,45,51.61
Orianna,Vex,137,63,74,45.99
Orianna,Ezreal,552,286,266,51.81
Orianna,Malzahar,225,101,124,44.89
Orianna,Gwen,159,84,75,52.83
Orianna,Rammus,114,66,48,57.89
Orianna,Katarina,201,81,120,40.3
Orianna,Viktor,231,97,134,41.99
Orianna,Ashe,514,207,307,40.27
Orianna,Yuumi,200,81,119,40.5
Orianna,Fiora,116,48,68,41.38
Orianna,Vladimir,181,88,93,48.62
Orianna,Varus,257,167,90,64.98
Orianna,Velkoz,155,87,68,56.13
Orianna,Chogath,273,132,141,48.35
Orianna,Gragas,163,62,101,38.04
Orianna,Shaco,222,112,110,50.45
Orianna,Morgana,318,147,171,46.23
Orianna,Bard,64,31,33,48.44
Orianna,Gangplank,89,46,43,51.69
Orianna,Brand,151,96,55,63.58
Orianna,Sett,378,180,198,47.62
Orianna,Nocturne,270,121,149,44.81
Orianna,Kennen,58,29,29,50
Orianna,Teemo,318,128,190,40.25
Orianna,Malphite,170,72,98,42.35
Orianna,Karthus,36,19,17,52.78
Orianna,Nilah,185,83,102,44.86
Orianna,Leona,188,86,102,45.74
Orianna,Xerath,263,94,169,35.74
Orianna,Graves,120,62,58,51.67
Orianna,Cassiopeia,95,40,55,42.11
Orianna,Qiyana,91,50,41,54.95
Orianna,Azir,112,49,63,43.75
Orianna,KSante,52,33,19,63.46
Orianna,Ambessa,222,108,114,48.65
Orianna,Lillia,140,45,95,32.14
Orianna,Samira,279,130,149,46.59
Orianna,Maokai,144,62,82,43.06
Orianna,Anivia,77,54,23,70.13
Orianna,Volibear,260,128,132,49.23
Orianna,Zyra,159,82,77,51.57
Orianna,Nidalee,57,34,23,59.65
Orianna,Taric,48,29,19,60.42
Orianna,Kassadin,38,27,11,71.05
Orianna,Udyr,60,38,22,63.33
Orianna,Sylas,289,140,149,48.44
Orianna,Zilean,72,28,44,38.89
Orianna,Zoe,117,35,82,29.91
Orianna,Sivir,129,72,57,55.81
Orianna,Renekton,139,58,81,41.73
Orianna,Ivern,51,29,22,56.86
Orianna,Elise,174,81,93,46.55
Orianna,Tryndamere,149,73,76,48.99
Orianna,Thresh,351,183,168,52.14
Orianna,FiddleSticks,114,50,64,43.86
Orianna,Trundle,119,39,80,32.77
Orianna,Leblanc,118,53,65,44.92
Orianna,Lulu,213,101,112,47.42
Orianna,Naafiri,112,77,35,68.75
Orianna,Skarner,111,64,47,57.66
Orianna,Khazix,216,120,96,55.56
Orianna,Hwei,159,104,55,65.41
Orianna,Diana,354,142,212,40.11
Orianna,Twitch,216,84,132,38.89
Orianna,MonkeyKing,131,61,70,46.56
Orianna,Belveth,48,16,32,33.33
Orianna,Xayah,164,94,70,57.32
Orianna,TahmKench,255,116,139,45.49
Orianna,Kled,43,19,24,44.19
Orianna,Jax,227,95,132,41.85
Orianna,Fizz,143,73,70,51.05
Orianna,Annie,123,55,68,44.72
Orianna,Sion,200,86,114,43
Orianna,Kayle,176,126,50,71.59
Orianna,Briar,269,140,129,52.04
Orianna,Sona,85,40,45,47.06
Orianna,Warwick,464,206,258,44.4
Orianna,Ziggs,123,58,65,47.15
Orianna,Smolder,130,59,71,45.38
Orianna,Tristana,228,132,96,57.89
Orianna,Hecarim,73,22,51,30.14
Orianna,KogMaw,149,69,80,46.31
Orianna,Garen,344,171,173,49.71
Orianna,Quinn,104,20,84,19.23
Orianna,Kalista,104,40,64,38.46
Orianna,Nasus,141,68,73,48.23
Orianna,Corki,103,45,58,43.69
Orianna,Ryze,76,53,23,69.74
Orianna,DrMundo,237,86,151,36.29
Orianna,Janna,101,52,49,51.49
Orianna,Renata,55,17,38,30.91
Orianna,Gnar,63,39,24,61.9
Orianna,Jayce,145,53,92,36.55
Orianna,AurelionSol,146,68,78,46.58
Orianna,Olaf,57,36,21,63.16
Orianna,Ahri,323,178,145,55.11
Orianna,JarvanIV,98,48,50,48.98
Orianna,Lissandra,68,34,34,50
Orianna,Rumble,74,45,29,60.81
Orianna,XinZhao,133,65,68,48.87
Orianna,Evelynn,128,63,65,49.22
Orianna,Taliyah,91,46,45,50.55
Orianna,Sejuani,117,48,69,41.03
Orianna,RekSai,37,19,18,51.35
Rengar,Aatrox,299,94,205,31.44
Rengar,Ekko,224,75,149,33.48
Rengar,Orianna,132,31,101,23.48
Rengar,Malzahar,205,73,132,35.61
Rengar,Maokai,119,51,68,42.86
Rengar,Mordekaiser,411,134,277,32.6
Rengar,Udyr,118,62,56,52.54
Rengar,Yorick,238,105,133,44.12
Rengar,Sivir,96,12,84,12.5
Rengar,Nautilus,272,105,167,38.6
Rengar,DrMundo,157,77,80,49.04
Rengar,Belveth,85,44,41,51.76
Rengar,Leblanc,125,39,86,31.2
Rengar,Briar,251,74,177,29.48
Rengar,Anivia,67,27,40,40.3
Rengar,Tryndamere,179,89,90,49.72
Rengar,Gragas,205,85,120,41.46
Rengar,Irelia,264,114,150,43.18
Rengar,Kalista,133,58,75,43.61
Rengar,Twitch,226,90,136,39.82
Rengar,Yasuo,567,212,355,37.39
Rengar,Yone,546,221,325,40.48
Rengar,Alistar,130,52,78,40
Rengar,Volibear,301,123,178,40.86
Rengar,Nocturne,228,69,159,30.26
Rengar,Xerath,167,56,111,33.53
Rengar,Ezreal,549,232,317,42.26
Rengar,Blitzcrank,222,100,122,45.05
Rengar,Poppy,182,70,112,38.46
Rengar,Warwick,353,181,172,51.27
Rengar,Leona,167,60,107,35.93
Rengar,MissFortune,562,212,350,37.72
Rengar,Lux,697,284,413,40.75
Rengar,Rammus,110,42,68,38.18
Rengar,Aurora,276,95,181,34.42
Rengar,Ashe,485,214,271,44.12
Rengar,Pantheon,376,139,237,36.97
Rengar,Jax,249,76,173,30.52
Rengar,Sejuani,144,43,101,29.86
Rengar,Syndra,151,51,100,33.77
Rengar,Jinx,506,226,280,44.66
Rengar,Swain,297,82,215,27.61
Rengar,Sylas,208,91,117,43.75
Rengar,FiddleSticks,141,40,101,28.37
Rengar,Aphelios,165,66,99,40
Rengar,Morgana,308,144,164,46.75
Rengar,Ambessa,188,82,106,43.62
Rengar,Varus,241,103,138,42.74
Rengar,Graves,194,79,115,40.72
Rengar,Neeko,187,79,108,42.25
Rengar,Gangplank,71,34,37,47.89
Rengar,Kayn,459,166,293,36.17
Rengar,Hwei,197,83,114,42.13
Rengar,Jhin,481,196,285,40.75
Rengar,Jayce,119,51,68,42.86
Rengar,JarvanIV,107,35,72,32.71
Rengar,Caitlyn,630,307,323,48.73
Rengar,Vex,138,49,89,35.51
Rengar,Renekton,123,46,77,37.4
Rengar,TahmKench,334,135,199,40.42
Rengar,Gwen,177,73,104,41.24
Rengar,LeeSin,279,108,171,38.71
Rengar,TwistedFate,108,51,57,47.22
Rengar,Zeri,141,57,84,40.43
Rengar,Seraphine,281,100,181,35.59
Rengar,Nasus,180,61,119,33.89
Rengar,Zac,106,33,73,31.13
Rengar,Mel,569,204,365,35.85
Rengar,Singed,71,41,30,57.75
Rengar,Shaco,259,130,129,50.19
Rengar,Taliyah,99,43,56,43.43
Rengar,Shen,200,74,126,37
Rengar,Gnar,99,41,58,41.41
Rengar,Vi,180,70,110,38.89
Rengar,Kaisa,374,152,222,40.64
Rengar,Rumble,39,24,15,61.54
Rengar,Malphite,181,74,107,40.88
Rengar,Lulu,243,76,167,31.28
Rengar,Khazix,232,123,109,53.02
Rengar,Talon,231,98,133,42.42
Rengar,Thresh,352,140,212,39.77
Rengar,Olaf,43,21,22,48.84
Rengar,Nunu,277,146,131,52.71
Rengar,Vladimir,138,47,91,34.06
Rengar,Diana,355,138,217,38.87
Rengar,Veigar,267,123,144,46.07
Rengar,Milio,152,67,85,44.08
Rengar,Kindred,136,48,88,35.29
Rengar,Heimerdinger,106,48,58,45.28
Rengar,Yuumi,278,117,161,42.09
Rengar,Trundle,138,64,74,46.38
Rengar,Xayah,196,63,133,32.14
Rengar,Riven,144,82,62,56.94
Rengar,Ahri,348,132,216,37.93
Rengar,Nami,210,87,123,41.43
Rengar,Garen,431,184,247,42.69
Rengar,Galio,183,63,120,34.43
Rengar,Katarina,249,104,145,41.77
Rengar,Braum,148,51,97,34.46
Rengar,Kennen,89,25,64,28.09
Rengar,Skarner,126,52,74,41.27
Rengar,Illaoi,115,40,75,34.78
Rengar,Ziggs,100,39,61,39
Rengar,Elise,178,81,97,45.51
Rengar,Sion,175,54,121,30.86
Rengar,Viego,320,127,193,39.69
Rengar,Annie,78,16,62,20.51
Rengar,AurelionSol,127,43,84,33.86
Rengar,Chogath,319,68,251,21.32
Rengar,Darius,456,181,275,39.69
Rengar,Zed,297,148,149,49.83
Rengar,Amumu,216,118,98,54.63
Rengar,Janna,144,55,89,38.19
Rengar,Vayne,228,101,127,44.3
Rengar,Brand,157,50,107,31.85
Rengar,Zoe,168,93,75,55.36
Rengar,MasterYi,258,101,157,39.15
Rengar,Soraka,176,90,86,51.14
Rengar,Lucian,147,64,83,43.54
Rengar,KSante,162,55,107,33.95
Rengar,Kassadin,63,11,52,17.46
Rengar,Teemo,339,129,210,38.05
Rengar,Smolder,274,112,162,40.88
Rengar,Cassiopeia,105,59,46,56.19
Rengar,Sona,84,30,54,35.71
Rengar,Qiyana,117,72,45,61.54
Rengar,Akshan,71,36,35,50.7
Rengar,Tristana,195,90,105,46.15
Rengar,Azir,138,58,80,42.03
Rengar,Karthus,74,45,29,60.81
Rengar,Corki,97,44,53,45.36
Rengar,Bard,159,54,105,33.96
Rengar,Sett,437,163,274,37.3
Rengar,Evelynn,123,33,90,26.83
Rengar,Naafiri,97,46,51,47.42
Rengar,Velkoz,188,76,112,40.43
Rengar,Samira,203,79,124,38.92
Rengar,KogMaw,61,13,48,21.31
Rengar,Ivern,70,32,38,45.71
Rengar,Draven,174,67,107,38.51
Rengar,Pyke,276,97,179,35.14
Rengar,Senna,170,85,85,50
Rengar,Akali,246,88,158,35.77
Rengar,Karma,238,120,118,50.42
Rengar,Rakan,171,67,104,39.18
Rengar,Hecarim,122,39,83,31.97
Rengar,Zilean,72,26,46,36.11
Rengar,Ryze,100,56,44,56
Rengar,Quinn,125,42,83,33.6
Rengar,Camille,72,41,31,56.94
Rengar,Rell,130,55,75,42.31
Rengar,Viktor,210,115,95,54.76
Rengar,Nilah,161,55,106,34.16
Rengar,Ornn,117,37,80,31.62
Rengar,Lillia,141,67,74,47.52
Rengar,Fizz,85,26,59,30.59
Rengar,XinZhao,131,41,90,31.3
Rengar,Kled,55,25,30,45.45
Rengar,Zyra,131,63,68,48.09
Rengar,Lissandra,93,39,54,41.94
Rengar,Fiora,147,62,85,42.18
Rengar,Renata,99,42,57,42.42
Rengar,MonkeyKing,113,25,88,22.12
Rengar,Shyvana,52,28,24,53.85
Rengar,Kayle,163,64,99,39.26
Rengar,Urgot,103,31,72,30.1
Rengar,Taric,65,24,41,36.92
Rengar,RekSai,70,43,27,61.43
Rengar,Nidalee,55,24,31,43.64
Syndra,Aatrox,267,148,119,55.43
Syndra,Ekko,220,115,105,52.27
Syndra,Orianna,234,113,121,48.29
Syndra,Malzahar,267,142,125,53.18
Syndra,Maokai,102,54,48,52.94
Syndra,XinZhao,210,108,102,51.43
Syndra,Katarina,298,139,159,46.64
Syndra,Teemo,468,222,246,47.44
Syndra,Vayne,335,167,168,49.85
Syndra,TwistedFate,102,59,43,57.84
Syndra,Yorick,349,159,190,45.56
Syndra,Viego,378,182,196,48.15
Syndra,Malphite,237,114,123,48.1
Syndra,Kaisa,440,216,224,49.09
Syndra,Rell,174,96,78,55.17
Syndra,Gangplank,137,74,63,54.01
Syndra,Karthus,96,69,27,71.88
Syndra,Aurora,393,207,186,52.67
Syndra,Ezreal,547,300,247,54.84
Syndra,Senna,226,114,112,50.44
Syndra,Volibear,303,154,149,50.83
Syndra,Evelynn,174,60,114,34.48
Syndra,Nocturne,237,115,122,48.52
Syndra,Neeko,219,153,66,69.86
Syndra,Azir,126,82,44,65.08
Syndra,Sejuani,134,58,76,43.28
Syndra,Sylas,230,125,105,54.35
Syndra,Lucian,199,118,81,59.3
Syndra,Seraphine,292,141,151,48.29
Syndra,Nasus,297,173,124,58.25
Syndra,Kindred,135,75,60,55.56
Syndra,Tristana,238,136,102,57.14
Syndra,Nautilus,402,207,195,51.49
Syndra,Vex,192,87,105,45.31
Syndra,Vi,272,167,105,61.4
Syndra,Nilah,178,85,93,47.75
Syndra,Thresh,427,231,196,54.1
Syndra,Rengar,151,100,51,66.23
Syndra,Jhin,694,382,312,55.04
Syndra,Illaoi,115,48,67,41.74
Syndra,Irelia,357,200,157,56.02
Syndra,Varus,269,161,108,59.85
Syndra,Kayn,532,276,256,51.88
Syndra,Hwei,265,152,113,57.36
Syndra,Lux,915,487,428,53.22
Syndra,Ornn,192,72,120,37.5
Syndra,Zed,393,212,181,53.94
Syndra,Sivir,200,75,125,37.5
Syndra,Veigar,357,154,203,43.14
Syndra,Heimerdinger,209,106,103,50.72
Syndra,Briar,290,171,119,58.97
Syndra,Jinx,578,291,287,50.35
Syndra,Warwick,487,263,224,54
Syndra,Kalista,111,46,65,41.44
Syndra,Yasuo,528,301,227,57.01
Syndra,Jax,247,128,119,51.82
Syndra,Xayah,221,114,107,51.58
Syndra,Lulu,248,115,133,46.37
Syndra,MasterYi,361,193,168,53.46
Syndra,Ashe,619,295,324,47.66
Syndra,Riven,163,101,62,61.96
Syndra,Bard,92,37,55,40.22
Syndra,Rammus,83,40,43,48.19
Syndra,Caitlyn,821,437,384,53.23
Syndra,Alistar,85,34,51,40
Syndra,Braum,151,75,76,49.67
Syndra,Gragas,205,105,100,51.22
Syndra,Akali,281,142,139,50.53
Syndra,Kassadin,76,23,53,30.26
Syndra,Vladimir,159,87,72,54.72
Syndra,Gnar,128,65,63,50.78
Syndra,Sona,92,60,32,65.22
Syndra,Darius,625,312,313,49.92
Syndra,Leona,281,112,169,39.86
Syndra,Swain,327,204,123,62.39
Syndra,Shaco,381,220,161,57.74
Syndra,Amumu,256,148,108,57.81
Syndra,Mel,706,364,342,51.56
Syndra,Nami,364,194,170,53.3
Syndra,FiddleSticks,169,101,68,59.76
Syndra,Anivia,135,76,59,56.3
Syndra,Sett,501,258,243,51.5
Syndra,Shen,202,96,106,47.52
Syndra,Garen,465,186,279,40
Syndra,Naafiri,168,74,94,44.05
Syndra,Lillia,255,147,108,57.65
Syndra,Mordekaiser,496,224,272,45.16
Syndra,AurelionSol,202,82,120,40.59
Syndra,Morgana,411,161,250,39.17
Syndra,KSante,149,102,47,68.46
Syndra,Trundle,150,63,87,42
Syndra,Milio,166,115,51,69.28
Syndra,Talon,239,143,96,59.83
Syndra,Draven,168,94,74,55.95
Syndra,MissFortune,623,270,353,43.34
Syndra,Xerath,246,106,140,43.09
Syndra,Chogath,399,171,228,42.86
Syndra,Velkoz,252,116,136,46.03
Syndra,Yuumi,289,137,152,47.4
Syndra,Poppy,209,122,87,58.37
Syndra,Galio,184,99,85,53.8
Syndra,Ziggs,231,105,126,45.45
Syndra,Kennen,114,50,64,43.86
Syndra,TahmKench,341,168,173,49.27
Syndra,Twitch,219,140,79,63.93
Syndra,Ambessa,186,92,94,49.46
Syndra,Zyra,299,153,146,51.17
Syndra,Akshan,75,33,42,44
Syndra,LeeSin,284,159,125,55.99
Syndra,Sion,255,149,106,58.43
Syndra,Blitzcrank,254,135,119,53.15
Syndra,Fizz,202,127,75,62.87
Syndra,Soraka,202,69,133,34.16
Syndra,Renekton,147,104,43,70.75
Syndra,Qiyana,110,71,39,64.55
Syndra,Karma,249,133,116,53.41
Syndra,Singed,83,36,47,43.37
Syndra,Yone,667,397,270,59.52
Syndra,Skarner,107,66,41,61.68
Syndra,Ivern,55,14,41,25.45
Syndra,Pyke,385,229,156,59.48
Syndra,Zoe,234,110,124,47.01
Syndra,Cassiopeia,198,113,85,57.07
Syndra,Renata,46,20,26,43.48
Syndra,Samira,310,181,129,58.39
Syndra,Ahri,557,301,256,54.04
Syndra,Graves,161,80,81,49.69
Syndra,Rakan,194,136,58,70.1
Syndra,Pantheon,548,255,293,46.53
Syndra,Diana,535,309,226,57.76
Syndra,Leblanc,161,98,63,60.87
Syndra,Nunu,292,129,163,44.18
Syndra,KogMaw,104,51,53,49.04
Syndra,Hecarim,150,84,66,56
Syndra,Elise,181,113,68,62.43
Syndra,Kled,74,33,41,44.59
Syndra,JarvanIV,120,57,63,47.5
Syndra,Jayce,120,57,63,47.5
Syndra,Viktor,192,108,84,56.25
Syndra,Kayle,177,82,95,46.33
Syndra,DrMundo,212,58,154,27.36
Syndra,Brand,173,69,104,39.88
Syndra,Gwen,150,72,78,48
Syndra,Aphelios,173,99,74,57.23
Syndra,Fiora,127,45,82,35.43
Syndra,Zeri,190,83,107,43.68
Syndra,Annie,111,62,49,55.86
Syndra,Khazix,182,108,74,59.34
Syndra,Udyr,140,68,72,48.57
Syndra,Quinn,84,48,36,57.14
Syndra,Tryndamere,188,98,90,52.13
Syndra,Smolder,298,143,155,47.99
Syndra,Olaf,62,37,25,59.68
Syndra,Urgot,146,80,66,54.79
Syndra,Rumble,62,35,27,56.45
Syndra,Nidalee,81,47,34,58.02
Syndra,MonkeyKing,123,55,68,44.72
Syndra,Corki,155,111,44,71.61
Syndra,Belveth,97,55,42,56.7
Syndra,Zac,113,37,76,32.74
Syndra,Ryze,60,38,22,63.33
Syndra,Taric,67,38,29,56.72
Syndra,Camille,149,84,65,56.38
Syndra,Shyvana,120,41,79,34.17
Syndra,Lissandra,64,35,29,54.69
Syndra,Zilean,96,33,63,34.38
Syndra,Taliyah,54,21,33,38.89
Syndra,Janna,118,60,58,50.85
Syndra,RekSai,43,23,20,53.49
Braum,Sett,428,226,202,52.8
Braum,Vi,249,115,134,46.18
Braum,AurelionSol,146,80,66,54.79
Braum,Corki,123,33,90,26.83
Braum,Milio,136,53,83,38.97
Braum,Trundle,210,94,116,44.76
Braum,Amumu,254,105,149,41.34
Braum,Fizz,121,69,52,57.02
Braum,Kaisa,421,226,195,53.68
Braum,Pantheon,543,231,312,42.54
Braum,Riven,102,55,47,53.92
Braum,FiddleSticks,155,52,103,33.55
Braum,Brand,201,81,120,40.3
Braum,Jinx,496,237,259,47.78
Braum,Illaoi,157,71,86,45.22
Braum,Warwick,343,177,166,51.6
Braum,Aurora,205,135,70,65.85
Braum,Ezreal,430,234,196,54.42
Braum,Neeko,179,106,73,59.22
Braum,Nocturne,305,129,176,42.3
Braum,Ekko,198,111,87,56.06
Braum,MissFortune,666,337,329,50.6
Braum,Seraphine,348,145,203,41.67
Braum,Gangplank,102,38,64,37.25
Braum,Malzahar,183,105,78,57.38
Braum,Tristana,283,135,148,47.7
Braum,Senna,201,92,109,45.77
Braum,Mordekaiser,382,176,206,46.07
Braum,Sejuani,87,38,49,43.68
Braum,Yone,386,228,158,59.07
Braum,Swain,322,129,193,40.06
Braum,Shaco,230,130,100,56.52
Braum,Akali,266,124,142,46.62
Braum,Sivir,126,49,77,38.89
Braum,Renata,80,58,22,72.5
Braum,Fiora,143,64,79,44.76
Braum,Diana,346,157,189,45.38
Braum,Veigar,333,194,139,58.26
Braum,Ashe,428,264,164,61.68
Braum,Volibear,268,166,102,61.94
Braum,Irelia,195,102,93,52.31
Braum,Varus,144,77,67,53.47
Braum,Nautilus,346,202,144,58.38
Braum,Tryndamere,195,98,97,50.26
Braum,MasterYi,268,150,118,55.97
Braum,Orianna,135,77,58,57.04
Braum,Lux,635,322,313,50.71
Braum,MonkeyKing,169,88,81,52.07
Braum,Jhin,540,283,257,52.41
Braum,Vayne,311,157,154,50.48
Braum,Talon,187,108,79,57.75
Braum,Taliyah,89,31,58,34.83
Braum,Zoe,150,76,74,50.67
Braum,Shen,180,78,102,43.33
Braum,Kayn,434,199,235,45.85
Braum,Chogath,402,221,181,54.98
Braum,Viktor,158,93,65,58.86
Braum,Morgana,308,141,167,45.78
Braum,Hwei,185,83,102,44.86
Braum,Caitlyn,705,333,372,47.23
Braum,Teemo,435,242,193,55.63
Braum,Lucian,126,84,42,66.67
Braum,Ornn,122,63,59,51.64
Braum,Yorick,286,130,156,45.45
Braum,Kalista,115,72,43,62.61
Braum,LeeSin,199,91,108,45.73
Braum,Mel,578,291,287,50.35
Braum,Smolder,216,110,106,50.93
Braum,Zed,225,104,121,46.22
Braum,Sion,215,113,102,52.56
Braum,Soraka,201,93,108,46.27
Braum,Aatrox,217,114,103,52.53
Braum,Rengar,148,97,51,65.54
Braum,Ivern,108,78,30,72.22
Braum,Syndra,151,76,75,50.33
Braum,Samira,208,113,95,54.33
Braum,Maokai,104,33,71,31.73
Braum,Zac,75,31,44,41.33
Braum,Galio,176,57,119,32.39
Braum,Alistar,72,33,39,45.83
Braum,Graves,213,109,104,51.17
Braum,Yuumi,293,160,133,54.61
Braum,DrMundo,162,68,94,41.98
Braum,Nami,269,133,136,49.44
Braum,Briar,307,160,147,52.12
Braum,Ryze,83,40,43,48.19
Braum,Singed,89,65,24,73.03
Braum,Nasus,216,113,103,52.31
Braum,Evelynn,165,73,92,44.24
Braum,Ahri,433,224,209,51.73
Braum,Zyra,163,68,95,41.72
Braum,Ambessa,172,83,89,48.26
Braum,Sylas,290,161,129,55.52
Braum,Camille,100,37,63,37
Braum,Karthus,67,29,38,43.28
Braum,Yasuo,430,223,207,51.86
Braum,Lulu,221,104,117,47.06
Braum,Kindred,110,72,38,65.45
Braum,Nunu,224,119,105,53.13
Braum,Renekton,140,93,47,66.43
Braum,Vex,159,82,77,51.57
Braum,Karma,230,112,118,48.7
Braum,Azir,118,60,58,50.85
Braum,Jax,253,129,124,50.99
Braum,Draven,195,90,105,46.15
Braum,Vladimir,132,73,59,55.3
Braum,XinZhao,166,86,80,51.81
Braum,Urgot,147,90,57,61.22
Braum,Annie,79,35,44,44.3
Braum,Kayle,229,120,109,52.4
Braum,Gwen,166,97,69,58.43
Braum,Katarina,211,97,114,45.97
Braum,Aphelios,146,84,62,57.53
Braum,TahmKench,386,212,174,54.92
Braum,Lillia,143,66,77,46.15
Braum,Kassadin,74,40,34,54.05
Braum,Twitch,299,157,142,52.51
Braum,Leblanc,142,102,40,71.83
Braum,Nilah,180,73,107,40.56
Braum,Thresh,427,221,206,51.76
Braum,Viego,290,187,103,64.48
Braum,Heimerdinger,132,41,91,31.06
Braum,Quinn,88,36,52,40.91
Braum,Khazix,150,73,77,48.67
Braum,Xerath,192,91,101,47.4
Braum,Darius,448,186,262,41.52
Braum,Blitzcrank,215,122,93,56.74
Braum,Belveth,92,66,26,71.74
Braum,Xayah,161,76,85,47.2
Braum,Rakan,136,55,81,40.44
Braum,Elise,139,85,54,61.15
Braum,Garen,467,224,243,47.97
Braum,Velkoz,192,81,111,42.19
Braum,Jayce,101,53,48,52.48
Braum,Shyvana,48,21,27,43.75
Braum,Gnar,103,52,51,50.49
Braum,Gragas,207,128,79,61.84
Braum,Ziggs,129,73,56,56.59
Braum,JarvanIV,95,48,47,50.53
Braum,KSante,82,44,38,53.66
Braum,Poppy,133,73,60,54.89
Braum,Kennen,77,37,40,48.05
Braum,Bard,117,61,56,52.14
Braum,Naafiri,121,63,58,52.07
Braum,Skarner,100,61,39,61
Braum,Olaf,58,33,25,56.9
Braum,Kled,72,44,28,61.11
Braum,Janna,73,39,34,53.42
Braum,Hecarim,95,41,54,43.16
Braum,Nidalee,102,60,42,58.82
Braum,Malphite,250,100,150,40
Braum,Qiyana,79,24,55,30.38
Braum,Sona,81,21,60,25.93
Braum,RekSai,61,51,10,83.61
Braum,Lissandra,108,43,65,39.81
Braum,Anivia,95,57,38,60
Braum,Rumble,38,28,10,73.68
Braum,Zilean,71,36,35,50.7
Braum,Leona,154,92,62,59.74
Braum,Pyke,294,173,121,58.84
Braum,Akshan,77,46,31,59.74
Braum,KogMaw,99,42,57,42.42
Braum,TwistedFate,146,72,74,49.32
Braum,Rell,173,87,86,50.29
Braum,Rammus,72,31,41,43.06
Braum,Udyr,103,31,72,30.1
Braum,Cassiopeia,80,47,33,58.75
Braum,Zeri,106,51,55,48.11
Braum,Taric,44,36,8,81.82
Corki,Braum,123,90,33,73.17
Corki,XinZhao,106,28,78,26.42
Corki,Lux,612,277,335,45.26
Corki,Chogath,194,84,110,43.3
Corki,Taliyah,43,30,13,69.77
Corki,Mordekaiser,235,79,156,33.62
Corki,Vi,152,63,89,41.45
Corki,Azir,92,45,47,48.91
Corki,MissFortune,417,169,248,40.53
Corki,Nautilus,184,101,83,54.89
Corki,Gnar,103,72,31,69.9
Corki,Warwick,241,101,140,41.91
Corki,Malzahar,142,48,94,33.8
Corki,Tristana,189,71,118,37.57
Corki,Brand,123,66,57,53.66
Corki,Ornn,68,46,22,67.65
Corki,Amumu,160,75,85,46.88
Corki,Katarina,215,96,119,44.65
Corki,Twitch,181,102,79,56.35
Corki,Senna,156,93,63,59.62
Corki,Garen,333,103,230,30.93
Corki,Ekko,115,44,71,38.26
Corki,Yasuo,439,189,250,43.05
Corki,Caitlyn,452,188,264,41.59
Corki,Poppy,70,36,34,51.43
Corki,Aurora,206,97,109,47.09
Corki,Nocturne,181,55,126,30.39
Corki,Pantheon,328,162,166,49.39
Corki,Nilah,119,78,41,65.55
Corki,Soraka,131,34,97,25.95
Corki,Kennen,63,35,28,55.56
Corki,TwistedFate,81,43,38,53.09
Corki,Cassiopeia,83,31,52,37.35
Corki,Smolder,98,42,56,42.86
Corki,Milio,121,62,59,51.24
Corki,TahmKench,243,98,145,40.33
Corki,Samira,231,138,93,59.74
Corki,Taric,41,16,25,39.02
Corki,Hecarim,63,24,39,38.1
Corki,Jhin,312,124,188,39.74
Corki,Velkoz,138,58,80,42.03
Corki,Nasus,130,76,54,58.46
Corki,MasterYi,170,73,97,42.94
Corki,Riven,108,64,44,59.26
Corki,Rell,88,38,50,43.18
Corki,Rammus,58,27,31,46.55
Corki,Vex,81,50,31,61.73
Corki,Lulu,173,79,94,45.66
Corki,Kayle,109,50,59,45.87
Corki,Tryndamere,128,58,70,45.31
Corki,Akali,167,89,78,53.29
Corki,Neeko,96,31,65,32.29
Corki,Yorick,142,46,96,32.39
Corki,Singed,64,29,35,45.31
Corki,Ryze,58,22,36,37.93
Corki,Kayn,329,159,170,48.33
Corki,Viktor,145,71,74,48.97
Corki,Zed,206,117,89,56.8
Corki,Ashe,320,155,165,48.44
Corki,Thresh,262,115,147,43.89
Corki,Jax,171,65,106,38.01
Corki,Shaco,194,97,97,50
Corki,Zoe,116,55,61,47.41
Corki,Yuumi,211,112,99,53.08
Corki,Teemo,211,93,118,44.08
Corki,Evelynn,60,41,19,68.33
Corki,Janna,77,34,43,44.16
Corki,Aatrox,158,73,85,46.2
Corki,Lucian,85,42,43,49.41
Corki,Nami,193,68,125,35.23
Corki,LeeSin,248,131,117,52.82
Corki,Zac,50,26,24,52
Corki,Gragas,149,76,73,51.01
Corki,Viego,247,113,134,45.75
Corki,Darius,385,166,219,43.12
Corki,Kaisa,288,142,146,49.31
Corki,Swain,196,79,117,40.31
Corki,DrMundo,127,61,66,48.03
Corki,Trundle,133,26,107,19.55
Corki,Rengar,97,53,44,54.64
Corki,Vladimir,127,60,67,47.24
Corki,Mel,436,174,262,39.91
Corki,Sett,271,100,171,36.9
Corki,Nunu,214,107,107,50
Corki,Jinx,304,117,187,38.49
Corki,Briar,148,80,68,54.05
Corki,Ezreal,389,186,203,47.81
Corki,Morgana,220,103,117,46.82
Corki,Nidalee,31,22,9,70.97
Corki,Volibear,241,117,124,48.55
Corki,Annie,49,22,27,44.9
Corki,Vayne,240,82,158,34.17
Corki,Zeri,87,40,47,45.98
Corki,Gwen,78,50,28,64.1
Corki,Veigar,226,123,103,54.42
Corki,Sylas,141,60,81,42.55
Corki,Varus,134,60,74,44.78
Corki,Irelia,96,50,46,52.08
Corki,FiddleSticks,100,44,56,44
Corki,Illaoi,107,64,43,59.81
Corki,Lillia,127,41,86,32.28
Corki,Fizz,55,39,16,70.91
Corki,Karma,124,65,59,52.42
Corki,Fiora,102,46,56,45.1
Corki,Ivern,43,37,6,86.05
Corki,Kassadin,69,16,53,23.19
Corki,Aphelios,150,60,90,40
Corki,Diana,208,89,119,42.79
Corki,Sejuani,99,39,60,39.39
Corki,Shen,131,45,86,34.35
Corki,KSante,56,35,21,62.5
Corki,Khazix,137,70,67,51.09
Corki,Blitzcrank,156,67,89,42.95
Corki,Heimerdinger,74,38,36,51.35
Corki,Renata,36,25,11,69.44
Corki,Udyr,76,25,51,32.89
Corki,Zilean,80,42,38,52.5
Corki,Sion,183,112,71,61.2
Corki,Ziggs,92,47,45,51.09
Corki,Pyke,220,130,90,59.09
Corki,Naafiri,94,27,67,28.72
Corki,Ahri,192,103,89,53.65
Corki,Sivir,103,47,56,45.63
Corki,Seraphine,169,95,74,56.21
Corki,Galio,168,73,95,43.45
Corki,Draven,123,66,57,53.66
Corki,KogMaw,62,22,40,35.48
Corki,Jayce,70,45,25,64.29
Corki,Xerath,107,33,74,30.84
Corki,Olaf,53,28,25,52.83
Corki,Shyvana,65,31,34,47.69
Corki,Yone,271,106,165,39.11
Corki,Kalista,58,25,33,43.1
Corki,Leblanc,104,38,66,36.54
Corki,Rakan,109,45,64,41.28
Corki,Karthus,23,3,20,13.04
Corki,Urgot,112,65,47,58.04
Corki,JarvanIV,96,39,57,40.63
Corki,Camille,118,72,46,61.02
Corki,Orianna,103,58,45,56.31
Corki,Akshan,57,23,34,40.35
Corki,Xayah,139,66,73,47.48
Corki,Zyra,114,63,51,55.26
Corki,Talon,109,44,65,40.37
Corki,Kindred,116,47,69,40.52
Corki,Hwei,152,68,84,44.74
Corki,Maokai,75,36,39,48
Corki,Syndra,155,44,111,28.39
Corki,Gangplank,57,32,25,56.14
Corki,Lissandra,47,25,22,53.19
Corki,Alistar,93,34,59,36.56
Corki,Quinn,83,43,40,51.81
Corki,Skarner,62,26,36,41.94
Corki,Qiyana,63,30,33,47.62
Corki,Belveth,103,40,63,38.83
Corki,Renekton,112,72,40,64.29
Corki,MonkeyKing,119,37,82,31.09
Corki,AurelionSol,89,20,69,22.47
Corki,Bard,88,34,54,38.64
Corki,Leona,162,77,85,47.53
Corki,Elise,122,58,64,47.54
Corki,Kled,55,20,35,36.36
Corki,Sona,75,35,40,46.67
Corki,Malphite,125,54,71,43.2
Corki,Ambessa,104,29,75,27.88
Corki,RekSai,26,19,7,73.08
Corki,Anivia,42,13,29,30.95
Corki,Graves,55,40,15,72.73
Corki,Rumble,45,36,9,80
Bard,Riven,71,43,28,60.56
Bard,Nocturne,132,73,59,55.3
Bard,Zoe,118,59,59,50
Bard,Jinx,368,185,183,50.27
Bard,Lulu,197,113,84,57.36
Bard,Teemo,279,124,155,44.44
Bard,Amumu,217,115,102,53
Bard,Garen,278,116,162,41.73
Bard,KogMaw,83,47,36,56.63
Bard,Yuumi,208,96,112,46.15
Bard,Fiora,64,32,32,50
Bard,LeeSin,246,132,114,53.66
Bard,Ziggs,101,35,66,34.65
Bard,Senna,183,88,95,48.09
Bard,Tryndamere,143,81,62,56.64
Bard,Sylas,219,109,110,49.77
Bard,Taliyah,57,33,24,57.89
Bard,Jhin,293,147,146,50.17
Bard,Volibear,217,101,116,46.54
Bard,Malzahar,126,35,91,27.78
Bard,Caitlyn,519,221,298,42.58
Bard,Pyke,198,120,78,60.61
Bard,Jayce,60,43,17,71.67
Bard,Skarner,85,41,44,48.24
Bard,Lux,484,258,226,53.31
Bard,Poppy,118,64,54,54.24
Bard,Malphite,119,46,73,38.66
Bard,Sejuani,142,85,57,59.86
Bard,Heimerdinger,88,47,41,53.41
Bard,Zilean,41,19,22,46.34
Bard,Singed,54,9,45,16.67
Bard,MasterYi,194,88,106,45.36
Bard,Veigar,283,124,159,43.82
Bard,Karma,166,57,109,34.34
Bard,Yasuo,398,197,201,49.5
Bard,Ekko,170,77,93,45.29
Bard,Hwei,130,78,52,60
Bard,Sett,348,175,173,50.29
Bard,Ivern,36,20,16,55.56
Bard,Katarina,178,82,96,46.07
Bard,Xayah,121,58,63,47.93
Bard,Mel,454,246,208,54.19
Bard,Zed,181,101,80,55.8
Bard,Morgana,266,115,151,43.23
Bard,Akshan,75,50,25,66.67
Bard,Syndra,92,55,37,59.78
Bard,Xerath,152,84,68,55.26
Bard,Warwick,263,98,165,37.26
Bard,Viktor,145,90,55,62.07
Bard,Ashe,242,106,136,43.8
Bard,Yone,324,179,145,55.25
Bard,Shen,163,59,104,36.2
Bard,Leblanc,70,23,47,32.86
Bard,Twitch,166,91,75,54.82
Bard,Velkoz,109,36,73,33.03
Bard,Kindred,141,61,80,43.26
Bard,Trundle,133,56,77,42.11
Bard,Udyr,84,50,34,59.52
Bard,Samira,192,93,99,48.44
Bard,Rell,69,34,35,49.28
Bard,Aphelios,222,105,117,47.3
Bard,Alistar,75,32,43,42.67
Bard,Nidalee,64,33,31,51.56
Bard,Naafiri,101,47,54,46.53
Bard,Nautilus,218,127,91,58.26
Bard,TahmKench,237,95,142,40.08
Bard,Diana,171,70,101,40.94
Bard,Ezreal,354,198,156,55.93
Bard,Swain,187,61,126,32.62
Bard,Irelia,112,51,61,45.54
Bard,Orianna,64,33,31,51.56
Bard,Vayne,203,115,88,56.65
Bard,Soraka,122,39,83,31.97
Bard,Ornn,105,53,52,50.48
Bard,TwistedFate,50,29,21,58
Bard,Kaisa,212,148,64,69.81
Bard,Yorick,180,80,100,44.44
Bard,XinZhao,76,21,55,27.63
Bard,Graves,111,42,69,37.84
Bard,Shaco,159,87,72,54.72
Bard,Hecarim,84,48,36,57.14
Bard,Rengar,159,105,54,66.04
Bard,Vladimir,128,69,59,53.91
Bard,Karthus,34,19,15,55.88
Bard,Khazix,89,57,32,64.04
Bard,Qiyana,57,31,26,54.39
Bard,Renekton,109,77,32,70.64
Bard,Aurora,176,88,88,50
Bard,MissFortune,362,182,180,50.28
Bard,Elise,167,92,75,55.09
Bard,Brand,118,56,62,47.46
Bard,Annie,62,47,15,75.81
Bard,Zeri,117,51,66,43.59
Bard,Mordekaiser,218,122,96,55.96
Bard,Nasus,89,32,57,35.96
Bard,Kayn,237,95,142,40.08
Bard,Gnar,33,3,30,9.09
Bard,Neeko,124,33,91,26.61
Bard,Gragas,133,70,63,52.63
Bard,Ambessa,142,66,76,46.48
Bard,Briar,183,99,84,54.1
Bard,Darius,385,170,215,44.16
Bard,Milio,124,61,63,49.19
Bard,Sion,168,131,37,77.98
Bard,Nunu,182,71,111,39.01
Bard,JarvanIV,102,40,62,39.22
Bard,Tristana,190,102,88,53.68
Bard,AurelionSol,81,30,51,37.04
Bard,Kassadin,57,25,32,43.86
Bard,Lucian,86,39,47,45.35
Bard,Braum,117,56,61,47.86
Bard,Akali,204,89,115,43.63
Bard,Jax,152,59,93,38.82
Bard,Thresh,204,126,78,61.76
Bard,Quinn,115,75,40,65.22
Bard,Pantheon,286,124,162,43.36
Bard,Camille,78,47,31,60.26
Bard,DrMundo,141,76,65,53.9
Bard,Olaf,43,14,29,32.56
Bard,Nami,204,90,114,44.12
Bard,Renata,59,36,23,61.02
Bard,Zyra,142,61,81,42.96
Bard,Sona,84,37,47,44.05
Bard,Ahri,265,159,106,60
Bard,Kayle,144,88,56,61.11
Bard,Zac,95,34,61,35.79
Bard,FiddleSticks,120,66,54,55
Bard,Lillia,111,50,61,45.05
Bard,Belveth,30,10,20,33.33
Bard,Illaoi,97,37,60,38.14
Bard,Azir,52,30,22,57.69
Bard,Seraphine,201,96,105,47.76
Bard,Chogath,303,162,141,53.47
Bard,Anivia,63,45,18,71.43
Bard,Smolder,145,97,48,66.9
Bard,Galio,143,65,78,45.45
Bard,Maokai,77,17,60,22.08
Bard,MonkeyKing,89,43,46,48.31
Bard,Evelynn,90,37,53,41.11
Bard,Urgot,91,40,51,43.96
Bard,Vex,123,57,66,46.34
Bard,Sivir,111,62,49,55.86
Bard,Rakan,114,55,59,48.25
Bard,Cassiopeia,62,40,22,64.52
Bard,Rammus,37,24,13,64.86
Bard,Varus,115,59,56,51.3
Bard,Talon,100,75,25,75
Bard,Viego,204,132,72,64.71
Bard,Nilah,112,71,41,63.39
Bard,Gwen,143,69,74,48.25
Bard,Janna,78,51,27,65.38
Bard,Vi,159,80,79,50.31
Bard,Kennen,101,48,53,47.52
Bard,Aatrox,216,98,118,45.37
Bard,Blitzcrank,119,49,70,41.18
Bard,Gangplank,92,40,52,43.48
Bard,Rumble,42,13,29,30.95
Bard,KSante,86,62,24,72.09
Bard,Draven,111,65,46,58.56
Bard,Corki,88,54,34,61.36
Bard,Kled,22,19,3,86.36
Bard,Kalista,120,64,56,53.33
Bard,Shyvana,44,13,31,29.55
Bard,Leona,129,86,43,66.67
Bard,Fizz,87,69,18,79.31
Bard,Taric,35,23,12,65.71
Bard,Ryze,56,19,37,33.93
Bard,Lissandra,39,10,29,25.64
Bard,RekSai,3,0,3,0
Xerath,Mordekaiser,561,263,298,46.88
Xerath,Vi,373,205,168,54.96
Xerath,Cassiopeia,239,115,124,48.12
Xerath,Ezreal,674,350,324,51.93
Xerath,Lux,1359,724,635,53.27
Xerath,Gwen,253,148,105,58.5
Xerath,Tryndamere,259,74,185,28.57
Xerath,Velkoz,314,133,181,42.36
Xerath,Zeri,106,69,37,65.09
Xerath,Thresh,475,255,220,53.68
Xerath,Kayn,712,334,378,46.91
Xerath,Diana,594,310,284,52.19
Xerath,Sivir,177,49,128,27.68
Xerath,Soraka,260,144,116,55.38
Xerath,MasterYi,432,220,212,50.93
Xerath,Shaco,336,145,191,43.15
Xerath,Azir,196,117,79,59.69
Xerath,Rengar,167,111,56,66.47
Xerath,Pyke,371,185,186,49.87
Xerath,Malzahar,336,154,182,45.83
Xerath,Twitch,394,170,224,43.15
Xerath,Talon,197,108,89,54.82
Xerath,Jhin,741,390,351,52.63
Xerath,Rakan,193,99,94,51.3
Xerath,Singed,109,46,63,42.2
Xerath,Kindred,227,120,107,52.86
Xerath,Yasuo,625,305,320,48.8
Xerath,Ashe,629,300,329,47.69
Xerath,Alistar,104,58,46,55.77
Xerath,Aatrox,333,197,136,59.16
Xerath,Warwick,659,346,313,52.5
Xerath,Varus,320,220,100,68.75
Xerath,Milio,194,71,123,36.6
Xerath,Ornn,162,79,83,48.77
Xerath,Hwei,321,153,168,47.66
Xerath,Caitlyn,1114,600,514,53.86
Xerath,Karma,352,195,157,55.4
Xerath,Nasus,316,148,168,46.84
Xerath,LeeSin,351,197,154,56.13
Xerath,Ivern,83,61,22,73.49
Xerath,Jinx,860,411,449,47.79
Xerath,Seraphine,414,202,212,48.79
Xerath,Yone,630,340,290,53.97
Xerath,Udyr,112,52,60,46.43
Xerath,Tristana,329,89,240,27.05
Xerath,Lulu,287,117,170,40.77
Xerath,Zac,147,75,72,51.02
Xerath,Swain,338,164,174,48.52
Xerath,Briar,451,214,237,47.45
Xerath,Poppy,249,163,86,65.46
Xerath,Ekko,357,146,211,40.9
Xerath,Kaisa,388,218,170,56.19
Xerath,Rell,195,104,91,53.33
Xerath,Gragas,249,134,115,53.82
Xerath,Xayah,261,145,116,55.56
Xerath,Fiora,219,109,110,49.77
Xerath,Sylas,384,196,188,51.04
Xerath,Nautilus,394,251,143,63.71
Xerath,Riven,144,74,70,51.39
Xerath,Bard,152,68,84,44.74
Xerath,Karthus,57,29,28,50.88
Xerath,KSante,166,75,91,45.18
Xerath,TahmKench,399,207,192,51.88
Xerath,Sion,338,202,136,59.76
Xerath,Garen,520,255,265,49.04
Xerath,Teemo,572,207,365,36.19
Xerath,Katarina,387,192,195,49.61
Xerath,Nilah,266,140,126,52.63
Xerath,Fizz,244,116,128,47.54
Xerath,Gangplank,201,98,103,48.76
Xerath,Kled,62,36,26,58.06
Xerath,Lillia,273,145,128,53.11
Xerath,Ahri,529,265,264,50.09
Xerath,MissFortune,942,538,404,57.11
Xerath,Neeko,281,156,125,55.52
Xerath,Graves,214,121,93,56.54
Xerath,Vayne,422,205,217,48.58
Xerath,Jax,282,163,119,57.8
Xerath,Amumu,423,181,242,42.79
Xerath,Heimerdinger,188,97,91,51.6
Xerath,Volibear,558,290,268,51.97
Xerath,Morgana,659,352,307,53.41
Xerath,Brand,364,209,155,57.42
Xerath,Blitzcrank,291,149,142,51.2
Xerath,Yorick,390,192,198,49.23
Xerath,Kassadin,46,28,18,60.87
Xerath,Mel,1082,613,469,56.65
Xerath,Galio,228,99,129,43.42
Xerath,Zoe,197,116,81,58.88
Xerath,Darius,712,402,310,56.46
Xerath,FiddleSticks,127,72,55,56.69
Xerath,Senna,367,200,167,54.5
Xerath,Illaoi,227,119,108,52.42
Xerath,Sona,156,90,66,57.69
Xerath,Irelia,340,207,133,60.88
Xerath,Orianna,263,169,94,64.26
Xerath,Syndra,246,140,106,56.91
Xerath,Samira,382,187,195,48.95
Xerath,Yuumi,345,151,194,43.77
Xerath,DrMundo,270,123,147,45.56
Xerath,Viktor,254,152,102,59.84
Xerath,Leona,267,120,147,44.94
Xerath,Sett,775,372,403,48
Xerath,Renekton,195,92,103,47.18
Xerath,Pantheon,598,289,309,48.33
Xerath,Viego,507,241,266,47.53
Xerath,Akali,428,227,201,53.04
Xerath,Kennen,144,78,66,54.17
Xerath,Kalista,198,100,98,50.51
Xerath,Janna,110,57,53,51.82
Xerath,Akshan,125,46,79,36.8
Xerath,Ziggs,171,83,88,48.54
Xerath,Sejuani,129,30,99,23.26
Xerath,Malphite,258,146,112,56.59
Xerath,Vex,276,146,130,52.9
Xerath,Gnar,137,98,39,71.53
Xerath,Qiyana,118,70,48,59.32
Xerath,Zilean,97,43,54,44.33
Xerath,XinZhao,229,123,106,53.71
Xerath,Aphelios,239,133,106,55.65
Xerath,Camille,150,75,75,50
Xerath,Naafiri,149,78,71,52.35
Xerath,Zed,354,200,154,56.5
Xerath,Braum,192,101,91,52.6
Xerath,Zyra,300,150,150,50
Xerath,AurelionSol,159,60,99,37.74
Xerath,Annie,140,78,62,55.71
Xerath,Aurora,324,196,128,60.49
Xerath,Taliyah,109,58,51,53.21
Xerath,Shen,291,151,140,51.89
Xerath,Ryze,96,36,60,37.5
Xerath,Urgot,179,64,115,35.75
Xerath,Rammus,96,35,61,36.46
Xerath,Lucian,200,109,91,54.5
Xerath,Nami,385,181,204,47.01
Xerath,Nunu,295,174,121,58.98
Xerath,Kayle,328,172,156,52.44
Xerath,MonkeyKing,133,56,77,42.11
Xerath,Veigar,572,273,299,47.73
Xerath,Corki,107,74,33,69.16
Xerath,Hecarim,178,104,74,58.43
Xerath,Smolder,336,193,143,57.44
Xerath,Renata,103,62,41,60.19
Xerath,Evelynn,184,91,93,49.46
Xerath,Shyvana,127,68,59,53.54
Xerath,JarvanIV,124,66,58,53.23
Xerath,KogMaw,98,58,40,59.18
Xerath,Maokai,158,68,90,43.04
Xerath,Trundle,181,96,85,53.04
Xerath,Olaf,82,53,29,64.63
Xerath,Vladimir,148,69,79,46.62
Xerath,Nocturne,345,160,185,46.38
Xerath,Khazix,205,122,83,59.51
Xerath,Elise,245,158,87,64.49
Xerath,Draven,243,141,102,58.02
Xerath,Ambessa,189,120,69,63.49
Xerath,Chogath,464,230,234,49.57
Xerath,Lissandra,70,19,51,27.14
Xerath,Nidalee,116,64,52,55.17
Xerath,Skarner,126,41,85,32.54
Xerath,Taric,100,62,38,62
Xerath,Rumble,153,91,62,59.48
Xerath,Leblanc,106,77,29,72.64
Xerath,Jayce,155,73,82,47.1
Xerath,TwistedFate,143,117,26,81.82
Xerath,Quinn,128,79,49,61.72
Xerath,Belveth,106,47,59,44.34
Xerath,Anivia,140,63,77,45
Xerath,RekSai,19,10,9,52.63
Karthus,Fiora,51,13,38,25.49
Karthus,FiddleSticks,101,46,55,45.54
Karthus,Syndra,96,27,69,28.13
Karthus,Vayne,143,63,80,44.06
Karthus,Morgana,222,96,126,43.24
Karthus,Illaoi,48,32,16,66.67
Karthus,Warwick,258,108,150,41.86
Karthus,Aurora,151,77,74,50.99
Karthus,Ezreal,242,129,113,53.31
Karthus,Neeko,101,52,49,51.49
Karthus,Kled,44,13,31,29.55
Karthus,Ambessa,65,26,39,40
Karthus,Diana,242,129,113,53.31
Karthus,Nilah,90,54,36,60
Karthus,Leona,80,55,25,68.75
Karthus,Gnar,95,35,60,36.84
Karthus,Kayn,278,106,172,38.13
Karthus,Katarina,91,48,43,52.75
Karthus,Ashe,290,150,140,51.72
Karthus,Thresh,210,95,115,45.24
Karthus,Yorick,130,40,90,30.77
Karthus,Mordekaiser,208,103,105,49.52
Karthus,Ahri,232,131,101,56.47
Karthus,Jinx,349,168,181,48.14
Karthus,Amumu,162,64,98,39.51
Karthus,Shaco,245,112,133,45.71
Karthus,MissFortune,310,148,162,47.74
Karthus,Lux,407,200,207,49.14
Karthus,Irelia,144,76,68,52.78
Karthus,MonkeyKing,63,28,35,44.44
Karthus,Vex,108,49,59,45.37
Karthus,Caitlyn,288,120,168,41.67
Karthus,Rell,86,37,49,43.02
Karthus,Nasus,92,33,59,35.87
Karthus,Xerath,57,28,29,49.12
Karthus,Aatrox,143,82,61,57.34
Karthus,Yone,288,113,175,39.24
Karthus,Samira,121,39,82,32.23
Karthus,Karma,84,20,64,23.81
Karthus,Nocturne,127,72,55,56.69
Karthus,Ryze,34,13,21,38.24
Karthus,Blitzcrank,105,61,44,58.1
Karthus,Urgot,48,8,40,16.67
Karthus,Ivern,33,15,18,45.45
Karthus,Kassadin,27,6,21,22.22
Karthus,Senna,131,72,59,54.96
Karthus,DrMundo,119,36,83,30.25
Karthus,TwistedFate,60,50,10,83.33
Karthus,Yasuo,279,154,125,55.2
Karthus,Rammus,51,31,20,60.78
Karthus,Vladimir,55,18,37,32.73
Karthus,Braum,67,38,29,56.72
Karthus,Sett,268,128,140,47.76
Karthus,Darius,330,166,164,50.3
Karthus,Ekko,69,32,37,46.38
Karthus,Swain,168,66,102,39.29
Karthus,Orianna,36,17,19,47.22
Karthus,Aphelios,139,50,89,35.97
Karthus,Brand,109,50,59,45.87
Karthus,Kaisa,267,149,118,55.81
Karthus,Gragas,131,41,90,31.3
Karthus,Talon,74,48,26,64.86
Karthus,Jhin,221,104,117,47.06
Karthus,Tristana,174,79,95,45.4
Karthus,Rengar,74,29,45,39.19
Karthus,Briar,120,40,80,33.33
Karthus,Mel,349,185,164,53.01
Karthus,Teemo,209,111,98,53.11
Karthus,Leblanc,90,47,43,52.22
Karthus,Bard,34,15,19,44.12
Karthus,LeeSin,142,59,83,41.55
Karthus,Renekton,31,16,15,51.61
Karthus,Nautilus,169,110,59,65.09
Karthus,Gwen,101,49,52,48.51
Karthus,MasterYi,164,101,63,61.59
Karthus,Elise,94,45,49,47.87
Karthus,Jax,100,29,71,29
Karthus,Viktor,102,29,73,28.43
Karthus,Zyra,131,37,94,28.24
Karthus,Hwei,136,65,71,47.79
Karthus,Viego,176,88,88,50
Karthus,Malzahar,123,37,86,30.08
Karthus,Lucian,51,29,22,56.86
Karthus,Veigar,161,86,75,53.42
Karthus,Soraka,118,39,79,33.05
Karthus,Ziggs,44,22,22,50
Karthus,Nunu,120,49,71,40.83
Karthus,Sona,64,34,30,53.13
Karthus,Varus,148,98,50,66.22
Karthus,Singed,36,17,19,47.22
Karthus,Garen,259,114,145,44.02
Karthus,Shen,89,50,39,56.18
Karthus,TahmKench,157,70,87,44.59
Karthus,Taliyah,67,26,41,38.81
Karthus,Janna,57,26,31,45.61
Karthus,Draven,51,16,35,31.37
Karthus,Pantheon,269,142,127,52.79
Karthus,Zed,116,72,44,62.07
Karthus,Smolder,125,52,73,41.6
Karthus,Riven,65,44,21,67.69
Karthus,Chogath,208,90,118,43.27
Karthus,Renata,26,8,18,30.77
Karthus,Lulu,92,34,58,36.96
Karthus,Annie,42,19,23,45.24
Karthus,Sivir,76,27,49,35.53
Karthus,Udyr,58,37,21,63.79
Karthus,Tryndamere,83,48,35,57.83
Karthus,Seraphine,157,56,101,35.67
Karthus,Trundle,74,16,58,21.62
Karthus,AurelionSol,86,54,32,62.79
Karthus,Qiyana,61,30,31,49.18
Karthus,Yuumi,183,86,97,46.99
Karthus,Lillia,65,43,22,66.15
Karthus,Sion,105,36,69,34.29
Karthus,Jayce,49,12,37,24.49
Karthus,RekSai,29,15,14,51.72
Karthus,Cassiopeia,66,38,28,57.58
Karthus,Kalista,62,26,36,41.94
Karthus,Corki,23,20,3,86.96
Karthus,Nami,94,26,68,27.66
Karthus,Heimerdinger,76,64,12,84.21
Karthus,Xayah,130,70,60,53.85
Karthus,Malphite,103,30,73,29.13
Karthus,Volibear,156,73,83,46.79
Karthus,Galio,88,25,63,28.41
Karthus,Kayle,121,43,78,35.54
Karthus,Fizz,63,54,9,85.71
Karthus,Khazix,92,35,57,38.04
Karthus,Zoe,83,48,35,57.83
Karthus,XinZhao,59,28,31,47.46
Karthus,Twitch,105,39,66,37.14
Karthus,Naafiri,80,38,42,47.5
Karthus,Olaf,18,6,12,33.33
Karthus,JarvanIV,50,28,22,56
Karthus,Akali,169,89,80,52.66
Karthus,Kindred,92,53,39,57.61
Karthus,Akshan,52,31,21,59.62
Karthus,KogMaw,27,3,24,11.11
Karthus,Pyke,149,78,71,52.35
Karthus,Camille,35,26,9,74.29
Karthus,Graves,118,61,57,51.69
Karthus,Zilean,77,33,44,42.86
Karthus,Azir,41,17,24,41.46
Karthus,Hecarim,61,21,40,34.43
Karthus,Evelynn,92,53,39,57.61
Karthus,Milio,81,36,45,44.44
Karthus,Taric,35,22,13,62.86
Karthus,Rakan,104,33,71,31.73
Karthus,Sylas,134,50,84,37.31
Karthus,Zac,66,22,44,33.33
Karthus,Maokai,71,36,35,50.7
Karthus,Nidalee,60,31,29,51.67
Karthus,Kennen,55,14,41,25.45
Karthus,Velkoz,82,21,61,25.61
Karthus,Poppy,52,18,34,34.62
Karthus,KSante,65,26,39,40
Karthus,Zeri,87,34,53,39.08
Karthus,Gangplank,54,25,29,46.3
Karthus,Belveth,44,25,19,56.82
Karthus,Anivia,53,29,24,54.72
Karthus,Quinn,60,27,33,45
Karthus,Sejuani,67,27,40,40.3
Karthus,Ornn,45,30,15,66.67
Karthus,Vi,56,28,28,50
Karthus,Alistar,41,27,14,65.85
Karthus,Shyvana,54,21,33,38.89
Karthus,Rumble,18,15,3,83.33
Karthus,Lissandra,15,6,9,40
Karthus,Skarner,21,13,8,61.9
Anivia,Ambessa,126,27,99,21.43
Anivia,Xayah,96,39,57,40.63
Anivia,AurelionSol,88,42,46,47.73
Anivia,Khazix,112,50,62,44.64
Anivia,Nautilus,202,111,91,54.95
Anivia,Malphite,140,94,46,67.14
Anivia,Rengar,67,40,27,59.7
Anivia,Akali,195,116,79,59.49
Anivia,Ashe,331,172,159,51.96
Anivia,Rakan,109,35,74,32.11
Anivia,Teemo,234,153,81,65.38
Anivia,Gragas,128,68,60,53.13
Anivia,Qiyana,31,21,10,67.74
Anivia,Caitlyn,446,223,223,50
Anivia,Soraka,144,80,64,55.56
Anivia,Yasuo,349,176,173,50.43
Anivia,Belveth,53,13,40,24.53
Anivia,Yone,318,151,167,47.48
Anivia,Mordekaiser,280,148,132,52.86
Anivia,Alistar,66,34,32,51.52
Anivia,Sylas,186,102,84,54.84
Anivia,FiddleSticks,97,29,68,29.9
Anivia,Leblanc,91,36,55,39.56
Anivia,Aphelios,77,36,41,46.75
Anivia,Morgana,270,172,98,63.7
Anivia,Nasus,112,50,62,44.64
Anivia,Zed,152,63,89,41.45
Anivia,Malzahar,152,51,101,33.55
Anivia,Ezreal,296,139,157,46.96
Anivia,Mel,356,198,158,55.62
Anivia,Garen,269,127,142,47.21
Anivia,LeeSin,174,96,78,55.17
Anivia,Aurora,154,70,84,45.45
Anivia,MissFortune,408,201,207,49.26
Anivia,Rell,92,62,30,67.39
Anivia,Heimerdinger,93,55,38,59.14
Anivia,Vi,129,49,80,37.98
Anivia,Vladimir,102,43,59,42.16
Anivia,Riven,125,70,55,56
Anivia,Katarina,157,89,68,56.69
Anivia,Kaisa,300,128,172,42.67
Anivia,Kayle,196,104,92,53.06
Anivia,Trundle,112,54,58,48.21
Anivia,Senna,157,75,82,47.77
Anivia,Sett,402,205,197,51
Anivia,Warwick,307,167,140,54.4
Anivia,Smolder,150,80,70,53.33
Anivia,Seraphine,261,128,133,49.04
Anivia,Pantheon,294,165,129,56.12
Anivia,Shaco,168,71,97,42.26
Anivia,Jhin,332,195,137,58.73
Anivia,Ahri,287,125,162,43.55
Anivia,Pyke,248,109,139,43.95
Anivia,Nunu,121,54,67,44.63
Anivia,Thresh,251,107,144,42.63
Anivia,Syndra,135,59,76,43.7
Anivia,Tristana,207,99,108,47.83
Anivia,Zyra,136,69,67,50.74
Anivia,Evelynn,99,48,51,48.48
Anivia,Talon,97,39,58,40.21
Anivia,Irelia,129,61,68,47.29
Anivia,Yuumi,125,70,55,56
Anivia,Zac,57,22,35,38.6
Anivia,Viego,257,127,130,49.42
Anivia,Milio,99,46,53,46.46
Anivia,Hwei,111,36,75,32.43
Anivia,Volibear,250,134,116,53.6
Anivia,Naafiri,68,29,39,42.65
Anivia,XinZhao,85,40,45,47.06
Anivia,Veigar,204,114,90,55.88
Anivia,Draven,83,30,53,36.14
Anivia,Karma,158,83,75,52.53
Anivia,Orianna,77,23,54,29.87
Anivia,Lux,442,205,237,46.38
Anivia,Shyvana,90,34,56,37.78
Anivia,Leona,132,77,55,58.33
Anivia,Kennen,69,41,28,59.42
Anivia,Ekko,90,43,47,47.78
Anivia,Varus,141,74,67,52.48
Anivia,Camille,77,34,43,44.16
Anivia,Jinx,298,131,167,43.96
Anivia,Urgot,124,55,69,44.35
Anivia,Lucian,88,33,55,37.5
Anivia,Ornn,77,38,39,49.35
Anivia,Kayn,289,131,158,45.33
Anivia,Akshan,117,60,57,51.28
Anivia,Aatrox,201,102,99,50.75
Anivia,Lillia,87,62,25,71.26
Anivia,Galio,131,53,78,40.46
Anivia,Chogath,230,135,95,58.7
Anivia,Yorick,187,91,96,48.66
Anivia,Jax,151,67,84,44.37
Anivia,Janna,56,27,29,48.21
Anivia,TahmKench,158,79,79,50
Anivia,Brand,119,71,48,59.66
Anivia,Darius,283,150,133,53
Anivia,Samira,193,90,103,46.63
Anivia,Briar,206,100,106,48.54
Anivia,Cassiopeia,102,30,72,29.41
Anivia,Shen,108,43,65,39.81
Anivia,Tryndamere,99,32,67,32.32
Anivia,Diana,214,89,125,41.59
Anivia,Kled,16,7,9,43.75
Anivia,Zoe,70,39,31,55.71
Anivia,Fizz,124,44,80,35.48
Anivia,Illaoi,63,40,23,63.49
Anivia,MonkeyKing,116,76,40,65.52
Anivia,Gwen,131,84,47,64.12
Anivia,Velkoz,138,58,80,42.03
Anivia,Poppy,156,60,96,38.46
Anivia,Neeko,124,75,49,60.48
Anivia,Graves,97,72,25,74.23
Anivia,KSante,57,18,39,31.58
Anivia,Quinn,41,17,24,41.46
Anivia,Sion,208,93,115,44.71
Anivia,Swain,228,125,103,54.82
Anivia,Kindred,131,46,85,35.11
Anivia,Viktor,144,91,53,63.19
Anivia,Amumu,185,81,104,43.78
Anivia,Nami,179,81,98,45.25
Anivia,Nilah,81,35,46,43.21
Anivia,Nocturne,143,65,78,45.45
Anivia,Lissandra,60,35,25,58.33
Anivia,Vex,127,57,70,44.88
Anivia,Bard,63,18,45,28.57
Anivia,Azir,71,24,47,33.8
Anivia,Sona,67,24,43,35.82
Anivia,MasterYi,188,89,99,47.34
Anivia,Gangplank,90,52,38,57.78
Anivia,Skarner,54,23,31,42.59
Anivia,Vayne,196,116,80,59.18
Anivia,Sivir,113,39,74,34.51
Anivia,Braum,95,38,57,40
Anivia,Twitch,114,49,65,42.98
Anivia,Kalista,74,42,32,56.76
Anivia,Fiora,51,26,25,50.98
Anivia,Annie,56,39,17,69.64
Anivia,Zilean,24,6,18,25
Anivia,Sejuani,59,31,28,52.54
Anivia,TwistedFate,51,15,36,29.41
Anivia,Taric,51,39,12,76.47
Anivia,DrMundo,126,61,65,48.41
Anivia,Rammus,36,16,20,44.44
Anivia,Blitzcrank,104,39,65,37.5
Anivia,Hecarim,39,9,30,23.08
Anivia,Udyr,74,39,35,52.7
Anivia,Lulu,108,53,55,49.07
Anivia,JarvanIV,91,49,42,53.85
Anivia,Singed,43,26,17,60.47
Anivia,KogMaw,72,33,39,45.83
Anivia,Zeri,81,44,37,54.32
Anivia,Karthus,53,24,29,45.28
Anivia,Ryze,59,20,39,33.9
Anivia,Xerath,140,77,63,55
Anivia,Ziggs,71,27,44,38.03
Anivia,Jayce,95,46,49,48.42
Anivia,Rumble,29,13,16,44.83
Anivia,Gnar,109,59,50,54.13
Anivia,Elise,100,64,36,64
Anivia,Renekton,82,33,49,40.24
Anivia,Kassadin,67,29,38,43.28
Anivia,Maokai,65,43,22,66.15
Anivia,Corki,42,29,13,69.05
Anivia,Nidalee,40,34,6,85
Anivia,Olaf,30,20,10,66.67
Anivia,Taliyah,48,23,25,47.92
Anivia,Ivern,36,8,28,22.22
Anivia,RekSai,26,16,10,61.54
Anivia,Renata,24,13,11,54.17
KSante,Mordekaiser,441,182,259,41.27
KSante,Vi,203,110,93,54.19
KSante,Azir,55,20,35,36.36
KSante,MissFortune,355,171,184,48.17
KSante,Nautilus,219,111,108,50.68
KSante,Volibear,278,112,166,40.29
KSante,LeeSin,311,127,184,40.84
KSante,Kayle,171,66,105,38.6
KSante,Ezreal,454,222,232,48.9
KSante,Morgana,272,131,141,48.16
KSante,Sett,384,155,229,40.36
KSante,Ambessa,186,87,99,46.77
KSante,Smolder,173,98,75,56.65
KSante,Swain,246,154,92,62.6
KSante,Malphite,188,93,95,49.47
KSante,FiddleSticks,78,23,55,29.49
KSante,Mel,506,247,259,48.81
KSante,Soraka,125,62,63,49.6
KSante,Heimerdinger,108,33,75,30.56
KSante,Warwick,269,132,137,49.07
KSante,Ashe,356,192,164,53.93
KSante,Pyke,233,119,114,51.07
KSante,Sion,178,64,114,35.96
KSante,MasterYi,163,69,94,42.33
KSante,AurelionSol,85,44,41,51.76
KSante,Nami,208,99,109,47.6
KSante,Shyvana,68,39,29,57.35
KSante,Fizz,100,45,55,45
KSante,Nilah,99,37,62,37.37
KSante,Naafiri,86,32,54,37.21
KSante,Lux,593,266,327,44.86
KSante,Aatrox,234,82,152,35.04
KSante,Briar,166,82,84,49.4
KSante,Elise,171,89,82,52.05
KSante,Chogath,261,112,149,42.91
KSante,Poppy,164,74,90,45.12
KSante,Irelia,243,107,136,44.03
KSante,Jhin,324,114,210,35.19
KSante,Leona,124,74,50,59.68
KSante,Aurora,183,78,105,42.62
KSante,Nocturne,185,92,93,49.73
KSante,Leblanc,129,80,49,62.02
KSante,Janna,92,33,59,35.87
KSante,Akali,267,102,165,38.2
KSante,Evelynn,107,45,62,42.06
KSante,Ahri,339,152,187,44.84
KSante,Velkoz,110,41,69,37.27
KSante,Tristana,189,79,110,41.8
KSante,Vayne,246,104,142,42.28
KSante,Zoe,75,45,30,60
KSante,Seraphine,276,109,167,39.49
KSante,Fiora,143,56,87,39.16
KSante,Shaco,305,147,158,48.2
KSante,Nunu,155,87,68,56.13
KSante,Pantheon,353,187,166,52.97
KSante,Yorick,154,58,96,37.66
KSante,Quinn,65,44,21,67.69
KSante,TahmKench,228,90,138,39.47
KSante,Gwen,179,96,83,53.63
KSante,Khazix,158,72,86,45.57
KSante,Katarina,220,88,132,40
KSante,Aphelios,189,73,116,38.62
KSante,Alistar,74,39,35,52.7
KSante,Garen,426,178,248,41.78
KSante,Diana,263,138,125,52.47
KSante,Ryze,71,22,49,30.99
KSante,Darius,466,196,270,42.06
KSante,Qiyana,52,22,30,42.31
KSante,Ziggs,90,43,47,47.78
KSante,JarvanIV,85,40,45,47.06
KSante,Ekko,162,82,80,50.62
KSante,Jinx,453,199,254,43.93
KSante,Hecarim,105,42,63,40
KSante,Vex,93,34,59,36.56
KSante,Veigar,220,64,156,29.09
KSante,Amumu,178,63,115,35.39
KSante,Samira,223,94,129,42.15
KSante,Kayn,358,163,195,45.53
KSante,Nasus,130,49,81,37.69
KSante,Xerath,166,91,75,54.82
KSante,Thresh,318,143,175,44.97
KSante,Vladimir,145,69,76,47.59
KSante,Caitlyn,567,252,315,44.44
KSante,Yone,375,161,214,42.93
KSante,Lillia,114,44,70,38.6
KSante,Draven,136,77,59,56.62
KSante,Blitzcrank,179,73,106,40.78
KSante,Renekton,78,49,29,62.82
KSante,Lucian,136,79,57,58.09
KSante,Viego,224,90,134,40.18
KSante,Viktor,142,67,75,47.18
KSante,Ornn,151,85,66,56.29
KSante,Sylas,251,163,88,64.94
KSante,Shen,154,73,81,47.4
KSante,Zed,199,97,102,48.74
KSante,Brand,135,38,97,28.15
KSante,Kaisa,274,127,147,46.35
KSante,Riven,85,58,27,68.24
KSante,Rengar,162,107,55,66.05
KSante,Syndra,149,47,102,31.54
KSante,Twitch,142,58,84,40.85
KSante,Kled,39,6,33,15.38
KSante,Gragas,160,94,66,58.75
KSante,Teemo,235,82,153,34.89
KSante,Orianna,52,19,33,36.54
KSante,Rell,137,73,64,53.28
KSante,Singed,53,21,32,39.62
KSante,DrMundo,130,58,72,44.62
KSante,Yasuo,405,214,191,52.84
KSante,Xayah,160,93,67,58.13
KSante,Trundle,138,41,97,29.71
KSante,Malzahar,168,66,102,39.29
KSante,Varus,211,123,88,58.29
KSante,Sona,70,16,54,22.86
KSante,Jax,94,46,48,48.94
KSante,Milio,137,59,78,43.07
KSante,Kassadin,61,27,34,44.26
KSante,Zyra,146,49,97,33.56
KSante,Camille,70,48,22,68.57
KSante,KogMaw,75,13,62,17.33
KSante,Yuumi,173,69,104,39.88
KSante,Senna,168,55,113,32.74
KSante,Gnar,72,24,48,33.33
KSante,Akshan,82,35,47,42.68
KSante,Urgot,79,42,37,53.16
KSante,Zac,107,36,71,33.64
KSante,Tryndamere,106,67,39,63.21
KSante,Karma,130,37,93,28.46
KSante,Rakan,104,73,31,70.19
KSante,Gangplank,73,38,35,52.05
KSante,Corki,56,21,35,37.5
KSante,Sejuani,72,39,33,54.17
KSante,Nidalee,43,25,18,58.14
KSante,Illaoi,54,23,31,42.59
KSante,Udyr,114,57,57,50
KSante,Taric,42,12,30,28.57
KSante,MonkeyKing,95,53,42,55.79
KSante,Braum,82,38,44,46.34
KSante,Galio,156,72,84,46.15
KSante,Ivern,52,16,36,30.77
KSante,Hwei,158,62,96,39.24
KSante,Renata,55,29,26,52.73
KSante,Cassiopeia,75,51,24,68
KSante,Kalista,117,58,59,49.57
KSante,Annie,59,20,39,33.9
KSante,Zeri,127,50,77,39.37
KSante,RekSai,50,22,28,44
KSante,Taliyah,60,35,25,58.33
KSante,Graves,151,81,70,53.64
KSante,Belveth,70,22,48,31.43
KSante,Anivia,57,39,18,68.42
KSante,XinZhao,139,59,80,42.45
KSante,Jayce,99,53,46,53.54
KSante,Maokai,133,51,82,38.35
KSante,Lulu,185,71,114,38.38
KSante,Kindred,123,57,66,46.34
KSante,TwistedFate,65,31,34,47.69
KSante,Neeko,119,62,57,52.1
KSante,Skarner,76,42,34,55.26
KSante,Rumble,46,26,20,56.52
KSante,Kennen,68,30,38,44.12
KSante,Zilean,64,16,48,25
KSante,Sivir,76,25,51,32.89
KSante,Bard,86,24,62,27.91
KSante,Rammus,55,20,35,36.36
KSante,Talon,124,41,83,33.06
KSante,Karthus,65,39,26,60
KSante,Lissandra,32,9,23,28.13
KSante,Olaf,29,10,19,34.48
Tryndamere,Mordekaiser,515,257,258,49.9
Tryndamere,Briar,317,154,163,48.58
Tryndamere,Zed,297,192,105,64.65
Tryndamere,Jinx,670,319,351,47.61
Tryndamere,Lulu,249,156,93,62.65
Tryndamere,Nasus,270,125,145,46.3
Tryndamere,MonkeyKing,170,84,86,49.41
Tryndamere,Zoe,159,95,64,59.75
Tryndamere,Xayah,229,109,120,47.6
Tryndamere,Zac,111,69,42,62.16
Tryndamere,Jayce,103,60,43,58.25
Tryndamere,Rengar,179,90,89,50.28
Tryndamere,Swain,351,134,217,38.18
Tryndamere,Ezreal,480,225,255,46.88
Tryndamere,Sona,173,40,133,23.12
Tryndamere,Teemo,466,201,265,43.13
Tryndamere,LeeSin,318,176,142,55.35
Tryndamere,Chogath,394,189,205,47.97
Tryndamere,Lucian,180,113,67,62.78
Tryndamere,Xerath,259,185,74,71.43
Tryndamere,Aatrox,287,130,157,45.3
Tryndamere,Twitch,296,165,131,55.74
Tryndamere,Veigar,410,218,192,53.17
Tryndamere,Milio,175,72,103,41.14
Tryndamere,Darius,723,355,368,49.1
Tryndamere,Aurora,371,214,157,57.68
Tryndamere,Brand,279,136,143,48.75
Tryndamere,Thresh,496,274,222,55.24
Tryndamere,FiddleSticks,167,81,86,48.5
Tryndamere,Viktor,200,101,99,50.5
Tryndamere,Pyke,398,204,194,51.26
Tryndamere,Gnar,160,84,76,52.5
Tryndamere,Jax,314,154,160,49.04
Tryndamere,Bard,143,62,81,43.36
Tryndamere,Yone,698,358,340,51.29
Tryndamere,Kayn,612,313,299,51.14
Tryndamere,Smolder,260,122,138,46.92
Tryndamere,Poppy,196,91,105,46.43
Tryndamere,Volibear,399,186,213,46.62
Tryndamere,Ivern,37,18,19,48.65
Tryndamere,Irelia,302,174,128,57.62
Tryndamere,Caitlyn,792,377,415,47.6
Tryndamere,Renekton,166,81,85,48.8
Tryndamere,Lillia,260,108,152,41.54
Tryndamere,Annie,124,54,70,43.55
Tryndamere,Kaisa,381,229,152,60.1
Tryndamere,Singed,92,36,56,39.13
Tryndamere,Garen,681,358,323,52.57
Tryndamere,KogMaw,125,64,61,51.2
Tryndamere,Lux,918,439,479,47.82
Tryndamere,RekSai,51,24,27,47.06
Tryndamere,Leona,222,95,127,42.79
Tryndamere,Akshan,123,57,66,46.34
Tryndamere,Aphelios,241,106,135,43.98
Tryndamere,Braum,195,97,98,49.74
Tryndamere,Warwick,624,270,354,43.27
Tryndamere,Yasuo,723,354,369,48.96
Tryndamere,Zilean,100,55,45,55
Tryndamere,Malphite,380,172,208,45.26
Tryndamere,Samira,318,186,132,58.49
Tryndamere,Blitzcrank,238,101,137,42.44
Tryndamere,Ekko,216,106,110,49.07
Tryndamere,Zeri,158,82,76,51.9
Tryndamere,Heimerdinger,213,77,136,36.15
Tryndamere,Udyr,147,72,75,48.98
Tryndamere,Akali,334,146,188,43.71
Tryndamere,MissFortune,806,361,445,44.79
Tryndamere,Gragas,218,109,109,50
Tryndamere,Fiora,170,125,45,73.53
Tryndamere,Shaco,385,178,207,46.23
Tryndamere,Ahri,479,236,243,49.27
Tryndamere,Nami,271,141,130,52.03
Tryndamere,Jhin,662,329,333,49.7
Tryndamere,Urgot,165,73,92,44.24
Tryndamere,Gwen,222,101,121,45.5
Tryndamere,JarvanIV,130,52,78,40
Tryndamere,Hwei,325,127,198,39.08
Tryndamere,Rammus,86,33,53,38.37
Tryndamere,Seraphine,360,182,178,50.56
Tryndamere,Velkoz,248,119,129,47.98
Tryndamere,Vladimir,171,92,79,53.8
Tryndamere,Zyra,253,120,133,47.43
Tryndamere,Corki,128,70,58,54.69
Tryndamere,Ziggs,166,80,86,48.19
Tryndamere,Camille,156,91,65,58.33
Tryndamere,Varus,235,105,130,44.68
Tryndamere,Yorick,378,147,231,38.89
Tryndamere,Nunu,315,114,201,36.19
Tryndamere,Nidalee,86,48,38,55.81
Tryndamere,MasterYi,328,162,166,49.39
Tryndamere,Kassadin,90,39,51,43.33
Tryndamere,Tristana,352,189,163,53.69
Tryndamere,Trundle,249,132,117,53.01
Tryndamere,Rell,178,66,112,37.08
Tryndamere,Malzahar,275,88,187,32
Tryndamere,Morgana,505,226,279,44.75
Tryndamere,Graves,128,72,56,56.25
Tryndamere,Cassiopeia,139,71,68,51.08
Tryndamere,Ashe,649,334,315,51.46
Tryndamere,Karma,216,99,117,45.83
Tryndamere,Sett,526,248,278,47.15
Tryndamere,Nocturne,262,94,168,35.88
Tryndamere,Amumu,290,146,144,50.34
Tryndamere,Ryze,172,88,84,51.16
Tryndamere,Senna,296,146,150,49.32
Tryndamere,Mel,693,360,333,51.95
Tryndamere,Vi,286,139,147,48.6
Tryndamere,Shen,213,92,121,43.19
Tryndamere,Leblanc,127,74,53,58.27
Tryndamere,TahmKench,341,144,197,42.23
Tryndamere,Vayne,326,173,153,53.07
Tryndamere,Diana,492,243,249,49.39
Tryndamere,Qiyana,107,61,46,57.01
Tryndamere,Kindred,191,120,71,62.83
Tryndamere,Ambessa,282,111,171,39.36
Tryndamere,Vex,215,97,118,45.12
Tryndamere,Nautilus,388,177,211,45.62
Tryndamere,Gangplank,120,45,75,37.5
Tryndamere,Riven,154,82,72,53.25
Tryndamere,Katarina,206,86,120,41.75
Tryndamere,Orianna,149,76,73,51.01
Tryndamere,Skarner,109,59,50,54.13
Tryndamere,Sylas,299,172,127,57.53
Tryndamere,Janna,81,53,28,65.43
Tryndamere,KSante,106,39,67,36.79
Tryndamere,Yuumi,317,163,154,51.42
Tryndamere,Sejuani,127,68,59,53.54
Tryndamere,Galio,221,89,132,40.27
Tryndamere,Soraka,212,91,121,42.92
Tryndamere,Karthus,83,35,48,42.17
Tryndamere,Pantheon,635,302,333,47.56
Tryndamere,Olaf,76,25,51,32.89
Tryndamere,Kayle,249,148,101,59.44
Tryndamere,Draven,186,125,61,67.2
Tryndamere,Fizz,234,152,82,64.96
Tryndamere,Viego,503,272,231,54.08
Tryndamere,Maokai,118,60,58,50.85
Tryndamere,Anivia,99,67,32,67.68
Tryndamere,Elise,183,93,90,50.82
Tryndamere,Naafiri,196,88,108,44.9
Tryndamere,Sion,340,143,197,42.06
Tryndamere,Nilah,307,107,200,34.85
Tryndamere,Hecarim,142,61,81,42.96
Tryndamere,Sivir,165,71,94,43.03
Tryndamere,Lissandra,63,20,43,31.75
Tryndamere,Neeko,261,159,102,60.92
Tryndamere,Taric,72,25,47,34.72
Tryndamere,Azir,116,37,79,31.9
Tryndamere,Talon,239,94,145,39.33
Tryndamere,Belveth,98,54,44,55.1
Tryndamere,DrMundo,191,76,115,39.79
Tryndamere,XinZhao,143,73,70,51.05
Tryndamere,Syndra,188,90,98,47.87
Tryndamere,TwistedFate,117,62,55,52.99
Tryndamere,Evelynn,174,104,70,59.77
Tryndamere,Quinn,171,109,62,63.74
Tryndamere,Alistar,69,47,22,68.12
Tryndamere,Kled,76,34,42,44.74
Tryndamere,Taliyah,104,56,48,53.85
Tryndamere,Rakan,210,132,78,62.86
Tryndamere,Ornn,174,85,89,48.85
Tryndamere,Illaoi,174,105,69,60.34
Tryndamere,Kennen,103,60,43,58.25
Tryndamere,AurelionSol,186,82,104,44.09
Tryndamere,Kalista,222,88,134,39.64
Tryndamere,Shyvana,75,22,53,29.33
Tryndamere,Rumble,28,15,13,53.57
Tryndamere,Khazix,215,100,115,46.51
Tryndamere,Renata,78,24,54,30.77
Janna,Mordekaiser,175,91,84,52
Janna,Briar,182,90,92,49.45
Janna,Zed,200,136,64,68
Janna,Jinx,394,222,172,56.35
Janna,Lillia,127,70,57,55.12
Janna,Aatrox,199,126,73,63.32
Janna,Darius,277,121,156,43.68
Janna,Aurora,210,96,114,45.71
Janna,Ezreal,304,171,133,56.25
Janna,Brand,111,60,51,54.05
Janna,Gwen,138,101,37,73.19
Janna,Nunu,138,54,84,39.13
Janna,Caitlyn,364,153,211,42.03
Janna,Vladimir,90,48,42,53.33
Janna,Lux,469,219,250,46.7
Janna,Malphite,126,87,39,69.05
Janna,MonkeyKing,97,40,57,41.24
Janna,Sylas,167,106,61,63.47
Janna,Swain,194,112,82,57.73
Janna,Senna,134,94,40,70.15
Janna,Gangplank,113,52,61,46.02
Janna,Chogath,295,145,150,49.15
Janna,Galio,130,60,70,46.15
Janna,MissFortune,348,156,192,44.83
Janna,Soraka,118,56,62,47.46
Janna,KSante,92,59,33,64.13
Janna,FiddleSticks,129,57,72,44.19
Janna,Ahri,224,117,107,52.23
Janna,Blitzcrank,162,71,91,43.83
Janna,Gragas,158,101,57,63.92
Janna,Veigar,179,79,100,44.13
Janna,Kalista,87,46,41,52.87
Janna,Zyra,129,73,56,56.59
Janna,Renekton,91,37,54,40.66
Janna,Kayn,296,171,125,57.77
Janna,Leblanc,86,57,29,66.28
Janna,Mel,377,212,165,56.23
Janna,Fiora,105,68,37,64.76
Janna,Evelynn,72,41,31,56.94
Janna,Tristana,186,116,70,62.37
Janna,Ambessa,102,67,35,65.69
Janna,Elise,203,104,99,51.23
Janna,Shen,106,29,77,27.36
Janna,Kaisa,293,165,128,56.31
Janna,MasterYi,203,106,97,52.22
Janna,Ashe,342,175,167,51.17
Janna,Kennen,88,49,39,55.68
Janna,Shaco,142,69,73,48.59
Janna,Twitch,138,57,81,41.3
Janna,Yuumi,195,113,82,57.95
Janna,Akali,199,119,80,59.8
Janna,Khazix,131,70,61,53.44
Janna,Irelia,161,64,97,39.75
Janna,Yorick,176,64,112,36.36
Janna,Vi,222,107,115,48.2
Janna,Katarina,150,72,78,48
Janna,Draven,75,32,43,42.67
Janna,Nautilus,236,101,135,42.8
Janna,Viego,219,93,126,42.47
Janna,Talon,146,96,50,65.75
Janna,Renata,39,20,19,51.28
Janna,Jayce,82,49,33,59.76
Janna,Neeko,138,72,66,52.17
Janna,Teemo,197,75,122,38.07
Janna,Yone,315,157,158,49.84
Janna,Corki,77,43,34,55.84
Janna,Nasus,105,48,57,45.71
Janna,Rengar,144,89,55,61.81
Janna,Yasuo,355,200,155,56.34
Janna,TahmKench,216,132,84,61.11
Janna,Warwick,265,130,135,49.06
Janna,Ekko,119,68,51,57.14
Janna,Seraphine,193,96,97,49.74
Janna,Sion,211,126,85,59.72
Janna,Xayah,124,68,56,54.84
Janna,Rakan,91,65,26,71.43
Janna,Nami,207,110,97,53.14
Janna,Jax,148,86,62,58.11
Janna,Amumu,152,96,56,63.16
Janna,LeeSin,199,116,83,58.29
Janna,Nocturne,129,70,59,54.26
Janna,Vayne,176,94,82,53.41
Janna,Milio,118,73,45,61.86
Janna,Kayle,126,57,69,45.24
Janna,Ornn,67,39,28,58.21
Janna,Thresh,303,162,141,53.47
Janna,Qiyana,57,29,28,50.88
Janna,Viktor,172,88,84,51.16
Janna,Xerath,110,53,57,48.18
Janna,Kindred,96,69,27,71.88
Janna,Varus,129,72,57,55.81
Janna,Morgana,231,106,125,45.89
Janna,Samira,193,86,107,44.56
Janna,Rell,157,97,60,61.78
Janna,Leona,176,49,127,27.84
Janna,Zac,87,37,50,42.53
Janna,Pyke,224,116,108,51.79
Janna,Diana,251,95,156,37.85
Janna,Tryndamere,81,28,53,34.57
Janna,Ziggs,70,38,32,54.29
Janna,JarvanIV,59,20,39,33.9
Janna,Karthus,57,31,26,54.39
Janna,Sett,245,102,143,41.63
Janna,Anivia,56,29,27,51.79
Janna,Karma,123,76,47,61.79
Janna,Garen,262,122,140,46.56
Janna,Zoe,120,78,42,65
Janna,Gnar,120,72,48,60
Janna,Jhin,331,195,136,58.91
Janna,Annie,46,18,28,39.13
Janna,Lucian,135,72,63,53.33
Janna,Udyr,57,42,15,73.68
Janna,Quinn,82,51,31,62.2
Janna,Pantheon,265,131,134,49.43
Janna,Hecarim,63,34,29,53.97
Janna,Lissandra,57,27,30,47.37
Janna,Maokai,92,35,57,38.04
Janna,DrMundo,72,20,52,27.78
Janna,Azir,56,31,25,55.36
Janna,Braum,73,34,39,46.58
Janna,Zeri,112,56,56,50
Janna,Aphelios,165,116,49,70.3
Janna,Lulu,203,124,79,61.08
Janna,Naafiri,83,40,43,48.19
Janna,Heimerdinger,88,35,53,39.77
Janna,Velkoz,86,36,50,41.86
Janna,Skarner,50,37,13,74
Janna,Orianna,101,49,52,48.51
Janna,Poppy,128,73,55,57.03
Janna,Fizz,93,52,41,55.91
Janna,Cassiopeia,44,23,21,52.27
Janna,Taliyah,76,60,16,78.95
Janna,Hwei,131,67,64,51.15
Janna,Smolder,127,61,66,48.03
Janna,Akshan,89,40,49,44.94
Janna,Graves,53,35,18,66.04
Janna,Zilean,73,30,43,41.1
Janna,Nidalee,24,15,9,62.5
Janna,Nilah,89,49,40,55.06
Janna,Bard,78,27,51,34.62
Janna,Vex,113,79,34,69.91
Janna,Belveth,57,31,26,54.39
Janna,Volibear,249,114,135,45.78
Janna,Trundle,98,58,40,59.18
Janna,RekSai,36,11,25,30.56
Janna,Ryze,114,54,60,47.37
Janna,Sejuani,43,25,18,58.14
Janna,Camille,119,53,66,44.54
Janna,Riven,90,64,26,71.11
Janna,Taric,41,7,34,17.07
Janna,TwistedFate,47,18,29,38.3
Janna,Malzahar,124,54,70,43.55
Janna,Kassadin,33,17,16,51.52
Janna,Sivir,108,43,65,39.81
Janna,Syndra,118,58,60,49.15
Janna,AurelionSol,67,22,45,32.84
Janna,Shyvana,44,28,16,63.64
Janna,Urgot,93,16,77,17.2
Janna,Sona,65,26,39,40
Janna,Alistar,58,24,34,41.38
Janna,Olaf,59,25,34,42.37
Janna,Rumble,42,27,15,64.29
Janna,Kled,40,34,6,85
Janna,Ivern,33,21,12,63.64
Janna,KogMaw,47,33,14,70.21
Janna,Singed,26,20,6,76.92
Janna,XinZhao,76,27,49,35.53
Janna,Illaoi,70,34,36,48.57
Janna,Rammus,46,25,21,54.35
Akshan,Darius,377,221,156,58.62
Akshan,Samira,269,174,95,64.68
Akshan,Karma,166,54,112,32.53
Akshan,Rammus,79,31,48,39.24
Akshan,Blitzcrank,176,105,71,59.66
Akshan,DrMundo,155,70,85,45.16
Akshan,Ivern,72,42,30,58.33
Akshan,Mordekaiser,322,184,138,57.14
Akshan,Nilah,111,39,72,35.14
Akshan,Yuumi,173,88,85,50.87
Akshan,Teemo,302,160,142,52.98
Akshan,Amumu,188,52,136,27.66
Akshan,Garen,392,156,236,39.8
Akshan,KogMaw,112,47,65,41.96
Akshan,Heimerdinger,192,94,98,48.96
Akshan,Vi,212,92,120,43.4
Akshan,Ahri,318,149,169,46.86
Akshan,Maokai,126,61,65,48.41
Akshan,Kennen,70,33,37,47.14
Akshan,XinZhao,89,42,47,47.19
Akshan,Akali,255,175,80,68.63
Akshan,Kaisa,321,166,155,51.71
Akshan,Caitlyn,536,293,243,54.66
Akshan,Evelynn,94,52,42,55.32
Akshan,Sylas,185,107,78,57.84
Akshan,Ezreal,294,151,143,51.36
Akshan,Seraphine,251,137,114,54.58
Akshan,Yasuo,392,206,186,52.55
Akshan,Yone,448,234,214,52.23
Akshan,Thresh,326,233,93,71.47
Akshan,Tryndamere,123,66,57,53.66
Akshan,MasterYi,192,87,105,45.31
Akshan,Orianna,112,66,46,58.93
Akshan,Tristana,174,87,87,50
Akshan,Lux,627,268,359,42.74
Akshan,TahmKench,252,138,114,54.76
Akshan,Nocturne,165,118,47,71.52
Akshan,Taric,49,20,29,40.82
Akshan,Sett,289,127,162,43.94
Akshan,Elise,200,72,128,36
Akshan,Katarina,185,99,86,53.51
Akshan,MissFortune,477,259,218,54.3
Akshan,Morgana,338,193,145,57.1
Akshan,Udyr,112,36,76,32.14
Akshan,Lulu,212,120,92,56.6
Akshan,Sejuani,94,64,30,68.09
Akshan,Jinx,478,261,217,54.6
Akshan,Nautilus,225,117,108,52
Akshan,Warwick,339,135,204,39.82
Akshan,Gangplank,124,60,64,48.39
Akshan,Poppy,186,108,78,58.06
Akshan,Riven,80,39,41,48.75
Akshan,Malzahar,214,118,96,55.14
Akshan,Bard,75,25,50,33.33
Akshan,Nunu,242,128,114,52.89
Akshan,Viktor,167,74,93,44.31
Akshan,Lucian,140,37,103,26.43
Akshan,Malphite,213,96,117,45.07
Akshan,Volibear,300,183,117,61
Akshan,Aurora,257,141,116,54.86
Akshan,Kayn,336,231,105,68.75
Akshan,Smolder,152,105,47,69.08
Akshan,Alistar,79,28,51,35.44
Akshan,Shaco,176,105,71,59.66
Akshan,Mel,492,253,239,51.42
Akshan,Milio,133,62,71,46.62
Akshan,Ryze,69,30,39,43.48
Akshan,Twitch,253,153,100,60.47
Akshan,Olaf,40,10,30,25
Akshan,Lillia,178,89,89,50
Akshan,Viego,312,180,132,57.69
Akshan,Vladimir,157,68,89,43.31
Akshan,Nami,194,78,116,40.21
Akshan,Rengar,71,35,36,49.3
Akshan,Rell,116,69,47,59.48
Akshan,Jax,186,87,99,46.77
Akshan,Zed,165,72,93,43.64
Akshan,Ashe,389,232,157,59.64
Akshan,Talon,140,70,70,50
Akshan,Shen,169,93,76,55.03
Akshan,Veigar,274,113,161,41.24
Akshan,Singed,53,21,32,39.62
Akshan,Jhin,425,192,233,45.18
Akshan,Zyra,93,50,43,53.76
Akshan,Hecarim,132,70,62,53.03
Akshan,Syndra,75,42,33,56
Akshan,Kindred,90,31,59,34.44
Akshan,Taliyah,51,27,24,52.94
Akshan,Draven,174,90,84,51.72
Akshan,Xerath,125,79,46,63.2
Akshan,Zeri,119,68,51,57.14
Akshan,Pyke,242,159,83,65.7
Akshan,Ziggs,89,50,39,56.18
Akshan,Hwei,195,142,53,72.82
Akshan,Gwen,165,82,83,49.7
Akshan,Gragas,153,93,60,60.78
Akshan,Kalista,90,51,39,56.67
Akshan,Diana,264,133,131,50.38
Akshan,Cassiopeia,105,56,49,53.33
Akshan,Nasus,159,95,64,59.75
Akshan,KSante,82,47,35,57.32
Akshan,Fizz,111,50,61,45.05
Akshan,Graves,126,76,50,60.32
Akshan,Annie,77,27,50,35.06
Akshan,Anivia,117,57,60,48.72
Akshan,FiddleSticks,121,49,72,40.5
Akshan,Xayah,209,92,117,44.02
Akshan,Aatrox,167,103,64,61.68
Akshan,Kayle,216,127,89,58.8
Akshan,Varus,131,51,80,38.93
Akshan,Velkoz,129,61,68,47.29
Akshan,Sion,181,79,102,43.65
Akshan,JarvanIV,77,39,38,50.65
Akshan,Illaoi,127,76,51,59.84
Akshan,Neeko,180,118,62,65.56
Akshan,Swain,248,126,122,50.81
Akshan,Urgot,110,54,56,49.09
Akshan,LeeSin,192,119,73,61.98
Akshan,Vayne,212,103,109,48.58
Akshan,Shyvana,52,37,15,71.15
Akshan,Galio,151,66,85,43.71
Akshan,Trundle,175,65,110,37.14
Akshan,TwistedFate,97,63,34,64.95
Akshan,Yorick,247,93,154,37.65
Akshan,Irelia,240,111,129,46.25
Akshan,Brand,159,81,78,50.94
Akshan,Kassadin,26,16,10,61.54
Akshan,Rakan,178,82,96,46.07
Akshan,Fiora,131,76,55,58.02
Akshan,Vex,129,54,75,41.86
Akshan,Camille,124,72,52,58.06
Akshan,Senna,249,89,160,35.74
Akshan,RekSai,39,25,14,64.1
Akshan,Renata,86,35,51,40.7
Akshan,Zac,56,27,29,48.21
Akshan,Quinn,83,55,28,66.27
Akshan,MonkeyKing,99,36,63,36.36
Akshan,Qiyana,55,37,18,67.27
Akshan,AurelionSol,100,51,49,51
Akshan,Ambessa,173,87,86,50.29
Akshan,Sona,69,51,18,73.91
Akshan,Leblanc,94,62,32,65.96
Akshan,Briar,230,111,119,48.26
Akshan,Leona,156,69,87,44.23
Akshan,Skarner,115,75,40,65.22
Akshan,Sivir,116,89,27,76.72
Akshan,Soraka,137,70,67,51.09
Akshan,Nidalee,94,49,45,52.13
Akshan,Aphelios,159,90,69,56.6
Akshan,Naafiri,131,55,76,41.98
Akshan,Ekko,162,94,68,58.02
Akshan,Renekton,117,55,62,47.01
Akshan,Corki,57,34,23,59.65
Akshan,Zoe,132,84,48,63.64
Akshan,Chogath,323,209,114,64.71
Akshan,Ornn,95,30,65,31.58
Akshan,Karthus,52,21,31,40.38
Akshan,Pantheon,386,215,171,55.7
Akshan,Janna,89,49,40,55.06
Akshan,Kled,65,39,26,60
Akshan,Azir,75,41,34,54.67
Akshan,Lissandra,42,18,24,42.86
Akshan,Braum,77,31,46,40.26
Akshan,Khazix,115,69,46,60
Akshan,Zilean,62,23,39,37.1
Akshan,Rumble,31,3,28,9.68
Akshan,Jayce,85,35,50,41.18
Akshan,Belveth,95,32,63,33.68
Akshan,Gnar,68,36,32,52.94
Zilean,Chogath,208,109,99,52.4
Zilean,Morgana,206,134,72,65.05
Zilean,Yasuo,319,157,162,49.22
Zilean,Jhin,352,169,183,48.01
Zilean,Mel,422,170,252,40.28
Zilean,Malphite,177,96,81,54.24
Zilean,Sett,293,127,166,43.34
Zilean,Sion,132,40,92,30.3
Zilean,Samira,157,96,61,61.15
Zilean,Alistar,62,39,23,62.9
Zilean,Poppy,91,41,50,45.05
Zilean,Khazix,133,60,73,45.11
Zilean,Irelia,165,72,93,43.64
Zilean,Tristana,127,46,81,36.22
Zilean,Neeko,109,60,49,55.05
Zilean,Jax,174,98,76,56.32
Zilean,Rammus,63,35,28,55.56
Zilean,Lux,465,202,263,43.44
Zilean,Caitlyn,382,202,180,52.88
Zilean,Nami,162,96,66,59.26
Zilean,Yone,302,141,161,46.69
Zilean,Sylas,173,85,88,49.13
Zilean,Viktor,91,43,48,47.25
Zilean,Pyke,166,95,71,57.23
Zilean,Akali,124,56,68,45.16
Zilean,Warwick,195,92,103,47.18
Zilean,Aurora,181,100,81,55.25
Zilean,Xayah,86,52,34,60.47
Zilean,Nautilus,161,96,65,59.63
Zilean,Teemo,218,103,115,47.25
Zilean,Vi,134,89,45,66.42
Zilean,Bard,41,22,19,53.66
Zilean,Fiora,75,32,43,42.67
Zilean,Sejuani,82,16,66,19.51
Zilean,Ashe,247,117,130,47.37
Zilean,Tryndamere,100,45,55,45
Zilean,Nocturne,221,87,134,39.37
Zilean,Seraphine,163,97,66,59.51
Zilean,Mordekaiser,279,105,174,37.63
Zilean,Galio,121,72,49,59.5
Zilean,Kayn,280,146,134,52.14
Zilean,Varus,158,62,96,39.24
Zilean,Blitzcrank,137,91,46,66.42
Zilean,Aatrox,197,103,94,52.28
Zilean,Kindred,120,78,42,65
Zilean,Swain,175,96,79,54.86
Zilean,Pantheon,259,136,123,52.51
Zilean,Nilah,48,19,29,39.58
Zilean,Naafiri,69,25,44,36.23
Zilean,Draven,87,60,27,68.97
Zilean,Veigar,192,102,90,53.13
Zilean,Nasus,112,46,66,41.07
Zilean,Fizz,78,41,37,52.56
Zilean,Darius,365,186,179,50.96
Zilean,MasterYi,155,61,94,39.35
Zilean,Kassadin,21,8,13,38.1
Zilean,Rell,118,59,59,50
Zilean,Yorick,142,70,72,49.3
Zilean,Lillia,112,59,53,52.68
Zilean,Trundle,54,17,37,31.48
Zilean,Vayne,121,59,62,48.76
Zilean,Thresh,261,122,139,46.74
Zilean,Riven,84,38,46,45.24
Zilean,Singed,50,12,38,24
Zilean,Kennen,64,44,20,68.75
Zilean,Ekko,144,70,74,48.61
Zilean,Lucian,129,64,65,49.61
Zilean,Ambessa,86,57,29,66.28
Zilean,Qiyana,78,54,24,69.23
Zilean,Aphelios,110,56,54,50.91
Zilean,Velkoz,198,99,99,50
Zilean,Renekton,74,23,51,31.08
Zilean,Gwen,81,34,47,41.98
Zilean,Ornn,94,42,52,44.68
Zilean,MissFortune,314,129,185,41.08
Zilean,Rakan,73,32,41,43.84
Zilean,Ahri,237,126,111,53.16
Zilean,Jinx,363,182,181,50.14
Zilean,Soraka,114,43,71,37.72
Zilean,Zed,196,122,74,62.24
Zilean,Gangplank,60,28,32,46.67
Zilean,Quinn,53,38,15,71.7
Zilean,Viego,197,69,128,35.03
Zilean,Katarina,92,42,50,45.65
Zilean,Xerath,97,54,43,55.67
Zilean,Graves,85,42,43,49.41
Zilean,Diana,211,94,117,44.55
Zilean,Ezreal,277,144,133,51.99
Zilean,Ziggs,56,28,28,50
Zilean,Malzahar,146,45,101,30.82
Zilean,Renata,44,23,21,52.27
Zilean,DrMundo,102,61,41,59.8
Zilean,Orianna,72,44,28,61.11
Zilean,Skarner,49,11,38,22.45
Zilean,Yuumi,96,45,51,46.88
Zilean,Lulu,156,79,77,50.64
Zilean,Belveth,57,32,25,56.14
Zilean,Leona,150,63,87,42
Zilean,Gragas,108,73,35,67.59
Zilean,Rengar,72,46,26,63.89
Zilean,Illaoi,84,43,41,51.19
Zilean,Kaisa,212,133,79,62.74
Zilean,Corki,80,38,42,47.5
Zilean,Garen,228,118,110,51.75
Zilean,Amumu,145,68,77,46.9
Zilean,Heimerdinger,94,47,47,50
Zilean,Twitch,155,74,81,47.74
Zilean,Camille,54,39,15,72.22
Zilean,Zoe,100,74,26,74
Zilean,Talon,94,41,53,43.62
Zilean,Cassiopeia,33,20,13,60.61
Zilean,LeeSin,146,84,62,57.53
Zilean,Volibear,169,89,80,52.66
Zilean,Briar,178,88,90,49.44
Zilean,Zeri,57,39,18,68.42
Zilean,Senna,125,38,87,30.4
Zilean,MonkeyKing,80,33,47,41.25
Zilean,Shen,134,37,97,27.61
Zilean,Evelynn,81,42,39,51.85
Zilean,Karthus,77,44,33,57.14
Zilean,Anivia,24,18,6,75
Zilean,Azir,51,17,34,33.33
Zilean,Shaco,123,77,46,62.6
Zilean,Milio,117,51,66,43.59
Zilean,Hecarim,55,36,19,65.45
Zilean,AurelionSol,64,28,36,43.75
Zilean,Nunu,157,56,101,35.67
Zilean,Elise,94,46,48,48.94
Zilean,Vladimir,80,26,54,32.5
Zilean,Urgot,98,49,49,50
Zilean,Braum,71,35,36,49.3
Zilean,Smolder,150,74,76,49.33
Zilean,Udyr,78,50,28,64.1
Zilean,Gnar,57,34,23,59.65
Zilean,Janna,73,43,30,58.9
Zilean,JarvanIV,49,18,31,36.73
Zilean,FiddleSticks,62,37,25,59.68
Zilean,Vex,87,34,53,39.08
Zilean,Lissandra,44,22,22,50
Zilean,Kayle,113,53,60,46.9
Zilean,Akshan,62,39,23,62.9
Zilean,Shyvana,44,41,3,93.18
Zilean,Karma,109,63,46,57.8
Zilean,Sona,71,42,29,59.15
Zilean,Taliyah,84,34,50,40.48
Zilean,Kalista,108,53,55,49.07
Zilean,KSante,64,48,16,75
Zilean,Zyra,98,38,60,38.78
Zilean,TahmKench,177,71,106,40.11
Zilean,Hwei,96,50,46,52.08
Zilean,Maokai,71,43,28,60.56
Zilean,RekSai,15,7,8,46.67
Zilean,Sivir,107,53,54,49.53
Zilean,Jayce,71,37,34,52.11
Zilean,Syndra,96,63,33,65.63
Zilean,Brand,146,84,62,57.53
Zilean,Zac,59,28,31,47.46
Zilean,KogMaw,51,19,32,37.25
Zilean,XinZhao,70,37,33,52.86
Zilean,Ryze,52,25,27,48.08
Zilean,Kled,56,35,21,62.5
Zilean,Rumble,40,14,26,35
Zilean,Nidalee,45,16,29,35.56
Zilean,Leblanc,52,28,24,53.85
Zilean,Olaf,26,16,10,61.54
Zilean,Ivern,27,24,3,88.89
Zilean,TwistedFate,33,16,17,48.48
Zilean,Annie,32,17,15,53.13
Zilean,Taric,6,3,3,50
Olaf,Chogath,188,94,94,50
Olaf,Graves,75,39,36,52
Olaf,Leblanc,45,21,24,46.67
Olaf,Caitlyn,226,124,102,54.87
Olaf,Milio,96,51,45,53.13
Olaf,Trundle,86,42,44,48.84
Olaf,Amumu,174,58,116,33.33
Olaf,Fizz,54,23,31,42.59
Olaf,Kaisa,222,104,118,46.85
Olaf,Pantheon,223,127,96,56.95
Olaf,Gangplank,47,25,22,53.19
Olaf,Warwick,237,116,121,48.95
Olaf,Malzahar,112,54,58,48.21
Olaf,Tristana,123,60,63,48.78
Olaf,Senna,120,42,78,35
Olaf,Darius,242,125,117,51.65
Olaf,Nami,125,63,62,50.4
Olaf,Rell,53,20,33,37.74
Olaf,Mordekaiser,287,142,145,49.48
Olaf,Viego,157,40,117,25.48
Olaf,Irelia,64,36,28,56.25
Olaf,Udyr,62,20,42,32.26
Olaf,Aatrox,76,44,32,57.89
Olaf,Kayn,174,79,95,45.4
Olaf,Lux,411,195,216,47.45
Olaf,Ezreal,195,95,100,48.72
Olaf,Varus,104,46,58,44.23
Olaf,Briar,134,68,66,50.75
Olaf,Mel,275,151,124,54.91
Olaf,Jinx,269,140,129,52.04
Olaf,Blitzcrank,122,49,73,40.16
Olaf,Fiora,26,5,21,19.23
Olaf,Shaco,142,58,84,40.85
Olaf,Nunu,107,48,59,44.86
Olaf,Nilah,72,35,37,48.61
Olaf,Heimerdinger,115,72,43,62.61
Olaf,Evelynn,39,21,18,53.85
Olaf,Zoe,48,22,26,45.83
Olaf,Jax,148,53,95,35.81
Olaf,Yasuo,295,168,127,56.95
Olaf,Rengar,43,22,21,51.16
Olaf,Ivern,20,17,3,85
Olaf,Cassiopeia,71,43,28,60.56
Olaf,LeeSin,137,78,59,56.93
Olaf,Katarina,120,68,52,56.67
Olaf,MissFortune,275,110,165,40
Olaf,Karma,63,15,48,23.81
Olaf,Yone,302,141,161,46.69
Olaf,Lulu,104,43,61,41.35
Olaf,Singed,42,3,39,7.14
Olaf,MonkeyKing,59,31,28,52.54
Olaf,Diana,134,56,78,41.79
Olaf,Volibear,156,71,85,45.51
Olaf,Talon,53,33,20,62.26
Olaf,Neeko,125,65,60,52
Olaf,Vladimir,67,27,40,40.3
Olaf,Akshan,40,30,10,75
Olaf,Pyke,134,73,61,54.48
Olaf,Ziggs,52,23,29,44.23
Olaf,Gragas,84,54,30,64.29
Olaf,Yuumi,128,44,84,34.38
Olaf,Camille,16,10,6,62.5
Olaf,Lillia,121,71,50,58.68
Olaf,Teemo,228,80,148,35.09
Olaf,Renekton,64,32,32,50
Olaf,TahmKench,193,86,107,44.56
Olaf,Kindred,116,72,44,62.07
Olaf,Ashe,204,91,113,44.61
Olaf,Vex,72,51,21,70.83
Olaf,Aphelios,111,57,54,51.35
Olaf,Soraka,86,37,49,43.02
Olaf,Ornn,81,48,33,59.26
Olaf,Draven,69,30,39,43.48
Olaf,Sett,225,93,132,41.33
Olaf,Thresh,154,101,53,65.58
Olaf,MasterYi,105,42,63,40
Olaf,Galio,101,68,33,67.33
Olaf,Swain,158,86,72,54.43
Olaf,Lucian,70,48,22,68.57
Olaf,Nasus,114,60,54,52.63
Olaf,Kayle,94,32,62,34.04
Olaf,Akali,141,69,72,48.94
Olaf,Samira,74,34,40,45.95
Olaf,Renata,29,20,9,68.97
Olaf,Sejuani,15,9,6,60
Olaf,Ryze,40,20,20,50
Olaf,Velkoz,53,25,28,47.17
Olaf,Tryndamere,76,51,25,67.11
Olaf,Nautilus,195,119,76,61.03
Olaf,Nidalee,45,34,11,75.56
Olaf,Zed,105,63,42,60
Olaf,Veigar,128,60,68,46.88
Olaf,Vayne,106,52,54,49.06
Olaf,Jhin,224,131,93,58.48
Olaf,Aurora,122,80,42,65.57
Olaf,Corki,53,25,28,47.17
Olaf,Zyra,159,85,74,53.46
Olaf,Garen,182,70,112,38.46
Olaf,Braum,58,25,33,43.1
Olaf,Ekko,121,44,77,36.36
Olaf,Rakan,74,20,54,27.03
Olaf,Bard,43,29,14,67.44
Olaf,JarvanIV,15,6,9,40
Olaf,Elise,73,40,33,54.79
Olaf,FiddleSticks,68,46,22,67.65
Olaf,Azir,32,13,19,40.63
Olaf,KogMaw,32,10,22,31.25
Olaf,Hecarim,44,19,25,43.18
Olaf,Ahri,216,116,100,53.7
Olaf,Xerath,82,29,53,35.37
Olaf,TwistedFate,29,17,12,58.62
Olaf,Seraphine,133,68,65,51.13
Olaf,DrMundo,73,26,47,35.62
Olaf,Twitch,112,46,66,41.07
Olaf,Yorick,86,42,44,48.84
Olaf,Vi,92,39,53,42.39
Olaf,Morgana,171,107,64,62.57
Olaf,Sivir,58,32,26,55.17
Olaf,Karthus,18,12,6,66.67
Olaf,Sona,45,9,36,20
Olaf,Syndra,62,25,37,40.32
Olaf,Quinn,65,18,47,27.69
Olaf,Nocturne,119,46,73,38.66
Olaf,XinZhao,81,21,60,25.93
Olaf,Urgot,49,27,22,55.1
Olaf,Xayah,74,37,37,50
Olaf,Qiyana,50,22,28,44
Olaf,Kled,22,0,22,0
Olaf,Maokai,65,34,31,52.31
Olaf,Leona,67,33,34,49.25
Olaf,Gnar,51,20,31,39.22
Olaf,Sylas,116,69,47,59.48
Olaf,Malphite,126,72,54,57.14
Olaf,Lissandra,50,25,25,50
Olaf,Riven,54,27,27,50
Olaf,Zac,54,25,29,46.3
Olaf,Naafiri,44,15,29,34.09
Olaf,Khazix,66,41,25,62.12
Olaf,Smolder,105,61,44,58.1
Olaf,Orianna,57,21,36,36.84
Olaf,Hwei,113,61,52,53.98
Olaf,Kalista,69,45,24,65.22
Olaf,Jayce,67,35,32,52.24
Olaf,Annie,30,20,10,66.67
Olaf,Illaoi,67,33,34,49.25
Olaf,Viktor,79,50,29,63.29
Olaf,Ambessa,68,25,43,36.76
Olaf,Rumble,23,10,13,43.48
Olaf,Poppy,72,42,30,58.33
Olaf,Sion,67,22,45,32.84
Olaf,Gwen,72,29,43,40.28
Olaf,Brand,68,30,38,44.12
Olaf,Belveth,35,15,20,42.86
Olaf,Shen,123,72,51,58.54
Olaf,Taliyah,48,18,30,37.5
Olaf,Alistar,27,17,10,62.96
Olaf,Rammus,46,24,22,52.17
Olaf,AurelionSol,72,34,38,47.22
Olaf,Kennen,52,40,12,76.92
Olaf,Skarner,48,28,20,58.33
Olaf,Janna,59,34,25,57.63
Olaf,Taric,20,10,10,50
Olaf,Anivia,30,10,20,33.33
Olaf,Zilean,26,10,16,38.46
Olaf,KSante,29,19,10,65.52
Olaf,Zeri,68,29,39,42.65
Olaf,Shyvana,26,20,6,76.92
Olaf,Kassadin,20,12,8,60
Olaf,RekSai,6,3,3,50
Annie,Shen,69,29,40,42.03
Annie,Warwick,256,131,125,51.17
Annie,Diana,239,132,107,55.23
Annie,Samira,155,69,86,44.52
Annie,Soraka,137,62,75,45.26
Annie,Kennen,63,28,35,44.44
Annie,Skarner,77,32,45,41.56
Annie,Malzahar,112,38,74,33.93
Annie,Jinx,303,148,155,48.84
Annie,Yuumi,203,102,101,50.25
Annie,Tryndamere,124,70,54,56.45
Annie,Lux,519,251,268,48.36
Annie,Sivir,81,30,51,37.04
Annie,Aatrox,216,107,109,49.54
Annie,Kayn,248,111,137,44.76
Annie,Veigar,225,96,129,42.67
Annie,Jhin,351,174,177,49.57
Annie,Swain,218,92,126,42.2
Annie,Kled,31,25,6,80.65
Annie,Vi,120,47,73,39.17
Annie,Yasuo,419,206,213,49.16
Annie,Zeri,101,42,59,41.58
Annie,Neeko,134,70,64,52.24
Annie,TahmKench,213,107,106,50.23
Annie,Gragas,123,67,56,54.47
Annie,Mel,362,173,189,47.79
Annie,Gangplank,91,36,55,39.56
Annie,Sett,351,124,227,35.33
Annie,Viktor,98,42,56,42.86
Annie,Caitlyn,410,218,192,53.17
Annie,Lulu,158,68,90,43.04
Annie,Yorick,161,71,90,44.1
Annie,Ekko,112,63,49,56.25
Annie,Yone,291,118,173,40.55
Annie,Thresh,185,108,77,58.38
Annie,Ivern,54,17,37,31.48
Annie,Katarina,209,105,104,50.24
Annie,Xayah,133,62,71,46.62
Annie,Garen,219,102,117,46.58
Annie,Sion,136,85,51,62.5
Annie,Akali,179,102,77,56.98
Annie,Ezreal,277,136,141,49.1
Annie,Varus,179,97,82,54.19
Annie,Viego,220,120,100,54.55
Annie,Fiora,76,32,44,42.11
Annie,Irelia,105,48,57,45.71
Annie,MasterYi,221,104,117,47.06
Annie,MissFortune,301,119,182,39.53
Annie,Shaco,160,43,117,26.88
Annie,Rengar,78,62,16,79.49
Annie,Zed,167,97,70,58.08
Annie,Ashe,380,164,216,43.16
Annie,Ambessa,107,58,49,54.21
Annie,Jax,168,74,94,44.05
Annie,Draven,127,58,69,45.67
Annie,Darius,263,131,132,49.81
Annie,Sylas,111,58,53,52.25
Annie,Nidalee,26,19,7,73.08
Annie,Vex,117,73,44,62.39
Annie,Velkoz,75,28,47,37.33
Annie,Mordekaiser,228,80,148,35.09
Annie,Amumu,230,111,119,48.26
Annie,Kaisa,252,133,119,52.78
Annie,Pyke,156,82,74,52.56
Annie,Kassadin,11,3,8,27.27
Annie,Galio,115,25,90,21.74
Annie,Poppy,108,62,46,57.41
Annie,Azir,68,39,29,57.35
Annie,Riven,112,68,44,60.71
Annie,Briar,156,34,122,21.79
Annie,Gnar,95,32,63,33.68
Annie,Teemo,278,114,164,41.01
Annie,Morgana,287,127,160,44.25
Annie,Aphelios,137,72,65,52.55
Annie,Pantheon,244,128,116,52.46
Annie,Braum,79,44,35,55.7
Annie,Cassiopeia,64,35,29,54.69
Annie,Maokai,60,31,29,51.67
Annie,Kayle,130,68,62,52.31
Annie,LeeSin,162,110,52,67.9
Annie,Nilah,108,44,64,40.74
Annie,Rell,133,59,74,44.36
Annie,Renekton,85,28,57,32.94
Annie,RekSai,45,22,23,48.89
Annie,Ziggs,89,42,47,47.19
Annie,Kindred,87,49,38,56.32
Annie,Lillia,143,72,71,50.35
Annie,Fizz,105,22,83,20.95
Annie,Corki,49,27,22,55.1
Annie,Bard,62,15,47,24.19
Annie,Ornn,91,58,33,63.74
Annie,Belveth,35,18,17,51.43
Annie,Taliyah,54,38,16,70.37
Annie,Camille,67,30,37,44.78
Annie,Gwen,97,39,58,40.21
Annie,Nasus,161,93,68,57.76
Annie,Akshan,77,50,27,64.94
Annie,Aurora,159,98,61,61.64
Annie,Evelynn,104,44,60,42.31
Annie,Malphite,116,73,43,62.93
Annie,Xerath,140,62,78,44.29
Annie,Seraphine,148,79,69,53.38
Annie,Nautilus,181,82,99,45.3
Annie,Illaoi,86,42,44,48.84
Annie,Nocturne,121,33,88,27.27
Annie,Ryze,46,27,19,58.7
Annie,Sona,66,41,25,62.12
Annie,Twitch,71,31,40,43.66
Annie,Graves,92,54,38,58.7
Annie,Elise,83,52,31,62.65
Annie,Smolder,137,68,69,49.64
Annie,Karthus,42,23,19,54.76
Annie,Heimerdinger,74,24,50,32.43
Annie,Senna,134,54,80,40.3
Annie,Khazix,135,53,82,39.26
Annie,Qiyana,56,35,21,62.5
Annie,Janna,46,28,18,60.87
Annie,Vladimir,81,45,36,55.56
Annie,Nami,163,63,100,38.65
Annie,Sejuani,74,39,35,52.7
Annie,MonkeyKing,67,41,26,61.19
Annie,Orianna,123,68,55,55.28
Annie,Taric,29,9,20,31.03
Annie,Quinn,49,12,37,24.49
Annie,Nunu,147,79,68,53.74
Annie,KSante,59,39,20,66.1
Annie,TwistedFate,98,45,53,45.92
Annie,KogMaw,56,31,25,55.36
Annie,Ahri,317,148,169,46.69
Annie,Talon,152,71,81,46.71
Annie,Tristana,170,75,95,44.12
Annie,Syndra,111,49,62,44.14
Annie,Chogath,231,95,136,41.13
Annie,Karma,100,57,43,57
Annie,Milio,137,31,106,22.63
Annie,Udyr,81,39,42,48.15
Annie,Volibear,193,66,127,34.2
Annie,Leblanc,46,27,19,58.7
Annie,Hwei,106,59,47,55.66
Annie,Zac,60,12,48,20
Annie,Blitzcrank,121,54,67,44.63
Annie,DrMundo,132,56,76,42.42
Annie,Brand,96,55,41,57.29
Annie,Vayne,176,115,61,65.34
Annie,Zyra,124,46,78,37.1
Annie,Hecarim,71,25,46,35.21
Annie,Anivia,56,17,39,30.36
Annie,Kalista,61,21,40,34.43
Annie,Shyvana,58,13,45,22.41
Annie,Alistar,69,53,16,76.81
Annie,Naafiri,115,63,52,54.78
Annie,FiddleSticks,104,50,54,48.08
Annie,Olaf,30,10,20,33.33
Annie,Jayce,67,22,45,32.84
Annie,Renata,43,33,10,76.74
Annie,Urgot,76,34,42,44.74
Annie,Leona,104,38,66,36.54
Annie,Singed,45,19,26,42.22
Annie,AurelionSol,93,25,68,26.88
Annie,Rakan,119,66,53,55.46
Annie,JarvanIV,73,24,49,32.88
Annie,Trundle,89,42,47,47.19
Annie,XinZhao,56,15,41,26.79
Annie,Lucian,84,48,36,57.14
Annie,Rammus,32,22,10,68.75
Annie,Rumble,10,10,0,100
Annie,Zoe,64,32,32,50
Annie,Lissandra,29,9,20,31.03
Annie,Zilean,32,15,17,46.88
Camille,Gwen,95,44,51,46.32
Camille,Kayn,334,140,194,41.92
Camille,Thresh,260,131,129,50.38
Camille,Ezreal,434,200,234,46.08
Camille,Yuumi,253,118,135,46.64
Camille,Sett,346,183,163,52.89
Camille,Ryze,80,29,51,36.25
Camille,Caitlyn,414,163,251,39.37
Camille,Lulu,158,76,82,48.1
Camille,Kalista,100,63,37,63
Camille,Gragas,148,96,52,64.86
Camille,Orianna,82,32,50,39.02
Camille,Gnar,57,33,24,57.89
Camille,Pyke,226,99,127,43.81
Camille,Aatrox,191,76,115,39.79
Camille,Chogath,202,102,100,50.5
Camille,Kaisa,234,86,148,36.75
Camille,Morgana,244,106,138,43.44
Camille,Garen,368,197,171,53.53
Camille,Rammus,90,52,38,57.78
Camille,Katarina,163,81,82,49.69
Camille,Milio,120,59,61,49.17
Camille,Shaco,200,122,78,61
Camille,Akali,204,94,110,46.08
Camille,Sivir,110,54,56,49.09
Camille,Renata,79,50,29,63.29
Camille,Renekton,93,46,47,49.46
Camille,Hecarim,60,37,23,61.67
Camille,Viktor,178,104,74,58.43
Camille,Jhin,423,184,239,43.5
Camille,Leblanc,100,39,61,39
Camille,LeeSin,203,111,92,54.68
Camille,TwistedFate,112,53,59,47.32
Camille,Zeri,119,54,65,45.38
Camille,Seraphine,184,97,87,52.72
Camille,Fiora,90,31,59,34.44
Camille,Nunu,192,98,94,51.04
Camille,Zed,200,99,101,49.5
Camille,Aphelios,158,79,79,50
Camille,Nami,182,82,100,45.05
Camille,Gangplank,93,31,62,33.33
Camille,Yone,316,165,151,52.22
Camille,Lux,534,255,279,47.75
Camille,Shen,176,71,105,40.34
Camille,Illaoi,101,43,58,42.57
Camille,Kindred,126,72,54,57.14
Camille,Talon,163,104,59,63.8
Camille,Varus,177,82,95,46.33
Camille,Mordekaiser,353,142,211,40.23
Camille,Sejuani,72,25,47,34.72
Camille,Yasuo,348,182,166,52.3
Camille,Velkoz,154,44,110,28.57
Camille,Darius,283,144,139,50.88
Camille,Warwick,324,147,177,45.37
Camille,Ashe,404,218,186,53.96
Camille,Nautilus,174,69,105,39.66
Camille,Tryndamere,156,65,91,41.67
Camille,Zac,75,37,38,49.33
Camille,Galio,135,53,82,39.26
Camille,MissFortune,346,145,201,41.91
Camille,Alistar,32,26,6,81.25
Camille,RekSai,19,0,19,0
Camille,Jax,180,73,107,40.56
Camille,Lucian,123,67,56,54.47
Camille,Riven,105,57,48,54.29
Camille,Khazix,124,69,55,55.65
Camille,Vex,92,34,58,36.96
Camille,Swain,215,54,161,25.12
Camille,Malzahar,114,56,58,49.12
Camille,Kled,27,18,9,66.67
Camille,Vi,193,97,96,50.26
Camille,Ahri,310,181,129,58.39
Camille,Aurora,222,113,109,50.9
Camille,Lissandra,20,6,14,30
Camille,Briar,234,111,123,47.44
Camille,Mel,468,234,234,50
Camille,Jinx,348,169,179,48.56
Camille,Pantheon,343,133,210,38.78
Camille,Twitch,198,76,122,38.38
Camille,Vladimir,138,52,86,37.68
Camille,Braum,100,63,37,63
Camille,Karma,142,63,79,44.37
Camille,Neeko,145,49,96,33.79
Camille,Volibear,290,124,166,42.76
Camille,Olaf,16,6,10,37.5
Camille,Diana,239,126,113,52.72
Camille,Yorick,191,38,153,19.9
Camille,Brand,130,57,73,43.85
Camille,FiddleSticks,104,56,48,53.85
Camille,Sylas,152,77,75,50.66
Camille,Poppy,144,64,80,44.44
Camille,Viego,161,70,91,43.48
Camille,Ziggs,79,27,52,34.18
Camille,Sona,63,12,51,19.05
Camille,Ekko,143,66,77,46.15
Camille,Vayne,186,75,111,40.32
Camille,TahmKench,239,129,110,53.97
Camille,Urgot,73,11,62,15.07
Camille,JarvanIV,98,32,66,32.65
Camille,Blitzcrank,147,63,84,42.86
Camille,Soraka,137,78,59,56.93
Camille,Shyvana,64,17,47,26.56
Camille,Senna,136,46,90,33.82
Camille,Trundle,84,35,49,41.67
Camille,Qiyana,81,41,40,50.62
Camille,Samira,170,88,82,51.76
Camille,Smolder,157,76,81,48.41
Camille,Tristana,164,79,85,48.17
Camille,Xerath,150,75,75,50
Camille,Malphite,127,67,60,52.76
Camille,Anivia,77,43,34,55.84
Camille,KSante,70,22,48,31.43
Camille,Zyra,85,40,45,47.06
Camille,Heimerdinger,83,27,56,32.53
Camille,Kayle,151,64,87,42.38
Camille,Amumu,162,59,103,36.42
Camille,Singed,64,37,27,57.81
Camille,Naafiri,102,44,58,43.14
Camille,MonkeyKing,93,30,63,32.26
Camille,Annie,67,37,30,55.22
Camille,Taliyah,68,43,25,63.24
Camille,Ivern,37,27,10,72.97
Camille,Kassadin,56,19,37,33.93
Camille,Irelia,160,112,48,70
Camille,Graves,105,52,53,49.52
Camille,Draven,89,35,54,39.33
Camille,Elise,146,60,86,41.1
Camille,Hwei,126,62,64,49.21
Camille,Rakan,85,26,59,30.59
Camille,Kennen,114,45,69,39.47
Camille,Maokai,43,30,13,69.77
Camille,Rengar,72,31,41,43.06
Camille,Cassiopeia,55,15,40,27.27
Camille,Belveth,41,16,25,39.02
Camille,KogMaw,75,52,23,69.33
Camille,Nocturne,173,48,125,27.75
Camille,Ambessa,143,92,51,64.34
Camille,Nasus,172,63,109,36.63
Camille,Bard,78,31,47,39.74
Camille,Teemo,270,114,156,42.22
Camille,Quinn,55,31,24,56.36
Camille,Akshan,124,52,72,41.94
Camille,Ornn,92,37,55,40.22
Camille,Sion,159,53,106,33.33
Camille,Zilean,54,15,39,27.78
Camille,Fizz,110,24,86,21.82
Camille,Xayah,117,33,84,28.21
Camille,Skarner,72,39,33,54.17
Camille,Corki,118,46,72,38.98
Camille,Zoe,105,78,27,74.29
Camille,AurelionSol,81,32,49,39.51
Camille,Karthus,35,9,26,25.71
Camille,Nilah,111,39,72,35.14
Camille,Rell,120,50,70,41.67
Camille,Nidalee,67,33,34,49.25
Camille,Azir,59,16,43,27.12
Camille,Jayce,83,26,57,31.33
Camille,MasterYi,191,86,105,45.03
Camille,DrMundo,105,49,56,46.67
Camille,Syndra,149,65,84,43.62
Camille,Leona,145,49,96,33.79
Camille,Janna,119,66,53,55.46
Camille,Udyr,90,30,60,33.33
Camille,Veigar,173,82,91,47.4
Camille,XinZhao,108,43,65,39.81
Camille,Taric,41,15,26,36.59
Camille,Lillia,134,67,67,50
Camille,Evelynn,45,21,24,46.67
Camille,Rumble,23,3,20,13.04
Lissandra,Sylas,143,59,84,41.26
Lissandra,Ekko,141,78,63,55.32
Lissandra,Talon,94,37,57,39.36
Lissandra,Jinx,323,145,178,44.89
Lissandra,Pyke,174,94,80,54.02
Lissandra,Yone,317,162,155,51.1
Lissandra,Yasuo,376,184,192,48.94
Lissandra,Irelia,178,80,98,44.94
Lissandra,Morgana,259,92,167,35.52
Lissandra,Lux,377,216,161,57.29
Lissandra,Fiora,87,46,41,52.87
Lissandra,Elise,77,34,43,44.16
Lissandra,Garen,229,94,135,41.05
Lissandra,Ashe,195,113,82,57.95
Lissandra,Senna,104,42,62,40.38
Lissandra,LeeSin,107,65,42,60.75
Lissandra,Hwei,106,25,81,23.58
Lissandra,Aurora,159,73,86,45.91
Lissandra,Yorick,139,69,70,49.64
Lissandra,Kayn,273,138,135,50.55
Lissandra,Jhin,312,156,156,50
Lissandra,Thresh,174,101,73,58.05
Lissandra,DrMundo,63,22,41,34.92
Lissandra,Zed,175,109,66,62.29
Lissandra,Caitlyn,340,164,176,48.24
Lissandra,Lulu,111,72,39,64.86
Lissandra,Poppy,76,41,35,53.95
Lissandra,Kalista,82,39,43,47.56
Lissandra,Neeko,99,56,43,56.57
Lissandra,Kled,59,39,20,66.1
Lissandra,Nocturne,141,68,73,48.23
Lissandra,Malzahar,101,27,74,26.73
Lissandra,Kaisa,231,105,126,45.45
Lissandra,Mel,379,182,197,48.02
Lissandra,Zac,84,62,22,73.81
Lissandra,Amumu,102,55,47,53.92
Lissandra,Alistar,60,33,27,55
Lissandra,Camille,20,14,6,70
Lissandra,Karma,76,29,47,38.16
Lissandra,Kennen,53,25,28,47.17
Lissandra,Lucian,67,28,39,41.79
Lissandra,Nami,159,69,90,43.4
Lissandra,Teemo,246,117,129,47.56
Lissandra,Darius,238,132,106,55.46
Lissandra,Seraphine,166,95,71,57.23
Lissandra,Velkoz,107,39,68,36.45
Lissandra,Shaco,168,101,67,60.12
Lissandra,Quinn,55,20,35,36.36
Lissandra,Briar,209,90,119,43.06
Lissandra,MasterYi,184,95,89,51.63
Lissandra,Milio,64,24,40,37.5
Lissandra,Diana,200,101,99,50.5
Lissandra,Yuumi,156,86,70,55.13
Lissandra,Trundle,82,29,53,35.37
Lissandra,Katarina,119,74,45,62.18
Lissandra,Draven,68,49,19,72.06
Lissandra,Chogath,206,96,110,46.6
Lissandra,Taric,27,10,17,37.04
Lissandra,Ivern,33,19,14,57.58
Lissandra,Rell,94,71,23,75.53
Lissandra,Viego,186,87,99,46.77
Lissandra,Gnar,42,29,13,69.05
Lissandra,Lillia,93,57,36,61.29
Lissandra,Smolder,102,30,72,29.41
Lissandra,TahmKench,177,81,96,45.76
Lissandra,Pantheon,239,130,109,54.39
Lissandra,Volibear,127,57,70,44.88
Lissandra,Tristana,141,64,77,45.39
Lissandra,Twitch,165,107,58,64.85
Lissandra,Ornn,65,27,38,41.54
Lissandra,Ezreal,285,139,146,48.77
Lissandra,Blitzcrank,103,59,44,57.28
Lissandra,Sett,217,112,105,51.61
Lissandra,Khazix,95,56,39,58.95
Lissandra,Azir,75,34,41,45.33
Lissandra,Shen,132,70,62,53.03
Lissandra,Illaoi,72,30,42,41.67
Lissandra,Belveth,40,29,11,72.5
Lissandra,Xayah,96,48,48,50
Lissandra,Rakan,91,52,39,57.14
Lissandra,Sejuani,33,10,23,30.3
Lissandra,Leblanc,69,42,27,60.87
Lissandra,Swain,181,76,105,41.99
Lissandra,Sion,142,79,63,55.63
Lissandra,Aatrox,110,63,47,57.27
Lissandra,Vayne,118,54,64,45.76
Lissandra,Riven,50,24,26,48
Lissandra,Vi,120,53,67,44.17
Lissandra,Akali,171,52,119,30.41
Lissandra,Rumble,39,30,9,76.92
Lissandra,Vladimir,66,36,30,54.55
Lissandra,Ahri,178,80,98,44.94
Lissandra,Renata,37,28,9,75.68
Lissandra,MissFortune,278,146,132,52.52
Lissandra,Gragas,104,69,35,66.35
Lissandra,Nilah,81,43,38,53.09
Lissandra,Leona,137,66,71,48.18
Lissandra,Janna,57,30,27,52.63
Lissandra,Heimerdinger,70,37,33,52.86
Lissandra,Hecarim,41,28,13,68.29
Lissandra,Varus,95,48,47,50.53
Lissandra,FiddleSticks,60,43,17,71.67
Lissandra,Cassiopeia,48,30,18,62.5
Lissandra,Samira,146,76,70,52.05
Lissandra,Nasus,100,31,69,31
Lissandra,Nautilus,171,102,69,59.65
Lissandra,Warwick,230,82,148,35.65
Lissandra,Graves,68,28,40,41.18
Lissandra,Tryndamere,63,43,20,68.25
Lissandra,Rengar,93,54,39,58.06
Lissandra,Mordekaiser,216,92,124,42.59
Lissandra,Shyvana,52,23,29,44.23
Lissandra,Brand,95,44,51,46.32
Lissandra,Anivia,60,25,35,41.67
Lissandra,Sona,32,18,14,56.25
Lissandra,Soraka,73,29,44,39.73
Lissandra,Naafiri,71,27,44,38.03
Lissandra,Jax,99,41,58,41.41
Lissandra,Aphelios,119,78,41,65.55
Lissandra,Gwen,94,45,49,47.87
Lissandra,Fizz,83,50,33,60.24
Lissandra,Gangplank,72,28,44,38.89
Lissandra,Braum,108,65,43,60.19
Lissandra,Malphite,128,67,61,52.34
Lissandra,Viktor,85,43,42,50.59
Lissandra,Zeri,40,34,6,85
Lissandra,Veigar,139,74,65,53.24
Lissandra,MonkeyKing,122,60,62,49.18
Lissandra,Qiyana,49,43,6,87.76
Lissandra,KogMaw,33,24,9,72.73
Lissandra,Galio,100,40,60,40
Lissandra,Nunu,109,58,51,53.21
Lissandra,Maokai,60,20,40,33.33
Lissandra,Jayce,50,37,13,74
Lissandra,Kayle,103,55,48,53.4
Lissandra,Vex,79,36,43,45.57
Lissandra,Zoe,75,57,18,76
Lissandra,Xerath,70,51,19,72.86
Lissandra,JarvanIV,59,33,26,55.93
Lissandra,Ziggs,71,40,31,56.34
Lissandra,Zyra,105,45,60,42.86
Lissandra,Ambessa,121,51,70,42.15
Lissandra,Olaf,50,25,25,50
Lissandra,Corki,47,22,25,46.81
Lissandra,Akshan,42,24,18,57.14
Lissandra,Zilean,44,22,22,50
Lissandra,Nidalee,34,21,13,61.76
Lissandra,Sivir,35,25,10,71.43
Lissandra,Rammus,56,27,29,48.21
Lissandra,Kindred,64,22,42,34.38
Lissandra,Orianna,68,34,34,50
Lissandra,Evelynn,94,48,46,51.06
Lissandra,Renekton,58,34,24,58.62
Lissandra,Urgot,73,38,35,52.05
Lissandra,Singed,27,15,12,55.56
Lissandra,XinZhao,60,32,28,53.33
Lissandra,Taliyah,23,17,6,73.91
Lissandra,Syndra,64,29,35,45.31
Lissandra,AurelionSol,88,47,41,53.41
Lissandra,KSante,32,23,9,71.88
Lissandra,TwistedFate,53,36,17,67.92
Lissandra,RekSai,28,18,10,64.29
Lissandra,Skarner,50,32,18,64
Lissandra,Udyr,37,14,23,37.84
Lissandra,Bard,39,29,10,74.36
Lissandra,Annie,29,20,9,68.97
Lissandra,Karthus,15,9,6,60
Lissandra,Ryze,28,20,8,71.43
Lissandra,Kassadin,22,13,9,59.09
Elise,Ryze,110,40,70,36.36
Elise,Nunu,276,104,172,37.68
Elise,Ahri,507,249,258,49.11
Elise,Lucian,208,104,104,50
Elise,Alistar,112,45,67,40.18
Elise,Yorick,280,91,189,32.5
Elise,Volibear,375,191,184,50.93
Elise,Veigar,466,203,263,43.56
Elise,Caitlyn,892,414,478,46.41
Elise,Sona,187,66,121,35.29
Elise,Ornn,163,63,100,38.65
Elise,Warwick,491,212,279,43.18
Elise,TwistedFate,131,59,72,45.04
Elise,Morgana,405,133,272,32.84
Elise,Gwen,254,115,139,45.28
Elise,Pantheon,575,306,269,53.22
Elise,Mel,748,340,408,45.45
Elise,Tristana,311,141,170,45.34
Elise,Poppy,161,89,72,55.28
Elise,KSante,171,82,89,47.95
Elise,Jax,285,111,174,38.95
Elise,Velkoz,218,99,119,45.41
Elise,Xayah,235,128,107,54.47
Elise,Rakan,227,106,121,46.7
Elise,Sett,594,256,338,43.1
Elise,Talon,296,148,148,50
Elise,Lissandra,77,43,34,55.84
Elise,Vayne,418,207,211,49.52
Elise,Milio,213,86,127,40.38
Elise,Aurora,332,109,223,32.83
Elise,Nocturne,385,161,224,41.82
Elise,Nilah,210,91,119,43.33
Elise,Soraka,255,134,121,52.55
Elise,Ambessa,186,87,99,46.77
Elise,Sejuani,198,83,115,41.92
Elise,Karma,290,136,154,46.9
Elise,Nidalee,98,45,53,45.92
Elise,Vex,184,74,110,40.22
Elise,Sivir,170,90,80,52.94
Elise,TahmKench,379,169,210,44.59
Elise,Gragas,262,127,135,48.47
Elise,Samira,263,107,156,40.68
Elise,Malphite,261,121,140,46.36
Elise,Viktor,296,168,128,56.76
Elise,Blitzcrank,241,137,104,56.85
Elise,Rumble,56,22,34,39.29
Elise,Akshan,200,128,72,64
Elise,Ezreal,724,371,353,51.24
Elise,Aatrox,307,149,158,48.53
Elise,Chogath,601,239,362,39.77
Elise,Janna,203,99,104,48.77
Elise,Kayn,618,257,361,41.59
Elise,Graves,154,62,92,40.26
Elise,Malzahar,189,81,108,42.86
Elise,Ivern,61,37,24,60.66
Elise,FiddleSticks,185,123,62,66.49
Elise,Azir,115,61,54,53.04
Elise,Viego,468,195,273,41.67
Elise,Aphelios,222,101,121,45.5
Elise,Diana,449,174,275,38.75
Elise,Ashe,620,276,344,44.52
Elise,Urgot,156,48,108,30.77
Elise,MasterYi,359,167,192,46.52
Elise,Seraphine,356,140,216,39.33
Elise,Garen,456,171,285,37.5
Elise,JarvanIV,164,65,99,39.63
Elise,Hwei,330,184,146,55.76
Elise,Twitch,297,140,157,47.14
Elise,Lulu,320,134,186,41.88
Elise,Amumu,308,97,211,31.49
Elise,Zed,393,183,210,46.56
Elise,Ziggs,198,77,121,38.89
Elise,Rengar,178,97,81,54.49
Elise,Yasuo,582,242,340,41.58
Elise,Nautilus,349,153,196,43.84
Elise,MissFortune,732,291,441,39.75
Elise,Pyke,385,209,176,54.29
Elise,Renekton,233,112,121,48.07
Elise,Zeri,147,88,59,59.86
Elise,Shen,241,103,138,42.74
Elise,LeeSin,375,201,174,53.6
Elise,Zac,142,57,85,40.14
Elise,Teemo,473,209,264,44.19
Elise,AurelionSol,217,80,137,36.87
Elise,Fiora,184,94,90,51.09
Elise,Mordekaiser,435,223,212,51.26
Elise,Briar,306,116,190,37.91
Elise,Rell,201,84,117,41.79
Elise,Kaisa,498,222,276,44.58
Elise,Jinx,658,284,374,43.16
Elise,XinZhao,201,91,110,45.27
Elise,Yuumi,270,124,146,45.93
Elise,Lillia,195,99,96,50.77
Elise,Draven,200,111,89,55.5
Elise,Thresh,470,230,240,48.94
Elise,Naafiri,196,84,112,42.86
Elise,Kindred,190,77,113,40.53
Elise,Irelia,316,168,148,53.16
Elise,Shaco,409,209,200,51.1
Elise,Lux,987,466,521,47.21
Elise,Swain,301,140,161,46.51
Elise,Renata,77,42,35,54.55
Elise,Singed,94,48,46,51.06
Elise,Cassiopeia,159,65,94,40.88
Elise,Vladimir,197,107,90,54.31
Elise,Belveth,116,58,58,50
Elise,Katarina,376,214,162,56.91
Elise,Brand,245,127,118,51.84
Elise,Nasus,262,145,117,55.34
Elise,Vi,264,96,168,36.36
Elise,Yone,634,286,348,45.11
Elise,Darius,605,290,315,47.93
Elise,Jhin,670,225,445,33.58
Elise,Zyra,209,100,109,47.85
Elise,Bard,167,75,92,44.91
Elise,Karthus,94,49,45,52.13
Elise,Nami,351,135,216,38.46
Elise,Leblanc,165,76,89,46.06
Elise,Zoe,142,74,68,52.11
Elise,Ekko,278,159,119,57.19
Elise,Kassadin,83,27,56,32.53
Elise,Sylas,331,151,180,45.62
Elise,Smolder,264,129,135,48.86
Elise,Gangplank,204,92,112,45.1
Elise,Neeko,294,155,139,52.72
Elise,Braum,139,54,85,38.85
Elise,Quinn,118,40,78,33.9
Elise,Orianna,174,93,81,53.45
Elise,Leona,249,122,127,49
Elise,Trundle,176,81,95,46.02
Elise,Skarner,123,69,54,56.1
Elise,Senna,350,180,170,51.43
Elise,Sion,277,116,161,41.88
Elise,MonkeyKing,175,59,116,33.71
Elise,Camille,146,86,60,58.9
Elise,Annie,83,31,52,37.35
Elise,Galio,244,105,139,43.03
Elise,Varus,278,133,145,47.84
Elise,Heimerdinger,225,109,116,48.44
Elise,Kled,102,43,59,42.16
Elise,Kayle,287,157,130,54.7
Elise,Illaoi,193,74,119,38.34
Elise,Jayce,147,43,104,29.25
Elise,Khazix,243,112,131,46.09
Elise,Kennen,190,122,68,64.21
Elise,Akali,282,133,149,47.16
Elise,Tryndamere,183,90,93,49.18
Elise,Olaf,73,33,40,45.21
Elise,Riven,161,72,89,44.72
Elise,Syndra,181,68,113,37.57
Elise,Udyr,149,70,79,46.98
Elise,Kalista,155,94,61,60.65
Elise,Fizz,180,82,98,45.56
Elise,Taric,119,41,78,34.45
Elise,Evelynn,205,76,129,37.07
Elise,Shyvana,123,50,73,40.65
Elise,Xerath,245,87,158,35.51
Elise,Gnar,128,91,37,71.09
Elise,Maokai,159,52,107,32.7
Elise,Qiyana,129,53,76,41.09
Elise,Hecarim,113,52,61,46.02
Elise,Zilean,94,48,46,51.06
Elise,Taliyah,93,56,37,60.22
Elise,KogMaw,99,54,45,54.55
Elise,DrMundo,227,67,160,29.52
Elise,Rammus,65,28,37,43.08
Elise,RekSai,74,24,50,32.43
Elise,Corki,122,64,58,52.46
Elise,Anivia,100,36,64,36
Jayce,Tryndamere,103,43,60,41.75
Jayce,Gragas,159,67,92,42.14
Jayce,Irelia,239,131,108,54.81
Jayce,Kalista,165,71,94,43.03
Jayce,Twitch,211,121,90,57.35
Jayce,DrMundo,192,75,117,39.06
Jayce,Shaco,258,105,153,40.7
Jayce,Leblanc,83,43,40,51.81
Jayce,Xayah,191,89,102,46.6
Jayce,Karma,137,66,71,48.18
Jayce,Akali,187,80,107,42.78
Jayce,Naafiri,95,36,59,37.89
Jayce,Kayle,174,90,84,51.72
Jayce,MissFortune,373,159,214,42.63
Jayce,Smolder,172,73,99,42.44
Jayce,Trundle,155,72,83,46.45
Jayce,Ahri,311,119,192,38.26
Jayce,Ashe,461,239,222,51.84
Jayce,Nami,248,69,179,27.82
Jayce,TahmKench,264,108,156,40.91
Jayce,Jax,228,91,137,39.91
Jayce,Malzahar,221,85,136,38.46
Jayce,Jinx,530,234,296,44.15
Jayce,Mordekaiser,326,130,196,39.88
Jayce,Sett,356,144,212,40.45
Jayce,LeeSin,242,118,124,48.76
Jayce,Nasus,190,58,132,30.53
Jayce,Kaisa,299,121,178,40.47
Jayce,Bard,60,17,43,28.33
Jayce,Gangplank,132,81,51,61.36
Jayce,Rengar,119,68,51,57.14
Jayce,Yasuo,470,174,296,37.02
Jayce,Kennen,82,37,45,45.12
Jayce,Aatrox,241,114,127,47.3
Jayce,Diana,336,115,221,34.23
Jayce,Mel,578,251,327,43.43
Jayce,Rell,84,36,48,42.86
Jayce,Amumu,193,86,107,44.56
Jayce,Senna,212,111,101,52.36
Jayce,Yone,552,274,278,49.64
Jayce,Viego,258,121,137,46.9
Jayce,Ezreal,513,246,267,47.95
Jayce,Blitzcrank,142,76,66,53.52
Jayce,Morgana,301,116,185,38.54
Jayce,Vi,233,140,93,60.09
Jayce,Yuumi,237,99,138,41.77
Jayce,Yorick,251,83,168,33.07
Jayce,Khazix,145,73,72,50.34
Jayce,Aurora,286,154,132,53.85
Jayce,Garen,354,131,223,37.01
Jayce,Varus,190,100,90,52.63
Jayce,Swain,247,128,119,51.82
Jayce,Darius,420,195,225,46.43
Jayce,Kayn,316,121,195,38.29
Jayce,Janna,82,33,49,40.24
Jayce,Talon,177,68,109,38.42
Jayce,Caitlyn,520,202,318,38.85
Jayce,Lillia,134,54,80,40.3
Jayce,Briar,239,115,124,48.12
Jayce,Veigar,211,87,124,41.23
Jayce,Viktor,160,66,94,41.25
Jayce,Kindred,167,77,90,46.11
Jayce,Katarina,189,115,74,60.85
Jayce,Aphelios,201,84,117,41.79
Jayce,Brand,141,63,78,44.68
Jayce,Renekton,71,29,42,40.85
Jayce,Warwick,364,173,191,47.53
Jayce,Gwen,106,43,63,40.57
Jayce,Tristana,174,101,73,58.05
Jayce,Illaoi,105,68,37,64.76
Jayce,Rammus,72,50,22,69.44
Jayce,Kled,35,18,17,51.43
Jayce,Alistar,79,33,46,41.77
Jayce,Pantheon,324,117,207,36.11
Jayce,MasterYi,254,126,128,49.61
Jayce,Ryze,67,25,42,37.31
Jayce,Pyke,271,138,133,50.92
Jayce,Galio,150,72,78,48
Jayce,Singed,95,50,45,52.63
Jayce,Lux,544,246,298,45.22
Jayce,AurelionSol,170,79,91,46.47
Jayce,Neeko,164,89,75,54.27
Jayce,Braum,101,48,53,47.52
Jayce,Nocturne,179,82,97,45.81
Jayce,Hwei,147,71,76,48.3
Jayce,Draven,123,39,84,31.71
Jayce,Graves,101,71,30,70.3
Jayce,Samira,219,102,117,46.58
Jayce,Thresh,336,168,168,50
Jayce,Seraphine,260,109,151,41.92
Jayce,Zac,103,49,54,47.57
Jayce,Shyvana,38,28,10,73.68
Jayce,Corki,70,25,45,35.71
Jayce,Elise,147,104,43,70.75
Jayce,Karthus,49,37,12,75.51
Jayce,Soraka,153,96,57,62.75
Jayce,Zyra,201,64,137,31.84
Jayce,Vayne,259,106,153,40.93
Jayce,Vladimir,164,85,79,51.83
Jayce,Jhin,484,231,253,47.73
Jayce,FiddleSticks,116,59,57,50.86
Jayce,Zeri,81,48,33,59.26
Jayce,Sylas,202,100,102,49.5
Jayce,Gnar,130,54,76,41.54
Jayce,Zed,241,97,144,40.25
Jayce,Maokai,134,19,115,14.18
Jayce,Teemo,368,188,180,51.09
Jayce,Syndra,120,63,57,52.5
Jayce,Zoe,127,53,74,41.73
Jayce,Fiora,89,37,52,41.57
Jayce,Volibear,237,120,117,50.63
Jayce,Sion,163,88,75,53.99
Jayce,Taric,89,37,52,41.57
Jayce,Quinn,107,43,64,40.19
Jayce,KSante,99,46,53,46.46
Jayce,Ornn,67,19,48,28.36
Jayce,Heimerdinger,171,26,145,15.2
Jayce,Malphite,171,60,111,35.09
Jayce,Lulu,251,132,119,52.59
Jayce,Ambessa,163,42,121,25.77
Jayce,Poppy,149,59,90,39.6
Jayce,Nautilus,252,108,144,42.86
Jayce,Lissandra,50,13,37,26
Jayce,Milio,109,43,66,39.45
Jayce,MonkeyKing,123,69,54,56.1
Jayce,Nilah,150,66,84,44
Jayce,Vex,142,47,95,33.1
Jayce,Chogath,323,149,174,46.13
Jayce,XinZhao,110,50,60,45.45
Jayce,TwistedFate,113,49,64,43.36
Jayce,Renata,41,28,13,68.29
Jayce,Riven,123,60,63,48.78
Jayce,Sejuani,113,44,69,38.94
Jayce,Orianna,145,92,53,63.45
Jayce,Camille,83,57,26,68.67
Jayce,Taliyah,88,41,47,46.59
Jayce,Azir,103,50,53,48.54
Jayce,Hecarim,85,54,31,63.53
Jayce,Olaf,67,32,35,47.76
Jayce,Leona,142,57,85,40.14
Jayce,Shen,116,37,79,31.9
Jayce,Annie,67,45,22,67.16
Jayce,Xerath,155,82,73,52.9
Jayce,Rakan,156,84,72,53.85
Jayce,Nunu,233,91,142,39.06
Jayce,Skarner,73,63,10,86.3
Jayce,Fizz,157,41,116,26.11
Jayce,Ivern,70,34,36,48.57
Jayce,Urgot,92,39,53,42.39
Jayce,Udyr,100,37,63,37
Jayce,Akshan,85,50,35,58.82
Jayce,Cassiopeia,99,62,37,62.63
Jayce,Ziggs,111,34,77,30.63
Jayce,Zilean,71,34,37,47.89
Jayce,Qiyana,117,67,50,57.26
Jayce,Lucian,142,66,76,46.48
Jayce,Velkoz,150,75,75,50
Jayce,JarvanIV,103,34,69,33.01
Jayce,Ekko,154,73,81,47.4
Jayce,KogMaw,72,43,29,59.72
Jayce,Sivir,123,51,72,41.46
Jayce,Anivia,95,49,46,51.58
Jayce,Sona,100,31,69,31
Jayce,Belveth,44,8,36,18.18
Jayce,Kassadin,22,16,6,72.73
Jayce,Evelynn,86,44,42,51.16
Jayce,Rumble,59,18,41,30.51
Jayce,Nidalee,85,39,46,45.88
Jayce,RekSai,34,24,10,70.59
Sion,Teemo,717,383,334,53.42
Sion,Amumu,481,213,268,44.28
Sion,Garen,643,299,344,46.5
Sion,KogMaw,187,79,108,42.25
Sion,Yuumi,425,195,230,45.88
Sion,Fiora,241,146,95,60.58
Sion,Kayn,710,342,368,48.17
Sion,Malzahar,337,181,156,53.71
Sion,Aphelios,416,239,177,57.45
Sion,Zilean,132,92,40,69.7
Sion,KSante,178,114,64,64.04
Sion,Udyr,233,93,140,39.91
Sion,Veigar,489,211,278,43.15
Sion,Ashe,822,474,348,57.66
Sion,Nautilus,474,261,213,55.06
Sion,Yasuo,727,406,321,55.85
Sion,Belveth,160,72,88,45
Sion,Yone,901,454,447,50.39
Sion,Mordekaiser,624,320,304,51.28
Sion,Alistar,157,77,80,49.04
Sion,Poppy,275,134,141,48.73
Sion,Khazix,315,191,124,60.63
Sion,Irelia,427,225,202,52.69
Sion,Tristana,447,255,192,57.05
Sion,Neeko,397,238,159,59.95
Sion,Gnar,222,128,94,57.66
Sion,Volibear,465,212,253,45.59
Sion,Mel,1063,600,463,56.44
Sion,Samira,476,263,213,55.25
Sion,Seraphine,507,309,198,60.95
Sion,Nasus,334,169,165,50.6
Sion,Pantheon,764,397,367,51.96
Sion,Zoe,238,142,96,59.66
Sion,Senna,427,227,200,53.16
Sion,TahmKench,571,261,310,45.71
Sion,Jax,339,171,168,50.44
Sion,Jinx,903,454,449,50.28
Sion,Akali,540,290,250,53.7
Sion,Zac,207,98,109,47.34
Sion,Diana,601,297,304,49.42
Sion,Vayne,516,268,248,51.94
Sion,Caitlyn,969,515,454,53.15
Sion,Ornn,235,80,155,34.04
Sion,Shaco,393,264,129,67.18
Sion,Hwei,367,186,181,50.68
Sion,Karma,371,206,165,55.53
Sion,Singed,151,44,107,29.14
Sion,Kindred,225,154,71,68.44
Sion,Katarina,392,219,173,55.87
Sion,Kaisa,638,329,309,51.57
Sion,Morgana,522,286,236,54.79
Sion,Illaoi,224,110,114,49.11
Sion,Jhin,861,434,427,50.41
Sion,Leona,336,161,175,47.92
Sion,Darius,984,520,464,52.85
Sion,Ekko,357,191,166,53.5
Sion,Nami,535,296,239,55.33
Sion,Viego,626,329,297,52.56
Sion,Ezreal,812,470,342,57.88
Sion,Blitzcrank,382,218,164,57.07
Sion,Braum,215,102,113,47.44
Sion,Talon,346,212,134,61.27
Sion,Galio,347,146,201,42.07
Sion,Lucian,272,112,160,41.18
Sion,Milio,326,177,149,54.29
Sion,Briar,456,265,191,58.11
Sion,Annie,136,51,85,37.5
Sion,Xerath,338,136,202,40.24
Sion,Thresh,646,386,260,59.75
Sion,Warwick,774,350,424,45.22
Sion,Kalista,166,103,63,62.05
Sion,Skarner,161,108,53,67.08
Sion,Lillia,350,186,164,53.14
Sion,Lulu,421,217,204,51.54
Sion,Renekton,180,107,73,59.44
Sion,Gragas,287,165,122,57.49
Sion,Viktor,330,147,183,44.55
Sion,MasterYi,513,264,249,51.46
Sion,Taliyah,177,122,55,68.93
Sion,Smolder,404,195,209,48.27
Sion,Graves,250,151,99,60.4
Sion,Lux,1165,584,581,50.13
Sion,Soraka,294,135,159,45.92
Sion,DrMundo,216,84,132,38.89
Sion,Rengar,175,121,54,69.14
Sion,LeeSin,434,243,191,55.99
Sion,Zed,479,283,196,59.08
Sion,MissFortune,955,551,404,57.7
Sion,Vi,414,199,215,48.07
Sion,Ryze,151,83,68,54.97
Sion,Janna,211,85,126,40.28
Sion,Vladimir,295,156,139,52.88
Sion,Draven,294,143,151,48.64
Sion,Swain,514,243,271,47.28
Sion,Aurora,474,258,216,54.43
Sion,Yorick,414,203,211,49.03
Sion,Sett,779,375,404,48.14
Sion,Varus,373,201,172,53.89
Sion,Gwen,407,219,188,53.81
Sion,AurelionSol,226,117,109,51.77
Sion,Sona,132,64,68,48.48
Sion,Malphite,289,141,148,48.79
Sion,Qiyana,197,115,82,58.38
Sion,Ambessa,202,81,121,40.1
Sion,Vex,371,207,164,55.8
Sion,Pyke,525,311,214,59.24
Sion,Trundle,292,141,151,48.29
Sion,Zyra,320,167,153,52.19
Sion,Syndra,255,106,149,41.57
Sion,Shyvana,117,43,74,36.75
Sion,Nunu,397,230,167,57.93
Sion,Nidalee,162,100,62,61.73
Sion,Sejuani,169,68,101,40.24
Sion,Lissandra,142,63,79,44.37
Sion,Aatrox,561,274,287,48.84
Sion,Twitch,479,211,268,44.05
Sion,Shen,392,173,219,44.13
Sion,Riven,278,181,97,65.11
Sion,Xayah,323,171,152,52.94
Sion,Rakan,294,151,143,51.36
Sion,Azir,171,104,67,60.82
Sion,Gangplank,256,156,100,60.94
Sion,Elise,277,161,116,58.12
Sion,Ziggs,149,62,87,41.61
Sion,Leblanc,188,92,96,48.94
Sion,JarvanIV,190,84,106,44.21
Sion,Corki,183,71,112,38.8
Sion,Akshan,181,102,79,56.35
Sion,XinZhao,246,104,142,42.28
Sion,Bard,168,37,131,22.02
Sion,Fizz,249,121,128,48.59
Sion,Sylas,449,216,233,48.11
Sion,Orianna,200,114,86,57
Sion,Quinn,164,71,93,43.29
Sion,Ivern,90,51,39,56.67
Sion,Maokai,249,141,108,56.63
Sion,Sivir,223,100,123,44.84
Sion,Ahri,582,307,275,52.75
Sion,Chogath,653,300,353,45.94
Sion,Karthus,105,69,36,65.71
Sion,Brand,269,152,117,56.51
Sion,Nilah,273,151,122,55.31
Sion,Tryndamere,340,197,143,57.94
Sion,TwistedFate,158,82,76,51.9
Sion,Cassiopeia,209,122,87,58.37
Sion,FiddleSticks,218,88,130,40.37
Sion,MonkeyKing,195,107,88,54.87
Sion,Anivia,208,115,93,55.29
Sion,Jayce,163,75,88,46.01
Sion,Camille,159,106,53,66.67
Sion,Rell,235,122,113,51.91
Sion,Heimerdinger,270,125,145,46.3
Sion,Naafiri,171,100,71,58.48
Sion,Nocturne,357,199,158,55.74
Sion,Velkoz,316,175,141,55.38
Sion,Evelynn,271,154,117,56.83
Sion,Kayle,322,169,153,52.48
Sion,Hecarim,163,105,58,64.42
Sion,Kassadin,111,79,32,71.17
Sion,Urgot,235,141,94,60
Sion,Zeri,250,110,140,44
Sion,Taric,97,43,54,44.33
Sion,Rumble,63,38,25,60.32
Sion,RekSai,99,40,59,40.4
Sion,Rammus,132,62,70,46.97
Sion,Olaf,67,45,22,67.16
Sion,Renata,112,59,53,52.68
Sion,Kennen,146,72,74,49.32
Sion,Kled,108,74,34,68.52
Shyvana,KSante,68,29,39,42.65
Shyvana,Kayn,242,169,73,69.83
Shyvana,Yasuo,271,157,114,57.93
Shyvana,MissFortune,300,142,158,47.33
Shyvana,Lux,434,209,225,48.16
Shyvana,Garen,259,162,97,62.55
Shyvana,Zed,117,85,32,72.65
Shyvana,Talon,83,60,23,72.29
Shyvana,Ashe,243,164,79,67.49
Shyvana,Milio,90,54,36,60
Shyvana,Aurora,167,101,66,60.48
Shyvana,Briar,169,70,99,41.42
Shyvana,Fizz,115,63,52,54.78
Shyvana,Jinx,399,190,209,47.62
Shyvana,Soraka,113,51,62,45.13
Shyvana,Vladimir,71,38,33,53.52
Shyvana,Ekko,106,64,42,60.38
Shyvana,Qiyana,43,22,21,51.16
Shyvana,Twitch,139,64,75,46.04
Shyvana,Senna,149,66,83,44.3
Shyvana,Fiora,75,26,49,34.67
Shyvana,Amumu,185,104,81,56.22
Shyvana,Samira,122,68,54,55.74
Shyvana,Seraphine,232,138,94,59.48
Shyvana,Darius,341,144,197,42.23
Shyvana,Gragas,122,82,40,67.21
Shyvana,Veigar,155,79,76,50.97
Shyvana,KogMaw,85,47,38,55.29
Shyvana,Thresh,189,105,84,55.56
Shyvana,Evelynn,116,53,63,45.69
Shyvana,Tristana,182,79,103,43.41
Shyvana,Sylas,101,45,56,44.55
Shyvana,Mordekaiser,321,183,138,57.01
Shyvana,Nidalee,48,34,14,70.83
Shyvana,Orianna,93,45,48,48.39
Shyvana,Caitlyn,376,231,145,61.44
Shyvana,Yuumi,190,104,86,54.74
Shyvana,Volibear,222,119,103,53.6
Shyvana,Yone,338,188,150,55.62
Shyvana,Lulu,124,44,80,35.48
Shyvana,Sett,271,127,144,46.86
Shyvana,Shaco,154,94,60,61.04
Shyvana,Mel,345,197,148,57.1
Shyvana,Graves,71,52,19,73.24
Shyvana,Kayle,143,102,41,71.33
Shyvana,Ezreal,285,156,129,54.74
Shyvana,Malzahar,159,85,74,53.46
Shyvana,Warwick,254,129,125,50.79
Shyvana,Teemo,235,128,107,54.47
Shyvana,Hecarim,75,35,40,46.67
Shyvana,Vayne,145,83,62,57.24
Shyvana,Chogath,156,81,75,51.92
Shyvana,Ambessa,105,55,50,52.38
Shyvana,Aphelios,114,60,54,52.63
Shyvana,Velkoz,92,64,28,69.57
Shyvana,RekSai,31,10,21,32.26
Shyvana,LeeSin,169,74,95,43.79
Shyvana,Nilah,103,51,52,49.51
Shyvana,Poppy,109,78,31,71.56
Shyvana,Galio,135,66,69,48.89
Shyvana,Yorick,179,92,87,51.4
Shyvana,Viktor,96,48,48,50
Shyvana,Zoe,101,55,46,54.46
Shyvana,Anivia,90,56,34,62.22
Shyvana,Camille,64,47,17,73.44
Shyvana,Zac,73,39,34,53.42
Shyvana,Morgana,211,126,85,59.72
Shyvana,Varus,128,84,44,65.63
Shyvana,Sion,117,74,43,63.25
Shyvana,Karma,83,38,45,45.78
Shyvana,Rakan,110,53,57,48.18
Shyvana,Gangplank,100,44,56,44
Shyvana,Kalista,86,55,31,63.95
Shyvana,Sejuani,46,32,14,69.57
Shyvana,Leblanc,53,35,18,66.04
Shyvana,Swain,205,116,89,56.59
Shyvana,Lillia,134,70,64,52.24
Shyvana,Draven,121,52,69,42.98
Shyvana,Leona,111,40,71,36.04
Shyvana,TahmKench,119,70,49,58.82
Shyvana,Akali,156,82,74,52.56
Shyvana,Kaisa,167,112,55,67.07
Shyvana,Braum,48,27,21,56.25
Shyvana,Nasus,103,56,47,54.37
Shyvana,Nunu,132,60,72,45.45
Shyvana,Pyke,218,109,109,50
Shyvana,FiddleSticks,64,23,41,35.94
Shyvana,Lucian,99,22,77,22.22
Shyvana,Blitzcrank,154,97,57,62.99
Shyvana,Khazix,106,82,24,77.36
Shyvana,Zyra,81,22,59,27.16
Shyvana,Gwen,111,48,63,43.24
Shyvana,Diana,240,150,90,62.5
Shyvana,Riven,54,30,24,55.56
Shyvana,Jax,145,82,63,56.55
Shyvana,Malphite,117,65,52,55.56
Shyvana,Pantheon,292,166,126,56.85
Shyvana,Renekton,64,45,19,70.31
Shyvana,Ahri,179,84,95,46.93
Shyvana,Ziggs,95,61,34,64.21
Shyvana,Heimerdinger,106,72,34,67.92
Shyvana,Jhin,256,141,115,55.08
Shyvana,Jayce,38,10,28,26.32
Shyvana,Akshan,52,15,37,28.85
Shyvana,Corki,65,34,31,52.31
Shyvana,Skarner,76,48,28,63.16
Shyvana,Xerath,127,59,68,46.46
Shyvana,Shen,118,44,74,37.29
Shyvana,Sivir,91,41,50,45.05
Shyvana,Maokai,56,11,45,19.64
Shyvana,Nautilus,177,108,69,61.02
Shyvana,Kindred,75,53,22,70.67
Shyvana,Rell,91,65,26,71.43
Shyvana,Lissandra,52,29,23,55.77
Shyvana,Elise,123,73,50,59.35
Shyvana,Renata,20,9,11,45
Shyvana,Viego,202,117,85,57.92
Shyvana,Xayah,101,66,35,65.35
Shyvana,Azir,44,33,11,75
Shyvana,Ornn,54,30,24,55.56
Shyvana,Gnar,79,41,38,51.9
Shyvana,Neeko,153,84,69,54.9
Shyvana,Taric,20,14,6,70
Shyvana,Rengar,52,24,28,46.15
Shyvana,Vex,80,32,48,40
Shyvana,Aatrox,94,77,17,81.91
Shyvana,Katarina,166,121,45,72.89
Shyvana,Quinn,96,52,44,54.17
Shyvana,MonkeyKing,116,72,44,62.07
Shyvana,Irelia,155,67,88,43.23
Shyvana,Smolder,162,75,87,46.3
Shyvana,Rammus,72,47,25,65.28
Shyvana,TwistedFate,45,33,12,73.33
Shyvana,Annie,58,45,13,77.59
Shyvana,Nami,145,81,64,55.86
Shyvana,Trundle,45,20,25,44.44
Shyvana,JarvanIV,62,27,35,43.55
Shyvana,Zilean,44,3,41,6.82
Shyvana,Naafiri,119,76,43,63.87
Shyvana,Vi,76,43,33,56.58
Shyvana,Cassiopeia,57,43,14,75.44
Shyvana,Hwei,116,71,45,61.21
Shyvana,Belveth,53,35,18,66.04
Shyvana,Kassadin,35,20,15,57.14
Shyvana,Nocturne,108,38,70,35.19
Shyvana,Brand,81,52,29,64.2
Shyvana,Ivern,42,20,22,47.62
Shyvana,Taliyah,67,39,28,58.21
Shyvana,Tryndamere,75,53,22,70.67
Shyvana,Syndra,120,79,41,65.83
Shyvana,Bard,44,31,13,70.45
Shyvana,DrMundo,95,40,55,42.11
Shyvana,Udyr,55,34,21,61.82
Shyvana,Zeri,65,18,47,27.69
Shyvana,MasterYi,134,67,67,50
Shyvana,XinZhao,131,64,67,48.85
Shyvana,Rumble,36,20,16,55.56
Shyvana,Kennen,66,27,39,40.91
Shyvana,Janna,44,16,28,36.36
Shyvana,Urgot,69,30,39,43.48
Shyvana,Alistar,60,50,10,83.33
Shyvana,Singed,27,0,27,0
Shyvana,AurelionSol,84,55,29,65.48
Shyvana,Ryze,36,13,23,36.11
Shyvana,Kled,28,8,20,28.57
Shyvana,Illaoi,85,24,61,28.24
Shyvana,Sona,71,38,33,53.52
Shyvana,Karthus,54,33,21,61.11
Shyvana,Olaf,26,6,20,23.08
Quinn,Naafiri,115,72,43,62.61
Quinn,Volibear,153,79,74,51.63
Quinn,Lux,509,252,257,49.51
Quinn,Ashe,357,175,182,49.02
Quinn,Soraka,120,47,73,39.17
Quinn,Jax,159,89,70,55.97
Quinn,FiddleSticks,102,54,48,52.94
Quinn,Cassiopeia,67,32,35,47.76
Quinn,Caitlyn,466,242,224,51.93
Quinn,Milio,167,75,92,44.91
Quinn,Nasus,107,51,56,47.66
Quinn,Kindred,94,44,50,46.81
Quinn,Malzahar,149,76,73,51.01
Quinn,Tristana,196,114,82,58.16
Quinn,Nautilus,190,98,92,51.58
Quinn,Yone,284,136,148,47.89
Quinn,Graves,130,70,60,53.85
Quinn,Akali,271,154,117,56.83
Quinn,Zeri,79,40,39,50.63
Quinn,Taric,84,51,33,60.71
Quinn,Malphite,265,118,147,44.53
Quinn,Ivern,38,17,21,44.74
Quinn,Yasuo,299,107,192,35.79
Quinn,Jhin,361,203,158,56.23
Quinn,Pyke,256,116,140,45.31
Quinn,KSante,65,21,44,32.31
Quinn,Darius,377,188,189,49.87
Quinn,Sylas,192,55,137,28.65
Quinn,Mel,455,239,216,52.53
Quinn,Pantheon,334,158,176,47.31
Quinn,Warwick,317,147,170,46.37
Quinn,Viego,246,109,137,44.31
Quinn,Ornn,80,34,46,42.5
Quinn,Shaco,244,128,116,52.46
Quinn,Irelia,161,74,87,45.96
Quinn,Evelynn,111,54,57,48.65
Quinn,Rammus,83,35,48,42.17
Quinn,Hwei,123,82,41,66.67
Quinn,Lulu,155,69,86,44.52
Quinn,Teemo,343,149,194,43.44
Quinn,Ahri,292,155,137,53.08
Quinn,Yuumi,201,108,93,53.73
Quinn,Aurora,222,93,129,41.89
Quinn,KogMaw,72,29,43,40.28
Quinn,Kayle,148,65,83,43.92
Quinn,LeeSin,242,126,116,52.07
Quinn,Vex,117,75,42,64.1
Quinn,MissFortune,521,247,274,47.41
Quinn,Kalista,61,20,41,32.79
Quinn,Vi,163,73,90,44.79
Quinn,Talon,145,76,69,52.41
Quinn,Briar,268,133,135,49.63
Quinn,Zoe,123,54,69,43.9
Quinn,Singed,46,22,24,47.83
Quinn,Ezreal,346,186,160,53.76
Quinn,Velkoz,149,64,85,42.95
Quinn,Ambessa,112,57,55,50.89
Quinn,Lissandra,55,35,20,63.64
Quinn,Samira,156,76,80,48.72
Quinn,Thresh,259,150,109,57.92
Quinn,Rakan,94,59,35,62.77
Quinn,Morgana,273,147,126,53.85
Quinn,DrMundo,148,84,64,56.76
Quinn,Mordekaiser,304,137,167,45.07
Quinn,Seraphine,238,119,119,50
Quinn,Vladimir,98,42,56,42.86
Quinn,Sett,370,151,219,40.81
Quinn,Nami,161,80,81,49.69
Quinn,Nocturne,157,89,68,56.69
Quinn,Aphelios,133,62,71,46.62
Quinn,Karma,109,60,49,55.05
Quinn,Gnar,78,45,33,57.69
Quinn,Qiyana,76,52,24,68.42
Quinn,Diana,213,91,122,42.72
Quinn,Zilean,53,15,38,28.3
Quinn,Renekton,112,48,64,42.86
Quinn,Twitch,200,108,92,54
Quinn,Braum,88,52,36,59.09
Quinn,Zed,257,160,97,62.26
Quinn,MasterYi,204,110,94,53.92
Quinn,Elise,118,78,40,66.1
Quinn,Vayne,198,98,100,49.49
Quinn,Gragas,129,41,88,31.78
Quinn,Udyr,72,53,19,73.61
Quinn,Poppy,146,51,95,34.93
Quinn,Swain,207,104,103,50.24
Quinn,Sejuani,45,23,22,51.11
Quinn,Kennen,86,45,41,52.33
Quinn,Kayn,334,178,156,53.29
Quinn,Veigar,171,84,87,49.12
Quinn,Varus,184,84,100,45.65
Quinn,Senna,168,95,73,56.55
Quinn,Gangplank,82,37,45,45.12
Quinn,Garen,342,168,174,49.12
Quinn,Rengar,125,83,42,66.4
Quinn,Smolder,206,131,75,63.59
Quinn,Skarner,94,62,32,65.96
Quinn,Jinx,406,202,204,49.75
Quinn,Yorick,183,89,94,48.63
Quinn,TwistedFate,66,41,25,62.12
Quinn,Leona,144,71,73,49.31
Quinn,Heimerdinger,134,47,87,35.07
Quinn,Khazix,121,45,76,37.19
Quinn,Janna,82,31,51,37.8
Quinn,Brand,156,79,77,50.64
Quinn,Ekko,157,62,95,39.49
Quinn,Nidalee,56,33,23,58.93
Quinn,Lucian,85,55,30,64.71
Quinn,Chogath,267,160,107,59.93
Quinn,Aatrox,174,83,91,47.7
Quinn,Nunu,169,81,88,47.93
Quinn,Belveth,52,27,25,51.92
Quinn,Urgot,91,16,75,17.58
Quinn,Sion,164,93,71,56.71
Quinn,Draven,161,86,75,53.42
Quinn,Hecarim,52,22,30,42.31
Quinn,Annie,49,37,12,75.51
Quinn,Bard,115,40,75,34.78
Quinn,Galio,164,66,98,40.24
Quinn,Amumu,179,69,110,38.55
Quinn,Neeko,177,112,65,63.28
Quinn,Azir,74,27,47,36.49
Quinn,Shen,88,55,33,62.5
Quinn,Fiora,97,54,43,55.67
Quinn,Camille,55,24,31,43.64
Quinn,Katarina,220,88,132,40
Quinn,Fizz,90,62,28,68.89
Quinn,Sona,44,18,26,40.91
Quinn,Anivia,41,24,17,58.54
Quinn,Leblanc,88,52,36,59.09
Quinn,Illaoi,88,44,44,50
Quinn,TahmKench,200,103,97,51.5
Quinn,Jayce,107,64,43,59.81
Quinn,Viktor,143,85,58,59.44
Quinn,Nilah,107,65,42,60.75
Quinn,Kaisa,327,118,209,36.09
Quinn,MonkeyKing,104,42,62,40.38
Quinn,Orianna,104,84,20,80.77
Quinn,Sivir,102,36,66,35.29
Quinn,Akshan,83,28,55,33.73
Quinn,Zac,61,36,25,59.02
Quinn,Trundle,94,42,52,44.68
Quinn,XinZhao,90,32,58,35.56
Quinn,Syndra,84,36,48,42.86
Quinn,Alistar,90,43,47,47.78
Quinn,Kassadin,45,32,13,71.11
Quinn,Tryndamere,171,62,109,36.26
Quinn,Olaf,65,47,18,72.31
Quinn,Rell,94,51,43,54.26
Quinn,Renata,34,9,25,26.47
Quinn,Shyvana,96,44,52,45.83
Quinn,Zyra,145,73,72,50.34
Quinn,Gwen,167,113,54,67.66
Quinn,Maokai,79,42,37,53.16
Quinn,Blitzcrank,159,56,103,35.22
Quinn,Corki,83,40,43,48.19
Quinn,AurelionSol,85,24,61,28.24
Quinn,Xerath,128,49,79,38.28
Quinn,Riven,99,44,55,44.44
Quinn,Xayah,103,44,59,42.72
Quinn,Karthus,60,33,27,55
Quinn,Ziggs,58,38,20,65.52
Quinn,RekSai,30,30,0,100
Quinn,Kled,45,29,16,64.44
Quinn,Lillia,147,77,70,52.38
Quinn,Rumble,13,7,6,53.85
Quinn,Taliyah,52,9,43,17.31
Quinn,JarvanIV,82,40,42,48.78
Quinn,Ryze,55,19,36,34.55
Kled,Sett,207,80,127,38.65
Kled,Karthus,44,31,13,70.45
Kled,Zed,97,57,40,58.76
Kled,Ashe,244,113,131,46.31
Kled,Maokai,53,29,24,54.72
Kled,Nasus,75,31,44,41.33
Kled,Udyr,44,23,21,52.27
Kled,Jhin,246,105,141,42.68
Kled,Alistar,31,11,20,35.48
Kled,Yone,192,90,102,46.88
Kled,Khazix,73,45,28,61.64
Kled,Varus,83,30,53,36.14
Kled,Samira,125,71,54,56.8
Kled,Yuumi,104,59,45,56.73
Kled,Urgot,79,44,35,55.7
Kled,Shaco,139,38,101,27.34
Kled,Annie,31,6,25,19.35
Kled,Ezreal,213,151,62,70.89
Kled,Lux,315,189,126,60
Kled,Ornn,69,40,29,57.97
Kled,Yorick,136,61,75,44.85
Kled,Zoe,65,29,36,44.62
Kled,Blitzcrank,91,27,64,29.67
Kled,Pantheon,163,76,87,46.63
Kled,Trundle,102,34,68,33.33
Kled,Yasuo,176,65,111,36.93
Kled,Leona,90,42,48,46.67
Kled,Chogath,179,92,87,51.4
Kled,Nocturne,81,34,47,41.98
Kled,Cassiopeia,54,34,20,62.96
Kled,Soraka,77,51,26,66.23
Kled,Ambessa,69,41,28,59.42
Kled,Evelynn,30,19,11,63.33
Kled,Katarina,120,57,63,47.5
Kled,Jinx,222,122,100,54.95
Kled,Singed,33,0,33,0
Kled,MonkeyKing,86,44,42,51.16
Kled,Diana,160,90,70,56.25
Kled,MissFortune,274,119,155,43.43
Kled,Amumu,130,64,66,49.23
Kled,Skarner,47,23,24,48.94
Kled,Warwick,204,120,84,58.82
Kled,Xerath,62,26,36,41.94
Kled,Brand,68,43,25,63.24
Kled,Camille,27,9,18,33.33
Kled,Lillia,51,26,25,50.98
Kled,Leblanc,42,33,9,78.57
Kled,Renata,45,27,18,60
Kled,Kayn,187,115,72,61.5
Kled,Lissandra,59,20,39,33.9
Kled,Kalista,73,39,34,53.42
Kled,JarvanIV,62,31,31,50
Kled,Rumble,42,27,15,64.29
Kled,XinZhao,47,25,22,53.19
Kled,Smolder,46,34,12,73.91
Kled,Seraphine,152,72,80,47.37
Kled,Garen,178,122,56,68.54
Kled,Vayne,138,46,92,33.33
Kled,Thresh,152,66,86,43.42
Kled,Shen,130,75,55,57.69
Kled,Lucian,75,34,41,45.33
Kled,Senna,85,55,30,64.71
Kled,Qiyana,41,21,20,51.22
Kled,Velkoz,84,44,40,52.38
Kled,Teemo,205,101,104,49.27
Kled,Ziggs,62,23,39,37.1
Kled,Pyke,152,98,54,64.47
Kled,Aatrox,114,65,49,57.02
Kled,AurelionSol,66,24,42,36.36
Kled,Aphelios,87,44,43,50.57
Kled,Milio,61,34,27,55.74
Kled,Ahri,155,81,74,52.26
Kled,Lulu,78,44,34,56.41
Kled,Rakan,60,32,28,53.33
Kled,Poppy,75,36,39,48
Kled,Viego,141,60,81,42.55
Kled,Irelia,98,54,44,55.1
Kled,Mel,300,174,126,58
Kled,Zyra,79,34,45,43.04
Kled,Ryze,30,18,12,60
Kled,Belveth,33,33,0,100
Kled,Heimerdinger,81,29,52,35.8
Kled,Gangplank,42,25,17,59.52
Kled,Vex,60,35,25,58.33
Kled,KSante,39,33,6,84.62
Kled,Mordekaiser,211,77,134,36.49
Kled,Veigar,143,78,65,54.55
Kled,Riven,54,34,20,62.96
Kled,Talon,107,50,57,46.73
Kled,Sona,49,30,19,61.22
Kled,Kayle,103,60,43,58.25
Kled,LeeSin,99,44,55,44.44
Kled,Sylas,117,68,49,58.12
Kled,MasterYi,89,42,47,47.19
Kled,Sivir,40,16,24,40
Kled,Renekton,59,37,22,62.71
Kled,Sejuani,38,16,22,42.11
Kled,Ekko,111,65,46,58.56
Kled,Jayce,35,17,18,48.57
Kled,Kaisa,148,96,52,64.86
Kled,Vi,75,30,45,40
Kled,Rammus,47,17,30,36.17
Kled,Jax,76,24,52,31.58
Kled,Morgana,188,100,88,53.19
Kled,Darius,252,121,131,48.02
Kled,TwistedFate,40,24,16,60
Kled,Nami,133,69,64,51.88
Kled,Volibear,125,66,59,52.8
Kled,Hecarim,34,26,8,76.47
Kled,Kassadin,17,3,14,17.65
Kled,Orianna,43,24,19,55.81
Kled,Kennen,48,29,19,60.42
Kled,Elise,102,59,43,57.84
Kled,Nilah,72,43,29,59.72
Kled,Rengar,55,30,25,54.55
Kled,Tristana,159,68,91,42.77
Kled,Caitlyn,291,154,137,52.92
Kled,Anivia,16,9,7,56.25
Kled,Nunu,78,48,30,61.54
Kled,Braum,72,28,44,38.89
Kled,Kindred,94,61,33,64.89
Kled,Nautilus,121,47,74,38.84
Kled,Syndra,74,41,33,55.41
Kled,TahmKench,148,97,51,65.54
Kled,Twitch,109,39,70,35.78
Kled,Rell,40,21,19,52.5
Kled,DrMundo,103,37,66,35.92
Kled,Xayah,79,50,29,63.29
Kled,Briar,162,82,80,50.62
Kled,Neeko,72,28,44,38.89
Kled,Gragas,56,20,36,35.71
Kled,Tryndamere,76,42,34,55.26
Kled,Akshan,65,26,39,40
Kled,Malzahar,69,31,38,44.93
Kled,Draven,48,11,37,22.92
Kled,Olaf,22,22,0,100
Kled,Graves,35,22,13,62.86
Kled,Aurora,76,20,56,26.32
Kled,Malphite,79,21,58,26.58
Kled,Zeri,47,32,15,68.09
Kled,FiddleSticks,54,17,37,31.48
Kled,Viktor,92,47,45,51.09
Kled,RekSai,32,22,10,68.75
Kled,Ivern,33,23,10,69.7
Kled,Nidalee,26,13,13,50
Kled,Gnar,56,27,29,48.21
Kled,Fizz,67,29,38,43.28
Kled,Vladimir,38,17,21,44.74
Kled,Bard,22,3,19,13.64
Kled,Swain,127,65,62,51.18
Kled,Galio,67,38,29,56.72
Kled,Gwen,86,55,31,63.95
Kled,Taliyah,46,19,27,41.3
Kled,Corki,55,35,20,63.64
Kled,Akali,145,80,65,55.17
Kled,Illaoi,36,16,20,44.44
Kled,Sion,108,34,74,31.48
Kled,Fiora,71,43,28,60.56
Kled,Hwei,77,46,31,59.74
Kled,Naafiri,66,44,22,66.67
Kled,KogMaw,62,21,41,33.87
Kled,Zac,58,18,40,31.03
Kled,Quinn,45,16,29,35.56
Kled,Zilean,56,21,35,37.5
Kled,Shyvana,28,20,8,71.43
Kled,Azir,51,36,15,70.59
Kled,Karma,79,31,48,39.24
Kled,Janna,40,6,34,15
Kled,Taric,19,12,7,63.16
Rumble,Poppy,115,55,60,47.83
Rumble,Viego,143,53,90,37.06
Rumble,Zed,91,61,30,67.03
Rumble,Mel,231,127,104,54.98
Rumble,Lux,217,98,119,45.16
Rumble,Yorick,94,45,49,47.87
Rumble,Shaco,132,66,66,50
Rumble,Kalista,33,13,20,39.39
Rumble,Blitzcrank,38,29,9,76.32
Rumble,Sett,182,86,96,47.25
Rumble,Elise,56,34,22,60.71
Rumble,Katarina,96,58,38,60.42
Rumble,MissFortune,207,98,109,47.34
Rumble,Morgana,110,41,69,37.27
Rumble,Aatrox,129,54,75,41.86
Rumble,Rengar,39,15,24,38.46
Rumble,RekSai,24,9,15,37.5
Rumble,Twitch,76,41,35,53.95
Rumble,Sona,29,9,20,31.03
Rumble,Kayle,73,31,42,42.47
Rumble,Warwick,192,73,119,38.02
Rumble,Fizz,62,27,35,43.55
Rumble,Tristana,89,38,51,42.7
Rumble,Seraphine,112,47,65,41.96
Rumble,Mordekaiser,151,63,88,41.72
Rumble,Graves,42,27,15,64.29
Rumble,Yasuo,277,130,147,46.93
Rumble,Ezreal,218,132,86,60.55
Rumble,Maokai,40,7,33,17.5
Rumble,Kled,42,15,27,35.71
Rumble,Varus,98,35,63,35.71
Rumble,Ekko,63,37,26,58.73
Rumble,Thresh,150,90,60,60
Rumble,Yone,178,88,90,49.44
Rumble,LeeSin,117,47,70,40.17
Rumble,Vladimir,44,15,29,34.09
Rumble,Gangplank,48,17,31,35.42
Rumble,MasterYi,108,43,65,39.81
Rumble,Aurora,105,29,76,27.62
Rumble,Chogath,127,64,63,50.39
Rumble,Darius,216,93,123,43.06
Rumble,Evelynn,63,35,28,55.56
Rumble,Irelia,72,25,47,34.72
Rumble,Jhin,177,68,109,38.42
Rumble,Ivern,39,15,24,38.46
Rumble,Vex,36,16,20,44.44
Rumble,Shen,117,56,61,47.86
Rumble,Lissandra,39,9,30,23.08
Rumble,Soraka,82,22,60,26.83
Rumble,Kayn,176,81,95,46.02
Rumble,Akali,115,53,62,46.09
Rumble,Kaisa,156,100,56,64.1
Rumble,Briar,92,47,45,51.09
Rumble,Sivir,37,14,23,37.84
Rumble,JarvanIV,47,35,12,74.47
Rumble,Teemo,277,144,133,51.99
Rumble,Malzahar,59,26,33,44.07
Rumble,Aphelios,72,37,35,51.39
Rumble,Sylas,123,59,64,47.97
Rumble,Nasus,85,38,47,44.71
Rumble,Caitlyn,192,84,108,43.75
Rumble,Pantheon,205,79,126,38.54
Rumble,Alistar,52,27,25,51.92
Rumble,Lillia,47,35,12,74.47
Rumble,Jinx,248,140,108,56.45
Rumble,Swain,128,75,53,58.59
Rumble,Renekton,52,29,23,55.77
Rumble,Leona,85,42,43,49.41
Rumble,Illaoi,66,26,40,39.39
Rumble,Jax,67,32,35,47.76
Rumble,KogMaw,48,6,42,12.5
Rumble,Pyke,114,61,53,53.51
Rumble,Amumu,116,64,52,55.17
Rumble,Ryze,30,24,6,80
Rumble,Smolder,86,56,30,65.12
Rumble,Ashe,154,68,86,44.16
Rumble,Milio,87,30,57,34.48
Rumble,Nocturne,65,28,37,43.08
Rumble,Vayne,122,77,45,63.11
Rumble,Qiyana,69,37,32,53.62
Rumble,Rammus,31,12,19,38.71
Rumble,Ahri,154,56,98,36.36
Rumble,Rell,66,31,35,46.97
Rumble,Trundle,65,34,31,52.31
Rumble,Volibear,80,39,41,48.75
Rumble,Urgot,36,15,21,41.67
Rumble,Skarner,57,24,33,42.11
Rumble,Braum,38,10,28,26.32
Rumble,MonkeyKing,57,17,40,29.82
Rumble,Yuumi,121,60,61,49.59
Rumble,Fiora,31,17,14,54.84
Rumble,Syndra,62,27,35,43.55
Rumble,KSante,46,20,26,43.48
Rumble,Viktor,53,33,20,62.26
Rumble,Diana,142,63,79,44.37
Rumble,Gwen,68,47,21,69.12
Rumble,Xerath,153,62,91,40.52
Rumble,Samira,70,21,49,30
Rumble,Garen,122,44,78,36.07
Rumble,TahmKench,110,48,62,43.64
Rumble,Veigar,73,36,37,49.32
Rumble,Sion,63,25,38,39.68
Rumble,Kassadin,19,6,13,31.58
Rumble,Nunu,93,42,51,45.16
Rumble,Velkoz,51,17,34,33.33
Rumble,Talon,73,41,32,56.16
Rumble,XinZhao,51,26,25,50.98
Rumble,TwistedFate,42,19,23,45.24
Rumble,Bard,42,29,13,69.05
Rumble,Zeri,79,39,40,49.37
Rumble,Olaf,23,13,10,56.52
Rumble,Belveth,30,20,10,66.67
Rumble,Orianna,74,29,45,39.19
Rumble,Vi,83,45,38,54.22
Rumble,Xayah,70,37,33,52.86
Rumble,Naafiri,61,16,45,26.23
Rumble,Nami,92,46,46,50
Rumble,Gnar,41,32,9,78.05
Rumble,Azir,31,21,10,67.74
Rumble,Kindred,61,35,26,57.38
Rumble,Akshan,31,28,3,90.32
Rumble,Zyra,72,38,34,52.78
Rumble,Rakan,77,32,45,41.56
Rumble,Leblanc,68,42,26,61.76
Rumble,Sejuani,50,23,27,46
Rumble,Khazix,61,21,40,34.43
Rumble,Lulu,100,52,48,52
Rumble,Taric,32,27,5,84.38
Rumble,Tryndamere,28,13,15,46.43
Rumble,Nautilus,121,44,77,36.36
Rumble,Anivia,29,16,13,55.17
Rumble,Brand,49,16,33,32.65
Rumble,Singed,45,6,39,13.33
Rumble,Ziggs,48,13,35,27.08
Rumble,Udyr,50,31,19,62
Rumble,Shyvana,36,16,20,44.44
Rumble,DrMundo,66,19,47,28.79
Rumble,Heimerdinger,47,28,19,59.57
Rumble,Draven,79,32,47,40.51
Rumble,AurelionSol,50,39,11,78
Rumble,Ornn,61,32,29,52.46
Rumble,Galio,93,43,50,46.24
Rumble,Malphite,104,43,61,41.35
Rumble,Senna,94,43,51,45.74
Rumble,Hecarim,41,23,18,56.1
Rumble,FiddleSticks,61,27,34,44.26
Rumble,Karma,76,39,37,51.32
Rumble,Riven,66,45,21,68.18
Rumble,Zilean,40,26,14,65
Rumble,Quinn,13,6,7,46.15
Rumble,Nilah,41,28,13,68.29
Rumble,Nidalee,32,26,6,81.25
Rumble,Jayce,59,41,18,69.49
Rumble,Ambessa,63,31,32,49.21
Rumble,Lucian,73,35,38,47.95
Rumble,Janna,42,15,27,35.71
Rumble,Camille,23,20,3,86.96
Rumble,Kennen,21,15,6,71.43
Rumble,Hwei,46,23,23,50
Rumble,Gragas,58,24,34,41.38
Rumble,Neeko,52,35,17,67.31
Rumble,Corki,45,9,36,20
Rumble,Cassiopeia,26,16,10,61.54
Rumble,Karthus,18,3,15,16.67
Rumble,Zoe,33,14,19,42.42
Rumble,Annie,10,0,10,0
Rumble,Taliyah,32,12,20,37.5
Rumble,Zac,18,12,6,66.67
Rumble,Renata,20,14,6,70
