Name,Opponent,Games,Wins,Losses,WR
Sett,Malphite,3184,1546,1638,48.56
Sett,Ekko,2867,1505,1362,52.49
Sett,Hwei,2141,1153,988,53.85
Sett,Lucian,2101,1122,979,53.4
Sett,Maokai,1571,770,801,49.01
Sett,Yorick,2919,1392,1527,47.69
Sett,Viego,4529,2433,2096,53.72
Sett,Diana,5108,2653,2455,51.94
Sett,Seraphine,2830,1520,1310,53.71
Sett,Rakan,1360,672,688,49.41
Sett,Gwen,1822,1051,771,57.68
Sett,JarvanIV,1632,858,774,52.57
Sett,Yone,6661,3658,3003,54.92
Sett,Zyra,2744,1366,1378,49.78
Sett,Kayle,2231,1102,1129,49.39
Sett,MonkeyKing,2094,1023,1071,48.85
Sett,RekSai,374,232,142,62.03
Sett,Warwick,5150,2550,2600,49.51
Sett,Briar,2458,1250,1208,50.85
Sett,Yasuo,6842,3434,3408,50.19
Sett,Irelia,2878,1579,1299,54.86
Sett,Lux,8238,4193,4045,50.9
Sett,Pantheon,5393,2797,2596,51.86
Sett,Kayn,4725,2457,2268,52
Sett,Leblanc,1763,865,898,49.06
Sett,Sivir,1577,736,841,46.67
Sett,Pyke,2894,1556,1338,53.77
Sett,Braum,1679,840,839,50.03
Sett,XinZhao,2056,1038,1018,50.49
Sett,Chogath,4501,2424,2077,53.85
Sett,Taliyah,765,373,392,48.76
Sett,Darius,7463,3940,3523,52.79
Sett,Volibear,4054,1964,2090,48.45
Sett,Ezreal,6849,3663,3186,53.48
Sett,Brand,2240,1206,1034,53.84
Sett,Singed,818,416,402,50.86
Sett,Ryze,988,511,477,51.72
Sett,Samira,2850,1477,1373,51.82
Sett,Soraka,1693,826,867,48.79
Sett,KSante,1811,984,827,54.33
Sett,Azir,1142,598,544,52.36
Sett,Aphelios,1703,944,759,55.43
Sett,Gnar,1336,672,664,50.3
Sett,Nunu,1980,1100,880,55.56
Sett,Jhin,6219,3284,2935,52.81
Sett,Shaco,3092,1511,1581,48.87
Sett,Ahri,4460,2263,2197,50.74
Sett,Ashe,6457,3393,3064,52.55
Sett,Poppy,1941,1015,926,52.29
Sett,Nami,2992,1571,1421,52.51
Sett,Fiora,1285,742,543,57.74
Sett,Malzahar,3211,1488,1723,46.34
Sett,Zilean,859,450,409,52.39
Sett,Mel,6621,3520,3101,53.16
Sett,Tristana,3226,1750,1476,54.25
Sett,Camille,1194,605,589,50.67
Sett,MasterYi,3853,2051,1802,53.23
Sett,LeeSin,4507,2450,2057,54.36
Sett,Riven,1478,787,691,53.25
Sett,Jax,2978,1547,1431,51.95
Sett,Naafiri,1164,564,600,48.45
Sett,MissFortune,7677,3823,3854,49.8
Sett,Nocturne,3793,1845,1948,48.64
Sett,Aatrox,3354,1681,1673,50.12
Sett,Swain,3305,1602,1703,48.47
Sett,Jinx,8284,4053,4231,48.93
Sett,Ambessa,2141,1156,985,53.99
Sett,Nilah,1294,640,654,49.46
Sett,Kled,589,340,249,57.72
Sett,Leona,2859,1486,1373,51.98
Sett,Nasus,2221,1061,1160,47.77
Sett,Kindred,1638,908,730,55.43
Sett,Nautilus,3647,1919,1728,52.62
Sett,Elise,2186,1162,1024,53.16
Sett,Garen,5553,2795,2758,50.33
Sett,Senna,2457,1287,1170,52.38
Sett,Illaoi,1824,914,910,50.11
Sett,Sylas,4182,2324,1858,55.57
Sett,Cassiopeia,937,510,427,54.43
Sett,Caitlyn,8462,4482,3980,52.97
Sett,Teemo,3589,1788,1801,49.82
Sett,Mordekaiser,5191,2530,2661,48.74
Sett,Sejuani,1416,723,693,51.06
Sett,Alistar,1345,679,666,50.48
Sett,Lulu,3505,1773,1732,50.58
Sett,DrMundo,2022,1010,1012,49.95
Sett,Viktor,2608,1291,1317,49.5
Sett,Rammus,957,477,480,49.84
Sett,Fizz,1682,888,794,52.79
Sett,TahmKench,2971,1608,1363,54.12
Sett,Jayce,1282,653,629,50.94
Sett,Skarner,982,531,451,54.07
Sett,Veigar,3377,1688,1689,49.99
Sett,Karma,3055,1563,1492,51.16
Sett,AurelionSol,1315,662,653,50.34
Sett,Kalista,1039,575,464,55.34
Sett,Talon,1892,1098,794,58.03
Sett,Evelynn,1246,622,624,49.92
Sett,Graves,1992,1032,960,51.81
Sett,Twitch,2583,1434,1149,55.52
Sett,Kaisa,5009,2600,2409,51.91
Sett,Taric,670,293,377,43.73
Sett,Aurora,2408,1313,1095,54.53
Sett,Zeri,1275,692,583,54.27
Sett,Vayne,3758,1788,1970,47.58
Sett,Draven,1585,914,671,57.67
Sett,Vex,1725,868,857,50.32
Sett,Gragas,1892,1000,892,52.85
Sett,Annie,1046,602,444,57.55
Sett,Ornn,1396,732,664,52.44
Sett,Zed,3360,1776,1584,52.86
Sett,Ivern,519,255,264,49.13
Sett,Yuumi,2662,1413,1249,53.08
Sett,Rumble,819,425,394,51.89
Sett,Akshan,1010,545,465,53.96
Sett,Sona,971,486,485,50.05
Sett,Morgana,4080,2022,2058,49.56
Sett,Ziggs,1291,677,614,52.44
Sett,Akali,3552,1905,1647,53.63
Sett,Shen,2236,1178,1058,52.68
Sett,Khazix,1599,901,698,56.35
Sett,Varus,2925,1554,1371,53.13
Sett,Thresh,4238,2147,2091,50.66
Sett,Blitzcrank,2666,1429,1237,53.6
Sett,Urgot,1830,906,924,49.51
Sett,Anivia,1057,517,540,48.91
Sett,Gangplank,1390,801,589,57.63
Sett,Bard,923,454,469,49.19
Sett,Kennen,961,517,444,53.8
Sett,TwistedFate,1094,575,519,52.56
Sett,Qiyana,851,543,308,63.81
Sett,Zoe,1247,667,580,53.49
Sett,Milio,1612,788,824,48.88
Sett,Rell,1755,898,857,51.17
Sett,Vladimir,1819,959,860,52.72
Sett,FiddleSticks,1627,858,769,52.74
Sett,Hecarim,1160,658,502,56.72
Sett,Shyvana,820,436,384,53.17
Sett,Smolder,2219,1193,1026,53.76
Sett,Neeko,1760,962,798,54.66
Sett,Heimerdinger,1693,831,862,49.08
Sett,Zac,1465,757,708,51.67
Sett,Katarina,2677,1445,1232,53.98
Sett,Syndra,1790,899,891,50.22
Sett,Udyr,1253,637,616,50.84
Sett,Xayah,1812,983,829,54.25
Sett,Vi,3098,1534,1564,49.52
Sett,Tryndamere,1683,885,798,52.58
Sett,Orianna,1213,639,574,52.68
Sett,Kassadin,560,228,332,40.71
Sett,Karthus,892,474,418,53.14
Sett,Galio,2915,1437,1478,49.3
Sett,Sion,2703,1334,1369,49.35
Sett,Rengar,1041,641,400,61.58
Sett,Corki,1106,628,478,56.78
Sett,Renekton,1981,1061,920,53.56
Sett,Xerath,2851,1488,1363,52.19
Sett,Trundle,1884,907,977,48.14
Sett,Lillia,1806,912,894,50.5
Sett,Quinn,1038,549,489,52.89
Sett,Amumu,3421,1695,1726,49.55
Sett,Lissandra,971,502,469,51.7
Sett,Olaf,749,400,349,53.4
Sett,Nidalee,913,486,427,53.23
Sett,Renata,509,296,213,58.15
Sett,Janna,835,411,424,49.22
Sett,Velkoz,1926,1020,906,52.96
Sett,KogMaw,1033,473,560,45.79
Sett,Belveth,757,428,329,56.54
Warwick,Malphite,2986,1488,1498,49.83
Warwick,Ekko,2888,1465,1423,50.73
Warwick,Hwei,1971,1006,965,51.04
Warwick,Lucian,1966,1072,894,54.53
Warwick,Maokai,1315,723,592,54.98
Warwick,Aatrox,2741,1430,1311,52.17
Warwick,Sylas,3960,2063,1897,52.1
Warwick,Diana,4913,2701,2212,54.98
Warwick,Varus,2513,1384,1129,55.07
Warwick,Blitzcrank,2318,1318,1000,56.86
Warwick,Vladimir,1657,858,799,51.78
Warwick,Darius,6587,3387,3200,51.42
Warwick,Lux,8162,4251,3911,52.08
Warwick,KogMaw,1049,500,549,47.66
Warwick,Yuumi,2425,1292,1133,53.28
Warwick,Mordekaiser,5182,2688,2494,51.87
Warwick,Viego,4277,2272,2005,53.12
Warwick,Irelia,2569,1376,1193,53.56
Warwick,Jhin,6404,3201,3203,49.98
Warwick,MonkeyKing,2110,1103,1007,52.27
Warwick,Kayn,5161,2829,2332,54.81
Warwick,Yasuo,6387,3270,3117,51.2
Warwick,Kaisa,4630,2473,2157,53.41
Warwick,Milio,1849,917,932,49.59
Warwick,Illaoi,1594,867,727,54.39
Warwick,Yone,5858,3290,2568,56.16
Warwick,Tristana,3163,1684,1479,53.24
Warwick,Morgana,4204,2104,2100,50.05
Warwick,Yorick,3531,1774,1757,50.24
Warwick,LeeSin,3845,2045,1800,53.19
Warwick,MissFortune,7783,4019,3764,51.64
Warwick,Mel,6323,3486,2837,55.13
Warwick,Shaco,3069,1612,1457,52.53
Warwick,AurelionSol,1268,574,694,45.27
Warwick,Ashe,5992,3198,2794,53.37
Warwick,Velkoz,1856,985,871,53.07
Warwick,Teemo,4171,2075,2096,49.75
Warwick,Hecarim,1084,583,501,53.78
Warwick,Veigar,3497,1846,1651,52.79
Warwick,Thresh,4271,2227,2044,52.14
Warwick,Sett,5150,2600,2550,50.49
Warwick,Amumu,3861,1894,1967,49.05
Warwick,Caitlyn,8404,4199,4205,49.96
Warwick,Poppy,1766,957,809,54.19
Warwick,Zed,3204,1697,1507,52.97
Warwick,MasterYi,4319,2257,2062,52.26
Warwick,Rell,1631,803,828,49.23
Warwick,Jax,3071,1621,1450,52.78
Warwick,Briar,2795,1337,1458,47.84
Warwick,Ahri,4299,2316,1983,53.87
Warwick,Zeri,1275,668,607,52.39
Warwick,Leblanc,1542,865,677,56.1
Warwick,Ezreal,6027,3267,2760,54.21
Warwick,Kindred,1456,771,685,52.95
Warwick,Aphelios,1808,998,810,55.2
Warwick,Pyke,2856,1512,1344,52.94
Warwick,Vi,3050,1637,1413,53.67
Warwick,Azir,1082,605,477,55.91
Warwick,Nautilus,3514,1897,1617,53.98
Warwick,Gangplank,1312,695,617,52.97
Warwick,Annie,975,465,510,47.69
Warwick,Gwen,1883,1045,838,55.5
Warwick,Aurora,2219,1103,1116,49.71
Warwick,Karma,2783,1470,1313,52.82
Warwick,Garen,4954,2503,2451,50.52
Warwick,Gnar,1302,713,589,54.76
Warwick,Nunu,2075,1106,969,53.3
Warwick,Elise,1736,985,751,56.74
Warwick,Twitch,2647,1307,1340,49.38
Warwick,Heimerdinger,1669,810,859,48.53
Warwick,Trundle,2199,1135,1064,51.61
Warwick,Gragas,1682,875,807,52.02
Warwick,Vex,1750,925,825,52.86
Warwick,FiddleSticks,1477,742,735,50.24
Warwick,Soraka,1803,895,908,49.64
Warwick,KSante,1258,628,630,49.92
Warwick,Lulu,3175,1619,1556,50.99
Warwick,Corki,1029,570,459,55.39
Warwick,Pantheon,4779,2485,2294,52
Warwick,Karthus,852,464,388,54.46
Warwick,Nilah,1260,613,647,48.65
Warwick,Braum,1475,693,782,46.98
Warwick,Akali,3414,1898,1516,55.59
Warwick,Nasus,2601,1310,1291,50.37
Warwick,Renata,598,302,296,50.5
Warwick,Lillia,1806,926,880,51.27
Warwick,Chogath,4083,2071,2012,50.72
Warwick,Alistar,1169,555,614,47.48
Warwick,Samira,2610,1447,1163,55.44
Warwick,Olaf,772,378,394,48.96
Warwick,Katarina,2414,1431,983,59.28
Warwick,Smolder,2030,1093,937,53.84
Warwick,Udyr,1227,610,617,49.71
Warwick,Galio,2666,1245,1421,46.7
Warwick,Fizz,1961,1039,922,52.98
Warwick,Taric,673,316,357,46.95
Warwick,Evelynn,1344,734,610,54.61
Warwick,Kayle,2109,1096,1013,51.97
Warwick,Volibear,4256,2221,2035,52.19
Warwick,Rengar,1029,548,481,53.26
Warwick,Vayne,3896,2024,1872,51.95
Warwick,Senna,2448,1242,1206,50.74
Warwick,Zilean,820,417,403,50.85
Warwick,Fiora,1149,617,532,53.7
Warwick,Sivir,1597,897,700,56.17
Warwick,Xerath,2531,1246,1285,49.23
Warwick,Leona,2787,1432,1355,51.38
Warwick,Singed,808,389,419,48.14
Warwick,Belveth,765,383,382,50.07
Warwick,Neeko,1740,899,841,51.67
Warwick,Tryndamere,1979,1114,865,56.29
Warwick,Nocturne,3957,1982,1975,50.09
Warwick,Seraphine,2931,1500,1431,51.18
Warwick,Ivern,490,259,231,52.86
Warwick,Draven,1696,872,824,51.42
Warwick,Ryze,1110,519,591,46.76
Warwick,Nami,2846,1360,1486,47.79
Warwick,Ornn,1402,773,629,55.14
Warwick,Zoe,1053,610,443,57.93
Warwick,Jinx,8292,4159,4133,50.16
Warwick,Graves,1779,900,879,50.59
Warwick,Syndra,1776,861,915,48.48
Warwick,Urgot,1705,775,930,45.45
Warwick,Qiyana,751,460,291,61.25
Warwick,Quinn,1145,548,597,47.86
Warwick,Kalista,968,535,433,55.27
Warwick,Akshan,1132,596,536,52.65
Warwick,Skarner,858,497,361,57.93
Warwick,Swain,3318,1706,1612,51.42
Warwick,Khazix,1555,855,700,54.98
Warwick,Ziggs,1248,648,600,51.92
Warwick,TahmKench,2890,1498,1392,51.83
Warwick,Kassadin,589,263,326,44.65
Warwick,Riven,1290,712,578,55.19
Warwick,Zac,1242,577,665,46.46
Warwick,Anivia,1031,511,520,49.56
Warwick,Rumble,768,440,328,57.29
Warwick,Sejuani,1325,668,657,50.42
Warwick,Sona,1092,525,567,48.08
Warwick,Bard,837,487,350,58.18
Warwick,Sion,2351,1168,1183,49.68
Warwick,Ambessa,1768,949,819,53.68
Warwick,Camille,1091,600,491,55
Warwick,Xayah,1531,764,767,49.9
Warwick,DrMundo,1918,996,922,51.93
Warwick,Kled,582,288,294,49.48
Warwick,Malzahar,2962,1496,1466,50.51
Warwick,Brand,2366,1207,1159,51.01
Warwick,JarvanIV,1609,761,848,47.3
Warwick,Shyvana,821,409,412,49.82
Warwick,XinZhao,1950,995,955,51.03
Warwick,Janna,895,444,451,49.61
Warwick,Jayce,1122,580,542,51.69
Warwick,Talon,1838,1007,831,54.79
Warwick,Rakan,1335,708,627,53.03
Warwick,Shen,1900,1026,874,54
Warwick,Viktor,2204,1132,1072,51.36
Warwick,Rammus,1199,610,589,50.88
Warwick,Kennen,811,399,412,49.2
Warwick,Cassiopeia,1007,522,485,51.84
Warwick,Naafiri,1232,628,604,50.97
Warwick,Renekton,1493,756,737,50.64
Warwick,RekSai,345,200,145,57.97
Warwick,Taliyah,669,331,338,49.48
Warwick,Zyra,2684,1427,1257,53.17
Warwick,TwistedFate,1018,547,471,53.73
Warwick,Orianna,1342,735,607,54.77
Warwick,Nidalee,729,436,293,59.81
Warwick,Lissandra,977,540,437,55.27
Shen,Malphite,1167,614,553,52.61
Shen,Ekko,1197,610,587,50.96
Shen,Hwei,908,448,460,49.34
Shen,Lucian,916,473,443,51.64
Shen,Maokai,596,292,304,48.99
Shen,Annie,358,193,165,53.91
Shen,Kayn,2043,995,1048,48.7
Shen,Aatrox,1231,626,605,50.85
Shen,MissFortune,3137,1487,1650,47.4
Shen,Pyke,1286,707,579,54.98
Shen,Riven,664,325,339,48.95
Shen,Ivern,234,115,119,49.15
Shen,Yasuo,2715,1406,1309,51.79
Shen,Swain,1456,688,768,47.25
Shen,Nami,1300,585,715,45
Shen,Gangplank,793,370,423,46.66
Shen,Taliyah,364,157,207,43.13
Shen,Sivir,702,337,365,48.01
Shen,Soraka,858,442,416,51.52
Shen,Mordekaiser,1927,946,981,49.09
Shen,Diana,2031,1048,983,51.6
Shen,Ezreal,2782,1530,1252,55
Shen,Thresh,2024,1071,953,52.92
Shen,Samira,1039,551,488,53.03
Shen,MasterYi,1510,729,781,48.28
Shen,Orianna,724,338,386,46.69
Shen,Nautilus,1556,819,737,52.63
Shen,Lillia,794,397,397,50
Shen,Ashe,2620,1321,1299,50.42
Shen,Velkoz,909,447,462,49.17
Shen,Jax,1257,628,629,49.96
Shen,Katarina,1020,582,438,57.06
Shen,Jhin,2573,1274,1299,49.51
Shen,Ambessa,965,586,379,60.73
Shen,Rammus,415,224,191,53.98
Shen,Aurora,1120,591,529,52.77
Shen,Caitlyn,3477,1837,1640,52.83
Shen,Talon,737,388,349,52.65
Shen,LeeSin,1750,905,845,51.71
Shen,Garen,2338,1144,1194,48.93
Shen,Senna,1115,536,579,48.07
Shen,Kayle,955,454,501,47.54
Shen,Morgana,1730,796,934,46.01
Shen,Yorick,1269,575,694,45.31
Shen,Volibear,1471,742,729,50.44
Shen,Blitzcrank,1118,538,580,48.12
Shen,Malzahar,1330,636,694,47.82
Shen,Viego,1862,948,914,50.91
Shen,Galio,1238,616,622,49.76
Shen,Vayne,1866,879,987,47.11
Shen,Sylas,1654,891,763,53.87
Shen,Renekton,552,292,260,52.9
Shen,Leona,1125,556,569,49.42
Shen,Sett,2236,1058,1178,47.32
Shen,Rengar,541,303,238,56.01
Shen,Kalista,407,243,164,59.71
Shen,DrMundo,682,269,413,39.44
Shen,Darius,2564,1222,1342,47.66
Shen,Viktor,1165,546,619,46.87
Shen,Lulu,1701,804,897,47.27
Shen,Chogath,1729,843,886,48.76
Shen,Ryze,500,240,260,48
Shen,Janna,468,237,231,50.64
Shen,Zoe,503,290,213,57.65
Shen,Gragas,926,505,421,54.54
Shen,Pantheon,2104,1071,1033,50.9
Shen,Kaisa,2294,1223,1071,53.31
Shen,XinZhao,844,471,373,55.81
Shen,Hecarim,532,268,264,50.38
Shen,Braum,777,394,383,50.71
Shen,Urgot,602,281,321,46.68
Shen,Tristana,1288,648,640,50.31
Shen,Zyra,1125,578,547,51.38
Shen,Illaoi,699,320,379,45.78
Shen,Lux,3437,1706,1731,49.64
Shen,Camille,572,301,271,52.62
Shen,Khazix,734,388,346,52.86
Shen,Heimerdinger,688,340,348,49.42
Shen,Mel,2648,1326,1322,50.08
Shen,MonkeyKing,897,461,436,51.39
Shen,Vladimir,842,402,440,47.74
Shen,Shaco,1373,720,653,52.44
Shen,Jinx,3539,1609,1930,45.46
Shen,Nunu,837,403,434,48.15
Shen,Twitch,1102,597,505,54.17
Shen,Karma,1470,712,758,48.44
Shen,Skarner,396,195,201,49.24
Shen,Yuumi,1156,579,577,50.09
Shen,Singed,483,245,238,50.72
Shen,Bard,474,247,227,52.11
Shen,Evelynn,514,253,261,49.22
Shen,Zeri,572,294,278,51.4
Shen,Ziggs,551,278,273,50.45
Shen,Brand,1049,472,577,45
Shen,Seraphine,1064,554,510,52.07
Shen,Sejuani,619,298,321,48.14
Shen,Poppy,880,447,433,50.8
Shen,Irelia,1077,582,495,54.04
Shen,Leblanc,760,359,401,47.24
Shen,Vi,1255,578,677,46.06
Shen,FiddleSticks,660,348,312,52.73
Shen,Nasus,931,465,466,49.95
Shen,Ahri,1741,890,851,51.12
Shen,Trundle,807,400,407,49.57
Shen,Briar,1053,519,534,49.29
Shen,KSante,671,369,302,54.99
Shen,Vex,681,347,334,50.95
Shen,Fiora,573,274,299,47.82
Shen,Elise,946,503,443,53.17
Shen,Draven,739,385,354,52.1
Shen,Kled,337,160,177,47.48
Shen,Syndra,801,386,415,48.19
Shen,Teemo,1594,855,739,53.64
Shen,Amumu,1503,670,833,44.58
Shen,Gnar,622,355,267,57.07
Shen,Smolder,981,517,464,52.7
Shen,Warwick,1900,874,1026,46
Shen,Ornn,622,321,301,51.61
Shen,Tryndamere,767,382,385,49.8
Shen,Yone,2497,1349,1148,54.02
Shen,Varus,1193,591,602,49.54
Shen,Neeko,676,349,327,51.63
Shen,Nidalee,386,232,154,60.1
Shen,Azir,539,257,282,47.68
Shen,Alistar,542,275,267,50.74
Shen,Akshan,466,244,222,52.36
Shen,Rell,771,338,433,43.84
Shen,Xayah,826,404,422,48.91
Shen,Sona,436,195,241,44.72
Shen,Udyr,580,310,270,53.45
Shen,Aphelios,782,415,367,53.07
Shen,Veigar,1441,649,792,45.04
Shen,Zed,1482,731,751,49.33
Shen,Lissandra,477,207,270,43.4
Shen,AurelionSol,599,291,308,48.58
Shen,Sion,1266,666,600,52.61
Shen,Qiyana,379,223,156,58.84
Shen,Karthus,334,174,160,52.1
Shen,Nocturne,1497,699,798,46.69
Shen,Naafiri,540,295,245,54.63
Shen,Xerath,1125,569,556,50.58
Shen,Rumble,376,184,192,48.94
Shen,Corki,563,303,260,53.82
Shen,Nilah,536,232,304,43.28
Shen,Rakan,618,340,278,55.02
Shen,Renata,273,147,126,53.85
Shen,TahmKench,1141,627,514,54.95
Shen,Milio,723,364,359,50.35
Shen,Taric,308,133,175,43.18
Shen,Akali,1242,622,620,50.08
Shen,JarvanIV,942,471,471,50
Shen,RekSai,220,109,111,49.55
Shen,KogMaw,473,209,264,44.19
Shen,Jayce,523,269,254,51.43
Shen,Fizz,787,431,356,54.76
Shen,Gwen,906,468,438,51.66
Shen,Belveth,342,196,146,57.31
Shen,Kindred,664,369,295,55.57
Shen,Zac,579,290,289,50.09
Shen,Kassadin,301,160,141,53.16
Shen,Kennen,347,193,154,55.62
Shen,Zilean,463,251,212,54.21
Shen,Graves,837,416,421,49.7
Shen,Shyvana,379,204,175,53.83
Shen,Olaf,404,196,208,48.51
Shen,Anivia,446,242,204,54.26
Shen,TwistedFate,413,226,187,54.72
Shen,Quinn,370,159,211,42.97
Shen,Cassiopeia,332,166,166,50
Tristana,Malphite,2003,949,1054,47.38
Tristana,Ekko,1842,891,951,48.37
Tristana,Hwei,1312,650,662,49.54
Tristana,Lucian,1363,724,639,53.12
Tristana,Maokai,848,445,403,52.48
Tristana,Renekton,974,481,493,49.38
Tristana,Kayn,2961,1477,1484,49.88
Tristana,Katarina,1586,848,738,53.47
Tristana,Draven,1035,506,529,48.89
Tristana,Yuumi,1736,894,842,51.5
Tristana,Vladimir,1288,559,729,43.4
Tristana,Darius,3832,1850,1982,48.28
Tristana,Lux,5198,2531,2667,48.69
Tristana,KogMaw,606,297,309,49.01
Tristana,Ambessa,1095,507,588,46.3
Tristana,Rammus,727,340,387,46.77
Tristana,Mel,4042,2139,1903,52.92
Tristana,Blitzcrank,1556,825,731,53.02
Tristana,Mordekaiser,2788,1343,1445,48.17
Tristana,Qiyana,550,327,223,59.45
Tristana,Warwick,3163,1479,1684,46.76
Tristana,Nautilus,2266,1055,1211,46.56
Tristana,Yasuo,4077,1968,2109,48.27
Tristana,Sylas,2552,1361,1191,53.33
Tristana,Zed,2191,1107,1084,50.52
Tristana,Sivir,932,499,433,53.54
Tristana,Gwen,1160,577,583,49.74
Tristana,Skarner,581,312,269,53.7
Tristana,Yone,3677,1814,1863,49.33
Tristana,Kaisa,3220,1666,1554,51.74
Tristana,Seraphine,1709,903,806,52.84
Tristana,Garen,3157,1545,1612,48.94
Tristana,Rakan,870,445,425,51.15
Tristana,Volibear,2385,1145,1240,48.01
Tristana,AurelionSol,793,424,369,53.47
Tristana,Caitlyn,5587,2695,2892,48.24
Tristana,TahmKench,1830,916,914,50.05
Tristana,Heimerdinger,928,424,504,45.69
Tristana,LeeSin,2705,1411,1294,52.16
Tristana,Veigar,2217,1044,1173,47.09
Tristana,Irelia,1638,830,808,50.67
Tristana,Gragas,1084,582,502,53.69
Tristana,XinZhao,1349,710,639,52.63
Tristana,Velkoz,1292,648,644,50.15
Tristana,Sett,3226,1476,1750,45.75
Tristana,Elise,1314,692,622,52.66
Tristana,Galio,1707,747,960,43.76
Tristana,Twitch,1767,919,848,52.01
Tristana,Soraka,1153,504,649,43.71
Tristana,Trundle,1007,513,494,50.94
Tristana,Amumu,2056,962,1094,46.79
Tristana,Fizz,1078,588,490,54.55
Tristana,Pantheon,3120,1542,1578,49.42
Tristana,Nunu,1227,591,636,48.17
Tristana,Vex,1222,571,651,46.73
Tristana,Jinx,5746,2848,2898,49.56
Tristana,Riven,904,537,367,59.4
Tristana,JarvanIV,1227,651,576,53.06
Tristana,Taliyah,518,249,269,48.07
Tristana,Thresh,2714,1346,1368,49.59
Tristana,Jax,1937,949,988,48.99
Tristana,Diana,3048,1495,1553,49.05
Tristana,Ahri,2707,1425,1282,52.64
Tristana,Aphelios,1088,537,551,49.36
Tristana,Senna,1485,727,758,48.96
Tristana,Aurora,1621,870,751,53.67
Tristana,FiddleSticks,994,514,480,51.71
Tristana,Jhin,4325,2288,2037,52.9
Tristana,Akali,2097,1048,1049,49.98
Tristana,Samira,1533,699,834,45.6
Tristana,Neeko,1058,472,586,44.61
Tristana,Kindred,932,447,485,47.96
Tristana,Corki,948,495,453,52.22
Tristana,Sion,1539,756,783,49.12
Tristana,Ezreal,4605,2303,2302,50.01
Tristana,Zilean,552,264,288,47.83
Tristana,Nocturne,2503,1151,1352,45.98
Tristana,Aatrox,1875,1020,855,54.4
Tristana,Swain,2125,1031,1094,48.52
Tristana,Ryze,684,320,364,46.78
Tristana,Nami,1767,879,888,49.75
Tristana,Nilah,736,380,356,51.63
Tristana,Quinn,791,355,436,44.88
Tristana,Talon,1112,612,500,55.04
Tristana,Syndra,1129,499,630,44.2
Tristana,Olaf,469,243,226,51.81
Tristana,Smolder,1430,699,731,48.88
Tristana,Braum,1189,599,590,50.38
Tristana,Karma,2113,1046,1067,49.5
Tristana,Vayne,2663,1303,1360,48.93
Tristana,Brand,1493,733,760,49.1
Tristana,TwistedFate,694,342,352,49.28
Tristana,Teemo,2563,1197,1366,46.7
Tristana,Khazix,1100,514,586,46.73
Tristana,Varus,1731,910,821,52.57
Tristana,Sejuani,800,357,443,44.63
Tristana,Ashe,4185,2271,1914,54.27
Tristana,Malzahar,2063,911,1152,44.16
Tristana,Yorick,2002,824,1178,41.16
Tristana,Lulu,2325,1144,1181,49.2
Tristana,Naafiri,724,387,337,53.45
Tristana,Morgana,2472,1217,1255,49.23
Tristana,KSante,884,463,421,52.38
Tristana,Nidalee,594,331,263,55.72
Tristana,MasterYi,2585,1306,1279,50.52
Tristana,Pyke,1885,1035,850,54.91
Tristana,Akshan,746,399,347,53.49
Tristana,Zyra,1616,778,838,48.14
Tristana,Graves,1233,577,656,46.8
Tristana,Vi,1895,913,982,48.18
Tristana,Fiora,812,459,353,56.53
Tristana,Xerath,1620,849,771,52.41
Tristana,DrMundo,1247,591,656,47.39
Tristana,Poppy,1277,569,708,44.56
Tristana,Nasus,1361,715,646,52.53
Tristana,Briar,1495,768,727,51.37
Tristana,Shyvana,545,278,267,51.01
Tristana,Viktor,1610,787,823,48.88
Tristana,Janna,672,290,382,43.15
Tristana,Kalista,663,372,291,56.11
Tristana,Rell,1101,539,562,48.96
Tristana,Evelynn,875,459,416,52.46
Tristana,Kassadin,405,209,196,51.6
Tristana,Ziggs,743,375,368,50.47
Tristana,Gnar,817,396,421,48.47
Tristana,Shen,1288,640,648,49.69
Tristana,Rumble,536,288,248,53.73
Tristana,Shaco,1934,937,997,48.45
Tristana,MissFortune,5660,2682,2978,47.39
Tristana,Zeri,760,370,390,48.68
Tristana,Kayle,1492,775,717,51.94
Tristana,Viego,2741,1393,1348,50.82
Tristana,Zac,765,352,413,46.01
Tristana,Ornn,941,422,519,44.85
Tristana,Udyr,811,418,393,51.54
Tristana,Leblanc,1001,469,532,46.85
Tristana,Tryndamere,1218,588,630,48.28
Tristana,Milio,1130,492,638,43.54
Tristana,Lillia,1124,562,562,50
Tristana,Anivia,797,385,412,48.31
Tristana,Illaoi,1002,535,467,53.39
Tristana,Jayce,803,408,395,50.81
Tristana,Leona,1789,857,932,47.9
Tristana,Azir,787,378,409,48.03
Tristana,Belveth,504,244,260,48.41
Tristana,Chogath,2543,1215,1328,47.78
Tristana,Rengar,650,345,305,53.08
Tristana,Sona,649,253,396,38.98
Tristana,Karthus,574,289,285,50.35
Tristana,Alistar,830,436,394,52.53
Tristana,MonkeyKing,1326,611,715,46.08
Tristana,Xayah,974,527,447,54.11
Tristana,Kennen,603,296,307,49.09
Tristana,Taric,435,224,211,51.49
Tristana,Lissandra,656,328,328,50
Tristana,Camille,716,345,371,48.18
Tristana,Urgot,972,478,494,49.18
Tristana,Zoe,834,504,330,60.43
Tristana,Gangplank,1087,582,505,53.54
Tristana,Hecarim,772,404,368,52.33
Tristana,Singed,636,319,317,50.16
Tristana,Cassiopeia,739,364,375,49.26
Tristana,Ivern,339,168,171,49.56
Tristana,RekSai,267,149,118,55.81
Tristana,Bard,668,317,351,47.46
Tristana,Orianna,879,434,445,49.37
Tristana,Annie,617,332,285,53.81
Tristana,Renata,423,213,210,50.35
Tristana,Kled,414,202,212,48.79
Blitzcrank,Malphite,1447,742,705,51.28
Blitzcrank,Ekko,1330,658,672,49.47
Blitzcrank,Hwei,1129,495,634,43.84
Blitzcrank,Lucian,1147,525,622,45.77
Blitzcrank,Maokai,728,286,442,39.29
Blitzcrank,Kennen,495,233,262,47.07
Blitzcrank,Warwick,2318,1000,1318,43.14
Blitzcrank,Yasuo,3093,1542,1551,49.85
Blitzcrank,Kindred,761,354,407,46.52
Blitzcrank,Lux,4830,2405,2425,49.79
Blitzcrank,Talon,914,480,434,52.52
Blitzcrank,Aurora,1257,535,722,42.56
Blitzcrank,Tristana,1556,731,825,46.98
Blitzcrank,Alistar,913,448,465,49.07
Blitzcrank,Teemo,1967,901,1066,45.81
Blitzcrank,TahmKench,1429,706,723,49.41
Blitzcrank,Jinx,3955,1821,2134,46.04
Blitzcrank,Zoe,696,360,336,51.72
Blitzcrank,Nami,1339,659,680,49.22
Blitzcrank,Evelynn,673,337,336,50.07
Blitzcrank,Irelia,1416,710,706,50.14
Blitzcrank,Thresh,2487,1163,1324,46.76
Blitzcrank,Pantheon,2831,1331,1500,47.02
Blitzcrank,Kayn,2250,1065,1185,47.33
Blitzcrank,Leblanc,1029,503,526,48.88
Blitzcrank,Sivir,1237,545,692,44.06
Blitzcrank,Pyke,1525,763,762,50.03
Blitzcrank,Volibear,1709,824,885,48.22
Blitzcrank,Akshan,512,229,283,44.73
Blitzcrank,Katarina,1241,676,565,54.47
Blitzcrank,Khazix,841,408,433,48.51
Blitzcrank,Akali,1804,815,989,45.18
Blitzcrank,Draven,715,294,421,41.12
Blitzcrank,Mel,3027,1391,1636,45.95
Blitzcrank,Viego,2255,1153,1102,51.13
Blitzcrank,Yone,3196,1596,1600,49.94
Blitzcrank,Nocturne,1963,857,1106,43.66
Blitzcrank,Aatrox,1691,838,853,49.56
Blitzcrank,Swain,1660,724,936,43.61
Blitzcrank,Cassiopeia,518,299,219,57.72
Blitzcrank,Shaco,1445,728,717,50.38
Blitzcrank,Riven,742,349,393,47.04
Blitzcrank,Caitlyn,4285,2119,2166,49.45
Blitzcrank,Senna,1186,547,639,46.12
Blitzcrank,MasterYi,1829,953,876,52.1
Blitzcrank,Azir,651,328,323,50.38
Blitzcrank,Rengar,523,293,230,56.02
Blitzcrank,Gragas,933,476,457,51.02
Blitzcrank,Zed,1734,817,917,47.12
Blitzcrank,MissFortune,3613,1760,1853,48.71
Blitzcrank,Poppy,899,385,514,42.83
Blitzcrank,Leona,1804,847,957,46.95
Blitzcrank,Janna,518,267,251,51.54
Blitzcrank,Shen,1118,580,538,51.88
Blitzcrank,MonkeyKing,987,457,530,46.3
Blitzcrank,Naafiri,583,325,258,55.75
Blitzcrank,Mordekaiser,2135,1028,1107,48.15
Blitzcrank,Samira,1291,582,709,45.08
Blitzcrank,Neeko,830,370,460,44.58
Blitzcrank,Olaf,450,228,222,50.67
Blitzcrank,Diana,2402,1167,1235,48.58
Blitzcrank,Ashe,3336,1686,1650,50.54
Blitzcrank,LeeSin,2699,1310,1389,48.54
Blitzcrank,Varus,1426,725,701,50.84
Blitzcrank,Tryndamere,846,467,379,55.2
Blitzcrank,Elise,1110,553,557,49.82
Blitzcrank,Nautilus,1985,895,1090,45.09
Blitzcrank,Rakan,689,277,412,40.2
Blitzcrank,Rumble,386,188,198,48.7
Blitzcrank,Qiyana,409,202,207,49.39
Blitzcrank,Kled,259,136,123,52.51
Blitzcrank,Taliyah,426,199,227,46.71
Blitzcrank,Ezreal,4225,2075,2150,49.11
Blitzcrank,Yorick,1324,536,788,40.48
Blitzcrank,Illaoi,830,368,462,44.34
Blitzcrank,Fizz,818,426,392,52.08
Blitzcrank,Kaisa,2394,1166,1228,48.71
Blitzcrank,Sion,1140,540,600,47.37
Blitzcrank,Jayce,819,387,432,47.25
Blitzcrank,KogMaw,467,208,259,44.54
Blitzcrank,XinZhao,1063,550,513,51.74
Blitzcrank,Hecarim,603,324,279,53.73
Blitzcrank,Jhin,2923,1504,1419,51.45
Blitzcrank,Velkoz,952,422,530,44.33
Blitzcrank,Sett,2666,1237,1429,46.4
Blitzcrank,Zilean,468,200,268,42.74
Blitzcrank,AurelionSol,703,327,376,46.51
Blitzcrank,Xayah,950,420,530,44.21
Blitzcrank,Singed,384,157,227,40.89
Blitzcrank,Orianna,757,370,387,48.88
Blitzcrank,Trundle,920,401,519,43.59
Blitzcrank,Ivern,248,149,99,60.08
Blitzcrank,Darius,3056,1436,1620,46.99
Blitzcrank,FiddleSticks,793,416,377,52.46
Blitzcrank,Chogath,1903,829,1074,43.56
Blitzcrank,Renekton,865,440,425,50.87
Blitzcrank,Seraphine,1288,703,585,54.58
Blitzcrank,Gwen,816,393,423,48.16
Blitzcrank,Zeri,716,358,358,50
Blitzcrank,Zyra,1477,677,800,45.84
Blitzcrank,Heimerdinger,759,366,393,48.22
Blitzcrank,DrMundo,874,466,408,53.32
Blitzcrank,Soraka,831,379,452,45.61
Blitzcrank,Ahri,2280,1034,1246,45.35
Blitzcrank,Sylas,2464,1168,1296,47.4
Blitzcrank,Nunu,1006,536,470,53.28
Blitzcrank,Twitch,1155,615,540,53.25
Blitzcrank,Karma,1745,825,920,47.28
Blitzcrank,Milio,815,406,409,49.82
Blitzcrank,KSante,870,461,409,52.99
Blitzcrank,Karthus,473,235,238,49.68
Blitzcrank,Morgana,2149,1018,1131,47.37
Blitzcrank,Xerath,1492,693,799,46.45
Blitzcrank,Nidalee,487,280,207,57.49
Blitzcrank,Amumu,1552,741,811,47.74
Blitzcrank,Renata,246,126,120,51.22
Blitzcrank,Gangplank,870,464,406,53.33
Blitzcrank,Kayle,944,446,498,47.25
Blitzcrank,Sejuani,659,309,350,46.89
Blitzcrank,Nasus,1137,557,580,48.99
Blitzcrank,Rell,859,422,437,49.13
Blitzcrank,Ryze,549,265,284,48.27
Blitzcrank,Viktor,1324,608,716,45.92
Blitzcrank,Vladimir,924,461,463,49.89
Blitzcrank,Yuumi,1327,671,656,50.57
Blitzcrank,Brand,1062,560,502,52.73
Blitzcrank,Malzahar,1419,642,777,45.24
Blitzcrank,Smolder,982,480,502,48.88
Blitzcrank,Garen,2437,1131,1306,46.41
Blitzcrank,JarvanIV,856,369,487,43.11
Blitzcrank,Galio,1279,627,652,49.02
Blitzcrank,Ziggs,650,325,325,50
Blitzcrank,Sona,397,210,187,52.9
Blitzcrank,Camille,549,275,274,50.09
Blitzcrank,Veigar,1700,824,876,48.47
Blitzcrank,Vex,938,466,472,49.68
Blitzcrank,Fiora,585,261,324,44.62
Blitzcrank,Nilah,513,211,302,41.13
Blitzcrank,Jax,1402,657,745,46.86
Blitzcrank,Lulu,2113,1084,1029,51.3
Blitzcrank,Syndra,926,455,471,49.14
Blitzcrank,Gnar,651,293,358,45.01
Blitzcrank,Vi,1419,725,694,51.09
Blitzcrank,Udyr,579,290,289,50.09
Blitzcrank,Braum,994,439,555,44.16
Blitzcrank,Kassadin,310,157,153,50.65
Blitzcrank,Lissandra,441,206,235,46.71
Blitzcrank,Vayne,1814,861,953,47.46
Blitzcrank,Ambessa,1120,607,513,54.2
Blitzcrank,Kalista,564,337,227,59.75
Blitzcrank,Corki,603,327,276,54.23
Blitzcrank,Lillia,1040,485,555,46.63
Blitzcrank,Shyvana,425,182,243,42.82
Blitzcrank,Graves,1063,495,568,46.57
Blitzcrank,TwistedFate,597,312,285,52.26
Blitzcrank,Zac,777,354,423,45.56
Blitzcrank,Aphelios,904,483,421,53.43
Blitzcrank,Annie,503,231,272,45.92
Blitzcrank,Anivia,461,240,221,52.06
Blitzcrank,Urgot,710,400,310,56.34
Blitzcrank,Taric,340,150,190,44.12
Blitzcrank,Ornn,739,343,396,46.41
Blitzcrank,Briar,1219,457,762,37.49
Blitzcrank,Bard,400,227,173,56.75
Blitzcrank,Skarner,497,269,228,54.12
Blitzcrank,Rammus,522,247,275,47.32
Blitzcrank,Belveth,358,182,176,50.84
Blitzcrank,Quinn,569,310,259,54.48
Blitzcrank,RekSai,236,127,109,53.81
Malphite,Sett,3184,1638,1546,51.44
Malphite,Warwick,2986,1498,1488,50.17
Malphite,Shen,1167,553,614,47.39
Malphite,Tristana,2003,1054,949,52.62
Malphite,Blitzcrank,1447,705,742,48.72
Malphite,Pantheon,3609,1942,1667,53.81
Malphite,MasterYi,2512,1228,1284,48.89
Malphite,Sylas,4193,1891,2302,45.1
Malphite,Ashe,4129,2128,2001,51.54
Malphite,Karma,2230,1063,1167,47.67
Malphite,Gangplank,1095,569,526,51.96
Malphite,Brand,1449,677,772,46.72
Malphite,Irelia,1905,1056,849,55.43
Malphite,Malzahar,2091,1054,1037,50.41
Malphite,Pyke,1977,1164,813,58.88
Malphite,Yasuo,4582,2374,2208,51.81
Malphite,Zed,3088,1743,1345,56.44
Malphite,Sivir,1179,587,592,49.79
Malphite,FiddleSticks,998,470,528,47.09
Malphite,Shaco,1969,994,975,50.48
Malphite,Syndra,1180,629,551,53.31
Malphite,Kalista,698,384,314,55.01
Malphite,Thresh,2957,1495,1462,50.56
Malphite,DrMundo,1105,504,601,45.61
Malphite,Belveth,517,314,203,60.74
Malphite,Leblanc,1081,599,482,55.41
Malphite,Briar,1627,786,841,48.31
Malphite,Anivia,557,269,288,48.29
Malphite,Akali,1977,993,984,50.23
Malphite,Rammus,671,326,345,48.58
Malphite,Jinx,5414,2650,2764,48.95
Malphite,Zyra,1715,858,857,50.03
Malphite,Fiora,682,437,245,64.08
Malphite,Kayn,3127,1533,1594,49.02
Malphite,Aphelios,1195,656,539,54.9
Malphite,Zilean,675,318,357,47.11
Malphite,KSante,924,443,481,47.94
Malphite,Viego,2888,1452,1436,50.28
Malphite,Vex,1086,570,516,52.49
Malphite,Senna,1652,886,766,53.63
Malphite,Jax,1694,867,827,51.18
Malphite,Evelynn,692,353,339,51.01
Malphite,Mel,4000,2056,1944,51.4
Malphite,Renata,410,224,186,54.63
Malphite,Heimerdinger,986,443,543,44.93
Malphite,Katarina,1520,806,714,53.03
Malphite,Caitlyn,5462,2796,2666,51.19
Malphite,Zac,912,464,448,50.88
Malphite,Nunu,1157,606,551,52.38
Malphite,Veigar,2103,994,1109,47.27
Malphite,Kaisa,3153,1687,1466,53.5
Malphite,Nasus,1695,822,873,48.5
Malphite,Vi,1923,968,955,50.34
Malphite,Lux,5427,2702,2725,49.79
Malphite,Alistar,860,414,446,48.14
Malphite,Samira,1528,794,734,51.96
Malphite,Chogath,2418,1081,1337,44.71
Malphite,Lillia,1209,598,611,49.46
Malphite,Jhin,3946,2043,1903,51.77
Malphite,Janna,576,256,320,44.44
Malphite,Yorick,1831,833,998,45.49
Malphite,Kindred,979,537,442,54.85
Malphite,Lulu,2524,1375,1149,54.48
Malphite,TahmKench,1783,843,940,47.28
Malphite,Diana,3014,1495,1519,49.6
Malphite,Darius,3720,1827,1893,49.11
Malphite,Twitch,1676,909,767,54.24
Malphite,Teemo,3819,1858,1961,48.65
Malphite,Bard,557,281,276,50.45
Malphite,Mordekaiser,3197,1407,1790,44.01
Malphite,Swain,2034,894,1140,43.95
Malphite,Tryndamere,1601,871,730,54.4
Malphite,Elise,1342,689,653,51.34
Malphite,Nautilus,2401,1244,1157,51.81
Malphite,Varus,1805,954,851,52.85
Malphite,Rakan,947,464,483,49
Malphite,Quinn,1182,614,568,51.95
Malphite,Aatrox,2053,1029,1024,50.12
Malphite,Rengar,712,406,306,57.02
Malphite,Galio,1911,899,1012,47.04
Malphite,Sona,647,315,332,48.69
Malphite,Kennen,628,330,298,52.55
Malphite,MissFortune,4885,2383,2502,48.78
Malphite,Morgana,2586,1235,1351,47.76
Malphite,Viktor,1654,816,838,49.33
Malphite,Volibear,2045,1018,1027,49.78
Malphite,Azir,706,363,343,51.42
Malphite,Xayah,1223,567,656,46.36
Malphite,Garen,3110,1474,1636,47.4
Malphite,Singed,532,224,308,42.11
Malphite,Smolder,1544,831,713,53.82
Malphite,Skarner,502,265,237,52.79
Malphite,Aurora,1460,767,693,52.53
Malphite,Ryze,659,314,345,47.65
Malphite,Illaoi,986,486,500,49.29
Malphite,Yone,4174,2259,1915,54.12
Malphite,Akshan,869,450,419,51.78
Malphite,Yuumi,1756,887,869,50.51
Malphite,Amumu,2131,967,1164,45.38
Malphite,Ivern,295,150,145,50.85
Malphite,Soraka,1022,527,495,51.57
Malphite,Kayle,1535,748,787,48.73
Malphite,Seraphine,1742,918,824,52.7
Malphite,JarvanIV,1301,654,647,50.27
Malphite,Draven,1098,591,507,53.83
Malphite,Gnar,1276,688,588,53.92
Malphite,Zoe,777,467,310,60.1
Malphite,Ezreal,5078,2514,2564,49.51
Malphite,Hwei,1348,687,661,50.96
Malphite,Graves,1275,741,534,58.12
Malphite,Orianna,806,390,416,48.39
Malphite,Neeko,1022,506,516,49.51
Malphite,Ornn,912,431,481,47.26
Malphite,Ekko,1759,850,909,48.32
Malphite,Renekton,943,487,456,51.64
Malphite,Kassadin,401,193,208,48.13
Malphite,Gwen,1225,640,585,52.24
Malphite,Nami,2108,988,1120,46.87
Malphite,Poppy,1127,568,559,50.4
Malphite,AurelionSol,791,379,412,47.91
Malphite,Nilah,801,402,399,50.19
Malphite,Ziggs,866,365,501,42.15
Malphite,Leona,1956,974,982,49.8
Malphite,Riven,1011,597,414,59.05
Malphite,Khazix,1058,596,462,56.33
Malphite,Qiyana,613,345,268,56.28
Malphite,Gragas,1059,614,445,57.98
Malphite,Velkoz,1226,613,613,50
Malphite,Nocturne,2629,1241,1388,47.2
Malphite,Udyr,798,411,387,51.5
Malphite,Sion,1603,759,844,47.35
Malphite,Trundle,1181,590,591,49.96
Malphite,Sejuani,859,451,408,52.5
Malphite,Ahri,2656,1382,1274,52.03
Malphite,Vayne,3159,1662,1497,52.61
Malphite,Xerath,1783,856,927,48.01
Malphite,Camille,639,336,303,52.58
Malphite,Naafiri,732,383,349,52.32
Malphite,Taliyah,497,275,222,55.33
Malphite,Lucian,1511,759,752,50.23
Malphite,Talon,1250,617,633,49.36
Malphite,Annie,625,281,344,44.96
Malphite,Cassiopeia,588,308,280,52.38
Malphite,Milio,1194,587,607,49.16
Malphite,XinZhao,1326,649,677,48.94
Malphite,Vladimir,1199,581,618,48.46
Malphite,Rell,1037,505,532,48.7
Malphite,LeeSin,2927,1528,1399,52.2
Malphite,Shyvana,560,280,280,50
Malphite,TwistedFate,640,346,294,54.06
Malphite,Lissandra,697,341,356,48.92
Malphite,Fizz,1081,520,561,48.1
Malphite,KogMaw,631,317,314,50.24
Malphite,Karthus,526,290,236,55.13
Malphite,Urgot,994,482,512,48.49
Malphite,Maokai,830,380,450,45.78
Malphite,Corki,745,352,393,47.25
Malphite,Ambessa,1189,709,480,59.63
Malphite,Nidalee,621,328,293,52.82
Malphite,Rumble,604,347,257,57.45
Malphite,RekSai,267,131,136,49.06
Malphite,Taric,429,221,208,51.52
Malphite,Olaf,460,174,286,37.83
Malphite,Hecarim,752,369,383,49.07
Malphite,Zeri,886,476,410,53.72
Malphite,Jayce,1061,552,509,52.03
Malphite,MonkeyKing,1350,622,728,46.07
Malphite,Braum,1140,627,513,55
Malphite,Kled,311,178,133,57.23
Ekko,Sett,2867,1362,1505,47.51
Ekko,Warwick,2888,1423,1465,49.27
Ekko,Shen,1197,587,610,49.04
Ekko,Tristana,1842,951,891,51.63
Ekko,Blitzcrank,1330,672,658,50.53
Ekko,Mordekaiser,2445,1215,1230,49.69
Ekko,Viego,2617,1292,1325,49.37
Ekko,Kindred,984,447,537,45.43
Ekko,Jhin,3772,1942,1830,51.48
Ekko,TahmKench,1699,900,799,52.97
Ekko,Darius,3572,1731,1841,48.46
Ekko,Rengar,742,400,342,53.91
Ekko,Syndra,1250,626,624,50.08
Ekko,Caitlyn,4991,2380,2611,47.69
Ekko,Lux,4753,2319,2434,48.79
Ekko,Renekton,1012,507,505,50.1
Ekko,Kayn,2859,1496,1363,52.33
Ekko,Vex,952,432,520,45.38
Ekko,Samira,1584,759,825,47.92
Ekko,Lulu,2313,1255,1058,54.26
Ekko,Karma,2027,948,1079,46.77
Ekko,Rammus,557,307,250,55.12
Ekko,Yone,3286,1749,1537,53.23
Ekko,Nocturne,2369,1112,1257,46.94
Ekko,Lissandra,658,314,344,47.72
Ekko,Pantheon,3037,1522,1515,50.12
Ekko,Ryze,668,328,340,49.1
Ekko,Jinx,5042,2505,2537,49.68
Ekko,Nami,1880,896,984,47.66
Ekko,Aatrox,1773,970,803,54.71
Ekko,Shaco,1910,983,927,51.47
Ekko,Leblanc,1001,473,528,47.25
Ekko,Draven,1021,489,532,47.89
Ekko,Hwei,1307,708,599,54.17
Ekko,Nasus,1294,604,690,46.68
Ekko,Zoe,812,434,378,53.45
Ekko,Ashe,3708,1814,1894,48.92
Ekko,Senna,1445,735,710,50.87
Ekko,Mel,3931,1984,1947,50.47
Ekko,Lucian,1370,724,646,52.85
Ekko,Thresh,2493,1273,1220,51.06
Ekko,RekSai,252,130,122,51.59
Ekko,Braum,1056,507,549,48.01
Ekko,Illaoi,863,418,445,48.44
Ekko,MonkeyKing,1238,552,686,44.59
Ekko,Vayne,2445,1261,1184,51.57
Ekko,Morgana,2185,1078,1107,49.34
Ekko,XinZhao,1274,622,652,48.82
Ekko,Irelia,1601,779,822,48.66
Ekko,Soraka,1167,587,580,50.3
Ekko,Teemo,2326,1105,1221,47.51
Ekko,Khazix,1008,540,468,53.57
Ekko,Vladimir,1164,606,558,52.06
Ekko,Corki,683,351,332,51.39
Ekko,Pyke,1690,886,804,52.43
Ekko,Singed,597,319,278,53.43
Ekko,Yasuo,3664,1869,1795,51.01
Ekko,Alistar,881,420,461,47.67
Ekko,Nautilus,1974,1036,938,52.48
Ekko,Lillia,1178,577,601,48.98
Ekko,FiddleSticks,999,471,528,47.15
Ekko,Akali,2041,1041,1000,51
Ekko,Evelynn,805,409,396,50.81
Ekko,Ahri,2547,1276,1271,50.1
Ekko,Chogath,2368,1169,1199,49.37
Ekko,Velkoz,1124,528,596,46.98
Ekko,Trundle,1113,484,629,43.49
Ekko,Leona,1758,802,956,45.62
Ekko,Heimerdinger,913,444,469,48.63
Ekko,Varus,1621,870,751,53.67
Ekko,Maokai,832,401,431,48.2
Ekko,MasterYi,2286,1141,1145,49.91
Ekko,Swain,1769,819,950,46.3
Ekko,MissFortune,4211,2045,2166,48.56
Ekko,Sion,1404,662,742,47.15
Ekko,Twitch,1658,862,796,51.99
Ekko,Rell,870,438,432,50.34
Ekko,Kayle,1325,639,686,48.23
Ekko,Shyvana,504,244,260,48.41
Ekko,Galio,1708,824,884,48.24
Ekko,Seraphine,1515,742,773,48.98
Ekko,Sona,650,314,336,48.31
Ekko,Ezreal,4244,2200,2044,51.84
Ekko,Garen,2930,1461,1469,49.86
Ekko,Tryndamere,1027,540,487,52.58
Ekko,Ivern,311,159,152,51.13
Ekko,Graves,1127,617,510,54.75
Ekko,Katarina,1455,811,644,55.74
Ekko,Annie,559,267,292,47.76
Ekko,Veigar,2024,976,1048,48.22
Ekko,Gangplank,950,463,487,48.74
Ekko,Volibear,2094,1006,1088,48.04
Ekko,Qiyana,551,316,235,57.35
Ekko,Taliyah,513,238,275,46.39
Ekko,Urgot,932,408,524,43.78
Ekko,Xerath,1599,876,723,54.78
Ekko,Poppy,1156,539,617,46.63
Ekko,Talon,1217,564,653,46.34
Ekko,AurelionSol,738,373,365,50.54
Ekko,KSante,992,508,484,51.21
Ekko,Fiora,811,425,386,52.4
Ekko,Aurora,1405,740,665,52.67
Ekko,LeeSin,2709,1399,1310,51.64
Ekko,Xayah,942,506,436,53.72
Ekko,DrMundo,1027,571,456,55.6
Ekko,JarvanIV,1030,518,512,50.29
Ekko,Hecarim,793,407,386,51.32
Ekko,Orianna,801,419,382,52.31
Ekko,Zyra,1609,742,867,46.12
Ekko,Sejuani,711,331,380,46.55
Ekko,Bard,622,353,269,56.75
Ekko,Nilah,622,311,311,50
Ekko,Viktor,1774,897,877,50.56
Ekko,Zeri,799,362,437,45.31
Ekko,Brand,1328,599,729,45.11
Ekko,Diana,2930,1412,1518,48.19
Ekko,Ziggs,709,345,364,48.66
Ekko,Riven,1041,544,497,52.26
Ekko,Briar,1531,742,789,48.47
Ekko,Kaisa,2840,1455,1385,51.23
Ekko,Jax,1664,769,895,46.21
Ekko,Sylas,2508,1264,1244,50.4
Ekko,Yuumi,1587,781,806,49.21
Ekko,Aphelios,1101,587,514,53.32
Ekko,Zed,2525,1310,1215,51.88
Ekko,Ornn,766,346,420,45.17
Ekko,Zac,884,451,433,51.02
Ekko,Belveth,353,173,180,49.01
Ekko,Naafiri,674,339,335,50.3
Ekko,Amumu,2006,954,1052,47.56
Ekko,Renata,309,160,149,51.78
Ekko,Zilean,623,324,299,52.01
Ekko,Rumble,456,244,212,53.51
Ekko,Smolder,1249,633,616,50.68
Ekko,Janna,585,306,279,52.31
Ekko,Neeko,881,454,427,51.53
Ekko,Kassadin,470,194,276,41.28
Ekko,Karthus,493,273,220,55.38
Ekko,Azir,684,340,344,49.71
Ekko,Sivir,988,507,481,51.32
Ekko,Malphite,1759,909,850,51.68
Ekko,Milio,1144,516,628,45.1
Ekko,Nunu,1190,608,582,51.09
Ekko,Fizz,1103,535,568,48.5
Ekko,Vi,1682,892,790,53.03
Ekko,Gragas,1132,604,528,53.36
Ekko,Malzahar,1876,922,954,49.15
Ekko,Kennen,526,288,238,54.75
Ekko,Kalista,523,273,250,52.2
Ekko,Udyr,671,334,337,49.78
Ekko,Gwen,1022,511,511,50
Ekko,Kled,342,154,188,45.03
Ekko,Camille,664,360,304,54.22
Ekko,Gnar,718,429,289,59.75
Ekko,TwistedFate,621,295,326,47.5
Ekko,Anivia,565,280,285,49.56
Ekko,Yorick,1829,802,1027,43.85
Ekko,Elise,1522,774,748,50.85
Ekko,KogMaw,562,308,254,54.8
Ekko,Nidalee,503,292,211,58.05
Ekko,Skarner,540,306,234,56.67
Ekko,Rakan,856,402,454,46.96
Ekko,Quinn,671,344,327,51.27
Ekko,Taric,429,202,227,47.09
Ekko,Ambessa,1213,624,589,51.44
Ekko,Jayce,756,376,380,49.74
Ekko,Akshan,672,330,342,49.11
Ekko,Olaf,490,254,236,51.84
Ekko,Cassiopeia,570,306,264,53.68
Hwei,Sett,2141,988,1153,46.15
Hwei,Warwick,1971,965,1006,48.96
Hwei,Shen,908,460,448,50.66
Hwei,Tristana,1312,662,650,50.46
Hwei,Blitzcrank,1129,634,495,56.16
Hwei,Mordekaiser,1997,1017,980,50.93
Hwei,Sejuani,652,307,345,47.09
Hwei,Yasuo,2651,1279,1372,48.25
Hwei,Lucian,924,513,411,55.52
Hwei,Pantheon,2358,1231,1127,52.21
Hwei,Fiora,620,264,356,42.58
Hwei,Katarina,1205,651,554,54.02
Hwei,Mel,2915,1566,1349,53.72
Hwei,Viktor,1669,780,889,46.73
Hwei,Gwen,811,430,381,53.02
Hwei,Vi,1392,679,713,48.78
Hwei,Zed,1528,687,841,44.96
Hwei,Jhin,3007,1425,1582,47.39
Hwei,Soraka,784,416,368,53.06
Hwei,Irelia,1246,557,689,44.7
Hwei,Kassadin,319,154,165,48.28
Hwei,Yuumi,1310,627,683,47.86
Hwei,Akali,1393,718,675,51.54
Hwei,Velkoz,886,398,488,44.92
Hwei,Yorick,1276,572,704,44.83
Hwei,Samira,1117,596,521,53.36
Hwei,Nami,1522,728,794,47.83
Hwei,Volibear,1577,821,756,52.06
Hwei,LeeSin,2103,1162,941,55.25
Hwei,Malzahar,1505,746,759,49.57
Hwei,Caitlyn,3861,2090,1771,54.13
Hwei,Pyke,1420,729,691,51.34
Hwei,Teemo,1699,857,842,50.44
Hwei,Khazix,927,490,437,52.86
Hwei,Smolder,923,459,464,49.73
Hwei,MissFortune,3070,1500,1570,48.86
Hwei,Rell,743,328,415,44.15
Hwei,Ekko,1307,599,708,45.83
Hwei,TahmKench,1293,648,645,50.12
Hwei,Gangplank,696,370,326,53.16
Hwei,Diana,2117,1092,1025,51.58
Hwei,Aphelios,961,451,510,46.93
Hwei,Leona,1180,566,614,47.97
Hwei,Illaoi,629,303,326,48.17
Hwei,Nocturne,1683,851,832,50.56
Hwei,Seraphine,1227,672,555,54.77
Hwei,Amumu,1388,707,681,50.94
Hwei,Lissandra,401,251,150,62.59
Hwei,Kayn,1959,945,1014,48.24
Hwei,Ezreal,3253,1703,1550,52.35
Hwei,Yone,2490,1298,1192,52.13
Hwei,Darius,2966,1562,1404,52.66
Hwei,Ahri,2173,1106,1067,50.9
Hwei,Jinx,3635,1746,1889,48.03
Hwei,Karma,1661,793,868,47.74
Hwei,Ambessa,861,429,432,49.83
Hwei,Ashe,2993,1587,1406,53.02
Hwei,Varus,1314,609,705,46.35
Hwei,Graves,857,445,412,51.93
Hwei,Neeko,825,429,396,52
Hwei,Rengar,504,293,211,58.13
Hwei,Syndra,1134,550,584,48.5
Hwei,Xayah,753,394,359,52.32
Hwei,Thresh,2016,1032,984,51.19
Hwei,Sion,1074,509,565,47.39
Hwei,Xerath,1463,728,735,49.76
Hwei,Lulu,1950,1016,934,52.1
Hwei,Nidalee,482,268,214,55.6
Hwei,KogMaw,423,174,249,41.13
Hwei,Nautilus,1614,850,764,52.66
Hwei,Veigar,1541,751,790,48.73
Hwei,FiddleSticks,709,357,352,50.35
Hwei,Gnar,601,335,266,55.74
Hwei,AurelionSol,618,289,329,46.76
Hwei,Poppy,864,433,431,50.12
Hwei,Ryze,470,240,230,51.06
Hwei,Udyr,570,312,258,54.74
Hwei,Briar,1172,595,577,50.77
Hwei,Renekton,673,377,296,56.02
Hwei,Kaisa,2228,1125,1103,50.49
Hwei,Heimerdinger,677,314,363,46.38
Hwei,Braum,799,411,388,51.44
Hwei,Jax,1259,593,666,47.1
Hwei,Zeri,667,361,306,54.12
Hwei,Naafiri,473,225,248,47.57
Hwei,Lux,3716,1883,1833,50.67
Hwei,Bard,411,168,243,40.88
Hwei,Evelynn,586,271,315,46.25
Hwei,Viego,2038,990,1048,48.58
Hwei,Qiyana,373,203,170,54.42
Hwei,Taric,263,112,151,42.59
Hwei,Vex,816,437,379,53.55
Hwei,Sona,443,220,223,49.66
Hwei,DrMundo,718,335,383,46.66
Hwei,Kayle,1040,538,502,51.73
Hwei,Draven,814,385,429,47.3
Hwei,Tryndamere,803,430,373,53.55
Hwei,MonkeyKing,1008,483,525,47.92
Hwei,Elise,1140,519,621,45.53
Hwei,Aurora,1212,677,535,55.86
Hwei,Quinn,485,209,276,43.09
Hwei,Galio,1427,700,727,49.05
Hwei,Kennen,479,263,216,54.91
Hwei,Belveth,363,148,215,40.77
Hwei,Brand,1083,566,517,52.26
Hwei,Gragas,805,383,422,47.58
Hwei,Morgana,1642,815,827,49.63
Hwei,Swain,1445,701,744,48.51
Hwei,Shaco,1306,632,674,48.39
Hwei,Zyra,1231,592,639,48.09
Hwei,Zoe,652,351,301,53.83
Hwei,Kindred,678,394,284,58.11
Hwei,Chogath,1770,931,839,52.6
Hwei,Malphite,1348,661,687,49.04
Hwei,Vladimir,883,421,462,47.68
Hwei,Nunu,925,465,460,50.27
Hwei,Cassiopeia,458,231,227,50.44
Hwei,Ornn,594,296,298,49.83
Hwei,Twitch,1100,514,586,46.73
Hwei,Vayne,1721,865,856,50.26
Hwei,Maokai,630,334,296,53.02
Hwei,Sivir,696,332,364,47.7
Hwei,Anivia,423,246,177,58.16
Hwei,Trundle,789,400,389,50.7
Hwei,JarvanIV,786,368,418,46.82
Hwei,Aatrox,1430,747,683,52.24
Hwei,Milio,865,442,423,51.1
Hwei,Ziggs,613,330,283,53.83
Hwei,Leblanc,829,436,393,52.59
Hwei,Senna,1123,545,578,48.53
Hwei,Karthus,419,213,206,50.84
Hwei,Akshan,534,200,334,37.45
Hwei,Kalista,504,299,205,59.33
Hwei,Garen,2134,1083,1051,50.75
Hwei,MasterYi,1575,796,779,50.54
Hwei,Nilah,588,263,325,44.73
Hwei,Lillia,751,381,370,50.73
Hwei,Fizz,768,358,410,46.61
Hwei,Nasus,974,459,515,47.13
Hwei,Orianna,637,274,363,43.01
Hwei,Jayce,636,354,282,55.66
Hwei,Camille,485,248,237,51.13
Hwei,Urgot,734,344,390,46.87
Hwei,XinZhao,885,426,459,48.14
Hwei,Hecarim,592,280,312,47.3
Hwei,Corki,542,278,264,51.29
Hwei,Sylas,1720,882,838,51.28
Hwei,Zac,694,375,319,54.03
Hwei,Janna,479,211,268,44.05
Hwei,Taliyah,468,216,252,46.15
Hwei,Riven,668,350,318,52.4
Hwei,Skarner,448,221,227,49.33
Hwei,RekSai,211,89,122,42.18
Hwei,Kled,261,113,148,43.3
Hwei,TwistedFate,530,261,269,49.25
Hwei,Alistar,542,286,256,52.77
Hwei,Talon,835,420,415,50.3
Hwei,Renata,254,124,130,48.82
Hwei,Singed,418,201,217,48.09
Hwei,Ivern,251,147,104,58.57
Hwei,Rakan,640,300,340,46.88
Hwei,Rammus,395,215,180,54.43
Hwei,KSante,741,392,349,52.9
Hwei,Olaf,376,182,194,48.4
Hwei,Rumble,368,177,191,48.1
Hwei,Annie,413,180,233,43.58
Hwei,Azir,559,258,301,46.15
Hwei,Zilean,466,211,255,45.28
Hwei,Shyvana,326,154,172,47.24
Lucian,Sett,2101,979,1122,46.6
Lucian,Warwick,1966,894,1072,45.47
Lucian,Shen,916,443,473,48.36
Lucian,Tristana,1363,639,724,46.88
Lucian,Blitzcrank,1147,622,525,54.23
Lucian,Singed,442,195,247,44.12
Lucian,Shaco,1228,580,648,47.23
Lucian,Zed,1646,771,875,46.84
Lucian,Hwei,924,411,513,44.48
Lucian,Lux,3659,1744,1915,47.66
Lucian,DrMundo,727,287,440,39.48
Lucian,Lillia,803,341,462,42.47
Lucian,Viktor,1359,637,722,46.87
Lucian,Jhin,3134,1510,1624,48.18
Lucian,Pyke,1376,764,612,55.52
Lucian,Jax,1303,634,669,48.66
Lucian,Elise,1124,542,582,48.22
Lucian,Naafiri,442,193,249,43.67
Lucian,Lulu,2193,1099,1094,50.11
Lucian,Gwen,812,410,402,50.49
Lucian,Tryndamere,808,346,462,42.82
Lucian,Velkoz,800,387,413,48.38
Lucian,Zeri,779,382,397,49.04
Lucian,Thresh,2107,988,1119,46.89
Lucian,Brand,997,542,455,54.36
Lucian,Twitch,1198,609,589,50.83
Lucian,Morgana,1538,742,796,48.24
Lucian,Riven,734,330,404,44.96
Lucian,LeeSin,2378,1142,1236,48.02
Lucian,Mel,3051,1490,1561,48.84
Lucian,Zac,733,332,401,45.29
Lucian,Volibear,1471,698,773,47.45
Lucian,Syndra,988,478,510,48.38
Lucian,Jinx,4051,1875,2176,46.28
Lucian,FiddleSticks,760,376,384,49.47
Lucian,Akali,1486,699,787,47.04
Lucian,Ambessa,968,450,518,46.49
Lucian,Yuumi,1360,671,689,49.34
Lucian,Qiyana,355,193,162,54.37
Lucian,Caitlyn,3864,1874,1990,48.5
Lucian,Illaoi,695,394,301,56.69
Lucian,Ekko,1370,646,724,47.15
Lucian,Leona,1071,472,599,44.07
Lucian,Ashe,3191,1461,1730,45.79
Lucian,MasterYi,1617,775,842,47.93
Lucian,AurelionSol,620,252,368,40.65
Lucian,Ezreal,4100,2096,2004,51.12
Lucian,Seraphine,1052,506,546,48.1
Lucian,Teemo,1691,867,824,51.27
Lucian,Rammus,424,182,242,42.92
Lucian,Fizz,846,390,456,46.1
Lucian,TahmKench,1325,567,758,42.79
Lucian,Briar,970,413,557,42.58
Lucian,Fiora,540,233,307,43.15
Lucian,Cassiopeia,403,195,208,48.39
Lucian,MonkeyKing,1065,488,577,45.82
Lucian,Nilah,537,228,309,42.46
Lucian,Evelynn,468,258,210,55.13
Lucian,Ahri,2068,1049,1019,50.73
Lucian,Chogath,1637,802,835,48.99
Lucian,Nocturne,1868,926,942,49.57
Lucian,Irelia,1153,562,591,48.74
Lucian,Gnar,633,344,289,54.34
Lucian,Kayn,2028,1037,991,51.13
Lucian,Katarina,1103,509,594,46.15
Lucian,Renekton,688,343,345,49.85
Lucian,Leblanc,827,407,420,49.21
Lucian,Aphelios,819,399,420,48.72
Lucian,Graves,1101,526,575,47.77
Lucian,Zoe,565,292,273,51.68
Lucian,Yasuo,3033,1489,1544,49.09
Lucian,Trundle,820,359,461,43.78
Lucian,Kayle,941,449,492,47.72
Lucian,Milio,846,399,447,47.16
Lucian,Sylas,2020,983,1037,48.66
Lucian,Mordekaiser,1916,955,961,49.84
Lucian,Talon,964,434,530,45.02
Lucian,Yone,2562,1357,1205,52.97
Lucian,Varus,1274,669,605,52.51
Lucian,Sejuani,666,293,373,43.99
Lucian,Azir,583,260,323,44.6
Lucian,Yorick,1323,579,744,43.76
Lucian,Ivern,222,117,105,52.7
Lucian,Aatrox,1586,772,814,48.68
Lucian,Aurora,1217,545,672,44.78
Lucian,MissFortune,3198,1521,1677,47.56
Lucian,Braum,853,361,492,42.32
Lucian,Galio,1261,560,701,44.41
Lucian,Sona,452,209,243,46.24
Lucian,Soraka,826,385,441,46.61
Lucian,Sion,1171,573,598,48.93
Lucian,Diana,2265,1064,1201,46.98
Lucian,Orianna,732,382,350,52.19
Lucian,Kaisa,2632,1368,1264,51.98
Lucian,Nami,1569,729,840,46.46
Lucian,Garen,2224,982,1242,44.15
Lucian,JarvanIV,865,383,482,44.28
Lucian,XinZhao,1050,484,566,46.1
Lucian,Ziggs,522,276,246,52.87
Lucian,Xayah,811,413,398,50.92
Lucian,Akshan,500,260,240,52
Lucian,Camille,571,271,300,47.46
Lucian,Nautilus,1622,798,824,49.2
Lucian,KSante,852,455,397,53.4
Lucian,Skarner,442,199,243,45.02
Lucian,Nunu,767,400,367,52.15
Lucian,Urgot,656,300,356,45.73
Lucian,Kassadin,302,144,158,47.68
Lucian,Senna,1087,489,598,44.99
Lucian,Darius,2934,1427,1507,48.64
Lucian,Heimerdinger,692,329,363,47.54
Lucian,Draven,786,321,465,40.84
Lucian,Smolder,916,466,450,50.87
Lucian,Pantheon,2391,1114,1277,46.59
Lucian,Gragas,943,453,490,48.04
Lucian,Amumu,1437,709,728,49.34
Lucian,Nasus,1000,514,486,51.4
Lucian,Rell,732,376,356,51.37
Lucian,Neeko,753,367,386,48.74
Lucian,Vayne,1935,929,1006,48.01
Lucian,Kennen,420,203,217,48.33
Lucian,Vi,1566,781,785,49.87
Lucian,Lissandra,465,218,247,46.88
Lucian,Zilean,454,177,277,38.99
Lucian,Khazix,835,409,426,48.98
Lucian,Rengar,493,270,223,54.77
Lucian,Rakan,714,392,322,54.9
Lucian,Kled,282,136,146,48.23
Lucian,Vladimir,903,430,473,47.62
Lucian,Karma,1797,850,947,47.3
Lucian,Corki,609,311,298,51.07
Lucian,Sivir,784,341,443,43.49
Lucian,Hecarim,583,271,312,46.48
Lucian,Renata,270,151,119,55.93
Lucian,Viego,1999,971,1028,48.57
Lucian,Kindred,626,327,299,52.24
Lucian,Malzahar,1375,687,688,49.96
Lucian,Ryze,531,284,247,53.48
Lucian,Poppy,1018,490,528,48.13
Lucian,Zyra,1329,616,713,46.35
Lucian,Karthus,446,210,236,47.09
Lucian,Anivia,535,260,275,48.6
Lucian,Malphite,1511,752,759,49.77
Lucian,Samira,993,479,514,48.24
Lucian,Taliyah,412,207,205,50.24
Lucian,Vex,825,379,446,45.94
Lucian,Shyvana,378,242,136,64.02
Lucian,Gangplank,889,401,488,45.11
Lucian,Alistar,628,302,326,48.09
Lucian,Olaf,391,195,196,49.87
Lucian,Xerath,1250,576,674,46.08
Lucian,Janna,536,248,288,46.27
Lucian,Quinn,452,212,240,46.9
Lucian,Taric,273,116,157,42.49
Lucian,Udyr,590,323,267,54.75
Lucian,Annie,476,217,259,45.59
Lucian,TwistedFate,590,279,311,47.29
Lucian,Veigar,1465,682,783,46.55
Lucian,Jayce,781,402,379,51.47
Lucian,Nidalee,511,289,222,56.56
Lucian,KogMaw,445,216,229,48.54
Lucian,Swain,1287,585,702,45.45
Lucian,Rumble,436,198,238,45.41
Lucian,Kalista,495,265,230,53.54
Lucian,Ornn,675,348,327,51.56
Lucian,Maokai,623,332,291,53.29
Lucian,Bard,430,216,214,50.23
Lucian,Belveth,341,143,198,41.94
Lucian,RekSai,220,112,108,50.91
Maokai,Sett,1571,801,770,50.99
Maokai,Warwick,1315,592,723,45.02
Maokai,Shen,596,304,292,51.01
Maokai,Tristana,848,403,445,47.52
Maokai,Blitzcrank,728,442,286,60.71
Maokai,Pantheon,1560,791,769,50.71
Maokai,MasterYi,1039,538,501,51.78
Maokai,Sylas,1390,748,642,53.81
Maokai,Ashe,1793,963,830,53.71
Maokai,Karma,1044,551,493,52.78
Maokai,Darius,1902,978,924,51.42
Maokai,Rengar,323,191,132,59.13
Maokai,Syndra,579,276,303,47.67
Maokai,Caitlyn,2493,1300,1193,52.15
Maokai,Lux,2375,1115,1260,46.95
Maokai,Kayn,1473,713,760,48.4
Maokai,Akali,940,473,467,50.32
Maokai,Akshan,339,167,172,49.26
Maokai,TahmKench,812,431,381,53.08
Maokai,Ivern,180,87,93,48.33
Maokai,Katarina,724,361,363,49.86
Maokai,Ezreal,2253,1188,1065,52.73
Maokai,Kled,192,109,83,56.77
Maokai,Ambessa,658,359,299,54.56
Maokai,Diana,1479,719,760,48.61
Maokai,Nilah,485,219,266,45.15
Maokai,Leona,845,360,485,42.6
Maokai,Rammus,281,163,118,58.01
Maokai,Aurora,739,436,303,59
Maokai,Swain,995,435,560,43.72
Maokai,Chogath,1203,603,600,50.12
Maokai,Yasuo,1802,958,844,53.16
Maokai,Kaisa,1560,870,690,55.77
Maokai,Yuumi,813,424,389,52.15
Maokai,Kennen,281,177,104,62.99
Maokai,TwistedFate,293,151,142,51.54
Maokai,Cassiopeia,295,160,135,54.24
Maokai,Smolder,662,308,354,46.53
Maokai,Milio,533,263,270,49.34
Maokai,Mordekaiser,1333,633,700,47.49
Maokai,Veigar,923,486,437,52.65
Maokai,Thresh,1279,705,574,55.12
Maokai,XinZhao,600,322,278,53.67
Maokai,MissFortune,2082,1069,1013,51.34
Maokai,Garen,1468,811,657,55.25
Maokai,Nocturne,1129,557,572,49.34
Maokai,Vladimir,565,271,294,47.96
Maokai,Ekko,832,431,401,51.8
Maokai,Singed,225,104,121,46.22
Maokai,Kindred,468,241,227,51.5
Maokai,Morgana,1269,588,681,46.34
Maokai,Lillia,579,299,280,51.64
Maokai,Pyke,946,514,432,54.33
Maokai,Ahri,1220,634,586,51.97
Maokai,Viego,1344,650,694,48.36
Maokai,Aatrox,924,482,442,52.16
Maokai,Renata,220,106,114,48.18
Maokai,Yorick,977,437,540,44.73
Maokai,Azir,373,195,178,52.28
Maokai,Twitch,699,356,343,50.93
Maokai,Lulu,1200,641,559,53.42
Maokai,Heimerdinger,383,180,203,47
Maokai,Briar,712,337,375,47.33
Maokai,Jinx,2387,1208,1179,50.61
Maokai,Nasus,688,344,344,50
Maokai,Shaco,857,425,432,49.59
Maokai,Sona,203,108,95,53.2
Maokai,Urgot,475,221,254,46.53
Maokai,Seraphine,859,443,416,51.57
Maokai,Jax,805,390,415,48.45
Maokai,Jhin,1725,949,776,55.01
Maokai,Braum,508,254,254,50
Maokai,Irelia,849,415,434,48.88
Maokai,Velkoz,580,314,266,54.14
Maokai,Renekton,463,197,266,42.55
Maokai,Nautilus,1122,651,471,58.02
Maokai,Zyra,922,457,465,49.57
Maokai,Yone,1715,856,859,49.91
Maokai,Amumu,969,511,458,52.73
Maokai,Zed,1053,540,513,51.28
Maokai,Draven,487,241,246,49.49
Maokai,LeeSin,1375,816,559,59.35
Maokai,Vex,473,236,237,49.89
Maokai,FiddleSticks,478,249,229,52.09
Maokai,Volibear,1112,563,549,50.63
Maokai,Rumble,242,137,105,56.61
Maokai,Xayah,446,208,238,46.64
Maokai,Fiora,363,155,208,42.7
Maokai,Vayne,1361,667,694,49.01
Maokai,Khazix,429,216,213,50.35
Maokai,Qiyana,308,182,126,59.09
Maokai,RekSai,118,54,64,45.76
Maokai,Poppy,667,360,307,53.97
Maokai,Teemo,1239,618,621,49.88
Maokai,Mel,1936,1017,919,52.53
Maokai,Gnar,382,190,192,49.74
Maokai,Hwei,630,296,334,46.98
Maokai,Aphelios,520,260,260,50
Maokai,Nami,826,415,411,50.24
Maokai,Orianna,492,254,238,51.63
Maokai,Udyr,430,239,191,55.58
Maokai,Annie,277,134,143,48.38
Maokai,Neeko,592,275,317,46.45
Maokai,Kassadin,218,92,126,42.2
Maokai,Riven,385,207,178,53.77
Maokai,Malzahar,928,538,390,57.97
Maokai,Zoe,400,241,159,60.25
Maokai,Sivir,460,230,230,50
Maokai,Viktor,994,494,500,49.7
Maokai,Camille,294,155,139,52.72
Maokai,Soraka,458,213,245,46.51
Maokai,Samira,807,385,422,47.71
Maokai,MonkeyKing,579,320,259,55.27
Maokai,Rell,555,280,275,50.45
Maokai,AurelionSol,398,197,201,49.5
Maokai,Shyvana,250,137,113,54.8
Maokai,Galio,814,426,388,52.33
Maokai,Xerath,773,355,418,45.92
Maokai,Gangplank,457,218,239,47.7
Maokai,Sion,746,320,426,42.9
Maokai,Nunu,648,301,347,46.45
Maokai,Belveth,240,137,103,57.08
Maokai,Malphite,830,450,380,54.22
Maokai,Anivia,361,151,210,41.83
Maokai,Varus,909,460,449,50.61
Maokai,DrMundo,550,298,252,54.18
Maokai,Vi,807,371,436,45.97
Maokai,Kalista,294,165,129,56.12
Maokai,Ornn,432,223,209,51.62
Maokai,Trundle,532,280,252,52.63
Maokai,KSante,553,303,250,54.79
Maokai,Gragas,614,374,240,60.91
Maokai,Quinn,335,156,179,46.57
Maokai,Leblanc,629,363,266,57.71
Maokai,Skarner,267,122,145,45.69
Maokai,Alistar,446,227,219,50.9
Maokai,Gwen,483,268,215,55.49
Maokai,Karthus,306,179,127,58.5
Maokai,Senna,744,373,371,50.13
Maokai,Lucian,623,291,332,46.71
Maokai,Illaoi,484,217,267,44.83
Maokai,Elise,744,427,317,57.39
Maokai,JarvanIV,486,237,249,48.77
Maokai,Olaf,276,156,120,56.52
Maokai,Lissandra,281,153,128,54.45
Maokai,Kayle,700,362,338,51.71
Maokai,KogMaw,343,135,208,39.36
Maokai,Jayce,431,265,166,61.48
Maokai,Evelynn,366,176,190,48.09
Maokai,Fizz,471,222,249,47.13
Maokai,Hecarim,364,191,173,52.47
Maokai,Zeri,438,246,192,56.16
Maokai,Graves,573,295,278,51.48
Maokai,Brand,700,349,351,49.86
Maokai,Ziggs,324,170,154,52.47
Maokai,Rakan,415,183,232,44.1
Maokai,Ryze,328,157,171,47.87
Maokai,Tryndamere,426,185,241,43.43
Maokai,Sejuani,434,224,210,51.61
Maokai,Taric,243,137,106,56.38
Maokai,Zac,448,253,195,56.47
Maokai,Corki,376,199,177,52.93
Maokai,Zilean,334,147,187,44.01
Maokai,Bard,332,191,141,57.53
Maokai,Janna,313,186,127,59.42
Maokai,Talon,591,326,265,55.16
Maokai,Naafiri,319,164,155,51.41
Maokai,Taliyah,251,136,115,54.18
Maokai,Nidalee,294,160,134,54.42
Yone,Mordekaiser,5520,2732,2788,49.49
Yone,Qiyana,996,507,489,50.9
Yone,Irelia,3890,1855,2035,47.69
Yone,Ezreal,9368,4573,4795,48.82
Yone,Rell,1884,914,970,48.51
Yone,Renekton,2380,1003,1377,42.14
Yone,Kayn,5845,2777,3068,47.51
Yone,Katarina,3100,1576,1524,50.84
Yone,Draven,1992,966,1026,48.49
Yone,Yuumi,3423,1742,1681,50.89
Yone,Kayle,2404,1210,1194,50.33
Yone,Sylas,6002,2929,3073,48.8
Yone,Caitlyn,10272,4815,5457,46.88
Yone,Renata,737,348,389,47.22
Yone,Warwick,5858,2568,3290,43.84
Yone,Mel,7961,4097,3864,51.46
Yone,Nautilus,4436,2177,2259,49.08
Yone,Gangplank,1902,958,944,50.37
Yone,Akali,5365,2489,2876,46.39
Yone,Sona,1214,519,695,42.75
Yone,Aatrox,4274,2125,2149,49.72
Yone,Sejuani,1523,717,806,47.08
Yone,Yasuo,10146,4913,5233,48.42
Yone,Jinx,9999,4581,5418,45.81
Yone,Pyke,3764,1890,1874,50.21
Yone,Heimerdinger,2013,905,1108,44.96
Yone,Neeko,2224,1067,1157,47.98
Yone,Leona,3184,1495,1689,46.95
Yone,Jax,4025,1885,2140,46.83
Yone,Nidalee,1154,626,528,54.25
Yone,Ahri,5385,2483,2902,46.11
Yone,Jhin,7711,3762,3949,48.79
Yone,Senna,2995,1401,1594,46.78
Yone,Sett,6661,3003,3658,45.08
Yone,Taliyah,899,438,461,48.72
Yone,Cassiopeia,1315,617,698,46.92
Yone,Kaisa,6757,3378,3379,49.99
Yone,Teemo,4697,2076,2621,44.2
Yone,Hecarim,1445,713,732,49.34
Yone,Veigar,4011,1913,2098,47.69
Yone,Ashe,7726,3788,3938,49.03
Yone,Thresh,5514,2613,2901,47.39
Yone,Morgana,4674,2165,2509,46.32
Yone,Viego,5407,2591,2816,47.92
Yone,Kindred,1829,874,955,47.79
Yone,TahmKench,3343,1640,1703,49.06
Yone,Diana,5963,2916,3047,48.9
Yone,Lux,9993,4730,5263,47.33
Yone,Tristana,3677,1863,1814,50.67
Yone,Vladimir,2638,1319,1319,50
Yone,Zac,1777,808,969,45.47
Yone,Amumu,3955,1666,2289,42.12
Yone,Xayah,2101,1060,1041,50.45
Yone,Darius,7278,3424,3854,47.05
Yone,AurelionSol,1465,727,738,49.62
Yone,MissFortune,9109,4251,4858,46.67
Yone,Talon,2342,1190,1152,50.81
Yone,Leblanc,2192,1067,1125,48.68
Yone,Soraka,2022,932,1090,46.09
Yone,Naafiri,1578,878,700,55.64
Yone,Nunu,2590,1286,1304,49.65
Yone,Malzahar,3482,1637,1845,47.01
Yone,Zeri,1743,806,937,46.24
Yone,Ekko,3286,1537,1749,46.77
Yone,Riven,1681,743,938,44.2
Yone,Ivern,611,312,299,51.06
Yone,Swain,3781,1807,1974,47.79
Yone,Nami,3411,1631,1780,47.82
Yone,Sivir,1936,936,1000,48.35
Yone,Trundle,2296,1059,1237,46.12
Yone,Gragas,2182,1152,1030,52.8
Yone,Vex,2551,1266,1285,49.63
Yone,Kennen,1106,522,584,47.2
Yone,Rammus,1569,669,900,42.64
Yone,Nasus,2957,1420,1537,48.02
Yone,Smolder,2752,1401,1351,50.91
Yone,Sion,3059,1530,1529,50.02
Yone,Rengar,1375,697,678,50.69
Yone,Anivia,1058,511,547,48.3
Yone,Poppy,2576,1222,1354,47.44
Yone,Illaoi,1991,902,1089,45.3
Yone,Aurora,3382,1633,1749,48.29
Yone,Tryndamere,2146,1047,1099,48.79
Yone,Zyra,3287,1495,1792,45.48
Yone,Nilah,1326,564,762,42.53
Yone,FiddleSticks,1938,864,1074,44.58
Yone,Blitzcrank,3196,1600,1596,50.06
Yone,Zed,4175,2080,2095,49.82
Yone,Rakan,1820,900,920,49.45
Yone,Evelynn,1595,786,809,49.28
Yone,Lissandra,1216,581,635,47.78
Yone,XinZhao,2587,1186,1401,45.84
Yone,Vayne,4273,1985,2288,46.45
Yone,Brand,2794,1326,1468,47.46
Yone,Pantheon,7021,3419,3602,48.7
Yone,Braum,1950,872,1078,44.72
Yone,Gnar,1606,793,813,49.38
Yone,Shaco,3733,1902,1831,50.95
Yone,Seraphine,3155,1567,1588,49.67
Yone,Nocturne,4397,2124,2273,48.31
Yone,Orianna,1533,807,726,52.64
Yone,LeeSin,6096,3069,3027,50.34
Yone,Garen,6144,2920,3224,47.53
Yone,Kled,717,372,345,51.88
Yone,Alistar,1632,774,858,47.43
Yone,DrMundo,2294,1112,1182,48.47
Yone,Akshan,1296,648,648,50
Yone,Zilean,1144,575,569,50.26
Yone,Hwei,2490,1192,1298,47.87
Yone,Azir,1344,629,715,46.8
Yone,Taric,764,317,447,41.49
Yone,Briar,3111,1356,1755,43.59
Yone,Ornn,1532,721,811,47.06
Yone,MasterYi,4589,2193,2396,47.79
Yone,Yorick,3762,1646,2116,43.75
Yone,Velkoz,2311,1014,1297,43.88
Yone,Volibear,4313,1925,2388,44.63
Yone,Quinn,1222,589,633,48.2
Yone,Varus,3346,1665,1681,49.76
Yone,Fiora,1631,747,884,45.8
Yone,Twitch,2798,1363,1435,48.71
Yone,Lulu,4606,2105,2501,45.7
Yone,Xerath,3180,1510,1670,47.48
Yone,Annie,1236,630,606,50.97
Yone,Chogath,4905,2409,2496,49.11
Yone,Vi,3700,1763,1937,47.65
Yone,Galio,3565,1697,1868,47.6
Yone,Samira,3160,1460,1700,46.2
Yone,Lucian,2562,1205,1357,47.03
Yone,Jayce,2004,926,1078,46.21
Yone,KogMaw,1194,555,639,46.48
Yone,Ryze,1299,583,716,44.88
Yone,Zoe,1626,794,832,48.83
Yone,Gwen,2006,997,1009,49.7
Yone,RekSai,457,242,215,52.95
Yone,MonkeyKing,2586,1143,1443,44.2
Yone,Kalista,1276,676,600,52.98
Yone,Camille,1237,600,637,48.5
Yone,Udyr,1383,711,672,51.41
Yone,TwistedFate,1257,696,561,55.37
Yone,Aphelios,2203,1003,1200,45.53
Yone,KSante,2067,1131,936,54.72
Yone,Graves,2591,1224,1367,47.24
Yone,Olaf,910,433,477,47.58
Yone,Karma,4051,1938,2113,47.84
Yone,Viktor,3259,1589,1670,48.76
Yone,Bard,1036,489,547,47.2
Yone,Karthus,1086,559,527,51.47
Yone,Malphite,4174,1915,2259,45.88
Yone,Ziggs,1529,738,791,48.27
Yone,Shyvana,955,450,505,47.12
Yone,Maokai,1715,859,856,50.09
Yone,Lillia,2308,1140,1168,49.39
Yone,Belveth,909,479,430,52.7
Yone,Janna,1131,553,578,48.89
Yone,Fizz,2001,848,1153,42.38
Yone,Singed,983,450,533,45.78
Yone,Khazix,2131,1057,1074,49.6
Yone,JarvanIV,2003,936,1067,46.73
Yone,Shen,2497,1148,1349,45.98
Yone,Rumble,1058,522,536,49.34
Yone,Elise,2688,1397,1291,51.97
Yone,Urgot,1673,736,937,43.99
Yone,Milio,1952,903,1049,46.26
Yone,Kassadin,669,329,340,49.18
Yone,Syndra,2287,1070,1217,46.79
Yone,Ambessa,2506,1192,1314,47.57
Yone,Skarner,1149,586,563,51
Yone,Corki,1367,740,627,54.13
Darius,Mordekaiser,6254,3168,3086,50.66
Darius,Qiyana,1018,607,411,59.63
Darius,Irelia,3136,1655,1481,52.77
Darius,Ezreal,8845,4766,4079,53.88
Darius,Rell,2064,978,1086,47.38
Darius,Fiora,1624,879,745,54.13
Darius,Pantheon,6463,3167,3296,49
Darius,Katarina,3071,1543,1528,50.24
Darius,Mel,8037,4236,3801,52.71
Darius,Viktor,3213,1608,1605,50.05
Darius,Illaoi,2039,882,1157,43.26
Darius,Warwick,6587,3200,3387,48.58
Darius,Diana,6298,3111,3187,49.4
Darius,Tristana,3832,1982,1850,51.72
Darius,Milio,2341,1140,1201,48.7
Darius,Viego,5350,2680,2670,50.09
Darius,Jhin,7932,3968,3964,50.03
Darius,Lux,10006,4867,5139,48.64
Darius,Aatrox,4210,2157,2053,51.24
Darius,Ekko,3572,1841,1731,51.54
Darius,Orianna,1800,892,908,49.56
Darius,Malzahar,3942,1857,2085,47.11
Darius,Maokai,1902,924,978,48.58
Darius,Sett,7463,3523,3940,47.21
Darius,Zac,1687,876,811,51.93
Darius,Yasuo,8031,4253,3778,52.96
Darius,MissFortune,9252,4418,4834,47.75
Darius,Yone,7278,3854,3424,52.95
Darius,Galio,3444,1698,1746,49.3
Darius,Chogath,5078,2473,2605,48.7
Darius,Vladimir,2442,1316,1126,53.89
Darius,Evelynn,1513,762,751,50.36
Darius,Yuumi,3435,1742,1693,50.71
Darius,Poppy,2230,1112,1118,49.87
Darius,Veigar,4230,2064,2166,48.79
Darius,Heimerdinger,2153,1004,1149,46.63
Darius,Ziggs,1501,739,762,49.23
Darius,Volibear,5025,2463,2562,49.01
Darius,Akshan,1399,694,705,49.61
Darius,Morgana,4698,2307,2391,49.11
Darius,FiddleSticks,1957,944,1013,48.24
Darius,Singed,960,469,491,48.85
Darius,Pyke,3421,1722,1699,50.34
Darius,Lillia,2363,1246,1117,52.73
Darius,Jinx,10477,5053,5424,48.23
Darius,Lulu,4903,2568,2335,52.38
Darius,Nasus,2943,1474,1469,50.08
Darius,Khazix,2054,1087,967,52.92
Darius,Urgot,2134,1038,1096,48.64
Darius,Tryndamere,2442,1264,1178,51.76
Darius,Briar,3340,1606,1734,48.08
Darius,Janna,1282,657,625,51.25
Darius,Ambessa,2285,1256,1029,54.97
Darius,Smolder,2845,1468,1377,51.6
Darius,Swain,3979,1940,2039,48.76
Darius,Kayn,5938,2985,2953,50.27
Darius,Akali,3824,1910,1914,49.95
Darius,TahmKench,3812,1950,1862,51.15
Darius,Kalista,1243,689,554,55.43
Darius,Thresh,5630,2839,2791,50.43
Darius,Udyr,1866,961,905,51.5
Darius,Yorick,3837,1720,2117,44.83
Darius,Karma,4322,2240,2082,51.83
Darius,Gnar,1790,904,886,50.5
Darius,Brand,2939,1422,1517,48.38
Darius,Caitlyn,10454,5269,5185,50.4
Darius,Velkoz,2408,1161,1247,48.21
Darius,XinZhao,2644,1257,1387,47.54
Darius,Samira,3118,1583,1535,50.77
Darius,Zed,4492,2436,2056,54.23
Darius,Graves,2567,1289,1278,50.21
Darius,Kassadin,840,417,423,49.64
Darius,Vex,1988,959,1029,48.24
Darius,Vi,3756,1872,1884,49.84
Darius,Nilah,1524,734,790,48.16
Darius,Gangplank,2149,1063,1086,49.46
Darius,Nunu,2462,1241,1221,50.41
Darius,Soraka,2245,1103,1142,49.13
Darius,Aurora,3188,1640,1548,51.44
Darius,Nocturne,4721,2207,2514,46.75
Darius,Olaf,907,506,401,55.79
Darius,Ashe,8103,4181,3922,51.6
Darius,Kayle,3026,1511,1515,49.93
Darius,Vayne,5531,2661,2870,48.11
Darius,Hwei,2966,1404,1562,47.34
Darius,Senna,3242,1597,1645,49.26
Darius,Malphite,3720,1893,1827,50.89
Darius,Naafiri,1481,791,690,53.41
Darius,Trundle,2382,1116,1266,46.85
Darius,Riven,2068,1078,990,52.13
Darius,Seraphine,3388,1687,1701,49.79
Darius,Sion,3177,1509,1668,47.5
Darius,Twitch,3088,1557,1531,50.42
Darius,Sylas,4832,2487,2345,51.47
Darius,Kaisa,6425,3214,3211,50.02
Darius,Renata,774,422,352,54.52
Darius,Aphelios,2306,1129,1177,48.96
Darius,Nautilus,4449,2322,2127,52.19
Darius,DrMundo,2400,1127,1273,46.96
Darius,Jax,3404,1676,1728,49.24
Darius,Shaco,3746,1917,1829,51.17
Darius,Talon,2220,1106,1114,49.82
Darius,Taliyah,1052,481,571,45.72
Darius,Zoe,1624,836,788,51.48
Darius,Quinn,1584,799,785,50.44
Darius,Shyvana,1096,590,506,53.83
Darius,Fizz,2317,1232,1085,53.17
Darius,Taric,962,458,504,47.61
Darius,Cassiopeia,1242,643,599,51.77
Darius,Ornn,1661,838,823,50.45
Darius,Shen,2564,1339,1225,52.22
Darius,MasterYi,4837,2487,2350,51.42
Darius,Nami,4064,2057,2007,50.62
Darius,AurelionSol,1679,821,858,48.9
Darius,Gragas,2277,1212,1065,53.23
Darius,RekSai,563,288,275,51.15
Darius,KSante,2212,1188,1024,53.71
Darius,Draven,2182,1165,1017,53.39
Darius,Varus,3389,1763,1626,52.02
Darius,Sejuani,1765,900,865,50.99
Darius,Neeko,2117,1166,951,55.08
Darius,Kennen,1365,708,657,51.87
Darius,Garen,7493,3729,3764,49.77
Darius,Rakan,1788,850,938,47.54
Darius,Ryze,1442,761,681,52.77
Darius,Blitzcrank,3056,1620,1436,53.01
Darius,LeeSin,5671,3077,2594,54.26
Darius,Ahri,5255,2772,2483,52.75
Darius,Jayce,1791,905,886,50.53
Darius,Renekton,2065,1054,1011,51.04
Darius,Rammus,1285,679,606,52.84
Darius,Camille,1382,673,709,48.7
Darius,Xayah,2060,1014,1046,49.22
Darius,Sona,1307,668,639,51.11
Darius,Teemo,5375,2602,2773,48.41
Darius,Belveth,903,470,433,52.05
Darius,Azir,1480,749,731,50.61
Darius,Leblanc,2016,997,1019,49.45
Darius,Amumu,4150,1903,2247,45.86
Darius,Skarner,1210,647,563,53.47
Darius,Zilean,1257,619,638,49.24
Darius,Lucian,2934,1507,1427,51.36
Darius,Syndra,2550,1262,1288,49.49
Darius,Hecarim,1587,866,721,54.57
Darius,KogMaw,1248,618,630,49.52
Darius,Rengar,1275,730,545,57.25
Darius,Zyra,3490,1539,1951,44.1
Darius,TwistedFate,1386,747,639,53.9
Darius,Leona,3323,1535,1788,46.19
Darius,Annie,1158,614,544,53.02
Darius,Xerath,3192,1524,1668,47.74
Darius,Sivir,1948,919,1029,47.18
Darius,Zeri,1629,866,763,53.16
Darius,Karthus,1216,616,600,50.66
Darius,Kindred,1962,1065,897,54.28
Darius,Lissandra,1210,624,586,51.57
Darius,Alistar,1591,832,759,52.29
Darius,Gwen,1984,994,990,50.1
Darius,Corki,1578,813,765,51.52
Darius,Nidalee,1118,629,489,56.26
Darius,JarvanIV,2222,1104,1118,49.68
Darius,Elise,2708,1351,1357,49.89
Darius,Braum,2190,1129,1061,51.55
Darius,Rumble,987,548,439,55.52
Darius,Bard,1257,704,553,56.01
Darius,Kled,792,430,362,54.29
Darius,MonkeyKing,2965,1465,1500,49.41
Darius,Ivern,706,386,320,54.67
Darius,Anivia,1259,593,666,47.1
Yasuo,Mordekaiser,5518,2603,2915,47.17
Yasuo,Qiyana,1093,604,489,55.26
Yasuo,Irelia,3980,1993,1987,50.08
Yasuo,Ezreal,9467,4966,4501,52.46
Yasuo,Rell,2070,999,1071,48.26
Yasuo,Singed,1132,542,590,47.88
Yasuo,Shaco,3852,2009,1843,52.15
Yasuo,Zed,5508,2963,2545,53.79
Yasuo,Hwei,2651,1372,1279,51.75
Yasuo,Lux,10551,5473,5078,51.87
Yasuo,Renekton,2775,1336,1439,48.14
Yasuo,Khazix,2225,1199,1026,53.89
Yasuo,Mel,9163,4829,4334,52.7
Yasuo,Jhin,8347,4201,4146,50.33
Yasuo,Aatrox,4011,2060,1951,51.36
Yasuo,Sylas,6097,3262,2835,53.5
Yasuo,Diana,6067,3067,3000,50.55
Yasuo,Varus,3483,1864,1619,53.52
Yasuo,Blitzcrank,3093,1551,1542,50.15
Yasuo,Ambessa,2687,1379,1308,51.32
Yasuo,Rammus,1710,760,950,44.44
Yasuo,Draven,2215,1214,1001,54.81
Yasuo,Viego,5748,2831,2917,49.25
Yasuo,Teemo,5434,2700,2734,49.69
Yasuo,Warwick,6387,3117,3270,48.8
Yasuo,Azir,1581,741,840,46.87
Yasuo,MissFortune,9390,4690,4700,49.95
Yasuo,Neeko,2144,1142,1002,53.26
Yasuo,Gangplank,2196,1109,1087,50.5
Yasuo,Brand,2922,1480,1442,50.65
Yasuo,Malzahar,4332,2083,2249,48.08
Yasuo,Pyke,3795,1986,1809,52.33
Yasuo,Briar,3231,1516,1715,46.92
Yasuo,Ryze,1406,716,690,50.92
Yasuo,Vex,3114,1439,1675,46.21
Yasuo,Yuumi,3659,1947,1712,53.21
Yasuo,Naafiri,1483,822,661,55.43
Yasuo,Yone,10146,5229,4917,51.54
Yasuo,Senna,3195,1599,1596,50.05
Yasuo,Galio,3414,1659,1755,48.59
Yasuo,TahmKench,3628,1951,1677,53.78
Yasuo,Hecarim,1619,797,822,49.23
Yasuo,Veigar,4161,2034,2127,48.88
Yasuo,Ashe,8254,4030,4224,48.82
Yasuo,Thresh,5770,2771,2999,48.02
Yasuo,Sett,6842,3408,3434,49.81
Yasuo,Amumu,4141,1938,2203,46.8
Yasuo,Caitlyn,11136,5622,5514,50.48
Yasuo,Poppy,2577,1267,1310,49.17
Yasuo,Malphite,4582,2208,2374,48.19
Yasuo,Evelynn,1643,854,789,51.98
Yasuo,Tristana,4077,2109,1968,51.73
Yasuo,Garen,7205,3483,3722,48.34
Yasuo,Kayn,6254,3066,3188,49.02
Yasuo,Riven,2045,1002,1043,49
Yasuo,Zoe,1561,904,657,57.91
Yasuo,Sona,1241,582,659,46.9
Yasuo,Nocturne,5022,2237,2785,44.54
Yasuo,Jinx,10555,5195,5360,49.22
Yasuo,Lulu,5059,2463,2596,48.69
Yasuo,Samira,3279,1652,1627,50.38
Yasuo,Darius,8031,3775,4256,47.01
Yasuo,Volibear,4598,2312,2286,50.28
Yasuo,Chogath,5155,2525,2630,48.98
Yasuo,Sivir,2123,1097,1026,51.67
Yasuo,Rakan,1882,898,984,47.72
Yasuo,Jax,4120,2077,2043,50.41
Yasuo,Xayah,2383,1148,1235,48.17
Yasuo,Karma,4526,2234,2292,49.36
Yasuo,Seraphine,3371,1748,1623,51.85
Yasuo,Zilean,1263,642,621,50.83
Yasuo,LeeSin,6056,3262,2794,53.86
Yasuo,Nami,3796,1858,1938,48.95
Yasuo,Aurora,3169,1632,1537,51.5
Yasuo,Kaisa,6773,3423,3350,50.54
Yasuo,Shen,2715,1309,1406,48.21
Yasuo,Gragas,2366,1246,1120,52.66
Yasuo,Alistar,1744,903,841,51.78
Yasuo,Kindred,1883,1021,862,54.22
Yasuo,Nasus,3361,1722,1639,51.23
Yasuo,Urgot,1988,944,1044,47.48
Yasuo,DrMundo,2280,1177,1103,51.62
Yasuo,Leblanc,2160,1127,1033,52.18
Yasuo,Nunu,2539,1353,1186,53.29
Yasuo,Vladimir,3123,1532,1591,49.06
Yasuo,Zac,1849,940,909,50.84
Yasuo,Kalista,1210,539,671,44.55
Yasuo,Vi,3959,2002,1957,50.57
Yasuo,Orianna,1629,812,817,49.85
Yasuo,Kennen,1298,633,665,48.77
Yasuo,MonkeyKing,2772,1328,1444,47.91
Yasuo,Vayne,5203,2569,2634,49.38
Yasuo,Fiora,1744,918,826,52.64
Yasuo,Ziggs,1431,734,697,51.29
Yasuo,Nilah,1780,720,1060,40.45
Yasuo,JarvanIV,2212,1068,1144,48.28
Yasuo,Taliyah,1270,665,605,52.36
Yasuo,Soraka,2237,1104,1133,49.35
Yasuo,Sion,2939,1375,1564,46.78
Yasuo,Rengar,1561,937,624,60.03
Yasuo,Ahri,5383,2687,2696,49.92
Yasuo,Anivia,1384,701,683,50.65
Yasuo,Sejuani,1675,866,809,51.7
Yasuo,AurelionSol,1695,857,838,50.56
Yasuo,Shyvana,954,469,485,49.16
Yasuo,Fizz,2316,1210,1106,52.25
Yasuo,Twitch,3281,1663,1618,50.69
Yasuo,Kayle,2878,1298,1580,45.1
Yasuo,FiddleSticks,2090,1003,1087,47.99
Yasuo,Katarina,3265,1753,1512,53.69
Yasuo,Lissandra,1732,867,865,50.06
Yasuo,XinZhao,2628,1259,1369,47.91
Yasuo,Ornn,1698,863,835,50.82
Yasuo,Smolder,2799,1448,1351,51.73
Yasuo,Swain,4296,2042,2254,47.53
Yasuo,Graves,2697,1363,1334,50.54
Yasuo,Kassadin,746,386,360,51.74
Yasuo,Maokai,1802,844,958,46.84
Yasuo,Ivern,733,391,342,53.34
Yasuo,Illaoi,2111,1014,1097,48.03
Yasuo,Morgana,4994,2438,2556,48.82
Yasuo,Gwen,1974,1011,963,51.22
Yasuo,RekSai,558,253,305,45.34
Yasuo,Leona,3354,1605,1749,47.85
Yasuo,Akali,5213,2574,2639,49.38
Yasuo,Pantheon,7087,3390,3697,47.83
Yasuo,Corki,1625,895,730,55.08
Yasuo,Viktor,3127,1489,1638,47.62
Yasuo,Akshan,1240,639,601,51.53
Yasuo,Lillia,2427,1128,1299,46.48
Yasuo,Velkoz,2385,1185,1200,49.69
Yasuo,Skarner,1085,613,472,56.5
Yasuo,Ekko,3664,1795,1869,48.99
Yasuo,Xerath,3285,1711,1574,52.09
Yasuo,Trundle,2354,1151,1203,48.9
Yasuo,Aphelios,2463,1289,1174,52.33
Yasuo,Nautilus,4458,2276,2182,51.05
Yasuo,Zyra,3475,1813,1662,52.17
Yasuo,Annie,1668,770,898,46.16
Yasuo,Jayce,1968,1114,854,56.61
Yasuo,Tryndamere,2359,1141,1218,48.37
Yasuo,MasterYi,5145,2374,2771,46.14
Yasuo,Zeri,1712,850,862,49.65
Yasuo,Taric,1004,470,534,46.81
Yasuo,Quinn,1407,675,732,47.97
Yasuo,Udyr,1587,782,805,49.28
Yasuo,Lucian,3033,1544,1489,50.91
Yasuo,Kled,689,381,308,55.3
Yasuo,KogMaw,1245,604,641,48.51
Yasuo,Olaf,966,445,521,46.07
Yasuo,Syndra,2048,1017,1031,49.66
Yasuo,Talon,2731,1517,1214,55.55
Yasuo,Yorick,3928,1890,2038,48.12
Yasuo,Bard,1238,623,615,50.32
Yasuo,Camille,1447,765,682,52.87
Yasuo,Cassiopeia,1186,571,615,48.15
Yasuo,Milio,2259,1044,1215,46.22
Yasuo,Renata,837,437,400,52.21
Yasuo,Elise,2757,1435,1322,52.05
Yasuo,Heimerdinger,2111,1086,1025,51.44
Yasuo,Belveth,1029,472,557,45.87
Yasuo,Janna,1406,665,741,47.3
Yasuo,Gnar,1743,913,830,52.38
Yasuo,Rumble,1219,691,528,56.69
Yasuo,Karthus,1130,545,585,48.23
Yasuo,Braum,2213,1081,1132,48.85
Yasuo,KSante,2277,1222,1055,53.67
Yasuo,Nidalee,1192,717,475,60.15
Yasuo,TwistedFate,1303,671,632,51.5
Jhin,Mordekaiser,5405,2547,2858,47.12
Jhin,Qiyana,1186,602,584,50.76
Jhin,Irelia,3531,1852,1679,52.45
Jhin,Ezreal,10839,5613,5226,51.79
Jhin,Rell,2050,1049,1001,51.17
Jhin,Aurora,3134,1611,1523,51.4
Jhin,Volibear,4631,2391,2240,51.63
Jhin,Yasuo,8347,4143,4204,49.63
Jhin,Vayne,5345,2500,2845,46.77
Jhin,Shaco,3951,2022,1929,51.18
Jhin,Chogath,5035,2612,2423,51.88
Jhin,Kayn,5982,2897,3085,48.43
Jhin,Gangplank,2146,1074,1072,50.05
Jhin,Hwei,3007,1582,1425,52.61
Jhin,Darius,7932,3961,3971,49.94
Jhin,Warwick,6404,3200,3204,49.97
Jhin,Caitlyn,13660,6994,6666,51.2
Jhin,Morgana,5081,2537,2544,49.93
Jhin,Gragas,2226,1195,1031,53.68
Jhin,TwistedFate,1587,923,664,58.16
Jhin,Lucian,3134,1624,1510,51.82
Jhin,Leona,3348,1643,1705,49.07
Jhin,Zed,4717,2392,2325,50.71
Jhin,Sona,1298,604,694,46.53
Jhin,Kaisa,6791,3322,3469,48.92
Jhin,Amumu,4283,2157,2126,50.36
Jhin,Riven,1884,953,931,50.58
Jhin,Ahri,5458,2769,2689,50.73
Jhin,Jinx,11864,5682,6182,47.89
Jhin,Nautilus,4506,2291,2215,50.84
Jhin,Gwen,2012,998,1014,49.6
Jhin,Talon,2303,1181,1122,51.28
Jhin,Yone,7711,3949,3762,51.21
Jhin,MissFortune,10165,5038,5127,49.56
Jhin,Taric,804,388,416,48.26
Jhin,Nasus,2767,1346,1421,48.64
Jhin,Varus,3799,1978,1821,52.07
Jhin,Neeko,2171,1142,1029,52.6
Jhin,Swain,4078,1874,2204,45.95
Jhin,Malzahar,4133,2088,2045,50.52
Jhin,Kalista,1307,680,627,52.03
Jhin,Poppy,2384,1183,1201,49.62
Jhin,Ekko,3772,1830,1942,48.52
Jhin,Pyke,3791,2046,1745,53.97
Jhin,Galio,3506,1701,1805,48.52
Jhin,Cassiopeia,1231,586,645,47.6
Jhin,Mel,8825,4639,4186,52.57
Jhin,Hecarim,1633,935,698,57.26
Jhin,Milio,2369,1133,1236,47.83
Jhin,Garen,6432,3078,3354,47.85
Jhin,Seraphine,3334,1697,1637,50.9
Jhin,Zilean,1361,698,663,51.29
Jhin,Soraka,2454,1164,1290,47.43
Jhin,Sylas,5157,2569,2588,49.82
Jhin,Ryze,1322,669,653,50.61
Jhin,Nunu,2567,1243,1324,48.42
Jhin,Alistar,1505,706,799,46.91
Jhin,Lillia,2394,1140,1254,47.62
Jhin,Vladimir,2787,1399,1388,50.2
Jhin,Lulu,5518,2786,2732,50.49
Jhin,Sett,6219,2935,3284,47.19
Jhin,Brand,2880,1499,1381,52.05
Jhin,Twitch,3489,1790,1699,51.3
Jhin,Ashe,8875,4432,4443,49.94
Jhin,Zac,1836,853,983,46.46
Jhin,Gnar,1818,948,870,52.15
Jhin,Jax,3637,1944,1693,53.45
Jhin,Bard,1226,591,635,48.21
Jhin,Heimerdinger,2020,996,1024,49.31
Jhin,FiddleSticks,2108,1047,1061,49.67
Jhin,Katarina,3394,1750,1644,51.56
Jhin,Akali,4490,2255,2235,50.22
Jhin,Naafiri,1549,801,748,51.71
Jhin,Kayle,2786,1337,1449,47.99
Jhin,Smolder,3016,1611,1405,53.42
Jhin,Sejuani,1698,871,827,51.3
Jhin,AurelionSol,1658,826,832,49.82
Jhin,Tristana,4325,2037,2288,47.1
Jhin,Rakan,1801,840,961,46.64
Jhin,Samira,3127,1587,1540,50.75
Jhin,Leblanc,2381,1207,1174,50.69
Jhin,Nami,4326,2120,2206,49.01
Jhin,Malphite,3946,1903,2043,48.23
Jhin,MonkeyKing,2649,1207,1442,45.56
Jhin,Senna,2986,1554,1432,52.04
Jhin,Shen,2573,1299,1274,50.49
Jhin,Ziggs,1578,788,790,49.94
Jhin,Kled,791,400,391,50.57
Jhin,XinZhao,2630,1192,1438,45.32
Jhin,Trundle,2281,1134,1147,49.72
Jhin,Aphelios,2478,1295,1183,52.26
Jhin,Viktor,3629,1908,1721,52.58
Jhin,Yuumi,3606,1807,1799,50.11
Jhin,Xerath,3716,1835,1881,49.38
Jhin,Rammus,1259,640,619,50.83
Jhin,Nocturne,5058,2394,2664,47.33
Jhin,Vex,2322,1134,1188,48.84
Jhin,KSante,2096,1148,948,54.77
Jhin,Azir,1382,755,627,54.63
Jhin,Skarner,1189,666,523,56.01
Jhin,Lissandra,1376,706,670,51.31
Jhin,DrMundo,2274,1118,1156,49.16
Jhin,Veigar,4105,2088,2017,50.86
Jhin,Pantheon,6404,3096,3308,48.34
Jhin,Annie,1340,679,661,50.67
Jhin,Syndra,2627,1280,1347,48.72
Jhin,Lux,10853,5573,5280,51.35
Jhin,Karma,4770,2257,2513,47.32
Jhin,Illaoi,1838,867,971,47.17
Jhin,Rengar,1476,838,638,56.78
Jhin,Xayah,2151,1017,1134,47.28
Jhin,Thresh,5657,2716,2941,48.01
Jhin,Ornn,1827,904,923,49.48
Jhin,Yorick,3951,1828,2123,46.27
Jhin,Braum,2295,1010,1285,44.01
Jhin,Sion,3064,1453,1611,47.42
Jhin,Evelynn,1523,787,736,51.67
Jhin,MasterYi,4862,2316,2546,47.63
Jhin,Kindred,1924,1037,887,53.9
Jhin,Sivir,2146,1069,1077,49.81
Jhin,Quinn,1524,705,819,46.26
Jhin,Teemo,5084,2480,2604,48.78
Jhin,Camille,1526,798,728,52.29
Jhin,Zeri,1731,839,892,48.47
Jhin,Singed,1050,493,557,46.95
Jhin,Aatrox,3859,1904,1955,49.34
Jhin,Khazix,2263,1153,1110,50.95
Jhin,Viego,6015,3043,2972,50.59
Jhin,Diana,6028,2999,3029,49.75
Jhin,Nilah,1447,726,721,50.17
Jhin,RekSai,527,230,297,43.64
Jhin,Velkoz,2481,1268,1213,51.11
Jhin,Vi,3586,1858,1728,51.81
Jhin,Kassadin,841,429,412,51.01
Jhin,Corki,1573,840,733,53.4
Jhin,Blitzcrank,2923,1419,1504,48.55
Jhin,Belveth,990,492,498,49.7
Jhin,Orianna,1621,834,787,51.45
Jhin,Tryndamere,2320,1134,1186,48.88
Jhin,Renekton,2104,1085,1019,51.57
Jhin,Briar,3193,1495,1698,46.82
Jhin,Anivia,1352,593,759,43.86
Jhin,Zoe,1657,843,814,50.88
Jhin,Zyra,3727,1840,1887,49.37
Jhin,Kennen,1252,646,606,51.6
Jhin,Ambessa,2547,1293,1254,50.77
Jhin,Maokai,1725,776,949,44.99
Jhin,Graves,2727,1310,1417,48.04
Jhin,TahmKench,3348,1772,1576,52.93
Jhin,JarvanIV,2355,1080,1275,45.86
Jhin,Fiora,1583,778,805,49.15
Jhin,KogMaw,1345,643,702,47.81
Jhin,LeeSin,6066,3216,2850,53.02
Jhin,Fizz,2348,1080,1268,46
Jhin,Draven,2236,1191,1045,53.26
Jhin,Karthus,1208,575,633,47.6
Jhin,Udyr,1540,817,723,53.05
Jhin,Elise,2846,1559,1287,54.78
Jhin,Akshan,1432,764,668,53.35
Jhin,Taliyah,980,498,482,50.82
Jhin,Renata,754,363,391,48.14
Jhin,Urgot,2083,984,1099,47.24
Jhin,Rumble,1160,620,540,53.45
Jhin,Ivern,745,432,313,57.99
Jhin,Janna,1289,601,688,46.63
Jhin,Nidalee,1214,689,525,56.75
Jhin,Olaf,958,467,491,48.75
Jhin,Shyvana,1025,498,527,48.59
Jhin,Jayce,2042,1037,1005,50.78
Lux,Mordekaiser,7326,3601,3725,49.15
Lux,Qiyana,1434,779,655,54.32
Lux,Irelia,4402,2246,2156,51.02
Lux,Ezreal,11092,5670,5422,51.12
Lux,Rell,2483,1267,1216,51.03
Lux,Sejuani,2106,1045,1061,49.62
Lux,Yasuo,10551,5078,5473,48.13
Lux,Lucian,3659,1915,1744,52.34
Lux,Pantheon,8467,4193,4274,49.52
Lux,Aurora,4135,2265,1870,54.78
Lux,Volibear,6178,3052,3126,49.4
Lux,Vayne,6231,2997,3234,48.1
Lux,Shaco,5250,2674,2576,50.93
Lux,Aatrox,4870,2503,2367,51.4
Lux,Sylas,6342,3234,3108,50.99
Lux,Diana,8246,4003,4243,48.54
Lux,Varus,4502,2346,2156,52.11
Lux,Blitzcrank,4830,2425,2405,50.21
Lux,Illaoi,2636,1350,1286,51.21
Lux,Warwick,8162,3911,4251,47.92
Lux,Tristana,5198,2667,2531,51.31
Lux,Milio,3057,1378,1679,45.08
Lux,Kayle,3677,1749,1928,47.57
Lux,Caitlyn,14329,7261,7068,50.67
Lux,Renata,950,468,482,49.26
Lux,Darius,10006,5139,4867,51.36
Lux,Morgana,8556,4122,4434,48.18
Lux,Brand,4636,2349,2287,50.67
Lux,Akali,5928,2933,2995,49.48
Lux,MissFortune,13215,6342,6873,47.99
Lux,Kassadin,1094,572,522,52.29
Lux,Kayn,8015,4068,3947,50.75
Lux,Sona,1752,906,846,51.71
Lux,Sett,8238,4045,4193,49.1
Lux,Amumu,5809,2739,3070,47.15
Lux,Poppy,2865,1440,1425,50.26
Lux,Teemo,7259,3422,3837,47.14
Lux,XinZhao,3222,1537,1685,47.7
Lux,Jinx,13306,6648,6658,49.96
Lux,Neeko,3287,1774,1513,53.97
Lux,Gwen,2672,1424,1248,53.29
Lux,Skarner,1443,724,719,50.17
Lux,Yone,9993,5263,4730,52.67
Lux,Kaisa,8101,4208,3893,51.94
Lux,Seraphine,5899,3002,2897,50.89
Lux,Ornn,2338,1108,1230,47.39
Lux,Ekko,4753,2434,2319,51.21
Lux,Orianna,2341,1211,1130,51.73
Lux,Malzahar,5440,2487,2953,45.72
Lux,Maokai,2375,1260,1115,53.05
Lux,Vi,4630,2281,2349,49.27
Lux,AurelionSol,2378,1094,1284,46.01
Lux,Corki,2038,1092,946,53.58
Lux,Chogath,6407,3219,3188,50.24
Lux,Yorick,5323,2335,2988,43.87
Lux,Sivir,2666,1307,1359,49.02
Lux,Xerath,5617,2717,2900,48.37
Lux,Vladimir,3045,1511,1534,49.62
Lux,Evelynn,2253,1093,1160,48.51
Lux,Yuumi,4638,2355,2283,50.78
Lux,Nasus,3970,1916,2054,48.26
Lux,MonkeyKing,3324,1668,1656,50.18
Lux,Zoe,2287,1203,1084,52.6
Lux,Xayah,2733,1438,1295,52.62
Lux,Zac,2102,1088,1014,51.76
Lux,Heimerdinger,2861,1441,1420,50.37
Lux,LeeSin,6913,3570,3343,51.64
Lux,Veigar,6242,3135,3107,50.22
Lux,Vex,3245,1574,1671,48.51
Lux,Rakan,2317,1158,1159,49.98
Lux,Gragas,2908,1577,1331,54.23
Lux,Soraka,3218,1556,1662,48.35
Lux,Garen,8309,4117,4192,49.55
Lux,Ziggs,2365,1217,1148,51.46
Lux,Zeri,1936,993,943,51.29
Lux,Zyra,4673,2236,2437,47.85
Lux,Talon,2802,1575,1227,56.21
Lux,Pyke,5310,2625,2685,49.44
Lux,Khazix,3093,1661,1432,53.7
Lux,Nautilus,5924,3017,2907,50.93
Lux,Twitch,4416,2269,2147,51.38
Lux,Kennen,1646,854,792,51.88
Lux,Naafiri,2087,965,1122,46.24
Lux,Nocturne,6407,2958,3449,46.17
Lux,Ashe,10406,5252,5154,50.47
Lux,Thresh,7646,3918,3728,51.24
Lux,Riven,2161,1189,972,55.02
Lux,JarvanIV,2894,1348,1546,46.58
Lux,Taliyah,1218,667,551,54.76
Lux,Draven,2886,1450,1436,50.24
Lux,Jax,4915,2550,2365,51.88
Lux,Mel,10923,5307,5616,48.59
Lux,Kalista,1696,888,808,52.36
Lux,Rammus,1588,810,778,51.01
Lux,TahmKench,5226,2563,2663,49.04
Lux,Katarina,4234,2203,2031,52.03
Lux,Shyvana,1382,671,711,48.55
Lux,Fizz,3285,1664,1621,50.65
Lux,Nilah,1963,957,1006,48.75
Lux,Nami,5513,2683,2830,48.67
Lux,Malphite,5427,2722,2705,50.16
Lux,Gnar,2021,1030,991,50.96
Lux,Samira,4417,2264,2153,51.26
Lux,Leblanc,3092,1612,1480,52.13
Lux,KSante,2387,1269,1118,53.16
Lux,Quinn,1861,868,993,46.64
Lux,FiddleSticks,2578,1318,1260,51.12
Lux,Cassiopeia,1404,720,684,51.28
Lux,Lillia,2883,1575,1308,54.63
Lux,Lissandra,1513,761,752,50.3
Lux,Renekton,2502,1276,1226,51
Lux,Annie,1781,912,869,51.21
Lux,Senna,4120,2127,1993,51.63
Lux,Alistar,1845,947,898,51.33
Lux,Briar,4339,1996,2343,46
Lux,Janna,1455,772,683,53.06
Lux,Zed,5937,3024,2913,50.93
Lux,Smolder,3502,1808,1694,51.63
Lux,Galio,4482,2246,2236,50.11
Lux,Swain,5590,2750,2840,49.19
Lux,Tryndamere,3237,1621,1616,50.08
Lux,Zilean,1614,839,775,51.98
Lux,Bard,1493,718,775,48.09
Lux,Rengar,1861,1053,808,56.58
Lux,Olaf,1288,656,632,50.93
Lux,MasterYi,6603,3301,3302,49.99
Lux,Velkoz,3751,1723,2028,45.93
Lux,Trundle,3276,1590,1686,48.53
Lux,Fiora,2103,1096,1007,52.12
Lux,Ryze,1600,859,741,53.69
Lux,Jhin,10853,5277,5576,48.62
Lux,Aphelios,2893,1541,1352,53.27
Lux,Hecarim,2038,1047,991,51.37
Lux,Syndra,3253,1603,1650,49.28
Lux,Akshan,1930,1006,924,52.12
Lux,Braum,2521,1217,1304,48.27
Lux,Singed,1408,700,708,49.72
Lux,Kindred,2594,1352,1242,52.12
Lux,Kled,933,447,486,47.91
Lux,Karma,5977,3037,2940,50.81
Lux,Ambessa,3189,1714,1475,53.75
Lux,Rumble,1146,588,558,51.31
Lux,Graves,3060,1546,1514,50.52
Lux,Ivern,809,422,387,52.16
Lux,Udyr,1866,938,928,50.27
Lux,Taric,1096,583,513,53.19
Lux,Nunu,3558,1781,1777,50.06
Lux,Viktor,4277,2142,2135,50.08
Lux,Urgot,2637,1345,1292,51
Lux,Lulu,5950,2961,2989,49.76
Lux,DrMundo,3271,1501,1770,45.89
Lux,Karthus,1483,813,670,54.82
Lux,Ahri,7725,4172,3553,54.01
Lux,Azir,1723,941,782,54.61
Lux,Viego,6910,3410,3500,49.35
Lux,Hwei,3716,1833,1883,49.33
Lux,Camille,1857,971,886,52.29
Lux,Shen,3437,1731,1706,50.36
Lux,TwistedFate,1890,1016,874,53.76
Lux,Gangplank,2583,1262,1321,48.86
Lux,Sion,3803,1817,1986,47.78
Lux,Belveth,1227,639,588,52.08
Lux,Nidalee,1406,820,586,58.32
Lux,Leona,4504,2185,2319,48.51
Lux,Anivia,1610,819,791,50.87
Lux,Elise,3424,1742,1682,50.88
Lux,KogMaw,1684,792,892,47.03
Lux,Jayce,2030,1057,973,52.07
Lux,RekSai,592,340,252,57.43
Mordekaiser,Yone,5520,2788,2732,50.51
Mordekaiser,Darius,6254,3086,3168,49.34
Mordekaiser,Yasuo,5518,2915,2603,52.83
Mordekaiser,Jhin,5405,2858,2547,52.88
Mordekaiser,Lux,7326,3725,3601,50.85
Mordekaiser,Singed,783,353,430,45.08
Mordekaiser,Shaco,2697,1464,1233,54.28
Mordekaiser,Zed,2922,1581,1341,54.11
Mordekaiser,Hwei,1997,980,1017,49.07
Mordekaiser,Fiora,1404,714,690,50.85
Mordekaiser,Belveth,707,336,371,47.52
Mordekaiser,Sylas,3494,1840,1654,52.66
Mordekaiser,Ezreal,5950,3131,2819,52.62
Mordekaiser,Yuumi,2531,1319,1212,52.11
Mordekaiser,Warwick,5182,2494,2688,48.13
Mordekaiser,Caitlyn,7559,3818,3741,50.51
Mordekaiser,Morgana,3808,1959,1849,51.44
Mordekaiser,Illaoi,1835,1007,828,54.88
Mordekaiser,MonkeyKing,1888,950,938,50.32
Mordekaiser,Tristana,2788,1445,1343,51.83
Mordekaiser,Garen,4965,2740,2225,55.19
Mordekaiser,Diana,4534,2352,2182,51.87
Mordekaiser,Pyke,2587,1393,1194,53.85
Mordekaiser,Volibear,3974,2038,1936,51.28
Mordekaiser,Ekko,2445,1230,1215,50.31
Mordekaiser,Kalista,946,471,475,49.79
Mordekaiser,Kayn,4369,2264,2105,51.82
Mordekaiser,TwistedFate,855,439,416,51.35
Mordekaiser,Smolder,1876,1045,831,55.7
Mordekaiser,Nautilus,3097,1630,1467,52.63
Mordekaiser,Renekton,1413,794,619,56.19
Mordekaiser,Vex,1582,841,741,53.16
Mordekaiser,Samira,2500,1359,1141,54.36
Mordekaiser,Lulu,3052,1630,1422,53.41
Mordekaiser,Urgot,1556,762,794,48.97
Mordekaiser,Rengar,1035,645,390,62.32
Mordekaiser,Ziggs,1227,599,628,48.82
Mordekaiser,Trundle,1879,924,955,49.18
Mordekaiser,Yorick,3098,1484,1614,47.9
Mordekaiser,Seraphine,2558,1340,1218,52.38
Mordekaiser,Sivir,1489,732,757,49.16
Mordekaiser,Xerath,2256,1128,1128,50
Mordekaiser,KSante,1768,945,823,53.45
Mordekaiser,Ashe,5481,2827,2654,51.58
Mordekaiser,Corki,899,533,366,59.29
Mordekaiser,Vladimir,1720,847,873,49.24
Mordekaiser,Tryndamere,1659,790,869,47.62
Mordekaiser,Milio,1576,817,759,51.84
Mordekaiser,Gangplank,1211,679,532,56.07
Mordekaiser,Mel,6061,3275,2786,54.03
Mordekaiser,Hecarim,1094,591,503,54.02
Mordekaiser,Heimerdinger,1511,707,804,46.79
Mordekaiser,Kindred,1371,774,597,56.46
Mordekaiser,Katarina,2190,1214,976,55.43
Mordekaiser,Janna,765,372,393,48.63
Mordekaiser,Teemo,3698,1909,1789,51.62
Mordekaiser,LeeSin,3510,1818,1692,51.79
Mordekaiser,Nami,2681,1340,1341,49.98
Mordekaiser,Amumu,3246,1650,1596,50.83
Mordekaiser,Kaisa,4224,2249,1975,53.24
Mordekaiser,Rakan,1167,619,548,53.04
Mordekaiser,Gnar,999,530,469,53.05
Mordekaiser,Viego,3674,1922,1752,52.31
Mordekaiser,TahmKench,2963,1553,1410,52.41
Mordekaiser,Akshan,921,448,473,48.64
Mordekaiser,FiddleSticks,1422,774,648,54.43
Mordekaiser,Nasus,2454,1228,1226,50.04
Mordekaiser,Neeko,1636,782,854,47.8
Mordekaiser,MissFortune,7328,3773,3555,51.49
Mordekaiser,Leblanc,1499,818,681,54.57
Mordekaiser,Karma,2792,1410,1382,50.5
Mordekaiser,Fizz,1705,949,756,55.66
Mordekaiser,Aatrox,2870,1527,1343,53.21
Mordekaiser,Aurora,2206,1163,1043,52.72
Mordekaiser,Brand,2176,1099,1077,50.51
Mordekaiser,Gragas,1424,834,590,58.57
Mordekaiser,Kennen,795,426,369,53.58
Mordekaiser,Vayne,3822,1818,2004,47.57
Mordekaiser,Thresh,3888,2028,1860,52.16
Mordekaiser,Akali,3183,1734,1449,54.48
Mordekaiser,Jinx,7507,3878,3629,51.66
Mordekaiser,Xayah,1539,798,741,51.85
Mordekaiser,Senna,2226,1104,1122,49.6
Mordekaiser,Shen,1927,981,946,50.91
Mordekaiser,Rammus,879,500,379,56.88
Mordekaiser,Cassiopeia,919,445,474,48.42
Mordekaiser,Nunu,2012,1072,940,53.28
Mordekaiser,Zeri,1159,649,510,56
Mordekaiser,Sion,2024,1020,1004,50.4
Mordekaiser,Ahri,3960,1989,1971,50.23
Mordekaiser,Anivia,990,507,483,51.21
Mordekaiser,Poppy,1744,865,879,49.6
Mordekaiser,Riven,1340,734,606,54.78
Mordekaiser,Briar,2526,1195,1331,47.31
Mordekaiser,Jayce,1022,556,466,54.4
Mordekaiser,Swain,3049,1601,1448,52.51
Mordekaiser,Sett,5191,2661,2530,51.26
Mordekaiser,Pantheon,4526,2419,2107,53.45
Mordekaiser,Braum,1532,810,722,52.87
Mordekaiser,Taric,688,316,372,45.93
Mordekaiser,Chogath,3923,2152,1771,54.86
Mordekaiser,Rell,1352,698,654,51.63
Mordekaiser,Olaf,1124,553,571,49.2
Mordekaiser,Evelynn,1202,707,495,58.82
Mordekaiser,Leona,2502,1389,1113,55.52
Mordekaiser,Talon,1458,843,615,57.82
Mordekaiser,Maokai,1333,700,633,52.51
Mordekaiser,Zyra,2402,1167,1235,48.58
Mordekaiser,Malphite,3197,1790,1407,55.99
Mordekaiser,Veigar,3264,1599,1665,48.99
Mordekaiser,Blitzcrank,2135,1107,1028,51.85
Mordekaiser,Orianna,1104,538,566,48.73
Mordekaiser,Draven,1405,709,696,50.46
Mordekaiser,Sejuani,1210,649,561,53.64
Mordekaiser,Gwen,1552,829,723,53.41
Mordekaiser,Malzahar,2747,1388,1359,50.53
Mordekaiser,Galio,2531,1256,1275,49.62
Mordekaiser,MasterYi,3568,1670,1898,46.8
Mordekaiser,Varus,2497,1251,1246,50.1
Mordekaiser,DrMundo,1674,797,877,47.61
Mordekaiser,Nilah,1098,561,537,51.09
Mordekaiser,Aphelios,1739,878,861,50.49
Mordekaiser,Nocturne,3223,1554,1669,48.22
Mordekaiser,Udyr,1100,600,500,54.55
Mordekaiser,JarvanIV,1487,791,696,53.19
Mordekaiser,Soraka,1675,838,837,50.03
Mordekaiser,Viktor,2098,1084,1014,51.67
Mordekaiser,Karthus,739,376,363,50.88
Mordekaiser,Qiyana,695,397,298,57.12
Mordekaiser,Lucian,1916,961,955,50.16
Mordekaiser,Naafiri,1129,621,508,55
Mordekaiser,Zilean,813,449,364,55.23
Mordekaiser,Kassadin,581,283,298,48.71
Mordekaiser,Graves,1640,835,805,50.91
Mordekaiser,Ivern,450,244,206,54.22
Mordekaiser,Velkoz,1660,756,904,45.54
Mordekaiser,Ryze,858,490,368,57.11
Mordekaiser,Sona,907,457,450,50.39
Mordekaiser,Kayle,2105,953,1152,45.27
Mordekaiser,Irelia,2222,1174,1048,52.84
Mordekaiser,Jax,2617,1381,1236,52.77
Mordekaiser,Khazix,1602,832,770,51.94
Mordekaiser,Camille,1045,593,452,56.75
Mordekaiser,Shyvana,824,397,427,48.18
Mordekaiser,Taliyah,665,365,300,54.89
Mordekaiser,Twitch,2353,1238,1115,52.61
Mordekaiser,KogMaw,944,511,433,54.13
Mordekaiser,Skarner,873,492,381,56.36
Mordekaiser,Azir,995,575,420,57.79
Mordekaiser,Vi,2612,1289,1323,49.35
Mordekaiser,AurelionSol,1251,696,555,55.64
Mordekaiser,Zac,1190,576,614,48.4
Mordekaiser,XinZhao,1854,984,870,53.07
Mordekaiser,Rumble,665,392,273,58.95
Mordekaiser,Zoe,1114,566,548,50.81
Mordekaiser,Renata,582,269,313,46.22
Mordekaiser,Ornn,1379,698,681,50.62
Mordekaiser,Lillia,1676,884,792,52.74
Mordekaiser,Annie,852,479,373,56.22
Mordekaiser,Syndra,1689,898,791,53.17
Mordekaiser,Elise,1640,849,791,51.77
Mordekaiser,Kled,547,318,229,58.14
Mordekaiser,Alistar,1160,653,507,56.29
Mordekaiser,Nidalee,638,350,288,54.86
Mordekaiser,Quinn,886,436,450,49.21
Mordekaiser,Ambessa,1548,818,730,52.84
Mordekaiser,Bard,768,371,397,48.31
Mordekaiser,Lissandra,837,392,445,46.83
Mordekaiser,RekSai,389,209,180,53.73
Qiyana,Yone,996,489,507,49.1
Qiyana,Darius,1018,411,607,40.37
Qiyana,Yasuo,1093,489,604,44.74
Qiyana,Jhin,1186,584,602,49.24
Qiyana,Lux,1434,655,779,45.68
Qiyana,Fiora,288,126,162,43.75
Qiyana,Belveth,156,94,62,60.26
Qiyana,Sylas,773,383,390,49.55
Qiyana,Ezreal,1294,596,698,46.06
Qiyana,Yuumi,486,195,291,40.12
Qiyana,Illaoi,260,130,130,50
Qiyana,Twitch,444,185,259,41.67
Qiyana,Velkoz,397,181,216,45.59
Qiyana,MonkeyKing,318,136,182,42.77
Qiyana,Tristana,550,223,327,40.55
Qiyana,Morgana,632,286,346,45.25
Qiyana,Teemo,634,263,371,41.48
Qiyana,Poppy,323,172,151,53.25
Qiyana,Akali,603,327,276,54.23
Qiyana,Caitlyn,1495,671,824,44.88
Qiyana,Leona,467,226,241,48.39
Qiyana,Zed,804,398,406,49.5
Qiyana,Shaco,508,227,281,44.69
Qiyana,Anivia,145,56,89,38.62
Qiyana,Garen,821,381,440,46.41
Qiyana,FiddleSticks,279,141,138,50.54
Qiyana,Brand,345,149,196,43.19
Qiyana,Yorick,488,231,257,47.34
Qiyana,Katarina,542,268,274,49.45
Qiyana,Lucian,355,162,193,45.63
Qiyana,Nautilus,645,294,351,45.58
Qiyana,Chogath,662,304,358,45.92
Qiyana,Talon,357,174,183,48.74
Qiyana,Nilah,225,100,125,44.44
Qiyana,Milio,407,199,208,48.89
Qiyana,Kindred,281,116,165,41.28
Qiyana,AurelionSol,219,115,104,52.51
Qiyana,Kalista,211,83,128,39.34
Qiyana,Kayle,347,170,177,48.99
Qiyana,Shyvana,127,53,74,41.73
Qiyana,Galio,395,180,215,45.57
Qiyana,Mel,1277,649,628,50.82
Qiyana,Blitzcrank,409,207,202,50.61
Qiyana,Urgot,261,105,156,40.23
Qiyana,Rakan,267,109,158,40.82
Qiyana,Kennen,150,70,80,46.67
Qiyana,JarvanIV,306,122,184,39.87
Qiyana,Karma,690,343,347,49.71
Qiyana,Soraka,320,140,180,43.75
Qiyana,Mordekaiser,695,298,397,42.88
Qiyana,Ekko,551,235,316,42.65
Qiyana,Irelia,475,246,229,51.79
Qiyana,Swain,577,237,340,41.07
Qiyana,Aatrox,603,313,290,51.91
Qiyana,Warwick,751,291,460,38.75
Qiyana,Fizz,302,146,156,48.34
Qiyana,Pyke,548,300,248,54.74
Qiyana,KSante,258,144,114,55.81
Qiyana,Draven,334,156,178,46.71
Qiyana,Renata,97,39,58,40.21
Qiyana,Hwei,373,170,203,45.58
Qiyana,Jinx,1446,677,769,46.82
Qiyana,Thresh,736,323,413,43.89
Qiyana,Volibear,637,328,309,51.49
Qiyana,Sett,851,308,543,36.19
Qiyana,Khazix,342,187,155,54.68
Qiyana,Ahri,739,340,399,46.01
Qiyana,DrMundo,281,101,180,35.94
Qiyana,Kayn,811,345,466,42.54
Qiyana,Sivir,255,120,135,47.06
Qiyana,Vi,478,205,273,42.89
Qiyana,Lulu,744,408,336,54.84
Qiyana,TahmKench,438,206,232,47.03
Qiyana,Veigar,556,284,272,51.08
Qiyana,Ashe,1136,567,569,49.91
Qiyana,Zilean,197,81,116,41.12
Qiyana,Ornn,281,122,159,43.42
Qiyana,Diana,859,387,472,45.05
Qiyana,Kled,107,47,60,43.93
Qiyana,Maokai,308,126,182,40.91
Qiyana,Riven,284,118,166,41.55
Qiyana,Orianna,325,163,162,50.15
Qiyana,Vladimir,396,198,198,50
Qiyana,Aphelios,372,158,214,42.47
Qiyana,Rengar,245,106,139,43.27
Qiyana,Rell,292,122,170,41.78
Qiyana,Gragas,384,198,186,51.56
Qiyana,Leblanc,226,121,105,53.54
Qiyana,Jax,512,209,303,40.82
Qiyana,Malphite,613,268,345,43.72
Qiyana,Udyr,220,95,125,43.18
Qiyana,Bard,187,68,119,36.36
Qiyana,Singed,155,77,78,49.68
Qiyana,MissFortune,1186,518,668,43.68
Qiyana,Tryndamere,355,166,189,46.76
Qiyana,Sion,495,231,264,46.67
Qiyana,Graves,368,162,206,44.02
Qiyana,Gnar,232,86,146,37.07
Qiyana,MasterYi,737,349,388,47.35
Qiyana,LeeSin,759,354,405,46.64
Qiyana,Azir,247,112,135,45.34
Qiyana,Nami,611,244,367,39.93
Qiyana,Nasus,431,216,215,50.12
Qiyana,Hecarim,269,131,138,48.7
Qiyana,Vayne,738,358,380,48.51
Qiyana,Seraphine,438,198,240,45.21
Qiyana,Janna,225,109,116,48.44
Qiyana,Pantheon,882,431,451,48.87
Qiyana,Camille,216,123,93,56.94
Qiyana,Syndra,361,156,205,43.21
Qiyana,Nunu,343,162,181,47.23
Qiyana,Ryze,235,122,113,51.91
Qiyana,Evelynn,254,103,151,40.55
Qiyana,Quinn,175,62,113,35.43
Qiyana,Viego,909,451,458,49.61
Qiyana,Xerath,407,175,232,43
Qiyana,Aurora,530,283,247,53.4
Qiyana,Briar,448,192,256,42.86
Qiyana,Kassadin,138,80,58,57.97
Qiyana,Gwen,332,177,155,53.31
Qiyana,Nocturne,592,259,333,43.75
Qiyana,Ambessa,392,147,245,37.5
Qiyana,Gangplank,280,140,140,50
Qiyana,Cassiopeia,193,90,103,46.63
Qiyana,Shen,379,156,223,41.16
Qiyana,Rammus,129,47,82,36.43
Qiyana,Heimerdinger,250,112,138,44.8
Qiyana,Vex,416,178,238,42.79
Qiyana,Amumu,587,246,341,41.91
Qiyana,Kaisa,833,439,394,52.7
Qiyana,Varus,498,219,279,43.98
Qiyana,Senna,550,219,331,39.82
Qiyana,XinZhao,365,186,179,50.96
Qiyana,Malzahar,462,189,273,40.91
Qiyana,Sejuani,247,138,109,55.87
Qiyana,Naafiri,212,93,119,43.87
Qiyana,Annie,162,74,88,45.68
Qiyana,Trundle,301,125,176,41.53
Qiyana,KogMaw,163,97,66,59.51
Qiyana,Ziggs,170,97,73,57.06
Qiyana,Corki,269,138,131,51.3
Qiyana,Zeri,296,152,144,51.35
Qiyana,Renekton,282,125,157,44.33
Qiyana,Rumble,172,69,103,40.12
Qiyana,Zyra,445,196,249,44.04
Qiyana,Ivern,117,74,43,63.25
Qiyana,Nidalee,181,82,99,45.3
Qiyana,Lissandra,201,75,126,37.31
Qiyana,Taric,107,57,50,53.27
Qiyana,Lillia,343,173,170,50.44
Qiyana,Samira,426,216,210,50.7
Qiyana,Elise,466,223,243,47.85
Qiyana,Jayce,334,156,178,46.71
Qiyana,Skarner,167,67,100,40.12
Qiyana,Zac,249,104,145,41.77
Qiyana,Smolder,354,184,170,51.98
Qiyana,Zoe,285,115,170,40.35
Qiyana,Alistar,269,152,117,56.51
Qiyana,Xayah,318,154,164,48.43
Qiyana,Viktor,493,250,243,50.71
Qiyana,Karthus,179,92,87,51.4
Qiyana,Neeko,251,104,147,41.43
Qiyana,TwistedFate,182,81,101,44.51
Qiyana,Braum,254,137,117,53.94
Qiyana,Taliyah,176,92,84,52.27
Qiyana,Akshan,191,81,110,42.41
Qiyana,Sona,143,64,79,44.76
Qiyana,Olaf,165,71,94,43.03
Qiyana,RekSai,76,33,43,43.42
Irelia,Yone,3890,2035,1855,52.31
Irelia,Darius,3136,1481,1655,47.23
Irelia,Yasuo,3980,1987,1993,49.92
Irelia,Jhin,3531,1676,1855,47.47
Irelia,Lux,4402,2151,2251,48.86
Irelia,Warwick,2569,1190,1379,46.32
Irelia,Caitlyn,4839,2540,2299,52.49
Irelia,Morgana,1952,892,1060,45.7
Irelia,Yorick,1896,884,1012,46.62
Irelia,Kayn,2743,1374,1369,50.09
Irelia,Ryze,674,357,317,52.97
Irelia,Pantheon,2750,1350,1400,49.09
Irelia,TahmKench,1514,732,782,48.35
Irelia,Malphite,1905,849,1056,44.57
Irelia,Aphelios,1145,585,560,51.09
Irelia,TwistedFate,580,340,240,58.62
Irelia,Gnar,916,505,411,55.13
Irelia,Jax,1856,1010,846,54.42
Irelia,Neeko,1035,535,500,51.69
Irelia,Renekton,781,364,417,46.61
Irelia,JarvanIV,972,488,484,50.21
Irelia,Mel,3783,1841,1942,48.67
Irelia,Sylas,2379,1087,1292,45.69
Irelia,Singed,462,201,261,43.51
Irelia,Graves,1036,493,543,47.59
Irelia,Fizz,929,449,480,48.33
Irelia,Ziggs,616,288,328,46.75
Irelia,Sett,2878,1299,1579,45.14
Irelia,Amumu,1824,823,1001,45.12
Irelia,Poppy,1141,524,617,45.92
Irelia,Zed,2182,1048,1134,48.03
Irelia,Sivir,906,408,498,45.03
Irelia,Blitzcrank,1416,706,710,49.86
Irelia,Gangplank,1035,521,514,50.34
Irelia,Kaisa,3088,1700,1388,55.05
Irelia,Galio,1517,720,797,47.46
Irelia,Cassiopeia,587,312,275,53.15
Irelia,Hwei,1246,689,557,55.3
Irelia,Gwen,878,472,406,53.76
Irelia,Skarner,530,278,252,52.45
Irelia,Seraphine,1517,687,830,45.29
Irelia,Ornn,789,402,387,50.95
Irelia,MissFortune,4014,1966,2048,48.98
Irelia,Brand,1301,689,612,52.96
Irelia,Teemo,2048,918,1130,44.82
Irelia,Shaco,1651,878,773,53.18
Irelia,Leblanc,962,462,500,48.02
Irelia,Ezreal,4102,2009,2093,48.98
Irelia,Thresh,2417,1174,1243,48.57
Irelia,Illaoi,892,402,490,45.07
Irelia,Aatrox,1820,982,838,53.96
Irelia,Ashe,3622,1715,1907,47.35
Irelia,Gragas,977,486,491,49.74
Irelia,Garen,2754,1278,1476,46.41
Irelia,Volibear,2092,967,1125,46.22
Irelia,Tristana,1638,808,830,49.33
Irelia,Zeri,735,414,321,56.33
Irelia,Zyra,1557,775,782,49.78
Irelia,Jayce,1023,525,498,51.32
Irelia,Rengar,701,415,286,59.2
Irelia,Swain,1793,893,900,49.8
Irelia,Sona,581,308,273,53.01
Irelia,Briar,1349,635,714,47.07
Irelia,Kennen,601,295,306,49.08
Irelia,Rammus,698,312,386,44.7
Irelia,Pyke,1638,938,700,57.26
Irelia,Riven,761,427,334,56.11
Irelia,Taliyah,469,234,235,49.89
Irelia,Draven,961,490,471,50.99
Irelia,Lulu,2068,1060,1008,51.26
Irelia,Akali,2178,1069,1109,49.08
Irelia,Naafiri,654,327,327,50
Irelia,Kayle,1357,684,673,50.41
Irelia,Smolder,1143,624,519,54.59
Irelia,Khazix,974,482,492,49.49
Irelia,Sion,1278,632,646,49.45
Irelia,FiddleSticks,850,443,407,52.12
Irelia,Zilean,566,288,278,50.88
Irelia,Tryndamere,902,427,475,47.34
Irelia,Nidalee,548,315,233,57.48
Irelia,Aurora,1462,690,772,47.2
Irelia,Nami,1677,763,914,45.5
Irelia,Nunu,1099,576,523,52.41
Irelia,Rakan,750,350,400,46.67
Irelia,Soraka,1064,536,528,50.38
Irelia,Lillia,1074,531,543,49.44
Irelia,Orianna,697,340,357,48.78
Irelia,Velkoz,1092,535,557,48.99
Irelia,Chogath,2035,992,1043,48.75
Irelia,Veigar,1721,782,939,45.44
Irelia,Evelynn,714,375,339,52.52
Irelia,Lissandra,662,314,348,47.43
Irelia,Nilah,575,280,295,48.7
Irelia,Diana,2652,1294,1358,48.79
Irelia,MonkeyKing,1136,523,613,46.04
Irelia,Vex,1009,511,498,50.64
Irelia,Vayne,2140,1094,1046,51.12
Irelia,Ekko,1601,822,779,51.34
Irelia,Senna,1289,658,631,51.05
Irelia,Olaf,286,148,138,51.75
Irelia,Jinx,4594,2236,2358,48.67
Irelia,Leona,1616,800,816,49.5
Irelia,KSante,975,493,482,50.56
Irelia,Zac,761,349,412,45.86
Irelia,Azir,639,316,323,49.45
Irelia,Ahri,2343,1206,1137,51.47
Irelia,Twitch,1295,658,637,50.81
Irelia,MasterYi,2222,1117,1105,50.27
Irelia,Nasus,1146,547,599,47.73
Irelia,Malzahar,1760,838,922,47.61
Irelia,Braum,916,414,502,45.2
Irelia,Syndra,1054,528,526,50.09
Irelia,Karma,1993,962,1031,48.27
Irelia,Nautilus,2055,1029,1026,50.07
Irelia,Lucian,1153,591,562,51.26
Irelia,Samira,1346,644,702,47.85
Irelia,Nocturne,2197,953,1244,43.38
Irelia,Trundle,962,452,510,46.99
Irelia,Heimerdinger,887,380,507,42.84
Irelia,Udyr,594,287,307,48.32
Irelia,Milio,981,414,567,42.2
Irelia,Vladimir,1234,628,606,50.89
Irelia,Qiyana,475,229,246,48.21
Irelia,Vi,1702,910,792,53.47
Irelia,Varus,1450,718,732,49.52
Irelia,Mordekaiser,2222,1048,1174,47.16
Irelia,Hecarim,673,336,337,49.93
Irelia,Karthus,493,253,240,51.32
Irelia,Kassadin,345,197,148,57.1
Irelia,Viktor,1515,760,755,50.17
Irelia,LeeSin,2559,1281,1278,50.06
Irelia,Kalista,608,319,289,52.47
Irelia,Sejuani,784,359,425,45.79
Irelia,Xayah,946,420,526,44.4
Irelia,Quinn,577,289,288,50.09
Irelia,Katarina,1468,760,708,51.77
Irelia,Janna,562,307,255,54.63
Irelia,Renata,389,211,178,54.24
Irelia,Maokai,849,434,415,51.12
Irelia,Urgot,844,370,474,43.84
Irelia,XinZhao,1094,519,575,47.44
Irelia,Annie,490,252,238,51.43
Irelia,KogMaw,551,229,322,41.56
Irelia,Shen,1077,495,582,45.96
Irelia,Yuumi,1637,810,827,49.48
Irelia,Rell,894,446,448,49.89
Irelia,Anivia,536,277,259,51.68
Irelia,Belveth,383,187,196,48.83
Irelia,AurelionSol,605,278,327,45.95
Irelia,DrMundo,907,449,458,49.5
Irelia,Viego,2417,1209,1208,50.02
Irelia,Bard,492,234,258,47.56
Irelia,Kindred,853,436,417,51.11
Irelia,Zoe,744,441,303,59.27
Irelia,Talon,1119,625,494,55.85
Irelia,Ambessa,1178,645,533,54.75
Irelia,Kled,280,148,132,52.86
Irelia,Xerath,1486,704,782,47.38
Irelia,Alistar,768,358,410,46.61
Irelia,Elise,1221,633,588,51.84
Irelia,RekSai,211,87,124,41.23
Irelia,Corki,577,287,290,49.74
Irelia,Ivern,281,155,126,55.16
Irelia,Taric,327,162,165,49.54
Irelia,Rumble,500,292,208,58.4
Irelia,Fiora,763,359,404,47.05
Irelia,Camille,548,245,303,44.71
Irelia,Akshan,615,332,283,53.98
Irelia,Shyvana,467,235,232,50.32
Ezreal,Yone,9368,4795,4573,51.18
Ezreal,Darius,8845,4079,4766,46.12
Ezreal,Yasuo,9467,4499,4968,47.52
Ezreal,Jhin,10839,5226,5613,48.21
Ezreal,Lux,11092,5420,5672,48.86
Ezreal,Gwen,2450,1239,1211,50.57
Ezreal,Vi,5117,2451,2666,47.9
Ezreal,Zed,5455,2704,2751,49.57
Ezreal,Soraka,2404,1114,1290,46.34
Ezreal,Mordekaiser,5950,2819,3131,47.38
Ezreal,Kindred,2231,1061,1170,47.56
Ezreal,Qiyana,1294,698,596,53.94
Ezreal,Ashe,11692,5863,5829,50.15
Ezreal,Sona,1377,593,784,43.06
Ezreal,Teemo,5485,2537,2948,46.25
Ezreal,MonkeyKing,3367,1647,1720,48.92
Ezreal,Malzahar,4507,2022,2485,44.86
Ezreal,Caitlyn,15708,7678,8030,48.88
Ezreal,Morgana,5434,2591,2843,47.68
Ezreal,Garen,7552,3556,3996,47.09
Ezreal,Briar,3261,1474,1787,45.2
Ezreal,Akali,5417,2743,2674,50.64
Ezreal,MissFortune,11246,5302,5944,47.15
Ezreal,Kassadin,1001,511,490,51.05
Ezreal,Kayn,6251,3024,3227,48.38
Ezreal,Kayle,2901,1357,1544,46.78
Ezreal,RekSai,754,372,382,49.34
Ezreal,Seraphine,3432,1684,1748,49.07
Ezreal,Irelia,4102,2091,2011,50.98
Ezreal,Warwick,6027,2760,3267,45.79
Ezreal,Galio,4670,2166,2504,46.38
Ezreal,Sivir,3144,1368,1776,43.51
Ezreal,Rell,2587,1195,1392,46.19
Ezreal,Sett,6849,3186,3663,46.52
Ezreal,Zac,2536,1268,1268,50
Ezreal,Yorick,4041,1857,2184,45.95
Ezreal,Xerath,4782,2321,2461,48.54
Ezreal,Fiora,1830,894,936,48.85
Ezreal,FiddleSticks,2385,1074,1311,45.03
Ezreal,Syndra,2906,1410,1496,48.52
Ezreal,Vayne,6454,3029,3425,46.93
Ezreal,Viego,6819,3284,3535,48.16
Ezreal,AurelionSol,1927,945,982,49.04
Ezreal,Nautilus,5963,2869,3094,48.11
Ezreal,Jinx,13479,6298,7181,46.72
Ezreal,Lulu,7356,3458,3898,47.01
Ezreal,Camille,2039,1061,978,52.04
Ezreal,Katarina,3444,1666,1778,48.37
Ezreal,Zyra,4396,2021,2375,45.97
Ezreal,Tryndamere,2353,1175,1178,49.94
Ezreal,Gragas,3220,1642,1578,50.99
Ezreal,Kalista,1817,848,969,46.67
Ezreal,Twitch,3249,1563,1686,48.11
Ezreal,Graves,3416,1695,1721,49.62
Ezreal,Sylas,7804,3876,3928,49.67
Ezreal,Leona,4417,2118,2299,47.95
Ezreal,KSante,2884,1421,1463,49.27
Ezreal,Nasus,3130,1476,1654,47.16
Ezreal,TahmKench,3719,1711,2008,46.01
Ezreal,Fizz,2368,1174,1194,49.58
Ezreal,Janna,1553,714,839,45.98
Ezreal,Nocturne,5825,2736,3089,46.97
Ezreal,Thresh,7403,3494,3909,47.2
Ezreal,Shen,2782,1252,1530,45
Ezreal,Rammus,1296,618,678,47.69
Ezreal,Cassiopeia,1409,665,744,47.2
Ezreal,Udyr,1760,868,892,49.32
Ezreal,Veigar,4224,2034,2190,48.15
Ezreal,Kennen,1496,745,751,49.8
Ezreal,XinZhao,3464,1647,1817,47.55
Ezreal,Kaisa,11107,5356,5751,48.22
Ezreal,Karthus,1485,769,716,51.78
Ezreal,Nilah,1505,668,837,44.39
Ezreal,Braum,2597,1210,1387,46.59
Ezreal,Maokai,2253,1065,1188,47.27
Ezreal,Pantheon,8216,4066,4150,49.49
Ezreal,Aurora,3970,1968,2002,49.57
Ezreal,Yuumi,3733,1723,2010,46.16
Ezreal,Poppy,2691,1340,1351,49.8
Ezreal,Khazix,2732,1348,1384,49.34
Ezreal,Tristana,4605,2302,2303,49.99
Ezreal,Neeko,2323,1077,1246,46.36
Ezreal,Nunu,2761,1254,1507,45.42
Ezreal,Vladimir,2992,1437,1555,48.03
Ezreal,Gnar,2193,1120,1073,51.07
Ezreal,Akshan,1456,682,774,46.84
Ezreal,Jax,4327,2047,2280,47.31
Ezreal,Velkoz,2724,1371,1353,50.33
Ezreal,Xayah,2486,1219,1267,49.03
Ezreal,Rakan,2161,1062,1099,49.14
Ezreal,MasterYi,5421,2636,2785,48.63
Ezreal,Shaco,4400,2245,2155,51.02
Ezreal,Azir,1807,934,873,51.69
Ezreal,Rengar,1663,901,762,54.18
Ezreal,Pyke,4490,2312,2178,51.49
Ezreal,Lucian,4100,2004,2096,48.88
Ezreal,Renekton,2545,1231,1314,48.37
Ezreal,Zoe,1975,931,1044,47.14
Ezreal,LeeSin,9258,4799,4459,51.84
Ezreal,Hwei,3253,1550,1703,47.65
Ezreal,Lillia,2820,1362,1458,48.3
Ezreal,Milio,2664,1189,1475,44.63
Ezreal,Diana,7703,3650,4053,47.38
Ezreal,Olaf,1191,582,609,48.87
Ezreal,Volibear,4508,2095,2413,46.47
Ezreal,Mel,9458,4815,4643,50.91
Ezreal,Ambessa,3590,1793,1797,49.94
Ezreal,Evelynn,1665,788,877,47.33
Ezreal,Anivia,1521,719,802,47.27
Ezreal,Singed,1196,534,662,44.65
Ezreal,Karma,6336,3163,3173,49.92
Ezreal,Kled,906,406,500,44.81
Ezreal,Zeri,2453,1170,1283,47.7
Ezreal,Swain,4343,1987,2356,45.75
Ezreal,Talon,3147,1565,1582,49.73
Ezreal,Varus,4986,2484,2502,49.82
Ezreal,DrMundo,2411,1109,1302,46
Ezreal,Ekko,4244,2044,2200,48.16
Ezreal,Amumu,4493,2096,2397,46.65
Ezreal,Ryze,1855,808,1047,43.56
Ezreal,Belveth,1216,603,613,49.59
Ezreal,Nami,4489,2018,2471,44.95
Ezreal,Ornn,1999,905,1094,45.27
Ezreal,Blitzcrank,4225,2150,2075,50.89
Ezreal,Elise,3996,1909,2087,47.77
Ezreal,Heimerdinger,2077,961,1116,46.27
Ezreal,Vex,2534,1291,1243,50.95
Ezreal,Senna,3587,1736,1851,48.4
Ezreal,Brand,3118,1402,1716,44.96
Ezreal,Sion,3591,1722,1869,47.95
Ezreal,Jayce,3140,1504,1636,47.9
Ezreal,KogMaw,1426,673,753,47.19
Ezreal,Urgot,2005,889,1116,44.34
Ezreal,Skarner,1375,650,725,47.27
Ezreal,Ziggs,1778,862,916,48.48
Ezreal,Leblanc,3397,1710,1687,50.34
Ezreal,Riven,2174,1070,1104,49.22
Ezreal,Annie,1664,855,809,51.38
Ezreal,Nidalee,1792,1026,766,57.25
Ezreal,Orianna,2416,1233,1183,51.03
Ezreal,Smolder,3397,1684,1713,49.57
Ezreal,Chogath,5339,2448,2891,45.85
Ezreal,Naafiri,1494,699,795,46.79
Ezreal,Aatrox,4991,2449,2542,49.07
Ezreal,Aphelios,2822,1431,1391,50.71
Ezreal,Alistar,2105,1105,1000,52.49
Ezreal,Shyvana,1149,509,640,44.3
Ezreal,Rumble,1619,858,761,53
Ezreal,Hecarim,1877,917,960,48.85
Ezreal,Samira,3327,1691,1636,50.83
Ezreal,Bard,1489,724,765,48.62
Ezreal,Illaoi,1980,971,1009,49.04
Ezreal,Draven,2469,1284,1185,52
Ezreal,Malphite,5078,2564,2514,50.49
Ezreal,Taliyah,1259,615,644,48.85
Ezreal,Quinn,1620,757,863,46.73
Ezreal,Renata,879,427,452,48.58
Ezreal,Trundle,2439,1109,1330,45.47
Ezreal,JarvanIV,2974,1365,1609,45.9
Ezreal,Ahri,6456,3158,3298,48.92
Ezreal,Sejuani,2201,1070,1131,48.61
Ezreal,Corki,2089,1045,1044,50.02
Ezreal,Ivern,868,444,424,51.15
Ezreal,Zilean,1500,723,777,48.2
Ezreal,Lissandra,1733,816,917,47.09
Ezreal,Gangplank,2806,1373,1433,48.93
Ezreal,TwistedFate,1812,932,880,51.43
Ezreal,Viktor,4634,2251,2383,48.58
Ezreal,Taric,944,439,505,46.5
Rell,Yone,1884,970,914,51.49
Rell,Darius,2064,1086,978,52.62
Rell,Yasuo,2070,1071,999,51.74
Rell,Jhin,2050,1001,1049,48.83
Rell,Lux,2483,1216,1267,48.97
Rell,Ryze,402,209,193,51.99
Rell,Warwick,1631,828,803,50.77
Rell,Morgana,1257,591,666,47.02
Rell,Xayah,669,281,388,42
Rell,Veigar,1066,483,583,45.31
Rell,Poppy,790,388,402,49.11
Rell,Katarina,836,473,363,56.58
Rell,Twitch,831,466,365,56.08
Rell,Teemo,1255,573,682,45.66
Rell,Shaco,894,472,422,52.8
Rell,Leblanc,560,272,288,48.57
Rell,Ezreal,2587,1392,1195,53.81
Rell,Thresh,1716,880,836,51.28
Rell,FiddleSticks,529,274,255,51.8
Rell,Syndra,700,316,384,45.14
Rell,Kalista,283,139,144,49.12
Rell,Mel,2335,1182,1153,50.62
Rell,Singed,355,155,200,43.66
Rell,Pyke,962,521,441,54.16
Rell,Volibear,1257,683,574,54.34
Rell,Lillia,711,364,347,51.2
Rell,Vladimir,709,355,354,50.07
Rell,Jinx,2561,1164,1397,45.45
Rell,Lulu,1227,654,573,53.3
Rell,Yorick,991,401,590,40.46
Rell,Gragas,712,421,291,59.13
Rell,Zac,588,283,305,48.13
Rell,Amumu,1174,547,627,46.59
Rell,Chogath,1240,588,652,47.42
Rell,Kennen,300,155,145,51.67
Rell,Rammus,300,146,154,48.67
Rell,Caitlyn,2780,1410,1370,50.72
Rell,Zeri,479,239,240,49.9
Rell,Aatrox,1159,575,584,49.61
Rell,Belveth,294,145,149,49.32
Rell,Hwei,743,415,328,55.85
Rell,TahmKench,1069,572,497,53.51
Rell,Nasus,679,321,358,47.28
Rell,Udyr,374,198,176,52.94
Rell,Ashe,2189,1128,1061,51.53
Rell,Alistar,679,342,337,50.37
Rell,Olaf,267,139,128,52.06
Rell,Mordekaiser,1352,654,698,48.37
Rell,Ornn,480,240,240,50
Rell,Vi,1068,553,515,51.78
Rell,Anivia,381,161,220,42.26
Rell,Yuumi,1056,560,496,53.03
Rell,Ekko,870,432,438,49.66
Rell,Nami,1061,535,526,50.42
Rell,Jayce,496,248,248,50
Rell,DrMundo,555,298,257,53.69
Rell,TwistedFate,388,230,158,59.28
Rell,Samira,878,463,415,52.73
Rell,Seraphine,829,441,388,53.2
Rell,MasterYi,1126,580,546,51.51
Rell,Urgot,542,279,263,51.48
Rell,Xerath,829,383,446,46.2
Rell,Tristana,1101,562,539,51.04
Rell,Garen,1584,804,780,50.76
Rell,Briar,710,361,349,50.85
Rell,Zed,1074,518,556,48.23
Rell,Corki,540,272,268,50.37
Rell,Pantheon,1782,887,895,49.78
Rell,Diana,1590,825,765,51.89
Rell,MissFortune,2198,1025,1173,46.63
Rell,Hecarim,424,206,218,48.58
Rell,Orianna,579,263,316,45.42
Rell,Zyra,924,404,520,43.72
Rell,Karthus,352,173,179,49.15
Rell,Kassadin,259,147,112,56.76
Rell,Nunu,677,332,345,49.04
Rell,Kaisa,1682,856,826,50.89
Rell,Jax,966,474,492,49.07
Rell,RekSai,154,69,85,44.81
Rell,Brand,709,336,373,47.39
Rell,Galio,918,417,501,45.42
Rell,Viego,1507,809,698,53.68
Rell,Rakan,531,263,268,49.53
Rell,Ahri,1502,774,728,51.53
Rell,Fiora,407,217,190,53.32
Rell,LeeSin,1519,753,766,49.57
Rell,Milio,616,289,327,46.92
Rell,Kindred,462,244,218,52.81
Rell,Sett,1755,857,898,48.83
Rell,Draven,556,299,257,53.78
Rell,Kayn,1513,754,759,49.83
Rell,Akali,1158,614,544,53.02
Rell,Sivir,541,276,265,51.02
Rell,Skarner,412,218,194,52.91
Rell,Zilean,340,162,178,47.65
Rell,Tryndamere,534,296,238,55.43
Rell,Bard,308,163,145,52.92
Rell,Leona,1156,578,578,50
Rell,JarvanIV,618,284,334,45.95
Rell,Lucian,732,356,376,48.63
Rell,Soraka,584,303,281,51.88
Rell,Riven,565,302,263,53.45
Rell,Karma,1180,574,606,48.64
Rell,Sylas,1374,714,660,51.97
Rell,Talon,620,352,268,56.77
Rell,Irelia,894,448,446,50.11
Rell,Fizz,491,220,271,44.81
Rell,Graves,740,342,398,46.22
Rell,Neeko,533,301,232,56.47
Rell,Gnar,450,229,221,50.89
Rell,Evelynn,434,214,220,49.31
Rell,Heimerdinger,488,258,230,52.87
Rell,Kayle,630,272,358,43.17
Rell,Swain,1087,470,617,43.24
Rell,Aphelios,695,335,360,48.2
Rell,Blitzcrank,859,437,422,50.87
Rell,Trundle,519,255,264,49.13
Rell,Elise,807,435,372,53.9
Rell,Malzahar,1171,570,601,48.68
Rell,Cassiopeia,379,194,185,51.19
Rell,Ambessa,654,366,288,55.96
Rell,Qiyana,292,170,122,58.22
Rell,Akshan,344,149,195,43.31
Rell,KSante,696,353,343,50.72
Rell,Aurora,899,464,435,51.61
Rell,Smolder,792,363,429,45.83
Rell,Lissandra,384,161,223,41.93
Rell,Senna,798,356,442,44.61
Rell,Renata,280,125,155,44.64
Rell,Nidalee,342,202,140,59.06
Rell,Annie,335,166,169,49.55
Rell,Sona,321,172,149,53.58
Rell,Gangplank,518,201,317,38.8
Rell,Shen,771,433,338,56.16
Rell,Viktor,940,446,494,47.45
Rell,Khazix,589,252,337,42.78
Rell,Janna,559,251,308,44.9
Rell,Vayne,1329,697,632,52.45
Rell,Nocturne,1305,581,724,44.52
Rell,Malphite,1037,532,505,51.3
Rell,Gwen,598,305,293,51
Rell,Renekton,542,218,324,40.22
Rell,Illaoi,456,189,267,41.45
Rell,Rengar,364,176,188,48.35
Rell,Varus,920,486,434,52.83
Rell,Velkoz,660,306,354,46.36
Rell,Nilah,447,238,209,53.24
Rell,Braum,728,364,364,50
Rell,Maokai,555,275,280,49.55
Rell,Ivern,220,109,111,49.55
Rell,Nautilus,1427,735,692,51.51
Rell,Zoe,462,247,215,53.46
Rell,XinZhao,685,340,345,49.64
Rell,MonkeyKing,682,302,380,44.28
Rell,Camille,425,228,197,53.65
Rell,Taliyah,353,180,173,50.99
Rell,Ziggs,398,199,199,50
Rell,Vex,627,297,330,47.37
Rell,Sejuani,494,253,241,51.21
Rell,AurelionSol,535,235,300,43.93
Rell,Sion,824,380,444,46.12
Rell,Naafiri,318,122,196,38.36
Rell,Quinn,408,216,192,52.94
Rell,Shyvana,261,114,147,43.68
Rell,Taric,217,92,125,42.4
Rell,KogMaw,346,151,195,43.64
Rell,Azir,435,247,188,56.78
Rell,Kled,209,107,102,51.2
Rell,Rumble,327,171,156,52.29
Sejuani,Singed,276,148,128,53.62
Sejuani,Shaco,691,352,339,50.94
Sejuani,Zed,921,485,436,52.66
Sejuani,Hwei,652,345,307,52.91
Sejuani,Lux,2106,1061,1045,50.38
Sejuani,Naafiri,262,103,159,39.31
Sejuani,Briar,586,273,313,46.59
Sejuani,Yone,1523,806,717,52.92
Sejuani,MissFortune,2021,1012,1009,50.07
Sejuani,Senna,621,279,342,44.93
Sejuani,Volibear,1085,464,621,42.76
Sejuani,Lillia,584,252,332,43.15
Sejuani,Vladimir,639,277,362,43.35
Sejuani,Jinx,2272,1121,1151,49.34
Sejuani,Lulu,1185,581,604,49.03
Sejuani,Riven,418,191,227,45.69
Sejuani,Syndra,550,284,266,51.64
Sejuani,Pyke,827,458,369,55.38
Sejuani,Aurora,817,452,365,55.32
Sejuani,FiddleSticks,479,243,236,50.73
Sejuani,Yasuo,1675,809,866,48.3
Sejuani,Jhin,1698,827,871,48.7
Sejuani,Vex,552,283,269,51.27
Sejuani,Kayn,1331,624,707,46.88
Sejuani,Khazix,469,266,203,56.72
Sejuani,Seraphine,736,370,366,50.27
Sejuani,Sett,1416,693,723,48.94
Sejuani,Pantheon,1404,755,649,53.77
Sejuani,Ashe,1865,962,903,51.58
Sejuani,Braum,554,275,279,49.64
Sejuani,Nasus,626,301,325,48.08
Sejuani,Smolder,604,246,358,40.73
Sejuani,Galio,735,415,320,56.46
Sejuani,Ahri,1297,669,628,51.58
Sejuani,Tristana,800,443,357,55.38
Sejuani,Alistar,457,227,230,49.67
Sejuani,Amumu,1021,465,556,45.54
Sejuani,Velkoz,513,260,253,50.68
Sejuani,Yorick,846,398,448,47.04
Sejuani,Rengar,334,202,132,60.48
Sejuani,Neeko,411,217,194,52.8
Sejuani,Gwen,560,269,291,48.04
Sejuani,Katarina,730,385,345,52.74
Sejuani,Elise,712,384,328,53.93
Sejuani,Teemo,1077,532,545,49.4
Sejuani,Vi,970,498,472,51.34
Sejuani,Bard,322,138,184,42.86
Sejuani,Caitlyn,2441,1192,1249,48.83
Sejuani,Mordekaiser,1210,561,649,46.36
Sejuani,Aphelios,515,249,266,48.35
Sejuani,Zilean,267,150,117,56.18
Sejuani,Morgana,1110,576,534,51.89
Sejuani,Viego,1152,618,534,53.65
Sejuani,Samira,693,331,362,47.76
Sejuani,Leona,745,352,393,47.25
Sejuani,Aatrox,943,435,508,46.13
Sejuani,LeeSin,1523,792,731,52
Sejuani,Akshan,284,118,166,41.55
Sejuani,Zyra,746,382,364,51.21
Sejuani,Trundle,574,282,292,49.13
Sejuani,Rammus,293,146,147,49.83
Sejuani,Fizz,479,251,228,52.4
Sejuani,Sivir,472,219,253,46.4
Sejuani,Lucian,666,373,293,56.01
Sejuani,Darius,1765,865,900,49.01
Sejuani,Sona,267,144,123,53.93
Sejuani,Graves,607,336,271,55.35
Sejuani,Ziggs,334,166,168,49.7
Sejuani,Nocturne,1080,494,586,45.74
Sejuani,Ekko,711,380,331,53.45
Sejuani,Irelia,784,425,359,54.21
Sejuani,Taric,196,87,109,44.39
Sejuani,Sylas,1421,720,701,50.67
Sejuani,Warwick,1325,657,668,49.58
Sejuani,Camille,381,215,166,56.43
Sejuani,Viktor,849,483,366,56.89
Sejuani,Mel,1691,917,774,54.23
Sejuani,Ambessa,581,337,244,58
Sejuani,Garen,1318,644,674,48.86
Sejuani,Soraka,528,213,315,40.34
Sejuani,Renekton,505,279,226,55.25
Sejuani,Thresh,1461,760,701,52.02
Sejuani,Shen,619,321,298,51.86
Sejuani,Gangplank,543,284,259,52.3
Sejuani,Gragas,570,296,274,51.93
Sejuani,Udyr,282,150,132,53.19
Sejuani,Ryze,265,134,131,50.57
Sejuani,Akali,888,460,428,51.8
Sejuani,Blitzcrank,659,350,309,53.11
Sejuani,Kindred,409,248,161,60.64
Sejuani,Draven,456,224,232,49.12
Sejuani,MasterYi,962,481,481,50
Sejuani,Nautilus,1108,602,506,54.33
Sejuani,Vayne,1213,624,589,51.44
Sejuani,Kennen,231,113,118,48.92
Sejuani,Varus,808,482,326,59.65
Sejuani,Yuumi,770,428,342,55.58
Sejuani,Gnar,435,247,188,56.78
Sejuani,Zeri,398,204,194,51.26
Sejuani,XinZhao,683,365,318,53.44
Sejuani,Veigar,858,410,448,47.79
Sejuani,Karma,1087,502,585,46.18
Sejuani,Kled,158,91,67,57.59
Sejuani,Ezreal,2201,1131,1070,51.39
Sejuani,Diana,1346,654,692,48.59
Sejuani,TahmKench,757,387,370,51.12
Sejuani,Zoe,355,193,162,54.37
Sejuani,Twitch,689,343,346,49.78
Sejuani,Cassiopeia,326,167,159,51.23
Sejuani,Nilah,352,157,195,44.6
Sejuani,Nunu,562,279,283,49.64
Sejuani,Milio,584,261,323,44.69
Sejuani,Swain,896,403,493,44.98
Sejuani,Illaoi,369,199,170,53.93
Sejuani,Leblanc,524,266,258,50.76
Sejuani,Brand,601,292,309,48.59
Sejuani,Malphite,859,408,451,47.5
Sejuani,Kaisa,1525,831,694,54.49
Sejuani,Xerath,693,367,326,52.96
Sejuani,Jax,770,416,354,54.03
Sejuani,Chogath,1083,553,530,51.06
Sejuani,RekSai,138,92,46,66.67
Sejuani,Malzahar,1003,428,575,42.67
Sejuani,JarvanIV,637,295,342,46.31
Sejuani,Shyvana,185,79,106,42.7
Sejuani,Lissandra,317,186,131,58.68
Sejuani,Sion,694,342,352,49.28
Sejuani,DrMundo,533,282,251,52.91
Sejuani,Rakan,362,185,177,51.1
Sejuani,KogMaw,357,158,199,44.26
Sejuani,Corki,372,183,189,49.19
Sejuani,Tryndamere,516,253,263,49.03
Sejuani,KSante,534,288,246,53.93
Sejuani,Xayah,538,295,243,54.83
Sejuani,Quinn,260,138,122,53.08
Sejuani,Skarner,381,227,154,59.58
Sejuani,Qiyana,247,109,138,44.13
Sejuani,Olaf,202,94,108,46.53
Sejuani,Poppy,552,282,270,51.09
Sejuani,Annie,340,181,159,53.24
Sejuani,Kayle,518,251,267,48.46
Sejuani,Talon,497,289,208,58.15
Sejuani,MonkeyKing,610,269,341,44.1
Sejuani,Orianna,506,269,237,53.16
Sejuani,Jayce,477,270,207,56.6
Sejuani,Taliyah,256,115,141,44.92
Sejuani,Heimerdinger,352,175,177,49.72
Sejuani,Fiora,352,182,170,51.7
Sejuani,Nami,882,438,444,49.66
Sejuani,Ornn,334,154,180,46.11
Sejuani,Janna,269,147,122,54.65
Sejuani,Evelynn,351,181,170,51.57
Sejuani,Karthus,233,110,123,47.21
Sejuani,Kassadin,164,89,75,54.27
Sejuani,Anivia,324,190,134,58.64
Sejuani,AurelionSol,368,179,189,48.64
Sejuani,Rell,494,241,253,48.79
Sejuani,Hecarim,348,179,169,51.44
Sejuani,Kalista,277,150,127,54.15
Sejuani,Rumble,195,104,91,53.33
Sejuani,Zac,479,259,220,54.07
Sejuani,Belveth,152,59,93,38.82
Sejuani,Ivern,161,94,67,58.39
Sejuani,TwistedFate,290,156,134,53.79
Sejuani,Urgot,421,179,242,42.52
Sejuani,Renata,203,95,108,46.8
Sejuani,Azir,376,151,225,40.16
Sejuani,Maokai,434,210,224,48.39
Sejuani,Nidalee,223,106,117,47.53
Pantheon,Singed,801,389,412,48.56
Pantheon,Shaco,3084,1561,1523,50.62
Pantheon,Zed,3969,2135,1834,53.79
Pantheon,Hwei,2358,1127,1231,47.79
Pantheon,Lux,8467,4271,4196,50.44
Pantheon,Darius,6463,3296,3167,51
Pantheon,Zac,1585,847,738,53.44
Pantheon,Poppy,2257,1076,1181,47.67
Pantheon,Twitch,2597,1406,1191,54.14
Pantheon,Maokai,1560,769,791,49.29
Pantheon,Graves,2089,1078,1011,51.6
Pantheon,Ahri,4578,2319,2259,50.66
Pantheon,Nilah,1346,630,716,46.81
Pantheon,Malphite,3609,1667,1942,46.19
Pantheon,Garen,5390,2718,2672,50.43
Pantheon,Briar,2599,1235,1364,47.52
Pantheon,Caitlyn,8500,4258,4242,50.09
Pantheon,Morgana,4051,2102,1949,51.89
Pantheon,Aatrox,3218,1698,1520,52.77
Pantheon,Brand,2518,1203,1315,47.78
Pantheon,Irelia,2750,1400,1350,50.91
Pantheon,Milio,1934,953,981,49.28
Pantheon,Kayn,5026,2396,2630,47.67
Pantheon,Katarina,2695,1353,1342,50.2
Pantheon,Vayne,4111,1980,2131,48.16
Pantheon,DrMundo,1987,913,1074,45.95
Pantheon,Gangplank,1745,893,852,51.17
Pantheon,Kaisa,5538,2816,2722,50.85
Pantheon,Galio,2690,1248,1442,46.39
Pantheon,Cassiopeia,1044,520,524,49.81
Pantheon,Sett,5393,2596,2797,48.14
Pantheon,Talon,2119,1114,1005,52.57
Pantheon,FiddleSticks,1761,883,878,50.14
Pantheon,Ashe,6390,3133,3257,49.03
Pantheon,Blitzcrank,2831,1500,1331,52.98
Pantheon,Lillia,1988,1063,925,53.47
Pantheon,Sylas,4618,2547,2071,55.15
Pantheon,TahmKench,2947,1477,1470,50.12
Pantheon,Jax,3003,1502,1501,50.02
Pantheon,Heimerdinger,1567,701,866,44.74
Pantheon,Soraka,1901,829,1072,43.61
Pantheon,Elise,2488,1190,1298,47.83
Pantheon,Olaf,785,360,425,45.86
Pantheon,Hecarim,1266,629,637,49.68
Pantheon,Veigar,3329,1529,1800,45.93
Pantheon,Tristana,3120,1578,1542,50.58
Pantheon,Braum,1937,980,957,50.59
Pantheon,Ryze,1120,555,565,49.55
Pantheon,Lulu,4204,2033,2171,48.36
Pantheon,Gnar,1524,801,723,52.56
Pantheon,Warwick,4779,2291,2488,47.94
Pantheon,Malzahar,3249,1442,1807,44.38
Pantheon,XinZhao,2250,1083,1167,48.13
Pantheon,Akali,3569,1762,1807,49.37
Pantheon,LeeSin,5242,2756,2486,52.58
Pantheon,Evelynn,1327,698,629,52.6
Pantheon,Ezreal,8216,4150,4066,50.51
Pantheon,Jinx,8744,3998,4746,45.72
Pantheon,Samira,2541,1360,1181,53.52
Pantheon,Ekko,3037,1515,1522,49.88
Pantheon,Chogath,4008,1866,2142,46.56
Pantheon,Yorick,3146,1495,1651,47.52
Pantheon,Sion,2515,1163,1352,46.24
Pantheon,MasterYi,3938,1890,2048,47.99
Pantheon,AurelionSol,1277,608,669,47.61
Pantheon,Seraphine,2928,1518,1410,51.84
Pantheon,Mordekaiser,4526,2107,2419,46.55
Pantheon,Sejuani,1404,649,755,46.23
Pantheon,Yone,7021,3602,3419,51.3
Pantheon,MissFortune,7459,3680,3779,49.34
Pantheon,Swain,3435,1602,1833,46.64
Pantheon,Yasuo,7087,3695,3392,52.14
Pantheon,Corki,1309,690,619,52.71
Pantheon,Karma,3696,1841,1855,49.81
Pantheon,Neeko,1920,938,982,48.85
Pantheon,Yuumi,2928,1545,1383,52.77
Pantheon,Rengar,1156,688,468,59.52
Pantheon,Jhin,6404,3308,3096,51.66
Pantheon,Kindred,1645,896,749,54.47
Pantheon,Alistar,1451,739,712,50.93
Pantheon,Volibear,3735,1845,1890,49.4
Pantheon,Velkoz,1986,912,1074,45.92
Pantheon,Varus,3036,1628,1408,53.62
Pantheon,Aurora,2845,1464,1381,51.46
Pantheon,Trundle,1766,890,876,50.4
Pantheon,Mel,7101,3765,3336,53.02
Pantheon,Illaoi,1608,796,812,49.5
Pantheon,Khazix,1868,933,935,49.95
Pantheon,Leona,2867,1391,1476,48.52
Pantheon,Draven,1789,844,945,47.18
Pantheon,Nautilus,3819,1944,1875,50.9
Pantheon,Viego,4821,2365,2456,49.06
Pantheon,KSante,1888,994,894,52.65
Pantheon,Kalista,1031,576,455,55.87
Pantheon,Ivern,493,241,252,48.88
Pantheon,Quinn,1150,555,595,48.26
Pantheon,Nasus,2428,1224,1204,50.41
Pantheon,Kled,579,322,257,55.61
Pantheon,Taliyah,920,435,485,47.28
Pantheon,Sona,1074,492,582,45.81
Pantheon,RekSai,485,233,252,48.04
Pantheon,Zoe,1334,692,642,51.87
Pantheon,Nunu,2227,1147,1080,51.5
Pantheon,Thresh,4728,2297,2431,48.58
Pantheon,Shen,2104,1033,1071,49.1
Pantheon,Riven,1416,836,580,59.04
Pantheon,Rell,1782,895,887,50.22
Pantheon,Vladimir,2277,1199,1078,52.66
Pantheon,Kayle,2335,1283,1052,54.95
Pantheon,Azir,1350,691,659,51.19
Pantheon,Xayah,1844,935,909,50.7
Pantheon,Orianna,1662,723,939,43.5
Pantheon,Ambessa,2232,1136,1096,50.9
Pantheon,Pyke,3480,1879,1601,53.99
Pantheon,Anivia,1007,428,579,42.5
Pantheon,Nocturne,4125,1911,2214,46.33
Pantheon,Udyr,1277,698,579,54.66
Pantheon,Sivir,1924,957,967,49.74
Pantheon,Skarner,1013,541,472,53.41
Pantheon,Gwen,1755,883,872,50.31
Pantheon,Rammus,1139,549,590,48.2
Pantheon,Viktor,2928,1532,1396,52.32
Pantheon,Fiora,1372,704,668,51.31
Pantheon,Vi,3248,1591,1657,48.98
Pantheon,TwistedFate,1233,645,588,52.31
Pantheon,Zilean,1048,524,524,50
Pantheon,Ziggs,1280,665,615,51.95
Pantheon,Ornn,1531,746,785,48.73
Pantheon,Aphelios,1841,879,962,47.75
Pantheon,Lucian,2391,1277,1114,53.41
Pantheon,Camille,1283,682,601,53.16
Pantheon,MonkeyKing,2257,1095,1162,48.52
Pantheon,Rakan,1587,845,742,53.25
Pantheon,Renekton,1760,847,913,48.13
Pantheon,Zeri,1380,716,664,51.88
Pantheon,Kassadin,705,361,344,51.21
Pantheon,Leblanc,1984,1056,928,53.23
Pantheon,Fizz,1832,943,889,51.47
Pantheon,Renata,599,269,330,44.91
Pantheon,Zyra,2888,1337,1551,46.3
Pantheon,Nami,3056,1472,1584,48.17
Pantheon,Diana,5435,2591,2844,47.67
Pantheon,Annie,1026,466,560,45.42
Pantheon,Xerath,2705,1290,1415,47.69
Pantheon,Lissandra,1048,502,546,47.9
Pantheon,Senna,2494,1300,1194,52.13
Pantheon,Naafiri,1140,565,575,49.56
Pantheon,Nidalee,1120,582,538,51.96
Pantheon,Teemo,4031,1965,2066,48.75
Pantheon,Qiyana,882,451,431,51.13
Pantheon,Jayce,1561,820,741,52.53
Pantheon,Gragas,2164,1049,1115,48.48
Pantheon,Taric,775,333,442,42.97
Pantheon,Karthus,985,486,499,49.34
Pantheon,Smolder,2328,1251,1077,53.74
Pantheon,Tryndamere,1808,927,881,51.27
Pantheon,Amumu,3423,1544,1879,45.11
Pantheon,Rumble,929,494,435,53.18
Pantheon,Shyvana,847,387,460,45.69
Pantheon,KogMaw,991,485,506,48.94
Pantheon,Belveth,864,454,410,52.55
Pantheon,Syndra,2069,1007,1062,48.67
Pantheon,Vex,1863,900,963,48.31
Pantheon,JarvanIV,1967,911,1056,46.31
Pantheon,Urgot,1740,795,945,45.69
Pantheon,Janna,1117,553,564,49.51
Pantheon,Bard,1035,532,503,51.4
Pantheon,Akshan,1185,602,583,50.8
Pantheon,Kennen,993,523,470,52.67
Singed,Mordekaiser,783,430,353,54.92
Singed,Sejuani,276,128,148,46.38
Singed,Yasuo,1132,590,542,52.12
Singed,Lucian,442,247,195,55.88
Singed,Pantheon,801,412,389,51.44
Singed,Irelia,462,261,201,56.49
Singed,Kayn,869,421,448,48.45
Singed,Katarina,482,279,203,57.88
Singed,Vayne,779,371,408,47.63
Singed,DrMundo,400,198,202,49.5
Singed,Heimerdinger,317,177,140,55.84
Singed,Talon,320,190,130,59.38
Singed,Ahri,681,380,301,55.8
Singed,Kalista,190,115,75,60.53
Singed,Brand,420,257,163,61.19
Singed,Sett,818,402,416,49.14
Singed,Vladimir,337,174,163,51.63
Singed,Kindred,247,134,113,54.25
Singed,Aphelios,329,162,167,49.24
Singed,Pyke,449,250,199,55.68
Singed,Darius,960,491,469,51.15
Singed,Poppy,360,185,175,51.39
Singed,Sylas,700,330,370,47.14
Singed,Rell,355,200,155,56.34
Singed,Kayle,467,195,272,41.76
Singed,Akali,564,326,238,57.8
Singed,Soraka,343,180,163,52.48
Singed,Swain,622,335,287,53.86
Singed,Jax,549,264,285,48.09
Singed,Morgana,696,326,370,46.84
Singed,Caitlyn,1524,782,742,51.31
Singed,Tryndamere,366,213,153,58.2
Singed,Nasus,604,284,320,47.02
Singed,Galio,544,283,261,52.02
Singed,Smolder,401,243,158,60.6
Singed,JarvanIV,352,175,177,49.72
Singed,Urgot,373,179,194,47.99
Singed,Ekko,597,278,319,46.57
Singed,Xerath,506,284,222,56.13
Singed,Warwick,808,419,389,51.86
Singed,Aurora,385,231,154,60
Singed,Samira,439,252,187,57.4
Singed,Neeko,275,149,126,54.18
Singed,Nocturne,733,361,372,49.25
Singed,Orianna,301,152,149,50.5
Singed,Ezreal,1196,662,534,55.35
Singed,Bard,180,111,69,61.67
Singed,Maokai,225,121,104,53.78
Singed,Sion,606,358,248,59.08
Singed,Lux,1408,708,700,50.28
Singed,Amumu,546,277,269,50.73
Singed,Mel,1272,697,575,54.8
Singed,Jhin,1050,557,493,53.05
Singed,Yuumi,539,317,222,58.81
Singed,FiddleSticks,297,170,127,57.24
Singed,Zoe,272,170,102,62.5
Singed,Kaisa,966,501,465,51.86
Singed,Taric,125,60,65,48
Singed,Karma,737,354,383,48.03
Singed,Zed,626,357,269,57.03
Singed,Veigar,566,279,287,49.29
Singed,Rengar,203,86,117,42.36
Singed,Thresh,903,479,424,53.05
Singed,MasterYi,708,372,336,52.54
Singed,Gragas,367,205,162,55.86
Singed,Aatrox,639,396,243,61.97
Singed,Blitzcrank,384,227,157,59.11
Singed,LeeSin,769,418,351,54.36
Singed,MissFortune,1190,686,504,57.65
Singed,Nami,669,343,326,51.27
Singed,Zeri,282,159,123,56.38
Singed,Nunu,435,218,217,50.11
Singed,Malphite,532,308,224,57.89
Singed,Jinx,1508,724,784,48.01
Singed,Shen,483,238,245,49.28
Singed,Leblanc,346,188,158,54.34
Singed,Twitch,500,287,213,57.4
Singed,Velkoz,407,181,226,44.47
Singed,Olaf,143,91,52,63.64
Singed,Kled,126,69,57,54.76
Singed,Briar,386,189,197,48.96
Singed,Ziggs,204,122,82,59.8
Singed,Nautilus,622,320,302,51.45
Singed,Taliyah,167,97,70,58.08
Singed,Viego,751,389,362,51.8
Singed,Graves,443,285,158,64.33
Singed,AurelionSol,286,126,160,44.06
Singed,Corki,219,139,80,63.47
Singed,Nilah,263,150,113,57.03
Singed,TahmKench,502,284,218,56.57
Singed,Cassiopeia,155,59,96,38.06
Singed,Braum,338,155,183,45.86
Singed,Gangplank,322,150,172,46.58
Singed,Khazix,360,205,155,56.94
Singed,Malzahar,642,298,344,46.42
Singed,Ashe,1197,579,618,48.37
Singed,Zilean,192,102,90,53.13
Singed,Lulu,749,358,391,47.8
Singed,Yone,983,533,450,54.22
Singed,Skarner,179,133,46,74.3
Singed,Senna,442,227,215,51.36
Singed,Evelynn,222,122,100,54.95
Singed,Draven,338,185,153,54.73
Singed,Zyra,496,279,217,56.25
Singed,Udyr,247,94,153,38.06
Singed,Quinn,231,140,91,60.61
Singed,Renata,82,37,45,45.12
Singed,Fizz,294,161,133,54.76
Singed,Volibear,603,312,291,51.74
Singed,Teemo,690,382,308,55.36
Singed,Rammus,198,99,99,50
Singed,KSante,260,147,113,56.54
Singed,Shaco,480,293,187,61.04
Singed,Nidalee,132,88,44,66.67
Singed,Elise,383,188,195,49.09
Singed,Garen,944,447,497,47.35
Singed,Qiyana,155,78,77,50.32
Singed,Viktor,515,260,255,50.49
Singed,Seraphine,508,303,205,59.65
Singed,Riven,272,166,106,61.03
Singed,Lillia,363,187,176,51.52
Singed,Akshan,189,106,83,56.08
Singed,Varus,527,283,244,53.7
Singed,Rakan,242,127,115,52.48
Singed,Ambessa,370,191,179,51.62
Singed,Renekton,224,126,98,56.25
Singed,Zac,266,142,124,53.38
Singed,Alistar,274,147,127,53.65
Singed,Syndra,342,157,185,45.91
Singed,Jayce,301,157,144,52.16
Singed,Illaoi,264,143,121,54.17
Singed,Vex,312,178,134,57.05
Singed,Camille,218,112,106,51.38
Singed,Karthus,169,93,76,55.03
Singed,Diana,843,408,435,48.4
Singed,Chogath,699,367,332,52.5
Singed,Naafiri,220,129,91,58.64
Singed,Kennen,155,82,73,52.9
Singed,Vi,495,282,213,56.97
Singed,Xayah,332,200,132,60.24
Singed,Yorick,552,237,315,42.93
Singed,XinZhao,362,206,156,56.91
Singed,Kassadin,156,78,78,50
Singed,Tristana,636,317,319,49.84
Singed,Gnar,245,145,100,59.18
Singed,Milio,413,217,196,52.54
Singed,Belveth,150,67,83,44.67
Singed,Hecarim,258,141,117,54.65
Singed,Sivir,332,183,149,55.12
Singed,Hwei,418,217,201,51.91
Singed,Annie,181,83,98,45.86
Singed,TwistedFate,165,110,55,66.67
Singed,Janna,192,90,102,46.88
Singed,Ryze,223,104,119,46.64
Singed,Rumble,158,109,49,68.99
Singed,Trundle,314,158,156,50.32
Singed,MonkeyKing,350,195,155,55.71
Singed,KogMaw,120,44,76,36.67
Singed,Fiora,206,93,113,45.15
Singed,Ornn,248,131,117,52.82
Singed,Gwen,311,200,111,64.31
Singed,Ivern,107,34,73,31.78
Singed,Anivia,205,93,112,45.37
Singed,Azir,203,140,63,68.97
Singed,RekSai,96,46,50,47.92
Singed,Leona,417,226,191,54.2
Singed,Sona,156,74,82,47.44
Singed,Lissandra,152,73,79,48.03
Singed,Shyvana,134,82,52,61.19
Shaco,Mordekaiser,2697,1233,1464,45.72
Shaco,Sejuani,691,339,352,49.06
Shaco,Yasuo,3852,1843,2009,47.85
Shaco,Lucian,1228,648,580,52.77
Shaco,Pantheon,3084,1523,1561,49.38
Shaco,Renekton,946,481,465,50.85
Shaco,Kayn,2930,1368,1562,46.69
Shaco,Katarina,1698,858,840,50.53
Shaco,Draven,1083,509,574,47
Shaco,Yuumi,1699,821,878,48.32
Shaco,Khazix,1117,564,553,50.49
Shaco,Mel,4136,2032,2104,49.13
Shaco,Jhin,3951,1929,2022,48.82
Shaco,Lux,5250,2576,2674,49.07
Shaco,Heimerdinger,1036,474,562,45.75
Shaco,Warwick,3069,1457,1612,47.47
Shaco,Neeko,986,465,521,47.16
Shaco,Leona,1534,852,682,55.54
Shaco,Fiora,781,398,383,50.96
Shaco,MasterYi,2316,1104,1212,47.67
Shaco,Karma,2161,1062,1099,49.14
Shaco,Irelia,1651,773,878,46.82
Shaco,Galio,1577,740,837,46.92
Shaco,Sivir,1144,589,555,51.49
Shaco,Rell,894,422,472,47.2
Shaco,Yorick,1968,856,1112,43.5
Shaco,Viego,2699,1341,1358,49.69
Shaco,Malphite,1969,975,994,49.52
Shaco,Kaisa,3115,1563,1552,50.18
Shaco,Briar,1502,740,762,49.27
Shaco,Zed,2238,1119,1119,50
Shaco,Jinx,4891,2223,2668,45.45
Shaco,Lulu,2341,1205,1136,51.47
Shaco,Teemo,2592,1204,1388,46.45
Shaco,Gragas,1155,665,490,57.58
Shaco,Qiyana,508,281,227,55.31
Shaco,Caitlyn,5378,2539,2839,47.21
Shaco,Soraka,1239,566,673,45.68
Shaco,Jayce,925,451,474,48.76
Shaco,Amumu,1956,842,1114,43.05
Shaco,Ashe,3812,1941,1871,50.92
Shaco,Milio,1147,508,639,44.29
Shaco,Sett,3092,1581,1511,51.13
Shaco,Ivern,312,180,132,57.69
Shaco,Senna,1606,769,837,47.88
Shaco,Jax,1664,850,814,51.08
Shaco,Diana,3104,1473,1631,47.45
Shaco,Ahri,2650,1418,1232,53.51
Shaco,Aphelios,1055,535,520,50.71
Shaco,Illaoi,997,513,484,51.45
Shaco,Velkoz,1230,555,675,45.12
Shaco,Veigar,2092,959,1133,45.84
Shaco,Ekko,1910,927,983,48.53
Shaco,Kassadin,449,171,278,38.08
Shaco,TahmKench,1521,812,709,53.39
Shaco,Ambessa,1113,556,557,49.96
Shaco,LeeSin,2906,1469,1437,50.55
Shaco,Malzahar,2094,959,1135,45.8
Shaco,MissFortune,4256,2086,2170,49.01
Shaco,Blitzcrank,1445,717,728,49.62
Shaco,Volibear,2129,982,1147,46.12
Shaco,Nocturne,2630,1224,1406,46.54
Shaco,Xerath,1532,798,734,52.09
Shaco,Ezreal,4400,2155,2245,48.98
Shaco,Gangplank,1034,471,563,45.55
Shaco,Yone,3733,1831,1902,49.05
Shaco,Twitch,1667,850,817,50.99
Shaco,Swain,2027,933,1094,46.03
Shaco,Rammus,437,238,199,54.46
Shaco,Chogath,2276,1027,1249,45.12
Shaco,Nautilus,2012,1020,992,50.7
Shaco,Cassiopeia,551,279,272,50.64
Shaco,Thresh,2552,1182,1370,46.32
Shaco,Aurora,1404,710,694,50.57
Shaco,Aatrox,1840,898,942,48.8
Shaco,Camille,700,352,348,50.29
Shaco,Azir,640,300,340,46.88
Shaco,Braum,961,442,519,45.99
Shaco,DrMundo,1114,497,617,44.61
Shaco,Naafiri,664,305,359,45.93
Shaco,Morgana,2514,1171,1343,46.58
Shaco,Sion,1461,617,844,42.23
Shaco,Kled,346,191,155,55.2
Shaco,Vi,1797,832,965,46.3
Shaco,Zeri,868,408,460,47
Shaco,Brand,1474,719,755,48.78
Shaco,Vladimir,1189,601,588,50.55
Shaco,Kindred,1043,548,495,52.54
Shaco,Seraphine,1673,854,819,51.05
Shaco,Sona,679,319,360,46.98
Shaco,Sylas,2239,1138,1101,50.83
Shaco,Nilah,835,395,440,47.31
Shaco,Rumble,559,274,285,49.02
Shaco,KSante,1096,576,520,52.55
Shaco,Olaf,467,245,222,52.46
Shaco,Darius,3746,1829,1917,48.83
Shaco,Vayne,2333,1151,1182,49.34
Shaco,Talon,1289,663,626,51.44
Shaco,Taliyah,440,221,219,50.23
Shaco,Zoe,769,418,351,54.36
Shaco,Udyr,781,417,364,53.39
Shaco,Leblanc,1178,629,549,53.4
Shaco,Nami,1982,947,1035,47.78
Shaco,Ornn,718,347,371,48.33
Shaco,Rengar,727,389,338,53.51
Shaco,Kalista,585,310,275,52.99
Shaco,Samira,1532,772,760,50.39
Shaco,Evelynn,806,344,462,42.68
Shaco,Trundle,1134,525,609,46.3
Shaco,AurelionSol,884,379,505,42.87
Shaco,Maokai,857,432,425,50.41
Shaco,Vex,1161,579,582,49.87
Shaco,Gwen,888,479,409,53.94
Shaco,Lillia,1081,565,516,52.27
Shaco,Pyke,1719,882,837,51.31
Shaco,Fizz,1209,563,646,46.57
Shaco,Renata,362,155,207,42.82
Shaco,Karthus,741,409,332,55.2
Shaco,Tryndamere,1161,587,574,50.56
Shaco,Varus,1643,799,844,48.63
Shaco,FiddleSticks,1057,522,535,49.39
Shaco,Ryze,642,285,357,44.39
Shaco,Janna,546,266,280,48.72
Shaco,Graves,1346,649,697,48.22
Shaco,Taric,396,172,224,43.43
Shaco,Kayle,1301,591,710,45.43
Shaco,Tristana,1934,997,937,51.55
Shaco,Garen,2970,1441,1529,48.52
Shaco,Kennen,583,287,296,49.23
Shaco,Quinn,711,344,367,48.38
Shaco,Shen,1373,653,720,47.56
Shaco,Viktor,1597,724,873,45.34
Shaco,Anivia,643,326,317,50.7
Shaco,Zyra,1833,923,910,50.35
Shaco,JarvanIV,1068,473,595,44.29
Shaco,XinZhao,1148,562,586,48.95
Shaco,TwistedFate,745,410,335,55.03
Shaco,Shyvana,536,263,273,49.07
Shaco,Akshan,650,307,343,47.23
Shaco,Smolder,1396,677,719,48.5
Shaco,Nunu,1227,538,689,43.85
Shaco,Nidalee,532,337,195,63.35
Shaco,Annie,571,329,242,57.62
Shaco,RekSai,297,148,149,49.83
Shaco,Ziggs,765,407,358,53.2
Shaco,Xayah,1020,542,478,53.14
Shaco,Syndra,1253,569,684,45.41
Shaco,Hwei,1306,674,632,51.61
Shaco,Akali,2194,1090,1104,49.68
Shaco,Rakan,789,393,396,49.81
Shaco,Belveth,451,213,238,47.23
Shaco,Corki,770,411,359,53.38
Shaco,Gnar,769,417,352,54.23
Shaco,Orianna,827,421,406,50.91
Shaco,Hecarim,847,430,417,50.77
Shaco,MonkeyKing,1266,614,652,48.5
Shaco,Lissandra,656,308,348,46.95
Shaco,Poppy,1146,571,575,49.83
Shaco,Bard,561,261,300,46.52
Shaco,Riven,833,451,382,54.14
Shaco,Zac,827,413,414,49.94
Shaco,Elise,1504,766,738,50.93
Shaco,Singed,480,187,293,38.96
Shaco,Urgot,905,465,440,51.38
Shaco,Alistar,798,375,423,46.99
Shaco,KogMaw,524,264,260,50.38
Shaco,Skarner,488,238,250,48.77
Shaco,Nasus,1366,646,720,47.29
Shaco,Zilean,622,278,344,44.69
Zed,Mordekaiser,2922,1341,1581,45.89
Zed,Sejuani,921,436,485,47.34
Zed,Yasuo,5508,2545,2963,46.21
Zed,Lucian,1646,875,771,53.16
Zed,Pantheon,3969,1834,2135,46.21
Zed,Chogath,2605,1200,1405,46.07
Zed,Kayn,3516,1696,1820,48.24
Zed,Gangplank,1184,557,627,47.04
Zed,Ezreal,5455,2751,2704,50.43
Zed,Hwei,1528,841,687,55.04
Zed,Diana,3923,1850,2073,47.16
Zed,Yuumi,1955,967,988,49.46
Zed,Trundle,1136,501,635,44.1
Zed,MasterYi,2704,1227,1477,45.38
Zed,Veigar,2278,1233,1045,54.13
Zed,Jhin,4717,2325,2392,49.29
Zed,Soraka,1263,640,623,50.67
Zed,Gnar,987,473,514,47.92
Zed,Jax,2010,1035,975,51.49
Zed,Caitlyn,6166,2910,3256,47.19
Zed,Neeko,1101,525,576,47.68
Zed,Fiora,894,418,476,46.76
Zed,Mel,4567,2278,2289,49.88
Zed,Karma,2622,1254,1368,47.83
Zed,Malphite,3088,1345,1743,43.56
Zed,Evelynn,875,424,451,48.46
Zed,Irelia,2182,1134,1048,51.97
Zed,Tristana,2191,1084,1107,49.48
Zed,Thresh,3237,1491,1746,46.06
Zed,Ryze,764,361,403,47.25
Zed,Warwick,3204,1507,1697,47.03
Zed,Morgana,2695,1213,1482,45.01
Zed,Xayah,1415,619,796,43.75
Zed,Vladimir,1577,740,837,46.92
Zed,Shaco,2238,1119,1119,50
Zed,Tryndamere,1169,536,633,45.85
Zed,Milio,1378,604,774,43.83
Zed,Heimerdinger,1049,502,547,47.86
Zed,Kindred,1000,477,523,47.7
Zed,Katarina,1852,915,937,49.41
Zed,Janna,755,315,440,41.72
Zed,Teemo,2889,1262,1627,43.68
Zed,Gragas,1461,762,699,52.16
Zed,Qiyana,804,406,398,50.5
Zed,Akali,2669,1331,1338,49.87
Zed,Jinx,5761,2642,3119,45.86
Zed,Leblanc,1426,710,716,49.79
Zed,Senna,1611,761,850,47.24
Zed,Amumu,2193,1004,1189,45.78
Zed,Kaisa,3943,1864,2079,47.27
Zed,Seraphine,1714,839,875,48.95
Zed,Ashe,4408,2100,2308,47.64
Zed,Pyke,2060,1059,1001,51.41
Zed,Darius,4492,2056,2436,45.77
Zed,Nami,2322,1026,1296,44.19
Zed,Aatrox,2170,1045,1125,48.16
Zed,Cassiopeia,677,297,380,43.87
Zed,Yone,4175,2095,2080,50.18
Zed,Vayne,2824,1351,1473,47.84
Zed,Shyvana,475,202,273,42.53
Zed,Sylas,3263,1528,1735,46.83
Zed,Briar,1770,835,935,47.18
Zed,Kled,386,179,207,46.37
Zed,Ambessa,1556,809,747,51.99
Zed,Nilah,798,349,449,43.73
Zed,Leona,1778,873,905,49.1
Zed,Riven,1185,563,622,47.51
Zed,TwistedFate,891,410,481,46.02
Zed,Kennen,719,405,314,56.33
Zed,Ahri,2848,1340,1508,47.05
Zed,Lux,5937,2911,3026,49.03
Zed,TahmKench,2016,935,1081,46.38
Zed,MissFortune,4840,2240,2600,46.28
Zed,Blitzcrank,1734,917,817,52.88
Zed,Vex,1217,567,650,46.59
Zed,Vi,2218,1013,1205,45.67
Zed,Swain,2173,1026,1147,47.22
Zed,DrMundo,1226,570,656,46.49
Zed,Lillia,1271,612,659,48.15
Zed,Lissandra,1139,469,670,41.18
Zed,FiddleSticks,1149,494,655,42.99
Zed,Anivia,761,378,383,49.67
Zed,Poppy,1353,654,699,48.34
Zed,XinZhao,1614,739,875,45.79
Zed,Syndra,1456,720,736,49.45
Zed,Sett,3360,1584,1776,47.14
Zed,Rumble,605,313,292,51.74
Zed,Samira,1811,884,927,48.81
Zed,Talon,1548,777,771,50.19
Zed,Aurora,1753,947,806,54.02
Zed,Taliyah,454,233,221,51.32
Zed,Zoe,878,458,420,52.16
Zed,Twitch,1839,862,977,46.87
Zed,Viego,3246,1637,1609,50.43
Zed,Nautilus,2483,1198,1285,48.25
Zed,Urgot,946,440,506,46.51
Zed,Galio,1759,823,936,46.79
Zed,Lulu,2914,1410,1504,48.39
Zed,AurelionSol,789,398,391,50.44
Zed,Zyra,1993,884,1109,44.36
Zed,Singed,626,269,357,42.97
Zed,Orianna,880,441,439,50.11
Zed,Garen,3745,1697,2048,45.31
Zed,Malzahar,2494,1233,1261,49.44
Zed,Volibear,2587,1291,1296,49.9
Zed,Yorick,1996,829,1167,41.53
Zed,Ziggs,877,427,450,48.69
Zed,Nasus,1544,679,865,43.98
Zed,Rell,1074,556,518,51.77
Zed,LeeSin,3695,1837,1858,49.72
Zed,Camille,894,452,442,50.56
Zed,Kayle,1397,585,812,41.88
Zed,Zac,994,470,524,47.28
Zed,Braum,1216,563,653,46.3
Zed,Velkoz,1383,679,704,49.1
Zed,Ornn,954,433,521,45.39
Zed,Graves,1513,778,735,51.42
Zed,Bard,610,295,315,48.36
Zed,Gwen,1030,540,490,52.43
Zed,Zeri,957,537,420,56.11
Zed,Hecarim,1038,501,537,48.27
Zed,Nunu,1213,589,624,48.56
Zed,Skarner,617,351,266,56.89
Zed,Elise,1724,878,846,50.93
Zed,Renekton,1162,523,639,45.01
Zed,Aphelios,1354,601,753,44.39
Zed,Renata,481,226,255,46.99
Zed,Nocturne,2751,1293,1458,47
Zed,Annie,780,365,415,46.79
Zed,Udyr,892,486,406,54.48
Zed,Maokai,1053,513,540,48.72
Zed,MonkeyKing,1428,617,811,43.21
Zed,Sion,1843,830,1013,45.04
Zed,Rengar,829,407,422,49.1
Zed,Ekko,2525,1215,1310,48.12
Zed,Corki,876,411,465,46.92
Zed,Alistar,985,436,549,44.26
Zed,Fizz,1505,762,743,50.63
Zed,Smolder,1563,811,752,51.89
Zed,KSante,1204,592,612,49.17
Zed,Nidalee,687,344,343,50.07
Zed,Rakan,1059,461,598,43.53
Zed,Sivir,1166,597,569,51.2
Zed,Kassadin,304,158,146,51.97
Zed,Sona,680,277,403,40.74
Zed,Viktor,1752,818,934,46.69
Zed,Khazix,1323,636,687,48.07
Zed,Rammus,813,381,432,46.86
Zed,Zilean,830,380,450,45.78
Zed,Akshan,779,370,409,47.5
Zed,Ivern,467,223,244,47.75
Zed,Draven,1182,552,630,46.7
Zed,Illaoi,1097,574,523,52.32
Zed,Varus,1976,989,987,50.05
Zed,Xerath,1840,915,925,49.73
Zed,Shen,1482,751,731,50.67
Zed,Quinn,956,426,530,44.56
Zed,RekSai,351,179,172,51
Zed,KogMaw,610,262,348,42.95
Zed,Azir,808,435,373,53.84
Zed,Karthus,572,265,307,46.33
Zed,Brand,1650,851,799,51.58
Zed,Taric,519,245,274,47.21
Zed,Olaf,506,237,269,46.84
Zed,Naafiri,748,370,378,49.47
Zed,Jayce,1109,569,540,51.31
Zed,JarvanIV,1206,550,656,45.61
Zed,Belveth,459,220,239,47.93
Zed,Kalista,724,358,366,49.45
Zac,Fiora,431,234,197,54.29
Zac,Pantheon,1585,738,847,46.56
Zac,Katarina,756,433,323,57.28
Zac,Mel,2090,1012,1078,48.42
Zac,Viktor,913,468,445,51.26
Zac,Ornn,436,220,216,50.46
Zac,Poppy,793,362,431,45.65
Zac,Yone,1777,969,808,54.53
Zac,MissFortune,1950,957,993,49.08
Zac,Brand,713,302,411,42.36
Zac,Darius,1687,811,876,48.07
Zac,Volibear,1086,520,566,47.88
Zac,Chogath,1219,575,644,47.17
Zac,Ezreal,2536,1268,1268,50
Zac,Tryndamere,396,189,207,47.73
Zac,Kayn,1384,644,740,46.53
Zac,Aurora,766,390,376,50.91
Zac,Twitch,636,345,291,54.25
Zac,Lux,2102,1014,1088,48.24
Zac,Gragas,594,294,300,49.49
Zac,XinZhao,777,365,412,46.98
Zac,Yasuo,1849,909,940,49.16
Zac,Lucian,733,401,332,54.71
Zac,Velkoz,595,305,290,51.26
Zac,Yorick,896,447,449,49.89
Zac,Cassiopeia,321,161,160,50.16
Zac,Jhin,1836,983,853,53.54
Zac,Rell,588,305,283,51.87
Zac,Samira,716,376,340,52.51
Zac,MasterYi,859,415,444,48.31
Zac,Orianna,406,202,204,49.75
Zac,Malphite,912,448,464,49.12
Zac,Nautilus,1228,646,582,52.61
Zac,Ivern,145,70,75,48.28
Zac,Gnar,485,233,252,48.04
Zac,Seraphine,701,342,359,48.79
Zac,Irelia,761,412,349,54.14
Zac,Leona,771,388,383,50.32
Zac,Briar,694,368,326,53.03
Zac,Akali,1025,542,483,52.88
Zac,Caitlyn,2672,1292,1380,48.35
Zac,Morgana,969,500,469,51.6
Zac,Sion,842,452,390,53.68
Zac,Ahri,1261,637,624,50.52
Zac,Draven,541,278,263,51.39
Zac,Kassadin,241,118,123,48.96
Zac,Renata,208,87,121,41.83
Zac,Teemo,1137,548,589,48.2
Zac,Rengar,360,207,153,57.5
Zac,Vladimir,703,363,340,51.64
Zac,Kaisa,1733,898,835,51.82
Zac,Xerath,891,450,441,50.51
Zac,Garen,1536,763,773,49.67
Zac,Warwick,1242,665,577,53.54
Zac,Xayah,642,313,329,48.75
Zac,Zed,994,524,470,52.72
Zac,Kindred,456,218,238,47.81
Zac,Diana,1585,802,783,50.6
Zac,Tristana,765,413,352,53.99
Zac,Yuumi,878,443,435,50.46
Zac,Ashe,2148,1068,1080,49.72
Zac,Riven,410,226,184,55.12
Zac,Nilah,334,136,198,40.72
Zac,Camille,383,207,176,54.05
Zac,Varus,1056,546,510,51.7
Zac,Braum,583,274,309,47
Zac,Naafiri,300,152,148,50.67
Zac,Veigar,858,454,404,52.91
Zac,Neeko,426,251,175,58.92
Zac,Nasus,650,352,298,54.15
Zac,Pyke,756,386,370,51.06
Zac,Sett,1465,708,757,48.33
Zac,Ekko,884,433,451,48.98
Zac,Aphelios,614,307,307,50
Zac,Alistar,513,247,266,48.15
Zac,Mordekaiser,1190,614,576,51.6
Zac,Vi,1096,543,553,49.54
Zac,Senna,649,319,330,49.15
Zac,AurelionSol,379,153,226,40.37
Zac,Lissandra,343,160,183,46.65
Zac,TahmKench,758,384,374,50.66
Zac,Swain,891,360,531,40.4
Zac,Evelynn,359,196,163,54.6
Zac,Vex,514,229,285,44.55
Zac,Milio,540,263,277,48.7
Zac,Trundle,461,236,225,51.19
Zac,Lulu,1449,754,695,52.04
Zac,Hecarim,379,194,185,51.19
Zac,Khazix,513,294,219,57.31
Zac,MonkeyKing,707,382,325,54.03
Zac,Graves,697,349,348,50.07
Zac,Corki,482,211,271,43.78
Zac,Elise,810,403,407,49.75
Zac,Anivia,339,158,181,46.61
Zac,Gwen,621,329,292,52.98
Zac,Jinx,2350,1227,1123,52.21
Zac,Zyra,896,419,477,46.76
Zac,Sivir,561,287,274,51.16
Zac,Nidalee,390,231,159,59.23
Zac,Shaco,827,414,413,50.06
Zac,Shyvana,286,145,141,50.7
Zac,Udyr,407,192,215,47.17
Zac,Ziggs,333,175,158,52.55
Zac,Vayne,1268,663,605,52.29
Zac,Leblanc,613,304,309,49.59
Zac,Thresh,1509,768,741,50.89
Zac,Gangplank,511,241,270,47.16
Zac,Singed,266,124,142,46.62
Zac,Zeri,493,245,248,49.7
Zac,Sona,296,159,137,53.72
Zac,Viego,1544,802,742,51.94
Zac,DrMundo,476,226,250,47.48
Zac,Lillia,700,341,359,48.71
Zac,FiddleSticks,600,281,319,46.83
Zac,Nami,944,460,484,48.73
Zac,Urgot,429,228,201,53.15
Zac,Karma,1274,661,613,51.88
Zac,Azir,493,238,255,48.28
Zac,KogMaw,290,153,137,52.76
Zac,Nunu,541,237,304,43.81
Zac,Sylas,1481,743,738,50.17
Zac,Janna,407,218,189,53.56
Zac,Taric,259,132,127,50.97
Zac,Amumu,1070,546,524,51.03
Zac,KSante,686,360,326,52.48
Zac,Jax,936,434,502,46.37
Zac,Blitzcrank,777,423,354,54.44
Zac,Galio,910,487,423,53.52
Zac,Ryze,358,211,147,58.94
Zac,Belveth,184,82,102,44.57
Zac,Malzahar,906,424,482,46.8
Zac,Hwei,694,319,375,45.97
Zac,Jayce,509,272,237,53.44
Zac,Kennen,310,192,118,61.94
Zac,Bard,317,173,144,54.57
Zac,LeeSin,1645,843,802,51.25
Zac,Smolder,725,337,388,46.48
Zac,Annie,327,196,131,59.94
Zac,Rammus,265,133,132,50.19
Zac,Nocturne,1182,604,578,51.1
Zac,Soraka,554,294,260,53.07
Zac,Fizz,496,198,298,39.92
Zac,Illaoi,410,225,185,54.88
Zac,Rakan,410,212,198,51.71
Zac,Rumble,303,116,187,38.28
Zac,Syndra,632,335,297,53.01
Zac,Ambessa,687,375,312,54.59
Zac,JarvanIV,595,301,294,50.59
Zac,Aatrox,1079,507,572,46.99
Zac,Skarner,412,194,218,47.09
Zac,Renekton,632,265,367,41.93
Zac,Heimerdinger,438,220,218,50.23
Zac,Kalista,286,150,136,52.45
Zac,Kayle,581,271,310,46.64
Zac,RekSai,140,79,61,56.43
Zac,Shen,579,289,290,49.91
Zac,Akshan,305,139,166,45.57
Zac,Sejuani,479,220,259,45.93
Zac,Zilean,341,181,160,53.08
Zac,Karthus,305,177,128,58.03
Zac,TwistedFate,364,220,144,60.44
Zac,Talon,541,306,235,56.56
Zac,Qiyana,249,145,104,58.23
Zac,Maokai,448,195,253,43.53
Zac,Quinn,282,125,157,44.33
Zac,Olaf,234,108,126,46.15
Zac,Taliyah,297,145,152,48.82
Zac,Kled,204,127,77,62.25
Zac,Zoe,391,179,212,45.78
Poppy,Fiora,533,314,219,58.91
Poppy,Pantheon,2257,1181,1076,52.33
Poppy,Katarina,995,552,443,55.48
Poppy,Mel,2569,1329,1240,51.73
Poppy,Viktor,1184,600,584,50.68
Poppy,Lillia,875,437,438,49.94
Poppy,Aurora,1038,522,516,50.29
Poppy,Zeri,746,401,345,53.75
Poppy,Rakan,840,399,441,47.5
Poppy,Renekton,728,383,345,52.61
Poppy,JarvanIV,824,410,414,49.76
Poppy,Jhin,2384,1201,1183,50.38
Poppy,Sylas,1554,864,690,55.6
Poppy,Warwick,1766,809,957,45.81
Poppy,Briar,1003,505,498,50.35
Poppy,Yasuo,2577,1310,1267,50.83
Poppy,Irelia,1141,617,524,54.08
Poppy,Lux,2865,1425,1440,49.74
Poppy,Jax,1305,638,667,48.89
Poppy,Ahri,1780,946,834,53.15
Poppy,Rell,790,402,388,50.89
Poppy,Vladimir,974,477,497,48.97
Poppy,Zac,793,431,362,54.35
Poppy,Cassiopeia,429,225,204,52.45
Poppy,Ambessa,957,512,445,53.5
Poppy,Xayah,773,384,389,49.68
Poppy,AurelionSol,506,234,272,46.25
Poppy,Khazix,706,371,335,52.55
Poppy,Nautilus,1761,948,813,53.83
Poppy,Darius,2230,1118,1112,50.13
Poppy,Volibear,1418,687,731,48.45
Poppy,Caitlyn,3178,1591,1587,50.06
Poppy,TahmKench,1171,606,565,51.75
Poppy,Chogath,1477,651,826,44.08
Poppy,Talon,853,498,355,58.38
Poppy,Qiyana,323,151,172,46.75
Poppy,Seraphine,966,462,504,47.83
Poppy,FiddleSticks,632,276,356,43.67
Poppy,Singed,360,175,185,48.61
Poppy,Pyke,1365,729,636,53.41
Poppy,Sett,1941,926,1015,47.71
Poppy,Ivern,227,133,94,58.59
Poppy,Neeko,663,358,305,54
Poppy,Senna,1049,513,536,48.9
Poppy,Elise,882,430,452,48.75
Poppy,Galio,1214,596,618,49.09
Poppy,Twitch,932,432,500,46.35
Poppy,Soraka,632,278,354,43.99
Poppy,Belveth,358,234,124,65.36
Poppy,Yone,2576,1354,1222,52.56
Poppy,Mordekaiser,1744,879,865,50.4
Poppy,Alistar,675,315,360,46.67
Poppy,Tryndamere,605,325,280,53.72
Poppy,Zyra,1074,484,590,45.07
Poppy,Nilah,459,242,217,52.72
Poppy,Sion,911,428,483,46.98
Poppy,Ezreal,2691,1351,1340,50.2
Poppy,Zilean,387,174,213,44.96
Poppy,Aatrox,1174,571,603,48.64
Poppy,Gragas,711,375,336,52.74
Poppy,Teemo,1341,680,661,50.71
Poppy,Evelynn,471,219,252,46.5
Poppy,Corki,552,294,258,53.26
Poppy,Rammus,418,214,204,51.2
Poppy,LeeSin,2443,1346,1097,55.1
Poppy,Nasus,919,415,504,45.16
Poppy,Kaisa,2326,1245,1081,53.53
Poppy,Bard,452,207,245,45.8
Poppy,Rengar,503,280,223,55.67
Poppy,Vayne,1790,858,932,47.93
Poppy,Blitzcrank,899,514,385,57.17
Poppy,KSante,860,498,362,57.91
Poppy,Azir,489,283,206,57.87
Poppy,Zed,1353,699,654,51.66
Poppy,Malzahar,1191,582,609,48.87
Poppy,Nidalee,475,232,243,48.84
Poppy,Vex,686,348,338,50.73
Poppy,Sivir,654,297,357,45.41
Poppy,Karma,1381,682,699,49.38
Poppy,Gangplank,633,322,311,50.87
Poppy,Lulu,1535,766,769,49.9
Poppy,Ashe,2575,1345,1230,52.23
Poppy,MasterYi,1348,640,708,47.48
Poppy,Diana,2077,1036,1041,49.88
Poppy,Varus,1209,568,641,46.98
Poppy,Rumble,437,216,221,49.43
Poppy,Samira,1004,545,459,54.28
Poppy,Kayn,1732,953,779,55.02
Poppy,Hwei,864,431,433,49.88
Poppy,Draven,609,321,288,52.71
Poppy,Gnar,608,309,299,50.82
Poppy,Nocturne,1491,690,801,46.28
Poppy,Trundle,746,399,347,53.49
Poppy,XinZhao,909,439,470,48.29
Poppy,Tristana,1277,708,569,55.44
Poppy,Orianna,632,314,318,49.68
Poppy,Milio,681,289,392,42.44
Poppy,Illaoi,609,300,309,49.26
Poppy,Morgana,1388,706,682,50.86
Poppy,Urgot,548,261,287,47.63
Poppy,Xerath,999,442,557,44.24
Poppy,Veigar,1181,523,658,44.28
Poppy,Ekko,1156,617,539,53.37
Poppy,Heimerdinger,504,211,293,41.87
Poppy,Kalista,545,291,254,53.39
Poppy,Thresh,1948,1014,934,52.05
Poppy,Akshan,456,212,244,46.49
Poppy,Nami,1106,531,575,48.01
Poppy,Aphelios,728,339,389,46.57
Poppy,Lissandra,390,177,213,45.38
Poppy,Riven,650,369,281,56.77
Poppy,Yuumi,1149,628,521,54.66
Poppy,MonkeyKing,746,340,406,45.58
Poppy,MissFortune,2597,1321,1276,50.87
Poppy,Amumu,1298,589,709,45.38
Poppy,Nunu,760,409,351,53.82
Poppy,Vi,1411,716,695,50.74
Poppy,Velkoz,676,349,327,51.63
Poppy,RekSai,231,140,91,60.61
Poppy,Ziggs,416,224,192,53.85
Poppy,Shen,880,433,447,49.2
Poppy,Brand,763,394,369,51.64
Poppy,Graves,804,434,370,53.98
Poppy,Ornn,537,275,262,51.21
Poppy,TwistedFate,535,275,260,51.4
Poppy,Jinx,3235,1565,1670,48.38
Poppy,Swain,1171,537,634,45.86
Poppy,Annie,386,163,223,42.23
Poppy,Leona,1500,767,733,51.13
Poppy,Shyvana,332,122,210,36.75
Poppy,Maokai,667,307,360,46.03
Poppy,Kled,275,150,125,54.55
Poppy,Shaco,1146,575,571,50.17
Poppy,Yorick,1055,486,569,46.07
Poppy,Kindred,626,312,314,49.84
Poppy,DrMundo,703,316,387,44.95
Poppy,Udyr,449,240,209,53.45
Poppy,Malphite,1127,559,568,49.6
Poppy,Kassadin,249,113,136,45.38
Poppy,Garen,1846,966,880,52.33
Poppy,Taric,316,133,183,42.09
Poppy,Camille,502,262,240,52.19
Poppy,Naafiri,422,233,189,55.21
Poppy,Syndra,841,411,430,48.87
Poppy,Lucian,1018,528,490,51.87
Poppy,Viego,1676,844,832,50.36
Poppy,Akali,1362,744,618,54.63
Poppy,Kennen,372,166,206,44.62
Poppy,Zoe,520,278,242,53.46
Poppy,Kayle,847,498,349,58.8
Poppy,Leblanc,827,436,391,52.72
Poppy,Renata,336,158,178,47.02
Poppy,Quinn,405,200,205,49.38
Poppy,Taliyah,339,167,172,49.26
Poppy,Sona,388,175,213,45.1
Poppy,Braum,796,374,422,46.98
Poppy,Hecarim,472,244,228,51.69
Poppy,Sejuani,552,270,282,48.91
Poppy,Fizz,678,358,320,52.8
Poppy,Jayce,682,353,329,51.76
Poppy,Skarner,347,178,169,51.3
Poppy,Smolder,785,343,442,43.69
Poppy,Karthus,355,177,178,49.86
Poppy,Ryze,469,193,276,41.15
Poppy,Olaf,358,139,219,38.83
Poppy,KogMaw,418,182,236,43.54
Poppy,Janna,457,225,232,49.23
Poppy,Gwen,715,438,277,61.26
Poppy,Anivia,471,257,214,54.56
Twitch,Fiora,803,455,348,56.66
Twitch,Pantheon,2597,1191,1406,45.86
Twitch,Katarina,1273,651,622,51.14
Twitch,Mel,3560,1835,1725,51.54
Twitch,Viktor,1413,702,711,49.68
Twitch,Kayle,1224,534,690,43.63
Twitch,Sylas,1860,987,873,53.06
Twitch,Qiyana,444,259,185,58.33
Twitch,Caitlyn,4304,2051,2253,47.65
Twitch,Renata,377,158,219,41.91
Twitch,Samira,1244,602,642,48.39
Twitch,Kayn,2543,1285,1258,50.53
Twitch,Nilah,731,354,377,48.43
Twitch,Leona,1299,642,657,49.42
Twitch,Riven,807,420,387,52.04
Twitch,Amumu,1812,810,1002,44.7
Twitch,Zoe,692,339,353,48.99
Twitch,MissFortune,3915,1865,2050,47.64
Twitch,Sona,549,287,262,52.28
Twitch,Jax,1453,709,744,48.8
Twitch,Briar,1356,708,648,52.21
Twitch,Ahri,2123,1028,1095,48.42
Twitch,Zeri,702,373,329,53.13
Twitch,Rell,831,365,466,43.92
Twitch,Nasus,1135,536,599,47.22
Twitch,MonkeyKing,1176,560,616,47.62
Twitch,Xayah,868,415,453,47.81
Twitch,Zac,636,291,345,45.75
Twitch,Jayce,592,307,285,51.86
Twitch,Rengar,622,317,305,50.96
Twitch,Swain,1656,831,825,50.18
Twitch,Ezreal,3249,1684,1565,51.83
Twitch,Neeko,800,421,379,52.63
Twitch,Morgana,1973,1017,956,51.55
Twitch,Tryndamere,923,443,480,48
Twitch,Graves,998,500,498,50.1
Twitch,Gnar,720,396,324,55
Twitch,Nunu,1057,503,554,47.59
Twitch,Lucian,1198,589,609,49.17
Twitch,Jhin,3489,1699,1790,48.7
Twitch,Lux,4416,2145,2271,48.57
Twitch,Ornn,738,359,379,48.64
Twitch,Warwick,2647,1340,1307,50.62
Twitch,TwistedFate,671,365,306,54.4
Twitch,Gangplank,836,423,413,50.6
Twitch,Taliyah,407,223,184,54.79
Twitch,Sivir,783,403,380,51.47
Twitch,Soraka,1021,509,512,49.85
Twitch,Yorick,1693,844,849,49.85
Twitch,Volibear,1956,935,1021,47.8
Twitch,Cassiopeia,573,225,348,39.27
Twitch,Gwen,970,496,474,51.13
Twitch,Tristana,1767,845,922,47.82
Twitch,Poppy,932,500,432,53.65
Twitch,Draven,924,430,494,46.54
Twitch,KogMaw,725,381,344,52.55
Twitch,Yuumi,1447,670,777,46.3
Twitch,Khazix,979,505,474,51.58
Twitch,Yasuo,3281,1618,1663,49.31
Twitch,Seraphine,1532,775,757,50.59
Twitch,Vi,1420,622,798,43.8
Twitch,Nocturne,2002,929,1073,46.4
Twitch,Corki,763,413,350,54.13
Twitch,Shaco,1667,817,850,49.01
Twitch,Naafiri,637,316,321,49.61
Twitch,Xerath,1370,719,651,52.48
Twitch,Rammus,552,294,258,53.26
Twitch,Nami,1818,952,866,52.37
Twitch,Irelia,1295,637,658,49.19
Twitch,Malphite,1676,767,909,45.76
Twitch,Vladimir,1113,549,564,49.33
Twitch,Senna,1367,703,664,51.43
Twitch,Aatrox,1495,735,760,49.16
Twitch,Trundle,1041,495,546,47.55
Twitch,Sett,2583,1149,1434,44.48
Twitch,Jinx,5515,2780,2735,50.41
Twitch,Karma,1794,958,836,53.4
Twitch,Darius,3088,1531,1557,49.58
Twitch,Ekko,1658,796,862,48.01
Twitch,Teemo,2111,989,1122,46.85
Twitch,Shyvana,480,253,227,52.71
Twitch,Galio,1325,682,643,51.47
Twitch,Thresh,2199,1067,1132,48.52
Twitch,Viego,2030,1037,993,51.08
Twitch,Kalista,522,248,274,47.51
Twitch,FiddleSticks,909,490,419,53.91
Twitch,Diana,2691,1352,1339,50.24
Twitch,Yone,2798,1432,1366,51.18
Twitch,Maokai,699,343,356,49.07
Twitch,Zed,1839,977,862,53.13
Twitch,Rumble,368,181,187,49.18
Twitch,Nautilus,1765,881,884,49.92
Twitch,Garen,2561,1300,1261,50.76
Twitch,Fizz,967,454,513,46.95
Twitch,Kaisa,2596,1396,1200,53.78
Twitch,Ryze,597,275,322,46.06
Twitch,Janna,581,276,305,47.5
Twitch,Heimerdinger,831,415,416,49.94
Twitch,Kindred,787,419,368,53.24
Twitch,TahmKench,1446,695,751,48.06
Twitch,Pyke,1303,678,625,52.03
Twitch,Shen,1102,505,597,45.83
Twitch,Veigar,1714,856,858,49.94
Twitch,Blitzcrank,1155,540,615,46.75
Twitch,Elise,1104,555,549,50.27
Twitch,Chogath,2162,972,1190,44.96
Twitch,Mordekaiser,2353,1115,1238,47.39
Twitch,Lillia,969,484,485,49.95
Twitch,Singed,500,213,287,42.6
Twitch,Bard,579,271,308,46.8
Twitch,MasterYi,2042,1009,1033,49.41
Twitch,Akali,1547,776,771,50.16
Twitch,LeeSin,1988,997,991,50.15
Twitch,Varus,1501,758,743,50.5
Twitch,Rakan,734,331,403,45.1
Twitch,Ambessa,979,534,445,54.55
Twitch,Akshan,647,292,355,45.13
Twitch,Zyra,1296,625,671,48.23
Twitch,Vayne,2204,1077,1127,48.87
Twitch,Azir,562,324,238,57.65
Twitch,Ashe,3410,1749,1661,51.29
Twitch,Gragas,977,511,466,52.3
Twitch,AurelionSol,683,313,370,45.83
Twitch,Taric,366,148,218,40.44
Twitch,Evelynn,760,433,327,56.97
Twitch,Vex,854,451,403,52.81
Twitch,Brand,1203,605,598,50.29
Twitch,Aphelios,986,483,503,48.99
Twitch,Camille,692,367,325,53.03
Twitch,Illaoi,725,352,373,48.55
Twitch,Hwei,1100,586,514,53.27
Twitch,KSante,778,431,347,55.4
Twitch,Kassadin,403,195,208,48.39
Twitch,Udyr,725,379,346,52.28
Twitch,Malzahar,1670,805,865,48.2
Twitch,Leblanc,913,442,471,48.41
Twitch,Sejuani,689,346,343,50.22
Twitch,Lulu,2157,1113,1044,51.6
Twitch,JarvanIV,942,380,562,40.34
Twitch,Renekton,874,429,445,49.08
Twitch,Syndra,1108,495,613,44.68
Twitch,Alistar,567,295,272,52.03
Twitch,Lissandra,597,272,325,45.56
Twitch,Aurora,1415,749,666,52.93
Twitch,Urgot,888,415,473,46.73
Twitch,Braum,986,436,550,44.22
Twitch,Quinn,640,307,333,47.97
Twitch,Skarner,493,263,230,53.35
Twitch,Smolder,1231,660,571,53.61
Twitch,DrMundo,1001,451,550,45.05
Twitch,Sion,1388,702,686,50.58
Twitch,Hecarim,684,380,304,55.56
Twitch,Ziggs,606,357,249,58.91
Twitch,Kennen,502,269,233,53.59
Twitch,Orianna,761,404,357,53.09
Twitch,XinZhao,1012,503,509,49.7
Twitch,Talon,1020,550,470,53.92
Twitch,Annie,411,206,205,50.12
Twitch,Velkoz,1064,535,529,50.28
Twitch,Milio,1128,553,575,49.02
Twitch,Zilean,571,254,317,44.48
Twitch,RekSai,254,126,128,49.61
Twitch,Nidalee,374,212,162,56.68
Twitch,Belveth,380,199,181,52.37
Twitch,Kled,324,165,159,50.93
Twitch,Karthus,452,261,191,57.74
Twitch,Ivern,258,123,135,47.67
Twitch,Olaf,371,201,170,54.18
Twitch,Anivia,533,278,255,52.16
Fiora,Darius,1624,745,879,45.87
Fiora,Zac,431,197,234,45.71
Fiora,Hwei,620,356,264,57.42
Fiora,Poppy,533,219,314,41.09
Fiora,Twitch,803,348,455,43.34
Fiora,Mordekaiser,1404,690,714,49.15
Fiora,Kindred,431,172,259,39.91
Fiora,Qiyana,288,162,126,56.25
Fiora,Ashe,1750,883,867,50.46
Fiora,Sona,259,134,125,51.74
Fiora,Leblanc,427,251,176,58.78
Fiora,Briar,741,337,404,45.48
Fiora,Zoe,372,216,156,58.06
Fiora,Jinx,2185,1006,1179,46.04
Fiora,Nasus,654,328,326,50.15
Fiora,Shaco,781,383,398,49.04
Fiora,Zed,894,476,418,53.24
Fiora,Varus,665,289,376,43.46
Fiora,Neeko,422,206,216,48.82
Fiora,Udyr,334,181,153,54.19
Fiora,Yorick,706,319,387,45.18
Fiora,Sivir,462,243,219,52.6
Fiora,Nautilus,1105,544,561,49.23
Fiora,Gangplank,445,241,204,54.16
Fiora,Karthus,231,117,114,50.65
Fiora,Aurora,742,377,365,50.81
Fiora,Ezreal,1830,936,894,51.15
Fiora,Senna,613,294,319,47.96
Fiora,Viego,1136,573,563,50.44
Fiora,AurelionSol,333,144,189,43.24
Fiora,MissFortune,1788,898,890,50.22
Fiora,Malphite,682,245,437,35.92
Fiora,Sett,1285,543,742,42.26
Fiora,Sion,739,370,369,50.07
Fiora,Samira,693,327,366,47.19
Fiora,Alistar,314,149,165,47.45
Fiora,Viktor,789,435,354,55.13
Fiora,Nocturne,923,398,525,43.12
Fiora,Yasuo,1744,826,918,47.36
Fiora,Nilah,328,159,169,48.48
Fiora,Bard,252,144,108,57.14
Fiora,Jax,815,449,366,55.09
Fiora,Diana,1291,567,724,43.92
Fiora,Ahri,1081,483,598,44.68
Fiora,Aphelios,521,263,258,50.48
Fiora,Aatrox,954,445,509,46.65
Fiora,Draven,439,255,184,58.09
Fiora,Talon,541,289,252,53.42
Fiora,Lissandra,257,115,142,44.75
Fiora,Vayne,888,400,488,45.05
Fiora,Milio,521,237,284,45.49
Fiora,Chogath,1290,597,693,46.28
Fiora,Galio,825,401,424,48.61
Fiora,Soraka,485,247,238,50.93
Fiora,Mel,1759,918,841,52.19
Fiora,Velkoz,536,261,275,48.69
Fiora,Kayle,562,228,334,40.57
Fiora,Sylas,959,460,499,47.97
Fiora,Lucian,540,307,233,56.85
Fiora,Nami,894,475,419,53.13
Fiora,MasterYi,927,406,521,43.8
Fiora,Yuumi,709,330,379,46.54
Fiora,Kayn,1213,581,632,47.9
Fiora,Warwick,1149,532,617,46.3
Fiora,Ziggs,325,162,163,49.85
Fiora,Malzahar,773,348,425,45.02
Fiora,Braum,565,288,277,50.97
Fiora,XinZhao,539,252,287,46.75
Fiora,Lux,2103,1007,1096,47.88
Fiora,Vi,837,395,442,47.19
Fiora,Zilean,278,144,134,51.8
Fiora,LeeSin,1147,548,599,47.78
Fiora,Akali,820,403,417,49.15
Fiora,Shyvana,200,120,80,60
Fiora,Garen,1246,553,693,44.38
Fiora,Veigar,791,337,454,42.6
Fiora,Zyra,610,295,315,48.36
Fiora,KSante,561,310,251,55.26
Fiora,Olaf,120,53,67,44.17
Fiora,Yone,1631,884,747,54.2
Fiora,Morgana,1010,501,509,49.6
Fiora,Tristana,812,353,459,43.47
Fiora,Lulu,1055,469,586,44.45
Fiora,Janna,275,131,144,47.64
Fiora,Caitlyn,2022,948,1074,46.88
Fiora,Ivern,121,56,65,46.28
Fiora,Tryndamere,441,211,230,47.85
Fiora,Ekko,811,386,425,47.6
Fiora,Thresh,1116,507,609,45.43
Fiora,Camille,414,231,183,55.8
Fiora,Lillia,463,246,217,53.13
Fiora,Xerath,725,356,369,49.1
Fiora,Pyke,753,411,342,54.58
Fiora,Evelynn,360,183,177,50.83
Fiora,Riven,519,262,257,50.48
Fiora,Katarina,691,280,411,40.52
Fiora,Xayah,380,181,199,47.63
Fiora,Illaoi,369,193,176,52.3
Fiora,Rell,407,190,217,46.68
Fiora,Volibear,846,412,434,48.7
Fiora,Taliyah,209,90,119,43.06
Fiora,Pantheon,1372,668,704,48.69
Fiora,Annie,264,137,127,51.89
Fiora,Swain,851,432,419,50.76
Fiora,Orianna,319,153,166,47.96
Fiora,Seraphine,744,387,357,52.02
Fiora,Teemo,782,346,436,44.25
Fiora,Vex,378,180,198,47.62
Fiora,Naafiri,283,116,167,40.99
Fiora,Gragas,515,283,232,54.95
Fiora,Maokai,363,208,155,57.3
Fiora,TahmKench,826,429,397,51.94
Fiora,Renekton,370,170,200,45.95
Fiora,Nunu,559,241,318,43.11
Fiora,Zeri,383,166,217,43.34
Fiora,Shen,573,299,274,52.18
Fiora,Jhin,1583,805,778,50.85
Fiora,Kaisa,1316,646,670,49.09
Fiora,Ornn,550,266,284,48.36
Fiora,Elise,650,364,286,56
Fiora,Leona,647,274,373,42.35
Fiora,Ambessa,533,280,253,52.53
Fiora,Karma,991,458,533,46.22
Fiora,Vladimir,577,281,296,48.7
Fiora,Amumu,829,453,376,54.64
Fiora,Smolder,483,235,248,48.65
Fiora,Blitzcrank,585,324,261,55.38
Fiora,MonkeyKing,546,293,253,53.66
Fiora,Gwen,613,272,341,44.37
Fiora,Cassiopeia,241,129,112,53.53
Fiora,Rakan,359,151,208,42.06
Fiora,Azir,314,159,155,50.64
Fiora,Kalista,266,146,120,54.89
Fiora,Urgot,348,138,210,39.66
Fiora,Corki,345,160,185,46.38
Fiora,Brand,516,218,298,42.25
Fiora,Irelia,763,404,359,52.95
Fiora,Graves,490,231,259,47.14
Fiora,Ryze,336,154,182,45.83
Fiora,Gnar,275,144,131,52.36
Fiora,Renata,196,83,113,42.35
Fiora,Trundle,390,178,212,45.64
Fiora,Rammus,280,149,131,53.21
Fiora,KogMaw,306,147,159,48.04
Fiora,Sejuani,352,170,182,48.3
Fiora,Rengar,300,178,122,59.33
Fiora,Heimerdinger,374,167,207,44.65
Fiora,Khazix,498,279,219,56.02
Fiora,DrMundo,449,188,261,41.87
Fiora,Anivia,211,101,110,47.87
Fiora,Syndra,485,285,200,58.76
Fiora,Taric,165,70,95,42.42
Fiora,Jayce,390,194,196,49.74
Fiora,Quinn,249,96,153,38.55
Fiora,Skarner,264,163,101,61.74
Fiora,Kassadin,135,70,65,51.85
Fiora,Akshan,343,152,191,44.31
Fiora,Fizz,389,202,187,51.93
Fiora,Singed,206,113,93,54.85
Fiora,TwistedFate,293,142,151,48.46
Fiora,Hecarim,341,180,161,52.79
Fiora,Kled,152,73,79,48.03
Fiora,FiddleSticks,403,199,204,49.38
Fiora,JarvanIV,376,196,180,52.13
Fiora,RekSai,102,62,40,60.78
Fiora,Belveth,261,127,134,48.66
Fiora,Rumble,215,117,98,54.42
Fiora,Nidalee,216,135,81,62.5
Fiora,Kennen,197,101,96,51.27
Katarina,Darius,3071,1528,1543,49.76
Katarina,Zac,756,323,433,42.72
Katarina,Hwei,1205,554,651,45.98
Katarina,Poppy,995,443,552,44.52
Katarina,Twitch,1273,622,651,48.86
Katarina,Yone,3100,1524,1576,49.16
Katarina,Shaco,1698,840,858,49.47
Katarina,Mel,3695,1906,1789,51.58
Katarina,Tristana,1586,738,848,46.53
Katarina,Pyke,1500,768,732,51.2
Katarina,Singed,482,203,279,42.12
Katarina,Graves,1025,565,460,55.12
Katarina,Fizz,921,407,514,44.19
Katarina,Ziggs,641,286,355,44.62
Katarina,Pantheon,2695,1342,1353,49.8
Katarina,Jax,1373,694,679,50.55
Katarina,Briar,1398,644,754,46.07
Katarina,Ahri,2419,1194,1225,49.36
Katarina,Zeri,691,393,298,56.87
Katarina,Rell,836,363,473,43.42
Katarina,Aatrox,1620,839,781,51.79
Katarina,Gwen,987,519,468,52.58
Katarina,Syndra,1050,556,494,52.95
Katarina,Ashe,3289,1562,1727,47.49
Katarina,Lulu,2134,1002,1132,46.95
Katarina,Mordekaiser,2190,976,1214,44.57
Katarina,Zed,1852,937,915,50.59
Katarina,Jinx,4088,1900,2188,46.48
Katarina,Lillia,917,441,476,48.09
Katarina,Samira,1350,643,707,47.63
Katarina,Karma,1831,909,922,49.65
Katarina,Rammus,532,216,316,40.6
Katarina,Blitzcrank,1241,565,676,45.53
Katarina,Kayn,2388,1156,1232,48.41
Katarina,Thresh,2285,1155,1130,50.55
Katarina,Ezreal,3444,1778,1666,51.63
Katarina,Yuumi,1448,764,684,52.76
Katarina,Yorick,1536,675,861,43.95
Katarina,Nunu,952,449,503,47.16
Katarina,Draven,927,438,489,47.25
Katarina,KogMaw,537,222,315,41.34
Katarina,Illaoi,736,350,386,47.55
Katarina,Khazix,991,492,499,49.65
Katarina,Kaisa,2560,1383,1177,54.02
Katarina,Lux,4234,2031,2203,47.97
Katarina,Malphite,1520,714,806,46.97
Katarina,Udyr,628,293,335,46.66
Katarina,Jhin,3394,1644,1750,48.44
Katarina,Evelynn,664,305,359,45.93
Katarina,XinZhao,1108,527,581,47.56
Katarina,Akali,1878,872,1006,46.43
Katarina,Caitlyn,4350,2101,2249,48.3
Katarina,Maokai,724,363,361,50.14
Katarina,Yasuo,3265,1512,1753,46.31
Katarina,Naafiri,527,218,309,41.37
Katarina,Leblanc,848,422,426,49.76
Katarina,MissFortune,3762,1620,2142,43.06
Katarina,Nami,1734,781,953,45.04
Katarina,Gangplank,889,430,459,48.37
Katarina,Nocturne,1752,812,940,46.35
Katarina,Corki,755,387,368,51.26
Katarina,Ambessa,1049,529,520,50.43
Katarina,Qiyana,542,274,268,50.55
Katarina,LeeSin,2316,1248,1068,53.89
Katarina,Nasus,1227,489,738,39.85
Katarina,Zoe,713,375,338,52.59
Katarina,Senna,1132,530,602,46.82
Katarina,Shen,1020,438,582,42.94
Katarina,Amumu,1593,693,900,43.5
Katarina,Leona,1317,611,706,46.39
Katarina,Warwick,2414,983,1431,40.72
Katarina,Malzahar,1450,621,829,42.83
Katarina,Soraka,968,487,481,50.31
Katarina,Heimerdinger,825,358,467,43.39
Katarina,Viktor,1271,565,706,44.45
Katarina,Morgana,2046,997,1049,48.73
Katarina,Vayne,1831,825,1006,45.06
Katarina,Aurora,1251,661,590,52.84
Katarina,Nilah,671,351,320,52.31
Katarina,Cassiopeia,496,228,268,45.97
Katarina,Swain,1596,742,854,46.49
Katarina,Camille,569,290,279,50.97
Katarina,Hecarim,696,342,354,49.14
Katarina,TwistedFate,549,254,295,46.27
Katarina,Nautilus,1743,831,912,47.68
Katarina,Sejuani,730,345,385,47.26
Katarina,Veigar,2024,973,1051,48.07
Katarina,Garen,2610,1207,1403,46.25
Katarina,MasterYi,1929,945,984,48.99
Katarina,Sion,1157,573,584,49.52
Katarina,Lucian,1103,594,509,53.85
Katarina,Karthus,465,220,245,47.31
Katarina,TahmKench,1357,679,678,50.04
Katarina,Renekton,882,437,445,49.55
Katarina,KSante,815,426,389,52.27
Katarina,Belveth,438,221,217,50.46
Katarina,Riven,817,399,418,48.84
Katarina,Rumble,436,229,207,52.52
Katarina,Akshan,542,248,294,45.76
Katarina,Sona,505,237,268,46.93
Katarina,Ornn,619,344,275,55.57
Katarina,Skarner,491,260,231,52.95
Katarina,Ekko,1455,644,811,44.26
Katarina,Diana,2567,1232,1335,47.99
Katarina,AurelionSol,654,342,312,52.29
Katarina,Neeko,834,385,449,46.16
Katarina,Vi,1477,683,794,46.24
Katarina,Vladimir,1184,567,617,47.89
Katarina,Anivia,567,240,327,42.33
Katarina,Seraphine,1353,630,723,46.56
Katarina,Gragas,1001,492,509,49.15
Katarina,Urgot,821,355,466,43.24
Katarina,Kindred,715,307,408,42.94
Katarina,Fiora,691,411,280,59.48
Katarina,Annie,567,304,263,53.62
Katarina,Bard,505,278,227,55.05
Katarina,Kennen,456,207,249,45.39
Katarina,Rengar,589,343,246,58.23
Katarina,Ivern,297,155,142,52.19
Katarina,Olaf,350,178,172,50.86
Katarina,Irelia,1468,708,760,48.23
Katarina,Ryze,522,237,285,45.4
Katarina,Xerath,1351,660,691,48.85
Katarina,Orianna,660,387,273,58.64
Katarina,Kled,279,132,147,47.31
Katarina,Galio,1624,695,929,42.8
Katarina,Brand,1141,551,590,48.29
Katarina,Kayle,1215,538,677,44.28
Katarina,Smolder,1155,545,610,47.19
Katarina,Janna,584,303,281,51.88
Katarina,MonkeyKing,1131,521,610,46.07
Katarina,Trundle,913,407,506,44.58
Katarina,Kalista,566,298,268,52.65
Katarina,Velkoz,955,450,505,47.12
Katarina,Vex,893,374,519,41.88
Katarina,Milio,1143,503,640,44.01
Katarina,Viego,2447,1222,1225,49.94
Katarina,Chogath,1990,844,1146,42.41
Katarina,Alistar,645,331,314,51.32
Katarina,Nidalee,452,263,189,58.19
Katarina,JarvanIV,879,376,503,42.78
Katarina,Sylas,2055,1023,1032,49.78
Katarina,Sett,2677,1232,1445,46.02
Katarina,Xayah,918,433,485,47.17
Katarina,Sivir,749,395,354,52.74
Katarina,Volibear,1878,873,1005,46.49
Katarina,Gnar,704,361,343,51.28
Katarina,Jayce,782,376,406,48.08
Katarina,FiddleSticks,760,388,372,51.05
Katarina,Azir,594,284,310,47.81
Katarina,Rakan,754,344,410,45.62
Katarina,Teemo,1958,948,1010,48.42
Katarina,Lissandra,587,291,296,49.57
Katarina,Taliyah,370,204,166,55.14
Katarina,Zyra,1408,583,825,41.41
Katarina,Kassadin,393,186,207,47.33
Katarina,DrMundo,962,430,532,44.7
Katarina,Elise,1186,547,639,46.12
Katarina,Renata,330,164,166,49.7
Katarina,Aphelios,943,464,479,49.2
Katarina,Braum,880,450,430,51.14
Katarina,Zilean,446,210,236,47.09
Katarina,Tryndamere,881,444,437,50.4
Katarina,Talon,1036,549,487,52.99
Katarina,Varus,1533,708,825,46.18
Katarina,RekSai,217,108,109,49.77
Katarina,Quinn,670,365,305,54.48
Katarina,Taric,345,191,154,55.36
Katarina,Shyvana,426,171,255,40.14
Mel,Darius,8037,3801,4236,47.29
Mel,Zac,2090,1078,1012,51.58
Mel,Hwei,2915,1349,1566,46.28
Mel,Poppy,2569,1240,1329,48.27
Mel,Twitch,3560,1725,1835,48.46
Mel,Renekton,2267,1179,1088,52.01
Mel,Kayn,6322,3001,3321,47.47
Mel,Katarina,3695,1789,1906,48.42
Mel,Draven,2415,1111,1304,46
Mel,Yuumi,3865,1794,2071,46.42
Mel,Aurora,3285,1660,1625,50.53
Mel,Volibear,4805,2293,2512,47.72
Mel,Yasuo,9163,4334,4829,47.3
Mel,Vayne,5372,2514,2858,46.8
Mel,Shaco,4136,2104,2032,50.87
Mel,Talon,2477,1194,1283,48.2
Mel,Tristana,4042,1903,2139,47.08
Mel,Alistar,1962,982,980,50.05
Mel,Yorick,4146,1815,2331,43.78
Mel,FiddleSticks,2185,1105,1080,50.57
Mel,Smolder,3032,1528,1504,50.4
Mel,Nautilus,4943,2342,2601,47.38
Mel,Illaoi,1949,901,1048,46.23
Mel,MonkeyKing,2788,1361,1427,48.82
Mel,Yone,7961,3864,4097,48.54
Mel,Morgana,5089,2477,2612,48.67
Mel,Gangplank,2008,1052,956,52.39
Mel,Warwick,6323,2837,3486,44.87
Mel,Akali,4835,2335,2500,48.29
Mel,Caitlyn,11074,5456,5618,49.27
Mel,Sona,1492,687,805,46.05
Mel,Riven,2099,1019,1080,48.55
Mel,Ahri,4701,2393,2308,50.9
Mel,Jinx,11438,5333,6105,46.63
Mel,Nasus,3271,1513,1758,46.25
Mel,Zed,4567,2289,2278,50.12
Mel,Varus,3815,1861,1954,48.78
Mel,Neeko,2381,1249,1132,52.46
Mel,Swain,4305,2061,2244,47.87
Mel,Malzahar,4437,2076,2361,46.79
Mel,Irelia,3783,1942,1841,51.33
Mel,Kalista,1501,806,695,53.7
Mel,Gwen,2206,1114,1092,50.5
Mel,Skarner,1261,622,639,49.33
Mel,Kaisa,6978,3391,3587,48.6
Mel,Seraphine,3387,1619,1768,47.8
Mel,Briar,3559,1587,1972,44.59
Mel,Vex,1808,928,880,51.33
Mel,Milio,2621,1117,1504,42.62
Mel,Mordekaiser,6061,2786,3275,45.97
Mel,Jhin,8825,4186,4639,47.43
Mel,Velkoz,2647,1226,1421,46.32
Mel,Garen,6854,3250,3604,47.42
Mel,Zilean,1346,678,668,50.37
Mel,Teemo,5629,2616,3013,46.47
Mel,Leona,4200,1876,2324,44.67
Mel,Sylas,5864,2812,3052,47.95
Mel,Kindred,1882,894,988,47.5
Mel,Rell,2335,1153,1182,49.38
Mel,Gnar,1787,889,898,49.75
Mel,Leblanc,2242,1169,1073,52.14
Mel,Karma,4755,2176,2579,45.76
Mel,Lillia,2411,1098,1313,45.54
Mel,Vladimir,2894,1291,1603,44.61
Mel,Lulu,5263,2434,2829,46.25
Mel,Veigar,4217,2062,2155,48.9
Mel,Kennen,1246,656,590,52.65
Mel,Naafiri,1590,815,775,51.26
Mel,Xayah,2320,1101,1219,47.46
Mel,Soraka,2749,1287,1462,46.82
Mel,Gragas,2361,1194,1167,50.57
Mel,XinZhao,2783,1223,1560,43.95
Mel,Lucian,3051,1561,1490,51.16
Mel,Aatrox,4054,1974,2080,48.69
Mel,Viego,6009,2918,3091,48.56
Mel,Ashe,8272,4070,4202,49.2
Mel,Blitzcrank,3027,1636,1391,54.05
Mel,Cassiopeia,1555,706,849,45.4
Mel,Sett,6621,3101,3520,46.84
Mel,Elise,2761,1359,1402,49.22
Mel,Galio,4044,1848,2196,45.7
Mel,KSante,2122,1086,1036,51.18
Mel,Senna,3528,1674,1854,47.45
Mel,Thresh,5792,2779,3013,47.98
Mel,Viktor,4203,2013,2190,47.89
Mel,Pyke,3964,1973,1991,49.77
Mel,Nilah,1745,688,1057,39.43
Mel,Malphite,4000,1944,2056,48.6
Mel,Diana,7008,3287,3721,46.9
Mel,Lux,10923,5616,5307,51.41
Mel,Orianna,2590,1166,1424,45.02
Mel,Udyr,1658,801,857,48.31
Mel,Sion,3302,1517,1785,45.94
Mel,AurelionSol,2378,1122,1256,47.18
Mel,Samira,3326,1741,1585,52.35
Mel,Jax,3639,1800,1839,49.46
Mel,Rakan,2148,1036,1112,48.23
Mel,Ekko,3931,1947,1984,49.53
Mel,Fizz,3244,1605,1639,49.48
Mel,Fiora,1759,841,918,47.81
Mel,Ziggs,1826,739,1087,40.47
Mel,LeeSin,6076,3018,3058,49.67
Mel,Chogath,5748,2685,3063,46.71
Mel,Ezreal,9458,4643,4815,49.09
Mel,RekSai,560,318,242,56.79
Mel,Evelynn,1697,874,823,51.5
Mel,Anivia,1335,638,697,47.79
Mel,Olaf,1041,504,537,48.41
Mel,MissFortune,9834,4635,5199,47.13
Mel,Pantheon,7101,3336,3765,46.98
Mel,KogMaw,1321,630,691,47.69
Mel,Urgot,2048,976,1072,47.66
Mel,Amumu,4457,2031,2426,45.57
Mel,Annie,1390,671,719,48.27
Mel,Ivern,649,348,301,53.62
Mel,Rumble,1044,499,545,47.8
Mel,Zoe,1518,790,728,52.04
Mel,Renata,688,331,357,48.11
Mel,Qiyana,1277,628,649,49.18
Mel,MasterYi,5121,2430,2691,47.45
Mel,TahmKench,3914,1946,1968,49.72
Mel,Trundle,2555,1145,1410,44.81
Mel,Singed,1272,575,697,45.2
Mel,Quinn,1646,726,920,44.11
Mel,Jayce,2008,1009,999,50.25
Mel,Zyra,3533,1719,1814,48.66
Mel,Nami,4109,1998,2111,48.62
Mel,Kayle,3139,1495,1644,47.63
Mel,Rengar,1602,913,689,56.99
Mel,Janna,1371,650,721,47.41
Mel,Nocturne,4951,2128,2823,42.98
Mel,Hecarim,1740,855,885,49.14
Mel,Kassadin,1271,573,698,45.08
Mel,JarvanIV,2386,1106,1280,46.35
Mel,DrMundo,2484,1132,1352,45.57
Mel,Heimerdinger,2064,952,1112,46.12
Mel,Ryze,1508,761,747,50.46
Mel,Braum,2248,1030,1218,45.82
Mel,Shen,2648,1322,1326,49.92
Mel,Aphelios,2602,1245,1357,47.85
Mel,Bard,1370,639,731,46.64
Mel,Sivir,2306,1092,1214,47.35
Mel,Sejuani,1691,774,917,45.77
Mel,Ornn,1658,815,843,49.16
Mel,Ambessa,2748,1376,1372,50.07
Mel,Shyvana,1077,525,552,48.75
Mel,Akshan,1528,715,813,46.79
Mel,Vi,4084,2009,2075,49.19
Mel,Xerath,4677,2116,2561,45.24
Mel,Syndra,2495,1177,1318,47.17
Mel,TwistedFate,1271,623,648,49.02
Mel,Lissandra,1333,618,715,46.36
Mel,Brand,2963,1412,1551,47.65
Mel,Khazix,2254,1135,1119,50.35
Mel,Camille,1653,818,835,49.49
Mel,Nunu,2605,1254,1351,48.14
Mel,Maokai,1936,919,1017,47.47
Mel,Kled,854,382,472,44.73
Mel,Zeri,1912,958,954,50.1
Mel,Tryndamere,2441,1211,1230,49.61
Mel,Azir,1822,827,995,45.39
Mel,Rammus,1135,579,556,51.01
Mel,Corki,1612,824,788,51.12
Mel,Karthus,1224,588,636,48.04
Mel,Graves,2565,1305,1260,50.88
Mel,Taric,930,451,479,48.49
Mel,Nidalee,1245,627,618,50.36
Mel,Taliyah,1147,546,601,47.6
Mel,Belveth,999,449,550,44.94
Viktor,Darius,3213,1605,1608,49.95
Viktor,Zac,913,445,468,48.74
Viktor,Hwei,1669,889,780,53.27
Viktor,Poppy,1184,584,600,49.32
Viktor,Twitch,1413,711,702,50.32
Viktor,Gangplank,995,405,590,40.7
Viktor,Gragas,1196,661,535,55.27
Viktor,TwistedFate,732,420,312,57.38
Viktor,Lucian,1359,722,637,53.13
Viktor,Leona,1474,758,716,51.42
Viktor,Tryndamere,900,472,428,52.44
Viktor,Amumu,1769,855,914,48.33
Viktor,Mel,4203,2190,2013,52.11
Viktor,Kaisa,3063,1553,1510,50.7
Viktor,Seraphine,1314,644,670,49.01
Viktor,Fiora,789,354,435,44.87
Viktor,LeeSin,2902,1504,1398,51.83
Viktor,Ziggs,640,289,351,45.16
Viktor,Jinx,4998,2496,2502,49.94
Viktor,Senna,1385,662,723,47.8
Viktor,Kennen,533,286,247,53.66
Viktor,Skarner,625,357,268,57.12
Viktor,Malzahar,2005,999,1006,49.83
Viktor,Yuumi,1468,691,777,47.07
Viktor,Ivern,340,162,178,47.65
Viktor,Katarina,1271,705,566,55.47
Viktor,Jhin,3629,1720,1909,47.4
Viktor,Nami,1888,872,1016,46.19
Viktor,Sett,2608,1317,1291,50.5
Viktor,Rammus,526,262,264,49.81
Viktor,Chogath,2131,1072,1059,50.31
Viktor,Yasuo,3127,1638,1489,52.38
Viktor,Nautilus,2121,1113,1008,52.48
Viktor,Ahri,2266,1142,1124,50.4
Viktor,Zilean,582,290,292,49.83
Viktor,Aurora,1655,873,782,52.75
Viktor,Annie,586,275,311,46.93
Viktor,Elise,1458,666,792,45.68
Viktor,Ashe,3659,1779,1880,48.62
Viktor,Camille,753,330,423,43.82
Viktor,Kayn,2321,1190,1131,51.27
Viktor,Zeri,815,445,370,54.6
Viktor,Illaoi,753,381,372,50.6
Viktor,Volibear,1825,906,919,49.64
Viktor,Naafiri,562,254,308,45.2
Viktor,Lux,4277,2135,2142,49.92
Viktor,Yorick,1408,631,777,44.82
Viktor,Mordekaiser,2098,1014,1084,48.33
Viktor,Evelynn,711,327,384,45.99
Viktor,Tristana,1610,823,787,51.12
Viktor,Sylas,2511,1239,1272,49.34
Viktor,Shen,1165,619,546,53.13
Viktor,MasterYi,2059,985,1074,47.84
Viktor,TahmKench,1543,757,786,49.06
Viktor,Malphite,1654,838,816,50.67
Viktor,Viego,2559,1324,1235,51.74
Viktor,Galio,1556,780,776,50.13
Viktor,Samira,1215,641,574,52.76
Viktor,Braum,1046,531,515,50.76
Viktor,Jax,1567,779,788,49.71
Viktor,Graves,1224,603,621,49.26
Viktor,Irelia,1515,755,760,49.83
Viktor,Caitlyn,4631,2311,2320,49.9
Viktor,Soraka,1037,494,543,47.64
Viktor,Kindred,810,399,411,49.26
Viktor,Talon,1145,570,575,49.78
Viktor,Varus,1524,778,746,51.05
Viktor,Lulu,2661,1480,1181,55.62
Viktor,Sejuani,849,366,483,43.11
Viktor,Aphelios,981,539,442,54.94
Viktor,Velkoz,1117,535,582,47.9
Viktor,MonkeyKing,1315,675,640,51.33
Viktor,Vladimir,1020,571,449,55.98
Viktor,MissFortune,3554,1741,1813,48.99
Viktor,Shaco,1597,873,724,54.66
Viktor,Ekko,1774,877,897,49.44
Viktor,Bard,578,291,287,50.35
Viktor,Orianna,1046,570,476,54.49
Viktor,Pantheon,2928,1396,1532,47.68
Viktor,Riven,798,403,395,50.5
Viktor,Yone,3259,1670,1589,51.24
Viktor,Akshan,625,344,281,55.04
Viktor,Xayah,850,430,420,50.59
Viktor,Rakan,712,349,363,49.02
Viktor,Sion,1285,667,618,51.91
Viktor,Nidalee,582,354,228,60.82
Viktor,KSante,1068,603,465,56.46
Viktor,Ambessa,1296,629,667,48.53
Viktor,Vi,1746,882,864,50.52
Viktor,Corki,783,398,385,50.83
Viktor,Zyra,1708,842,866,49.3
Viktor,Heimerdinger,734,376,358,51.23
Viktor,Briar,1228,608,620,49.51
Viktor,Taric,408,181,227,44.36
Viktor,Jayce,956,503,453,52.62
Viktor,Nasus,1334,685,649,51.35
Viktor,Cassiopeia,633,308,325,48.66
Viktor,Alistar,836,443,393,52.99
Viktor,Pyke,1495,812,683,54.31
Viktor,Lillia,1048,554,494,52.86
Viktor,Draven,901,439,462,48.72
Viktor,Milio,1109,546,563,49.23
Viktor,Zoe,712,356,356,50
Viktor,Nilah,519,206,313,39.69
Viktor,Gnar,836,418,418,50
Viktor,Zed,1752,934,818,53.31
Viktor,Trundle,908,443,465,48.79
Viktor,Veigar,1925,899,1026,46.7
Viktor,Warwick,2204,1071,1133,48.59
Viktor,Thresh,2602,1334,1268,51.27
Viktor,Blitzcrank,1324,716,608,54.08
Viktor,Sona,558,275,283,49.28
Viktor,Taliyah,416,179,237,43.03
Viktor,XinZhao,1238,574,664,46.37
Viktor,Brand,1259,648,611,51.47
Viktor,Shyvana,418,221,197,52.87
Viktor,Vayne,2322,1171,1151,50.43
Viktor,Morgana,2052,979,1073,47.71
Viktor,Teemo,2038,969,1069,47.55
Viktor,Xerath,1691,811,880,47.96
Viktor,Renekton,883,460,423,52.1
Viktor,FiddleSticks,883,446,437,50.51
Viktor,Akali,2042,962,1080,47.11
Viktor,Singed,515,255,260,49.51
Viktor,Smolder,1274,694,580,54.47
Viktor,Karma,2402,1162,1240,48.38
Viktor,Kayle,1187,598,589,50.38
Viktor,Janna,660,329,331,49.85
Viktor,Fizz,931,480,451,51.56
Viktor,Rell,940,494,446,52.55
Viktor,Vex,1021,498,523,48.78
Viktor,Karthus,494,250,244,50.61
Viktor,Neeko,877,446,431,50.86
Viktor,Nunu,1010,452,558,44.75
Viktor,Kassadin,381,149,232,39.11
Viktor,Swain,1753,815,938,46.49
Viktor,Nocturne,2078,1049,1029,50.48
Viktor,Maokai,994,500,494,50.3
Viktor,Diana,2663,1289,1374,48.4
Viktor,Ezreal,4634,2383,2251,51.42
Viktor,Kalista,584,341,243,58.39
Viktor,Aatrox,1739,908,831,52.21
Viktor,Ryze,721,381,340,52.84
Viktor,Rengar,611,308,303,50.41
Viktor,Leblanc,1077,585,492,54.32
Viktor,Renata,391,209,182,53.45
Viktor,JarvanIV,1185,616,569,51.98
Viktor,Anivia,667,269,398,40.33
Viktor,AurelionSol,769,377,392,49.02
Viktor,Sivir,1056,501,555,47.44
Viktor,Azir,752,411,341,54.65
Viktor,Olaf,482,224,258,46.47
Viktor,Garen,2738,1329,1409,48.54
Viktor,Ornn,813,406,407,49.94
Viktor,Lissandra,598,316,282,52.84
Viktor,DrMundo,949,487,462,51.32
Viktor,Hecarim,771,357,414,46.3
Viktor,Syndra,1416,689,727,48.66
Viktor,Urgot,939,448,491,47.71
Viktor,RekSai,238,118,120,49.58
Viktor,Gwen,1047,544,503,51.96
Viktor,Udyr,685,378,307,55.18
Viktor,Rumble,466,220,246,47.21
Viktor,KogMaw,588,292,296,49.66
Viktor,Quinn,617,274,343,44.41
Viktor,Belveth,428,215,213,50.23
Viktor,Kled,367,195,172,53.13
Viktor,Khazix,1085,557,528,51.34
Viktor,Qiyana,493,243,250,49.29
Pyke,Renekton,918,411,507,44.77
Pyke,Kayn,2725,1215,1510,44.59
Pyke,Katarina,1500,731,769,48.73
Pyke,Draven,963,494,469,51.3
Pyke,Yuumi,1769,761,1008,43.02
Pyke,Gangplank,907,478,429,52.7
Pyke,Gragas,1011,467,544,46.19
Pyke,TwistedFate,698,352,346,50.43
Pyke,Lucian,1376,612,764,44.48
Pyke,Leona,1622,801,821,49.38
Pyke,TahmKench,1716,815,901,47.49
Pyke,Malphite,1977,813,1164,41.12
Pyke,Yasuo,3795,1808,1987,47.64
Pyke,Aphelios,1098,521,577,47.45
Pyke,Mordekaiser,2587,1194,1393,46.15
Pyke,Briar,1545,668,877,43.24
Pyke,Ryze,640,304,336,47.5
Pyke,Vex,996,453,543,45.48
Pyke,Naafiri,794,376,418,47.36
Pyke,Yone,3764,1874,1890,49.79
Pyke,MissFortune,3999,1931,2068,48.29
Pyke,Senna,1470,711,759,48.37
Pyke,Viego,2741,1241,1500,45.28
Pyke,Kindred,1042,542,500,52.02
Pyke,Jhin,3791,1745,2046,46.03
Pyke,Sett,2894,1338,1556,46.23
Pyke,Talon,1136,513,623,45.16
Pyke,FiddleSticks,960,480,480,50
Pyke,Ashe,3787,1769,2018,46.71
Pyke,Blitzcrank,1525,762,763,49.97
Pyke,Warwick,2856,1341,1515,46.95
Pyke,Singed,449,199,250,44.32
Pyke,Samira,1465,689,776,47.03
Pyke,Soraka,1096,466,630,42.52
Pyke,Shen,1286,579,707,45.02
Pyke,Diana,2751,1375,1376,49.98
Pyke,DrMundo,1095,479,616,43.74
Pyke,Ivern,310,153,157,49.35
Pyke,Nilah,774,311,463,40.18
Pyke,Nocturne,2070,1077,993,52.03
Pyke,Lissandra,543,249,294,45.86
Pyke,Lux,5310,2682,2628,50.51
Pyke,Darius,3421,1696,1725,49.58
Pyke,Poppy,1365,636,729,46.59
Pyke,Sylas,2662,1300,1362,48.84
Pyke,Rell,962,441,521,45.84
Pyke,Fizz,1021,449,572,43.98
Pyke,Gnar,725,366,359,50.48
Pyke,Caitlyn,4945,2386,2559,48.25
Pyke,Neeko,1096,486,610,44.34
Pyke,Irelia,1638,700,938,42.74
Pyke,Tryndamere,1106,570,536,51.54
Pyke,Amumu,1890,890,1000,47.09
Pyke,Mel,3964,1991,1973,50.23
Pyke,Kaisa,3138,1424,1714,45.38
Pyke,Seraphine,1449,742,707,51.21
Pyke,Zed,2060,1001,1059,48.59
Pyke,Nunu,1258,568,690,45.15
Pyke,KSante,971,484,487,49.85
Pyke,Zeri,879,409,470,46.53
Pyke,Lulu,2134,986,1148,46.2
Pyke,Azir,703,326,377,46.37
Pyke,Sejuani,827,369,458,44.62
Pyke,Udyr,734,340,394,46.32
Pyke,Evelynn,861,406,455,47.15
Pyke,Khazix,1101,578,523,52.5
Pyke,Camille,667,376,291,56.37
Pyke,LeeSin,2788,1398,1390,50.14
Pyke,Jax,1968,960,1008,48.78
Pyke,JarvanIV,882,421,461,47.73
Pyke,Hwei,1420,691,729,48.66
Pyke,Bard,526,235,291,44.68
Pyke,Morgana,2247,1091,1156,48.55
Pyke,Ambessa,1078,507,571,47.03
Pyke,XinZhao,1159,504,655,43.49
Pyke,Volibear,2243,947,1296,42.22
Pyke,Xerath,1543,758,785,49.13
Pyke,Ezreal,4490,2178,2312,48.51
Pyke,Heimerdinger,953,431,522,45.23
Pyke,Aatrox,1736,731,1005,42.11
Pyke,Taric,403,147,256,36.48
Pyke,Varus,1647,755,892,45.84
Pyke,Garen,2864,1241,1623,43.33
Pyke,Ekko,1690,804,886,47.57
Pyke,Ahri,2521,1271,1250,50.42
Pyke,Jinx,4843,2367,2476,48.87
Pyke,Zilean,522,257,265,49.23
Pyke,Chogath,2325,1027,1298,44.17
Pyke,Yorick,1756,740,1016,42.14
Pyke,Thresh,2887,1374,1513,47.59
Pyke,Trundle,1005,454,551,45.17
Pyke,MasterYi,2225,1062,1163,47.73
Pyke,Sivir,1163,493,670,42.39
Pyke,Tristana,1885,850,1035,45.09
Pyke,Gwen,1066,492,574,46.15
Pyke,Maokai,946,432,514,45.67
Pyke,Veigar,1971,876,1095,44.44
Pyke,Brand,1352,626,726,46.3
Pyke,Urgot,894,413,481,46.2
Pyke,Zyra,1481,690,791,46.59
Pyke,Malzahar,1708,732,976,42.86
Pyke,Quinn,668,329,339,49.25
Pyke,Teemo,2667,1214,1453,45.52
Pyke,Galio,1572,797,775,50.7
Pyke,Nasus,1352,582,770,43.05
Pyke,AurelionSol,839,364,475,43.38
Pyke,Qiyana,548,248,300,45.26
Pyke,Nami,1717,814,903,47.41
Pyke,Orianna,841,400,441,47.56
Pyke,RekSai,262,159,103,60.69
Pyke,Shaco,1719,837,882,48.69
Pyke,Kayle,1415,626,789,44.24
Pyke,Aurora,1526,702,824,46
Pyke,Fiora,753,342,411,45.42
Pyke,Nautilus,2351,1050,1301,44.66
Pyke,Akali,2196,1025,1171,46.68
Pyke,Hecarim,756,340,416,44.97
Pyke,Smolder,1324,668,656,50.45
Pyke,Pantheon,3480,1601,1879,46.01
Pyke,MonkeyKing,1213,525,688,43.28
Pyke,Vladimir,1087,518,569,47.65
Pyke,Twitch,1303,625,678,47.97
Pyke,Anivia,596,303,293,50.84
Pyke,Ziggs,700,348,352,49.71
Pyke,Elise,1374,624,750,45.41
Pyke,Leblanc,1033,444,589,42.98
Pyke,Vi,1691,780,911,46.13
Pyke,Xayah,915,475,440,51.91
Pyke,Zac,756,370,386,48.94
Pyke,Lillia,1011,469,542,46.39
Pyke,Rammus,732,318,414,43.44
Pyke,Illaoi,919,431,488,46.9
Pyke,Belveth,435,169,266,38.85
Pyke,Zoe,779,380,399,48.78
Pyke,Viktor,1495,683,812,45.69
Pyke,Milio,961,465,496,48.39
Pyke,Nidalee,533,257,276,48.22
Pyke,Kled,392,168,224,42.86
Pyke,Annie,574,259,315,45.12
Pyke,Olaf,441,191,250,43.31
Pyke,Swain,1896,832,1064,43.88
Pyke,Vayne,2118,987,1131,46.6
Pyke,Riven,783,435,348,55.56
Pyke,Kassadin,376,179,197,47.61
Pyke,Sion,1357,624,733,45.98
Pyke,Rengar,701,390,311,55.63
Pyke,Akshan,600,278,322,46.33
Pyke,Rakan,915,438,477,47.87
Pyke,Skarner,544,335,209,61.58
Pyke,Jayce,915,462,453,50.49
Pyke,Janna,616,283,333,45.94
Pyke,Graves,1277,611,666,47.85
Pyke,Syndra,1080,493,587,45.65
Pyke,Shyvana,470,215,255,45.74
Pyke,Karma,2049,949,1100,46.32
Pyke,Corki,777,362,415,46.59
Pyke,Ornn,787,356,431,45.24
Pyke,Kennen,546,260,286,47.62
Pyke,Renata,321,164,157,51.09
Pyke,Alistar,793,407,386,51.32
Pyke,Karthus,481,227,254,47.19
Pyke,Rumble,498,260,238,52.21
Pyke,Braum,1089,483,606,44.35
Pyke,Cassiopeia,640,312,328,48.75
Pyke,KogMaw,544,266,278,48.9
Pyke,Taliyah,425,194,231,45.65
Pyke,Sona,594,230,364,38.72
Pyke,Kalista,611,278,333,45.5
Pyke,Velkoz,1021,495,526,48.48
Renekton,Yone,2380,1377,1003,57.86
Renekton,Shaco,946,465,481,49.15
Renekton,Mel,2267,1088,1179,47.99
Renekton,Tristana,974,493,481,50.62
Renekton,Pyke,918,507,411,55.23
Renekton,Aurora,933,467,466,50.05
Renekton,Volibear,1182,564,618,47.72
Renekton,Yasuo,2775,1439,1336,51.86
Renekton,Vayne,1230,582,648,47.32
Renekton,Swain,1007,430,577,42.7
Renekton,Malzahar,896,443,453,49.44
Renekton,Irelia,781,417,364,53.39
Renekton,Kalista,379,176,203,46.44
Renekton,Poppy,728,345,383,47.39
Renekton,Smolder,719,386,333,53.69
Renekton,Ekko,1012,505,507,49.9
Renekton,Mordekaiser,1413,619,794,43.81
Renekton,Yuumi,796,446,350,56.03
Renekton,Jax,967,518,449,53.57
Renekton,FiddleSticks,445,202,243,45.39
Renekton,Cassiopeia,323,135,188,41.8
Renekton,Caitlyn,2629,1313,1316,49.94
Renekton,Milio,524,239,285,45.61
Renekton,Tryndamere,453,224,229,49.45
Renekton,Diana,1643,797,846,48.51
Renekton,Lux,2502,1226,1276,49
Renekton,Sivir,512,236,276,46.09
Renekton,Soraka,599,279,320,46.58
Renekton,Kayn,1344,647,697,48.14
Renekton,Ezreal,2545,1314,1231,51.63
Renekton,Brand,579,300,279,51.81
Renekton,Nunu,630,303,327,48.1
Renekton,Kaisa,1852,986,866,53.24
Renekton,Nami,1078,454,624,42.12
Renekton,Camille,461,213,248,46.2
Renekton,Katarina,882,445,437,50.45
Renekton,Zeri,504,237,267,47.02
Renekton,Rengar,355,210,145,59.15
Renekton,Akali,1087,579,508,53.27
Renekton,Lucian,688,345,343,50.15
Renekton,Viego,1616,839,777,51.92
Renekton,Samira,828,403,425,48.67
Renekton,Leona,952,460,492,48.32
Renekton,Shen,552,260,292,47.1
Renekton,Leblanc,589,297,292,50.42
Renekton,Hwei,673,296,377,43.98
Renekton,Kayle,571,305,266,53.42
Renekton,Janna,330,188,142,56.97
Renekton,Zoe,460,185,275,40.22
Renekton,Gragas,594,303,291,51.01
Renekton,Garen,1766,800,966,45.3
Renekton,Nilah,397,205,192,51.64
Renekton,Thresh,1559,794,765,50.93
Renekton,Kennen,287,147,140,51.22
Renekton,Evelynn,336,177,159,52.68
Renekton,Trundle,610,315,295,51.64
Renekton,Rammus,319,135,184,42.32
Renekton,Sylas,1515,775,740,51.16
Renekton,Xayah,588,287,301,48.81
Renekton,Blitzcrank,865,425,440,49.13
Renekton,MonkeyKing,692,333,359,48.12
Renekton,Vex,601,287,314,47.75
Renekton,Jhin,2104,1019,1085,48.43
Renekton,Nautilus,1230,633,597,51.46
Renekton,Darius,2065,1011,1054,48.96
Renekton,Senna,767,400,367,52.15
Renekton,Ashe,2283,1116,1167,48.88
Renekton,Sion,643,291,352,45.26
Renekton,Nidalee,354,202,152,57.06
Renekton,Jinx,2621,1327,1294,50.63
Renekton,KSante,675,351,324,52
Renekton,Sejuani,505,226,279,44.75
Renekton,Zed,1162,639,523,54.99
Renekton,Naafiri,377,164,213,43.5
Renekton,Draven,580,258,322,44.48
Renekton,Veigar,1031,538,493,52.18
Renekton,Neeko,529,264,265,49.91
Renekton,Nasus,844,413,431,48.93
Renekton,Gangplank,456,199,257,43.64
Renekton,Belveth,243,135,108,55.56
Renekton,Maokai,463,266,197,57.45
Renekton,Riven,730,410,320,56.16
Renekton,Karma,1306,640,666,49
Renekton,Ambessa,1090,599,491,54.95
Renekton,Graves,738,329,409,44.58
Renekton,Ahri,1457,716,741,49.14
Renekton,Teemo,979,387,592,39.53
Renekton,Briar,706,327,379,46.32
Renekton,Rakan,449,220,229,49
Renekton,Jayce,499,257,242,51.5
Renekton,LeeSin,1738,860,878,49.48
Renekton,Zilean,306,170,136,55.56
Renekton,Fiora,370,200,170,54.05
Renekton,Elise,931,458,473,49.19
Renekton,Pantheon,1760,913,847,51.88
Renekton,Khazix,512,210,302,41.02
Renekton,Braum,629,271,358,43.08
Renekton,Velkoz,645,289,356,44.81
Renekton,Malphite,943,456,487,48.36
Renekton,Lillia,658,328,330,49.85
Renekton,Ryze,389,198,191,50.9
Renekton,Vi,1079,594,485,55.05
Renekton,Fizz,577,285,292,49.39
Renekton,Vladimir,708,356,352,50.28
Renekton,Kled,208,89,119,42.79
Renekton,Morgana,1228,607,621,49.43
Renekton,Seraphine,796,414,382,52.01
Renekton,Sett,1981,920,1061,46.44
Renekton,Viktor,883,423,460,47.9
Renekton,Aatrox,1266,724,542,57.19
Renekton,Warwick,1493,737,756,49.36
Renekton,Xerath,916,475,441,51.86
Renekton,Olaf,213,118,95,55.4
Renekton,MissFortune,2189,1060,1129,48.42
Renekton,Kindred,416,212,204,50.96
Renekton,Gnar,460,239,221,51.96
Renekton,Karthus,253,139,114,54.94
Renekton,Twitch,874,445,429,50.92
Renekton,JarvanIV,707,349,358,49.36
Renekton,Bard,380,172,208,45.26
Renekton,Udyr,369,183,186,49.59
Renekton,MasterYi,1167,606,561,51.93
Renekton,Annie,379,182,197,48.02
Renekton,Zyra,842,420,422,49.88
Renekton,Gwen,544,267,277,49.08
Renekton,Syndra,638,257,381,40.28
Renekton,Ziggs,394,187,207,47.46
Renekton,Singed,224,98,126,43.75
Renekton,Alistar,454,254,200,55.95
Renekton,Sona,345,176,169,51.01
Renekton,RekSai,145,83,62,57.24
Renekton,Quinn,420,171,249,40.71
Renekton,DrMundo,440,229,211,52.05
Renekton,Nocturne,1094,526,568,48.08
Renekton,Orianna,491,268,223,54.58
Renekton,Galio,907,463,444,51.05
Renekton,Illaoi,589,246,343,41.77
Renekton,TwistedFate,379,171,208,45.12
Renekton,TahmKench,832,455,377,54.69
Renekton,Rell,542,324,218,59.78
Renekton,Kassadin,231,104,127,45.02
Renekton,KogMaw,316,138,178,43.67
Renekton,Shyvana,223,102,121,45.74
Renekton,Azir,368,182,186,49.46
Renekton,Akshan,367,193,174,52.59
Renekton,Yorick,1074,475,599,44.23
Renekton,Corki,432,212,220,49.07
Renekton,Lulu,1296,588,708,45.37
Renekton,Talon,720,391,329,54.31
Renekton,Chogath,1116,518,598,46.42
Renekton,Qiyana,282,157,125,55.67
Renekton,XinZhao,739,384,355,51.96
Renekton,Heimerdinger,414,210,204,50.72
Renekton,Amumu,1066,511,555,47.94
Renekton,Urgot,490,222,268,45.31
Renekton,Lissandra,373,163,210,43.7
Renekton,Zac,632,367,265,58.07
Renekton,Renata,210,115,95,54.76
Renekton,Ornn,417,184,233,44.12
Renekton,Skarner,394,212,182,53.81
Renekton,Varus,932,429,503,46.03
Renekton,Taric,237,114,123,48.1
Renekton,Taliyah,306,148,158,48.37
Renekton,Hecarim,412,219,193,53.16
Renekton,AurelionSol,405,193,212,47.65
Renekton,Anivia,312,149,163,47.76
Renekton,Rumble,239,101,138,42.26
Renekton,Aphelios,569,274,295,48.15
Renekton,Ivern,191,89,102,46.6
Kayn,Yone,5845,3068,2777,52.49
Kayn,Shaco,2930,1562,1368,53.31
Kayn,Mel,6322,3321,3001,52.53
Kayn,Tristana,2961,1484,1477,50.12
Kayn,Pyke,2725,1510,1215,55.41
Kayn,Gwen,1489,777,712,52.18
Kayn,Vi,2888,1435,1453,49.69
Kayn,Zed,3516,1820,1696,51.76
Kayn,Jhin,5982,3085,2897,51.57
Kayn,Soraka,1743,797,946,45.73
Kayn,Aatrox,2792,1522,1270,54.51
Kayn,Brand,2320,1204,1116,51.9
Kayn,Irelia,2743,1369,1374,49.91
Kayn,Caitlyn,7974,3902,4072,48.93
Kayn,Milio,1795,750,1045,41.78
Kayn,Teemo,3975,1830,2145,46.04
Kayn,Warwick,5161,2332,2829,45.19
Kayn,Azir,847,469,378,55.37
Kayn,MissFortune,7036,3574,3462,50.8
Kayn,Neeko,1669,886,783,53.09
Kayn,Trundle,1755,898,857,51.17
Kayn,MasterYi,4062,1857,2205,45.72
Kayn,Veigar,3311,1577,1734,47.63
Kayn,Gangplank,1414,723,691,51.13
Kayn,Ivern,487,260,227,53.39
Kayn,Swain,2950,1437,1513,48.71
Kayn,Ornn,1322,614,708,46.44
Kayn,Udyr,1260,696,564,55.24
Kayn,Lux,8015,3947,4068,49.25
Kayn,Ezreal,6251,3227,3024,51.62
Kayn,Singed,869,448,421,51.55
Kayn,Graves,1967,957,1010,48.65
Kayn,Fizz,1853,894,959,48.25
Kayn,Ziggs,1166,596,570,51.11
Kayn,Pantheon,5026,2630,2396,52.33
Kayn,XinZhao,1785,892,893,49.97
Kayn,Yasuo,6254,3188,3066,50.98
Kayn,Jinx,7962,3840,4122,48.23
Kayn,FiddleSticks,1707,811,896,47.51
Kayn,Akali,3090,1673,1417,54.14
Kayn,Twitch,2543,1258,1285,49.47
Kayn,Senna,2281,1160,1121,50.85
Kayn,Riven,1332,701,631,52.63
Kayn,Amumu,3240,1544,1696,47.65
Kayn,Zoe,1182,581,601,49.15
Kayn,Sona,1048,488,560,46.56
Kayn,Heimerdinger,1563,725,838,46.39
Kayn,Talon,1747,959,788,54.89
Kayn,Ahri,3887,1874,2013,48.21
Kayn,Kalista,956,500,456,52.3
Kayn,Sett,4725,2268,2457,48
Kayn,Ashe,5742,2996,2746,52.18
Kayn,Blitzcrank,2250,1185,1065,52.67
Kayn,Mordekaiser,4369,2105,2264,48.18
Kayn,Sylas,3563,1923,1640,53.97
Kayn,Xayah,1590,704,886,44.28
Kayn,Smolder,2040,1059,981,51.91
Kayn,Ekko,2859,1363,1496,47.67
Kayn,Yuumi,2539,1256,1283,49.47
Kayn,Cassiopeia,953,497,456,52.15
Kayn,Nasus,2275,1109,1166,48.75
Kayn,MonkeyKing,2000,951,1049,47.55
Kayn,Zac,1384,740,644,53.47
Kayn,Shen,2043,1048,995,51.3
Kayn,Diana,5179,2605,2574,50.3
Kayn,Samira,2564,1274,1290,49.69
Kayn,Camille,1037,523,514,50.43
Kayn,Katarina,2388,1232,1156,51.59
Kayn,Zyra,2550,1247,1303,48.9
Kayn,Lulu,3457,1703,1754,49.26
Kayn,Volibear,3734,1914,1820,51.26
Kayn,Vayne,3701,1770,1931,47.82
Kayn,Briar,2614,1230,1384,47.05
Kayn,Nautilus,3298,1753,1545,53.15
Kayn,Darius,5938,2953,2985,49.73
Kayn,Maokai,1473,760,713,51.6
Kayn,Malphite,3127,1594,1533,50.98
Kayn,Sion,2302,1198,1104,52.04
Kayn,Alistar,1080,584,496,54.07
Kayn,Rammus,985,512,473,51.98
Kayn,Sivir,1493,732,761,49.03
Kayn,Xerath,2612,1305,1307,49.96
Kayn,Gragas,1693,908,785,53.63
Kayn,LeeSin,3903,2182,1721,55.91
Kayn,Shyvana,830,344,486,41.45
Kayn,Nilah,1230,623,607,50.65
Kayn,Nami,3039,1470,1569,48.37
Kayn,Sejuani,1331,707,624,53.12
Kayn,Tryndamere,1858,921,937,49.57
Kayn,TahmKench,2632,1373,1259,52.17
Kayn,Naafiri,1158,551,607,47.58
Kayn,Jax,2821,1414,1407,50.12
Kayn,Morgana,3745,1804,1941,48.17
Kayn,Galio,2408,1182,1226,49.09
Kayn,Illaoi,1588,709,879,44.65
Kayn,Leona,2702,1299,1403,48.08
Kayn,Vex,1668,792,876,47.48
Kayn,Thresh,3898,1943,1955,49.85
Kayn,Nocturne,3685,1721,1964,46.7
Kayn,Orianna,1241,583,658,46.98
Kayn,Khazix,1714,848,866,49.47
Kayn,Varus,2423,1285,1138,53.03
Kayn,Malzahar,3017,1336,1681,44.28
Kayn,Renekton,1344,697,647,51.86
Kayn,Viego,4524,2389,2135,52.81
Kayn,Skarner,889,490,399,55.12
Kayn,DrMundo,1761,836,925,47.47
Kayn,Hwei,1959,1014,945,51.76
Kayn,Aurora,2035,999,1036,49.09
Kayn,Lillia,1771,889,882,50.2
Kayn,Lissandra,951,441,510,46.37
Kayn,Garen,4756,2331,2425,49.01
Kayn,TwistedFate,1057,514,543,48.63
Kayn,Annie,937,487,450,51.97
Kayn,Olaf,632,318,314,50.32
Kayn,Fiora,1213,632,581,52.1
Kayn,Kaisa,4551,2362,2189,51.9
Kayn,Ryze,903,405,498,44.85
Kayn,Rengar,1210,675,535,55.79
Kayn,Syndra,1878,942,936,50.16
Kayn,JarvanIV,1670,836,834,50.06
Kayn,Lucian,2028,991,1037,48.87
Kayn,Karthus,898,499,399,55.57
Kayn,Karma,2984,1498,1486,50.2
Kayn,Gnar,1100,561,539,51
Kayn,AurelionSol,1153,579,574,50.22
Kayn,Vladimir,2000,980,1020,49
Kayn,Hecarim,1196,574,622,47.99
Kayn,Viktor,2321,1131,1190,48.73
Kayn,Leblanc,1433,753,680,52.55
Kayn,Poppy,1732,779,953,44.98
Kayn,Kayle,1974,974,1000,49.34
Kayn,Janna,1039,464,575,44.66
Kayn,Ambessa,1821,1005,816,55.19
Kayn,Zilean,968,477,491,49.28
Kayn,Taric,676,306,370,45.27
Kayn,Braum,1669,823,846,49.31
Kayn,Elise,2068,1076,992,52.03
Kayn,Nidalee,800,483,317,60.38
Kayn,Aphelios,1755,931,824,53.05
Kayn,Rakan,1396,685,711,49.07
Kayn,Yorick,2985,1438,1547,48.17
Kayn,Evelynn,1205,628,577,52.12
Kayn,RekSai,348,142,206,40.8
Kayn,Kennen,844,377,467,44.67
Kayn,Velkoz,1833,960,873,52.37
Kayn,KSante,1389,803,586,57.81
Kayn,Jayce,1163,608,555,52.28
Kayn,Renata,610,323,287,52.95
Kayn,Kindred,1551,805,746,51.9
Kayn,Qiyana,811,466,345,57.46
Kayn,Rell,1513,759,754,50.17
Kayn,Akshan,1104,465,639,42.12
Kayn,Nunu,1861,986,875,52.98
Kayn,KogMaw,939,466,473,49.63
Kayn,Corki,1316,748,568,56.84
Kayn,Chogath,3732,1925,1807,51.58
Kayn,Urgot,1552,673,879,43.36
Kayn,Kled,549,237,312,43.17
Kayn,Seraphine,2538,1251,1287,49.29
Kayn,Draven,1605,792,813,49.35
Kayn,Kassadin,635,376,259,59.21
Kayn,Belveth,704,379,325,53.84
Kayn,Taliyah,733,351,382,47.89
Kayn,Zeri,1116,575,541,51.52
Kayn,Anivia,985,486,499,49.34
Kayn,Bard,869,446,423,51.32
Kayn,Rumble,738,403,335,54.61
Kayn,Quinn,1094,486,608,44.42
Draven,Yone,1992,1026,966,51.51
Draven,Shaco,1083,574,509,53
Draven,Mel,2415,1304,1111,54
Draven,Tristana,1035,529,506,51.11
Draven,Pyke,963,469,494,48.7
Draven,Talon,650,304,346,46.77
Draven,Aurora,932,484,448,51.93
Draven,Yasuo,2215,1001,1214,45.19
Draven,Alistar,501,234,267,46.71
Draven,Gangplank,635,314,321,49.45
Draven,MasterYi,1185,596,589,50.3
Draven,Veigar,1240,570,670,45.97
Draven,Swain,1005,427,578,42.49
Draven,AurelionSol,437,197,240,45.08
Draven,Ashe,2361,1163,1198,49.26
Draven,Velkoz,747,368,379,49.26
Draven,Aatrox,1089,656,433,60.24
Draven,Viego,1474,663,811,44.98
Draven,Sylas,1329,659,670,49.59
Draven,Blitzcrank,715,421,294,58.88
Draven,Urgot,643,305,338,47.43
Draven,LeeSin,1487,766,721,51.51
Draven,TwistedFate,521,259,262,49.71
Draven,Rakan,467,187,280,40.04
Draven,Evelynn,411,194,217,47.2
Draven,Irelia,961,471,490,49.01
Draven,Lux,2886,1436,1450,49.76
Draven,Jax,901,414,487,45.95
Draven,Graves,749,398,351,53.14
Draven,Katarina,927,489,438,52.75
Draven,Twitch,924,494,430,53.46
Draven,Seraphine,878,455,423,51.82
Draven,Kalista,403,219,184,54.34
Draven,Gragas,758,370,388,48.81
Draven,Orianna,445,245,200,55.06
Draven,Gnar,418,230,188,55.02
Draven,Fiora,439,184,255,41.91
Draven,Ekko,1021,532,489,52.11
Draven,Kassadin,195,99,96,50.77
Draven,Caitlyn,2911,1395,1516,47.92
Draven,TahmKench,912,452,460,49.56
Draven,Akali,998,539,459,54.01
Draven,Zac,541,263,278,48.61
Draven,Diana,1670,810,860,48.5
Draven,Vayne,1492,716,776,47.99
Draven,Mordekaiser,1405,696,709,49.54
Draven,Zeri,506,231,275,45.65
Draven,Sett,1585,671,914,42.33
Draven,Volibear,1306,645,661,49.39
Draven,KogMaw,340,202,138,59.41
Draven,Gwen,587,284,303,48.38
Draven,JarvanIV,720,377,343,52.36
Draven,Senna,834,426,408,51.08
Draven,Pantheon,1789,945,844,52.82
Draven,Vex,503,221,282,43.94
Draven,Kaisa,1808,984,824,54.42
Draven,Poppy,609,288,321,47.29
Draven,Warwick,1696,824,872,48.58
Draven,Ryze,382,181,201,47.38
Draven,Garen,1610,759,851,47.14
Draven,Briar,928,441,487,47.52
Draven,Malzahar,1063,497,566,46.75
Draven,Fizz,612,285,327,46.57
Draven,Teemo,1413,675,738,47.77
Draven,Zoe,482,270,212,56.02
Draven,Darius,2182,1017,1165,46.61
Draven,Qiyana,334,178,156,53.29
Draven,Ziggs,443,201,242,45.37
Draven,MissFortune,2570,1268,1302,49.34
Draven,Nami,1308,620,688,47.4
Draven,RekSai,153,99,54,64.71
Draven,Brand,829,407,422,49.1
Draven,Vladimir,710,341,369,48.03
Draven,Soraka,749,361,388,48.2
Draven,Cassiopeia,372,179,193,48.12
Draven,Karma,1195,602,593,50.38
Draven,Chogath,1303,612,691,46.97
Draven,Aphelios,624,300,324,48.08
Draven,Smolder,761,400,361,52.56
Draven,Hwei,814,429,385,52.7
Draven,Milio,637,275,362,43.17
Draven,KSante,575,295,280,51.3
Draven,Nautilus,1269,579,690,45.63
Draven,Kayle,828,372,456,44.93
Draven,Amumu,1104,504,600,45.65
Draven,Janna,376,208,168,55.32
Draven,DrMundo,596,260,336,43.62
Draven,Kindred,603,329,274,54.56
Draven,Rell,556,257,299,46.22
Draven,Renekton,580,322,258,55.52
Draven,Zilean,298,136,162,45.64
Draven,Nocturne,1253,566,687,45.17
Draven,Lucian,786,465,321,59.16
Draven,Udyr,466,201,265,43.13
Draven,Annie,405,206,199,50.86
Draven,Maokai,487,246,241,50.51
Draven,Trundle,576,261,315,45.31
Draven,Samira,966,472,494,48.86
Draven,Yorick,1090,429,661,39.36
Draven,Neeko,584,274,310,46.92
Draven,Leblanc,611,310,301,50.74
Draven,Hecarim,558,292,266,52.33
Draven,MonkeyKing,719,375,344,52.16
Draven,Ezreal,2469,1185,1284,48
Draven,Malphite,1098,507,591,46.17
Draven,Heimerdinger,508,245,263,48.23
Draven,Naafiri,368,174,194,47.28
Draven,Thresh,1656,742,914,44.81
Draven,Viktor,901,462,439,51.28
Draven,Nunu,658,319,339,48.48
Draven,Shen,739,354,385,47.9
Draven,Singed,338,153,185,45.27
Draven,Lulu,1347,713,634,52.93
Draven,Sejuani,456,232,224,50.88
Draven,Leona,911,409,502,44.9
Draven,Azir,414,213,201,51.45
Draven,Sivir,547,283,264,51.74
Draven,Sion,901,434,467,48.17
Draven,Jinx,2965,1425,1540,48.06
Draven,Ahri,1323,661,662,49.96
Draven,Ambessa,682,409,273,59.97
Draven,Morgana,1255,641,614,51.08
Draven,Kayn,1605,813,792,50.65
Draven,Jhin,2236,1045,1191,46.74
Draven,Lissandra,352,141,211,40.06
Draven,Syndra,760,367,393,48.29
Draven,Illaoi,471,204,267,43.31
Draven,Taliyah,303,121,182,39.93
Draven,Zyra,858,362,496,42.19
Draven,Riven,632,329,303,52.06
Draven,XinZhao,709,315,394,44.43
Draven,Kennen,364,200,164,54.95
Draven,Elise,705,353,352,50.07
Draven,Zed,1182,630,552,53.3
Draven,Braum,783,383,400,48.91
Draven,Anivia,356,167,189,46.91
Draven,Varus,1018,501,517,49.21
Draven,Lillia,655,348,307,53.13
Draven,Nilah,383,175,208,45.69
Draven,Olaf,298,168,130,56.38
Draven,Rengar,407,211,196,51.84
Draven,Akshan,458,227,231,49.56
Draven,Khazix,625,320,305,51.2
Draven,Belveth,285,134,151,47.02
Draven,Xayah,569,270,299,47.45
Draven,Galio,997,449,548,45.04
Draven,Shyvana,320,160,160,50
Draven,Taric,237,109,128,45.99
Draven,Jayce,490,283,207,57.76
Draven,Karthus,306,168,138,54.9
Draven,Sona,372,141,231,37.9
Draven,Yuumi,984,531,453,53.96
Draven,Skarner,312,159,153,50.96
Draven,Nasus,768,322,446,41.93
Draven,Camille,407,217,190,53.32
Draven,Ivern,213,106,107,49.77
Draven,Tryndamere,608,262,346,43.09
Draven,Corki,456,201,255,44.08
Draven,Rammus,397,206,191,51.89
Draven,Xerath,958,460,498,48.02
Draven,Nidalee,306,168,138,54.9
Draven,Vi,1007,515,492,51.14
Draven,Bard,339,147,192,43.36
Draven,Renata,239,126,113,52.72
Draven,Kled,194,106,88,54.64
Draven,FiddleSticks,501,237,264,47.31
Draven,Rumble,282,141,141,50
Draven,Ornn,487,227,260,46.61
Draven,Quinn,461,228,233,49.46
Yuumi,Yone,3423,1681,1742,49.11
Yuumi,Shaco,1699,878,821,51.68
Yuumi,Mel,3865,2071,1794,53.58
Yuumi,Tristana,1736,842,894,48.5
Yuumi,Pyke,1769,1005,764,56.81
Yuumi,Illaoi,853,415,438,48.65
Yuumi,Warwick,2425,1133,1292,46.72
Yuumi,Diana,2744,1236,1508,45.04
Yuumi,Milio,1158,558,600,48.19
Yuumi,Mordekaiser,2531,1212,1319,47.89
Yuumi,Kindred,902,496,406,54.99
Yuumi,Qiyana,486,291,195,59.88
Yuumi,Ashe,3704,1799,1905,48.57
Yuumi,Sona,644,283,361,43.94
Yuumi,Garen,2843,1315,1528,46.25
Yuumi,Briar,1379,666,713,48.3
Yuumi,Zed,1955,988,967,50.54
Yuumi,Caitlyn,4507,2186,2321,48.5
Yuumi,Morgana,2128,1000,1128,46.99
Yuumi,Yasuo,3659,1709,1950,46.71
Yuumi,Gangplank,1017,517,500,50.84
Yuumi,Kaisa,3124,1593,1531,50.99
Yuumi,Galio,1538,710,828,46.16
Yuumi,Cassiopeia,527,248,279,47.06
Yuumi,Hwei,1310,683,627,52.14
Yuumi,Renekton,796,350,446,43.97
Yuumi,Kayn,2539,1283,1256,50.53
Yuumi,Vex,996,481,515,48.29
Yuumi,Samira,1495,735,760,49.16
Yuumi,Lulu,2899,1431,1468,49.36
Yuumi,Darius,3435,1693,1742,49.29
Yuumi,Lux,4638,2283,2355,49.22
Yuumi,Sivir,712,378,334,53.09
Yuumi,Rakan,862,397,465,46.06
Yuumi,Jinx,4644,2202,2442,47.42
Yuumi,Volibear,1932,889,1043,46.01
Yuumi,Camille,794,404,390,50.88
Yuumi,Katarina,1448,684,764,47.24
Yuumi,MissFortune,3953,1944,2009,49.18
Yuumi,Zyra,1490,745,745,50
Yuumi,Yorick,1569,728,841,46.4
Yuumi,Akshan,611,318,293,52.05
Yuumi,FiddleSticks,1073,540,533,50.33
Yuumi,Sion,1307,678,629,51.87
Yuumi,Bard,606,332,274,54.79
Yuumi,Kennen,505,298,207,59.01
Yuumi,Naafiri,644,316,328,49.07
Yuumi,Xayah,1118,518,600,46.33
Yuumi,Soraka,1121,577,544,51.47
Yuumi,Ornn,741,370,371,49.93
Yuumi,TwistedFate,642,365,277,56.85
Yuumi,Jax,1467,711,756,48.47
Yuumi,Graves,1264,702,562,55.54
Yuumi,Twitch,1447,777,670,53.7
Yuumi,Seraphine,1448,699,749,48.27
Yuumi,Viktor,1468,777,691,52.93
Yuumi,Nocturne,2156,1063,1093,49.3
Yuumi,Annie,665,352,313,52.93
Yuumi,KogMaw,602,300,302,49.83
Yuumi,Alistar,645,328,317,50.85
Yuumi,Akali,2023,1084,939,53.58
Yuumi,Ezreal,3733,2010,1723,53.84
Yuumi,Nasus,1274,616,658,48.35
Yuumi,Vi,1840,873,967,47.45
Yuumi,Renata,299,166,133,55.52
Yuumi,Aatrox,1932,1009,923,52.23
Yuumi,Chogath,2156,1047,1109,48.56
Yuumi,Lucian,1360,689,671,50.66
Yuumi,Nautilus,2101,989,1112,47.07
Yuumi,Nunu,1192,548,644,45.97
Yuumi,Teemo,2325,1172,1153,50.41
Yuumi,Kassadin,369,170,199,46.07
Yuumi,Kalista,716,333,383,46.51
Yuumi,Maokai,813,389,424,47.85
Yuumi,Kled,296,157,139,53.04
Yuumi,AurelionSol,731,385,346,52.67
Yuumi,Jhin,3606,1796,1810,49.81
Yuumi,MonkeyKing,1108,486,622,43.86
Yuumi,Vayne,2100,1022,1078,48.67
Yuumi,Pantheon,2928,1383,1545,47.23
Yuumi,Swain,1801,917,884,50.92
Yuumi,Fiora,709,379,330,53.46
Yuumi,Viego,2370,1141,1229,48.14
Yuumi,Vladimir,1144,642,502,56.12
Yuumi,LeeSin,2697,1337,1360,49.57
Yuumi,Aurora,1489,767,722,51.51
Yuumi,Rell,1056,496,560,46.97
Yuumi,Neeko,843,411,432,48.75
Yuumi,Hecarim,664,358,306,53.92
Yuumi,Leblanc,1035,534,501,51.59
Yuumi,Trundle,980,463,517,47.24
Yuumi,Singed,539,222,317,41.19
Yuumi,Thresh,2591,1253,1338,48.36
Yuumi,Sett,2662,1249,1413,46.92
Yuumi,Karma,2272,1189,1083,52.33
Yuumi,Gwen,1030,539,491,52.33
Yuumi,Khazix,907,482,425,53.14
Yuumi,Aphelios,1127,542,585,48.09
Yuumi,Smolder,1301,720,581,55.34
Yuumi,Ziggs,554,291,263,52.53
Yuumi,Malzahar,1634,764,870,46.76
Yuumi,Senna,1424,765,659,53.72
Yuumi,Rammus,627,275,352,43.86
Yuumi,Fizz,928,436,492,46.98
Yuumi,Jayce,897,506,391,56.41
Yuumi,Gragas,1164,583,581,50.09
Yuumi,Leona,1592,712,880,44.72
Yuumi,Nidalee,607,357,250,58.81
Yuumi,Ahri,2389,1194,1195,49.98
Yuumi,MasterYi,2053,964,1089,46.96
Yuumi,Ryze,607,260,347,42.83
Yuumi,Janna,598,252,346,42.14
Yuumi,Rengar,732,417,315,56.97
Yuumi,TahmKench,1380,640,740,46.38
Yuumi,Amumu,1735,899,836,51.82
Yuumi,Varus,1725,872,853,50.55
Yuumi,Zoe,818,433,385,52.93
Yuumi,Shyvana,492,232,260,47.15
Yuumi,Zac,878,435,443,49.54
Yuumi,Shen,1156,574,582,49.65
Yuumi,Poppy,1149,521,628,45.34
Yuumi,Quinn,643,324,319,50.39
Yuumi,Skarner,608,312,296,51.32
Yuumi,Nami,2088,1043,1045,49.95
Yuumi,Braum,923,420,503,45.5
Yuumi,Malphite,1756,869,887,49.49
Yuumi,Orianna,750,382,368,50.93
Yuumi,Nilah,697,355,342,50.93
Yuumi,Urgot,832,405,427,48.68
Yuumi,Sylas,2240,1087,1153,48.53
Yuumi,Ekko,1587,806,781,50.79
Yuumi,Zeri,832,442,390,53.13
Yuumi,Irelia,1637,827,810,50.52
Yuumi,Heimerdinger,752,337,415,44.81
Yuumi,Corki,749,390,359,52.07
Yuumi,Veigar,1800,786,1014,43.67
Yuumi,Anivia,631,299,332,47.39
Yuumi,Belveth,449,215,234,47.88
Yuumi,Azir,744,426,318,57.26
Yuumi,Velkoz,1009,500,509,49.55
Yuumi,Evelynn,719,368,351,51.18
Yuumi,Lissandra,620,288,332,46.45
Yuumi,Olaf,413,215,198,52.06
Yuumi,Lillia,978,501,477,51.23
Yuumi,Gnar,745,355,390,47.65
Yuumi,Blitzcrank,1327,656,671,49.43
Yuumi,DrMundo,1031,506,525,49.08
Yuumi,Elise,1300,629,671,48.38
Yuumi,Brand,1268,681,587,53.71
Yuumi,Xerath,1532,778,754,50.78
Yuumi,Riven,806,427,379,52.98
Yuumi,Sejuani,770,342,428,44.42
Yuumi,Syndra,1236,568,668,45.95
Yuumi,XinZhao,1198,587,611,49
Yuumi,KSante,964,504,460,52.28
Yuumi,Tryndamere,1028,442,586,43
Yuumi,Zilean,621,331,290,53.3
Yuumi,Udyr,662,347,315,52.42
Yuumi,Draven,984,453,531,46.04
Yuumi,Taliyah,474,194,280,40.93
Yuumi,Ambessa,1158,553,605,47.75
Yuumi,JarvanIV,1063,535,528,50.33
Yuumi,Talon,1168,515,653,44.09
Yuumi,Kayle,1215,608,607,50.04
Yuumi,Rumble,449,223,226,49.67
Yuumi,RekSai,264,118,146,44.7
Yuumi,Taric,424,175,249,41.27
Yuumi,Ivern,335,168,167,50.15
Yuumi,Karthus,530,303,227,57.17
Aurora,Renekton,933,466,467,49.95
Aurora,Khazix,1008,459,549,45.54
Aurora,Mel,3285,1625,1660,49.47
Aurora,Jhin,3134,1523,1611,48.6
Aurora,Lux,4135,1870,2265,45.22
Aurora,Leblanc,1038,510,528,49.13
Aurora,Briar,1251,547,704,43.73
Aurora,Zoe,711,395,316,55.56
Aurora,Jinx,4220,1945,2275,46.09
Aurora,Poppy,1038,516,522,49.71
Aurora,Ambessa,1088,530,558,48.71
Aurora,Rammus,394,210,184,53.3
Aurora,Draven,932,448,484,48.07
Aurora,Blitzcrank,1257,722,535,57.44
Aurora,Fiora,742,365,377,49.19
Aurora,FiddleSticks,913,416,497,45.56
Aurora,Syndra,1141,526,615,46.1
Aurora,Vayne,2000,955,1045,47.75
Aurora,Morgana,1841,921,920,50.03
Aurora,Nasus,1195,511,684,42.76
Aurora,MonkeyKing,1081,538,543,49.77
Aurora,Xayah,947,490,457,51.74
Aurora,Zac,766,376,390,49.09
Aurora,Smolder,1038,537,501,51.73
Aurora,Warwick,2219,1116,1103,50.29
Aurora,Yasuo,3169,1537,1632,48.5
Aurora,Caitlyn,4134,1924,2210,46.54
Aurora,Velkoz,961,463,498,48.18
Aurora,Tryndamere,884,378,506,42.76
Aurora,Mordekaiser,2206,1043,1163,47.28
Aurora,MissFortune,3636,1726,1910,47.47
Aurora,Janna,586,279,307,47.61
Aurora,Gragas,951,441,510,46.37
Aurora,Sylas,2371,1171,1200,49.39
Aurora,Taliyah,388,161,227,41.49
Aurora,Senna,1192,472,720,39.6
Aurora,Riven,707,383,324,54.17
Aurora,Sejuani,817,365,452,44.68
Aurora,AurelionSol,641,290,351,45.24
Aurora,Tristana,1621,751,870,46.33
Aurora,Rakan,774,351,423,45.35
Aurora,Gwen,915,482,433,52.68
Aurora,Karthus,518,260,258,50.19
Aurora,Yone,3382,1749,1633,51.71
Aurora,Nilah,679,332,347,48.9
Aurora,Braum,861,373,488,43.32
Aurora,LeeSin,2578,1240,1338,48.1
Aurora,Evelynn,705,365,340,51.77
Aurora,Ezreal,3970,2002,1968,50.43
Aurora,Brand,1046,533,513,50.96
Aurora,Volibear,1744,900,844,51.61
Aurora,Ivern,275,153,122,55.64
Aurora,Irelia,1462,772,690,52.8
Aurora,Swain,1735,786,949,45.3
Aurora,Gangplank,876,455,421,51.94
Aurora,Diana,2849,1374,1475,48.23
Aurora,Aphelios,981,539,442,54.94
Aurora,Leona,1420,684,736,48.17
Aurora,TwistedFate,607,320,287,52.72
Aurora,Nami,1540,760,780,49.35
Aurora,Shen,1120,529,591,47.23
Aurora,Ahri,2528,1192,1336,47.15
Aurora,Samira,1248,701,547,56.17
Aurora,Maokai,739,303,436,41
Aurora,Kayle,1069,508,561,47.52
Aurora,Kindred,845,437,408,51.72
Aurora,Veigar,1612,720,892,44.67
Aurora,Lulu,2229,1154,1075,51.77
Aurora,Garen,2485,1146,1339,46.12
Aurora,Shyvana,469,221,248,47.12
Aurora,Seraphine,1385,674,711,48.66
Aurora,Ziggs,594,264,330,44.44
Aurora,Darius,3188,1548,1640,48.56
Aurora,Corki,649,345,304,53.16
Aurora,Elise,1212,672,540,55.45
Aurora,Katarina,1251,590,661,47.16
Aurora,Karma,2017,1012,1005,50.17
Aurora,Yorick,1359,596,763,43.86
Aurora,Akali,1902,897,1005,47.16
Aurora,Lissandra,528,263,265,49.81
Aurora,Kayn,2035,1036,999,50.91
Aurora,KSante,827,411,416,49.7
Aurora,Rengar,612,345,267,56.37
Aurora,Shaco,1404,694,710,49.43
Aurora,Galio,1609,727,882,45.18
Aurora,Kaisa,2787,1500,1287,53.82
Aurora,Zilean,551,281,270,51
Aurora,Aatrox,1667,812,855,48.71
Aurora,Varus,1365,667,698,48.86
Aurora,RekSai,193,117,76,60.62
Aurora,Jax,1429,687,742,48.08
Aurora,Viktor,1655,782,873,47.25
Aurora,Sett,2408,1095,1313,45.47
Aurora,Zyra,1521,756,765,49.7
Aurora,Ornn,755,360,395,47.68
Aurora,Vi,1510,739,771,48.94
Aurora,Anivia,546,274,272,50.18
Aurora,Ashe,3557,1767,1790,49.68
Aurora,Yuumi,1489,722,767,48.49
Aurora,Nidalee,512,284,228,55.47
Aurora,Vex,1014,511,503,50.39
Aurora,Sivir,1006,510,496,50.7
Aurora,Singed,385,154,231,40
Aurora,Pantheon,2845,1381,1464,48.54
Aurora,Kalista,513,232,281,45.22
Aurora,Kennen,550,234,316,42.55
Aurora,Nunu,1174,550,624,46.85
Aurora,Zed,1753,806,947,45.98
Aurora,Heimerdinger,819,398,421,48.6
Aurora,Trundle,884,442,442,50
Aurora,Orianna,840,386,454,45.95
Aurora,TahmKench,1371,647,724,47.19
Aurora,Hecarim,715,382,333,53.43
Aurora,Kassadin,322,156,166,48.45
Aurora,Amumu,1515,691,824,45.61
Aurora,Nautilus,1862,899,963,48.28
Aurora,Teemo,2128,985,1143,46.29
Aurora,Ekko,1405,665,740,47.33
Aurora,Lucian,1217,672,545,55.22
Aurora,Pyke,1526,824,702,54
Aurora,Vladimir,1069,595,474,55.66
Aurora,Jayce,961,452,509,47.03
Aurora,Fizz,817,433,384,53
Aurora,Zeri,784,384,400,48.98
Aurora,Hwei,1212,535,677,44.14
Aurora,Malphite,1460,693,767,47.47
Aurora,JarvanIV,968,446,522,46.07
Aurora,Milio,1042,509,533,48.85
Aurora,XinZhao,1084,530,554,48.89
Aurora,Quinn,630,344,286,54.6
Aurora,Akshan,715,342,373,47.83
Aurora,Chogath,2021,942,1079,46.61
Aurora,MasterYi,1936,986,950,50.93
Aurora,Azir,737,379,358,51.42
Aurora,Neeko,1009,522,487,51.73
Aurora,Thresh,2427,1191,1236,49.07
Aurora,Camille,686,338,348,49.27
Aurora,Lillia,971,506,465,52.11
Aurora,Renata,345,159,186,46.09
Aurora,Soraka,917,425,492,46.35
Aurora,Cassiopeia,619,301,318,48.63
Aurora,Alistar,633,335,298,52.92
Aurora,Illaoi,786,396,390,50.38
Aurora,Gnar,722,341,381,47.23
Aurora,Udyr,647,353,294,54.56
Aurora,Sion,1257,589,668,46.86
Aurora,Talon,1050,463,587,44.1
Aurora,Viego,2228,1167,1061,52.38
Aurora,Naafiri,657,363,294,55.25
Aurora,Taric,371,150,221,40.43
Aurora,Rell,899,435,464,48.39
Aurora,Malzahar,1576,689,887,43.72
Aurora,DrMundo,984,424,560,43.09
Aurora,Graves,1053,527,526,50.05
Aurora,Skarner,515,282,233,54.76
Aurora,Sona,519,213,306,41.04
Aurora,Urgot,769,369,400,47.98
Aurora,Ryze,611,302,309,49.43
Aurora,Bard,545,277,268,50.83
Aurora,Qiyana,530,247,283,46.6
Aurora,Twitch,1415,666,749,47.07
Aurora,Rumble,473,262,211,55.39
Aurora,Annie,568,258,310,45.42
Aurora,Xerath,1297,595,702,45.88
Aurora,KogMaw,532,247,285,46.43
Aurora,Nocturne,1953,883,1070,45.21
Aurora,Kled,249,154,95,61.85
Aurora,Olaf,380,163,217,42.89
Aurora,Belveth,383,179,204,46.74
Volibear,Renekton,1182,618,564,52.28
Volibear,Khazix,1207,662,545,54.85
Volibear,Mel,4805,2511,2294,52.26
Volibear,Jhin,4631,2240,2391,48.37
Volibear,Lux,6178,3126,3052,50.6
Volibear,Mordekaiser,3974,1936,2038,48.72
Volibear,Viego,3238,1609,1629,49.69
Volibear,Kindred,1034,532,502,51.45
Volibear,TahmKench,2174,1174,1000,54
Volibear,Sett,4054,2090,1964,51.55
Volibear,Zac,1086,566,520,52.12
Volibear,Yasuo,4598,2286,2312,49.72
Volibear,MissFortune,5606,2732,2874,48.73
Volibear,Tristana,2385,1240,1145,51.99
Volibear,Poppy,1418,731,687,51.55
Volibear,Veigar,2550,1287,1263,50.47
Volibear,Heimerdinger,1113,558,555,50.13
Volibear,Ziggs,975,468,507,48
Volibear,Darius,5025,2561,2464,50.97
Volibear,Samira,1847,965,882,52.25
Volibear,Karma,2253,1112,1141,49.36
Volibear,Rammus,691,355,336,51.37
Volibear,Blitzcrank,1709,885,824,51.78
Volibear,LeeSin,2721,1382,1339,50.79
Volibear,Irelia,2092,1125,967,53.78
Volibear,Yuumi,1932,1043,889,53.99
Volibear,Gnar,930,471,459,50.65
Volibear,Kayn,3734,1820,1914,48.74
Volibear,Leblanc,1226,675,551,55.06
Volibear,Caitlyn,6226,3122,3104,50.14
Volibear,Sejuani,1085,621,464,57.24
Volibear,Rell,1257,574,683,45.66
Volibear,Teemo,3009,1394,1615,46.33
Volibear,Trundle,1682,760,922,45.18
Volibear,Elise,1320,668,652,50.61
Volibear,KSante,1079,608,471,56.35
Volibear,Ashe,4452,2288,2164,51.39
Volibear,Nasus,2019,992,1027,49.13
Volibear,Fizz,1356,737,619,54.35
Volibear,Azir,844,442,402,52.37
Volibear,Aphelios,1327,583,744,43.93
Volibear,Soraka,1360,635,725,46.69
Volibear,Aatrox,2100,1117,983,53.19
Volibear,Sylas,2756,1398,1358,50.73
Volibear,Amumu,2655,1278,1377,48.14
Volibear,Chogath,3083,1490,1593,48.33
Volibear,Twitch,1956,1021,935,52.2
Volibear,Illaoi,1363,676,687,49.6
Volibear,Syndra,1301,662,639,50.88
Volibear,Kaisa,3620,1923,1697,53.12
Volibear,Lucian,1471,773,698,52.55
Volibear,Seraphine,2217,1164,1053,52.5
Volibear,Jax,2164,1090,1074,50.37
Volibear,JarvanIV,1319,682,637,51.71
Volibear,Hwei,1577,756,821,47.94
Volibear,Bard,719,355,364,49.37
Volibear,Sion,1752,895,857,51.08
Volibear,AurelionSol,985,438,547,44.47
Volibear,Tryndamere,1460,778,682,53.29
Volibear,Nidalee,530,307,223,57.92
Volibear,Aurora,1744,844,900,48.39
Volibear,Nami,2367,1104,1263,46.64
Volibear,Quinn,757,372,385,49.14
Volibear,Thresh,3130,1610,1520,51.44
Volibear,Diana,3665,1870,1795,51.02
Volibear,MasterYi,2786,1376,1410,49.39
Volibear,Shaco,2129,1147,982,53.88
Volibear,Rengar,835,435,400,52.1
Volibear,Pyke,2243,1296,947,57.78
Volibear,Udyr,1061,522,539,49.2
Volibear,Warwick,4256,2035,2221,47.81
Volibear,Leona,1928,941,987,48.81
Volibear,Galio,1881,910,971,48.38
Volibear,Shen,1471,729,742,49.56
Volibear,MonkeyKing,1621,833,788,51.39
Volibear,Naafiri,918,486,432,52.94
Volibear,Ezreal,4508,2413,2095,53.53
Volibear,Varus,2098,1142,956,54.43
Volibear,Ambessa,1333,718,615,53.86
Volibear,Nilah,932,417,515,44.74
Volibear,DrMundo,1447,675,772,46.65
Volibear,Pantheon,3735,1890,1845,50.6
Volibear,Nautilus,2481,1322,1159,53.28
Volibear,Braum,1264,622,642,49.21
Volibear,Skarner,723,405,318,56.02
Volibear,Vayne,2959,1379,1580,46.6
Volibear,Malzahar,2291,1097,1194,47.88
Volibear,Draven,1306,661,645,50.61
Volibear,Briar,1874,906,968,48.35
Volibear,Yone,4313,2388,1925,55.37
Volibear,Hecarim,813,449,364,55.23
Volibear,Velkoz,1424,708,716,49.72
Volibear,Yorick,2226,1024,1202,46
Volibear,KogMaw,856,416,440,48.6
Volibear,Vi,2283,1146,1137,50.2
Volibear,FiddleSticks,1163,622,541,53.48
Volibear,Taliyah,590,268,322,45.42
Volibear,Viktor,1825,919,906,50.36
Volibear,Ekko,2094,1088,1006,51.96
Volibear,Swain,2593,1275,1318,49.17
Volibear,Garen,3863,1895,1968,49.06
Volibear,Talon,1204,644,560,53.49
Volibear,Zed,2587,1296,1291,50.1
Volibear,Kalista,622,362,260,58.2
Volibear,Nocturne,2937,1403,1534,47.77
Volibear,Malphite,2045,1027,1018,50.22
Volibear,Xayah,1156,578,578,50
Volibear,Rakan,885,422,463,47.68
Volibear,Vex,1178,546,632,46.35
Volibear,Nunu,1506,744,762,49.4
Volibear,Akali,2484,1310,1174,52.74
Volibear,Lillia,1453,728,725,50.1
Volibear,Qiyana,637,309,328,48.51
Volibear,Morgana,2947,1396,1551,47.37
Volibear,Lulu,2607,1325,1282,50.82
Volibear,Ryze,726,381,345,52.48
Volibear,Brand,1867,933,934,49.97
Volibear,Gragas,1390,682,708,49.06
Volibear,Fiora,846,434,412,51.3
Volibear,XinZhao,1480,752,728,50.81
Volibear,Akshan,853,373,480,43.73
Volibear,Shyvana,728,342,386,46.98
Volibear,Jinx,6256,3057,3199,48.87
Volibear,Sona,738,331,407,44.85
Volibear,Xerath,2073,1080,993,52.1
Volibear,Sivir,1220,650,570,53.28
Volibear,Ornn,954,506,448,53.04
Volibear,Gangplank,1064,552,512,51.88
Volibear,Zeri,987,535,452,54.2
Volibear,Olaf,551,282,269,51.18
Volibear,Senna,1689,935,754,55.36
Volibear,Graves,1246,627,619,50.32
Volibear,Urgot,1329,604,725,45.45
Volibear,Maokai,1112,549,563,49.37
Volibear,Alistar,865,418,447,48.32
Volibear,Katarina,1878,1005,873,53.51
Volibear,Ahri,3128,1624,1504,51.92
Volibear,Milio,1294,585,709,45.21
Volibear,Camille,843,462,381,54.8
Volibear,Taric,525,240,285,45.71
Volibear,Renata,482,251,231,52.07
Volibear,Singed,603,291,312,48.26
Volibear,Anivia,778,336,442,43.19
Volibear,Riven,982,558,424,56.82
Volibear,Vladimir,1335,697,638,52.21
Volibear,Kayle,1633,791,842,48.44
Volibear,Orianna,963,477,486,49.53
Volibear,Lissandra,673,330,343,49.03
Volibear,Neeko,1281,694,587,54.18
Volibear,Corki,879,469,410,53.36
Volibear,Gwen,1280,712,568,55.63
Volibear,Zoe,813,468,345,57.56
Volibear,Kassadin,443,245,198,55.3
Volibear,Kled,469,229,240,48.83
Volibear,Evelynn,1009,543,466,53.82
Volibear,TwistedFate,739,354,385,47.9
Volibear,Smolder,1523,777,746,51.02
Volibear,RekSai,342,181,161,52.92
Volibear,Janna,770,395,375,51.3
Volibear,Zilean,729,348,381,47.74
Volibear,Belveth,548,264,284,48.18
Volibear,Ivern,454,224,230,49.34
Volibear,Cassiopeia,683,291,392,42.61
Volibear,Zyra,1834,860,974,46.89
Volibear,Rumble,430,230,200,53.49
Volibear,Karthus,610,281,329,46.07
Volibear,Kennen,547,312,235,57.04
Volibear,Jayce,888,445,443,50.11
Volibear,Annie,707,366,341,51.77
Vayne,Renekton,1230,648,582,52.68
Vayne,Khazix,1282,671,611,52.34
Vayne,Mel,5372,2858,2514,53.2
Vayne,Jhin,5345,2842,2503,53.17
Vayne,Lux,6231,3231,3000,51.85
Vayne,Teemo,3129,1441,1688,46.05
Vayne,TahmKench,2792,1542,1250,55.23
Vayne,Jinx,7316,3449,3867,47.14
Vayne,Zoe,1043,583,460,55.9
Vayne,Nami,2477,1242,1235,50.14
Vayne,Singed,779,408,371,52.37
Vayne,Graves,1519,785,734,51.68
Vayne,Fizz,1476,777,699,52.64
Vayne,Ziggs,932,476,456,51.07
Vayne,Pantheon,4111,2131,1980,51.84
Vayne,Aatrox,2315,1240,1075,53.56
Vayne,Gwen,1244,659,585,52.97
Vayne,Syndra,1697,849,848,50.03
Vayne,Ashe,4923,2485,2438,50.48
Vayne,Lulu,2937,1478,1459,50.32
Vayne,Gangplank,1230,607,623,49.35
Vayne,Karthus,727,407,320,55.98
Vayne,Aurora,2000,1045,955,52.25
Vayne,Ezreal,6454,3425,3029,53.07
Vayne,Senna,1871,882,989,47.14
Vayne,Kennen,839,467,372,55.66
Vayne,Kayn,3701,1931,1770,52.18
Vayne,Naafiri,852,398,454,46.71
Vayne,Xayah,1410,694,716,49.22
Vayne,Soraka,1403,666,737,47.47
Vayne,Mordekaiser,3822,2004,1818,52.43
Vayne,Ahri,3303,1686,1617,51.04
Vayne,Nunu,1407,690,717,49.04
Vayne,Yasuo,5203,2631,2572,50.57
Vayne,Zyra,2028,1001,1027,49.36
Vayne,Garen,4591,2388,2203,52.01
Vayne,Zed,2824,1473,1351,52.16
Vayne,Talon,1404,780,624,55.56
Vayne,Milio,1384,708,676,51.16
Vayne,Fiora,888,488,400,54.95
Vayne,Elise,1841,936,905,50.84
Vayne,Yone,4273,2288,1985,53.55
Vayne,Tristana,2663,1360,1303,51.07
Vayne,Sivir,1285,735,550,57.2
Vayne,Katarina,1831,1006,825,54.94
Vayne,Kayle,1772,895,877,50.51
Vayne,Ekko,2445,1184,1261,48.43
Vayne,Irelia,2140,1046,1094,48.88
Vayne,Yuumi,2100,1078,1022,51.33
Vayne,Nasus,2059,1023,1036,49.68
Vayne,Galio,2237,1167,1070,52.17
Vayne,Smolder,1825,966,859,52.93
Vayne,JarvanIV,1522,739,783,48.55
Vayne,Amumu,2541,1263,1278,49.7
Vayne,Velkoz,1595,810,785,50.78
Vayne,Poppy,1790,932,858,52.07
Vayne,Warwick,3896,1872,2024,48.05
Vayne,Leona,2381,1225,1156,51.45
Vayne,MissFortune,5991,3041,2950,50.76
Vayne,Darius,5531,2870,2661,51.89
Vayne,Sion,2195,1160,1035,52.85
Vayne,Draven,1492,776,716,52.01
Vayne,Sett,3758,1970,1788,52.42
Vayne,Volibear,2959,1580,1379,53.4
Vayne,KogMaw,858,384,474,44.76
Vayne,Seraphine,1963,969,994,49.36
Vayne,Leblanc,1266,685,581,54.11
Vayne,Samira,2123,1053,1070,49.6
Vayne,Shen,1866,984,882,52.73
Vayne,KSante,1426,861,565,60.38
Vayne,Evelynn,953,487,466,51.1
Vayne,MasterYi,3175,1752,1423,55.18
Vayne,Shaco,2333,1182,1151,50.66
Vayne,Kaisa,4746,2515,2231,52.99
Vayne,Braum,1480,737,743,49.8
Vayne,Diana,3857,1988,1869,51.54
Vayne,Briar,1931,915,1016,47.38
Vayne,Caitlyn,6630,3267,3363,49.28
Vayne,Akali,2709,1509,1200,55.7
Vayne,Brand,1733,911,822,52.57
Vayne,Sona,801,375,426,46.82
Vayne,Illaoi,1246,612,634,49.12
Vayne,Vex,1374,690,684,50.22
Vayne,Ornn,1231,620,611,50.37
Vayne,Nautilus,3220,1619,1601,50.28
Vayne,Orianna,1170,622,548,53.16
Vayne,Morgana,2964,1542,1422,52.02
Vayne,Veigar,2653,1319,1334,49.72
Vayne,Rammus,989,517,472,52.28
Vayne,Zeri,1120,622,498,55.54
Vayne,Taric,610,313,297,51.31
Vayne,Nilah,938,490,448,52.24
Vayne,Swain,2658,1349,1309,50.75
Vayne,Sylas,3079,1654,1425,53.72
Vayne,Viego,3405,1742,1663,51.16
Vayne,Xerath,2135,1089,1046,51.01
Vayne,Twitch,2204,1127,1077,51.13
Vayne,Jax,2161,1084,1077,50.16
Vayne,DrMundo,1606,821,785,51.12
Vayne,Vi,2458,1211,1247,49.27
Vayne,Varus,2194,1132,1062,51.6
Vayne,Kalista,756,435,321,57.54
Vayne,Zilean,733,356,377,48.57
Vayne,MonkeyKing,1757,860,897,48.95
Vayne,Lucian,1935,1006,929,51.99
Vayne,Bard,722,329,393,45.57
Vayne,Rengar,890,527,363,59.21
Vayne,Shyvana,695,358,337,51.51
Vayne,Karma,2725,1486,1239,54.53
Vayne,LeeSin,3256,1755,1501,53.9
Vayne,Cassiopeia,777,363,414,46.72
Vayne,Alistar,1278,624,654,48.83
Vayne,Gragas,1559,829,730,53.18
Vayne,Maokai,1361,694,667,50.99
Vayne,Kled,496,272,224,54.84
Vayne,Kindred,1156,602,554,52.08
Vayne,Azir,802,403,399,50.25
Vayne,Neeko,1303,730,573,56.02
Vayne,Rakan,1182,586,596,49.58
Vayne,Pyke,2118,1128,990,53.26
Vayne,Ryze,980,498,482,50.82
Vayne,Hwei,1721,856,865,49.74
Vayne,FiddleSticks,1261,601,660,47.66
Vayne,Malzahar,2478,1183,1295,47.74
Vayne,Vladimir,1808,950,858,52.54
Vayne,Sejuani,1213,589,624,48.56
Vayne,Viktor,2322,1151,1171,49.57
Vayne,XinZhao,1727,899,828,52.06
Vayne,Trundle,1502,757,745,50.4
Vayne,Tryndamere,1362,712,650,52.28
Vayne,Aphelios,1464,723,741,49.39
Vayne,Yorick,2459,1120,1339,45.55
Vayne,Camille,960,489,471,50.94
Vayne,Chogath,3615,1933,1682,53.47
Vayne,Janna,873,413,460,47.31
Vayne,Kassadin,639,300,339,46.95
Vayne,Renata,447,211,236,47.2
Vayne,Belveth,587,294,293,50.09
Vayne,Skarner,836,458,378,54.78
Vayne,Qiyana,738,380,358,51.49
Vayne,Zac,1268,605,663,47.71
Vayne,Riven,1174,557,617,47.44
Vayne,Lillia,1459,769,690,52.71
Vayne,Corki,1127,605,522,53.68
Vayne,Malphite,3159,1497,1662,47.39
Vayne,Gnar,1029,559,470,54.32
Vayne,AurelionSol,1078,559,519,51.86
Vayne,Quinn,968,478,490,49.38
Vayne,Blitzcrank,1814,953,861,52.54
Vayne,Nocturne,2955,1512,1443,51.17
Vayne,Heimerdinger,1186,538,648,45.36
Vayne,Lissandra,852,399,453,46.83
Vayne,Udyr,958,524,434,54.7
Vayne,Ambessa,1621,924,697,57
Vayne,Rell,1329,632,697,47.55
Vayne,Urgot,1232,619,613,50.24
Vayne,Hecarim,1046,528,518,50.48
Vayne,Olaf,568,284,284,50
Vayne,Ivern,411,199,212,48.42
Vayne,Thresh,3549,1776,1773,50.04
Vayne,Annie,762,351,411,46.06
Vayne,Jayce,1096,588,508,53.65
Vayne,Taliyah,665,303,362,45.56
Vayne,Anivia,767,351,416,45.76
Vayne,RekSai,268,171,97,63.81
Vayne,Akshan,996,520,476,52.21
Vayne,Nidalee,639,349,290,54.62
Vayne,Rumble,649,309,340,47.61
Vayne,TwistedFate,864,444,420,51.39
Khazix,Aurora,1008,549,459,54.46
Khazix,Volibear,1207,545,662,45.15
Khazix,Yasuo,2225,1025,1200,46.07
Khazix,Vayne,1282,611,671,47.66
Khazix,Shaco,1117,553,564,49.51
Khazix,Poppy,706,335,371,47.45
Khazix,Diana,1714,819,895,47.78
Khazix,Anivia,343,171,172,49.85
Khazix,Caitlyn,3113,1472,1641,47.29
Khazix,Thresh,1536,754,782,49.09
Khazix,Garen,1789,791,998,44.21
Khazix,FiddleSticks,662,358,304,54.08
Khazix,Lux,3093,1432,1661,46.3
Khazix,Brand,895,408,487,45.59
Khazix,Darius,2054,967,1087,47.08
Khazix,Amumu,1086,448,638,41.25
Khazix,MissFortune,2383,1043,1340,43.77
Khazix,Swain,1030,529,501,51.36
Khazix,Aatrox,1162,589,573,50.69
Khazix,Viego,1710,786,924,45.96
Khazix,Sylas,1427,698,729,48.91
Khazix,Ashe,2238,989,1249,44.19
Khazix,Blitzcrank,841,433,408,51.49
Khazix,Evelynn,555,258,297,46.49
Khazix,Katarina,991,498,493,50.25
Khazix,Nocturne,1356,597,759,44.03
Khazix,Neeko,636,316,320,49.69
Khazix,Sejuani,469,203,266,43.28
Khazix,LeeSin,1793,864,929,48.19
Khazix,Irelia,974,492,482,50.51
Khazix,Twitch,979,474,505,48.42
Khazix,Pyke,1101,523,578,47.5
Khazix,Sion,867,370,497,42.68
Khazix,Ezreal,2732,1384,1348,50.66
Khazix,Zilean,369,186,183,50.41
Khazix,Belveth,249,127,122,51
Khazix,Hwei,927,437,490,47.14
Khazix,Jinx,2766,1236,1530,44.69
Khazix,TahmKench,882,428,454,48.53
Khazix,Jax,965,448,517,46.42
Khazix,Cassiopeia,342,176,166,51.46
Khazix,Milio,648,317,331,48.92
Khazix,Ambessa,653,339,314,51.91
Khazix,Rammus,326,138,188,42.33
Khazix,Kled,214,105,109,49.07
Khazix,Kayn,1714,866,848,50.53
Khazix,AurelionSol,409,204,205,49.88
Khazix,Tristana,1100,586,514,53.27
Khazix,Ekko,1008,468,540,46.43
Khazix,Pantheon,1868,935,933,50.05
Khazix,Azir,442,212,230,47.96
Khazix,Ziggs,403,190,213,47.15
Khazix,Lulu,1420,669,751,47.11
Khazix,KSante,584,313,271,53.6
Khazix,Riven,547,263,284,48.08
Khazix,Jhin,2263,1110,1153,49.05
Khazix,Yuumi,907,425,482,46.86
Khazix,Sett,1599,698,901,43.65
Khazix,Rengar,682,355,327,52.05
Khazix,Kennen,376,183,193,48.67
Khazix,Morgana,1382,614,768,44.43
Khazix,Warwick,1555,700,855,45.02
Khazix,Kaisa,1926,1015,911,52.7
Khazix,Jayce,519,245,274,47.21
Khazix,Senna,794,424,370,53.4
Khazix,Chogath,1298,543,755,41.83
Khazix,Galio,907,403,504,44.43
Khazix,Shen,734,346,388,47.14
Khazix,Aphelios,751,363,388,48.34
Khazix,Illaoi,501,243,258,48.5
Khazix,Taliyah,289,102,187,35.29
Khazix,Sivir,569,267,302,46.92
Khazix,Velkoz,658,341,317,51.82
Khazix,Mordekaiser,1602,770,832,48.06
Khazix,Akali,1138,589,549,51.76
Khazix,Seraphine,1018,507,511,49.8
Khazix,Briar,901,394,507,43.73
Khazix,Janna,401,214,187,53.37
Khazix,Gangplank,592,313,279,52.87
Khazix,Qiyana,342,155,187,45.32
Khazix,Zoe,524,270,254,51.53
Khazix,Sona,428,187,241,43.69
Khazix,Fizz,618,278,340,44.98
Khazix,Samira,906,390,516,43.05
Khazix,Ornn,437,183,254,41.88
Khazix,Ivern,165,93,72,56.36
Khazix,Nilah,436,185,251,42.43
Khazix,Teemo,1360,610,750,44.85
Khazix,Camille,434,240,194,55.3
Khazix,Leblanc,633,312,321,49.29
Khazix,Singed,360,155,205,43.06
Khazix,XinZhao,712,349,363,49.02
Khazix,Yorick,1009,399,610,39.54
Khazix,KogMaw,313,143,170,45.69
Khazix,Nautilus,1146,519,627,45.29
Khazix,DrMundo,673,304,369,45.17
Khazix,Nasus,798,374,424,46.87
Khazix,Mel,2254,1119,1135,49.65
Khazix,Vladimir,693,339,354,48.92
Khazix,MasterYi,1463,703,760,48.05
Khazix,Lucian,835,426,409,51.02
Khazix,Maokai,429,213,216,49.65
Khazix,Rakan,556,299,257,53.78
Khazix,Renekton,512,302,210,58.98
Khazix,Veigar,1080,520,560,48.15
Khazix,Ahri,1507,688,819,45.65
Khazix,Talon,812,422,390,51.97
Khazix,Yone,2131,1074,1057,50.4
Khazix,Zac,513,219,294,42.69
Khazix,Hecarim,472,242,230,51.27
Khazix,Renata,202,71,131,35.15
Khazix,Zed,1323,687,636,51.93
Khazix,Trundle,610,272,338,44.59
Khazix,Xayah,533,236,297,44.28
Khazix,Lillia,710,375,335,52.82
Khazix,Vex,608,270,338,44.41
Khazix,Karma,1459,673,786,46.13
Khazix,Gnar,480,237,243,49.38
Khazix,Vi,1009,508,501,50.35
Khazix,Zeri,567,243,324,42.86
Khazix,Kayle,758,307,451,40.5
Khazix,Varus,1056,529,527,50.09
Khazix,Malphite,1058,462,596,43.67
Khazix,Udyr,365,209,156,57.26
Khazix,Bard,286,115,171,40.21
Khazix,Zyra,962,463,499,48.13
Khazix,Urgot,561,200,361,35.65
Khazix,JarvanIV,608,292,316,48.03
Khazix,MonkeyKing,814,326,488,40.05
Khazix,Nami,1273,626,647,49.18
Khazix,Heimerdinger,572,235,337,41.08
Khazix,Nunu,624,313,311,50.16
Khazix,Gwen,567,278,289,49.03
Khazix,Naafiri,355,155,200,43.66
Khazix,Braum,559,228,331,40.79
Khazix,Ryze,358,186,172,51.96
Khazix,Draven,625,305,320,48.8
Khazix,Smolder,797,393,404,49.31
Khazix,Lissandra,384,167,217,43.49
Khazix,Rell,589,337,252,57.22
Khazix,Gragas,686,379,307,55.25
Khazix,Leona,771,357,414,46.3
Khazix,Orianna,589,248,341,42.11
Khazix,Corki,466,264,202,56.65
Khazix,Shyvana,282,102,180,36.17
Khazix,Soraka,597,278,319,46.57
Khazix,TwistedFate,430,230,200,53.49
Khazix,Annie,360,201,159,55.83
Khazix,Kassadin,218,101,117,46.33
Khazix,Graves,889,465,424,52.31
Khazix,Quinn,431,222,209,51.51
Khazix,Skarner,330,114,216,34.55
Khazix,Kalista,325,159,166,48.92
Khazix,Malzahar,1028,466,562,45.33
Khazix,Alistar,420,199,221,47.38
Khazix,Tryndamere,565,308,257,54.51
Khazix,Nidalee,437,239,198,54.69
Khazix,Fiora,498,219,279,43.98
Khazix,Olaf,244,118,126,48.36
Khazix,Karthus,359,212,147,59.05
Khazix,Xerath,964,418,546,43.36
Khazix,Syndra,754,367,387,48.67
Khazix,Rumble,288,151,137,52.43
Khazix,Kindred,551,272,279,49.36
Khazix,Elise,840,429,411,51.07
Khazix,Akshan,389,165,224,42.42
Khazix,Viktor,1085,528,557,48.66
Khazix,Taric,233,74,159,31.76
Khazix,RekSai,106,74,32,69.81
Chogath,Gwen,1820,968,852,53.19
Chogath,Vi,2514,1295,1219,51.51
Chogath,Zed,2605,1405,1200,53.93
Chogath,Jhin,5035,2423,2612,48.12
Chogath,Soraka,1528,834,694,54.58
Chogath,Sett,4501,2077,2424,46.15
Chogath,AurelionSol,1191,581,610,48.78
Chogath,Corki,948,530,418,55.91
Chogath,Milio,1409,696,713,49.4
Chogath,Zac,1219,644,575,52.83
Chogath,Yasuo,5155,2630,2525,51.02
Chogath,MissFortune,5992,2971,3021,49.58
Chogath,Lux,6407,3188,3219,49.76
Chogath,Darius,5078,2605,2473,51.3
Chogath,Viego,3360,1729,1631,51.46
Chogath,Nautilus,2881,1503,1378,52.17
Chogath,Garen,4387,2322,2065,52.93
Chogath,Malzahar,2621,1260,1361,48.07
Chogath,Seraphine,2050,996,1054,48.59
Chogath,Zilean,833,400,433,48.02
Chogath,Olaf,703,361,342,51.35
Chogath,LeeSin,3317,1835,1482,55.32
Chogath,Diana,3896,2058,1838,52.82
Chogath,Karma,2653,1335,1318,50.32
Chogath,Teemo,3659,1984,1675,54.22
Chogath,Poppy,1477,826,651,55.92
Chogath,Akali,2658,1494,1164,56.21
Chogath,Caitlyn,6704,3535,3169,52.73
Chogath,Leona,2369,1160,1209,48.97
Chogath,Tryndamere,1482,756,726,51.01
Chogath,Velkoz,1584,763,821,48.17
Chogath,Zeri,1136,616,520,54.23
Chogath,Thresh,3613,1883,1730,52.12
Chogath,Ivern,507,259,248,51.08
Chogath,Neeko,1322,721,601,54.54
Chogath,Senna,2048,997,1051,48.68
Chogath,Yorick,2920,1501,1419,51.4
Chogath,Volibear,3083,1593,1490,51.67
Chogath,Cassiopeia,886,493,393,55.64
Chogath,Rell,1240,652,588,52.58
Chogath,Rammus,748,430,318,57.49
Chogath,Jinx,7007,3392,3615,48.41
Chogath,TahmKench,2592,1319,1273,50.89
Chogath,DrMundo,1906,874,1032,45.86
Chogath,Trundle,1581,776,805,49.08
Chogath,Ahri,3498,1732,1766,49.51
Chogath,Ashe,4906,2571,2335,52.41
Chogath,Nami,2793,1425,1368,51.02
Chogath,Camille,840,440,400,52.38
Chogath,Pantheon,4008,2142,1866,53.44
Chogath,Xayah,1380,761,619,55.14
Chogath,Yuumi,2156,1109,1047,51.44
Chogath,Warwick,4083,2012,2071,49.28
Chogath,Irelia,2035,1043,992,51.25
Chogath,Samira,1920,1107,813,57.66
Chogath,Malphite,2418,1337,1081,55.29
Chogath,MonkeyKing,1485,793,692,53.4
Chogath,Sylas,3368,1730,1638,51.37
Chogath,Swain,2782,1375,1407,49.42
Chogath,Fiora,1290,693,597,53.72
Chogath,Amumu,2945,1430,1515,48.56
Chogath,Vladimir,1743,910,833,52.21
Chogath,Varus,2176,1134,1042,52.11
Chogath,Janna,897,444,453,49.5
Chogath,Graves,1616,852,764,52.72
Chogath,Kassadin,524,267,257,50.95
Chogath,Kalista,747,412,335,55.15
Chogath,Maokai,1203,600,603,49.88
Chogath,Shaco,2276,1249,1027,54.88
Chogath,Viktor,2131,1059,1072,49.69
Chogath,Mordekaiser,3923,1771,2152,45.14
Chogath,Morgana,3117,1559,1558,50.02
Chogath,Kaisa,3945,1991,1954,50.47
Chogath,Qiyana,662,358,304,54.08
Chogath,Mel,5748,3063,2685,53.29
Chogath,KSante,1118,600,518,53.67
Chogath,Azir,966,517,449,53.52
Chogath,Pyke,2325,1298,1027,55.83
Chogath,Veigar,2900,1541,1359,53.14
Chogath,Ekko,2368,1199,1169,50.63
Chogath,Lucian,1637,835,802,51.01
Chogath,XinZhao,1597,839,758,52.54
Chogath,Leblanc,1333,760,573,57.01
Chogath,Aatrox,2261,1156,1105,51.13
Chogath,Ryze,885,455,430,51.41
Chogath,Jax,2121,1182,939,55.73
Chogath,Galio,2095,1077,1018,51.41
Chogath,Yone,4905,2496,2409,50.89
Chogath,Urgot,1305,604,701,46.28
Chogath,Lillia,1689,737,952,43.64
Chogath,Lulu,3166,1659,1507,52.4
Chogath,Briar,2040,1000,1040,49.02
Chogath,Ambessa,1388,740,648,53.31
Chogath,Elise,1939,1034,905,53.33
Chogath,Shen,1729,886,843,51.24
Chogath,Brand,1893,954,939,50.4
Chogath,FiddleSticks,1325,715,610,53.96
Chogath,Braum,1534,762,772,49.67
Chogath,Aphelios,1458,763,695,52.33
Chogath,Kayle,1889,882,1007,46.69
Chogath,Khazix,1298,755,543,58.17
Chogath,Blitzcrank,1903,1074,829,56.44
Chogath,Nilah,1035,521,514,50.34
Chogath,Kled,492,241,251,48.98
Chogath,Vex,1450,800,650,55.17
Chogath,Nocturne,2917,1358,1559,46.55
Chogath,Draven,1303,691,612,53.03
Chogath,Riven,1057,597,460,56.48
Chogath,Twitch,2162,1190,972,55.04
Chogath,Skarner,731,340,391,46.51
Chogath,Aurora,2021,1079,942,53.39
Chogath,KogMaw,886,440,446,49.66
Chogath,MasterYi,3223,1684,1539,52.25
Chogath,Orianna,1089,553,536,50.78
Chogath,Rengar,856,516,340,60.28
Chogath,Smolder,1842,908,934,49.29
Chogath,Kayn,3732,1807,1925,48.42
Chogath,Talon,1496,781,715,52.21
Chogath,Ezreal,5339,2891,2448,54.15
Chogath,Katarina,1990,1146,844,57.59
Chogath,RekSai,310,204,106,65.81
Chogath,Ziggs,1029,502,527,48.79
Chogath,Nasus,1792,934,858,52.12
Chogath,Evelynn,1067,593,474,55.58
Chogath,Zyra,2012,960,1052,47.71
Chogath,Hecarim,979,464,515,47.4
Chogath,Illaoi,1364,657,707,48.17
Chogath,Zoe,985,500,485,50.76
Chogath,Hwei,1770,839,931,47.4
Chogath,Shyvana,604,309,295,51.16
Chogath,Nunu,1543,821,722,53.21
Chogath,Nidalee,641,372,269,58.03
Chogath,Tristana,2543,1328,1215,52.22
Chogath,Fizz,1383,673,710,48.66
Chogath,Lissandra,824,453,371,54.98
Chogath,Gragas,1463,784,679,53.59
Chogath,Sivir,1354,683,671,50.44
Chogath,Syndra,1584,824,760,52.02
Chogath,Gangplank,1223,643,580,52.58
Chogath,Vayne,3615,1682,1933,46.53
Chogath,Heimerdinger,1228,638,590,51.95
Chogath,Sejuani,1083,530,553,48.94
Chogath,Kennen,888,458,430,51.58
Chogath,Rumble,551,271,280,49.18
Chogath,Udyr,1052,537,515,51.05
Chogath,Alistar,1069,577,492,53.98
Chogath,Rakan,1275,651,624,51.06
Chogath,Sona,799,389,410,48.69
Chogath,Singed,699,332,367,47.5
Chogath,Kindred,1100,605,495,55
Chogath,Anivia,896,403,493,44.98
Chogath,Karthus,693,372,321,53.68
Chogath,Taliyah,647,287,360,44.36
Chogath,Gnar,1135,542,593,47.75
Chogath,Quinn,834,395,439,47.36
Chogath,JarvanIV,1582,750,832,47.41
Chogath,Xerath,2005,1013,992,50.52
Chogath,Belveth,588,279,309,47.45
Chogath,Jayce,1104,590,514,53.44
Chogath,Renekton,1116,598,518,53.58
Chogath,TwistedFate,875,468,407,53.49
Chogath,Renata,465,233,232,50.11
Chogath,Taric,684,313,371,45.76
Chogath,Sion,2180,1121,1059,51.42
Chogath,Ornn,1226,598,628,48.78
Chogath,Bard,862,391,471,45.36
Chogath,Naafiri,1018,522,496,51.28
Chogath,Akshan,1014,492,522,48.52
Chogath,Annie,839,458,381,54.59
Gangplank,Gwen,538,274,264,50.93
Gangplank,Vi,1065,533,532,50.05
Gangplank,Zed,1184,627,557,52.96
Gangplank,Jhin,2146,1069,1077,49.81
Gangplank,Soraka,653,319,334,48.85
Gangplank,Garen,1596,705,891,44.17
Gangplank,Briar,827,414,413,50.06
Gangplank,Caitlyn,2864,1400,1464,48.88
Gangplank,Morgana,1222,624,598,51.06
Gangplank,DrMundo,572,263,309,45.98
Gangplank,Lillia,531,295,236,55.56
Gangplank,Viktor,995,590,405,59.3
Gangplank,Pyke,907,429,478,47.3
Gangplank,Yorick,886,455,431,51.35
Gangplank,FiddleSticks,505,213,292,42.18
Gangplank,Draven,635,321,314,50.55
Gangplank,Smolder,638,352,286,55.17
Gangplank,Nautilus,1163,574,589,49.36
Gangplank,TahmKench,739,360,379,48.71
Gangplank,Malphite,1095,526,569,48.04
Gangplank,Yasuo,2196,1084,1112,49.36
Gangplank,Aphelios,656,320,336,48.78
Gangplank,TwistedFate,535,240,295,44.86
Gangplank,LeeSin,1894,935,959,49.37
Gangplank,Yone,1902,944,958,49.63
Gangplank,MissFortune,2145,1045,1100,48.72
Gangplank,Mel,2008,956,1052,47.61
Gangplank,Riven,534,271,263,50.75
Gangplank,Kayn,1414,691,723,48.87
Gangplank,Ahri,1554,813,741,52.32
Gangplank,Jinx,2825,1358,1467,48.07
Gangplank,Irelia,1035,514,521,49.66
Gangplank,Pantheon,1745,852,893,48.83
Gangplank,Kassadin,222,117,105,52.7
Gangplank,Yuumi,1017,500,517,49.16
Gangplank,Fiora,445,204,241,45.84
Gangplank,Syndra,617,302,315,48.95
Gangplank,Vayne,1230,623,607,50.65
Gangplank,Mordekaiser,1211,532,679,43.93
Gangplank,Warwick,1312,617,695,47.03
Gangplank,Akali,1023,520,503,50.83
Gangplank,Velkoz,640,320,320,50
Gangplank,Vladimir,765,355,410,46.41
Gangplank,Diana,1703,830,873,48.74
Gangplank,Karma,1493,743,750,49.77
Gangplank,Shen,793,423,370,53.34
Gangplank,Teemo,1349,668,681,49.52
Gangplank,Twitch,836,410,426,49.04
Gangplank,Ornn,505,255,250,50.5
Gangplank,Amumu,984,426,558,43.29
Gangplank,Katarina,889,459,430,51.63
Gangplank,Senna,748,353,395,47.19
Gangplank,Graves,859,433,426,50.41
Gangplank,Aurora,876,421,455,48.06
Gangplank,Nilah,390,195,195,50
Gangplank,Hwei,696,326,370,46.84
Gangplank,Olaf,261,109,152,41.76
Gangplank,Aatrox,1561,775,786,49.65
Gangplank,Braum,600,290,310,48.33
Gangplank,Varus,956,460,496,48.12
Gangplank,Janna,415,185,230,44.58
Gangplank,Gnar,528,278,250,52.65
Gangplank,Shaco,1034,563,471,54.45
Gangplank,Xayah,552,246,306,44.57
Gangplank,Seraphine,797,431,366,54.08
Gangplank,Darius,2149,1086,1063,50.54
Gangplank,XinZhao,817,348,469,42.59
Gangplank,Zeri,501,225,276,44.91
Gangplank,Taric,259,105,154,40.54
Gangplank,Rengar,369,167,202,45.26
Gangplank,Thresh,1539,676,863,43.92
Gangplank,Kalista,333,154,179,46.25
Gangplank,Nasus,699,397,302,56.8
Gangplank,Jayce,712,374,338,52.53
Gangplank,JarvanIV,707,343,364,48.51
Gangplank,Poppy,633,311,322,49.13
Gangplank,Gragas,761,355,406,46.65
Gangplank,Annie,370,191,179,51.62
Gangplank,Ekko,950,487,463,51.26
Gangplank,Akshan,422,211,211,50
Gangplank,Nami,1165,559,606,47.98
Gangplank,Veigar,942,455,487,48.3
Gangplank,Malzahar,1129,500,629,44.29
Gangplank,Camille,389,242,147,62.21
Gangplank,Evelynn,375,204,171,54.4
Gangplank,Taliyah,282,130,152,46.1
Gangplank,Sett,1390,589,801,42.37
Gangplank,Ashe,2239,1131,1108,50.51
Gangplank,Viego,1558,775,783,49.74
Gangplank,Khazix,592,279,313,47.13
Gangplank,Nocturne,1434,623,811,43.44
Gangplank,Xerath,973,485,488,49.85
Gangplank,Lux,2583,1321,1262,51.14
Gangplank,Sona,346,149,197,43.06
Gangplank,Renekton,456,257,199,56.36
Gangplank,Leblanc,671,327,344,48.73
Gangplank,MonkeyKing,811,417,394,51.42
Gangplank,Jax,956,460,496,48.12
Gangplank,Talon,672,349,323,51.93
Gangplank,Volibear,1064,512,552,48.12
Gangplank,Singed,322,172,150,53.42
Gangplank,Sejuani,543,259,284,47.7
Gangplank,Sylas,1618,840,778,51.92
Gangplank,Illaoi,396,183,213,46.21
Gangplank,Belveth,298,145,153,48.66
Gangplank,Orianna,518,239,279,46.14
Gangplank,Alistar,506,284,222,56.13
Gangplank,Nidalee,295,154,141,52.2
Gangplank,Ziggs,410,180,230,43.9
Gangplank,Blitzcrank,870,406,464,46.67
Gangplank,Kled,216,112,104,51.85
Gangplank,MasterYi,1130,548,582,48.5
Gangplank,Zyra,921,424,497,46.04
Gangplank,Kaisa,1918,980,938,51.09
Gangplank,Urgot,554,245,309,44.22
Gangplank,Swain,968,450,518,46.49
Gangplank,Rammus,297,134,163,45.12
Gangplank,Zilean,340,158,182,46.47
Gangplank,Hecarim,464,229,235,49.35
Gangplank,Milio,725,329,396,45.38
Gangplank,Kayle,775,328,447,42.32
Gangplank,Chogath,1223,580,643,47.42
Gangplank,Vex,530,277,253,52.26
Gangplank,Skarner,350,178,172,50.86
Gangplank,Renata,211,98,113,46.45
Gangplank,Zac,511,270,241,52.84
Gangplank,Rell,518,317,201,61.2
Gangplank,Leona,843,456,387,54.09
Gangplank,Tryndamere,581,298,283,51.29
Gangplank,Sivir,614,295,319,48.05
Gangplank,Rumble,321,158,163,49.22
Gangplank,Ivern,175,93,82,53.14
Gangplank,Ryze,435,173,262,39.77
Gangplank,Shyvana,295,149,146,50.51
Gangplank,Elise,915,445,470,48.63
Gangplank,Rakan,419,217,202,51.79
Gangplank,Kennen,371,195,176,52.56
Gangplank,Ezreal,2806,1433,1373,51.07
Gangplank,Qiyana,280,140,140,50
Gangplank,Lulu,1505,782,723,51.96
Gangplank,Sion,855,415,440,48.54
Gangplank,KSante,560,297,263,53.04
Gangplank,Tristana,1087,505,582,46.46
Gangplank,Fizz,584,280,304,47.95
Gangplank,Lucian,889,488,401,54.89
Gangplank,Galio,1000,437,563,43.7
Gangplank,Neeko,574,266,308,46.34
Gangplank,Quinn,443,241,202,54.4
Gangplank,Kindred,475,218,257,45.89
Gangplank,Zoe,470,251,219,53.4
Gangplank,Cassiopeia,321,137,184,42.68
Gangplank,Lissandra,343,194,149,56.56
Gangplank,KogMaw,340,163,177,47.94
Gangplank,Brand,630,270,360,42.86
Gangplank,Maokai,457,239,218,52.3
Gangplank,Nunu,524,268,256,51.15
Gangplank,Anivia,423,187,236,44.21
Gangplank,Samira,716,358,358,50
Gangplank,Naafiri,341,151,190,44.28
Gangplank,Corki,415,195,220,46.99
Gangplank,Bard,347,199,148,57.35
Gangplank,Ambessa,681,379,302,55.65
Gangplank,Udyr,367,185,182,50.41
Gangplank,Karthus,344,178,166,51.74
Gangplank,Heimerdinger,484,229,255,47.31
Gangplank,Trundle,537,233,304,43.39
Gangplank,AurelionSol,415,181,234,43.61
Gangplank,Azir,455,209,246,45.93
Gangplank,RekSai,212,95,117,44.81
Gwen,Chogath,1820,852,968,46.81
Gwen,Kayn,1489,712,777,47.82
Gwen,Gangplank,538,264,274,49.07
Gwen,Ezreal,2450,1211,1239,49.43
Gwen,Hwei,811,381,430,46.98
Gwen,Jax,953,416,537,43.65
Gwen,Nidalee,303,166,137,54.79
Gwen,Ahri,1575,766,809,48.63
Gwen,Jhin,2012,1014,998,50.4
Gwen,Senna,834,376,458,45.08
Gwen,Sett,1822,771,1051,42.32
Gwen,Taliyah,310,144,166,46.45
Gwen,Cassiopeia,336,187,149,55.65
Gwen,Kaisa,1774,880,894,49.61
Gwen,Neeko,638,314,324,49.22
Gwen,Irelia,878,406,472,46.24
Gwen,Diana,1904,876,1028,46.01
Gwen,Lux,2672,1248,1424,46.71
Gwen,Tristana,1160,583,577,50.26
Gwen,Mel,2206,1092,1114,49.5
Gwen,XinZhao,739,358,381,48.44
Gwen,Katarina,987,468,519,47.42
Gwen,Teemo,1176,493,683,41.92
Gwen,Vayne,1244,585,659,47.03
Gwen,TwistedFate,361,153,208,42.38
Gwen,Riven,635,322,313,50.71
Gwen,Nocturne,1364,682,682,50
Gwen,Zoe,514,279,235,54.28
Gwen,Jinx,2917,1352,1565,46.35
Gwen,Lulu,1229,596,633,48.49
Gwen,Camille,389,197,192,50.64
Gwen,Warwick,1883,838,1045,44.5
Gwen,MissFortune,2595,1142,1453,44.01
Gwen,Zyra,918,433,485,47.17
Gwen,LeeSin,1359,660,699,48.57
Gwen,Lucian,812,402,410,49.51
Gwen,Xerath,852,417,435,48.94
Gwen,Elise,788,439,349,55.71
Gwen,Galio,1038,486,552,46.82
Gwen,Twitch,970,474,496,48.87
Gwen,Soraka,703,330,373,46.94
Gwen,Illaoi,601,278,323,46.26
Gwen,Aurora,915,433,482,47.32
Gwen,Vi,1043,444,599,42.57
Gwen,Briar,828,392,436,47.34
Gwen,Janna,420,165,255,39.29
Gwen,Gnar,417,171,246,41.01
Gwen,Yasuo,1974,963,1011,48.78
Gwen,Zeri,477,198,279,41.51
Gwen,Taric,267,119,148,44.57
Gwen,Ambessa,676,330,346,48.82
Gwen,Sejuani,560,291,269,51.96
Gwen,Veigar,1100,476,624,43.27
Gwen,Nilah,427,211,216,49.41
Gwen,Karma,1106,489,617,44.21
Gwen,Lillia,577,293,284,50.78
Gwen,Pyke,1066,574,492,53.85
Gwen,Viego,1422,632,790,44.44
Gwen,Mordekaiser,1552,723,829,46.59
Gwen,Akali,1186,489,697,41.23
Gwen,Sylas,1353,686,667,50.7
Gwen,Draven,587,303,284,51.62
Gwen,Velkoz,689,335,354,48.62
Gwen,KSante,745,387,358,51.95
Gwen,Belveth,321,166,155,51.71
Gwen,Yuumi,1030,491,539,47.67
Gwen,Rengar,456,251,205,55.04
Gwen,Ashe,2079,955,1124,45.94
Gwen,Kennen,279,168,111,60.22
Gwen,Shaco,888,409,479,46.06
Gwen,Brand,713,320,393,44.88
Gwen,Sona,426,210,216,49.3
Gwen,FiddleSticks,538,243,295,45.17
Gwen,Yone,2006,1009,997,50.3
Gwen,Caitlyn,2730,1316,1414,48.21
Gwen,Tryndamere,616,289,327,46.92
Gwen,Zed,1030,490,540,47.57
Gwen,Blitzcrank,816,423,393,51.84
Gwen,Garen,1888,812,1076,43.01
Gwen,Trundle,650,305,345,46.92
Gwen,Samira,936,460,476,49.15
Gwen,Heimerdinger,502,221,281,44.02
Gwen,Alistar,410,206,204,50.24
Gwen,Orianna,463,231,232,49.89
Gwen,Pantheon,1755,872,883,49.69
Gwen,AurelionSol,475,192,283,40.42
Gwen,MasterYi,1300,592,708,45.54
Gwen,Fizz,621,286,335,46.05
Gwen,Nami,1193,527,666,44.17
Gwen,Malzahar,1122,501,621,44.65
Gwen,Seraphine,997,462,535,46.34
Gwen,Rammus,399,225,174,56.39
Gwen,Aatrox,1012,511,501,50.49
Gwen,Leona,952,485,467,50.95
Gwen,Nasus,812,377,435,46.43
Gwen,Xayah,586,258,328,44.03
Gwen,Rakan,522,191,331,36.59
Gwen,Morgana,1484,609,875,41.04
Gwen,Jayce,382,204,178,53.4
Gwen,Zilean,295,174,121,58.98
Gwen,Graves,717,335,382,46.72
Gwen,Hecarim,396,200,196,50.51
Gwen,Nautilus,1334,665,669,49.85
Gwen,Nunu,734,377,357,51.36
Gwen,Darius,1984,990,994,49.9
Gwen,Yorick,1281,531,750,41.45
Gwen,Zac,621,292,329,47.02
Gwen,Malphite,1225,585,640,47.76
Gwen,Evelynn,432,231,201,53.47
Gwen,Sion,1200,576,624,48
Gwen,Ekko,1022,511,511,50
Gwen,Varus,973,508,465,52.21
Gwen,Leblanc,539,269,270,49.91
Gwen,Vladimir,783,333,450,42.53
Gwen,Ivern,240,121,119,50.42
Gwen,Smolder,769,375,394,48.76
Gwen,Milio,684,340,344,49.71
Gwen,Renekton,544,277,267,50.92
Gwen,Karthus,298,138,160,46.31
Gwen,Braum,591,257,334,43.49
Gwen,Fiora,613,341,272,55.63
Gwen,Corki,448,229,219,51.12
Gwen,Khazix,567,289,278,50.97
Gwen,TahmKench,1159,544,615,46.94
Gwen,Amumu,1231,583,648,47.36
Gwen,Volibear,1280,568,712,44.38
Gwen,Gragas,609,281,328,46.14
Gwen,Naafiri,426,193,233,45.31
Gwen,Akshan,379,179,200,47.23
Gwen,Aphelios,658,327,331,49.7
Gwen,Sivir,594,244,350,41.08
Gwen,Qiyana,332,155,177,46.69
Gwen,Annie,374,207,167,55.35
Gwen,JarvanIV,647,270,377,41.73
Gwen,Ziggs,438,235,203,53.65
Gwen,Shyvana,343,180,163,52.48
Gwen,Ryze,376,187,189,49.73
Gwen,Rell,598,293,305,49
Gwen,Talon,571,285,286,49.91
Gwen,Thresh,1588,701,887,44.14
Gwen,MonkeyKing,719,354,365,49.24
Gwen,Swain,1057,487,570,46.07
Gwen,Ornn,634,310,324,48.9
Gwen,Lissandra,354,187,167,52.82
Gwen,Udyr,517,246,271,47.58
Gwen,Vex,626,296,330,47.28
Gwen,Renata,228,113,115,49.56
Gwen,KogMaw,400,196,204,49
Gwen,Urgot,549,306,243,55.74
Gwen,Kindred,561,299,262,53.3
Gwen,Shen,906,438,468,48.34
Gwen,Skarner,323,162,161,50.15
Gwen,Syndra,594,256,338,43.1
Gwen,Anivia,376,173,203,46.01
Gwen,Kayle,743,341,402,45.9
Gwen,Viktor,1047,503,544,48.04
Gwen,Rumble,253,121,132,47.83
Gwen,Maokai,483,215,268,44.51
Gwen,DrMundo,799,447,352,55.94
Gwen,Bard,405,190,215,46.91
Gwen,Poppy,715,277,438,38.74
Gwen,Kalista,319,173,146,54.23
Gwen,Azir,364,203,161,55.77
Gwen,Kassadin,256,105,151,41.02
Gwen,Olaf,224,119,105,53.13
Gwen,Singed,311,111,200,35.69
Gwen,Kled,225,100,125,44.44
Gwen,Quinn,408,162,246,39.71
Gwen,RekSai,161,85,76,52.8
Vi,Chogath,2514,1219,1295,48.49
Vi,Kayn,2888,1453,1435,50.31
Vi,Gangplank,1065,532,533,49.95
Vi,Ezreal,5117,2666,2451,52.1
Vi,Hwei,1392,713,679,51.22
Vi,Braum,1157,559,598,48.31
Vi,XinZhao,1496,721,775,48.2
Vi,Lux,4630,2349,2281,50.73
Vi,Taliyah,636,333,303,52.36
Vi,Yorick,1618,716,902,44.25
Vi,Seraphine,1480,735,745,49.66
Vi,Sivir,1127,542,585,48.09
Vi,Xerath,1947,945,1002,48.54
Vi,KSante,1138,591,547,51.93
Vi,Warwick,3050,1413,1637,46.33
Vi,Diana,3199,1482,1717,46.33
Vi,Ashe,3936,1949,1987,49.52
Vi,Corki,775,417,358,53.81
Vi,Akali,1994,1061,933,53.21
Vi,Akshan,689,351,338,50.94
Vi,TahmKench,1685,869,816,51.57
Vi,Urgot,946,489,457,51.69
Vi,LeeSin,3843,2042,1801,53.14
Vi,TwistedFate,772,396,376,51.3
Vi,Yasuo,3959,1957,2002,49.43
Vi,Rakan,949,485,464,51.11
Vi,Kennen,586,291,295,49.66
Vi,Kaisa,3312,1681,1631,50.75
Vi,Caitlyn,5313,2682,2631,50.48
Vi,Malphite,1923,955,968,49.66
Vi,Vex,1110,567,543,51.08
Vi,Twitch,1420,796,624,56.06
Vi,Yuumi,1840,967,873,52.55
Vi,Gwen,1043,599,444,57.43
Vi,Udyr,726,400,326,55.1
Vi,Orianna,890,469,421,52.7
Vi,Nautilus,2220,1150,1070,51.8
Vi,Darius,3756,1884,1872,50.16
Vi,Zed,2218,1205,1013,54.33
Vi,Syndra,1256,620,636,49.36
Vi,Senna,1421,621,800,43.7
Vi,Sejuani,970,472,498,48.66
Vi,Heimerdinger,923,453,470,49.08
Vi,Jinx,5238,2557,2681,48.82
Vi,Zilean,594,288,306,48.48
Vi,Garen,3246,1515,1731,46.67
Vi,Aurora,1510,771,739,51.06
Vi,MissFortune,4385,2039,2346,46.5
Vi,Rell,1068,515,553,48.22
Vi,Fiora,837,442,395,52.81
Vi,Sylas,2909,1471,1438,50.57
Vi,Ornn,925,459,466,49.62
Vi,Shaco,1797,965,832,53.7
Vi,Annie,621,326,295,52.5
Vi,Volibear,2283,1136,1147,49.76
Vi,Teemo,2276,1050,1226,46.13
Vi,Tristana,1895,982,913,51.82
Vi,Thresh,2837,1364,1473,48.08
Vi,Yone,3700,1937,1763,52.35
Vi,Rengar,608,363,245,59.7
Vi,KogMaw,670,338,332,50.45
Vi,Zoe,928,528,400,56.9
Vi,Anivia,660,344,316,52.12
Vi,JarvanIV,1322,656,666,49.62
Vi,Katarina,1477,794,683,53.76
Vi,Aatrox,1887,974,913,51.62
Vi,FiddleSticks,939,473,466,50.37
Vi,Jayce,1146,526,620,45.9
Vi,Gragas,1337,700,637,52.36
Vi,Hecarim,816,415,401,50.86
Vi,Jhin,3586,1728,1858,48.19
Vi,Velkoz,1116,503,613,45.07
Vi,Irelia,1702,790,912,46.42
Vi,Zyra,1753,817,936,46.61
Vi,Morgana,2459,1202,1257,48.88
Vi,Rammus,563,251,312,44.58
Vi,Alistar,897,449,448,50.06
Vi,Kassadin,445,192,253,43.15
Vi,Milio,1140,535,605,46.93
Vi,Veigar,1949,938,1011,48.13
Vi,Kayle,1391,638,753,45.87
Vi,Amumu,1861,869,992,46.7
Vi,AurelionSol,859,426,433,49.59
Vi,Smolder,1318,646,672,49.01
Vi,Janna,663,291,372,43.89
Vi,Pantheon,3248,1657,1591,51.02
Vi,Lillia,1216,608,608,50
Vi,Lulu,2468,1254,1214,50.81
Vi,Jax,1740,852,888,48.97
Vi,Nilah,692,316,376,45.66
Vi,Karma,2454,1269,1185,51.71
Vi,Ziggs,762,350,412,45.93
Vi,Pyke,1691,911,780,53.87
Vi,Mordekaiser,2612,1323,1289,50.65
Vi,Qiyana,478,273,205,57.11
Vi,Brand,1371,697,674,50.84
Vi,Poppy,1411,695,716,49.26
Vi,Viego,2843,1311,1532,46.11
Vi,Mel,4084,2075,2009,50.81
Vi,Gnar,862,440,422,51.04
Vi,Malzahar,1870,920,950,49.2
Vi,Ryze,639,313,326,48.98
Vi,Viktor,1746,864,882,49.48
Vi,Quinn,724,378,346,52.21
Vi,Xayah,1312,616,696,46.95
Vi,Neeko,1036,504,532,48.65
Vi,Talon,1270,662,608,52.13
Vi,Leona,1711,942,769,55.06
Vi,Shen,1255,677,578,53.94
Vi,Nami,2026,957,1069,47.24
Vi,Zac,1096,553,543,50.46
Vi,Camille,736,356,380,48.37
Vi,Leblanc,1184,629,555,53.13
Vi,Renata,459,236,223,51.42
Vi,Vayne,2458,1247,1211,50.73
Vi,Zeri,1050,581,469,55.33
Vi,MasterYi,2467,1300,1167,52.7
Vi,Fizz,1081,548,533,50.69
Vi,Ivern,351,182,169,51.85
Vi,Sett,3098,1564,1534,50.48
Vi,Samira,1344,698,646,51.93
Vi,Briar,1594,723,871,45.36
Vi,Lucian,1566,785,781,50.13
Vi,Ambessa,1382,717,665,51.88
Vi,Graves,1265,607,658,47.98
Vi,Nunu,1163,566,597,48.67
Vi,Sion,1560,778,782,49.87
Vi,Skarner,637,369,268,57.93
Vi,Vladimir,1138,481,657,42.27
Vi,Aphelios,1080,520,560,48.15
Vi,Nidalee,573,333,240,58.12
Vi,Ekko,1682,790,892,46.97
Vi,Cassiopeia,638,312,326,48.9
Vi,Tryndamere,1001,478,523,47.75
Vi,Swain,1997,897,1100,44.92
Vi,Khazix,1009,501,508,49.65
Vi,Ahri,2774,1348,1426,48.59
Vi,Soraka,1099,470,629,42.77
Vi,Renekton,1079,485,594,44.95
Vi,Nocturne,2567,1117,1450,43.51
Vi,Elise,1369,685,684,50.04
Vi,Illaoi,960,479,481,49.9
Vi,Riven,908,503,405,55.4
Vi,Blitzcrank,1419,694,725,48.91
Vi,Kled,355,165,190,46.48
Vi,Varus,1767,917,850,51.9
Vi,Galio,1860,835,1025,44.89
Vi,Belveth,441,235,206,53.29
Vi,Evelynn,800,472,328,59
Vi,Taric,439,211,228,48.06
Vi,Naafiri,663,361,302,54.45
Vi,Singed,495,213,282,43.03
Vi,Lissandra,621,309,312,49.76
Vi,Kindred,884,474,410,53.62
Vi,Nasus,1463,802,661,54.82
Vi,DrMundo,1104,547,557,49.55
Vi,Karthus,537,263,274,48.98
Vi,Olaf,539,259,280,48.05
Vi,Draven,1007,492,515,48.86
Vi,Maokai,807,436,371,54.03
Vi,Sona,521,248,273,47.6
Vi,RekSai,247,110,137,44.53
Vi,Bard,567,279,288,49.21
Vi,Azir,713,418,295,58.63
Vi,MonkeyKing,1508,771,737,51.13
Vi,Trundle,1051,488,563,46.43
Vi,Rumble,575,250,325,43.48
Vi,Kalista,558,275,283,49.28
Vi,Shyvana,461,189,272,41
Soraka,Chogath,1528,694,834,45.42
Soraka,Kayn,1743,946,797,54.27
Soraka,Gangplank,653,334,319,51.15
Soraka,Ezreal,2404,1290,1114,53.66
Soraka,Hwei,784,368,416,46.94
Soraka,Zed,1263,623,640,49.33
Soraka,Sona,398,219,179,55.03
Soraka,Kaisa,1935,1069,866,55.25
Soraka,Amumu,1146,565,581,49.3
Soraka,Sett,1693,867,826,51.21
Soraka,Vladimir,675,395,280,58.52
Soraka,Kindred,575,326,249,56.7
Soraka,Aphelios,763,401,362,52.56
Soraka,Pyke,1096,630,466,57.48
Soraka,Teemo,1534,800,734,52.15
Soraka,LeeSin,1565,856,709,54.7
Soraka,Yone,2022,1090,932,53.91
Soraka,Jhin,2454,1290,1164,52.57
Soraka,Nami,1509,734,775,48.64
Soraka,Annie,412,191,221,46.36
Soraka,Aatrox,1080,563,517,52.13
Soraka,MissFortune,2527,1230,1297,48.67
Soraka,Diana,1619,750,869,46.32
Soraka,Akali,1322,748,574,56.58
Soraka,Caitlyn,2950,1588,1362,53.83
Soraka,Karma,1481,741,740,50.03
Soraka,Shaco,1239,673,566,54.32
Soraka,Anivia,432,195,237,45.14
Soraka,Lux,3218,1662,1556,51.65
Soraka,Morgana,1489,722,767,48.49
Soraka,Volibear,1360,725,635,53.31
Soraka,Ambessa,759,363,396,47.83
Soraka,Smolder,777,394,383,50.71
Soraka,Swain,1233,622,611,50.45
Soraka,Vayne,1403,737,666,52.53
Soraka,Briar,1020,525,495,51.47
Soraka,Mel,2749,1462,1287,53.18
Soraka,Yuumi,1121,544,577,48.53
Soraka,Shen,858,416,442,48.48
Soraka,Twitch,1021,512,509,50.15
Soraka,Nautilus,1271,679,592,53.42
Soraka,Pantheon,1901,1072,829,56.39
Soraka,Warwick,1803,908,895,50.36
Soraka,Leblanc,583,303,280,51.97
Soraka,Leona,1045,583,462,55.79
Soraka,Gwen,703,373,330,53.06
Soraka,Tristana,1153,649,504,56.29
Soraka,Poppy,632,354,278,56.01
Soraka,KSante,618,356,262,57.61
Soraka,Viego,1614,784,830,48.57
Soraka,Vex,626,268,358,42.81
Soraka,Jinx,3181,1598,1583,50.24
Soraka,Senna,965,466,499,48.29
Soraka,Ivern,207,105,102,50.72
Soraka,Yasuo,2237,1133,1104,50.65
Soraka,Evelynn,477,264,213,55.35
Soraka,Brand,804,416,388,51.74
Soraka,Udyr,431,225,206,52.2
Soraka,Orianna,503,262,241,52.09
Soraka,Ashe,2253,1200,1053,53.26
Soraka,Irelia,1064,528,536,49.62
Soraka,Quinn,469,246,223,52.45
Soraka,Thresh,1563,758,805,48.5
Soraka,Renekton,599,320,279,53.42
Soraka,Lillia,661,295,366,44.63
Soraka,Xerath,1012,552,460,54.55
Soraka,Rammus,439,233,206,53.08
Soraka,Garen,1774,853,921,48.08
Soraka,Talon,727,440,287,60.52
Soraka,Milio,855,419,436,49.01
Soraka,Singed,343,163,180,47.52
Soraka,Galio,972,515,457,52.98
Soraka,Riven,603,304,299,50.41
Soraka,TwistedFate,417,211,206,50.6
Soraka,Fiora,485,238,247,49.07
Soraka,Varus,1069,538,531,50.33
Soraka,Janna,395,188,207,47.59
Soraka,MonkeyKing,797,431,366,54.08
Soraka,Katarina,968,481,487,49.69
Soraka,Darius,2245,1142,1103,50.87
Soraka,Jax,1085,527,558,48.57
Soraka,Ekko,1167,580,587,49.7
Soraka,Shyvana,310,154,156,49.68
Soraka,Taliyah,292,178,114,60.96
Soraka,Corki,491,290,201,59.06
Soraka,Elise,888,434,454,48.87
Soraka,Seraphine,1051,503,548,47.86
Soraka,Mordekaiser,1675,837,838,49.97
Soraka,Qiyana,320,180,140,56.25
Soraka,Neeko,602,302,300,50.17
Soraka,Sylas,1447,725,722,50.1
Soraka,Gragas,686,426,260,62.1
Soraka,Nilah,425,167,258,39.29
Soraka,Kennen,396,191,205,48.23
Soraka,Malzahar,1170,614,556,52.48
Soraka,Yorick,1171,532,639,45.43
Soraka,Lulu,1851,921,930,49.76
Soraka,Viktor,1037,543,494,52.36
Soraka,Lucian,826,441,385,53.39
Soraka,Braum,633,336,297,53.08
Soraka,Ornn,557,280,277,50.27
Soraka,Graves,730,418,312,57.26
Soraka,MasterYi,1300,598,702,46
Soraka,Draven,749,388,361,51.8
Soraka,Hecarim,520,247,273,47.5
Soraka,Ahri,1599,852,747,53.28
Soraka,Blitzcrank,831,452,379,54.39
Soraka,Zeri,576,296,280,51.39
Soraka,Kayle,834,428,406,51.32
Soraka,Kled,216,103,113,47.69
Soraka,Veigar,1292,662,630,51.24
Soraka,Sejuani,528,315,213,59.66
Soraka,Sion,950,465,485,48.95
Soraka,Alistar,442,213,229,48.19
Soraka,Malphite,1022,495,527,48.43
Soraka,Nunu,789,378,411,47.91
Soraka,Nasus,956,482,474,50.42
Soraka,Rell,584,281,303,48.12
Soraka,KogMaw,421,220,201,52.26
Soraka,Aurora,917,492,425,53.65
Soraka,Bard,428,260,168,60.75
Soraka,TahmKench,960,513,447,53.44
Soraka,Rengar,415,203,212,48.92
Soraka,Cassiopeia,367,197,170,53.68
Soraka,Naafiri,452,236,216,52.21
Soraka,Trundle,720,343,377,47.64
Soraka,Zilean,389,195,194,50.13
Soraka,Velkoz,756,379,377,50.13
Soraka,Ziggs,498,244,254,49
Soraka,Azir,376,179,197,47.61
Soraka,Sivir,551,254,297,46.1
Soraka,Zyra,1073,554,519,51.63
Soraka,Vi,1099,629,470,57.23
Soraka,Zoe,502,259,243,51.59
Soraka,DrMundo,584,295,289,50.51
Soraka,FiddleSticks,580,270,310,46.55
Soraka,Camille,474,231,243,48.73
Soraka,Olaf,281,143,138,50.89
Soraka,Gnar,468,243,225,51.92
Soraka,Syndra,767,431,336,56.19
Soraka,Nidalee,352,194,158,55.11
Soraka,Fizz,604,302,302,50
Soraka,Taric,246,130,116,52.85
Soraka,Karthus,412,227,185,55.1
Soraka,Illaoi,589,297,292,50.42
Soraka,AurelionSol,509,227,282,44.6
Soraka,JarvanIV,773,401,372,51.88
Soraka,Heimerdinger,562,276,286,49.11
Soraka,Samira,891,415,476,46.58
Soraka,Rumble,283,147,136,51.94
Soraka,Khazix,597,319,278,53.43
Soraka,Tryndamere,701,381,320,54.35
Soraka,Kassadin,271,144,127,53.14
Soraka,Maokai,458,245,213,53.49
Soraka,Nocturne,1331,666,665,50.04
Soraka,Renata,210,115,95,54.76
Soraka,XinZhao,714,408,306,57.14
Soraka,Akshan,447,216,231,48.32
Soraka,Ryze,381,197,184,51.71
Soraka,Xayah,624,321,303,51.44
Soraka,Rakan,520,277,243,53.27
Soraka,Zac,554,260,294,46.93
Soraka,Jayce,589,268,321,45.5
Soraka,Lissandra,367,183,184,49.86
Soraka,Skarner,336,182,154,54.17
Soraka,Urgot,519,231,288,44.51
Soraka,Kalista,432,224,208,51.85
Soraka,RekSai,150,84,66,56
Soraka,Belveth,338,176,162,52.07
Jax,Vladimir,1264,606,658,47.94
Jax,Viego,2600,1325,1275,50.96
Jax,Velkoz,1004,448,556,44.62
Jax,Kaisa,3091,1584,1507,51.25
Jax,Karma,2038,932,1106,45.73
Jax,Irelia,1856,846,1010,45.58
Jax,Zed,2010,975,1035,48.51
Jax,Galio,1766,795,971,45.02
Jax,MissFortune,4278,1980,2298,46.28
Jax,TahmKench,1472,751,721,51.02
Jax,Gwen,953,537,416,56.35
Jax,Talon,985,481,504,48.83
Jax,Yone,4025,2140,1885,53.17
Jax,Taric,365,139,226,38.08
Jax,Poppy,1305,667,638,51.11
Jax,Warwick,3071,1447,1624,47.12
Jax,Katarina,1373,679,694,49.45
Jax,Twitch,1453,744,709,51.2
Jax,Morgana,2311,1145,1166,49.55
Jax,Briar,1458,784,674,53.77
Jax,Vex,1029,557,472,54.13
Jax,Jinx,4978,2389,2589,47.99
Jax,Milio,1132,539,593,47.61
Jax,Akali,2081,999,1082,48.01
Jax,Rammus,618,245,373,39.64
Jax,Yasuo,4120,2043,2077,49.59
Jax,Zyra,1549,691,858,44.61
Jax,Ryze,535,288,247,53.83
Jax,Nunu,1128,521,607,46.19
Jax,Ahri,2506,1270,1236,50.68
Jax,Lucian,1303,669,634,51.34
Jax,Alistar,806,423,383,52.48
Jax,Ornn,737,362,375,49.12
Jax,TwistedFate,732,380,352,51.91
Jax,Caitlyn,4836,2254,2582,46.61
Jax,Pantheon,3003,1501,1502,49.98
Jax,Leblanc,1136,540,596,47.54
Jax,Aphelios,998,573,425,57.41
Jax,Leona,1606,801,805,49.88
Jax,Yorick,1749,788,961,45.05
Jax,Draven,901,487,414,54.05
Jax,KogMaw,685,355,330,51.82
Jax,Yuumi,1467,756,711,51.53
Jax,Tryndamere,1182,585,597,49.49
Jax,Sylas,2615,1377,1238,52.66
Jax,Taliyah,533,252,281,47.28
Jax,Jhin,3637,1693,1944,46.55
Jax,Senna,1440,742,698,51.53
Jax,Malphite,1694,827,867,48.82
Jax,Diana,3006,1480,1526,49.23
Jax,Lux,4915,2365,2550,48.12
Jax,Fiora,815,366,449,44.91
Jax,Shaco,1664,814,850,48.92
Jax,Fizz,1089,516,573,47.38
Jax,Tristana,1937,988,949,51.01
Jax,Rakan,838,385,453,45.94
Jax,Sett,2978,1431,1547,48.05
Jax,FiddleSticks,906,432,474,47.68
Jax,Samira,1405,688,717,48.97
Jax,Neeko,1028,516,512,50.19
Jax,Volibear,2164,1074,1090,49.63
Jax,LeeSin,2831,1476,1355,52.14
Jax,Malzahar,1723,776,947,45.04
Jax,Pyke,1968,1008,960,51.22
Jax,Renekton,967,449,518,46.43
Jax,Khazix,965,517,448,53.58
Jax,Quinn,595,258,337,43.36
Jax,Kayn,2821,1407,1414,49.88
Jax,Aatrox,1713,912,801,53.24
Jax,Mel,3639,1839,1800,50.54
Jax,Ezreal,4327,2280,2047,52.69
Jax,Elise,1346,669,677,49.7
Jax,Shen,1257,629,628,50.04
Jax,Amumu,1814,803,1011,44.27
Jax,Ziggs,746,331,415,44.37
Jax,Jayce,890,450,440,50.56
Jax,Swain,1949,854,1095,43.82
Jax,Sion,1234,614,620,49.76
Jax,XinZhao,1286,620,666,48.21
Jax,Soraka,1085,558,527,51.43
Jax,Singed,549,285,264,51.91
Jax,Garen,3867,1684,2183,43.55
Jax,Zilean,595,277,318,46.55
Jax,Rengar,645,404,241,62.64
Jax,Aurora,1429,742,687,51.92
Jax,Seraphine,1565,754,811,48.18
Jax,Gragas,1432,704,728,49.16
Jax,Veigar,2050,1002,1048,48.88
Jax,Kalista,615,292,323,47.48
Jax,Trundle,1269,663,606,52.25
Jax,MonkeyKing,1214,598,616,49.26
Jax,Darius,3404,1728,1676,50.76
Jax,Chogath,2121,939,1182,44.27
Jax,Evelynn,778,394,384,50.64
Jax,Nocturne,2322,1118,1204,48.15
Jax,Thresh,2470,1180,1290,47.77
Jax,Olaf,502,265,237,52.79
Jax,Ashe,3757,1850,1907,49.24
Jax,AurelionSol,802,380,422,47.38
Jax,Nilah,634,342,292,53.94
Jax,Riven,817,422,395,51.65
Jax,Syndra,1134,544,590,47.97
Jax,MasterYi,2847,1434,1413,50.37
Jax,Xayah,1023,526,497,51.42
Jax,Hwei,1259,666,593,52.9
Jax,Illaoi,1045,447,598,42.78
Jax,Mordekaiser,2617,1236,1381,47.23
Jax,Nami,1699,825,874,48.56
Jax,Nautilus,1983,974,1009,49.12
Jax,Viktor,1567,788,779,50.29
Jax,DrMundo,1209,572,637,47.31
Jax,Rell,966,492,474,50.93
Jax,Zoe,753,405,348,53.78
Jax,Udyr,618,328,290,53.07
Jax,Lulu,2440,1127,1313,46.19
Jax,Teemo,2294,1090,1204,47.52
Jax,Lillia,1169,538,631,46.02
Jax,Graves,1327,681,646,51.32
Jax,Kennen,511,283,228,55.38
Jax,Brand,1343,661,682,49.22
Jax,Maokai,805,415,390,51.55
Jax,Camille,766,439,327,57.31
Jax,Skarner,613,295,318,48.12
Jax,Vi,1740,888,852,51.03
Jax,Xerath,1597,771,826,48.28
Jax,Kayle,1489,750,739,50.37
Jax,Ekko,1664,895,769,53.79
Jax,Urgot,857,405,452,47.26
Jax,Ivern,246,106,140,43.09
Jax,Kassadin,393,223,170,56.74
Jax,Gangplank,956,496,460,51.88
Jax,Hecarim,780,380,400,48.72
Jax,Annie,633,316,317,49.92
Jax,Vayne,2161,1077,1084,49.84
Jax,Corki,736,387,349,52.58
Jax,Ambessa,1300,615,685,47.31
Jax,Varus,1698,900,798,53
Jax,Heimerdinger,820,360,460,43.9
Jax,Azir,662,332,330,50.15
Jax,Akshan,654,332,322,50.76
Jax,Sona,651,310,341,47.62
Jax,Qiyana,512,303,209,59.18
Jax,Braum,1115,544,571,48.79
Jax,Cassiopeia,549,266,283,48.45
Jax,KSante,888,456,432,51.35
Jax,Janna,573,246,327,42.93
Jax,Naafiri,604,279,325,46.19
Jax,Blitzcrank,1402,745,657,53.14
Jax,Nasus,1249,593,656,47.48
Jax,Gnar,568,294,274,51.76
Jax,Sejuani,770,354,416,45.97
Jax,Smolder,1303,662,641,50.81
Jax,Karthus,458,251,207,54.8
Jax,Kled,320,163,157,50.94
Jax,Anivia,620,292,328,47.1
Jax,Kindred,852,427,425,50.12
Jax,Nidalee,532,279,253,52.44
Jax,JarvanIV,1013,525,488,51.83
Jax,Zac,936,502,434,53.63
Jax,Belveth,372,208,164,55.91
Jax,Renata,410,238,172,58.05
Jax,Sivir,1114,529,585,47.49
Jax,Shyvana,417,192,225,46.04
Jax,Orianna,845,427,418,50.53
Jax,Rumble,454,234,220,51.54
Jax,Zeri,834,470,364,56.35
Jax,RekSai,235,84,151,35.74
Jax,Lissandra,530,261,269,49.25
Jax,Bard,593,297,296,50.08
XinZhao,Vladimir,847,430,417,50.77
XinZhao,Viego,2000,971,1029,48.55
XinZhao,Velkoz,811,428,383,52.77
XinZhao,Kaisa,2353,1211,1142,51.47
XinZhao,Karma,1738,766,972,44.07
XinZhao,Garen,2220,991,1229,44.64
XinZhao,Kayn,1785,893,892,50.03
XinZhao,Lux,3222,1685,1537,52.3
XinZhao,Caitlyn,3486,1802,1684,51.69
XinZhao,Thresh,2058,1017,1041,49.42
XinZhao,Aatrox,1368,703,665,51.39
XinZhao,Gwen,739,381,358,51.56
XinZhao,Syndra,868,384,484,44.24
XinZhao,Ashe,2932,1522,1410,51.91
XinZhao,Lulu,1906,982,924,51.52
XinZhao,Sett,2056,1018,1038,49.51
XinZhao,Vi,1496,775,721,51.8
XinZhao,AurelionSol,457,222,235,48.58
XinZhao,Corki,541,302,239,55.82
XinZhao,Milio,670,315,355,47.01
XinZhao,Riven,685,413,272,60.29
XinZhao,LeeSin,2675,1428,1247,53.38
XinZhao,Mel,2783,1560,1223,56.05
XinZhao,Tristana,1349,639,710,47.37
XinZhao,Zac,777,412,365,53.02
XinZhao,FiddleSticks,759,372,387,49.01
XinZhao,Brand,937,533,404,56.88
XinZhao,Jinx,3459,1694,1765,48.97
XinZhao,Amumu,1396,657,739,47.06
XinZhao,Akshan,403,228,175,56.58
XinZhao,Ezreal,3464,1815,1649,52.4
XinZhao,Darius,2644,1384,1260,52.34
XinZhao,Ivern,191,103,88,53.93
XinZhao,Katarina,1108,581,527,52.44
XinZhao,Pantheon,2250,1165,1085,51.78
XinZhao,Rammus,403,188,215,46.65
XinZhao,Yasuo,2628,1369,1259,52.09
XinZhao,Pyke,1159,655,504,56.51
XinZhao,Yone,2587,1401,1186,54.16
XinZhao,Sivir,661,328,333,49.62
XinZhao,Ahri,1996,1006,990,50.4
XinZhao,Diana,2245,1134,1111,50.51
XinZhao,Jhin,2630,1438,1192,54.68
XinZhao,RekSai,209,106,103,50.72
XinZhao,Gangplank,817,469,348,57.41
XinZhao,Leona,1229,623,606,50.69
XinZhao,Jax,1286,666,620,51.79
XinZhao,Ekko,1274,652,622,51.18
XinZhao,Trundle,836,406,430,48.56
XinZhao,Aphelios,721,329,392,45.63
XinZhao,Ambessa,983,572,411,58.19
XinZhao,Veigar,1288,705,583,54.74
XinZhao,MissFortune,3010,1538,1472,51.1
XinZhao,Nautilus,1543,722,821,46.79
XinZhao,Chogath,1597,758,839,47.46
XinZhao,Zed,1614,875,739,54.21
XinZhao,Galio,1185,626,559,52.83
XinZhao,Maokai,600,278,322,46.33
XinZhao,Fiora,539,287,252,53.25
XinZhao,DrMundo,659,322,337,48.86
XinZhao,Poppy,909,470,439,51.71
XinZhao,TwistedFate,448,245,203,54.69
XinZhao,Samira,973,471,502,48.41
XinZhao,Seraphine,1176,643,533,54.68
XinZhao,Urgot,603,219,384,36.32
XinZhao,Sylas,1917,920,997,47.99
XinZhao,Rakan,633,373,260,58.93
XinZhao,Shen,844,373,471,44.19
XinZhao,Kassadin,244,141,103,57.79
XinZhao,Blitzcrank,1063,513,550,48.26
XinZhao,MonkeyKing,980,362,618,36.94
XinZhao,Vex,796,370,426,46.48
XinZhao,TahmKench,1063,528,535,49.67
XinZhao,Cassiopeia,483,274,209,56.73
XinZhao,Lucian,1050,566,484,53.9
XinZhao,Nami,1428,740,688,51.82
XinZhao,Ornn,600,277,323,46.17
XinZhao,Aurora,1084,554,530,51.11
XinZhao,Xayah,798,418,380,52.38
XinZhao,Kayle,825,414,411,50.18
XinZhao,Volibear,1480,728,752,49.19
XinZhao,Shaco,1148,586,562,51.05
XinZhao,Yorick,1452,717,735,49.38
XinZhao,Irelia,1094,575,519,52.56
XinZhao,MasterYi,1592,830,762,52.14
XinZhao,Akali,1562,794,768,50.83
XinZhao,Lillia,771,415,356,53.83
XinZhao,Khazix,712,363,349,50.98
XinZhao,Varus,1284,690,594,53.74
XinZhao,Mordekaiser,1854,870,984,46.93
XinZhao,Warwick,1950,955,995,48.97
XinZhao,Naafiri,448,232,216,51.79
XinZhao,Ziggs,586,273,313,46.59
XinZhao,Kled,220,110,110,50
XinZhao,Gnar,611,349,262,57.12
XinZhao,Nasus,996,494,502,49.6
XinZhao,Ryze,469,248,221,52.88
XinZhao,Bard,385,218,167,56.62
XinZhao,Viktor,1238,664,574,53.63
XinZhao,Draven,709,394,315,55.57
XinZhao,Elise,1076,568,508,52.79
XinZhao,Udyr,486,274,212,56.38
XinZhao,Vayne,1727,825,902,47.77
XinZhao,Anivia,433,224,209,51.73
XinZhao,Sejuani,683,318,365,46.56
XinZhao,Braum,831,425,406,51.14
XinZhao,Kennen,340,158,182,46.47
XinZhao,Gragas,743,411,332,55.32
XinZhao,Heimerdinger,622,284,338,45.66
XinZhao,Morgana,1576,785,791,49.81
XinZhao,Briar,1023,466,557,45.55
XinZhao,Taric,337,176,161,52.23
XinZhao,Belveth,375,208,167,55.47
XinZhao,Nunu,730,401,329,54.93
XinZhao,Kindred,614,343,271,55.86
XinZhao,Taliyah,400,229,171,57.25
XinZhao,Nilah,484,246,238,50.83
XinZhao,Illaoi,578,322,256,55.71
XinZhao,Xerath,1220,644,576,52.79
XinZhao,Yuumi,1198,608,590,50.75
XinZhao,Smolder,952,537,415,56.41
XinZhao,Twitch,1012,509,503,50.3
XinZhao,Senna,990,494,496,49.9
XinZhao,Malzahar,1369,656,713,47.92
XinZhao,Malphite,1326,677,649,51.06
XinZhao,Nidalee,430,220,210,51.16
XinZhao,Kalista,444,241,203,54.28
XinZhao,Zyra,1164,594,570,51.03
XinZhao,Skarner,469,287,182,61.19
XinZhao,Qiyana,365,179,186,49.04
XinZhao,Evelynn,474,266,208,56.12
XinZhao,Sona,407,222,185,54.55
XinZhao,Singed,362,156,206,43.09
XinZhao,Alistar,591,274,317,46.36
XinZhao,Sion,1023,480,543,46.92
XinZhao,Teemo,1471,716,755,48.67
XinZhao,Nocturne,1868,940,928,50.32
XinZhao,Hwei,885,459,426,51.86
XinZhao,Soraka,714,306,408,42.86
XinZhao,JarvanIV,1016,509,507,50.1
XinZhao,Graves,978,528,450,53.99
XinZhao,Zoe,496,301,195,60.69
XinZhao,Talon,885,504,381,56.95
XinZhao,Lissandra,373,190,183,50.94
XinZhao,Azir,550,265,285,48.18
XinZhao,KSante,826,423,403,51.21
XinZhao,Rell,685,345,340,50.36
XinZhao,Renekton,739,355,384,48.04
XinZhao,Swain,1471,709,762,48.2
XinZhao,Tryndamere,707,339,368,47.95
XinZhao,Rengar,360,202,158,56.11
XinZhao,Shyvana,355,183,172,51.55
XinZhao,Camille,541,298,243,55.08
XinZhao,Zeri,576,303,273,52.6
XinZhao,Jayce,717,362,355,50.49
XinZhao,Fizz,775,392,383,50.58
XinZhao,Olaf,338,187,151,55.33
XinZhao,Leblanc,889,460,429,51.74
XinZhao,KogMaw,428,184,244,42.99
XinZhao,Orianna,636,318,318,50
XinZhao,Annie,455,228,227,50.11
XinZhao,Hecarim,523,302,221,57.74
XinZhao,Karthus,401,205,196,51.12
XinZhao,Quinn,385,218,167,56.62
XinZhao,Janna,406,198,208,48.77
XinZhao,Rumble,360,180,180,50
XinZhao,Zilean,365,180,185,49.32
XinZhao,Neeko,743,386,357,51.95
XinZhao,Renata,229,137,92,59.83
Kennen,Vladimir,495,248,247,50.1
Kennen,Viego,978,438,540,44.79
Kennen,Velkoz,330,125,205,37.88
Kennen,Kaisa,991,521,470,52.57
Kennen,Karma,684,326,358,47.66
Kennen,Aatrox,709,363,346,51.2
Kennen,Sylas,925,417,508,45.08
Kennen,Diana,1005,470,535,46.77
Kennen,Varus,570,336,234,58.95
Kennen,Blitzcrank,495,262,233,52.93
Kennen,Vayne,839,372,467,44.34
Kennen,Briar,421,153,268,36.34
Kennen,Lux,1646,789,857,47.93
Kennen,Mel,1246,590,656,47.35
Kennen,Yuumi,505,207,298,40.99
Kennen,Yone,1106,584,522,52.8
Kennen,Gragas,417,215,202,51.56
Kennen,Irelia,601,306,295,50.92
Kennen,TahmKench,534,237,297,44.38
Kennen,Rell,300,145,155,48.33
Kennen,Mordekaiser,795,369,426,46.42
Kennen,Ahri,926,437,489,47.19
Kennen,Nunu,380,199,181,52.37
Kennen,Yasuo,1298,665,633,51.23
Kennen,Zyra,495,253,242,51.11
Kennen,Viktor,533,244,289,45.78
Kennen,Nocturne,706,360,346,50.99
Kennen,Annie,169,79,90,46.75
Kennen,KogMaw,211,112,99,53.08
Kennen,Alistar,303,137,166,45.21
Kennen,Vi,586,295,291,50.34
Kennen,Amumu,587,243,344,41.4
Kennen,Akshan,185,92,93,49.73
Kennen,Ezreal,1496,751,745,50.2
Kennen,Zed,719,314,405,43.67
Kennen,TwistedFate,185,104,81,56.22
Kennen,Teemo,886,421,465,47.52
Kennen,Maokai,281,104,177,37.01
Kennen,Corki,272,154,118,56.62
Kennen,Taric,126,50,76,39.68
Kennen,Jayce,390,216,174,55.38
Kennen,JarvanIV,352,150,202,42.61
Kennen,Aurora,550,316,234,57.45
Kennen,Caitlyn,1519,699,820,46.02
Kennen,Akali,678,338,340,49.85
Kennen,MasterYi,743,338,405,45.49
Kennen,Swain,658,311,347,47.26
Kennen,MissFortune,1386,589,797,42.5
Kennen,Thresh,923,469,454,50.81
Kennen,Qiyana,150,80,70,53.33
Kennen,Neeko,430,243,187,56.51
Kennen,Malphite,628,298,330,47.45
Kennen,Khazix,376,193,183,51.33
Kennen,Lulu,795,435,360,54.72
Kennen,Gwen,279,111,168,39.78
Kennen,Lillia,374,199,175,53.21
Kennen,Morgana,631,308,323,48.81
Kennen,Soraka,396,205,191,51.77
Kennen,Renekton,287,140,147,48.78
Kennen,Darius,1365,657,708,48.13
Kennen,FiddleSticks,328,170,158,51.83
Kennen,Ryze,215,119,96,55.35
Kennen,Kalista,224,125,99,55.8
Kennen,Janna,282,132,150,46.81
Kennen,Kayn,844,467,377,55.33
Kennen,Xayah,377,196,181,51.99
Kennen,Shaco,583,296,287,50.77
Kennen,Sett,961,444,517,46.2
Kennen,Katarina,456,249,207,54.61
Kennen,Rengar,204,123,81,60.29
Kennen,Seraphine,482,229,253,47.51
Kennen,Urgot,359,156,203,43.45
Kennen,Hwei,479,216,263,45.09
Kennen,Jhin,1252,606,646,48.4
Kennen,Jax,511,228,283,44.62
Kennen,Zoe,261,158,103,60.54
Kennen,Ashe,1190,546,644,45.88
Kennen,Kindred,276,151,125,54.71
Kennen,Galio,522,249,273,47.7
Kennen,Lucian,420,217,203,51.67
Kennen,Yorick,478,202,276,42.26
Kennen,Rammus,149,69,80,46.31
Kennen,Milio,352,153,199,43.47
Kennen,DrMundo,398,144,254,36.18
Kennen,Lissandra,201,120,81,59.7
Kennen,Zilean,190,58,132,30.53
Kennen,Udyr,246,119,127,48.37
Kennen,Orianna,284,133,151,46.83
Kennen,Trundle,304,146,158,48.03
Kennen,Rakan,275,143,132,52
Kennen,Gnar,307,172,135,56.03
Kennen,Cassiopeia,232,116,116,50
Kennen,Nami,593,256,337,43.17
Kennen,Evelynn,303,142,161,46.86
Kennen,Zeri,245,112,133,45.71
Kennen,Leona,463,249,214,53.78
Kennen,Leblanc,376,168,208,44.68
Kennen,Jinx,1497,785,712,52.44
Kennen,Warwick,811,412,399,50.8
Kennen,Sejuani,231,118,113,51.08
Kennen,Malzahar,605,295,310,48.76
Kennen,Ekko,526,238,288,45.25
Kennen,Draven,364,164,200,45.05
Kennen,Nautilus,623,285,338,45.75
Kennen,Riven,343,152,191,44.31
Kennen,Tristana,603,307,296,50.91
Kennen,LeeSin,936,517,419,55.24
Kennen,Xerath,526,268,258,50.95
Kennen,Nasus,524,219,305,41.79
Kennen,XinZhao,340,182,158,53.53
Kennen,Syndra,381,212,169,55.64
Kennen,Nilah,191,94,97,49.21
Kennen,Veigar,676,283,393,41.86
Kennen,Anivia,203,107,96,52.71
Kennen,Poppy,372,206,166,55.38
Kennen,Naafiri,268,141,127,52.61
Kennen,Chogath,888,430,458,48.42
Kennen,Vex,320,151,169,47.19
Kennen,Kayle,401,170,231,42.39
Kennen,Gangplank,371,176,195,47.44
Kennen,Smolder,455,200,255,43.96
Kennen,Samira,499,239,260,47.9
Kennen,Singed,155,73,82,47.1
Kennen,Garen,834,345,489,41.37
Kennen,Hecarim,239,94,145,39.33
Kennen,Fizz,317,151,166,47.63
Kennen,Twitch,502,233,269,46.41
Kennen,Belveth,127,51,76,40.16
Kennen,Senna,451,268,183,59.42
Kennen,Camille,251,144,107,57.37
Kennen,Quinn,238,105,133,44.12
Kennen,Sona,214,95,119,44.39
Kennen,Illaoi,197,102,95,51.78
Kennen,Brand,437,176,261,40.27
Kennen,Braum,334,168,166,50.3
Kennen,Kled,117,48,69,41.03
Kennen,Aphelios,444,201,243,45.27
Kennen,Skarner,164,79,85,48.17
Kennen,Zac,310,118,192,38.06
Kennen,Pyke,546,286,260,52.38
Kennen,Ambessa,391,246,145,62.92
Kennen,Renata,146,53,93,36.3
Kennen,Heimerdinger,331,155,176,46.83
Kennen,Ivern,113,56,57,49.56
Kennen,Karthus,235,112,123,47.66
Kennen,Sion,451,234,217,51.88
Kennen,Kassadin,108,37,71,34.26
Kennen,Azir,183,113,70,61.75
Kennen,Shen,347,154,193,44.38
Kennen,Volibear,547,235,312,42.96
Kennen,Rumble,160,80,80,50
Kennen,Graves,398,225,173,56.53
Kennen,Pantheon,993,470,523,47.33
Kennen,MonkeyKing,415,195,220,46.99
Kennen,RekSai,70,35,35,50
Kennen,Talon,388,170,218,43.81
Kennen,Elise,580,253,327,43.62
Kennen,Tryndamere,283,133,150,47
Kennen,KSante,251,154,97,61.35
Kennen,Olaf,139,53,86,38.13
Kennen,Ziggs,196,89,107,45.41
Kennen,Nidalee,199,121,78,60.8
Kennen,Ornn,277,108,169,38.99
Kennen,AurelionSol,212,105,107,49.53
Kennen,Taliyah,162,79,83,48.77
Kennen,Sivir,300,132,168,44
Kennen,Fiora,197,96,101,48.73
Kennen,Bard,244,117,127,47.95
Kennen,Shyvana,160,76,84,47.5
Kalista,Vladimir,439,210,229,47.84
Kalista,Viego,920,423,497,45.98
Kalista,Velkoz,328,131,197,39.94
Kalista,Kaisa,1069,538,531,50.33
Kalista,Karma,743,367,376,49.39
Kalista,Renekton,379,203,176,53.56
Kalista,JarvanIV,446,224,222,50.22
Kalista,Mel,1501,695,806,46.3
Kalista,Jhin,1307,627,680,47.97
Kalista,Sylas,907,382,525,42.12
Kalista,Mordekaiser,946,475,471,50.21
Kalista,Kindred,349,186,163,53.3
Kalista,TahmKench,600,268,332,44.67
Kalista,Yorick,515,187,328,36.31
Kalista,AurelionSol,302,111,191,36.75
Kalista,Kayn,956,456,500,47.7
Kalista,Singed,190,75,115,39.47
Kalista,Udyr,243,109,134,44.86
Kalista,Malphite,698,314,384,44.99
Kalista,Rell,283,144,139,50.88
Kalista,Jayce,385,208,177,54.03
Kalista,Rengar,277,157,120,56.68
Kalista,Swain,658,288,370,43.77
Kalista,Ezreal,1817,969,848,53.33
Kalista,Sona,205,85,120,41.46
Kalista,Darius,1243,554,689,44.57
Kalista,Trundle,360,154,206,42.78
Kalista,Gragas,393,185,208,47.07
Kalista,Yasuo,1210,671,539,55.45
Kalista,Vex,397,188,209,47.36
Kalista,Diana,1046,517,529,49.43
Kalista,Akali,800,378,422,47.25
Kalista,Jinx,1560,705,855,45.19
Kalista,Lux,1696,808,888,47.64
Kalista,Camille,281,130,151,46.26
Kalista,LeeSin,1015,531,484,52.32
Kalista,Draven,403,184,219,45.66
Kalista,Senna,457,217,240,47.48
Kalista,Chogath,747,335,412,44.85
Kalista,Yuumi,716,383,333,53.49
Kalista,Ornn,296,131,165,44.26
Kalista,Briar,530,209,321,39.43
Kalista,Caitlyn,1677,732,945,43.65
Kalista,Morgana,798,403,395,50.5
Kalista,Ashe,1296,619,677,47.76
Kalista,Alistar,289,137,152,47.4
Kalista,Nocturne,728,343,385,47.12
Kalista,Qiyana,211,128,83,60.66
Kalista,Sett,1039,464,575,44.66
Kalista,Jax,615,323,292,52.52
Kalista,Janna,220,102,118,46.36
Kalista,Gangplank,333,179,154,53.75
Kalista,MissFortune,1576,755,821,47.91
Kalista,Aurora,513,281,232,54.78
Kalista,Aatrox,697,341,356,48.92
Kalista,Rumble,148,76,72,51.35
Kalista,Leona,495,239,256,48.28
Kalista,Urgot,310,126,184,40.65
Kalista,Twitch,522,274,248,52.49
Kalista,Teemo,767,350,417,45.63
Kalista,Pantheon,1031,455,576,44.13
Kalista,Graves,426,211,215,49.53
Kalista,Leblanc,431,187,244,43.39
Kalista,Garen,1162,534,628,45.96
Kalista,Syndra,413,215,198,52.06
Kalista,Rammus,217,96,121,44.24
Kalista,Fizz,308,160,148,51.95
Kalista,Sivir,303,145,158,47.85
Kalista,Shaco,585,275,310,47.01
Kalista,Taliyah,245,115,130,46.94
Kalista,Shen,407,164,243,40.29
Kalista,Volibear,622,260,362,41.8
Kalista,Tristana,663,291,372,43.89
Kalista,Nami,569,243,326,42.71
Kalista,Poppy,545,254,291,46.61
Kalista,Warwick,968,433,535,44.73
Kalista,Illaoi,306,143,163,46.73
Kalista,Nautilus,753,389,364,51.66
Kalista,Kennen,224,99,125,44.2
Kalista,Yone,1276,600,676,47.02
Kalista,Ziggs,285,127,158,44.56
Kalista,Braum,348,151,197,43.39
Kalista,Irelia,608,289,319,47.53
Kalista,MasterYi,785,353,432,44.97
Kalista,Aphelios,494,245,249,49.6
Kalista,Lissandra,256,134,122,52.34
Kalista,Sion,444,196,248,44.14
Kalista,Katarina,566,268,298,47.35
Kalista,Talon,372,198,174,53.23
Kalista,Lillia,380,174,206,45.79
Kalista,Quinn,185,75,110,40.54
Kalista,Xayah,368,162,206,44.02
Kalista,Neeko,382,181,201,47.38
Kalista,Rakan,296,127,169,42.91
Kalista,Kled,149,56,93,37.58
Kalista,Malzahar,656,265,391,40.4
Kalista,Vayne,756,321,435,42.46
Kalista,Thresh,931,436,495,46.83
Kalista,Cassiopeia,242,93,149,38.43
Kalista,Heimerdinger,292,119,173,40.75
Kalista,Samira,509,203,306,39.88
Kalista,Kayle,529,250,279,47.26
Kalista,Ahri,958,414,544,43.22
Kalista,FiddleSticks,276,116,160,42.03
Kalista,Ekko,523,250,273,47.8
Kalista,Xerath,517,236,281,45.65
Kalista,Seraphine,562,266,296,47.33
Kalista,Hwei,504,205,299,40.67
Kalista,Ambessa,434,237,197,54.61
Kalista,Akshan,210,87,123,41.43
Kalista,Zoe,269,111,158,41.26
Kalista,Fiora,266,120,146,45.11
Kalista,Milio,376,181,195,48.14
Kalista,Shyvana,194,87,107,44.85
Kalista,Smolder,589,260,329,44.14
Kalista,Zeri,296,166,130,56.08
Kalista,Blitzcrank,564,227,337,40.25
Kalista,Viktor,584,243,341,41.61
Kalista,Veigar,779,290,489,37.23
Kalista,Nasus,476,221,255,46.43
Kalista,XinZhao,444,203,241,45.72
Kalista,Kassadin,187,92,95,49.2
Kalista,KogMaw,174,84,90,48.28
Kalista,Ryze,250,139,111,55.6
Kalista,Khazix,325,166,159,51.08
Kalista,TwistedFate,230,109,121,47.39
Kalista,Ivern,116,40,76,34.48
Kalista,Orianna,315,151,164,47.94
Kalista,Gnar,291,142,149,48.8
Kalista,MonkeyKing,390,175,215,44.87
Kalista,Varus,654,313,341,47.86
Kalista,Maokai,294,129,165,43.88
Kalista,Lucian,495,230,265,46.46
Kalista,Elise,542,226,316,41.7
Kalista,Lulu,776,354,422,45.62
Kalista,Nunu,412,212,200,51.46
Kalista,Zac,286,136,150,47.55
Kalista,Sejuani,277,127,150,45.85
Kalista,Galio,580,286,294,49.31
Kalista,Zyra,491,223,268,45.42
Kalista,Riven,274,149,125,54.38
Kalista,Pyke,611,333,278,54.5
Kalista,Corki,243,147,96,60.49
Kalista,KSante,349,155,194,44.41
Kalista,Skarner,232,132,100,56.9
Kalista,Gwen,319,146,173,45.77
Kalista,Zed,724,366,358,50.55
Kalista,Naafiri,201,93,108,46.27
Kalista,Soraka,432,208,224,48.15
Kalista,Belveth,206,97,109,47.09
Kalista,Brand,449,220,229,49
Kalista,Vi,558,283,275,50.72
Kalista,Azir,282,169,113,59.93
Kalista,Amumu,620,243,377,39.19
Kalista,Nilah,296,90,206,30.41
Kalista,RekSai,92,42,50,45.65
Kalista,Olaf,187,82,105,43.85
Kalista,Taric,188,86,102,45.74
Kalista,Tryndamere,423,243,180,57.45
Kalista,Renata,167,53,114,31.74
Kalista,Zilean,223,102,121,45.74
Kalista,Evelynn,346,170,176,49.13
Kalista,Annie,179,85,94,47.49
Kalista,Anivia,203,94,109,46.31
Kalista,Karthus,152,79,73,51.97
Kalista,Bard,247,107,140,43.32
Kalista,DrMundo,369,173,196,46.88
Kalista,Hecarim,308,159,149,51.62
Kalista,Nidalee,200,94,106,47
Lulu,Vladimir,1920,926,994,48.23
Lulu,Viego,3582,1767,1815,49.33
Lulu,Velkoz,1524,736,788,48.29
Lulu,Kaisa,4390,2352,2038,53.58
Lulu,Karma,4203,2044,2159,48.63
Lulu,Yorick,2132,1010,1122,47.37
Lulu,Diana,4204,2099,2105,49.93
Lulu,Seraphine,2148,953,1195,44.37
Lulu,Rakan,1152,601,551,52.17
Lulu,XinZhao,1906,924,982,48.48
Lulu,Katarina,2134,1132,1002,53.05
Lulu,Teemo,2761,1327,1434,48.06
Lulu,Vayne,2937,1459,1478,49.68
Lulu,TwistedFate,986,476,510,48.28
Lulu,Gragas,1809,960,849,53.07
Lulu,Gwen,1229,633,596,51.51
Lulu,Yasuo,5059,2593,2466,51.26
Lulu,Zeri,1294,634,660,49
Lulu,Bard,843,384,459,45.55
Lulu,Smolder,1752,991,761,56.56
Lulu,Ekko,2313,1058,1255,45.74
Lulu,Mordekaiser,3052,1422,1630,46.59
Lulu,Yuumi,2899,1468,1431,50.64
Lulu,Shaco,2341,1136,1205,48.53
Lulu,Tryndamere,1321,640,681,48.45
Lulu,Ezreal,7356,3896,3460,52.96
Lulu,Milio,2220,1051,1169,47.34
Lulu,Ryze,1051,523,528,49.76
Lulu,Nunu,1365,669,696,49.01
Lulu,Ahri,3579,1765,1814,49.32
Lulu,Lucian,2193,1094,1099,49.89
Lulu,Alistar,1124,537,587,47.78
Lulu,Nasus,1692,834,858,49.29
Lulu,Kayn,3457,1754,1703,50.74
Lulu,Neeko,1095,557,538,50.87
Lulu,MissFortune,5194,2617,2577,50.39
Lulu,Morgana,2717,1311,1406,48.25
Lulu,Darius,4903,2335,2568,47.62
Lulu,Sejuani,1185,604,581,50.97
Lulu,Mel,5263,2829,2434,53.75
Lulu,Jhin,5518,2732,2786,49.51
Lulu,Rell,1227,573,654,46.7
Lulu,Amumu,2193,1019,1174,46.47
Lulu,Swain,2366,1098,1268,46.41
Lulu,Urgot,1254,656,598,52.31
Lulu,LeeSin,4460,2330,2130,52.24
Lulu,Heimerdinger,1040,567,473,54.52
Lulu,Warwick,3175,1556,1619,49.01
Lulu,Ashe,5440,2583,2857,47.48
Lulu,Pyke,2134,1148,986,53.8
Lulu,Camille,1162,625,537,53.79
Lulu,MasterYi,2813,1403,1410,49.88
Lulu,Irelia,2068,1008,1060,48.74
Lulu,Pantheon,4204,2171,2033,51.64
Lulu,DrMundo,1166,569,597,48.8
Lulu,Trundle,1183,545,638,46.07
Lulu,Nami,3916,1856,2060,47.4
Lulu,Nocturne,3233,1512,1721,46.77
Lulu,Aurora,2229,1075,1154,48.23
Lulu,Jinx,6697,3174,3523,47.39
Lulu,Ivern,533,266,267,49.91
Lulu,Sett,3505,1732,1773,49.42
Lulu,Malphite,2524,1149,1375,45.52
Lulu,Tristana,2325,1181,1144,50.8
Lulu,Ziggs,887,397,490,44.76
Lulu,Lillia,1471,695,776,47.25
Lulu,Lissandra,982,472,510,48.07
Lulu,FiddleSticks,1389,669,720,48.16
Lulu,Ornn,1128,552,576,48.94
Lulu,Hwei,1950,934,1016,47.9
Lulu,Caitlyn,6368,3074,3294,48.27
Lulu,Illaoi,1035,526,509,50.82
Lulu,Malzahar,2617,1293,1324,49.41
Lulu,Khazix,1420,751,669,52.89
Lulu,Leona,1912,948,964,49.58
Lulu,Poppy,1535,769,766,50.1
Lulu,Annie,910,453,457,49.78
Lulu,Nautilus,3035,1562,1473,51.47
Lulu,Yone,4606,2501,2105,54.3
Lulu,Maokai,1200,559,641,46.58
Lulu,Fiora,1055,586,469,55.55
Lulu,Riven,1222,621,601,50.82
Lulu,Akshan,837,421,416,50.3
Lulu,Xerath,2171,1053,1118,48.5
Lulu,Chogath,3166,1507,1659,47.6
Lulu,Zed,2914,1504,1410,51.61
Lulu,Lux,5950,2987,2963,50.2
Lulu,Rengar,975,523,452,53.64
Lulu,Galio,2432,1147,1285,47.16
Lulu,Samira,1666,904,762,54.26
Lulu,Sona,832,411,421,49.4
Lulu,Shen,1701,897,804,52.73
Lulu,TahmKench,1818,894,924,49.17
Lulu,Kennen,795,360,435,45.28
Lulu,Syndra,1845,899,946,48.73
Lulu,Akali,2700,1387,1313,51.37
Lulu,Soraka,1851,930,921,50.24
Lulu,Evelynn,989,522,467,52.78
Lulu,Briar,1773,860,913,48.51
Lulu,Viktor,2661,1181,1480,44.38
Lulu,Jax,2440,1313,1127,53.81
Lulu,Corki,1309,733,576,56
Lulu,Volibear,2607,1282,1325,49.18
Lulu,Rammus,807,394,413,48.82
Lulu,Cassiopeia,785,411,374,52.36
Lulu,MonkeyKing,1926,984,942,51.09
Lulu,Elise,2117,1072,1045,50.64
Lulu,Quinn,858,396,462,46.15
Lulu,Talon,1749,902,847,51.57
Lulu,Varus,2407,1207,1200,50.15
Lulu,Aatrox,2738,1390,1348,50.77
Lulu,Olaf,691,331,360,47.9
Lulu,Vex,1050,546,504,52
Lulu,Thresh,4142,1956,2186,47.22
Lulu,Kindred,1222,581,641,47.55
Lulu,Vi,2468,1212,1256,49.11
Lulu,Sion,2106,1052,1054,49.95
Lulu,Garen,3923,1922,2001,48.99
Lulu,Shyvana,635,343,292,54.02
Lulu,Sivir,1278,673,605,52.66
Lulu,Qiyana,744,336,408,45.16
Lulu,Ambessa,1949,1036,913,53.16
Lulu,Zyra,2236,1025,1211,45.84
Lulu,Graves,1957,958,999,48.95
Lulu,Nidalee,842,458,384,54.39
Lulu,Senna,2161,1114,1047,51.55
Lulu,Fizz,1250,627,623,50.16
Lulu,Sylas,3660,1829,1831,49.97
Lulu,Xayah,1359,650,709,47.83
Lulu,Leblanc,1611,846,765,52.51
Lulu,Gnar,1191,611,580,51.3
Lulu,Zac,1449,695,754,47.96
Lulu,Singed,749,391,358,52.2
Lulu,Braum,1608,770,838,47.89
Lulu,Zoe,1065,541,524,50.8
Lulu,Naafiri,846,404,442,47.75
Lulu,Skarner,835,435,400,52.1
Lulu,Draven,1347,634,713,47.07
Lulu,Azir,1056,564,492,53.41
Lulu,Kled,525,246,279,46.86
Lulu,Belveth,595,311,284,52.27
Lulu,Hecarim,1233,610,623,49.47
Lulu,Nilah,777,398,379,51.22
Lulu,Kassadin,473,232,241,49.05
Lulu,Twitch,2157,1038,1119,48.12
Lulu,Udyr,978,490,488,50.1
Lulu,Aphelios,1663,768,895,46.18
Lulu,Blitzcrank,2113,1029,1084,48.7
Lulu,Renata,614,340,274,55.37
Lulu,Veigar,2309,1148,1161,49.72
Lulu,KogMaw,905,440,465,48.62
Lulu,Gangplank,1505,723,782,48.04
Lulu,JarvanIV,1815,788,1027,43.42
Lulu,Orianna,1252,677,575,54.07
Lulu,Zilean,1062,542,520,51.04
Lulu,Karthus,734,390,344,53.13
Lulu,Brand,1678,839,839,50
Lulu,Kayle,1672,742,930,44.38
Lulu,Anivia,822,427,395,51.95
Lulu,Janna,1101,537,564,48.77
Lulu,KSante,1745,920,825,52.72
Lulu,Jayce,1567,732,835,46.71
Lulu,AurelionSol,965,467,498,48.39
Lulu,Renekton,1296,708,588,54.63
Lulu,Rumble,844,427,417,50.59
Lulu,Taliyah,785,387,398,49.3
Lulu,RekSai,368,186,182,50.54
Lulu,Kalista,776,422,354,54.38
Lulu,Taric,620,304,316,49.03
Vladimir,Jax,1264,658,606,52.06
Vladimir,XinZhao,847,417,430,49.23
Vladimir,Kennen,495,247,248,49.9
Vladimir,Kalista,439,229,210,52.16
Vladimir,Lulu,1920,991,929,51.61
Vladimir,Illaoi,537,266,271,49.53
Vladimir,Warwick,1657,799,858,48.22
Vladimir,Diana,2062,976,1086,47.33
Vladimir,Tristana,1288,729,559,56.6
Vladimir,Milio,840,377,463,44.88
Vladimir,Ornn,596,266,330,44.63
Vladimir,Poppy,974,497,477,51.03
Vladimir,Yone,2638,1316,1322,49.89
Vladimir,MissFortune,2685,1321,1364,49.2
Vladimir,Brand,992,502,490,50.6
Vladimir,Singed,337,163,174,48.37
Vladimir,Ryze,592,312,280,52.7
Vladimir,Samira,934,428,506,45.82
Vladimir,Soraka,675,280,395,41.48
Vladimir,Mordekaiser,1720,873,847,50.76
Vladimir,Briar,985,464,521,47.11
Vladimir,Zed,1577,837,740,53.08
Vladimir,Jinx,3535,1745,1790,49.36
Vladimir,Darius,2442,1126,1316,46.11
Vladimir,Garen,1792,895,897,49.94
Vladimir,Lux,3045,1534,1511,50.38
Vladimir,Sivir,753,319,434,42.36
Vladimir,Rakan,696,338,358,48.56
Vladimir,Gangplank,765,407,358,53.2
Vladimir,Lillia,727,328,399,45.12
Vladimir,Sejuani,639,362,277,56.65
Vladimir,Mel,2894,1603,1291,55.39
Vladimir,Jhin,2787,1388,1399,49.8
Vladimir,Rell,709,354,355,49.93
Vladimir,TwistedFate,386,189,197,48.96
Vladimir,LeeSin,1877,1007,870,53.65
Vladimir,Yasuo,3123,1591,1532,50.94
Vladimir,Nilah,503,221,282,43.94
Vladimir,Ahri,1739,889,850,51.12
Vladimir,Nunu,817,408,409,49.94
Vladimir,Zyra,1212,587,625,48.43
Vladimir,Zoe,532,286,246,53.76
Vladimir,Ezreal,2992,1555,1437,51.97
Vladimir,Janna,430,213,217,49.53
Vladimir,Chogath,1743,833,910,47.79
Vladimir,Galio,1093,579,514,52.97
Vladimir,Yorick,1149,491,658,42.73
Vladimir,Kindred,664,333,331,50.15
Vladimir,Ashe,2602,1308,1294,50.27
Vladimir,Ekko,1164,558,606,47.94
Vladimir,Caitlyn,3451,1708,1743,49.49
Vladimir,Kayle,1051,511,540,48.62
Vladimir,Sona,417,187,230,44.84
Vladimir,Twitch,1113,564,549,50.67
Vladimir,Teemo,1733,866,867,49.97
Vladimir,Aatrox,1162,571,591,49.14
Vladimir,MasterYi,1519,753,766,49.57
Vladimir,Yuumi,1144,502,642,43.88
Vladimir,Heimerdinger,668,322,346,48.2
Vladimir,Varus,1051,560,491,53.28
Vladimir,Maokai,565,294,271,52.04
Vladimir,Veigar,1264,588,676,46.52
Vladimir,Shyvana,356,181,175,50.84
Vladimir,Morgana,1415,699,716,49.4
Vladimir,Riven,684,351,333,51.32
Vladimir,Shaco,1189,588,601,49.45
Vladimir,Thresh,1833,957,876,52.21
Vladimir,Kayn,2000,1020,980,51
Vladimir,Seraphine,963,535,428,55.56
Vladimir,DrMundo,765,366,399,47.84
Vladimir,Irelia,1234,606,628,49.11
Vladimir,Swain,1390,675,715,48.56
Vladimir,Nasus,960,437,523,45.52
Vladimir,Zac,703,340,363,48.36
Vladimir,Kaisa,2177,1140,1037,52.37
Vladimir,Anivia,408,200,208,49.02
Vladimir,JarvanIV,754,384,370,50.93
Vladimir,Katarina,1184,617,567,52.11
Vladimir,TahmKench,1041,498,543,47.84
Vladimir,Akali,1435,755,680,52.61
Vladimir,FiddleSticks,724,332,392,45.86
Vladimir,Rengar,463,278,185,60.04
Vladimir,Belveth,365,205,160,56.16
Vladimir,Pantheon,2277,1078,1199,47.34
Vladimir,Amumu,1346,618,728,45.91
Vladimir,Nami,1339,649,690,48.47
Vladimir,Aurora,1069,474,595,44.34
Vladimir,Aphelios,769,356,413,46.29
Vladimir,Draven,710,369,341,51.97
Vladimir,Shen,842,440,402,52.26
Vladimir,Pyke,1087,569,518,52.35
Vladimir,Viktor,1020,449,571,44.02
Vladimir,Senna,930,457,473,49.14
Vladimir,Tryndamere,696,320,376,45.98
Vladimir,Neeko,611,309,302,50.57
Vladimir,KSante,640,368,272,57.5
Vladimir,Taric,315,161,154,51.11
Vladimir,Talon,896,509,387,56.81
Vladimir,Sett,1819,860,959,47.28
Vladimir,Leona,1054,529,525,50.19
Vladimir,Viego,1924,886,1038,46.05
Vladimir,Orianna,738,356,382,48.24
Vladimir,Smolder,848,432,416,50.94
Vladimir,Syndra,759,362,397,47.69
Vladimir,Velkoz,778,355,423,45.63
Vladimir,Sylas,1760,900,860,51.14
Vladimir,KogMaw,469,250,219,53.3
Vladimir,Nautilus,1476,765,711,51.83
Vladimir,Evelynn,487,258,229,52.98
Vladimir,Alistar,572,272,300,47.55
Vladimir,Karthus,402,226,176,56.22
Vladimir,Khazix,693,354,339,51.08
Vladimir,Leblanc,801,419,382,52.31
Vladimir,Camille,564,336,228,59.57
Vladimir,Lucian,903,473,430,52.38
Vladimir,Nidalee,436,218,218,50
Vladimir,Vex,621,342,279,55.07
Vladimir,Hwei,883,462,421,52.32
Vladimir,Vi,1138,657,481,57.73
Vladimir,Olaf,304,172,132,56.58
Vladimir,Sion,1037,526,511,50.72
Vladimir,Akshan,510,289,221,56.67
Vladimir,Urgot,601,286,315,47.59
Vladimir,Qiyana,396,198,198,50
Vladimir,Rammus,389,166,223,42.67
Vladimir,Vayne,1808,858,950,47.46
Vladimir,Gnar,580,341,239,58.79
Vladimir,Zeri,599,298,301,49.75
Vladimir,Blitzcrank,924,463,461,50.11
Vladimir,Azir,465,250,215,53.76
Vladimir,Fiora,577,296,281,51.3
Vladimir,AurelionSol,507,225,282,44.38
Vladimir,Corki,589,314,275,53.31
Vladimir,Bard,399,216,183,54.14
Vladimir,Volibear,1335,638,697,47.79
Vladimir,Braum,795,373,422,46.92
Vladimir,Renekton,708,352,356,49.72
Vladimir,Naafiri,416,200,216,48.08
Vladimir,Trundle,635,307,328,48.35
Vladimir,Fizz,876,480,396,54.79
Vladimir,Ziggs,465,243,222,52.26
Vladimir,Rumble,409,196,213,47.92
Vladimir,Quinn,437,227,210,51.95
Vladimir,Gwen,783,450,333,57.47
Vladimir,Elise,1004,497,507,49.5
Vladimir,Ivern,233,109,124,46.78
Vladimir,Nocturne,1597,796,801,49.84
Vladimir,Kassadin,368,168,200,45.65
Vladimir,Xayah,729,391,338,53.64
Vladimir,Malzahar,1383,638,745,46.13
Vladimir,Ambessa,752,383,369,50.93
Vladimir,Skarner,365,196,169,53.7
Vladimir,Graves,833,421,412,50.54
Vladimir,Taliyah,319,175,144,54.86
Vladimir,Karma,1618,864,754,53.4
Vladimir,Gragas,788,437,351,55.46
Vladimir,MonkeyKing,885,459,426,51.86
Vladimir,Malphite,1199,618,581,51.54
Vladimir,Udyr,479,253,226,52.82
Vladimir,Lissandra,465,223,242,47.96
Vladimir,RekSai,169,95,74,56.21
Vladimir,Hecarim,547,286,261,52.29
Vladimir,Annie,444,195,249,43.92
Vladimir,Renata,263,134,129,50.95
Vladimir,Xerath,935,437,498,46.74
Vladimir,Kled,234,126,108,53.85
Vladimir,Jayce,696,348,348,50
Vladimir,Cassiopeia,491,266,225,54.18
Vladimir,Zilean,438,208,230,47.49
Viego,Jax,2600,1275,1325,49.04
Viego,XinZhao,2000,1029,971,51.45
Viego,Kennen,978,540,438,55.21
Viego,Kalista,920,497,423,54.02
Viego,Lulu,3582,1815,1767,50.67
Viego,Sett,4529,2096,2433,46.28
Viego,Ivern,505,291,214,57.62
Viego,Veigar,2974,1461,1513,49.13
Viego,Jinx,7711,3721,3990,48.26
Viego,Darius,5350,2670,2680,49.91
Viego,Warwick,4277,2005,2272,46.88
Viego,Yasuo,5748,2917,2831,50.75
Viego,Caitlyn,7433,3871,3562,52.08
Viego,Morgana,3116,1503,1613,48.23
Viego,Volibear,3238,1629,1609,50.31
Viego,Ekko,2617,1325,1292,50.63
Viego,Yone,5407,2816,2591,52.08
Viego,Pyke,2741,1500,1241,54.72
Viego,Illaoi,1240,647,593,52.18
Viego,Aatrox,3036,1515,1521,49.9
Viego,Ashe,5994,3063,2931,51.1
Viego,Aphelios,1592,760,832,47.74
Viego,Gragas,1619,853,766,52.69
Viego,FiddleSticks,1367,625,742,45.72
Viego,Shaco,2699,1358,1341,50.31
Viego,Syndra,1833,900,933,49.1
Viego,Thresh,4298,2103,2195,48.93
Viego,Fiora,1136,563,573,49.56
Viego,Galio,2600,1296,1304,49.85
Viego,Ezreal,6819,3535,3284,51.84
Viego,Chogath,3360,1631,1729,48.54
Viego,Naafiri,1024,525,499,51.27
Viego,Nunu,1726,807,919,46.76
Viego,Malzahar,2576,1219,1357,47.32
Viego,Zeri,1227,658,569,53.63
Viego,Mordekaiser,3674,1752,1922,47.69
Viego,Khazix,1710,924,786,54.04
Viego,Akali,3131,1567,1564,50.05
Viego,Draven,1474,811,663,55.02
Viego,Mel,6009,3091,2918,51.44
Viego,Malphite,2888,1436,1452,49.72
Viego,MissFortune,6279,3134,3145,49.91
Viego,Soraka,1614,830,784,51.43
Viego,Ambessa,2065,1050,1015,50.85
Viego,Vex,1525,746,779,48.92
Viego,Blitzcrank,2255,1102,1153,48.87
Viego,Heimerdinger,1192,580,612,48.66
Viego,Seraphine,2374,1274,1100,53.66
Viego,Ziggs,1110,555,555,50
Viego,Yorick,2710,1199,1511,44.24
Viego,Kayn,4524,2135,2389,47.19
Viego,Nasus,2065,988,1077,47.85
Viego,Smolder,1853,934,919,50.4
Viego,JarvanIV,1585,754,831,47.57
Viego,Olaf,730,419,311,57.4
Viego,Evelynn,1169,597,572,51.07
Viego,Leona,2380,1179,1201,49.54
Viego,MasterYi,3432,1702,1730,49.59
Viego,Ahri,3659,1790,1869,48.92
Viego,Sivir,1451,718,733,49.48
Viego,Yuumi,2370,1229,1141,51.86
Viego,Orianna,1349,728,621,53.97
Viego,Nautilus,3502,1698,1804,48.49
Viego,Gwen,1422,790,632,55.56
Viego,Maokai,1344,694,650,51.64
Viego,Brand,1800,984,816,54.67
Viego,TahmKench,2484,1282,1202,51.61
Viego,Leblanc,1716,834,882,48.6
Viego,Samira,2192,1156,1036,52.74
Viego,Shen,1862,914,948,49.09
Viego,Graves,1972,984,988,49.9
Viego,Taric,581,340,241,58.52
Viego,Rumble,815,437,378,53.62
Viego,Pantheon,4821,2456,2365,50.94
Viego,Urgot,1276,626,650,49.06
Viego,Twitch,2030,993,1037,48.92
Viego,Kaisa,4810,2446,2364,50.85
Viego,Teemo,3508,1712,1796,48.8
Viego,Renekton,1616,777,839,48.08
Viego,Sejuani,1152,534,618,46.35
Viego,Taliyah,729,363,366,49.79
Viego,Diana,4873,2494,2379,51.18
Viego,MonkeyKing,2250,1110,1140,49.33
Viego,Karma,3328,1676,1652,50.36
Viego,Garen,4307,2071,2236,48.08
Viego,Jhin,6015,2972,3043,49.41
Viego,Trundle,1575,766,809,48.63
Viego,Zed,3246,1609,1637,49.57
Viego,Fizz,1519,723,796,47.6
Viego,Quinn,1044,513,531,49.14
Viego,Sion,2342,1136,1206,48.51
Viego,Jayce,1496,815,681,54.48
Viego,KogMaw,873,392,481,44.9
Viego,Viktor,2559,1235,1324,48.26
Viego,Riven,1390,685,705,49.28
Viego,Neeko,1556,793,763,50.96
Viego,Elise,2249,1148,1101,51.04
Viego,Lux,6910,3500,3410,50.65
Viego,Ornn,1245,628,617,50.44
Viego,Hwei,2038,1048,990,51.42
Viego,Gangplank,1558,783,775,50.26
Viego,Rell,1507,698,809,46.32
Viego,Kindred,1322,737,585,55.75
Viego,Tristana,2741,1348,1393,49.18
Viego,Hecarim,1246,656,590,52.65
Viego,Milio,1566,727,839,46.42
Viego,LeeSin,5820,3004,2816,51.62
Viego,AurelionSol,1176,654,522,55.61
Viego,Annie,890,448,442,50.34
Viego,Singed,751,362,389,48.2
Viego,Nilah,1038,499,539,48.07
Viego,Janna,882,489,393,55.44
Viego,Nocturne,3283,1652,1631,50.32
Viego,Vayne,3405,1663,1742,48.84
Viego,Kayle,1697,860,837,50.68
Viego,Amumu,3029,1388,1641,45.82
Viego,KSante,1471,785,686,53.37
Viego,Vladimir,1924,1038,886,53.95
Viego,Vi,2843,1532,1311,53.89
Viego,Katarina,2447,1225,1222,50.06
Viego,Varus,2536,1273,1263,50.2
Viego,Velkoz,1534,754,780,49.15
Viego,DrMundo,1571,815,756,51.88
Viego,Rengar,961,514,447,53.49
Viego,Nami,2746,1327,1419,48.32
Viego,Belveth,813,421,392,51.78
Viego,Sylas,4073,2170,1903,53.28
Viego,Senna,2155,1087,1068,50.44
Viego,Swain,2773,1440,1333,51.93
Viego,Irelia,2417,1208,1209,49.98
Viego,Anivia,966,489,477,50.62
Viego,Kled,473,243,230,51.37
Viego,Gnar,1227,651,576,53.06
Viego,TwistedFate,1002,522,480,52.1
Viego,Akshan,1097,524,573,47.77
Viego,Sona,785,408,377,51.97
Viego,Corki,1222,639,583,52.29
Viego,Skarner,791,478,313,60.43
Viego,Lillia,1772,870,902,49.1
Viego,Aurora,2228,1061,1167,47.62
Viego,Lissandra,921,495,426,53.75
Viego,Lucian,1999,1028,971,51.43
Viego,Udyr,1131,544,587,48.1
Viego,Talon,1822,1004,818,55.1
Viego,Xerath,2572,1254,1318,48.76
Viego,Camille,935,537,398,57.43
Viego,Briar,2078,1051,1027,50.58
Viego,Poppy,1676,832,844,49.64
Viego,Kassadin,572,291,281,50.87
Viego,Zyra,2519,1335,1184,53
Viego,Xayah,1377,725,652,52.65
Viego,Qiyana,909,458,451,50.39
Viego,Zilean,897,480,417,53.51
Viego,Azir,1081,637,444,58.93
Viego,Renata,574,319,255,55.57
Viego,Zac,1544,742,802,48.06
Viego,Braum,1636,688,948,42.05
Viego,Cassiopeia,843,413,430,48.99
Viego,RekSai,460,275,185,59.78
Viego,Karthus,746,360,386,48.26
Viego,Nidalee,910,520,390,57.14
Viego,Zoe,1260,678,582,53.81
Viego,Ryze,1037,522,515,50.34
Viego,Tryndamere,1688,828,860,49.05
Viego,Rakan,1307,720,587,55.09
Viego,Rammus,996,474,522,47.59
Viego,Alistar,1392,665,727,47.77
Viego,Shyvana,707,304,403,43
Viego,Bard,907,427,480,47.08
Velkoz,Jax,1004,556,448,55.38
Velkoz,XinZhao,811,383,428,47.23
Velkoz,Kennen,330,205,125,62.12
Velkoz,Kalista,328,197,131,60.06
Velkoz,Lulu,1524,788,736,51.71
Velkoz,Kayle,886,424,462,47.86
Velkoz,Sylas,1318,749,569,56.83
Velkoz,Qiyana,397,216,181,54.41
Velkoz,Caitlyn,3418,1770,1648,51.78
Velkoz,Renata,210,133,77,63.33
Velkoz,Heimerdinger,593,308,285,51.94
Velkoz,Warwick,1856,871,985,46.93
Velkoz,Neeko,650,388,262,59.69
Velkoz,Draven,747,379,368,50.74
Velkoz,Leona,982,498,484,50.71
Velkoz,Gangplank,640,320,320,50
Velkoz,Hwei,886,488,398,55.08
Velkoz,Mel,2647,1421,1226,53.68
Velkoz,Hecarim,601,333,268,55.41
Velkoz,Milio,623,324,299,52.01
Velkoz,Teemo,1728,800,928,46.3
Velkoz,Briar,1006,530,476,52.68
Velkoz,Aurora,961,498,463,51.82
Velkoz,Kaisa,1890,1012,878,53.54
Velkoz,Karma,1362,651,711,47.8
Velkoz,LeeSin,1661,855,806,51.48
Velkoz,Chogath,1584,821,763,51.83
Velkoz,Lucian,800,413,387,51.63
Velkoz,Xerath,1289,650,639,50.43
Velkoz,Riven,565,288,277,50.97
Velkoz,Tristana,1292,644,648,49.85
Velkoz,Zac,595,290,305,48.74
Velkoz,Darius,2408,1247,1161,51.79
Velkoz,Shaco,1230,675,555,54.88
Velkoz,Veigar,1463,783,680,53.52
Velkoz,Ashe,2235,1230,1005,55.03
Velkoz,Azir,417,219,198,52.52
Velkoz,Yorick,1241,592,649,47.7
Velkoz,MasterYi,1500,768,732,51.2
Velkoz,Irelia,1092,557,535,51.01
Velkoz,Shen,909,462,447,50.83
Velkoz,Nami,1289,648,641,50.27
Velkoz,Aatrox,1139,607,532,53.29
Velkoz,Ezreal,2724,1353,1371,49.67
Velkoz,Elise,840,481,359,57.26
Velkoz,Fiora,536,275,261,51.31
Velkoz,Gragas,710,394,316,55.49
Velkoz,Seraphine,1217,623,594,51.19
Velkoz,Ziggs,526,247,279,46.96
Velkoz,Vayne,1595,785,810,49.22
Velkoz,Jinx,3259,1639,1620,50.29
Velkoz,Yasuo,2385,1200,1185,50.31
Velkoz,Sejuani,513,253,260,49.32
Velkoz,TahmKench,1157,599,558,51.77
Velkoz,DrMundo,784,340,444,43.37
Velkoz,Lux,3751,2028,1723,54.07
Velkoz,Pantheon,1986,1074,912,54.08
Velkoz,KSante,548,305,243,55.66
Velkoz,MonkeyKing,771,399,372,51.75
Velkoz,Ekko,1124,596,528,53.02
Velkoz,Senna,988,535,453,54.15
Velkoz,Gwen,689,354,335,51.38
Velkoz,JarvanIV,741,378,363,51.01
Velkoz,Yone,2311,1297,1014,56.12
Velkoz,Volibear,1424,716,708,50.28
Velkoz,Talon,655,377,278,57.56
Velkoz,AurelionSol,570,288,282,50.53
Velkoz,Jhin,2481,1213,1268,48.89
Velkoz,Vi,1116,613,503,54.93
Velkoz,Kassadin,282,160,122,56.74
Velkoz,Corki,528,300,228,56.82
Velkoz,Blitzcrank,952,530,422,55.67
Velkoz,Mordekaiser,1660,904,756,54.46
Velkoz,Nidalee,369,189,180,51.22
Velkoz,Ahri,1667,839,828,50.33
Velkoz,Sona,399,216,183,54.14
Velkoz,Garen,1959,987,972,50.38
Velkoz,Zed,1383,704,679,50.9
Velkoz,Aphelios,733,356,377,48.57
Velkoz,Thresh,1786,957,829,53.58
Velkoz,Khazix,658,317,341,48.18
Velkoz,Taric,304,153,151,50.33
Velkoz,Swain,1280,601,679,46.95
Velkoz,Camille,492,251,241,51.02
Velkoz,Viktor,1117,582,535,52.1
Velkoz,Kayn,1833,873,960,47.63
Velkoz,Tryndamere,716,370,346,51.68
Velkoz,FiddleSticks,575,285,290,49.57
Velkoz,Singed,407,226,181,55.53
Velkoz,Galio,1076,526,550,48.88
Velkoz,Bard,384,197,187,51.3
Velkoz,Diana,1881,1036,845,55.08
Velkoz,Rakan,602,289,313,48.01
Velkoz,Malzahar,1264,578,686,45.73
Velkoz,TwistedFate,416,250,166,60.1
Velkoz,Maokai,580,266,314,45.86
Velkoz,Gnar,521,298,223,57.2
Velkoz,Katarina,955,505,450,52.88
Velkoz,Samira,999,527,472,52.75
Velkoz,Poppy,676,327,349,48.37
Velkoz,Viego,1534,780,754,50.85
Velkoz,Orianna,521,261,260,50.1
Velkoz,Vladimir,778,423,355,54.37
Velkoz,Rammus,369,216,153,58.54
Velkoz,Nautilus,1443,783,660,54.26
Velkoz,Naafiri,537,260,277,48.42
Velkoz,Zeri,523,269,254,51.43
Velkoz,Brand,998,488,510,48.9
Velkoz,Smolder,788,410,378,52.03
Velkoz,Shyvana,296,148,148,50
Velkoz,Zilean,524,260,264,49.62
Velkoz,Kled,247,143,104,57.89
Velkoz,Nunu,813,433,380,53.26
Velkoz,Annie,397,224,173,56.42
Velkoz,MissFortune,2883,1566,1317,54.32
Velkoz,Yuumi,1009,509,500,50.45
Velkoz,Nasus,857,486,371,56.71
Velkoz,Udyr,471,281,190,59.66
Velkoz,Quinn,518,284,234,54.83
Velkoz,Kindred,554,302,252,54.51
Velkoz,Lissandra,369,195,174,52.85
Velkoz,Renekton,645,356,289,55.19
Velkoz,Soraka,756,377,379,49.87
Velkoz,Syndra,787,396,391,50.32
Velkoz,Zyra,977,465,512,47.59
Velkoz,Cassiopeia,414,231,183,55.8
Velkoz,Alistar,422,197,225,46.68
Velkoz,Rengar,506,297,209,58.7
Velkoz,Ryze,470,230,240,48.94
Velkoz,Malphite,1226,613,613,50
Velkoz,Leblanc,686,387,299,56.41
Velkoz,Akali,1215,611,604,50.29
Velkoz,Fizz,789,371,418,47.02
Velkoz,Vex,644,345,299,53.57
Velkoz,Morgana,1561,813,748,52.08
Velkoz,Illaoi,555,333,222,60
Velkoz,Xayah,604,320,284,52.98
Velkoz,Braum,685,388,297,56.64
Velkoz,Sett,1926,906,1020,47.04
Velkoz,Akshan,410,182,228,44.39
Velkoz,Varus,1084,560,524,51.66
Velkoz,Olaf,247,129,118,52.23
Velkoz,Nocturne,1546,780,766,50.45
Velkoz,Twitch,1064,529,535,49.72
Velkoz,Ambessa,787,449,338,57.05
Velkoz,Rell,660,354,306,53.64
Velkoz,Graves,735,415,320,56.46
Velkoz,Sion,978,460,518,47.03
Velkoz,Zoe,509,299,210,58.74
Velkoz,Ornn,565,288,277,50.97
Velkoz,Evelynn,531,261,270,49.15
Velkoz,Belveth,300,133,167,44.33
Velkoz,Jayce,532,287,245,53.95
Velkoz,Trundle,666,349,317,52.4
Velkoz,Amumu,1393,627,766,45.01
Velkoz,Taliyah,291,147,144,50.52
Velkoz,Nilah,564,316,248,56.03
Velkoz,Anivia,469,238,231,50.75
Velkoz,Rumble,297,169,128,56.9
Velkoz,Pyke,1021,526,495,51.52
Velkoz,Lillia,643,374,269,58.16
Velkoz,Janna,383,196,187,51.17
Velkoz,Karthus,306,176,130,57.52
Velkoz,Urgot,644,266,378,41.3
Velkoz,Sivir,669,339,330,50.67
Velkoz,Skarner,319,172,147,53.92
Velkoz,Ivern,217,116,101,53.46
Velkoz,KogMaw,419,202,217,48.21
Velkoz,RekSai,142,72,70,50.7
Kaisa,Jax,3091,1507,1584,48.75
Kaisa,XinZhao,2353,1142,1211,48.53
Kaisa,Kennen,991,470,521,47.43
Kaisa,Kalista,1069,531,538,49.67
Kaisa,Lulu,4390,2038,2352,46.42
Kaisa,Teemo,3797,1661,2136,43.75
Kaisa,Warwick,4630,2154,2476,46.52
Kaisa,Azir,1309,681,628,52.02
Kaisa,MissFortune,7608,3624,3984,47.63
Kaisa,Neeko,1516,712,804,46.97
Kaisa,Trundle,1796,882,914,49.11
Kaisa,MasterYi,3761,1740,2021,46.26
Kaisa,Veigar,3095,1476,1619,47.69
Kaisa,Jhin,6791,3469,3322,51.08
Kaisa,Soraka,1935,866,1069,44.75
Kaisa,TahmKench,2774,1405,1369,50.65
Kaisa,Jinx,9931,4669,5262,47.01
Kaisa,Zoe,1476,769,707,52.1
Kaisa,Nami,3240,1589,1651,49.04
Kaisa,Gwen,1774,894,880,50.39
Kaisa,JarvanIV,2094,1064,1030,50.81
Kaisa,Yone,6757,3379,3378,50.01
Kaisa,Zyra,2911,1304,1607,44.8
Kaisa,Seraphine,2668,1313,1355,49.21
Kaisa,Irelia,3088,1388,1700,44.95
Kaisa,Pantheon,5538,2720,2818,49.12
Kaisa,Kassadin,700,308,392,44
Kaisa,Yuumi,3124,1531,1593,49.01
Kaisa,Diana,5407,2564,2843,47.42
Kaisa,Lux,8101,3893,4208,48.06
Kaisa,Tristana,3220,1554,1666,48.26
Kaisa,Mel,6978,3584,3394,51.36
Kaisa,FiddleSticks,1723,781,942,45.33
Kaisa,Shaco,3115,1552,1563,49.82
Kaisa,Syndra,2136,1091,1045,51.08
Kaisa,Thresh,5101,2447,2654,47.97
Kaisa,Mordekaiser,4224,1975,2249,46.76
Kaisa,Karma,4193,2051,2142,48.91
Kaisa,Naafiri,1187,533,654,44.9
Kaisa,Nunu,1982,968,1014,48.84
Kaisa,Malzahar,3184,1461,1723,45.89
Kaisa,Zeri,1634,812,822,49.69
Kaisa,Smolder,2281,1090,1191,47.79
Kaisa,Yasuo,6773,3347,3426,49.42
Kaisa,Caitlyn,8647,4037,4610,46.69
Kaisa,Velkoz,1890,878,1012,46.46
Kaisa,Ornn,1436,649,787,45.19
Kaisa,TwistedFate,1315,654,661,49.73
Kaisa,Morgana,3618,1716,1902,47.43
Kaisa,Yorick,2735,1229,1506,44.94
Kaisa,Samira,2581,1286,1295,49.83
Kaisa,Zed,3943,2079,1864,52.73
Kaisa,Viktor,3063,1510,1553,49.3
Kaisa,Pyke,3138,1714,1424,54.62
Kaisa,Olaf,790,387,403,48.99
Kaisa,Hecarim,1378,671,707,48.69
Kaisa,Braum,2124,966,1158,45.48
Kaisa,Volibear,3620,1697,1923,46.88
Kaisa,Evelynn,1242,603,639,48.55
Kaisa,Katarina,2560,1177,1383,45.98
Kaisa,Nocturne,4244,1980,2264,46.65
Kaisa,Vi,3312,1631,1681,49.25
Kaisa,Amumu,3332,1450,1882,43.52
Kaisa,Akshan,1074,524,550,48.79
Kaisa,Ezreal,11107,5749,5358,51.76
Kaisa,Orianna,1556,737,819,47.37
Kaisa,Malphite,3153,1466,1687,46.5
Kaisa,Nautilus,3697,1748,1949,47.28
Kaisa,Akali,3850,1823,2027,47.35
Kaisa,LeeSin,5675,2901,2774,51.12
Kaisa,Camille,1229,662,567,53.86
Kaisa,Xayah,2438,1075,1363,44.09
Kaisa,Tryndamere,1661,804,857,48.4
Kaisa,Sivir,1830,828,1002,45.25
Kaisa,Graves,2580,1310,1270,50.78
Kaisa,Maokai,1560,690,870,44.23
Kaisa,Gnar,1404,656,748,46.72
Kaisa,Taric,704,311,393,44.18
Kaisa,Jayce,1663,862,801,51.83
Kaisa,Skarner,1091,549,542,50.32
Kaisa,Poppy,2326,1081,1245,46.47
Kaisa,Chogath,3945,1954,1991,49.53
Kaisa,Talon,2161,1084,1077,50.16
Kaisa,Nilah,1298,566,732,43.61
Kaisa,Milio,1844,840,1004,45.55
Kaisa,Leona,2899,1414,1485,48.78
Kaisa,Aurora,2787,1287,1500,46.18
Kaisa,Kayn,4551,2189,2362,48.1
Kaisa,Ziggs,1137,542,595,47.67
Kaisa,Senna,2547,1212,1335,47.59
Kaisa,Sett,5009,2409,2600,48.09
Kaisa,Renata,719,362,357,50.35
Kaisa,Rammus,1032,480,552,46.51
Kaisa,Renekton,1852,866,986,46.76
Kaisa,Sion,2567,1198,1369,46.67
Kaisa,Ashe,6957,3260,3697,46.86
Kaisa,Briar,2388,1077,1311,45.1
Kaisa,Draven,1808,824,984,45.58
Kaisa,Darius,6425,3211,3214,49.98
Kaisa,Viego,4810,2364,2446,49.15
Kaisa,Vayne,4746,2231,2515,47.01
Kaisa,Taliyah,948,430,518,45.36
Kaisa,Singed,966,465,501,48.14
Kaisa,Brand,2196,1103,1093,50.23
Kaisa,Nasus,2289,997,1292,43.56
Kaisa,Zac,1733,832,901,48.01
Kaisa,Swain,3381,1458,1923,43.12
Kaisa,Rengar,1146,645,501,56.28
Kaisa,Hwei,2228,1103,1125,49.51
Kaisa,KogMaw,1052,437,615,41.54
Kaisa,Heimerdinger,1436,650,786,45.26
Kaisa,Urgot,1692,754,938,44.56
Kaisa,Xerath,2748,1350,1398,49.13
Kaisa,Aatrox,3430,1663,1767,48.48
Kaisa,Ryze,1295,557,738,43.01
Kaisa,Janna,1177,555,622,47.15
Kaisa,Vladimir,2177,1034,1143,47.5
Kaisa,Aphelios,2034,947,1087,46.56
Kaisa,Alistar,1520,722,798,47.5
Kaisa,Twitch,2596,1197,1399,46.11
Kaisa,Blitzcrank,2394,1228,1166,51.29
Kaisa,Shen,2294,1071,1223,46.69
Kaisa,Lillia,1989,994,995,49.97
Kaisa,Khazix,1926,911,1015,47.3
Kaisa,Anivia,1296,629,667,48.53
Kaisa,DrMundo,2016,981,1035,48.66
Kaisa,Kayle,2026,879,1147,43.39
Kaisa,Udyr,1271,602,669,47.36
Kaisa,Rell,1682,826,856,49.11
Kaisa,Galio,3269,1465,1804,44.81
Kaisa,Lucian,2632,1264,1368,48.02
Kaisa,Ekko,2840,1385,1455,48.77
Kaisa,Riven,1592,748,844,46.98
Kaisa,Ahri,4595,2189,2406,47.64
Kaisa,Garen,5150,2351,2799,45.65
Kaisa,Nidalee,1175,612,563,52.09
Kaisa,Lissandra,1117,520,597,46.55
Kaisa,Sylas,4958,2490,2468,50.22
Kaisa,Bard,1034,478,556,46.23
Kaisa,Kindred,1707,893,814,52.31
Kaisa,Ambessa,2296,1201,1095,52.31
Kaisa,Varus,3074,1565,1509,50.91
Kaisa,Illaoi,1575,791,784,50.22
Kaisa,Annie,1131,489,642,43.24
Kaisa,Fiora,1316,670,646,50.91
Kaisa,KSante,1968,1058,910,53.76
Kaisa,Karthus,1095,467,628,42.65
Kaisa,Belveth,861,443,418,51.45
Kaisa,Leblanc,2037,996,1041,48.9
Kaisa,Gangplank,1918,938,980,48.91
Kaisa,Elise,2700,1291,1409,47.81
Kaisa,Corki,1460,774,686,53.01
Kaisa,Cassiopeia,1044,526,518,50.38
Kaisa,Rakan,1673,731,942,43.69
Kaisa,Vex,1731,809,922,46.74
Kaisa,Ivern,580,271,309,46.72
Kaisa,Fizz,1856,902,954,48.6
Kaisa,Gragas,1944,906,1038,46.6
Kaisa,Sejuani,1525,694,831,45.51
Kaisa,Kled,616,308,308,50
Kaisa,Sona,1027,480,547,46.74
Kaisa,AurelionSol,1376,638,738,46.37
Kaisa,Shyvana,800,353,447,44.13
Kaisa,Qiyana,833,394,439,47.3
Kaisa,Rumble,918,425,493,46.3
Kaisa,Zilean,1084,479,605,44.19
Kaisa,RekSai,449,230,219,51.22
Kaisa,MonkeyKing,2187,912,1275,41.7
Kaisa,Quinn,1140,610,530,53.51
Karma,Jax,2038,1106,932,54.27
Karma,XinZhao,1738,972,766,55.93
Karma,Kennen,684,358,326,52.34
Karma,Kalista,743,376,367,50.61
Karma,Lulu,4203,2159,2044,51.37
Karma,Maokai,1044,493,551,47.22
Karma,Graves,1712,876,836,51.17
Karma,Ahri,3197,1522,1675,47.61
Karma,Nilah,698,328,370,46.99
Karma,Malphite,2230,1167,1063,52.33
Karma,Nasus,1559,756,803,48.49
Karma,Shaco,2161,1099,1062,50.86
Karma,Zed,2622,1368,1254,52.17
Karma,Varus,2178,1166,1012,53.54
Karma,Neeko,1076,499,577,46.38
Karma,Volibear,2253,1141,1112,50.64
Karma,Ekko,2027,1079,948,53.23
Karma,Akshan,790,445,345,56.33
Karma,Yasuo,4526,2292,2234,50.64
Karma,Katarina,1831,922,909,50.35
Karma,Chogath,2653,1318,1335,49.68
Karma,Leblanc,1655,845,810,51.06
Karma,Caitlyn,6286,3193,3093,50.8
Karma,Milio,1625,781,844,48.06
Karma,Sylas,3085,1666,1419,54
Karma,Amumu,2097,1021,1076,48.69
Karma,Vex,1192,615,577,51.59
Karma,Kaisa,4193,2142,2051,51.09
Karma,Rakan,1080,532,548,49.26
Karma,Gangplank,1493,750,743,50.23
Karma,Lillia,1299,650,649,50.04
Karma,MissFortune,4632,2276,2356,49.14
Karma,Soraka,1481,740,741,49.97
Karma,Smolder,1522,841,681,55.26
Karma,Warwick,2783,1313,1470,47.18
Karma,Velkoz,1362,711,651,52.2
Karma,Mordekaiser,2792,1382,1410,49.5
Karma,Mel,4755,2579,2176,54.24
Karma,Ashe,5115,2582,2533,50.48
Karma,Jayce,1495,747,748,49.97
Karma,Gragas,1451,765,686,52.72
Karma,Darius,4322,2082,2240,48.17
Karma,MasterYi,2577,1266,1311,49.13
Karma,Taric,413,207,206,50.12
Karma,Garen,3661,1803,1858,49.25
Karma,Talon,1531,708,823,46.24
Karma,Tristana,2113,1067,1046,50.5
Karma,Aurora,2017,1005,1012,49.83
Karma,Nocturne,2757,1348,1409,48.89
Karma,Pantheon,3696,1855,1841,50.19
Karma,Sett,3055,1492,1563,48.84
Karma,Samira,1439,734,705,51.01
Karma,Illaoi,842,464,378,55.11
Karma,Evelynn,838,401,437,47.85
Karma,Hwei,1661,868,793,52.26
Karma,Senna,1733,867,866,50.03
Karma,Gwen,1106,617,489,55.79
Karma,Elise,1939,1029,910,53.07
Karma,Aatrox,2341,1175,1166,50.19
Karma,Twitch,1794,836,958,46.6
Karma,Ryze,1001,492,509,49.15
Karma,Jhin,4770,2513,2257,52.68
Karma,Nautilus,2599,1263,1336,48.6
Karma,Poppy,1381,699,682,50.62
Karma,Nami,3144,1422,1722,45.23
Karma,Irelia,1993,1031,962,51.73
Karma,Orianna,1166,618,548,53
Karma,Ezreal,6336,3173,3163,50.08
Karma,Bard,883,442,441,50.06
Karma,Sion,1655,831,824,50.21
Karma,Yorick,1976,1000,976,50.61
Karma,Xerath,2490,1264,1226,50.76
Karma,Akali,2560,1267,1293,49.49
Karma,Kayn,2984,1486,1498,49.8
Karma,Ziggs,908,434,474,47.8
Karma,Naafiri,680,330,350,48.53
Karma,Lux,5977,2940,3037,49.19
Karma,Belveth,593,254,339,42.83
Karma,Viego,3328,1652,1676,49.64
Karma,Yuumi,2272,1083,1189,47.67
Karma,Qiyana,690,347,343,50.29
Karma,Singed,737,383,354,51.97
Karma,Riven,1246,636,610,51.04
Karma,LeeSin,4507,2443,2064,54.2
Karma,Olaf,545,303,242,55.6
Karma,Draven,1195,593,602,49.62
Karma,Thresh,3579,1772,1807,49.51
Karma,Swain,2188,1074,1114,49.09
Karma,Shen,1470,758,712,51.56
Karma,Veigar,1889,963,926,50.98
Karma,Blitzcrank,1745,920,825,52.72
Karma,Ambessa,1687,866,821,51.33
Karma,Jinx,6082,2977,3105,48.95
Karma,Brand,1349,737,612,54.63
Karma,Fizz,1134,576,558,50.79
Karma,Yone,4051,2113,1938,52.16
Karma,Karthus,761,428,333,56.24
Karma,Diana,3636,1698,1938,46.7
Karma,Skarner,718,370,348,51.53
Karma,Malzahar,2380,1212,1168,50.92
Karma,Vi,2454,1185,1269,48.29
Karma,Gnar,983,548,435,55.75
Karma,FiddleSticks,1236,618,618,50
Karma,Leona,1815,961,854,52.95
Karma,Nunu,1277,605,672,47.38
Karma,Zoe,1019,540,479,52.99
Karma,TahmKench,1752,938,814,53.54
Karma,Renekton,1306,666,640,51
Karma,Rammus,577,284,293,49.22
Karma,Hecarim,1012,559,453,55.24
Karma,Briar,1649,743,906,45.06
Karma,KogMaw,716,382,334,53.35
Karma,Seraphine,1842,929,913,50.43
Karma,Rell,1180,606,574,51.36
Karma,Kayle,1469,635,834,43.23
Karma,Vayne,2725,1239,1486,45.47
Karma,Lissandra,800,460,340,57.5
Karma,Morgana,2716,1471,1245,54.16
Karma,Camille,1047,570,477,54.44
Karma,Lucian,1797,947,850,52.7
Karma,Tryndamere,1064,528,536,49.62
Karma,Sona,756,306,450,40.48
Karma,Sivir,1423,696,727,48.91
Karma,Trundle,1200,570,630,47.5
Karma,Khazix,1459,786,673,53.87
Karma,Galio,2246,1083,1163,48.22
Karma,Braum,1460,694,766,47.53
Karma,Alistar,885,484,401,54.69
Karma,Zyra,2362,1150,1212,48.69
Karma,Fiora,991,533,458,53.78
Karma,Cassiopeia,666,332,334,49.85
Karma,Anivia,887,446,441,50.28
Karma,Sejuani,1087,585,502,53.82
Karma,Kindred,1006,549,457,54.57
Karma,Viktor,2402,1240,1162,51.62
Karma,DrMundo,1166,541,625,46.4
Karma,Quinn,819,412,407,50.31
Karma,Xayah,1075,606,469,56.37
Karma,Syndra,1650,855,795,51.82
Karma,Zac,1274,613,661,48.12
Karma,Ornn,999,469,530,46.95
Karma,Shyvana,512,253,259,49.41
Karma,Rengar,846,488,358,57.68
Karma,Ivern,438,241,197,55.02
Karma,Corki,997,493,504,49.45
Karma,RekSai,327,161,166,49.24
Karma,Vladimir,1618,754,864,46.6
Karma,KSante,1553,882,671,56.79
Karma,Udyr,870,467,403,53.68
Karma,Janna,896,422,474,47.1
Karma,Teemo,2578,1268,1310,49.19
Karma,Kassadin,518,224,294,43.24
Karma,Zeri,1215,643,572,52.92
Karma,Pyke,2049,1100,949,53.68
Karma,Azir,880,491,389,55.8
Karma,Nidalee,862,471,391,54.64
Karma,MonkeyKing,1745,883,862,50.6
Karma,JarvanIV,1437,677,760,47.11
Karma,Rumble,782,416,366,53.2
Karma,Heimerdinger,991,468,523,47.23
Karma,Taliyah,716,389,327,54.33
Karma,Urgot,1204,599,605,49.75
Karma,TwistedFate,857,482,375,56.24
Karma,AurelionSol,841,386,455,45.9
Karma,Aphelios,1330,725,605,54.51
Karma,Renata,512,266,246,51.95
Karma,Zilean,850,408,442,48
Karma,Annie,784,375,409,47.83
Karma,Kled,422,234,188,55.45
Aatrox,Kennen,709,346,363,48.8
Aatrox,Warwick,2741,1311,1430,47.83
Aatrox,Yasuo,4011,1951,2060,48.64
Aatrox,Kindred,993,519,474,52.27
Aatrox,Lux,4870,2367,2503,48.6
Aatrox,Yorick,1689,713,976,42.21
Aatrox,Kayn,2792,1270,1522,45.49
Aatrox,Ryze,761,451,310,59.26
Aatrox,Pantheon,3218,1520,1698,47.23
Aatrox,Naafiri,743,330,413,44.41
Aatrox,Briar,1555,722,833,46.43
Aatrox,Yone,4274,2148,2126,50.26
Aatrox,MissFortune,4203,1984,2219,47.2
Aatrox,Senna,1363,691,672,50.7
Aatrox,Kayle,1343,597,746,44.45
Aatrox,Viego,3036,1521,1515,50.1
Aatrox,Irelia,1820,838,982,46.04
Aatrox,Jinx,5328,2466,2862,46.28
Aatrox,Thresh,3260,1570,1690,48.16
Aatrox,Darius,4210,2053,2157,48.76
Aatrox,Rengar,706,446,260,63.17
Aatrox,Syndra,1162,511,651,43.98
Aatrox,Caitlyn,5036,2349,2687,46.64
Aatrox,XinZhao,1368,665,703,48.61
Aatrox,Katarina,1620,781,839,48.21
Aatrox,Teemo,2765,1263,1502,45.68
Aatrox,Vayne,2315,1075,1240,46.44
Aatrox,TwistedFate,798,411,387,51.5
Aatrox,Shen,1231,605,626,49.15
Aatrox,Diana,3125,1504,1621,48.13
Aatrox,Samira,1519,744,775,48.98
Aatrox,Soraka,1080,517,563,47.87
Aatrox,Garen,3271,1554,1717,47.51
Aatrox,FiddleSticks,1060,543,517,51.23
Aatrox,Brand,1279,609,670,47.62
Aatrox,Tryndamere,935,491,444,52.51
Aatrox,Graves,1526,767,759,50.26
Aatrox,Sylas,2773,1366,1407,49.26
Aatrox,Leona,1715,842,873,49.1
Aatrox,Mordekaiser,2870,1343,1527,46.79
Aatrox,Janna,664,294,370,44.28
Aatrox,Volibear,2100,983,1117,46.81
Aatrox,Khazix,1162,573,589,49.31
Aatrox,Akali,2159,1053,1106,48.77
Aatrox,Draven,1089,433,656,39.76
Aatrox,Mel,4054,2080,1974,51.31
Aatrox,Smolder,1326,715,611,53.92
Aatrox,Rell,1159,584,575,50.39
Aatrox,Sett,3354,1673,1681,49.88
Aatrox,Tristana,1875,855,1020,45.6
Aatrox,Blitzcrank,1691,853,838,50.44
Aatrox,Poppy,1174,603,571,51.36
Aatrox,Nunu,1123,560,563,49.87
Aatrox,Zed,2170,1125,1045,51.84
Aatrox,Rakan,987,495,492,50.15
Aatrox,Fiora,954,509,445,53.35
Aatrox,Ekko,1773,803,970,45.29
Aatrox,Kassadin,421,233,188,55.34
Aatrox,TahmKench,1722,902,820,52.38
Aatrox,Camille,810,419,391,51.73
Aatrox,Xayah,1070,556,514,51.96
Aatrox,Yuumi,1932,923,1009,47.77
Aatrox,Veigar,1891,912,979,48.23
Aatrox,KSante,1358,711,647,52.36
Aatrox,Jax,1713,801,912,46.76
Aatrox,Velkoz,1139,532,607,46.71
Aatrox,Gangplank,1561,786,775,50.35
Aatrox,Malzahar,1878,845,1033,44.99
Aatrox,Heimerdinger,843,357,486,42.35
Aatrox,Ashe,4321,2174,2147,50.31
Aatrox,Pyke,1736,1005,731,57.89
Aatrox,Nasus,1340,596,744,44.48
Aatrox,Azir,769,381,388,49.54
Aatrox,Nami,2224,1044,1180,46.94
Aatrox,Shaco,1840,942,898,51.2
Aatrox,Annie,675,357,318,52.89
Aatrox,Olaf,415,189,226,45.54
Aatrox,Aurora,1667,855,812,51.29
Aatrox,Vladimir,1162,591,571,50.86
Aatrox,Gnar,900,498,402,55.33
Aatrox,Twitch,1495,760,735,50.84
Aatrox,Xerath,1824,887,937,48.63
Aatrox,Morgana,2214,1030,1184,46.52
Aatrox,Zoe,863,454,409,52.61
Aatrox,Karma,2341,1166,1175,49.81
Aatrox,Ornn,912,436,476,47.81
Aatrox,Kalista,697,356,341,51.08
Aatrox,Chogath,2261,1105,1156,48.87
Aatrox,Hecarim,759,367,392,48.35
Aatrox,Malphite,2053,1024,1029,49.88
Aatrox,Maokai,924,442,482,47.84
Aatrox,Sona,549,261,288,47.54
Aatrox,Ivern,296,190,106,64.19
Aatrox,Belveth,474,252,222,53.16
Aatrox,Jhin,3859,1955,1904,50.66
Aatrox,LeeSin,3533,1801,1732,50.98
Aatrox,Lillia,1133,608,525,53.66
Aatrox,Jayce,1227,675,552,55.01
Aatrox,DrMundo,1253,609,644,48.6
Aatrox,Seraphine,1607,728,879,45.3
Aatrox,Galio,1851,905,946,48.89
Aatrox,Nilah,750,354,396,47.2
Aatrox,Urgot,1098,506,592,46.08
Aatrox,MasterYi,2264,1059,1205,46.78
Aatrox,Sejuani,943,508,435,53.87
Aatrox,Amumu,1606,717,889,44.65
Aatrox,Ahri,2713,1363,1350,50.24
Aatrox,Nautilus,2261,1106,1155,48.92
Aatrox,Qiyana,603,290,313,48.09
Aatrox,Rumble,656,306,350,46.65
Aatrox,Ambessa,1356,588,768,43.36
Aatrox,Elise,1477,713,764,48.27
Aatrox,Kaisa,3430,1767,1663,51.52
Aatrox,Vi,1887,913,974,48.38
Aatrox,Vex,1126,610,516,54.17
Aatrox,Milio,1263,536,727,42.44
Aatrox,Zeri,976,478,498,48.98
Aatrox,Singed,639,243,396,38.03
Aatrox,Orianna,894,388,506,43.4
Aatrox,Zilean,707,338,369,47.81
Aatrox,Lucian,1586,814,772,51.32
Aatrox,Cassiopeia,651,357,294,54.84
Aatrox,Aphelios,1114,519,595,46.59
Aatrox,MonkeyKing,1265,621,644,49.09
Aatrox,Trundle,924,430,494,46.54
Aatrox,Illaoi,916,433,483,47.27
Aatrox,Gragas,1395,672,723,48.17
Aatrox,Braum,1074,490,584,45.62
Aatrox,Nidalee,757,450,307,59.45
Aatrox,Lulu,2738,1348,1390,49.23
Aatrox,Karthus,608,346,262,56.91
Aatrox,Neeko,1048,516,532,49.24
Aatrox,Ziggs,814,379,435,46.56
Aatrox,JarvanIV,1246,629,617,50.48
Aatrox,Evelynn,796,379,417,47.61
Aatrox,Leblanc,1317,716,601,54.37
Aatrox,Ezreal,4991,2542,2449,50.93
Aatrox,Gwen,1012,501,511,49.51
Aatrox,Skarner,593,309,284,52.11
Aatrox,Varus,1872,923,949,49.31
Aatrox,Corki,775,396,379,51.1
Aatrox,Rammus,646,296,350,45.82
Aatrox,Fizz,1077,464,613,43.08
Aatrox,Swain,2043,986,1057,48.26
Aatrox,Kled,428,206,222,48.13
Aatrox,Sivir,1100,545,555,49.55
Aatrox,Udyr,837,403,434,48.15
Aatrox,Riven,844,437,407,51.78
Aatrox,Renekton,1266,542,724,42.81
Aatrox,Hwei,1430,683,747,47.76
Aatrox,KogMaw,622,232,390,37.3
Aatrox,RekSai,274,146,128,53.28
Aatrox,Anivia,670,317,353,47.31
Aatrox,Alistar,905,423,482,46.74
Aatrox,Sion,1494,790,704,52.88
Aatrox,Talon,1204,591,613,49.09
Aatrox,Akshan,660,316,344,47.88
Aatrox,Lissandra,607,267,340,43.99
Aatrox,Renata,415,200,215,48.19
Aatrox,Nocturne,2515,1084,1431,43.1
Aatrox,Viktor,1739,831,908,47.79
Aatrox,AurelionSol,866,369,497,42.61
Aatrox,Zac,1079,572,507,53.01
Aatrox,Bard,641,341,300,53.2
Aatrox,Taliyah,555,249,306,44.86
Aatrox,Zyra,1690,772,918,45.68
Aatrox,Quinn,638,352,286,55.17
Aatrox,Taric,387,221,166,57.11
Aatrox,Shyvana,378,147,231,38.89
Sylas,Kennen,925,508,417,54.92
Sylas,Warwick,3960,1897,2063,47.9
Sylas,Yasuo,6097,2835,3262,46.5
Sylas,Kindred,1267,619,648,48.86
Sylas,Lux,6342,3108,3234,49.01
Sylas,Maokai,1390,642,748,46.19
Sylas,Graves,2065,942,1123,45.62
Sylas,Ahri,4374,2177,2197,49.77
Sylas,Nilah,948,468,480,49.37
Sylas,Malphite,4193,2299,1894,54.83
Sylas,Mordekaiser,3494,1654,1840,47.34
Sylas,Qiyana,773,390,383,50.45
Sylas,Ashe,6315,3207,3108,50.78
Sylas,Sona,817,419,398,51.29
Sylas,Illaoi,1275,530,745,41.57
Sylas,Twitch,1860,873,987,46.94
Sylas,Yone,6002,3073,2929,51.2
Sylas,Velkoz,1318,569,749,43.17
Sylas,Swain,3071,1431,1640,46.6
Sylas,Malzahar,2309,1060,1249,45.91
Sylas,Irelia,2379,1292,1087,54.31
Sylas,Kalista,907,525,382,57.88
Sylas,Poppy,1554,690,864,44.4
Sylas,Kayle,1706,807,899,47.3
Sylas,MonkeyKing,1900,870,1030,45.79
Sylas,RekSai,322,170,152,52.8
Sylas,Seraphine,2247,1109,1138,49.35
Sylas,Briar,1810,778,1032,42.98
Sylas,Evelynn,947,495,452,52.27
Sylas,Tristana,2552,1191,1361,46.67
Sylas,Thresh,3976,1865,2111,46.91
Sylas,Ryze,1160,521,639,44.91
Sylas,Morgana,2916,1372,1544,47.05
Sylas,Xayah,1538,724,814,47.07
Sylas,Veigar,2591,1288,1303,49.71
Sylas,FiddleSticks,1649,815,834,49.42
Sylas,Akali,3784,1946,1838,51.43
Sylas,Senna,1848,899,949,48.65
Sylas,Kayn,3563,1640,1923,46.03
Sylas,TwistedFate,1084,523,561,48.25
Sylas,Smolder,1750,897,853,51.26
Sylas,Nautilus,3479,1777,1702,51.08
Sylas,Diana,4625,2224,2401,48.09
Sylas,MissFortune,6088,2848,3240,46.78
Sylas,Karma,3085,1419,1666,46
Sylas,Pantheon,4618,2071,2547,44.85
Sylas,Garen,4534,2180,2354,48.08
Sylas,Ziggs,927,484,443,52.21
Sylas,Zeri,1291,676,615,52.36
Sylas,Zyra,2501,1238,1263,49.5
Sylas,Nocturne,3660,1824,1836,49.84
Sylas,Lissandra,896,476,420,53.13
Sylas,Jhin,5157,2588,2569,50.18
Sylas,Mel,5864,3052,2812,52.05
Sylas,Singed,700,370,330,52.86
Sylas,Pyke,2662,1362,1300,51.16
Sylas,Aatrox,2773,1407,1366,50.74
Sylas,Ezreal,7804,3928,3876,50.33
Sylas,Milio,1347,662,685,49.15
Sylas,Yorick,2070,1050,1020,50.72
Sylas,Gragas,1793,904,889,50.42
Sylas,Volibear,2756,1358,1398,49.27
Sylas,Khazix,1427,729,698,51.09
Sylas,Draven,1329,670,659,50.41
Sylas,Gnar,1299,690,609,53.12
Sylas,Jax,2615,1238,1377,47.34
Sylas,Aurora,2371,1200,1171,50.61
Sylas,Bard,841,404,437,48.04
Sylas,Riven,1222,618,604,50.57
Sylas,Syndra,1311,667,644,50.88
Sylas,Jinx,7080,3340,3740,47.18
Sylas,Zed,3263,1735,1528,53.17
Sylas,Talon,1883,1004,879,53.32
Sylas,Rammus,790,385,405,48.73
Sylas,Akshan,792,360,432,45.45
Sylas,Chogath,3368,1638,1730,48.63
Sylas,Lillia,1594,746,848,46.8
Sylas,Vex,1800,788,1012,43.78
Sylas,Janna,746,324,422,43.43
Sylas,Sett,4182,1858,2324,44.43
Sylas,Cassiopeia,902,406,496,45.01
Sylas,Fiora,959,499,460,52.03
Sylas,LeeSin,5287,2695,2592,50.97
Sylas,Zilean,879,420,459,47.78
Sylas,Rengar,749,370,379,49.4
Sylas,Anivia,936,468,468,50
Sylas,Galio,3416,1593,1823,46.63
Sylas,Naafiri,1000,468,532,46.8
Sylas,Vi,2909,1438,1471,49.43
Sylas,Aphelios,1522,712,810,46.78
Sylas,Heimerdinger,1244,456,788,36.66
Sylas,Varus,2726,1349,1377,49.49
Sylas,Gwen,1353,667,686,49.3
Sylas,JarvanIV,1685,868,817,51.51
Sylas,Leblanc,1696,883,813,52.06
Sylas,Samira,2041,957,1084,46.89
Sylas,Shen,1654,763,891,46.13
Sylas,Darius,4832,2345,2487,48.53
Sylas,Shaco,2239,1101,1138,49.17
Sylas,Zoe,1143,548,595,47.94
Sylas,Ivern,444,191,253,43.02
Sylas,Quinn,882,454,428,51.47
Sylas,TahmKench,2161,1083,1078,50.12
Sylas,XinZhao,1917,997,920,52.01
Sylas,AurelionSol,857,417,440,48.66
Sylas,Rakan,1315,658,657,50.04
Sylas,Shyvana,567,279,288,49.21
Sylas,Viktor,2511,1272,1239,50.66
Sylas,Lucian,2020,1037,983,51.34
Sylas,Soraka,1447,722,725,49.9
Sylas,Neeko,1492,762,730,51.07
Sylas,Xerath,2436,1192,1244,48.93
Sylas,Renekton,1515,740,775,48.84
Sylas,Sivir,1554,734,820,47.23
Sylas,Sejuani,1421,701,720,49.33
Sylas,Blitzcrank,2464,1296,1168,52.6
Sylas,Ornn,1349,621,728,46.03
Sylas,Vayne,3079,1422,1657,46.18
Sylas,Nasus,1893,895,998,47.28
Sylas,Amumu,2928,1407,1521,48.05
Sylas,Caitlyn,6996,3494,3502,49.94
Sylas,KogMaw,787,386,401,49.05
Sylas,Ekko,2508,1244,1264,49.6
Sylas,Yuumi,2240,1153,1087,51.47
Sylas,Katarina,2055,1032,1023,50.22
Sylas,Lulu,3660,1831,1829,50.03
Sylas,Gangplank,1618,778,840,48.08
Sylas,Skarner,883,459,424,51.98
Sylas,Vladimir,1760,860,900,48.86
Sylas,Rell,1374,660,714,48.03
Sylas,Viego,4073,1903,2170,46.72
Sylas,KSante,1700,834,866,49.06
Sylas,Teemo,3234,1497,1737,46.29
Sylas,Braum,1677,778,899,46.39
Sylas,Kaisa,4958,2468,2490,49.78
Sylas,DrMundo,1389,724,665,52.12
Sylas,Annie,764,357,407,46.73
Sylas,Urgot,1198,586,612,48.91
Sylas,Kassadin,500,223,277,44.6
Sylas,Taliyah,831,400,431,48.13
Sylas,Kled,516,236,280,45.74
Sylas,Nami,2373,1115,1258,46.99
Sylas,Udyr,953,467,486,49
Sylas,Camille,1056,546,510,51.7
Sylas,Nidalee,912,478,434,52.41
Sylas,MasterYi,2979,1408,1571,47.26
Sylas,Corki,1096,555,541,50.64
Sylas,Orianna,1336,685,651,51.27
Sylas,Elise,2071,1044,1027,50.41
Sylas,Zac,1481,738,743,49.83
Sylas,Alistar,1672,888,784,53.11
Sylas,Tryndamere,1296,653,643,50.39
Sylas,Leona,2643,1302,1341,49.26
Sylas,Ambessa,1802,890,912,49.39
Sylas,Nunu,1674,827,847,49.4
Sylas,Azir,1143,578,565,50.57
Sylas,Rumble,878,419,459,47.72
Sylas,Sion,2008,922,1086,45.92
Sylas,Belveth,603,305,298,50.58
Sylas,Hwei,1720,838,882,48.72
Sylas,Hecarim,1205,646,559,53.61
Sylas,Taric,570,258,312,45.26
Sylas,Olaf,609,281,328,46.14
Sylas,Fizz,1401,736,665,52.53
Sylas,Brand,1686,827,859,49.05
Sylas,Renata,489,252,237,51.53
Sylas,Trundle,1391,671,720,48.24
Sylas,Karthus,802,389,413,48.5
Sylas,Jayce,1520,703,817,46.25
Diana,Kennen,1005,535,470,53.23
Diana,Warwick,4913,2212,2701,45.02
Diana,Yasuo,6067,3000,3067,49.45
Diana,Kindred,1564,847,717,54.16
Diana,Lux,8246,4243,4003,51.46
Diana,Vladimir,2062,1086,976,52.67
Diana,Darius,6298,3187,3111,50.6
Diana,KogMaw,997,516,481,51.76
Diana,Yuumi,2744,1508,1236,54.96
Diana,Sett,5108,2455,2653,48.06
Diana,Ivern,543,307,236,56.54
Diana,Veigar,3482,1790,1692,51.41
Diana,Jinx,8437,4034,4403,47.81
Diana,Lulu,4204,2102,2102,50
Diana,Garen,5151,2590,2561,50.28
Diana,Briar,2596,1240,1356,47.77
Diana,Zed,3923,2073,1850,52.84
Diana,Caitlyn,8493,4407,4086,51.89
Diana,Morgana,4041,2084,1957,51.57
Diana,Mordekaiser,4534,2182,2352,48.13
Diana,Ryze,1083,542,541,50.05
Diana,Vex,1894,960,934,50.69
Diana,Gwen,1904,1028,876,53.99
Diana,Skarner,913,471,442,51.59
Diana,Yone,5963,3044,2919,51.05
Diana,Kaisa,5407,2840,2567,52.52
Diana,Seraphine,2616,1385,1231,52.94
Diana,Ambessa,2111,1069,1042,50.64
Diana,Xayah,1770,900,870,50.85
Diana,AurelionSol,1214,605,609,49.84
Diana,Khazix,1714,895,819,52.22
Diana,Nautilus,3648,1857,1791,50.9
Diana,Vi,3199,1717,1482,53.67
Diana,Azir,1229,649,580,52.81
Diana,MissFortune,7755,3928,3827,50.65
Diana,Chogath,3896,1838,2058,47.18
Diana,Graves,2166,1096,1070,50.6
Diana,Leblanc,2005,1032,973,51.47
Diana,Milio,1723,834,889,48.4
Diana,Annie,1034,539,495,52.13
Diana,Kayn,5179,2574,2605,49.7
Diana,Aatrox,3125,1621,1504,51.87
Diana,Pyke,2751,1376,1375,50.02
Diana,Sylas,4625,2401,2224,51.91
Diana,Amumu,3642,1708,1934,46.9
Diana,Rakan,1317,654,663,49.66
Diana,Gangplank,1703,870,833,51.09
Diana,Lillia,1932,1040,892,53.83
Diana,Soraka,1619,869,750,53.68
Diana,Nasus,2375,1159,1216,48.8
Diana,Neeko,1673,882,791,52.72
Diana,Swain,3054,1446,1608,47.35
Diana,Shen,2031,983,1048,48.4
Diana,Rammus,898,491,407,54.68
Diana,Cassiopeia,1115,553,562,49.6
Diana,Sivir,1753,800,953,45.64
Diana,Xerath,2745,1344,1401,48.96
Diana,Jax,3006,1526,1480,50.77
Diana,Evelynn,1425,736,689,51.65
Diana,Mel,7008,3721,3287,53.1
Diana,Kalista,1046,529,517,50.57
Diana,Renata,637,339,298,53.22
Diana,Fiora,1291,724,567,56.08
Diana,Shaco,3104,1631,1473,52.55
Diana,Fizz,1801,944,857,52.42
Diana,Tristana,3048,1553,1495,50.95
Diana,Renekton,1643,846,797,51.49
Diana,Karthus,1068,560,508,52.43
Diana,Ashe,6458,3430,3028,53.11
Diana,Maokai,1479,760,719,51.39
Diana,Aurora,2849,1475,1374,51.77
Diana,Nilah,1101,542,559,49.23
Diana,Hwei,2117,1025,1092,48.42
Diana,Volibear,3665,1795,1870,48.98
Diana,XinZhao,2245,1111,1134,49.49
Diana,Irelia,2652,1358,1294,51.21
Diana,Nami,3406,1681,1725,49.35
Diana,Samira,2410,1171,1239,48.59
Diana,Malphite,3014,1519,1495,50.4
Diana,Sion,2389,1195,1194,50.02
Diana,Ahri,4578,2406,2172,52.56
Diana,Draven,1670,860,810,51.5
Diana,Akali,3626,1867,1759,51.49
Diana,Ezreal,7703,4053,3650,52.62
Diana,Senna,2315,1136,1179,49.07
Diana,Yorick,3013,1472,1541,48.85
Diana,Malzahar,3375,1722,1653,51.02
Diana,Aphelios,1991,985,1006,49.47
Diana,Braum,1812,899,913,49.61
Diana,Trundle,1752,832,920,47.49
Diana,Blitzcrank,2402,1235,1167,51.42
Diana,Poppy,2077,1041,1036,50.12
Diana,Twitch,2691,1339,1352,49.76
Diana,Viego,4873,2379,2494,48.82
Diana,Katarina,2567,1335,1232,52.01
Diana,Jayce,1629,882,747,54.14
Diana,Jhin,6028,3029,2999,50.25
Diana,Thresh,4604,2232,2372,48.48
Diana,Illaoi,1594,763,831,47.87
Diana,MasterYi,4214,2090,2124,49.6
Diana,Vayne,3857,1869,1988,48.46
Diana,Sona,1048,508,540,48.47
Diana,Kayle,2158,1104,1054,51.16
Diana,JarvanIV,1868,945,923,50.59
Diana,LeeSin,5189,2611,2578,50.32
Diana,Naafiri,1192,599,593,50.25
Diana,KSante,1850,981,869,53.03
Diana,Nunu,1904,1017,887,53.41
Diana,Teemo,4295,2124,2171,49.45
Diana,Kassadin,747,364,383,48.73
Diana,Ziggs,1335,603,732,45.17
Diana,RekSai,353,201,152,56.94
Diana,Talon,2034,1043,991,51.28
Diana,Rell,1590,765,825,48.11
Diana,Leona,2749,1423,1326,51.76
Diana,Elise,2214,1195,1019,53.97
Diana,Rengar,1058,616,442,58.22
Diana,Galio,3286,1540,1746,46.87
Diana,Lucian,2265,1201,1064,53.02
Diana,Hecarim,1115,591,524,53
Diana,Ekko,2930,1518,1412,51.81
Diana,Zac,1585,783,802,49.4
Diana,Riven,1416,779,637,55.01
Diana,Gragas,1889,1048,841,55.48
Diana,Olaf,646,333,313,51.55
Diana,Kled,563,277,286,49.2
Diana,Karma,3636,1938,1698,53.3
Diana,Velkoz,1881,845,1036,44.92
Diana,Brand,2351,1092,1259,46.45
Diana,Bard,927,461,466,49.73
Diana,Heimerdinger,1549,708,841,45.71
Diana,TahmKench,2721,1450,1271,53.29
Diana,Qiyana,859,472,387,54.95
Diana,Nocturne,4023,1975,2048,49.09
Diana,Varus,2813,1435,1378,51.01
Diana,Lissandra,1090,521,569,47.8
Diana,Camille,1185,621,564,52.41
Diana,Pantheon,5435,2844,2591,52.33
Diana,DrMundo,1895,930,965,49.08
Diana,Nidalee,1008,571,437,56.65
Diana,Smolder,2349,1186,1163,50.49
Diana,Zoe,1283,673,610,52.46
Diana,Udyr,1243,653,590,52.53
Diana,Tryndamere,1711,851,860,49.74
Diana,Alistar,1442,770,672,53.4
Diana,Sejuani,1346,692,654,51.41
Diana,Zyra,2946,1455,1491,49.39
Diana,FiddleSticks,1704,862,842,50.59
Diana,Ornn,1396,732,664,52.44
Diana,MonkeyKing,2249,1014,1235,45.09
Diana,Quinn,978,495,483,50.61
Diana,Zilean,935,489,446,52.3
Diana,Taric,744,340,404,45.7
Diana,Akshan,990,510,480,51.52
Diana,Gnar,1299,714,585,54.97
Diana,Singed,843,435,408,51.6
Diana,Janna,1070,536,534,50.09
Diana,Taliyah,823,443,380,53.83
Diana,Corki,1196,631,565,52.76
Diana,Viktor,2663,1374,1289,51.6
Diana,Orianna,1456,860,596,59.07
Diana,TwistedFate,1173,641,532,54.65
Diana,Shyvana,878,420,458,47.84
Diana,Anivia,1079,489,590,45.32
Diana,Urgot,1622,796,826,49.08
Diana,Syndra,2048,977,1071,47.71
Diana,Belveth,719,388,331,53.96
Diana,Zeri,1462,765,697,52.33
Diana,Rumble,909,487,422,53.58
Varus,Kennen,570,234,336,41.05
Varus,Warwick,2513,1129,1384,44.93
Varus,Yasuo,3483,1619,1864,46.48
Varus,Kindred,781,402,379,51.47
Varus,Lux,4502,2153,2349,47.82
Varus,Fiora,665,376,289,56.54
Varus,MasterYi,2187,1071,1116,48.97
Varus,Mel,3815,1954,1861,51.22
Varus,Jhin,3799,1821,1978,47.93
Varus,Karma,2178,1012,1166,46.46
Varus,Fizz,983,481,502,48.93
Varus,Gnar,877,456,421,52
Varus,Caitlyn,5359,2678,2681,49.97
Varus,Neeko,1015,516,499,50.84
Varus,Gangplank,956,496,460,51.88
Varus,Chogath,2176,1042,1134,47.89
Varus,Galio,1675,818,857,48.84
Varus,MissFortune,4166,2002,2164,48.06
Varus,Soraka,1069,531,538,49.67
Varus,Kled,354,204,150,57.63
Varus,Kayn,2423,1138,1285,46.97
Varus,AurelionSol,703,375,328,53.34
Varus,Tristana,1731,821,910,47.43
Varus,Pyke,1647,892,755,54.16
Varus,Nasus,1208,584,624,48.34
Varus,FiddleSticks,838,438,400,52.27
Varus,Azir,673,365,308,54.23
Varus,Xayah,838,413,425,49.28
Varus,Nami,1887,906,981,48.01
Varus,Olaf,560,258,302,46.07
Varus,Volibear,2098,956,1142,45.57
Varus,Aurora,1365,698,667,51.14
Varus,Ashe,4214,2097,2117,49.76
Varus,Smolder,1248,636,612,50.96
Varus,Rengar,686,368,318,53.64
Varus,Hwei,1314,705,609,53.65
Varus,Thresh,2614,1282,1332,49.04
Varus,Pantheon,3036,1408,1628,46.38
Varus,Xerath,1719,724,995,42.12
Varus,Morgana,2071,1003,1068,48.43
Varus,Braum,989,478,511,48.33
Varus,Skarner,563,297,266,52.75
Varus,Syndra,1195,543,652,45.44
Varus,Hecarim,801,397,404,49.56
Varus,Talon,1176,629,547,53.49
Varus,Samira,1355,688,667,50.77
Varus,Blitzcrank,1426,701,725,49.16
Varus,Garen,2939,1331,1608,45.29
Varus,Nocturne,2039,936,1103,45.9
Varus,Vladimir,1051,491,560,46.72
Varus,Sylas,2726,1377,1349,50.51
Varus,Ekko,1621,751,870,46.33
Varus,Malphite,1805,851,954,47.15
Varus,Poppy,1209,641,568,53.02
Varus,Ornn,905,485,420,53.59
Varus,Ambessa,1345,651,694,48.4
Varus,Zoe,764,422,342,55.24
Varus,Swain,1856,872,984,46.98
Varus,Mordekaiser,2497,1246,1251,49.9
Varus,Amumu,1900,846,1054,44.53
Varus,Yone,3346,1681,1665,50.24
Varus,Zyra,1732,918,814,53
Varus,Ezreal,4986,2502,2484,50.18
Varus,Seraphine,1485,740,745,49.83
Varus,MonkeyKing,1243,609,634,48.99
Varus,Rakan,821,385,436,46.89
Varus,Sett,2925,1371,1554,46.87
Varus,Lucian,1274,605,669,47.49
Varus,Veigar,1823,871,952,47.78
Varus,Zilean,583,276,307,47.34
Varus,Irelia,1450,732,718,50.48
Varus,Darius,3389,1626,1763,47.98
Varus,Shaco,1643,844,799,51.37
Varus,Ahri,2483,1250,1233,50.34
Varus,Graves,1278,623,655,48.75
Varus,Taliyah,539,251,288,46.57
Varus,Yuumi,1725,853,872,49.45
Varus,Camille,733,373,360,50.89
Varus,Briar,1287,582,705,45.22
Varus,Viktor,1524,743,781,48.75
Varus,Jinx,5202,2504,2698,48.14
Varus,Senna,1391,669,722,48.09
Varus,Jayce,1079,518,561,48.01
Varus,Malzahar,1806,840,966,46.51
Varus,Lulu,2407,1200,1207,49.85
Varus,Annie,629,283,346,44.99
Varus,Tryndamere,930,503,427,54.09
Varus,Zac,1056,510,546,48.3
Varus,Alistar,713,318,395,44.6
Varus,Leona,1538,705,833,45.84
Varus,Viego,2536,1263,1273,49.8
Varus,Orianna,932,411,521,44.1
Varus,Twitch,1501,743,758,49.5
Varus,LeeSin,2871,1432,1439,49.88
Varus,Illaoi,829,393,436,47.41
Varus,XinZhao,1284,594,690,46.26
Varus,Teemo,2292,1082,1210,47.21
Varus,Akali,1925,1002,923,52.05
Varus,Vayne,2194,1062,1132,48.4
Varus,Nautilus,1979,1000,979,50.53
Varus,Aatrox,1872,949,923,50.69
Varus,Rumble,556,291,265,52.34
Varus,TahmKench,1545,763,782,49.39
Varus,Kaisa,3074,1509,1565,49.09
Varus,Ziggs,732,295,437,40.3
Varus,Jax,1698,798,900,47
Varus,Diana,2813,1378,1435,48.99
Varus,Heimerdinger,736,328,408,44.57
Varus,Milio,1011,500,511,49.46
Varus,Urgot,810,376,434,46.42
Varus,Shen,1193,602,591,50.46
Varus,KogMaw,647,287,360,44.36
Varus,Lillia,1022,516,506,50.49
Varus,Khazix,1056,527,529,49.91
Varus,Sion,1439,661,778,45.93
Varus,Sejuani,808,326,482,40.35
Varus,KSante,1100,554,546,50.36
Varus,Gwen,973,465,508,47.79
Varus,Gragas,1119,545,574,48.7
Varus,Sona,572,288,284,50.35
Varus,Ivern,307,134,173,43.65
Varus,Kassadin,423,199,224,47.04
Varus,Evelynn,665,324,341,48.72
Varus,Draven,1018,517,501,50.79
Varus,Zed,1976,987,989,49.95
Varus,Singed,527,244,283,46.3
Varus,Renata,298,135,163,45.3
Varus,Trundle,915,432,483,47.21
Varus,Shyvana,462,199,263,43.07
Varus,Taric,397,223,174,56.17
Varus,Corki,744,415,329,55.78
Varus,Anivia,582,263,319,45.19
Varus,Sivir,1109,575,534,51.85
Varus,Vi,1767,850,917,48.1
Varus,Rammus,578,319,259,55.19
Varus,Janna,585,252,333,43.08
Varus,Karthus,551,223,328,40.47
Varus,DrMundo,1019,497,522,48.77
Varus,Nunu,1203,580,623,48.21
Varus,Leblanc,1148,600,548,52.26
Varus,Katarina,1533,825,708,53.82
Varus,Akshan,595,312,283,52.44
Varus,Brand,1160,564,596,48.62
Varus,Quinn,659,313,346,47.5
Varus,Qiyana,498,279,219,56.02
Varus,Nilah,600,267,333,44.5
Varus,Vex,1001,495,506,49.45
Varus,TwistedFate,653,340,313,52.07
Varus,JarvanIV,1195,596,599,49.87
Varus,Riven,767,373,394,48.63
Varus,Velkoz,1084,524,560,48.34
Varus,Rell,920,434,486,47.17
Varus,Cassiopeia,545,254,291,46.61
Varus,Nidalee,601,339,262,56.41
Varus,Aphelios,1095,548,547,50.05
Varus,Elise,1404,708,696,50.43
Varus,Ryze,696,340,356,48.85
Varus,Zeri,914,473,441,51.75
Varus,Bard,544,271,273,49.82
Varus,Lissandra,552,253,299,45.83
Varus,Yorick,1743,806,937,46.24
Varus,Naafiri,612,335,277,54.74
Varus,Udyr,698,374,324,53.58
Varus,Belveth,488,214,274,43.85
Varus,Maokai,909,449,460,49.39
Varus,Kalista,654,341,313,52.14
Varus,Kayle,1217,558,659,45.85
Varus,Renekton,932,503,429,53.97
Varus,RekSai,240,144,96,60
Kindred,Aatrox,993,474,519,47.73
Kindred,Sylas,1267,648,619,51.14
Kindred,Diana,1564,717,847,45.84
Kindred,Varus,781,379,402,48.53
Kindred,Blitzcrank,761,407,354,53.48
Kindred,Fiora,431,259,172,60.09
Kindred,Belveth,259,136,123,52.51
Kindred,Ezreal,2231,1170,1061,52.44
Kindred,Yuumi,902,406,496,45.01
Kindred,Volibear,1034,502,532,48.55
Kindred,Ekko,984,537,447,54.57
Kindred,Yone,1829,955,874,52.21
Kindred,Kalista,349,163,186,46.7
Kindred,Pyke,1042,500,542,47.98
Kindred,Warwick,1456,685,771,47.05
Kindred,Singed,247,113,134,45.75
Kindred,Ryze,303,131,172,43.23
Kindred,Samira,763,322,441,42.2
Kindred,Soraka,575,249,326,43.3
Kindred,Mordekaiser,1371,597,774,43.54
Kindred,Briar,836,319,517,38.16
Kindred,Zed,1000,523,477,52.3
Kindred,Jinx,2749,1311,1438,47.69
Kindred,Lillia,651,344,307,52.84
Kindred,Yasuo,1883,862,1021,45.78
Kindred,FiddleSticks,542,293,249,54.06
Kindred,Mel,1882,988,894,52.5
Kindred,Amumu,1089,443,646,40.68
Kindred,Thresh,1355,633,722,46.72
Kindred,Gnar,428,209,219,48.83
Kindred,Malzahar,1051,437,614,41.58
Kindred,Tristana,932,485,447,52.04
Kindred,Brand,695,318,377,45.76
Kindred,Quinn,320,168,152,52.5
Kindred,Talon,608,303,305,49.84
Kindred,Syndra,521,237,284,45.49
Kindred,Caitlyn,2501,1161,1340,46.42
Kindred,Sett,1638,730,908,44.57
Kindred,MasterYi,1092,509,583,46.61
Kindred,AurelionSol,381,202,179,53.02
Kindred,Seraphine,817,383,434,46.88
Kindred,Nasus,771,293,478,38
Kindred,Nocturne,1181,577,604,48.86
Kindred,Aurora,845,408,437,48.28
Kindred,Nunu,617,270,347,43.76
Kindred,TwistedFate,354,142,212,40.11
Kindred,Teemo,1270,550,720,43.31
Kindred,Malphite,979,442,537,45.15
Kindred,Vladimir,664,331,333,49.85
Kindred,Ziggs,415,203,212,48.92
Kindred,Urgot,505,271,234,53.66
Kindred,Xerath,778,348,430,44.73
Kindred,Pantheon,1645,749,896,45.53
Kindred,TahmKench,848,393,455,46.34
Kindred,Qiyana,281,165,116,58.72
Kindred,Ashe,1917,902,1015,47.05
Kindred,Garen,1688,798,890,47.27
Kindred,Maokai,468,227,241,48.5
Kindred,Sion,757,325,432,42.93
Kindred,Akali,1026,470,556,45.81
Kindred,Lux,2594,1242,1352,47.88
Kindred,Riven,434,204,230,47
Kindred,Shaco,1043,495,548,47.46
Kindred,Jhin,1924,887,1037,46.1
Kindred,Senna,817,391,426,47.86
Kindred,Milio,528,235,293,44.51
Kindred,Naafiri,378,198,180,52.38
Kindred,Orianna,449,237,212,52.78
Kindred,Zilean,316,128,188,40.51
Kindred,Vex,606,282,324,46.53
Kindred,Illaoi,431,231,200,53.6
Kindred,MonkeyKing,657,338,319,51.45
Kindred,Twitch,787,368,419,46.76
Kindred,Nautilus,1112,576,536,51.8
Kindred,Galio,899,458,441,50.95
Kindred,Sona,371,181,190,48.79
Kindred,Hecarim,434,191,243,44.01
Kindred,Zyra,858,368,490,42.89
Kindred,Trundle,588,278,310,47.28
Kindred,Katarina,715,408,307,57.06
Kindred,Rengar,335,218,117,65.07
Kindred,Ivern,182,87,95,47.8
Kindred,Viego,1322,585,737,44.25
Kindred,Ahri,1371,679,692,49.53
Kindred,Camille,361,167,194,46.26
Kindred,Viktor,810,411,399,50.74
Kindred,Kayn,1551,746,805,48.1
Kindred,Zac,456,238,218,52.19
Kindred,Rell,462,218,244,47.19
Kindred,Rammus,294,149,145,50.68
Kindred,Draven,603,274,329,45.44
Kindred,Lulu,1222,641,581,52.45
Kindred,Leona,790,352,438,44.56
Kindred,Nilah,428,212,216,49.53
Kindred,Bard,322,188,134,58.39
Kindred,Taric,144,52,92,36.11
Kindred,Hwei,678,284,394,41.89
Kindred,Rakan,397,190,207,47.86
Kindred,Veigar,1142,542,600,47.46
Kindred,Skarner,287,128,159,44.6
Kindred,Kennen,276,125,151,45.29
Kindred,LeeSin,1416,697,719,49.22
Kindred,Cassiopeia,303,122,181,40.26
Kindred,Alistar,384,157,227,40.89
Kindred,Kaisa,1707,814,893,47.69
Kindred,Zeri,432,230,202,53.24
Kindred,Jayce,504,268,236,53.17
Kindred,Irelia,853,417,436,48.89
Kindred,Vayne,1156,554,602,47.92
Kindred,Aphelios,655,347,308,52.98
Kindred,Sejuani,409,161,248,39.36
Kindred,MissFortune,2225,1094,1131,49.17
Kindred,Braum,490,201,289,41.02
Kindred,Darius,1962,897,1065,45.72
Kindred,Velkoz,554,252,302,45.49
Kindred,Udyr,391,206,185,52.69
Kindred,Nami,1102,541,561,49.09
Kindred,JarvanIV,558,248,310,44.44
Kindred,Poppy,626,314,312,50.16
Kindred,Azir,364,172,192,47.25
Kindred,Lucian,626,299,327,47.76
Kindred,Elise,730,383,347,52.47
Kindred,Olaf,279,134,145,48.03
Kindred,Xayah,448,205,243,45.76
Kindred,Karma,1006,457,549,45.43
Kindred,Gragas,655,400,255,61.07
Kindred,Renekton,416,204,212,49.04
Kindred,Tryndamere,593,273,320,46.04
Kindred,Swain,1065,524,541,49.2
Kindred,Annie,283,142,141,50.18
Kindred,Morgana,1251,640,611,51.16
Kindred,Akshan,293,167,126,57
Kindred,XinZhao,614,271,343,44.14
Kindred,Kassadin,188,104,84,55.32
Kindred,KogMaw,265,109,156,41.13
Kindred,Janna,318,117,201,36.79
Kindred,Chogath,1100,495,605,45
Kindred,Jax,852,425,427,49.88
Kindred,Evelynn,370,178,192,48.11
Kindred,Zoe,345,181,164,52.46
Kindred,Vi,884,410,474,46.38
Kindred,Leblanc,605,290,315,47.93
Kindred,Gangplank,475,257,218,54.11
Kindred,Neeko,537,256,281,47.67
Kindred,Smolder,633,304,329,48.03
Kindred,Heimerdinger,455,220,235,48.35
Kindred,Fizz,532,271,261,50.94
Kindred,Gwen,561,262,299,46.7
Kindred,Taliyah,261,94,167,36.02
Kindred,Corki,418,219,199,52.39
Kindred,Yorick,931,443,488,47.58
Kindred,Nidalee,303,169,134,55.78
Kindred,DrMundo,519,239,280,46.05
Kindred,Renata,224,145,79,64.73
Kindred,Ornn,465,206,259,44.3
Kindred,Kayle,733,284,449,38.74
Kindred,Sivir,556,284,272,51.08
Kindred,Shen,664,295,369,44.43
Kindred,Ambessa,534,232,302,43.45
Kindred,Karthus,299,126,173,42.14
Kindred,Anivia,308,171,137,55.52
Kindred,Graves,717,335,382,46.72
Kindred,Khazix,551,279,272,50.64
Kindred,Rumble,274,136,138,49.64
Kindred,KSante,552,327,225,59.24
Kindred,RekSai,128,71,57,55.47
Kindred,Lissandra,263,145,118,55.13
Kindred,Shyvana,246,121,125,49.19
Kindred,Kled,223,95,128,42.6
Illaoi,Vladimir,537,271,266,50.47
Illaoi,Darius,2039,1157,882,56.74
Illaoi,Lux,2636,1286,1350,48.79
Illaoi,KogMaw,291,148,143,50.86
Illaoi,Yuumi,853,438,415,51.35
Illaoi,Kayle,737,321,416,43.55
Illaoi,Sylas,1275,745,530,58.43
Illaoi,Qiyana,260,130,130,50
Illaoi,Caitlyn,2689,1395,1294,51.88
Illaoi,Renata,199,104,95,52.26
Illaoi,Mordekaiser,1835,828,1007,45.12
Illaoi,Warwick,1594,727,867,45.61
Illaoi,Mel,1949,1048,901,53.77
Illaoi,Nautilus,1130,573,557,50.71
Illaoi,Viego,1240,593,647,47.82
Illaoi,Irelia,892,490,402,54.93
Illaoi,Jinx,2583,1296,1287,50.17
Illaoi,Thresh,1286,653,633,50.78
Illaoi,Volibear,1363,687,676,50.4
Illaoi,Evelynn,348,184,164,52.87
Illaoi,Katarina,736,386,350,52.45
Illaoi,Nocturne,1178,593,585,50.34
Illaoi,Neeko,574,321,253,55.92
Illaoi,Gwen,601,323,278,53.74
Illaoi,Karthus,249,129,120,51.81
Illaoi,Yone,1991,1089,902,54.7
Illaoi,Nilah,380,187,193,49.21
Illaoi,Braum,508,258,250,50.79
Illaoi,Shaco,997,484,513,48.55
Illaoi,Veigar,1110,520,590,46.85
Illaoi,Ashe,2079,1056,1023,50.79
Illaoi,Azir,352,209,143,59.38
Illaoi,Samira,896,475,421,53.01
Illaoi,Kayn,1588,879,709,55.35
Illaoi,Lucian,695,301,394,43.31
Illaoi,Sett,1824,910,914,49.89
Illaoi,RekSai,105,57,48,54.29
Illaoi,Hwei,629,326,303,51.83
Illaoi,Ekko,863,445,418,51.56
Illaoi,Yasuo,2111,1096,1015,51.92
Illaoi,Ahri,1305,689,616,52.8
Illaoi,Karma,842,378,464,44.89
Illaoi,Skarner,302,172,130,56.95
Illaoi,Syndra,514,286,228,55.64
Illaoi,Jhin,1838,971,867,52.83
Illaoi,Sion,710,350,360,49.3
Illaoi,Pantheon,1608,812,796,50.5
Illaoi,Ziggs,387,212,175,54.78
Illaoi,Lulu,1035,509,526,49.18
Illaoi,Viktor,753,372,381,49.4
Illaoi,Briar,802,370,432,46.13
Illaoi,Teemo,1135,501,634,44.14
Illaoi,Blitzcrank,830,462,368,55.66
Illaoi,Diana,1594,831,763,52.13
Illaoi,Poppy,609,309,300,50.74
Illaoi,Heimerdinger,532,218,314,40.98
Illaoi,Kalista,306,163,143,53.27
Illaoi,Swain,972,497,475,51.13
Illaoi,AurelionSol,418,198,220,47.37
Illaoi,Xayah,536,250,286,46.64
Illaoi,Rakan,468,244,224,52.14
Illaoi,Jax,1045,598,447,57.22
Illaoi,MissFortune,2591,1310,1281,50.56
Illaoi,Morgana,1351,641,710,47.45
Illaoi,Kindred,431,200,231,46.4
Illaoi,Ryze,316,132,184,41.77
Illaoi,Orianna,466,227,239,48.71
Illaoi,Shen,699,379,320,54.22
Illaoi,Aatrox,916,482,434,52.62
Illaoi,Khazix,501,258,243,51.5
Illaoi,Vex,556,229,327,41.19
Illaoi,Vayne,1246,634,612,50.88
Illaoi,Malzahar,955,443,512,46.39
Illaoi,Camille,351,180,171,51.28
Illaoi,Rammus,337,191,146,56.68
Illaoi,Alistar,429,255,174,59.44
Illaoi,TwistedFate,383,195,188,50.91
Illaoi,Fiora,369,176,193,47.7
Illaoi,LeeSin,1243,658,585,52.94
Illaoi,Kassadin,171,56,115,32.75
Illaoi,Milio,540,297,243,55
Illaoi,Malphite,986,500,486,50.71
Illaoi,Sona,328,162,166,49.39
Illaoi,Rengar,283,179,104,63.25
Illaoi,TahmKench,1013,565,448,55.77
Illaoi,Garen,1698,774,924,45.58
Illaoi,Lillia,546,280,266,51.28
Illaoi,Smolder,660,317,343,48.03
Illaoi,Tristana,1002,467,535,46.61
Illaoi,Zyra,837,394,443,47.07
Illaoi,Gangplank,396,213,183,53.79
Illaoi,Varus,829,436,393,52.59
Illaoi,Pyke,919,488,431,53.1
Illaoi,Chogath,1364,707,657,51.83
Illaoi,Hecarim,326,198,128,60.74
Illaoi,MonkeyKing,622,330,292,53.05
Illaoi,Ezreal,1980,1009,971,50.96
Illaoi,Brand,772,373,399,48.32
Illaoi,Nunu,709,373,336,52.61
Illaoi,Aurora,786,390,396,49.62
Illaoi,Leona,833,418,415,50.18
Illaoi,Xerath,848,415,433,48.94
Illaoi,Ornn,412,200,212,48.54
Illaoi,Twitch,725,373,352,51.45
Illaoi,Amumu,1105,508,597,45.97
Illaoi,Kaisa,1575,784,791,49.78
Illaoi,Jayce,394,169,225,42.89
Illaoi,Zeri,344,171,173,49.71
Illaoi,FiddleSticks,534,257,277,48.13
Illaoi,Aphelios,519,254,265,48.94
Illaoi,Draven,471,267,204,56.69
Illaoi,Ambessa,574,342,232,59.58
Illaoi,Talon,434,260,174,59.91
Illaoi,Nidalee,292,170,122,58.22
Illaoi,Zed,1097,523,574,47.68
Illaoi,Yorick,1088,463,625,42.56
Illaoi,Gnar,351,186,165,52.99
Illaoi,Vi,960,481,479,50.1
Illaoi,Zoe,334,162,172,48.5
Illaoi,Sejuani,369,170,199,46.07
Illaoi,Leblanc,496,249,247,50.2
Illaoi,Seraphine,818,423,395,51.71
Illaoi,Riven,435,259,176,59.54
Illaoi,Trundle,705,352,353,49.93
Illaoi,Cassiopeia,229,124,105,54.15
Illaoi,XinZhao,578,256,322,44.29
Illaoi,Taric,213,99,114,46.48
Illaoi,Ivern,132,68,64,51.52
Illaoi,Velkoz,555,222,333,40
Illaoi,Lissandra,341,182,159,53.37
Illaoi,Galio,854,464,390,54.33
Illaoi,Corki,373,183,190,49.06
Illaoi,Singed,264,121,143,45.83
Illaoi,Soraka,589,292,297,49.58
Illaoi,Annie,285,142,143,49.82
Illaoi,MasterYi,1249,638,611,51.08
Illaoi,Renekton,589,343,246,58.23
Illaoi,KSante,411,234,177,56.93
Illaoi,Fizz,531,310,221,58.38
Illaoi,Nami,911,406,505,44.57
Illaoi,Kennen,197,95,102,48.22
Illaoi,Udyr,366,179,187,48.91
Illaoi,Zilean,280,140,140,50
Illaoi,Taliyah,254,132,122,51.97
Illaoi,Akshan,336,127,209,37.8
Illaoi,Rell,456,267,189,58.55
Illaoi,Naafiri,366,152,214,41.53
Illaoi,Nasus,872,417,455,47.82
Illaoi,Elise,679,336,343,49.48
Illaoi,Sivir,556,284,272,51.08
Illaoi,Akali,1090,546,544,50.09
Illaoi,Zac,410,185,225,45.12
Illaoi,Gragas,593,331,262,55.82
Illaoi,Bard,289,162,127,56.06
Illaoi,JarvanIV,510,238,272,46.67
Illaoi,Kled,158,72,86,45.57
Illaoi,Rumble,258,123,135,47.67
Illaoi,Olaf,286,154,132,53.85
Illaoi,Graves,485,213,272,43.92
Illaoi,Urgot,452,226,226,50
Illaoi,Maokai,484,267,217,55.17
Illaoi,Anivia,286,101,185,35.31
Illaoi,Senna,725,336,389,46.34
Illaoi,DrMundo,694,332,362,47.84
Illaoi,Shyvana,278,178,100,64.03
Illaoi,Quinn,275,127,148,46.18
Illaoi,Tryndamere,602,308,294,51.16
Illaoi,Belveth,258,141,117,54.65
Illaoi,Janna,283,118,165,41.7
Milio,Vladimir,840,463,377,55.12
Milio,Darius,2341,1201,1140,51.3
Milio,Lux,3057,1679,1378,54.92
Milio,KogMaw,453,235,218,51.88
Milio,Yuumi,1158,600,558,51.81
Milio,Yorick,1184,602,582,50.84
Milio,Kayn,1795,1045,750,58.22
Milio,Ryze,351,158,193,45.01
Milio,Pantheon,1934,979,955,50.62
Milio,Teemo,1368,681,687,49.78
Milio,Warwick,1849,932,917,50.41
Milio,Azir,422,204,218,48.34
Milio,MissFortune,2431,1285,1146,52.86
Milio,Neeko,564,287,277,50.89
Milio,Akali,1239,616,623,49.72
Milio,Kassadin,290,137,153,47.24
Milio,Sona,487,245,242,50.31
Milio,Braum,665,327,338,49.17
Milio,XinZhao,670,355,315,52.99
Milio,Chogath,1409,713,696,50.6
Milio,Taliyah,353,168,185,47.59
Milio,Mordekaiser,1576,759,817,48.16
Milio,Briar,821,408,413,49.7
Milio,Zed,1378,774,604,56.17
Milio,Jinx,3027,1457,1570,48.13
Milio,Lulu,2220,1169,1051,52.66
Milio,Jax,1132,593,539,52.39
Milio,Talon,746,426,320,57.1
Milio,Leblanc,596,306,290,51.34
Milio,Mel,2621,1504,1117,57.38
Milio,Jhin,2369,1236,1133,52.17
Milio,Velkoz,623,299,324,47.99
Milio,Olaf,339,172,167,50.74
Milio,LeeSin,1536,823,713,53.58
Milio,Diana,1723,889,834,51.6
Milio,Seraphine,1032,597,435,57.85
Milio,Karma,1625,844,781,51.94
Milio,Tryndamere,742,398,344,53.64
Milio,Graves,775,408,367,52.65
Milio,Sylas,1347,685,662,50.85
Milio,Leona,1001,495,506,49.45
Milio,DrMundo,665,357,308,53.68
Milio,Shaco,1147,639,508,55.71
Milio,Xayah,596,326,270,54.7
Milio,Morgana,1480,768,712,51.89
Milio,Ashe,2562,1398,1164,54.57
Milio,Renekton,524,285,239,54.39
Milio,Khazix,648,331,317,51.08
Milio,Malzahar,1260,648,612,51.43
Milio,Quinn,496,250,246,50.4
Milio,Vayne,1384,676,708,48.84
Milio,Shyvana,284,160,124,56.34
Milio,Soraka,855,436,419,50.99
Milio,Fiora,521,284,237,54.51
Milio,Elise,926,503,423,54.32
Milio,Garen,1904,942,962,49.47
Milio,Senna,1037,530,507,51.11
Milio,Maokai,533,270,263,50.66
Milio,Corki,569,319,250,56.06
Milio,Taric,272,115,157,42.28
Milio,Camille,484,244,240,50.41
Milio,Hecarim,575,292,283,50.78
Milio,TwistedFate,462,288,174,62.34
Milio,Ezreal,2664,1473,1191,55.29
Milio,Nautilus,1389,808,581,58.17
Milio,Kaisa,1844,1004,840,54.45
Milio,Qiyana,407,208,199,51.11
Milio,Swain,1092,536,556,49.08
Milio,Ziggs,435,232,203,53.33
Milio,Nasus,748,359,389,47.99
Milio,Xerath,984,516,468,52.44
Milio,Caitlyn,3250,1674,1576,51.51
Milio,Irelia,981,567,414,57.8
Milio,Amumu,1334,624,710,46.78
Milio,Poppy,681,392,289,57.56
Milio,Veigar,1162,548,614,47.16
Milio,Gnar,552,341,211,61.78
Milio,Lucian,846,447,399,52.84
Milio,Nami,1721,921,800,53.52
Milio,Aatrox,1263,727,536,57.56
Milio,FiddleSticks,659,347,312,52.66
Milio,Kindred,528,293,235,55.49
Milio,Aphelios,803,424,379,52.8
Milio,Rengar,500,258,242,51.6
Milio,Sion,1022,505,517,49.41
Milio,Orianna,599,297,302,49.58
Milio,Illaoi,540,243,297,45
Milio,Vi,1140,605,535,53.07
Milio,Yasuo,2259,1215,1044,53.78
Milio,Rell,616,327,289,53.08
Milio,Sivir,591,330,261,55.84
Milio,Aurora,1042,533,509,51.15
Milio,Sett,1612,824,788,51.12
Milio,Gragas,737,380,357,51.56
Milio,Viego,1566,839,727,53.58
Milio,Draven,637,362,275,56.83
Milio,Blitzcrank,815,409,406,50.18
Milio,Ahri,1575,856,719,54.35
Milio,Katarina,1143,640,503,55.99
Milio,Evelynn,504,288,216,57.14
Milio,Akshan,440,255,185,57.95
Milio,Smolder,864,468,396,54.17
Milio,MasterYi,1339,691,648,51.61
Milio,Tristana,1130,638,492,56.46
Milio,Thresh,1757,879,878,50.03
Milio,MonkeyKing,797,445,352,55.83
Milio,Urgot,581,302,279,51.98
Milio,Zac,540,277,263,51.3
Milio,Volibear,1294,709,585,54.79
Milio,Kennen,352,199,153,56.53
Milio,Rammus,343,182,161,53.06
Milio,Zeri,553,241,312,43.58
Milio,Pyke,961,496,465,51.61
Milio,Viktor,1109,563,546,50.77
Milio,Riven,635,324,311,51.02
Milio,Syndra,821,405,416,49.33
Milio,Kled,202,88,114,43.56
Milio,Lillia,718,373,345,51.95
Milio,Ekko,1144,628,516,54.9
Milio,Anivia,413,211,202,51.09
Milio,Samira,909,494,415,54.35
Milio,Ornn,571,251,320,43.96
Milio,Lissandra,408,207,201,50.74
Milio,Varus,1011,511,500,50.54
Milio,TahmKench,973,537,436,55.19
Milio,Nunu,682,325,357,47.65
Milio,Heimerdinger,451,217,234,48.12
Milio,Trundle,644,324,320,50.31
Milio,Gangplank,725,396,329,54.62
Milio,Alistar,490,251,239,51.22
Milio,Hwei,865,423,442,48.9
Milio,JarvanIV,764,417,347,54.58
Milio,KSante,624,344,280,55.13
Milio,Gwen,684,344,340,50.29
Milio,Yone,1952,1049,903,53.74
Milio,Janna,516,241,275,46.71
Milio,Sejuani,584,323,261,55.31
Milio,Brand,718,408,310,56.82
Milio,Renata,294,144,150,48.98
Milio,Vex,606,352,254,58.09
Milio,Udyr,499,257,242,51.5
Milio,Kalista,376,195,181,51.86
Milio,Fizz,698,401,297,57.45
Milio,AurelionSol,448,227,221,50.67
Milio,Galio,934,489,445,52.36
Milio,Naafiri,421,183,238,43.47
Milio,Ivern,271,161,110,59.41
Milio,Nilah,363,202,161,55.65
Milio,Kayle,861,421,440,48.9
Milio,Ambessa,769,430,339,55.92
Milio,Malphite,1194,607,587,50.84
Milio,Bard,410,229,181,55.85
Milio,Zyra,972,484,488,49.79
Milio,Twitch,1128,575,553,50.98
Milio,Shen,723,359,364,49.65
Milio,Zoe,504,264,240,52.38
Milio,Singed,413,196,217,47.46
Milio,Rakan,488,262,226,53.69
Milio,Jayce,518,312,206,60.23
Milio,Rumble,314,169,145,53.82
Milio,Zilean,401,220,181,54.86
Milio,Cassiopeia,288,157,131,54.51
Milio,Nocturne,1248,625,623,50.08
Milio,Belveth,314,138,176,43.95
Milio,Skarner,392,216,176,55.1
Milio,Karthus,339,199,140,58.7
Milio,RekSai,189,88,101,46.56
Milio,Annie,374,232,142,62.03
Milio,Nidalee,338,198,140,58.58
KogMaw,Illaoi,291,143,148,49.14
KogMaw,Warwick,1049,549,500,52.34
KogMaw,Diana,997,481,516,48.24
KogMaw,Tristana,606,309,297,50.99
KogMaw,Milio,453,218,235,48.12
KogMaw,Sion,583,318,265,54.55
KogMaw,Akshan,277,153,124,55.23
KogMaw,Jinx,2062,1102,960,53.44
KogMaw,Bard,211,112,99,53.08
KogMaw,Jax,685,330,355,48.18
KogMaw,Graves,424,185,239,43.63
KogMaw,Katarina,537,315,222,58.66
KogMaw,Twitch,725,344,381,47.45
KogMaw,Seraphine,565,285,280,50.44
KogMaw,Kennen,211,99,112,46.92
KogMaw,Skarner,221,129,92,58.37
KogMaw,Malzahar,682,347,335,50.88
KogMaw,Yuumi,602,302,300,50.17
KogMaw,Swain,696,364,332,52.3
KogMaw,Morgana,864,448,416,51.85
KogMaw,Caitlyn,1763,869,894,49.29
KogMaw,Tryndamere,401,193,208,48.13
KogMaw,Vayne,858,474,384,55.24
KogMaw,Draven,340,138,202,40.59
KogMaw,Mel,1321,691,630,52.31
KogMaw,Volibear,856,440,416,51.4
KogMaw,MasterYi,651,375,276,57.6
KogMaw,Hwei,423,249,174,58.87
KogMaw,Samira,529,263,266,49.72
KogMaw,Shyvana,181,93,88,51.38
KogMaw,Fizz,382,175,207,45.81
KogMaw,Yasuo,1245,641,604,51.49
KogMaw,Taric,158,75,83,47.47
KogMaw,Gnar,233,107,126,45.92
KogMaw,Vi,670,332,338,49.55
KogMaw,Kaisa,1052,615,437,58.46
KogMaw,Nautilus,745,440,305,59.06
KogMaw,Yone,1194,639,555,53.52
KogMaw,Viego,873,481,392,55.1
KogMaw,Ezreal,1426,753,673,52.81
KogMaw,Blitzcrank,467,259,208,55.46
KogMaw,Mordekaiser,944,433,511,45.87
KogMaw,Talon,348,169,179,48.56
KogMaw,Quinn,252,133,119,52.78
KogMaw,Briar,535,220,315,41.12
KogMaw,Chogath,886,446,440,50.34
KogMaw,Sylas,787,401,386,50.95
KogMaw,Smolder,455,244,211,53.63
KogMaw,Neeko,373,217,156,58.18
KogMaw,Teemo,893,445,448,49.83
KogMaw,Kayn,939,473,466,50.37
KogMaw,Renata,153,103,50,67.32
KogMaw,Darius,1248,630,618,50.48
KogMaw,LeeSin,810,450,360,55.56
KogMaw,Irelia,551,322,229,58.44
KogMaw,Karma,716,334,382,46.65
KogMaw,Vladimir,469,219,250,46.7
KogMaw,Khazix,313,170,143,54.31
KogMaw,Kayle,470,237,233,50.43
KogMaw,MissFortune,1490,778,712,52.21
KogMaw,Soraka,421,201,220,47.74
KogMaw,Zoe,311,174,137,55.95
KogMaw,Garen,1107,580,527,52.39
KogMaw,Ahri,862,459,403,53.25
KogMaw,Jhin,1345,702,643,52.19
KogMaw,Rakan,263,110,153,41.83
KogMaw,Varus,647,360,287,55.64
KogMaw,Nasus,530,259,271,48.87
KogMaw,Zyra,525,278,247,52.95
KogMaw,Aatrox,622,390,232,62.7
KogMaw,Rengar,168,113,55,67.26
KogMaw,Lux,1684,892,792,52.97
KogMaw,Kindred,265,156,109,58.87
KogMaw,Veigar,678,347,331,51.18
KogMaw,Ekko,562,254,308,45.2
KogMaw,Yorick,653,290,363,44.41
KogMaw,Lillia,408,222,186,54.41
KogMaw,KSante,359,222,137,61.84
KogMaw,Zac,290,137,153,47.24
KogMaw,Galio,613,274,339,44.7
KogMaw,Sona,306,169,137,55.23
KogMaw,Nunu,351,200,151,56.98
KogMaw,Shaco,524,260,264,49.62
KogMaw,Taliyah,185,103,82,55.68
KogMaw,Xayah,317,150,167,47.32
KogMaw,Lulu,905,465,440,51.38
KogMaw,Zed,610,348,262,57.05
KogMaw,Hecarim,331,167,164,50.45
KogMaw,Sejuani,357,199,158,55.74
KogMaw,Ambessa,474,244,230,51.48
KogMaw,TahmKench,628,286,342,45.54
KogMaw,Urgot,322,145,177,45.03
KogMaw,Vex,338,161,177,47.63
KogMaw,FiddleSticks,438,209,229,47.72
KogMaw,Evelynn,267,123,144,46.07
KogMaw,Ivern,145,93,52,64.14
KogMaw,Aurora,532,285,247,53.57
KogMaw,Camille,222,111,111,50
KogMaw,Renekton,316,178,138,56.33
KogMaw,Kalista,174,90,84,51.72
KogMaw,Sivir,364,213,151,58.52
KogMaw,Nami,728,358,370,49.18
KogMaw,Sett,1033,560,473,54.21
KogMaw,Pantheon,991,506,485,51.06
KogMaw,Amumu,741,381,360,51.42
KogMaw,Brand,472,214,258,45.34
KogMaw,Qiyana,163,66,97,40.49
KogMaw,Aphelios,295,149,146,50.51
KogMaw,Anivia,261,148,113,56.7
KogMaw,Jayce,275,145,130,52.73
KogMaw,Alistar,277,151,126,54.51
KogMaw,Annie,221,98,123,44.34
KogMaw,Malphite,631,314,317,49.76
KogMaw,Gangplank,340,177,163,52.06
KogMaw,Thresh,917,462,455,50.38
KogMaw,Riven,300,146,154,48.67
KogMaw,AurelionSol,306,129,177,42.16
KogMaw,Corki,279,166,113,59.5
KogMaw,Fiora,306,159,147,51.96
KogMaw,Syndra,446,205,241,45.96
KogMaw,Nilah,174,75,99,43.1
KogMaw,Leblanc,390,220,170,56.41
KogMaw,Gwen,400,204,196,51
KogMaw,Ornn,255,132,123,51.76
KogMaw,Lucian,445,229,216,51.46
KogMaw,Shen,473,264,209,55.81
KogMaw,Senna,566,289,277,51.06
KogMaw,Ashe,1362,738,624,54.19
KogMaw,Rammus,239,121,118,50.63
KogMaw,Xerath,499,242,257,48.5
KogMaw,Ryze,250,127,123,50.8
KogMaw,DrMundo,397,212,185,53.4
KogMaw,Orianna,357,176,181,49.3
KogMaw,Viktor,588,296,292,50.34
KogMaw,Poppy,418,236,182,56.46
KogMaw,Nocturne,706,327,379,46.32
KogMaw,Pyke,544,278,266,51.1
KogMaw,Leona,517,256,261,49.52
KogMaw,Gragas,396,197,199,49.75
KogMaw,Akali,618,356,262,57.61
KogMaw,MonkeyKing,368,195,173,52.99
KogMaw,Braum,428,266,162,62.15
KogMaw,TwistedFate,222,125,97,56.31
KogMaw,Ziggs,257,125,132,48.64
KogMaw,Janna,210,95,115,45.24
KogMaw,Azir,192,102,90,53.13
KogMaw,Trundle,359,180,179,50.14
KogMaw,Maokai,343,208,135,60.64
KogMaw,XinZhao,428,244,184,57.01
KogMaw,Singed,120,76,44,63.33
KogMaw,Karthus,185,104,81,56.22
KogMaw,Zilean,216,120,96,55.56
KogMaw,JarvanIV,403,224,179,55.58
KogMaw,Belveth,132,79,53,59.85
KogMaw,Rell,346,195,151,56.36
KogMaw,Kassadin,137,73,64,53.28
KogMaw,Elise,462,227,235,49.13
KogMaw,Kled,152,77,75,50.66
KogMaw,Rumble,196,125,71,63.78
KogMaw,Udyr,285,181,104,63.51
KogMaw,Lissandra,205,101,104,49.27
KogMaw,Cassiopeia,200,103,97,51.5
KogMaw,Naafiri,236,119,117,50.42
KogMaw,Zeri,289,130,159,44.98
KogMaw,Olaf,114,65,49,57.02
KogMaw,Heimerdinger,319,175,144,54.86
KogMaw,Nidalee,190,109,81,57.37
KogMaw,Velkoz,419,217,202,51.79
KogMaw,RekSai,66,38,28,57.58
MasterYi,Maokai,1039,501,538,48.22
MasterYi,Graves,1502,748,754,49.8
MasterYi,Ahri,3167,1597,1570,50.43
MasterYi,Nilah,962,483,479,50.21
MasterYi,Malphite,2512,1284,1228,51.11
MasterYi,Yorick,2542,1135,1407,44.65
MasterYi,FiddleSticks,1269,615,654,48.46
MasterYi,Draven,1185,589,596,49.7
MasterYi,Smolder,1721,980,741,56.94
MasterYi,Nautilus,2917,1394,1523,47.79
MasterYi,Kayn,4062,2205,1857,54.28
MasterYi,Zed,2704,1477,1227,54.62
MasterYi,Sona,819,357,462,43.59
MasterYi,Kaisa,3761,2021,1740,53.74
MasterYi,Amumu,2814,1367,1447,48.58
MasterYi,Nasus,2078,1007,1071,48.46
MasterYi,Shaco,2316,1212,1104,52.33
MasterYi,Varus,2187,1116,1071,51.03
MasterYi,Neeko,1477,746,731,50.51
MasterYi,Ryze,686,359,327,52.33
MasterYi,Warwick,4319,2059,2260,47.67
MasterYi,Morgana,3124,1618,1506,51.79
MasterYi,Xayah,1342,627,715,46.72
MasterYi,Veigar,2712,1319,1393,48.64
MasterYi,Sett,3853,1802,2051,46.77
MasterYi,Caitlyn,6650,3370,3280,50.68
MasterYi,Lulu,2813,1410,1403,50.12
MasterYi,KSante,1137,575,562,50.57
MasterYi,Udyr,970,475,495,48.97
MasterYi,Ashe,5074,2676,2398,52.74
MasterYi,Akali,2740,1457,1283,53.18
MasterYi,Jinx,6612,3330,3282,50.36
MasterYi,Karma,2577,1311,1266,50.87
MasterYi,Zac,859,444,415,51.69
MasterYi,Nunu,1543,842,701,54.57
MasterYi,Shen,1510,781,729,51.72
MasterYi,Riven,1045,510,535,48.8
MasterYi,Lillia,1169,605,564,51.75
MasterYi,Orianna,1094,552,542,50.46
MasterYi,Velkoz,1500,732,768,48.8
MasterYi,Volibear,2786,1410,1376,50.61
MasterYi,Nocturne,3176,1623,1553,51.1
MasterYi,Xerath,2029,1050,979,51.75
MasterYi,Ezreal,5421,2785,2636,51.37
MasterYi,Blitzcrank,1829,876,953,47.9
MasterYi,Pantheon,3938,2048,1890,52.01
MasterYi,Kindred,1092,583,509,53.39
MasterYi,Teemo,3335,1661,1674,49.81
MasterYi,Lucian,1617,842,775,52.07
MasterYi,Zyra,2029,974,1055,48
MasterYi,Gnar,952,461,491,48.42
MasterYi,Seraphine,2090,1044,1046,49.95
MasterYi,TahmKench,2332,1177,1155,50.47
MasterYi,Briar,2164,1089,1075,50.32
MasterYi,Heimerdinger,1204,584,620,48.5
MasterYi,MissFortune,6032,3047,2985,50.51
MasterYi,Fiora,927,521,406,56.2
MasterYi,Viego,3432,1730,1702,50.41
MasterYi,Vladimir,1519,766,753,50.43
MasterYi,Pyke,2225,1163,1062,52.27
MasterYi,Irelia,2222,1105,1117,49.73
MasterYi,DrMundo,1448,682,766,47.1
MasterYi,Lux,6603,3302,3301,50.01
MasterYi,Bard,666,379,287,56.91
MasterYi,Katarina,1929,984,945,51.01
MasterYi,Tristana,2585,1279,1306,49.48
MasterYi,Yone,4589,2396,2193,52.21
MasterYi,Akshan,793,376,417,47.41
MasterYi,Aphelios,1286,621,665,48.29
MasterYi,Braum,1363,620,743,45.49
MasterYi,Kennen,743,405,338,54.51
MasterYi,Ekko,2286,1145,1141,50.09
MasterYi,Poppy,1348,708,640,52.52
MasterYi,Yasuo,5145,2771,2374,53.86
MasterYi,Nidalee,581,326,255,56.11
MasterYi,Mordekaiser,3568,1898,1670,53.2
MasterYi,KogMaw,651,276,375,42.4
MasterYi,Ornn,970,480,490,49.48
MasterYi,Ambessa,1392,768,624,55.17
MasterYi,Zoe,979,518,461,52.91
MasterYi,Jhin,4862,2546,2316,52.37
MasterYi,Swain,2562,1312,1250,51.21
MasterYi,Samira,1904,1003,901,52.68
MasterYi,Mel,5121,2691,2430,52.55
MasterYi,Vayne,3175,1423,1752,44.82
MasterYi,Thresh,3214,1629,1585,50.68
MasterYi,Urgot,1381,650,731,47.07
MasterYi,Galio,2123,1025,1098,48.28
MasterYi,Rell,1126,546,580,48.49
MasterYi,Diana,4214,2124,2090,50.4
MasterYi,Aatrox,2264,1205,1059,53.22
MasterYi,Darius,4837,2350,2487,48.58
MasterYi,Viktor,2059,1074,985,52.16
MasterYi,Alistar,975,480,495,49.23
MasterYi,Fizz,1469,800,669,54.46
MasterYi,Nami,2213,1118,1095,50.52
MasterYi,Singed,708,336,372,47.46
MasterYi,Garen,3960,2076,1884,52.42
MasterYi,Corki,824,426,398,51.7
MasterYi,JarvanIV,1324,668,656,50.45
MasterYi,Janna,727,340,387,46.77
MasterYi,Evelynn,975,491,484,50.36
MasterYi,Jax,2847,1413,1434,49.63
MasterYi,Zeri,951,474,477,49.84
MasterYi,Yuumi,2053,1089,964,53.04
MasterYi,Gragas,1360,710,650,52.21
MasterYi,LeeSin,3328,1747,1581,52.49
MasterYi,Syndra,1415,695,720,49.12
MasterYi,Kalista,785,432,353,55.03
MasterYi,Soraka,1300,702,598,54
MasterYi,Hecarim,854,428,426,50.12
MasterYi,Ivern,368,202,166,54.89
MasterYi,Trundle,1436,688,748,47.91
MasterYi,Elise,1605,776,829,48.35
MasterYi,Senna,1785,890,895,49.86
MasterYi,Belveth,524,272,252,51.91
MasterYi,Brand,1916,1061,855,55.38
MasterYi,Sion,1761,882,879,50.09
MasterYi,Talon,1312,706,606,53.81
MasterYi,Renata,577,323,254,55.98
MasterYi,Gwen,1300,708,592,54.46
MasterYi,RekSai,237,116,121,48.95
MasterYi,Aurora,1936,950,986,49.07
MasterYi,Chogath,3223,1539,1684,47.75
MasterYi,Naafiri,852,457,395,53.64
MasterYi,XinZhao,1592,762,830,47.86
MasterYi,Malzahar,2428,1115,1313,45.92
MasterYi,Twitch,2042,1033,1009,50.59
MasterYi,Skarner,623,340,283,54.57
MasterYi,Zilean,719,337,382,46.87
MasterYi,Annie,808,407,401,50.37
MasterYi,Tryndamere,1489,736,753,49.43
MasterYi,Milio,1339,648,691,48.39
MasterYi,MonkeyKing,1682,795,887,47.27
MasterYi,Azir,786,425,361,54.07
MasterYi,Vi,2467,1167,1300,47.3
MasterYi,Khazix,1463,760,703,51.95
MasterYi,Rengar,846,510,336,60.28
MasterYi,Kassadin,496,248,248,50
MasterYi,Rakan,1113,569,544,51.12
MasterYi,Sejuani,962,481,481,50
MasterYi,Leona,2253,1002,1251,44.47
MasterYi,Lissandra,893,429,464,48.04
MasterYi,Gangplank,1130,582,548,51.5
MasterYi,Taric,631,285,346,45.17
MasterYi,Kled,377,181,196,48.01
MasterYi,Ziggs,954,480,474,50.31
MasterYi,Cassiopeia,650,358,292,55.08
MasterYi,Rammus,2170,961,1209,44.29
MasterYi,Qiyana,737,388,349,52.65
MasterYi,Renekton,1167,561,606,48.07
MasterYi,Taliyah,575,293,282,50.96
MasterYi,Karthus,743,381,362,51.28
MasterYi,TwistedFate,849,436,413,51.35
MasterYi,AurelionSol,1023,505,518,49.36
MasterYi,Sylas,2979,1571,1408,52.74
MasterYi,Kayle,1679,869,810,51.76
MasterYi,Jayce,1090,556,534,51.01
MasterYi,Rumble,575,316,259,54.96
MasterYi,Hwei,1575,779,796,49.46
MasterYi,Vex,1251,669,582,53.48
MasterYi,Quinn,898,411,487,45.77
MasterYi,Illaoi,1249,611,638,48.92
MasterYi,Sivir,1220,617,603,50.57
MasterYi,Olaf,558,328,230,58.78
MasterYi,Leblanc,1261,672,589,53.29
MasterYi,Camille,855,445,410,52.05
MasterYi,Anivia,818,418,400,51.1
MasterYi,Shyvana,604,329,275,54.47
Ashe,Maokai,1793,830,963,46.29
Ashe,Graves,2827,1422,1405,50.3
Ashe,Ahri,5758,2893,2865,50.24
Ashe,Nilah,1449,775,674,53.49
Ashe,Malphite,4129,2001,2128,48.46
Ashe,Fiora,1750,867,883,49.54
Ashe,Belveth,989,527,462,53.29
Ashe,Sylas,6315,3105,3210,49.17
Ashe,Ezreal,11692,5829,5863,49.85
Ashe,Yuumi,3704,1905,1799,51.43
Ashe,Heimerdinger,2027,1033,994,50.96
Ashe,Warwick,5992,2794,3198,46.63
Ashe,Neeko,2235,1164,1071,52.08
Ashe,Draven,2361,1198,1163,50.74
Ashe,Leona,3537,1790,1747,50.61
Ashe,Evelynn,1646,849,797,51.58
Ashe,Yasuo,8254,4224,4030,51.18
Ashe,Yone,7726,3935,3791,50.93
Ashe,Kayle,2493,1221,1272,48.98
Ashe,Viego,5994,2928,3066,48.85
Ashe,Irelia,3622,1907,1715,52.65
Ashe,Jinx,13183,6391,6792,48.48
Ashe,Thresh,5953,2921,3032,49.07
Ashe,XinZhao,2932,1410,1522,48.09
Ashe,Katarina,3289,1727,1562,52.51
Ashe,Teemo,5186,2495,2691,48.11
Ashe,Vayne,4923,2438,2485,49.52
Ashe,TwistedFate,1430,734,696,51.33
Ashe,Pantheon,6390,3257,3133,50.97
Ashe,Kayn,5742,2746,2996,47.82
Ashe,Leblanc,2698,1314,1384,48.7
Ashe,Sivir,2558,1272,1286,49.73
Ashe,Pyke,3787,2018,1769,53.29
Ashe,Smolder,2583,1374,1209,53.19
Ashe,Nautilus,4673,2237,2436,47.87
Ashe,DrMundo,2328,1108,1220,47.59
Ashe,Briar,3108,1406,1702,45.24
Ashe,Anivia,1353,655,698,48.41
Ashe,Mordekaiser,5481,2654,2827,48.42
Ashe,Vi,3936,1987,1949,50.48
Ashe,Azir,1597,841,756,52.66
Ashe,MissFortune,10818,5219,5599,48.24
Ashe,Riven,1825,979,846,53.64
Ashe,Ivern,715,380,335,53.15
Ashe,Swain,4297,2158,2139,50.22
Ashe,Nami,3940,1909,2031,48.45
Ashe,Gnar,1660,828,832,49.88
Ashe,Caitlyn,12833,6356,6477,49.53
Ashe,Karma,5115,2533,2582,49.52
Ashe,Volibear,4452,2164,2288,48.61
Ashe,LeeSin,7073,3718,3355,52.57
Ashe,Morgana,5107,2436,2671,47.7
Ashe,Shaco,3812,1871,1941,49.08
Ashe,Xayah,2124,1098,1026,51.69
Ashe,Sett,6457,3064,3393,47.45
Ashe,Jhin,8875,4440,4435,50.03
Ashe,Senna,3154,1581,1573,50.13
Ashe,Yorick,3848,1685,2163,43.79
Ashe,Gragas,2297,1173,1124,51.07
Ashe,Lux,10406,5151,5255,49.5
Ashe,Aphelios,2287,1179,1108,51.55
Ashe,Khazix,2238,1249,989,55.81
Ashe,Akali,4646,2366,2280,50.93
Ashe,Mel,8272,4202,4070,50.8
Ashe,Zed,4408,2308,2100,52.36
Ashe,Nunu,2429,1335,1094,54.96
Ashe,KSante,2473,1298,1175,52.49
Ashe,Zeri,1875,946,929,50.45
Ashe,Lulu,5440,2857,2583,52.52
Ashe,Sion,3067,1407,1660,45.88
Ashe,MasterYi,5074,2398,2676,47.26
Ashe,AurelionSol,1626,771,855,47.42
Ashe,FiddleSticks,2176,1047,1129,48.12
Ashe,Brand,3053,1369,1684,44.84
Ashe,Milio,2562,1164,1398,45.43
Ashe,Illaoi,2079,1023,1056,49.21
Ashe,Velkoz,2235,1005,1230,44.97
Ashe,Soraka,2253,1053,1200,46.74
Ashe,Chogath,4906,2335,2571,47.59
Ashe,Jayce,2305,1182,1123,51.28
Ashe,Samira,2895,1394,1501,48.15
Ashe,Quinn,1525,730,795,47.87
Ashe,Shen,2620,1299,1321,49.58
Ashe,Shyvana,1036,445,591,42.95
Ashe,Seraphine,3404,1637,1767,48.09
Ashe,Kled,851,413,438,48.53
Ashe,Ambessa,2728,1364,1364,50
Ashe,Diana,6458,3028,3430,46.89
Ashe,Ekko,3708,1894,1814,51.08
Ashe,Talon,2454,1252,1202,51.02
Ashe,Lissandra,1248,594,654,47.6
Ashe,Lucian,3191,1730,1461,54.21
Ashe,Nocturne,4961,2310,2651,46.56
Ashe,Sejuani,1865,903,962,48.42
Ashe,Rell,2189,1061,1128,48.47
Ashe,Aatrox,4321,2147,2174,49.69
Ashe,Fizz,2185,1028,1157,47.05
Ashe,Taric,856,419,437,48.95
Ashe,Tristana,4185,1914,2271,45.73
Ashe,Alistar,1674,823,851,49.16
Ashe,Vladimir,2602,1294,1308,49.73
Ashe,Ziggs,1691,882,809,52.16
Ashe,Darius,8103,3922,4181,48.4
Ashe,Rammus,1367,621,746,45.43
Ashe,TahmKench,3428,1715,1713,50.03
Ashe,Rengar,1324,710,614,53.63
Ashe,Galio,3749,1812,1937,48.33
Ashe,Urgot,1855,863,992,46.52
Ashe,Xerath,3633,1827,1806,50.29
Ashe,Kalista,1296,677,619,52.24
Ashe,Sona,1365,626,739,45.86
Ashe,Garen,6490,3041,3449,46.86
Ashe,Kindred,1917,1015,902,52.95
Ashe,Varus,4214,2117,2097,50.24
Ashe,Hwei,2993,1406,1587,46.98
Ashe,Aurora,3557,1790,1767,50.32
Ashe,Malzahar,4005,1876,2129,46.84
Ashe,Braum,2143,948,1195,44.24
Ashe,Zoe,1740,925,815,53.16
Ashe,Zilean,1325,723,602,54.57
Ashe,Hecarim,1593,808,785,50.72
Ashe,Blitzcrank,3336,1650,1686,49.46
Ashe,Veigar,4188,2046,2142,48.85
Ashe,Karthus,1230,590,640,47.97
Ashe,Kaisa,6957,3697,3260,53.14
Ashe,Poppy,2575,1230,1345,47.77
Ashe,Viktor,3659,1880,1779,51.38
Ashe,Udyr,1627,867,760,53.29
Ashe,Nasus,2983,1434,1549,48.07
Ashe,Lillia,2490,1184,1306,47.55
Ashe,Gwen,2079,1124,955,54.06
Ashe,Jax,3757,1904,1853,50.68
Ashe,Amumu,4025,1957,2068,48.62
Ashe,JarvanIV,2455,1215,1240,49.49
Ashe,Janna,1366,666,700,48.76
Ashe,Syndra,2483,1236,1247,49.78
Ashe,Gangplank,2239,1108,1131,49.49
Ashe,Vex,2253,1150,1103,51.04
Ashe,Rakan,1849,934,915,50.51
Ashe,MonkeyKing,2670,1315,1355,49.25
Ashe,Bard,1121,563,558,50.22
Ashe,Elise,2999,1564,1435,52.15
Ashe,Zyra,3765,1766,1999,46.91
Ashe,Renekton,2283,1167,1116,51.12
Ashe,Renata,836,438,398,52.39
Ashe,Ornn,1812,890,922,49.12
Ashe,Camille,1626,816,810,50.18
Ashe,Zac,2148,1080,1068,50.28
Ashe,Nidalee,1572,882,690,56.11
Ashe,Taliyah,1131,549,582,48.54
Ashe,Orianna,1917,1004,913,52.37
Ashe,Kennen,1190,644,546,54.12
Ashe,Annie,1520,793,727,52.17
Ashe,Twitch,3410,1661,1749,48.71
Ashe,Corki,1791,944,847,52.71
Ashe,Singed,1197,618,579,51.63
Ashe,Qiyana,1136,569,567,50.09
Ashe,Tryndamere,2208,1125,1083,50.95
Ashe,Cassiopeia,1124,573,551,50.98
Ashe,Ryze,1382,660,722,47.76
Ashe,Akshan,1353,664,689,49.08
Ashe,Naafiri,1450,716,734,49.38
Ashe,Olaf,1078,513,565,47.59
Ashe,Skarner,1323,705,618,53.29
Ashe,Trundle,2393,1129,1264,47.18
Ashe,Kassadin,776,352,424,45.36
Ashe,RekSai,548,294,254,53.65
Ashe,Rumble,1054,563,491,53.42
Ashe,KogMaw,1362,624,738,45.81
Graves,Pantheon,2089,1011,1078,48.4
Graves,MasterYi,1502,754,748,50.2
Graves,Sylas,2065,1123,942,54.38
Graves,Ashe,2827,1405,1422,49.7
Graves,Karma,1712,836,876,48.83
Graves,Irelia,1036,543,493,52.41
Graves,Kayn,1967,1010,957,51.35
Graves,Katarina,1025,460,565,44.88
Graves,Vayne,1519,734,785,48.32
Graves,DrMundo,640,352,288,55
Graves,Olaf,332,177,155,53.31
Graves,LeeSin,3063,1568,1495,51.19
Graves,Diana,2166,1070,1096,49.4
Graves,Seraphine,898,440,458,49
Graves,Aatrox,1526,759,767,49.74
Graves,Twitch,998,498,500,49.9
Graves,Veigar,1243,601,642,48.35
Graves,Ezreal,3416,1721,1695,50.38
Graves,Milio,775,367,408,47.35
Graves,Yorick,1058,461,597,43.57
Graves,Nunu,849,472,377,55.59
Graves,Draven,749,351,398,46.86
Graves,KogMaw,424,239,185,56.37
Graves,Yuumi,1264,562,702,44.46
Graves,Gangplank,859,426,433,49.59
Graves,Aphelios,751,396,355,52.73
Graves,Leona,1159,615,544,53.06
Graves,Darius,2567,1278,1289,49.79
Graves,Chogath,1616,764,852,47.28
Graves,Yasuo,2697,1334,1363,49.46
Graves,Kaisa,2580,1270,1310,49.22
Graves,Trundle,637,335,302,52.59
Graves,Caitlyn,3407,1662,1745,48.78
Graves,Sett,1992,960,1032,48.19
Graves,Smolder,964,493,471,51.14
Graves,Rengar,512,295,217,57.62
Graves,Hwei,857,412,445,48.07
Graves,Thresh,2234,1142,1092,51.12
Graves,Quinn,482,222,260,46.06
Graves,Viego,1972,988,984,50.1
Graves,MissFortune,2884,1440,1444,49.93
Graves,Neeko,709,350,359,49.37
Graves,Tristana,1233,656,577,53.2
Graves,Lux,3060,1514,1546,49.48
Graves,Ornn,522,268,254,51.34
Graves,Skarner,391,226,165,57.8
Graves,Ekko,1127,510,617,45.25
Graves,Lucian,1101,575,526,52.23
Graves,Senna,914,450,464,49.23
Graves,Briar,898,408,490,45.43
Graves,Vex,705,365,340,51.77
Graves,Morgana,1461,783,678,53.59
Graves,Naafiri,421,177,244,42.04
Graves,Ziggs,525,242,283,46.1
Graves,Kalista,426,215,211,50.47
Graves,Swain,1241,536,705,43.19
Graves,Warwick,1779,879,900,49.41
Graves,Gragas,808,468,340,57.92
Graves,Hecarim,575,295,280,51.3
Graves,Kassadin,264,144,120,54.55
Graves,Mordekaiser,1640,805,835,49.09
Graves,Jinx,3688,1734,1954,47.02
Graves,Elise,1015,536,479,52.81
Graves,Sejuani,607,271,336,44.65
Graves,MonkeyKing,1039,506,533,48.7
Graves,Viktor,1224,621,603,50.74
Graves,Shaco,1346,697,649,51.78
Graves,Zed,1513,735,778,48.58
Graves,Varus,1278,655,623,51.25
Graves,Soraka,730,312,418,42.74
Graves,Yone,2591,1367,1224,52.76
Graves,Lillia,739,384,355,51.96
Graves,Akali,1375,698,677,50.76
Graves,Udyr,451,238,213,52.77
Graves,Jax,1327,646,681,48.68
Graves,Singed,443,158,285,35.67
Graves,Braum,833,378,455,45.38
Graves,Sion,1016,517,499,50.89
Graves,Jhin,2727,1417,1310,51.96
Graves,Xerath,1308,648,660,49.54
Graves,TahmKench,1077,572,505,53.11
Graves,Cassiopeia,336,166,170,49.4
Graves,Garen,2143,954,1189,44.52
Graves,Ryze,519,262,257,50.48
Graves,Renekton,738,409,329,55.42
Graves,Zeri,608,298,310,49.01
Graves,Lulu,1957,999,958,51.05
Graves,Volibear,1246,619,627,49.68
Graves,Tryndamere,671,332,339,49.48
Graves,Xayah,695,332,363,47.77
Graves,Kayle,939,465,474,49.52
Graves,AurelionSol,656,293,363,44.66
Graves,Rell,740,398,342,53.78
Graves,Heimerdinger,522,248,274,47.51
Graves,Shyvana,365,144,221,39.45
Graves,Taric,231,115,116,49.78
Graves,Poppy,804,370,434,46.02
Graves,Rumble,392,200,192,51.02
Graves,Nautilus,1663,804,859,48.35
Graves,Rakan,655,339,316,51.76
Graves,Gwen,717,382,335,53.28
Graves,Vi,1265,658,607,52.02
Graves,Zoe,547,291,256,53.2
Graves,Teemo,1480,679,801,45.88
Graves,Malphite,1275,534,741,41.88
Graves,Alistar,645,308,337,47.75
Graves,Rammus,412,174,238,42.23
Graves,Bard,398,169,229,42.46
Graves,Zac,697,348,349,49.93
Graves,Belveth,328,137,191,41.77
Graves,Evelynn,481,199,282,41.37
Graves,Ahri,1782,934,848,52.41
Graves,Orianna,598,285,313,47.66
Graves,FiddleSticks,704,329,375,46.73
Graves,Aurora,1053,526,527,49.95
Graves,Sivir,687,316,371,46
Graves,Nidalee,613,337,276,54.98
Graves,Brand,839,427,412,50.89
Graves,Samira,1043,481,562,46.12
Graves,Riven,644,314,330,48.76
Graves,Qiyana,368,206,162,55.98
Graves,Vladimir,833,412,421,49.46
Graves,Zilean,459,219,240,47.71
Graves,Mel,2565,1260,1305,49.12
Graves,Nasus,918,439,479,47.82
Graves,Akshan,468,236,232,50.43
Graves,Sona,388,187,201,48.2
Graves,Pyke,1277,665,612,52.08
Graves,Fiora,490,259,231,52.86
Graves,Malzahar,1280,633,647,49.45
Graves,Gnar,586,295,291,50.34
Graves,Jayce,875,384,491,43.89
Graves,Camille,629,327,302,51.99
Graves,Annie,459,202,257,44.01
Graves,Blitzcrank,1063,568,495,53.43
Graves,Galio,1228,635,593,51.71
Graves,TwistedFate,613,294,319,47.96
Graves,Khazix,889,423,466,47.58
Graves,Taliyah,405,170,235,41.98
Graves,Syndra,939,454,485,48.35
Graves,Renata,279,140,139,50.18
Graves,Velkoz,735,320,415,43.54
Graves,Leblanc,927,466,461,50.27
Graves,Nocturne,1601,706,895,44.1
Graves,Urgot,590,321,269,54.41
Graves,Zyra,1169,503,666,43.03
Graves,JarvanIV,834,416,418,49.88
Graves,XinZhao,978,450,528,46.01
Graves,Nami,1319,596,723,45.19
Graves,Ambessa,903,438,465,48.5
Graves,Talon,944,461,483,48.83
Graves,Ivern,304,126,178,41.45
Graves,Lissandra,476,242,234,50.84
Graves,KSante,821,391,430,47.62
Graves,Illaoi,485,272,213,56.08
Graves,Fizz,711,346,365,48.66
Graves,Corki,546,246,300,45.05
Graves,Kindred,717,382,335,53.28
Graves,Kennen,398,173,225,43.47
Graves,Janna,399,204,195,51.13
Graves,Kled,227,107,120,47.14
Graves,RekSai,213,109,104,51.17
Graves,Amumu,1276,610,666,47.81
Graves,Anivia,474,174,300,36.71
Graves,Shen,837,421,416,50.3
Graves,Maokai,573,278,295,48.52
Graves,Karthus,465,202,263,43.44
Graves,Nilah,416,182,234,43.75
Graves,Azir,498,248,250,49.8
Ahri,Pantheon,4578,2259,2319,49.34
Ahri,MasterYi,3167,1570,1597,49.57
Ahri,Sylas,4374,2197,2177,50.23
Ahri,Ashe,5758,2865,2893,49.76
Ahri,Karma,3197,1675,1522,52.39
Ahri,Gangplank,1554,741,813,47.68
Ahri,Ivern,439,207,232,47.15
Ahri,Mel,4701,2308,2393,49.1
Ahri,Jhin,5458,2689,2769,49.27
Ahri,Swain,2952,1345,1607,45.56
Ahri,Gwen,1575,809,766,51.37
Ahri,Talon,1684,904,780,53.68
Ahri,Yone,5385,2902,2483,53.89
Ahri,MissFortune,6603,3286,3317,49.77
Ahri,Taric,584,262,322,44.86
Ahri,Teemo,3456,1626,1830,47.05
Ahri,Hecarim,1103,635,468,57.57
Ahri,Veigar,3243,1517,1726,46.78
Ahri,Thresh,3805,1886,1919,49.57
Ahri,Poppy,1780,834,946,46.85
Ahri,Warwick,4299,1983,2316,46.13
Ahri,Katarina,2419,1225,1194,50.64
Ahri,Twitch,2123,1095,1028,51.58
Ahri,Morgana,3366,1683,1683,50
Ahri,Yorick,2748,1227,1521,44.65
Ahri,AurelionSol,1142,552,590,48.34
Ahri,Kayn,3887,2013,1874,51.79
Ahri,Singed,681,301,380,44.2
Ahri,Udyr,999,486,513,48.65
Ahri,Jax,2506,1236,1270,49.32
Ahri,Elise,1955,979,976,50.08
Ahri,Naafiri,900,433,467,48.11
Ahri,Lulu,3579,1814,1765,50.68
Ahri,Nasus,2136,1008,1128,47.19
Ahri,Neeko,1604,804,800,50.12
Ahri,Sett,4460,2197,2263,49.26
Ahri,Senna,2314,1102,1212,47.62
Ahri,Akali,2838,1361,1477,47.96
Ahri,Akshan,1085,577,508,53.18
Ahri,TahmKench,2280,1126,1154,49.39
Ahri,Kennen,926,489,437,52.81
Ahri,MonkeyKing,1867,882,985,47.24
Ahri,Vladimir,1739,850,889,48.88
Ahri,Vayne,3303,1617,1686,48.96
Ahri,Fiora,1081,598,483,55.32
Ahri,Shaco,2650,1232,1418,46.49
Ahri,Fizz,1427,628,799,44.01
Ahri,Tristana,2707,1282,1425,47.36
Ahri,Rakan,1278,652,626,51.02
Ahri,Yasuo,5383,2696,2687,50.08
Ahri,Belveth,621,271,350,43.64
Ahri,Mordekaiser,3960,1971,1989,49.77
Ahri,Alistar,1099,531,568,48.32
Ahri,Chogath,3498,1766,1732,50.49
Ahri,Briar,2299,1114,1185,48.46
Ahri,Jayce,1414,750,664,53.04
Ahri,Samira,2122,1027,1095,48.4
Ahri,XinZhao,1996,990,1006,49.6
Ahri,Brand,2256,1071,1185,47.47
Ahri,Ambessa,1715,902,813,52.59
Ahri,Rammus,857,406,451,47.37
Ahri,Aurora,2528,1336,1192,52.85
Ahri,Caitlyn,7499,3637,3862,48.5
Ahri,Riven,1199,664,535,55.38
Ahri,Zed,2848,1508,1340,52.95
Ahri,Smolder,1859,912,947,49.06
Ahri,Galio,2828,1399,1429,49.47
Ahri,Sejuani,1297,628,669,48.42
Ahri,Malzahar,2808,1222,1586,43.52
Ahri,Amumu,2962,1336,1626,45.1
Ahri,DrMundo,1650,771,879,46.73
Ahri,Viktor,2266,1124,1142,49.6
Ahri,Pyke,2521,1250,1271,49.58
Ahri,Nocturne,3326,1552,1774,46.66
Ahri,Leblanc,1862,976,886,52.42
Ahri,Irelia,2343,1137,1206,48.53
Ahri,Janna,825,417,408,50.55
Ahri,Jinx,7208,3430,3778,47.59
Ahri,Nautilus,3146,1621,1525,51.53
Ahri,Zac,1261,624,637,49.48
Ahri,Diana,4578,2172,2406,47.44
Ahri,Illaoi,1305,616,689,47.2
Ahri,Evelynn,1183,632,551,53.42
Ahri,Hwei,2173,1067,1106,49.1
Ahri,Viego,3659,1869,1790,51.08
Ahri,KSante,1526,795,731,52.1
Ahri,Ekko,2547,1271,1276,49.9
Ahri,Lucian,2068,1019,1049,49.27
Ahri,Kassadin,655,311,344,47.48
Ahri,Renata,574,317,257,55.23
Ahri,Maokai,1220,586,634,48.03
Ahri,Ornn,1197,560,637,46.78
Ahri,Zoe,1204,574,630,47.67
Ahri,Aatrox,2713,1350,1363,49.76
Ahri,LeeSin,3951,2010,1941,50.87
Ahri,Zyra,2307,967,1340,41.92
Ahri,Karthus,687,355,332,51.67
Ahri,Xayah,1514,729,785,48.15
Ahri,FiddleSticks,1334,686,648,51.42
Ahri,Lux,7725,3553,4172,45.99
Ahri,Velkoz,1667,828,839,49.67
Ahri,Nilah,1135,549,586,48.37
Ahri,Yuumi,2389,1195,1194,50.02
Ahri,Tryndamere,1522,773,749,50.79
Ahri,Varus,2483,1233,1250,49.66
Ahri,Seraphine,2432,1227,1205,50.45
Ahri,Soraka,1599,747,852,46.72
Ahri,Rengar,946,522,424,55.18
Ahri,Kindred,1371,692,679,50.47
Ahri,Vex,1767,843,924,47.71
Ahri,Darius,5255,2483,2772,47.25
Ahri,Anivia,962,493,469,51.25
Ahri,Blitzcrank,2280,1246,1034,54.65
Ahri,Qiyana,739,399,340,53.99
Ahri,Sona,934,439,495,47
Ahri,Gragas,1629,803,826,49.29
Ahri,Rell,1502,728,774,48.47
Ahri,Nami,2742,1304,1438,47.56
Ahri,Quinn,926,461,465,49.78
Ahri,RekSai,402,213,189,52.99
Ahri,Ryze,1055,500,555,47.39
Ahri,Taliyah,872,447,425,51.26
Ahri,Skarner,847,459,388,54.19
Ahri,Xerath,2361,1151,1210,48.75
Ahri,Milio,1575,719,856,45.65
Ahri,Kaisa,4595,2406,2189,52.36
Ahri,Renekton,1457,741,716,50.86
Ahri,Lillia,1629,772,857,47.39
Ahri,Zeri,1238,616,622,49.76
Ahri,Trundle,1570,733,837,46.69
Ahri,Kayle,1913,894,1019,46.73
Ahri,Shen,1741,851,890,48.88
Ahri,Braum,1672,797,875,47.67
Ahri,Camille,1074,519,555,48.32
Ahri,Volibear,3128,1504,1624,48.08
Ahri,Azir,1037,568,469,54.77
Ahri,Khazix,1507,819,688,54.35
Ahri,Draven,1323,662,661,50.04
Ahri,Kled,485,251,234,51.75
Ahri,KogMaw,862,403,459,46.75
Ahri,Zilean,923,454,469,49.19
Ahri,Graves,1782,848,934,47.59
Ahri,Cassiopeia,972,472,500,48.56
Ahri,Ezreal,6456,3298,3158,51.08
Ahri,Ziggs,972,467,505,48.05
Ahri,JarvanIV,1871,876,995,46.82
Ahri,Kalista,958,544,414,56.78
Ahri,Vi,2774,1426,1348,51.41
Ahri,Nunu,1757,820,937,46.67
Ahri,Aphelios,1649,847,802,51.36
Ahri,Leona,2285,1161,1124,50.81
Ahri,Gnar,1261,666,595,52.82
Ahri,TwistedFate,1031,532,499,51.6
Ahri,Malphite,2656,1274,1382,47.97
Ahri,Garen,4327,2208,2119,51.03
Ahri,Nidalee,833,461,372,55.34
Ahri,Urgot,1420,622,798,43.8
Ahri,Corki,1022,506,516,49.51
Ahri,Lissandra,925,469,456,50.7
Ahri,Syndra,2177,1014,1163,46.58
Ahri,Shyvana,681,357,324,52.42
Ahri,Sivir,1582,751,831,47.47
Ahri,Olaf,703,338,365,48.08
Ahri,Orianna,1461,708,753,48.46
Ahri,Sion,2093,999,1094,47.73
Ahri,Rumble,723,383,340,52.97
Ahri,Annie,1070,563,507,52.62
Ahri,Bard,931,418,513,44.9
Ahri,Heimerdinger,1316,601,715,45.67
Nilah,Pantheon,1346,716,630,53.19
Nilah,MasterYi,962,479,483,49.79
Nilah,Sylas,948,480,468,50.63
Nilah,Ashe,1449,674,775,46.51
Nilah,Karma,698,370,328,53.01
Nilah,Swain,895,391,504,43.69
Nilah,FiddleSticks,407,186,221,45.7
Nilah,Akali,802,421,381,52.49
Nilah,Twitch,731,377,354,51.57
Nilah,Senna,595,298,297,50.08
Nilah,Yorick,675,305,370,45.19
Nilah,Akshan,281,168,113,59.79
Nilah,Samira,1073,588,485,54.8
Nilah,Pyke,774,463,311,59.82
Nilah,TahmKench,695,344,351,49.5
Nilah,Nunu,529,242,287,45.75
Nilah,Vladimir,503,282,221,56.06
Nilah,Nami,855,422,433,49.36
Nilah,Fiora,328,169,159,51.52
Nilah,LeeSin,883,452,431,51.19
Nilah,Ziggs,323,151,172,46.75
Nilah,Jinx,1995,952,1043,47.72
Nilah,Nasus,666,305,361,45.8
Nilah,Gragas,458,246,212,53.71
Nilah,Yasuo,1780,1060,720,59.55
Nilah,Smolder,557,323,234,57.99
Nilah,Mel,1745,1057,688,60.57
Nilah,KSante,344,188,156,54.65
Nilah,Kayn,1230,607,623,49.35
Nilah,MissFortune,2085,1052,1033,50.46
Nilah,Lux,1963,1006,957,51.25
Nilah,Illaoi,380,193,187,50.79
Nilah,Warwick,1260,647,613,51.35
Nilah,Aurora,679,347,332,51.1
Nilah,Ezreal,1505,837,668,55.61
Nilah,Neeko,454,244,210,53.74
Nilah,Yone,1326,762,564,57.47
Nilah,Poppy,459,217,242,47.28
Nilah,Thresh,1036,560,476,54.05
Nilah,Sett,1294,654,640,50.54
Nilah,Rammus,228,96,132,42.11
Nilah,Tristana,736,356,380,48.37
Nilah,Karthus,248,119,129,47.98
Nilah,Zed,798,449,349,56.27
Nilah,Maokai,485,266,219,54.85
Nilah,Gangplank,390,195,195,50
Nilah,Diana,1101,559,542,50.77
Nilah,Irelia,575,295,280,51.3
Nilah,Aphelios,538,268,270,49.81
Nilah,Leona,726,421,305,57.99
Nilah,Darius,1524,790,734,51.84
Nilah,Syndra,473,254,219,53.7
Nilah,Corki,341,156,185,45.75
Nilah,Elise,552,311,241,56.34
Nilah,Katarina,671,320,351,47.69
Nilah,Kaisa,1298,732,566,56.39
Nilah,Qiyana,225,125,100,55.56
Nilah,Volibear,932,515,417,55.26
Nilah,Gwen,427,216,211,50.59
Nilah,DrMundo,496,261,235,52.62
Nilah,Lucian,537,309,228,57.54
Nilah,Belveth,210,125,85,59.52
Nilah,AurelionSol,330,165,165,50
Nilah,Briar,749,360,389,48.06
Nilah,Kassadin,154,95,59,61.69
Nilah,Renata,226,119,107,52.65
Nilah,Mordekaiser,1098,537,561,48.91
Nilah,Shaco,835,440,395,52.69
Nilah,Zoe,329,210,119,63.83
Nilah,Seraphine,763,358,405,46.92
Nilah,Olaf,210,122,88,58.1
Nilah,Morgana,1096,574,522,52.37
Nilah,Teemo,1043,492,551,47.17
Nilah,Aatrox,750,396,354,52.8
Nilah,Jhin,1447,721,726,49.83
Nilah,Renekton,397,192,205,48.36
Nilah,Jax,634,292,342,46.06
Nilah,Soraka,425,258,167,60.71
Nilah,Nidalee,191,109,82,57.07
Nilah,Ahri,1135,586,549,51.63
Nilah,Sona,269,117,152,43.49
Nilah,Amumu,837,364,473,43.49
Nilah,Caitlyn,1931,980,951,50.75
Nilah,Xayah,559,259,300,46.33
Nilah,Ekko,622,311,311,50
Nilah,Chogath,1035,514,521,49.66
Nilah,Ryze,232,104,128,44.83
Nilah,Xerath,589,286,303,48.56
Nilah,Zac,334,198,136,59.28
Nilah,Skarner,209,125,84,59.81
Nilah,Malzahar,774,347,427,44.83
Nilah,Vi,692,376,316,54.34
Nilah,Viego,1038,539,499,51.93
Nilah,Vayne,938,448,490,47.76
Nilah,Zilean,230,115,115,50
Nilah,Singed,263,113,150,42.97
Nilah,Kindred,428,216,212,50.47
Nilah,Yuumi,697,342,355,49.07
Nilah,Garen,1324,694,630,52.42
Nilah,Khazix,436,251,185,57.57
Nilah,Brand,653,316,337,48.39
Nilah,Evelynn,407,182,225,44.72
Nilah,Leblanc,312,187,125,59.94
Nilah,Kayle,550,290,260,52.73
Nilah,Viktor,519,313,206,60.31
Nilah,Veigar,861,442,419,51.34
Nilah,Shyvana,217,105,112,48.39
Nilah,Orianna,376,193,183,51.33
Nilah,Ambessa,513,316,197,61.6
Nilah,Ornn,356,137,219,38.48
Nilah,Naafiri,343,192,151,55.98
Nilah,Riven,342,222,120,64.91
Nilah,Lulu,777,379,398,48.78
Nilah,Nocturne,912,427,485,46.82
Nilah,Malphite,801,399,402,49.81
Nilah,Trundle,518,224,294,43.24
Nilah,Sejuani,352,195,157,55.4
Nilah,Kennen,191,97,94,50.79
Nilah,Blitzcrank,513,302,211,58.87
Nilah,Annie,228,117,111,51.32
Nilah,Draven,383,208,175,54.31
Nilah,Taliyah,191,64,127,33.51
Nilah,Heimerdinger,349,133,216,38.11
Nilah,XinZhao,484,238,246,49.17
Nilah,Azir,269,120,149,44.61
Nilah,Braum,418,233,185,55.74
Nilah,Cassiopeia,273,145,128,53.11
Nilah,Hwei,588,325,263,55.27
Nilah,Vex,483,214,269,44.31
Nilah,Milio,363,161,202,44.35
Nilah,Gnar,290,174,116,60
Nilah,Nautilus,870,512,358,58.85
Nilah,Galio,643,287,356,44.63
Nilah,Shen,536,304,232,56.72
Nilah,Hecarim,224,114,110,50.89
Nilah,Varus,600,333,267,55.5
Nilah,JarvanIV,419,206,213,49.16
Nilah,Udyr,265,164,101,61.89
Nilah,Rengar,364,233,131,64.01
Nilah,Kled,145,59,86,40.69
Nilah,Quinn,267,110,157,41.2
Nilah,Rell,447,209,238,46.76
Nilah,KogMaw,174,99,75,56.9
Nilah,Sion,630,317,313,50.32
Nilah,TwistedFate,282,147,135,52.13
Nilah,Lillia,542,250,292,46.13
Nilah,Lissandra,271,137,134,50.55
Nilah,Zeri,321,185,136,57.63
Nilah,Jayce,341,208,133,61
Nilah,Rakan,310,126,184,40.65
Nilah,Alistar,369,177,192,47.97
Nilah,MonkeyKing,516,256,260,49.61
Nilah,Sivir,312,156,156,50
Nilah,Zyra,602,318,284,52.82
Nilah,Fizz,365,194,171,53.15
Nilah,Ivern,128,75,53,58.59
Nilah,Velkoz,564,248,316,43.97
Nilah,Camille,284,169,115,59.51
Nilah,Tryndamere,611,362,249,59.25
Nilah,Kalista,296,206,90,69.59
Nilah,RekSai,108,63,45,58.33
Nilah,Talon,377,189,188,50.13
Nilah,Bard,271,106,165,39.11
Nilah,Anivia,222,99,123,44.59
Nilah,Urgot,400,181,219,45.25
Nilah,Janna,282,131,151,46.45
Nilah,Graves,416,234,182,56.25
Nilah,Taric,183,98,85,53.55
Nilah,Rumble,108,45,63,41.67
Belveth,Mordekaiser,707,371,336,52.48
Belveth,Kindred,259,123,136,47.49
Belveth,Qiyana,156,62,94,39.74
Belveth,Ashe,989,462,527,46.71
Belveth,Sona,149,78,71,52.35
Belveth,Malphite,517,203,314,39.26
Belveth,Rengar,204,98,106,48.04
Belveth,Akali,537,263,274,48.98
Belveth,Rakan,222,113,109,50.9
Belveth,Sion,397,209,188,52.64
Belveth,Ahri,621,350,271,56.36
Belveth,Anivia,164,108,56,65.85
Belveth,Poppy,358,124,234,34.64
Belveth,Teemo,679,301,378,44.33
Belveth,Khazix,249,122,127,49
Belveth,Smolder,337,170,167,50.45
Belveth,MissFortune,1088,554,534,50.92
Belveth,Rell,294,149,145,50.68
Belveth,Warwick,765,382,383,49.93
Belveth,Briar,463,244,219,52.7
Belveth,Nilah,210,85,125,40.48
Belveth,Morgana,571,290,281,50.79
Belveth,Aatrox,474,222,252,46.84
Belveth,Veigar,499,201,298,40.28
Belveth,Ezreal,1216,613,603,50.41
Belveth,Karma,593,339,254,57.17
Belveth,Gwen,321,155,166,48.29
Belveth,Katarina,438,217,221,49.54
Belveth,Aphelios,319,175,144,54.86
Belveth,Alistar,168,68,100,40.48
Belveth,Vladimir,365,160,205,43.84
Belveth,Jhin,990,498,492,50.3
Belveth,Seraphine,416,176,240,42.31
Belveth,Urgot,257,106,151,41.25
Belveth,MasterYi,524,252,272,48.09
Belveth,Hwei,363,215,148,59.23
Belveth,Xayah,338,180,158,53.25
Belveth,Darius,903,433,470,47.95
Belveth,Evelynn,153,45,108,29.41
Belveth,Renekton,243,108,135,44.44
Belveth,Lux,1227,588,639,47.92
Belveth,Jinx,1339,562,777,41.97
Belveth,Caitlyn,1239,591,648,47.7
Belveth,Nautilus,578,315,263,54.5
Belveth,Garen,794,380,414,47.86
Belveth,Shaco,451,238,213,52.77
Belveth,Yone,909,430,479,47.3
Belveth,Yorick,506,238,268,47.04
Belveth,Irelia,383,196,187,51.17
Belveth,Yasuo,1029,557,472,54.13
Belveth,TahmKench,460,221,239,48.04
Belveth,Viego,813,392,421,48.22
Belveth,Pyke,435,266,169,61.15
Belveth,Ekko,353,180,173,50.99
Belveth,Vex,243,116,127,47.74
Belveth,Gangplank,298,153,145,51.34
Belveth,Yuumi,449,234,215,52.12
Belveth,Gragas,309,161,148,52.1
Belveth,Naafiri,158,87,71,55.06
Belveth,Kayle,391,196,195,50.13
Belveth,Graves,328,191,137,58.23
Belveth,Galio,440,229,211,52.05
Belveth,Tristana,504,260,244,51.59
Belveth,Lulu,595,284,311,47.73
Belveth,Kled,101,37,64,36.63
Belveth,Ivern,93,56,37,60.22
Belveth,Nasus,403,189,214,46.9
Belveth,Kaisa,861,418,443,48.55
Belveth,Elise,379,176,203,46.44
Belveth,Ryze,195,91,104,46.67
Belveth,Vayne,587,293,294,49.91
Belveth,XinZhao,375,167,208,44.53
Belveth,Kayn,704,325,379,46.16
Belveth,Taric,121,64,57,52.89
Belveth,Amumu,583,288,295,49.4
Belveth,Annie,178,87,91,48.88
Belveth,Leona,462,223,239,48.27
Belveth,Lissandra,159,65,94,40.88
Belveth,Vi,441,206,235,46.71
Belveth,Draven,285,151,134,52.98
Belveth,Braum,297,112,185,37.71
Belveth,Udyr,192,99,93,51.56
Belveth,Kennen,127,76,51,59.84
Belveth,Nunu,320,175,145,54.69
Belveth,Leblanc,266,123,143,46.24
Belveth,Zilean,178,80,98,44.94
Belveth,Skarner,180,118,62,65.56
Belveth,Orianna,265,131,134,49.43
Belveth,Cassiopeia,209,119,90,56.94
Belveth,Renata,149,73,76,48.99
Belveth,Jax,372,164,208,44.09
Belveth,Mel,999,550,449,55.06
Belveth,Camille,161,85,76,52.8
Belveth,Pantheon,864,410,454,47.45
Belveth,Trundle,313,130,183,41.53
Belveth,Sylas,603,298,305,49.42
Belveth,Zac,184,102,82,55.43
Belveth,Chogath,588,309,279,52.55
Belveth,Heimerdinger,264,113,151,42.8
Belveth,LeeSin,618,335,283,54.21
Belveth,Ambessa,387,212,175,54.78
Belveth,Maokai,240,103,137,42.92
Belveth,Ziggs,189,91,98,48.15
Belveth,Singed,150,83,67,55.33
Belveth,Akshan,227,113,114,49.78
Belveth,Velkoz,300,167,133,55.67
Belveth,Varus,488,274,214,56.15
Belveth,Zeri,228,125,103,54.82
Belveth,Sett,757,329,428,43.46
Belveth,MonkeyKing,309,169,140,54.69
Belveth,Volibear,548,284,264,51.82
Belveth,Sivir,220,113,107,51.36
Belveth,Tryndamere,302,146,156,48.34
Belveth,Samira,376,163,213,43.35
Belveth,Senna,397,187,210,47.1
Belveth,Diana,719,331,388,46.04
Belveth,Brand,414,176,238,42.51
Belveth,Jayce,207,119,88,57.49
Belveth,Nidalee,153,73,80,47.71
Belveth,Twitch,380,181,199,47.63
Belveth,Nami,574,269,305,46.86
Belveth,Malzahar,493,151,342,30.63
Belveth,Milio,314,176,138,56.05
Belveth,Rumble,146,62,84,42.47
Belveth,Shen,342,146,196,42.69
Belveth,Kassadin,93,46,47,49.46
Belveth,Zed,459,239,220,52.07
Belveth,FiddleSticks,316,152,164,48.1
Belveth,Fizz,253,103,150,40.71
Belveth,Blitzcrank,358,176,182,49.16
Belveth,Sejuani,152,93,59,61.18
Belveth,Shyvana,139,62,77,44.6
Belveth,Viktor,428,213,215,49.77
Belveth,Azir,199,83,116,41.71
Belveth,Olaf,98,44,54,44.9
Belveth,Riven,191,95,96,49.74
Belveth,Swain,503,219,284,43.54
Belveth,Neeko,216,123,93,56.94
Belveth,JarvanIV,263,106,157,40.3
Belveth,Zyra,424,205,219,48.35
Belveth,KSante,275,138,137,50.18
Belveth,Kalista,206,109,97,52.91
Belveth,Thresh,742,383,359,51.62
Belveth,Taliyah,139,52,87,37.41
Belveth,Nocturne,633,241,392,38.07
Belveth,Talon,310,140,170,45.16
Belveth,Lucian,341,198,143,58.06
Belveth,Soraka,338,162,176,47.93
Belveth,Lillia,265,113,152,42.64
Belveth,KogMaw,132,53,79,40.15
Belveth,AurelionSol,204,99,105,48.53
Belveth,Syndra,308,153,155,49.68
Belveth,Janna,178,64,114,35.96
Belveth,Illaoi,258,117,141,45.35
Belveth,Quinn,178,81,97,45.51
Belveth,Xerath,461,246,215,53.36
Belveth,Ornn,222,117,105,52.7
Belveth,Karthus,146,77,69,52.74
Belveth,Corki,231,119,112,51.52
Belveth,DrMundo,282,144,138,51.06
Belveth,Gnar,189,102,87,53.97
Belveth,Bard,132,67,65,50.76
Belveth,Hecarim,215,103,112,47.91
Belveth,Aurora,383,204,179,53.26
Belveth,Fiora,261,134,127,51.34
Belveth,Zoe,184,87,97,47.28
Belveth,Rammus,191,93,98,48.69
Belveth,RekSai,65,45,20,69.23
Belveth,TwistedFate,161,85,76,52.8
Sona,Fiora,259,125,134,48.26
Sona,Belveth,149,71,78,47.65
Sona,Sylas,817,398,419,48.71
Sona,Ezreal,1377,784,593,56.94
Sona,Yuumi,644,361,283,56.06
Sona,Trundle,393,207,186,52.67
Sona,MasterYi,819,462,357,56.41
Sona,Veigar,715,339,376,47.41
Sona,Jhin,1298,694,604,53.47
Sona,Soraka,398,179,219,44.97
Sona,Yorick,724,309,415,42.68
Sona,LeeSin,712,424,288,59.55
Sona,Yone,1214,695,519,57.25
Sona,MissFortune,1505,691,814,45.91
Sona,Mel,1492,805,687,53.95
Sona,Ornn,305,142,163,46.56
Sona,Udyr,239,90,149,37.66
Sona,Lux,1752,846,906,48.29
Sona,Milio,487,242,245,49.69
Sona,Urgot,416,177,239,42.55
Sona,Kayn,1048,560,488,53.44
Sona,Yasuo,1241,659,582,53.1
Sona,Twitch,549,262,287,47.72
Sona,Neeko,385,218,167,56.62
Sona,Tryndamere,441,277,164,62.81
Sona,Gragas,357,189,168,52.94
Sona,Irelia,581,273,308,46.99
Sona,Kalista,205,120,85,58.54
Sona,Teemo,960,489,471,50.94
Sona,Leblanc,358,206,152,57.54
Sona,Elise,455,277,178,60.88
Sona,Rammus,173,75,98,43.35
Sona,Fizz,397,221,176,55.67
Sona,DrMundo,404,199,205,49.26
Sona,TahmKench,589,284,305,48.22
Sona,Vladimir,417,230,187,55.16
Sona,Ashe,1365,739,626,54.14
Sona,Swain,753,388,365,51.53
Sona,Riven,343,173,170,50.44
Sona,Shaco,679,360,319,53.02
Sona,Ekko,650,336,314,51.69
Sona,Thresh,840,420,420,50
Sona,Aatrox,549,288,261,52.46
Sona,Nocturne,798,361,437,45.24
Sona,Aphelios,384,217,167,56.51
Sona,Nautilus,639,360,279,56.34
Sona,Sett,971,485,486,49.95
Sona,Katarina,505,268,237,53.07
Sona,Morgana,969,483,486,49.85
Sona,Diana,1048,540,508,51.53
Sona,Briar,545,274,271,50.28
Sona,Pantheon,1074,582,492,54.19
Sona,Caitlyn,1776,986,790,55.52
Sona,Rumble,139,82,57,58.99
Sona,Malphite,647,332,315,51.31
Sona,Lulu,832,421,411,50.6
Sona,Ambessa,397,206,191,51.89
Sona,Maokai,203,95,108,46.8
Sona,Gwen,426,216,210,50.7
Sona,Lillia,473,260,213,54.97
Sona,Vayne,801,426,375,53.18
Sona,Velkoz,399,183,216,45.86
Sona,Nilah,269,152,117,56.51
Sona,Sejuani,267,123,144,46.07
Sona,Malzahar,671,389,282,57.97
Sona,Jinx,1864,887,977,47.59
Sona,Smolder,420,223,197,53.1
Sona,Mordekaiser,907,450,457,49.61
Sona,Gnar,219,101,118,46.12
Sona,Kindred,371,190,181,51.21
Sona,Lucian,452,243,209,53.76
Sona,Warwick,1092,567,525,51.92
Sona,TwistedFate,247,114,133,46.15
Sona,Akali,729,354,375,48.56
Sona,Taliyah,170,91,79,53.53
Sona,Hwei,443,223,220,50.34
Sona,Khazix,428,241,187,56.31
Sona,Ahri,934,495,439,53
Sona,Illaoi,328,166,162,50.61
Sona,Darius,1307,639,668,48.89
Sona,Xayah,314,146,168,46.5
Sona,Rakan,318,157,161,49.37
Sona,Gangplank,346,197,149,56.94
Sona,Volibear,738,407,331,55.15
Sona,Syndra,351,180,171,51.28
Sona,Nidalee,201,123,78,61.19
Sona,Vex,403,218,185,54.09
Sona,Samira,512,270,242,52.73
Sona,Nunu,397,217,180,54.66
Sona,Cassiopeia,255,163,92,63.92
Sona,Karma,756,450,306,59.52
Sona,Xerath,559,271,288,48.48
Sona,Evelynn,265,152,113,57.36
Sona,Zed,680,403,277,59.26
Sona,JarvanIV,399,207,192,51.88
Sona,Zyra,575,287,288,49.91
Sona,Amumu,613,275,338,44.86
Sona,Heimerdinger,409,207,202,50.61
Sona,Seraphine,717,403,314,56.21
Sona,Viego,785,377,408,48.03
Sona,Nami,854,422,432,49.41
Sona,Kled,123,54,69,43.9
Sona,Rengar,243,148,95,60.91
Sona,Viktor,558,283,275,50.72
Sona,Tristana,649,396,253,61.02
Sona,Galio,541,276,265,51.02
Sona,KSante,292,169,123,57.88
Sona,Jax,651,341,310,52.38
Sona,Sion,442,246,196,55.66
Sona,FiddleSticks,364,189,175,51.92
Sona,Varus,572,284,288,49.65
Sona,Aurora,519,306,213,58.96
Sona,Brand,460,255,205,55.43
Sona,Kayle,545,265,280,48.62
Sona,Alistar,228,142,86,62.28
Sona,Camille,238,166,72,69.75
Sona,Naafiri,257,143,114,55.64
Sona,Blitzcrank,397,187,210,47.1
Sona,Rell,321,149,172,46.42
Sona,Ziggs,285,166,119,58.25
Sona,Zac,296,137,159,46.28
Sona,Renekton,345,169,176,48.99
Sona,Azir,253,140,113,55.34
Sona,Kaisa,1027,547,480,53.26
Sona,Renata,153,72,81,47.06
Sona,Shen,436,241,195,55.28
Sona,Leona,513,242,271,47.17
Sona,Senna,598,295,303,49.33
Sona,KogMaw,306,137,169,44.77
Sona,Karthus,220,112,108,50.91
Sona,Graves,388,201,187,51.8
Sona,Chogath,799,410,389,51.31
Sona,Draven,372,231,141,62.1
Sona,Annie,232,91,141,39.22
Sona,Ivern,147,76,71,51.7
Sona,AurelionSol,270,138,132,51.11
Sona,Kassadin,141,88,53,62.41
Sona,Kennen,214,119,95,55.61
Sona,Talon,384,221,163,57.55
Sona,Poppy,388,213,175,54.9
Sona,XinZhao,407,185,222,45.45
Sona,Zeri,234,145,89,61.97
Sona,Zilean,272,118,154,43.38
Sona,Ryze,187,99,88,52.94
Sona,Vi,521,273,248,52.4
Sona,Taric,172,97,75,56.4
Sona,Jayce,286,173,113,60.49
Sona,MonkeyKing,406,205,201,50.49
Sona,Janna,283,172,111,60.78
Sona,Braum,253,135,118,53.36
Sona,Garen,1027,517,510,50.34
Sona,Pyke,594,364,230,61.28
Sona,Nasus,513,270,243,52.63
Sona,Shyvana,188,101,87,53.72
Sona,Olaf,131,87,44,66.41
Sona,Hecarim,285,127,158,44.56
Sona,Akshan,210,92,118,43.81
Sona,Sivir,335,159,176,47.46
Sona,Orianna,242,132,110,54.55
Sona,Bard,213,133,80,62.44
Sona,Zoe,217,123,94,56.68
Sona,Skarner,218,123,95,56.42
Sona,Anivia,204,97,107,47.55
Sona,Singed,156,82,74,52.56
Sona,Quinn,208,111,97,53.37
Sona,Corki,217,104,113,47.93
Sona,RekSai,114,76,38,66.67
Sona,Lissandra,142,60,82,42.25
Sona,Qiyana,143,79,64,55.24
Ivern,Yorick,325,148,177,45.54
Ivern,Viego,505,214,291,42.38
Ivern,Diana,543,236,307,43.46
Ivern,Seraphine,243,107,136,44.03
Ivern,Rakan,147,55,92,37.41
Ivern,Riven,193,69,124,35.75
Ivern,Kayn,487,227,260,46.61
Ivern,Ahri,439,232,207,52.85
Ivern,Jinx,873,415,458,47.54
Ivern,Nautilus,404,203,201,50.25
Ivern,Akshan,165,72,93,43.64
Ivern,FiddleSticks,166,94,72,56.63
Ivern,Samira,247,123,124,49.8
Ivern,Pyke,310,157,153,50.65
Ivern,Shen,234,119,115,50.85
Ivern,Gragas,218,100,118,45.87
Ivern,Yone,611,299,312,48.94
Ivern,Ashe,715,335,380,46.85
Ivern,Alistar,158,77,81,48.73
Ivern,Chogath,507,248,259,48.92
Ivern,Shaco,312,132,180,42.31
Ivern,Poppy,227,94,133,41.41
Ivern,Garen,632,309,323,48.89
Ivern,Rammus,104,43,61,41.35
Ivern,Soraka,207,102,105,49.28
Ivern,TahmKench,294,146,148,49.66
Ivern,Zac,145,75,70,51.72
Ivern,XinZhao,191,88,103,46.07
Ivern,Akali,427,209,218,48.95
Ivern,Caitlyn,862,407,455,47.22
Ivern,Maokai,180,93,87,51.67
Ivern,Tryndamere,164,81,83,49.39
Ivern,Nidalee,103,64,39,62.14
Ivern,Aurora,275,122,153,44.36
Ivern,MissFortune,730,314,416,43.01
Ivern,Nami,451,231,220,51.22
Ivern,Heimerdinger,151,55,96,36.42
Ivern,Viktor,340,178,162,52.35
Ivern,Yasuo,733,342,391,46.66
Ivern,Lulu,533,267,266,50.09
Ivern,Warwick,490,231,259,47.14
Ivern,Mel,649,301,348,46.38
Ivern,Quinn,126,52,74,41.27
Ivern,Teemo,443,187,256,42.21
Ivern,Sett,519,264,255,50.87
Ivern,Lux,809,387,422,47.84
Ivern,Pantheon,493,252,241,51.12
Ivern,Nocturne,402,209,193,51.99
Ivern,Sylas,444,253,191,56.98
Ivern,Aatrox,296,106,190,35.81
Ivern,Vex,187,94,93,50.27
Ivern,Nasus,244,103,141,42.21
Ivern,Briar,201,90,111,44.78
Ivern,Ekko,311,152,159,48.87
Ivern,Zeri,157,71,86,45.22
Ivern,Xerath,273,114,159,41.76
Ivern,Olaf,88,32,56,36.36
Ivern,Nunu,265,123,142,46.42
Ivern,Thresh,504,192,312,38.1
Ivern,Skarner,120,47,73,39.17
Ivern,Fiora,121,65,56,53.72
Ivern,Mordekaiser,450,206,244,45.78
Ivern,Veigar,291,109,182,37.46
Ivern,Elise,293,150,143,51.19
Ivern,Lucian,222,105,117,47.3
Ivern,Senna,299,170,129,56.86
Ivern,Kindred,182,95,87,52.2
Ivern,Blitzcrank,248,99,149,39.92
Ivern,Annie,127,76,51,59.84
Ivern,Bard,133,75,58,56.39
Ivern,MasterYi,368,166,202,45.11
Ivern,Swain,335,147,188,43.88
Ivern,Ambessa,280,123,157,43.93
Ivern,Katarina,297,142,155,47.81
Ivern,Braum,238,85,153,35.71
Ivern,MonkeyKing,241,116,125,48.13
Ivern,Khazix,165,72,93,43.64
Ivern,Jax,246,140,106,56.91
Ivern,Karthus,111,54,57,48.65
Ivern,Malphite,295,145,150,49.15
Ivern,Vi,351,169,182,48.15
Ivern,Smolder,276,103,173,37.32
Ivern,Belveth,93,37,56,39.78
Ivern,Kassadin,92,40,52,43.48
Ivern,Lissandra,89,43,46,48.31
Ivern,Zed,467,244,223,52.25
Ivern,Brand,223,127,96,56.95
Ivern,Varus,307,173,134,56.35
Ivern,Gnar,144,66,78,45.83
Ivern,Gwen,240,119,121,49.58
Ivern,Vladimir,233,124,109,53.22
Ivern,Kaisa,580,309,271,53.28
Ivern,Kayle,195,86,109,44.1
Ivern,Rengar,167,97,70,58.08
Ivern,Ezreal,868,424,444,48.85
Ivern,Illaoi,132,64,68,48.48
Ivern,Evelynn,154,70,84,45.45
Ivern,Gangplank,175,82,93,46.86
Ivern,Orianna,213,103,110,48.36
Ivern,Sivir,244,113,131,46.31
Ivern,Karma,438,197,241,44.98
Ivern,Irelia,281,126,155,44.84
Ivern,Urgot,188,84,104,44.68
Ivern,Rumble,102,51,51,50
Ivern,Syndra,235,119,116,50.64
Ivern,Milio,271,110,161,40.59
Ivern,Camille,143,59,84,41.26
Ivern,Ziggs,139,85,54,61.15
Ivern,Corki,150,60,90,40
Ivern,Ryze,116,56,60,48.28
Ivern,Jhin,745,313,432,42.01
Ivern,Sona,147,71,76,48.3
Ivern,KogMaw,145,52,93,35.86
Ivern,Darius,706,320,386,45.33
Ivern,Leblanc,187,86,101,45.99
Ivern,Draven,213,107,106,50.23
Ivern,Aphelios,241,140,101,58.09
Ivern,KSante,212,143,69,67.45
Ivern,Vayne,411,212,199,51.58
Ivern,Kled,86,28,58,32.56
Ivern,Anivia,128,72,56,56.25
Ivern,Rell,220,111,109,50.45
Ivern,Kalista,116,76,40,65.52
Ivern,LeeSin,471,216,255,45.86
Ivern,Jayce,207,114,93,55.07
Ivern,Azir,136,63,73,46.32
Ivern,Qiyana,117,43,74,36.75
Ivern,Tristana,339,171,168,50.44
Ivern,Volibear,454,230,224,50.66
Ivern,Kennen,113,57,56,50.44
Ivern,Hwei,251,104,147,41.43
Ivern,Renata,89,48,41,53.93
Ivern,Sion,256,130,126,50.78
Ivern,Morgana,363,188,175,51.79
Ivern,Malzahar,311,144,167,46.3
Ivern,Neeko,175,97,78,55.43
Ivern,Hecarim,130,68,62,52.31
Ivern,Zilean,91,26,65,28.57
Ivern,DrMundo,216,104,112,48.15
Ivern,Graves,304,178,126,58.55
Ivern,Amumu,312,160,152,51.28
Ivern,Fizz,165,60,105,36.36
Ivern,Trundle,201,89,112,44.28
Ivern,Janna,102,57,45,55.88
Ivern,Yuumi,335,167,168,49.85
Ivern,Zyra,307,116,191,37.79
Ivern,Lillia,179,89,90,49.72
Ivern,Sejuani,161,67,94,41.61
Ivern,Nilah,128,53,75,41.41
Ivern,Zoe,148,70,78,47.3
Ivern,Taliyah,70,40,30,57.14
Ivern,Twitch,258,135,123,52.33
Ivern,Taric,69,36,33,52.17
Ivern,JarvanIV,240,132,108,55
Ivern,Singed,107,73,34,68.22
Ivern,Leona,287,178,109,62.02
Ivern,TwistedFate,112,74,38,66.07
Ivern,Xayah,220,94,126,42.73
Ivern,Udyr,122,58,64,47.54
Ivern,AurelionSol,173,65,108,37.57
Ivern,Shyvana,93,47,46,50.54
Ivern,Naafiri,129,51,78,39.53
Ivern,Galio,268,107,161,39.93
Ivern,Cassiopeia,102,48,54,47.06
Ivern,Velkoz,217,101,116,46.54
Ivern,Talon,210,96,114,45.71
Ivern,Renekton,191,102,89,53.4
Ivern,Ornn,136,72,64,52.94
Ivern,RekSai,48,24,24,50
Veigar,Yorick,2421,1118,1303,46.18
Veigar,Viego,2974,1513,1461,50.87
Veigar,Diana,3482,1692,1790,48.59
Veigar,Seraphine,1868,941,927,50.37
Veigar,Rakan,915,475,440,51.91
Veigar,FiddleSticks,1044,509,535,48.75
Veigar,Draven,1240,670,570,54.03
Veigar,Smolder,1536,852,684,55.47
Veigar,Nautilus,2462,1291,1171,52.44
Veigar,Kayn,3311,1734,1577,52.37
Veigar,Zed,2278,1045,1233,45.87
Veigar,Sona,715,376,339,52.59
Veigar,Kaisa,3095,1616,1479,52.21
Veigar,Amumu,2569,1269,1300,49.4
Veigar,Warwick,3497,1651,1846,47.21
Veigar,Evelynn,925,533,392,57.62
Veigar,Ahri,3243,1726,1517,53.22
Veigar,Yasuo,4161,2127,2034,51.12
Veigar,Yone,4011,2098,1913,52.31
Veigar,Sylas,2591,1303,1288,50.29
Veigar,Caitlyn,5845,2963,2882,50.69
Veigar,MasterYi,2712,1390,1322,51.25
Veigar,Rell,1066,583,483,54.69
Veigar,Darius,4230,2166,2064,51.21
Veigar,Volibear,2550,1263,1287,49.53
Veigar,AurelionSol,1079,505,574,46.8
Veigar,TahmKench,2221,1124,1097,50.61
Veigar,Garen,3563,1769,1794,49.65
Veigar,Tristana,2217,1173,1044,52.91
Veigar,Lux,6242,3107,3135,49.78
Veigar,Morgana,3043,1536,1507,50.48
Veigar,Tryndamere,1290,609,681,47.21
Veigar,Graves,1243,642,601,51.65
Veigar,MissFortune,5343,2727,2616,51.04
Veigar,Leona,1815,930,885,51.24
Veigar,Teemo,3206,1637,1569,51.06
Veigar,Trundle,1220,620,600,50.82
Veigar,Mel,4217,2155,2062,51.1
Veigar,Leblanc,1070,513,557,47.94
Veigar,Elise,1363,696,667,51.06
Veigar,Fizz,1643,865,778,52.65
Veigar,Pantheon,3329,1800,1529,54.07
Veigar,Sion,1639,887,752,54.12
Veigar,Ezreal,4224,2190,2034,51.85
Veigar,Nami,2113,1042,1071,49.31
Veigar,Gnar,861,445,416,51.68
Veigar,Malzahar,2297,1092,1205,47.54
Veigar,Brand,1740,847,893,48.68
Veigar,Illaoi,1110,590,520,53.15
Veigar,Velkoz,1463,680,783,46.48
Veigar,Samira,1733,927,806,53.49
Veigar,Orianna,886,505,381,57
Veigar,Malphite,2103,1109,994,52.73
Veigar,Akali,2261,1211,1050,53.56
Veigar,Shaco,2092,1133,959,54.16
Veigar,Irelia,1721,939,782,54.56
Veigar,Aatrox,1891,979,912,51.77
Veigar,Briar,1715,855,860,49.85
Veigar,Jinx,5885,2848,3037,48.39
Veigar,Nasus,1702,821,881,48.24
Veigar,Nocturne,2473,1202,1271,48.6
Veigar,Aurora,1612,892,720,55.33
Veigar,Neeko,1214,616,598,50.74
Veigar,Heimerdinger,1227,643,584,52.4
Veigar,Sett,3377,1689,1688,50.01
Veigar,Vex,1282,657,625,51.25
Veigar,Jhin,4105,2017,2088,49.14
Veigar,Senna,1739,891,848,51.24
Veigar,TwistedFate,725,382,343,52.69
Veigar,Annie,735,383,352,52.11
Veigar,Chogath,2900,1359,1541,46.86
Veigar,Talon,1067,588,479,55.11
Veigar,Maokai,923,437,486,47.35
Veigar,Gwen,1100,624,476,56.73
Veigar,Katarina,2024,1051,973,51.93
Veigar,XinZhao,1288,583,705,45.26
Veigar,Aphelios,1221,662,559,54.22
Veigar,Braum,1142,589,553,51.58
Veigar,Mordekaiser,3264,1665,1599,51.01
Veigar,Jax,2050,1045,1005,50.98
Veigar,Swain,2312,1129,1183,48.83
Veigar,Janna,597,326,271,54.61
Veigar,Bard,695,390,305,56.12
Veigar,Lillia,1185,571,614,48.19
Veigar,Pyke,1971,1095,876,55.56
Veigar,Ashe,4188,2142,2046,51.15
Veigar,Vladimir,1264,676,588,53.48
Veigar,Thresh,2668,1432,1236,53.67
Veigar,Naafiri,867,515,352,59.4
Veigar,Syndra,1327,655,672,49.36
Veigar,Fiora,791,454,337,57.4
Veigar,Sivir,1171,613,558,52.35
Veigar,Hwei,1541,790,751,51.27
Veigar,Ryze,718,335,383,46.66
Veigar,Belveth,499,298,201,59.72
Veigar,Gragas,1198,649,549,54.17
Veigar,Ekko,2024,1048,976,51.78
Veigar,Shyvana,553,252,301,45.57
Veigar,Taric,448,205,243,45.76
Veigar,Singed,566,287,279,50.71
Veigar,Milio,1162,614,548,52.84
Veigar,Kayle,1576,786,790,49.87
Veigar,Poppy,1181,658,523,55.72
Veigar,Varus,1823,952,871,52.22
Veigar,Skarner,561,312,249,55.61
Veigar,Gangplank,942,487,455,51.7
Veigar,RekSai,281,143,138,50.89
Veigar,Ivern,291,182,109,62.54
Veigar,JarvanIV,1127,528,599,46.85
Veigar,KSante,942,525,417,55.73
Veigar,Rengar,726,370,356,50.96
Veigar,Nunu,1463,757,706,51.74
Veigar,Twitch,1714,858,856,50.06
Veigar,Karma,1889,926,963,49.02
Veigar,Vi,1949,1011,938,51.87
Veigar,Vayne,2653,1334,1319,50.28
Veigar,Soraka,1292,630,662,48.76
Veigar,Ornn,836,470,366,56.22
Veigar,LeeSin,2421,1311,1110,54.15
Veigar,Zac,858,404,454,47.09
Veigar,Renekton,1031,493,538,47.82
Veigar,Zilean,675,311,364,46.07
Veigar,Jayce,794,407,387,51.26
Veigar,Ziggs,901,421,480,46.73
Veigar,Yuumi,1800,1014,786,56.33
Veigar,Nidalee,512,291,221,56.84
Veigar,Kindred,1142,600,542,52.54
Veigar,Ambessa,1161,588,573,50.65
Veigar,Qiyana,556,272,284,48.92
Veigar,Taliyah,449,246,203,54.79
Veigar,Khazix,1080,560,520,51.85
Veigar,Nilah,861,419,442,48.66
Veigar,Viktor,1925,1026,899,53.3
Veigar,Kled,406,182,224,44.83
Veigar,DrMundo,1302,669,633,51.38
Veigar,Azir,637,334,303,52.43
Veigar,Anivia,730,327,403,44.79
Veigar,Sejuani,858,448,410,52.21
Veigar,Kassadin,498,230,268,46.18
Veigar,Akshan,758,418,340,55.15
Veigar,Blitzcrank,1700,876,824,51.53
Veigar,Riven,943,543,400,57.58
Veigar,Kennen,676,393,283,58.14
Veigar,Xayah,1157,641,516,55.4
Veigar,Alistar,790,355,435,44.94
Veigar,Corki,762,387,375,50.79
Veigar,KogMaw,678,331,347,48.82
Veigar,Shen,1441,792,649,54.96
Veigar,Galio,1698,888,810,52.3
Veigar,Karthus,577,298,279,51.65
Veigar,MonkeyKing,1445,691,754,47.82
Veigar,Lulu,2309,1161,1148,50.28
Veigar,Udyr,851,485,366,56.99
Veigar,Urgot,1099,600,499,54.6
Veigar,Quinn,738,378,360,51.22
Veigar,Renata,385,226,159,58.7
Veigar,Kalista,779,489,290,62.77
Veigar,Zyra,1784,855,929,47.93
Veigar,Olaf,519,260,259,50.1
Veigar,Zeri,805,470,335,58.39
Veigar,Hecarim,792,479,313,60.48
Veigar,Xerath,2017,1017,1000,50.42
Veigar,Lucian,1465,783,682,53.45
Veigar,Rammus,656,330,326,50.3
Veigar,Camille,657,365,292,55.56
Veigar,Cassiopeia,692,367,325,53.03
Veigar,Lissandra,567,290,277,51.15
Veigar,Rumble,420,238,182,56.67
Veigar,Zoe,1003,509,494,50.75
Jinx,Yorick,5084,2455,2629,48.29
Jinx,Viego,7711,3990,3721,51.74
Jinx,Diana,8437,4403,4034,52.19
Jinx,Seraphine,4539,2258,2281,49.75
Jinx,Rakan,2403,1314,1089,54.68
Jinx,Fiora,2185,1179,1006,53.96
Jinx,Lillia,3029,1638,1391,54.08
Jinx,Aurora,4220,2275,1945,53.91
Jinx,Zeri,2613,1395,1218,53.39
Jinx,Teemo,6736,3395,3341,50.4
Jinx,MonkeyKing,3718,1887,1831,50.75
Jinx,Malzahar,5618,2887,2731,51.39
Jinx,Caitlyn,17602,9014,8588,51.21
Jinx,Morgana,6935,3414,3521,49.23
Jinx,Naafiri,1927,1014,913,52.62
Jinx,Briar,4513,2294,2219,50.83
Jinx,Yone,9999,5417,4582,54.18
Jinx,MissFortune,15002,7631,7371,50.87
Jinx,Senna,4254,2197,2057,51.65
Jinx,Gangplank,2825,1467,1358,51.93
Jinx,Ivern,873,458,415,52.46
Jinx,Mel,11438,6104,5334,53.37
Jinx,Jhin,11864,6182,5682,52.11
Jinx,Swain,5453,2703,2750,49.57
Jinx,Vayne,7316,3867,3449,52.86
Jinx,Nocturne,6570,3187,3383,48.51
Jinx,Kaisa,9931,5259,4672,52.96
Jinx,Galio,4738,2433,2305,51.35
Jinx,Blitzcrank,3955,2134,1821,53.96
Jinx,Garen,8668,4406,4262,50.83
Jinx,Kayn,7962,4122,3840,51.77
Jinx,Lux,13306,6658,6648,50.04
Jinx,Thresh,7451,3839,3612,51.52
Jinx,Illaoi,2583,1286,1297,49.79
Jinx,Aatrox,5328,2862,2466,53.72
Jinx,Ashe,13183,6792,6391,51.52
Jinx,Aphelios,3793,1976,1817,52.1
Jinx,Gragas,3232,1740,1492,53.84
Jinx,Gwen,2917,1565,1352,53.65
Jinx,Yasuo,10555,5359,5196,50.77
Jinx,Bard,1647,851,796,51.67
Jinx,Vladimir,3535,1790,1745,50.64
Jinx,Shaco,4891,2668,2223,54.55
Jinx,Tryndamere,3224,1657,1567,51.4
Jinx,Ezreal,13479,7179,6300,53.26
Jinx,Milio,3027,1570,1457,51.87
Jinx,Jax,4978,2589,2389,52.01
Jinx,Talon,3188,1697,1491,53.23
Jinx,Leblanc,3029,1622,1407,53.55
Jinx,Yuumi,4644,2442,2202,52.58
Jinx,Malphite,5414,2764,2650,51.05
Jinx,Neeko,2731,1409,1322,51.59
Jinx,Xayah,2857,1564,1293,54.74
Jinx,Heimerdinger,2700,1370,1330,50.74
Jinx,Kindred,2749,1438,1311,52.31
Jinx,Katarina,4088,2187,1901,53.5
Jinx,Janna,1861,879,982,47.23
Jinx,Lissandra,1837,967,870,52.64
Jinx,Darius,10477,5423,5054,51.76
Jinx,Sejuani,2272,1151,1121,50.66
Jinx,Rell,2561,1397,1164,54.55
Jinx,Amumu,5850,2818,3032,48.17
Jinx,KogMaw,2062,960,1102,46.56
Jinx,FiddleSticks,2768,1499,1269,54.15
Jinx,Soraka,3181,1583,1598,49.76
Jinx,Mordekaiser,7507,3629,3878,48.34
Jinx,Zed,5761,3119,2642,54.14
Jinx,Vex,3011,1617,1394,53.7
Jinx,Samira,4636,2444,2192,52.72
Jinx,Viktor,4998,2502,2496,50.06
Jinx,Nilah,1995,1043,952,52.28
Jinx,Akali,5779,2899,2880,50.16
Jinx,Tristana,5746,2898,2848,50.44
Jinx,Evelynn,2079,1101,978,52.96
Jinx,Kalista,1560,855,705,54.81
Jinx,Renata,1119,558,561,49.87
Jinx,Chogath,7007,3615,3392,51.59
Jinx,Azir,1921,1032,889,53.72
Jinx,Sylas,7080,3740,3340,52.82
Jinx,Lucian,4051,2176,1875,53.72
Jinx,MasterYi,6612,3282,3330,49.64
Jinx,Taric,1263,647,616,51.23
Jinx,XinZhao,3459,1765,1694,51.03
Jinx,Braum,2919,1458,1461,49.95
Jinx,Annie,1781,921,860,51.71
Jinx,Alistar,2298,1265,1033,55.05
Jinx,Pantheon,8744,4744,4000,54.25
Jinx,Khazix,2766,1530,1236,55.31
Jinx,Smolder,3899,2113,1786,54.19
Jinx,Sett,8284,4231,4053,51.07
Jinx,Ekko,5042,2537,2505,50.32
Jinx,Veigar,5885,3037,2848,51.61
Jinx,Nasus,4166,2038,2128,48.92
Jinx,Zoe,2232,1203,1029,53.9
Jinx,Jayce,2850,1426,1424,50.04
Jinx,Rammus,1766,942,824,53.34
Jinx,Sion,4070,2048,2022,50.32
Jinx,Kayle,3761,1893,1868,50.33
Jinx,Lulu,6697,3523,3174,52.61
Jinx,Udyr,2093,1123,970,53.66
Jinx,TahmKench,4506,2290,2216,50.82
Jinx,Shyvana,1426,727,699,50.98
Jinx,Taliyah,1376,731,645,53.13
Jinx,Ziggs,2272,1153,1119,50.75
Jinx,LeeSin,7765,4114,3651,52.98
Jinx,Pyke,4843,2476,2367,51.13
Jinx,Irelia,4594,2358,2236,51.33
Jinx,Velkoz,3259,1620,1639,49.71
Jinx,Ahri,7208,3778,3430,52.41
Jinx,Rengar,1883,985,898,52.31
Jinx,Hwei,3635,1889,1746,51.97
Jinx,Sivir,2952,1475,1477,49.97
Jinx,Vi,5238,2680,2558,51.16
Jinx,DrMundo,3220,1671,1549,51.89
Jinx,Twitch,5515,2735,2780,49.59
Jinx,Ryze,1789,910,879,50.87
Jinx,Nautilus,6120,3336,2784,54.51
Jinx,Olaf,1240,576,664,46.45
Jinx,Orianna,2667,1377,1290,51.63
Jinx,Urgot,2800,1451,1349,51.82
Jinx,Hecarim,2277,1248,1029,54.81
Jinx,Xerath,4634,2296,2338,49.55
Jinx,Nunu,3170,1636,1534,51.61
Jinx,Syndra,3268,1589,1679,48.62
Jinx,Maokai,2387,1179,1208,49.39
Jinx,Akshan,1921,946,975,49.25
Jinx,Zyra,4843,2390,2453,49.35
Jinx,Warwick,8292,4133,4159,49.84
Jinx,Karthus,1618,871,747,53.83
Jinx,Gnar,2422,1282,1140,52.93
Jinx,Nami,5725,2985,2740,52.14
Jinx,Trundle,3141,1660,1481,52.85
Jinx,RekSai,704,378,326,53.69
Jinx,Graves,3688,1953,1735,52.96
Jinx,KSante,2906,1611,1295,55.44
Jinx,Sona,1864,977,887,52.41
Jinx,Cassiopeia,1664,919,745,55.23
Jinx,Qiyana,1446,769,677,53.18
Jinx,Varus,5202,2698,2504,51.86
Jinx,Singed,1508,784,724,51.99
Jinx,Riven,2495,1375,1120,55.11
Jinx,TwistedFate,1842,1026,816,55.7
Jinx,Shen,3539,1930,1609,54.54
Jinx,Ornn,2395,1175,1220,49.06
Jinx,Karma,6082,3105,2977,51.05
Jinx,Kled,963,481,482,49.95
Jinx,Renekton,2621,1294,1327,49.37
Jinx,Volibear,6256,3199,3057,51.13
Jinx,Belveth,1339,777,562,58.03
Jinx,AurelionSol,2276,1164,1112,51.14
Jinx,Brand,3876,2092,1784,53.97
Jinx,Nidalee,1533,874,659,57.01
Jinx,Camille,1910,1037,873,54.29
Jinx,Leona,4575,2405,2170,52.57
Jinx,Poppy,3235,1670,1565,51.62
Jinx,Kassadin,1137,575,562,50.57
Jinx,Draven,2965,1540,1425,51.94
Jinx,Ambessa,3372,1806,1566,53.56
Jinx,Zilean,1735,842,893,48.53
Jinx,Elise,3728,1957,1771,52.49
Jinx,Zac,2350,1123,1227,47.79
Jinx,Kennen,1497,712,785,47.56
Jinx,Corki,2050,1081,969,52.73
Jinx,Skarner,1533,882,651,57.53
Jinx,Anivia,1805,923,882,51.14
Jinx,JarvanIV,3378,1679,1699,49.7
Jinx,Fizz,2959,1484,1475,50.15
Jinx,Quinn,2040,1024,1016,50.2
Jinx,Rumble,1493,818,675,54.79
Yorick,Sett,2919,1527,1392,52.31
Yorick,Ivern,325,177,148,54.46
Yorick,Veigar,2421,1303,1118,53.82
Yorick,Jinx,5084,2629,2455,51.71
Yorick,Lulu,2132,1122,1010,52.63
Yorick,Teemo,3004,1569,1435,52.23
Yorick,MonkeyKing,1303,715,588,54.87
Yorick,Malzahar,2086,1146,940,54.94
Yorick,Caitlyn,5517,3069,2448,55.63
Yorick,Morgana,2503,1325,1178,52.94
Yorick,Aatrox,1689,976,713,57.79
Yorick,Brand,1600,808,792,50.5
Yorick,Irelia,1896,1012,884,53.38
Yorick,Milio,1184,582,602,49.16
Yorick,Gangplank,886,431,455,48.65
Yorick,MasterYi,2542,1407,1135,55.35
Yorick,Mel,4146,2330,1816,56.2
Yorick,Swain,1949,932,1017,47.82
Yorick,Warwick,3531,1757,1774,49.76
Yorick,Akali,1959,1038,921,52.99
Yorick,Sona,724,415,309,57.32
Yorick,Heimerdinger,1040,546,494,52.5
Yorick,Talon,1052,561,491,53.33
Yorick,Ahri,2748,1521,1227,55.35
Yorick,Kalista,515,328,187,63.69
Yorick,FiddleSticks,871,456,415,52.35
Yorick,Shaco,1968,1112,856,56.5
Yorick,Syndra,1261,661,600,52.42
Yorick,Thresh,2658,1418,1240,53.35
Yorick,Urgot,1306,685,621,52.45
Yorick,Rengar,671,389,282,57.97
Yorick,Ziggs,762,433,329,56.82
Yorick,Trundle,1416,763,653,53.88
Yorick,Fiora,706,387,319,54.82
Yorick,Mordekaiser,3098,1614,1484,52.1
Yorick,Vi,1618,901,717,55.69
Yorick,Cassiopeia,602,335,267,55.65
Yorick,Ezreal,4041,2184,1857,54.05
Yorick,Lux,5323,2988,2335,56.13
Yorick,DrMundo,1105,604,501,54.66
Yorick,Nilah,675,370,305,54.81
Yorick,Yuumi,1569,841,728,53.6
Yorick,Leblanc,974,500,474,51.33
Yorick,Elise,1137,647,490,56.9
Yorick,Sylas,2070,1020,1050,49.28
Yorick,Nocturne,2313,1089,1224,47.08
Yorick,Rell,991,590,401,59.54
Yorick,Ashe,3848,2163,1685,56.21
Yorick,Briar,1748,891,857,50.97
Yorick,Hwei,1276,704,572,55.17
Yorick,Kaisa,2735,1503,1232,54.95
Yorick,TahmKench,1671,900,771,53.86
Yorick,Zac,896,449,447,50.11
Yorick,Amumu,2248,1205,1043,53.6
Yorick,Chogath,2920,1419,1501,48.6
Yorick,Twitch,1693,849,844,50.15
Yorick,Jax,1749,961,788,54.95
Yorick,Graves,1058,597,461,56.43
Yorick,Katarina,1536,861,675,56.05
Yorick,Seraphine,1795,1009,786,56.21
Yorick,Darius,3837,2116,1721,55.15
Yorick,Neeko,1095,627,468,57.26
Yorick,Taric,440,265,175,60.23
Yorick,Riven,732,404,328,55.19
Yorick,Lillia,1161,584,577,50.3
Yorick,Orianna,932,535,397,57.4
Yorick,Velkoz,1241,649,592,52.3
Yorick,Ambessa,1037,593,444,57.18
Yorick,Qiyana,488,257,231,52.66
Yorick,LeeSin,2110,1172,938,55.55
Yorick,Nasus,1640,931,709,56.77
Yorick,Pantheon,3146,1651,1495,52.48
Yorick,Zoe,726,424,302,58.4
Yorick,Senna,1603,920,683,57.39
Yorick,Viego,2710,1511,1199,55.76
Yorick,Skarner,560,336,224,60
Yorick,Malphite,1831,998,833,54.51
Yorick,Vladimir,1149,658,491,57.27
Yorick,Tristana,2002,1178,824,58.84
Yorick,Aurora,1359,763,596,56.14
Yorick,MissFortune,4898,2539,2359,51.84
Yorick,Gragas,1044,589,455,56.42
Yorick,Rammus,636,290,346,45.6
Yorick,Nami,2055,1092,963,53.14
Yorick,Lissandra,628,334,294,53.18
Yorick,Pyke,1756,1016,740,57.86
Yorick,Sejuani,846,448,398,52.96
Yorick,Shen,1269,694,575,54.69
Yorick,Naafiri,804,422,382,52.49
Yorick,Diana,3013,1541,1472,51.15
Yorick,Ornn,809,441,368,54.51
Yorick,Karma,1976,976,1000,49.39
Yorick,Yone,3762,2116,1646,56.25
Yorick,Jhin,3951,2123,1828,53.73
Yorick,Volibear,2226,1202,1024,54
Yorick,Samira,1539,868,671,56.4
Yorick,Rumble,384,216,168,56.25
Yorick,Leona,1644,862,782,52.43
Yorick,Maokai,977,540,437,55.27
Yorick,KSante,809,523,286,64.65
Yorick,Kled,356,183,173,51.4
Yorick,Taliyah,402,225,177,55.97
Yorick,Annie,668,357,311,53.44
Yorick,Blitzcrank,1324,788,536,59.52
Yorick,Viktor,1408,777,631,55.18
Yorick,Karthus,499,309,190,61.92
Yorick,Xayah,957,515,442,53.81
Yorick,Rakan,723,383,340,52.97
Yorick,Fizz,1176,683,493,58.08
Yorick,Sivir,1054,514,540,48.77
Yorick,Zed,1996,1167,829,58.47
Yorick,Nautilus,2304,1222,1082,53.04
Yorick,Zyra,1616,847,769,52.41
Yorick,Vex,1097,580,517,52.87
Yorick,Lucian,1323,744,579,56.24
Yorick,Braum,1036,524,512,50.58
Yorick,Kayn,2985,1547,1438,51.83
Yorick,Yasuo,3928,2038,1890,51.88
Yorick,Soraka,1171,639,532,54.57
Yorick,Jayce,921,514,407,55.81
Yorick,AurelionSol,886,432,454,48.76
Yorick,Kayle,1536,781,755,50.85
Yorick,Hecarim,673,403,270,59.88
Yorick,Smolder,1444,808,636,55.96
Yorick,Janna,583,315,268,54.03
Yorick,Tryndamere,1587,853,734,53.75
Yorick,Corki,694,384,310,55.33
Yorick,Aphelios,1224,654,570,53.43
Yorick,TwistedFate,680,401,279,58.97
Yorick,XinZhao,1452,735,717,50.62
Yorick,Evelynn,738,416,322,56.37
Yorick,Xerath,1605,820,785,51.09
Yorick,Zeri,795,381,414,47.92
Yorick,Belveth,506,268,238,52.96
Yorick,Khazix,1009,610,399,60.46
Yorick,Draven,1090,661,429,60.64
Yorick,Renata,357,184,173,51.54
Yorick,Zilean,582,295,287,50.69
Yorick,Kennen,478,276,202,57.74
Yorick,Bard,614,360,254,58.63
Yorick,Sion,1597,806,791,50.47
Yorick,Gwen,1281,750,531,58.55
Yorick,Galio,1606,848,758,52.8
Yorick,Shyvana,576,307,269,53.3
Yorick,Camille,536,340,196,63.43
Yorick,Poppy,1055,569,486,53.93
Yorick,Azir,611,349,262,57.12
Yorick,Illaoi,1088,625,463,57.44
Yorick,Vayne,2459,1339,1120,54.45
Yorick,Ekko,1829,1027,802,56.15
Yorick,Alistar,734,418,316,56.95
Yorick,KogMaw,653,363,290,55.59
Yorick,Gnar,790,449,341,56.84
Yorick,JarvanIV,1126,540,586,47.96
Yorick,Anivia,655,330,325,50.38
Yorick,Kassadin,364,164,200,45.05
Yorick,Udyr,770,471,299,61.17
Yorick,Nidalee,466,273,193,58.58
Yorick,Quinn,717,380,337,53
Yorick,Garen,3050,1637,1413,53.67
Yorick,Singed,552,315,237,57.07
Yorick,Nunu,1385,725,660,52.35
Yorick,Renekton,1074,599,475,55.77
Yorick,Varus,1743,937,806,53.76
Yorick,RekSai,229,136,93,59.39
Yorick,Ryze,641,344,297,53.67
Yorick,Kindred,931,488,443,52.42
Yorick,Akshan,772,449,323,58.16
Yorick,Olaf,385,226,159,58.7
Seraphine,Sett,2830,1310,1520,46.29
Seraphine,Ivern,243,136,107,55.97
Seraphine,Veigar,1868,927,941,49.63
Seraphine,Jinx,4539,2281,2258,50.25
Seraphine,Lulu,2148,1195,953,55.63
Seraphine,Taliyah,366,165,201,45.08
Seraphine,Cassiopeia,541,268,273,49.54
Seraphine,Kaisa,2668,1355,1313,50.79
Seraphine,Neeko,1226,654,572,53.34
Seraphine,Sylas,2247,1138,1109,50.65
Seraphine,Ezreal,3432,1748,1684,50.93
Seraphine,Morgana,2567,1271,1296,49.51
Seraphine,Irelia,1517,830,687,54.71
Seraphine,Diana,2616,1231,1385,47.06
Seraphine,Lux,5899,2897,3002,49.11
Seraphine,Tristana,1709,806,903,47.16
Seraphine,Mel,3387,1768,1619,52.2
Seraphine,Mordekaiser,2558,1218,1340,47.62
Seraphine,Vi,1480,745,735,50.34
Seraphine,Chogath,2050,1054,996,51.41
Seraphine,Yasuo,3371,1623,1748,48.15
Seraphine,Jhin,3334,1637,1697,49.1
Seraphine,Graves,898,458,440,51
Seraphine,Leblanc,868,447,421,51.5
Seraphine,Caitlyn,4858,2510,2348,51.67
Seraphine,Milio,1032,435,597,42.15
Seraphine,Teemo,2365,1138,1227,48.12
Seraphine,Poppy,966,504,462,52.17
Seraphine,Akali,1905,1009,896,52.97
Seraphine,Leona,1458,728,730,49.93
Seraphine,Thresh,2264,1233,1031,54.46
Seraphine,FiddleSticks,957,420,537,43.89
Seraphine,Zed,1714,875,839,51.05
Seraphine,Viktor,1314,670,644,50.99
Seraphine,Pyke,1449,707,742,48.79
Seraphine,Yorick,1795,786,1009,43.79
Seraphine,Nunu,1194,587,607,49.16
Seraphine,Draven,878,423,455,48.18
Seraphine,KogMaw,565,280,285,49.56
Seraphine,Yuumi,1448,749,699,51.73
Seraphine,Riven,779,404,375,51.86
Seraphine,Volibear,2217,1053,1164,47.5
Seraphine,Syndra,885,449,436,50.73
Seraphine,Sejuani,736,366,370,49.73
Seraphine,LeeSin,2050,1075,975,52.44
Seraphine,Twitch,1532,757,775,49.41
Seraphine,Sion,1329,582,747,43.79
Seraphine,Zac,701,359,342,51.21
Seraphine,AurelionSol,771,392,379,50.84
Seraphine,Gnar,641,335,306,52.26
Seraphine,Rammus,533,284,249,53.28
Seraphine,Akshan,630,315,315,50
Seraphine,Ashe,3404,1767,1637,51.91
Seraphine,RekSai,256,125,131,48.83
Seraphine,Hwei,1227,555,672,45.23
Seraphine,Braum,894,446,448,49.89
Seraphine,Pantheon,2928,1410,1518,48.16
Seraphine,Kindred,817,434,383,53.12
Seraphine,Lucian,1052,546,506,51.9
Seraphine,Zyra,1600,777,823,48.56
Seraphine,Gangplank,797,366,431,45.92
Seraphine,MasterYi,2090,1046,1044,50.05
Seraphine,Yone,3155,1588,1567,50.33
Seraphine,Swain,1727,857,870,49.62
Seraphine,Kayle,1384,671,713,48.48
Seraphine,Aurora,1385,711,674,51.34
Seraphine,Viego,2374,1100,1274,46.34
Seraphine,Velkoz,1217,594,623,48.81
Seraphine,Briar,1550,767,783,49.48
Seraphine,Soraka,1051,548,503,52.14
Seraphine,DrMundo,1040,529,511,50.87
Seraphine,Jax,1565,811,754,51.82
Seraphine,Vayne,1963,994,969,50.64
Seraphine,Malzahar,1792,902,890,50.33
Seraphine,Darius,3388,1701,1687,50.21
Seraphine,Warwick,2931,1431,1500,48.82
Seraphine,Zilean,418,199,219,47.61
Seraphine,Shaco,1673,819,854,48.95
Seraphine,Ekko,1515,773,742,51.02
Seraphine,Shyvana,506,240,266,47.43
Seraphine,Garen,2761,1347,1414,48.79
Seraphine,KSante,809,451,358,55.75
Seraphine,Evelynn,720,383,337,53.19
Seraphine,Sivir,958,480,478,50.1
Seraphine,Vladimir,963,428,535,44.44
Seraphine,Talon,951,462,489,48.58
Seraphine,Varus,1485,745,740,50.17
Seraphine,Nilah,763,405,358,53.08
Seraphine,Nasus,1456,681,775,46.77
Seraphine,Zeri,597,306,291,51.26
Seraphine,Xerath,1354,673,681,49.7
Seraphine,Aatrox,1607,879,728,54.7
Seraphine,XinZhao,1176,533,643,45.32
Seraphine,Rell,829,388,441,46.8
Seraphine,Camille,619,297,322,47.98
Seraphine,Rengar,611,352,259,57.61
Seraphine,Amumu,1875,883,992,47.09
Seraphine,MissFortune,4413,2086,2327,47.27
Seraphine,Heimerdinger,1041,453,588,43.52
Seraphine,Katarina,1353,723,630,53.44
Seraphine,Belveth,416,240,176,57.69
Seraphine,Ahri,2432,1205,1227,49.55
Seraphine,Aphelios,1029,531,498,51.6
Seraphine,Anivia,629,298,331,47.38
Seraphine,Urgot,936,455,481,48.61
Seraphine,Trundle,1145,545,600,47.6
Seraphine,Xayah,862,438,424,50.81
Seraphine,Blitzcrank,1288,585,703,45.42
Seraphine,Zoe,651,324,327,49.77
Seraphine,Rakan,792,424,368,53.54
Seraphine,Rumble,342,189,153,55.26
Seraphine,Nautilus,1883,939,944,49.87
Seraphine,Samira,1688,783,905,46.39
Seraphine,Galio,1444,713,731,49.38
Seraphine,Senna,1504,717,787,47.67
Seraphine,Kennen,482,253,229,52.49
Seraphine,Khazix,1018,511,507,50.2
Seraphine,Orianna,738,351,387,47.56
Seraphine,Nocturne,2045,937,1108,45.82
Seraphine,Elise,1083,558,525,51.52
Seraphine,Maokai,859,416,443,48.43
Seraphine,Smolder,1151,624,527,54.21
Seraphine,Gragas,831,419,412,50.42
Seraphine,Ryze,535,302,233,56.45
Seraphine,Tryndamere,914,436,478,47.7
Seraphine,Ambessa,945,450,495,47.62
Seraphine,Fiora,744,357,387,47.98
Seraphine,Brand,1420,661,759,46.55
Seraphine,Fizz,1029,494,535,48.01
Seraphine,Gwen,997,535,462,53.66
Seraphine,Karma,1842,913,929,49.57
Seraphine,Shen,1064,510,554,47.93
Seraphine,Malphite,1742,824,918,47.3
Seraphine,Kayn,2538,1287,1251,50.71
Seraphine,Kled,329,146,183,44.38
Seraphine,Janna,518,255,263,49.23
Seraphine,Nami,1711,837,874,48.92
Seraphine,Kassadin,386,179,207,46.37
Seraphine,MonkeyKing,1041,550,491,52.83
Seraphine,Lissandra,526,242,284,46.01
Seraphine,JarvanIV,894,420,474,46.98
Seraphine,Sona,717,314,403,43.79
Seraphine,Lillia,987,474,513,48.02
Seraphine,Udyr,646,324,322,50.15
Seraphine,Vex,1072,530,542,49.44
Seraphine,Ziggs,790,399,391,50.51
Seraphine,Quinn,693,348,345,50.22
Seraphine,Renekton,796,382,414,47.99
Seraphine,Singed,508,205,303,40.35
Seraphine,Skarner,524,286,238,54.58
Seraphine,Illaoi,818,395,423,48.29
Seraphine,Qiyana,438,240,198,54.79
Seraphine,TahmKench,1576,824,752,52.28
Seraphine,Kalista,562,296,266,52.67
Seraphine,Annie,488,244,244,50
Seraphine,Renata,313,143,170,45.69
Seraphine,Nidalee,467,275,192,58.89
Seraphine,Karthus,452,241,211,53.32
Seraphine,Corki,578,302,276,52.25
Seraphine,Jayce,731,389,342,53.21
Seraphine,TwistedFate,593,312,281,52.61
Seraphine,Hecarim,595,327,268,54.96
Seraphine,Azir,574,329,245,57.32
Seraphine,Bard,501,243,258,48.5
Seraphine,Alistar,521,249,272,47.79
Seraphine,Naafiri,761,408,353,53.61
Seraphine,Olaf,367,185,182,50.41
Seraphine,Ornn,770,393,377,51.04
Seraphine,Taric,341,191,150,56.01
Rakan,Sett,1360,688,672,50.59
Rakan,Ivern,147,92,55,62.59
Rakan,Veigar,915,440,475,48.09
Rakan,Jinx,2403,1089,1314,45.32
Rakan,Lulu,1152,551,601,47.83
Rakan,Leblanc,541,238,303,43.99
Rakan,Briar,744,378,366,50.81
Rakan,Zoe,366,207,159,56.56
Rakan,Poppy,840,441,399,52.5
Rakan,DrMundo,518,252,266,48.65
Rakan,Belveth,222,109,113,49.1
Rakan,Anivia,321,188,133,58.57
Rakan,Vladimir,696,358,338,51.44
Rakan,Evelynn,449,258,191,57.46
Rakan,Yasuo,1882,984,898,52.28
Rakan,Tristana,870,425,445,48.85
Rakan,Yuumi,862,465,397,53.94
Rakan,Akali,1073,583,490,54.33
Rakan,Rammus,326,173,153,53.07
Rakan,Zyra,695,294,401,42.3
Rakan,Mordekaiser,1167,548,619,46.96
Rakan,Diana,1317,663,654,50.34
Rakan,Lux,2317,1159,1158,50.02
Rakan,MissFortune,2005,936,1069,46.68
Rakan,Karma,1080,548,532,50.74
Rakan,Caitlyn,2263,1081,1182,47.77
Rakan,Vi,949,464,485,48.89
Rakan,Orianna,432,226,206,52.31
Rakan,Draven,467,280,187,59.96
Rakan,Xayah,535,285,250,53.27
Rakan,Senna,799,411,388,51.44
Rakan,Jax,838,453,385,54.06
Rakan,Ahri,1278,626,652,48.98
Rakan,Aphelios,544,277,267,50.92
Rakan,Aurora,774,423,351,54.65
Rakan,FiddleSticks,466,203,263,43.56
Rakan,Jhin,1801,961,840,53.36
Rakan,Vex,585,285,300,48.72
Rakan,Samira,718,419,299,58.36
Rakan,Neeko,528,274,254,51.89
Rakan,Aatrox,987,492,495,49.85
Rakan,Gragas,506,248,258,49.01
Rakan,Cassiopeia,302,130,172,43.05
Rakan,Irelia,750,400,350,53.33
Rakan,Yone,1820,920,900,50.55
Rakan,Mel,2148,1112,1036,51.77
Rakan,Ezreal,2161,1099,1062,50.86
Rakan,Elise,829,411,418,49.58
Rakan,Nasus,638,328,310,51.41
Rakan,Amumu,940,427,513,45.43
Rakan,Naafiri,344,200,144,58.14
Rakan,Xerath,706,339,367,48.02
Rakan,Malphite,947,483,464,51
Rakan,Blitzcrank,689,412,277,59.8
Rakan,XinZhao,633,260,373,41.07
Rakan,Qiyana,267,158,109,59.18
Rakan,AurelionSol,387,189,198,48.84
Rakan,Teemo,1002,521,481,52
Rakan,Sylas,1315,657,658,49.96
Rakan,Varus,821,436,385,53.11
Rakan,Yorick,723,340,383,47.03
Rakan,Volibear,885,463,422,52.32
Rakan,Azir,334,157,177,47.01
Rakan,Thresh,1512,719,793,47.55
Rakan,Illaoi,468,224,244,47.86
Rakan,Nocturne,980,508,472,51.84
Rakan,Ryze,339,165,174,48.67
Rakan,Kayn,1396,711,685,50.93
Rakan,Morgana,1113,532,581,47.8
Rakan,Darius,1788,938,850,52.46
Rakan,Taliyah,259,128,131,49.42
Rakan,LeeSin,1425,750,675,52.63
Rakan,Kayle,608,313,295,51.48
Rakan,Seraphine,792,368,424,46.46
Rakan,Garen,1660,782,878,47.11
Rakan,Nunu,583,302,281,51.8
Rakan,Rell,531,268,263,50.47
Rakan,Ashe,1849,915,934,49.49
Rakan,Swain,933,423,510,45.34
Rakan,Riven,446,198,248,44.39
Rakan,Talon,560,306,254,54.64
Rakan,Viktor,712,363,349,50.98
Rakan,Sona,318,161,157,50.63
Rakan,Ornn,443,226,217,51.02
Rakan,Ziggs,377,215,162,57.03
Rakan,Galio,810,368,442,45.43
Rakan,Velkoz,602,313,289,51.99
Rakan,Leona,685,345,340,50.36
Rakan,Twitch,734,403,331,54.9
Rakan,Brand,542,291,251,53.69
Rakan,Shaco,789,396,393,50.19
Rakan,Kalista,296,169,127,57.09
Rakan,Gwen,522,331,191,63.41
Rakan,Kindred,397,207,190,52.14
Rakan,JarvanIV,493,259,234,52.54
Rakan,Gnar,379,185,194,48.81
Rakan,Renekton,449,229,220,51
Rakan,Graves,655,316,339,48.24
Rakan,Lucian,714,322,392,45.1
Rakan,Pantheon,1587,742,845,46.75
Rakan,Warwick,1335,627,708,46.97
Rakan,Zed,1059,598,461,56.47
Rakan,Vayne,1182,596,586,50.42
Rakan,Janna,324,135,189,41.67
Rakan,Katarina,754,410,344,54.38
Rakan,Khazix,556,257,299,46.22
Rakan,Zilean,292,151,141,51.71
Rakan,Kennen,275,132,143,48
Rakan,TahmKench,795,429,366,53.96
Rakan,Kled,149,73,76,48.99
Rakan,KogMaw,263,153,110,58.17
Rakan,Quinn,310,164,146,52.9
Rakan,MasterYi,1113,544,569,48.88
Rakan,Kassadin,192,117,75,60.94
Rakan,Kaisa,1673,942,731,56.31
Rakan,Fizz,471,235,236,49.89
Rakan,Sivir,472,222,250,47.03
Rakan,Taric,156,76,80,48.72
Rakan,Urgot,426,209,217,49.06
Rakan,Nautilus,1063,586,477,55.13
Rakan,Singed,242,115,127,47.52
Rakan,Shyvana,272,149,123,54.78
Rakan,Pyke,915,477,438,52.13
Rakan,Fiora,359,208,151,57.94
Rakan,Smolder,718,340,378,47.35
Rakan,Lillia,556,305,251,54.86
Rakan,Lissandra,289,131,158,45.33
Rakan,Braum,597,337,260,56.45
Rakan,Gangplank,419,202,217,48.21
Rakan,Chogath,1275,624,651,48.94
Rakan,Rengar,392,241,151,61.48
Rakan,RekSai,152,70,82,46.05
Rakan,Sion,763,370,393,48.49
Rakan,Sejuani,362,177,185,48.9
Rakan,Ambessa,620,391,229,63.06
Rakan,KSante,520,246,274,47.31
Rakan,Nami,1005,469,536,46.67
Rakan,Ekko,856,454,402,53.04
Rakan,Heimerdinger,415,206,209,49.64
Rakan,Camille,345,211,134,61.16
Rakan,Shen,618,278,340,44.98
Rakan,Skarner,272,126,146,46.32
Rakan,Syndra,626,288,338,46.01
Rakan,Udyr,351,188,163,53.56
Rakan,Alistar,400,189,211,47.25
Rakan,Malzahar,878,440,438,50.11
Rakan,Trundle,517,250,267,48.36
Rakan,Soraka,520,243,277,46.73
Rakan,Nidalee,277,176,101,63.54
Rakan,MonkeyKing,650,315,335,48.46
Rakan,Renata,202,62,140,30.69
Rakan,TwistedFate,386,220,166,56.99
Rakan,Viego,1307,587,720,44.91
Rakan,Milio,488,226,262,46.31
Rakan,Zac,410,198,212,48.29
Rakan,Tryndamere,527,235,292,44.59
Rakan,Nilah,310,184,126,59.35
Rakan,Hwei,640,340,300,53.13
Rakan,Annie,312,167,145,53.53
Rakan,Jayce,533,246,287,46.15
Rakan,Karthus,313,173,140,55.27
Rakan,Bard,360,179,181,49.72
Rakan,Zeri,393,204,189,51.91
Rakan,Corki,403,215,188,53.35
Rakan,Akshan,380,196,184,51.58
Rakan,Rumble,281,151,130,53.74
Rakan,Hecarim,328,140,188,42.68
Rakan,Maokai,415,232,183,55.9
Rakan,Olaf,246,145,101,58.94
Lillia,Leblanc,725,319,406,44
Lillia,Briar,1059,469,590,44.29
Lillia,Zoe,477,254,223,53.25
Lillia,Jinx,3029,1391,1638,45.92
Lillia,Poppy,875,438,437,50.06
Lillia,Gangplank,531,236,295,44.44
Lillia,Gragas,706,394,312,55.81
Lillia,TwistedFate,464,236,228,50.86
Lillia,Lucian,803,462,341,57.53
Lillia,Leona,1074,511,563,47.58
Lillia,Heimerdinger,672,322,350,47.92
Lillia,Kindred,651,307,344,47.16
Lillia,Katarina,917,476,441,51.91
Lillia,Caitlyn,3188,1543,1645,48.4
Lillia,Janna,370,200,170,54.05
Lillia,Vladimir,727,399,328,54.88
Lillia,Diana,1932,892,1040,46.17
Lillia,Akali,1365,693,672,50.77
Lillia,Karma,1299,649,650,49.96
Lillia,Pantheon,1988,925,1063,46.53
Lillia,Garen,2109,1036,1073,49.12
Lillia,Ziggs,451,199,252,44.12
Lillia,Zeri,501,258,243,51.5
Lillia,Zyra,1016,517,499,50.89
Lillia,Darius,2363,1117,1246,47.27
Lillia,Sejuani,584,332,252,56.85
Lillia,Mel,2411,1313,1098,54.46
Lillia,Jhin,2394,1254,1140,52.38
Lillia,Rell,711,347,364,48.8
Lillia,Yorick,1161,577,584,49.7
Lillia,MasterYi,1169,564,605,48.25
Lillia,Irelia,1074,543,531,50.56
Lillia,Shen,794,397,397,50
Lillia,Nami,1042,463,579,44.43
Lillia,Teemo,1510,729,781,48.28
Lillia,Warwick,1806,880,926,48.73
Lillia,Samira,887,483,404,54.45
Lillia,Lux,2883,1308,1575,45.37
Lillia,Tryndamere,694,368,326,53.03
Lillia,Sivir,629,292,337,46.42
Lillia,Soraka,661,366,295,55.37
Lillia,Malphite,1209,611,598,50.54
Lillia,MonkeyKing,789,385,404,48.8
Lillia,Sylas,1594,848,746,53.2
Lillia,Swain,1369,665,704,48.58
Lillia,Senna,1009,451,558,44.7
Lillia,Kayle,867,364,503,41.98
Lillia,Kayn,1771,882,889,49.8
Lillia,Yasuo,2427,1299,1128,53.52
Lillia,Ezreal,2820,1458,1362,51.7
Lillia,Morgana,1532,725,807,47.32
Lillia,DrMundo,915,484,431,52.9
Lillia,Ekko,1178,601,577,51.02
Lillia,Zed,1271,659,612,51.85
Lillia,Lulu,1471,776,695,52.75
Lillia,Gwen,577,284,293,49.22
Lillia,Maokai,579,280,299,48.36
Lillia,Veigar,1185,614,571,51.81
Lillia,Brand,845,412,433,48.76
Lillia,Aatrox,1133,525,608,46.34
Lillia,Ashe,2490,1306,1184,52.45
Lillia,Chogath,1689,952,737,56.36
Lillia,Kennen,374,175,199,46.79
Lillia,Shaco,1081,516,565,47.73
Lillia,Kaisa,1989,995,994,50.03
Lillia,Sona,473,213,260,45.03
Lillia,Fiora,463,217,246,46.87
Lillia,Nunu,880,448,432,50.91
Lillia,Aphelios,752,361,391,48.01
Lillia,LeeSin,1822,1025,797,56.26
Lillia,MissFortune,2861,1390,1471,48.58
Lillia,Xayah,600,332,268,55.33
Lillia,Volibear,1453,725,728,49.9
Lillia,Jax,1169,631,538,53.98
Lillia,Taliyah,316,164,152,51.9
Lillia,Twitch,969,485,484,50.05
Lillia,KSante,692,421,271,60.84
Lillia,Graves,739,355,384,48.04
Lillia,Taric,247,134,113,54.25
Lillia,Vi,1216,608,608,50
Lillia,Sion,997,530,467,53.16
Lillia,Skarner,457,274,183,59.96
Lillia,Xerath,945,456,489,48.25
Lillia,Jayce,599,277,322,46.24
Lillia,Kalista,380,206,174,54.21
Lillia,Neeko,658,336,322,51.06
Lillia,XinZhao,771,356,415,46.17
Lillia,Tristana,1124,562,562,50
Lillia,Hecarim,551,258,293,46.82
Lillia,Malzahar,1109,565,544,50.95
Lillia,Fizz,655,327,328,49.92
Lillia,Pyke,1011,542,469,53.61
Lillia,Illaoi,546,266,280,48.72
Lillia,Ahri,1629,857,772,52.61
Lillia,Talon,719,328,391,45.62
Lillia,Nocturne,1408,667,741,47.37
Lillia,Trundle,628,273,355,43.47
Lillia,Yone,2308,1168,1140,50.61
Lillia,Kled,193,60,133,31.09
Lillia,Aurora,971,465,506,47.89
Lillia,Thresh,1812,902,910,49.78
Lillia,Zilean,370,181,189,48.92
Lillia,Gnar,468,277,191,59.19
Lillia,Viktor,1048,494,554,47.14
Lillia,Syndra,751,318,433,42.34
Lillia,Mordekaiser,1676,792,884,47.26
Lillia,Akshan,428,209,219,48.83
Lillia,Amumu,1306,680,626,52.07
Lillia,Azir,433,236,197,54.5
Lillia,AurelionSol,562,327,235,58.19
Lillia,Milio,718,345,373,48.05
Lillia,Ambessa,790,408,382,51.65
Lillia,Khazix,710,335,375,47.18
Lillia,Viego,1772,902,870,50.9
Lillia,Olaf,344,180,164,52.33
Lillia,Yuumi,978,477,501,48.77
Lillia,Naafiri,441,205,236,46.49
Lillia,Orianna,517,281,236,54.35
Lillia,Renekton,658,330,328,50.15
Lillia,Seraphine,987,513,474,51.98
Lillia,JarvanIV,679,333,346,49.04
Lillia,Galio,1149,514,635,44.73
Lillia,FiddleSticks,663,336,327,50.68
Lillia,Varus,1022,506,516,49.51
Lillia,Elise,776,365,411,47.04
Lillia,Ryze,346,157,189,45.38
Lillia,TahmKench,1176,624,552,53.06
Lillia,Kassadin,312,162,150,51.92
Lillia,Lissandra,405,161,244,39.75
Lillia,Sett,1806,894,912,49.5
Lillia,Alistar,484,249,235,51.45
Lillia,Draven,655,307,348,46.87
Lillia,Singed,363,176,187,48.48
Lillia,Annie,389,184,205,47.3
Lillia,Vayne,1459,690,769,47.29
Lillia,Braum,642,322,320,50.16
Lillia,Evelynn,552,284,268,51.45
Lillia,Zac,700,359,341,51.29
Lillia,Udyr,540,264,276,48.89
Lillia,KogMaw,408,186,222,45.59
Lillia,Vex,779,412,367,52.89
Lillia,Smolder,862,436,426,50.58
Lillia,Rakan,556,251,305,45.14
Lillia,Corki,433,240,193,55.43
Lillia,Hwei,751,370,381,49.27
Lillia,Anivia,337,126,211,37.39
Lillia,Rammus,476,256,220,53.78
Lillia,Nautilus,1374,720,654,52.4
Lillia,Riven,492,266,226,54.07
Lillia,Renata,201,113,88,56.22
Lillia,Shyvana,338,166,172,49.11
Lillia,Blitzcrank,1040,555,485,53.37
Lillia,Cassiopeia,406,193,213,47.54
Lillia,Rengar,359,202,157,56.27
Lillia,Nasus,918,487,431,53.05
Lillia,Nilah,542,292,250,53.87
Lillia,Ornn,512,280,232,54.69
Lillia,Karthus,369,176,193,47.7
Lillia,Rumble,296,132,164,44.59
Lillia,Quinn,445,202,243,45.39
Lillia,Ivern,179,90,89,50.28
Lillia,Urgot,550,300,250,54.55
Lillia,Qiyana,343,170,173,49.56
Lillia,Camille,414,154,260,37.2
Lillia,Bard,391,185,206,47.31
Lillia,Nidalee,336,185,151,55.06
Lillia,Velkoz,643,269,374,41.84
Lillia,Belveth,265,152,113,57.36
Lillia,RekSai,171,87,84,50.88
Zeri,Leblanc,590,297,293,50.34
Zeri,Briar,683,317,366,46.41
Zeri,Zoe,414,212,202,51.21
Zeri,Jinx,2613,1218,1395,46.61
Zeri,Poppy,746,345,401,46.25
Zeri,Warwick,1275,607,668,47.61
Zeri,Katarina,691,298,393,43.13
Zeri,Twitch,702,329,373,46.87
Zeri,Morgana,987,445,542,45.09
Zeri,Riven,460,247,213,53.7
Zeri,Nocturne,1092,597,495,54.67
Zeri,Lulu,1294,660,634,51
Zeri,Gnar,412,224,188,54.37
Zeri,Viego,1227,569,658,46.37
Zeri,Yone,1743,937,806,53.76
Zeri,Kaisa,1634,822,812,50.31
Zeri,TahmKench,716,374,342,52.23
Zeri,Irelia,735,321,414,43.67
Zeri,Lillia,501,243,258,48.5
Zeri,Sylas,1291,615,676,47.64
Zeri,Caitlyn,2046,1015,1031,49.61
Zeri,Lux,1936,943,993,48.71
Zeri,Teemo,1114,556,558,49.91
Zeri,LeeSin,1571,770,801,49.01
Zeri,Chogath,1136,520,616,45.77
Zeri,Lucian,779,397,382,50.96
Zeri,Xerath,696,314,382,45.11
Zeri,Gragas,616,335,281,54.38
Zeri,Rell,479,240,239,50.1
Zeri,Heimerdinger,379,202,177,53.3
Zeri,Mordekaiser,1159,510,649,44
Zeri,Ashe,1875,929,946,49.55
Zeri,Pyke,879,470,409,53.47
Zeri,Gwen,477,279,198,58.49
Zeri,RekSai,132,61,71,46.21
Zeri,Gangplank,501,276,225,55.09
Zeri,Leona,892,458,434,51.35
Zeri,Sett,1275,583,692,45.73
Zeri,Orianna,433,236,197,54.5
Zeri,Draven,506,275,231,54.35
Zeri,Nautilus,1118,570,548,50.98
Zeri,Urgot,456,208,248,45.61
Zeri,Shaco,868,460,408,53
Zeri,Annie,332,171,161,51.51
Zeri,Ezreal,2453,1283,1170,52.3
Zeri,Quinn,259,126,133,48.65
Zeri,Yasuo,1712,862,850,50.35
Zeri,MissFortune,1898,951,947,50.11
Zeri,Neeko,518,285,233,55.02
Zeri,Renekton,504,267,237,52.98
Zeri,Hecarim,420,205,215,48.81
Zeri,Viktor,815,370,445,45.4
Zeri,Jhin,1731,892,839,51.53
Zeri,Tryndamere,446,230,216,51.57
Zeri,Ivern,157,86,71,54.78
Zeri,Seraphine,597,291,306,48.74
Zeri,Kayle,540,237,303,43.89
Zeri,FiddleSticks,499,247,252,49.5
Zeri,Taric,194,88,106,45.36
Zeri,Camille,401,202,199,50.37
Zeri,Rengar,372,207,165,55.65
Zeri,Aatrox,976,498,478,51.02
Zeri,MasterYi,951,477,474,50.16
Zeri,Xayah,595,286,309,48.07
Zeri,Hwei,667,306,361,45.88
Zeri,Zed,957,420,537,43.89
Zeri,Blitzcrank,716,358,358,50
Zeri,Ambessa,690,359,331,52.03
Zeri,Singed,282,123,159,43.62
Zeri,Talon,595,270,325,45.38
Zeri,Ekko,799,437,362,54.69
Zeri,Tristana,760,390,370,51.32
Zeri,Soraka,576,280,296,48.61
Zeri,Nasus,747,328,419,43.91
Zeri,Aurora,784,400,384,51.02
Zeri,Vayne,1120,498,622,44.46
Zeri,MonkeyKing,574,297,277,51.74
Zeri,Samira,717,358,359,49.93
Zeri,Volibear,987,452,535,45.8
Zeri,Graves,608,310,298,50.99
Zeri,Ahri,1238,622,616,50.24
Zeri,Yorick,795,414,381,52.08
Zeri,Velkoz,523,254,269,48.57
Zeri,DrMundo,453,213,240,47.02
Zeri,Shen,572,278,294,48.6
Zeri,Fizz,439,243,196,55.35
Zeri,Yuumi,832,390,442,46.88
Zeri,Vi,1050,469,581,44.67
Zeri,Swain,800,340,460,42.5
Zeri,Akali,1002,472,530,47.11
Zeri,Kindred,432,202,230,46.76
Zeri,Naafiri,280,106,174,37.86
Zeri,Milio,553,312,241,56.42
Zeri,Fiora,383,217,166,56.66
Zeri,Elise,643,309,334,48.06
Zeri,Pantheon,1380,664,716,48.12
Zeri,Malzahar,862,367,495,42.58
Zeri,Darius,1629,763,866,46.84
Zeri,Udyr,350,172,178,49.14
Zeri,Cassiopeia,338,148,190,43.79
Zeri,Nami,890,406,484,45.62
Zeri,Illaoi,344,173,171,50.29
Zeri,Rammus,253,153,100,60.47
Zeri,Kennen,245,133,112,54.29
Zeri,Mel,1912,954,958,49.9
Zeri,Zyra,868,453,415,52.19
Zeri,Vladimir,599,301,298,50.25
Zeri,Khazix,567,324,243,57.14
Zeri,Thresh,1313,633,680,48.21
Zeri,Sejuani,398,194,204,48.74
Zeri,Renata,165,77,88,46.67
Zeri,Corki,395,197,198,49.87
Zeri,Bard,315,162,153,51.43
Zeri,Zac,493,248,245,50.3
Zeri,Akshan,332,145,187,43.67
Zeri,Ziggs,312,166,146,53.21
Zeri,Kayn,1116,541,575,48.48
Zeri,Smolder,715,374,341,52.31
Zeri,AurelionSol,362,171,191,47.24
Zeri,Garen,1421,628,793,44.19
Zeri,Evelynn,317,163,154,51.42
Zeri,Karma,1215,572,643,47.08
Zeri,Kalista,296,130,166,43.92
Zeri,Azir,401,261,140,65.09
Zeri,Vex,468,236,232,50.43
Zeri,Galio,910,424,486,46.59
Zeri,Varus,914,441,473,48.25
Zeri,Veigar,805,335,470,41.61
Zeri,KSante,627,365,262,58.21
Zeri,Jax,834,364,470,43.65
Zeri,Ornn,376,185,191,49.2
Zeri,Qiyana,296,144,152,48.65
Zeri,Sona,234,89,145,38.03
Zeri,Sion,722,348,374,48.2
Zeri,Alistar,465,225,240,48.39
Zeri,Sivir,497,199,298,40.04
Zeri,Trundle,444,223,221,50.23
Zeri,Belveth,228,103,125,45.18
Zeri,Amumu,829,361,468,43.55
Zeri,Brand,497,240,257,48.29
Zeri,Janna,327,162,165,49.54
Zeri,Nilah,321,136,185,42.37
Zeri,Diana,1462,697,765,47.67
Zeri,Lissandra,276,114,162,41.3
Zeri,Aphelios,621,299,322,48.15
Zeri,Malphite,886,410,476,46.28
Zeri,Kassadin,193,110,83,56.99
Zeri,XinZhao,576,273,303,47.4
Zeri,Ryze,356,177,179,49.72
Zeri,JarvanIV,580,264,316,45.52
Zeri,Karthus,299,152,147,50.84
Zeri,Rakan,393,189,204,48.09
Zeri,Nunu,562,262,300,46.62
Zeri,Senna,708,341,367,48.16
Zeri,Maokai,438,192,246,43.84
Zeri,Syndra,673,354,319,52.6
Zeri,Jayce,548,245,303,44.71
Zeri,Taliyah,272,124,148,45.59
Zeri,Nidalee,305,167,138,54.75
Zeri,Zilean,272,112,160,41.18
Zeri,Anivia,304,150,154,49.34
Zeri,TwistedFate,339,203,136,59.88
Zeri,Shyvana,204,122,82,59.8
Zeri,Rumble,286,138,148,48.25
Zeri,Kled,163,65,98,39.88
Zeri,Skarner,304,157,147,51.64
Zeri,KogMaw,289,159,130,55.02
Zeri,Olaf,264,114,150,43.18
Zeri,Braum,457,250,207,54.7
Leblanc,Fiora,427,176,251,41.22
Leblanc,Lillia,725,406,319,56
Leblanc,Aurora,1038,528,510,50.87
Leblanc,Zeri,590,293,297,49.66
Leblanc,Rakan,541,303,238,56.01
Leblanc,Irelia,962,497,465,51.66
Leblanc,Warwick,1542,677,865,43.9
Leblanc,Galio,1342,648,694,48.29
Leblanc,Sivir,629,296,333,47.06
Leblanc,Rell,560,288,272,51.43
Leblanc,Sett,1763,898,865,50.94
Leblanc,Talon,784,392,392,50
Leblanc,FiddleSticks,605,307,298,50.74
Leblanc,Ashe,2698,1384,1314,51.3
Leblanc,Blitzcrank,1029,526,503,51.12
Leblanc,Malphite,1081,482,599,44.59
Leblanc,Rengar,475,252,223,53.05
Leblanc,Akali,1308,636,672,48.62
Leblanc,Yone,2192,1125,1067,51.32
Leblanc,Briar,820,346,474,42.2
Leblanc,Vex,1029,495,534,48.1
Leblanc,Jinx,3029,1407,1622,46.45
Leblanc,Milio,596,290,306,48.66
Leblanc,Olaf,283,151,132,53.36
Leblanc,LeeSin,2415,1235,1180,51.14
Leblanc,Diana,2005,973,1032,48.53
Leblanc,Seraphine,868,421,447,48.5
Leblanc,Karma,1655,810,845,48.94
Leblanc,Mordekaiser,1499,681,818,45.43
Leblanc,Volibear,1226,551,675,44.94
Leblanc,Mel,2242,1072,1170,47.81
Leblanc,Neeko,615,318,297,51.71
Leblanc,Yorick,974,474,500,48.67
Leblanc,Veigar,1070,557,513,52.06
Leblanc,Caitlyn,3056,1518,1538,49.67
Leblanc,Sona,358,152,206,42.46
Leblanc,Jayce,740,336,404,45.41
Leblanc,Amumu,1043,520,523,49.86
Leblanc,Yasuo,2160,1029,1131,47.64
Leblanc,Jax,1136,596,540,52.46
Leblanc,Heimerdinger,438,174,264,39.73
Leblanc,Soraka,583,280,303,48.03
Leblanc,Zed,1426,716,710,50.21
Leblanc,Samira,921,446,475,48.43
Leblanc,Ambessa,887,447,440,50.39
Leblanc,Nunu,603,314,289,52.07
Leblanc,Kayle,713,341,372,47.83
Leblanc,Katarina,848,425,423,50.12
Leblanc,Jhin,2381,1174,1207,49.31
Leblanc,Lux,3092,1480,1612,47.87
Leblanc,Ekko,1001,528,473,52.75
Leblanc,Kassadin,280,136,144,48.57
Leblanc,TahmKench,759,358,401,47.17
Leblanc,Gnar,502,279,223,55.58
Leblanc,KSante,773,388,385,50.19
Leblanc,Ahri,1862,886,976,47.58
Leblanc,Anivia,412,215,197,52.18
Leblanc,Xayah,623,328,295,52.65
Leblanc,Chogath,1333,573,760,42.99
Leblanc,MissFortune,2593,1202,1391,46.36
Leblanc,Malzahar,1198,547,651,45.66
Leblanc,Viego,1716,882,834,51.4
Leblanc,Vayne,1266,581,685,45.89
Leblanc,Sylas,1696,813,883,47.94
Leblanc,Camille,492,209,283,42.48
Leblanc,Kayn,1433,680,753,47.45
Leblanc,Yuumi,1035,501,534,48.41
Leblanc,Lucian,827,420,407,50.79
Leblanc,Nami,1168,597,571,51.11
Leblanc,Teemo,1372,671,701,48.91
Leblanc,Shaco,1178,549,629,46.6
Leblanc,Naafiri,485,178,307,36.7
Leblanc,Ziggs,345,175,170,50.72
Leblanc,Kalista,431,244,187,56.61
Leblanc,Swain,1016,438,578,43.11
Leblanc,Renekton,589,292,297,49.58
Leblanc,Leona,957,422,535,44.1
Leblanc,Janna,417,173,244,41.49
Leblanc,JarvanIV,684,317,367,46.35
Leblanc,Udyr,381,188,193,49.34
Leblanc,Skarner,406,217,189,53.45
Leblanc,Ezreal,3397,1687,1710,49.66
Leblanc,Trundle,589,283,306,48.05
Leblanc,Rammus,317,162,155,51.1
Leblanc,MonkeyKing,832,427,405,51.32
Leblanc,Nautilus,1377,655,722,47.57
Leblanc,Garen,1827,879,948,48.11
Leblanc,Singed,346,158,188,45.66
Leblanc,Bard,359,178,181,49.58
Leblanc,Nocturne,1473,669,804,45.42
Leblanc,Darius,2016,1018,998,50.5
Leblanc,Gragas,831,430,401,51.74
Leblanc,Gangplank,671,341,330,50.82
Leblanc,Tristana,1001,532,469,53.15
Leblanc,Pyke,1033,589,444,57.02
Leblanc,Aatrox,1317,601,716,45.63
Leblanc,Riven,505,245,260,48.51
Leblanc,Aphelios,645,346,299,53.64
Leblanc,DrMundo,632,317,315,50.16
Leblanc,Thresh,1890,978,912,51.75
Leblanc,Khazix,633,321,312,50.71
Leblanc,Shen,760,401,359,52.76
Leblanc,Nilah,312,125,187,40.06
Leblanc,Kled,246,119,127,48.37
Leblanc,Vi,1184,554,630,46.79
Leblanc,Draven,611,301,310,49.26
Leblanc,Lulu,1611,765,846,47.49
Leblanc,Vladimir,801,382,419,47.69
Leblanc,Brand,746,343,403,45.98
Leblanc,Zoe,592,306,286,51.69
Leblanc,Pantheon,1984,928,1056,46.77
Leblanc,Evelynn,453,215,238,47.46
Leblanc,Azir,508,257,251,50.59
Leblanc,Fizz,642,324,318,50.47
Leblanc,Kaisa,2037,1038,999,50.96
Leblanc,Tryndamere,603,325,278,53.9
Leblanc,Kennen,376,208,168,55.32
Leblanc,Qiyana,226,105,121,46.46
Leblanc,Karthus,380,203,177,53.42
Leblanc,Twitch,913,471,442,51.59
Leblanc,Gwen,539,270,269,50.09
Leblanc,AurelionSol,370,208,162,56.22
Leblanc,Morgana,1235,609,626,49.31
Leblanc,Velkoz,686,299,387,43.59
Leblanc,Smolder,834,363,471,43.53
Leblanc,Illaoi,496,247,249,49.8
Leblanc,Sejuani,524,258,266,49.24
Leblanc,Ornn,495,201,294,40.61
Leblanc,Zac,613,309,304,50.41
Leblanc,Elise,970,456,514,47.01
Leblanc,Hwei,829,393,436,47.41
Leblanc,Braum,729,294,435,40.33
Leblanc,Poppy,827,391,436,47.28
Leblanc,Shyvana,247,122,125,49.39
Leblanc,Lissandra,593,260,333,43.84
Leblanc,Orianna,616,302,314,49.03
Leblanc,Nasus,749,353,396,47.13
Leblanc,MasterYi,1261,589,672,46.71
Leblanc,TwistedFate,405,233,172,57.53
Leblanc,Belveth,266,143,123,53.76
Leblanc,Senna,781,386,395,49.42
Leblanc,Varus,1148,548,600,47.74
Leblanc,Sion,773,402,371,52.01
Leblanc,Hecarim,428,231,197,53.97
Leblanc,Kindred,605,315,290,52.07
Leblanc,Ivern,187,101,86,54.01
Leblanc,Nidalee,409,177,232,43.28
Leblanc,Alistar,619,317,302,51.21
Leblanc,Viktor,1077,492,585,45.68
Leblanc,Graves,927,460,467,49.62
Leblanc,Ryze,377,155,222,41.11
Leblanc,Syndra,754,361,393,47.88
Leblanc,KogMaw,390,170,220,43.59
Leblanc,Zyra,1112,492,620,44.24
Leblanc,Corki,613,319,294,52.04
Leblanc,Zilean,310,154,156,49.68
Leblanc,Maokai,629,266,363,42.29
Leblanc,Annie,443,205,238,46.28
Leblanc,Urgot,529,224,305,42.34
Leblanc,Akshan,351,165,186,47.01
Leblanc,Xerath,1131,556,575,49.16
Leblanc,Rumble,384,165,219,42.97
Leblanc,XinZhao,889,429,460,48.26
Leblanc,Quinn,427,183,244,42.86
Leblanc,Taric,168,69,99,41.07
Leblanc,RekSai,145,71,74,48.97
Leblanc,Renata,205,117,88,57.07
Leblanc,Taliyah,274,133,141,48.54
Leblanc,Cassiopeia,253,146,107,57.71
Briar,Fiora,741,404,337,54.52
Briar,Lillia,1059,590,469,55.71
Briar,Aurora,1251,704,547,56.27
Briar,Zeri,683,366,317,53.59
Briar,Rakan,744,366,378,49.19
Briar,Pantheon,2599,1364,1235,52.48
Briar,Diana,2596,1356,1240,52.23
Briar,Gangplank,827,413,414,49.94
Briar,Ezreal,3261,1787,1474,54.8
Briar,Yuumi,1379,713,666,51.7
Briar,Garen,2429,1208,1221,49.73
Briar,Yasuo,3231,1715,1516,53.08
Briar,Caitlyn,4250,2129,2121,50.09
Briar,Pyke,1545,877,668,56.76
Briar,Aatrox,1555,833,722,53.57
Briar,Sejuani,586,313,273,53.41
Briar,Jinx,4513,2219,2294,49.17
Briar,Sett,2458,1208,1250,49.15
Briar,Amumu,1741,769,972,44.17
Briar,Sylas,1810,1032,778,57.02
Briar,Poppy,1003,498,505,49.65
Briar,Warwick,2795,1458,1337,52.16
Briar,Katarina,1398,754,644,53.93
Briar,Twitch,1356,648,708,47.79
Briar,Morgana,2090,1064,1026,50.91
Briar,Malphite,1627,841,786,51.69
Briar,Rengar,579,358,221,61.83
Briar,Akali,1741,835,906,47.96
Briar,Ashe,3108,1702,1406,54.76
Briar,Vladimir,985,521,464,52.89
Briar,Shaco,1502,762,740,50.73
Briar,Tryndamere,855,440,415,51.46
Briar,Milio,821,413,408,50.3
Briar,Jax,1458,674,784,46.23
Briar,Talon,774,454,320,58.66
Briar,Leblanc,820,474,346,57.8
Briar,Mel,3559,1972,1587,55.41
Briar,Heimerdinger,780,434,346,55.64
Briar,Kindred,836,517,319,61.84
Briar,Janna,523,267,256,51.05
Briar,Smolder,1053,609,444,57.83
Briar,Velkoz,1006,476,530,47.32
Briar,Darius,3340,1734,1606,51.92
Briar,Brand,1302,645,657,49.54
Briar,Kennen,421,268,153,63.66
Briar,Kayn,2614,1384,1230,52.95
Briar,Naafiri,685,362,323,52.85
Briar,Xayah,820,419,401,51.1
Briar,Soraka,1020,495,525,48.53
Briar,Yorick,1748,857,891,49.03
Briar,Irelia,1349,714,635,52.93
Briar,Samira,1362,688,674,50.51
Briar,Nami,1404,679,725,48.36
Briar,DrMundo,1034,495,539,47.87
Briar,Trundle,1071,545,526,50.89
Briar,Ahri,2299,1185,1114,51.54
Briar,Gwen,828,436,392,52.66
Briar,Nunu,1201,647,554,53.87
Briar,Lux,4339,2343,1996,54
Briar,Mordekaiser,2526,1331,1195,52.69
Briar,Zed,1770,935,835,52.82
Briar,MissFortune,3844,2051,1793,53.36
Briar,Veigar,1715,860,855,50.15
Briar,KSante,698,381,317,54.58
Briar,Gragas,872,456,416,52.29
Briar,MasterYi,2164,1075,1089,49.68
Briar,Shyvana,420,245,175,58.33
Briar,Taliyah,430,198,232,46.05
Briar,Swain,1605,811,794,50.53
Briar,Kayle,1173,639,534,54.48
Briar,Nocturne,2080,1039,1041,49.95
Briar,Lucian,970,557,413,57.42
Briar,Seraphine,1550,783,767,50.52
Briar,Ambessa,921,489,432,53.09
Briar,Zac,694,326,368,46.97
Briar,Kalista,530,321,209,60.57
Briar,Olaf,384,190,194,49.48
Briar,Yone,3111,1755,1356,56.41
Briar,Belveth,463,219,244,47.3
Briar,AurelionSol,759,354,405,46.64
Briar,Neeko,860,446,414,51.86
Briar,Nilah,749,389,360,51.94
Briar,Zyra,1332,717,615,53.83
Briar,Volibear,1874,968,906,51.65
Briar,Vex,944,538,406,56.99
Briar,Kaisa,2388,1311,1077,54.9
Briar,Ivern,201,111,90,55.22
Briar,Syndra,890,418,472,46.97
Briar,Maokai,712,375,337,52.67
Briar,Illaoi,802,432,370,53.87
Briar,Hwei,1172,577,595,49.23
Briar,Graves,898,490,408,54.57
Briar,Zoe,584,294,290,50.34
Briar,Tristana,1495,727,768,48.63
Briar,Vayne,1931,1016,915,52.62
Briar,Sona,545,271,274,49.72
Briar,Chogath,2040,1040,1000,50.98
Briar,Draven,928,487,441,52.48
Briar,Teemo,2173,929,1244,42.75
Briar,Xerath,1300,700,600,53.85
Briar,Nasus,1275,658,617,51.61
Briar,Riven,721,386,335,53.54
Briar,Rell,710,349,361,49.15
Briar,Nidalee,393,238,155,60.56
Briar,Hecarim,565,337,228,59.65
Briar,Varus,1287,705,582,54.78
Briar,Lulu,1773,913,860,51.49
Briar,Ornn,667,324,343,48.58
Briar,Jhin,3193,1698,1495,53.18
Briar,Nautilus,1693,907,786,53.57
Briar,Sion,1248,608,640,48.72
Briar,Khazix,901,507,394,56.27
Briar,Ekko,1531,789,742,51.53
Briar,Singed,386,197,189,51.04
Briar,Leona,1473,782,691,53.09
Briar,KogMaw,535,315,220,58.88
Briar,Thresh,2132,1100,1032,51.59
Briar,Fizz,922,462,460,50.11
Briar,Jayce,627,351,276,55.98
Briar,Ziggs,617,354,263,57.37
Briar,TahmKench,1560,825,735,52.88
Briar,Cassiopeia,560,280,280,50
Briar,Braum,840,407,433,48.45
Briar,Renekton,706,379,327,53.68
Briar,Galio,1378,755,623,54.79
Briar,Malzahar,1551,772,779,49.77
Briar,Karma,1649,906,743,54.94
Briar,MonkeyKing,887,421,466,47.46
Briar,Aphelios,968,499,469,51.55
Briar,Viktor,1228,620,608,50.49
Briar,Shen,1053,534,519,50.71
Briar,Renata,321,153,168,47.66
Briar,Vi,1594,871,723,54.64
Briar,Camille,606,333,273,54.95
Briar,Quinn,619,287,332,46.37
Briar,Lissandra,539,301,238,55.84
Briar,Elise,970,517,453,53.3
Briar,Kassadin,296,170,126,57.43
Briar,Evelynn,728,389,339,53.43
Briar,Karthus,440,279,161,63.41
Briar,Annie,464,257,207,55.39
Briar,LeeSin,1899,1058,841,55.71
Briar,Senna,1290,701,589,54.34
Briar,Skarner,403,222,181,55.09
Briar,Corki,484,248,236,51.24
Briar,Viego,2078,1027,1051,49.42
Briar,XinZhao,1023,557,466,54.45
Briar,Ryze,640,363,277,56.72
Briar,Udyr,610,291,319,47.7
Briar,Qiyana,448,256,192,57.14
Briar,Taric,356,157,199,44.1
Briar,FiddleSticks,806,468,338,58.06
Briar,Bard,463,206,257,44.49
Briar,Rumble,353,189,164,53.54
Briar,JarvanIV,827,442,385,53.45
Briar,Sivir,841,406,435,48.28
Briar,Urgot,835,443,392,53.05
Briar,Azir,545,305,240,55.96
Briar,Alistar,613,347,266,56.61
Briar,TwistedFate,518,295,223,56.95
Briar,Orianna,670,335,335,50
Briar,Kled,379,181,198,47.76
Briar,Gnar,615,347,268,56.42
Briar,RekSai,209,121,88,57.89
Briar,Blitzcrank,1219,762,457,62.51
Briar,Akshan,585,291,294,49.74
Briar,Zilean,529,271,258,51.23
Briar,Anivia,506,271,235,53.56
Briar,Rammus,729,361,368,49.52
Zoe,Fiora,372,156,216,41.94
Zoe,Lillia,477,223,254,46.75
Zoe,Aurora,711,316,395,44.44
Zoe,Zeri,414,202,212,48.79
Zoe,Rakan,366,159,207,43.44
Zoe,Vayne,1043,460,583,44.1
Zoe,Nocturne,948,446,502,47.05
Zoe,Kaisa,1476,704,772,47.7
Zoe,Galio,845,364,481,43.08
Zoe,Blitzcrank,696,336,360,48.28
Zoe,Urgot,384,142,242,36.98
Zoe,Kayn,1182,601,581,50.85
Zoe,Yasuo,1561,657,904,42.09
Zoe,Twitch,692,353,339,51.01
Zoe,Neeko,485,267,218,55.05
Zoe,Gragas,538,299,239,55.58
Zoe,Gwen,514,235,279,45.72
Zoe,Bard,289,155,134,53.63
Zoe,Tryndamere,513,251,262,48.93
Zoe,Lux,2287,1084,1203,47.4
Zoe,Nunu,517,211,306,40.81
Zoe,Caitlyn,2167,1065,1102,49.15
Zoe,Vladimir,532,246,286,46.24
Zoe,Yorick,726,302,424,41.6
Zoe,Ekko,812,378,434,46.55
Zoe,Katarina,713,338,375,47.41
Zoe,Jinx,2232,1029,1203,46.1
Zoe,Sion,651,279,372,42.86
Zoe,Evelynn,331,161,170,48.64
Zoe,Akali,859,424,435,49.36
Zoe,Ezreal,1975,1044,931,52.86
Zoe,Aatrox,863,409,454,47.39
Zoe,Naafiri,409,225,184,55.01
Zoe,Ashe,1740,815,925,46.84
Zoe,Morgana,1054,486,568,46.11
Zoe,Trundle,452,208,244,46.02
Zoe,MasterYi,979,461,518,47.09
Zoe,Ahri,1204,630,574,52.33
Zoe,Varus,764,342,422,44.76
Zoe,KSante,441,265,176,60.09
Zoe,Sivir,438,222,216,50.68
Zoe,Mel,1518,728,790,47.96
Zoe,DrMundo,505,229,276,45.35
Zoe,Sylas,1143,595,548,52.06
Zoe,Nilah,329,119,210,36.17
Zoe,Darius,1624,788,836,48.52
Zoe,Shaco,769,351,418,45.64
Zoe,Zed,878,420,458,47.84
Zoe,Braum,515,229,286,44.47
Zoe,Kled,178,97,81,54.49
Zoe,Warwick,1053,443,610,42.07
Zoe,Taliyah,228,90,138,39.47
Zoe,TahmKench,631,321,310,50.87
Zoe,Ornn,376,176,200,46.81
Zoe,Skarner,266,126,140,47.37
Zoe,Lucian,565,273,292,48.32
Zoe,Senna,630,269,361,42.7
Zoe,Nasus,473,173,300,36.58
Zoe,Briar,584,290,294,49.66
Zoe,AurelionSol,338,163,175,48.22
Zoe,Singed,272,102,170,37.5
Zoe,TwistedFate,389,171,218,43.96
Zoe,Brand,613,262,351,42.74
Zoe,Gnar,383,178,205,46.48
Zoe,Vi,928,400,528,43.1
Zoe,Nautilus,931,403,528,43.29
Zoe,Olaf,189,72,117,38.1
Zoe,Pantheon,1334,642,692,48.13
Zoe,Renekton,460,275,185,59.78
Zoe,MissFortune,1803,771,1032,42.76
Zoe,Thresh,1160,558,602,48.1
Zoe,Yone,1626,829,797,50.98
Zoe,Draven,482,212,270,43.98
Zoe,Shen,503,213,290,42.35
Zoe,Jax,753,348,405,46.22
Zoe,Hecarim,273,127,146,46.52
Zoe,Seraphine,651,327,324,50.23
Zoe,Sett,1247,580,667,46.51
Zoe,Khazix,524,254,270,48.47
Zoe,Jhin,1657,814,843,49.12
Zoe,Yuumi,818,385,433,47.07
Zoe,Xayah,415,184,231,44.34
Zoe,Kennen,261,103,158,39.46
Zoe,Karma,1019,479,540,47.01
Zoe,Corki,402,206,196,51.24
Zoe,Hwei,652,301,351,46.17
Zoe,Mordekaiser,1114,548,566,49.19
Zoe,Chogath,985,485,500,49.24
Zoe,Pyke,779,399,380,51.22
Zoe,Garen,1171,514,657,43.89
Zoe,Rengar,359,158,201,44.01
Zoe,Xerath,733,346,387,47.2
Zoe,Samira,588,265,323,45.07
Zoe,Malphite,777,310,467,39.9
Zoe,Amumu,819,373,446,45.54
Zoe,MonkeyKing,503,271,232,53.88
Zoe,Quinn,336,166,170,49.4
Zoe,Ambessa,558,239,319,42.83
Zoe,Graves,547,256,291,46.8
Zoe,Irelia,744,303,441,40.73
Zoe,Lulu,1065,521,544,48.92
Zoe,KogMaw,311,137,174,44.05
Zoe,Nami,876,396,480,45.21
Zoe,Viktor,712,356,356,50
Zoe,Leblanc,592,286,306,48.31
Zoe,Ryze,311,162,149,52.09
Zoe,Leona,680,312,368,45.88
Zoe,Malzahar,825,321,504,38.91
Zoe,Zyra,723,336,387,46.47
Zoe,Riven,374,185,189,49.47
Zoe,Shyvana,223,106,117,47.53
Zoe,Cassiopeia,281,154,127,54.8
Zoe,Soraka,502,243,259,48.41
Zoe,Diana,1283,610,673,47.54
Zoe,Kassadin,117,56,61,47.86
Zoe,LeeSin,1280,626,654,48.91
Zoe,Swain,766,288,478,37.6
Zoe,Sejuani,355,162,193,45.63
Zoe,Illaoi,334,172,162,51.5
Zoe,Poppy,520,242,278,46.54
Zoe,Elise,713,340,373,47.69
Zoe,Smolder,495,278,217,56.16
Zoe,Maokai,400,159,241,39.75
Zoe,Orianna,359,202,157,56.27
Zoe,Volibear,813,345,468,42.44
Zoe,Aphelios,544,262,282,48.16
Zoe,Kalista,269,158,111,58.74
Zoe,Teemo,1015,415,600,40.89
Zoe,Tristana,834,330,504,39.57
Zoe,Syndra,665,339,326,50.98
Zoe,Azir,332,176,156,53.01
Zoe,Ziggs,402,214,188,53.23
Zoe,JarvanIV,428,199,229,46.5
Zoe,Viego,1260,582,678,46.19
Zoe,Kindred,345,164,181,47.54
Zoe,Janna,309,138,171,44.66
Zoe,Gangplank,470,216,254,45.96
Zoe,Velkoz,509,210,299,41.26
Zoe,XinZhao,496,195,301,39.31
Zoe,Milio,504,240,264,47.62
Zoe,Rell,462,215,247,46.54
Zoe,Heimerdinger,324,130,194,40.12
Zoe,Camille,356,147,209,41.29
Zoe,Nidalee,289,158,131,54.67
Zoe,Fizz,451,175,276,38.8
Zoe,Lissandra,263,100,163,38.02
Zoe,FiddleSticks,390,177,213,45.38
Zoe,Alistar,313,157,156,50.16
Zoe,Udyr,315,165,150,52.38
Zoe,Vex,397,184,213,46.35
Zoe,Rumble,238,121,117,50.84
Zoe,Ivern,148,78,70,52.7
Zoe,Veigar,1003,494,509,49.25
Zoe,Annie,259,135,124,52.12
Zoe,Zilean,313,124,189,39.62
Zoe,Kayle,511,235,276,45.99
Zoe,Qiyana,285,170,115,59.65
Zoe,Sona,217,94,123,43.32
Zoe,Anivia,301,154,147,51.16
Zoe,Karthus,281,140,141,49.82
Zoe,Renata,189,100,89,52.91
Zoe,Talon,528,244,284,46.21
Zoe,Jayce,426,248,178,58.22
Zoe,Belveth,184,97,87,52.72
Zoe,Zac,391,212,179,54.22
Zoe,Taric,156,59,97,37.82
Zoe,Akshan,391,168,223,42.97
Zoe,RekSai,146,57,89,39.04
Zoe,Rammus,243,105,138,43.21
LeeSin,Teemo,3178,1438,1740,45.25
LeeSin,MonkeyKing,2163,983,1180,45.45
LeeSin,Malzahar,2672,1192,1480,44.61
LeeSin,Caitlyn,7627,3662,3965,48.01
LeeSin,Morgana,3121,1421,1700,45.53
LeeSin,Gangplank,1894,959,935,50.63
LeeSin,Warwick,3845,1800,2045,46.81
LeeSin,Akali,3437,1706,1731,49.64
LeeSin,Sona,712,288,424,40.45
LeeSin,Garen,4450,2062,2388,46.34
LeeSin,Volibear,2721,1338,1383,49.17
LeeSin,Tristana,2705,1291,1414,47.73
LeeSin,Lux,6913,3343,3570,48.36
LeeSin,Chogath,3317,1482,1835,44.68
LeeSin,Graves,3063,1495,1568,48.81
LeeSin,Leblanc,2415,1179,1236,48.82
LeeSin,Milio,1536,713,823,46.42
LeeSin,Mordekaiser,3510,1692,1818,48.21
LeeSin,Amumu,2503,1169,1334,46.7
LeeSin,Yasuo,6056,2788,3268,46.04
LeeSin,Soraka,1565,709,856,45.3
LeeSin,Gwen,1359,699,660,51.43
LeeSin,Tryndamere,1450,612,838,42.21
LeeSin,Velkoz,1661,806,855,48.52
LeeSin,Zeri,1571,801,770,50.99
LeeSin,Thresh,4786,2259,2527,47.2
LeeSin,KSante,2077,1118,959,53.83
LeeSin,Ashe,7073,3355,3718,47.43
LeeSin,Nasus,1872,852,1020,45.51
LeeSin,TahmKench,2204,1028,1176,46.64
LeeSin,Fizz,1331,652,679,48.99
LeeSin,Nunu,1664,815,849,48.98
LeeSin,Vladimir,1877,867,1010,46.19
LeeSin,Samira,2033,999,1034,49.14
LeeSin,Nami,2572,1136,1436,44.17
LeeSin,Gragas,2294,1157,1137,50.44
LeeSin,XinZhao,2675,1244,1431,46.5
LeeSin,Lucian,2378,1236,1142,51.98
LeeSin,Vi,3843,1801,2042,46.86
LeeSin,Orianna,1548,723,825,46.71
LeeSin,Draven,1487,721,766,48.49
LeeSin,Lulu,4460,2127,2333,47.69
LeeSin,Viktor,2902,1398,1504,48.17
LeeSin,Nocturne,3812,1666,2146,43.7
LeeSin,Nilah,883,431,452,48.81
LeeSin,Bard,1012,436,576,43.08
LeeSin,Sett,4507,2057,2450,45.64
LeeSin,Kayn,3903,1721,2182,44.09
LeeSin,Ryze,1288,643,645,49.92
LeeSin,Khazix,1793,929,864,51.81
LeeSin,MissFortune,6112,2952,3160,48.3
LeeSin,Seraphine,2050,975,1075,47.56
LeeSin,Kalista,1015,484,531,47.68
LeeSin,Gnar,1281,627,654,48.95
LeeSin,Pyke,2788,1387,1401,49.75
LeeSin,Pantheon,5242,2486,2756,47.42
LeeSin,Aurora,2578,1338,1240,51.9
LeeSin,Jax,2831,1355,1476,47.86
LeeSin,JarvanIV,1956,886,1070,45.3
LeeSin,Hwei,2103,941,1162,44.75
LeeSin,Kaisa,5675,2774,2901,48.88
LeeSin,Yorick,2110,937,1173,44.41
LeeSin,Shaco,2906,1437,1469,49.45
LeeSin,Katarina,2316,1068,1248,46.11
LeeSin,Nautilus,3578,1723,1855,48.16
LeeSin,Riven,1299,576,723,44.34
LeeSin,Yone,6096,3027,3069,49.66
LeeSin,Trundle,1298,616,682,47.46
LeeSin,Naafiri,951,426,525,44.79
LeeSin,Aphelios,1719,827,892,48.11
LeeSin,Shen,1750,842,908,48.11
LeeSin,Rammus,891,405,486,45.45
LeeSin,Jayce,2198,1105,1093,50.27
LeeSin,Skarner,982,469,513,47.76
LeeSin,Jinx,7765,3650,4115,47.01
LeeSin,Poppy,2443,1097,1346,44.9
LeeSin,Neeko,1355,640,715,47.23
LeeSin,Sylas,5287,2592,2695,49.03
LeeSin,Lissandra,907,450,457,49.61
LeeSin,Ezreal,9258,4459,4799,48.16
LeeSin,Mel,6076,3058,3018,50.33
LeeSin,Talon,2114,981,1133,46.4
LeeSin,RekSai,621,306,315,49.28
LeeSin,Leona,2453,1123,1330,45.78
LeeSin,Ornn,1467,713,754,48.6
LeeSin,Anivia,1026,483,543,47.08
LeeSin,Yuumi,2697,1360,1337,50.43
LeeSin,Fiora,1147,599,548,52.22
LeeSin,Hecarim,1340,678,662,50.6
LeeSin,Blitzcrank,2699,1389,1310,51.46
LeeSin,Ziggs,922,445,477,48.26
LeeSin,Evelynn,1101,557,544,50.59
LeeSin,Sivir,1634,790,844,48.35
LeeSin,Aatrox,3533,1732,1801,49.02
LeeSin,Xerath,3095,1470,1625,47.5
LeeSin,Sejuani,1523,731,792,48
LeeSin,Ahri,3951,1941,2010,49.13
LeeSin,Camille,1224,605,619,49.43
LeeSin,Rengar,948,497,451,52.43
LeeSin,Diana,5189,2575,2614,49.62
LeeSin,Singed,769,351,418,45.64
LeeSin,Zed,3695,1858,1837,50.28
LeeSin,Urgot,1162,525,637,45.18
LeeSin,Ekko,2709,1310,1399,48.36
LeeSin,Lillia,1822,797,1025,43.74
LeeSin,Smolder,1937,1015,922,52.4
LeeSin,Braum,1747,821,926,46.99
LeeSin,Brand,1742,900,842,51.66
LeeSin,Xayah,1390,650,740,46.76
LeeSin,Irelia,2559,1278,1281,49.94
LeeSin,MasterYi,3328,1581,1747,47.51
LeeSin,Rakan,1425,675,750,47.37
LeeSin,Darius,5671,2594,3077,45.74
LeeSin,Karma,4507,2064,2443,45.8
LeeSin,Taliyah,916,432,484,47.16
LeeSin,Ambessa,2370,1171,1199,49.41
LeeSin,Olaf,863,398,465,46.12
LeeSin,Kayle,1452,671,781,46.21
LeeSin,Illaoi,1243,585,658,47.06
LeeSin,Rell,1519,766,753,50.43
LeeSin,Viego,5820,2816,3004,48.38
LeeSin,Veigar,2421,1110,1311,45.85
LeeSin,Quinn,961,472,489,49.12
LeeSin,Cassiopeia,862,371,491,43.04
LeeSin,Renata,552,236,316,42.75
LeeSin,Twitch,1988,988,1000,49.7
LeeSin,Sion,2070,902,1168,43.57
LeeSin,KogMaw,810,360,450,44.44
LeeSin,Vex,1478,661,817,44.72
LeeSin,Swain,2683,1178,1505,43.91
LeeSin,Heimerdinger,1202,521,681,43.34
LeeSin,Varus,2871,1439,1432,50.12
LeeSin,FiddleSticks,1463,719,744,49.15
LeeSin,Maokai,1375,559,816,40.65
LeeSin,Kindred,1416,719,697,50.78
LeeSin,Vayne,3256,1501,1755,46.1
LeeSin,Renekton,1738,878,860,50.52
LeeSin,Udyr,1034,489,545,47.29
LeeSin,Shyvana,624,333,291,53.37
LeeSin,Kassadin,551,270,281,49
LeeSin,Corki,1287,656,631,50.97
LeeSin,Elise,2777,1400,1377,50.41
LeeSin,TwistedFate,1244,595,649,47.83
LeeSin,Jhin,6066,2847,3219,46.93
LeeSin,Kled,475,228,247,48
LeeSin,DrMundo,1454,719,735,49.45
LeeSin,Briar,1899,841,1058,44.29
LeeSin,AurelionSol,1140,530,610,46.49
LeeSin,Janna,952,396,556,41.6
LeeSin,Zyra,3016,1400,1616,46.42
LeeSin,Alistar,1409,703,706,49.89
LeeSin,Zoe,1280,651,629,50.86
LeeSin,Senna,1872,931,941,49.73
LeeSin,Karthus,875,440,435,50.29
LeeSin,Rumble,1063,520,543,48.92
LeeSin,Kennen,936,419,517,44.76
LeeSin,Annie,1099,526,573,47.86
LeeSin,Galio,2823,1311,1512,46.44
LeeSin,Qiyana,759,405,354,53.36
LeeSin,Syndra,1803,912,891,50.58
LeeSin,Taric,581,275,306,47.33
LeeSin,Malphite,2927,1399,1528,47.8
LeeSin,Akshan,840,407,433,48.45
LeeSin,Belveth,618,283,335,45.79
LeeSin,Zac,1645,802,843,48.75
LeeSin,Ivern,471,255,216,54.14
LeeSin,Nidalee,1573,851,722,54.1
LeeSin,Zilean,840,373,467,44.4
LeeSin,Azir,1297,658,639,50.73
Swain,Teemo,2721,1349,1372,49.58
Swain,MonkeyKing,1304,668,636,51.23
Swain,Malzahar,2384,1177,1207,49.37
Swain,Caitlyn,5584,2763,2821,49.48
Swain,Morgana,2616,1195,1421,45.68
Swain,Yorick,1949,1017,932,52.18
Swain,FiddleSticks,1087,577,510,53.08
Swain,Draven,1005,578,427,57.51
Swain,Smolder,1504,820,684,54.52
Swain,Nautilus,2505,1436,1069,57.33
Swain,Riven,936,489,447,52.24
Swain,Kayn,2950,1513,1437,51.29
Swain,Ahri,2952,1607,1345,54.44
Swain,Jinx,5453,2749,2704,50.41
Swain,Renekton,1007,577,430,57.3
Swain,JarvanIV,1128,597,531,52.93
Swain,Mel,4305,2244,2061,52.13
Swain,Jhin,4078,2204,1874,54.05
Swain,Sylas,3071,1640,1431,53.4
Swain,Samira,1755,936,819,53.33
Swain,Nilah,895,504,391,56.31
Swain,Leona,1846,1015,831,54.98
Swain,Shen,1456,768,688,52.75
Swain,Gragas,1195,647,548,54.14
Swain,Yone,3781,1974,1807,52.21
Swain,Ashe,4297,2139,2158,49.78
Swain,Alistar,942,514,428,54.56
Swain,Tryndamere,1142,622,520,54.47
Swain,Irelia,1793,900,893,50.2
Swain,Kalista,658,370,288,56.23
Swain,Twitch,1656,825,831,49.82
Swain,Nasus,1676,851,825,50.78
Swain,Khazix,1030,501,529,48.64
Swain,Diana,3054,1608,1446,52.65
Swain,Urgot,1076,530,546,49.26
Swain,Lulu,2366,1265,1101,53.47
Swain,KSante,1059,524,535,49.48
Swain,Darius,3979,2039,1940,51.24
Swain,Azir,740,398,342,53.78
Swain,Aphelios,1229,689,540,56.06
Swain,Soraka,1233,611,622,49.55
Swain,Taliyah,483,224,259,46.38
Swain,Senna,1712,884,828,51.64
Swain,Sett,3305,1703,1602,51.53
Swain,Akali,2207,1197,1010,54.24
Swain,Tristana,2125,1091,1034,51.34
Swain,Blitzcrank,1660,936,724,56.39
Swain,Nidalee,509,319,190,62.67
Swain,Aurora,1735,949,786,54.7
Swain,MissFortune,4928,2581,2347,52.37
Swain,Nami,1922,894,1028,46.51
Swain,Chogath,2782,1407,1375,50.58
Swain,Lillia,1369,704,665,51.42
Swain,Vex,1119,618,501,55.23
Swain,Janna,682,312,370,45.75
Swain,TahmKench,1982,1124,858,56.71
Swain,Jax,1949,1095,854,56.18
Swain,Mordekaiser,3049,1448,1601,47.49
Swain,Pantheon,3435,1833,1602,53.36
Swain,Yasuo,4296,2253,2043,52.44
Swain,Braum,1236,632,604,51.13
Swain,Maokai,995,560,435,56.28
Swain,Gnar,937,535,402,57.1
Swain,Shaco,2027,1094,933,53.97
Swain,Xayah,1047,524,523,50.05
Swain,Seraphine,1727,870,857,50.38
Swain,Briar,1605,794,811,49.47
Swain,Fizz,1110,586,524,52.79
Swain,Singed,622,287,335,46.14
Swain,Garen,3551,1818,1733,51.2
Swain,Zed,2173,1147,1026,52.78
Swain,KogMaw,696,332,364,47.7
Swain,Lux,5590,2838,2752,50.77
Swain,Katarina,1596,854,742,53.51
Swain,Neeko,1215,704,511,57.94
Swain,Yuumi,1801,884,917,49.08
Swain,Talon,1119,551,568,49.24
Swain,Milio,1092,556,536,50.92
Swain,Ornn,914,492,422,53.83
Swain,TwistedFate,719,384,335,53.41
Swain,Annie,741,415,326,56.01
Swain,Kayle,1468,770,698,52.45
Swain,Sona,753,365,388,48.47
Swain,Rengar,699,434,265,62.09
Swain,Malphite,2034,1140,894,56.05
Swain,Veigar,2312,1183,1129,51.17
Swain,Zyra,1792,902,890,50.33
Swain,Kennen,658,347,311,52.74
Swain,Ekko,1769,950,819,53.7
Swain,Ezreal,4343,2354,1989,54.2
Swain,Trundle,1258,608,650,48.33
Swain,MasterYi,2562,1250,1312,48.79
Swain,Varus,1856,984,872,53.02
Swain,Heimerdinger,1052,525,527,49.9
Swain,DrMundo,1243,669,574,53.82
Swain,Graves,1241,705,536,56.81
Swain,Leblanc,1016,578,438,56.89
Swain,Vladimir,1390,715,675,51.44
Swain,Volibear,2593,1318,1275,50.83
Swain,Qiyana,577,340,237,58.93
Swain,Kaisa,3381,1923,1458,56.88
Swain,Xerath,1629,817,812,50.15
Swain,Illaoi,972,475,497,48.87
Swain,Warwick,3318,1612,1706,48.58
Swain,Naafiri,773,480,293,62.1
Swain,Orianna,816,457,359,56
Swain,Zilean,643,318,325,49.46
Swain,Ivern,335,188,147,56.12
Swain,Velkoz,1280,679,601,53.05
Swain,Rakan,933,510,423,54.66
Swain,Karma,2188,1114,1074,50.91
Swain,Jayce,884,456,428,51.58
Swain,Vayne,2658,1309,1349,49.25
Swain,Brand,1747,916,831,52.43
Swain,Fiora,851,419,432,49.24
Swain,Camille,665,411,254,61.8
Swain,LeeSin,2683,1505,1178,56.09
Swain,Syndra,1187,579,608,48.78
Swain,Hwei,1445,744,701,51.49
Swain,Thresh,3193,1733,1460,54.27
Swain,Ryze,650,359,291,55.23
Swain,Zeri,800,460,340,57.5
Swain,Zac,891,531,360,59.6
Swain,Viego,2773,1333,1440,48.07
Swain,Bard,530,280,250,52.83
Swain,Cassiopeia,706,345,361,48.87
Swain,Poppy,1171,634,537,54.14
Swain,Kassadin,470,209,261,44.47
Swain,Karthus,606,308,298,50.83
Swain,Pyke,1896,1064,832,56.12
Swain,Nocturne,2362,1266,1096,53.6
Swain,Galio,2076,1050,1026,50.58
Swain,Sion,1524,806,718,52.89
Swain,Aatrox,2043,1056,987,51.69
Swain,Rammus,570,277,293,48.6
Swain,Rell,1087,617,470,56.76
Swain,Corki,734,423,311,57.63
Swain,Skarner,594,350,244,58.92
Swain,Gangplank,968,518,450,53.51
Swain,Udyr,822,410,412,49.88
Swain,Vi,1997,1098,899,54.98
Swain,Nunu,1282,766,516,59.75
Swain,Taric,472,253,219,53.6
Swain,Zoe,766,478,288,62.4
Swain,Elise,1269,615,654,48.46
Swain,Kindred,1065,541,524,50.8
Swain,Sejuani,896,493,403,55.02
Swain,Ziggs,797,444,353,55.71
Swain,Evelynn,787,471,316,59.85
Swain,Amumu,2267,1113,1154,49.1
Swain,Shyvana,644,303,341,47.05
Swain,Lissandra,643,350,293,54.43
Swain,Viktor,1753,938,815,53.51
Swain,Olaf,482,238,244,49.38
Swain,Ambessa,1283,722,561,56.27
Swain,Sivir,1092,565,527,51.74
Swain,Quinn,690,356,334,51.59
Swain,Akshan,754,392,362,51.99
Swain,Gwen,1057,570,487,53.93
Swain,Lucian,1287,702,585,54.55
Swain,XinZhao,1471,762,709,51.8
Swain,AurelionSol,854,394,460,46.14
Swain,Hecarim,782,421,361,53.84
Swain,Rumble,495,239,256,48.28
Swain,Belveth,503,284,219,56.46
Swain,Anivia,678,339,339,50
Swain,Kled,367,196,171,53.41
Swain,Renata,424,224,200,52.83
Swain,RekSai,264,131,133,49.62
Teemo,Yorick,3004,1435,1569,47.77
Teemo,LeeSin,3178,1740,1438,54.75
Teemo,Ezreal,5485,2948,2537,53.75
Teemo,Jinx,6736,3341,3395,49.6
Teemo,Swain,2721,1372,1349,50.42
Teemo,MonkeyKing,1588,735,853,46.28
Teemo,Kayn,3975,2145,1830,53.96
Teemo,Yasuo,5434,2734,2700,50.31
Teemo,Kaisa,3797,2136,1661,56.25
Teemo,Milio,1368,687,681,50.22
Teemo,Vayne,3129,1688,1441,53.95
Teemo,Nocturne,3232,1588,1644,49.13
Teemo,Galio,2347,1211,1136,51.6
Teemo,Blitzcrank,1967,1066,901,54.19
Teemo,Warwick,4171,2096,2075,50.25
Teemo,Evelynn,1171,719,452,61.4
Teemo,Ahri,3456,1830,1626,52.95
Teemo,Yone,4697,2621,2076,55.8
Teemo,Garen,4402,2376,2026,53.98
Teemo,Lux,7259,3835,3424,52.83
Teemo,Caitlyn,7229,3705,3524,51.25
Teemo,Thresh,3379,1734,1645,51.32
Teemo,Irelia,2048,1130,918,55.18
Teemo,Sivir,1439,765,674,53.16
Teemo,Rell,1255,682,573,54.34
Teemo,Aatrox,2765,1502,1263,54.32
Teemo,Gwen,1176,683,493,58.08
Teemo,Syndra,1571,770,801,49.01
Teemo,Ashe,5186,2691,2495,51.89
Teemo,Lulu,2761,1434,1327,51.94
Teemo,Mordekaiser,3698,1789,1909,48.38
Teemo,Amumu,3017,1474,1543,48.86
Teemo,Soraka,1534,734,800,47.85
Teemo,Smolder,1868,983,885,52.62
Teemo,Velkoz,1728,928,800,53.7
Teemo,Chogath,3659,1675,1984,45.78
Teemo,Talon,1489,840,649,56.41
Teemo,Qiyana,634,371,263,58.52
Teemo,Mel,5629,3013,2616,53.53
Teemo,Seraphine,2365,1227,1138,51.88
Teemo,Zed,2889,1627,1262,56.32
Teemo,Shaco,2592,1388,1204,53.55
Teemo,Anivia,799,356,443,44.56
Teemo,Morgana,3379,1766,1613,52.26
Teemo,Tryndamere,1549,825,724,53.26
Teemo,Zeri,1114,558,556,50.09
Teemo,Volibear,3009,1615,1394,53.67
Teemo,Veigar,3206,1569,1637,48.94
Teemo,Sona,960,471,489,49.06
Teemo,Sion,2402,1158,1244,48.21
Teemo,Akshan,963,466,497,48.39
Teemo,Bard,718,381,337,53.06
Teemo,Gangplank,1349,681,668,50.48
Teemo,Taliyah,623,371,252,59.55
Teemo,Akali,2915,1554,1361,53.31
Teemo,Belveth,679,378,301,55.67
Teemo,Hwei,1699,842,857,49.56
Teemo,TahmKench,2210,1172,1038,53.03
Teemo,MissFortune,6593,3366,3227,51.05
Teemo,Lillia,1510,781,729,51.72
Teemo,Gnar,1042,557,485,53.45
Teemo,Rammus,763,360,403,47.18
Teemo,Poppy,1341,661,680,49.29
Teemo,Sett,3589,1801,1788,50.18
Teemo,MasterYi,3335,1674,1661,50.19
Teemo,AurelionSol,1092,559,533,51.19
Teemo,Kindred,1270,720,550,56.69
Teemo,Kennen,886,465,421,52.48
Teemo,Tristana,2563,1366,1197,53.3
Teemo,Yuumi,2325,1153,1172,49.59
Teemo,Ekko,2326,1221,1105,52.49
Teemo,Lucian,1691,824,867,48.73
Teemo,TwistedFate,911,545,366,59.82
Teemo,Cassiopeia,1100,590,510,53.64
Teemo,DrMundo,1539,721,818,46.85
Teemo,Nautilus,2984,1626,1358,54.49
Teemo,Trundle,1476,740,736,50.14
Teemo,Aphelios,1537,881,656,57.32
Teemo,Malphite,3819,1961,1858,51.35
Teemo,Vladimir,1733,867,866,50.03
Teemo,Senna,2052,1033,1019,50.34
Teemo,Ziggs,1248,679,569,54.41
Teemo,Sejuani,1077,545,532,50.6
Teemo,Heimerdinger,1637,800,837,48.87
Teemo,Zilean,857,447,410,52.16
Teemo,Hecarim,977,489,488,50.05
Teemo,Twitch,2111,1122,989,53.15
Teemo,Ivern,443,256,187,57.79
Teemo,Jhin,5084,2604,2480,51.22
Teemo,Pyke,2667,1453,1214,54.48
Teemo,Viego,3508,1796,1712,51.2
Teemo,Kalista,767,417,350,54.37
Teemo,FiddleSticks,1421,641,780,45.11
Teemo,Udyr,957,500,457,52.25
Teemo,Leblanc,1372,701,671,51.09
Teemo,Nami,2505,1222,1283,48.78
Teemo,Vi,2276,1226,1050,53.87
Teemo,Nilah,1043,551,492,52.83
Teemo,Samira,2264,1167,1097,51.55
Teemo,Taric,591,293,298,49.58
Teemo,Ornn,1085,500,585,46.08
Teemo,Skarner,719,353,366,49.1
Teemo,Illaoi,1135,634,501,55.86
Teemo,Naafiri,980,509,471,51.94
Teemo,Xayah,1274,670,604,52.59
Teemo,Rakan,1002,481,521,48
Teemo,Nasus,2228,1138,1090,51.08
Teemo,Zac,1137,589,548,51.8
Teemo,Briar,2173,1244,929,57.25
Teemo,Urgot,1323,701,622,52.99
Teemo,Draven,1413,738,675,52.23
Teemo,Vex,1630,823,807,50.49
Teemo,Diana,4295,2171,2124,50.55
Teemo,Leona,2227,1169,1058,52.49
Teemo,Ryze,1030,524,506,50.87
Teemo,Aurora,2128,1143,985,53.71
Teemo,Braum,1381,681,700,49.31
Teemo,Jax,2294,1204,1090,52.48
Teemo,Zyra,2391,1160,1231,48.52
Teemo,Gragas,1395,828,567,59.35
Teemo,Xerath,2191,1159,1032,52.9
Teemo,Quinn,1110,619,491,55.77
Teemo,Darius,5375,2773,2602,51.59
Teemo,Renata,538,234,304,43.49
Teemo,Ambessa,1361,737,624,54.15
Teemo,KogMaw,893,448,445,50.17
Teemo,Nunu,1735,865,870,49.86
Teemo,Azir,803,428,375,53.3
Teemo,Renekton,979,592,387,60.47
Teemo,Khazix,1360,750,610,55.15
Teemo,Brand,2172,1138,1034,52.39
Teemo,Neeko,1635,892,743,54.56
Teemo,Fiora,782,436,346,55.75
Teemo,Malzahar,2883,1441,1442,49.98
Teemo,Kayle,1858,949,909,51.08
Teemo,Corki,877,483,394,55.07
Teemo,Janna,629,347,282,55.17
Teemo,Fizz,1551,770,781,49.65
Teemo,Alistar,1035,595,440,57.49
Teemo,Sylas,3234,1737,1497,53.71
Teemo,Varus,2292,1210,1082,52.79
Teemo,Shyvana,710,348,362,49.01
Teemo,Lissandra,795,419,376,52.7
Teemo,Kled,478,261,217,54.6
Teemo,Graves,1480,801,679,54.12
Teemo,Orianna,1055,586,469,55.55
Teemo,Shen,1594,739,855,46.36
Teemo,Elise,1608,902,706,56.09
Teemo,Rengar,870,506,364,58.16
Teemo,Maokai,1239,621,618,50.12
Teemo,Singed,690,308,382,44.64
Teemo,Riven,1073,585,488,54.52
Teemo,Katarina,1958,1010,948,51.58
Teemo,Olaf,743,392,351,52.76
Teemo,KSante,831,479,352,57.64
Teemo,Kassadin,465,241,224,51.83
Teemo,Karthus,796,399,397,50.13
Teemo,Annie,946,479,467,50.63
Teemo,Viktor,2038,1069,969,52.45
Teemo,Pantheon,4031,2066,1965,51.25
Teemo,Nidalee,736,436,300,59.24
Teemo,JarvanIV,1315,603,712,45.86
Teemo,Zoe,1015,600,415,59.11
Teemo,Karma,2578,1310,1268,50.81
Teemo,Rumble,877,470,407,53.59
Teemo,XinZhao,1471,755,716,51.33
Teemo,RekSai,315,195,120,61.9
Teemo,Jayce,1251,668,583,53.4
Teemo,Camille,820,462,358,56.34
MonkeyKing,Yorick,1303,588,715,45.13
MonkeyKing,LeeSin,2163,1180,983,54.55
MonkeyKing,Ezreal,3367,1720,1647,51.08
MonkeyKing,Jinx,3718,1831,1887,49.25
MonkeyKing,Swain,1304,636,668,48.77
MonkeyKing,Teemo,1588,853,735,53.72
MonkeyKing,Warwick,2110,1007,1103,47.73
MonkeyKing,Azir,597,340,257,56.95
MonkeyKing,MissFortune,3115,1548,1567,49.7
MonkeyKing,Neeko,662,347,315,52.42
MonkeyKing,Mordekaiser,1888,938,950,49.68
MonkeyKing,Qiyana,318,182,136,57.23
MonkeyKing,Mel,2788,1427,1361,51.18
MonkeyKing,Nautilus,1515,818,697,53.99
MonkeyKing,Sett,2094,1071,1023,51.15
MonkeyKing,Taliyah,390,162,228,41.54
MonkeyKing,Sylas,1900,1030,870,54.21
MonkeyKing,Morgana,1501,739,762,49.23
MonkeyKing,Tryndamere,759,380,379,50.07
MonkeyKing,Kayn,2000,1049,951,52.45
MonkeyKing,Aurora,1081,543,538,50.23
MonkeyKing,Twitch,1176,616,560,52.38
MonkeyKing,Lux,3324,1656,1668,49.82
MonkeyKing,Ahri,1867,985,882,52.76
MonkeyKing,Nunu,810,419,391,51.73
MonkeyKing,Yasuo,2772,1444,1328,52.09
MonkeyKing,Zyra,1272,652,620,51.26
MonkeyKing,Chogath,1485,692,793,46.6
MonkeyKing,Lillia,789,404,385,51.2
MonkeyKing,Vex,657,312,345,47.49
MonkeyKing,Jhin,2649,1442,1207,54.44
MonkeyKing,Janna,465,256,209,55.05
MonkeyKing,Caitlyn,3571,1784,1787,49.96
MonkeyKing,Soraka,797,366,431,45.92
MonkeyKing,Kayle,870,406,464,46.67
MonkeyKing,Ekko,1238,686,552,55.41
MonkeyKing,Irelia,1136,613,523,53.96
MonkeyKing,Yuumi,1108,622,486,56.14
MonkeyKing,Volibear,1621,788,833,48.61
MonkeyKing,Lucian,1065,577,488,54.18
MonkeyKing,Blitzcrank,987,530,457,53.7
MonkeyKing,Akali,1467,782,685,53.31
MonkeyKing,Evelynn,484,234,250,48.35
MonkeyKing,Velkoz,771,372,399,48.25
MonkeyKing,Jax,1214,616,598,50.74
MonkeyKing,Braum,837,409,428,48.86
MonkeyKing,Viego,2250,1140,1110,50.67
MonkeyKing,Heimerdinger,605,316,289,52.23
MonkeyKing,Udyr,554,272,282,49.1
MonkeyKing,Malzahar,1386,678,708,48.92
MonkeyKing,Xayah,761,392,369,51.51
MonkeyKing,Rammus,364,179,185,49.18
MonkeyKing,Varus,1243,634,609,51.01
MonkeyKing,Yone,2586,1443,1143,55.8
MonkeyKing,Graves,1039,533,506,51.3
MonkeyKing,Aatrox,1265,644,621,50.91
MonkeyKing,Ziggs,517,266,251,51.45
MonkeyKing,Kindred,657,319,338,48.55
MonkeyKing,Ryze,487,230,257,47.23
MonkeyKing,Karthus,351,186,165,52.99
MonkeyKing,Kassadin,276,159,117,57.61
MonkeyKing,Renekton,692,359,333,51.88
MonkeyKing,XinZhao,980,618,362,63.06
MonkeyKing,Leblanc,832,405,427,48.68
MonkeyKing,Shen,897,436,461,48.61
MonkeyKing,Pyke,1213,688,525,56.72
MonkeyKing,Viktor,1315,640,675,48.67
MonkeyKing,Ashe,2670,1355,1315,50.75
MonkeyKing,Senna,1084,611,473,56.37
MonkeyKing,Garen,2267,1110,1157,48.96
MonkeyKing,JarvanIV,996,515,481,51.71
MonkeyKing,Hwei,1008,525,483,52.08
MonkeyKing,Lulu,1926,942,984,48.91
MonkeyKing,Leona,1140,561,579,49.21
MonkeyKing,Ivern,241,125,116,51.87
MonkeyKing,Olaf,329,176,153,53.5
MonkeyKing,Katarina,1131,610,521,53.93
MonkeyKing,Kled,255,127,128,49.8
MonkeyKing,Poppy,746,406,340,54.42
MonkeyKing,Zeri,574,277,297,48.26
MonkeyKing,Gangplank,811,394,417,48.58
MonkeyKing,Smolder,934,530,404,56.75
MonkeyKing,Alistar,653,369,284,56.51
MonkeyKing,Urgot,694,358,336,51.59
MonkeyKing,MasterYi,1682,887,795,52.73
MonkeyKing,Zed,1428,811,617,56.79
MonkeyKing,Milio,797,352,445,44.17
MonkeyKing,Briar,887,466,421,52.54
MonkeyKing,Illaoi,622,292,330,46.95
MonkeyKing,Shaco,1266,652,614,51.5
MonkeyKing,Draven,719,344,375,47.84
MonkeyKing,Vayne,1757,897,860,51.05
MonkeyKing,Nasus,979,448,531,45.76
MonkeyKing,Zoe,503,232,271,46.12
MonkeyKing,Pantheon,2257,1162,1095,51.48
MonkeyKing,DrMundo,762,396,366,51.97
MonkeyKing,Seraphine,1041,491,550,47.17
MonkeyKing,Zac,707,325,382,45.97
MonkeyKing,AurelionSol,537,252,285,46.93
MonkeyKing,Aphelios,732,382,350,52.19
MonkeyKing,Tristana,1326,715,611,53.92
MonkeyKing,TwistedFate,452,232,220,51.33
MonkeyKing,Taric,260,142,118,54.62
MonkeyKing,Khazix,814,488,326,59.95
MonkeyKing,Fiora,546,253,293,46.34
MonkeyKing,Diana,2249,1235,1014,54.91
MonkeyKing,Brand,976,473,503,48.46
MonkeyKing,Veigar,1445,754,691,52.18
MonkeyKing,Camille,557,315,242,56.55
MonkeyKing,Vladimir,885,426,459,48.14
MonkeyKing,Gragas,791,380,411,48.04
MonkeyKing,FiddleSticks,705,351,354,49.79
MonkeyKing,Orianna,622,310,312,49.84
MonkeyKing,Elise,884,442,442,50
MonkeyKing,Riven,678,378,300,55.75
MonkeyKing,Darius,2965,1500,1465,50.59
MonkeyKing,KSante,742,420,322,56.6
MonkeyKing,Thresh,2047,1010,1037,49.34
MonkeyKing,Xerath,1026,520,506,50.68
MonkeyKing,Fizz,792,415,377,52.4
MonkeyKing,Annie,375,179,196,47.73
MonkeyKing,Maokai,579,259,320,44.73
MonkeyKing,Quinn,495,266,229,53.74
MonkeyKing,Sejuani,610,341,269,55.9
MonkeyKing,Gwen,719,365,354,50.76
MonkeyKing,Nami,1418,657,761,46.33
MonkeyKing,Kaisa,2187,1275,912,58.3
MonkeyKing,Bard,432,236,196,54.63
MonkeyKing,Karma,1745,862,883,49.4
MonkeyKing,Galio,1145,588,557,51.35
MonkeyKing,Rakan,650,335,315,51.54
MonkeyKing,Trundle,743,373,370,50.2
MonkeyKing,Nidalee,440,229,211,52.05
MonkeyKing,Talon,837,528,309,63.08
MonkeyKing,Rell,682,380,302,55.72
MonkeyKing,Ambessa,878,487,391,55.47
MonkeyKing,Kalista,390,215,175,55.13
MonkeyKing,Sivir,718,333,385,46.38
MonkeyKing,Amumu,1339,662,677,49.44
MonkeyKing,Belveth,309,140,169,45.31
MonkeyKing,Zilean,414,242,172,58.45
MonkeyKing,Sion,1059,526,533,49.67
MonkeyKing,Syndra,789,406,383,51.46
MonkeyKing,Nocturne,1907,919,988,48.19
MonkeyKing,Gnar,529,240,289,45.37
MonkeyKing,RekSai,149,67,82,44.97
MonkeyKing,TahmKench,1194,612,582,51.26
MonkeyKing,Ornn,591,301,290,50.93
MonkeyKing,Renata,282,155,127,54.96
MonkeyKing,Sona,406,201,205,49.51
MonkeyKing,Hecarim,491,296,195,60.29
MonkeyKing,Cassiopeia,452,218,234,48.23
MonkeyKing,Nilah,516,260,256,50.39
MonkeyKing,Naafiri,462,224,238,48.48
MonkeyKing,KogMaw,368,173,195,47.01
MonkeyKing,Malphite,1350,728,622,53.93
MonkeyKing,Lissandra,542,264,278,48.71
MonkeyKing,Vi,1508,737,771,48.87
MonkeyKing,Singed,350,155,195,44.29
MonkeyKing,Jayce,725,359,366,49.52
MonkeyKing,Kennen,415,220,195,53.01
MonkeyKing,Akshan,455,240,215,52.75
MonkeyKing,Samira,1087,628,459,57.77
MonkeyKing,Rengar,415,276,139,66.51
MonkeyKing,Shyvana,348,142,206,40.8
MonkeyKing,Corki,592,342,250,57.77
MonkeyKing,Skarner,458,270,188,58.95
MonkeyKing,Rumble,338,207,131,61.24
MonkeyKing,Anivia,497,229,268,46.08
Malzahar,Yorick,2086,940,1146,45.06
Malzahar,LeeSin,2672,1480,1192,55.39
Malzahar,Ezreal,4507,2485,2022,55.14
Malzahar,Jinx,5618,2729,2889,48.58
Malzahar,Swain,2384,1207,1177,50.63
Malzahar,TahmKench,1926,1071,855,55.61
Malzahar,Malphite,2091,1037,1054,49.59
Malzahar,Yasuo,4332,2247,2085,51.87
Malzahar,Aphelios,1317,702,615,53.3
Malzahar,TwistedFate,889,449,440,50.51
Malzahar,Renekton,896,453,443,50.56
Malzahar,JarvanIV,1316,675,641,51.29
Malzahar,Mel,4437,2361,2076,53.21
Malzahar,Jhin,4133,2045,2088,49.48
Malzahar,Sylas,2309,1249,1060,54.09
Malzahar,Darius,3942,2085,1857,52.89
Malzahar,Rengar,697,394,303,56.53
Malzahar,Syndra,1407,722,685,51.31
Malzahar,Caitlyn,5567,2964,2603,53.24
Malzahar,Lux,5440,2953,2487,54.28
Malzahar,Chogath,2621,1361,1260,51.93
Malzahar,Morgana,2474,1307,1167,52.83
Malzahar,Gnar,876,465,411,53.08
Malzahar,Viego,2576,1357,1219,52.68
Malzahar,Yone,3482,1845,1637,52.99
Malzahar,Kaisa,3184,1721,1463,54.05
Malzahar,Sett,3211,1723,1488,53.66
Malzahar,Sion,1756,893,863,50.85
Malzahar,Samira,1484,857,627,57.75
Malzahar,Alistar,823,468,355,56.87
Malzahar,Viktor,2005,1006,999,50.17
Malzahar,Nocturne,2570,1172,1398,45.6
Malzahar,Annie,654,343,311,52.45
Malzahar,KogMaw,682,335,347,49.12
Malzahar,Kindred,1051,614,437,58.42
Malzahar,Veigar,2297,1205,1092,52.46
Malzahar,Corki,768,425,343,55.34
Malzahar,Pantheon,3249,1807,1442,55.62
Malzahar,Jax,1723,947,776,54.96
Malzahar,Hwei,1505,759,746,50.43
Malzahar,Bard,591,325,266,54.99
Malzahar,FiddleSticks,993,596,397,60.02
Malzahar,Cassiopeia,651,323,328,49.62
Malzahar,Milio,1260,610,650,48.41
Malzahar,Quinn,642,294,348,45.79
Malzahar,Talon,1216,687,529,56.5
Malzahar,Olaf,557,270,287,48.47
Malzahar,Aatrox,1878,1033,845,55.01
Malzahar,Katarina,1450,829,621,57.17
Malzahar,Smolder,1888,936,952,49.58
Malzahar,Braum,1127,576,551,51.11
Malzahar,Shaco,2094,1135,959,54.2
Malzahar,Riven,868,470,398,54.15
Malzahar,Senna,1639,907,732,55.34
Malzahar,Jayce,852,466,386,54.69
Malzahar,Rammus,676,368,308,54.44
Malzahar,Kayn,3017,1681,1336,55.72
Malzahar,Ahri,2808,1586,1222,56.48
Malzahar,Tristana,2063,1152,911,55.84
Malzahar,Nasus,1443,746,697,51.7
Malzahar,Amumu,2155,1074,1081,49.84
Malzahar,Naafiri,779,362,417,46.47
Malzahar,MissFortune,4899,2540,2359,51.85
Malzahar,Xerath,1889,964,925,51.03
Malzahar,Trundle,1261,618,643,49.01
Malzahar,Irelia,1760,922,838,52.39
Malzahar,Evelynn,763,449,314,58.85
Malzahar,Anivia,691,386,305,55.86
Malzahar,Poppy,1191,609,582,51.13
Malzahar,Fiora,773,425,348,54.98
Malzahar,Diana,3375,1653,1722,48.98
Malzahar,Ashe,4005,2129,1876,53.16
Malzahar,Volibear,2291,1194,1097,52.12
Malzahar,Seraphine,1792,890,902,49.67
Malzahar,Azir,742,375,367,50.54
Malzahar,Ziggs,836,434,402,51.91
Malzahar,Lulu,2617,1324,1293,50.59
Malzahar,Mordekaiser,2747,1359,1388,49.47
Malzahar,Leblanc,1198,651,547,54.34
Malzahar,Shen,1330,694,636,52.18
Malzahar,Pyke,1708,976,732,57.14
Malzahar,Nautilus,2266,1217,1049,53.71
Malzahar,MonkeyKing,1386,708,678,51.08
Malzahar,Akali,1899,1037,862,54.61
Malzahar,Zed,2494,1261,1233,50.56
Malzahar,Draven,1063,566,497,53.25
Malzahar,Yuumi,1634,870,764,53.24
Malzahar,Elise,1213,685,528,56.47
Malzahar,Gangplank,1129,629,500,55.71
Malzahar,Xayah,1108,574,534,51.81
Malzahar,Sona,671,282,389,42.03
Malzahar,Soraka,1170,556,614,47.52
Malzahar,Akshan,807,417,390,51.67
Malzahar,Illaoi,955,512,443,53.61
Malzahar,Nidalee,512,315,197,61.52
Malzahar,Orianna,984,538,446,54.67
Malzahar,Zyra,1757,901,856,51.28
Malzahar,Varus,1806,966,840,53.49
Malzahar,Nilah,774,427,347,55.17
Malzahar,Karma,2380,1168,1212,49.08
Malzahar,Velkoz,1264,686,578,54.27
Malzahar,Warwick,2962,1466,1496,49.49
Malzahar,MasterYi,2428,1313,1115,54.08
Malzahar,Nunu,1350,708,642,52.44
Malzahar,Gragas,1014,561,453,55.33
Malzahar,Gwen,1122,621,501,55.35
Malzahar,Vi,1870,950,920,50.8
Malzahar,Lillia,1109,544,565,49.05
Malzahar,Neeko,987,535,452,54.2
Malzahar,Briar,1551,779,772,50.23
Malzahar,Urgot,1014,490,524,48.32
Malzahar,Camille,638,283,355,44.36
Malzahar,Tryndamere,1186,671,515,56.58
Malzahar,Teemo,2883,1442,1441,50.02
Malzahar,Heimerdinger,988,527,461,53.34
Malzahar,Lissandra,588,317,271,53.91
Malzahar,Kalista,656,391,265,59.6
Malzahar,DrMundo,1196,568,628,47.49
Malzahar,Shyvana,605,306,299,50.58
Malzahar,Garen,3328,1687,1641,50.69
Malzahar,Singed,642,344,298,53.58
Malzahar,Thresh,2916,1567,1349,53.74
Malzahar,Udyr,833,457,376,54.86
Malzahar,Kayle,1544,763,781,49.42
Malzahar,Leona,1692,926,766,54.73
Malzahar,Zeri,862,495,367,57.42
Malzahar,Kassadin,390,196,194,50.26
Malzahar,Rell,1171,601,570,51.32
Malzahar,Ornn,893,460,433,51.51
Malzahar,Zoe,825,504,321,61.09
Malzahar,Ekko,1876,954,922,50.85
Malzahar,Vayne,2478,1295,1183,52.26
Malzahar,Kennen,605,310,295,51.24
Malzahar,Aurora,1576,887,689,56.28
Malzahar,Brand,1538,807,731,52.47
Malzahar,KSante,1021,577,444,56.51
Malzahar,Twitch,1670,865,805,51.8
Malzahar,Ryze,769,494,275,64.24
Malzahar,Lucian,1375,688,687,50.04
Malzahar,Blitzcrank,1419,777,642,54.76
Malzahar,Taric,454,229,225,50.44
Malzahar,Vladimir,1383,745,638,53.87
Malzahar,Maokai,928,390,538,42.03
Malzahar,Vex,1066,581,485,54.5
Malzahar,Zilean,686,338,348,49.27
Malzahar,Ambessa,1149,593,556,51.61
Malzahar,Karthus,586,366,220,62.46
Malzahar,Hecarim,793,389,404,49.05
Malzahar,Sejuani,1003,575,428,57.33
Malzahar,Galio,1974,988,986,50.05
Malzahar,Nami,2188,1091,1097,49.86
Malzahar,Graves,1280,647,633,50.55
Malzahar,XinZhao,1369,711,658,51.94
Malzahar,Skarner,621,358,263,57.65
Malzahar,Qiyana,462,273,189,59.09
Malzahar,Rumble,495,270,225,54.55
Malzahar,Sivir,1125,593,532,52.71
Malzahar,Fizz,1293,689,604,53.29
Malzahar,AurelionSol,1198,549,649,45.83
Malzahar,Renata,427,245,182,57.38
Malzahar,Rakan,878,438,440,49.89
Malzahar,Zac,906,482,424,53.2
Malzahar,Khazix,1028,562,466,54.67
Malzahar,Janna,611,303,308,49.59
Malzahar,Kled,362,185,177,51.1
Malzahar,Ivern,311,167,144,53.7
Malzahar,Belveth,493,342,151,69.37
Malzahar,Taliyah,491,239,252,48.68
Malzahar,RekSai,246,135,111,54.88
Caitlyn,Yorick,5517,2447,3070,44.35
Caitlyn,LeeSin,7627,3965,3662,51.99
Caitlyn,Ezreal,15708,8028,7680,51.11
Caitlyn,Jinx,17602,8587,9015,48.78
Caitlyn,Swain,5584,2821,2763,50.52
Caitlyn,Illaoi,2689,1294,1395,48.12
Caitlyn,Twitch,4304,2253,2051,52.35
Caitlyn,Yone,10272,5457,4815,53.13
Caitlyn,Lux,14329,7068,7261,49.33
Caitlyn,Velkoz,3418,1648,1770,48.22
Caitlyn,Pantheon,8500,4242,4258,49.91
Caitlyn,Diana,8493,4086,4407,48.11
Caitlyn,Gangplank,2864,1464,1400,51.12
Caitlyn,Yuumi,4507,2321,2186,51.5
Caitlyn,Mordekaiser,7559,3741,3818,49.49
Caitlyn,Viego,7433,3562,3871,47.92
Caitlyn,Irelia,4839,2299,2540,47.51
Caitlyn,Jhin,13660,6666,6994,48.8
Caitlyn,Kayn,7974,4072,3902,51.07
Caitlyn,Ryze,1859,913,946,49.11
Caitlyn,Briar,4250,2121,2129,49.91
Caitlyn,Vex,3027,1434,1593,47.37
Caitlyn,MissFortune,15197,7341,7856,48.31
Caitlyn,Mel,11074,5618,5456,50.73
Caitlyn,Zed,6166,3254,2912,52.77
Caitlyn,Galio,4621,2403,2218,52
Caitlyn,TahmKench,4768,2501,2267,52.45
Caitlyn,Warwick,8404,4205,4199,50.04
Caitlyn,Yasuo,11136,5514,5622,49.52
Caitlyn,Teemo,7229,3522,3707,48.72
Caitlyn,XinZhao,3486,1684,1802,48.31
Caitlyn,Neeko,3004,1498,1506,49.87
Caitlyn,Morgana,6627,3226,3401,48.68
Caitlyn,Xayah,3024,1574,1450,52.05
Caitlyn,Veigar,5845,2882,2963,49.31
Caitlyn,Aatrox,5036,2687,2349,53.36
Caitlyn,Ekko,4991,2611,2380,52.31
Caitlyn,Orianna,2420,1223,1197,50.54
Caitlyn,Malzahar,5567,2603,2964,46.76
Caitlyn,Maokai,2493,1193,1300,47.85
Caitlyn,Ambessa,3324,1753,1571,52.74
Caitlyn,AurelionSol,2273,1088,1185,47.87
Caitlyn,Khazix,3113,1641,1472,52.71
Caitlyn,Nautilus,6165,2932,3233,47.56
Caitlyn,Lillia,3188,1645,1543,51.6
Caitlyn,Tristana,5587,2892,2695,51.76
Caitlyn,Poppy,3178,1587,1591,49.94
Caitlyn,Heimerdinger,2636,1245,1391,47.23
Caitlyn,Ziggs,2568,1281,1287,49.88
Caitlyn,Olaf,1248,627,621,50.24
Caitlyn,Seraphine,4858,2348,2510,48.33
Caitlyn,Karma,6286,3093,3193,49.2
Caitlyn,Nami,5294,2618,2676,49.45
Caitlyn,Rakan,2263,1182,1081,52.23
Caitlyn,Soraka,2950,1362,1588,46.17
Caitlyn,Aurora,4134,2210,1924,53.46
Caitlyn,Kaisa,8647,4607,4040,53.28
Caitlyn,Chogath,6704,3169,3535,47.27
Caitlyn,Talon,3080,1685,1395,54.71
Caitlyn,Qiyana,1495,824,671,55.12
Caitlyn,Shaco,5378,2839,2539,52.79
Caitlyn,Anivia,1769,902,867,50.99
Caitlyn,Garen,8738,4306,4432,49.28
Caitlyn,Zeri,2046,1031,1015,50.39
Caitlyn,Zyra,4959,2405,2554,48.5
Caitlyn,Volibear,6226,3103,3123,49.84
Caitlyn,Ashe,12833,6477,6356,50.47
Caitlyn,Trundle,3272,1640,1632,50.12
Caitlyn,Leblanc,3056,1537,1519,50.29
Caitlyn,Elise,3705,1804,1901,48.69
Caitlyn,Amumu,5839,2801,3038,47.97
Caitlyn,Pyke,4945,2559,2386,51.75
Caitlyn,Varus,5359,2678,2681,49.97
Caitlyn,Thresh,7338,3758,3580,51.21
Caitlyn,Jax,4836,2579,2257,53.33
Caitlyn,Gragas,3081,1665,1416,54.04
Caitlyn,Rell,2780,1370,1410,49.28
Caitlyn,Camille,1847,962,885,52.08
Caitlyn,MasterYi,6650,3277,3373,49.28
Caitlyn,Malphite,5462,2666,2796,48.81
Caitlyn,Udyr,2150,1146,1004,53.3
Caitlyn,Evelynn,2140,1107,1033,51.73
Caitlyn,Akali,5881,3080,2801,52.37
Caitlyn,Vi,5313,2631,2682,49.52
Caitlyn,Akshan,1900,943,957,49.63
Caitlyn,Darius,10454,5185,5269,49.6
Caitlyn,Azir,1972,995,977,50.46
Caitlyn,Ivern,862,455,407,52.78
Caitlyn,Katarina,4350,2249,2101,51.7
Caitlyn,JarvanIV,2937,1320,1617,44.94
Caitlyn,Hwei,3861,1771,2090,45.87
Caitlyn,Bard,1721,937,784,54.45
Caitlyn,Tryndamere,3127,1632,1495,52.19
Caitlyn,Nidalee,1513,813,700,53.73
Caitlyn,Draven,2911,1516,1395,52.08
Caitlyn,Renekton,2629,1316,1313,50.06
Caitlyn,Quinn,1923,894,1029,46.49
Caitlyn,Zoe,2167,1102,1065,50.85
Caitlyn,Janna,1530,806,724,52.68
Caitlyn,Lucian,3864,1990,1874,51.5
Caitlyn,Nasus,4137,2153,1984,52.04
Caitlyn,Kindred,2501,1340,1161,53.58
Caitlyn,Riven,2338,1253,1085,53.59
Caitlyn,TwistedFate,1996,1056,940,52.91
Caitlyn,Sett,8462,3980,4482,47.03
Caitlyn,Blitzcrank,4285,2166,2119,50.55
Caitlyn,Shen,3477,1640,1837,47.17
Caitlyn,Ahri,7499,3862,3637,51.5
Caitlyn,Samira,4416,2342,2074,53.03
Caitlyn,MonkeyKing,3571,1787,1784,50.04
Caitlyn,Smolder,4043,2129,1914,52.66
Caitlyn,Brand,4353,2134,2219,49.02
Caitlyn,Skarner,1459,791,668,54.22
Caitlyn,Singed,1524,742,782,48.69
Caitlyn,KogMaw,1763,894,869,50.71
Caitlyn,Vladimir,3451,1743,1708,50.51
Caitlyn,Corki,1955,1076,879,55.04
Caitlyn,Cassiopeia,1691,825,866,48.79
Caitlyn,Zilean,1756,852,904,48.52
Caitlyn,Rammus,1699,785,914,46.2
Caitlyn,Hecarim,2049,1024,1025,49.98
Caitlyn,Zac,2672,1380,1292,51.65
Caitlyn,Kalista,1677,945,732,56.35
Caitlyn,Nocturne,6527,2963,3564,45.4
Caitlyn,Sion,3952,1902,2050,48.13
Caitlyn,Gnar,2294,1140,1154,49.69
Caitlyn,Graves,3407,1745,1662,51.22
Caitlyn,Sejuani,2441,1249,1192,51.17
Caitlyn,Lissandra,1652,829,823,50.18
Caitlyn,FiddleSticks,2758,1447,1311,52.47
Caitlyn,Milio,3250,1576,1674,48.49
Caitlyn,Xerath,5076,2416,2660,47.6
Caitlyn,Lulu,6368,3294,3074,51.73
Caitlyn,Rengar,1764,953,811,54.02
Caitlyn,Kennen,1519,817,702,53.79
Caitlyn,Annie,1657,805,852,48.58
Caitlyn,Senna,4362,2194,2168,50.3
Caitlyn,Aphelios,3334,1642,1692,49.25
Caitlyn,Vayne,6630,3363,3267,50.72
Caitlyn,Sona,1776,790,986,44.48
Caitlyn,Kayle,3898,1938,1960,49.72
Caitlyn,Fiora,2022,1074,948,53.12
Caitlyn,Gwen,2730,1414,1316,51.79
Caitlyn,Braum,3207,1596,1611,49.77
Caitlyn,Leona,4525,2288,2237,50.56
Caitlyn,Karthus,1397,743,654,53.19
Caitlyn,Kassadin,1143,609,534,53.28
Caitlyn,Viktor,4631,2320,2311,50.1
Caitlyn,Urgot,2806,1261,1545,44.94
Caitlyn,Nilah,1931,951,980,49.25
Caitlyn,Taliyah,1286,638,648,49.61
Caitlyn,Sivir,3139,1525,1614,48.58
Caitlyn,Syndra,3392,1694,1698,49.94
Caitlyn,Shyvana,1380,644,736,46.67
Caitlyn,KSante,2850,1454,1396,51.02
Caitlyn,RekSai,656,347,309,52.9
Caitlyn,Sylas,6996,3502,3494,50.06
Caitlyn,Naafiri,2008,998,1010,49.7
Caitlyn,Belveth,1239,648,591,52.3
Caitlyn,Alistar,2147,1116,1031,51.98
Caitlyn,Nunu,3470,1792,1678,51.64
Caitlyn,Jayce,2484,1369,1115,55.11
Caitlyn,Ornn,2305,1127,1178,48.89
Caitlyn,Fizz,3040,1583,1457,52.07
Caitlyn,Taric,1156,553,603,47.84
Caitlyn,DrMundo,3062,1426,1636,46.57
Caitlyn,Renata,1030,546,484,53.01
Caitlyn,Rumble,1301,669,632,51.42
Caitlyn,Kled,1030,517,513,50.19
Morgana,Yorick,2503,1178,1325,47.06
Morgana,LeeSin,3121,1700,1421,54.47
Morgana,Ezreal,5434,2843,2591,52.32
Morgana,Jinx,6935,3521,3414,50.77
Morgana,Swain,2616,1421,1195,54.32
Morgana,Pantheon,4051,1949,2102,48.11
Morgana,Diana,4041,1957,2084,48.43
Morgana,Gangplank,1222,598,624,48.94
Morgana,Yuumi,2128,1128,1000,53.01
Morgana,Mordekaiser,3808,1849,1959,48.56
Morgana,Viego,3116,1613,1503,51.77
Morgana,Irelia,1952,1060,892,54.3
Morgana,Jhin,5081,2544,2537,50.07
Morgana,Lux,8556,4434,4122,51.82
Morgana,Qiyana,632,346,286,54.75
Morgana,Warwick,4204,2100,2104,49.95
Morgana,Mel,5089,2612,2477,51.33
Morgana,Nautilus,2911,1498,1413,51.46
Morgana,Kayle,1863,887,976,47.61
Morgana,MonkeyKing,1501,762,739,50.77
Morgana,RekSai,303,156,147,51.49
Morgana,Yone,4674,2509,2165,53.68
Morgana,Seraphine,2567,1296,1271,50.49
Morgana,Sylas,2916,1544,1372,52.95
Morgana,Caitlyn,6627,3401,3226,51.32
Morgana,Zed,2695,1482,1213,54.99
Morgana,MasterYi,3124,1506,1618,48.21
Morgana,Rell,1257,666,591,52.98
Morgana,Jax,2311,1166,1145,50.45
Morgana,Briar,2090,1026,1064,49.09
Morgana,Ahri,3366,1683,1683,50
Morgana,Zeri,987,542,445,54.91
Morgana,Karthus,656,331,325,50.46
Morgana,Aurora,1841,920,921,49.97
Morgana,Senna,2121,1039,1082,48.99
Morgana,Garen,3844,1880,1964,48.91
Morgana,Darius,4698,2391,2307,50.89
Morgana,Malzahar,2474,1167,1307,47.17
Morgana,Zilean,798,349,449,43.73
Morgana,Heimerdinger,1419,645,774,45.45
Morgana,Veigar,3043,1507,1536,49.52
Morgana,Teemo,3379,1613,1766,47.74
Morgana,Gragas,1355,777,578,57.34
Morgana,Soraka,1489,767,722,51.51
Morgana,Twitch,1973,956,1017,48.45
Morgana,Lulu,2717,1406,1311,51.75
Morgana,KSante,1112,596,516,53.6
Morgana,Ashe,5107,2671,2436,52.3
Morgana,Nasus,1880,916,964,48.72
Morgana,TahmKench,2231,1262,969,56.57
Morgana,Fizz,1507,735,772,48.77
Morgana,Gnar,946,497,449,52.54
Morgana,Nunu,1722,920,802,53.43
Morgana,Lucian,1538,796,742,51.76
Morgana,Elise,1563,846,717,54.13
Morgana,Kaisa,3618,1902,1716,52.57
Morgana,Riven,1031,571,460,55.38
Morgana,FiddleSticks,1348,652,696,48.37
Morgana,Brand,2205,1101,1104,49.93
Morgana,Milio,1480,712,768,48.11
Morgana,Camille,788,437,351,55.46
Morgana,Xayah,1310,670,640,51.15
Morgana,Evelynn,1225,667,558,54.45
Morgana,Lissandra,826,455,371,55.08
Morgana,MissFortune,6180,3166,3014,51.23
Morgana,Pyke,2247,1156,1091,51.45
Morgana,Kayn,3745,1941,1804,51.83
Morgana,Katarina,2046,1049,997,51.27
Morgana,Ekko,2185,1107,1078,50.66
Morgana,Yasuo,4994,2556,2438,51.18
Morgana,Singed,696,370,326,53.16
Morgana,KogMaw,864,416,448,48.15
Morgana,Azir,868,475,393,54.72
Morgana,Nami,2246,1082,1164,48.17
Morgana,Chogath,3117,1558,1559,49.98
Morgana,Shen,1730,934,796,53.99
Morgana,Lillia,1532,807,725,52.68
Morgana,Sivir,1495,722,773,48.29
Morgana,Neeko,1563,758,805,48.5
Morgana,Ambessa,1256,642,614,51.11
Morgana,Zac,969,469,500,48.4
Morgana,Kalista,798,395,403,49.5
Morgana,Rengar,776,420,356,54.12
Morgana,Anivia,877,405,472,46.18
Morgana,Galio,2195,1085,1110,49.43
Morgana,Aatrox,2214,1184,1030,53.48
Morgana,Varus,2071,1068,1003,51.57
Morgana,Shaco,2514,1343,1171,53.42
Morgana,Tristana,2472,1255,1217,50.77
Morgana,Zoe,1054,568,486,53.89
Morgana,Belveth,571,281,290,49.21
Morgana,AurelionSol,967,514,453,53.15
Morgana,Maokai,1269,681,588,53.66
Morgana,Sion,1818,902,916,49.61
Morgana,Akali,2726,1499,1227,54.99
Morgana,Sejuani,1110,534,576,48.11
Morgana,Vladimir,1415,716,699,50.6
Morgana,Fiora,1010,509,501,50.4
Morgana,Nilah,1096,522,574,47.63
Morgana,Rumble,592,335,257,56.59
Morgana,Akshan,941,428,513,45.48
Morgana,Sona,969,486,483,50.15
Morgana,Samira,2086,1173,913,56.23
Morgana,Sett,4080,2058,2022,50.44
Morgana,Graves,1461,678,783,46.41
Morgana,Urgot,1246,599,647,48.07
Morgana,Poppy,1388,682,706,49.14
Morgana,Malphite,2586,1351,1235,52.24
Morgana,Khazix,1382,768,614,55.57
Morgana,Jayce,1011,569,442,56.28
Morgana,Kennen,631,323,308,51.19
Morgana,Taric,483,219,264,45.34
Morgana,Braum,1170,612,558,52.31
Morgana,Aphelios,1379,676,703,49.02
Morgana,DrMundo,1671,828,843,49.55
Morgana,Cassiopeia,833,431,402,51.74
Morgana,Rakan,1113,581,532,52.2
Morgana,Illaoi,1351,710,641,52.55
Morgana,Amumu,2787,1341,1446,48.12
Morgana,Vi,2459,1257,1202,51.12
Morgana,Bard,673,360,313,53.49
Morgana,Rammus,826,419,407,50.73
Morgana,Vex,1530,811,719,53.01
Morgana,Volibear,2947,1551,1396,52.63
Morgana,Vayne,2964,1422,1542,47.98
Morgana,Skarner,662,401,261,60.57
Morgana,Nocturne,2971,1372,1599,46.18
Morgana,Ryze,811,371,440,45.75
Morgana,Thresh,3541,1866,1675,52.7
Morgana,Blitzcrank,2149,1131,1018,52.63
Morgana,Nidalee,596,299,297,50.17
Morgana,Hwei,1642,827,815,50.37
Morgana,Xerath,2364,1194,1170,50.51
Morgana,Ornn,1052,574,478,54.56
Morgana,Trundle,1501,747,754,49.77
Morgana,Tryndamere,1564,821,743,52.49
Morgana,TwistedFate,778,417,361,53.6
Morgana,Orianna,1081,537,544,49.68
Morgana,Hecarim,854,445,409,52.11
Morgana,Gwen,1484,875,609,58.96
Morgana,Smolder,1673,888,785,53.08
Morgana,Karma,2716,1245,1471,45.84
Morgana,Naafiri,934,460,474,49.25
Morgana,Leona,2314,1247,1067,53.89
Morgana,Udyr,998,532,466,53.31
Morgana,Syndra,1414,712,702,50.35
Morgana,Draven,1255,614,641,48.92
Morgana,Ziggs,1186,637,549,53.71
Morgana,Talon,1324,688,636,51.96
Morgana,Quinn,961,405,556,42.14
Morgana,Viktor,2052,1073,979,52.29
Morgana,Zyra,2384,1151,1233,48.28
Morgana,Annie,966,519,447,53.73
Morgana,Renekton,1228,621,607,50.57
Morgana,Corki,837,435,402,51.97
Morgana,Leblanc,1235,626,609,50.69
Morgana,XinZhao,1576,791,785,50.19
Morgana,Shyvana,626,323,303,51.6
Morgana,Renata,455,221,234,48.57
Morgana,Kindred,1251,611,640,48.84
Morgana,Velkoz,1561,748,813,47.92
Morgana,Janna,697,352,345,50.5
Morgana,Kled,470,230,240,48.94
Morgana,Taliyah,506,277,229,54.74
Morgana,Alistar,793,450,343,56.75
Morgana,Kassadin,548,288,260,52.55
Morgana,JarvanIV,1159,508,651,43.83
Morgana,Olaf,668,298,370,44.61
Morgana,Ivern,363,175,188,48.21
Kayle,Illaoi,737,416,321,56.45
Kayle,Twitch,1224,690,534,56.37
Kayle,Yone,2404,1194,1210,49.67
Kayle,Lux,3677,1928,1749,52.43
Kayle,Velkoz,886,462,424,52.14
Kayle,Sett,2231,1129,1102,50.61
Kayle,Taliyah,346,191,155,55.2
Kayle,Sylas,1706,899,807,52.7
Kayle,Ezreal,2901,1542,1359,53.15
Kayle,Morgana,1863,976,887,52.39
Kayle,Aatrox,1343,746,597,55.55
Kayle,Ashe,2493,1272,1221,51.02
Kayle,Aphelios,869,513,356,59.03
Kayle,Gragas,845,434,411,51.36
Kayle,KSante,698,402,296,57.59
Kayle,Nasus,1293,599,694,46.33
Kayle,TahmKench,1132,570,562,50.35
Kayle,Fizz,795,418,377,52.58
Kayle,Irelia,1357,673,684,49.59
Kayle,Nocturne,1566,855,711,54.6
Kayle,Jayce,518,273,245,52.7
Kayle,Jhin,2786,1449,1337,52.01
Kayle,Senna,1218,636,582,52.22
Kayle,Yasuo,2878,1579,1299,54.86
Kayle,Naafiri,532,281,251,52.82
Kayle,Leblanc,713,372,341,52.17
Kayle,MissFortune,3218,1626,1592,50.53
Kayle,Nami,1559,744,815,47.72
Kayle,Singed,467,272,195,58.24
Kayle,Galio,1155,539,616,46.67
Kayle,Smolder,1108,599,509,54.06
Kayle,Brand,1027,548,479,53.36
Kayle,Aurora,1069,561,508,52.48
Kayle,Jinx,3761,1868,1893,49.67
Kayle,Seraphine,1384,713,671,51.52
Kayle,MonkeyKing,870,464,406,53.33
Kayle,Vex,777,396,381,50.97
Kayle,Vayne,1772,877,895,49.49
Kayle,Briar,1173,534,639,45.52
Kayle,Fiora,562,334,228,59.43
Kayle,Cassiopeia,469,235,234,50.11
Kayle,Darius,3026,1515,1511,50.07
Kayle,Warwick,2109,1013,1096,48.03
Kayle,Shen,955,501,454,52.46
Kayle,Lillia,867,503,364,58.02
Kayle,Sivir,644,326,318,50.62
Kayle,Neeko,696,392,304,56.32
Kayle,Vladimir,1051,540,511,51.38
Kayle,Rammus,456,227,229,49.78
Kayle,Swain,1468,698,770,47.55
Kayle,Ekko,1325,686,639,51.77
Kayle,Qiyana,347,177,170,51.01
Kayle,Zeri,540,303,237,56.11
Kayle,TwistedFate,539,304,235,56.4
Kayle,Gnar,462,247,215,53.46
Kayle,Diana,2158,1054,1104,48.84
Kayle,Veigar,1576,790,786,50.13
Kayle,Lucian,941,492,449,52.28
Kayle,Renekton,571,266,305,46.58
Kayle,Kayn,1974,1000,974,50.66
Kayle,Caitlyn,3898,1960,1938,50.28
Kayle,Mel,3139,1644,1495,52.37
Kayle,Pantheon,2335,1052,1283,45.05
Kayle,Zed,1397,810,587,57.98
Kayle,Nautilus,1419,779,640,54.9
Kayle,Mordekaiser,2105,1152,953,54.73
Kayle,Anivia,560,285,275,50.89
Kayle,Pyke,1415,789,626,55.76
Kayle,Chogath,1889,1007,882,53.31
Kayle,Kaisa,2026,1147,879,56.61
Kayle,Yorick,1536,755,781,49.15
Kayle,Nunu,930,485,445,52.15
Kayle,Rakan,608,295,313,48.52
Kayle,Rumble,321,184,137,57.32
Kayle,Shaco,1301,710,591,54.57
Kayle,Talon,836,471,365,56.34
Kayle,Tristana,1492,717,775,48.06
Kayle,Soraka,834,406,428,48.68
Kayle,JarvanIV,850,396,454,46.59
Kayle,LeeSin,1452,781,671,53.79
Kayle,Hwei,1040,502,538,48.27
Kayle,Ornn,639,338,301,52.9
Kayle,Xayah,720,346,374,48.06
Kayle,Zyra,1066,544,522,51.03
Kayle,Corki,544,304,240,55.88
Kayle,Ziggs,469,227,242,48.4
Kayle,Vi,1391,753,638,54.13
Kayle,Katarina,1215,676,539,55.64
Kayle,Draven,828,456,372,55.07
Kayle,XinZhao,825,411,414,49.82
Kayle,Viego,1697,837,860,49.32
Kayle,Quinn,529,248,281,46.88
Kayle,DrMundo,762,384,378,50.39
Kayle,Jax,1489,739,750,49.63
Kayle,Malphite,1535,787,748,51.27
Kayle,Ahri,1913,1019,894,53.27
Kayle,Renata,254,118,136,46.46
Kayle,Teemo,1858,907,951,48.82
Kayle,Samira,1151,623,528,54.13
Kayle,Graves,939,473,466,50.37
Kayle,Shyvana,372,143,229,38.44
Kayle,Amumu,1580,734,846,46.46
Kayle,Garen,2689,1482,1207,55.11
Kayle,KogMaw,470,233,237,49.57
Kayle,Karma,1469,834,635,56.77
Kayle,Evelynn,643,359,284,55.83
Kayle,Nilah,550,260,290,47.27
Kayle,Leona,1093,565,528,51.69
Kayle,Akali,1483,775,708,52.26
Kayle,Blitzcrank,944,498,446,52.75
Kayle,Malzahar,1544,781,763,50.58
Kayle,Rell,630,358,272,56.83
Kayle,Belveth,391,195,196,49.87
Kayle,Kled,274,120,154,43.8
Kayle,Kalista,529,279,250,52.74
Kayle,Khazix,758,451,307,59.5
Kayle,AurelionSol,580,299,281,51.55
Kayle,Thresh,1838,946,892,51.47
Kayle,Gangplank,775,447,328,57.68
Kayle,Volibear,1633,842,791,51.56
Kayle,Sona,545,280,265,51.38
Kayle,Braum,821,417,404,50.79
Kayle,Ryze,448,227,221,50.67
Kayle,Annie,466,231,235,49.57
Kayle,Udyr,530,279,251,52.64
Kayle,Hecarim,598,317,281,53.01
Kayle,Janna,473,268,205,56.66
Kayle,Poppy,847,349,498,41.2
Kayle,Viktor,1187,589,598,49.62
Kayle,Ivern,195,109,86,55.9
Kayle,MasterYi,1679,810,869,48.24
Kayle,Camille,435,233,202,53.56
Kayle,Kennen,401,231,170,57.61
Kayle,FiddleSticks,694,350,344,50.43
Kayle,Kassadin,339,157,182,46.31
Kayle,Heimerdinger,633,296,337,46.76
Kayle,Akshan,565,253,312,44.78
Kayle,Milio,861,440,421,51.1
Kayle,Olaf,279,159,120,56.99
Kayle,Xerath,1208,568,640,47.02
Kayle,Ambessa,747,404,343,54.08
Kayle,Tryndamere,836,429,407,51.32
Kayle,Sejuani,518,267,251,51.54
Kayle,Elise,827,395,432,47.76
Kayle,Yuumi,1215,607,608,49.96
Kayle,Sion,1107,560,547,50.59
Kayle,Lulu,1672,930,742,55.62
Kayle,Alistar,481,251,230,52.18
Kayle,Urgot,857,426,431,49.71
Kayle,Riven,561,296,265,52.76
Kayle,Skarner,424,251,173,59.2
Kayle,Nidalee,367,221,146,60.22
Kayle,Gwen,743,402,341,54.1
Kayle,Syndra,867,464,403,53.52
Kayle,Zilean,466,215,251,46.14
Kayle,Lissandra,462,249,213,53.9
Kayle,Kindred,733,449,284,61.26
Kayle,Zac,581,310,271,53.36
Kayle,Karthus,400,225,175,56.25
Kayle,Varus,1217,659,558,54.15
Kayle,Trundle,721,362,359,50.21
Kayle,Maokai,700,338,362,48.29
Kayle,Taric,359,176,183,49.03
Kayle,RekSai,172,95,77,55.23
Kayle,Azir,465,240,225,51.61
Kayle,Bard,425,209,216,49.18
Kayle,Zoe,511,276,235,54.01
Kayle,Orianna,528,236,292,44.7
Kayle,Rengar,500,264,236,52.8
Renata,Illaoi,199,95,104,47.74
Renata,Twitch,377,219,158,58.09
Renata,Yone,737,389,348,52.78
Renata,Lux,950,482,468,50.74
Renata,Velkoz,210,77,133,36.67
Renata,Malphite,410,186,224,45.37
Renata,Diana,637,298,339,46.78
Renata,Akali,469,235,234,50.11
Renata,Jinx,1119,561,558,50.13
Renata,Warwick,598,296,302,49.5
Renata,Vex,184,80,104,43.48
Renata,Yuumi,299,133,166,44.48
Renata,Camille,194,67,127,34.54
Renata,Azir,189,87,102,46.03
Renata,Kaisa,719,357,362,49.65
Renata,Braum,239,123,116,51.46
Renata,Naafiri,147,85,62,57.82
Renata,Zac,208,121,87,58.17
Renata,Ahri,574,257,317,44.77
Renata,Nilah,226,107,119,47.35
Renata,Zyra,311,153,158,49.2
Renata,Darius,774,352,422,45.48
Renata,Mel,688,357,331,51.89
Renata,TwistedFate,165,90,75,54.55
Renata,Maokai,220,114,106,51.82
Renata,Shaco,362,207,155,57.18
Renata,Qiyana,97,58,39,59.79
Renata,Ziggs,135,52,83,38.52
Renata,Kayn,610,287,323,47.05
Renata,Senna,379,182,197,48.02
Renata,Ashe,836,398,438,47.61
Renata,Irelia,389,178,211,45.76
Renata,Teemo,538,304,234,56.51
Renata,MasterYi,577,254,323,44.02
Renata,Yasuo,837,400,437,47.79
Renata,Aphelios,287,134,153,46.69
Renata,Janna,140,82,58,58.57
Renata,LeeSin,552,316,236,57.25
Renata,Zed,481,255,226,53.01
Renata,KogMaw,153,50,103,32.68
Renata,Nami,488,226,262,46.31
Renata,Garen,671,332,339,49.48
Renata,Kayle,254,136,118,53.54
Renata,Kled,104,40,64,38.46
Renata,Vi,459,223,236,48.58
Renata,Aurora,345,186,159,53.91
Renata,Thresh,626,295,331,47.12
Renata,Yorick,357,173,184,48.46
Renata,Briar,321,168,153,52.34
Renata,Neeko,270,146,124,54.07
Renata,Nautilus,619,311,308,50.24
Renata,Mordekaiser,582,313,269,53.78
Renata,Ekko,309,149,160,48.22
Renata,Heimerdinger,201,108,93,53.73
Renata,Blitzcrank,246,120,126,48.78
Renata,Singed,82,45,37,54.88
Renata,Ezreal,879,452,427,51.42
Renata,Volibear,482,231,251,47.93
Renata,Khazix,202,131,71,64.85
Renata,Lucian,270,119,151,44.07
Renata,Ambessa,285,164,121,57.54
Renata,Pantheon,599,330,269,55.09
Renata,Zeri,165,88,77,53.33
Renata,Elise,265,122,143,46.04
Renata,Fizz,201,90,111,44.78
Renata,Samira,387,197,190,50.9
Renata,Rell,280,155,125,55.36
Renata,Cassiopeia,115,53,62,46.09
Renata,Riven,212,112,100,52.83
Renata,Vayne,447,236,211,52.8
Renata,JarvanIV,310,170,140,54.84
Renata,Katarina,330,166,164,50.3
Renata,Morgana,455,234,221,51.43
Renata,Milio,294,150,144,51.02
Renata,Gangplank,211,113,98,53.55
Renata,Varus,298,163,135,54.7
Renata,Lulu,614,274,340,44.63
Renata,Viego,574,255,319,44.43
Renata,Sona,153,81,72,52.94
Renata,Zilean,145,70,75,48.28
Renata,Jhin,754,391,363,51.86
Renata,Sett,509,213,296,41.85
Renata,Caitlyn,1030,484,546,46.99
Renata,Seraphine,313,170,143,54.31
Renata,Aatrox,415,215,200,51.81
Renata,Lillia,201,88,113,43.78
Renata,Taliyah,126,55,71,43.65
Renata,Poppy,336,178,158,52.98
Renata,MissFortune,899,425,474,47.27
Renata,Karthus,86,39,47,45.35
Renata,Gnar,256,129,127,50.39
Renata,Fiora,196,113,83,57.65
Renata,Olaf,95,39,56,41.05
Renata,Veigar,385,159,226,41.3
Renata,FiddleSticks,231,99,132,42.86
Renata,Xayah,229,115,114,50.22
Renata,Belveth,149,76,73,51.01
Renata,Syndra,278,131,147,47.12
Renata,Jax,410,172,238,41.95
Renata,Amumu,382,172,210,45.03
Renata,Corki,163,68,95,41.72
Renata,Alistar,237,111,126,46.84
Renata,Shen,273,126,147,46.15
Renata,Lissandra,139,48,91,34.53
Renata,RekSai,61,31,30,50.82
Renata,Evelynn,160,76,84,47.5
Renata,Soraka,210,95,115,45.24
Renata,Trundle,200,96,104,48
Renata,Graves,279,139,140,49.82
Renata,Malzahar,427,182,245,42.62
Renata,Viktor,391,182,209,46.55
Renata,Smolder,359,208,151,57.94
Renata,Galio,375,196,179,52.27
Renata,Vladimir,263,129,134,49.05
Renata,Pyke,321,157,164,48.91
Renata,Gwen,228,115,113,50.44
Renata,Nocturne,500,248,252,49.6
Renata,Kennen,146,93,53,63.7
Renata,Gragas,230,109,121,47.39
Renata,Rakan,202,140,62,69.31
Renata,Chogath,465,232,233,49.89
Renata,Rumble,97,47,50,48.45
Renata,Hwei,254,130,124,51.18
Renata,Ivern,89,41,48,46.07
Renata,TahmKench,362,173,189,47.79
Renata,Urgot,221,103,118,46.61
Renata,Tryndamere,236,121,115,51.27
Renata,Karma,512,246,266,48.05
Renata,Orianna,200,109,91,54.5
Renata,MonkeyKing,282,127,155,45.04
Renata,Sylas,489,237,252,48.47
Renata,Renekton,210,95,115,45.24
Renata,Kindred,224,79,145,35.27
Renata,Draven,239,113,126,47.28
Renata,AurelionSol,161,77,84,47.83
Renata,Rengar,204,116,88,56.86
Renata,KSante,192,92,100,47.92
Renata,Talon,230,142,88,61.74
Renata,Brand,234,111,123,47.44
Renata,Anivia,130,63,67,48.46
Renata,Hecarim,124,68,56,54.84
Renata,Sejuani,203,108,95,53.2
Renata,Ornn,194,82,112,42.27
Renata,Ryze,151,83,68,54.97
Renata,Jayce,189,91,98,48.15
Renata,Sivir,263,119,144,45.25
Renata,Swain,424,200,224,47.17
Renata,Tristana,423,210,213,49.65
Renata,Kalista,167,114,53,68.26
Renata,Udyr,112,61,51,54.46
Renata,Zoe,189,89,100,47.09
Renata,Nasus,301,163,138,54.15
Renata,DrMundo,201,89,112,44.28
Renata,Annie,124,37,87,29.84
Renata,Bard,137,59,78,43.07
Renata,Leona,318,184,134,57.86
Renata,Rammus,115,70,45,60.87
Renata,Akshan,200,115,85,57.5
Renata,Quinn,105,54,51,51.43
Renata,Sion,285,118,167,41.4
Renata,Nidalee,104,56,48,53.85
Renata,Leblanc,205,88,117,42.93
Renata,Xerath,320,142,178,44.38
Renata,Skarner,140,76,64,54.29
Renata,Taric,97,52,45,53.61
Renata,Shyvana,86,53,33,61.63
Renata,Kassadin,75,22,53,29.33
Renata,XinZhao,229,92,137,40.17
Renata,Nunu,216,79,137,36.57
Ambessa,Talon,785,399,386,50.83
Ambessa,Aurora,1088,558,530,51.29
Ambessa,Yasuo,2687,1308,1379,48.68
Ambessa,Tristana,1095,588,507,53.7
Ambessa,Alistar,570,317,253,55.61
Ambessa,Poppy,957,445,512,46.5
Ambessa,Diana,2111,1042,1069,49.36
Ambessa,Anivia,457,251,206,54.92
Ambessa,Caitlyn,3324,1571,1753,47.26
Ambessa,Thresh,1944,952,992,48.97
Ambessa,KSante,1026,518,508,50.49
Ambessa,Darius,2285,1029,1256,45.03
Ambessa,Azir,564,279,285,49.47
Ambessa,Aphelios,752,342,410,45.48
Ambessa,Soraka,759,396,363,52.17
Ambessa,Akali,1418,683,735,48.17
Ambessa,Viego,2065,1015,1050,49.15
Ambessa,Leblanc,887,440,447,49.61
Ambessa,Sett,2141,985,1156,46.01
Ambessa,Rammus,369,188,181,50.95
Ambessa,Pyke,1078,571,507,52.97
Ambessa,Yorick,1037,444,593,42.82
Ambessa,Shaco,1113,557,556,50.04
Ambessa,Katarina,1049,520,529,49.57
Ambessa,Lucian,968,518,450,53.51
Ambessa,Nautilus,1504,708,796,47.07
Ambessa,Karthus,423,220,203,52.01
Ambessa,Zed,1556,747,809,48.01
Ambessa,Ashe,2728,1361,1367,49.89
Ambessa,Maokai,658,299,359,45.44
Ambessa,Garen,1956,851,1105,43.51
Ambessa,Shen,965,379,586,39.27
Ambessa,Khazix,653,314,339,48.09
Ambessa,Ahri,1715,813,902,47.41
Ambessa,Samira,950,428,522,45.05
Ambessa,Ornn,643,324,319,50.39
Ambessa,Briar,921,432,489,46.91
Ambessa,Morgana,1256,614,642,48.89
Ambessa,Volibear,1333,615,718,46.14
Ambessa,Gwen,676,346,330,51.18
Ambessa,Elise,1034,476,558,46.03
Ambessa,Smolder,909,466,443,51.27
Ambessa,Rengar,442,224,218,50.68
Ambessa,Hwei,861,432,429,50.17
Ambessa,XinZhao,983,411,572,41.81
Ambessa,Ezreal,3590,1797,1793,50.06
Ambessa,Leona,1118,566,552,50.63
Ambessa,Trundle,644,297,347,46.12
Ambessa,MasterYi,1392,624,768,44.83
Ambessa,Varus,1345,694,651,51.6
Ambessa,Lux,3189,1475,1714,46.25
Ambessa,Aatrox,1356,768,588,56.64
Ambessa,Chogath,1388,648,740,46.69
Ambessa,Ryze,525,225,300,42.86
Ambessa,Janna,499,229,270,45.89
Ambessa,Nasus,808,390,418,48.27
Ambessa,Kayn,1821,816,1005,44.81
Ambessa,MissFortune,2541,1230,1311,48.41
Ambessa,Sona,397,191,206,48.11
Ambessa,Nocturne,1670,692,978,41.44
Ambessa,Neeko,671,296,375,44.11
Ambessa,LeeSin,2370,1199,1171,50.59
Ambessa,Zeri,690,331,359,47.97
Ambessa,Pantheon,2232,1096,1136,49.1
Ambessa,Sejuani,581,244,337,42
Ambessa,Ivern,280,157,123,56.07
Ambessa,Urgot,556,257,299,46.22
Ambessa,Jhin,2547,1254,1293,49.23
Ambessa,Karma,1687,821,866,48.67
Ambessa,Taric,278,139,139,50
Ambessa,Kled,233,111,122,47.64
Ambessa,Warwick,1768,819,949,46.32
Ambessa,Seraphine,945,495,450,52.38
Ambessa,Teemo,1361,624,737,45.85
Ambessa,Mel,2748,1372,1376,49.93
Ambessa,Viktor,1296,667,629,51.47
Ambessa,Twitch,979,445,534,45.45
Ambessa,Lulu,1949,913,1036,46.84
Ambessa,Renekton,1090,491,599,45.05
Ambessa,Udyr,547,315,232,57.59
Ambessa,Annie,429,221,208,51.52
Ambessa,Amumu,1177,561,616,47.66
Ambessa,Braum,794,390,404,49.12
Ambessa,Shyvana,333,159,174,47.75
Ambessa,TahmKench,1066,555,511,52.06
Ambessa,Veigar,1161,573,588,49.35
Ambessa,Zilean,384,171,213,44.53
Ambessa,Vi,1382,665,717,48.12
Ambessa,Zoe,558,319,239,57.17
Ambessa,Kaisa,2296,1095,1201,47.69
Ambessa,Jax,1300,685,615,52.69
Ambessa,Evelynn,501,256,245,51.1
Ambessa,Draven,682,273,409,40.03
Ambessa,Jinx,3372,1566,1806,46.44
Ambessa,Xayah,725,338,387,46.62
Ambessa,Renata,285,121,164,42.46
Ambessa,Quinn,467,208,259,44.54
Ambessa,Irelia,1178,533,645,45.25
Ambessa,Lillia,790,382,408,48.35
Ambessa,Nilah,513,197,316,38.4
Ambessa,Hecarim,564,293,271,51.95
Ambessa,Rell,654,288,366,44.04
Ambessa,Fiora,533,253,280,47.47
Ambessa,Naafiri,454,232,222,51.1
Ambessa,Orianna,742,362,380,48.79
Ambessa,Illaoi,574,232,342,40.42
Ambessa,Heimerdinger,475,214,261,45.05
Ambessa,Brand,828,395,433,47.71
Ambessa,Cassiopeia,358,178,180,49.72
Ambessa,Riven,725,316,409,43.59
Ambessa,Gnar,598,339,259,56.69
Ambessa,DrMundo,610,313,297,51.31
Ambessa,Mordekaiser,1548,730,818,47.16
Ambessa,Gragas,894,453,441,50.67
Ambessa,Galio,1267,547,720,43.17
Ambessa,Tryndamere,799,401,398,50.19
Ambessa,Sion,972,493,479,50.72
Ambessa,Senna,953,440,513,46.17
Ambessa,Syndra,831,400,431,48.13
Ambessa,Zyra,1202,526,676,43.76
Ambessa,Vladimir,752,369,383,49.07
Ambessa,Singed,370,179,191,48.38
Ambessa,Ziggs,478,219,259,45.82
Ambessa,Nami,1289,585,704,45.38
Ambessa,Malzahar,1149,556,593,48.39
Ambessa,Kalista,434,197,237,45.39
Ambessa,Qiyana,392,245,147,62.5
Ambessa,Yone,2506,1314,1192,52.43
Ambessa,TwistedFate,461,203,258,44.03
Ambessa,Rakan,620,229,391,36.94
Ambessa,Sylas,1802,912,890,50.61
Ambessa,Swain,1283,561,722,43.73
Ambessa,Bard,451,243,208,53.88
Ambessa,KogMaw,474,230,244,48.52
Ambessa,Vayne,1621,694,927,42.81
Ambessa,FiddleSticks,681,333,348,48.9
Ambessa,Blitzcrank,1120,513,607,45.8
Ambessa,Milio,769,339,430,44.08
Ambessa,JarvanIV,805,391,414,48.57
Ambessa,Kassadin,280,138,142,49.29
Ambessa,Fizz,573,236,337,41.19
Ambessa,Velkoz,787,338,449,42.95
Ambessa,Kayle,747,343,404,45.92
Ambessa,Camille,773,359,414,46.44
Ambessa,Yuumi,1158,605,553,52.25
Ambessa,AurelionSol,541,260,281,48.06
Ambessa,Jayce,884,465,419,52.6
Ambessa,Kennen,391,145,246,37.08
Ambessa,Sivir,755,370,385,49.01
Ambessa,Nunu,742,382,360,51.48
Ambessa,Belveth,387,175,212,45.22
Ambessa,Ekko,1213,589,624,48.56
Ambessa,MonkeyKing,878,391,487,44.53
Ambessa,Malphite,1189,477,712,40.12
Ambessa,Zac,687,312,375,45.41
Ambessa,Akshan,511,259,252,50.68
Ambessa,Taliyah,402,177,225,44.03
Ambessa,Graves,903,465,438,51.5
Ambessa,Xerath,1150,481,669,41.83
Ambessa,Nidalee,483,256,227,53
Ambessa,Skarner,430,252,178,58.6
Ambessa,Vex,727,332,395,45.67
Ambessa,Kindred,534,302,232,56.55
Ambessa,Gangplank,681,302,379,44.35
Ambessa,Lissandra,398,185,213,46.48
Ambessa,Corki,567,313,254,55.2
Ambessa,Rumble,350,197,153,56.29
Ambessa,Olaf,313,158,155,50.48
Ambessa,RekSai,184,72,112,39.13
Rammus,Talon,374,221,153,59.09
Rammus,Aurora,394,184,210,46.7
Rammus,Yasuo,1710,950,760,55.56
Rammus,Tristana,727,387,340,53.23
Rammus,Alistar,266,130,136,48.87
Rammus,Malphite,671,345,326,51.42
Rammus,Jax,618,373,245,60.36
Rammus,Neeko,325,177,148,54.46
Rammus,Xayah,374,203,171,54.28
Rammus,Rakan,326,153,173,46.93
Rammus,Volibear,691,336,355,48.63
Rammus,Ekko,557,250,307,44.88
Rammus,Akshan,235,122,113,51.91
Rammus,Katarina,532,316,216,59.4
Rammus,Yone,1569,900,669,57.36
Rammus,Gragas,336,180,156,53.57
Rammus,Irelia,698,386,312,55.3
Rammus,TahmKench,479,219,260,45.72
Rammus,Rell,300,154,146,51.33
Rammus,Mordekaiser,879,379,500,43.12
Rammus,Kayn,985,473,512,48.02
Rammus,Diana,898,407,491,45.32
Rammus,Ezreal,1296,676,620,52.16
Rammus,Thresh,889,454,435,51.07
Rammus,Chogath,748,318,430,42.51
Rammus,Ivern,104,61,43,58.65
Rammus,Lux,1588,776,812,48.87
Rammus,Ambessa,369,181,188,49.05
Rammus,XinZhao,403,215,188,53.35
Rammus,Nilah,228,132,96,57.89
Rammus,Soraka,439,206,233,46.92
Rammus,Teemo,763,403,360,52.82
Rammus,Evelynn,181,72,109,39.78
Rammus,Sylas,790,405,385,51.27
Rammus,Seraphine,533,249,284,46.72
Rammus,Malzahar,676,308,368,45.56
Rammus,Jinx,1766,824,942,46.66
Rammus,Shen,415,191,224,46.02
Rammus,Khazix,326,188,138,57.67
Rammus,Ahri,857,451,406,52.63
Rammus,Samira,537,299,238,55.68
Rammus,Maokai,281,118,163,41.99
Rammus,DrMundo,325,150,175,46.15
Rammus,Shaco,437,199,238,45.54
Rammus,Viktor,526,264,262,50.19
Rammus,Jhin,1259,619,640,49.17
Rammus,Poppy,418,204,214,48.8
Rammus,Garen,1046,529,517,50.57
Rammus,Sett,957,480,477,50.16
Rammus,Lucian,424,242,182,57.08
Rammus,Sona,173,98,75,56.65
Rammus,Yorick,636,346,290,54.4
Rammus,Akali,694,353,341,50.86
Rammus,Twitch,552,258,294,46.74
Rammus,Zilean,157,67,90,42.68
Rammus,LeeSin,891,486,405,54.55
Rammus,Caitlyn,1699,914,785,53.8
Rammus,Ashe,1367,746,621,54.57
Rammus,Camille,237,124,113,52.32
Rammus,Hecarim,245,130,115,53.06
Rammus,TwistedFate,217,116,101,53.46
Rammus,Nautilus,761,416,345,54.66
Rammus,Rengar,237,151,86,63.71
Rammus,Galio,664,319,345,48.04
Rammus,Kayle,456,229,227,50.22
Rammus,Nunu,309,118,191,38.19
Rammus,Kaisa,1032,552,480,53.49
Rammus,Nami,581,291,290,50.09
Rammus,Smolder,433,230,203,53.12
Rammus,MonkeyKing,364,185,179,50.82
Rammus,Sejuani,293,147,146,50.17
Rammus,Kalista,217,121,96,55.76
Rammus,Yuumi,627,352,275,56.14
Rammus,Amumu,658,280,378,42.55
Rammus,MissFortune,1445,712,733,49.27
Rammus,Renekton,319,184,135,57.68
Rammus,Leblanc,317,155,162,48.9
Rammus,Corki,233,124,109,53.22
Rammus,Morgana,826,407,419,49.27
Rammus,Illaoi,337,146,191,43.32
Rammus,Vi,563,310,253,55.06
Rammus,Syndra,381,201,180,52.76
Rammus,Lulu,807,413,394,51.18
Rammus,Darius,1285,606,679,47.16
Rammus,Quinn,250,140,110,56
Rammus,Orianna,292,131,161,44.86
Rammus,Pantheon,1139,590,549,51.8
Rammus,Tryndamere,433,214,219,49.42
Rammus,FiddleSticks,303,124,179,40.92
Rammus,Vayne,989,472,517,47.72
Rammus,Kindred,294,145,149,49.32
Rammus,Riven,381,228,153,59.84
Rammus,Karma,577,293,284,50.78
Rammus,Velkoz,369,153,216,41.46
Rammus,Pyke,732,414,318,56.56
Rammus,Gwen,399,174,225,43.61
Rammus,Brand,433,202,231,46.65
Rammus,Karthus,188,82,106,43.62
Rammus,Senna,510,293,217,57.45
Rammus,Kennen,149,80,69,53.69
Rammus,Leona,635,300,335,47.24
Rammus,Naafiri,212,129,83,60.85
Rammus,Milio,343,161,182,46.94
Rammus,Aatrox,646,350,296,54.18
Rammus,JarvanIV,321,195,126,60.75
Rammus,Cassiopeia,234,73,161,31.2
Rammus,Zyra,511,267,244,52.25
Rammus,Graves,412,238,174,57.77
Rammus,Swain,570,293,277,51.4
Rammus,Jayce,259,137,122,52.9
Rammus,Zeri,253,100,153,39.53
Rammus,Zed,813,432,381,53.14
Rammus,Gangplank,297,163,134,54.88
Rammus,Vex,371,208,163,56.06
Rammus,Singed,198,99,99,50
Rammus,Mel,1135,556,579,48.99
Rammus,Warwick,1199,589,610,49.12
Rammus,Vladimir,389,223,166,57.33
Rammus,Gnar,246,138,108,56.1
Rammus,MasterYi,2170,1209,961,55.71
Rammus,Fizz,419,239,180,57.04
Rammus,Kled,114,62,52,54.39
Rammus,Varus,578,259,319,44.81
Rammus,Lillia,476,220,256,46.22
Rammus,Qiyana,129,82,47,63.57
Rammus,Nasus,443,234,209,52.82
Rammus,Xerath,494,224,270,45.34
Rammus,Trundle,501,272,229,54.29
Rammus,Olaf,157,76,81,48.41
Rammus,Shyvana,136,60,76,44.12
Rammus,Ryze,248,129,119,52.02
Rammus,Sivir,266,137,129,51.5
Rammus,Sion,461,215,246,46.64
Rammus,Fiora,280,131,149,46.79
Rammus,Kassadin,152,81,71,53.29
Rammus,Ornn,229,103,126,44.98
Rammus,Elise,378,200,178,52.91
Rammus,Draven,397,191,206,48.11
Rammus,Zac,265,132,133,49.81
Rammus,Azir,228,145,83,63.6
Rammus,Heimerdinger,279,138,141,49.46
Rammus,AurelionSol,276,125,151,45.29
Rammus,Viego,996,522,474,52.41
Rammus,Veigar,656,326,330,49.7
Rammus,Aphelios,377,203,174,53.85
Rammus,Blitzcrank,522,275,247,52.68
Rammus,KogMaw,239,118,121,49.37
Rammus,Taliyah,141,79,62,56.03
Rammus,Urgot,421,232,189,55.11
Rammus,Ziggs,283,131,152,46.29
Rammus,Nocturne,805,356,449,44.22
Rammus,Hwei,395,180,215,45.57
Rammus,Braum,407,207,200,50.86
Rammus,Annie,160,75,85,46.88
Rammus,Lissandra,235,115,120,48.94
Rammus,Anivia,223,125,98,56.05
Rammus,RekSai,101,52,49,51.49
Rammus,Briar,729,368,361,50.48
Rammus,Rumble,175,89,86,50.86
Rammus,Taric,130,48,82,36.92
Rammus,KSante,304,165,139,54.28
Rammus,Renata,115,45,70,39.13
Rammus,Janna,232,97,135,41.81
Rammus,Nidalee,142,86,56,60.56
Rammus,Bard,155,94,61,60.65
Rammus,Udyr,179,100,79,55.87
Rammus,Belveth,191,98,93,51.31
Rammus,Skarner,103,65,38,63.11
Rammus,Zoe,243,138,105,56.79
Talon,Ambessa,785,386,399,49.17
Talon,Rammus,374,153,221,40.91
Talon,Mel,2477,1283,1194,51.8
Talon,Draven,650,346,304,53.23
Talon,Blitzcrank,914,434,480,47.48
Talon,Jax,985,504,481,51.17
Talon,Nidalee,429,254,175,59.21
Talon,Ahri,1684,780,904,46.32
Talon,Jhin,2303,1119,1184,48.59
Talon,Senna,1036,461,575,44.5
Talon,Yorick,1052,491,561,46.67
Talon,AurelionSol,429,173,256,40.33
Talon,Kayn,1747,788,959,45.11
Talon,Singed,320,130,190,40.63
Talon,Udyr,476,249,227,52.31
Talon,Pantheon,2119,1005,1114,47.43
Talon,Leblanc,784,389,395,49.62
Talon,Sivir,719,370,349,51.46
Talon,Pyke,1136,623,513,54.84
Talon,Yone,2342,1152,1190,49.19
Talon,Briar,774,320,454,41.34
Talon,Vex,664,320,344,48.19
Talon,Jinx,3188,1491,1697,46.77
Talon,Milio,746,320,426,42.9
Talon,Teemo,1489,649,840,43.59
Talon,Poppy,853,355,498,41.62
Talon,Akali,1451,658,793,45.35
Talon,Caitlyn,3080,1395,1685,45.29
Talon,Leona,959,486,473,50.68
Talon,Nocturne,1428,750,678,52.52
Talon,Lissandra,425,208,217,48.94
Talon,Lux,2802,1227,1575,43.79
Talon,Vayne,1404,624,780,44.44
Talon,Shyvana,347,135,212,38.9
Talon,Sylas,1883,879,1004,46.68
Talon,Karma,1531,823,708,53.76
Talon,Soraka,727,287,440,39.48
Talon,Nasus,709,370,339,52.19
Talon,Kindred,608,305,303,50.16
Talon,Malzahar,1216,529,687,43.5
Talon,Tristana,1112,500,612,44.96
Talon,Nautilus,1377,640,737,46.48
Talon,Fiora,541,252,289,46.58
Talon,Elise,1082,520,562,48.06
Talon,Garen,1739,751,988,43.19
Talon,Ashe,2454,1202,1252,48.98
Talon,Trundle,645,345,300,53.49
Talon,Naafiri,475,236,239,49.68
Talon,Aphelios,694,315,379,45.39
Talon,Shen,737,349,388,47.35
Talon,Amumu,1180,499,681,42.29
Talon,MissFortune,2642,1247,1395,47.2
Talon,Xerath,972,457,515,47.02
Talon,LeeSin,2114,1133,981,53.6
Talon,Kaisa,2161,1077,1084,49.84
Talon,Qiyana,357,183,174,51.26
Talon,Swain,1119,568,551,50.76
Talon,Sett,1892,794,1098,41.97
Talon,Mordekaiser,1458,615,843,42.18
Talon,Veigar,1067,479,588,44.89
Talon,Thresh,1764,768,996,43.54
Talon,Varus,1176,547,629,46.51
Talon,Zyra,1017,470,547,46.21
Talon,Galio,1055,510,545,48.34
Talon,Ezreal,3147,1582,1565,50.27
Talon,Seraphine,951,489,462,51.42
Talon,Darius,2220,1114,1106,50.18
Talon,Shaco,1289,626,663,48.56
Talon,Zed,1548,771,777,49.81
Talon,Braum,636,281,355,44.18
Talon,Volibear,1204,560,644,46.51
Talon,Nami,1219,634,585,52.01
Talon,Rengar,501,250,251,49.9
Talon,Lucian,964,530,434,54.98
Talon,Ekko,1217,653,564,53.66
Talon,Velkoz,655,278,377,42.44
Talon,Yasuo,2731,1214,1517,44.45
Talon,Diana,2034,991,1043,48.72
Talon,Sion,998,436,562,43.69
Talon,Orianna,552,257,295,46.56
Talon,Camille,601,271,330,45.09
Talon,Viktor,1145,575,570,50.22
Talon,Zeri,595,325,270,54.62
Talon,Kayle,836,365,471,43.66
Talon,Brand,778,370,408,47.56
Talon,Rakan,560,254,306,45.36
Talon,Lulu,1749,847,902,48.43
Talon,KogMaw,348,179,169,51.44
Talon,MasterYi,1312,606,706,46.19
Talon,Janna,466,206,260,44.21
Talon,Vladimir,896,387,509,43.19
Talon,Alistar,514,232,282,45.14
Talon,Gangplank,672,323,349,48.07
Talon,Nunu,792,384,408,48.48
Talon,Jayce,732,393,339,53.69
Talon,Kalista,372,174,198,46.77
Talon,Neeko,708,383,325,54.1
Talon,Chogath,1496,715,781,47.79
Talon,Quinn,450,193,257,42.89
Talon,Lillia,719,391,328,54.38
Talon,Gragas,776,353,423,45.49
Talon,Xayah,753,336,417,44.62
Talon,Vi,1270,608,662,47.87
Talon,Evelynn,527,268,259,50.85
Talon,Rell,620,268,352,43.23
Talon,Anivia,463,227,236,49.03
Talon,Urgot,555,253,302,45.59
Talon,Olaf,272,131,141,48.16
Talon,Irelia,1119,494,625,44.15
Talon,Warwick,1838,831,1007,45.21
Talon,Khazix,812,390,422,48.03
Talon,Aurora,1050,587,463,55.9
Talon,Karthus,384,175,209,45.57
Talon,Gnar,498,245,253,49.2
Talon,Morgana,1324,636,688,48.04
Talon,Syndra,690,304,386,44.06
Talon,Kled,255,123,132,48.24
Talon,DrMundo,624,247,377,39.58
Talon,Smolder,822,423,399,51.46
Talon,Illaoi,434,174,260,40.09
Talon,Viego,1822,818,1004,44.9
Talon,Fizz,665,339,326,50.98
Talon,Samira,873,406,467,46.51
Talon,Akshan,440,231,209,52.5
Talon,Taric,194,103,91,53.09
Talon,Malphite,1250,633,617,50.64
Talon,Aatrox,1204,613,591,50.91
Talon,Katarina,1036,487,549,47.01
Talon,TahmKench,988,418,570,42.31
Talon,Ziggs,494,256,238,51.82
Talon,Twitch,1020,470,550,46.08
Talon,Sona,384,163,221,42.45
Talon,Heimerdinger,543,196,347,36.1
Talon,Gwen,571,286,285,50.09
Talon,Sejuani,497,208,289,41.85
Talon,Yuumi,1168,653,515,55.91
Talon,Azir,462,266,196,57.58
Talon,Annie,454,228,226,50.22
Talon,XinZhao,885,381,504,43.05
Talon,Renekton,720,329,391,45.69
Talon,MonkeyKing,837,309,528,36.92
Talon,JarvanIV,637,329,308,51.65
Talon,Riven,601,276,325,45.92
Talon,Tryndamere,644,332,312,51.55
Talon,Hecarim,509,228,281,44.79
Talon,Hwei,835,415,420,49.7
Talon,Rumble,392,197,195,50.26
Talon,Graves,944,483,461,51.17
Talon,Cassiopeia,438,207,231,47.26
Talon,Ryze,448,205,243,45.76
Talon,Renata,230,88,142,38.26
Talon,FiddleSticks,649,289,360,44.53
Talon,Kassadin,250,129,121,51.6
Talon,RekSai,192,83,109,43.23
Talon,Zilean,410,207,203,50.49
Talon,Belveth,310,170,140,54.84
Talon,Corki,498,275,223,55.22
Talon,KSante,707,384,323,54.31
Talon,Zac,541,235,306,43.44
Talon,Taliyah,313,150,163,47.92
Talon,TwistedFate,462,225,237,48.7
Talon,Skarner,326,174,152,53.37
Talon,Kennen,388,218,170,56.19
Talon,Zoe,528,284,244,53.79
Talon,Nilah,377,188,189,49.87
Talon,Bard,380,163,217,42.89
Talon,Maokai,591,265,326,44.84
Talon,Ornn,555,244,311,43.96
Talon,Ivern,210,114,96,54.29
Alistar,Ambessa,570,253,317,44.39
Alistar,Rammus,266,136,130,51.13
Alistar,Mel,1962,980,982,49.95
Alistar,Draven,501,267,234,53.29
Alistar,Blitzcrank,913,465,448,50.93
Alistar,Jax,806,383,423,47.52
Alistar,Elise,607,330,277,54.37
Alistar,Naafiri,266,144,122,54.14
Alistar,Jhin,1505,799,706,53.09
Alistar,Lulu,1124,587,537,52.22
Alistar,Riven,412,236,176,57.28
Alistar,Ivern,158,81,77,51.27
Alistar,Yasuo,1744,841,903,48.22
Alistar,Swain,942,428,514,45.44
Alistar,Nami,742,331,411,44.61
Alistar,Fiora,314,165,149,52.55
Alistar,Kayn,1080,496,584,45.93
Alistar,Malzahar,823,355,468,43.13
Alistar,Aphelios,403,206,197,51.12
Alistar,Zilean,294,121,173,41.16
Alistar,Sion,699,347,352,49.64
Alistar,Rengar,342,197,145,57.6
Alistar,Ahri,1099,568,531,51.68
Alistar,Anivia,298,136,162,45.64
Alistar,Poppy,675,360,315,53.33
Alistar,Kennen,303,166,137,54.79
Alistar,Skarner,291,147,144,50.52
Alistar,Jinx,2298,1033,1265,44.95
Alistar,Yuumi,645,317,328,49.15
Alistar,Warwick,1169,614,555,52.52
Alistar,Malphite,860,446,414,51.86
Alistar,Lux,1845,898,947,48.67
Alistar,Kled,137,81,56,59.12
Alistar,Gragas,583,288,295,49.4
Alistar,Rell,679,337,342,49.63
Alistar,Sett,1345,666,679,49.52
Alistar,Sejuani,457,230,227,50.33
Alistar,Yone,1632,858,774,52.57
Alistar,Ashe,1674,851,823,50.84
Alistar,Urgot,440,194,246,44.09
Alistar,Ekko,881,461,420,52.33
Alistar,Xerath,661,307,354,46.44
Alistar,Kalista,289,152,137,52.6
Alistar,Pantheon,1451,712,739,49.07
Alistar,Orianna,428,231,197,53.97
Alistar,Nautilus,1425,711,714,49.89
Alistar,KSante,488,261,227,53.48
Alistar,Belveth,168,100,68,59.52
Alistar,MasterYi,975,495,480,50.77
Alistar,Kaisa,1520,798,722,52.5
Alistar,Gwen,410,204,206,49.76
Alistar,Illaoi,429,174,255,40.56
Alistar,Vi,897,448,449,49.94
Alistar,Syndra,563,270,293,47.96
Alistar,Camille,343,169,174,49.27
Alistar,Varus,713,395,318,55.4
Alistar,Braum,540,276,264,51.11
Alistar,Talon,514,282,232,54.86
Alistar,Thresh,1611,795,816,49.35
Alistar,MonkeyKing,653,284,369,43.49
Alistar,Akshan,247,139,108,56.28
Alistar,Caitlyn,2147,1031,1116,48.02
Alistar,Soraka,442,229,213,51.81
Alistar,Katarina,645,314,331,48.68
Alistar,Samira,805,450,355,55.9
Alistar,Ezreal,2105,1000,1105,47.51
Alistar,Zac,513,266,247,51.85
Alistar,Zed,985,549,436,55.74
Alistar,Bard,244,139,105,56.97
Alistar,Volibear,865,447,418,51.68
Alistar,Smolder,613,294,319,47.96
Alistar,Teemo,1035,440,595,42.51
Alistar,AurelionSol,340,146,194,42.94
Alistar,Lissandra,342,167,175,48.83
Alistar,Senna,560,297,263,53.04
Alistar,Vladimir,572,300,272,52.45
Alistar,Hecarim,343,193,150,56.27
Alistar,Akali,883,520,363,58.89
Alistar,TwistedFate,325,181,144,55.69
Alistar,Aurora,633,298,335,47.08
Alistar,Kindred,384,227,157,59.11
Alistar,Viktor,836,393,443,47.01
Alistar,Vayne,1278,654,624,51.17
Alistar,Gangplank,506,222,284,43.87
Alistar,Brand,524,247,277,47.14
Alistar,Trundle,469,250,219,53.3
Alistar,Darius,1591,759,832,47.71
Alistar,Graves,645,337,308,52.25
Alistar,Neeko,411,231,180,56.2
Alistar,Gnar,450,253,197,56.22
Alistar,Karma,885,401,484,45.31
Alistar,Mordekaiser,1160,507,653,43.71
Alistar,Nunu,405,184,221,45.43
Alistar,Shen,542,267,275,49.26
Alistar,Tristana,830,394,436,47.47
Alistar,Velkoz,422,225,197,53.32
Alistar,LeeSin,1409,706,703,50.11
Alistar,Milio,490,239,251,48.78
Alistar,Diana,1442,672,770,46.6
Alistar,Irelia,768,410,358,53.39
Alistar,Lillia,484,235,249,48.55
Alistar,Sona,228,86,142,37.72
Alistar,Leona,921,469,452,50.92
Alistar,Yorick,734,316,418,43.05
Alistar,Veigar,790,435,355,55.06
Alistar,MissFortune,1721,812,909,47.18
Alistar,Renekton,454,200,254,44.05
Alistar,Twitch,567,272,295,47.97
Alistar,Jayce,455,208,247,45.71
Alistar,Singed,274,127,147,46.35
Alistar,TahmKench,783,404,379,51.6
Alistar,Shaco,798,423,375,53.01
Alistar,Sylas,1672,784,888,46.89
Alistar,Chogath,1069,492,577,46.02
Alistar,Taliyah,244,116,128,47.54
Alistar,Xayah,554,287,267,51.81
Alistar,Aatrox,905,482,423,53.26
Alistar,Galio,761,352,409,46.25
Alistar,Evelynn,305,156,149,51.15
Alistar,FiddleSticks,403,182,221,45.16
Alistar,Fizz,450,232,218,51.56
Alistar,Lucian,628,326,302,51.91
Alistar,Morgana,793,343,450,43.25
Alistar,Renata,237,126,111,53.16
Alistar,XinZhao,591,317,274,53.64
Alistar,Rumble,284,172,112,60.56
Alistar,Azir,368,192,176,52.17
Alistar,Nocturne,1015,424,591,41.77
Alistar,Leblanc,619,302,317,48.79
Alistar,Sivir,559,244,315,43.65
Alistar,Rakan,400,211,189,52.75
Alistar,Tryndamere,383,180,203,47
Alistar,KogMaw,277,126,151,45.49
Alistar,Kayle,481,230,251,47.82
Alistar,Vex,432,201,231,46.53
Alistar,Briar,613,266,347,43.39
Alistar,Ziggs,299,135,164,45.15
Alistar,Seraphine,521,272,249,52.21
Alistar,Khazix,420,221,199,52.62
Alistar,Hwei,542,256,286,47.23
Alistar,Pyke,793,386,407,48.68
Alistar,Zeri,465,240,225,51.61
Alistar,Zyra,640,307,333,47.97
Alistar,Annie,322,130,192,40.37
Alistar,Kassadin,172,98,74,56.98
Alistar,Nasus,551,241,310,43.74
Alistar,Garen,1434,678,756,47.28
Alistar,Karthus,253,108,145,42.69
Alistar,Corki,417,234,183,56.12
Alistar,Nilah,369,192,177,52.03
Alistar,DrMundo,442,230,212,52.04
Alistar,Amumu,843,405,438,48.04
Alistar,Taric,211,94,117,44.55
Alistar,Ornn,387,193,194,49.87
Alistar,Cassiopeia,274,116,158,42.34
Alistar,JarvanIV,579,242,337,41.8
Alistar,Viego,1392,727,665,52.23
Alistar,Zoe,313,156,157,49.84
Alistar,Maokai,446,219,227,49.1
Alistar,Ryze,289,138,151,47.75
Alistar,Shyvana,264,108,156,40.91
Alistar,Heimerdinger,376,156,220,41.49
Alistar,Qiyana,269,117,152,43.49
Alistar,Olaf,229,99,130,43.23
Alistar,Udyr,366,205,161,56.01
Alistar,RekSai,123,70,53,56.91
Alistar,Janna,320,168,152,52.5
Alistar,Quinn,300,166,134,55.33
Alistar,Nidalee,224,122,102,54.46
Garen,Pantheon,5390,2672,2718,49.57
Garen,Diana,5151,2561,2590,49.72
Garen,Gangplank,1596,891,705,55.83
Garen,Ezreal,7552,3996,3556,52.91
Garen,Yuumi,2843,1528,1315,53.75
Garen,Mordekaiser,4965,2225,2740,44.81
Garen,Briar,2429,1221,1208,50.27
Garen,Ryze,1130,522,608,46.19
Garen,Vex,1762,951,811,53.97
Garen,Teemo,4402,2026,2376,46.02
Garen,XinZhao,2220,1229,991,55.36
Garen,Yasuo,7205,3722,3483,51.66
Garen,Jinx,8668,4262,4406,49.17
Garen,Neeko,1786,968,818,54.2
Garen,Vladimir,1792,897,895,50.06
Garen,Evelynn,1228,654,574,53.26
Garen,Tristana,3157,1609,1548,50.97
Garen,Chogath,4387,2065,2322,47.07
Garen,Morgana,3844,1964,1880,51.09
Garen,Jhin,6432,3353,3079,52.13
Garen,Mel,6854,3604,3250,52.58
Garen,Heimerdinger,1543,775,768,50.23
Garen,LeeSin,4450,2388,2062,53.66
Garen,Veigar,3563,1794,1769,50.35
Garen,Irelia,2754,1474,1280,53.52
Garen,Lillia,2109,1073,1036,50.88
Garen,Sylas,4534,2354,2180,51.92
Garen,Caitlyn,8738,4432,4306,50.72
Garen,Lux,8309,4192,4117,50.45
Garen,Aatrox,3271,1717,1554,52.49
Garen,Khazix,1789,998,791,55.79
Garen,Qiyana,821,440,381,53.59
Garen,MissFortune,7578,3851,3727,50.82
Garen,Nautilus,3844,1926,1918,50.1
Garen,Sion,2476,1314,1162,53.07
Garen,Warwick,4954,2450,2504,49.45
Garen,Akshan,1107,571,536,51.58
Garen,Bard,1002,542,460,54.09
Garen,Ivern,632,323,309,51.11
Garen,Vayne,4591,2203,2388,47.99
Garen,Shyvana,996,492,504,49.4
Garen,Karma,3661,1858,1803,50.75
Garen,Soraka,1774,921,853,51.92
Garen,Sett,5553,2758,2795,49.67
Garen,Talon,1739,988,751,56.81
Garen,Lissandra,1007,445,562,44.19
Garen,Milio,1904,962,942,50.53
Garen,Aphelios,1960,890,1070,45.41
Garen,Leona,2832,1426,1406,50.35
Garen,Riven,1669,960,709,57.52
Garen,Ambessa,1956,1105,851,56.49
Garen,TwistedFate,1248,694,554,55.61
Garen,Nami,3318,1759,1559,53.01
Garen,Yone,6144,3224,2920,52.47
Garen,Trundle,2083,1119,964,53.72
Garen,Naafiri,1221,644,577,52.74
Garen,Shen,2338,1194,1144,51.07
Garen,Aurora,2485,1339,1146,53.88
Garen,Fizz,2035,1058,977,51.99
Garen,Swain,3551,1731,1820,48.75
Garen,Jax,3867,2183,1684,56.45
Garen,Tryndamere,2355,1135,1220,48.2
Garen,Corki,1437,828,609,57.62
Garen,Pyke,2864,1623,1241,56.67
Garen,Rammus,1046,515,531,49.24
Garen,DrMundo,2009,1066,943,53.06
Garen,TahmKench,2984,1561,1423,52.31
Garen,Camille,1827,868,959,47.51
Garen,Hecarim,1309,710,599,54.24
Garen,Kayn,4756,2425,2331,50.99
Garen,Nocturne,4095,2017,2078,49.26
Garen,Ashe,6490,3449,3041,53.14
Garen,Ornn,1477,700,777,47.39
Garen,Vi,3246,1731,1515,53.33
Garen,Anivia,1090,560,530,51.38
Garen,Kindred,1688,890,798,52.73
Garen,Varus,2939,1608,1331,54.71
Garen,Maokai,1468,657,811,44.75
Garen,Katarina,2610,1402,1208,53.72
Garen,Fiora,1246,693,553,55.62
Garen,Amumu,3492,1692,1800,48.45
Garen,Samira,2395,1297,1098,54.15
Garen,Seraphine,2761,1414,1347,51.21
Garen,Thresh,4607,2464,2143,53.48
Garen,Viego,4307,2236,2071,51.92
Garen,Ekko,2930,1469,1461,50.14
Garen,Senna,2458,1231,1227,50.08
Garen,Kalista,1162,628,534,54.04
Garen,Zed,3745,2048,1697,54.69
Garen,Draven,1610,851,759,52.86
Garen,Volibear,3863,1968,1895,50.94
Garen,Cassiopeia,1012,552,460,54.55
Garen,JarvanIV,2006,1037,969,51.69
Garen,Twitch,2561,1259,1302,49.16
Garen,KSante,1995,1167,828,58.5
Garen,Nunu,2111,1078,1033,51.07
Garen,Nasus,2787,1509,1278,54.14
Garen,MasterYi,3960,1884,2076,47.58
Garen,Rell,1584,780,804,49.24
Garen,Renekton,1766,966,800,54.7
Garen,Azir,1128,583,545,51.68
Garen,Xayah,1905,1000,905,52.49
Garen,Akali,3613,1896,1717,52.48
Garen,FiddleSticks,1640,863,777,52.62
Garen,Zac,1536,773,763,50.33
Garen,Darius,7493,3764,3729,50.23
Garen,Velkoz,1959,972,987,49.62
Garen,Rakan,1660,878,782,52.89
Garen,Shaco,2970,1529,1441,51.48
Garen,Gwen,1888,1076,812,56.99
Garen,Rengar,1158,608,550,52.5
Garen,Malphite,3110,1636,1474,52.6
Garen,Annie,1026,542,484,52.83
Garen,Jayce,1354,814,540,60.12
Garen,MonkeyKing,2267,1157,1110,51.04
Garen,Lucian,2224,1242,982,55.85
Garen,Elise,2256,1292,964,57.27
Garen,Xerath,2619,1329,1290,50.74
Garen,Sejuani,1318,674,644,51.14
Garen,Leblanc,1827,948,879,51.89
Garen,Lulu,3923,1996,1927,50.88
Garen,AurelionSol,1325,714,611,53.89
Garen,Nilah,1324,630,694,47.58
Garen,Kassadin,629,309,320,49.13
Garen,Graves,2143,1189,954,55.48
Garen,Illaoi,1698,924,774,54.42
Garen,Kaisa,5150,2799,2351,54.35
Garen,Renata,671,339,332,50.52
Garen,Brand,2474,1364,1110,55.13
Garen,Belveth,794,414,380,52.14
Garen,Nidalee,883,532,351,60.25
Garen,Taric,726,348,378,47.93
Garen,Kayle,2689,1207,1482,44.89
Garen,Malzahar,3328,1641,1687,49.31
Garen,Zoe,1171,657,514,56.11
Garen,Gnar,1343,661,682,49.22
Garen,Smolder,2158,1116,1042,51.71
Garen,Kled,598,252,346,42.14
Garen,Syndra,2037,1101,936,54.05
Garen,KogMaw,1107,527,580,47.61
Garen,Galio,3036,1484,1552,48.88
Garen,Zyra,2744,1368,1376,49.85
Garen,Skarner,873,489,384,56.01
Garen,Ziggs,1301,709,592,54.5
Garen,Poppy,1846,880,966,47.67
Garen,Blitzcrank,2437,1306,1131,53.59
Garen,Singed,944,497,447,52.65
Garen,Gragas,1821,1017,804,55.85
Garen,Hwei,2134,1051,1083,49.25
Garen,Ahri,4327,2119,2208,48.97
Garen,Sivir,1803,841,962,46.64
Garen,Karthus,989,535,454,54.1
Garen,Braum,1958,1006,952,51.38
Garen,Udyr,1341,696,645,51.9
Garen,Kennen,834,489,345,58.63
Garen,Zeri,1421,793,628,55.81
Garen,Urgot,1779,947,832,53.23
Garen,Janna,1083,561,522,51.8
Garen,Quinn,1315,656,659,49.89
Garen,Yorick,3050,1413,1637,46.33
Garen,Olaf,824,474,350,57.52
Garen,Viktor,2738,1409,1329,51.46
Garen,Orianna,1497,804,693,53.71
Garen,Taliyah,851,474,377,55.7
Garen,RekSai,324,190,134,58.64
Garen,Alistar,1434,756,678,52.72
Garen,Zilean,1070,514,556,48.04
Garen,Sona,1027,510,517,49.66
Garen,Rumble,735,366,369,49.8
Ryze,Aatrox,761,310,451,40.74
Ryze,Brand,410,211,199,51.46
Ryze,Irelia,674,317,357,47.03
Ryze,Caitlyn,1859,946,913,50.89
Ryze,Milio,351,193,158,54.99
Ryze,Garen,1130,608,522,53.81
Ryze,Diana,1083,541,542,49.95
Ryze,Yasuo,1406,690,716,49.08
Ryze,Pyke,640,336,304,52.5
Ryze,Sylas,1160,639,521,55.09
Ryze,Zed,764,403,361,52.75
Ryze,MasterYi,686,327,359,47.67
Ryze,Rell,402,193,209,48.01
Ryze,Sett,988,477,511,48.28
Ryze,Vladimir,592,280,312,47.3
Ryze,Kindred,303,172,131,56.77
Ryze,Aphelios,350,169,181,48.29
Ryze,Jax,535,247,288,46.17
Ryze,Elise,547,299,248,54.66
Ryze,Naafiri,259,138,121,53.28
Ryze,Jhin,1322,653,669,49.39
Ryze,Lulu,1051,528,523,50.24
Ryze,Camille,286,133,153,46.5
Ryze,LeeSin,1288,645,643,50.08
Ryze,Pantheon,1120,565,555,50.45
Ryze,Samira,601,298,303,49.58
Ryze,Ekko,668,340,328,50.9
Ryze,Tristana,684,364,320,53.22
Ryze,Kayn,903,498,405,55.15
Ryze,Lux,1600,741,859,46.31
Ryze,Jinx,1789,879,910,49.13
Ryze,Karma,1001,509,492,50.85
Ryze,Chogath,885,430,455,48.59
Ryze,Hwei,470,230,240,48.94
Ryze,Draven,382,201,181,52.62
Ryze,Warwick,1110,591,519,53.24
Ryze,Veigar,718,383,335,53.34
Ryze,Ezreal,1855,1047,808,56.44
Ryze,Ambessa,525,300,225,57.14
Ryze,Shen,500,260,240,52
Ryze,Kaisa,1295,738,557,56.99
Ryze,KSante,435,233,202,53.56
Ryze,Nunu,392,220,172,56.12
Ryze,Yone,1299,716,583,55.12
Ryze,Thresh,1142,629,513,55.08
Ryze,Mordekaiser,858,368,490,42.89
Ryze,Teemo,1030,506,524,49.13
Ryze,AurelionSol,302,144,158,47.68
Ryze,Xayah,338,175,163,51.78
Ryze,Rakan,339,174,165,51.33
Ryze,Kennen,215,96,119,44.65
Ryze,Shaco,642,357,285,55.61
Ryze,Twitch,597,322,275,53.94
Ryze,Yuumi,607,347,260,57.17
Ryze,Illaoi,316,184,132,58.23
Ryze,MonkeyKing,487,257,230,52.77
Ryze,Vex,345,170,175,49.28
Ryze,Mel,1508,747,761,49.54
Ryze,Darius,1442,681,761,47.23
Ryze,FiddleSticks,349,173,176,49.57
Ryze,Azir,338,161,177,47.63
Ryze,Volibear,726,345,381,47.52
Ryze,Trundle,359,194,165,54.04
Ryze,TahmKench,564,275,289,48.76
Ryze,Amumu,693,344,349,49.64
Ryze,Ziggs,259,142,117,54.83
Ryze,Malphite,659,345,314,52.35
Ryze,Katarina,522,285,237,54.6
Ryze,Nilah,232,128,104,55.17
Ryze,Seraphine,535,233,302,43.55
Ryze,Karthus,198,103,95,52.02
Ryze,Taliyah,207,117,90,56.52
Ryze,Morgana,811,440,371,54.25
Ryze,Ahri,1055,555,500,52.61
Ryze,Nautilus,858,464,394,54.08
Ryze,Cassiopeia,299,159,140,53.18
Ryze,MissFortune,1456,720,736,49.45
Ryze,Braum,473,210,263,44.4
Ryze,Graves,519,257,262,49.52
Ryze,Fizz,347,176,171,50.72
Ryze,Vi,639,326,313,51.02
Ryze,Akshan,250,116,134,46.4
Ryze,Corki,343,186,157,54.23
Ryze,Zyra,581,252,329,43.37
Ryze,Senna,545,301,244,55.23
Ryze,DrMundo,461,244,217,52.93
Ryze,Swain,650,291,359,44.77
Ryze,Sejuani,265,131,134,49.43
Ryze,Neeko,289,135,154,46.71
Ryze,Akali,766,406,360,53
Ryze,Sion,512,250,262,48.83
Ryze,XinZhao,469,221,248,47.12
Ryze,Tryndamere,414,219,195,52.9
Ryze,Vayne,980,482,498,49.18
Ryze,Blitzcrank,549,284,265,51.73
Ryze,Kled,120,53,67,44.17
Ryze,Zoe,311,149,162,47.91
Ryze,Renekton,389,191,198,49.1
Ryze,Udyr,330,170,160,51.52
Ryze,Lillia,346,189,157,54.62
Ryze,Malzahar,769,275,494,35.76
Ryze,Ashe,1382,722,660,52.24
Ryze,Riven,287,139,148,48.43
Ryze,Nocturne,922,433,489,46.96
Ryze,Hecarim,283,155,128,54.77
Ryze,Velkoz,470,240,230,51.06
Ryze,Lucian,531,247,284,46.52
Ryze,Nami,718,362,356,50.42
Ryze,Belveth,195,104,91,53.33
Ryze,Heimerdinger,333,180,153,54.05
Ryze,Kayle,448,221,227,49.33
Ryze,Briar,640,277,363,43.28
Ryze,Aurora,611,309,302,50.57
Ryze,Taric,138,70,68,50.72
Ryze,Qiyana,235,113,122,48.09
Ryze,Gragas,456,252,204,55.26
Ryze,Gangplank,435,262,173,60.23
Ryze,Khazix,358,172,186,48.04
Ryze,Jayce,358,207,151,57.82
Ryze,Leona,613,332,281,54.16
Ryze,Urgot,313,151,162,48.24
Ryze,Kassadin,184,109,75,59.24
Ryze,Xerath,610,327,283,53.61
Ryze,Annie,193,90,103,46.63
Ryze,Ivern,116,60,56,51.72
Ryze,Fiora,336,182,154,54.17
Ryze,TwistedFate,277,150,127,54.15
Ryze,Rengar,268,128,140,47.76
Ryze,Gwen,376,189,187,50.27
Ryze,Olaf,192,103,89,53.65
Ryze,Viktor,721,340,381,47.16
Ryze,Kalista,250,111,139,44.4
Ryze,Sivir,396,189,207,47.73
Ryze,Varus,696,356,340,51.15
Ryze,Zac,358,147,211,41.06
Ryze,Nasus,484,265,219,54.75
Ryze,Viego,1037,515,522,49.66
Ryze,Rammus,248,119,129,47.98
Ryze,Leblanc,377,222,155,58.89
Ryze,Soraka,381,184,197,48.29
Ryze,JarvanIV,449,220,229,49
Ryze,Zilean,254,130,124,51.18
Ryze,Gnar,323,160,163,49.54
Ryze,Shyvana,162,87,75,53.7
Ryze,Galio,676,349,327,51.63
Ryze,Yorick,641,297,344,46.33
Ryze,Ornn,327,171,156,52.29
Ryze,Poppy,469,276,193,58.85
Ryze,Sona,187,88,99,47.06
Ryze,Smolder,453,255,198,56.29
Ryze,KogMaw,250,123,127,49.2
Ryze,Anivia,300,152,148,50.67
Ryze,Quinn,239,133,106,55.65
Ryze,Talon,448,243,205,54.24
Ryze,Skarner,233,126,107,54.08
Ryze,Singed,223,119,104,53.36
Ryze,Alistar,289,151,138,52.25
Ryze,Orianna,317,145,172,45.74
Ryze,Zeri,356,179,177,50.28
Ryze,Renata,151,68,83,45.03
Ryze,Maokai,328,171,157,52.13
Ryze,Syndra,351,173,178,49.29
Ryze,Lissandra,198,77,121,38.89
Ryze,Janna,300,135,165,45
Ryze,Rumble,177,94,83,53.11
Ryze,Evelynn,263,131,132,49.81
Ryze,Nidalee,218,154,64,70.64
Ryze,Bard,234,130,104,55.56
Ryze,RekSai,119,62,57,52.1
Brand,Yorick,1600,792,808,49.5
Brand,Kayn,2320,1116,1204,48.1
Brand,Ryze,410,199,211,48.54
Brand,Lux,4636,2287,2349,49.33
Brand,Pantheon,2518,1315,1203,52.22
Brand,TahmKench,1572,839,733,53.37
Brand,Malphite,1449,772,677,53.28
Brand,Yasuo,2922,1442,1480,49.35
Brand,Aphelios,820,405,415,49.39
Brand,TwistedFate,491,231,260,47.05
Brand,Vladimir,992,490,502,49.4
Brand,Zac,713,411,302,57.64
Brand,Cassiopeia,419,214,205,51.07
Brand,Irelia,1301,612,689,47.04
Brand,AurelionSol,648,311,337,47.99
Brand,Singed,420,163,257,38.81
Brand,Udyr,561,311,250,55.44
Brand,Sett,2240,1034,1206,46.16
Brand,MissFortune,3961,2062,1899,52.06
Brand,Aatrox,1279,670,609,52.38
Brand,Khazix,895,487,408,54.41
Brand,Qiyana,345,196,149,56.81
Brand,Nautilus,1802,996,806,55.27
Brand,Tryndamere,1013,503,510,49.65
Brand,Briar,1302,657,645,50.46
Brand,Mordekaiser,2176,1077,1099,49.49
Brand,Janna,408,184,224,45.1
Brand,Gnar,650,320,330,49.23
Brand,Nunu,1016,501,515,49.31
Brand,Lucian,997,455,542,45.64
Brand,Jhin,2880,1381,1499,47.95
Brand,Samira,1264,617,647,48.81
Brand,Nami,1350,658,692,48.74
Brand,XinZhao,937,404,533,43.12
Brand,Morgana,2205,1104,1101,50.07
Brand,Ashe,3053,1684,1369,55.16
Brand,Braum,814,420,394,51.6
Brand,Darius,2939,1517,1422,51.62
Brand,Kindred,695,377,318,54.24
Brand,Veigar,1740,893,847,51.32
Brand,Corki,497,254,243,51.11
Brand,Nocturne,1910,932,978,48.8
Brand,Aurora,1046,513,533,49.04
Brand,Soraka,804,388,416,48.26
Brand,Kayle,1027,479,548,46.64
Brand,Akali,1564,798,766,51.02
Brand,Yone,2794,1468,1326,52.54
Brand,Tristana,1493,760,733,50.9
Brand,Sivir,783,360,423,45.98
Brand,Ahri,2256,1185,1071,52.53
Brand,Neeko,976,506,470,51.84
Brand,Heimerdinger,857,437,420,50.99
Brand,Renekton,579,279,300,48.19
Brand,Caitlyn,4353,2219,2134,50.98
Brand,Lillia,845,433,412,51.24
Brand,Pyke,1352,726,626,53.7
Brand,Viego,1800,816,984,45.33
Brand,Urgot,817,378,439,46.27
Brand,Amumu,1656,819,837,49.46
Brand,Shaco,1474,755,719,51.22
Brand,FiddleSticks,720,389,331,54.03
Brand,Zoe,613,351,262,57.26
Brand,Kaisa,2196,1093,1103,49.77
Brand,Taric,250,122,128,48.8
Brand,Chogath,1893,939,954,49.6
Brand,Ezreal,3118,1716,1402,55.04
Brand,Gwen,713,393,320,55.12
Brand,Vayne,1733,822,911,47.43
Brand,LeeSin,1742,842,900,48.34
Brand,Thresh,1943,1035,908,53.27
Brand,DrMundo,1088,497,591,45.68
Brand,Draven,829,422,407,50.9
Brand,Rell,709,373,336,52.61
Brand,Talon,778,408,370,52.44
Brand,Ekko,1328,729,599,54.89
Brand,Volibear,1867,934,933,50.03
Brand,MasterYi,1916,855,1061,44.62
Brand,Hwei,1083,517,566,47.74
Brand,Karma,1349,612,737,45.37
Brand,Katarina,1141,590,551,51.71
Brand,Jax,1343,682,661,50.78
Brand,Kled,262,117,145,44.66
Brand,Xerath,1364,629,735,46.11
Brand,Nidalee,344,173,171,50.29
Brand,Swain,1747,831,916,47.57
Brand,Vi,1371,674,697,49.16
Brand,Jinx,3876,1784,2092,46.03
Brand,Riven,569,294,275,51.67
Brand,Nilah,653,337,316,51.61
Brand,Trundle,922,432,490,46.85
Brand,Diana,2351,1259,1092,53.55
Brand,Seraphine,1420,759,661,53.45
Brand,Velkoz,998,510,488,51.1
Brand,Teemo,2172,1034,1138,47.61
Brand,Senna,1157,566,591,48.92
Brand,Shen,1049,577,472,55
Brand,Rakan,542,251,291,46.31
Brand,Garen,2474,1110,1364,44.87
Brand,Rammus,433,231,202,53.35
Brand,Ornn,542,253,289,46.68
Brand,Poppy,763,369,394,48.36
Brand,Warwick,2366,1159,1207,48.99
Brand,KSante,614,373,241,60.75
Brand,Illaoi,772,399,373,51.68
Brand,Rengar,541,330,211,61
Brand,Mel,2963,1551,1412,52.35
Brand,Leblanc,746,403,343,54.02
Brand,Twitch,1203,598,605,49.71
Brand,Jayce,562,298,264,53.02
Brand,Orianna,507,227,280,44.77
Brand,Alistar,524,277,247,52.86
Brand,Karthus,399,198,201,49.62
Brand,Leona,1265,647,618,51.15
Brand,Fizz,983,493,490,50.15
Brand,Zyra,1379,657,722,47.64
Brand,Viktor,1259,611,648,48.53
Brand,Camille,484,246,238,50.83
Brand,Azir,419,240,179,57.28
Brand,Blitzcrank,1062,502,560,47.27
Brand,Ambessa,828,433,395,52.29
Brand,Malzahar,1538,731,807,47.53
Brand,Yuumi,1268,587,681,46.29
Brand,Sona,460,205,255,44.57
Brand,Ivern,223,96,127,43.05
Brand,Kassadin,331,139,192,41.99
Brand,Elise,967,425,542,43.95
Brand,Graves,839,412,427,49.11
Brand,Milio,718,310,408,43.18
Brand,Bard,415,213,202,51.33
Brand,Sejuani,601,309,292,51.41
Brand,MonkeyKing,976,503,473,51.54
Brand,Galio,1431,705,726,49.27
Brand,Nasus,1255,709,546,56.49
Brand,Fiora,516,298,218,57.75
Brand,Gragas,825,462,363,56
Brand,Anivia,440,206,234,46.82
Brand,Xayah,684,361,323,52.78
Brand,Varus,1160,596,564,51.38
Brand,Zed,1650,799,851,48.42
Brand,Quinn,510,260,250,50.98
Brand,Kennen,437,261,176,59.73
Brand,KogMaw,472,258,214,54.66
Brand,Ziggs,527,260,267,49.34
Brand,Lulu,1678,839,839,50
Brand,Hecarim,580,325,255,56.03
Brand,Sion,1153,541,612,46.92
Brand,Gangplank,630,360,270,57.14
Brand,Vex,819,424,395,51.77
Brand,Evelynn,616,330,286,53.57
Brand,JarvanIV,820,425,395,51.83
Brand,Zeri,497,257,240,51.71
Brand,Sylas,1686,859,827,50.95
Brand,Belveth,414,238,176,57.49
Brand,Rumble,303,156,147,51.49
Brand,Lissandra,419,203,216,48.45
Brand,Olaf,308,170,138,55.19
Brand,Naafiri,555,261,294,47.03
Brand,Smolder,1057,554,503,52.41
Brand,Syndra,768,391,377,50.91
Brand,Taliyah,308,160,148,51.95
Brand,Skarner,389,221,168,56.81
Brand,Renata,234,123,111,52.56
Brand,Akshan,512,285,227,55.66
Brand,Kalista,449,229,220,51
Brand,Shyvana,393,171,222,43.51
Brand,Zilean,487,241,246,49.49
Brand,Maokai,700,351,349,50.14
Brand,RekSai,174,88,86,50.57
Brand,Annie,390,198,192,50.77
DrMundo,Gangplank,572,309,263,54.02
DrMundo,Gragas,634,327,307,51.58
DrMundo,TwistedFate,389,225,164,57.84
DrMundo,Lucian,727,440,287,60.52
DrMundo,Leona,1026,503,523,49.03
DrMundo,Singed,400,202,198,50.5
DrMundo,Graves,640,288,352,45
DrMundo,Fizz,698,359,339,51.43
DrMundo,Ziggs,478,231,247,48.33
DrMundo,Pantheon,1987,1074,913,54.05
DrMundo,Malphite,1105,601,504,54.39
DrMundo,Rengar,409,220,189,53.79
DrMundo,Akali,1230,627,603,50.98
DrMundo,Ashe,2328,1220,1108,52.41
DrMundo,Rakan,518,266,252,51.35
DrMundo,Yorick,1105,498,607,45.07
DrMundo,Akshan,437,226,211,51.72
DrMundo,FiddleSticks,665,358,307,53.83
DrMundo,Samira,993,552,441,55.59
DrMundo,Pyke,1095,616,479,56.26
DrMundo,Jayce,555,314,241,56.58
DrMundo,Amumu,1324,630,694,47.58
DrMundo,Yasuo,2280,1103,1177,48.38
DrMundo,Milio,665,308,357,46.32
DrMundo,Chogath,1906,1032,874,54.14
DrMundo,Briar,1034,539,495,52.13
DrMundo,Lulu,1166,597,569,51.2
DrMundo,Sett,2022,1012,1010,50.05
DrMundo,Rammus,325,175,150,53.85
DrMundo,Nautilus,1307,704,603,53.86
DrMundo,Kayn,1761,925,836,52.53
DrMundo,Zed,1226,656,570,53.51
DrMundo,Yone,2294,1181,1113,51.48
DrMundo,MissFortune,2788,1495,1293,53.62
DrMundo,Senna,885,470,415,53.11
DrMundo,Garen,2009,943,1066,46.94
DrMundo,Ahri,1650,879,771,53.27
DrMundo,Sona,404,205,199,50.74
DrMundo,Teemo,1539,818,721,53.15
DrMundo,Jhin,2274,1156,1118,50.84
DrMundo,Volibear,1447,772,675,53.35
DrMundo,MasterYi,1448,766,682,52.9
DrMundo,Seraphine,1040,511,529,49.13
DrMundo,Nilah,496,235,261,47.38
DrMundo,Velkoz,784,444,340,56.63
DrMundo,Shaco,1114,617,497,55.39
DrMundo,Lillia,915,431,484,47.1
DrMundo,Lissandra,304,137,167,45.07
DrMundo,Jinx,3220,1546,1674,48.01
DrMundo,Mordekaiser,1674,877,797,52.39
DrMundo,Zoe,505,276,229,54.65
DrMundo,Ezreal,2411,1302,1109,54
DrMundo,Darius,2400,1273,1127,53.04
DrMundo,Aphelios,665,334,331,50.23
DrMundo,Neeko,607,313,294,51.57
DrMundo,Aatrox,1253,644,609,51.4
DrMundo,XinZhao,659,337,322,51.14
DrMundo,Vladimir,765,399,366,52.16
DrMundo,Tristana,1247,656,591,52.61
DrMundo,Rell,555,257,298,46.31
DrMundo,Swain,1243,573,670,46.1
DrMundo,Shen,682,413,269,60.56
DrMundo,Lux,3271,1770,1501,54.11
DrMundo,TahmKench,1184,649,535,54.81
DrMundo,Morgana,1671,843,828,50.45
DrMundo,Urgot,603,352,251,58.37
DrMundo,Skarner,351,173,178,49.29
DrMundo,Ekko,1027,456,571,44.4
DrMundo,Kaisa,2016,1035,981,51.34
DrMundo,Mel,2484,1349,1135,54.31
DrMundo,Jax,1209,637,572,52.69
DrMundo,RekSai,112,51,61,45.54
DrMundo,Brand,1088,591,497,54.32
DrMundo,Smolder,882,451,431,51.13
DrMundo,Riven,397,221,176,55.67
DrMundo,Hwei,718,383,335,53.34
DrMundo,Blitzcrank,874,408,466,46.68
DrMundo,Draven,596,336,260,56.38
DrMundo,Warwick,1918,922,996,48.07
DrMundo,Qiyana,281,180,101,64.06
DrMundo,Xayah,629,292,337,46.42
DrMundo,Evelynn,544,307,237,56.43
DrMundo,Kayle,762,378,384,49.61
DrMundo,Leblanc,632,312,320,49.37
DrMundo,Sion,782,385,397,49.23
DrMundo,Viego,1571,756,815,48.12
DrMundo,Braum,591,290,301,49.07
DrMundo,Zyra,1080,594,486,55
DrMundo,Zeri,453,240,213,52.98
DrMundo,Vayne,1606,785,821,48.88
DrMundo,Ryze,461,217,244,47.07
DrMundo,Karthus,349,208,141,59.6
DrMundo,Udyr,465,211,254,45.38
DrMundo,AurelionSol,507,240,267,47.34
DrMundo,Khazix,673,369,304,54.83
DrMundo,Irelia,907,458,449,50.5
DrMundo,Malzahar,1196,628,568,52.51
DrMundo,Hecarim,491,280,211,57.03
DrMundo,Sylas,1389,665,724,47.88
DrMundo,Nami,1197,664,533,55.47
DrMundo,Kennen,398,254,144,63.82
DrMundo,MonkeyKing,762,366,396,48.03
DrMundo,Veigar,1302,633,669,48.62
DrMundo,KSante,529,295,234,55.77
DrMundo,Diana,1895,965,930,50.92
DrMundo,Talon,624,377,247,60.42
DrMundo,Quinn,479,228,251,47.6
DrMundo,Aurora,984,560,424,56.91
DrMundo,Yuumi,1031,525,506,50.92
DrMundo,Corki,423,221,202,52.25
DrMundo,Poppy,703,387,316,55.05
DrMundo,Katarina,962,532,430,55.3
DrMundo,LeeSin,1454,735,719,50.55
DrMundo,Vex,613,317,296,51.71
DrMundo,Xerath,982,511,471,52.04
DrMundo,Caitlyn,3062,1636,1426,53.43
DrMundo,Soraka,584,289,295,49.49
DrMundo,Ambessa,610,297,313,48.69
DrMundo,Kassadin,275,141,134,51.27
DrMundo,Nunu,803,417,386,51.93
DrMundo,Karma,1166,625,541,53.6
DrMundo,Gnar,477,255,222,53.46
DrMundo,Zac,476,247,229,51.89
DrMundo,Zilean,341,158,183,46.33
DrMundo,Renekton,440,211,229,47.95
DrMundo,Twitch,1001,550,451,54.95
DrMundo,Varus,1019,522,497,51.23
DrMundo,Sejuani,533,251,282,47.09
DrMundo,Nidalee,321,185,136,57.63
DrMundo,Naafiri,417,214,203,51.32
DrMundo,Heimerdinger,631,298,333,47.23
DrMundo,Vi,1104,557,547,50.45
DrMundo,Sivir,533,286,247,53.66
DrMundo,Olaf,217,101,116,46.54
DrMundo,Galio,1043,557,486,53.4
DrMundo,Thresh,1519,733,786,48.26
DrMundo,Ornn,549,293,256,53.37
DrMundo,Camille,382,205,177,53.66
DrMundo,Viktor,949,462,487,48.68
DrMundo,Trundle,841,356,485,42.33
DrMundo,Nocturne,1395,703,692,50.39
DrMundo,Anivia,456,204,252,44.74
DrMundo,Maokai,550,252,298,45.82
DrMundo,Fiora,449,261,188,58.13
DrMundo,Alistar,442,212,230,47.96
DrMundo,Kindred,519,280,239,53.95
DrMundo,Ivern,216,112,104,51.85
DrMundo,Orianna,568,333,235,58.63
DrMundo,Janna,296,170,126,57.43
DrMundo,Elise,761,406,355,53.35
DrMundo,Shyvana,322,161,161,50
DrMundo,Nasus,800,377,423,47.13
DrMundo,KogMaw,397,185,212,46.6
DrMundo,Taliyah,301,157,144,52.16
DrMundo,Gwen,799,352,447,44.06
DrMundo,JarvanIV,535,242,293,45.23
DrMundo,Bard,376,192,184,51.06
DrMundo,Rumble,323,171,152,52.94
DrMundo,Taric,295,148,147,50.17
DrMundo,Illaoi,694,361,333,52.02
DrMundo,Cassiopeia,411,203,208,49.39
DrMundo,Syndra,646,360,286,55.73
DrMundo,Annie,405,234,171,57.78
DrMundo,Tryndamere,676,363,313,53.7
DrMundo,Renata,201,112,89,55.72
DrMundo,Belveth,282,138,144,48.94
DrMundo,Azir,352,162,190,46.02
DrMundo,Kalista,369,196,173,53.12
DrMundo,Kled,264,133,131,50.38
Gragas,DrMundo,634,307,327,48.42
Gragas,Lillia,706,312,394,44.19
Gragas,Viktor,1196,535,661,44.73
Gragas,Jhin,2226,1031,1195,46.32
Gragas,Pyke,1011,543,468,53.71
Gragas,Kayle,845,410,435,48.52
Gragas,Viego,1619,766,853,47.31
Gragas,Irelia,977,491,486,50.26
Gragas,Jinx,3232,1491,1741,46.13
Gragas,Thresh,1949,862,1087,44.23
Gragas,Riven,558,287,271,51.43
Gragas,Nocturne,1363,596,767,43.73
Gragas,Zoe,538,239,299,44.42
Gragas,Lulu,1809,849,960,46.93
Gragas,Zed,1461,699,762,47.84
Gragas,Shaco,1155,490,665,42.42
Gragas,Anivia,420,210,210,50
Gragas,Lux,2908,1331,1577,45.77
Gragas,Morgana,1355,578,777,42.66
Gragas,Ivern,218,118,100,54.13
Gragas,Yasuo,2366,1120,1246,47.34
Gragas,Swain,1195,548,647,45.86
Gragas,Nami,1210,556,654,45.95
Gragas,Jayce,697,376,321,53.95
Gragas,Rengar,471,258,213,54.78
Gragas,Ezreal,3220,1578,1642,49.01
Gragas,Sona,357,168,189,47.06
Gragas,LeeSin,2294,1137,1157,49.56
Gragas,Mel,2361,1167,1194,49.43
Gragas,Tristana,1084,502,582,46.31
Gragas,Zac,594,300,294,50.51
Gragas,Sylas,1793,889,904,49.58
Gragas,Rell,712,291,421,40.87
Gragas,Ashe,2297,1124,1173,48.93
Gragas,Mordekaiser,1424,590,834,41.43
Gragas,Warwick,1682,807,875,47.98
Gragas,Yone,2182,1030,1152,47.2
Gragas,Kalista,393,208,185,52.93
Gragas,Kennen,417,202,215,48.44
Gragas,Rammus,336,156,180,46.43
Gragas,Caitlyn,3081,1416,1665,45.96
Gragas,Zeri,616,281,335,45.62
Gragas,Kayn,1693,785,908,46.37
Gragas,Aurora,951,510,441,53.63
Gragas,Nilah,458,212,246,46.29
Gragas,Karma,1451,686,765,47.28
Gragas,Camille,509,239,270,46.95
Gragas,Draven,758,388,370,51.19
Gragas,Senna,944,464,480,49.15
Gragas,Poppy,711,336,375,47.26
Gragas,Nunu,773,366,407,47.35
Gragas,MissFortune,2440,1129,1311,46.27
Gragas,Rakan,506,258,248,50.99
Gragas,Nasus,824,333,491,40.41
Gragas,Udyr,545,248,297,45.5
Gragas,Alistar,583,295,288,50.6
Gragas,TahmKench,1049,516,533,49.19
Gragas,Briar,872,416,456,47.71
Gragas,Heimerdinger,531,231,300,43.5
Gragas,Blitzcrank,933,457,476,48.98
Gragas,Velkoz,710,316,394,44.51
Gragas,Yorick,1044,455,589,43.58
Gragas,Evelynn,403,209,194,51.86
Gragas,Akali,1270,602,668,47.4
Gragas,Neeko,615,295,320,47.97
Gragas,Jax,1432,728,704,50.84
Gragas,Janna,482,210,272,43.57
Gragas,Sett,1892,892,1000,47.15
Gragas,Nautilus,1553,816,737,52.54
Gragas,Elise,997,505,492,50.65
Gragas,Annie,451,214,237,47.45
Gragas,Ziggs,489,226,263,46.22
Gragas,Naafiri,383,173,210,45.17
Gragas,Gangplank,761,406,355,53.35
Gragas,Ornn,571,260,311,45.53
Gragas,Sivir,605,258,347,42.64
Gragas,Veigar,1198,549,649,45.83
Gragas,Samira,1017,497,520,48.87
Gragas,Tryndamere,649,355,294,54.7
Gragas,Shyvana,340,153,187,45
Gragas,Fizz,601,291,310,48.42
Gragas,Taric,275,110,165,40
Gragas,Singed,367,162,205,44.14
Gragas,Darius,2277,1065,1212,46.77
Gragas,Shen,926,421,505,45.46
Gragas,Vi,1337,637,700,47.64
Gragas,Yuumi,1164,581,583,49.91
Gragas,Graves,808,340,468,42.08
Gragas,Renekton,594,291,303,48.99
Gragas,Soraka,686,260,426,37.9
Gragas,Katarina,1001,509,492,50.85
Gragas,Gnar,585,308,277,52.65
Gragas,Xerath,1051,476,575,45.29
Gragas,Leona,1010,516,494,51.09
Gragas,Aphelios,760,382,378,50.26
Gragas,MasterYi,1360,650,710,47.79
Gragas,Zyra,1111,483,628,43.47
Gragas,Aatrox,1395,723,672,51.83
Gragas,TwistedFate,457,219,238,47.92
Gragas,Seraphine,831,412,419,49.58
Gragas,Teemo,1395,567,828,40.65
Gragas,Volibear,1390,708,682,50.94
Gragas,Ahri,1629,826,803,50.71
Gragas,Diana,1889,841,1048,44.52
Gragas,Milio,737,357,380,48.44
Gragas,Sion,962,456,506,47.4
Gragas,Nidalee,418,210,208,50.24
Gragas,Hwei,805,422,383,52.42
Gragas,Leblanc,831,400,431,48.13
Gragas,Smolder,939,470,469,50.05
Gragas,Syndra,788,368,420,46.7
Gragas,Malzahar,1014,453,561,44.67
Gragas,Talon,776,423,353,54.51
Gragas,Lucian,943,490,453,51.96
Gragas,Twitch,977,466,511,47.7
Gragas,Orianna,569,287,282,50.44
Gragas,Sejuani,570,274,296,48.07
Gragas,FiddleSticks,638,294,344,46.08
Gragas,Fiora,515,232,283,45.05
Gragas,Vayne,1559,730,829,46.82
Gragas,Belveth,309,148,161,47.9
Gragas,Corki,544,274,270,50.37
Gragas,Karthus,358,213,145,59.5
Gragas,KSante,761,402,359,52.83
Gragas,Olaf,320,155,165,48.44
Gragas,Ekko,1132,528,604,46.64
Gragas,Galio,1190,500,690,42.02
Gragas,Chogath,1463,679,784,46.41
Gragas,Qiyana,384,186,198,48.44
Gragas,Hecarim,541,304,237,56.19
Gragas,Xayah,703,293,410,41.68
Gragas,Varus,1119,574,545,51.3
Gragas,Garen,1821,804,1017,44.15
Gragas,Kindred,655,255,400,38.93
Gragas,Malphite,1059,445,614,42.02
Gragas,Ambessa,894,441,453,49.33
Gragas,XinZhao,743,332,411,44.68
Gragas,Kaisa,1944,1038,906,53.4
Gragas,Ryze,456,204,252,44.74
Gragas,Gwen,609,328,281,53.86
Gragas,Pantheon,2164,1115,1049,51.52
Gragas,Akshan,394,183,211,46.45
Gragas,Quinn,442,246,196,55.66
Gragas,Bard,425,212,213,49.88
Gragas,Khazix,686,306,380,44.61
Gragas,Skarner,373,199,174,53.35
Gragas,Vladimir,788,351,437,44.54
Gragas,MonkeyKing,791,411,380,51.96
Gragas,Trundle,661,334,327,50.53
Gragas,Braum,733,355,378,48.43
Gragas,Azir,507,250,257,49.31
Gragas,Brand,825,363,462,44
Gragas,Zilean,412,194,218,47.09
Gragas,Urgot,522,220,302,42.15
Gragas,Kassadin,329,160,169,48.63
Gragas,Vex,710,298,412,41.97
Gragas,Lissandra,432,208,224,48.15
Gragas,JarvanIV,769,358,411,46.55
Gragas,Rumble,360,212,148,58.89
Gragas,Amumu,1208,543,665,44.95
Gragas,Renata,230,121,109,52.61
Gragas,Taliyah,327,154,173,47.09
Gragas,Illaoi,593,262,331,44.18
Gragas,Kled,224,105,119,46.88
Gragas,RekSai,155,58,97,37.42
Gragas,Cassiopeia,333,143,190,42.94
Gragas,Maokai,614,240,374,39.09
Gragas,AurelionSol,477,220,257,46.12
Gragas,KogMaw,396,199,197,50.25
TwistedFate,DrMundo,389,164,225,42.16
TwistedFate,Lillia,464,228,236,49.14
TwistedFate,Viktor,732,312,420,42.62
TwistedFate,Jhin,1587,664,923,41.84
TwistedFate,Pyke,698,346,352,49.57
TwistedFate,Gangplank,535,295,240,55.14
TwistedFate,Brand,491,260,231,52.95
TwistedFate,Irelia,580,240,340,41.38
TwistedFate,Malzahar,889,440,449,49.49
TwistedFate,Aatrox,798,387,411,48.5
TwistedFate,Gwen,361,208,153,57.62
TwistedFate,Syndra,456,203,253,44.52
TwistedFate,Ashe,1430,696,734,48.67
TwistedFate,Lulu,986,510,476,51.72
TwistedFate,Mordekaiser,855,416,439,48.65
TwistedFate,Amumu,778,336,442,43.19
TwistedFate,Sylas,1084,561,523,51.75
TwistedFate,Xayah,416,210,206,50.48
TwistedFate,TahmKench,619,301,318,48.63
TwistedFate,Nunu,440,204,236,46.36
TwistedFate,Vladimir,386,197,189,51.04
TwistedFate,Samira,510,262,248,51.37
TwistedFate,Nami,817,374,443,45.78
TwistedFate,Jax,732,352,380,48.09
TwistedFate,Elise,505,228,277,45.15
TwistedFate,Kaisa,1315,661,654,50.27
TwistedFate,Twitch,671,306,365,45.6
TwistedFate,Yuumi,642,277,365,43.15
TwistedFate,Vi,772,376,396,48.7
TwistedFate,Orianna,384,210,174,54.69
TwistedFate,Draven,521,262,259,50.29
TwistedFate,Garen,1248,554,694,44.39
TwistedFate,Zed,891,481,410,53.98
TwistedFate,Aurora,607,287,320,47.28
TwistedFate,Caitlyn,1996,940,1056,47.09
TwistedFate,Soraka,417,206,211,49.4
TwistedFate,Kindred,354,212,142,59.89
TwistedFate,Kennen,185,81,104,43.78
TwistedFate,Tristana,694,352,342,50.72
TwistedFate,Teemo,911,366,545,40.18
TwistedFate,Maokai,293,142,151,48.46
TwistedFate,Corki,338,182,156,53.85
TwistedFate,Taric,199,89,110,44.72
TwistedFate,Rammus,217,101,116,46.54
TwistedFate,Katarina,549,295,254,53.73
TwistedFate,Milio,462,174,288,37.66
TwistedFate,Kayn,1057,543,514,51.37
TwistedFate,Veigar,725,343,382,47.31
TwistedFate,Swain,719,335,384,46.59
TwistedFate,Renata,165,75,90,45.45
TwistedFate,XinZhao,448,203,245,45.31
TwistedFate,Rell,388,158,230,40.72
TwistedFate,Kayle,539,235,304,43.6
TwistedFate,FiddleSticks,352,170,182,48.3
TwistedFate,Zoe,389,218,171,56.04
TwistedFate,Camille,331,174,157,52.57
TwistedFate,Rengar,256,152,104,59.38
TwistedFate,Sett,1094,519,575,47.44
TwistedFate,MissFortune,1585,761,824,48.01
TwistedFate,Sona,247,133,114,53.85
TwistedFate,Jinx,1842,816,1026,44.3
TwistedFate,Yone,1257,561,696,44.63
TwistedFate,Illaoi,383,188,195,49.09
TwistedFate,Gragas,457,238,219,52.08
TwistedFate,Lux,1890,874,1016,46.24
TwistedFate,Leona,561,279,282,49.73
TwistedFate,Pantheon,1233,588,645,47.69
TwistedFate,Akali,762,316,446,41.47
TwistedFate,Shaco,745,335,410,44.97
TwistedFate,Velkoz,416,166,250,39.9
TwistedFate,Yorick,680,279,401,41.03
TwistedFate,Zyra,656,278,378,42.38
TwistedFate,Karthus,238,107,131,44.96
TwistedFate,Mel,1271,648,623,50.98
TwistedFate,Morgana,778,361,417,46.4
TwistedFate,Darius,1386,639,747,46.1
TwistedFate,Poppy,535,260,275,48.6
TwistedFate,Bard,212,107,105,50.47
TwistedFate,Galio,611,279,332,45.66
TwistedFate,Alistar,325,144,181,44.31
TwistedFate,LeeSin,1244,649,595,52.17
TwistedFate,Kassadin,169,83,86,49.11
TwistedFate,Viego,1002,480,522,47.9
TwistedFate,Hecarim,333,151,182,45.35
TwistedFate,Thresh,1144,564,580,49.3
TwistedFate,MonkeyKing,452,220,232,48.67
TwistedFate,Ekko,621,326,295,52.5
TwistedFate,Ahri,1031,499,532,48.4
TwistedFate,MasterYi,849,413,436,48.65
TwistedFate,Nautilus,785,373,412,47.52
TwistedFate,Vex,318,139,179,43.71
TwistedFate,Yasuo,1303,632,671,48.5
TwistedFate,Trundle,453,200,253,44.15
TwistedFate,Ezreal,1812,880,932,48.57
TwistedFate,Ambessa,461,258,203,55.97
TwistedFate,AurelionSol,324,152,172,46.91
TwistedFate,Udyr,323,169,154,52.32
TwistedFate,Leblanc,405,172,233,42.47
TwistedFate,Renekton,379,208,171,54.88
TwistedFate,Kled,152,62,90,40.79
TwistedFate,Ryze,277,127,150,45.85
TwistedFate,Diana,1173,532,641,45.35
TwistedFate,Fizz,472,198,274,41.95
TwistedFate,Varus,653,313,340,47.93
TwistedFate,Khazix,430,200,230,46.51
TwistedFate,Naafiri,235,81,154,34.47
TwistedFate,Quinn,349,184,165,52.72
TwistedFate,Blitzcrank,597,285,312,47.74
TwistedFate,Volibear,739,385,354,52.1
TwistedFate,Graves,613,319,294,52.04
TwistedFate,Seraphine,593,281,312,47.39
TwistedFate,Malphite,640,294,346,45.94
TwistedFate,Sivir,382,162,220,42.41
TwistedFate,Senna,538,292,246,54.28
TwistedFate,Jayce,411,200,211,48.66
TwistedFate,Shyvana,186,95,91,51.08
TwistedFate,Lissandra,267,117,150,43.82
TwistedFate,Nasus,513,222,291,43.27
TwistedFate,Neeko,373,191,182,51.21
TwistedFate,Braum,469,233,236,49.68
TwistedFate,Kalista,230,121,109,52.61
TwistedFate,Warwick,1018,471,547,46.27
TwistedFate,Lucian,590,311,279,52.71
TwistedFate,Briar,518,223,295,43.05
TwistedFate,Akshan,278,127,151,45.68
TwistedFate,Chogath,875,407,468,46.51
TwistedFate,Hwei,530,269,261,50.75
TwistedFate,Heimerdinger,308,120,188,38.96
TwistedFate,Rakan,386,166,220,43.01
TwistedFate,Sion,554,213,341,38.45
TwistedFate,JarvanIV,474,239,235,50.42
TwistedFate,Azir,303,138,165,45.54
TwistedFate,Nilah,282,135,147,47.87
TwistedFate,Karma,857,375,482,43.76
TwistedFate,Urgot,368,173,195,47.01
TwistedFate,Olaf,157,73,84,46.5
TwistedFate,Singed,165,55,110,33.33
TwistedFate,Nocturne,861,347,514,40.3
TwistedFate,Riven,351,186,165,52.99
TwistedFate,Rumble,207,108,99,52.17
TwistedFate,Smolder,534,281,253,52.62
TwistedFate,KogMaw,222,97,125,43.69
TwistedFate,Xerath,685,267,418,38.98
TwistedFate,Vayne,864,420,444,48.61
TwistedFate,Skarner,217,109,108,50.23
TwistedFate,Sejuani,290,134,156,46.21
TwistedFate,KSante,382,221,161,57.85
TwistedFate,Zilean,223,98,125,43.95
TwistedFate,Zac,364,144,220,39.56
TwistedFate,Talon,462,237,225,51.3
TwistedFate,Tryndamere,376,181,195,48.14
TwistedFate,Ziggs,292,147,145,50.34
TwistedFate,Ivern,112,38,74,33.93
TwistedFate,Fiora,293,151,142,51.54
TwistedFate,Aphelios,475,247,228,52
TwistedFate,Ornn,261,123,138,47.13
TwistedFate,Shen,413,187,226,45.28
TwistedFate,Taliyah,242,98,144,40.5
TwistedFate,Annie,305,167,138,54.75
TwistedFate,Gnar,341,186,155,54.55
TwistedFate,Qiyana,182,101,81,55.49
TwistedFate,Zeri,339,136,203,40.12
TwistedFate,Nidalee,270,113,157,41.85
TwistedFate,Evelynn,274,131,143,47.81
TwistedFate,Janna,210,105,105,50
TwistedFate,Anivia,262,136,126,51.91
TwistedFate,Cassiopeia,231,112,119,48.48
TwistedFate,RekSai,104,59,45,56.73
TwistedFate,Belveth,161,76,85,47.2
Leona,DrMundo,1026,523,503,50.97
Leona,Lillia,1074,563,511,52.42
Leona,Viktor,1474,716,758,48.58
Leona,Jhin,3348,1702,1646,50.84
Leona,Pyke,1622,821,801,50.62
Leona,Yone,3184,1689,1495,53.05
Leona,Shaco,1534,682,852,44.46
Leona,AurelionSol,786,371,415,47.2
Leona,Ashe,3537,1747,1790,49.39
Leona,Velkoz,982,484,498,49.29
Leona,Swain,1846,831,1015,45.02
Leona,FiddleSticks,873,437,436,50.06
Leona,Akali,1812,910,902,50.22
Leona,Twitch,1299,657,642,50.58
Leona,Senna,1214,662,552,54.53
Leona,Chogath,2369,1209,1160,51.03
Leona,Talon,959,473,486,49.32
Leona,Qiyana,467,241,226,51.61
Leona,Mel,4200,2324,1876,55.33
Leona,Seraphine,1458,730,728,50.07
Leona,Aatrox,1715,873,842,50.9
Leona,Veigar,1815,885,930,48.76
Leona,Ezreal,4417,2299,2118,52.05
Leona,Milio,1001,506,495,50.55
Leona,Jax,1606,802,804,49.94
Leona,Heimerdinger,804,381,423,47.39
Leona,Soraka,1045,462,583,44.21
Leona,Sett,2859,1373,1486,48.02
Leona,Karthus,450,208,242,46.22
Leona,Zed,1778,905,873,50.9
Leona,Maokai,845,485,360,57.4
Leona,Samira,1374,742,632,54
Leona,Kayn,2702,1403,1299,51.92
Leona,Lucian,1071,599,472,55.93
Leona,Thresh,2810,1330,1480,47.33
Leona,Garen,2832,1406,1426,49.65
Leona,Graves,1159,544,615,46.94
Leona,Aurora,1420,736,684,51.83
Leona,Nilah,726,305,421,42.01
Leona,Hwei,1180,614,566,52.03
Leona,Katarina,1317,706,611,53.61
Leona,Gnar,743,387,356,52.09
Leona,XinZhao,1229,606,623,49.31
Leona,Yasuo,3354,1749,1605,52.15
Leona,Zeri,892,434,458,48.65
Leona,Taric,442,197,245,44.57
Leona,Nasus,1374,621,753,45.2
Leona,Galio,1786,857,929,47.98
Leona,Smolder,1223,629,594,51.43
Leona,JarvanIV,962,489,473,50.83
Leona,Mordekaiser,2502,1113,1389,44.48
Leona,Viego,2380,1201,1179,50.46
Leona,Irelia,1616,816,800,50.5
Leona,Kaisa,2899,1482,1417,51.12
Leona,Udyr,689,355,334,51.52
Leona,Volibear,1928,987,941,51.19
Leona,Rengar,533,292,241,54.78
Leona,Vayne,2381,1156,1225,48.55
Leona,Blitzcrank,1804,957,847,53.05
Leona,KSante,918,473,445,51.53
Leona,Zac,771,383,388,49.68
Leona,Azir,717,373,344,52.02
Leona,Ambessa,1118,552,566,49.37
Leona,MissFortune,3900,1926,1974,49.38
Leona,Nautilus,2318,1200,1118,51.77
Leona,Warwick,2787,1355,1432,48.62
Leona,Tryndamere,847,490,357,57.85
Leona,LeeSin,2453,1330,1123,54.22
Leona,Ekko,1758,956,802,54.38
Leona,Sion,1284,614,670,47.82
Leona,Pantheon,2867,1476,1391,51.48
Leona,Ziggs,552,296,256,53.62
Leona,Lulu,1912,964,948,50.42
Leona,Hecarim,657,352,305,53.58
Leona,Yorick,1644,782,862,47.57
Leona,Kalista,495,256,239,51.72
Leona,Renekton,952,492,460,51.68
Leona,Sejuani,745,393,352,52.75
Leona,Taliyah,510,233,277,45.69
Leona,Kled,356,189,167,53.09
Leona,Shen,1125,569,556,50.58
Leona,Leblanc,957,532,425,55.59
Leona,Yuumi,1592,880,712,55.28
Leona,Teemo,2227,1058,1169,47.51
Leona,Gragas,1010,494,516,48.91
Leona,Diana,2749,1326,1423,48.24
Leona,Caitlyn,4525,2237,2288,49.44
Leona,TwistedFate,561,282,279,50.27
Leona,MonkeyKing,1140,579,561,50.79
Leona,Briar,1473,691,782,46.91
Leona,TahmKench,1586,805,781,50.76
Leona,Evelynn,604,313,291,51.82
Leona,Varus,1538,833,705,54.16
Leona,Nami,1549,774,775,49.97
Leona,Kindred,790,438,352,55.44
Leona,Vladimir,1054,525,529,49.81
Leona,Nocturne,2225,1051,1174,47.24
Leona,Karma,1815,854,961,47.05
Leona,Rakan,685,340,345,49.64
Leona,Lux,4504,2319,2185,51.49
Leona,Syndra,1135,587,548,51.72
Leona,Zyra,1616,751,865,46.47
Leona,Rell,1156,578,578,50
Leona,Vi,1711,769,942,44.94
Leona,Gwen,952,467,485,49.05
Leona,Kayle,1093,528,565,48.31
Leona,Darius,3323,1788,1535,53.81
Leona,Rammus,635,335,300,52.76
Leona,Illaoi,833,415,418,49.82
Leona,Nunu,1112,593,519,53.33
Leona,Amumu,1953,867,1086,44.39
Leona,Jinx,4575,2170,2405,47.43
Leona,Morgana,2314,1067,1247,46.11
Leona,Draven,911,502,409,55.1
Leona,Malzahar,1692,766,926,45.27
Leona,Tristana,1789,932,857,52.1
Leona,Poppy,1500,733,767,48.87
Leona,Orianna,807,387,420,47.96
Leona,Aphelios,997,471,526,47.24
Leona,Brand,1265,618,647,48.85
Leona,Kennen,463,214,249,46.22
Leona,Neeko,841,397,444,47.21
Leona,MasterYi,2253,1248,1005,55.39
Leona,Zoe,680,368,312,54.12
Leona,Fiora,647,373,274,57.65
Leona,Ahri,2285,1124,1161,49.19
Leona,Xerath,1445,760,685,52.6
Leona,Malphite,1956,982,974,50.2
Leona,Anivia,583,285,298,48.89
Leona,Alistar,921,452,469,49.08
Leona,Gangplank,843,387,456,45.91
Leona,Belveth,462,239,223,51.73
Leona,Sona,513,271,242,52.83
Leona,Urgot,811,380,431,46.86
Leona,Janna,667,363,304,54.42
Leona,Ryze,613,281,332,45.84
Leona,Riven,640,349,291,54.53
Leona,Elise,1125,526,599,46.76
Leona,Sylas,2643,1341,1302,50.74
Leona,Khazix,771,414,357,53.7
Leona,Sivir,1054,468,586,44.4
Leona,Shyvana,472,250,222,52.97
Leona,Zilean,536,265,271,49.44
Leona,Skarner,514,275,239,53.5
Leona,Vex,1007,554,453,55.01
Leona,Quinn,541,283,258,52.31
Leona,Trundle,984,462,522,46.95
Leona,Akshan,603,301,302,49.92
Leona,Braum,1162,531,631,45.7
Leona,Naafiri,595,291,304,48.91
Leona,Olaf,453,216,237,47.68
Leona,Nidalee,468,273,195,58.33
Leona,RekSai,241,131,110,54.36
Leona,Camille,580,284,296,48.97
Leona,Lissandra,609,263,346,43.19
Leona,Xayah,969,491,478,50.67
Leona,Corki,683,343,340,50.22
Leona,Ornn,798,377,421,47.24
Leona,KogMaw,517,261,256,50.48
Leona,Fizz,1010,530,480,52.48
Leona,Bard,487,232,255,47.64
Leona,Annie,579,313,266,54.06
Leona,Cassiopeia,569,315,254,55.36
Leona,Kassadin,355,195,160,54.93
Leona,Ivern,287,109,178,37.98
Leona,Jayce,762,391,371,51.31
Leona,Singed,417,191,226,45.8
Leona,Rumble,477,244,233,51.15
Leona,Renata,318,134,184,42.14
Azir,MonkeyKing,597,257,340,43.05
Azir,Kayn,847,378,469,44.63
Azir,Yasuo,1581,837,744,52.94
Azir,Kaisa,1309,628,681,47.98
Azir,Milio,422,218,204,51.66
Azir,KSante,424,229,195,54.01
Azir,Warwick,1082,477,605,44.09
Azir,Diana,1229,580,649,47.19
Azir,Ashe,1597,756,841,47.34
Azir,Corki,309,159,150,51.46
Azir,Sett,1142,544,598,47.64
Azir,Volibear,844,402,442,47.63
Azir,Ambessa,564,285,279,50.53
Azir,Smolder,542,291,251,53.69
Azir,Swain,740,342,398,46.22
Azir,Riven,289,165,124,57.09
Azir,Syndra,516,242,274,46.9
Azir,Jinx,1921,889,1032,46.28
Azir,Pyke,703,377,326,53.63
Azir,Illaoi,352,143,209,40.63
Azir,Caitlyn,1972,977,995,49.54
Azir,Velkoz,417,198,219,47.48
Azir,Nocturne,834,354,480,42.45
Azir,Xerath,735,342,393,46.53
Azir,Ezreal,1807,873,934,48.31
Azir,Blitzcrank,651,323,328,49.62
Azir,Aatrox,769,388,381,50.46
Azir,Cassiopeia,263,154,109,58.56
Azir,Varus,673,308,365,45.77
Azir,Morgana,868,393,475,45.28
Azir,Chogath,966,449,517,46.48
Azir,Poppy,489,206,283,42.13
Azir,Irelia,639,320,319,50.08
Azir,Jhin,1382,627,755,45.37
Azir,Leona,717,341,376,47.56
Azir,Shaco,640,340,300,53.13
Azir,Akali,764,380,384,49.74
Azir,Sivir,442,202,240,45.7
Azir,Renata,189,102,87,53.97
Azir,Nunu,451,241,210,53.44
Azir,Yone,1344,715,629,53.2
Azir,Malzahar,742,367,375,49.46
Azir,Khazix,442,230,212,52.04
Azir,Nasus,478,224,254,46.86
Azir,Maokai,373,178,195,47.72
Azir,Elise,554,277,277,50
Azir,Vex,425,172,253,40.47
Azir,Lucian,583,323,260,55.4
Azir,Senna,588,325,263,55.27
Azir,Malphite,706,343,363,48.58
Azir,Xayah,457,261,196,57.11
Azir,Rakan,334,177,157,52.99
Azir,Garen,1128,545,583,48.32
Azir,Lux,1723,782,941,45.39
Azir,Ryze,338,177,161,52.37
Azir,Pantheon,1350,659,691,48.81
Azir,Darius,1480,731,749,49.39
Azir,Mordekaiser,995,420,575,42.21
Azir,Evelynn,256,131,125,51.17
Azir,Aurora,737,358,379,48.58
Azir,Naafiri,249,109,140,43.78
Azir,MasterYi,786,361,425,45.93
Azir,Twitch,562,238,324,42.35
Azir,Teemo,803,375,428,46.7
Azir,Vayne,802,399,403,49.75
Azir,Ahri,1037,469,568,45.23
Azir,Katarina,594,310,284,52.19
Azir,Yuumi,744,318,426,42.74
Azir,Gnar,358,150,208,41.9
Azir,Annie,224,101,123,45.09
Azir,Tristana,787,409,378,51.97
Azir,Ekko,684,344,340,50.29
Azir,Lillia,433,197,236,45.5
Azir,Draven,414,201,213,48.55
Azir,Lulu,1056,492,564,46.59
Azir,Leblanc,508,251,257,49.41
Azir,Jax,662,330,332,49.85
Azir,Trundle,470,237,233,50.43
Azir,Soraka,376,197,179,52.39
Azir,TahmKench,617,285,332,46.19
Azir,Udyr,323,182,141,56.35
Azir,Orianna,377,193,184,51.19
Azir,Mel,1822,995,827,54.61
Azir,Veigar,637,303,334,47.57
Azir,Braum,522,224,298,42.91
Azir,Rengar,309,174,135,56.31
Azir,Yorick,611,262,349,42.88
Azir,Kindred,364,192,172,52.75
Azir,Vladimir,465,215,250,46.24
Azir,Brand,419,179,240,42.72
Azir,FiddleSticks,394,175,219,44.42
Azir,Shen,539,282,257,52.32
Azir,Skarner,275,137,138,49.82
Azir,Samira,580,266,314,45.86
Azir,Qiyana,247,135,112,54.66
Azir,Zyra,605,321,284,53.06
Azir,Viego,1081,444,637,41.07
Azir,Nilah,269,149,120,55.39
Azir,Sona,253,113,140,44.66
Azir,Zac,493,255,238,51.72
Azir,Galio,674,349,325,51.78
Azir,Fiora,314,155,159,49.36
Azir,Lissandra,219,123,96,56.16
Azir,Thresh,1097,550,547,50.14
Azir,MissFortune,1520,711,809,46.78
Azir,Sion,513,216,297,42.11
Azir,Zed,808,373,435,46.16
Azir,Taric,169,73,96,43.2
Azir,Amumu,660,290,370,43.94
Azir,Zoe,332,156,176,46.99
Azir,Zeri,401,140,261,34.91
Azir,Gragas,507,257,250,50.69
Azir,Sylas,1143,565,578,49.43
Azir,Taliyah,212,107,105,50.47
Azir,Karma,880,389,491,44.2
Azir,Aphelios,438,184,254,42.01
Azir,Seraphine,574,245,329,42.68
Azir,Alistar,368,176,192,47.83
Azir,Briar,545,240,305,44.04
Azir,Nautilus,896,500,396,55.8
Azir,Renekton,368,186,182,50.54
Azir,Bard,175,75,100,42.86
Azir,Viktor,752,341,411,45.35
Azir,Talon,462,193,269,41.77
Azir,XinZhao,550,285,265,51.82
Azir,Nami,664,332,332,50
Azir,Karthus,248,120,128,48.39
Azir,Neeko,357,179,178,50.14
Azir,Rammus,228,83,145,36.4
Azir,Zilean,251,123,128,49
Azir,JarvanIV,429,240,189,55.94
Azir,Ivern,136,73,63,53.68
Azir,TwistedFate,303,165,138,54.46
Azir,Tryndamere,366,173,193,47.27
Azir,Shyvana,150,62,88,41.33
Azir,Quinn,281,166,115,59.07
Azir,LeeSin,1297,639,658,49.27
Azir,Jayce,449,243,206,54.12
Azir,Kassadin,122,64,58,52.46
Azir,Heimerdinger,316,126,190,39.87
Azir,Nidalee,244,130,114,53.28
Azir,Ziggs,193,79,114,40.93
Azir,Kennen,183,70,113,38.25
Azir,Urgot,354,170,184,48.02
Azir,KogMaw,192,90,102,46.88
Azir,Vi,713,295,418,41.37
Azir,Ornn,370,166,204,44.86
Azir,Hwei,559,301,258,53.85
Azir,Gwen,364,161,203,44.23
Azir,Fizz,275,128,147,46.55
Azir,Belveth,199,116,83,58.29
Azir,Rumble,194,80,114,41.24
Azir,Kalista,282,113,169,40.07
Azir,Kayle,465,225,240,48.39
Azir,Sejuani,376,225,151,59.84
Azir,Camille,305,147,158,48.2
Azir,Singed,203,63,140,31.03
Azir,Rell,435,188,247,43.22
Azir,RekSai,133,65,68,48.87
Azir,Janna,224,107,117,47.77
Azir,Gangplank,455,243,212,53.41
Azir,Olaf,144,76,68,52.78
Azir,AurelionSol,286,106,180,37.06
Azir,Akshan,264,129,135,48.86
Azir,DrMundo,352,190,162,53.98
Azir,Hecarim,298,120,178,40.27
Azir,Graves,498,250,248,50.2
Azir,Kled,160,61,99,38.13
Azir,Anivia,214,98,116,45.79
MissFortune,MonkeyKing,3115,1567,1548,50.3
MissFortune,Kayn,7036,3462,3574,49.2
MissFortune,Yasuo,9390,4699,4691,50.04
MissFortune,Kaisa,7608,3984,3624,52.37
MissFortune,Milio,2431,1146,1285,47.14
MissFortune,Gangplank,2145,1100,1045,51.28
MissFortune,Warwick,7783,3763,4020,48.35
MissFortune,Akali,5550,2799,2751,50.43
MissFortune,Caitlyn,15197,7856,7341,51.69
MissFortune,Sona,1505,814,691,54.09
MissFortune,Aatrox,4203,2218,1985,52.77
MissFortune,Sejuani,2021,1009,1012,49.93
MissFortune,Jinx,15002,7370,7632,49.13
MissFortune,Pyke,3999,2065,1934,51.64
MissFortune,Gnar,1961,1056,905,53.85
MissFortune,Jax,4278,2298,1980,53.72
MissFortune,Neeko,2948,1612,1336,54.68
MissFortune,Ornn,1876,915,961,48.77
MissFortune,Udyr,1684,907,777,53.86
MissFortune,Lux,13215,6873,6342,52.01
MissFortune,Ezreal,11246,5944,5302,52.85
MissFortune,Nidalee,1216,698,518,57.4
MissFortune,Ahri,6603,3317,3286,50.23
MissFortune,Jhin,10165,5123,5042,50.4
MissFortune,Senna,3474,1803,1671,51.9
MissFortune,Urgot,2563,1264,1299,49.32
MissFortune,Twitch,3915,2050,1865,52.36
MissFortune,Vladimir,2685,1364,1321,50.8
MissFortune,Zac,1950,993,957,50.92
MissFortune,Cassiopeia,1479,783,696,52.94
MissFortune,Irelia,4014,2045,1969,50.95
MissFortune,Darius,9252,4834,4418,52.25
MissFortune,Volibear,5606,2874,2732,51.27
MissFortune,Chogath,5992,3021,2971,50.42
MissFortune,Brand,3961,1899,2062,47.94
MissFortune,Fiora,1788,890,898,49.78
MissFortune,Yone,9109,4858,4251,53.33
MissFortune,Galio,4009,1964,2045,48.99
MissFortune,KSante,2167,1187,980,54.78
MissFortune,Diana,7755,3827,3928,49.35
MissFortune,Ashe,10818,5599,5219,51.76
MissFortune,Corki,1759,949,810,53.95
MissFortune,Shen,3137,1650,1487,52.6
MissFortune,Samira,4040,2031,2009,50.27
MissFortune,Soraka,2527,1297,1230,51.33
MissFortune,Sylas,6088,3240,2848,53.22
MissFortune,Amumu,4987,2371,2616,47.54
MissFortune,Vex,2734,1348,1386,49.31
MissFortune,Rakan,2005,1069,936,53.32
MissFortune,Gwen,2595,1453,1142,55.99
MissFortune,Thresh,6133,3240,2893,52.83
MissFortune,Yuumi,3953,2009,1944,50.82
MissFortune,Karma,4632,2356,2276,50.86
MissFortune,Garen,7578,3727,3851,49.18
MissFortune,FiddleSticks,2347,1119,1228,47.68
MissFortune,Mordekaiser,7328,3555,3773,48.51
MissFortune,Lulu,5194,2577,2617,49.61
MissFortune,Veigar,5343,2616,2727,48.96
MissFortune,Nasus,3795,1891,1904,49.83
MissFortune,Khazix,2383,1340,1043,56.23
MissFortune,Aurora,3636,1910,1726,52.53
MissFortune,Viego,6279,3145,3134,50.09
MissFortune,Nocturne,5685,2804,2881,49.32
MissFortune,Jayce,1846,984,862,53.3
MissFortune,Sett,7677,3854,3823,50.2
MissFortune,Shyvana,1209,633,576,52.36
MissFortune,Fizz,3013,1640,1373,54.43
MissFortune,Nilah,2085,1033,1052,49.54
MissFortune,Nami,4438,2083,2355,46.94
MissFortune,LeeSin,6112,3160,2952,51.7
MissFortune,Evelynn,1883,956,927,50.77
MissFortune,Belveth,1088,534,554,49.08
MissFortune,Hwei,3070,1570,1500,51.14
MissFortune,TahmKench,4284,2249,2035,52.5
MissFortune,Orianna,1993,1001,992,50.23
MissFortune,Nautilus,5203,2834,2369,54.47
MissFortune,Ivern,730,416,314,56.99
MissFortune,Swain,4928,2347,2581,47.63
MissFortune,Kayle,3218,1592,1626,49.47
MissFortune,Katarina,3762,2141,1621,56.91
MissFortune,Gragas,2440,1311,1129,53.73
MissFortune,Teemo,6593,3227,3366,48.95
MissFortune,Morgana,6180,3014,3166,48.77
MissFortune,Briar,3844,1793,2051,46.64
MissFortune,RekSai,517,251,266,48.55
MissFortune,Braum,2911,1441,1470,49.5
MissFortune,Varus,4166,2164,2002,51.94
MissFortune,Janna,1338,668,670,49.93
MissFortune,Shaco,4256,2170,2086,50.99
MissFortune,Riven,1893,1050,843,55.47
MissFortune,Pantheon,7459,3776,3683,50.62
MissFortune,Zed,4840,2600,2240,53.72
MissFortune,MasterYi,6032,2985,3047,49.49
MissFortune,Trundle,2985,1395,1590,46.73
MissFortune,Malzahar,4899,2359,2540,48.15
MissFortune,Talon,2642,1395,1247,52.8
MissFortune,DrMundo,2788,1292,1496,46.34
MissFortune,Yorick,4898,2359,2539,48.16
MissFortune,Blitzcrank,3613,1853,1760,51.29
MissFortune,Smolder,3029,1617,1412,53.38
MissFortune,JarvanIV,2492,1287,1205,51.65
MissFortune,Rengar,1559,889,670,57.02
MissFortune,Vayne,5991,2950,3041,49.24
MissFortune,XinZhao,3010,1472,1538,48.9
MissFortune,Leona,3900,1974,1926,50.62
MissFortune,Vi,4385,2346,2039,53.5
MissFortune,Anivia,1501,743,758,49.5
MissFortune,Leblanc,2593,1391,1202,53.64
MissFortune,Maokai,2082,1013,1069,48.66
MissFortune,Mel,9834,5199,4635,52.87
MissFortune,Kalista,1576,821,755,52.09
MissFortune,Kennen,1386,797,589,57.5
MissFortune,Ekko,4211,2166,2045,51.44
MissFortune,Graves,2884,1444,1440,50.07
MissFortune,Zeri,1898,947,951,49.89
MissFortune,Taric,1008,510,498,50.6
MissFortune,Rumble,1129,550,579,48.72
MissFortune,Akshan,1654,799,855,48.31
MissFortune,Tryndamere,2793,1438,1355,51.49
MissFortune,Malphite,4885,2502,2383,51.22
MissFortune,Zoe,1803,1032,771,57.24
MissFortune,Heimerdinger,2684,1339,1345,49.89
MissFortune,Ambessa,2541,1311,1230,51.59
MissFortune,Rammus,1445,733,712,50.73
MissFortune,Seraphine,4413,2327,2086,52.73
MissFortune,Ziggs,1946,898,1048,46.15
MissFortune,Karthus,1262,679,583,53.8
MissFortune,AurelionSol,2126,998,1128,46.94
MissFortune,Rell,2198,1173,1025,53.37
MissFortune,Xayah,2515,1335,1180,53.08
MissFortune,Lucian,3198,1677,1521,52.44
MissFortune,Singed,1190,504,686,42.35
MissFortune,Draven,2570,1302,1268,50.66
MissFortune,Lillia,2861,1471,1390,51.42
MissFortune,Illaoi,2591,1281,1310,49.44
MissFortune,Hecarim,1712,891,821,52.04
MissFortune,Tristana,5660,2978,2682,52.61
MissFortune,Aphelios,2509,1280,1229,51.02
MissFortune,TwistedFate,1585,824,761,51.99
MissFortune,Viktor,3554,1813,1741,51.01
MissFortune,Olaf,1064,599,465,56.3
MissFortune,Nunu,3122,1578,1544,50.54
MissFortune,Camille,1504,789,715,52.46
MissFortune,Kled,783,388,395,49.55
MissFortune,Poppy,2597,1276,1321,49.13
MissFortune,Skarner,1241,716,525,57.7
MissFortune,Xerath,4018,1918,2100,47.74
MissFortune,Elise,2990,1697,1293,56.76
MissFortune,Quinn,1671,825,846,49.37
MissFortune,Kassadin,919,407,512,44.29
MissFortune,Annie,1424,718,706,50.42
MissFortune,Ryze,1456,736,720,50.55
MissFortune,Zyra,4225,2078,2147,49.18
MissFortune,Sivir,2654,1314,1340,49.51
MissFortune,KogMaw,1490,712,778,47.79
MissFortune,Sion,3476,1618,1858,46.55
MissFortune,Naafiri,1740,886,854,50.92
MissFortune,Velkoz,2883,1317,1566,45.68
MissFortune,Zilean,1370,697,673,50.88
MissFortune,Kindred,2225,1131,1094,50.83
MissFortune,Syndra,2615,1346,1269,51.47
MissFortune,Qiyana,1186,668,518,56.32
MissFortune,Renekton,2189,1129,1060,51.58
MissFortune,Bard,1257,622,635,49.48
MissFortune,Alistar,1721,909,812,52.82
MissFortune,Taliyah,970,443,527,45.67
MissFortune,Azir,1520,809,711,53.22
MissFortune,Renata,899,474,425,52.73
MissFortune,Lissandra,1413,722,691,51.1
Neeko,MonkeyKing,662,315,347,47.58
Neeko,Kayn,1669,783,886,46.91
Neeko,Yasuo,2144,1002,1142,46.74
Neeko,Kaisa,1516,804,712,53.03
Neeko,Milio,564,277,287,49.11
Neeko,Irelia,1035,500,535,48.31
Neeko,Zed,1101,576,525,52.32
Neeko,Galio,942,405,537,42.99
Neeko,MissFortune,2948,1336,1612,45.32
Neeko,TahmKench,1016,492,524,48.43
Neeko,Yone,2224,1157,1067,52.02
Neeko,Shaco,986,521,465,52.84
Neeko,AurelionSol,475,198,277,41.68
Neeko,Ashe,2235,1071,1164,47.92
Neeko,Velkoz,650,262,388,40.31
Neeko,Fiora,422,216,206,51.18
Neeko,MasterYi,1477,731,746,49.49
Neeko,Mel,2381,1132,1249,47.54
Neeko,Jhin,2171,1029,1142,47.4
Neeko,Karma,1076,577,499,53.62
Neeko,Gwen,638,324,314,50.78
Neeko,JarvanIV,439,196,243,44.65
Neeko,Zyra,1107,491,616,44.35
Neeko,Seraphine,1226,572,654,46.66
Neeko,Garen,1786,818,968,45.8
Neeko,Lux,3287,1513,1774,46.03
Neeko,Caitlyn,3004,1506,1498,50.13
Neeko,Thresh,1489,779,710,52.32
Neeko,Riven,464,237,227,51.08
Neeko,Amumu,1263,585,678,46.32
Neeko,Zoe,485,218,267,44.95
Neeko,Sona,385,167,218,43.38
Neeko,Akali,1225,610,615,49.8
Neeko,Rammus,325,148,177,45.54
Neeko,Jinx,2731,1322,1409,48.41
Neeko,Mordekaiser,1636,854,782,52.2
Neeko,Diana,1673,791,882,47.28
Neeko,Ahri,1604,800,804,49.88
Neeko,Twitch,800,379,421,47.38
Neeko,Lulu,1095,538,557,49.13
Neeko,Gnar,458,244,214,53.28
Neeko,Leblanc,615,297,318,48.29
Neeko,Pyke,1096,610,486,55.66
Neeko,Varus,1015,499,516,49.16
Neeko,Chogath,1322,601,721,45.46
Neeko,Poppy,663,305,358,46
Neeko,Illaoi,574,253,321,44.08
Neeko,Khazix,636,320,316,50.31
Neeko,Syndra,621,275,346,44.28
Neeko,Udyr,397,161,236,40.55
Neeko,Yorick,1095,468,627,42.74
Neeko,Jax,1028,512,516,49.81
Neeko,Naafiri,426,223,203,52.35
Neeko,Tristana,1058,586,472,55.39
Neeko,Rakan,528,254,274,48.11
Neeko,Karthus,308,123,185,39.94
Neeko,Nilah,454,210,244,46.26
Neeko,Braum,537,233,304,43.39
Neeko,Sion,841,364,477,43.28
Neeko,FiddleSticks,469,222,247,47.33
Neeko,Ezreal,2323,1246,1077,53.64
Neeko,Zilean,332,128,204,38.55
Neeko,Trundle,617,305,312,49.43
Neeko,Nocturne,1256,580,676,46.18
Neeko,Orianna,495,223,272,45.05
Neeko,Veigar,1214,598,616,49.26
Neeko,Brand,976,470,506,48.16
Neeko,Cassiopeia,429,186,243,43.36
Neeko,Pantheon,1920,982,938,51.15
Neeko,Swain,1215,511,704,42.06
Neeko,Gragas,615,320,295,52.03
Neeko,LeeSin,1355,715,640,52.77
Neeko,Kayle,696,304,392,43.68
Neeko,Morgana,1563,805,758,51.5
Neeko,Sejuani,411,194,217,47.2
Neeko,Smolder,625,282,343,45.12
Neeko,Rengar,390,231,159,59.23
Neeko,Hwei,825,396,429,48
Neeko,Singed,275,126,149,45.82
Neeko,Yuumi,843,432,411,51.25
Neeko,Blitzcrank,830,460,370,55.42
Neeko,Warwick,1740,841,899,48.33
Neeko,Briar,860,414,446,48.14
Neeko,Senna,871,424,447,48.68
Neeko,Urgot,613,240,373,39.15
Neeko,Annie,327,150,177,45.87
Neeko,Graves,709,359,350,50.63
Neeko,Zeri,518,233,285,44.98
Neeko,Taric,228,91,137,39.91
Neeko,DrMundo,607,294,313,48.43
Neeko,Samira,993,493,500,49.65
Neeko,Kennen,430,187,243,43.49
Neeko,Katarina,834,449,385,53.84
Neeko,Soraka,602,300,302,49.83
Neeko,Ambessa,671,375,296,55.89
Neeko,Darius,2117,951,1166,44.92
Neeko,Viego,1556,763,793,49.04
Neeko,Sylas,1492,730,762,48.93
Neeko,Nami,1039,505,534,48.6
Neeko,Aphelios,626,282,344,45.05
Neeko,Lissandra,405,190,215,46.91
Neeko,Vladimir,611,302,309,49.43
Neeko,Corki,385,210,175,54.55
Neeko,Ziggs,378,160,218,42.33
Neeko,Aatrox,1048,532,516,50.76
Neeko,Xayah,638,269,369,42.16
Neeko,Skarner,338,194,144,57.4
Neeko,Xerath,909,384,525,42.24
Neeko,Zac,426,175,251,41.08
Neeko,Renekton,529,265,264,50.09
Neeko,Sett,1760,798,962,45.34
Neeko,KogMaw,373,156,217,41.82
Neeko,Janna,365,171,194,46.85
Neeko,Talon,708,325,383,45.9
Neeko,Lillia,658,322,336,48.94
Neeko,Hecarim,447,229,218,51.23
Neeko,Malzahar,987,452,535,45.8
Neeko,Fizz,625,296,329,47.36
Neeko,Kalista,382,201,181,52.62
Neeko,Vi,1036,532,504,51.35
Neeko,Teemo,1635,743,892,45.44
Neeko,Aurora,1009,487,522,48.27
Neeko,Rell,533,232,301,43.53
Neeko,Nasus,888,387,501,43.58
Neeko,Draven,584,310,274,53.08
Neeko,Renata,270,124,146,45.93
Neeko,Lucian,753,386,367,51.26
Neeko,Vex,670,327,343,48.81
Neeko,Ryze,289,154,135,53.29
Neeko,Olaf,312,159,153,50.96
Neeko,Vayne,1303,573,730,43.98
Neeko,Ekko,881,427,454,48.47
Neeko,Nunu,821,397,424,48.36
Neeko,Evelynn,484,217,267,44.83
Neeko,Malphite,1022,516,506,50.49
Neeko,Alistar,411,180,231,43.8
Neeko,Camille,350,191,159,54.57
Neeko,Leona,841,444,397,52.79
Neeko,Shen,676,327,349,48.37
Neeko,Nautilus,1224,583,641,47.63
Neeko,Sivir,582,258,324,44.33
Neeko,Nidalee,355,192,163,54.08
Neeko,Kassadin,231,112,119,48.48
Neeko,Maokai,592,317,275,53.55
Neeko,Volibear,1281,587,694,45.82
Neeko,Taliyah,256,108,148,42.19
Neeko,Elise,795,382,413,48.05
Neeko,Bard,278,161,117,57.91
Neeko,Heimerdinger,668,290,378,43.41
Neeko,Viktor,877,431,446,49.14
Neeko,Jayce,518,301,217,58.11
Neeko,Gangplank,574,308,266,53.66
Neeko,Akshan,403,172,231,42.68
Neeko,Kindred,537,281,256,52.33
Neeko,TwistedFate,373,182,191,48.79
Neeko,Rumble,205,108,97,52.68
Neeko,Azir,357,178,179,49.86
Neeko,Ornn,424,195,229,45.99
Neeko,Ivern,175,78,97,44.57
Neeko,Belveth,216,93,123,43.06
Neeko,RekSai,146,76,70,52.05
Neeko,Tryndamere,642,311,331,48.44
Neeko,Kled,178,100,78,56.18
Neeko,Anivia,341,151,190,44.28
Neeko,Shyvana,311,157,154,50.48
Neeko,Qiyana,251,147,104,58.57
Neeko,Quinn,407,181,226,44.47
Neeko,KSante,525,242,283,46.1
Neeko,XinZhao,743,357,386,48.05
FiddleSticks,Gangplank,505,292,213,57.82
FiddleSticks,MasterYi,1269,654,615,51.54
FiddleSticks,Veigar,1044,535,509,51.25
FiddleSticks,Mel,2185,1080,1105,49.43
FiddleSticks,Swain,1087,510,577,46.92
FiddleSticks,Samira,771,441,330,57.2
FiddleSticks,Kayn,1707,896,811,52.49
FiddleSticks,Sylas,1649,834,815,50.58
FiddleSticks,Nilah,407,221,186,54.3
FiddleSticks,Leona,873,436,437,49.94
FiddleSticks,Pantheon,1761,878,883,49.86
FiddleSticks,Leblanc,605,298,307,49.26
FiddleSticks,Sivir,614,333,281,54.23
FiddleSticks,Pyke,960,480,480,50
FiddleSticks,Yorick,871,415,456,47.65
FiddleSticks,Viego,1367,742,625,54.28
FiddleSticks,Malphite,998,528,470,52.91
FiddleSticks,Kaisa,1723,942,781,54.67
FiddleSticks,Rell,529,255,274,48.2
FiddleSticks,Karthus,371,202,169,54.45
FiddleSticks,Aurora,913,497,416,54.44
FiddleSticks,Ezreal,2385,1311,1074,54.97
FiddleSticks,Senna,804,371,433,46.14
FiddleSticks,DrMundo,665,307,358,46.17
FiddleSticks,Ivern,166,72,94,43.37
FiddleSticks,Mordekaiser,1422,648,774,45.57
FiddleSticks,Yuumi,1073,533,540,49.67
FiddleSticks,Aatrox,1060,517,543,48.77
FiddleSticks,Khazix,662,304,358,45.92
FiddleSticks,Qiyana,279,138,141,49.46
FiddleSticks,MissFortune,2347,1228,1119,52.32
FiddleSticks,Nautilus,1231,617,614,50.12
FiddleSticks,Darius,1957,1013,944,51.76
FiddleSticks,Poppy,632,356,276,56.33
FiddleSticks,Kindred,542,249,293,45.94
FiddleSticks,Warwick,1477,735,742,49.76
FiddleSticks,Aphelios,666,332,334,49.85
FiddleSticks,KSante,569,336,233,59.05
FiddleSticks,Vex,635,339,296,53.39
FiddleSticks,Jinx,2768,1269,1499,45.85
FiddleSticks,Tryndamere,602,313,289,51.99
FiddleSticks,Amumu,1129,593,536,52.52
FiddleSticks,Seraphine,957,537,420,56.11
FiddleSticks,Udyr,425,213,212,50.12
FiddleSticks,Jhin,2108,1061,1047,50.33
FiddleSticks,Evelynn,354,197,157,55.65
FiddleSticks,XinZhao,759,387,372,50.99
FiddleSticks,Morgana,1348,696,652,51.63
FiddleSticks,Ashe,2176,1129,1047,51.88
FiddleSticks,Braum,634,346,288,54.57
FiddleSticks,Riven,568,311,257,54.75
FiddleSticks,Sejuani,479,236,243,49.27
FiddleSticks,AurelionSol,395,175,220,44.3
FiddleSticks,Tristana,994,480,514,48.29
FiddleSticks,Rakan,466,263,203,56.44
FiddleSticks,Jax,906,474,432,52.32
FiddleSticks,Naafiri,384,198,186,51.56
FiddleSticks,Irelia,850,407,443,47.88
FiddleSticks,Neeko,469,247,222,52.67
FiddleSticks,Yone,1938,1074,864,55.42
FiddleSticks,Nocturne,1260,608,652,48.25
FiddleSticks,Lucian,760,384,376,50.53
FiddleSticks,Yasuo,2090,1087,1003,52.01
FiddleSticks,Nami,1082,561,521,51.85
FiddleSticks,Renekton,445,243,202,54.61
FiddleSticks,Malzahar,993,397,596,39.98
FiddleSticks,Lux,2578,1260,1318,48.88
FiddleSticks,Quinn,397,199,198,50.13
FiddleSticks,Cassiopeia,308,138,170,44.81
FiddleSticks,Varus,838,400,438,47.73
FiddleSticks,Janna,416,228,188,54.81
FiddleSticks,Rengar,353,228,125,64.59
FiddleSticks,Anivia,325,192,133,59.08
FiddleSticks,Xayah,653,329,324,50.38
FiddleSticks,Galio,973,496,477,50.98
FiddleSticks,Ekko,999,528,471,52.85
FiddleSticks,Zed,1149,655,494,57.01
FiddleSticks,Caitlyn,2758,1311,1447,47.53
FiddleSticks,Lulu,1389,720,669,51.84
FiddleSticks,Akali,1084,588,496,54.24
FiddleSticks,Ziggs,354,151,203,42.66
FiddleSticks,Volibear,1163,541,622,46.52
FiddleSticks,Hwei,709,352,357,49.65
FiddleSticks,Urgot,487,237,250,48.67
FiddleSticks,Twitch,909,419,490,46.09
FiddleSticks,Teemo,1421,780,641,54.89
FiddleSticks,Singed,297,127,170,42.76
FiddleSticks,Zeri,499,252,247,50.5
FiddleSticks,TwistedFate,352,182,170,51.7
FiddleSticks,Brand,720,331,389,45.97
FiddleSticks,Vladimir,724,392,332,54.14
FiddleSticks,Vi,939,466,473,49.63
FiddleSticks,Ahri,1334,648,686,48.58
FiddleSticks,Milio,659,312,347,47.34
FiddleSticks,Chogath,1325,610,715,46.04
FiddleSticks,TahmKench,896,488,408,54.46
FiddleSticks,Gwen,538,295,243,54.83
FiddleSticks,Elise,772,373,399,48.32
FiddleSticks,Kennen,328,158,170,48.17
FiddleSticks,Shaco,1057,535,522,50.61
FiddleSticks,Hecarim,482,239,243,49.59
FiddleSticks,Garen,1640,777,863,47.38
FiddleSticks,Ryze,349,176,173,50.43
FiddleSticks,Blitzcrank,793,377,416,47.54
FiddleSticks,Rammus,303,179,124,59.08
FiddleSticks,Velkoz,575,290,285,50.43
FiddleSticks,Sett,1627,769,858,47.26
FiddleSticks,Karma,1236,618,618,50
FiddleSticks,Shen,660,312,348,47.27
FiddleSticks,LeeSin,1463,744,719,50.85
FiddleSticks,Syndra,656,316,340,48.17
FiddleSticks,Zyra,951,477,474,50.16
FiddleSticks,Maokai,478,229,249,47.91
FiddleSticks,Gragas,638,344,294,53.92
FiddleSticks,Thresh,1484,702,782,47.3
FiddleSticks,Katarina,760,372,388,48.95
FiddleSticks,Nasus,843,432,411,51.25
FiddleSticks,Xerath,831,398,433,47.89
FiddleSticks,Graves,704,375,329,53.27
FiddleSticks,Illaoi,534,277,257,51.87
FiddleSticks,Vayne,1261,660,601,52.34
FiddleSticks,Trundle,628,348,280,55.41
FiddleSticks,Camille,446,224,222,50.22
FiddleSticks,Azir,394,219,175,55.58
FiddleSticks,Kalista,276,160,116,57.97
FiddleSticks,Lillia,663,327,336,49.32
FiddleSticks,Nunu,713,394,319,55.26
FiddleSticks,Sona,364,175,189,48.08
FiddleSticks,Taric,228,90,138,39.47
FiddleSticks,Viktor,883,437,446,49.49
FiddleSticks,Nidalee,310,166,144,53.55
FiddleSticks,Soraka,580,310,270,53.45
FiddleSticks,Diana,1704,842,862,49.41
FiddleSticks,Zac,600,319,281,53.17
FiddleSticks,Corki,397,205,192,51.64
FiddleSticks,Heimerdinger,500,227,273,45.4
FiddleSticks,Akshan,347,197,150,56.77
FiddleSticks,Taliyah,270,120,150,44.44
FiddleSticks,Kayle,694,344,350,49.57
FiddleSticks,Orianna,523,287,236,54.88
FiddleSticks,Briar,806,338,468,41.94
FiddleSticks,Ambessa,681,348,333,51.1
FiddleSticks,MonkeyKing,705,354,351,50.21
FiddleSticks,Shyvana,248,114,134,45.97
FiddleSticks,Alistar,403,221,182,54.84
FiddleSticks,Smolder,727,402,325,55.3
FiddleSticks,Gnar,453,232,221,51.21
FiddleSticks,Renata,231,132,99,57.14
FiddleSticks,KogMaw,438,229,209,52.28
FiddleSticks,Ornn,475,206,269,43.37
FiddleSticks,Sion,841,410,431,48.75
FiddleSticks,Rumble,304,191,113,62.83
FiddleSticks,Zoe,390,213,177,54.62
FiddleSticks,Kled,210,107,103,50.95
FiddleSticks,Lissandra,313,129,184,41.21
FiddleSticks,Skarner,327,143,184,43.73
FiddleSticks,Fizz,589,337,252,57.22
FiddleSticks,Belveth,316,164,152,51.9
FiddleSticks,Draven,501,264,237,52.69
FiddleSticks,Talon,649,360,289,55.47
FiddleSticks,Kassadin,266,120,146,45.11
FiddleSticks,Bard,368,189,179,51.36
FiddleSticks,RekSai,137,80,57,58.39
FiddleSticks,Fiora,403,204,199,50.62
FiddleSticks,Zilean,338,167,171,49.41
FiddleSticks,JarvanIV,640,320,320,50
FiddleSticks,Annie,357,202,155,56.58
FiddleSticks,Olaf,312,135,177,43.27
FiddleSticks,Jayce,541,268,273,49.54
Smolder,Gangplank,638,286,352,44.83
Smolder,MasterYi,1721,741,980,43.06
Smolder,Veigar,1536,684,852,44.53
Smolder,Mel,3032,1504,1528,49.6
Smolder,Swain,1504,684,820,45.48
Smolder,Mordekaiser,1876,831,1045,44.3
Smolder,Amumu,1489,684,805,45.94
Smolder,Sylas,1750,853,897,48.74
Smolder,Xayah,707,359,348,50.78
Smolder,Ashe,2583,1206,1377,46.69
Smolder,Renekton,719,333,386,46.31
Smolder,Kayn,2040,981,1059,48.09
Smolder,Vex,691,347,344,50.22
Smolder,Samira,1146,596,550,52.01
Smolder,Lulu,1752,761,991,43.44
Smolder,Teemo,1868,885,983,47.38
Smolder,Briar,1053,444,609,42.17
Smolder,Aurora,1038,501,537,48.27
Smolder,Kaisa,2281,1191,1090,52.21
Smolder,Karma,1522,681,841,44.74
Smolder,KSante,755,373,382,49.4
Smolder,Darius,2845,1377,1468,48.4
Smolder,Azir,542,251,291,46.31
Smolder,Aphelios,970,489,481,50.41
Smolder,Soraka,777,383,394,49.29
Smolder,Yone,2752,1351,1401,49.09
Smolder,Nilah,557,234,323,42.01
Smolder,Irelia,1143,519,624,45.41
Smolder,Nocturne,1669,744,925,44.58
Smolder,Jayce,647,320,327,49.46
Smolder,Jhin,3016,1405,1611,46.58
Smolder,Senna,1024,468,556,45.7
Smolder,Tryndamere,735,340,395,46.26
Smolder,Zyra,1091,528,563,48.4
Smolder,TahmKench,1284,667,617,51.95
Smolder,Aatrox,1326,611,715,46.08
Smolder,Belveth,337,167,170,49.55
Smolder,Hwei,923,464,459,50.27
Smolder,Jinx,3899,1786,2113,45.81
Smolder,Kayle,1108,509,599,45.94
Smolder,Akali,1314,655,659,49.85
Smolder,Yasuo,2799,1351,1448,48.27
Smolder,Warwick,2030,937,1093,46.16
Smolder,Malzahar,1888,952,936,50.42
Smolder,Tristana,1430,731,699,51.12
Smolder,Sejuani,604,358,246,59.27
Smolder,Ahri,1859,947,912,50.94
Smolder,Caitlyn,4043,1914,2129,47.34
Smolder,Lux,3502,1694,1808,48.37
Smolder,Maokai,662,354,308,53.47
Smolder,Corki,486,227,259,46.71
Smolder,Taric,346,152,194,43.93
Smolder,Singed,401,158,243,39.4
Smolder,Viego,1853,919,934,49.6
Smolder,Vayne,1825,856,969,46.9
Smolder,MissFortune,3029,1412,1617,46.62
Smolder,Leona,1223,594,629,48.57
Smolder,Ambessa,909,443,466,48.73
Smolder,Varus,1248,612,636,49.04
Smolder,Graves,964,471,493,48.86
Smolder,Neeko,625,343,282,54.88
Smolder,Nasus,1088,520,568,47.79
Smolder,Thresh,2004,960,1044,47.9
Smolder,Rammus,433,203,230,46.88
Smolder,Yuumi,1301,581,720,44.66
Smolder,LeeSin,1937,922,1015,47.6
Smolder,Sona,420,197,223,46.9
Smolder,Anivia,465,223,242,47.96
Smolder,Braum,761,386,375,50.72
Smolder,DrMundo,882,431,451,48.87
Smolder,Nunu,774,408,366,52.71
Smolder,Malphite,1544,710,834,45.98
Smolder,Pyke,1324,656,668,49.55
Smolder,Skarner,421,225,196,53.44
Smolder,Ezreal,3397,1713,1684,50.43
Smolder,Seraphine,1151,527,624,45.79
Smolder,Draven,761,361,400,47.44
Smolder,Yorick,1444,636,808,44.04
Smolder,Vi,1318,672,646,50.99
Smolder,Katarina,1155,610,545,52.81
Smolder,Nautilus,1656,816,840,49.28
Smolder,Ziggs,537,235,302,43.76
Smolder,Sion,1211,608,603,50.21
Smolder,Gragas,939,469,470,49.95
Smolder,MonkeyKing,934,404,530,43.25
Smolder,Akshan,500,218,282,43.6
Smolder,Sett,2219,1026,1193,46.24
Smolder,Shaco,1396,719,677,51.5
Smolder,KogMaw,455,211,244,46.37
Smolder,Milio,864,396,468,45.83
Smolder,Vladimir,848,416,432,49.06
Smolder,Gnar,597,286,311,47.91
Smolder,Chogath,1842,934,908,50.71
Smolder,Illaoi,660,343,317,51.97
Smolder,Fizz,826,390,436,47.22
Smolder,Lucian,916,450,466,49.13
Smolder,Urgot,772,338,434,43.78
Smolder,Zed,1563,752,811,48.11
Smolder,Alistar,613,319,294,52.04
Smolder,Evelynn,524,243,281,46.37
Smolder,Heimerdinger,678,301,377,44.4
Smolder,Morgana,1673,785,888,46.92
Smolder,Garen,2158,1042,1116,48.29
Smolder,Trundle,823,416,407,50.55
Smolder,Velkoz,788,378,410,47.97
Smolder,Kled,223,88,135,39.46
Smolder,Ekko,1249,616,633,49.32
Smolder,Sivir,744,382,362,51.34
Smolder,Rengar,528,293,235,55.49
Smolder,Galio,1355,591,764,43.62
Smolder,Ivern,276,173,103,62.68
Smolder,Shen,981,464,517,47.3
Smolder,Cassiopeia,454,228,226,50.22
Smolder,Rell,792,429,363,54.17
Smolder,Diana,2349,1163,1186,49.51
Smolder,Talon,822,399,423,48.54
Smolder,Blitzcrank,982,502,480,51.12
Smolder,Lissandra,398,194,204,48.74
Smolder,Fiora,483,248,235,51.35
Smolder,Gwen,769,394,375,51.24
Smolder,Viktor,1274,580,694,45.53
Smolder,Leblanc,834,471,363,56.47
Smolder,Ornn,651,314,337,48.23
Smolder,Jax,1303,641,662,49.19
Smolder,Zoe,495,217,278,43.84
Smolder,Camille,503,270,233,53.68
Smolder,Taliyah,354,177,177,50
Smolder,Zeri,715,341,374,47.69
Smolder,Elise,937,461,476,49.2
Smolder,Twitch,1231,571,660,46.39
Smolder,XinZhao,952,415,537,43.59
Smolder,Lillia,862,426,436,49.42
Smolder,Rakan,718,378,340,52.65
Smolder,Khazix,797,404,393,50.69
Smolder,Kennen,455,255,200,56.04
Smolder,Kalista,589,329,260,55.86
Smolder,Karthus,375,202,173,53.87
Smolder,Nami,1549,765,784,49.39
Smolder,Pantheon,2328,1077,1251,46.26
Smolder,FiddleSticks,727,325,402,44.7
Smolder,Annie,414,205,209,49.52
Smolder,Quinn,520,219,301,42.12
Smolder,Riven,580,282,298,48.62
Smolder,Renata,359,151,208,42.06
Smolder,Kindred,633,329,304,51.97
Smolder,Syndra,879,441,438,50.17
Smolder,Naafiri,544,265,279,48.71
Smolder,Volibear,1523,746,777,48.98
Smolder,Xerath,1207,563,644,46.64
Smolder,Zac,725,388,337,53.52
Smolder,Bard,428,179,249,41.82
Smolder,Nidalee,393,203,190,51.65
Smolder,Zilean,467,214,253,45.82
Smolder,JarvanIV,869,434,435,49.94
Smolder,Poppy,785,442,343,56.31
Smolder,Ryze,453,198,255,43.71
Smolder,Udyr,502,227,275,45.22
Smolder,Shyvana,449,247,202,55.01
Smolder,AurelionSol,597,252,345,42.21
Smolder,Orianna,522,244,278,46.74
Smolder,Olaf,377,177,200,46.95
Smolder,Brand,1057,503,554,47.59
Smolder,Hecarim,644,338,306,52.48
Smolder,TwistedFate,534,253,281,47.38
Smolder,Janna,447,217,230,48.55
Smolder,Qiyana,354,170,184,48.02
Smolder,RekSai,205,99,106,48.29
Smolder,Rumble,350,168,182,48
Smolder,Kassadin,331,154,177,46.53
Nautilus,Gangplank,1163,589,574,50.64
Nautilus,MasterYi,2917,1523,1394,52.21
Nautilus,Veigar,2462,1171,1291,47.56
Nautilus,Mel,4943,2601,2342,52.62
Nautilus,Swain,2505,1069,1436,42.67
Nautilus,Illaoi,1130,557,573,49.29
Nautilus,MonkeyKing,1515,697,818,46.01
Nautilus,Yone,4436,2259,2177,50.92
Nautilus,Tristana,2266,1211,1055,53.44
Nautilus,Morgana,2911,1413,1498,48.54
Nautilus,Ivern,404,201,203,49.75
Nautilus,Jhin,4506,2215,2291,49.16
Nautilus,Mordekaiser,3097,1467,1630,47.37
Nautilus,Amumu,2741,1225,1516,44.69
Nautilus,Sylas,3479,1702,1777,48.92
Nautilus,Xayah,1552,681,871,43.88
Nautilus,Ashe,4673,2436,2237,52.13
Nautilus,Urgot,1191,529,662,44.42
Nautilus,Rengar,735,403,332,54.83
Nautilus,Ziggs,966,484,482,50.1
Nautilus,Trundle,1296,566,730,43.67
Nautilus,Fiora,1105,561,544,50.77
Nautilus,Poppy,1761,813,948,46.17
Nautilus,Diana,3648,1791,1857,49.1
Nautilus,Anivia,817,353,464,43.21
Nautilus,Caitlyn,6165,3233,2932,52.44
Nautilus,Thresh,3820,1888,1932,49.42
Nautilus,Galio,2249,1068,1181,47.49
Nautilus,Ezreal,5963,3094,2869,51.89
Nautilus,Chogath,2881,1378,1503,47.83
Nautilus,KSante,1304,696,608,53.37
Nautilus,Warwick,3514,1617,1897,46.02
Nautilus,Corki,936,471,465,50.32
Nautilus,Garen,3844,1918,1926,49.9
Nautilus,FiddleSticks,1231,614,617,49.88
Nautilus,Lux,5924,2907,3017,49.07
Nautilus,Brand,1802,806,996,44.73
Nautilus,Kayn,3298,1545,1753,46.85
Nautilus,Taliyah,664,291,373,43.83
Nautilus,Sivir,1352,555,797,41.05
Nautilus,Soraka,1271,592,679,46.58
Nautilus,Sion,1794,860,934,47.94
Nautilus,AurelionSol,974,475,499,48.77
Nautilus,Nami,2125,955,1170,44.94
Nautilus,Zac,1228,582,646,47.39
Nautilus,Nunu,1461,756,705,51.75
Nautilus,Kaisa,3697,1949,1748,52.72
Nautilus,Shen,1556,737,819,47.37
Nautilus,Riven,1048,538,510,51.34
Nautilus,Vi,2220,1070,1150,48.2
Nautilus,MissFortune,5203,2369,2834,45.53
Nautilus,Ambessa,1504,796,708,52.93
Nautilus,Yuumi,2101,1112,989,52.93
Nautilus,Qiyana,645,351,294,54.42
Nautilus,LeeSin,3578,1855,1723,51.84
Nautilus,Quinn,655,319,336,48.7
Nautilus,Talon,1377,737,640,53.52
Nautilus,Syndra,1553,783,770,50.42
Nautilus,Sett,3647,1728,1919,47.38
Nautilus,DrMundo,1307,603,704,46.14
Nautilus,Shaco,2012,992,1020,49.3
Nautilus,Viktor,2121,1008,1113,47.52
Nautilus,Rammus,761,345,416,45.34
Nautilus,Katarina,1743,912,831,52.32
Nautilus,Milio,1389,581,808,41.83
Nautilus,Teemo,2984,1358,1626,45.51
Nautilus,Ahri,3146,1525,1621,48.47
Nautilus,Senna,1901,933,968,49.08
Nautilus,Ekko,1974,938,1036,47.52
Nautilus,Aphelios,1398,642,756,45.92
Nautilus,Nasus,1645,748,897,45.47
Nautilus,Zilean,685,284,401,41.46
Nautilus,Volibear,2481,1159,1322,46.72
Nautilus,XinZhao,1543,821,722,53.21
Nautilus,Leona,2318,1118,1200,48.23
Nautilus,Yasuo,4458,2182,2276,48.95
Nautilus,Jinx,6120,2784,3336,45.49
Nautilus,Karma,2599,1336,1263,51.4
Nautilus,Braum,1993,913,1080,45.81
Nautilus,Skarner,857,401,456,46.79
Nautilus,Viego,3502,1804,1698,51.51
Nautilus,Irelia,2055,1026,1029,49.93
Nautilus,Zeri,1118,548,570,49.02
Nautilus,Alistar,1425,714,711,50.11
Nautilus,Akali,2389,1176,1213,49.23
Nautilus,Pantheon,3819,1875,1944,49.1
Nautilus,Vex,1390,701,689,50.43
Nautilus,Gragas,1553,737,816,47.46
Nautilus,Lulu,3035,1473,1562,48.53
Nautilus,Malphite,2401,1157,1244,48.19
Nautilus,Samira,1618,786,832,48.58
Nautilus,Blitzcrank,1985,1090,895,54.91
Nautilus,Hwei,1614,764,850,47.34
Nautilus,Darius,4449,2127,2322,47.81
Nautilus,Malzahar,2266,1049,1217,46.29
Nautilus,Sona,639,279,360,43.66
Nautilus,Zed,2483,1285,1198,51.75
Nautilus,Heimerdinger,1060,519,541,48.96
Nautilus,Udyr,937,507,430,54.11
Nautilus,Aatrox,2261,1155,1106,51.08
Nautilus,Akshan,747,398,349,53.28
Nautilus,Zyra,1877,894,983,47.63
Nautilus,KogMaw,745,305,440,40.94
Nautilus,Zoe,931,528,403,56.71
Nautilus,RekSai,246,123,123,50
Nautilus,Twitch,1765,884,881,50.08
Nautilus,Yorick,2304,1082,1222,46.96
Nautilus,Kalista,753,364,389,48.34
Nautilus,JarvanIV,1404,644,760,45.87
Nautilus,Aurora,1862,963,899,51.72
Nautilus,TahmKench,2219,1109,1110,49.98
Nautilus,Kayle,1419,640,779,45.1
Nautilus,Kindred,1112,536,576,48.2
Nautilus,Jax,1983,1009,974,50.88
Nautilus,Xerath,2130,974,1156,45.73
Nautilus,Pyke,2351,1301,1050,55.34
Nautilus,Fizz,1280,636,644,49.69
Nautilus,Seraphine,1883,944,939,50.13
Nautilus,Renekton,1230,597,633,48.54
Nautilus,Leblanc,1377,722,655,52.43
Nautilus,Vayne,3220,1601,1619,49.72
Nautilus,Briar,1693,786,907,46.43
Nautilus,Orianna,1162,551,611,47.42
Nautilus,Draven,1269,690,579,54.37
Nautilus,Ornn,1097,485,612,44.21
Nautilus,Camille,819,451,368,55.07
Nautilus,Smolder,1656,840,816,50.72
Nautilus,Janna,779,403,376,51.73
Nautilus,Ryze,858,394,464,45.92
Nautilus,Lucian,1622,824,798,50.8
Nautilus,Singed,622,302,320,48.55
Nautilus,Elise,1599,779,820,48.72
Nautilus,Belveth,578,263,315,45.5
Nautilus,Maokai,1122,471,651,41.98
Nautilus,Cassiopeia,767,371,396,48.37
Nautilus,Velkoz,1443,660,783,45.74
Nautilus,Gnar,1034,483,551,46.71
Nautilus,Taric,727,314,413,43.19
Nautilus,Bard,668,320,348,47.9
Nautilus,Vladimir,1476,711,765,48.17
Nautilus,Khazix,1146,627,519,54.71
Nautilus,Renata,619,308,311,49.76
Nautilus,Varus,1979,979,1000,49.47
Nautilus,Graves,1663,859,804,51.65
Nautilus,Evelynn,848,466,382,54.95
Nautilus,Kassadin,506,253,253,50
Nautilus,Gwen,1334,669,665,50.15
Nautilus,Sejuani,1108,506,602,45.67
Nautilus,Kennen,623,338,285,54.25
Nautilus,Neeko,1224,641,583,52.37
Nautilus,Nocturne,2725,1275,1450,46.79
Nautilus,Rakan,1063,477,586,44.87
Nautilus,Naafiri,735,394,341,53.61
Nautilus,Hecarim,940,463,477,49.26
Nautilus,Karthus,665,325,340,48.87
Nautilus,Tryndamere,1312,683,629,52.06
Nautilus,TwistedFate,785,412,373,52.48
Nautilus,Lillia,1374,654,720,47.6
Nautilus,Nidalee,740,468,272,63.24
Nautilus,Annie,731,375,356,51.3
Nautilus,Nilah,870,358,512,41.15
Nautilus,Olaf,707,343,364,48.51
Nautilus,Azir,896,396,500,44.2
Nautilus,Rell,1427,692,735,48.49
Nautilus,Kled,451,227,224,50.33
Nautilus,Lissandra,772,360,412,46.63
Nautilus,Jayce,1152,606,546,52.6
Nautilus,Rumble,633,331,302,52.29
Nautilus,Shyvana,581,241,340,41.48
TahmKench,Gangplank,739,376,363,50.88
TahmKench,Brand,1572,733,839,46.63
TahmKench,Irelia,1514,779,735,51.45
TahmKench,Malzahar,1926,855,1071,44.39
TahmKench,Pyke,1716,901,815,52.51
TahmKench,Gnar,898,502,396,55.9
TahmKench,Jax,1472,721,751,48.98
TahmKench,Yasuo,3628,1674,1954,46.14
TahmKench,Caitlyn,4768,2267,2501,47.55
TahmKench,Neeko,1016,524,492,51.57
TahmKench,Vayne,2792,1250,1542,44.77
TahmKench,Nocturne,2105,1013,1092,48.12
TahmKench,Kaisa,2774,1369,1405,49.35
TahmKench,Galio,1413,638,775,45.15
TahmKench,Blitzcrank,1429,723,706,50.59
TahmKench,Volibear,2174,1000,1174,46
TahmKench,Ekko,1699,799,900,47.03
TahmKench,Yone,3343,1703,1640,50.94
TahmKench,Kalista,600,332,268,55.33
TahmKench,Tristana,1830,914,916,49.95
TahmKench,Poppy,1171,565,606,48.25
TahmKench,Veigar,2221,1097,1124,49.39
TahmKench,Heimerdinger,926,446,480,48.16
TahmKench,Ziggs,741,347,394,46.83
TahmKench,Naafiri,710,309,401,43.52
TahmKench,Nunu,1097,574,523,52.32
TahmKench,Zeri,716,342,374,47.77
TahmKench,Mordekaiser,2963,1410,1553,47.59
TahmKench,LeeSin,2204,1176,1028,53.36
TahmKench,Kayle,1132,562,570,49.65
TahmKench,Ezreal,3719,2008,1711,53.99
TahmKench,Morgana,2231,969,1262,43.43
TahmKench,TwistedFate,619,318,301,51.37
TahmKench,Nilah,695,351,344,50.5
TahmKench,Vi,1685,816,869,48.43
TahmKench,Ahri,2280,1154,1126,50.61
TahmKench,Darius,3812,1862,1950,48.85
TahmKench,Maokai,812,381,431,46.92
TahmKench,Yorick,1671,771,900,46.14
TahmKench,Pantheon,2947,1470,1477,49.88
TahmKench,Samira,1406,574,832,40.83
TahmKench,Nami,1788,854,934,47.76
TahmKench,Kennen,534,297,237,55.62
TahmKench,Rammus,479,260,219,54.28
TahmKench,Chogath,2592,1273,1319,49.11
TahmKench,Ivern,294,148,146,50.34
TahmKench,Lux,5226,2663,2563,50.96
TahmKench,Kayn,2632,1259,1373,47.83
TahmKench,Smolder,1284,617,667,48.05
TahmKench,Thresh,2602,1264,1338,48.58
TahmKench,Teemo,2210,1038,1172,46.97
TahmKench,Khazix,882,454,428,51.47
TahmKench,MissFortune,4284,2035,2249,47.5
TahmKench,Rell,1069,497,572,46.49
TahmKench,Aatrox,1722,820,902,47.62
TahmKench,Shaco,1521,709,812,46.61
TahmKench,Leblanc,759,401,358,52.83
TahmKench,Draven,912,460,452,50.44
TahmKench,Hwei,1293,645,648,49.88
TahmKench,Cassiopeia,588,260,328,44.22
TahmKench,Riven,717,368,349,51.32
TahmKench,Senna,1451,722,729,49.76
TahmKench,Jayce,711,382,329,53.73
TahmKench,Swain,1982,858,1124,43.29
TahmKench,Sion,1388,681,707,49.06
TahmKench,Gragas,1049,533,516,50.81
TahmKench,Zed,2016,1081,935,53.62
TahmKench,Jinx,4506,2216,2290,49.18
TahmKench,MasterYi,2332,1155,1177,49.53
TahmKench,Garen,2984,1423,1561,47.69
TahmKench,Sett,2971,1363,1608,45.88
TahmKench,Lucian,1325,758,567,57.21
TahmKench,Sona,589,305,284,51.78
TahmKench,Vex,893,421,472,47.14
TahmKench,Malphite,1783,940,843,52.72
TahmKench,Amumu,2004,862,1142,43.01
TahmKench,Ashe,3428,1713,1715,49.97
TahmKench,Velkoz,1157,558,599,48.23
TahmKench,Kindred,848,455,393,53.66
TahmKench,AurelionSol,802,364,438,45.39
TahmKench,Urgot,1048,500,548,47.71
TahmKench,Viego,2484,1202,1282,48.39
TahmKench,Katarina,1357,678,679,49.96
TahmKench,Elise,1188,638,550,53.7
TahmKench,Annie,581,259,322,44.58
TahmKench,Nasus,1362,627,735,46.04
TahmKench,Mel,3914,1968,1946,50.28
TahmKench,Rengar,673,367,306,54.53
TahmKench,Akali,1759,850,909,48.32
TahmKench,KSante,798,411,387,51.5
TahmKench,Sylas,2161,1078,1083,49.88
TahmKench,Trundle,1363,638,725,46.81
TahmKench,Akshan,691,320,371,46.31
TahmKench,Corki,640,358,282,55.94
TahmKench,Ornn,749,353,396,47.13
TahmKench,Zoe,631,310,321,49.13
TahmKench,DrMundo,1184,535,649,45.19
TahmKench,Viktor,1543,786,757,50.94
TahmKench,Lulu,1818,924,894,50.83
TahmKench,Vladimir,1041,543,498,52.16
TahmKench,Evelynn,771,389,382,50.45
TahmKench,Aurora,1371,724,647,52.81
TahmKench,Warwick,2890,1392,1498,48.17
TahmKench,FiddleSticks,896,408,488,45.54
TahmKench,Nautilus,2219,1110,1109,50.02
TahmKench,Yuumi,1380,740,640,53.62
TahmKench,Ryze,564,289,275,51.24
TahmKench,Twitch,1446,751,695,51.94
TahmKench,Xerath,1341,694,647,51.75
TahmKench,XinZhao,1063,535,528,50.33
TahmKench,JarvanIV,892,449,443,50.34
TahmKench,Zyra,1496,676,820,45.19
TahmKench,Sivir,877,410,467,46.75
TahmKench,Leona,1586,778,808,49.05
TahmKench,Karma,1752,814,938,46.46
TahmKench,Illaoi,1013,448,565,44.23
TahmKench,Jhin,3348,1576,1772,47.07
TahmKench,Aphelios,1006,484,522,48.11
TahmKench,Graves,1077,505,572,46.89
TahmKench,Briar,1560,735,825,47.12
TahmKench,Singed,502,218,284,43.43
TahmKench,Belveth,460,239,221,51.96
TahmKench,Janna,626,308,318,49.2
TahmKench,Zac,758,374,384,49.34
TahmKench,Bard,546,292,254,53.48
TahmKench,Diana,2721,1271,1450,46.71
TahmKench,Soraka,960,447,513,46.56
TahmKench,Ambessa,1066,511,555,47.94
TahmKench,Qiyana,438,232,206,52.97
TahmKench,Fiora,826,397,429,48.06
TahmKench,Varus,1545,782,763,50.61
TahmKench,Rakan,795,366,429,46.04
TahmKench,Azir,617,332,285,53.81
TahmKench,Tryndamere,1048,572,476,54.58
TahmKench,Milio,973,436,537,44.81
TahmKench,Hecarim,719,404,315,56.19
TahmKench,Udyr,676,333,343,49.26
TahmKench,Lillia,1176,552,624,46.94
TahmKench,Lissandra,569,291,278,51.14
TahmKench,Nidalee,499,267,232,53.51
TahmKench,Sejuani,757,370,387,48.88
TahmKench,Olaf,467,233,234,49.89
TahmKench,Camille,634,323,311,50.95
TahmKench,Kassadin,363,172,191,47.38
TahmKench,Syndra,1008,520,488,51.59
TahmKench,Seraphine,1576,752,824,47.72
TahmKench,Braum,1108,517,591,46.66
TahmKench,Xayah,924,461,463,49.89
TahmKench,Alistar,783,379,404,48.4
TahmKench,Gwen,1159,615,544,53.06
TahmKench,Skarner,483,256,227,53
TahmKench,Karthus,464,257,207,55.39
TahmKench,Talon,988,567,421,57.39
TahmKench,Taliyah,461,254,207,55.1
TahmKench,Shyvana,396,204,192,51.52
TahmKench,Fizz,972,494,478,50.82
TahmKench,KogMaw,628,342,286,54.46
TahmKench,Anivia,565,265,300,46.9
TahmKench,Renekton,832,377,455,45.31
TahmKench,Orianna,723,362,361,50.07
TahmKench,Shen,1141,514,627,45.05
TahmKench,RekSai,173,86,87,49.71
TahmKench,Quinn,585,277,308,47.35
TahmKench,Rumble,434,219,215,50.46
TahmKench,Zilean,496,261,235,52.62
TahmKench,Kled,318,121,197,38.05
TahmKench,Renata,362,189,173,52.21
TahmKench,MonkeyKing,1194,582,612,48.74
TahmKench,Taric,445,213,232,47.87
Aphelios,Gangplank,656,336,320,51.22
Aphelios,Brand,820,415,405,50.61
Aphelios,Irelia,1145,560,585,48.91
Aphelios,Malzahar,1317,615,702,46.7
Aphelios,Pyke,1098,577,521,52.55
Aphelios,Kayle,869,356,513,40.97
Aphelios,Viego,1592,832,760,52.26
Aphelios,Jinx,3793,1817,1976,47.9
Aphelios,Thresh,1753,872,881,49.74
Aphelios,Warwick,1808,810,998,44.8
Aphelios,Singed,329,167,162,50.76
Aphelios,Ryze,350,181,169,51.71
Aphelios,Samira,921,445,476,48.32
Aphelios,Soraka,763,362,401,47.44
Aphelios,Sett,1703,759,944,44.57
Aphelios,Volibear,1327,744,583,56.07
Aphelios,Ambessa,752,410,342,54.52
Aphelios,Smolder,970,481,489,49.59
Aphelios,Swain,1229,540,689,43.94
Aphelios,Malphite,1195,539,656,45.1
Aphelios,Sion,1105,484,621,43.8
Aphelios,Alistar,403,197,206,48.88
Aphelios,Jax,998,425,573,42.59
Aphelios,FiddleSticks,666,334,332,50.15
Aphelios,Heimerdinger,578,247,331,42.73
Aphelios,Ashe,2287,1108,1179,48.45
Aphelios,Fiora,521,258,263,49.52
Aphelios,Shaco,1055,520,535,49.29
Aphelios,Fizz,604,343,261,56.79
Aphelios,Tristana,1088,551,537,50.64
Aphelios,Rakan,544,267,277,49.08
Aphelios,Garen,1960,1070,890,54.59
Aphelios,Graves,751,355,396,47.27
Aphelios,Aurora,981,442,539,45.06
Aphelios,Nilah,538,270,268,50.19
Aphelios,Hwei,961,510,451,53.07
Aphelios,Talon,694,379,315,54.61
Aphelios,LeeSin,1719,892,827,51.89
Aphelios,Jhin,2478,1183,1295,47.74
Aphelios,Senna,1018,477,541,46.86
Aphelios,XinZhao,721,392,329,54.37
Aphelios,Nautilus,1398,756,642,54.08
Aphelios,Teemo,1537,656,881,42.68
Aphelios,Yasuo,2463,1174,1289,47.67
Aphelios,Rengar,408,225,183,55.15
Aphelios,Anivia,387,214,173,55.3
Aphelios,Xayah,583,343,240,58.83
Aphelios,Galio,931,452,479,48.55
Aphelios,Diana,1991,1006,985,50.53
Aphelios,Veigar,1221,559,662,45.78
Aphelios,Sejuani,515,266,249,51.65
Aphelios,Sylas,1522,810,712,53.22
Aphelios,Lux,2893,1352,1541,46.73
Aphelios,Tryndamere,620,315,305,50.81
Aphelios,MasterYi,1286,665,621,51.71
Aphelios,Orianna,615,298,317,48.46
Aphelios,Darius,2306,1177,1129,51.04
Aphelios,Caitlyn,3334,1692,1642,50.75
Aphelios,Sona,384,167,217,43.49
Aphelios,DrMundo,665,331,334,49.77
Aphelios,Mordekaiser,1739,861,878,49.51
Aphelios,Akali,1216,654,562,53.78
Aphelios,Lucian,819,420,399,51.28
Aphelios,Nami,1251,587,664,46.92
Aphelios,KSante,680,365,315,53.68
Aphelios,Belveth,319,144,175,45.14
Aphelios,Riven,563,316,247,56.13
Aphelios,Yuumi,1127,585,542,51.91
Aphelios,Kaisa,2034,1087,947,53.44
Aphelios,Kayn,1755,824,931,46.95
Aphelios,Amumu,1279,579,700,45.27
Aphelios,Chogath,1458,695,763,47.67
Aphelios,Morgana,1379,703,676,50.98
Aphelios,Camille,448,232,216,51.79
Aphelios,Lillia,752,391,361,51.99
Aphelios,Aatrox,1114,595,519,53.41
Aphelios,Elise,789,441,348,55.89
Aphelios,Seraphine,1029,498,531,48.4
Aphelios,Gragas,760,378,382,49.74
Aphelios,Milio,803,379,424,47.2
Aphelios,Vladimir,769,413,356,53.71
Aphelios,Velkoz,733,377,356,51.43
Aphelios,Khazix,751,388,363,51.66
Aphelios,Mel,2602,1357,1245,52.15
Aphelios,Vex,672,337,335,50.15
Aphelios,MissFortune,2509,1229,1280,48.98
Aphelios,Viktor,981,442,539,45.06
Aphelios,Nocturne,1381,617,764,44.68
Aphelios,Yone,2203,1200,1003,54.47
Aphelios,Draven,624,324,300,51.92
Aphelios,Poppy,728,389,339,53.43
Aphelios,Kalista,494,249,245,50.4
Aphelios,Neeko,626,344,282,54.95
Aphelios,Renata,287,153,134,53.31
Aphelios,Yorick,1224,570,654,46.57
Aphelios,Zed,1354,753,601,55.61
Aphelios,Evelynn,557,297,260,53.32
Aphelios,Leblanc,645,299,346,46.36
Aphelios,TahmKench,1006,522,484,51.89
Aphelios,RekSai,176,71,105,40.34
Aphelios,Pantheon,1841,962,879,52.25
Aphelios,Ekko,1101,514,587,46.68
Aphelios,Urgot,564,266,298,47.16
Aphelios,Briar,968,469,499,48.45
Aphelios,Ezreal,2822,1391,1431,49.29
Aphelios,Zac,614,307,307,50
Aphelios,Bard,461,234,227,50.76
Aphelios,Jayce,545,272,273,49.91
Aphelios,Twitch,986,503,483,51.01
Aphelios,Shyvana,309,157,152,50.81
Aphelios,Zilean,405,210,195,51.85
Aphelios,Gnar,428,213,215,49.77
Aphelios,Kindred,655,308,347,47.02
Aphelios,Cassiopeia,429,222,207,51.75
Aphelios,Karthus,379,216,163,56.99
Aphelios,Leona,997,526,471,52.76
Aphelios,Kled,245,118,127,48.16
Aphelios,MonkeyKing,732,350,382,47.81
Aphelios,Vi,1080,560,520,51.85
Aphelios,Nasus,887,417,470,47.01
Aphelios,Rell,695,360,335,51.8
Aphelios,Illaoi,519,265,254,51.06
Aphelios,Maokai,520,260,260,50
Aphelios,Qiyana,372,214,158,57.53
Aphelios,Ahri,1649,802,847,48.64
Aphelios,Vayne,1464,741,723,50.61
Aphelios,Annie,390,201,189,51.54
Aphelios,Hecarim,464,231,233,49.78
Aphelios,Naafiri,411,194,217,47.2
Aphelios,Lulu,1663,895,768,53.82
Aphelios,Olaf,316,163,153,51.58
Aphelios,Katarina,943,479,464,50.8
Aphelios,Quinn,394,197,197,50
Aphelios,Ziggs,472,219,253,46.4
Aphelios,Braum,660,316,344,47.88
Aphelios,Xerath,901,416,485,46.17
Aphelios,Shen,782,367,415,46.93
Aphelios,Zoe,544,282,262,51.84
Aphelios,Zyra,1050,506,544,48.19
Aphelios,AurelionSol,482,239,243,49.59
Aphelios,Gwen,658,331,327,50.3
Aphelios,JarvanIV,633,293,340,46.29
Aphelios,Taliyah,357,195,162,54.62
Aphelios,Corki,506,287,219,56.72
Aphelios,Nunu,697,354,343,50.79
Aphelios,Udyr,398,182,216,45.73
Aphelios,Rumble,272,113,159,41.54
Aphelios,Sivir,667,300,367,44.98
Aphelios,Varus,1095,547,548,49.95
Aphelios,Kennen,444,243,201,54.73
Aphelios,Azir,438,254,184,57.99
Aphelios,Blitzcrank,904,421,483,46.57
Aphelios,Ivern,241,101,140,41.91
Aphelios,KogMaw,295,146,149,49.49
Aphelios,Janna,459,206,253,44.88
Aphelios,Kassadin,235,121,114,51.49
Aphelios,Rammus,377,174,203,46.15
Aphelios,Karma,1330,605,725,45.49
Aphelios,Syndra,744,376,368,50.54
Aphelios,Ornn,575,278,297,48.35
Aphelios,Trundle,637,326,311,51.18
Aphelios,Zeri,621,322,299,51.85
Aphelios,Lissandra,418,170,248,40.67
Aphelios,Skarner,362,172,190,47.51
Aphelios,Nidalee,378,220,158,58.2
Aphelios,TwistedFate,475,228,247,48
Aphelios,Taric,269,136,133,50.56
Aphelios,Akshan,467,217,250,46.47
Aphelios,Renekton,569,295,274,51.85
Amumu,Trundle,1447,702,745,48.51
Amumu,MasterYi,2814,1447,1367,51.42
Amumu,Veigar,2569,1300,1269,50.6
Amumu,Jhin,4283,2123,2160,49.57
Amumu,Soraka,1146,581,565,50.7
Amumu,Warwick,3861,1967,1894,50.95
Amumu,Briar,1741,972,769,55.83
Amumu,Yasuo,4141,2203,1938,53.2
Amumu,Irelia,1824,1001,823,54.88
Amumu,Lux,5809,3070,2739,52.85
Amumu,Urgot,1123,589,534,52.45
Amumu,Kayn,3240,1696,1544,52.35
Amumu,Twitch,1812,1002,810,55.3
Amumu,Neeko,1263,678,585,53.68
Amumu,Yone,3955,2286,1669,57.8
Amumu,TwistedFate,778,442,336,56.81
Amumu,Smolder,1489,805,684,54.06
Amumu,Nautilus,2741,1516,1225,55.31
Amumu,Teemo,3017,1543,1474,51.14
Amumu,LeeSin,2503,1334,1169,53.3
Amumu,Nami,2138,1092,1046,51.08
Amumu,Mordekaiser,3246,1596,1650,49.17
Amumu,Diana,3642,1934,1708,53.1
Amumu,MissFortune,4987,2616,2371,52.46
Amumu,Karma,2097,1076,1021,51.31
Amumu,Nasus,1589,762,827,47.95
Amumu,Khazix,1086,638,448,58.75
Amumu,Lulu,2193,1174,1019,53.53
Amumu,Kindred,1089,646,443,59.32
Amumu,Fizz,1217,603,614,49.55
Amumu,Gnar,890,497,393,55.84
Amumu,Caitlyn,5839,3038,2801,52.03
Amumu,Sion,1775,976,799,54.99
Amumu,Akshan,740,451,289,60.95
Amumu,Jinx,5850,3032,2818,51.83
Amumu,Bard,646,337,309,52.17
Amumu,DrMundo,1324,694,630,52.42
Amumu,Shaco,1956,1114,842,56.95
Amumu,Leblanc,1043,523,520,50.14
Amumu,Xayah,1216,700,516,57.57
Amumu,Yorick,2248,1043,1205,46.4
Amumu,Volibear,2655,1377,1278,51.86
Amumu,Cassiopeia,709,398,311,56.14
Amumu,Rell,1174,627,547,53.41
Amumu,Thresh,2655,1446,1209,54.46
Amumu,FiddleSticks,1129,536,593,47.48
Amumu,Zed,2193,1189,1004,54.22
Amumu,Viktor,1769,914,855,51.67
Amumu,Pyke,1890,1000,890,52.91
Amumu,Olaf,548,297,251,54.2
Amumu,Hecarim,890,494,396,55.51
Amumu,Tristana,2056,1094,962,53.21
Amumu,Braum,1221,661,560,54.14
Amumu,Kennen,587,344,243,58.6
Amumu,XinZhao,1396,739,657,52.94
Amumu,Akali,2239,1267,972,56.59
Amumu,Kaisa,3332,1882,1450,56.48
Amumu,Gangplank,984,558,426,56.71
Amumu,Nocturne,2795,1429,1366,51.13
Amumu,Corki,764,422,342,55.24
Amumu,Jax,1814,1008,806,55.57
Amumu,Katarina,1593,900,693,56.5
Amumu,Chogath,2945,1515,1430,51.44
Amumu,Galio,1938,1029,909,53.1
Amumu,Hwei,1388,681,707,49.06
Amumu,Ahri,2962,1626,1336,54.9
Amumu,Malzahar,2155,1081,1074,50.16
Amumu,Talon,1180,681,499,57.71
Amumu,Rakan,940,513,427,54.57
Amumu,Senna,1720,860,860,50
Amumu,Vayne,2541,1278,1263,50.3
Amumu,Sejuani,1021,556,465,54.46
Amumu,TahmKench,2004,1142,862,56.99
Amumu,Brand,1656,837,819,50.54
Amumu,Mel,4457,2426,2031,54.43
Amumu,Zyra,1811,974,837,53.78
Amumu,Varus,1900,1054,846,55.47
Amumu,Shyvana,665,328,337,49.32
Amumu,Garen,3492,1800,1692,51.55
Amumu,Singed,546,269,277,49.27
Amumu,Ezreal,4493,2397,2096,53.35
Amumu,Jayce,878,455,423,51.82
Amumu,Aatrox,1606,889,717,55.35
Amumu,JarvanIV,1320,670,650,50.76
Amumu,Karthus,645,339,306,52.56
Amumu,Orianna,951,507,444,53.31
Amumu,Milio,1334,710,624,53.22
Amumu,Rammus,658,378,280,57.45
Amumu,Ashe,4025,2068,1957,51.38
Amumu,Seraphine,1875,992,883,52.91
Amumu,Aurora,1515,824,691,54.39
Amumu,Aphelios,1279,700,579,54.73
Amumu,KSante,949,554,395,58.38
Amumu,Vladimir,1346,728,618,54.09
Amumu,Nilah,837,473,364,56.51
Amumu,Yuumi,1735,836,899,48.18
Amumu,Vex,1262,642,620,50.87
Amumu,Morgana,2787,1446,1341,51.88
Amumu,Skarner,627,364,263,58.05
Amumu,Ryze,693,349,344,50.36
Amumu,Elise,1351,758,593,56.11
Amumu,Vi,1861,992,869,53.3
Amumu,Draven,1104,600,504,54.35
Amumu,Kled,445,240,205,53.93
Amumu,Poppy,1298,709,589,54.62
Amumu,AurelionSol,973,528,445,54.27
Amumu,Sylas,2928,1521,1407,51.95
Amumu,Xerath,1810,948,862,52.38
Amumu,Darius,4150,2247,1903,54.14
Amumu,Malphite,2131,1164,967,54.62
Amumu,Viego,3029,1638,1391,54.08
Amumu,Maokai,969,458,511,47.27
Amumu,Rengar,690,335,355,48.55
Amumu,Syndra,1169,592,577,50.64
Amumu,Lucian,1437,728,709,50.66
Amumu,Lissandra,661,324,337,49.02
Amumu,Samira,1718,949,769,55.24
Amumu,Kayle,1580,846,734,53.54
Amumu,Ambessa,1177,616,561,52.34
Amumu,Taliyah,563,317,246,56.31
Amumu,Ekko,2006,1052,954,52.44
Amumu,Heimerdinger,1104,569,535,51.54
Amumu,Blitzcrank,1552,811,741,52.26
Amumu,Zoe,819,446,373,54.46
Amumu,Evelynn,819,466,353,56.9
Amumu,Ornn,835,417,418,49.94
Amumu,Naafiri,785,435,350,55.41
Amumu,Leona,1953,1086,867,55.61
Amumu,Tryndamere,1207,657,550,54.43
Amumu,Illaoi,1105,597,508,54.03
Amumu,Annie,714,384,330,53.78
Amumu,Sona,613,338,275,55.14
Amumu,Lillia,1306,626,680,47.93
Amumu,Shen,1503,833,670,55.42
Amumu,Riven,920,518,402,56.3
Amumu,Ziggs,796,418,378,52.51
Amumu,Fiora,829,376,453,45.36
Amumu,Nunu,1611,862,749,53.51
Amumu,Janna,652,342,310,52.45
Amumu,Sett,3421,1726,1695,50.45
Amumu,Gwen,1231,648,583,52.64
Amumu,Swain,2267,1154,1113,50.9
Amumu,Belveth,583,295,288,50.6
Amumu,Camille,672,364,308,54.17
Amumu,Sivir,1129,603,526,53.41
Amumu,Zac,1070,524,546,48.97
Amumu,Kassadin,425,247,178,58.12
Amumu,Nidalee,555,319,236,57.48
Amumu,Qiyana,587,341,246,58.09
Amumu,Azir,660,370,290,56.06
Amumu,Renata,382,210,172,54.97
Amumu,Pantheon,3423,1879,1544,54.89
Amumu,Taric,491,237,254,48.27
Amumu,KogMaw,741,360,381,48.58
Amumu,RekSai,246,130,116,52.85
Amumu,Quinn,734,411,323,55.99
Amumu,Gragas,1208,665,543,55.05
Amumu,MonkeyKing,1339,677,662,50.56
Amumu,Renekton,1066,555,511,52.06
Amumu,Zeri,829,468,361,56.45
Amumu,Udyr,770,404,366,52.47
Amumu,Alistar,843,438,405,51.96
Amumu,Zilean,690,368,322,53.33
Amumu,Ivern,312,152,160,48.72
Amumu,Velkoz,1393,766,627,54.99
Amumu,Graves,1276,666,610,52.19
Amumu,Kalista,620,377,243,60.81
Amumu,Rumble,525,238,287,45.33
Amumu,Anivia,698,383,315,54.87
Trundle,Kayn,1755,857,898,48.83
Trundle,Zed,1136,635,501,55.9
Trundle,Sona,393,186,207,47.33
Trundle,Kaisa,1796,914,882,50.89
Trundle,Amumu,1447,745,702,51.49
Trundle,Mordekaiser,1879,955,924,50.82
Trundle,Udyr,433,246,187,56.81
Trundle,Yorick,1416,653,763,46.12
Trundle,Sivir,638,331,307,51.88
Trundle,Nautilus,1296,730,566,56.33
Trundle,Volibear,1682,922,760,54.82
Trundle,Veigar,1220,600,620,49.18
Trundle,Caitlyn,3272,1632,1640,49.88
Trundle,Warwick,2199,1064,1135,48.39
Trundle,Yone,2296,1237,1059,53.88
Trundle,Kalista,360,206,154,57.22
Trundle,Thresh,1549,788,761,50.87
Trundle,Olaf,391,195,196,49.87
Trundle,Hecarim,471,263,208,55.84
Trundle,Tristana,1007,494,513,49.06
Trundle,Braum,700,365,335,52.14
Trundle,Chogath,1581,805,776,50.92
Trundle,Briar,1071,526,545,49.11
Trundle,Jayce,469,238,231,50.75
Trundle,Samira,979,533,446,54.44
Trundle,Lulu,1183,638,545,53.93
Trundle,MissFortune,2985,1590,1395,53.27
Trundle,Neeko,617,312,305,50.57
Trundle,Heimerdinger,582,317,265,54.47
Trundle,Talon,645,300,345,46.51
Trundle,LeeSin,1298,682,616,52.54
Trundle,Garen,2083,964,1119,46.28
Trundle,Jhin,2281,1147,1134,50.28
Trundle,Senna,899,458,441,50.95
Trundle,Pyke,1005,551,454,54.83
Trundle,XinZhao,836,430,406,51.44
Trundle,Teemo,1476,736,740,49.86
Trundle,Yasuo,2354,1203,1151,51.1
Trundle,Gnar,417,202,215,48.44
Trundle,Graves,637,302,335,47.41
Trundle,Twitch,1041,546,495,52.45
Trundle,Malzahar,1261,643,618,50.99
Trundle,Ekko,1113,629,484,56.51
Trundle,Galio,1053,620,433,58.88
Trundle,Lux,3276,1686,1590,51.47
Trundle,Darius,2382,1266,1116,53.15
Trundle,Diana,1752,920,832,52.51
Trundle,Pantheon,1766,876,890,49.6
Trundle,Jax,1269,606,663,47.75
Trundle,Ornn,551,288,263,52.27
Trundle,Ambessa,644,347,297,53.88
Trundle,Zoe,452,244,208,53.98
Trundle,Swain,1258,650,608,51.67
Trundle,Mel,2555,1410,1145,55.19
Trundle,Yuumi,980,517,463,52.76
Trundle,TahmKench,1363,725,638,53.19
Trundle,Irelia,962,510,452,53.01
Trundle,Poppy,746,347,399,46.51
Trundle,Kled,264,147,117,55.68
Trundle,Viego,1575,809,766,51.37
Trundle,Lucian,820,461,359,56.22
Trundle,Sejuani,574,292,282,50.87
Trundle,Jinx,3141,1481,1660,47.15
Trundle,Shaco,1134,609,525,53.7
Trundle,Aurora,884,442,442,50
Trundle,Aatrox,924,494,430,53.46
Trundle,Anivia,402,201,201,50
Trundle,Kindred,588,310,278,52.72
Trundle,Blitzcrank,920,519,401,56.41
Trundle,Renekton,610,295,315,48.36
Trundle,Rengar,356,197,159,55.34
Trundle,Leblanc,589,306,283,51.95
Trundle,Seraphine,1145,600,545,52.4
Trundle,Gwen,650,345,305,53.08
Trundle,MasterYi,1436,748,688,52.09
Trundle,Ryze,359,165,194,45.96
Trundle,Katarina,913,506,407,55.42
Trundle,Brand,922,490,432,53.15
Trundle,Tryndamere,778,368,410,47.3
Trundle,Ahri,1570,837,733,53.31
Trundle,Draven,576,315,261,54.69
Trundle,Bard,341,189,152,55.43
Trundle,Morgana,1501,754,747,50.23
Trundle,Lillia,628,355,273,56.53
Trundle,Shen,807,407,400,50.43
Trundle,Nocturne,1534,720,814,46.94
Trundle,Zilean,300,140,160,46.67
Trundle,Zac,461,225,236,48.81
Trundle,Smolder,823,407,416,49.45
Trundle,Alistar,469,219,250,46.7
Trundle,JarvanIV,556,300,256,53.96
Trundle,Cassiopeia,366,161,205,43.99
Trundle,Zyra,972,474,498,48.77
Trundle,Kennen,304,158,146,51.97
Trundle,Riven,481,288,193,59.88
Trundle,Syndra,704,346,358,49.15
Trundle,Ezreal,2439,1330,1109,54.53
Trundle,Viktor,908,465,443,51.21
Trundle,Nasus,1083,532,551,49.12
Trundle,Soraka,720,377,343,52.36
Trundle,Akali,1247,693,554,55.57
Trundle,Khazix,610,338,272,55.41
Trundle,Azir,470,233,237,49.57
Trundle,Rell,519,264,255,50.87
Trundle,Lissandra,439,226,213,51.48
Trundle,Ziggs,463,221,242,47.73
Trundle,Karma,1200,630,570,52.5
Trundle,Evelynn,472,256,216,54.24
Trundle,Taric,268,148,120,55.22
Trundle,FiddleSticks,628,280,348,44.59
Trundle,Vex,620,273,347,44.03
Trundle,Milio,644,320,324,49.69
Trundle,Hwei,789,389,400,49.3
Trundle,Corki,435,260,175,59.77
Trundle,KSante,595,388,207,65.21
Trundle,Vayne,1502,745,757,49.6
Trundle,Vladimir,635,328,307,51.65
Trundle,Xayah,637,348,289,54.63
Trundle,Sett,1884,977,907,51.86
Trundle,Nami,1051,560,491,53.28
Trundle,Nilah,518,294,224,56.76
Trundle,Malphite,1181,591,590,50.04
Trundle,Sion,1065,568,497,53.33
Trundle,Camille,300,125,175,41.67
Trundle,Varus,915,483,432,52.79
Trundle,Illaoi,705,353,352,50.07
Trundle,Ashe,2393,1264,1129,52.82
Trundle,Elise,651,337,314,51.77
Trundle,Orianna,471,268,203,56.9
Trundle,TwistedFate,453,253,200,55.85
Trundle,Gragas,661,327,334,49.47
Trundle,Kassadin,257,145,112,56.42
Trundle,Leona,984,522,462,53.05
Trundle,Rammus,501,229,272,45.71
Trundle,Qiyana,301,176,125,58.47
Trundle,Karthus,276,162,114,58.7
Trundle,Renata,200,104,96,52
Trundle,Fiora,390,212,178,54.36
Trundle,Belveth,313,183,130,58.47
Trundle,Rakan,517,267,250,51.64
Trundle,Annie,364,189,175,51.92
Trundle,MonkeyKing,743,370,373,49.8
Trundle,AurelionSol,569,282,287,49.56
Trundle,Urgot,630,293,337,46.51
Trundle,DrMundo,841,485,356,57.67
Trundle,Nunu,818,408,410,49.88
Trundle,Zeri,444,221,223,49.77
Trundle,Akshan,470,285,185,60.64
Trundle,Maokai,532,252,280,47.37
Trundle,Janna,315,134,181,42.54
Trundle,Velkoz,666,317,349,47.6
Trundle,Skarner,332,179,153,53.92
Trundle,Aphelios,637,311,326,48.82
Trundle,Ivern,201,112,89,55.72
Trundle,Kayle,721,359,362,49.79
Trundle,Fizz,642,320,322,49.84
Trundle,KogMaw,359,179,180,49.86
Trundle,Sylas,1391,720,671,51.76
Trundle,Singed,314,156,158,49.68
Trundle,Vi,1051,563,488,53.57
Trundle,Xerath,1022,491,531,48.04
Trundle,Taliyah,263,147,116,55.89
Trundle,Gangplank,537,304,233,56.61
Trundle,RekSai,135,71,64,52.59
Trundle,Rumble,229,106,123,46.29
Trundle,Naafiri,399,189,210,47.37
Trundle,Nidalee,294,161,133,54.76
Trundle,Shyvana,246,116,130,47.15
Trundle,Quinn,320,174,146,54.38
Vex,Garen,1762,811,951,46.03
Vex,Diana,1894,934,960,49.31
Vex,Yasuo,3114,1675,1439,53.79
Vex,Caitlyn,3027,1593,1434,52.63
Vex,Pyke,996,543,453,54.52
Vex,Smolder,691,344,347,49.78
Vex,Ekko,952,520,432,54.62
Vex,Mordekaiser,1582,741,841,46.84
Vex,Yuumi,996,515,481,51.71
Vex,Jax,1029,472,557,45.87
Vex,Talon,664,344,320,51.81
Vex,Leblanc,1029,534,495,51.9
Vex,Mel,1808,880,928,48.67
Vex,Lux,3245,1671,1574,51.49
Vex,MissFortune,2734,1386,1348,50.69
Vex,Karma,1192,577,615,48.41
Vex,Warwick,1750,825,925,47.14
Vex,Yone,2551,1285,1266,50.37
Vex,Kalista,397,209,188,52.64
Vex,Thresh,1570,803,767,51.15
Vex,Malphite,1086,516,570,47.51
Vex,FiddleSticks,635,296,339,46.61
Vex,Soraka,626,358,268,57.19
Vex,Akali,1447,811,636,56.05
Vex,Jinx,3011,1394,1617,46.3
Vex,Xayah,695,350,345,50.36
Vex,Senna,875,457,418,52.23
Vex,Viego,1525,779,746,51.08
Vex,Tristana,1222,651,571,53.27
Vex,Riven,450,234,216,52
Vex,Sejuani,552,269,283,48.73
Vex,AurelionSol,357,156,201,43.7
Vex,Rakan,585,300,285,51.28
Vex,Nasus,764,359,405,46.99
Vex,Vi,1110,543,567,48.92
Vex,Renata,184,104,80,56.52
Vex,MonkeyKing,657,345,312,52.51
Vex,Sylas,1800,1012,788,56.22
Vex,Swain,1119,501,618,44.77
Vex,Darius,1988,1029,959,51.76
Vex,Kayn,1668,876,792,52.52
Vex,Zed,1217,650,567,53.41
Vex,Syndra,691,336,355,48.63
Vex,Kayle,777,381,396,49.03
Vex,Irelia,1009,498,511,49.36
Vex,TahmKench,893,472,421,52.86
Vex,Veigar,1282,625,657,48.75
Vex,Jhin,2322,1188,1134,51.16
Vex,Poppy,686,338,348,49.27
Vex,Elise,722,377,345,52.22
Vex,Aurora,1014,503,511,49.61
Vex,Nami,953,453,500,47.53
Vex,Sett,1725,857,868,49.68
Vex,Briar,944,406,538,43.01
Vex,Draven,503,282,221,56.06
Vex,Nautilus,1390,689,701,49.57
Vex,Rengar,403,245,158,60.79
Vex,Ivern,187,93,94,49.73
Vex,Graves,705,340,365,48.23
Vex,Ezreal,2534,1243,1291,49.05
Vex,Teemo,1630,807,823,49.51
Vex,Aatrox,1126,516,610,45.83
Vex,Shaco,1161,582,579,50.13
Vex,Azir,425,253,172,59.53
Vex,Yorick,1097,517,580,47.13
Vex,Kindred,606,324,282,53.47
Vex,Heimerdinger,635,350,285,55.12
Vex,Ryze,345,175,170,50.72
Vex,KSante,515,277,238,53.79
Vex,Volibear,1178,632,546,53.65
Vex,Karthus,369,192,177,52.03
Vex,Kassadin,234,111,123,47.44
Vex,Illaoi,556,327,229,58.81
Vex,Amumu,1262,620,642,49.13
Vex,Ashe,2253,1103,1150,48.96
Vex,Vayne,1374,684,690,49.78
Vex,Renekton,601,314,287,52.25
Vex,XinZhao,796,426,370,53.52
Vex,Ahri,1767,924,843,52.29
Vex,Corki,389,208,181,53.47
Vex,Morgana,1530,719,811,46.99
Vex,Hwei,816,379,437,46.45
Vex,Aphelios,672,335,337,49.85
Vex,Nidalee,321,181,140,56.39
Vex,Orianna,474,248,226,52.32
Vex,Chogath,1450,650,800,44.83
Vex,Nocturne,1447,718,729,49.62
Vex,Cassiopeia,435,241,194,55.4
Vex,Ornn,503,248,255,49.3
Vex,Lulu,1050,504,546,48
Vex,Skarner,263,119,144,45.25
Vex,Katarina,893,519,374,58.12
Vex,Quinn,390,188,202,48.21
Vex,Camille,424,220,204,51.89
Vex,LeeSin,1478,817,661,55.28
Vex,Hecarim,394,196,198,49.75
Vex,Maokai,473,237,236,50.11
Vex,Fiora,378,198,180,52.38
Vex,Naafiri,475,239,236,50.32
Vex,Belveth,243,127,116,52.26
Vex,Twitch,854,403,451,47.19
Vex,Zac,514,285,229,55.45
Vex,Neeko,670,343,327,51.19
Vex,Shen,681,334,347,49.05
Vex,Vladimir,621,279,342,44.93
Vex,Nunu,737,369,368,50.07
Vex,Annie,438,218,220,49.77
Vex,Sona,403,185,218,45.91
Vex,Kled,180,72,108,40
Vex,Khazix,608,338,270,55.59
Vex,Galio,883,390,493,44.17
Vex,Braum,658,335,323,50.91
Vex,Trundle,620,347,273,55.97
Vex,Rammus,371,163,208,43.94
Vex,Seraphine,1072,542,530,50.56
Vex,DrMundo,613,296,317,48.29
Vex,Kaisa,1731,922,809,53.26
Vex,Gangplank,530,253,277,47.74
Vex,Blitzcrank,938,472,466,50.32
Vex,Olaf,309,131,178,42.39
Vex,JarvanIV,594,318,276,53.54
Vex,Tryndamere,664,369,295,55.57
Vex,Sion,956,441,515,46.13
Vex,Malzahar,1066,485,581,45.5
Vex,Samira,796,419,377,52.64
Vex,Xerath,1062,529,533,49.81
Vex,Viktor,1021,523,498,51.22
Vex,Milio,606,254,352,41.91
Vex,Velkoz,644,299,345,46.43
Vex,TwistedFate,318,179,139,56.29
Vex,Lillia,779,367,412,47.11
Vex,Kennen,320,169,151,52.81
Vex,MasterYi,1251,582,669,46.52
Vex,Singed,312,134,178,42.95
Vex,Nilah,483,269,214,55.69
Vex,Taliyah,234,123,111,52.56
Vex,Qiyana,416,238,178,57.21
Vex,Lucian,825,446,379,54.06
Vex,Rumble,257,146,111,56.81
Vex,KogMaw,338,177,161,52.37
Vex,Leona,1007,453,554,44.99
Vex,Varus,1001,506,495,50.55
Vex,Sivir,608,298,310,49.01
Vex,Gragas,710,412,298,58.03
Vex,Zeri,468,232,236,49.57
Vex,Zyra,1009,502,507,49.75
Vex,Alistar,432,231,201,53.47
Vex,Pantheon,1863,963,900,51.69
Vex,Akshan,426,238,188,55.87
Vex,Gwen,626,330,296,52.72
Vex,Brand,819,395,424,48.23
Vex,Urgot,500,251,249,50.2
Vex,Evelynn,490,255,235,52.04
Vex,Rell,627,330,297,52.63
Vex,Ambessa,727,395,332,54.33
Vex,Udyr,402,230,172,57.21
Vex,Bard,330,189,141,57.27
Vex,Zoe,397,213,184,53.65
Vex,Gnar,485,254,231,52.37
Vex,Fizz,618,326,292,52.75
Vex,Ziggs,431,166,265,38.52
Vex,Zilean,300,149,151,49.67
Vex,Lissandra,290,167,123,57.59
Vex,Anivia,338,172,166,50.89
Vex,Shyvana,288,161,127,55.9
Vex,Taric,225,125,100,55.56
Vex,Janna,329,133,196,40.43
Vex,RekSai,121,78,43,64.46
Vex,Jayce,526,294,232,55.89
Akali,Yorick,1959,921,1038,47.01
Akali,LeeSin,3437,1731,1706,50.36
Akali,Yone,5365,2876,2489,53.61
Akali,MissFortune,5550,2751,2799,49.57
Akali,Mel,4835,2500,2335,51.71
Akali,Ornn,982,491,491,50
Akali,Udyr,770,406,364,52.73
Akali,Lux,5928,2992,2936,50.47
Akali,Ezreal,5417,2674,2743,49.36
Akali,Milio,1239,623,616,50.28
Akali,Samira,1657,785,872,47.37
Akali,Kayn,3090,1417,1673,45.86
Akali,Sylas,3784,1838,1946,48.57
Akali,Nilah,802,381,421,47.51
Akali,Leona,1812,902,910,49.78
Akali,DrMundo,1230,603,627,49.02
Akali,Belveth,537,274,263,51.02
Akali,Leblanc,1308,672,636,51.38
Akali,Briar,1741,906,835,52.04
Akali,Anivia,638,293,345,45.92
Akali,Malphite,1977,984,993,49.77
Akali,Jax,2081,1082,999,51.99
Akali,Neeko,1225,615,610,50.2
Akali,Xayah,1215,601,614,49.47
Akali,Rakan,1073,490,583,45.67
Akali,Gangplank,1023,503,520,49.17
Akali,Hwei,1393,675,718,48.46
Akali,Hecarim,835,418,417,50.06
Akali,Lillia,1365,672,693,49.23
Akali,Soraka,1322,574,748,43.42
Akali,Chogath,2658,1164,1494,43.79
Akali,Talon,1451,793,658,54.65
Akali,Qiyana,603,276,327,45.77
Akali,Seraphine,1905,896,1009,47.03
Akali,Heimerdinger,1083,467,616,43.12
Akali,Vi,1994,933,1061,46.79
Akali,Ahri,2838,1477,1361,52.04
Akali,Darius,3824,1914,1910,50.05
Akali,Maokai,940,467,473,49.68
Akali,Aatrox,2159,1106,1053,51.23
Akali,Viego,3131,1564,1567,49.95
Akali,Ashe,4646,2280,2366,49.07
Akali,Blitzcrank,1804,989,815,54.82
Akali,Mordekaiser,3183,1449,1734,45.52
Akali,Zed,2669,1338,1331,50.13
Akali,Vex,1447,636,811,43.95
Akali,Ambessa,1418,735,683,51.83
Akali,Nunu,1476,744,732,50.41
Akali,Jinx,5779,2880,2899,49.84
Akali,Evelynn,931,509,422,54.67
Akali,Kalista,800,422,378,52.75
Akali,Renata,469,234,235,49.89
Akali,MasterYi,2740,1283,1457,46.82
Akali,Caitlyn,5881,2798,3083,47.58
Akali,Taric,445,196,249,44.04
Akali,Amumu,2239,972,1267,43.41
Akali,Akshan,766,302,464,39.43
Akali,Irelia,2178,1109,1069,50.92
Akali,Nocturne,2571,1266,1305,49.24
Akali,Jayce,1066,535,531,50.19
Akali,Jhin,4490,2232,2258,49.71
Akali,Senna,1676,807,869,48.15
Akali,Riven,988,477,511,48.28
Akali,Naafiri,855,379,476,44.33
Akali,Tristana,2097,1046,1051,49.88
Akali,Ivern,427,218,209,51.05
Akali,Katarina,1878,1006,872,53.57
Akali,Pantheon,3569,1807,1762,50.63
Akali,Teemo,2915,1361,1554,46.69
Akali,Warwick,3414,1516,1898,44.41
Akali,Veigar,2261,1050,1211,46.44
Akali,Kaisa,3850,2027,1823,52.65
Akali,Yuumi,2023,939,1084,46.42
Akali,Lucian,1486,787,699,52.96
Akali,Swain,2207,1010,1197,45.76
Akali,Singed,564,238,326,42.2
Akali,Galio,2381,1138,1243,47.8
Akali,Smolder,1314,659,655,50.15
Akali,Brand,1564,766,798,48.98
Akali,Yasuo,5213,2636,2577,50.57
Akali,Thresh,3056,1475,1581,48.27
Akali,Skarner,683,357,326,52.27
Akali,Aurora,1902,1005,897,52.84
Akali,Zoe,859,435,424,50.64
Akali,Gragas,1270,668,602,52.6
Akali,Rammus,694,341,353,49.14
Akali,Nami,1982,974,1008,49.14
Akali,Zac,1025,483,542,47.12
Akali,Sion,1601,766,835,47.85
Akali,Draven,998,459,539,45.99
Akali,Nasus,1563,735,828,47.02
Akali,Diana,3626,1759,1867,48.51
Akali,Zilean,562,269,293,47.86
Akali,Camille,753,354,399,47.01
Akali,Azir,764,384,380,50.26
Akali,Braum,1128,510,618,45.21
Akali,KSante,1295,714,581,55.14
Akali,MonkeyKing,1467,685,782,46.69
Akali,Ekko,2041,1000,1041,49
Akali,Fiora,820,417,403,50.85
Akali,Kindred,1026,556,470,54.19
Akali,Morgana,2726,1227,1499,45.01
Akali,Gwen,1186,697,489,58.77
Akali,JarvanIV,1133,560,573,49.43
Akali,Kennen,678,340,338,50.15
Akali,Nautilus,2389,1213,1176,50.77
Akali,FiddleSticks,1084,496,588,45.76
Akali,Karma,2560,1293,1267,50.51
Akali,Quinn,834,405,429,48.56
Akali,Sivir,1170,572,598,48.89
Akali,Gnar,919,487,432,52.99
Akali,AurelionSol,710,327,383,46.06
Akali,Renekton,1087,508,579,46.73
Akali,Aphelios,1216,562,654,46.22
Akali,TahmKench,1759,909,850,51.68
Akali,Malzahar,1899,862,1037,45.39
Akali,Sett,3552,1647,1905,46.37
Akali,Vayne,2709,1200,1509,44.3
Akali,Tryndamere,1194,621,573,52.01
Akali,Fizz,1238,617,621,49.84
Akali,Vladimir,1435,680,755,47.39
Akali,Garen,3613,1717,1896,47.52
Akali,Lulu,2700,1310,1390,48.52
Akali,RekSai,251,108,143,43.03
Akali,Pyke,2196,1168,1028,53.19
Akali,Volibear,2484,1174,1310,47.26
Akali,Sona,729,375,354,51.44
Akali,Annie,747,349,398,46.72
Akali,Khazix,1138,549,589,48.24
Akali,Orianna,958,458,500,47.81
Akali,Janna,692,304,388,43.93
Akali,Zyra,1954,936,1018,47.9
Akali,Corki,790,400,390,50.63
Akali,Ziggs,926,455,471,49.14
Akali,Graves,1375,677,698,49.24
Akali,TwistedFate,762,446,316,58.53
Akali,Rell,1158,544,614,46.98
Akali,Syndra,1106,576,530,52.08
Akali,XinZhao,1562,765,797,48.98
Akali,Twitch,1547,771,776,49.84
Akali,Shaco,2194,1104,1090,50.32
Akali,Varus,1925,923,1002,47.95
Akali,Zeri,1002,530,472,52.89
Akali,Alistar,883,363,520,41.11
Akali,Ryze,766,360,406,47
Akali,Kayle,1483,708,775,47.74
Akali,Sejuani,888,428,460,48.2
Akali,Kassadin,442,222,220,50.23
Akali,Trundle,1247,554,693,44.43
Akali,Xerath,1866,914,952,48.98
Akali,Viktor,2042,1077,965,52.74
Akali,Urgot,1030,451,579,43.79
Akali,Poppy,1362,618,744,45.37
Akali,Velkoz,1215,604,611,49.71
Akali,Rengar,693,411,282,59.31
Akali,Nidalee,728,378,350,51.92
Akali,Shyvana,589,278,311,47.2
Akali,Lissandra,811,486,325,59.93
Akali,Rumble,600,298,302,49.67
Akali,Olaf,521,295,226,56.62
Akali,Cassiopeia,636,292,344,45.91
Akali,Shen,1242,617,625,49.68
Akali,Illaoi,1090,544,546,49.91
Akali,Kled,442,210,232,47.51
Akali,Elise,1483,737,746,49.7
Akali,KogMaw,618,262,356,42.39
Akali,Karthus,682,317,365,46.48
Akali,Bard,628,314,314,50
Akali,Taliyah,620,296,324,47.74
Naafiri,Aatrox,743,413,330,55.59
Naafiri,Sejuani,262,159,103,60.69
Naafiri,Yasuo,1483,661,822,44.57
Naafiri,Jinx,1927,910,1017,47.22
Naafiri,Pyke,794,418,376,52.64
Naafiri,Gnar,327,168,159,51.38
Naafiri,Viego,1024,499,525,48.73
Naafiri,Yone,1578,700,878,44.36
Naafiri,Kaisa,1187,654,533,55.1
Naafiri,TahmKench,710,401,309,56.48
Naafiri,Ryze,259,121,138,46.72
Naafiri,Nunu,547,273,274,49.91
Naafiri,Ahri,900,467,433,51.89
Naafiri,Lucian,442,249,193,56.33
Naafiri,Alistar,266,122,144,45.86
Naafiri,Vayne,852,454,398,53.29
Naafiri,Briar,685,323,362,47.15
Naafiri,Lux,2087,1122,965,53.76
Naafiri,Mel,1590,772,818,48.55
Naafiri,Yuumi,644,328,316,50.93
Naafiri,Irelia,654,327,327,50
Naafiri,Nocturne,876,378,498,43.15
Naafiri,Jayce,285,163,122,57.19
Naafiri,Jhin,1549,748,801,48.29
Naafiri,Senna,561,264,297,47.06
Naafiri,Sett,1164,600,564,51.55
Naafiri,FiddleSticks,384,186,198,48.44
Naafiri,Akali,855,476,379,55.67
Naafiri,Samira,606,299,307,49.34
Naafiri,Neeko,426,203,223,47.65
Naafiri,Kayle,532,251,281,47.18
Naafiri,Katarina,527,309,218,58.63
Naafiri,KSante,318,191,127,60.06
Naafiri,Kayn,1158,607,551,52.42
Naafiri,Quinn,272,133,139,48.9
Naafiri,Thresh,913,464,449,50.82
Naafiri,Talon,475,239,236,50.32
Naafiri,LeeSin,951,525,426,55.21
Naafiri,Garen,1221,577,644,47.26
Naafiri,Malzahar,779,417,362,53.53
Naafiri,Twitch,637,321,316,50.39
Naafiri,Rakan,344,144,200,41.86
Naafiri,Yorick,804,379,425,47.14
Naafiri,Volibear,918,432,486,47.06
Naafiri,Blitzcrank,583,258,325,44.25
Naafiri,Shaco,664,359,305,54.07
Naafiri,Darius,1481,690,791,46.59
Naafiri,Sylas,1000,532,468,53.2
Naafiri,Tristana,724,337,387,46.55
Naafiri,Zoe,409,184,225,44.99
Naafiri,Kassadin,129,64,65,49.61
Naafiri,Renata,147,62,85,42.18
Naafiri,Gragas,383,210,173,54.83
Naafiri,Karma,680,350,330,51.47
Naafiri,Veigar,867,352,515,40.6
Naafiri,Viktor,562,308,254,54.8
Naafiri,Teemo,980,469,511,47.86
Naafiri,Graves,421,244,177,57.96
Naafiri,Leblanc,485,304,181,62.68
Naafiri,Mordekaiser,1129,508,621,45
Naafiri,Diana,1192,593,599,49.75
Naafiri,Kindred,378,180,198,47.62
Naafiri,Swain,773,293,480,37.9
Naafiri,JarvanIV,418,213,205,50.96
Naafiri,Hwei,473,248,225,52.43
Naafiri,Riven,305,173,132,56.72
Naafiri,Nami,761,374,387,49.15
Naafiri,Xayah,386,177,209,45.85
Naafiri,Evelynn,349,229,120,65.62
Naafiri,Zac,300,145,155,48.33
Naafiri,Renekton,377,213,164,56.5
Naafiri,Caitlyn,2008,1010,998,50.3
Naafiri,Zilean,241,116,125,48.13
Naafiri,MasterYi,852,395,457,46.36
Naafiri,Azir,249,140,109,56.22
Naafiri,Ezreal,1494,793,701,53.08
Naafiri,Velkoz,537,277,260,51.58
Naafiri,Vex,475,236,239,49.68
Naafiri,Bard,237,132,105,55.7
Naafiri,Ekko,674,335,339,49.7
Naafiri,Fiora,283,167,116,59.01
Naafiri,XinZhao,448,216,232,48.21
Naafiri,Draven,368,194,174,52.72
Naafiri,Rammus,212,83,129,39.15
Naafiri,Zeri,280,174,106,62.14
Naafiri,Amumu,785,350,435,44.59
Naafiri,MissFortune,1740,854,886,49.08
Naafiri,Morgana,934,474,460,50.75
Naafiri,Syndra,467,251,216,53.75
Naafiri,Lulu,846,442,404,52.25
Naafiri,Belveth,158,71,87,44.94
Naafiri,Soraka,452,216,236,47.79
Naafiri,Ambessa,454,222,232,48.9
Naafiri,Lillia,441,236,205,53.51
Naafiri,Aurora,657,294,363,44.75
Naafiri,Cassiopeia,216,108,108,50
Naafiri,Nilah,343,151,192,44.02
Naafiri,Ornn,290,126,164,43.45
Naafiri,Heimerdinger,405,182,223,44.94
Naafiri,Anivia,229,122,107,53.28
Naafiri,Udyr,274,151,123,55.11
Naafiri,Nasus,571,253,318,44.31
Naafiri,Warwick,1232,604,628,49.03
Naafiri,Elise,455,235,220,51.65
Naafiri,Jax,604,325,279,53.81
Naafiri,Vladimir,416,216,200,51.92
Naafiri,Nautilus,735,341,394,46.39
Naafiri,Ashe,1450,734,716,50.62
Naafiri,Rengar,250,141,109,56.4
Naafiri,Poppy,422,189,233,44.79
Naafiri,Galio,591,274,317,46.36
Naafiri,Ziggs,286,137,149,47.9
Naafiri,Sona,257,114,143,44.36
Naafiri,Aphelios,411,217,194,52.8
Naafiri,Pantheon,1140,575,565,50.44
Naafiri,Kennen,268,127,141,47.39
Naafiri,Khazix,355,200,155,56.34
Naafiri,Gwen,426,233,193,54.69
Naafiri,Xerath,571,310,261,54.29
Naafiri,Malphite,732,349,383,47.68
Naafiri,Camille,272,168,104,61.76
Naafiri,Fizz,389,190,199,48.84
Naafiri,Singed,220,91,129,41.36
Naafiri,RekSai,52,22,30,42.31
Naafiri,AurelionSol,344,189,155,54.94
Naafiri,Milio,421,238,183,56.53
Naafiri,Vi,663,302,361,45.55
Naafiri,Orianna,355,160,195,45.07
Naafiri,Shen,540,245,295,45.37
Naafiri,DrMundo,417,203,214,48.68
Naafiri,Corki,268,146,122,54.48
Naafiri,TwistedFate,235,154,81,65.53
Naafiri,Qiyana,212,119,93,56.13
Naafiri,Illaoi,366,214,152,58.47
Naafiri,Smolder,544,279,265,51.29
Naafiri,Zed,748,376,372,50.27
Naafiri,Leona,595,304,291,51.09
Naafiri,Tryndamere,428,208,220,48.6
Naafiri,Varus,612,277,335,45.26
Naafiri,Urgot,391,171,220,43.73
Naafiri,Janna,254,135,119,53.15
Naafiri,Akshan,303,164,139,54.13
Naafiri,Gangplank,341,190,151,55.72
Naafiri,Seraphine,761,353,408,46.39
Naafiri,Zyra,644,310,334,48.14
Naafiri,Brand,555,294,261,52.97
Naafiri,Lissandra,260,120,140,46.15
Naafiri,MonkeyKing,462,238,224,51.52
Naafiri,Shyvana,256,91,165,35.55
Naafiri,Hecarim,306,141,165,46.08
Naafiri,Karthus,215,106,109,49.3
Naafiri,Chogath,1018,496,522,48.72
Naafiri,Kalista,201,108,93,53.73
Naafiri,Taliyah,205,97,108,47.32
Naafiri,Annie,251,134,117,53.39
Naafiri,Rell,318,196,122,61.64
Naafiri,Kled,137,54,83,39.42
Naafiri,Sion,502,211,291,42.03
Naafiri,Braum,360,162,198,45
Naafiri,Nidalee,198,126,72,63.64
Naafiri,Skarner,234,125,109,53.42
Naafiri,Trundle,399,210,189,52.63
Naafiri,Sivir,352,200,152,56.82
Naafiri,Olaf,142,73,69,51.41
Naafiri,Maokai,319,155,164,48.59
Naafiri,Ivern,129,78,51,60.47
Naafiri,Rumble,174,107,67,61.49
Naafiri,KogMaw,236,117,119,49.58
Naafiri,Taric,163,95,68,58.28
Senna,Aatrox,1363,672,691,49.3
Senna,Sejuani,621,342,279,55.07
Senna,Yasuo,3195,1596,1599,49.95
Senna,Jinx,4254,2057,2197,48.35
Senna,Pyke,1470,759,711,51.63
Senna,Gwen,834,458,376,54.92
Senna,Talon,1036,575,461,55.5
Senna,Yone,2995,1594,1401,53.22
Senna,MissFortune,3474,1670,1804,48.07
Senna,Taric,309,146,163,47.25
Senna,Samira,1277,665,612,52.08
Senna,Kayn,2281,1121,1160,49.15
Senna,Sylas,1848,946,902,51.19
Senna,Nilah,595,297,298,49.92
Senna,Leona,1214,549,665,45.22
Senna,Fiora,613,319,294,52.04
Senna,FiddleSticks,804,433,371,53.86
Senna,Syndra,841,417,424,49.58
Senna,Vayne,1871,989,882,52.86
Senna,Morgana,2121,1082,1039,51.01
Senna,Chogath,2048,1051,997,51.32
Senna,Shaco,1606,837,769,52.12
Senna,Ahri,2314,1212,1102,52.38
Senna,Ashe,3154,1570,1584,49.78
Senna,Poppy,1049,536,513,51.1
Senna,Malphite,1652,766,886,46.37
Senna,Mel,3528,1854,1674,52.55
Senna,Soraka,965,499,466,51.71
Senna,Mordekaiser,2226,1122,1104,50.4
Senna,Zed,1611,850,761,52.76
Senna,Vex,875,418,457,47.77
Senna,Rakan,799,388,411,48.56
Senna,Viktor,1385,722,663,52.13
Senna,Nocturne,1867,842,1025,45.1
Senna,Bard,558,305,253,54.66
Senna,Gnar,715,358,357,50.07
Senna,Jax,1440,698,742,48.47
Senna,Aurora,1192,720,472,60.4
Senna,Swain,1712,828,884,48.36
Senna,Fizz,892,437,455,48.99
Senna,Tristana,1485,758,727,51.04
Senna,Akali,1676,869,807,51.85
Senna,Naafiri,561,297,264,52.94
Senna,Kayle,1218,582,636,47.78
Senna,Smolder,1024,553,471,54
Senna,Kalista,457,240,217,52.52
Senna,Gragas,944,480,464,50.85
Senna,Orianna,707,355,352,50.21
Senna,Gangplank,748,395,353,52.81
Senna,Corki,612,325,287,53.1
Senna,Lux,4120,1990,2130,48.3
Senna,Yorick,1603,683,920,42.61
Senna,Ekko,1445,710,735,49.13
Senna,Katarina,1132,602,530,53.18
Senna,Sion,1273,608,665,47.76
Senna,Sett,2457,1170,1287,47.62
Senna,Lissandra,432,242,190,56.02
Senna,Milio,1037,507,530,48.89
Senna,Lillia,1009,558,451,55.3
Senna,Jhin,2986,1432,1554,47.96
Senna,Janna,563,275,288,48.85
Senna,Olaf,411,253,158,61.56
Senna,Braum,873,483,390,55.33
Senna,TahmKench,1451,729,722,50.24
Senna,Malzahar,1639,732,907,44.66
Senna,Blitzcrank,1186,639,547,53.88
Senna,Vi,1421,800,621,56.3
Senna,Thresh,2247,1059,1188,47.13
Senna,Trundle,899,441,458,49.05
Senna,Aphelios,1018,541,477,53.14
Senna,Shen,1115,579,536,51.93
Senna,Nunu,1036,565,471,54.54
Senna,DrMundo,885,415,470,46.89
Senna,Amumu,1720,857,863,49.83
Senna,Irelia,1289,631,658,48.95
Senna,Warwick,2448,1203,1245,49.14
Senna,Veigar,1739,845,894,48.59
Senna,Nautilus,1901,968,933,50.92
Senna,Darius,3242,1645,1597,50.74
Senna,Karma,1733,866,867,49.97
Senna,Diana,2315,1179,1136,50.93
Senna,Twitch,1367,664,703,48.57
Senna,Teemo,2052,1019,1033,49.66
Senna,Kaisa,2547,1335,1212,52.41
Senna,Evelynn,605,316,289,52.23
Senna,Velkoz,988,453,535,45.85
Senna,Nasus,1118,591,527,52.86
Senna,Neeko,871,447,424,51.32
Senna,Draven,834,408,426,48.92
Senna,Shyvana,461,231,230,50.11
Senna,Galio,1370,690,680,50.36
Senna,Caitlyn,4362,2165,2197,49.63
Senna,Garen,2458,1226,1232,49.88
Senna,Graves,914,464,450,50.77
Senna,Zoe,630,361,269,57.3
Senna,Jayce,818,408,410,49.88
Senna,Ezreal,3587,1851,1736,51.6
Senna,Kindred,817,426,391,52.14
Senna,Yuumi,1424,659,765,46.28
Senna,Azir,588,263,325,44.73
Senna,Ivern,299,129,170,43.14
Senna,Anivia,539,258,281,47.87
Senna,Hecarim,605,311,294,51.4
Senna,Khazix,794,370,424,46.6
Senna,Sivir,847,396,451,46.75
Senna,Seraphine,1504,787,717,52.33
Senna,MonkeyKing,1084,473,611,43.63
Senna,Vladimir,930,473,457,50.86
Senna,Varus,1391,722,669,51.91
Senna,Urgot,873,415,458,47.54
Senna,MasterYi,1785,895,890,50.14
Senna,Renekton,767,367,400,47.85
Senna,Renata,379,197,182,51.98
Senna,Karthus,474,220,254,46.41
Senna,Lucian,1087,598,489,55.01
Senna,Nami,1675,781,894,46.63
Senna,Volibear,1689,754,935,44.64
Senna,Lulu,2161,1047,1114,48.45
Senna,Brand,1157,591,566,51.08
Senna,Ryze,545,244,301,44.77
Senna,Zac,649,330,319,50.85
Senna,Ziggs,638,288,350,45.14
Senna,Viego,2155,1068,1087,49.56
Senna,Alistar,560,263,297,46.96
Senna,Rammus,510,217,293,42.55
Senna,Nidalee,429,240,189,55.94
Senna,Kled,262,112,150,42.75
Senna,Udyr,638,344,294,53.92
Senna,Xerath,1292,627,665,48.53
Senna,Ornn,799,391,408,48.94
Senna,Singed,442,215,227,48.64
Senna,Kassadin,299,139,160,46.49
Senna,Tryndamere,916,471,445,51.42
Senna,Riven,746,380,366,50.94
Senna,Rell,798,442,356,55.39
Senna,Briar,1290,589,701,45.66
Senna,LeeSin,1872,941,931,50.27
Senna,Pantheon,2494,1194,1300,47.87
Senna,Camille,535,311,224,58.13
Senna,Ambessa,953,510,443,53.52
Senna,Skarner,421,254,167,60.33
Senna,Hwei,1123,578,545,51.47
Senna,Heimerdinger,739,345,394,46.68
Senna,Rengar,460,224,236,48.7
Senna,Sona,598,303,295,50.67
Senna,KSante,717,401,316,55.93
Senna,Xayah,872,433,439,49.66
Senna,Kennen,451,183,268,40.58
Senna,Leblanc,781,395,386,50.58
Senna,Elise,1175,576,599,49.02
Senna,XinZhao,990,496,494,50.1
Senna,Quinn,625,293,332,46.88
Senna,Qiyana,550,331,219,60.18
Senna,Annie,486,260,226,53.5
Senna,TwistedFate,538,246,292,45.72
Senna,AurelionSol,763,384,379,50.33
Senna,Zilean,470,250,220,53.19
Senna,Zyra,1487,737,750,49.56
Senna,KogMaw,566,277,289,48.94
Senna,Cassiopeia,533,256,277,48.03
Senna,Belveth,397,210,187,52.9
Senna,Taliyah,500,235,265,47
Senna,JarvanIV,922,456,466,49.46
Senna,Rumble,387,201,186,51.94
Senna,Akshan,612,324,288,52.94
Senna,Maokai,744,371,373,49.87
Senna,Illaoi,725,389,336,53.66
Senna,Zeri,708,367,341,51.84
Senna,RekSai,171,107,64,62.57
Galio,Gnar,767,393,374,51.24
Galio,Jax,1766,971,795,54.98
Galio,Yasuo,3414,1755,1659,51.41
Galio,Caitlyn,4621,2218,2403,48
Galio,Neeko,942,537,405,57.01
Galio,Teemo,2347,1136,1211,48.4
Galio,TahmKench,1413,775,638,54.85
Galio,Jinx,4738,2305,2433,48.65
Galio,Zoe,845,481,364,56.92
Galio,Nami,1758,921,837,52.39
Galio,Irelia,1517,797,720,52.54
Galio,Pantheon,2690,1442,1248,53.61
Galio,Kassadin,376,204,172,54.26
Galio,Jhin,3506,1805,1701,51.48
Galio,Yuumi,1538,828,710,53.84
Galio,Shaco,1577,837,740,53.08
Galio,Leblanc,1342,694,648,51.71
Galio,Ezreal,4670,2504,2166,53.62
Galio,Thresh,2683,1307,1376,48.71
Galio,Darius,3444,1746,1698,50.7
Galio,Viego,2600,1304,1296,50.15
Galio,AurelionSol,798,415,383,52.01
Galio,MissFortune,4009,2045,1964,51.01
Galio,Nautilus,2249,1181,1068,52.51
Galio,Gwen,1038,552,486,53.18
Galio,Mel,4044,2196,1848,54.3
Galio,Tristana,1707,960,747,56.24
Galio,Poppy,1214,618,596,50.91
Galio,Kayle,1155,616,539,53.33
Galio,Kayn,2408,1226,1182,50.91
Galio,Akali,2381,1243,1138,52.2
Galio,Soraka,972,457,515,47.02
Galio,Fiora,825,424,401,51.39
Galio,Amumu,1938,909,1029,46.9
Galio,Vladimir,1093,514,579,47.03
Galio,Varus,1675,857,818,51.16
Galio,Janna,531,247,284,46.52
Galio,Warwick,2666,1421,1245,53.3
Galio,Sejuani,735,320,415,43.54
Galio,Ahri,2828,1429,1399,50.53
Galio,Lux,4482,2236,2246,49.89
Galio,Singed,544,261,283,47.98
Galio,Vayne,2237,1070,1167,47.83
Galio,Leona,1786,929,857,52.02
Galio,Volibear,1881,971,910,51.62
Galio,Rammus,664,345,319,51.96
Galio,Aurora,1609,882,727,54.82
Galio,Ashe,3749,1937,1812,51.67
Galio,Sylas,3416,1823,1593,53.37
Galio,FiddleSticks,973,477,496,49.02
Galio,Aphelios,931,479,452,51.45
Galio,Morgana,2195,1110,1085,50.57
Galio,Trundle,1053,433,620,41.12
Galio,XinZhao,1185,559,626,47.17
Galio,Mordekaiser,2531,1275,1256,50.38
Galio,Samira,1168,578,590,49.49
Galio,Shen,1238,622,616,50.24
Galio,Ekko,1708,884,824,51.76
Galio,Qiyana,395,215,180,54.43
Galio,Twitch,1325,643,682,48.53
Galio,Senna,1370,680,690,49.64
Galio,Talon,1055,545,510,51.66
Galio,Chogath,2095,1018,1077,48.59
Galio,MasterYi,2123,1098,1025,51.72
Galio,Zed,1759,936,823,53.21
Galio,Aatrox,1851,946,905,51.11
Galio,Pyke,1572,775,797,49.3
Galio,Malphite,1911,1012,899,52.96
Galio,Yone,3565,1868,1697,52.4
Galio,Lulu,2432,1285,1147,52.84
Galio,Skarner,587,298,289,50.77
Galio,Zilean,567,250,317,44.09
Galio,Viktor,1556,776,780,49.87
Galio,Kindred,899,441,458,49.05
Galio,Lucian,1261,701,560,55.59
Galio,Sion,1464,742,722,50.68
Galio,Diana,3286,1746,1540,53.13
Galio,Orianna,758,407,351,53.69
Galio,Kaisa,3269,1804,1465,55.19
Galio,Khazix,907,504,403,55.57
Galio,Rell,918,501,417,54.58
Galio,Seraphine,1444,731,713,50.62
Galio,Rengar,593,364,229,61.38
Galio,Hwei,1427,727,700,50.95
Galio,Katarina,1624,929,695,57.2
Galio,Velkoz,1076,550,526,51.12
Galio,Camille,736,431,305,58.56
Galio,Braum,868,473,395,54.49
Galio,Xayah,1082,527,555,48.71
Galio,Rakan,810,442,368,54.57
Galio,Briar,1378,623,755,45.21
Galio,Heimerdinger,903,476,427,52.71
Galio,Zyra,1696,869,827,51.24
Galio,Fizz,1069,560,509,52.39
Galio,Sivir,1023,528,495,51.61
Galio,Xerath,1571,740,831,47.1
Galio,Kennen,522,273,249,52.3
Galio,TwistedFate,611,332,279,54.34
Galio,Nocturne,2230,1084,1146,48.61
Galio,Annie,579,319,260,55.09
Galio,Swain,2076,1026,1050,49.42
Galio,Shyvana,502,250,252,49.8
Galio,Belveth,440,211,229,47.95
Galio,Smolder,1355,764,591,56.38
Galio,Sett,2915,1478,1437,50.7
Galio,Garen,3036,1552,1484,51.12
Galio,Yorick,1606,758,848,47.2
Galio,Vex,883,493,390,55.83
Galio,Karma,2246,1163,1083,51.78
Galio,Gragas,1190,690,500,57.98
Galio,Nunu,1094,623,471,56.95
Galio,Sona,541,265,276,48.98
Galio,Lillia,1149,635,514,55.27
Galio,Ziggs,823,458,365,55.65
Galio,Nasus,1278,650,628,50.86
Galio,Naafiri,591,317,274,53.64
Galio,Syndra,1083,541,542,49.95
Galio,Blitzcrank,1279,652,627,50.98
Galio,LeeSin,2823,1512,1311,53.56
Galio,Ambessa,1267,720,547,56.83
Galio,Brand,1431,726,705,50.73
Galio,Azir,674,325,349,48.22
Galio,KogMaw,613,339,274,55.3
Galio,Nidalee,627,327,300,52.15
Galio,Evelynn,695,394,301,56.69
Galio,Riven,858,463,395,53.96
Galio,Vi,1860,1025,835,55.11
Galio,Veigar,1698,810,888,47.7
Galio,Jayce,936,533,403,56.94
Galio,Illaoi,854,390,464,45.67
Galio,Malzahar,1974,986,988,49.95
Galio,Anivia,634,335,299,52.84
Galio,Draven,997,548,449,54.96
Galio,Alistar,761,409,352,53.75
Galio,RekSai,285,136,149,47.72
Galio,Taliyah,438,201,237,45.89
Galio,Renekton,907,444,463,48.95
Galio,Milio,934,445,489,47.64
Galio,Olaf,451,219,232,48.56
Galio,Tryndamere,879,419,460,47.67
Galio,Nilah,643,356,287,55.37
Galio,Gangplank,1000,563,437,56.3
Galio,Graves,1228,593,635,48.29
Galio,Elise,1451,845,606,58.24
Galio,Cassiopeia,555,286,269,51.53
Galio,Corki,912,476,436,52.19
Galio,KSante,1140,576,564,50.53
Galio,Zeri,910,486,424,53.41
Galio,Zac,910,423,487,46.48
Galio,DrMundo,1043,486,557,46.6
Galio,Renata,375,179,196,47.73
Galio,MonkeyKing,1145,557,588,48.65
Galio,Ryze,676,327,349,48.37
Galio,Maokai,814,388,426,47.67
Galio,Quinn,652,329,323,50.46
Galio,Ornn,850,411,439,48.35
Galio,Lissandra,569,264,305,46.4
Galio,JarvanIV,1128,529,599,46.9
Galio,Hecarim,658,386,272,58.66
Galio,Udyr,720,397,323,55.14
Galio,Kalista,580,294,286,50.69
Galio,Rumble,659,341,318,51.75
Galio,Karthus,549,296,253,53.92
Galio,Bard,545,291,254,53.39
Galio,Urgot,784,404,380,51.53
Galio,Taric,344,159,185,46.22
Galio,Kled,296,149,147,50.34
Galio,Akshan,491,261,230,53.16
Galio,Ivern,268,161,107,60.07
Gnar,Irelia,916,411,505,44.87
Gnar,Zed,987,514,473,52.08
Gnar,Galio,767,374,393,48.76
Gnar,MissFortune,1961,905,1056,46.15
Gnar,TahmKench,898,396,502,44.1
Gnar,Naafiri,327,159,168,48.62
Gnar,Nunu,543,273,270,50.28
Gnar,Malzahar,876,411,465,46.92
Gnar,Zeri,412,188,224,45.63
Gnar,Mordekaiser,999,469,530,46.95
Gnar,Volibear,930,459,471,49.35
Gnar,Mel,1787,898,889,50.25
Gnar,Ashe,1660,832,828,50.12
Gnar,Neeko,458,214,244,46.72
Gnar,Amumu,890,393,497,44.16
Gnar,Pyke,725,359,366,49.52
Gnar,Varus,877,421,456,48
Gnar,Thresh,1287,640,647,49.73
Gnar,Sett,1336,664,672,49.7
Gnar,Warwick,1302,589,713,45.24
Gnar,Brand,650,330,320,50.77
Gnar,Twitch,720,324,396,45
Gnar,Morgana,946,449,497,47.46
Gnar,Tryndamere,451,231,220,51.22
Gnar,Sylas,1299,609,690,46.88
Gnar,Taliyah,259,123,136,47.49
Gnar,Jhin,1818,870,948,47.85
Gnar,Senna,715,357,358,49.93
Gnar,Darius,1790,886,904,49.5
Gnar,Kindred,428,219,209,51.17
Gnar,Veigar,861,416,445,48.32
Gnar,Corki,382,180,202,47.12
Gnar,Pantheon,1524,723,801,47.44
Gnar,Camille,319,145,174,45.45
Gnar,LeeSin,1281,654,627,51.05
Gnar,Draven,418,188,230,44.98
Gnar,Sion,662,312,350,47.13
Gnar,Zac,485,252,233,51.96
Gnar,AurelionSol,377,166,211,44.03
Gnar,Lux,2021,991,1030,49.04
Gnar,Teemo,1042,485,557,46.55
Gnar,Evelynn,413,214,199,51.82
Gnar,Ezreal,2193,1073,1120,48.93
Gnar,Seraphine,641,306,335,47.74
Gnar,Gangplank,528,250,278,47.35
Gnar,MasterYi,952,491,461,51.58
Gnar,Yone,1606,813,793,50.62
Gnar,Swain,937,402,535,42.9
Gnar,Gwen,417,246,171,58.99
Gnar,RekSai,144,84,60,58.33
Gnar,Kaisa,1404,748,656,53.28
Gnar,Leona,743,356,387,47.91
Gnar,Leblanc,502,223,279,44.42
Gnar,Aatrox,900,402,498,44.67
Gnar,Trundle,417,215,202,51.56
Gnar,Caitlyn,2294,1154,1140,50.31
Gnar,Lucian,633,289,344,45.66
Gnar,Karthus,314,176,138,56.05
Gnar,Kayn,1100,539,561,49
Gnar,Akali,919,432,487,47.01
Gnar,Sivir,474,249,225,52.53
Gnar,Hwei,601,266,335,44.26
Gnar,Poppy,608,299,309,49.18
Gnar,Kayle,462,215,247,46.54
Gnar,Fizz,432,217,215,50.23
Gnar,Jinx,2422,1140,1282,47.07
Gnar,Milio,552,211,341,38.22
Gnar,Rengar,326,186,140,57.06
Gnar,KogMaw,233,126,107,54.08
Gnar,Zoe,383,205,178,53.52
Gnar,Gragas,585,277,308,47.35
Gnar,Xayah,544,281,263,51.65
Gnar,Tristana,817,421,396,51.53
Gnar,Sona,219,118,101,53.88
Gnar,Nocturne,1078,539,539,50
Gnar,Velkoz,521,223,298,42.8
Gnar,Karma,983,435,548,44.25
Gnar,Smolder,597,311,286,52.09
Gnar,Syndra,544,241,303,44.3
Gnar,Vi,862,422,440,48.96
Gnar,Nautilus,1034,551,483,53.29
Gnar,Shaco,769,352,417,45.77
Gnar,Katarina,704,343,361,48.72
Gnar,Nami,987,458,529,46.4
Gnar,Yasuo,1743,830,913,47.62
Gnar,Lillia,468,191,277,40.81
Gnar,Malphite,1276,588,688,46.08
Gnar,Rakan,379,194,185,51.19
Gnar,Rell,450,221,229,49.11
Gnar,Garen,1343,682,661,50.78
Gnar,Lulu,1191,580,611,48.7
Gnar,Aphelios,428,215,213,50.23
Gnar,Azir,358,208,150,58.1
Gnar,Kennen,307,135,172,43.97
Gnar,Aurora,722,381,341,52.77
Gnar,XinZhao,611,262,349,42.88
Gnar,Viktor,836,418,418,50
Gnar,Kassadin,221,104,117,47.06
Gnar,Viego,1227,576,651,46.94
Gnar,Alistar,450,197,253,43.78
Gnar,Shen,622,267,355,42.93
Gnar,Maokai,382,192,190,50.26
Gnar,Nasus,560,267,293,47.68
Gnar,Talon,498,253,245,50.8
Gnar,Cassiopeia,283,117,166,41.34
Gnar,Vladimir,580,239,341,41.21
Gnar,Khazix,480,243,237,50.63
Gnar,Yuumi,745,390,355,52.35
Gnar,Sejuani,435,188,247,43.22
Gnar,Annie,314,169,145,53.82
Gnar,Lissandra,338,134,204,39.64
Gnar,Ivern,144,78,66,54.17
Gnar,Ambessa,598,259,339,43.31
Gnar,Zyra,744,334,410,44.89
Gnar,Illaoi,351,165,186,47.01
Gnar,Ekko,718,289,429,40.25
Gnar,Ahri,1261,595,666,47.18
Gnar,Samira,579,248,331,42.83
Gnar,Renekton,460,221,239,48.04
Gnar,Rammus,246,108,138,43.9
Gnar,Qiyana,232,146,86,62.93
Gnar,Udyr,361,186,175,51.52
Gnar,Soraka,468,225,243,48.08
Gnar,DrMundo,477,222,255,46.54
Gnar,Blitzcrank,651,358,293,54.99
Gnar,Jax,568,274,294,48.24
Gnar,Quinn,336,163,173,48.51
Gnar,Xerath,739,364,375,49.26
Gnar,Vayne,1029,470,559,45.68
Gnar,KSante,588,325,263,55.27
Gnar,Diana,1299,585,714,45.03
Gnar,Bard,235,113,122,48.09
Gnar,Yorick,790,341,449,43.16
Gnar,Skarner,308,158,150,51.3
Gnar,Nilah,290,116,174,40
Gnar,JarvanIV,515,270,245,52.43
Gnar,Riven,342,160,182,46.78
Gnar,Graves,586,291,295,49.66
Gnar,Braum,516,254,262,49.22
Gnar,Renata,256,127,129,49.61
Gnar,Ziggs,319,133,186,41.69
Gnar,Janna,331,162,169,48.94
Gnar,Fiora,275,131,144,47.64
Gnar,FiddleSticks,453,221,232,48.79
Gnar,Chogath,1135,593,542,52.25
Gnar,Ornn,403,171,232,42.43
Gnar,Jayce,513,271,242,52.83
Gnar,Singed,245,100,145,40.82
Gnar,Heimerdinger,360,160,200,44.44
Gnar,Orianna,404,193,211,47.77
Gnar,Elise,697,305,392,43.76
Gnar,Kalista,291,149,142,51.2
Gnar,Nidalee,284,149,135,52.46
Gnar,Ryze,323,163,160,50.46
Gnar,Hecarim,302,129,173,42.72
Gnar,Kled,170,88,82,51.76
Gnar,Briar,615,268,347,43.58
Gnar,Zilean,285,136,149,47.72
Gnar,Urgot,453,189,264,41.72
Gnar,MonkeyKing,529,289,240,54.63
Gnar,Vex,485,231,254,47.63
Gnar,Anivia,372,196,176,52.69
Gnar,Rumble,269,138,131,51.3
Gnar,Shyvana,249,134,115,53.82
Gnar,Olaf,249,127,122,51
Gnar,TwistedFate,341,155,186,45.45
Gnar,Belveth,189,87,102,46.03
Gnar,Taric,205,94,111,45.85
Gnar,Akshan,265,124,141,46.79
Riven,Gangplank,534,263,271,49.25
Riven,Ivern,193,124,69,64.25
Riven,Mel,2099,1080,1019,51.45
Riven,Jhin,1884,931,953,49.42
Riven,Swain,936,447,489,47.76
Riven,Urgot,592,268,324,45.27
Riven,Kayn,1332,631,701,47.37
Riven,Yasuo,2045,1043,1002,51
Riven,Twitch,807,387,420,47.96
Riven,Neeko,464,227,237,48.92
Riven,Gragas,558,271,287,48.57
Riven,Gwen,635,313,322,49.29
Riven,Zeri,460,213,247,46.3
Riven,Bard,323,154,169,47.68
Riven,Shen,664,339,325,51.05
Riven,Yone,1681,938,743,55.8
Riven,Ashe,1825,846,979,46.36
Riven,Alistar,412,176,236,42.72
Riven,XinZhao,685,272,413,39.71
Riven,Lucian,734,404,330,55.04
Riven,Velkoz,565,277,288,49.03
Riven,Evelynn,429,196,233,45.69
Riven,Irelia,761,334,427,43.89
Riven,Tristana,904,367,537,40.6
Riven,Lux,2161,972,1189,44.98
Riven,Azir,289,124,165,42.91
Riven,Sejuani,418,227,191,54.31
Riven,Sylas,1222,604,618,49.43
Riven,Seraphine,779,375,404,48.14
Riven,Mordekaiser,1340,606,734,45.22
Riven,Morgana,1031,460,571,44.62
Riven,Braum,589,273,316,46.35
Riven,Aurora,707,324,383,45.83
Riven,FiddleSticks,568,257,311,45.25
Riven,Vex,450,216,234,48
Riven,Sett,1478,691,787,46.75
Riven,Akali,988,511,477,51.72
Riven,Samira,770,416,354,54.03
Riven,Udyr,362,148,214,40.88
Riven,Orianna,437,241,196,55.15
Riven,Nautilus,1048,510,538,48.66
Riven,Yorick,732,328,404,44.81
Riven,MasterYi,1045,532,513,50.91
Riven,Nami,1065,475,590,44.6
Riven,Garen,1669,709,960,42.48
Riven,Zed,1185,622,563,52.49
Riven,Caitlyn,2338,1085,1253,46.41
Riven,Soraka,603,299,304,49.59
Riven,TahmKench,717,349,368,48.68
Riven,Malzahar,868,398,470,45.85
Riven,MissFortune,1893,843,1050,44.53
Riven,Blitzcrank,742,393,349,52.96
Riven,LeeSin,1299,723,576,55.66
Riven,Ahri,1199,535,664,44.62
Riven,Darius,2068,990,1078,47.87
Riven,Vladimir,684,333,351,48.68
Riven,Kindred,434,230,204,53
Riven,Sona,343,170,173,49.56
Riven,Khazix,547,284,263,51.92
Riven,Katarina,817,418,399,51.16
Riven,Aphelios,563,247,316,43.87
Riven,Lulu,1222,601,621,49.18
Riven,Briar,721,335,386,46.46
Riven,Corki,420,215,205,51.19
Riven,Pantheon,1416,580,836,40.96
Riven,Warwick,1290,578,712,44.81
Riven,Heimerdinger,324,170,154,52.47
Riven,Anivia,334,167,167,50
Riven,Viego,1390,705,685,50.72
Riven,Jax,817,392,425,47.98
Riven,Xayah,459,227,232,49.46
Riven,Fiora,519,257,262,49.52
Riven,Ezreal,2174,1104,1070,50.78
Riven,Akshan,301,149,152,49.5
Riven,Syndra,669,316,353,47.23
Riven,Xerath,725,360,365,49.66
Riven,Karma,1246,610,636,48.96
Riven,Rengar,335,166,169,49.55
Riven,Naafiri,305,132,173,43.28
Riven,DrMundo,397,176,221,44.33
Riven,Jinx,2495,1120,1375,44.89
Riven,Ekko,1041,497,544,47.74
Riven,Rakan,446,248,198,55.61
Riven,Diana,1416,637,779,44.99
Riven,Chogath,1057,460,597,43.52
Riven,Nunu,545,245,300,44.95
Riven,Viktor,798,395,403,49.5
Riven,Poppy,650,281,369,43.23
Riven,Zac,410,184,226,44.88
Riven,Kaisa,1592,841,751,52.83
Riven,Leblanc,505,260,245,51.49
Riven,Renekton,730,320,410,43.84
Riven,Rammus,381,153,228,40.16
Riven,Brand,569,275,294,48.33
Riven,Hecarim,404,185,219,45.79
Riven,Camille,405,217,188,53.58
Riven,Rell,565,263,302,46.55
Riven,JarvanIV,550,265,285,48.18
Riven,Zilean,319,170,149,53.29
Riven,KSante,474,235,239,49.58
Riven,Trundle,481,193,288,40.12
Riven,Kassadin,240,111,129,46.25
Riven,Milio,635,311,324,48.98
Riven,Nidalee,293,166,127,56.66
Riven,Pyke,783,348,435,44.44
Riven,Teemo,1073,488,585,45.48
Riven,Senna,746,363,383,48.66
Riven,Amumu,920,402,518,43.7
Riven,Qiyana,284,166,118,58.45
Riven,Zoe,374,189,185,50.53
Riven,Kled,168,47,121,27.98
Riven,Draven,632,303,329,47.94
Riven,Volibear,982,424,558,43.18
Riven,Yuumi,806,379,427,47.02
Riven,Annie,335,176,159,52.54
Riven,Nilah,342,120,222,35.09
Riven,Aatrox,844,407,437,48.22
Riven,Shaco,833,382,451,45.86
Riven,Thresh,1382,625,757,45.22
Riven,Kennen,343,191,152,55.69
Riven,Ryze,287,148,139,51.57
Riven,Taric,276,112,164,40.58
Riven,Malphite,1011,414,597,40.95
Riven,Ambessa,725,409,316,56.41
Riven,Singed,272,106,166,38.97
Riven,Renata,212,100,112,47.17
Riven,Vi,908,405,503,44.6
Riven,Ziggs,410,206,204,50.24
Riven,Veigar,943,400,543,42.42
Riven,Graves,644,330,314,51.24
Riven,Cassiopeia,270,132,138,48.89
Riven,Maokai,385,178,207,46.23
Riven,Vayne,1174,617,557,52.56
Riven,Zyra,737,355,382,48.17
Riven,Illaoi,435,176,259,40.46
Riven,Galio,858,395,463,46.04
Riven,Tryndamere,487,253,234,51.95
Riven,Lillia,492,226,266,45.93
Riven,Leona,640,291,349,45.47
Riven,Sion,748,337,411,45.05
Riven,Skarner,287,152,135,52.96
Riven,Lissandra,347,176,171,50.72
Riven,Karthus,290,139,151,47.93
Riven,Gnar,342,182,160,53.22
Riven,MonkeyKing,678,300,378,44.25
Riven,Sivir,512,236,276,46.09
Riven,Varus,767,394,373,51.37
Riven,Shyvana,217,122,95,56.22
Riven,Smolder,580,298,282,51.38
Riven,Elise,727,361,366,49.66
Riven,Hwei,668,318,350,47.6
Riven,KogMaw,300,154,146,51.33
Riven,Ornn,398,150,248,37.69
Riven,Fizz,538,228,310,42.38
Riven,Talon,601,325,276,54.08
Riven,Kayle,561,265,296,47.24
Riven,AurelionSol,337,138,199,40.95
Riven,Nocturne,1012,474,538,46.84
Riven,Janna,389,173,216,44.47
Riven,Nasus,689,318,371,46.15
Riven,TwistedFate,351,165,186,47.01
Riven,Kalista,274,125,149,45.62
Riven,Rumble,287,129,158,44.95
Riven,Jayce,463,216,247,46.65
Riven,Belveth,191,96,95,50.26
Riven,Taliyah,256,110,146,42.97
Riven,Quinn,319,161,158,50.47
Riven,Olaf,166,77,89,46.39
Riven,RekSai,147,72,75,48.98
AurelionSol,Heimerdinger,445,217,228,48.76
AurelionSol,Warwick,1268,694,574,54.73
AurelionSol,Neeko,475,277,198,58.32
AurelionSol,Draven,437,240,197,54.92
AurelionSol,Leona,786,415,371,52.8
AurelionSol,Talon,429,256,173,59.67
AurelionSol,Ahri,1142,590,552,51.66
AurelionSol,Kalista,302,191,111,63.25
AurelionSol,Brand,648,337,311,52.01
AurelionSol,Braum,522,293,229,56.13
AurelionSol,XinZhao,457,235,222,51.42
AurelionSol,Lux,2378,1284,1094,53.99
AurelionSol,Chogath,1191,610,581,51.22
AurelionSol,Taliyah,254,149,105,58.66
AurelionSol,Poppy,506,272,234,53.75
AurelionSol,Diana,1214,609,605,50.16
AurelionSol,Anivia,344,165,179,47.97
AurelionSol,Caitlyn,2273,1185,1088,52.13
AurelionSol,Thresh,1115,534,581,47.89
AurelionSol,Fiora,333,189,144,56.76
AurelionSol,Yone,1465,738,727,50.38
AurelionSol,Galio,798,383,415,47.99
AurelionSol,Ezreal,1927,982,945,50.96
AurelionSol,Tristana,793,369,424,46.53
AurelionSol,Veigar,1079,574,505,53.2
AurelionSol,Ziggs,381,166,215,43.57
AurelionSol,KSante,400,207,193,51.75
AurelionSol,Udyr,334,188,146,56.29
AurelionSol,Ashe,1626,855,771,52.58
AurelionSol,Nautilus,974,499,475,51.23
AurelionSol,Aurora,641,351,290,54.76
AurelionSol,FiddleSticks,395,220,175,55.7
AurelionSol,Yasuo,1695,838,857,49.44
AurelionSol,Jhin,1658,832,826,50.18
AurelionSol,Vex,357,201,156,56.3
AurelionSol,Gnar,377,211,166,55.97
AurelionSol,Volibear,985,547,438,55.53
AurelionSol,Mel,2378,1256,1122,52.82
AurelionSol,Samira,679,378,301,55.67
AurelionSol,Seraphine,771,379,392,49.16
AurelionSol,Pantheon,1277,669,608,52.39
AurelionSol,Kindred,381,179,202,46.98
AurelionSol,Teemo,1092,533,559,48.81
AurelionSol,Lucian,620,368,252,59.35
AurelionSol,Zyra,710,356,354,50.14
AurelionSol,Khazix,409,205,204,50.12
AurelionSol,Varus,703,328,375,46.66
AurelionSol,Yuumi,731,346,385,47.33
AurelionSol,TahmKench,802,438,364,54.61
AurelionSol,Nocturne,1053,561,492,53.28
AurelionSol,Qiyana,219,104,115,47.49
AurelionSol,Sett,1315,653,662,49.66
AurelionSol,Briar,759,405,354,53.36
AurelionSol,Nilah,330,165,165,50
AurelionSol,Morgana,967,453,514,46.85
AurelionSol,Kayn,1153,574,579,49.78
AurelionSol,Akali,710,383,327,53.94
AurelionSol,Sivir,456,215,241,47.15
AurelionSol,Hwei,618,329,289,53.24
AurelionSol,Urgot,491,219,272,44.6
AurelionSol,Sylas,857,440,417,51.34
AurelionSol,Zed,789,391,398,49.56
AurelionSol,Rakan,387,198,189,51.16
AurelionSol,Zoe,338,175,163,51.78
AurelionSol,Nunu,579,319,260,55.09
AurelionSol,Katarina,654,312,342,47.71
AurelionSol,Pyke,839,475,364,56.62
AurelionSol,Ekko,738,365,373,49.46
AurelionSol,Shaco,884,505,379,57.13
AurelionSol,Velkoz,570,282,288,49.47
AurelionSol,Darius,1679,858,821,51.1
AurelionSol,Jax,802,422,380,52.62
AurelionSol,MissFortune,2126,1128,998,53.06
AurelionSol,Illaoi,418,220,198,52.63
AurelionSol,Ryze,302,158,144,52.32
AurelionSol,Blitzcrank,703,376,327,53.49
AurelionSol,Yorick,886,454,432,51.24
AurelionSol,Viego,1176,522,654,44.39
AurelionSol,Vi,859,433,426,50.41
AurelionSol,Singed,286,160,126,55.94
AurelionSol,Gwen,475,283,192,59.58
AurelionSol,Amumu,973,445,528,45.73
AurelionSol,Garen,1325,611,714,46.11
AurelionSol,Jinx,2276,1112,1164,48.86
AurelionSol,Nami,807,440,367,54.52
AurelionSol,Mordekaiser,1251,555,696,44.36
AurelionSol,Rengar,254,139,115,54.72
AurelionSol,Hecarim,399,204,195,51.13
AurelionSol,Twitch,683,370,313,54.17
AurelionSol,DrMundo,507,267,240,52.66
AurelionSol,Graves,656,363,293,55.34
AurelionSol,Zac,379,226,153,59.63
AurelionSol,Irelia,605,327,278,54.05
AurelionSol,Alistar,340,194,146,57.06
AurelionSol,Evelynn,387,254,133,65.63
AurelionSol,Syndra,631,347,284,54.99
AurelionSol,Kled,171,86,85,50.29
AurelionSol,Lillia,562,235,327,41.81
AurelionSol,MonkeyKing,537,285,252,53.07
AurelionSol,Elise,599,325,274,54.26
AurelionSol,Kayle,580,281,299,48.45
AurelionSol,Vladimir,507,282,225,55.62
AurelionSol,Malphite,791,412,379,52.09
AurelionSol,Kassadin,172,82,90,47.67
AurelionSol,Sion,709,355,354,50.07
AurelionSol,Leblanc,370,162,208,43.78
AurelionSol,LeeSin,1140,610,530,53.51
AurelionSol,MasterYi,1023,518,505,50.64
AurelionSol,Kaisa,1376,738,638,53.63
AurelionSol,Vayne,1078,519,559,48.14
AurelionSol,Nidalee,260,128,132,49.23
AurelionSol,Aphelios,482,243,239,50.41
AurelionSol,Xerath,655,333,322,50.84
AurelionSol,Soraka,509,282,227,55.4
AurelionSol,Jayce,456,255,201,55.92
AurelionSol,Milio,448,221,227,49.33
AurelionSol,Shen,599,308,291,51.42
AurelionSol,Naafiri,344,155,189,45.06
AurelionSol,Zeri,362,191,171,52.76
AurelionSol,TwistedFate,324,172,152,53.09
AurelionSol,Sona,270,132,138,48.89
AurelionSol,Malzahar,1198,649,549,54.17
AurelionSol,Aatrox,866,497,369,57.39
AurelionSol,Karthus,256,115,141,44.92
AurelionSol,Taric,243,135,108,55.56
AurelionSol,Ambessa,541,281,260,51.94
AurelionSol,Viktor,769,392,377,50.98
AurelionSol,Senna,763,379,384,49.67
AurelionSol,KogMaw,306,177,129,57.84
AurelionSol,Maokai,398,201,197,50.5
AurelionSol,Quinn,313,179,134,57.19
AurelionSol,Lulu,965,498,467,51.61
AurelionSol,Trundle,569,287,282,50.44
AurelionSol,Ornn,359,184,175,51.25
AurelionSol,JarvanIV,497,265,232,53.32
AurelionSol,Shyvana,217,97,120,44.7
AurelionSol,Fizz,553,270,283,48.82
AurelionSol,Rammus,276,151,125,54.71
AurelionSol,Zilean,270,132,138,48.89
AurelionSol,Xayah,406,242,164,59.61
AurelionSol,Karma,841,455,386,54.1
AurelionSol,Nasus,743,376,367,50.61
AurelionSol,Olaf,210,107,103,50.95
AurelionSol,Riven,337,199,138,59.05
AurelionSol,Swain,854,460,394,53.86
AurelionSol,Tryndamere,510,267,243,52.35
AurelionSol,Sejuani,368,189,179,51.36
AurelionSol,Gragas,477,257,220,53.88
AurelionSol,Smolder,597,345,252,57.79
AurelionSol,Skarner,269,132,137,49.07
AurelionSol,Renata,161,84,77,52.17
AurelionSol,Rell,535,300,235,56.07
AurelionSol,RekSai,105,53,52,50.48
AurelionSol,Corki,299,178,121,59.53
AurelionSol,Orianna,389,212,177,54.5
AurelionSol,Bard,242,133,109,54.96
AurelionSol,Lissandra,282,131,151,46.45
AurelionSol,Camille,323,178,145,55.11
AurelionSol,Janna,264,154,110,58.33
AurelionSol,Akshan,310,166,144,53.55
AurelionSol,Rumble,162,69,93,42.59
AurelionSol,Ivern,173,108,65,62.43
AurelionSol,Belveth,204,105,99,51.47
AurelionSol,Annie,268,141,127,52.61
AurelionSol,Gangplank,415,234,181,56.39
AurelionSol,Renekton,405,212,193,52.35
AurelionSol,Azir,286,180,106,62.94
AurelionSol,Kennen,212,107,105,50.47
AurelionSol,Cassiopeia,257,103,154,40.08
Heimerdinger,Yone,2013,1108,905,55.04
Heimerdinger,Shaco,1036,562,474,54.25
Heimerdinger,AurelionSol,445,228,217,51.24
Heimerdinger,Ashe,2027,994,1033,49.04
Heimerdinger,Velkoz,593,285,308,48.06
Heimerdinger,Yorick,1040,494,546,47.5
Heimerdinger,Kayn,1563,838,725,53.61
Heimerdinger,Singed,317,140,177,44.16
Heimerdinger,Udyr,316,174,142,55.06
Heimerdinger,Mordekaiser,1511,804,707,53.21
Heimerdinger,Briar,780,346,434,44.36
Heimerdinger,Zed,1049,547,502,52.14
Heimerdinger,Jinx,2700,1330,1370,49.26
Heimerdinger,Lillia,672,350,322,52.08
Heimerdinger,Darius,2153,1149,1004,53.37
Heimerdinger,Volibear,1113,555,558,49.87
Heimerdinger,Caitlyn,2636,1391,1245,52.77
Heimerdinger,TahmKench,926,480,446,51.84
Heimerdinger,Garen,1543,768,775,49.77
Heimerdinger,Tristana,928,504,424,54.31
Heimerdinger,Lux,2861,1420,1441,49.63
Heimerdinger,Morgana,1419,774,645,54.55
Heimerdinger,Warwick,1669,859,810,51.47
Heimerdinger,Akali,1083,616,467,56.88
Heimerdinger,Akshan,403,195,208,48.39
Heimerdinger,Pantheon,1567,866,701,55.26
Heimerdinger,Leblanc,438,264,174,60.27
Heimerdinger,Aphelios,578,331,247,57.27
Heimerdinger,Leona,804,423,381,52.61
Heimerdinger,Nunu,763,363,400,47.58
Heimerdinger,KSante,356,207,149,58.15
Heimerdinger,Zeri,379,177,202,46.7
Heimerdinger,Lulu,1040,473,567,45.48
Heimerdinger,Malphite,986,543,443,55.07
Heimerdinger,Jhin,2020,1024,996,50.69
Heimerdinger,Evelynn,392,224,168,57.14
Heimerdinger,Gragas,531,300,231,56.5
Heimerdinger,Pyke,953,522,431,54.77
Heimerdinger,MasterYi,1204,620,584,51.5
Heimerdinger,Aatrox,843,486,357,57.65
Heimerdinger,Viego,1192,612,580,51.34
Heimerdinger,Fizz,605,330,275,54.55
Heimerdinger,Taric,191,99,92,51.83
Heimerdinger,Trundle,582,265,317,45.53
Heimerdinger,Nocturne,1166,599,567,51.37
Heimerdinger,Orianna,491,252,239,51.32
Heimerdinger,Veigar,1227,584,643,47.6
Heimerdinger,Brand,857,420,437,49.01
Heimerdinger,Ivern,151,96,55,63.58
Heimerdinger,Katarina,825,467,358,56.61
Heimerdinger,Nami,927,513,414,55.34
Heimerdinger,Teemo,1637,837,800,51.13
Heimerdinger,Vi,923,470,453,50.92
Heimerdinger,Bard,242,132,110,54.55
Heimerdinger,Vladimir,668,346,322,51.8
Heimerdinger,Sylas,1244,788,456,63.34
Heimerdinger,Ekko,913,469,444,51.37
Heimerdinger,Syndra,685,350,335,51.09
Heimerdinger,Samira,833,437,396,52.46
Heimerdinger,Maokai,383,203,180,53
Heimerdinger,Swain,1052,527,525,50.1
Heimerdinger,MonkeyKing,605,289,316,47.77
Heimerdinger,Ezreal,2077,1116,961,53.73
Heimerdinger,Tryndamere,658,342,316,51.98
Heimerdinger,Irelia,887,507,380,57.16
Heimerdinger,Nautilus,1060,541,519,51.04
Heimerdinger,Olaf,287,158,129,55.05
Heimerdinger,Aurora,819,421,398,51.4
Heimerdinger,Kaisa,1436,786,650,54.74
Heimerdinger,Poppy,504,293,211,58.13
Heimerdinger,Illaoi,532,314,218,59.02
Heimerdinger,Anivia,330,144,186,43.64
Heimerdinger,JarvanIV,383,188,195,49.09
Heimerdinger,MissFortune,2684,1345,1339,50.11
Heimerdinger,RekSai,135,72,63,53.33
Heimerdinger,Seraphine,1041,588,453,56.48
Heimerdinger,Riven,324,154,170,47.53
Heimerdinger,Hwei,677,363,314,53.62
Heimerdinger,Vex,635,285,350,44.88
Heimerdinger,Mel,2064,1112,952,53.88
Heimerdinger,Twitch,831,416,415,50.06
Heimerdinger,Xayah,525,268,257,51.05
Heimerdinger,Rengar,293,149,144,50.85
Heimerdinger,Shen,688,348,340,50.58
Heimerdinger,Thresh,1185,656,529,55.36
Heimerdinger,Gwen,502,281,221,55.98
Heimerdinger,Blitzcrank,759,393,366,51.78
Heimerdinger,Xerath,766,391,375,51.04
Heimerdinger,Yasuo,2111,1025,1086,48.56
Heimerdinger,Sett,1693,862,831,50.92
Heimerdinger,Lucian,692,363,329,52.46
Heimerdinger,LeeSin,1202,681,521,56.66
Heimerdinger,Malzahar,988,461,527,46.66
Heimerdinger,Galio,903,427,476,47.29
Heimerdinger,Yuumi,752,415,337,55.19
Heimerdinger,Viktor,734,358,376,48.77
Heimerdinger,Graves,522,274,248,52.49
Heimerdinger,Diana,1549,841,708,54.29
Heimerdinger,Draven,508,263,245,51.77
Heimerdinger,Nidalee,248,134,114,54.03
Heimerdinger,Amumu,1104,535,569,48.46
Heimerdinger,Renata,201,93,108,46.27
Heimerdinger,Smolder,678,377,301,55.6
Heimerdinger,Rell,488,230,258,47.13
Heimerdinger,Varus,736,408,328,55.43
Heimerdinger,Jax,820,460,360,56.1
Heimerdinger,Sivir,476,271,205,56.93
Heimerdinger,Sona,409,202,207,49.39
Heimerdinger,Kled,186,110,76,59.14
Heimerdinger,Nasus,954,474,480,49.69
Heimerdinger,Kalista,292,173,119,59.25
Heimerdinger,Ambessa,475,261,214,54.95
Heimerdinger,Naafiri,405,223,182,55.06
Heimerdinger,Milio,451,234,217,51.88
Heimerdinger,Ryze,333,153,180,45.95
Heimerdinger,XinZhao,622,338,284,54.34
Heimerdinger,Chogath,1228,590,638,48.05
Heimerdinger,Khazix,572,337,235,58.92
Heimerdinger,Nilah,349,216,133,61.89
Heimerdinger,Senna,739,394,345,53.32
Heimerdinger,Zyra,882,426,456,48.3
Heimerdinger,Ziggs,463,241,222,52.05
Heimerdinger,FiddleSticks,500,273,227,54.6
Heimerdinger,Braum,495,251,244,50.71
Heimerdinger,Camille,238,135,103,56.72
Heimerdinger,Vayne,1186,648,538,54.64
Heimerdinger,Neeko,668,378,290,56.59
Heimerdinger,Qiyana,250,138,112,55.2
Heimerdinger,Soraka,562,286,276,50.89
Heimerdinger,Kayle,633,337,296,53.24
Heimerdinger,Corki,305,193,112,63.28
Heimerdinger,Taliyah,236,114,122,48.31
Heimerdinger,Rakan,415,209,206,50.36
Heimerdinger,Annie,309,169,140,54.69
Heimerdinger,Talon,543,347,196,63.9
Heimerdinger,Quinn,408,241,167,59.07
Heimerdinger,DrMundo,631,333,298,52.77
Heimerdinger,Elise,585,306,279,52.31
Heimerdinger,Gnar,360,200,160,55.56
Heimerdinger,Belveth,264,151,113,57.2
Heimerdinger,Urgot,456,211,245,46.27
Heimerdinger,Kindred,455,235,220,51.65
Heimerdinger,Karma,991,523,468,52.77
Heimerdinger,Sejuani,352,177,175,50.28
Heimerdinger,Zoe,324,194,130,59.88
Heimerdinger,Zilean,347,158,189,45.53
Heimerdinger,TwistedFate,308,188,120,61.04
Heimerdinger,Rammus,279,141,138,50.54
Heimerdinger,Fiora,374,207,167,55.35
Heimerdinger,Renekton,414,204,210,49.28
Heimerdinger,Ahri,1316,715,601,54.33
Heimerdinger,Kennen,331,176,155,53.17
Heimerdinger,Shyvana,275,125,150,45.45
Heimerdinger,Zac,438,218,220,49.77
Heimerdinger,Jayce,509,299,210,58.74
Heimerdinger,Azir,316,190,126,60.13
Heimerdinger,Ornn,385,213,172,55.32
Heimerdinger,Skarner,262,156,106,59.54
Heimerdinger,Gangplank,484,255,229,52.69
Heimerdinger,Alistar,376,220,156,58.51
Heimerdinger,Lissandra,308,161,147,52.27
Heimerdinger,Rumble,246,139,107,56.5
Heimerdinger,Karthus,299,109,190,36.45
Heimerdinger,Sion,825,408,417,49.45
Heimerdinger,Janna,267,154,113,57.68
Heimerdinger,Kassadin,233,86,147,36.91
Heimerdinger,Cassiopeia,308,150,158,48.7
Heimerdinger,KogMaw,319,144,175,45.14
Heimerdinger,Hecarim,309,175,134,56.63
Nocturne,Teemo,3232,1644,1588,50.87
Nocturne,TahmKench,2105,1092,1013,51.88
Nocturne,Jinx,6570,3379,3191,51.43
Nocturne,Zoe,948,502,446,52.95
Nocturne,Nami,2467,1291,1176,52.33
Nocturne,Gragas,1363,767,596,56.27
Nocturne,Gwen,1364,682,682,50
Nocturne,Yasuo,5022,2781,2241,55.38
Nocturne,Zeri,1092,495,597,45.33
Nocturne,Bard,716,331,385,46.23
Nocturne,Sylas,3660,1833,1827,50.08
Nocturne,Ekko,2369,1257,1112,53.06
Nocturne,Talon,1428,675,753,47.27
Nocturne,Pyke,2070,993,1077,47.97
Nocturne,Yorick,2313,1221,1092,52.79
Nocturne,Ezreal,5825,3089,2736,53.03
Nocturne,Lux,6407,3446,2961,53.78
Nocturne,Fiora,923,525,398,56.88
Nocturne,LeeSin,3812,2146,1666,56.3
Nocturne,Ziggs,935,473,462,50.59
Nocturne,Senna,1867,1022,845,54.74
Nocturne,Illaoi,1178,585,593,49.66
Nocturne,Khazix,1356,759,597,55.97
Nocturne,Syndra,1551,839,712,54.09
Nocturne,Kaisa,4244,2264,1980,53.35
Nocturne,Kennen,706,346,360,49.01
Nocturne,Skarner,653,368,285,56.36
Nocturne,Malzahar,2570,1398,1172,54.4
Nocturne,Yuumi,2156,1093,1063,50.7
Nocturne,Akali,2571,1305,1266,50.76
Nocturne,Naafiri,876,498,378,56.85
Nocturne,Kayle,1566,711,855,45.4
Nocturne,MissFortune,5685,2881,2804,50.68
Nocturne,Smolder,1669,922,747,55.24
Nocturne,Evelynn,1067,590,477,55.3
Nocturne,Brand,1910,978,932,51.2
Nocturne,Sett,3793,1948,1845,51.36
Nocturne,FiddleSticks,1260,652,608,51.75
Nocturne,Tristana,2503,1352,1151,54.02
Nocturne,Blitzcrank,1963,1106,857,56.34
Nocturne,Ornn,1115,569,546,51.03
Nocturne,Amumu,2795,1366,1429,48.87
Nocturne,Katarina,1752,940,812,53.65
Nocturne,Twitch,2002,1073,929,53.6
Nocturne,RekSai,303,149,154,49.17
Nocturne,Hwei,1683,832,851,49.44
Nocturne,Ashe,4961,2651,2310,53.44
Nocturne,Braum,1432,734,698,51.26
Nocturne,MasterYi,3176,1553,1623,48.9
Nocturne,Shaco,2630,1406,1224,53.46
Nocturne,Azir,834,480,354,57.55
Nocturne,Rengar,863,490,373,56.78
Nocturne,Kindred,1181,604,577,51.14
Nocturne,Veigar,2473,1271,1202,51.4
Nocturne,Yone,4397,2270,2127,51.63
Nocturne,Lulu,3233,1721,1512,53.23
Nocturne,Neeko,1256,676,580,53.82
Nocturne,Kayn,3685,1964,1721,53.3
Nocturne,Heimerdinger,1166,567,599,48.63
Nocturne,Corki,1094,621,473,56.76
Nocturne,Elise,1908,1022,886,53.56
Nocturne,Darius,4721,2514,2207,53.25
Nocturne,Karma,2757,1409,1348,51.11
Nocturne,Briar,2080,1041,1039,50.05
Nocturne,Cassiopeia,636,341,295,53.62
Nocturne,Jhin,5058,2661,2397,52.61
Nocturne,KSante,1359,726,633,53.42
Nocturne,Ahri,3326,1774,1552,53.34
Nocturne,Caitlyn,6527,3564,2963,54.6
Nocturne,Garen,4095,2078,2017,50.74
Nocturne,AurelionSol,1053,492,561,46.72
Nocturne,Kalista,728,385,343,52.88
Nocturne,Singed,733,372,361,50.75
Nocturne,Varus,2039,1103,936,54.1
Nocturne,Maokai,1129,572,557,50.66
Nocturne,Warwick,3957,1975,1982,49.91
Nocturne,Lucian,1868,942,926,50.43
Nocturne,Zilean,922,456,466,49.46
Nocturne,Sona,798,437,361,54.76
Nocturne,Ivern,402,193,209,48.01
Nocturne,Irelia,2197,1241,956,56.49
Nocturne,Poppy,1491,801,690,53.72
Nocturne,Mordekaiser,3223,1669,1554,51.78
Nocturne,Akshan,821,415,406,50.55
Nocturne,Jax,2322,1201,1121,51.72
Nocturne,Volibear,2937,1534,1403,52.23
Nocturne,Ambessa,1670,975,695,58.38
Nocturne,Mel,4951,2820,2131,56.96
Nocturne,Xayah,1465,776,689,52.97
Nocturne,Rakan,980,472,508,48.16
Nocturne,Sejuani,1080,586,494,54.26
Nocturne,Urgot,1294,623,671,48.15
Nocturne,Seraphine,2045,1108,937,54.18
Nocturne,Gangplank,1434,808,626,56.35
Nocturne,Kled,423,234,189,55.32
Nocturne,Pantheon,4125,2214,1911,53.67
Nocturne,Vex,1447,729,718,50.38
Nocturne,Chogath,2917,1559,1358,53.45
Nocturne,Aphelios,1381,764,617,55.32
Nocturne,Karthus,714,378,336,52.94
Nocturne,Taliyah,584,320,264,54.79
Nocturne,Morgana,2971,1599,1372,53.82
Nocturne,Viego,3283,1628,1655,49.59
Nocturne,Leblanc,1473,801,672,54.38
Nocturne,Gnar,1078,539,539,50
Nocturne,Samira,1687,808,879,47.9
Nocturne,Leona,2225,1171,1054,52.63
Nocturne,Draven,1253,687,566,54.83
Nocturne,Zed,2751,1458,1293,53
Nocturne,Lillia,1408,741,667,52.63
Nocturne,Trundle,1534,814,720,53.06
Nocturne,Lissandra,859,471,388,54.83
Nocturne,JarvanIV,1688,838,850,49.64
Nocturne,Tryndamere,1229,673,556,54.76
Nocturne,Orianna,1096,557,539,50.82
Nocturne,Diana,4023,2048,1975,50.91
Nocturne,Kassadin,519,237,282,45.66
Nocturne,Galio,2230,1146,1084,51.39
Nocturne,Swain,2362,1096,1266,46.4
Nocturne,Nilah,912,485,427,53.18
Nocturne,Nautilus,2725,1450,1275,53.21
Nocturne,Nasus,1763,896,867,50.82
Nocturne,Zyra,2288,1164,1124,50.87
Nocturne,Ryze,922,489,433,53.04
Nocturne,Janna,715,351,364,49.09
Nocturne,Vi,2567,1450,1117,56.49
Nocturne,Vladimir,1597,801,796,50.16
Nocturne,Malphite,2629,1388,1241,52.8
Nocturne,Thresh,3480,1809,1671,51.98
Nocturne,Quinn,916,454,462,49.56
Nocturne,Hecarim,958,486,472,50.73
Nocturne,Renekton,1094,568,526,51.92
Nocturne,Qiyana,592,333,259,56.25
Nocturne,Vayne,2955,1443,1512,48.83
Nocturne,Viktor,2078,1029,1049,49.52
Nocturne,Annie,778,457,321,58.74
Nocturne,Shen,1497,798,699,53.31
Nocturne,Jayce,1062,575,487,54.14
Nocturne,Aatrox,2515,1430,1085,56.86
Nocturne,Nunu,1563,772,791,49.39
Nocturne,Fizz,1367,694,673,50.77
Nocturne,Rell,1305,724,581,55.48
Nocturne,Sivir,1456,719,737,49.38
Nocturne,Velkoz,1546,766,780,49.55
Nocturne,Camille,900,512,388,56.89
Nocturne,Soraka,1331,665,666,49.96
Nocturne,Alistar,1015,591,424,58.23
Nocturne,XinZhao,1868,928,940,49.68
Nocturne,Graves,1601,895,706,55.9
Nocturne,Anivia,769,382,387,49.67
Nocturne,Aurora,1953,1070,883,54.79
Nocturne,Renata,500,252,248,50.4
Nocturne,Zac,1182,575,607,48.65
Nocturne,DrMundo,1395,691,704,49.53
Nocturne,Olaf,631,329,302,52.14
Nocturne,Xerath,2218,1235,983,55.68
Nocturne,Taric,488,236,252,48.36
Nocturne,MonkeyKing,1907,988,919,51.81
Nocturne,Rumble,586,313,273,53.41
Nocturne,Sion,1742,895,847,51.38
Nocturne,Shyvana,674,351,323,52.08
Nocturne,Milio,1248,623,625,49.92
Nocturne,Udyr,916,457,459,49.89
Nocturne,Riven,1012,538,474,53.16
Nocturne,KogMaw,706,379,327,53.68
Nocturne,Rammus,805,449,356,55.78
Nocturne,TwistedFate,861,514,347,59.7
Nocturne,Nidalee,737,412,325,55.9
Nocturne,Belveth,633,392,241,61.93
Nami,Vayne,2477,1235,1242,49.86
Nami,Nocturne,2467,1176,1291,47.67
Nami,Kaisa,3240,1651,1589,50.96
Nami,Galio,1758,837,921,47.61
Nami,Blitzcrank,1339,680,659,50.78
Nami,Mordekaiser,2681,1341,1340,50.02
Nami,Amumu,2138,1046,1092,48.92
Nami,Yasuo,3796,1938,1858,51.05
Nami,Caitlyn,5294,2674,2620,50.51
Nami,Soraka,1509,775,734,51.36
Nami,Shen,1300,715,585,55
Nami,Gragas,1210,654,556,54.05
Nami,Yone,3411,1780,1631,52.18
Nami,Ashe,3940,2031,1909,51.55
Nami,Alistar,742,411,331,55.39
Nami,TwistedFate,817,443,374,54.22
Nami,LeeSin,2572,1436,1136,55.83
Nami,Nilah,855,433,422,50.64
Nami,Brand,1350,692,658,51.26
Nami,Sett,2992,1421,1571,47.49
Nami,Briar,1404,725,679,51.64
Nami,Hwei,1522,794,728,52.17
Nami,TahmKench,1788,934,854,52.24
Nami,KSante,1044,601,443,57.57
Nami,Udyr,841,467,374,55.53
Nami,Veigar,2113,1071,1042,50.69
Nami,Nautilus,2125,1170,955,55.06
Nami,Kayn,3039,1569,1470,51.63
Nami,MissFortune,4438,2355,2083,53.06
Nami,Lux,5513,2828,2685,51.3
Nami,Volibear,2367,1263,1104,53.36
Nami,Ivern,451,220,231,48.78
Nami,Irelia,1677,914,763,54.5
Nami,Swain,1922,1028,894,53.49
Nami,Chogath,2793,1368,1425,48.98
Nami,Jayce,858,466,392,54.31
Nami,Samira,1533,798,735,52.05
Nami,Lulu,3916,2060,1856,52.6
Nami,Zed,2322,1296,1026,55.81
Nami,Ekko,1880,984,896,52.34
Nami,Tristana,1767,888,879,50.25
Nami,Kayle,1559,813,746,52.15
Nami,FiddleSticks,1082,521,561,48.15
Nami,Katarina,1734,952,782,54.9
Nami,Jhin,4326,2205,2121,50.97
Nami,Riven,1065,590,475,55.4
Nami,Lillia,1042,579,463,55.57
Nami,Orianna,983,528,455,53.71
Nami,Velkoz,1289,641,648,49.73
Nami,Garen,3318,1559,1759,46.99
Nami,Aurora,1540,780,760,50.65
Nami,Heimerdinger,927,414,513,44.66
Nami,Viktor,1888,1016,872,53.81
Nami,Aatrox,2224,1180,1044,53.06
Nami,Cassiopeia,638,300,338,47.02
Nami,Varus,1887,981,906,51.99
Nami,Morgana,2246,1164,1082,51.83
Nami,Olaf,454,205,249,45.15
Nami,Yorick,2055,963,1092,46.86
Nami,Diana,3406,1725,1681,50.65
Nami,Akali,1982,1008,974,50.86
Nami,Twitch,1818,866,952,47.63
Nami,Zilean,783,379,404,48.4
Nami,Fiora,894,419,475,46.87
Nami,Rammus,581,290,291,49.91
Nami,Renekton,1078,624,454,57.88
Nami,Zyra,1866,859,1007,46.03
Nami,Nidalee,579,365,214,63.04
Nami,Vex,953,500,453,52.47
Nami,Sivir,1121,626,495,55.84
Nami,Karma,3144,1722,1422,54.77
Nami,Sion,1783,861,922,48.29
Nami,Evelynn,842,429,413,50.95
Nami,Rell,1061,526,535,49.58
Nami,Leblanc,1168,571,597,48.89
Nami,Aphelios,1251,664,587,53.08
Nami,Warwick,2846,1485,1361,52.18
Nami,Ezreal,4489,2471,2018,55.05
Nami,Teemo,2505,1283,1222,51.22
Nami,Shaco,1982,1035,947,52.22
Nami,Nasus,1314,688,626,52.36
Nami,Mel,4109,2111,1998,51.38
Nami,Thresh,2906,1515,1391,52.13
Nami,Fizz,1151,645,506,56.04
Nami,Jinx,5725,2740,2985,47.86
Nami,Milio,1721,800,921,46.48
Nami,Talon,1219,585,634,47.99
Nami,Kalista,569,326,243,57.29
Nami,Pyke,1717,903,814,52.59
Nami,MasterYi,2213,1095,1118,49.48
Nami,Darius,4064,2007,2057,49.38
Nami,Gangplank,1165,606,559,52.02
Nami,Poppy,1106,575,531,51.99
Nami,Tryndamere,1123,572,551,50.93
Nami,Singed,669,326,343,48.73
Nami,Draven,1308,688,620,52.6
Nami,Neeko,1039,534,505,51.4
Nami,Camille,865,416,449,48.09
Nami,Jax,1699,874,825,51.44
Nami,Vladimir,1339,690,649,51.53
Nami,Skarner,639,344,295,53.83
Nami,Rengar,851,508,343,59.69
Nami,Naafiri,761,385,376,50.59
Nami,Lucian,1569,840,729,53.54
Nami,Ahri,2742,1438,1304,52.44
Nami,Ziggs,740,379,361,51.22
Nami,XinZhao,1428,688,740,48.18
Nami,Taric,427,183,244,42.86
Nami,Yuumi,2088,1045,1043,50.05
Nami,Leona,1549,775,774,50.03
Nami,AurelionSol,807,367,440,45.48
Nami,Gwen,1193,666,527,55.83
Nami,Urgot,1126,534,592,47.42
Nami,Kassadin,509,235,274,46.17
Nami,Senna,1675,893,782,53.31
Nami,Renata,488,262,226,53.69
Nami,Viego,2746,1419,1327,51.68
Nami,Braum,1348,700,648,51.93
Nami,Vi,2026,1069,957,52.76
Nami,Syndra,1466,793,673,54.09
Nami,Gnar,987,529,458,53.6
Nami,Xayah,1100,606,494,55.09
Nami,DrMundo,1197,533,664,44.53
Nami,Lissandra,749,387,362,51.67
Nami,Ornn,953,555,398,58.24
Nami,Seraphine,1711,874,837,51.08
Nami,Corki,977,535,442,54.76
Nami,Zoe,876,480,396,54.79
Nami,Kennen,593,337,256,56.83
Nami,Kindred,1102,561,541,50.91
Nami,Zeri,890,484,406,54.38
Nami,Akshan,838,435,403,51.91
Nami,Sona,854,432,422,50.59
Nami,Maokai,826,411,415,49.76
Nami,Pantheon,3056,1584,1472,51.83
Nami,Malphite,2108,1120,988,53.13
Nami,Sylas,2373,1258,1115,53.01
Nami,Janna,942,495,447,52.55
Nami,Ryze,718,356,362,49.58
Nami,Trundle,1051,491,560,46.72
Nami,Quinn,730,363,367,49.73
Nami,Khazix,1273,647,626,50.82
Nami,Qiyana,611,367,244,60.07
Nami,Taliyah,598,322,276,53.85
Nami,Elise,1663,887,776,53.34
Nami,Ambessa,1289,704,585,54.62
Nami,Zac,944,484,460,51.27
Nami,RekSai,317,165,152,52.05
Nami,Malzahar,2188,1097,1091,50.14
Nami,Smolder,1549,784,765,50.61
Nami,JarvanIV,1370,721,649,52.63
Nami,Rakan,1005,536,469,53.33
Nami,Illaoi,911,505,406,55.43
Nami,Hecarim,873,455,418,52.12
Nami,Kled,438,224,214,51.14
Nami,Xerath,1710,841,869,49.18
Nami,KogMaw,728,370,358,50.82
Nami,Annie,719,382,337,53.13
Nami,MonkeyKing,1418,761,657,53.67
Nami,Nunu,1275,626,649,49.1
Nami,Azir,664,332,332,50
Nami,Graves,1319,723,596,54.81
Nami,Sejuani,882,444,438,50.34
Nami,Karthus,575,343,232,59.65
Nami,Belveth,574,305,269,53.14
Nami,Rumble,474,243,231,51.27
Nami,Anivia,789,397,392,50.32
Nami,Bard,775,378,397,48.77
Nami,Shyvana,529,290,239,54.82
Ornn,Akali,982,491,491,50
Ornn,MissFortune,1876,961,915,51.23
Ornn,Kassadin,184,79,105,42.93
Ornn,Kayn,1322,708,614,53.56
Ornn,Sona,305,163,142,53.44
Ornn,Vladimir,596,330,266,55.37
Ornn,Zac,436,216,220,49.54
Ornn,Cassiopeia,249,127,122,51
Ornn,Irelia,789,387,402,49.05
Ornn,Lux,2338,1230,1108,52.61
Ornn,Jax,737,375,362,50.88
Ornn,Elise,659,341,318,51.75
Ornn,Kaisa,1436,787,649,54.81
Ornn,Twitch,738,379,359,51.36
Ornn,Yuumi,741,371,370,50.07
Ornn,Gangplank,505,250,255,49.5
Ornn,Nocturne,1115,546,569,48.97
Ornn,Yasuo,1698,835,863,49.18
Ornn,Corki,362,168,194,46.41
Ornn,Ambessa,643,319,324,49.61
Ornn,Kalista,296,165,131,55.74
Ornn,Swain,914,422,492,46.17
Ornn,Garen,1477,777,700,52.61
Ornn,LeeSin,1467,754,713,51.4
Ornn,Aurora,755,395,360,52.32
Ornn,Rell,480,240,240,50
Ornn,Aatrox,912,476,436,52.19
Ornn,Vi,925,466,459,50.38
Ornn,Yone,1532,811,721,52.94
Ornn,Nasus,604,303,301,50.17
Ornn,Sion,679,369,310,54.34
Ornn,Yorick,809,368,441,45.49
Ornn,Xerath,769,425,344,55.27
Ornn,Jhin,1827,923,904,50.52
Ornn,Lulu,1128,576,552,51.06
Ornn,Trundle,551,263,288,47.73
Ornn,MasterYi,970,490,480,50.52
Ornn,Ahri,1197,637,560,53.22
Ornn,Varus,905,420,485,46.41
Ornn,Gragas,571,311,260,54.47
Ornn,Syndra,612,324,288,52.94
Ornn,Sett,1396,664,732,47.56
Ornn,Kled,201,85,116,42.29
Ornn,Warwick,1402,629,773,44.86
Ornn,Taliyah,253,130,123,51.38
Ornn,Ezreal,1999,1094,905,54.73
Ornn,TahmKench,749,396,353,52.87
Ornn,Teemo,1085,585,500,53.92
Ornn,Graves,522,254,268,48.66
Ornn,Zoe,376,200,176,53.19
Ornn,Katarina,619,275,344,44.43
Ornn,Quinn,293,141,152,48.12
Ornn,Shaco,718,371,347,51.67
Ornn,Darius,1661,823,838,49.55
Ornn,Braum,546,257,289,47.07
Ornn,Viego,1245,617,628,49.56
Ornn,Zed,954,521,433,54.61
Ornn,Soraka,557,277,280,49.73
Ornn,Vayne,1231,611,620,49.63
Ornn,Briar,667,343,324,51.42
Ornn,Orianna,483,232,251,48.03
Ornn,Mel,1658,843,815,50.84
Ornn,Jinx,2395,1220,1175,50.94
Ornn,Thresh,1156,593,563,51.3
Ornn,Kayle,639,301,338,47.1
Ornn,XinZhao,600,323,277,53.83
Ornn,Vex,503,255,248,50.7
Ornn,Ashe,1812,922,890,50.88
Ornn,Veigar,836,366,470,43.78
Ornn,Tristana,941,519,422,55.15
Ornn,Nautilus,1097,612,485,55.79
Ornn,Khazix,437,254,183,58.12
Ornn,Sylas,1349,728,621,53.97
Ornn,Xayah,526,250,276,47.53
Ornn,Rakan,443,217,226,48.98
Ornn,Fizz,465,205,260,44.09
Ornn,Pantheon,1531,785,746,51.27
Ornn,Volibear,954,448,506,46.96
Ornn,Morgana,1052,478,574,45.44
Ornn,Ekko,766,420,346,54.83
Ornn,Caitlyn,2305,1178,1127,51.11
Ornn,Brand,542,289,253,53.32
Ornn,KSante,626,306,320,48.88
Ornn,Poppy,537,262,275,48.79
Ornn,Bard,321,160,161,49.84
Ornn,Nami,953,398,555,41.76
Ornn,Amumu,835,418,417,50.06
Ornn,Qiyana,281,159,122,56.58
Ornn,Mordekaiser,1379,681,698,49.38
Ornn,Illaoi,412,212,200,51.46
Ornn,Hwei,594,298,296,50.17
Ornn,Evelynn,333,182,151,54.65
Ornn,Senna,799,408,391,51.06
Ornn,Zilean,345,184,161,53.33
Ornn,Malphite,912,481,431,52.74
Ornn,Fiora,550,284,266,51.64
Ornn,Milio,571,320,251,56.04
Ornn,Shen,622,301,321,48.39
Ornn,Malzahar,893,433,460,48.49
Ornn,Nilah,356,219,137,61.52
Ornn,Ziggs,398,196,202,49.25
Ornn,JarvanIV,548,265,283,48.36
Ornn,Naafiri,290,164,126,56.55
Ornn,Leblanc,495,294,201,59.39
Ornn,Smolder,651,337,314,51.77
Ornn,Janna,273,119,154,43.59
Ornn,Diana,1396,664,732,47.56
Ornn,Samira,685,346,339,50.51
Ornn,Zyra,740,374,366,50.54
Ornn,Olaf,247,80,167,32.39
Ornn,Annie,320,144,176,45
Ornn,Karma,999,530,469,53.05
Ornn,Hecarim,361,163,198,45.15
Ornn,Lissandra,253,143,110,56.52
Ornn,Anivia,312,139,173,44.55
Ornn,Sivir,448,237,211,52.9
Ornn,Taric,187,96,91,51.34
Ornn,Udyr,284,155,129,54.58
Ornn,FiddleSticks,475,269,206,56.63
Ornn,Gnar,403,232,171,57.57
Ornn,Rengar,357,209,148,58.54
Ornn,Gwen,634,324,310,51.1
Ornn,DrMundo,549,256,293,46.63
Ornn,Velkoz,565,277,288,49.03
Ornn,Rumble,237,121,116,51.05
Ornn,Viktor,813,407,406,50.06
Ornn,Pyke,787,431,356,54.76
Ornn,Riven,398,248,150,62.31
Ornn,Rammus,229,126,103,55.02
Ornn,Zeri,376,191,185,50.8
Ornn,Skarner,265,149,116,56.23
Ornn,AurelionSol,359,175,184,48.75
Ornn,KogMaw,255,123,132,48.24
Ornn,Blitzcrank,739,396,343,53.59
Ornn,Sejuani,334,180,154,53.89
Ornn,Galio,850,439,411,51.65
Ornn,Urgot,418,226,192,54.07
Ornn,Lillia,512,232,280,45.31
Ornn,Chogath,1226,628,598,51.22
Ornn,Tryndamere,466,229,237,49.14
Ornn,Camille,359,196,163,54.6
Ornn,Ryze,327,156,171,47.71
Ornn,Maokai,432,209,223,48.38
Ornn,Neeko,424,229,195,54.01
Ornn,MonkeyKing,591,290,301,49.07
Ornn,Aphelios,575,297,278,51.65
Ornn,Shyvana,206,103,103,50
Ornn,Alistar,387,194,193,50.13
Ornn,Lucian,675,327,348,48.44
Ornn,Kindred,465,259,206,55.7
Ornn,Renekton,417,233,184,55.88
Ornn,Leona,798,421,377,52.76
Ornn,Nunu,600,299,301,49.83
Ornn,Seraphine,770,377,393,48.96
Ornn,Heimerdinger,385,172,213,44.68
Ornn,Draven,487,260,227,53.39
Ornn,Azir,370,204,166,55.14
Ornn,Renata,194,112,82,57.73
Ornn,Singed,248,117,131,47.18
Ornn,TwistedFate,261,138,123,52.87
Ornn,Belveth,222,105,117,47.3
Ornn,Akshan,316,187,129,59.18
Ornn,Talon,555,311,244,56.04
Ornn,Kennen,277,169,108,61.01
Ornn,RekSai,143,66,77,46.15
Ornn,Jayce,363,206,157,56.75
Ornn,Nidalee,304,208,96,68.42
Ornn,Ivern,136,64,72,47.06
Ornn,Karthus,200,97,103,48.5
Udyr,Akali,770,364,406,47.27
Udyr,MissFortune,1684,777,907,46.14
Udyr,Kassadin,121,62,59,51.24
Udyr,Kayn,1260,564,696,44.76
Udyr,Sona,239,149,90,62.34
Udyr,Heimerdinger,316,142,174,44.94
Udyr,Talon,476,227,249,47.69
Udyr,Ahri,999,513,486,51.35
Udyr,Kalista,243,134,109,55.14
Udyr,Brand,561,250,311,44.56
Udyr,Urgot,459,209,250,45.53
Udyr,Rengar,261,118,143,45.21
Udyr,Ziggs,335,189,146,56.42
Udyr,Trundle,433,187,246,43.19
Udyr,Fiora,334,153,181,45.81
Udyr,Sion,722,364,358,50.42
Udyr,MasterYi,970,495,475,51.03
Udyr,AurelionSol,334,146,188,43.71
Udyr,Ezreal,1760,892,868,50.68
Udyr,Nami,841,374,467,44.47
Udyr,FiddleSticks,425,212,213,49.88
Udyr,Katarina,628,335,293,53.34
Udyr,Caitlyn,2150,1004,1146,46.7
Udyr,Pyke,734,394,340,53.68
Udyr,Darius,1866,905,961,48.5
Udyr,Neeko,397,236,161,59.45
Udyr,Taric,207,100,107,48.31
Udyr,Riven,362,214,148,59.12
Udyr,Vi,726,326,400,44.9
Udyr,Mel,1658,857,801,51.69
Udyr,Soraka,431,206,225,47.8
Udyr,Kled,130,54,76,41.54
Udyr,Warwick,1227,617,610,50.29
Udyr,Gragas,545,297,248,54.5
Udyr,Jinx,2093,970,1123,46.34
Udyr,Rell,374,176,198,47.06
Udyr,Olaf,184,88,96,47.83
Udyr,Evelynn,350,163,187,46.57
Udyr,Volibear,1061,539,522,50.8
Udyr,Leona,689,334,355,48.48
Udyr,Teemo,957,457,500,47.75
Udyr,Shaco,781,364,417,46.61
Udyr,Yasuo,1587,805,782,50.72
Udyr,Ashe,1627,760,867,46.71
Udyr,Lux,1866,928,938,49.73
Udyr,Akshan,332,210,122,63.25
Udyr,Hwei,570,258,312,45.26
Udyr,Xerath,600,285,315,47.5
Udyr,Mordekaiser,1100,500,600,45.45
Udyr,MonkeyKing,554,282,272,50.9
Udyr,Tryndamere,498,239,259,47.99
Udyr,Irelia,594,307,287,51.68
Udyr,Nautilus,937,430,507,45.89
Udyr,Nunu,524,219,305,41.79
Udyr,Leblanc,381,193,188,50.66
Udyr,Kaisa,1271,669,602,52.64
Udyr,Jax,618,290,328,46.93
Udyr,Yone,1383,672,711,48.59
Udyr,Samira,610,318,292,52.13
Udyr,Thresh,1217,611,606,50.21
Udyr,Pantheon,1277,579,698,45.34
Udyr,Graves,451,213,238,47.23
Udyr,Tristana,811,393,418,48.46
Udyr,Ambessa,547,232,315,42.41
Udyr,Zed,892,406,486,45.52
Udyr,Draven,466,265,201,56.87
Udyr,Bard,282,161,121,57.09
Udyr,DrMundo,465,254,211,54.62
Udyr,Sett,1253,616,637,49.16
Udyr,Sejuani,282,132,150,46.81
Udyr,LeeSin,1034,545,489,52.71
Udyr,Cassiopeia,251,105,146,41.83
Udyr,Senna,638,294,344,46.08
Udyr,Kennen,246,127,119,51.63
Udyr,Malzahar,833,376,457,45.14
Udyr,Morgana,998,466,532,46.69
Udyr,Singed,247,153,94,61.94
Udyr,Velkoz,471,190,281,40.34
Udyr,Kindred,391,185,206,47.31
Udyr,Aurora,647,294,353,45.44
Udyr,Zeri,350,178,172,50.86
Udyr,Azir,323,141,182,43.65
Udyr,Swain,822,412,410,50.12
Udyr,Aatrox,837,434,403,51.85
Udyr,Seraphine,646,322,324,49.85
Udyr,Jhin,1540,723,817,46.95
Udyr,Ekko,671,337,334,50.22
Udyr,XinZhao,486,212,274,43.62
Udyr,Sylas,953,486,467,51
Udyr,Naafiri,274,123,151,44.89
Udyr,Poppy,449,209,240,46.55
Udyr,Twitch,725,346,379,47.72
Udyr,Ryze,330,160,170,48.48
Udyr,TahmKench,676,343,333,50.74
Udyr,Diana,1243,590,653,47.47
Udyr,Viego,1131,587,544,51.9
Udyr,Maokai,430,191,239,44.42
Udyr,Khazix,365,156,209,42.74
Udyr,Qiyana,220,125,95,56.82
Udyr,Lulu,978,488,490,49.9
Udyr,Malphite,798,387,411,48.5
Udyr,Kayle,530,251,279,47.36
Udyr,Zac,407,215,192,52.83
Udyr,Renekton,369,186,183,50.41
Udyr,Gnar,361,175,186,48.48
Udyr,Shen,580,270,310,46.55
Udyr,Lillia,540,276,264,51.11
Udyr,Orianna,291,101,190,34.71
Udyr,Briar,610,319,291,52.3
Udyr,Chogath,1052,515,537,48.95
Udyr,Blitzcrank,579,289,290,49.91
Udyr,Milio,499,242,257,48.5
Udyr,Veigar,851,366,485,43.01
Udyr,Skarner,241,126,115,52.28
Udyr,Karma,870,403,467,46.32
Udyr,Vayne,958,434,524,45.3
Udyr,Garen,1341,645,696,48.1
Udyr,Quinn,308,143,165,46.43
Udyr,Belveth,192,93,99,48.44
Udyr,Nasus,507,229,278,45.17
Udyr,TwistedFate,323,154,169,47.68
Udyr,Xayah,393,210,183,53.44
Udyr,Hecarim,351,200,151,56.98
Udyr,Yuumi,662,315,347,47.58
Udyr,Yorick,770,299,471,38.83
Udyr,KSante,445,188,257,42.25
Udyr,Ornn,284,129,155,45.42
Udyr,Zyra,604,306,298,50.66
Udyr,Vladimir,479,226,253,47.18
Udyr,Aphelios,398,216,182,54.27
Udyr,Illaoi,366,187,179,51.09
Udyr,Corki,343,201,142,58.6
Udyr,Karthus,198,113,85,57.07
Udyr,Nilah,265,101,164,38.11
Udyr,Janna,275,108,167,39.27
Udyr,Lucian,590,267,323,45.25
Udyr,Rakan,351,163,188,46.44
Udyr,Gwen,517,271,246,52.42
Udyr,Jayce,338,193,145,57.1
Udyr,Nidalee,287,187,100,65.16
Udyr,Sivir,411,186,225,45.26
Udyr,Varus,698,324,374,46.42
Udyr,Amumu,770,366,404,47.53
Udyr,JarvanIV,479,192,287,40.08
Udyr,Syndra,532,236,296,44.36
Udyr,Rumble,211,96,115,45.5
Udyr,Anivia,273,132,141,48.35
Udyr,Smolder,502,275,227,54.78
Udyr,Nocturne,916,459,457,50.11
Udyr,Galio,720,323,397,44.86
Udyr,Viktor,685,307,378,44.82
Udyr,Camille,296,169,127,57.09
Udyr,Lissandra,187,100,87,53.48
Udyr,Vex,402,172,230,42.79
Udyr,Zoe,315,150,165,47.62
Udyr,Taliyah,205,102,103,49.76
Udyr,Elise,569,278,291,48.86
Udyr,Gangplank,367,182,185,49.59
Udyr,Fizz,406,220,186,54.19
Udyr,Zilean,275,143,132,52
Udyr,Braum,427,236,191,55.27
Udyr,Ivern,122,64,58,52.46
Udyr,Renata,112,51,61,45.54
Udyr,RekSai,126,76,50,60.32
Udyr,Alistar,366,161,205,43.99
Udyr,Shyvana,207,91,116,43.96
Udyr,Annie,256,110,146,42.97
Udyr,KogMaw,285,104,181,36.49
Udyr,Rammus,179,79,100,44.13
Kassadin,Ornn,184,105,79,57.07
Kassadin,Udyr,121,59,62,48.76
Kassadin,Lux,1094,522,572,47.71
Kassadin,Ezreal,1001,490,511,48.95
Kassadin,Milio,290,153,137,52.76
Kassadin,Gangplank,222,105,117,47.3
Kassadin,Kaisa,700,392,308,56
Kassadin,Galio,376,172,204,45.74
Kassadin,Cassiopeia,113,60,53,53.1
Kassadin,Hwei,319,165,154,51.72
Kassadin,Aatrox,421,188,233,44.66
Kassadin,Shaco,449,278,171,61.92
Kassadin,Leblanc,280,144,136,51.43
Kassadin,Draven,195,96,99,49.23
Kassadin,Darius,840,423,417,50.36
Kassadin,Chogath,524,257,267,49.05
Kassadin,Yasuo,746,360,386,48.26
Kassadin,Yuumi,369,199,170,53.93
Kassadin,Naafiri,129,65,64,50.39
Kassadin,Zac,241,123,118,51.04
Kassadin,Ahri,655,344,311,52.52
Kassadin,Nilah,154,59,95,38.31
Kassadin,Zyra,319,177,142,55.49
Kassadin,XinZhao,244,103,141,42.21
Kassadin,Hecarim,190,86,104,45.26
Kassadin,Jhin,841,412,429,48.99
Kassadin,Velkoz,282,122,160,43.26
Kassadin,Mordekaiser,581,298,283,51.29
Kassadin,Diana,747,383,364,51.27
Kassadin,Tristana,405,196,209,48.4
Kassadin,Taric,93,45,48,48.39
Kassadin,Warwick,589,326,263,55.35
Kassadin,Graves,264,120,144,45.45
Kassadin,Aurora,322,166,156,51.55
Kassadin,Mel,1271,698,573,54.92
Kassadin,Irelia,345,148,197,42.9
Kassadin,MonkeyKing,276,117,159,42.39
Kassadin,Vex,234,123,111,52.56
Kassadin,Caitlyn,1143,534,609,46.72
Kassadin,Rell,259,112,147,43.24
Kassadin,Illaoi,171,115,56,67.25
Kassadin,Vi,445,253,192,56.85
Kassadin,Sivir,236,130,106,55.08
Kassadin,Jax,393,170,223,43.26
Kassadin,Karthus,133,80,53,60.15
Kassadin,Lucian,302,158,144,52.32
Kassadin,Nami,509,274,235,53.83
Kassadin,Garen,629,320,309,50.87
Kassadin,Skarner,101,56,45,55.45
Kassadin,Zilean,127,61,66,48.03
Kassadin,MissFortune,919,512,407,55.71
Kassadin,Tryndamere,275,144,131,52.36
Kassadin,Evelynn,220,106,114,48.18
Kassadin,Syndra,285,163,122,57.19
Kassadin,Xerath,343,166,177,48.4
Kassadin,Nunu,294,147,147,50
Kassadin,Seraphine,386,207,179,53.63
Kassadin,Nautilus,506,253,253,50
Kassadin,Zed,304,146,158,48.03
Kassadin,Pantheon,705,344,361,48.79
Kassadin,Nocturne,519,282,237,54.34
Kassadin,Akali,442,220,222,49.77
Kassadin,Jinx,1137,562,575,49.43
Kassadin,Annie,135,81,54,60
Kassadin,Sett,560,332,228,59.29
Kassadin,Ekko,470,276,194,58.72
Kassadin,Swain,470,261,209,55.53
Kassadin,LeeSin,551,281,270,51
Kassadin,Riven,240,129,111,53.75
Kassadin,Rengar,172,105,67,61.05
Kassadin,Gnar,221,117,104,52.94
Kassadin,MasterYi,496,248,248,50
Kassadin,TwistedFate,169,86,83,50.89
Kassadin,Senna,299,160,139,53.51
Kassadin,Kayn,635,259,376,40.79
Kassadin,Malzahar,390,194,196,49.74
Kassadin,Malphite,401,208,193,51.87
Kassadin,Sylas,500,277,223,55.4
Kassadin,Rakan,192,75,117,39.06
Kassadin,Ivern,92,52,40,56.52
Kassadin,Katarina,393,207,186,52.67
Kassadin,Teemo,465,224,241,48.17
Kassadin,Briar,296,126,170,42.57
Kassadin,Twitch,403,208,195,51.61
Kassadin,Poppy,249,136,113,54.62
Kassadin,AurelionSol,172,90,82,52.33
Kassadin,Zoe,117,61,56,52.14
Kassadin,Lillia,312,150,162,48.08
Kassadin,Lulu,473,241,232,50.95
Kassadin,Veigar,498,268,230,53.82
Kassadin,Brand,331,192,139,58.01
Kassadin,Pyke,376,197,179,52.39
Kassadin,Varus,423,224,199,52.96
Kassadin,DrMundo,275,134,141,48.73
Kassadin,Vladimir,368,200,168,54.35
Kassadin,Neeko,231,119,112,51.52
Kassadin,KSante,244,140,104,57.38
Kassadin,Vayne,639,339,300,53.05
Kassadin,TahmKench,363,191,172,52.62
Kassadin,Maokai,218,126,92,57.8
Kassadin,Orianna,177,82,95,46.33
Kassadin,Viego,572,281,291,49.13
Kassadin,Xayah,219,94,125,42.92
Kassadin,Kindred,188,84,104,44.68
Kassadin,Urgot,269,115,154,42.75
Kassadin,Elise,337,188,149,55.79
Kassadin,Braum,272,155,117,56.99
Kassadin,Nasus,341,157,184,46.04
Kassadin,Yone,669,340,329,50.82
Kassadin,Blitzcrank,310,153,157,49.35
Kassadin,Qiyana,138,58,80,42.03
Kassadin,Ziggs,180,105,75,58.33
Kassadin,Amumu,425,178,247,41.88
Kassadin,Viktor,381,232,149,60.89
Kassadin,Thresh,674,306,368,45.4
Kassadin,Volibear,443,198,245,44.7
Kassadin,Yorick,364,200,164,54.95
Kassadin,Kayle,339,182,157,53.69
Kassadin,Ashe,776,424,352,54.64
Kassadin,Ryze,184,75,109,40.76
Kassadin,Camille,194,94,100,48.45
Kassadin,Corki,236,168,68,71.19
Kassadin,Karma,518,294,224,56.76
Kassadin,Sona,141,53,88,37.59
Kassadin,Fizz,268,142,126,52.99
Kassadin,Trundle,257,112,145,43.58
Kassadin,Soraka,271,127,144,46.86
Kassadin,Gragas,329,169,160,51.37
Kassadin,Ambessa,280,142,138,50.71
Kassadin,Kled,77,44,33,57.14
Kassadin,Khazix,218,117,101,53.67
Kassadin,Renekton,231,127,104,54.98
Kassadin,Kalista,187,95,92,50.8
Kassadin,Morgana,548,260,288,47.45
Kassadin,Singed,156,78,78,50
Kassadin,Samira,313,151,162,48.24
Kassadin,Akshan,138,64,74,46.38
Kassadin,RekSai,65,35,30,53.85
Kassadin,Rammus,152,71,81,46.71
Kassadin,Rumble,114,64,50,56.14
Kassadin,Sion,339,150,189,44.25
Kassadin,JarvanIV,207,97,110,46.86
Kassadin,Aphelios,235,114,121,48.51
Kassadin,Alistar,172,74,98,43.02
Kassadin,Olaf,68,37,31,54.41
Kassadin,Sejuani,164,75,89,45.73
Kassadin,Janna,150,69,81,46
Kassadin,Belveth,93,47,46,50.54
Kassadin,Anivia,216,99,117,45.83
Kassadin,Bard,179,96,83,53.63
Kassadin,Taliyah,112,50,62,44.64
Kassadin,Fiora,135,65,70,48.15
Kassadin,Azir,122,58,64,47.54
Kassadin,Shyvana,96,53,43,55.21
Kassadin,Shen,301,141,160,46.84
Kassadin,Zeri,193,83,110,43.01
Kassadin,Kennen,108,71,37,65.74
Kassadin,Talon,250,121,129,48.4
Kassadin,Gwen,256,151,105,58.98
Kassadin,Leona,355,160,195,45.07
Kassadin,Quinn,141,54,87,38.3
Kassadin,FiddleSticks,266,146,120,54.89
Kassadin,Nidalee,137,95,42,69.34
Kassadin,KogMaw,137,64,73,46.72
Kassadin,Heimerdinger,233,147,86,63.09
Kassadin,Jayce,203,86,117,42.36
Kassadin,Smolder,331,177,154,53.47
Kassadin,Renata,75,53,22,70.67
Kassadin,Lissandra,152,90,62,59.21
Taric,Jax,365,226,139,61.92
Taric,Nidalee,110,47,63,42.73
Taric,Ahri,584,322,262,55.14
Taric,Jhin,804,416,388,51.74
Taric,Senna,309,163,146,52.75
Taric,Udyr,207,107,100,51.69
Taric,Yorick,440,175,265,39.77
Taric,Akali,445,249,196,55.96
Taric,Jinx,1263,616,647,48.77
Taric,Karma,413,206,207,49.88
Taric,Heimerdinger,191,92,99,48.17
Taric,Warwick,673,357,316,53.05
Taric,Mordekaiser,688,372,316,54.07
Taric,Ashe,856,437,419,51.05
Taric,Pyke,403,256,147,63.52
Taric,Gwen,267,148,119,55.43
Taric,RekSai,56,43,13,76.79
Taric,Gangplank,259,154,105,59.46
Taric,Kaisa,704,393,311,55.82
Taric,Leona,442,245,197,55.43
Taric,Kennen,126,76,50,60.32
Taric,TwistedFate,199,110,89,55.28
Taric,Cassiopeia,172,100,72,58.14
Taric,Smolder,346,194,152,56.07
Taric,Milio,272,157,115,57.72
Taric,Sett,670,377,293,56.27
Taric,Nunu,283,159,124,56.18
Taric,Yone,764,447,317,58.51
Taric,Quinn,162,67,95,41.36
Taric,Viego,581,241,340,41.48
Taric,Yasuo,1004,534,470,53.19
Taric,MissFortune,1008,498,510,49.4
Taric,Neeko,228,137,91,60.09
Taric,Teemo,591,298,293,50.42
Taric,Akshan,157,83,74,52.87
Taric,Corki,212,118,94,55.66
Taric,Lux,1096,513,583,46.81
Taric,Singed,125,65,60,52
Taric,Zeri,194,106,88,54.64
Taric,Brand,250,128,122,51.2
Taric,Darius,962,504,458,52.39
Taric,Gragas,275,165,110,60
Taric,Veigar,448,243,205,54.24
Taric,KogMaw,158,83,75,52.53
Taric,Thresh,784,429,355,54.72
Taric,Kayn,676,370,306,54.73
Taric,Kassadin,93,48,45,51.61
Taric,Ziggs,155,81,74,52.26
Taric,Morgana,483,264,219,54.66
Taric,Shaco,396,224,172,56.57
Taric,Hwei,263,151,112,57.41
Taric,Sejuani,196,109,87,55.61
Taric,Taliyah,157,76,81,48.41
Taric,Sivir,233,137,96,58.8
Taric,Velkoz,304,151,153,49.67
Taric,Ambessa,278,139,139,50
Taric,Lillia,247,113,134,45.75
Taric,Vladimir,315,154,161,48.89
Taric,Vayne,610,297,313,48.69
Taric,Nami,427,244,183,57.14
Taric,Viktor,408,227,181,55.64
Taric,Xayah,227,110,117,48.46
Taric,Nautilus,727,413,314,56.81
Taric,Garen,726,378,348,52.07
Taric,Kindred,144,92,52,63.89
Taric,Graves,231,116,115,50.22
Taric,Twitch,366,218,148,59.56
Taric,Volibear,525,285,240,54.29
Taric,Evelynn,160,72,88,45
Taric,Trundle,268,120,148,44.78
Taric,JarvanIV,251,126,125,50.2
Taric,Aurora,371,221,150,59.57
Taric,MasterYi,631,346,285,54.83
Taric,Lissandra,150,68,82,45.33
Taric,Caitlyn,1156,603,553,52.16
Taric,Rakan,156,80,76,51.28
Taric,Riven,276,164,112,59.42
Taric,FiddleSticks,228,138,90,60.53
Taric,Tristana,435,211,224,48.51
Taric,Swain,472,219,253,46.4
Taric,Talon,194,91,103,46.91
Taric,Orianna,233,106,127,45.49
Taric,MonkeyKing,260,118,142,45.38
Taric,Malzahar,454,225,229,49.56
Taric,Poppy,316,183,133,57.91
Taric,XinZhao,337,161,176,47.77
Taric,Ryze,138,68,70,49.28
Taric,Varus,397,174,223,43.83
Taric,Belveth,121,57,64,47.11
Taric,Illaoi,213,114,99,53.52
Taric,Urgot,245,115,130,46.94
Taric,Diana,744,404,340,54.3
Taric,Soraka,246,116,130,47.15
Taric,Mel,930,479,451,51.51
Taric,LeeSin,581,306,275,52.67
Taric,Zac,259,127,132,49.03
Taric,Pantheon,775,442,333,57.03
Taric,Briar,356,199,157,55.9
Taric,Irelia,327,165,162,50.46
Taric,Nasus,290,140,150,48.28
Taric,Vi,439,228,211,51.94
Taric,Azir,169,96,73,56.8
Taric,Draven,237,128,109,54.01
Taric,Ornn,187,91,96,48.66
Taric,KSante,210,121,89,57.62
Taric,Zed,519,274,245,52.79
Taric,Samira,347,228,119,65.71
Taric,Amumu,491,254,237,51.73
Taric,Lucian,273,157,116,57.51
Taric,AurelionSol,243,108,135,44.44
Taric,Shen,308,175,133,56.82
Taric,Karthus,110,44,66,40
Taric,Ekko,429,227,202,52.91
Taric,Ezreal,944,505,439,53.5
Taric,Sylas,570,312,258,54.74
Taric,Blitzcrank,340,190,150,55.88
Taric,Chogath,684,371,313,54.24
Taric,Zyra,338,162,176,47.93
Taric,Nocturne,488,252,236,51.64
Taric,Fizz,284,138,146,48.59
Taric,Zilean,85,37,48,43.53
Taric,Elise,351,206,145,58.69
Taric,Sona,172,75,97,43.6
Taric,Malphite,429,208,221,48.48
Taric,Alistar,211,117,94,55.45
Taric,Fiora,165,95,70,57.58
Taric,Yuumi,424,249,175,58.73
Taric,Katarina,345,154,191,44.64
Taric,Sion,378,213,165,56.35
Taric,Braum,262,121,141,46.18
Taric,Lulu,620,316,304,50.97
Taric,Qiyana,107,50,57,46.73
Taric,Kayle,359,183,176,50.97
Taric,Seraphine,341,150,191,43.99
Taric,Renekton,237,123,114,51.9
Taric,Aatrox,387,166,221,42.89
Taric,DrMundo,295,147,148,49.83
Taric,Shyvana,77,20,57,25.97
Taric,Ivern,69,33,36,47.83
Taric,Galio,344,185,159,53.78
Taric,TahmKench,445,232,213,52.13
Taric,Leblanc,168,99,69,58.93
Taric,Vex,225,100,125,44.44
Taric,Aphelios,269,133,136,49.44
Taric,Tryndamere,267,137,130,51.31
Taric,Kalista,188,102,86,54.26
Taric,Rell,217,125,92,57.6
Taric,Rammus,130,82,48,63.08
Taric,Maokai,243,106,137,43.62
Taric,Annie,139,80,59,57.55
Taric,Khazix,233,159,74,68.24
Taric,Syndra,296,133,163,44.93
Taric,Hecarim,156,100,56,64.1
Taric,Rengar,154,75,79,48.7
Taric,Camille,142,77,65,54.23
Taric,Xerath,325,168,157,51.69
Taric,Kled,89,36,53,40.45
Taric,Janna,161,75,86,46.58
Taric,Gnar,205,111,94,54.15
Taric,Skarner,115,71,44,61.74
Taric,Bard,120,56,64,46.67
Taric,Naafiri,163,68,95,41.72
Taric,Renata,97,45,52,46.39
Taric,Olaf,92,57,35,61.96
Taric,Rumble,122,61,61,50
Taric,Nilah,183,85,98,46.45
Taric,Jayce,189,111,78,58.73
Taric,Zoe,156,97,59,62.18
Taric,Anivia,150,59,91,39.33
Nidalee,Gwen,303,137,166,45.21
Nidalee,Talon,429,175,254,40.79
Nidalee,Yone,1154,528,626,45.75
Nidalee,MissFortune,1216,518,698,42.6
Nidalee,Taric,110,63,47,57.27
Nidalee,Volibear,530,223,307,42.08
Nidalee,Ivern,103,39,64,37.86
Nidalee,Irelia,548,233,315,42.52
Nidalee,Caitlyn,1513,700,813,46.27
Nidalee,Swain,509,190,319,37.33
Nidalee,Poppy,475,243,232,51.16
Nidalee,Elise,545,270,275,49.54
Nidalee,Aurora,512,228,284,44.53
Nidalee,Tristana,594,263,331,44.28
Nidalee,Nami,579,214,365,36.96
Nidalee,MasterYi,581,255,326,43.89
Nidalee,Hwei,482,214,268,44.4
Nidalee,Samira,463,190,273,41.04
Nidalee,Kayn,800,317,483,39.63
Nidalee,Briar,393,155,238,39.44
Nidalee,Velkoz,369,180,189,48.78
Nidalee,Nilah,191,82,109,42.93
Nidalee,Yuumi,607,250,357,41.19
Nidalee,Aatrox,757,307,450,40.55
Nidalee,Shyvana,147,72,75,48.98
Nidalee,Vex,321,140,181,43.61
Nidalee,Ezreal,1792,766,1026,42.75
Nidalee,Malzahar,512,197,315,38.48
Nidalee,Renekton,354,152,202,42.94
Nidalee,Gragas,418,208,210,49.76
Nidalee,Viktor,582,228,354,39.18
Nidalee,Ashe,1572,690,882,43.89
Nidalee,Morgana,596,297,299,49.83
Nidalee,Tryndamere,312,147,165,47.12
Nidalee,Shaco,532,195,337,36.65
Nidalee,Brand,344,171,173,49.71
Nidalee,Lux,1406,586,820,41.68
Nidalee,Blitzcrank,487,207,280,42.51
Nidalee,Kaisa,1175,563,612,47.91
Nidalee,Lulu,842,384,458,45.61
Nidalee,Katarina,452,189,263,41.81
Nidalee,Jinx,1533,659,874,42.99
Nidalee,Garen,883,351,532,39.75
Nidalee,Veigar,512,221,291,43.16
Nidalee,Bard,184,84,100,45.65
Nidalee,Heimerdinger,248,114,134,45.97
Nidalee,Zed,687,343,344,49.93
Nidalee,Senna,429,189,240,44.06
Nidalee,Gangplank,295,141,154,47.8
Nidalee,Pyke,533,276,257,51.78
Nidalee,Vladimir,436,218,218,50
Nidalee,Nunu,354,171,183,48.31
Nidalee,Annie,233,104,129,44.64
Nidalee,Sona,201,78,123,38.81
Nidalee,Riven,293,127,166,43.34
Nidalee,Vi,573,240,333,41.88
Nidalee,Chogath,641,269,372,41.97
Nidalee,Fizz,272,110,162,40.44
Nidalee,Ziggs,267,110,157,41.2
Nidalee,Darius,1118,489,629,43.74
Nidalee,Diana,1008,437,571,43.35
Nidalee,Mordekaiser,638,288,350,45.14
Nidalee,Shen,386,154,232,39.9
Nidalee,Zac,390,159,231,40.77
Nidalee,Yasuo,1192,475,717,39.85
Nidalee,TahmKench,499,232,267,46.49
Nidalee,Graves,613,276,337,45.02
Nidalee,Illaoi,292,122,170,41.78
Nidalee,FiddleSticks,310,144,166,46.45
Nidalee,Singed,132,44,88,33.33
Nidalee,Orianna,335,147,188,43.88
Nidalee,Corki,253,112,141,44.27
Nidalee,Neeko,355,163,192,45.92
Nidalee,Rell,342,140,202,40.94
Nidalee,Pantheon,1120,538,582,48.04
Nidalee,Sylas,912,434,478,47.59
Nidalee,Galio,627,300,327,47.85
Nidalee,Zyra,651,274,377,42.09
Nidalee,AurelionSol,260,132,128,50.77
Nidalee,Soraka,352,158,194,44.89
Nidalee,Viego,910,390,520,42.86
Nidalee,Teemo,736,300,436,40.76
Nidalee,Ekko,503,211,292,41.95
Nidalee,Mel,1245,618,627,49.64
Nidalee,Sion,499,211,288,42.28
Nidalee,Sett,913,427,486,46.77
Nidalee,Nautilus,740,272,468,36.76
Nidalee,DrMundo,321,136,185,42.37
Nidalee,JarvanIV,395,176,219,44.56
Nidalee,Amumu,555,236,319,42.52
Nidalee,Akali,728,350,378,48.08
Nidalee,Ahri,833,372,461,44.66
Nidalee,KSante,383,201,182,52.48
Nidalee,Jax,532,253,279,47.56
Nidalee,Seraphine,467,192,275,41.11
Nidalee,Nasus,428,161,267,37.62
Nidalee,XinZhao,430,210,220,48.84
Nidalee,Jhin,1214,525,689,43.25
Nidalee,Yorick,466,193,273,41.42
Nidalee,Olaf,172,77,95,44.77
Nidalee,Varus,601,262,339,43.59
Nidalee,Quinn,231,96,135,41.56
Nidalee,Leblanc,409,232,177,56.72
Nidalee,Cassiopeia,223,96,127,43.05
Nidalee,Karma,862,391,471,45.36
Nidalee,Gnar,284,135,149,47.54
Nidalee,Udyr,287,100,187,34.84
Nidalee,Rakan,277,101,176,36.46
Nidalee,MonkeyKing,440,211,229,47.95
Nidalee,LeeSin,1573,722,851,45.9
Nidalee,Twitch,374,162,212,43.32
Nidalee,Lucian,511,222,289,43.44
Nidalee,Draven,306,138,168,45.1
Nidalee,Leona,468,195,273,41.67
Nidalee,Zoe,289,131,158,45.33
Nidalee,Smolder,393,190,203,48.35
Nidalee,Khazix,437,198,239,45.31
Nidalee,Malphite,621,293,328,47.18
Nidalee,Qiyana,181,99,82,54.7
Nidalee,Belveth,153,80,73,52.29
Nidalee,Kayle,367,146,221,39.78
Nidalee,Xerath,652,261,391,40.03
Nidalee,Xayah,318,139,179,43.71
Nidalee,Vayne,639,290,349,45.38
Nidalee,Kindred,303,134,169,44.22
Nidalee,Janna,173,75,98,43.35
Nidalee,Warwick,729,293,436,40.19
Nidalee,Camille,321,116,205,36.14
Nidalee,Lissandra,237,92,145,38.82
Nidalee,Urgot,303,122,181,40.26
Nidalee,Sivir,354,158,196,44.63
Nidalee,Syndra,378,159,219,42.06
Nidalee,Ambessa,483,227,256,47
Nidalee,Rumble,236,129,107,54.66
Nidalee,Hecarim,243,104,139,42.8
Nidalee,Taliyah,206,108,98,52.43
Nidalee,Azir,244,114,130,46.72
Nidalee,Nocturne,737,325,412,44.1
Nidalee,Aphelios,378,158,220,41.8
Nidalee,Zeri,305,138,167,45.25
Nidalee,Lillia,336,151,185,44.94
Nidalee,Karthus,224,121,103,54.02
Nidalee,Thresh,1042,475,567,45.59
Nidalee,Kassadin,137,42,95,30.66
Nidalee,Milio,338,140,198,41.42
Nidalee,Sejuani,223,117,106,52.47
Nidalee,Naafiri,198,72,126,36.36
Nidalee,Trundle,294,133,161,45.24
Nidalee,Skarner,164,92,72,56.1
Nidalee,Braum,396,177,219,44.7
Nidalee,Rengar,222,121,101,54.5
Nidalee,Zilean,214,108,106,50.47
Nidalee,TwistedFate,270,157,113,58.15
Nidalee,Rammus,142,56,86,39.44
Nidalee,Evelynn,233,100,133,42.92
Nidalee,Kled,108,49,59,45.37
Nidalee,Kennen,199,78,121,39.2
Nidalee,Renata,104,48,56,46.15
Nidalee,Ryze,218,64,154,29.36
Nidalee,Kalista,200,106,94,53
Nidalee,RekSai,111,62,49,55.86
Nidalee,Fiora,216,81,135,37.5
Nidalee,Ornn,304,96,208,31.58
Nidalee,Maokai,294,134,160,45.58
Nidalee,KogMaw,190,81,109,42.63
Nidalee,Akshan,235,104,131,44.26
Nidalee,Alistar,224,102,122,45.54
Nidalee,Jayce,434,214,220,49.31
Nidalee,Anivia,193,77,116,39.9
Nasus,Fiora,654,326,328,49.85
Nasus,MasterYi,2078,1071,1007,51.54
Nasus,Mel,3271,1758,1513,53.75
Nasus,Jhin,2767,1418,1349,51.25
Nasus,Karma,1559,803,756,51.51
Nasus,Tryndamere,928,525,403,56.57
Nasus,Kayn,2275,1166,1109,51.25
Nasus,Aurora,1195,684,511,57.24
Nasus,Twitch,1135,599,536,52.78
Nasus,Lux,3970,2054,1916,51.74
Nasus,Mordekaiser,2454,1226,1228,49.96
Nasus,Diana,2375,1216,1159,51.2
Nasus,Ahri,2136,1128,1008,52.81
Nasus,Lulu,1692,858,834,50.71
Nasus,Darius,2943,1469,1474,49.92
Nasus,Amumu,1589,827,762,52.05
Nasus,Yasuo,3361,1639,1722,48.77
Nasus,MissFortune,3795,1904,1891,50.17
Nasus,Swain,1676,825,851,49.22
Nasus,Volibear,2019,1027,992,50.87
Nasus,LeeSin,1872,1020,852,54.49
Nasus,Kayle,1293,693,600,53.6
Nasus,Ezreal,3130,1654,1476,52.84
Nasus,Morgana,1880,964,916,51.28
Nasus,Yone,2957,1537,1420,51.98
Nasus,Nilah,666,361,305,54.2
Nasus,Malphite,1695,873,822,51.5
Nasus,Warwick,2601,1291,1310,49.63
Nasus,Vex,764,405,359,53.01
Nasus,Yuumi,1274,658,616,51.65
Nasus,Yorick,1640,709,931,43.23
Nasus,Ekko,1294,690,604,53.32
Nasus,Katarina,1227,738,489,60.15
Nasus,Jinx,4166,2127,2039,51.06
Nasus,Sion,1238,639,599,51.62
Nasus,Quinn,453,236,217,52.1
Nasus,Talon,709,339,370,47.81
Nasus,Syndra,902,450,452,49.89
Nasus,Caitlyn,4137,1984,2153,47.96
Nasus,Sett,2221,1160,1061,52.23
Nasus,Kindred,771,478,293,62
Nasus,Veigar,1702,881,821,51.76
Nasus,Kled,260,136,124,52.31
Nasus,Gragas,824,491,333,59.59
Nasus,Rell,679,358,321,52.72
Nasus,Sejuani,626,325,301,51.92
Nasus,Malzahar,1443,697,746,48.3
Nasus,Rakan,638,310,328,48.59
Nasus,Aatrox,1340,744,596,55.52
Nasus,Cassiopeia,486,233,253,47.94
Nasus,Varus,1208,624,584,51.66
Nasus,Jayce,600,368,232,61.33
Nasus,Skarner,395,202,193,51.14
Nasus,Poppy,919,504,415,54.84
Nasus,Singed,604,320,284,52.98
Nasus,Viego,2065,1077,988,52.15
Nasus,Vayne,2059,1036,1023,50.32
Nasus,Leona,1374,753,621,54.8
Nasus,Akali,1563,828,735,52.98
Nasus,Xayah,810,418,392,51.6
Nasus,Nautilus,1645,897,748,54.53
Nasus,Milio,748,389,359,52.01
Nasus,Irelia,1146,596,550,52.01
Nasus,Evelynn,648,305,343,47.07
Nasus,Anivia,477,217,260,45.49
Nasus,Ornn,604,301,303,49.83
Nasus,Gangplank,699,302,397,43.2
Nasus,Senna,1118,527,591,47.14
Nasus,Smolder,1088,568,520,52.21
Nasus,TahmKench,1362,735,627,53.96
Nasus,Azir,478,254,224,53.14
Nasus,Pantheon,2428,1201,1227,49.46
Nasus,Nami,1314,626,688,47.64
Nasus,Xerath,1179,643,536,54.54
Nasus,Ashe,2983,1549,1434,51.93
Nasus,Ivern,244,141,103,57.79
Nasus,Seraphine,1456,775,681,53.23
Nasus,Zoe,473,300,173,63.42
Nasus,Nunu,960,472,488,49.17
Nasus,Tristana,1361,646,715,47.47
Nasus,Pyke,1352,766,586,56.66
Nasus,Teemo,2228,1090,1138,48.92
Nasus,Rengar,484,301,183,62.19
Nasus,Vladimir,960,523,437,54.48
Nasus,Kaisa,2289,1292,997,56.44
Nasus,Ambessa,808,418,390,51.73
Nasus,Maokai,688,344,344,50
Nasus,Garen,2787,1278,1509,45.86
Nasus,Briar,1275,617,658,48.39
Nasus,Zed,1544,865,679,56.02
Nasus,Corki,507,252,255,49.7
Nasus,Karthus,339,210,129,61.95
Nasus,KSante,654,396,258,60.55
Nasus,Zeri,747,419,328,56.09
Nasus,Sylas,1893,998,895,52.72
Nasus,Zac,650,298,352,45.85
Nasus,Renekton,844,431,413,51.07
Nasus,Zilean,506,270,236,53.36
Nasus,Ziggs,582,298,284,51.2
Nasus,JarvanIV,823,433,390,52.61
Nasus,Lucian,1000,486,514,48.6
Nasus,Soraka,956,474,482,49.58
Nasus,Shen,931,466,465,50.05
Nasus,Chogath,1792,858,934,47.88
Nasus,Braum,773,417,356,53.95
Nasus,Janna,474,215,259,45.36
Nasus,Gwen,812,435,377,53.57
Nasus,Neeko,888,501,387,56.42
Nasus,Taliyah,281,118,163,41.99
Nasus,Khazix,798,423,375,53.01
Nasus,Viktor,1334,649,685,48.65
Nasus,Thresh,2059,1051,1008,51.04
Nasus,MonkeyKing,979,531,448,54.24
Nasus,Samira,1317,754,563,57.25
Nasus,FiddleSticks,843,411,432,48.75
Nasus,Velkoz,857,371,486,43.29
Nasus,XinZhao,996,502,494,50.4
Nasus,Trundle,1083,551,532,50.88
Nasus,Fizz,854,484,370,56.67
Nasus,Aphelios,887,470,417,52.99
Nasus,Blitzcrank,1137,580,557,51.01
Nasus,Belveth,403,214,189,53.1
Nasus,Heimerdinger,954,480,474,50.31
Nasus,Gnar,560,293,267,52.32
Nasus,Hecarim,611,312,299,51.06
Nasus,Zyra,1106,554,552,50.09
Nasus,Nocturne,1763,867,896,49.18
Nasus,KogMaw,530,271,259,51.13
Nasus,Naafiri,571,318,253,55.69
Nasus,Galio,1278,628,650,49.14
Nasus,Elise,921,434,487,47.12
Nasus,Kennen,524,305,219,58.21
Nasus,Qiyana,431,215,216,49.88
Nasus,Jax,1249,656,593,52.52
Nasus,Kassadin,341,184,157,53.96
Nasus,Urgot,938,464,474,49.47
Nasus,Akshan,499,244,255,48.9
Nasus,Bard,396,212,184,53.54
Nasus,Graves,918,479,439,52.18
Nasus,Annie,483,233,250,48.24
Nasus,Brand,1255,546,709,43.51
Nasus,Taric,290,150,140,51.72
Nasus,Shaco,1366,720,646,52.71
Nasus,Hwei,974,515,459,52.87
Nasus,Udyr,507,278,229,54.83
Nasus,Leblanc,749,395,354,52.74
Nasus,Shyvana,343,158,185,46.06
Nasus,Vi,1463,661,802,45.18
Nasus,Draven,768,446,322,58.07
Nasus,Olaf,355,162,193,45.63
Nasus,Sivir,812,427,385,52.59
Nasus,Nidalee,428,267,161,62.38
Nasus,Kalista,476,255,221,53.57
Nasus,Rammus,443,209,234,47.18
Nasus,Rumble,356,189,167,53.09
Nasus,Illaoi,872,455,417,52.18
Nasus,Lissandra,447,250,197,55.93
Nasus,TwistedFate,513,291,222,56.73
Nasus,Ryze,484,219,265,45.25
Nasus,Lillia,918,431,487,46.95
Nasus,Orianna,575,253,322,44
Nasus,Alistar,551,310,241,56.26
Nasus,AurelionSol,743,367,376,49.39
Nasus,DrMundo,800,423,377,52.88
Nasus,RekSai,170,106,64,62.35
Nasus,Riven,689,371,318,53.85
Nasus,Sona,513,243,270,47.37
Nasus,Camille,614,338,276,55.05
Nasus,Renata,301,138,163,45.85
JarvanIV,Swain,1128,530,598,46.99
JarvanIV,Malzahar,1316,641,675,48.71
JarvanIV,Irelia,972,484,488,49.79
JarvanIV,Kalista,446,222,224,49.78
JarvanIV,Poppy,824,414,410,50.24
JarvanIV,Sett,1632,774,858,47.43
JarvanIV,Taliyah,289,153,136,52.94
JarvanIV,Cassiopeia,421,206,215,48.93
JarvanIV,Kaisa,2094,1030,1064,49.19
JarvanIV,Neeko,439,243,196,55.35
JarvanIV,Yasuo,2212,1144,1068,51.72
JarvanIV,Evelynn,396,194,202,48.99
JarvanIV,Tristana,1227,576,651,46.94
JarvanIV,Lux,2894,1546,1348,53.42
JarvanIV,Volibear,1319,637,682,48.29
JarvanIV,LeeSin,1956,1070,886,54.7
JarvanIV,Caitlyn,2937,1617,1320,55.06
JarvanIV,Pyke,882,461,421,52.27
JarvanIV,Singed,352,177,175,50.28
JarvanIV,Viego,1585,831,754,52.43
JarvanIV,Vayne,1522,783,739,51.45
JarvanIV,MissFortune,2492,1204,1288,48.31
JarvanIV,Leona,962,473,489,49.17
JarvanIV,Gangplank,707,364,343,51.49
JarvanIV,Rengar,438,269,169,61.42
JarvanIV,Kennen,352,202,150,57.39
JarvanIV,Akali,1133,573,560,50.57
JarvanIV,Kayn,1670,834,836,49.94
JarvanIV,Sylas,1685,817,868,48.49
JarvanIV,Draven,720,343,377,47.64
JarvanIV,Velkoz,741,363,378,48.99
JarvanIV,Mordekaiser,1487,696,791,46.81
JarvanIV,Amumu,1320,650,670,49.24
JarvanIV,Qiyana,306,184,122,60.13
JarvanIV,Garen,2006,969,1037,48.31
JarvanIV,Diana,1868,923,945,49.41
JarvanIV,Heimerdinger,383,195,188,50.91
JarvanIV,Vi,1322,666,656,50.38
JarvanIV,Vladimir,754,370,384,49.07
JarvanIV,Leblanc,684,367,317,53.65
JarvanIV,Veigar,1127,599,528,53.15
JarvanIV,Ashe,2455,1240,1215,50.51
JarvanIV,Nautilus,1404,760,644,54.13
JarvanIV,KSante,686,402,284,58.6
JarvanIV,MasterYi,1324,656,668,49.55
JarvanIV,Mel,2386,1280,1106,53.65
JarvanIV,Ekko,1030,512,518,49.71
JarvanIV,Naafiri,418,205,213,49.04
JarvanIV,Kayle,850,454,396,53.41
JarvanIV,Tryndamere,611,317,294,51.88
JarvanIV,MonkeyKing,996,481,515,48.29
JarvanIV,Lucian,865,482,383,55.72
JarvanIV,Elise,951,494,457,51.95
JarvanIV,TahmKench,892,443,449,49.66
JarvanIV,Shaco,1068,595,473,55.71
JarvanIV,Aurora,968,522,446,53.93
JarvanIV,Xayah,622,331,291,53.22
JarvanIV,Aatrox,1246,617,629,49.52
JarvanIV,Skarner,359,218,141,60.72
JarvanIV,Nasus,823,390,433,47.39
JarvanIV,Katarina,879,503,376,57.22
JarvanIV,Rell,618,334,284,54.05
JarvanIV,Kled,251,151,100,60.16
JarvanIV,Nocturne,1688,849,839,50.3
JarvanIV,Malphite,1301,647,654,49.73
JarvanIV,Warwick,1609,848,761,52.7
JarvanIV,Rakan,493,234,259,47.46
JarvanIV,Riven,550,285,265,51.82
JarvanIV,Jhin,2355,1275,1080,54.14
JarvanIV,Thresh,1926,948,978,49.22
JarvanIV,Trundle,556,256,300,46.04
JarvanIV,Rammus,321,126,195,39.25
JarvanIV,Fizz,706,335,371,47.45
JarvanIV,Sona,399,192,207,48.12
JarvanIV,Kindred,558,310,248,55.56
JarvanIV,Ezreal,2974,1609,1365,54.1
JarvanIV,Seraphine,894,474,420,53.02
JarvanIV,Yone,2003,1066,937,53.22
JarvanIV,Taric,251,125,126,49.8
JarvanIV,Lillia,679,346,333,50.96
JarvanIV,Ahri,1871,995,876,53.18
JarvanIV,Ornn,548,283,265,51.64
JarvanIV,Hwei,786,418,368,53.18
JarvanIV,Darius,2222,1118,1104,50.32
JarvanIV,Hecarim,516,263,253,50.97
JarvanIV,Twitch,942,562,380,59.66
JarvanIV,Blitzcrank,856,487,369,56.89
JarvanIV,Camille,488,273,215,55.94
JarvanIV,Khazix,608,316,292,51.97
JarvanIV,Milio,764,347,417,45.42
JarvanIV,Renekton,707,358,349,50.64
JarvanIV,Renata,310,140,170,45.16
JarvanIV,Vex,594,276,318,46.46
JarvanIV,Sejuani,637,342,295,53.69
JarvanIV,Teemo,1315,712,603,54.14
JarvanIV,Nidalee,395,219,176,55.44
JarvanIV,Lulu,1815,1027,788,56.58
JarvanIV,Yorick,1126,586,540,52.04
JarvanIV,Aphelios,633,340,293,53.71
JarvanIV,Janna,445,224,221,50.34
JarvanIV,Soraka,773,372,401,48.12
JarvanIV,Gnar,515,245,270,47.57
JarvanIV,Zoe,428,229,199,53.5
JarvanIV,Gwen,647,377,270,58.27
JarvanIV,Jinx,3378,1699,1679,50.3
JarvanIV,Nami,1370,649,721,47.37
JarvanIV,Sion,892,470,422,52.69
JarvanIV,Jax,1013,488,525,48.17
JarvanIV,Ambessa,805,414,391,51.43
JarvanIV,Rumble,377,211,166,55.97
JarvanIV,Briar,827,385,442,46.55
JarvanIV,Nilah,419,213,206,50.84
JarvanIV,Akshan,422,219,203,51.9
JarvanIV,Varus,1195,599,596,50.13
JarvanIV,Braum,796,393,403,49.37
JarvanIV,Yuumi,1063,528,535,49.67
JarvanIV,Chogath,1582,832,750,52.59
JarvanIV,Sivir,683,344,339,50.37
JarvanIV,Gragas,769,411,358,53.45
JarvanIV,Viktor,1185,569,616,48.02
JarvanIV,Zilean,431,228,203,52.9
JarvanIV,XinZhao,1016,507,509,49.9
JarvanIV,Morgana,1159,651,508,56.17
JarvanIV,Graves,834,418,416,50.12
JarvanIV,Shen,942,471,471,50
JarvanIV,Olaf,245,132,113,53.88
JarvanIV,Bard,414,225,189,54.35
JarvanIV,Ryze,449,229,220,51
JarvanIV,Syndra,800,406,394,50.75
JarvanIV,Zyra,1047,519,528,49.57
JarvanIV,Karma,1437,760,677,52.89
JarvanIV,Samira,679,332,347,48.9
JarvanIV,Nunu,767,410,357,53.46
JarvanIV,Xerath,1038,558,480,53.76
JarvanIV,AurelionSol,497,232,265,46.68
JarvanIV,Talon,637,308,329,48.35
JarvanIV,Pantheon,1967,1056,911,53.69
JarvanIV,Azir,429,189,240,44.06
JarvanIV,TwistedFate,474,235,239,49.58
JarvanIV,Kassadin,207,110,97,53.14
JarvanIV,Smolder,869,435,434,50.06
JarvanIV,Zed,1206,656,550,54.39
JarvanIV,Brand,820,395,425,48.17
JarvanIV,Zac,595,294,301,49.41
JarvanIV,Senna,922,466,456,50.54
JarvanIV,Illaoi,510,271,239,53.14
JarvanIV,Orianna,603,330,273,54.73
JarvanIV,Udyr,479,287,192,59.92
JarvanIV,Galio,1128,599,529,53.1
JarvanIV,Urgot,514,247,267,48.05
JarvanIV,Corki,590,295,295,50
JarvanIV,Alistar,579,337,242,58.2
JarvanIV,Quinn,434,221,213,50.92
JarvanIV,Karthus,307,123,184,40.07
JarvanIV,DrMundo,535,293,242,54.77
JarvanIV,Zeri,580,316,264,54.48
JarvanIV,Maokai,486,249,237,51.23
JarvanIV,Belveth,263,157,106,59.7
JarvanIV,Lissandra,404,207,197,51.24
JarvanIV,Anivia,400,176,224,44
JarvanIV,Ivern,240,108,132,45
JarvanIV,Ziggs,421,178,243,42.28
JarvanIV,Shyvana,322,164,158,50.93
JarvanIV,KogMaw,403,179,224,44.42
JarvanIV,Annie,455,256,199,56.26
JarvanIV,RekSai,164,87,77,53.05
JarvanIV,Fiora,376,180,196,47.87
JarvanIV,FiddleSticks,640,320,320,50
JarvanIV,Jayce,629,359,270,57.07
Fizz,Irelia,929,480,449,51.67
Fizz,Kayn,1853,959,894,51.75
Fizz,Katarina,921,514,407,55.81
Fizz,Vayne,1476,699,777,47.36
Fizz,DrMundo,698,339,359,48.57
Fizz,Mordekaiser,1705,756,949,44.34
Fizz,Amumu,1217,614,603,50.45
Fizz,Pyke,1021,572,449,56.02
Fizz,Varus,983,502,481,51.07
Fizz,Thresh,1540,782,758,50.78
Fizz,Volibear,1356,619,737,45.65
Fizz,LeeSin,1331,679,652,51.01
Fizz,Kayle,795,377,418,47.42
Fizz,Ezreal,2368,1194,1174,50.42
Fizz,Morgana,1507,772,735,51.23
Fizz,Olaf,227,109,118,48.02
Fizz,Hecarim,417,215,202,51.56
Fizz,Veigar,1643,778,865,47.35
Fizz,Tristana,1078,490,588,45.45
Fizz,Braum,613,257,356,41.92
Fizz,Jax,1089,573,516,52.62
Fizz,Diana,1801,857,944,47.58
Fizz,Ahri,1427,799,628,55.99
Fizz,Aphelios,604,261,343,43.21
Fizz,Senna,892,455,437,51.01
Fizz,KSante,508,254,254,50
Fizz,Yasuo,2316,1106,1210,47.75
Fizz,MissFortune,3013,1373,1640,45.57
Fizz,Lux,3285,1621,1664,49.35
Fizz,Heimerdinger,605,275,330,45.45
Fizz,Warwick,1961,922,1039,47.02
Fizz,Ashe,2185,1157,1028,52.95
Fizz,Garen,2035,977,1058,48.01
Fizz,Shyvana,333,150,183,45.05
Fizz,Mel,3244,1639,1605,50.52
Fizz,Taliyah,247,107,140,43.32
Fizz,Swain,1110,524,586,47.21
Fizz,Sett,1682,794,888,47.21
Fizz,Lucian,846,456,390,53.9
Fizz,Sona,397,176,221,44.33
Fizz,Darius,2317,1085,1232,46.83
Fizz,Gragas,601,310,291,51.58
Fizz,KogMaw,382,207,175,54.19
Fizz,Gnar,432,215,217,49.77
Fizz,Nami,1151,506,645,43.96
Fizz,Yorick,1176,493,683,41.92
Fizz,Sejuani,479,228,251,47.6
Fizz,Kalista,308,148,160,48.05
Fizz,Yuumi,928,492,436,53.02
Fizz,Urgot,621,278,343,44.77
Fizz,Viego,1519,796,723,52.4
Fizz,Qiyana,302,156,146,51.66
Fizz,Draven,612,327,285,53.43
Fizz,MasterYi,1469,669,800,45.54
Fizz,Akali,1238,621,617,50.16
Fizz,Twitch,967,513,454,53.05
Fizz,Blitzcrank,818,392,426,47.92
Fizz,Shaco,1209,646,563,53.43
Fizz,Ziggs,492,255,237,51.83
Fizz,Rumble,261,124,137,47.51
Fizz,Aurora,817,384,433,47
Fizz,Nautilus,1280,644,636,50.31
Fizz,Xerath,1119,559,560,49.96
Fizz,Khazix,618,340,278,55.02
Fizz,Karma,1134,558,576,49.21
Fizz,Gwen,621,335,286,53.95
Fizz,Briar,922,460,462,49.89
Fizz,Zilean,325,174,151,53.54
Fizz,RekSai,132,48,84,36.36
Fizz,Ornn,465,260,205,55.91
Fizz,Seraphine,1029,535,494,51.99
Fizz,Lillia,655,328,327,50.08
Fizz,Samira,920,472,448,51.3
Fizz,Neeko,625,329,296,52.64
Fizz,Ryze,347,171,176,49.28
Fizz,Smolder,826,436,390,52.78
Fizz,Zyra,1022,544,478,53.23
Fizz,Zeri,439,196,243,44.65
Fizz,Zed,1505,743,762,49.37
Fizz,Lulu,1250,623,627,49.84
Fizz,Teemo,1551,781,770,50.35
Fizz,Vi,1081,533,548,49.31
Fizz,Galio,1069,509,560,47.61
Fizz,Rell,491,271,220,55.19
Fizz,Yone,2001,1153,848,57.62
Fizz,Aatrox,1077,613,464,56.92
Fizz,JarvanIV,706,371,335,52.55
Fizz,Cassiopeia,301,166,135,55.15
Fizz,Nasus,854,370,484,43.33
Fizz,Pantheon,1832,889,943,48.53
Fizz,Singed,294,133,161,45.24
Fizz,Caitlyn,3040,1457,1583,47.93
Fizz,Chogath,1383,710,673,51.34
Fizz,Ekko,1103,568,535,51.5
Fizz,Leblanc,642,318,324,49.53
Fizz,Jhin,2348,1268,1080,54
Fizz,Nidalee,272,162,110,59.56
Fizz,Brand,983,490,493,49.85
Fizz,Renekton,577,292,285,50.61
Fizz,Rakan,471,236,235,50.11
Fizz,Vladimir,876,396,480,45.21
Fizz,Xayah,681,357,324,52.42
Fizz,Talon,665,326,339,49.02
Fizz,Renata,201,111,90,55.22
Fizz,Kaisa,1856,954,902,51.4
Fizz,Evelynn,501,278,223,55.49
Fizz,Syndra,852,419,433,49.18
Fizz,Annie,360,232,128,64.44
Fizz,Rammus,419,180,239,42.96
Fizz,Velkoz,789,418,371,52.98
Fizz,Viktor,931,451,480,48.44
Fizz,Soraka,604,302,302,50
Fizz,Corki,366,187,179,51.09
Fizz,Akshan,380,193,187,50.79
Fizz,Milio,698,297,401,42.55
Fizz,Naafiri,389,199,190,51.16
Fizz,Hwei,768,410,358,53.39
Fizz,Kennen,317,166,151,52.37
Fizz,TahmKench,972,478,494,49.18
Fizz,Gangplank,584,304,280,52.05
Fizz,Alistar,450,218,232,48.44
Fizz,Illaoi,531,221,310,41.62
Fizz,Nocturne,1367,673,694,49.23
Fizz,Kassadin,268,126,142,47.01
Fizz,TwistedFate,472,274,198,58.05
Fizz,Jinx,2959,1475,1484,49.85
Fizz,Ambessa,573,337,236,58.81
Fizz,Malzahar,1293,604,689,46.71
Fizz,Sion,876,415,461,47.37
Fizz,MonkeyKing,792,377,415,47.6
Fizz,Orianna,460,237,223,51.52
Fizz,Malphite,1081,561,520,51.9
Fizz,Tryndamere,810,370,440,45.68
Fizz,Poppy,678,320,358,47.2
Fizz,Kindred,532,261,271,49.06
Fizz,Rengar,380,216,164,56.84
Fizz,Sylas,1401,665,736,47.47
Fizz,Skarner,268,145,123,54.1
Fizz,AurelionSol,553,283,270,51.18
Fizz,Elise,794,397,397,50
Fizz,Quinn,405,209,196,51.6
Fizz,Zac,496,298,198,60.08
Fizz,Riven,538,310,228,57.62
Fizz,Zoe,451,276,175,61.2
Fizz,Shen,787,356,431,45.24
Fizz,Taric,284,146,138,51.41
Fizz,Anivia,419,213,206,50.84
Fizz,Kled,236,117,119,49.58
Fizz,FiddleSticks,589,252,337,42.78
Fizz,Ivern,165,105,60,63.64
Fizz,Belveth,253,150,103,59.29
Fizz,Leona,1010,480,530,47.52
Fizz,Camille,392,242,150,61.73
Fizz,Sivir,489,237,252,48.47
Fizz,Karthus,233,95,138,40.77
Fizz,Trundle,642,322,320,50.16
Fizz,XinZhao,775,383,392,49.42
Fizz,Azir,275,147,128,53.45
Fizz,Jayce,506,262,244,51.78
Fizz,Janna,360,175,185,48.61
Fizz,Fiora,389,187,202,48.07
Fizz,Vex,618,292,326,47.25
Fizz,Nunu,715,350,365,48.95
Fizz,Graves,711,365,346,51.34
Fizz,Nilah,365,171,194,46.85
Fizz,Bard,317,154,163,48.58
Fizz,Udyr,406,186,220,45.81
Fizz,Maokai,471,249,222,52.87
Fizz,Lissandra,449,175,274,38.98
Ziggs,Irelia,616,328,288,53.25
Ziggs,Kayn,1166,570,596,48.89
Ziggs,Katarina,641,355,286,55.38
Ziggs,Vayne,932,456,476,48.93
Ziggs,DrMundo,478,247,231,51.67
Ziggs,Mordekaiser,1227,628,599,51.18
Ziggs,Udyr,335,146,189,43.58
Ziggs,Yorick,762,329,433,43.18
Ziggs,Sivir,420,222,198,52.86
Ziggs,Nautilus,966,482,484,49.9
Ziggs,Darius,1501,762,739,50.77
Ziggs,Volibear,975,507,468,52
Ziggs,AurelionSol,381,215,166,56.43
Ziggs,Caitlyn,2568,1284,1284,50
Ziggs,TahmKench,741,394,347,53.17
Ziggs,Lillia,451,252,199,55.88
Ziggs,Sylas,927,443,484,47.79
Ziggs,Lux,2365,1148,1217,48.54
Ziggs,Viktor,640,351,289,54.84
Ziggs,Nocturne,935,462,473,49.41
Ziggs,Yasuo,1431,697,734,48.71
Ziggs,Nilah,323,172,151,53.25
Ziggs,Bard,236,125,111,52.97
Ziggs,Jax,746,415,331,55.63
Ziggs,Jhin,1578,790,788,50.06
Ziggs,Thresh,1052,598,454,56.84
Ziggs,Aurora,594,330,264,55.56
Ziggs,Viego,1110,555,555,50
Ziggs,Mel,1826,1087,739,59.53
Ziggs,Jinx,2272,1119,1153,49.25
Ziggs,Velkoz,526,279,247,53.04
Ziggs,Kindred,415,212,203,51.08
Ziggs,Lulu,887,490,397,55.24
Ziggs,Ashe,1691,809,882,47.84
Ziggs,Fiora,325,163,162,50.15
Ziggs,Teemo,1248,569,679,45.59
Ziggs,Kaisa,1137,595,542,52.33
Ziggs,Milio,435,203,232,46.67
Ziggs,Illaoi,387,175,212,45.22
Ziggs,Malzahar,836,402,434,48.09
Ziggs,Khazix,403,213,190,52.85
Ziggs,Leona,552,253,299,45.83
Ziggs,FiddleSticks,354,203,151,57.34
Ziggs,Gragas,489,263,226,53.78
Ziggs,LeeSin,922,474,448,51.41
Ziggs,Karma,908,474,434,52.2
Ziggs,Sett,1291,614,677,47.56
Ziggs,Graves,525,283,242,53.9
Ziggs,Leblanc,345,170,175,49.28
Ziggs,Yuumi,554,263,291,47.47
Ziggs,KSante,369,184,185,49.86
Ziggs,Zed,877,450,427,51.31
Ziggs,Fizz,492,237,255,48.17
Ziggs,Draven,443,242,201,54.63
Ziggs,Renata,135,83,52,61.48
Ziggs,Warwick,1248,597,651,47.84
Ziggs,MissFortune,1946,1048,898,53.85
Ziggs,Diana,1335,732,603,54.83
Ziggs,Tristana,743,368,375,49.53
Ziggs,Taric,155,74,81,47.74
Ziggs,Sejuani,334,168,166,50.3
Ziggs,MonkeyKing,517,251,266,48.55
Ziggs,Kalista,285,158,127,55.44
Ziggs,Ezreal,1778,916,862,51.52
Ziggs,Ekko,709,364,345,51.34
Ziggs,Nami,740,361,379,48.78
Ziggs,Cassiopeia,290,174,116,60
Ziggs,Lucian,522,246,276,47.13
Ziggs,Skarner,263,144,119,54.75
Ziggs,Ryze,259,117,142,45.17
Ziggs,Elise,539,308,231,57.14
Ziggs,Kayle,469,242,227,51.6
Ziggs,Tryndamere,442,214,228,48.42
Ziggs,Akali,926,468,458,50.54
Ziggs,Neeko,378,218,160,57.67
Ziggs,Yone,1529,791,738,51.73
Ziggs,Singed,204,82,122,40.2
Ziggs,Smolder,537,302,235,56.24
Ziggs,Pyke,700,352,348,50.29
Ziggs,Aatrox,814,435,379,53.44
Ziggs,Xayah,418,232,186,55.5
Ziggs,Rakan,377,162,215,42.97
Ziggs,Rengar,236,139,97,58.9
Ziggs,Vi,762,412,350,54.07
Ziggs,Pantheon,1280,615,665,48.05
Ziggs,Evelynn,336,219,117,65.18
Ziggs,Nasus,582,284,298,48.8
Ziggs,Briar,617,263,354,42.63
Ziggs,Veigar,901,477,424,52.94
Ziggs,Shen,551,273,278,49.55
Ziggs,Shaco,765,358,407,46.8
Ziggs,Chogath,1029,527,502,51.21
Ziggs,Poppy,416,192,224,46.15
Ziggs,Senna,638,350,288,54.86
Ziggs,XinZhao,586,313,273,53.41
Ziggs,Taliyah,235,129,106,54.89
Ziggs,Samira,616,323,293,52.44
Ziggs,Kled,153,97,56,63.4
Ziggs,Varus,732,437,295,59.7
Ziggs,Gangplank,410,230,180,56.1
Ziggs,Olaf,179,82,97,45.81
Ziggs,Nidalee,267,157,110,58.8
Ziggs,Morgana,1186,549,637,46.29
Ziggs,Soraka,498,254,244,51
Ziggs,Trundle,463,242,221,52.27
Ziggs,Ahri,972,505,467,51.95
Ziggs,Ornn,398,202,196,50.75
Ziggs,Amumu,796,378,418,47.49
Ziggs,Galio,823,365,458,44.35
Ziggs,Seraphine,790,391,399,49.49
Ziggs,Zyra,702,359,343,51.14
Ziggs,Malphite,866,501,365,57.85
Ziggs,Garen,1301,589,712,45.27
Ziggs,Vladimir,465,222,243,47.74
Ziggs,MasterYi,954,474,480,49.69
Ziggs,Camille,289,165,124,57.09
Ziggs,Naafiri,286,149,137,52.1
Ziggs,Syndra,521,270,251,51.82
Ziggs,Blitzcrank,650,325,325,50
Ziggs,Riven,410,201,209,49.02
Ziggs,Hwei,613,283,330,46.17
Ziggs,Nunu,516,244,272,47.29
Ziggs,Zac,333,158,175,47.45
Ziggs,Annie,251,135,116,53.78
Ziggs,Renekton,394,207,187,52.54
Ziggs,Swain,797,350,447,43.91
Ziggs,Aphelios,472,253,219,53.6
Ziggs,Ambessa,478,259,219,54.18
Ziggs,Sona,285,119,166,41.75
Ziggs,Xerath,698,391,307,56.02
Ziggs,Zeri,312,146,166,46.79
Ziggs,Zilean,229,109,120,47.6
Ziggs,Akshan,254,121,133,47.64
Ziggs,Heimerdinger,463,222,241,47.95
Ziggs,Kassadin,180,75,105,41.67
Ziggs,Karthus,185,85,100,45.95
Ziggs,Twitch,606,246,360,40.59
Ziggs,Janna,258,126,132,48.84
Ziggs,Urgot,438,239,199,54.57
Ziggs,Ivern,139,54,85,38.85
Ziggs,Sion,585,313,272,53.5
Ziggs,Zoe,402,188,214,46.77
Ziggs,Talon,494,238,256,48.18
Ziggs,Gnar,319,186,133,58.31
Ziggs,Braum,417,218,199,52.28
Ziggs,Gwen,438,203,235,46.35
Ziggs,Corki,274,145,129,52.92
Ziggs,Brand,527,267,260,50.66
Ziggs,Qiyana,170,73,97,42.94
Ziggs,Hecarim,310,167,143,53.87
Ziggs,Alistar,299,164,135,54.85
Ziggs,Jayce,344,193,151,56.1
Ziggs,Orianna,356,192,164,53.93
Ziggs,RekSai,102,63,39,61.76
Ziggs,Belveth,189,98,91,51.85
Ziggs,Lissandra,270,139,131,51.48
Ziggs,Rell,398,199,199,50
Ziggs,Rammus,283,152,131,53.71
Ziggs,Azir,193,114,79,59.07
Ziggs,Anivia,288,142,146,49.31
Ziggs,KogMaw,257,132,125,51.36
Ziggs,Vex,431,265,166,61.48
Ziggs,Quinn,258,129,129,50
Ziggs,JarvanIV,421,243,178,57.72
Ziggs,Rumble,198,121,77,61.11
Ziggs,TwistedFate,292,145,147,49.66
Ziggs,Maokai,324,154,170,47.53
Ziggs,Kennen,196,107,89,54.59
Ziggs,Shyvana,225,94,131,41.78
Zyra,Sett,2744,1378,1366,50.22
Zyra,Taliyah,443,219,224,49.44
Zyra,Cassiopeia,517,275,242,53.19
Zyra,Kaisa,2911,1607,1304,55.2
Zyra,Neeko,1107,616,491,55.65
Zyra,Malphite,1715,857,858,49.97
Zyra,Jax,1549,855,694,55.2
Zyra,Xayah,790,443,347,56.08
Zyra,Rakan,695,401,294,57.7
Zyra,Gwen,918,485,433,52.83
Zyra,Kayn,2550,1303,1247,51.1
Zyra,Thresh,2493,1365,1128,54.75
Zyra,Ezreal,4396,2375,2021,54.03
Zyra,Yuumi,1490,745,745,50
Zyra,Irelia,1557,782,775,50.22
Zyra,Lillia,1016,499,517,49.11
Zyra,Sylas,2501,1263,1238,50.5
Zyra,Caitlyn,4959,2554,2405,51.5
Zyra,Lux,4673,2437,2236,52.15
Zyra,Kennen,495,242,253,48.89
Zyra,MonkeyKing,1272,620,652,48.74
Zyra,Vladimir,1212,625,587,51.57
Zyra,Vayne,2028,1027,1001,50.64
Zyra,Yone,3287,1789,1498,54.43
Zyra,Smolder,1091,563,528,51.6
Zyra,Poppy,1074,590,484,54.93
Zyra,MasterYi,2029,1055,974,52
Zyra,AurelionSol,710,354,356,49.86
Zyra,Seraphine,1600,823,777,51.44
Zyra,Mordekaiser,2402,1235,1167,51.42
Zyra,Nunu,1046,574,472,54.88
Zyra,Aurora,1521,765,756,50.3
Zyra,Nami,1866,1007,859,53.97
Zyra,Swain,1792,890,902,49.67
Zyra,Janna,543,275,268,50.64
Zyra,Briar,1332,615,717,46.17
Zyra,Kassadin,319,142,177,44.51
Zyra,Yasuo,3475,1662,1813,47.83
Zyra,Renata,311,158,153,50.8
Zyra,Amumu,1811,837,974,46.22
Zyra,Tristana,1616,838,778,51.86
Zyra,Pyke,1481,791,690,53.41
Zyra,Fiora,610,315,295,51.64
Zyra,Samira,1288,684,604,53.11
Zyra,Talon,1017,547,470,53.79
Zyra,Varus,1732,814,918,47
Zyra,Urgot,849,434,415,51.12
Zyra,Zed,1993,1109,884,55.64
Zyra,Mel,3533,1814,1719,51.34
Zyra,Sejuani,746,364,382,48.79
Zyra,Ahri,2307,1340,967,58.08
Zyra,Jinx,4843,2453,2390,50.65
Zyra,Nautilus,1877,983,894,52.37
Zyra,Yorick,1616,769,847,47.59
Zyra,Vi,1753,936,817,53.39
Zyra,Shen,1125,547,578,48.62
Zyra,Kindred,858,490,368,57.11
Zyra,Ekko,1609,867,742,53.88
Zyra,Rell,924,520,404,56.28
Zyra,Gragas,1111,628,483,56.53
Zyra,Blitzcrank,1477,800,677,54.16
Zyra,Teemo,2391,1231,1160,51.48
Zyra,Shaco,1833,910,923,49.65
Zyra,Malzahar,1757,856,901,48.72
Zyra,Ashe,3765,1999,1766,53.09
Zyra,TahmKench,1496,820,676,54.81
Zyra,Kayle,1066,522,544,48.97
Zyra,Tryndamere,913,471,442,51.59
Zyra,Akali,1954,1018,936,52.1
Zyra,Jhin,3727,1884,1843,50.55
Zyra,Maokai,922,465,457,50.43
Zyra,Ryze,581,329,252,56.63
Zyra,Viktor,1708,866,842,50.7
Zyra,Twitch,1296,671,625,51.77
Zyra,Lulu,2236,1211,1025,54.16
Zyra,DrMundo,1080,486,594,45
Zyra,Fizz,1022,478,544,46.77
Zyra,Leona,1616,865,751,53.53
Zyra,Darius,3490,1951,1539,55.9
Zyra,FiddleSticks,951,474,477,49.84
Zyra,Hwei,1231,639,592,51.91
Zyra,Anivia,667,328,339,49.18
Zyra,Illaoi,837,443,394,52.93
Zyra,Chogath,2012,1052,960,52.29
Zyra,MissFortune,4225,2147,2078,50.82
Zyra,Braum,932,485,447,52.04
Zyra,Galio,1696,827,869,48.76
Zyra,TwistedFate,656,378,278,57.62
Zyra,Singed,496,217,279,43.75
Zyra,Trundle,972,498,474,51.23
Zyra,Rammus,511,244,267,47.75
Zyra,Sona,575,288,287,50.09
Zyra,Kled,332,170,162,51.2
Zyra,Zeri,868,415,453,47.81
Zyra,Pantheon,2888,1551,1337,53.7
Zyra,Gangplank,921,497,424,53.96
Zyra,Zoe,723,387,336,53.53
Zyra,Draven,858,496,362,57.81
Zyra,Katarina,1408,825,583,58.59
Zyra,Garen,2744,1376,1368,50.15
Zyra,Brand,1379,722,657,52.36
Zyra,Zac,896,477,419,53.24
Zyra,Karma,2362,1212,1150,51.31
Zyra,Velkoz,977,512,465,52.41
Zyra,Hecarim,742,396,346,53.37
Zyra,Soraka,1073,519,554,48.37
Zyra,Evelynn,650,364,286,56
Zyra,Morgana,2384,1233,1151,51.72
Zyra,Nasus,1106,552,554,49.91
Zyra,Skarner,452,263,189,58.19
Zyra,Ziggs,702,343,359,48.86
Zyra,Sivir,1053,573,480,54.42
Zyra,Nocturne,2288,1124,1164,49.13
Zyra,KogMaw,525,247,278,47.05
Zyra,LeeSin,3016,1616,1400,53.58
Zyra,Orianna,765,374,391,48.89
Zyra,Gnar,744,410,334,55.11
Zyra,Khazix,962,499,463,51.87
Zyra,Diana,2946,1491,1455,50.61
Zyra,KSante,983,492,491,50.05
Zyra,Syndra,1203,618,585,51.37
Zyra,Ambessa,1202,676,526,56.24
Zyra,Elise,1242,693,549,55.8
Zyra,Akshan,484,235,249,48.55
Zyra,Sion,1439,684,755,47.53
Zyra,Renekton,842,422,420,50.12
Zyra,Viego,2519,1181,1338,46.88
Zyra,Riven,737,382,355,51.83
Zyra,Azir,605,284,321,46.94
Zyra,Ornn,740,366,374,49.46
Zyra,Lucian,1329,713,616,53.65
Zyra,Karthus,619,365,254,58.97
Zyra,Heimerdinger,882,456,426,51.7
Zyra,Camille,681,360,321,52.86
Zyra,Nidalee,651,377,274,57.91
Zyra,Aphelios,1050,544,506,51.81
Zyra,Xerath,1855,878,977,47.33
Zyra,RekSai,237,132,105,55.7
Zyra,Warwick,2684,1257,1427,46.83
Zyra,Shyvana,407,221,186,54.3
Zyra,Udyr,604,298,306,49.34
Zyra,Milio,972,488,484,50.21
Zyra,XinZhao,1164,570,594,48.97
Zyra,Veigar,1784,929,855,52.07
Zyra,Vex,1009,507,502,50.25
Zyra,Graves,1169,666,503,56.97
Zyra,JarvanIV,1047,528,519,50.43
Zyra,Rengar,473,256,217,54.12
Zyra,Senna,1487,747,740,50.24
Zyra,Quinn,667,318,349,47.68
Zyra,Corki,676,364,312,53.85
Zyra,Taric,338,176,162,52.07
Zyra,Alistar,640,333,307,52.03
Zyra,Leblanc,1112,620,492,55.76
Zyra,Qiyana,445,249,196,55.96
Zyra,Olaf,485,236,249,48.66
Zyra,Volibear,1834,974,860,53.11
Zyra,Lissandra,588,321,267,54.59
Zyra,Bard,610,315,295,51.64
Zyra,Naafiri,644,334,310,51.86
Zyra,Kalista,491,268,223,54.58
Zyra,Ivern,307,191,116,62.21
Zyra,Nilah,602,284,318,47.18
Zyra,Aatrox,1690,918,772,54.32
Zyra,Zilean,502,250,252,49.8
Zyra,Belveth,424,219,205,51.65
Zyra,Annie,631,311,320,49.29
Zyra,Rumble,566,256,310,45.23
Zyra,Jayce,1005,591,414,58.81
Taliyah,Gwen,310,166,144,53.55
Taliyah,JarvanIV,289,136,153,47.06
Taliyah,Yone,899,461,438,51.28
Taliyah,Zyra,443,224,219,50.56
Taliyah,Seraphine,366,201,165,54.92
Taliyah,Kayle,346,155,191,44.8
Taliyah,MonkeyKing,390,228,162,58.46
Taliyah,RekSai,68,38,30,55.88
Taliyah,Sett,765,392,373,51.24
Taliyah,Vi,636,303,333,47.64
Taliyah,AurelionSol,254,105,149,41.34
Taliyah,Corki,244,128,116,52.46
Taliyah,Milio,353,185,168,52.41
Taliyah,Shen,364,207,157,56.87
Taliyah,Teemo,623,252,371,40.45
Taliyah,Twitch,407,184,223,45.21
Taliyah,Nautilus,664,373,291,56.17
Taliyah,Yasuo,1270,605,665,47.64
Taliyah,Evelynn,165,84,81,50.91
Taliyah,Irelia,469,235,234,50.11
Taliyah,Tristana,518,269,249,51.93
Taliyah,Lux,1218,551,667,45.24
Taliyah,Gnar,259,136,123,52.51
Taliyah,Jax,533,281,252,52.72
Taliyah,Aurora,388,227,161,58.51
Taliyah,Swain,483,259,224,53.62
Taliyah,Bard,206,112,94,54.37
Taliyah,Briar,430,232,198,53.95
Taliyah,Fizz,247,140,107,56.68
Taliyah,Jinx,1376,645,731,46.88
Taliyah,Soraka,292,114,178,39.04
Taliyah,Volibear,590,322,268,54.58
Taliyah,Viego,729,366,363,50.21
Taliyah,Samira,358,211,147,58.94
Taliyah,Leona,510,277,233,54.31
Taliyah,Darius,1052,571,481,54.28
Taliyah,Shaco,440,219,221,49.77
Taliyah,Zed,454,221,233,48.68
Taliyah,Kaisa,948,518,430,54.64
Taliyah,Braum,354,192,162,54.24
Taliyah,Ornn,253,123,130,48.62
Taliyah,Yorick,402,177,225,44.03
Taliyah,Zoe,228,138,90,60.53
Taliyah,Blitzcrank,426,227,199,53.29
Taliyah,Pantheon,920,485,435,52.72
Taliyah,Rengar,233,126,107,54.08
Taliyah,Ekko,513,275,238,53.61
Taliyah,Kalista,245,130,115,53.06
Taliyah,Thresh,861,477,384,55.4
Taliyah,Gangplank,282,152,130,53.9
Taliyah,Nunu,339,176,163,51.92
Taliyah,Rakan,259,131,128,50.58
Taliyah,Varus,539,288,251,53.43
Taliyah,Khazix,289,187,102,64.71
Taliyah,Caitlyn,1286,648,638,50.39
Taliyah,Taric,157,81,76,51.59
Taliyah,LeeSin,916,484,432,52.84
Taliyah,Sona,170,79,91,46.47
Taliyah,Mordekaiser,665,300,365,45.11
Taliyah,Lillia,316,152,164,48.1
Taliyah,Fiora,209,119,90,56.94
Taliyah,Nocturne,584,264,320,45.21
Taliyah,Ryze,207,90,117,43.48
Taliyah,Sion,483,232,251,48.03
Taliyah,Ahri,872,425,447,48.74
Taliyah,Ashe,1131,582,549,51.46
Taliyah,Singed,167,70,97,41.92
Taliyah,Nasus,281,163,118,58.01
Taliyah,Amumu,563,246,317,43.69
Taliyah,Ezreal,1259,644,615,51.15
Taliyah,Veigar,449,203,246,45.21
Taliyah,Ziggs,235,106,129,45.11
Taliyah,Sylas,831,431,400,51.87
Taliyah,Viktor,416,237,179,56.97
Taliyah,Draven,303,182,121,60.07
Taliyah,Katarina,370,166,204,44.86
Taliyah,MasterYi,575,282,293,49.04
Taliyah,Nilah,191,127,64,66.49
Taliyah,Nami,598,276,322,46.15
Taliyah,Kayn,733,382,351,52.11
Taliyah,Akshan,222,112,110,50.45
Taliyah,XinZhao,400,171,229,42.75
Taliyah,MissFortune,970,527,443,54.33
Taliyah,Jhin,980,482,498,49.18
Taliyah,Neeko,256,148,108,57.81
Taliyah,Vladimir,319,144,175,45.14
Taliyah,Smolder,354,177,177,50
Taliyah,Malphite,497,222,275,44.67
Taliyah,Annie,231,105,126,45.45
Taliyah,KogMaw,185,82,103,44.32
Taliyah,Alistar,244,128,116,52.46
Taliyah,Galio,438,237,201,54.11
Taliyah,FiddleSticks,270,150,120,55.56
Taliyah,Xerath,437,197,240,45.08
Taliyah,Lucian,412,205,207,49.76
Taliyah,Skarner,208,114,94,54.81
Taliyah,Diana,823,380,443,46.17
Taliyah,Vex,234,111,123,47.44
Taliyah,Karthus,229,123,106,53.71
Taliyah,TahmKench,461,207,254,44.9
Taliyah,Camille,226,125,101,55.31
Taliyah,Aphelios,357,162,195,45.38
Taliyah,Renata,126,71,55,56.35
Taliyah,Warwick,669,338,331,50.52
Taliyah,Morgana,506,229,277,45.26
Taliyah,Yuumi,474,280,194,59.07
Taliyah,Mel,1147,601,546,52.4
Taliyah,Cassiopeia,154,91,63,59.09
Taliyah,Heimerdinger,236,122,114,51.69
Taliyah,Azir,212,105,107,49.53
Taliyah,Chogath,647,360,287,55.64
Taliyah,Poppy,339,172,167,50.74
Taliyah,Illaoi,254,122,132,48.03
Taliyah,Graves,405,235,170,58.02
Taliyah,Vayne,665,362,303,54.44
Taliyah,Hwei,468,252,216,53.85
Taliyah,Sejuani,256,141,115,55.08
Taliyah,KSante,318,170,148,53.46
Taliyah,Karma,716,327,389,45.67
Taliyah,Gragas,327,173,154,52.91
Taliyah,Lissandra,177,89,88,50.28
Taliyah,Lulu,785,398,387,50.7
Taliyah,Garen,851,377,474,44.3
Taliyah,Urgot,277,125,152,45.13
Taliyah,Kindred,261,167,94,63.98
Taliyah,Senna,500,265,235,53
Taliyah,Rell,353,173,180,49.01
Taliyah,Ambessa,402,225,177,55.97
Taliyah,Rammus,141,62,79,43.97
Taliyah,Jayce,339,194,145,57.23
Taliyah,Orianna,317,168,149,53
Taliyah,Olaf,167,101,66,60.48
Taliyah,Elise,381,177,204,46.46
Taliyah,Pyke,425,231,194,54.35
Taliyah,Anivia,186,81,105,43.55
Taliyah,Kassadin,112,62,50,55.36
Taliyah,Malzahar,491,252,239,51.32
Taliyah,Rumble,160,100,60,62.5
Taliyah,DrMundo,301,144,157,47.84
Taliyah,Nidalee,206,98,108,47.57
Taliyah,Brand,308,148,160,48.05
Taliyah,Aatrox,555,306,249,55.14
Taliyah,Tryndamere,291,144,147,49.48
Taliyah,Velkoz,291,144,147,49.48
Taliyah,Udyr,205,103,102,50.24
Taliyah,Hecarim,229,120,109,52.4
Taliyah,Naafiri,205,108,97,52.68
Taliyah,Ivern,70,30,40,42.86
Taliyah,Riven,256,146,110,57.03
Taliyah,Belveth,139,87,52,62.59
Taliyah,Xayah,287,116,171,40.42
Taliyah,Akali,620,324,296,52.26
Taliyah,Renekton,306,158,148,51.63
Taliyah,Trundle,263,116,147,44.11
Taliyah,Talon,313,163,150,52.08
Taliyah,Zeri,272,148,124,54.41
Taliyah,Janna,216,84,132,38.89
Taliyah,TwistedFate,242,144,98,59.5
Taliyah,Syndra,345,160,185,46.38
Taliyah,Qiyana,176,84,92,47.73
Taliyah,Zac,297,152,145,51.18
Taliyah,Quinn,228,118,110,51.75
Taliyah,Maokai,251,115,136,45.82
Taliyah,Sivir,260,111,149,42.69
Taliyah,Zilean,205,114,91,55.61
Taliyah,Leblanc,274,141,133,51.46
Taliyah,Kennen,162,83,79,51.23
Taliyah,Kled,99,50,49,50.51
Taliyah,Shyvana,145,61,84,42.07
Cassiopeia,Gwen,336,149,187,44.35
Cassiopeia,JarvanIV,421,215,206,51.07
Cassiopeia,Yone,1315,698,617,53.08
Cassiopeia,Zyra,517,242,275,46.81
Cassiopeia,Seraphine,541,273,268,50.46
Cassiopeia,Irelia,587,275,312,46.85
Cassiopeia,Pantheon,1044,524,520,50.19
Cassiopeia,Kassadin,113,53,60,46.9
Cassiopeia,Jhin,1231,645,586,52.4
Cassiopeia,Yuumi,527,279,248,52.94
Cassiopeia,Ornn,249,122,127,49
Cassiopeia,Poppy,429,204,225,47.55
Cassiopeia,MissFortune,1479,696,783,47.06
Cassiopeia,Brand,419,205,214,48.93
Cassiopeia,Yorick,602,267,335,44.35
Cassiopeia,Kayn,953,456,497,47.85
Cassiopeia,Sivir,336,182,154,54.17
Cassiopeia,Xerath,650,311,339,47.85
Cassiopeia,Zac,321,160,161,49.84
Cassiopeia,Amumu,709,311,398,43.86
Cassiopeia,Chogath,886,393,493,44.36
Cassiopeia,Twitch,573,348,225,60.73
Cassiopeia,Mel,1555,849,706,54.6
Cassiopeia,Mordekaiser,919,474,445,51.58
Cassiopeia,Diana,1115,562,553,50.4
Cassiopeia,Ezreal,1409,744,665,52.8
Cassiopeia,Thresh,921,496,425,53.85
Cassiopeia,Nunu,389,183,206,47.04
Cassiopeia,Zed,677,380,297,56.13
Cassiopeia,Rakan,302,172,130,56.95
Cassiopeia,Renekton,323,188,135,58.2
Cassiopeia,Khazix,342,166,176,48.54
Cassiopeia,Malzahar,651,328,323,50.38
Cassiopeia,Lux,1404,684,720,48.72
Cassiopeia,Quinn,231,115,116,49.78
Cassiopeia,TahmKench,588,328,260,55.78
Cassiopeia,Sett,937,427,510,45.57
Cassiopeia,Blitzcrank,518,219,299,42.28
Cassiopeia,Katarina,496,268,228,54.03
Cassiopeia,Shaco,551,272,279,49.36
Cassiopeia,Neeko,429,243,186,56.64
Cassiopeia,Caitlyn,1691,866,825,51.21
Cassiopeia,Nasus,486,253,233,52.06
Cassiopeia,FiddleSticks,308,170,138,55.19
Cassiopeia,Azir,263,109,154,41.44
Cassiopeia,Xayah,312,160,152,51.28
Cassiopeia,Nami,638,338,300,52.98
Cassiopeia,Teemo,1100,510,590,46.36
Cassiopeia,Maokai,295,135,160,45.76
Cassiopeia,Sylas,902,496,406,54.99
Cassiopeia,Corki,240,143,97,59.58
Cassiopeia,Taric,172,72,100,41.86
Cassiopeia,Kayle,469,234,235,49.89
Cassiopeia,Nocturne,636,295,341,46.38
Cassiopeia,Lucian,403,208,195,51.61
Cassiopeia,Garen,1012,460,552,45.45
Cassiopeia,Darius,1242,599,643,48.23
Cassiopeia,Aatrox,651,294,357,45.16
Cassiopeia,Jinx,1664,745,919,44.77
Cassiopeia,Morgana,833,402,431,48.26
Cassiopeia,Olaf,217,91,126,41.94
Cassiopeia,Draven,372,193,179,51.88
Cassiopeia,Kled,137,68,69,49.64
Cassiopeia,Vex,435,194,241,44.6
Cassiopeia,Yasuo,1186,615,571,51.85
Cassiopeia,Lulu,785,374,411,47.64
Cassiopeia,XinZhao,483,209,274,43.27
Cassiopeia,Ziggs,290,116,174,40
Cassiopeia,LeeSin,862,491,371,56.96
Cassiopeia,Graves,336,170,166,50.6
Cassiopeia,Briar,560,280,280,50
Cassiopeia,Ryze,299,140,159,46.82
Cassiopeia,Singed,155,96,59,61.94
Cassiopeia,Nautilus,767,396,371,51.63
Cassiopeia,Aurora,619,318,301,51.37
Cassiopeia,Kindred,303,181,122,59.74
Cassiopeia,Viktor,633,325,308,51.34
Cassiopeia,Vayne,777,414,363,53.28
Cassiopeia,Tryndamere,403,203,200,50.37
Cassiopeia,Hwei,458,227,231,49.56
Cassiopeia,Sona,255,92,163,36.08
Cassiopeia,Udyr,251,146,105,58.17
Cassiopeia,Swain,706,361,345,51.13
Cassiopeia,Kalista,242,149,93,61.57
Cassiopeia,Aphelios,429,207,222,48.25
Cassiopeia,Soraka,367,170,197,46.32
Cassiopeia,Trundle,366,205,161,56.01
Cassiopeia,Rammus,234,161,73,68.8
Cassiopeia,Fizz,301,135,166,44.85
Cassiopeia,Ashe,1124,551,573,49.02
Cassiopeia,Kennen,232,116,116,50
Cassiopeia,Zeri,338,190,148,56.21
Cassiopeia,Rengar,219,106,113,48.4
Cassiopeia,Ahri,972,500,472,51.44
Cassiopeia,Orianna,276,132,144,47.83
Cassiopeia,Smolder,454,226,228,49.78
Cassiopeia,Gnar,283,166,117,58.66
Cassiopeia,Vi,638,326,312,51.1
Cassiopeia,Rell,379,185,194,48.81
Cassiopeia,Kaisa,1044,518,526,49.62
Cassiopeia,Zoe,281,127,154,45.2
Cassiopeia,Naafiri,216,108,108,50
Cassiopeia,Hecarim,286,146,140,51.05
Cassiopeia,Velkoz,414,183,231,44.2
Cassiopeia,Warwick,1007,485,522,48.16
Cassiopeia,Ambessa,358,180,178,50.28
Cassiopeia,Karma,666,334,332,50.15
Cassiopeia,Jax,549,283,266,51.55
Cassiopeia,Samira,557,284,273,50.99
Cassiopeia,Elise,486,225,261,46.3
Cassiopeia,Sejuani,326,159,167,48.77
Cassiopeia,MasterYi,650,292,358,44.92
Cassiopeia,Annie,215,103,112,47.91
Cassiopeia,Renata,115,62,53,53.91
Cassiopeia,Riven,270,138,132,51.11
Cassiopeia,Illaoi,229,105,124,45.85
Cassiopeia,Urgot,308,163,145,52.92
Cassiopeia,Viego,843,430,413,51.01
Cassiopeia,Fiora,241,112,129,46.47
Cassiopeia,Akshan,237,127,110,53.59
Cassiopeia,Nilah,273,128,145,46.89
Cassiopeia,Qiyana,193,103,90,53.37
Cassiopeia,Malphite,588,280,308,47.62
Cassiopeia,Lillia,406,213,193,52.46
Cassiopeia,Taliyah,154,63,91,40.91
Cassiopeia,Belveth,209,90,119,43.06
Cassiopeia,Syndra,568,256,312,45.07
Cassiopeia,Camille,227,131,96,57.71
Cassiopeia,Galio,555,269,286,48.47
Cassiopeia,Varus,545,291,254,53.39
Cassiopeia,Gangplank,321,184,137,57.32
Cassiopeia,Akali,636,344,292,54.09
Cassiopeia,Nidalee,223,127,96,56.95
Cassiopeia,Tristana,739,375,364,50.74
Cassiopeia,Senna,533,277,256,51.97
Cassiopeia,Jayce,320,132,188,41.25
Cassiopeia,Veigar,692,325,367,46.97
Cassiopeia,Evelynn,276,154,122,55.8
Cassiopeia,Milio,288,131,157,45.49
Cassiopeia,Lissandra,226,103,123,45.58
Cassiopeia,Volibear,683,392,291,57.39
Cassiopeia,Sion,530,245,285,46.23
Cassiopeia,Gragas,333,190,143,57.06
Cassiopeia,Pyke,640,328,312,51.25
Cassiopeia,Alistar,274,158,116,57.66
Cassiopeia,Talon,438,231,207,52.74
Cassiopeia,MonkeyKing,452,234,218,51.77
Cassiopeia,Vladimir,491,225,266,45.82
Cassiopeia,Leona,569,254,315,44.64
Cassiopeia,Ekko,570,264,306,46.32
Cassiopeia,Janna,203,93,110,45.81
Cassiopeia,DrMundo,411,208,203,50.61
Cassiopeia,Braum,364,186,178,51.1
Cassiopeia,Bard,210,105,105,50
Cassiopeia,Rumble,134,69,65,51.49
Cassiopeia,Zilean,171,73,98,42.69
Cassiopeia,Heimerdinger,308,158,150,51.3
Cassiopeia,Shen,332,166,166,50
Cassiopeia,Ivern,102,54,48,52.94
Cassiopeia,Anivia,289,145,144,50.17
Cassiopeia,KogMaw,200,97,103,48.5
Cassiopeia,Karthus,158,91,67,57.59
Cassiopeia,TwistedFate,231,119,112,51.52
Cassiopeia,AurelionSol,257,154,103,59.92
Cassiopeia,Shyvana,155,60,95,38.71
Cassiopeia,RekSai,75,48,27,64
Cassiopeia,KSante,357,186,171,52.1
Cassiopeia,Skarner,195,110,85,56.41
Cassiopeia,Leblanc,253,107,146,42.29
Evelynn,Teemo,1171,452,719,38.6
Evelynn,Hecarim,269,152,117,56.51
Evelynn,Veigar,925,392,533,42.38
Evelynn,Ashe,1646,797,849,48.42
Evelynn,Thresh,922,422,500,45.77
Evelynn,Yasuo,1643,789,854,48.02
Evelynn,Sylas,947,452,495,47.73
Evelynn,Zed,875,451,424,51.54
Evelynn,Sivir,428,176,252,41.12
Evelynn,Blitzcrank,673,336,337,49.93
Evelynn,Darius,1513,751,762,49.64
Evelynn,Garen,1228,571,657,46.5
Evelynn,Lux,2253,1157,1096,51.35
Evelynn,Rakan,449,191,258,42.54
Evelynn,Riven,429,233,196,54.31
Evelynn,JarvanIV,396,202,194,51.01
Evelynn,Taliyah,165,81,84,49.09
Evelynn,Draven,411,217,194,52.8
Evelynn,Malphite,692,339,353,48.99
Evelynn,Diana,1425,689,736,48.35
Evelynn,Akali,931,419,512,45.01
Evelynn,Jinx,2079,978,1101,47.04
Evelynn,Illaoi,348,164,184,47.13
Evelynn,Khazix,555,297,258,53.51
Evelynn,Syndra,490,262,228,53.47
Evelynn,Kaisa,1242,639,603,51.45
Evelynn,Heimerdinger,392,168,224,42.86
Evelynn,FiddleSticks,354,157,197,44.35
Evelynn,Katarina,664,359,305,54.07
Evelynn,Caitlyn,2140,1033,1107,48.27
Evelynn,Pyke,861,455,406,52.85
Evelynn,Pantheon,1327,629,698,47.4
Evelynn,Nocturne,1067,477,590,44.7
Evelynn,Aurora,705,340,365,48.23
Evelynn,MissFortune,1883,924,959,49.07
Evelynn,Soraka,477,213,264,44.65
Evelynn,Yone,1595,809,786,50.72
Evelynn,Irelia,714,339,375,47.48
Evelynn,Morgana,1225,558,667,45.55
Evelynn,Gnar,413,199,214,48.18
Evelynn,Rammus,181,109,72,60.22
Evelynn,Akshan,262,124,138,47.33
Evelynn,Poppy,471,252,219,53.5
Evelynn,Warwick,1344,607,737,45.16
Evelynn,Zoe,331,170,161,51.36
Evelynn,Gragas,403,194,209,48.14
Evelynn,Mordekaiser,1202,495,707,41.18
Evelynn,Viego,1169,572,597,48.93
Evelynn,Udyr,350,187,163,53.43
Evelynn,Ahri,1183,551,632,46.58
Evelynn,Karma,838,437,401,52.15
Evelynn,Sett,1246,624,622,50.08
Evelynn,KSante,384,211,173,54.95
Evelynn,MonkeyKing,484,250,234,51.65
Evelynn,Ekko,805,396,409,49.19
Evelynn,Lucian,468,210,258,44.87
Evelynn,Senna,605,289,316,47.77
Evelynn,Nasus,648,340,308,52.47
Evelynn,Malzahar,763,314,449,41.15
Evelynn,Ezreal,1665,877,788,52.67
Evelynn,Mel,1697,823,874,48.5
Evelynn,Jhin,1523,736,787,48.33
Evelynn,Nami,842,413,429,49.05
Evelynn,Vayne,953,466,487,48.9
Evelynn,LeeSin,1101,541,560,49.14
Evelynn,Seraphine,720,337,383,46.81
Evelynn,Shyvana,234,118,116,50.43
Evelynn,Viktor,711,384,327,54.01
Evelynn,Janna,239,92,147,38.49
Evelynn,Jax,778,384,394,49.36
Evelynn,Olaf,130,61,69,46.92
Evelynn,Shaco,806,462,344,57.32
Evelynn,TahmKench,771,382,389,49.55
Evelynn,RekSai,72,26,46,36.11
Evelynn,Tristana,875,416,459,47.54
Evelynn,Xayah,547,269,278,49.18
Evelynn,MasterYi,975,484,491,49.64
Evelynn,Renekton,336,159,177,47.32
Evelynn,Fiora,360,177,183,49.17
Evelynn,Kayn,1205,577,628,47.88
Evelynn,Gangplank,375,171,204,45.6
Evelynn,Nunu,558,260,298,46.59
Evelynn,Hwei,586,315,271,53.75
Evelynn,Lulu,989,467,522,47.22
Evelynn,Quinn,278,145,133,52.16
Evelynn,Kled,107,54,53,50.47
Evelynn,Samira,696,355,341,51.01
Evelynn,Leona,604,291,313,48.18
Evelynn,DrMundo,544,237,307,43.57
Evelynn,Belveth,153,108,45,70.59
Evelynn,Azir,256,125,131,48.83
Evelynn,Aphelios,557,260,297,46.68
Evelynn,Naafiri,349,120,229,34.38
Evelynn,Aatrox,796,417,379,52.39
Evelynn,Milio,504,216,288,42.86
Evelynn,Ziggs,336,117,219,34.82
Evelynn,Nilah,407,225,182,55.28
Evelynn,Yorick,738,322,416,43.63
Evelynn,Kassadin,220,114,106,51.82
Evelynn,Shen,514,261,253,50.78
Evelynn,Talon,527,259,268,49.15
Evelynn,Chogath,1067,474,593,44.42
Evelynn,Braum,487,255,232,52.36
Evelynn,Anivia,266,138,128,51.88
Evelynn,Corki,258,141,117,54.65
Evelynn,Vladimir,487,229,258,47.02
Evelynn,Nautilus,848,382,466,45.05
Evelynn,Twitch,760,324,436,42.63
Evelynn,Kayle,643,284,359,44.17
Evelynn,Zac,359,163,196,45.4
Evelynn,Amumu,819,353,466,43.1
Evelynn,Smolder,524,281,243,53.63
Evelynn,Rell,434,220,214,50.69
Evelynn,Ornn,333,151,182,45.35
Evelynn,Singed,222,100,122,45.05
Evelynn,Sona,265,113,152,42.64
Evelynn,Neeko,484,267,217,55.17
Evelynn,AurelionSol,387,133,254,34.37
Evelynn,Ambessa,501,245,256,48.9
Evelynn,Taric,160,88,72,55
Evelynn,Kennen,303,161,142,53.14
Evelynn,Yuumi,719,351,368,48.82
Evelynn,Graves,481,282,199,58.63
Evelynn,Leblanc,453,238,215,52.54
Evelynn,Trundle,472,216,256,45.76
Evelynn,Gwen,432,201,231,46.53
Evelynn,Briar,728,339,389,46.57
Evelynn,Zyra,650,286,364,44
Evelynn,Rengar,290,196,94,67.59
Evelynn,Varus,665,341,324,51.28
Evelynn,Fizz,501,223,278,44.51
Evelynn,Lillia,552,268,284,48.55
Evelynn,Qiyana,254,151,103,59.45
Evelynn,Swain,787,313,474,39.77
Evelynn,Ivern,154,84,70,54.55
Evelynn,Galio,695,301,394,43.31
Evelynn,Annie,218,121,97,55.5
Evelynn,Vi,800,328,472,41
Evelynn,Alistar,305,149,156,48.85
Evelynn,Rumble,226,136,90,60.18
Evelynn,Zeri,317,154,163,48.58
Evelynn,Kindred,370,192,178,51.89
Evelynn,Volibear,1009,466,543,46.18
Evelynn,XinZhao,474,208,266,43.88
Evelynn,KogMaw,267,144,123,53.93
Evelynn,Renata,160,84,76,52.5
Evelynn,Bard,247,109,138,44.13
Evelynn,Velkoz,531,270,261,50.85
Evelynn,Brand,616,286,330,46.43
Evelynn,Zilean,249,112,137,44.98
Evelynn,Sejuani,351,170,181,48.43
Evelynn,Cassiopeia,276,122,154,44.2
Evelynn,Orianna,324,180,144,55.56
Evelynn,Vex,490,235,255,47.96
Evelynn,Sion,688,306,382,44.48
Evelynn,Karthus,231,98,133,42.42
Evelynn,Urgot,436,201,235,46.1
Evelynn,Xerath,615,314,301,51.06
Evelynn,Tryndamere,440,189,251,42.95
Evelynn,Camille,202,118,84,58.42
Evelynn,Maokai,366,190,176,51.91
Evelynn,Lissandra,281,126,155,44.84
Evelynn,Kalista,346,176,170,50.87
Evelynn,Jayce,313,149,164,47.6
Evelynn,Elise,627,357,270,56.94
Evelynn,TwistedFate,274,143,131,52.19
Evelynn,Nidalee,233,133,100,57.08
Evelynn,Ryze,263,132,131,50.19
Evelynn,Skarner,232,121,111,52.16
Hecarim,Warwick,1084,500,584,46.13
Hecarim,Evelynn,269,117,152,43.49
Hecarim,Ahri,1103,468,635,42.43
Hecarim,Yasuo,1619,822,797,50.77
Hecarim,Yone,1445,732,713,50.66
Hecarim,Mordekaiser,1094,503,591,45.98
Hecarim,Akali,835,417,418,49.94
Hecarim,Jhin,1633,697,936,42.68
Hecarim,Velkoz,601,268,333,44.59
Hecarim,Trundle,471,208,263,44.16
Hecarim,Amumu,890,396,494,44.49
Hecarim,Fizz,417,202,215,48.44
Hecarim,Kaisa,1378,707,671,51.31
Hecarim,Pantheon,1266,637,629,50.32
Hecarim,Garen,1309,599,710,45.76
Hecarim,Rammus,245,115,130,46.94
Hecarim,Katarina,696,353,343,50.72
Hecarim,Caitlyn,2049,1025,1024,50.02
Hecarim,Milio,575,283,292,49.22
Hecarim,Ashe,1593,785,808,49.28
Hecarim,LeeSin,1340,662,678,49.4
Hecarim,Varus,801,404,397,50.44
Hecarim,Lux,2038,991,1047,48.63
Hecarim,Aatrox,759,392,367,51.65
Hecarim,Volibear,813,364,449,44.77
Hecarim,Teemo,977,488,489,49.95
Hecarim,Jinx,2277,1029,1248,45.19
Hecarim,Leona,657,305,352,46.42
Hecarim,Camille,310,143,167,46.13
Hecarim,Kayn,1196,622,574,52.01
Hecarim,Zeri,420,215,205,51.19
Hecarim,Yuumi,664,306,358,46.08
Hecarim,Shen,532,264,268,49.62
Hecarim,Vi,816,401,415,49.14
Hecarim,Kassadin,190,104,86,54.74
Hecarim,Corki,390,205,185,52.56
Hecarim,Blitzcrank,603,279,324,46.27
Hecarim,Graves,575,280,295,48.7
Hecarim,Aurora,715,333,382,46.57
Hecarim,Mel,1740,885,855,50.86
Hecarim,KSante,504,272,232,53.97
Hecarim,FiddleSticks,482,243,239,50.41
Hecarim,Irelia,673,337,336,50.07
Hecarim,Senna,605,293,312,48.43
Hecarim,Kindred,434,243,191,55.99
Hecarim,Ekko,793,386,407,48.68
Hecarim,Rell,424,218,206,51.42
Hecarim,Briar,565,228,337,40.35
Hecarim,Zoe,273,146,127,53.48
Hecarim,MissFortune,1712,821,891,47.96
Hecarim,Soraka,520,273,247,52.5
Hecarim,MasterYi,854,426,428,49.88
Hecarim,Zed,1038,537,501,51.73
Hecarim,Pyke,756,416,340,55.03
Hecarim,Yorick,673,270,403,40.12
Hecarim,Diana,1115,524,591,47
Hecarim,Viego,1246,590,656,47.35
Hecarim,Samira,603,285,318,47.26
Hecarim,Thresh,1159,569,590,49.09
Hecarim,Sett,1160,502,658,43.28
Hecarim,Riven,404,219,185,54.21
Hecarim,Darius,1587,721,866,45.43
Hecarim,AurelionSol,399,195,204,48.87
Hecarim,Karma,1012,453,559,44.76
Hecarim,Lillia,551,293,258,53.18
Hecarim,Jax,780,400,380,51.28
Hecarim,Neeko,447,218,229,48.77
Hecarim,Chogath,979,515,464,52.6
Hecarim,Vex,394,198,196,50.25
Hecarim,DrMundo,491,211,280,42.97
Hecarim,Ezreal,1877,960,917,51.15
Hecarim,Morgana,854,409,445,47.89
Hecarim,Illaoi,326,128,198,39.26
Hecarim,Shaco,847,417,430,49.23
Hecarim,Draven,558,266,292,47.67
Hecarim,Alistar,343,150,193,43.73
Hecarim,Shyvana,271,128,143,47.23
Hecarim,Gwen,396,196,200,49.49
Hecarim,Zac,379,185,194,48.81
Hecarim,Khazix,472,230,242,48.73
Hecarim,Lucian,583,312,271,53.52
Hecarim,Ambessa,564,271,293,48.05
Hecarim,Nasus,611,299,312,48.94
Hecarim,TwistedFate,333,182,151,54.65
Hecarim,Gangplank,464,235,229,50.65
Hecarim,Lulu,1233,623,610,50.53
Hecarim,TahmKench,719,315,404,43.81
Hecarim,Cassiopeia,286,140,146,48.95
Hecarim,Gragas,541,237,304,43.81
Hecarim,Bard,331,160,171,48.34
Hecarim,Zyra,742,346,396,46.63
Hecarim,JarvanIV,516,253,263,49.03
Hecarim,Aphelios,464,233,231,50.22
Hecarim,Ryze,283,128,155,45.23
Hecarim,Nautilus,940,477,463,50.74
Hecarim,Kayle,598,281,317,46.99
Hecarim,Akshan,351,183,168,52.14
Hecarim,Skarner,250,130,120,52
Hecarim,Qiyana,269,138,131,51.3
Hecarim,Nocturne,958,472,486,49.27
Hecarim,Malzahar,793,404,389,50.95
Hecarim,Ornn,361,198,163,54.85
Hecarim,Twitch,684,304,380,44.44
Hecarim,Rengar,375,237,138,63.2
Hecarim,KogMaw,331,164,167,49.55
Hecarim,Kennen,239,145,94,60.67
Hecarim,Udyr,351,151,200,43.02
Hecarim,Leblanc,428,197,231,46.03
Hecarim,Nilah,224,110,114,49.11
Hecarim,Nami,873,418,455,47.88
Hecarim,Vayne,1046,518,528,49.52
Hecarim,Tristana,772,368,404,47.67
Hecarim,Kled,143,52,91,36.36
Hecarim,Seraphine,595,268,327,45.04
Hecarim,Vladimir,547,261,286,47.71
Hecarim,Poppy,472,228,244,48.31
Hecarim,Hwei,592,312,280,52.7
Hecarim,Sivir,465,224,241,48.17
Hecarim,Brand,580,255,325,43.97
Hecarim,Sylas,1205,559,646,46.39
Hecarim,Veigar,792,313,479,39.52
Hecarim,Ziggs,310,143,167,46.13
Hecarim,Gnar,302,173,129,57.28
Hecarim,Elise,631,311,320,49.29
Hecarim,Jayce,412,173,239,41.99
Hecarim,Viktor,771,414,357,53.7
Hecarim,Singed,258,117,141,45.35
Hecarim,Talon,509,281,228,55.21
Hecarim,Braum,470,259,211,55.11
Hecarim,Ivern,130,62,68,47.69
Hecarim,Galio,658,272,386,41.34
Hecarim,Sejuani,348,169,179,48.56
Hecarim,Malphite,752,383,369,50.93
Hecarim,MonkeyKing,491,195,296,39.71
Hecarim,Swain,782,361,421,46.16
Hecarim,Smolder,644,306,338,47.52
Hecarim,Nunu,610,281,329,46.07
Hecarim,Naafiri,306,165,141,53.92
Hecarim,Nidalee,243,139,104,57.2
Hecarim,Xayah,419,210,209,50.12
Hecarim,Karthus,253,162,91,64.03
Hecarim,Rumble,239,110,129,46.03
Hecarim,Syndra,586,280,306,47.78
Hecarim,Urgot,375,163,212,43.47
Hecarim,Sona,285,158,127,55.44
Hecarim,Taliyah,229,109,120,47.6
Hecarim,Zilean,250,86,164,34.4
Hecarim,Sion,674,298,376,44.21
Hecarim,Tryndamere,463,222,241,47.95
Hecarim,Renata,124,56,68,45.16
Hecarim,Maokai,364,173,191,47.53
Hecarim,Xerath,763,351,412,46
Hecarim,Janna,307,138,169,44.95
Hecarim,Quinn,246,131,115,53.25
Hecarim,XinZhao,523,221,302,42.26
Hecarim,Rakan,328,188,140,57.32
Hecarim,Fiora,341,161,180,47.21
Hecarim,Anivia,251,111,140,44.22
Hecarim,Annie,275,156,119,56.73
Hecarim,Lissandra,249,107,142,42.97
Hecarim,Taric,156,56,100,35.9
Hecarim,Renekton,412,193,219,46.84
Hecarim,Orianna,369,193,176,52.3
Hecarim,Olaf,184,93,91,50.54
Hecarim,Belveth,215,112,103,52.09
Hecarim,Azir,298,178,120,59.73
Hecarim,Kalista,308,149,159,48.38
Hecarim,RekSai,128,39,89,30.47
Hecarim,Heimerdinger,309,134,175,43.37
Thresh,Warwick,4271,2044,2227,47.86
Thresh,Evelynn,922,500,422,54.23
Thresh,Ahri,3805,1919,1886,50.43
Thresh,Yasuo,5770,2999,2771,51.98
Thresh,Yone,5514,2901,2613,52.61
Thresh,Sylas,3976,2111,1865,53.09
Thresh,Zed,3237,1746,1491,53.94
Thresh,Sivir,1613,789,824,48.92
Thresh,Blitzcrank,2487,1324,1163,53.24
Thresh,Teemo,3379,1645,1734,48.68
Thresh,XinZhao,2058,1041,1017,50.58
Thresh,Jinx,7451,3609,3842,48.44
Thresh,Neeko,1489,710,779,47.68
Thresh,Irelia,2417,1243,1174,51.43
Thresh,Galio,2683,1376,1307,51.29
Thresh,Rell,1716,836,880,48.72
Thresh,Illaoi,1286,633,653,49.22
Thresh,Aatrox,3260,1690,1570,51.84
Thresh,Ashe,5953,3032,2921,50.93
Thresh,Aphelios,1753,881,872,50.26
Thresh,Gragas,1949,1087,862,55.77
Thresh,Yorick,2658,1237,1421,46.54
Thresh,Viego,4298,2195,2103,51.07
Thresh,Malphite,2957,1462,1495,49.44
Thresh,Kaisa,5101,2654,2447,52.03
Thresh,Ambessa,1944,992,952,51.03
Thresh,Xayah,1655,831,824,50.21
Thresh,AurelionSol,1115,581,534,52.11
Thresh,Khazix,1536,782,754,50.91
Thresh,Nautilus,3820,1932,1888,50.58
Thresh,Camille,1109,553,556,49.86
Thresh,Katarina,2285,1130,1155,49.45
Thresh,MissFortune,6133,2893,3240,47.17
Thresh,Zyra,2493,1128,1365,45.25
Thresh,LeeSin,4786,2527,2259,52.8
Thresh,Chogath,3613,1730,1883,47.88
Thresh,Lucian,2107,1119,988,53.11
Thresh,Xerath,2482,1257,1225,50.64
Thresh,Kindred,1355,722,633,53.28
Thresh,Fizz,1540,758,782,49.22
Thresh,Gnar,1287,647,640,50.27
Thresh,Caitlyn,7338,3580,3758,48.79
Thresh,Ezreal,7403,3909,3494,52.8
Thresh,Lux,7646,3728,3918,48.76
Thresh,Darius,5630,2791,2839,49.57
Thresh,Trundle,1549,761,788,49.13
Thresh,Vex,1570,767,803,48.85
Thresh,Mordekaiser,3888,1860,2028,47.84
Thresh,Nunu,1783,838,945,47
Thresh,Shen,2024,953,1071,47.08
Thresh,Rammus,889,435,454,48.93
Thresh,Cassiopeia,921,425,496,46.15
Thresh,Tryndamere,1607,761,846,47.36
Thresh,Amumu,2655,1209,1446,45.54
Thresh,Mel,5792,3010,2782,51.97
Thresh,Seraphine,2264,1031,1233,45.54
Thresh,Tristana,2714,1368,1346,50.41
Thresh,Nilah,1036,476,560,45.95
Thresh,TahmKench,2602,1338,1264,51.42
Thresh,Naafiri,913,449,464,49.18
Thresh,Volibear,3130,1520,1610,48.56
Thresh,Soraka,1563,805,758,51.5
Thresh,Ekko,2493,1220,1273,48.94
Thresh,Leona,2810,1480,1330,52.67
Thresh,Ziggs,1052,454,598,43.16
Thresh,Kayn,3898,1955,1943,50.15
Thresh,Syndra,1841,937,904,50.9
Thresh,Senna,2247,1188,1059,52.87
Thresh,Akali,3056,1581,1475,51.73
Thresh,Akshan,965,434,531,44.97
Thresh,Skarner,865,469,396,54.22
Thresh,Shaco,2552,1370,1182,53.68
Thresh,Lissandra,981,443,538,45.16
Thresh,Pyke,2887,1513,1374,52.41
Thresh,Talon,1764,996,768,56.46
Thresh,Maokai,1279,574,705,44.88
Thresh,Varus,2614,1332,1282,50.96
Thresh,Graves,2234,1092,1142,48.88
Thresh,Gangplank,1539,863,676,56.08
Thresh,Hwei,2016,984,1032,48.81
Thresh,Jhin,5657,2941,2716,51.99
Thresh,Kennen,923,454,469,49.19
Thresh,Karthus,847,438,409,51.71
Thresh,Veigar,2668,1236,1432,46.33
Thresh,Vladimir,1833,876,957,47.79
Thresh,Sona,840,420,420,50
Thresh,Urgot,1298,629,669,48.46
Thresh,Twitch,2199,1132,1067,51.48
Thresh,MasterYi,3214,1585,1629,49.32
Thresh,Smolder,2004,1044,960,52.1
Thresh,Yuumi,2591,1338,1253,51.64
Thresh,Garen,4607,2143,2464,46.52
Thresh,Vi,2837,1473,1364,51.92
Thresh,Diana,4604,2372,2232,51.52
Thresh,Annie,923,497,426,53.85
Thresh,Shyvana,688,286,402,41.57
Thresh,Taric,784,355,429,45.28
Thresh,Nami,2906,1391,1515,47.87
Thresh,Singed,903,424,479,46.95
Thresh,Taliyah,861,384,477,44.6
Thresh,Jax,2470,1290,1180,52.23
Thresh,Zoe,1160,602,558,51.9
Thresh,Poppy,1948,934,1014,47.95
Thresh,Sett,4238,2091,2147,49.34
Thresh,Rengar,986,566,420,57.4
Thresh,Ivern,504,312,192,61.9
Thresh,Ryze,1142,513,629,44.92
Thresh,Pantheon,4728,2431,2297,51.42
Thresh,Renekton,1559,765,794,49.07
Thresh,Fiora,1116,609,507,54.57
Thresh,Rakan,1512,793,719,52.45
Thresh,Brand,1943,908,1035,46.73
Thresh,Velkoz,1786,829,957,46.42
Thresh,Heimerdinger,1185,529,656,44.64
Thresh,Qiyana,736,413,323,56.11
Thresh,Udyr,1217,606,611,49.79
Thresh,Karma,3579,1807,1772,50.49
Thresh,Ornn,1156,563,593,48.7
Thresh,KSante,1688,927,761,54.92
Thresh,Sion,2465,1151,1314,46.69
Thresh,Hecarim,1159,590,569,50.91
Thresh,Lulu,4142,2186,1956,52.78
Thresh,Samira,2098,1064,1034,50.71
Thresh,Morgana,3541,1675,1866,47.3
Thresh,Alistar,1611,816,795,50.65
Thresh,Briar,2132,1032,1100,48.41
Thresh,Anivia,983,503,480,51.17
Thresh,Leblanc,1890,909,981,48.1
Thresh,Milio,1757,878,879,49.97
Thresh,Sejuani,1461,701,760,47.98
Thresh,Corki,1216,611,605,50.25
Thresh,Swain,3193,1460,1733,45.73
Thresh,Aurora,2427,1236,1191,50.93
Thresh,Lillia,1812,910,902,50.22
Thresh,Renata,626,331,295,52.88
Thresh,FiddleSticks,1484,782,702,52.7
Thresh,Kalista,931,495,436,53.17
Thresh,Zilean,1016,493,523,48.52
Thresh,JarvanIV,1926,978,948,50.78
Thresh,Malzahar,2916,1349,1567,46.26
Thresh,Draven,1656,914,742,55.19
Thresh,Nasus,2059,1008,1051,48.96
Thresh,Rumble,782,386,396,49.36
Thresh,Kled,508,254,254,50
Thresh,Quinn,999,471,528,47.15
Thresh,Viktor,2602,1268,1334,48.73
Thresh,TwistedFate,1144,580,564,50.7
Thresh,Zeri,1313,680,633,51.79
Thresh,Kayle,1838,892,946,48.53
Thresh,Elise,2160,1086,1074,50.28
Thresh,Riven,1382,757,625,54.78
Thresh,Nocturne,3480,1671,1809,48.02
Thresh,Janna,1032,468,564,45.35
Thresh,Zac,1509,738,771,48.91
Thresh,Braum,2217,1086,1131,48.99
Thresh,Olaf,671,267,404,39.79
Thresh,Kassadin,674,368,306,54.6
Thresh,Orianna,1319,720,599,54.59
Thresh,Azir,1097,547,550,49.86
Thresh,Jayce,1559,796,763,51.06
Thresh,MonkeyKing,2047,1037,1010,50.66
Thresh,Gwen,1588,887,701,55.86
Thresh,Vayne,3549,1773,1776,49.96
Thresh,KogMaw,917,455,462,49.62
Thresh,DrMundo,1519,786,733,51.74
Thresh,Bard,975,449,526,46.05
Thresh,RekSai,351,184,167,52.42
Thresh,Belveth,742,359,383,48.38
Thresh,Nidalee,1042,567,475,54.41
RekSai,Sett,374,142,232,37.97
RekSai,Taliyah,68,30,38,44.12
RekSai,Sylas,322,152,170,47.2
RekSai,Ezreal,754,382,372,50.66
RekSai,Morgana,303,147,156,48.51
RekSai,Illaoi,105,48,57,45.71
RekSai,Nocturne,303,154,149,50.83
RekSai,Ekko,252,122,130,48.41
RekSai,MissFortune,517,266,251,51.45
RekSai,Seraphine,256,131,125,51.17
RekSai,Gnar,144,60,84,41.67
RekSai,XinZhao,209,103,106,49.28
RekSai,Yasuo,558,305,253,54.66
RekSai,Zeri,132,71,61,53.79
RekSai,Taric,56,13,43,23.21
RekSai,Tryndamere,136,76,60,55.88
RekSai,LeeSin,621,315,306,50.72
RekSai,Aurora,193,76,117,39.38
RekSai,Mel,560,242,318,43.21
RekSai,Rumble,88,43,45,48.86
RekSai,Pantheon,485,252,233,51.96
RekSai,Jhin,527,297,230,56.36
RekSai,Nautilus,246,123,123,50
RekSai,Darius,563,275,288,48.85
RekSai,Evelynn,72,46,26,63.89
RekSai,Heimerdinger,135,63,72,46.67
RekSai,Jinx,704,326,378,46.31
RekSai,Pyke,262,103,159,39.31
RekSai,Diana,353,152,201,43.06
RekSai,Yone,457,215,242,47.05
RekSai,Veigar,281,138,143,49.11
RekSai,DrMundo,112,61,51,54.46
RekSai,Kayn,348,206,142,59.2
RekSai,Akali,251,143,108,56.97
RekSai,Draven,153,54,99,35.29
RekSai,Rell,154,85,69,55.19
RekSai,Camille,87,48,39,55.17
RekSai,Ahri,402,189,213,47.01
RekSai,Caitlyn,656,309,347,47.1
RekSai,Fizz,132,84,48,63.64
RekSai,MasterYi,237,121,116,51.05
RekSai,Aphelios,176,105,71,59.66
RekSai,Shaco,297,149,148,50.17
RekSai,Chogath,310,106,204,34.19
RekSai,Poppy,231,91,140,39.39
RekSai,Shyvana,57,40,17,70.18
RekSai,Maokai,118,64,54,54.24
RekSai,Warwick,345,145,200,42.03
RekSai,Irelia,211,124,87,58.77
RekSai,Sivir,169,68,101,40.24
RekSai,Annie,127,68,59,53.54
RekSai,Renekton,145,62,83,42.76
RekSai,Sejuani,138,46,92,33.33
RekSai,Urgot,144,57,87,39.58
RekSai,Viego,460,185,275,40.22
RekSai,Aatrox,274,128,146,46.72
RekSai,Zed,351,172,179,49
RekSai,Karma,327,166,161,50.76
RekSai,Galio,285,149,136,52.28
RekSai,Nami,317,152,165,47.95
RekSai,Naafiri,52,30,22,57.69
RekSai,Zyra,237,105,132,44.3
RekSai,Xayah,179,95,84,53.07
RekSai,Rakan,152,82,70,53.95
RekSai,Vladimir,169,74,95,43.79
RekSai,Renata,61,30,31,49.18
RekSai,Teemo,315,120,195,38.1
RekSai,Anivia,108,54,54,50
RekSai,TahmKench,173,87,86,50.29
RekSai,Twitch,254,128,126,50.39
RekSai,Kaisa,449,219,230,48.78
RekSai,Ashe,548,254,294,46.35
RekSai,Kassadin,65,30,35,46.15
RekSai,Shen,220,111,109,50.45
RekSai,Volibear,342,161,181,47.08
RekSai,Amumu,246,116,130,47.15
RekSai,Katarina,217,109,108,50.23
RekSai,Vayne,268,97,171,36.19
RekSai,Yorick,229,93,136,40.61
RekSai,Hwei,211,122,89,57.82
RekSai,Mordekaiser,389,180,209,46.27
RekSai,Ziggs,102,39,63,38.24
RekSai,Samira,207,90,117,43.48
RekSai,Leona,241,110,131,45.64
RekSai,Garen,324,134,190,41.36
RekSai,Briar,209,88,121,42.11
RekSai,Thresh,351,167,184,47.58
RekSai,Yuumi,264,146,118,55.3
RekSai,Gragas,155,97,58,62.58
RekSai,Lulu,368,182,186,49.46
RekSai,Malphite,267,136,131,50.94
RekSai,MonkeyKing,149,82,67,55.03
RekSai,Tristana,267,118,149,44.19
RekSai,Viktor,238,120,118,50.42
RekSai,Nasus,170,64,106,37.65
RekSai,Vi,247,137,110,55.47
RekSai,AurelionSol,105,52,53,49.52
RekSai,Milio,189,101,88,53.44
RekSai,Zac,140,61,79,43.57
RekSai,Kayle,172,77,95,44.77
RekSai,Malzahar,246,111,135,45.12
RekSai,Lux,592,252,340,42.57
RekSai,Talon,192,109,83,56.77
RekSai,Neeko,146,70,76,47.95
RekSai,Jax,235,151,84,64.26
RekSai,Rammus,101,49,52,48.51
RekSai,Graves,213,104,109,48.83
RekSai,Soraka,150,66,84,44
RekSai,Sion,254,134,120,52.76
RekSai,Syndra,185,67,118,36.22
RekSai,Braum,199,80,119,40.2
RekSai,Trundle,135,64,71,47.41
RekSai,Kalista,92,50,42,54.35
RekSai,Swain,264,133,131,50.38
RekSai,Kennen,70,35,35,50
RekSai,Smolder,205,106,99,51.71
RekSai,FiddleSticks,137,57,80,41.61
RekSai,Kled,67,33,34,49.25
RekSai,Nilah,108,45,63,41.67
RekSai,Singed,96,50,46,52.08
RekSai,Brand,174,86,88,49.43
RekSai,Udyr,126,50,76,39.68
RekSai,Akshan,77,30,47,38.96
RekSai,Xerath,193,86,107,44.56
RekSai,Elise,240,142,98,59.17
RekSai,Alistar,123,53,70,43.09
RekSai,Varus,240,96,144,40
RekSai,Lissandra,133,64,69,48.12
RekSai,Kindred,128,57,71,44.53
RekSai,Azir,133,68,65,51.13
RekSai,JarvanIV,164,77,87,46.95
RekSai,Leblanc,145,74,71,51.03
RekSai,Karthus,121,57,64,47.11
RekSai,Orianna,161,87,74,54.04
RekSai,KSante,219,115,104,52.51
RekSai,Sona,114,38,76,33.33
RekSai,Gangplank,212,117,95,55.19
RekSai,Bard,77,44,33,57.14
RekSai,Fiora,102,40,62,39.22
RekSai,Ornn,143,77,66,53.85
RekSai,Khazix,106,32,74,30.19
RekSai,Vex,121,43,78,35.54
RekSai,Janna,108,58,50,53.7
RekSai,Nidalee,111,49,62,44.14
RekSai,Corki,146,41,105,28.08
RekSai,Zilean,82,40,42,48.78
RekSai,Hecarim,128,89,39,69.53
RekSai,Ambessa,184,112,72,60.87
RekSai,Cassiopeia,75,27,48,36
RekSai,Senna,171,64,107,37.43
RekSai,Riven,147,75,72,51.02
RekSai,Belveth,65,20,45,30.77
RekSai,TwistedFate,104,45,59,43.27
RekSai,Qiyana,76,43,33,56.58
RekSai,Velkoz,142,70,72,49.3
RekSai,Lillia,171,84,87,49.12
RekSai,Lucian,220,108,112,49.09
RekSai,Gwen,161,76,85,47.2
RekSai,Blitzcrank,236,109,127,46.19
RekSai,Quinn,110,38,72,34.55
RekSai,Zoe,146,89,57,60.96
RekSai,Nunu,194,93,101,47.94
RekSai,Rengar,104,55,49,52.88
RekSai,Ryze,119,57,62,47.9
RekSai,Skarner,76,38,38,50
RekSai,KogMaw,66,28,38,42.42
RekSai,Ivern,48,24,24,50
RekSai,Jayce,149,55,94,36.91
RekSai,Olaf,43,21,22,48.84
Sivir,Malphite,1179,592,587,50.21
Sivir,Evelynn,428,252,176,58.88
Sivir,Irelia,906,498,408,54.97
Sivir,Tristana,932,433,499,46.46
Sivir,Thresh,1613,824,789,51.08
Sivir,Teemo,1439,674,765,46.84
Sivir,Shaco,1144,555,589,48.51
Sivir,Leblanc,629,333,296,52.94
Sivir,Ezreal,3144,1776,1368,56.49
Sivir,Sett,1577,841,736,53.33
Sivir,Talon,719,349,370,48.54
Sivir,FiddleSticks,614,281,333,45.77
Sivir,Ashe,2558,1286,1272,50.27
Sivir,Blitzcrank,1237,692,545,55.94
Sivir,Urgot,509,261,248,51.28
Sivir,Rengar,298,197,101,66.11
Sivir,Ziggs,420,198,222,47.14
Sivir,Trundle,638,307,331,48.12
Sivir,Fiora,462,219,243,47.4
Sivir,Mordekaiser,1489,757,732,50.84
Sivir,Vi,1127,585,542,51.91
Sivir,Cassiopeia,336,154,182,45.83
Sivir,Lux,2666,1359,1307,50.98
Sivir,Vladimir,753,434,319,57.64
Sivir,Yasuo,2123,1026,1097,48.33
Sivir,Yuumi,712,334,378,46.91
Sivir,Shen,702,365,337,51.99
Sivir,Yone,1936,1000,936,51.65
Sivir,Twitch,783,380,403,48.53
Sivir,Nautilus,1352,797,555,58.95
Sivir,Kayn,1493,761,732,50.97
Sivir,Diana,1753,953,800,54.36
Sivir,Renekton,512,276,236,53.91
Sivir,Lillia,629,337,292,53.58
Sivir,Annie,382,223,159,58.38
Sivir,Kaisa,1830,1002,828,54.75
Sivir,Xerath,980,537,443,54.8
Sivir,XinZhao,661,333,328,50.38
Sivir,Vayne,1285,550,735,42.8
Sivir,Brand,783,423,360,54.02
Sivir,Kayle,644,318,326,49.38
Sivir,Morgana,1495,773,722,51.71
Sivir,Viego,1451,733,718,50.52
Sivir,Jinx,2952,1477,1475,50.03
Sivir,Pyke,1163,670,493,57.61
Sivir,Camille,429,199,230,46.39
Sivir,Warwick,1597,700,897,43.83
Sivir,Azir,442,240,202,54.3
Sivir,Braum,573,279,294,48.69
Sivir,Poppy,654,357,297,54.59
Sivir,Elise,829,405,424,48.85
Sivir,Aurora,1006,496,510,49.3
Sivir,Nami,1121,495,626,44.16
Sivir,Akali,1170,598,572,51.11
Sivir,Gragas,605,347,258,57.36
Sivir,Syndra,721,374,347,51.87
Sivir,Veigar,1171,558,613,47.65
Sivir,Gnar,474,225,249,47.47
Sivir,AurelionSol,456,241,215,52.85
Sivir,LeeSin,1634,844,790,51.65
Sivir,Zoe,438,216,222,49.32
Sivir,Jhin,2146,1077,1069,50.19
Sivir,Seraphine,958,478,480,49.9
Sivir,Yorick,1054,540,514,51.23
Sivir,Sejuani,472,253,219,53.6
Sivir,Kalista,303,158,145,52.15
Sivir,Khazix,569,302,267,53.08
Sivir,Caitlyn,3139,1614,1525,51.42
Sivir,Taric,233,96,137,41.2
Sivir,Mel,2306,1214,1092,52.65
Sivir,Sylas,1554,820,734,52.77
Sivir,Senna,847,451,396,53.25
Sivir,Pantheon,1924,967,957,50.26
Sivir,Kassadin,236,106,130,44.92
Sivir,Milio,591,261,330,44.16
Sivir,TahmKench,877,467,410,53.25
Sivir,Qiyana,255,135,120,52.94
Sivir,Rell,541,265,276,48.98
Sivir,Volibear,1220,570,650,46.72
Sivir,Lulu,1278,605,673,47.34
Sivir,Katarina,749,354,395,47.26
Sivir,Galio,1023,495,528,48.39
Sivir,MissFortune,2654,1340,1314,50.49
Sivir,Smolder,744,362,382,48.66
Sivir,Zed,1166,569,597,48.8
Sivir,Darius,1948,1029,919,52.82
Sivir,Karma,1423,727,696,51.09
Sivir,Ekko,988,481,507,48.68
Sivir,Lucian,784,443,341,56.51
Sivir,Draven,547,264,283,48.26
Sivir,Heimerdinger,476,205,271,43.07
Sivir,Aatrox,1100,555,545,50.45
Sivir,Hwei,696,364,332,52.3
Sivir,Chogath,1354,671,683,49.56
Sivir,Soraka,551,297,254,53.9
Sivir,Kled,168,92,76,54.76
Sivir,Zac,561,274,287,48.84
Sivir,Rakan,472,250,222,52.97
Sivir,Zyra,1053,480,573,45.58
Sivir,Graves,687,371,316,54
Sivir,Neeko,582,324,258,55.67
Sivir,RekSai,169,101,68,59.76
Sivir,Maokai,460,230,230,50
Sivir,Orianna,479,201,278,41.96
Sivir,Varus,1109,534,575,48.15
Sivir,Gangplank,614,319,295,51.95
Sivir,Gwen,594,350,244,58.92
Sivir,Ivern,244,131,113,53.69
Sivir,Garen,1803,962,841,53.36
Sivir,Amumu,1129,526,603,46.59
Sivir,MasterYi,1220,603,617,49.43
Sivir,Nunu,713,357,356,50.07
Sivir,Leona,1054,586,468,55.6
Sivir,Ornn,448,211,237,47.1
Sivir,Swain,1092,527,565,48.26
Sivir,Vex,608,310,298,50.99
Sivir,Riven,512,276,236,53.91
Sivir,Nocturne,1456,737,719,50.62
Sivir,Rumble,284,159,125,55.99
Sivir,Nasus,812,385,427,47.41
Sivir,Karthus,328,176,152,53.66
Sivir,Malzahar,1125,532,593,47.29
Sivir,Aphelios,667,367,300,55.02
Sivir,Jax,1114,585,529,52.51
Sivir,Briar,841,435,406,51.72
Sivir,Corki,470,255,215,54.26
Sivir,Ryze,396,207,189,52.27
Sivir,KogMaw,364,151,213,41.48
Sivir,JarvanIV,683,339,344,49.63
Sivir,DrMundo,533,247,286,46.34
Sivir,TwistedFate,382,220,162,57.59
Sivir,Hecarim,465,241,224,51.83
Sivir,Ahri,1582,831,751,52.53
Sivir,Alistar,559,315,244,56.35
Sivir,Sion,828,427,401,51.57
Sivir,Illaoi,556,272,284,48.92
Sivir,Viktor,1056,555,501,52.56
Sivir,KSante,526,309,217,58.75
Sivir,Rammus,266,129,137,48.5
Sivir,Zilean,401,205,196,51.12
Sivir,Udyr,411,225,186,54.74
Sivir,Quinn,411,232,179,56.45
Sivir,Ambessa,755,385,370,50.99
Sivir,Zeri,497,298,199,59.96
Sivir,Singed,332,149,183,44.88
Sivir,MonkeyKing,718,385,333,53.62
Sivir,Belveth,220,107,113,48.64
Sivir,Olaf,316,179,137,56.65
Sivir,Lissandra,325,158,167,48.62
Sivir,Shyvana,310,149,161,48.06
Sivir,Nidalee,354,196,158,55.37
Sivir,Skarner,331,201,130,60.73
Sivir,Kindred,556,272,284,48.92
Sivir,Anivia,406,217,189,53.45
Sivir,Nilah,312,156,156,50
Sivir,Fizz,489,252,237,51.53
Sivir,Tryndamere,597,294,303,49.25
Sivir,Janna,390,213,177,54.62
Sivir,Akshan,361,163,198,45.15
Sivir,Sona,335,176,159,52.54
Sivir,Renata,263,144,119,54.75
Sivir,Samira,818,400,418,48.9
Sivir,Jayce,557,271,286,48.65
Sivir,Naafiri,352,152,200,43.18
Sivir,Velkoz,669,330,339,49.33
Sivir,Xayah,563,302,261,53.64
Sivir,Bard,343,189,154,55.1
Sivir,Taliyah,260,149,111,57.31
Sivir,Kennen,300,168,132,56
Xayah,Sylas,1538,814,724,52.93
Xayah,Caitlyn,3024,1450,1574,47.95
Xayah,Zed,1415,796,619,56.25
Xayah,MasterYi,1342,715,627,53.28
Xayah,Rell,669,388,281,58
Xayah,Yone,2101,1041,1060,49.55
Xayah,Kayn,1590,886,704,55.72
Xayah,TwistedFate,416,206,210,49.52
Xayah,Smolder,707,348,359,49.22
Xayah,Nautilus,1552,871,681,56.12
Xayah,Poppy,773,389,384,50.32
Xayah,Diana,1770,870,900,49.15
Xayah,Anivia,373,166,207,44.5
Xayah,Thresh,1655,824,831,49.79
Xayah,Akali,1215,614,601,50.53
Xayah,Rammus,374,171,203,45.72
Xayah,Yasuo,2383,1235,1148,51.83
Xayah,Jinx,2857,1293,1564,45.26
Xayah,Zyra,790,347,443,43.92
Xayah,Tryndamere,576,281,295,48.78
Xayah,Aurora,947,457,490,48.26
Xayah,Twitch,868,453,415,52.19
Xayah,Lux,2733,1295,1438,47.38
Xayah,Jayce,508,276,232,54.33
Xayah,Amumu,1216,516,700,42.43
Xayah,Ashe,2124,1026,1098,48.31
Xayah,Milio,596,270,326,45.3
Xayah,Vayne,1410,716,694,50.78
Xayah,Briar,820,401,419,48.9
Xayah,Mel,2320,1219,1101,52.54
Xayah,Yuumi,1118,600,518,53.67
Xayah,Mordekaiser,1539,741,798,48.15
Xayah,Vex,695,345,350,49.64
Xayah,Samira,992,545,447,54.94
Xayah,Rakan,535,250,285,46.73
Xayah,Aatrox,1070,514,556,48.04
Xayah,Chogath,1380,619,761,44.86
Xayah,Kaisa,2438,1363,1075,55.91
Xayah,Morgana,1310,640,670,48.85
Xayah,Ezreal,2486,1267,1219,50.97
Xayah,Elise,824,371,453,45.02
Xayah,Gangplank,552,306,246,55.43
Xayah,Swain,1047,523,524,49.95
Xayah,Cassiopeia,312,152,160,48.72
Xayah,Varus,838,425,413,50.72
Xayah,Nasus,810,392,418,48.4
Xayah,Zilean,272,125,147,45.96
Xayah,FiddleSticks,653,324,329,49.62
Xayah,Leblanc,623,295,328,47.35
Xayah,Aphelios,583,240,343,41.17
Xayah,Hwei,753,359,394,47.68
Xayah,Jhin,2151,1134,1017,52.72
Xayah,MonkeyKing,761,369,392,48.49
Xayah,Teemo,1274,604,670,47.41
Xayah,Yorick,957,442,515,46.19
Xayah,Ahri,1514,785,729,51.85
Xayah,Riven,459,232,227,50.54
Xayah,Malzahar,1108,534,574,48.19
Xayah,Syndra,691,335,356,48.48
Xayah,Volibear,1156,578,578,50
Xayah,Evelynn,547,278,269,50.82
Xayah,Azir,457,196,261,42.89
Xayah,Illaoi,536,286,250,53.36
Xayah,Nocturne,1465,689,776,47.03
Xayah,Ryze,338,163,175,48.22
Xayah,MissFortune,2515,1180,1335,46.92
Xayah,Blitzcrank,950,530,420,55.79
Xayah,Garen,1905,905,1000,47.51
Xayah,Jax,1023,497,526,48.58
Xayah,Gnar,544,263,281,48.35
Xayah,Zeri,595,309,286,51.93
Xayah,Xerath,869,436,433,50.17
Xayah,Urgot,429,227,202,52.91
Xayah,Skarner,343,188,155,54.81
Xayah,Ekko,942,436,506,46.28
Xayah,Heimerdinger,525,257,268,48.95
Xayah,Zac,642,329,313,51.25
Xayah,LeeSin,1390,740,650,53.24
Xayah,Fiora,380,199,181,52.37
Xayah,Pantheon,1844,909,935,49.3
Xayah,Annie,384,162,222,42.19
Xayah,Bard,347,184,163,53.03
Xayah,Renekton,588,301,287,51.19
Xayah,Rengar,523,320,203,61.19
Xayah,Seraphine,862,424,438,49.19
Xayah,Kennen,377,181,196,48.01
Xayah,Lillia,600,268,332,44.67
Xayah,Irelia,946,526,420,55.6
Xayah,Nilah,559,300,259,53.67
Xayah,Malphite,1223,656,567,53.64
Xayah,JarvanIV,622,291,331,46.78
Xayah,Lucian,811,398,413,49.08
Xayah,Kayle,720,374,346,51.94
Xayah,XinZhao,798,380,418,47.62
Xayah,Darius,2060,1046,1014,50.78
Xayah,Warwick,1531,767,764,50.1
Xayah,Viktor,850,420,430,49.41
Xayah,Sona,314,168,146,53.5
Xayah,Ornn,526,276,250,52.47
Xayah,Neeko,638,369,269,57.84
Xayah,Ziggs,418,186,232,44.5
Xayah,Galio,1082,555,527,51.29
Xayah,Zoe,415,231,184,55.66
Xayah,DrMundo,629,337,292,53.58
Xayah,Belveth,338,158,180,46.75
Xayah,Naafiri,386,209,177,54.15
Xayah,Pyke,915,440,475,48.09
Xayah,Kalista,368,206,162,55.98
Xayah,Vi,1312,696,616,53.05
Xayah,Talon,753,417,336,55.38
Xayah,Shaco,1020,478,542,46.86
Xayah,Graves,695,363,332,52.23
Xayah,Lulu,1359,709,650,52.17
Xayah,Katarina,918,485,433,52.83
Xayah,Taric,227,117,110,51.54
Xayah,Gwen,586,328,258,55.97
Xayah,Sett,1812,829,983,45.75
Xayah,Nami,1100,494,606,44.91
Xayah,Maokai,446,238,208,53.36
Xayah,Janna,367,154,213,41.96
Xayah,Ambessa,725,387,338,53.38
Xayah,Khazix,533,297,236,55.72
Xayah,KSante,563,291,272,51.69
Xayah,Gragas,703,410,293,58.32
Xayah,Nunu,762,360,402,47.24
Xayah,Tristana,974,447,527,45.89
Xayah,Trundle,637,289,348,45.37
Xayah,Fizz,681,324,357,47.58
Xayah,Kindred,448,243,205,54.24
Xayah,Vladimir,729,338,391,46.36
Xayah,Kassadin,219,125,94,57.08
Xayah,Viego,1377,652,725,47.35
Xayah,Veigar,1157,516,641,44.6
Xayah,TahmKench,924,463,461,50.11
Xayah,Karma,1075,469,606,43.63
Xayah,Shen,826,422,404,51.09
Xayah,Senna,872,439,433,50.34
Xayah,Lissandra,375,191,184,50.93
Xayah,Draven,569,299,270,52.55
Xayah,Braum,578,295,283,51.04
Xayah,KogMaw,317,167,150,52.68
Xayah,Alistar,554,267,287,48.19
Xayah,Akshan,381,219,162,57.48
Xayah,RekSai,179,84,95,46.93
Xayah,Velkoz,604,284,320,47.02
Xayah,Sion,855,432,423,50.53
Xayah,Udyr,393,183,210,46.56
Xayah,Sejuani,538,243,295,45.17
Xayah,Brand,684,323,361,47.22
Xayah,Orianna,485,245,240,50.52
Xayah,Singed,332,132,200,39.76
Xayah,Renata,229,114,115,49.78
Xayah,Soraka,624,303,321,48.56
Xayah,AurelionSol,406,164,242,40.39
Xayah,Leona,969,478,491,49.33
Xayah,Nidalee,318,179,139,56.29
Xayah,Olaf,277,138,139,49.82
Xayah,Karthus,345,177,168,51.3
Xayah,Corki,456,248,208,54.39
Xayah,Quinn,325,169,156,52
Xayah,Hecarim,419,209,210,49.88
Xayah,Camille,475,278,197,58.53
Xayah,Taliyah,287,171,116,59.58
Xayah,Shyvana,276,113,163,40.94
Xayah,Ivern,220,126,94,57.27
Xayah,Qiyana,318,164,154,51.57
Xayah,Kled,209,96,113,45.93
Xayah,Sivir,563,261,302,46.36
Xayah,Rumble,328,205,123,62.5
Samira,Swain,1755,819,936,46.67
Samira,FiddleSticks,771,330,441,42.8
Samira,Akali,1657,872,785,52.63
Samira,Twitch,1244,642,602,51.61
Samira,Senna,1277,612,665,47.92
Samira,Smolder,1146,550,596,47.99
Samira,Ekko,1584,825,759,52.08
Samira,Mordekaiser,2500,1141,1359,45.64
Samira,Yasuo,3279,1627,1652,49.62
Samira,Yuumi,1495,760,735,50.84
Samira,Sett,2850,1373,1477,48.18
Samira,Vladimir,934,506,428,54.18
Samira,Kindred,763,441,322,57.8
Samira,Aphelios,921,476,445,51.68
Samira,Pyke,1465,776,689,52.97
Samira,Volibear,1847,882,965,47.75
Samira,Akshan,614,287,327,46.74
Samira,Katarina,1350,707,643,52.37
Samira,Annie,510,256,254,50.2
Samira,Kayn,2564,1290,1274,50.31
Samira,Aatrox,1519,775,744,51.02
Samira,MissFortune,4040,2009,2031,49.73
Samira,DrMundo,993,441,552,44.41
Samira,Ivern,247,124,123,50.2
Samira,Nilah,1073,485,588,45.2
Samira,TwistedFate,510,248,262,48.63
Samira,LeeSin,2033,1034,999,50.86
Samira,Brand,1264,647,617,51.19
Samira,Briar,1362,674,688,49.49
Samira,Hwei,1117,521,596,46.64
Samira,Kaisa,2581,1295,1286,50.17
Samira,TahmKench,1406,832,574,59.17
Samira,Fiora,693,366,327,52.81
Samira,Malzahar,1484,627,857,42.25
Samira,Zilean,449,215,234,47.88
Samira,Jinx,4636,2192,2444,47.28
Samira,Leblanc,921,475,446,51.57
Samira,Xayah,992,447,545,45.06
Samira,Riven,770,354,416,45.97
Samira,Jax,1405,717,688,51.03
Samira,Naafiri,606,307,299,50.66
Samira,Tristana,1533,834,699,54.4
Samira,Rakan,718,299,419,41.64
Samira,Zac,716,340,376,47.49
Samira,Nunu,1093,509,584,46.57
Samira,Veigar,1733,806,927,46.51
Samira,Shen,1039,488,551,46.97
Samira,Sion,1161,497,664,42.81
Samira,AurelionSol,679,301,378,44.33
Samira,Jhin,3127,1540,1587,49.25
Samira,Lux,4417,2153,2264,48.74
Samira,Trundle,979,446,533,45.56
Samira,Ahri,2122,1095,1027,51.6
Samira,Ashe,2895,1501,1394,51.85
Samira,Nami,1533,735,798,47.95
Samira,Darius,3118,1535,1583,49.23
Samira,Pantheon,2541,1181,1360,46.48
Samira,Ryze,601,303,298,50.42
Samira,Lillia,887,404,483,45.55
Samira,Chogath,1920,813,1107,42.34
Samira,Mel,3326,1585,1741,47.65
Samira,Warwick,2610,1163,1447,44.56
Samira,Malphite,1528,734,794,48.04
Samira,Illaoi,896,421,475,46.99
Samira,Leona,1374,632,742,46
Samira,Ambessa,950,522,428,54.95
Samira,Rammus,537,238,299,44.32
Samira,Aurora,1248,547,701,43.83
Samira,Caitlyn,4416,2074,2342,46.97
Samira,Kled,245,116,129,47.35
Samira,Diana,2410,1239,1171,51.41
Samira,Karma,1439,705,734,48.99
Samira,Singed,439,187,252,42.6
Samira,Blitzcrank,1291,709,582,54.92
Samira,Varus,1355,667,688,49.23
Samira,Irelia,1346,702,644,52.15
Samira,Elise,896,462,434,51.56
Samira,Viego,2192,1036,1156,47.26
Samira,Galio,1168,590,578,50.51
Samira,Vayne,2123,1070,1053,50.4
Samira,Sylas,2041,1084,957,53.11
Samira,Tryndamere,905,413,492,45.64
Samira,Nautilus,1618,832,786,51.42
Samira,Yorick,1539,671,868,43.6
Samira,Nidalee,463,273,190,58.96
Samira,KogMaw,529,266,263,50.28
Samira,Poppy,1004,459,545,45.72
Samira,Zed,1811,927,884,51.19
Samira,Shyvana,384,158,226,41.15
Samira,MasterYi,1904,901,1003,47.32
Samira,Garen,2395,1098,1297,45.85
Samira,Zyra,1288,604,684,46.89
Samira,Neeko,993,500,493,50.35
Samira,Renekton,828,425,403,51.33
Samira,Sejuani,693,362,331,52.24
Samira,Taliyah,358,147,211,41.06
Samira,Teemo,2264,1097,1167,48.45
Samira,Corki,694,309,385,44.52
Samira,Heimerdinger,833,396,437,47.54
Samira,Gragas,1017,520,497,51.13
Samira,Morgana,2086,913,1173,43.77
Samira,XinZhao,973,502,471,51.59
Samira,Rell,878,415,463,47.27
Samira,Shaco,1532,760,772,49.61
Samira,Yone,3160,1700,1460,53.8
Samira,Lulu,1666,762,904,45.74
Samira,Viktor,1215,574,641,47.24
Samira,KSante,789,446,343,56.53
Samira,Gwen,936,476,460,50.85
Samira,Seraphine,1688,905,783,53.61
Samira,Udyr,610,292,318,47.87
Samira,Hecarim,603,318,285,52.74
Samira,Khazix,906,516,390,56.95
Samira,Karthus,394,230,164,58.38
Samira,Thresh,2098,1034,1064,49.29
Samira,Braum,795,377,418,47.42
Samira,Evelynn,696,341,355,48.99
Samira,Nocturne,1687,879,808,52.1
Samira,Velkoz,999,472,527,47.25
Samira,Urgot,793,336,457,42.37
Samira,Zeri,717,359,358,50.07
Samira,Fizz,920,448,472,48.7
Samira,Draven,966,494,472,51.14
Samira,Bard,485,270,215,55.67
Samira,Alistar,805,355,450,44.1
Samira,Kayle,1151,528,623,45.87
Samira,Amumu,1718,769,949,44.76
Samira,Ezreal,3327,1636,1691,49.17
Samira,Vi,1344,646,698,48.07
Samira,Zoe,588,323,265,54.93
Samira,Sona,512,242,270,47.27
Samira,Nasus,1317,563,754,42.75
Samira,Ziggs,616,293,323,47.56
Samira,Milio,909,415,494,45.65
Samira,Quinn,519,244,275,47.01
Samira,Kalista,509,306,203,60.12
Samira,Xerath,1325,617,708,46.57
Samira,Cassiopeia,557,273,284,49.01
Samira,Orianna,649,326,323,50.23
Samira,Talon,873,467,406,53.49
Samira,Renata,387,190,197,49.1
Samira,Rengar,548,317,231,57.85
Samira,Graves,1043,562,481,53.88
Samira,Gnar,579,331,248,57.17
Samira,Azir,580,314,266,54.14
Samira,Ornn,685,339,346,49.49
Samira,Camille,511,275,236,53.82
Samira,Vex,796,377,419,47.36
Samira,Janna,554,300,254,54.15
Samira,Lucian,993,514,479,51.76
Samira,Soraka,891,476,415,53.42
Samira,Kennen,499,260,239,52.1
Samira,Skarner,533,233,300,43.71
Samira,Olaf,285,133,152,46.67
Samira,Syndra,892,428,464,47.98
Samira,Jayce,676,348,328,51.48
Samira,Taric,347,119,228,34.29
Samira,Maokai,807,422,385,52.29
Samira,Kassadin,313,162,151,51.76
Samira,Anivia,568,285,283,50.18
Samira,JarvanIV,679,347,332,51.1
Samira,RekSai,207,117,90,56.52
Samira,Rumble,330,177,153,53.64
Samira,Belveth,376,213,163,56.65
Samira,Gangplank,716,358,358,50
Samira,Lissandra,479,236,243,49.27
Samira,Qiyana,426,210,216,49.3
Samira,Sivir,818,418,400,51.1
Samira,MonkeyKing,1087,459,628,42.23
Skarner,Irelia,530,252,278,47.55
Skarner,Diana,913,442,471,48.41
Skarner,Lux,1443,719,724,49.83
Skarner,Tristana,581,269,312,46.3
Skarner,Mel,1261,639,622,50.67
Skarner,Viktor,625,268,357,42.88
Skarner,Nocturne,653,285,368,43.64
Skarner,Annie,240,133,107,55.42
Skarner,KogMaw,221,92,129,41.63
Skarner,Alistar,291,144,147,49.48
Skarner,Yorick,560,224,336,40
Skarner,Kayn,889,399,490,44.88
Skarner,Akali,683,326,357,47.73
Skarner,Caitlyn,1459,668,791,45.78
Skarner,Sett,982,451,531,45.93
Skarner,LeeSin,982,513,469,52.24
Skarner,Nasus,395,193,202,48.86
Skarner,Kaisa,1091,542,549,49.68
Skarner,Bard,190,88,102,46.32
Skarner,Yasuo,1085,472,613,43.5
Skarner,Jhin,1189,523,666,43.99
Skarner,Thresh,865,396,469,45.78
Skarner,Illaoi,302,130,172,43.05
Skarner,Volibear,723,318,405,43.98
Skarner,Varus,563,266,297,47.25
Skarner,Nautilus,857,456,401,53.21
Skarner,Teemo,719,366,353,50.9
Skarner,Graves,391,165,226,42.2
Skarner,Zoe,266,140,126,52.63
Skarner,Katarina,491,231,260,47.05
Skarner,Galio,587,289,298,49.23
Skarner,Warwick,858,361,497,42.07
Skarner,Veigar,561,249,312,44.39
Skarner,Ivern,120,73,47,60.83
Skarner,Ezreal,1375,725,650,52.73
Skarner,Xayah,343,155,188,45.19
Skarner,DrMundo,351,178,173,50.71
Skarner,Nunu,425,207,218,48.71
Skarner,Leblanc,406,189,217,46.55
Skarner,Nami,639,295,344,46.17
Skarner,Smolder,421,196,225,46.56
Skarner,Zed,617,266,351,43.11
Skarner,Morgana,662,261,401,39.43
Skarner,Pantheon,1013,472,541,46.59
Skarner,Amumu,627,263,364,41.95
Skarner,Ziggs,263,119,144,45.25
Skarner,Malphite,502,237,265,47.21
Skarner,Sion,514,196,318,38.13
Skarner,Shen,396,201,195,50.76
Skarner,Jax,613,318,295,51.88
Skarner,Rengar,253,143,110,56.52
Skarner,Nilah,209,84,125,40.19
Skarner,Karma,718,348,370,48.47
Skarner,Chogath,731,391,340,53.49
Skarner,JarvanIV,359,141,218,39.28
Skarner,Vex,263,144,119,54.75
Skarner,Mordekaiser,873,381,492,43.64
Skarner,Lucian,442,243,199,54.98
Skarner,Yuumi,608,296,312,48.68
Skarner,Kled,154,78,76,50.65
Skarner,Lillia,457,183,274,40.04
Skarner,Ahri,847,388,459,45.81
Skarner,MissFortune,1241,525,716,42.3
Skarner,Neeko,338,144,194,42.6
Skarner,Darius,1210,563,647,46.53
Skarner,MasterYi,623,283,340,45.43
Skarner,Kassadin,101,45,56,44.55
Skarner,Rell,412,194,218,47.09
Skarner,Aatrox,593,284,309,47.89
Skarner,Sylas,883,424,459,48.02
Skarner,Kindred,287,159,128,55.4
Skarner,Singed,179,46,133,25.7
Skarner,Vi,637,268,369,42.07
Skarner,Lulu,835,400,435,47.9
Skarner,Viego,791,313,478,39.57
Skarner,Swain,594,244,350,41.08
Skarner,Aurora,515,233,282,45.24
Skarner,Zyra,452,189,263,41.81
Skarner,Garen,873,384,489,43.99
Skarner,Azir,275,138,137,50.18
Skarner,Briar,403,181,222,44.91
Skarner,Gangplank,350,172,178,49.14
Skarner,Urgot,244,93,151,38.11
Skarner,Jinx,1533,651,882,42.47
Skarner,Seraphine,524,238,286,45.42
Skarner,Hecarim,250,120,130,48
Skarner,Ashe,1323,618,705,46.71
Skarner,Vayne,836,378,458,45.22
Skarner,Vladimir,365,169,196,46.3
Skarner,Senna,421,167,254,39.67
Skarner,Twitch,493,230,263,46.65
Skarner,Pyke,544,209,335,38.42
Skarner,Shaco,488,250,238,51.23
Skarner,Tryndamere,261,117,144,44.83
Skarner,Udyr,241,115,126,47.72
Skarner,Syndra,374,190,184,50.8
Skarner,TahmKench,483,227,256,47
Skarner,Taliyah,208,94,114,45.19
Skarner,Zilean,162,108,54,66.67
Skarner,Gragas,373,174,199,46.65
Skarner,Elise,502,215,287,42.83
Skarner,Gnar,308,150,158,48.7
Skarner,Orianna,351,174,177,49.57
Skarner,Ekko,540,234,306,43.33
Skarner,Riven,287,135,152,47.04
Skarner,Samira,533,300,233,56.29
Skarner,Draven,312,153,159,49.04
Skarner,Belveth,180,62,118,34.44
Skarner,Leona,514,239,275,46.5
Skarner,Quinn,233,121,112,51.93
Skarner,XinZhao,469,182,287,38.81
Skarner,Malzahar,621,263,358,42.35
Skarner,Sejuani,381,154,227,40.42
Skarner,Rakan,272,146,126,53.68
Skarner,Khazix,330,216,114,65.45
Skarner,Kennen,164,85,79,51.83
Skarner,Yone,1149,563,586,49
Skarner,Ornn,265,116,149,43.77
Skarner,Hwei,448,227,221,50.67
Skarner,Corki,229,121,108,52.84
Skarner,Shyvana,199,87,112,43.72
Skarner,Fizz,268,123,145,45.9
Skarner,Poppy,347,169,178,48.7
Skarner,Jayce,256,86,170,33.59
Skarner,Kayle,424,173,251,40.8
Skarner,Gwen,323,161,162,49.85
Skarner,Zac,412,218,194,52.91
Skarner,FiddleSticks,327,184,143,56.27
Skarner,Xerath,536,304,232,56.72
Skarner,Blitzcrank,497,228,269,45.88
Skarner,Soraka,336,154,182,45.83
Skarner,Camille,244,130,114,53.28
Skarner,Milio,392,176,216,44.9
Skarner,Trundle,332,153,179,46.08
Skarner,Sivir,331,130,201,39.27
Skarner,AurelionSol,269,137,132,50.93
Skarner,Fiora,264,101,163,38.26
Skarner,Ambessa,430,178,252,41.4
Skarner,Maokai,267,145,122,54.31
Skarner,Ryze,233,107,126,45.92
Skarner,Anivia,194,101,93,52.06
Skarner,Rumble,199,103,96,51.76
Skarner,Karthus,157,81,76,51.59
Skarner,Renekton,394,182,212,46.19
Skarner,Brand,389,168,221,43.19
Skarner,Kalista,232,100,132,43.1
Skarner,Aphelios,362,190,172,52.49
Skarner,TwistedFate,217,108,109,49.77
Skarner,Heimerdinger,262,106,156,40.46
Skarner,Janna,143,53,90,37.06
Skarner,Qiyana,167,100,67,59.88
Skarner,Talon,326,152,174,46.63
Skarner,Sona,218,95,123,43.58
Skarner,Braum,436,199,237,45.64
Skarner,Naafiri,234,109,125,46.58
Skarner,Nidalee,164,72,92,43.9
Skarner,Velkoz,319,147,172,46.08
Skarner,KSante,390,172,218,44.1
Skarner,Olaf,200,98,102,49
Skarner,Zeri,304,147,157,48.36
Skarner,Evelynn,232,111,121,47.84
Skarner,MonkeyKing,458,188,270,41.05
Skarner,Taric,115,44,71,38.26
Skarner,Renata,140,64,76,45.71
Skarner,Rammus,103,38,65,36.89
Skarner,Akshan,284,121,163,42.61
Skarner,Cassiopeia,195,85,110,43.59
Skarner,Lissandra,168,76,92,45.24
Skarner,RekSai,76,38,38,50
Urgot,Riven,592,324,268,54.73
Urgot,Amumu,1123,534,589,47.55
Urgot,Zoe,384,242,142,63.02
Urgot,MissFortune,2563,1299,1264,50.68
Urgot,Sona,416,239,177,57.45
Urgot,Mordekaiser,1556,794,762,51.03
Urgot,Udyr,459,250,209,54.47
Urgot,Yorick,1306,621,685,47.55
Urgot,Sivir,509,248,261,48.72
Urgot,Nautilus,1191,662,529,55.58
Urgot,Darius,2134,1096,1038,51.36
Urgot,Yasuo,1988,1044,944,52.52
Urgot,Swain,1076,546,530,50.74
Urgot,Vi,946,457,489,48.31
Urgot,Orianna,439,232,207,52.85
Urgot,Draven,643,338,305,52.57
Urgot,Lulu,1254,598,656,47.69
Urgot,Singed,373,194,179,52.01
Urgot,Kindred,505,234,271,46.34
Urgot,Ashe,1855,992,863,53.48
Urgot,Alistar,440,246,194,55.91
Urgot,Kled,235,112,123,47.66
Urgot,Zeri,456,248,208,54.39
Urgot,Neeko,613,373,240,60.85
Urgot,TahmKench,1048,548,500,52.29
Urgot,Brand,817,439,378,53.73
Urgot,Mel,2048,1072,976,52.34
Urgot,Jinx,2800,1349,1451,48.18
Urgot,Pyke,894,481,413,53.8
Urgot,Thresh,1298,669,629,51.54
Urgot,Viego,1276,650,626,50.94
Urgot,Kalista,310,184,126,59.35
Urgot,FiddleSticks,487,250,237,51.33
Urgot,Chogath,1305,701,604,53.72
Urgot,MasterYi,1381,731,650,52.93
Urgot,Zed,946,506,440,53.49
Urgot,Lux,2637,1292,1345,49
Urgot,Morgana,1246,647,599,51.93
Urgot,Aatrox,1098,592,506,53.92
Urgot,XinZhao,603,384,219,63.68
Urgot,Qiyana,261,156,105,59.77
Urgot,AurelionSol,491,272,219,55.4
Urgot,Zyra,849,415,434,48.88
Urgot,Warwick,1705,930,775,54.55
Urgot,Fizz,621,343,278,55.23
Urgot,Teemo,1323,622,701,47.01
Urgot,Poppy,548,287,261,52.37
Urgot,Ekko,932,524,408,56.22
Urgot,Kaisa,1692,938,754,55.44
Urgot,Rell,542,263,279,48.52
Urgot,Sett,1830,924,906,50.49
Urgot,LeeSin,1162,637,525,54.82
Urgot,Ezreal,2005,1116,889,55.66
Urgot,Xayah,429,202,227,47.09
Urgot,DrMundo,603,251,352,41.63
Urgot,Shen,602,321,281,53.32
Urgot,Tryndamere,619,332,287,53.63
Urgot,Katarina,821,466,355,56.76
Urgot,Seraphine,936,481,455,51.39
Urgot,Caitlyn,2806,1545,1261,55.06
Urgot,Nocturne,1294,671,623,51.85
Urgot,Elise,659,345,314,52.35
Urgot,Senna,873,458,415,52.46
Urgot,Maokai,475,254,221,53.47
Urgot,Kennen,359,203,156,56.55
Urgot,Belveth,257,151,106,58.75
Urgot,Ambessa,556,299,257,53.78
Urgot,Irelia,844,474,370,56.16
Urgot,Samira,793,457,336,57.63
Urgot,Yuumi,832,427,405,51.32
Urgot,Jax,857,452,405,52.74
Urgot,Karthus,251,144,107,57.37
Urgot,MonkeyKing,694,336,358,48.41
Urgot,Lucian,656,356,300,54.27
Urgot,Nami,1126,592,534,52.58
Urgot,Malzahar,1014,524,490,51.68
Urgot,Aphelios,564,298,266,52.84
Urgot,Milio,581,279,302,48.02
Urgot,Kayn,1552,879,673,56.64
Urgot,Volibear,1329,725,604,54.55
Urgot,Smolder,772,434,338,56.22
Urgot,Talon,555,302,253,54.41
Urgot,Sylas,1198,612,586,51.09
Urgot,Vladimir,601,315,286,52.41
Urgot,Gangplank,554,309,245,55.78
Urgot,Varus,810,434,376,53.58
Urgot,Rakan,426,217,209,50.94
Urgot,Aurora,769,400,369,52.02
Urgot,Braum,628,260,368,41.4
Urgot,Yone,1673,937,736,56.01
Urgot,Camille,346,249,97,71.97
Urgot,Khazix,561,361,200,64.35
Urgot,Akali,1030,579,451,56.21
Urgot,Skarner,244,151,93,61.89
Urgot,Shaco,905,440,465,48.62
Urgot,Zac,429,201,228,46.85
Urgot,Kassadin,269,154,115,57.25
Urgot,Twitch,888,473,415,53.27
Urgot,Nasus,938,474,464,50.53
Urgot,Cassiopeia,308,145,163,47.08
Urgot,RekSai,144,87,57,60.42
Urgot,Leona,811,431,380,53.14
Urgot,Taric,245,130,115,53.06
Urgot,Anivia,373,183,190,49.06
Urgot,KSante,456,227,229,49.78
Urgot,Fiora,348,210,138,60.34
Urgot,Veigar,1099,499,600,45.4
Urgot,Ivern,188,104,84,55.32
Urgot,Jhin,2083,1099,984,52.76
Urgot,Ryze,313,162,151,51.76
Urgot,Ziggs,438,199,239,45.43
Urgot,Tristana,972,494,478,50.82
Urgot,Garen,1779,832,947,46.77
Urgot,Ahri,1420,798,622,56.2
Urgot,Vayne,1232,613,619,49.76
Urgot,KogMaw,322,177,145,54.97
Urgot,Xerath,888,474,414,53.38
Urgot,Gragas,522,302,220,57.85
Urgot,Akshan,390,208,182,53.33
Urgot,Briar,835,392,443,46.95
Urgot,Hwei,734,390,344,53.13
Urgot,Graves,590,269,321,45.59
Urgot,Heimerdinger,456,245,211,53.73
Urgot,Nunu,620,342,278,55.16
Urgot,Diana,1622,826,796,50.92
Urgot,Kayle,857,431,426,50.29
Urgot,Trundle,630,337,293,53.49
Urgot,Vex,500,249,251,49.8
Urgot,Malphite,994,512,482,51.51
Urgot,Gwen,549,243,306,44.26
Urgot,Blitzcrank,710,310,400,43.66
Urgot,Naafiri,391,220,171,56.27
Urgot,Ornn,418,192,226,45.93
Urgot,Karma,1204,605,599,50.25
Urgot,Taliyah,277,152,125,54.87
Urgot,Pantheon,1740,945,795,54.31
Urgot,Shyvana,293,181,112,61.77
Urgot,Gnar,453,264,189,58.28
Urgot,TwistedFate,368,195,173,52.99
Urgot,Renata,221,118,103,53.39
Urgot,JarvanIV,514,267,247,51.95
Urgot,Viktor,939,491,448,52.29
Urgot,Renekton,490,268,222,54.69
Urgot,Sion,862,412,450,47.8
Urgot,Janna,378,225,153,59.52
Urgot,Olaf,229,115,114,50.22
Urgot,Nidalee,303,181,122,59.74
Urgot,Zilean,353,165,188,46.74
Urgot,Rammus,421,189,232,44.89
Urgot,Evelynn,436,235,201,53.9
Urgot,Leblanc,529,305,224,57.66
Urgot,Rumble,224,135,89,60.27
Urgot,Azir,354,184,170,51.98
Urgot,Bard,334,193,141,57.78
Urgot,Soraka,519,288,231,55.49
Urgot,Illaoi,452,226,226,50
Urgot,Quinn,361,226,135,62.6
Urgot,Hecarim,375,212,163,56.53
Urgot,Lillia,550,250,300,45.45
Urgot,Corki,418,229,189,54.78
Urgot,Lissandra,334,178,156,53.29
Urgot,Rengar,395,250,145,63.29
Urgot,Galio,784,380,404,48.47
Urgot,Sejuani,421,242,179,57.48
Urgot,Syndra,583,313,270,53.69
Urgot,Annie,328,148,180,45.12
Urgot,Jayce,388,210,178,54.12
Urgot,Velkoz,644,378,266,58.7
Urgot,Nilah,400,219,181,54.75
Orianna,Darius,1800,908,892,50.44
Orianna,Rengar,351,195,156,55.56
Orianna,Syndra,786,386,400,49.11
Orianna,Caitlyn,2420,1197,1223,49.46
Orianna,Lux,2341,1130,1211,48.27
Orianna,Urgot,439,207,232,47.15
Orianna,LeeSin,1548,825,723,53.29
Orianna,TwistedFate,384,174,210,45.31
Orianna,Yasuo,1629,817,812,50.15
Orianna,Rakan,432,206,226,47.69
Orianna,Camille,375,215,160,57.33
Orianna,Mel,2590,1424,1166,54.98
Orianna,Draven,445,200,245,44.94
Orianna,Senna,707,352,355,49.79
Orianna,Zac,406,204,202,50.25
Orianna,Nunu,534,277,257,51.87
Orianna,Veigar,886,381,505,43
Orianna,Kaisa,1556,819,737,52.63
Orianna,Shen,724,386,338,53.31
Orianna,Riven,437,196,241,44.85
Orianna,Vi,890,421,469,47.3
Orianna,MissFortune,1993,992,1001,49.77
Orianna,Soraka,503,241,262,47.91
Orianna,Yorick,932,397,535,42.6
Orianna,MasterYi,1094,542,552,49.54
Orianna,Irelia,697,357,340,51.22
Orianna,Nami,983,455,528,46.29
Orianna,Yone,1533,726,807,47.36
Orianna,Neeko,495,272,223,54.95
Orianna,Kayn,1241,658,583,53.02
Orianna,Heimerdinger,491,239,252,48.68
Orianna,Mordekaiser,1104,566,538,51.27
Orianna,Viego,1349,621,728,46.03
Orianna,Zeri,433,197,236,45.5
Orianna,Alistar,428,197,231,46.03
Orianna,Singed,301,149,152,49.5
Orianna,Karma,1166,548,618,47
Orianna,Jinx,2667,1290,1377,48.37
Orianna,Akshan,333,166,167,49.85
Orianna,Aphelios,615,317,298,51.54
Orianna,Braum,538,270,268,50.19
Orianna,Amumu,951,444,507,46.69
Orianna,Zed,880,439,441,49.89
Orianna,Poppy,632,318,314,50.32
Orianna,Pyke,841,441,400,52.44
Orianna,Aurora,840,454,386,54.05
Orianna,Aatrox,894,506,388,56.6
Orianna,Kindred,449,212,237,47.22
Orianna,Swain,816,359,457,44
Orianna,Blitzcrank,757,387,370,51.12
Orianna,Ekko,801,382,419,47.69
Orianna,Rell,579,316,263,54.58
Orianna,Illaoi,466,239,227,51.29
Orianna,Jhin,1621,787,834,48.55
Orianna,Talon,552,295,257,53.44
Orianna,Galio,758,351,407,46.31
Orianna,Lucian,732,350,382,47.81
Orianna,Milio,599,302,297,50.42
Orianna,Ornn,483,251,232,51.97
Orianna,Pantheon,1662,939,723,56.5
Orianna,Nautilus,1162,611,551,52.58
Orianna,Akali,958,500,458,52.19
Orianna,Vayne,1170,548,622,46.84
Orianna,Seraphine,738,387,351,52.44
Orianna,Shyvana,255,118,137,46.27
Orianna,Vex,474,226,248,47.68
Orianna,Ezreal,2416,1183,1233,48.97
Orianna,Malzahar,984,446,538,45.33
Orianna,Gwen,463,232,231,50.11
Orianna,Rammus,292,161,131,55.14
Orianna,Katarina,660,273,387,41.36
Orianna,Viktor,1046,476,570,45.51
Orianna,Ashe,1917,913,1004,47.63
Orianna,Yuumi,750,368,382,49.07
Orianna,Fiora,319,166,153,52.04
Orianna,Vladimir,738,382,356,51.76
Orianna,Varus,932,521,411,55.9
Orianna,Velkoz,521,260,261,49.9
Orianna,Chogath,1089,536,553,49.22
Orianna,Gragas,569,282,287,49.56
Orianna,Shaco,827,406,421,49.09
Orianna,Morgana,1081,544,537,50.32
Orianna,Bard,346,167,179,48.27
Orianna,Gangplank,518,279,239,53.86
Orianna,Brand,507,280,227,55.23
Orianna,Sett,1213,574,639,47.32
Orianna,Nocturne,1096,539,557,49.18
Orianna,Kennen,284,151,133,53.17
Orianna,Teemo,1055,469,586,44.45
Orianna,Malphite,806,416,390,51.61
Orianna,Karthus,232,133,99,57.33
Orianna,Nilah,376,183,193,48.67
Orianna,Leona,807,420,387,52.04
Orianna,Xerath,954,423,531,44.34
Orianna,Graves,598,313,285,52.34
Orianna,Cassiopeia,276,144,132,52.17
Orianna,Qiyana,325,162,163,49.85
Orianna,Azir,377,184,193,48.81
Orianna,KSante,478,263,215,55.02
Orianna,Ambessa,742,380,362,51.21
Orianna,Lillia,517,236,281,45.65
Orianna,Samira,649,323,326,49.77
Orianna,Maokai,492,238,254,48.37
Orianna,Anivia,350,146,204,41.71
Orianna,Volibear,963,486,477,50.47
Orianna,Zyra,765,391,374,51.11
Orianna,Nidalee,335,188,147,56.12
Orianna,Taric,233,127,106,54.51
Orianna,Kassadin,177,95,82,53.67
Orianna,Udyr,291,190,101,65.29
Orianna,Sylas,1336,651,685,48.73
Orianna,Zilean,320,148,172,46.25
Orianna,Zoe,359,157,202,43.73
Orianna,Sivir,479,278,201,58.04
Orianna,Renekton,491,223,268,45.42
Orianna,Ivern,213,110,103,51.64
Orianna,Elise,730,353,377,48.36
Orianna,Tryndamere,439,210,229,47.84
Orianna,Thresh,1319,599,720,45.41
Orianna,FiddleSticks,523,236,287,45.12
Orianna,Trundle,471,203,268,43.1
Orianna,Leblanc,616,314,302,50.97
Orianna,Lulu,1252,575,677,45.93
Orianna,Naafiri,355,195,160,54.93
Orianna,Skarner,351,177,174,50.43
Orianna,Khazix,589,341,248,57.89
Orianna,Hwei,637,363,274,56.99
Orianna,Diana,1456,596,860,40.93
Orianna,Twitch,761,357,404,46.91
Orianna,MonkeyKing,622,312,310,50.16
Orianna,Belveth,265,134,131,50.57
Orianna,Xayah,485,240,245,49.48
Orianna,TahmKench,723,361,362,49.93
Orianna,Kled,174,87,87,50
Orianna,Jax,845,418,427,49.47
Orianna,Fizz,460,223,237,48.48
Orianna,Annie,345,144,201,41.74
Orianna,Sion,687,311,376,45.27
Orianna,Sejuani,506,237,269,46.84
Orianna,Ahri,1461,753,708,51.54
Orianna,Warwick,1342,607,735,45.23
Orianna,Gnar,404,211,193,52.23
Orianna,Kalista,315,164,151,52.06
Orianna,Janna,356,157,199,44.1
Orianna,Briar,670,335,335,50
Orianna,Nasus,575,322,253,56
Orianna,Ziggs,356,164,192,46.07
Orianna,Garen,1497,693,804,46.29
Orianna,Jayce,592,263,329,44.43
Orianna,Olaf,265,138,127,52.08
Orianna,Evelynn,324,144,180,44.44
Orianna,JarvanIV,603,273,330,45.27
Orianna,DrMundo,568,235,333,41.37
Orianna,Renata,200,91,109,45.5
Orianna,KogMaw,357,181,176,50.7
Orianna,Taliyah,317,149,168,47
Orianna,Smolder,522,278,244,53.26
Orianna,Ryze,317,172,145,54.26
Orianna,AurelionSol,389,177,212,45.5
Orianna,Rumble,298,194,104,65.1
Orianna,Corki,462,248,214,53.68
Orianna,Tristana,879,445,434,50.63
Orianna,XinZhao,636,318,318,50
Orianna,Sona,242,110,132,45.45
Orianna,Kayle,528,292,236,55.3
Orianna,Lissandra,300,138,162,46
Orianna,Quinn,334,144,190,43.11
Orianna,Hecarim,369,176,193,47.7
Orianna,RekSai,161,74,87,45.96
Rengar,Aatrox,706,260,446,36.83
Rengar,Ekko,742,342,400,46.09
Rengar,Orianna,351,156,195,44.44
Rengar,Malzahar,697,303,394,43.47
Rengar,Maokai,323,132,191,40.87
Rengar,Mordekaiser,1035,390,645,37.68
Rengar,Udyr,261,143,118,54.79
Rengar,Yorick,671,282,389,42.03
Rengar,Sivir,298,101,197,33.89
Rengar,Nautilus,735,332,403,45.17
Rengar,DrMundo,409,189,220,46.21
Rengar,Belveth,204,106,98,51.96
Rengar,Leblanc,475,223,252,46.95
Rengar,Briar,579,221,358,38.17
Rengar,Anivia,222,86,136,38.74
Rengar,Tryndamere,472,243,229,51.48
Rengar,Gragas,471,213,258,45.22
Rengar,Irelia,701,286,415,40.8
Rengar,Kalista,277,120,157,43.32
Rengar,Twitch,622,305,317,49.04
Rengar,Yasuo,1561,624,937,39.97
Rengar,Yone,1375,678,697,49.31
Rengar,Alistar,342,145,197,42.4
Rengar,Volibear,835,400,435,47.9
Rengar,Nocturne,863,373,490,43.22
Rengar,Xerath,541,224,317,41.4
Rengar,Ezreal,1663,762,901,45.82
Rengar,Blitzcrank,523,230,293,43.98
Rengar,Poppy,503,223,280,44.33
Rengar,Warwick,1029,481,548,46.74
Rengar,Leona,533,241,292,45.22
Rengar,MissFortune,1559,670,889,42.98
Rengar,Lux,1861,806,1055,43.31
Rengar,Rammus,237,86,151,36.29
Rengar,Aurora,612,267,345,43.63
Rengar,Ashe,1324,614,710,46.37
Rengar,Pantheon,1156,468,688,40.48
Rengar,Jax,645,241,404,37.36
Rengar,Sejuani,334,132,202,39.52
Rengar,Syndra,457,196,261,42.89
Rengar,Jinx,1883,898,985,47.69
Rengar,Swain,699,265,434,37.91
Rengar,Sylas,749,379,370,50.6
Rengar,FiddleSticks,353,125,228,35.41
Rengar,Aphelios,408,183,225,44.85
Rengar,Morgana,776,356,420,45.88
Rengar,Ambessa,442,218,224,49.32
Rengar,Varus,686,318,368,46.36
Rengar,Graves,512,217,295,42.38
Rengar,Neeko,390,159,231,40.77
Rengar,Gangplank,369,202,167,54.74
Rengar,Kayn,1210,535,675,44.21
Rengar,Hwei,504,211,293,41.87
Rengar,Jhin,1476,638,838,43.22
Rengar,Jayce,313,154,159,49.2
Rengar,JarvanIV,438,169,269,38.58
Rengar,Caitlyn,1764,809,955,45.86
Rengar,Vex,403,158,245,39.21
Rengar,Renekton,355,145,210,40.85
Rengar,TahmKench,673,306,367,45.47
Rengar,Gwen,456,205,251,44.96
Rengar,LeeSin,948,451,497,47.57
Rengar,TwistedFate,256,104,152,40.63
Rengar,Zeri,372,165,207,44.35
Rengar,Seraphine,611,259,352,42.39
Rengar,Nasus,484,183,301,37.81
Rengar,Zac,360,153,207,42.5
Rengar,Mel,1602,689,913,43.01
Rengar,Singed,203,117,86,57.64
Rengar,Shaco,727,338,389,46.49
Rengar,Taliyah,233,107,126,45.92
Rengar,Shen,541,238,303,43.99
Rengar,Gnar,326,140,186,42.94
Rengar,Vi,608,245,363,40.3
Rengar,Kaisa,1146,501,645,43.72
Rengar,Rumble,158,83,75,52.53
Rengar,Malphite,712,306,406,42.98
Rengar,Lulu,975,452,523,46.36
Rengar,Khazix,682,327,355,47.95
Rengar,Talon,501,251,250,50.1
Rengar,Thresh,986,420,566,42.6
Rengar,Olaf,152,61,91,40.13
Rengar,Nunu,506,251,255,49.6
Rengar,Vladimir,463,185,278,39.96
Rengar,Diana,1058,442,616,41.78
Rengar,Veigar,726,356,370,49.04
Rengar,Milio,500,242,258,48.4
Rengar,Kindred,335,117,218,34.93
Rengar,Heimerdinger,293,144,149,49.15
Rengar,Yuumi,732,315,417,43.03
Rengar,Trundle,356,159,197,44.66
Rengar,Xayah,523,203,320,38.81
Rengar,Riven,335,169,166,50.45
Rengar,Ahri,946,424,522,44.82
Rengar,Nami,851,343,508,40.31
Rengar,Garen,1158,550,608,47.5
Rengar,Galio,593,229,364,38.62
Rengar,Katarina,589,246,343,41.77
Rengar,Braum,437,161,276,36.84
Rengar,Kennen,204,81,123,39.71
Rengar,Skarner,253,110,143,43.48
Rengar,Illaoi,283,104,179,36.75
Rengar,Ziggs,236,97,139,41.1
Rengar,Elise,627,297,330,47.37
Rengar,Sion,526,204,322,38.78
Rengar,Viego,961,447,514,46.51
Rengar,Annie,221,80,141,36.2
Rengar,AurelionSol,254,115,139,45.28
Rengar,Chogath,856,340,516,39.72
Rengar,Darius,1275,545,730,42.75
Rengar,Zed,829,422,407,50.9
Rengar,Amumu,690,355,335,51.45
Rengar,Janna,301,141,160,46.84
Rengar,Vayne,890,363,527,40.79
Rengar,Brand,541,211,330,39
Rengar,Zoe,359,201,158,55.99
Rengar,MasterYi,846,336,510,39.72
Rengar,Soraka,415,212,203,51.08
Rengar,Lucian,493,223,270,45.23
Rengar,KSante,462,196,266,42.42
Rengar,Kassadin,172,67,105,38.95
Rengar,Teemo,870,364,506,41.84
Rengar,Smolder,528,235,293,44.51
Rengar,Cassiopeia,219,113,106,51.6
Rengar,Sona,243,95,148,39.09
Rengar,Qiyana,245,139,106,56.73
Rengar,Akshan,245,124,121,50.61
Rengar,Tristana,650,305,345,46.92
Rengar,Azir,309,135,174,43.69
Rengar,Karthus,260,118,142,45.38
Rengar,Corki,344,158,186,45.93
Rengar,Bard,304,136,168,44.74
Rengar,Sett,1041,400,641,38.42
Rengar,Evelynn,290,94,196,32.41
Rengar,Naafiri,250,107,143,42.8
Rengar,Velkoz,506,209,297,41.3
Rengar,Samira,548,231,317,42.15
Rengar,KogMaw,168,55,113,32.74
Rengar,Ivern,167,70,97,41.92
Rengar,Draven,407,196,211,48.16
Rengar,Pyke,701,311,390,44.37
Rengar,Senna,460,236,224,51.3
Rengar,Akali,693,282,411,40.69
Rengar,Karma,846,358,488,42.32
Rengar,Rakan,392,151,241,38.52
Rengar,Hecarim,375,138,237,36.8
Rengar,Zilean,244,96,148,39.34
Rengar,Ryze,268,140,128,52.24
Rengar,Quinn,303,112,191,36.96
Rengar,Camille,270,135,135,50
Rengar,Rell,364,188,176,51.65
Rengar,Viktor,611,303,308,49.59
Rengar,Nilah,364,131,233,35.99
Rengar,Ornn,357,148,209,41.46
Rengar,Lillia,359,157,202,43.73
Rengar,Zyra,473,217,256,45.88
Rengar,Fizz,380,164,216,43.16
Rengar,Fiora,300,122,178,40.67
Rengar,XinZhao,360,158,202,43.89
Rengar,Lissandra,282,122,160,43.26
Rengar,Renata,204,88,116,43.14
Rengar,Urgot,395,145,250,36.71
Rengar,Shyvana,148,64,84,43.24
Rengar,Taric,154,79,75,51.3
Rengar,MonkeyKing,415,139,276,33.49
Rengar,Kled,161,71,90,44.1
Rengar,Nidalee,222,101,121,45.5
Rengar,Kayle,500,234,266,46.8
Rengar,RekSai,104,49,55,47.12
Syndra,Aatrox,1162,651,511,56.02
Syndra,Ekko,1250,624,626,49.92
Syndra,Orianna,786,400,386,50.89
Syndra,Malzahar,1407,685,722,48.69
Syndra,Maokai,579,303,276,52.33
Syndra,XinZhao,868,484,384,55.76
Syndra,Katarina,1050,494,556,47.05
Syndra,Teemo,1571,801,770,50.99
Syndra,Vayne,1697,848,849,49.97
Syndra,TwistedFate,456,253,203,55.48
Syndra,Yorick,1261,600,661,47.58
Syndra,Viego,1833,933,900,50.9
Syndra,Malphite,1180,551,629,46.69
Syndra,Kaisa,2136,1045,1091,48.92
Syndra,Rell,700,384,316,54.86
Syndra,Gangplank,617,315,302,51.05
Syndra,Karthus,390,214,176,54.87
Syndra,Aurora,1141,615,526,53.9
Syndra,Ezreal,2906,1496,1410,51.48
Syndra,Senna,841,424,417,50.42
Syndra,Volibear,1301,639,662,49.12
Syndra,Evelynn,490,228,262,46.53
Syndra,Nocturne,1551,712,839,45.91
Syndra,Neeko,621,346,275,55.72
Syndra,Azir,516,274,242,53.1
Syndra,Sejuani,550,266,284,48.36
Syndra,Sylas,1311,644,667,49.12
Syndra,Lucian,988,510,478,51.62
Syndra,Seraphine,885,436,449,49.27
Syndra,Nasus,902,452,450,50.11
Syndra,Kindred,521,284,237,54.51
Syndra,Tristana,1129,630,499,55.8
Syndra,Nautilus,1553,770,783,49.58
Syndra,Vex,691,355,336,51.37
Syndra,Vi,1256,636,620,50.64
Syndra,Nilah,473,219,254,46.3
Syndra,Thresh,1841,904,937,49.1
Syndra,Rengar,457,261,196,57.11
Syndra,Jhin,2627,1347,1280,51.28
Syndra,Illaoi,514,228,286,44.36
Syndra,Irelia,1054,524,530,49.72
Syndra,Varus,1195,652,543,54.56
Syndra,Kayn,1878,936,942,49.84
Syndra,Hwei,1134,584,550,51.5
Syndra,Lux,3253,1650,1603,50.72
Syndra,Ornn,612,288,324,47.06
Syndra,Zed,1456,736,720,50.55
Syndra,Sivir,721,347,374,48.13
Syndra,Veigar,1327,672,655,50.64
Syndra,Heimerdinger,685,335,350,48.91
Syndra,Briar,890,472,418,53.03
Syndra,Jinx,3268,1679,1589,51.38
Syndra,Warwick,1776,915,861,51.52
Syndra,Kalista,413,198,215,47.94
Syndra,Yasuo,2048,1031,1017,50.34
Syndra,Jax,1134,590,544,52.03
Syndra,Xayah,691,356,335,51.52
Syndra,Lulu,1845,944,901,51.17
Syndra,MasterYi,1415,720,695,50.88
Syndra,Ashe,2483,1247,1236,50.22
Syndra,Riven,669,353,316,52.77
Syndra,Bard,437,231,206,52.86
Syndra,Rammus,381,178,203,46.72
Syndra,Caitlyn,3392,1698,1694,50.06
Syndra,Alistar,563,293,270,52.04
Syndra,Braum,742,325,417,43.8
Syndra,Gragas,788,420,368,53.3
Syndra,Akali,1106,530,576,47.92
Syndra,Kassadin,285,122,163,42.81
Syndra,Vladimir,759,397,362,52.31
Syndra,Gnar,544,303,241,55.7
Syndra,Sona,351,171,180,48.72
Syndra,Darius,2550,1288,1262,50.51
Syndra,Leona,1135,548,587,48.28
Syndra,Swain,1187,606,581,51.05
Syndra,Shaco,1253,684,569,54.59
Syndra,Amumu,1169,577,592,49.36
Syndra,Mel,2495,1318,1177,52.83
Syndra,Nami,1466,673,793,45.91
Syndra,FiddleSticks,656,340,316,51.83
Syndra,Anivia,643,315,328,48.99
Syndra,Sett,1790,891,899,49.78
Syndra,Shen,801,415,386,51.81
Syndra,Garen,2037,936,1101,45.95
Syndra,Naafiri,467,216,251,46.25
Syndra,Lillia,751,433,318,57.66
Syndra,Mordekaiser,1689,791,898,46.83
Syndra,AurelionSol,631,284,347,45.01
Syndra,Morgana,1414,702,712,49.65
Syndra,KSante,629,370,259,58.82
Syndra,Trundle,704,358,346,50.85
Syndra,Milio,821,416,405,50.67
Syndra,Talon,690,386,304,55.94
Syndra,Draven,760,393,367,51.71
Syndra,MissFortune,2615,1269,1346,48.53
Syndra,Xerath,1256,573,683,45.62
Syndra,Chogath,1584,760,824,47.98
Syndra,Velkoz,787,391,396,49.68
Syndra,Yuumi,1236,668,568,54.05
Syndra,Poppy,841,430,411,51.13
Syndra,Galio,1083,542,541,50.05
Syndra,Ziggs,521,251,270,48.18
Syndra,Kennen,381,169,212,44.36
Syndra,TahmKench,1008,488,520,48.41
Syndra,Twitch,1108,611,497,55.14
Syndra,Ambessa,831,431,400,51.87
Syndra,Zyra,1203,585,618,48.63
Syndra,Akshan,399,200,199,50.13
Syndra,LeeSin,1803,891,912,49.42
Syndra,Sion,1041,521,520,50.05
Syndra,Blitzcrank,926,471,455,50.86
Syndra,Fizz,852,433,419,50.82
Syndra,Soraka,767,336,431,43.81
Syndra,Renekton,638,381,257,59.72
Syndra,Qiyana,361,205,156,56.79
Syndra,Karma,1650,795,855,48.18
Syndra,Singed,342,185,157,54.09
Syndra,Yone,2287,1217,1070,53.21
Syndra,Skarner,374,184,190,49.2
Syndra,Ivern,235,116,119,49.36
Syndra,Pyke,1080,587,493,54.35
Syndra,Zoe,665,326,339,49.02
Syndra,Cassiopeia,568,312,256,54.93
Syndra,Renata,278,147,131,52.88
Syndra,Samira,892,464,428,52.02
Syndra,Ahri,2177,1163,1014,53.42
Syndra,Graves,939,485,454,51.65
Syndra,Rakan,626,338,288,53.99
Syndra,Smolder,879,438,441,49.83
Syndra,Pantheon,2069,1062,1007,51.33
Syndra,Jayce,607,300,307,49.42
Syndra,JarvanIV,800,394,406,49.25
Syndra,Leblanc,754,393,361,52.12
Syndra,Janna,496,253,243,51.01
Syndra,KogMaw,446,241,205,54.04
Syndra,Diana,2048,1071,977,52.29
Syndra,Elise,1020,507,513,49.71
Syndra,Zac,632,297,335,46.99
Syndra,MonkeyKing,789,383,406,48.54
Syndra,Viktor,1416,727,689,51.34
Syndra,Udyr,532,296,236,55.64
Syndra,Lissandra,375,160,215,42.67
Syndra,Aphelios,744,368,376,49.46
Syndra,Fiora,485,200,285,41.24
Syndra,Gwen,594,338,256,56.9
Syndra,Kayle,867,403,464,46.48
Syndra,Zilean,420,182,238,43.33
Syndra,Camille,570,296,274,51.93
Syndra,Nidalee,378,219,159,57.94
Syndra,Brand,768,377,391,49.09
Syndra,Shyvana,328,118,210,35.98
Syndra,Hecarim,586,306,280,52.22
Syndra,Khazix,754,387,367,51.33
Syndra,Olaf,324,172,152,53.09
Syndra,Annie,501,275,226,54.89
Syndra,Tryndamere,729,351,378,48.15
Syndra,Urgot,583,270,313,46.31
Syndra,Zeri,673,319,354,47.4
Syndra,RekSai,185,118,67,63.78
Syndra,Rumble,333,148,185,44.44
Syndra,Corki,538,319,219,59.29
Syndra,DrMundo,646,286,360,44.27
Syndra,Belveth,308,155,153,50.32
Syndra,Ryze,351,178,173,50.71
Syndra,Taric,296,163,133,55.07
Syndra,Taliyah,345,185,160,53.62
Syndra,Quinn,487,243,244,49.9
Syndra,Nunu,800,399,401,49.88
Syndra,Kled,274,140,134,51.09
Braum,Sett,1679,839,840,49.97
Braum,Vi,1157,598,559,51.69
Braum,AurelionSol,522,229,293,43.87
Braum,Corki,612,291,321,47.55
Braum,Milio,665,338,327,50.83
Braum,Trundle,700,335,365,47.86
Braum,Amumu,1221,560,661,45.86
Braum,Fizz,613,356,257,58.08
Braum,Kaisa,2124,1158,966,54.52
Braum,Pantheon,1937,957,980,49.41
Braum,Riven,589,316,273,53.65
Braum,FiddleSticks,634,288,346,45.43
Braum,Brand,814,394,420,48.4
Braum,Jinx,2919,1461,1458,50.05
Braum,Illaoi,508,250,258,49.21
Braum,Warwick,1475,782,693,53.02
Braum,Aurora,861,488,373,56.68
Braum,Ezreal,2597,1387,1210,53.41
Braum,Neeko,537,304,233,56.61
Braum,Nocturne,1432,698,734,48.74
Braum,Ekko,1056,549,507,51.99
Braum,MissFortune,2911,1470,1441,50.5
Braum,Seraphine,894,448,446,50.11
Braum,Gangplank,600,310,290,51.67
Braum,Malzahar,1127,551,576,48.89
Braum,Tristana,1189,590,599,49.62
Braum,Senna,873,390,483,44.67
Braum,Mordekaiser,1532,722,810,47.13
Braum,Sejuani,554,279,275,50.36
Braum,Yone,1950,1078,872,55.28
Braum,Swain,1236,604,632,48.87
Braum,Shaco,961,519,442,54.01
Braum,Akali,1128,618,510,54.79
Braum,Sivir,573,294,279,51.31
Braum,Renata,239,116,123,48.54
Braum,Fiora,565,277,288,49.03
Braum,Diana,1812,913,899,50.39
Braum,Veigar,1142,553,589,48.42
Braum,Ashe,2143,1195,948,55.76
Braum,Volibear,1264,642,622,50.79
Braum,Irelia,916,502,414,54.8
Braum,Varus,989,511,478,51.67
Braum,Nautilus,1993,1080,913,54.19
Braum,Tryndamere,681,363,318,53.3
Braum,MasterYi,1363,743,620,54.51
Braum,Orianna,538,268,270,49.81
Braum,Lux,2521,1304,1217,51.73
Braum,MonkeyKing,837,428,409,51.14
Braum,Jhin,2295,1285,1010,55.99
Braum,Vayne,1480,743,737,50.2
Braum,Talon,636,355,281,55.82
Braum,Taliyah,354,162,192,45.76
Braum,Zoe,515,286,229,55.53
Braum,Shen,777,383,394,49.29
Braum,Kayn,1669,846,823,50.69
Braum,Chogath,1534,772,762,50.33
Braum,Viktor,1046,515,531,49.24
Braum,Morgana,1170,558,612,47.69
Braum,Hwei,799,388,411,48.56
Braum,Caitlyn,3207,1611,1596,50.23
Braum,Teemo,1381,700,681,50.69
Braum,Lucian,853,492,361,57.68
Braum,Ornn,546,289,257,52.93
Braum,Yorick,1036,512,524,49.42
Braum,Kalista,348,197,151,56.61
Braum,LeeSin,1747,926,821,53.01
Braum,Mel,2248,1218,1030,54.18
Braum,Smolder,761,375,386,49.28
Braum,Zed,1216,653,563,53.7
Braum,Sion,884,441,443,49.89
Braum,Soraka,633,297,336,46.92
Braum,Aatrox,1074,584,490,54.38
Braum,Rengar,437,276,161,63.16
Braum,Ivern,238,153,85,64.29
Braum,Syndra,742,417,325,56.2
Braum,Samira,795,418,377,52.58
Braum,Maokai,508,254,254,50
Braum,Zac,583,309,274,53
Braum,Galio,868,395,473,45.51
Braum,Alistar,540,264,276,48.89
Braum,Graves,833,455,378,54.62
Braum,Yuumi,923,503,420,54.5
Braum,DrMundo,591,301,290,50.93
Braum,Nami,1348,648,700,48.07
Braum,Briar,840,433,407,51.55
Braum,Ryze,473,263,210,55.6
Braum,Singed,338,183,155,54.14
Braum,Nasus,773,356,417,46.05
Braum,Evelynn,487,232,255,47.64
Braum,Ahri,1672,875,797,52.33
Braum,Zyra,932,447,485,47.96
Braum,Ambessa,794,404,390,50.88
Braum,Sylas,1677,899,778,53.61
Braum,Camille,467,232,235,49.68
Braum,Karthus,319,150,169,47.02
Braum,Yasuo,2213,1132,1081,51.15
Braum,Lulu,1608,838,770,52.11
Braum,Kindred,490,289,201,58.98
Braum,Nunu,690,378,312,54.78
Braum,Renekton,629,358,271,56.92
Braum,Vex,658,323,335,49.09
Braum,Karma,1460,766,694,52.47
Braum,Azir,522,298,224,57.09
Braum,Jax,1115,571,544,51.21
Braum,Draven,783,400,383,51.09
Braum,Vladimir,795,422,373,53.08
Braum,XinZhao,831,406,425,48.86
Braum,Urgot,628,368,260,58.6
Braum,Annie,379,189,190,49.87
Braum,Kayle,821,404,417,49.21
Braum,Gwen,591,334,257,56.51
Braum,Katarina,880,430,450,48.86
Braum,Aphelios,660,344,316,52.12
Braum,TahmKench,1108,591,517,53.34
Braum,Lillia,642,320,322,49.84
Braum,Kassadin,272,117,155,43.01
Braum,Twitch,986,550,436,55.78
Braum,Leblanc,729,435,294,59.67
Braum,Nilah,418,185,233,44.26
Braum,Thresh,2217,1131,1086,51.01
Braum,Viego,1636,948,688,57.95
Braum,Heimerdinger,495,244,251,49.29
Braum,Quinn,391,201,190,51.41
Braum,Khazix,559,331,228,59.21
Braum,Xerath,860,435,425,50.58
Braum,Darius,2190,1061,1129,48.45
Braum,Blitzcrank,994,555,439,55.84
Braum,Belveth,297,185,112,62.29
Braum,Xayah,578,283,295,48.96
Braum,Rakan,597,260,337,43.55
Braum,Elise,935,520,415,55.61
Braum,Garen,1958,952,1006,48.62
Braum,Velkoz,685,297,388,43.36
Braum,Jayce,627,285,342,45.45
Braum,Shyvana,288,138,150,47.92
Braum,Gnar,516,262,254,50.78
Braum,Gragas,733,378,355,51.57
Braum,Ziggs,417,199,218,47.72
Braum,JarvanIV,796,403,393,50.63
Braum,KSante,657,387,270,58.9
Braum,Poppy,796,422,374,53.02
Braum,Kennen,334,166,168,49.7
Braum,TwistedFate,469,236,233,50.32
Braum,Lissandra,485,245,240,50.52
Braum,Rell,728,364,364,50
Braum,Leona,1162,631,531,54.3
Braum,Zilean,378,158,220,41.8
Braum,Hecarim,470,211,259,44.89
Braum,Rumble,337,202,135,59.94
Braum,Pyke,1089,606,483,55.65
Braum,Janna,369,192,177,52.03
Braum,Olaf,284,161,123,56.69
Braum,Taric,262,141,121,53.82
Braum,Rammus,407,200,207,49.14
Braum,Sona,253,118,135,46.64
Braum,Malphite,1140,513,627,45
Braum,KogMaw,428,162,266,37.85
Braum,Bard,451,196,255,43.46
Braum,Udyr,427,191,236,44.73
Braum,Anivia,411,220,191,53.53
Braum,Naafiri,360,198,162,55
Braum,Kled,193,120,73,62.18
Braum,RekSai,199,119,80,59.8
Braum,Cassiopeia,364,178,186,48.9
Braum,Skarner,436,237,199,54.36
Braum,Nidalee,396,219,177,55.3
Braum,Qiyana,254,117,137,46.06
Braum,Zeri,457,207,250,45.3
Braum,Akshan,387,216,171,55.81
Corki,Braum,612,321,291,52.45
Corki,XinZhao,541,239,302,44.18
Corki,Lux,2038,946,1092,46.42
Corki,Chogath,948,418,530,44.09
Corki,Taliyah,244,116,128,47.54
Corki,Mordekaiser,899,366,533,40.71
Corki,Vi,775,358,417,46.19
Corki,Azir,309,150,159,48.54
Corki,MissFortune,1759,810,949,46.05
Corki,Nautilus,936,465,471,49.68
Corki,Gnar,382,202,180,52.88
Corki,Warwick,1029,459,570,44.61
Corki,Malzahar,768,343,425,44.66
Corki,Tristana,948,453,495,47.78
Corki,Brand,497,243,254,48.89
Corki,Ornn,362,194,168,53.59
Corki,Amumu,764,342,422,44.76
Corki,Katarina,755,368,387,48.74
Corki,Twitch,763,350,413,45.87
Corki,Senna,612,284,328,46.41
Corki,Garen,1437,609,828,42.38
Corki,Ekko,683,332,351,48.61
Corki,Yasuo,1625,730,895,44.92
Corki,Caitlyn,1955,879,1076,44.96
Corki,Poppy,552,258,294,46.74
Corki,Aurora,649,304,345,46.84
Corki,Nocturne,1094,473,621,43.24
Corki,Pantheon,1309,619,690,47.29
Corki,Nilah,341,185,156,54.25
Corki,Soraka,491,201,290,40.94
Corki,Kennen,272,118,154,43.38
Corki,TwistedFate,338,156,182,46.15
Corki,Cassiopeia,240,97,143,40.42
Corki,Smolder,486,259,227,53.29
Corki,Milio,569,250,319,43.94
Corki,TahmKench,640,282,358,44.06
Corki,Samira,694,385,309,55.48
Corki,Taric,212,94,118,44.34
Corki,Hecarim,390,185,205,47.44
Corki,Jhin,1573,730,843,46.41
Corki,Velkoz,528,228,300,43.18
Corki,Nasus,507,255,252,50.3
Corki,MasterYi,824,398,426,48.3
Corki,Riven,420,205,215,48.81
Corki,Rell,540,268,272,49.63
Corki,Rammus,233,109,124,46.78
Corki,Vex,389,181,208,46.53
Corki,Lulu,1309,576,733,44
Corki,Kayle,544,240,304,44.12
Corki,Tryndamere,503,255,248,50.7
Corki,Akali,790,390,400,49.37
Corki,Neeko,385,175,210,45.45
Corki,Yorick,694,310,384,44.67
Corki,Singed,219,80,139,36.53
Corki,Ryze,343,157,186,45.77
Corki,Kayn,1316,568,748,43.16
Corki,Viktor,783,385,398,49.17
Corki,Zed,876,465,411,53.08
Corki,Ashe,1791,847,944,47.29
Corki,Thresh,1216,605,611,49.75
Corki,Jax,736,346,390,47.01
Corki,Shaco,770,359,411,46.62
Corki,Zoe,402,196,206,48.76
Corki,Yuumi,749,359,390,47.93
Corki,Teemo,877,394,483,44.93
Corki,Evelynn,258,117,141,45.35
Corki,Janna,301,124,177,41.2
Corki,Aatrox,775,379,396,48.9
Corki,Lucian,609,298,311,48.93
Corki,Nami,977,442,535,45.24
Corki,LeeSin,1287,631,656,49.03
Corki,Zac,482,271,211,56.22
Corki,Gragas,544,270,274,49.63
Corki,Viego,1222,580,642,47.46
Corki,Darius,1578,765,813,48.48
Corki,Kaisa,1460,686,774,46.99
Corki,Swain,734,311,423,42.37
Corki,DrMundo,423,202,221,47.75
Corki,Trundle,435,175,260,40.23
Corki,Rengar,344,186,158,54.07
Corki,Vladimir,589,275,314,46.69
Corki,Mel,1612,788,824,48.88
Corki,Sett,1106,478,628,43.22
Corki,Nunu,527,263,264,49.91
Corki,Jinx,2050,969,1081,47.27
Corki,Briar,484,236,248,48.76
Corki,Ezreal,2089,1044,1045,49.98
Corki,Morgana,837,402,435,48.03
Corki,Nidalee,253,141,112,55.73
Corki,Volibear,879,410,469,46.64
Corki,Annie,260,127,133,48.85
Corki,Vayne,1127,522,605,46.32
Corki,Zeri,395,198,197,50.13
Corki,Gwen,448,219,229,48.88
Corki,Veigar,762,375,387,49.21
Corki,Sylas,1096,541,555,49.36
Corki,Varus,744,329,415,44.22
Corki,Irelia,577,290,287,50.26
Corki,FiddleSticks,397,192,205,48.36
Corki,Illaoi,373,190,183,50.94
Corki,Lillia,433,193,240,44.57
Corki,Fizz,366,179,187,48.91
Corki,Karma,997,504,493,50.55
Corki,Fiora,345,185,160,53.62
Corki,Ivern,150,90,60,60
Corki,Kassadin,236,68,168,28.81
Corki,Aphelios,506,219,287,43.28
Corki,Diana,1196,565,631,47.24
Corki,Sejuani,372,189,183,50.81
Corki,Shen,563,260,303,46.18
Corki,KSante,486,243,243,50
Corki,Khazix,466,202,264,43.35
Corki,Blitzcrank,603,276,327,45.77
Corki,Heimerdinger,305,112,193,36.72
Corki,Renata,163,95,68,58.28
Corki,Udyr,343,142,201,41.4
Corki,Zilean,302,144,158,47.68
Corki,Sion,730,362,368,49.59
Corki,Ziggs,274,129,145,47.08
Corki,Pyke,777,415,362,53.41
Corki,Naafiri,268,122,146,45.52
Corki,Ahri,1022,516,506,50.49
Corki,Sivir,470,215,255,45.74
Corki,Seraphine,578,276,302,47.75
Corki,Galio,912,436,476,47.81
Corki,Draven,456,255,201,55.92
Corki,Hwei,542,264,278,48.71
Corki,Qiyana,269,131,138,48.7
Corki,Renekton,432,220,212,50.93
Corki,Jayce,437,231,206,52.86
Corki,KogMaw,279,113,166,40.5
Corki,Zyra,676,312,364,46.15
Corki,Skarner,229,108,121,47.16
Corki,Malphite,745,393,352,52.75
Corki,Leblanc,613,294,319,47.96
Corki,Kindred,418,199,219,47.61
Corki,Alistar,417,183,234,43.88
Corki,Leona,683,340,343,49.78
Corki,JarvanIV,590,295,295,50
Corki,Akshan,298,128,170,42.95
Corki,Xayah,456,208,248,45.61
Corki,Gangplank,415,220,195,53.01
Corki,AurelionSol,299,121,178,40.47
Corki,Bard,317,148,169,46.69
Corki,Kled,176,74,102,42.05
Corki,Yone,1367,624,743,45.65
Corki,Kalista,243,96,147,39.51
Corki,Elise,676,332,344,49.11
Corki,Ambessa,567,254,313,44.8
Corki,Orianna,462,214,248,46.32
Corki,Urgot,418,189,229,45.22
Corki,Rakan,403,188,215,46.65
Corki,Graves,546,300,246,54.95
Corki,Anivia,248,102,146,41.13
Corki,Xerath,565,255,310,45.13
Corki,Talon,498,223,275,44.78
Corki,Karthus,227,90,137,39.65
Corki,Camille,415,220,195,53.01
Corki,Quinn,368,178,190,48.37
Corki,Lissandra,266,129,137,48.5
Corki,Syndra,538,219,319,40.71
Corki,Maokai,376,177,199,47.07
Corki,Sona,217,113,104,52.07
Corki,Shyvana,220,107,113,48.64
Corki,Belveth,231,112,119,48.48
Corki,Olaf,218,117,101,53.67
Corki,MonkeyKing,592,250,342,42.23
Corki,RekSai,146,105,41,71.92
Corki,Rumble,259,137,122,52.9
Bard,Riven,323,169,154,52.32
Bard,Nocturne,716,385,331,53.77
Bard,Zoe,289,134,155,46.37
Bard,Jinx,1647,796,851,48.33
Bard,Lulu,843,459,384,54.45
Bard,Teemo,718,337,381,46.94
Bard,Amumu,646,309,337,47.83
Bard,Garen,1002,460,542,45.91
Bard,KogMaw,211,99,112,46.92
Bard,Yuumi,606,274,332,45.21
Bard,Fiora,252,108,144,42.86
Bard,LeeSin,1012,576,436,56.92
Bard,Ziggs,236,111,125,47.03
Bard,Senna,558,253,305,45.34
Bard,Tryndamere,359,210,149,58.5
Bard,Sylas,841,437,404,51.96
Bard,Taliyah,206,94,112,45.63
Bard,Jhin,1226,635,591,51.79
Bard,Volibear,719,364,355,50.63
Bard,Malzahar,591,266,325,45.01
Bard,Caitlyn,1721,784,937,45.55
Bard,Pyke,526,291,235,55.32
Bard,Jayce,370,205,165,55.41
Bard,Skarner,190,102,88,53.68
Bard,Lux,1493,775,718,51.91
Bard,Poppy,452,245,207,54.2
Bard,Malphite,557,276,281,49.55
Bard,Sejuani,322,184,138,57.14
Bard,Heimerdinger,242,110,132,45.45
Bard,Zilean,252,114,138,45.24
Bard,Singed,180,69,111,38.33
Bard,MasterYi,666,287,379,43.09
Bard,Veigar,695,305,390,43.88
Bard,Karma,883,441,442,49.94
Bard,Yasuo,1238,615,623,49.68
Bard,Ekko,622,269,353,43.25
Bard,Hwei,411,243,168,59.12
Bard,Sett,923,469,454,50.81
Bard,Ivern,133,58,75,43.61
Bard,Katarina,505,227,278,44.95
Bard,Xayah,347,163,184,46.97
Bard,Mel,1370,731,639,53.36
Bard,Zed,610,315,295,51.64
Bard,Morgana,673,313,360,46.51
Bard,Akshan,264,143,121,54.17
Bard,Syndra,437,206,231,47.14
Bard,Xerath,567,314,253,55.38
Bard,Warwick,837,350,487,41.82
Bard,Viktor,578,287,291,49.65
Bard,Ashe,1121,558,563,49.78
Bard,Yone,1036,547,489,52.8
Bard,Shen,474,227,247,47.89
Bard,Leblanc,359,181,178,50.42
Bard,Twitch,579,308,271,53.2
Bard,Velkoz,384,187,197,48.7
Bard,Kindred,322,134,188,41.61
Bard,Trundle,341,152,189,44.57
Bard,Udyr,282,121,161,42.91
Bard,Samira,485,215,270,44.33
Bard,Rell,308,145,163,47.08
Bard,Aphelios,461,227,234,49.24
Bard,Alistar,244,105,139,43.03
Bard,Nidalee,184,100,84,54.35
Bard,Naafiri,237,105,132,44.3
Bard,Nautilus,668,348,320,52.1
Bard,TahmKench,546,254,292,46.52
Bard,Diana,927,466,461,50.27
Bard,Ezreal,1489,765,724,51.38
Bard,Swain,530,250,280,47.17
Bard,Irelia,492,258,234,52.44
Bard,Orianna,346,179,167,51.73
Bard,Vayne,722,393,329,54.43
Bard,Soraka,428,168,260,39.25
Bard,Ornn,321,161,160,50.16
Bard,TwistedFate,212,105,107,49.53
Bard,Kaisa,1034,556,478,53.77
Bard,Yorick,614,254,360,41.37
Bard,XinZhao,385,167,218,43.38
Bard,Graves,398,229,169,57.54
Bard,Shaco,561,300,261,53.48
Bard,Hecarim,331,171,160,51.66
Bard,Rengar,304,168,136,55.26
Bard,Vladimir,399,183,216,45.86
Bard,Karthus,199,94,105,47.24
Bard,Khazix,286,171,115,59.79
Bard,Qiyana,187,119,68,63.64
Bard,Renekton,380,208,172,54.74
Bard,Aurora,545,268,277,49.17
Bard,MissFortune,1257,635,622,50.52
Bard,Elise,541,258,283,47.69
Bard,Brand,415,202,213,48.67
Bard,Annie,184,105,79,57.07
Bard,Zeri,315,153,162,48.57
Bard,Mordekaiser,768,397,371,51.69
Bard,Nasus,396,184,212,46.46
Bard,Kayn,869,423,446,48.68
Bard,Gnar,235,122,113,51.91
Bard,Neeko,278,117,161,42.09
Bard,Gragas,425,213,212,50.12
Bard,Ambessa,451,208,243,46.12
Bard,Briar,463,257,206,55.51
Bard,Darius,1257,553,704,43.99
Bard,Milio,410,181,229,44.15
Bard,Sion,540,286,254,52.96
Bard,Nunu,418,184,234,44.02
Bard,Evelynn,247,138,109,55.87
Bard,Varus,544,273,271,50.18
Bard,MonkeyKing,432,196,236,45.37
Bard,Azir,175,100,75,57.14
Bard,Seraphine,501,258,243,51.5
Bard,JarvanIV,414,189,225,45.65
Bard,Zac,317,144,173,45.43
Bard,Ahri,931,513,418,55.1
Bard,Thresh,975,526,449,53.95
Bard,Smolder,428,249,179,58.18
Bard,Janna,298,129,169,43.29
Bard,Kled,95,56,39,58.95
Bard,Illaoi,289,127,162,43.94
Bard,Blitzcrank,400,173,227,43.25
Bard,Chogath,862,471,391,54.64
Bard,Tristana,668,351,317,52.54
Bard,Draven,339,192,147,56.64
Bard,Aatrox,641,300,341,46.8
Bard,Zyra,610,295,315,48.36
Bard,Nami,775,397,378,51.23
Bard,Kassadin,179,83,96,46.37
Bard,Gangplank,347,148,199,42.65
Bard,Pantheon,1035,503,532,48.6
Bard,Corki,317,169,148,53.31
Bard,Vex,330,141,189,42.73
Bard,Vi,567,288,279,50.79
Bard,AurelionSol,242,109,133,45.04
Bard,Leona,487,255,232,52.36
Bard,Gwen,405,215,190,53.09
Bard,Rakan,360,181,179,50.28
Bard,DrMundo,376,184,192,48.94
Bard,Urgot,334,141,193,42.22
Bard,Galio,545,254,291,46.61
Bard,Quinn,291,167,124,57.39
Bard,Braum,451,255,196,56.54
Bard,Akali,628,314,314,50
Bard,Lucian,430,214,216,49.77
Bard,Fizz,317,163,154,51.42
Bard,Camille,310,172,138,55.48
Bard,Jax,593,296,297,49.92
Bard,Lillia,391,206,185,52.69
Bard,Viego,907,480,427,52.92
Bard,Kayle,425,216,209,50.82
Bard,FiddleSticks,368,179,189,48.64
Bard,Sona,213,80,133,37.56
Bard,Cassiopeia,210,105,105,50
Bard,Talon,380,217,163,57.11
Bard,Maokai,332,141,191,42.47
Bard,Renata,137,78,59,56.93
Bard,Nilah,271,165,106,60.89
Bard,Belveth,132,65,67,49.24
Bard,Rumble,186,97,89,52.15
Bard,Kalista,247,140,107,56.68
Bard,Olaf,160,77,83,48.13
Bard,Rammus,155,61,94,39.35
Bard,Anivia,216,118,98,54.63
Bard,Sivir,343,154,189,44.9
Bard,Lissandra,182,56,126,30.77
Bard,RekSai,77,33,44,42.86
Bard,KSante,333,189,144,56.76
Bard,Shyvana,159,72,87,45.28
Bard,Taric,120,64,56,53.33
Bard,Kennen,244,127,117,52.05
Bard,Ryze,234,104,130,44.44
Xerath,Mordekaiser,2256,1128,1128,50
Xerath,Vi,1947,1002,945,51.46
Xerath,Cassiopeia,650,339,311,52.15
Xerath,Ezreal,4782,2459,2323,51.42
Xerath,Lux,5617,2900,2717,51.63
Xerath,Gwen,852,435,417,51.06
Xerath,Tryndamere,957,433,524,45.25
Xerath,Velkoz,1289,639,650,49.57
Xerath,Zeri,696,382,314,54.89
Xerath,Thresh,2482,1225,1257,49.36
Xerath,Kayn,2612,1307,1305,50.04
Xerath,Diana,2745,1401,1344,51.04
Xerath,Sivir,980,443,537,45.2
Xerath,Soraka,1012,460,552,45.45
Xerath,MasterYi,2029,979,1050,48.25
Xerath,Shaco,1532,734,798,47.91
Xerath,Azir,735,393,342,53.47
Xerath,Rengar,541,315,226,58.23
Xerath,Pyke,1543,782,761,50.68
Xerath,Malzahar,1889,925,964,48.97
Xerath,Twitch,1370,651,719,47.52
Xerath,Talon,972,515,457,52.98
Xerath,Jhin,3716,1878,1838,50.54
Xerath,Rakan,706,367,339,51.98
Xerath,Singed,506,222,284,43.87
Xerath,Kindred,778,430,348,55.27
Xerath,Yasuo,3285,1572,1713,47.85
Xerath,Ashe,3633,1806,1827,49.71
Xerath,Alistar,661,354,307,53.56
Xerath,Aatrox,1824,937,887,51.37
Xerath,Warwick,2531,1285,1246,50.77
Xerath,Varus,1719,995,724,57.88
Xerath,Milio,984,466,518,47.36
Xerath,Ornn,769,344,425,44.73
Xerath,Hwei,1463,735,728,50.24
Xerath,Caitlyn,5076,2660,2416,52.4
Xerath,Karma,2490,1226,1264,49.24
Xerath,Nasus,1179,536,643,45.46
Xerath,LeeSin,3095,1625,1470,52.5
Xerath,Ivern,273,159,114,58.24
Xerath,Jinx,4634,2336,2298,50.41
Xerath,Seraphine,1354,681,673,50.3
Xerath,Yone,3180,1670,1510,52.52
Xerath,Udyr,600,315,285,52.5
Xerath,Tristana,1620,771,849,47.59
Xerath,Lulu,2171,1118,1053,51.5
Xerath,Zac,891,441,450,49.49
Xerath,Swain,1629,812,817,49.85
Xerath,Briar,1300,600,700,46.15
Xerath,Poppy,999,557,442,55.76
Xerath,Ekko,1599,723,876,45.22
Xerath,Kaisa,2748,1396,1352,50.8
Xerath,Rell,829,446,383,53.8
Xerath,Gragas,1051,575,476,54.71
Xerath,Xayah,869,433,436,49.83
Xerath,Fiora,725,369,356,50.9
Xerath,Sylas,2436,1244,1192,51.07
Xerath,Nautilus,2130,1156,974,54.27
Xerath,Riven,725,365,360,50.34
Xerath,Bard,567,253,314,44.62
Xerath,Karthus,485,269,216,55.46
Xerath,KSante,1083,606,477,55.96
Xerath,TahmKench,1341,647,694,48.25
Xerath,Sion,1261,665,596,52.74
Xerath,Garen,2619,1290,1329,49.26
Xerath,Teemo,2191,1030,1161,47.01
Xerath,Katarina,1351,691,660,51.15
Xerath,Nilah,589,303,286,51.44
Xerath,Fizz,1119,560,559,50.04
Xerath,Gangplank,973,488,485,50.15
Xerath,Kled,302,145,157,48.01
Xerath,Lillia,945,489,456,51.75
Xerath,Ahri,2361,1210,1151,51.25
Xerath,MissFortune,4018,2100,1918,52.26
Xerath,Neeko,909,525,384,57.76
Xerath,Graves,1308,660,648,50.46
Xerath,Vayne,2135,1046,1089,48.99
Xerath,Jax,1597,826,771,51.72
Xerath,Amumu,1810,862,948,47.62
Xerath,Heimerdinger,766,375,391,48.96
Xerath,Volibear,2073,993,1080,47.9
Xerath,Morgana,2364,1170,1194,49.49
Xerath,Brand,1364,735,629,53.89
Xerath,Blitzcrank,1492,799,693,53.55
Xerath,Yorick,1605,785,820,48.91
Xerath,Kassadin,343,177,166,51.6
Xerath,Mel,4677,2561,2116,54.76
Xerath,Galio,1571,831,740,52.9
Xerath,Zoe,733,387,346,52.8
Xerath,Darius,3192,1668,1524,52.26
Xerath,FiddleSticks,831,433,398,52.11
Xerath,Senna,1292,665,627,51.47
Xerath,Illaoi,848,433,415,51.06
Xerath,Sona,559,288,271,51.52
Xerath,Irelia,1486,779,707,52.42
Xerath,Orianna,954,531,423,55.66
Xerath,Syndra,1256,683,573,54.38
Xerath,Samira,1325,708,617,53.43
Xerath,Yuumi,1532,754,778,49.22
Xerath,DrMundo,982,471,511,47.96
Xerath,Viktor,1691,880,811,52.04
Xerath,Leona,1445,685,760,47.4
Xerath,Sett,2851,1363,1488,47.81
Xerath,Renekton,916,441,475,48.14
Xerath,Pantheon,2705,1412,1293,52.2
Xerath,Viego,2572,1318,1254,51.24
Xerath,Akali,1866,952,914,51.02
Xerath,Kennen,526,258,268,49.05
Xerath,Kalista,517,281,236,54.35
Xerath,Janna,515,239,276,46.41
Xerath,Akshan,541,263,278,48.61
Xerath,Ziggs,698,307,391,43.98
Xerath,Sejuani,693,326,367,47.04
Xerath,Malphite,1783,927,856,51.99
Xerath,Vex,1062,533,529,50.19
Xerath,Gnar,739,375,364,50.74
Xerath,Qiyana,407,232,175,57
Xerath,Zilean,519,249,270,47.98
Xerath,XinZhao,1220,574,646,47.05
Xerath,Aphelios,901,485,416,53.83
Xerath,Camille,674,356,318,52.82
Xerath,Naafiri,571,261,310,45.71
Xerath,Zed,1840,923,917,50.16
Xerath,Braum,860,425,435,49.42
Xerath,Zyra,1855,977,878,52.67
Xerath,AurelionSol,655,322,333,49.16
Xerath,Annie,675,330,345,48.89
Xerath,Aurora,1297,702,595,54.12
Xerath,Taliyah,437,240,197,54.92
Xerath,Shen,1125,556,569,49.42
Xerath,Ryze,610,283,327,46.39
Xerath,Urgot,888,414,474,46.62
Xerath,Rammus,494,270,224,54.66
Xerath,Lucian,1250,674,576,53.92
Xerath,Nami,1710,867,843,50.7
Xerath,Nunu,1041,565,476,54.27
Xerath,Kayle,1208,640,568,52.98
Xerath,MonkeyKing,1026,506,520,49.32
Xerath,Chogath,2005,992,1013,49.48
Xerath,Quinn,641,332,309,51.79
Xerath,Veigar,2017,1000,1017,49.58
Xerath,Jayce,1006,522,484,51.89
Xerath,Smolder,1207,644,563,53.36
Xerath,Maokai,773,418,355,54.08
Xerath,Elise,1425,751,674,52.7
Xerath,Draven,958,498,460,51.98
Xerath,JarvanIV,1038,480,558,46.24
Xerath,Vladimir,935,498,437,53.26
Xerath,Shyvana,458,247,211,53.93
Xerath,Nocturne,2218,983,1235,44.32
Xerath,Nidalee,652,391,261,59.97
Xerath,Skarner,536,232,304,43.28
Xerath,Olaf,386,200,186,51.81
Xerath,Ambessa,1150,669,481,58.17
Xerath,KogMaw,499,257,242,51.5
Xerath,Lissandra,587,337,250,57.41
Xerath,Khazix,964,546,418,56.64
Xerath,TwistedFate,685,418,267,61.02
Xerath,Evelynn,615,298,317,48.46
Xerath,Corki,565,310,255,54.87
Xerath,Leblanc,1131,575,556,50.84
Xerath,Trundle,1022,531,491,51.96
Xerath,Hecarim,763,412,351,54
Xerath,Anivia,606,256,350,42.24
Xerath,Rumble,576,337,239,58.51
Xerath,RekSai,193,107,86,55.44
Xerath,Belveth,461,215,246,46.64
Xerath,Taric,325,157,168,48.31
Xerath,Renata,320,178,142,55.63
Karthus,Fiora,231,114,117,49.35
Karthus,FiddleSticks,371,169,202,45.55
Karthus,Syndra,390,176,214,45.13
Karthus,Vayne,727,320,407,44.02
Karthus,Morgana,656,325,331,49.54
Karthus,Illaoi,249,120,129,48.19
Karthus,Warwick,852,388,464,45.54
Karthus,Aurora,518,258,260,49.81
Karthus,Ezreal,1485,716,769,48.22
Karthus,Neeko,308,185,123,60.06
Karthus,Kled,100,34,66,34
Karthus,Ambessa,423,203,220,47.99
Karthus,Diana,1068,508,560,47.57
Karthus,Nilah,248,129,119,52.02
Karthus,Leona,450,242,208,53.78
Karthus,Gnar,314,138,176,43.95
Karthus,Kayn,898,399,499,44.43
Karthus,Katarina,465,245,220,52.69
Karthus,Ashe,1230,640,590,52.03
Karthus,Thresh,847,409,438,48.29
Karthus,Yorick,499,190,309,38.08
Karthus,Mordekaiser,739,363,376,49.12
Karthus,Ahri,687,332,355,48.33
Karthus,Jinx,1618,747,871,46.17
Karthus,Amumu,645,306,339,47.44
Karthus,Shaco,741,332,409,44.8
Karthus,MissFortune,1262,583,679,46.2
Karthus,Lux,1483,670,813,45.18
Karthus,Irelia,493,240,253,48.68
Karthus,MonkeyKing,351,165,186,47.01
Karthus,Vex,369,177,192,47.97
Karthus,Caitlyn,1397,654,743,46.81
Karthus,Rell,352,179,173,50.85
Karthus,Nasus,339,129,210,38.05
Karthus,Xerath,485,216,269,44.54
Karthus,Aatrox,608,262,346,43.09
Karthus,Yone,1086,527,559,48.53
Karthus,Samira,394,164,230,41.62
Karthus,Karma,761,333,428,43.76
Karthus,Nocturne,714,336,378,47.06
Karthus,Ryze,198,95,103,47.98
Karthus,Blitzcrank,473,238,235,50.32
Karthus,Urgot,251,107,144,42.63
Karthus,Ivern,111,57,54,51.35
Karthus,Kassadin,133,53,80,39.85
Karthus,Senna,474,254,220,53.59
Karthus,DrMundo,349,141,208,40.4
Karthus,TwistedFate,238,131,107,55.04
Karthus,Yasuo,1130,585,545,51.77
Karthus,Rammus,188,106,82,56.38
Karthus,Vladimir,402,176,226,43.78
Karthus,Braum,319,169,150,52.98
Karthus,Sett,892,418,474,46.86
Karthus,Darius,1216,600,616,49.34
Karthus,Ekko,493,220,273,44.62
Karthus,Swain,606,298,308,49.17
Karthus,Orianna,232,99,133,42.67
Karthus,Aphelios,379,163,216,43.01
Karthus,Brand,399,201,198,50.38
Karthus,Kaisa,1095,628,467,57.35
Karthus,Gragas,358,145,213,40.5
Karthus,Talon,384,209,175,54.43
Karthus,Jhin,1208,633,575,52.4
Karthus,Tristana,574,285,289,49.65
Karthus,Rengar,260,142,118,54.62
Karthus,Briar,440,161,279,36.59
Karthus,Mel,1224,636,588,51.96
Karthus,Teemo,796,397,399,49.87
Karthus,Leblanc,380,177,203,46.58
Karthus,Bard,199,105,94,52.76
Karthus,LeeSin,875,435,440,49.71
Karthus,Renekton,253,114,139,45.06
Karthus,Nautilus,665,340,325,51.13
Karthus,Gwen,298,160,138,53.69
Karthus,MasterYi,743,362,381,48.72
Karthus,Elise,459,236,223,51.42
Karthus,Jax,458,207,251,45.2
Karthus,Viktor,494,244,250,49.39
Karthus,Zyra,619,254,365,41.03
Karthus,Hwei,419,206,213,49.16
Karthus,Viego,746,386,360,51.74
Karthus,Malzahar,586,220,366,37.54
Karthus,Lucian,446,236,210,52.91
Karthus,Veigar,577,279,298,48.35
Karthus,Soraka,412,185,227,44.9
Karthus,Ziggs,185,100,85,54.05
Karthus,Nunu,351,170,181,48.43
Karthus,Sona,220,108,112,49.09
Karthus,Varus,551,328,223,59.53
Karthus,Singed,169,76,93,44.97
Karthus,Garen,989,454,535,45.9
Karthus,Shen,334,160,174,47.9
Karthus,TahmKench,464,207,257,44.61
Karthus,Taliyah,229,106,123,46.29
Karthus,Janna,209,115,94,55.02
Karthus,Draven,306,138,168,45.1
Karthus,Pantheon,985,499,486,50.66
Karthus,Zed,572,307,265,53.67
Karthus,Smolder,375,173,202,46.13
Karthus,Riven,290,151,139,52.07
Karthus,Chogath,693,321,372,46.32
Karthus,Renata,86,47,39,54.65
Karthus,Lulu,734,344,390,46.87
Karthus,Annie,211,91,120,43.13
Karthus,Sivir,328,152,176,46.34
Karthus,Udyr,198,85,113,42.93
Karthus,Tryndamere,290,145,145,50
Karthus,Seraphine,452,211,241,46.68
Karthus,Trundle,276,114,162,41.3
Karthus,AurelionSol,256,141,115,55.08
Karthus,Vi,537,274,263,51.02
Karthus,Taric,110,66,44,60
Karthus,Malphite,526,236,290,44.87
Karthus,KSante,304,156,148,51.32
Karthus,Azir,248,128,120,51.61
Karthus,Rumble,174,108,66,62.07
Karthus,Anivia,271,102,169,37.64
Karthus,Pyke,481,254,227,52.81
Karthus,Lillia,369,193,176,52.3
Karthus,Nami,575,232,343,40.35
Karthus,Poppy,355,178,177,50.14
Karthus,Alistar,253,145,108,57.31
Karthus,Sejuani,233,123,110,52.79
Karthus,Camille,238,136,102,57.14
Karthus,Khazix,359,147,212,40.95
Karthus,Sion,428,198,230,46.26
Karthus,Milio,339,140,199,41.3
Karthus,Evelynn,231,133,98,57.58
Karthus,Jayce,328,172,156,52.44
Karthus,Xayah,345,168,177,48.7
Karthus,Rakan,313,140,173,44.73
Karthus,Kayle,400,175,225,43.75
Karthus,Volibear,610,329,281,53.93
Karthus,Akali,682,365,317,53.52
Karthus,Skarner,157,76,81,48.41
Karthus,Kennen,235,123,112,52.34
Karthus,Maokai,306,127,179,41.5
Karthus,Galio,549,253,296,46.08
Karthus,JarvanIV,307,184,123,59.93
Karthus,Naafiri,215,109,106,50.7
Karthus,Kindred,299,173,126,57.86
Karthus,Fizz,233,138,95,59.23
Karthus,Zeri,299,147,152,49.16
Karthus,Hecarim,253,91,162,35.97
Karthus,Quinn,248,127,121,51.21
Karthus,Yuumi,530,227,303,42.83
Karthus,Gangplank,344,166,178,48.26
Karthus,Twitch,452,191,261,42.26
Karthus,Corki,227,137,90,60.35
Karthus,Zac,305,128,177,41.97
Karthus,Heimerdinger,299,190,109,63.55
Karthus,Lissandra,152,56,96,36.84
Karthus,Nidalee,224,103,121,45.98
Karthus,Olaf,144,70,74,48.61
Karthus,KogMaw,185,81,104,43.78
Karthus,Sylas,802,413,389,51.5
Karthus,Zoe,281,141,140,50.18
Karthus,Velkoz,306,130,176,42.48
Karthus,Akshan,189,111,78,58.73
Karthus,Qiyana,179,87,92,48.6
Karthus,Kalista,152,73,79,48.03
Karthus,Shyvana,122,59,63,48.36
Karthus,XinZhao,401,196,205,48.88
Karthus,RekSai,121,64,57,52.89
Karthus,Belveth,146,69,77,47.26
Karthus,Zilean,224,110,114,49.11
Karthus,Graves,465,263,202,56.56
Karthus,Cassiopeia,158,67,91,42.41
Karthus,Ornn,200,103,97,51.5
Anivia,Ambessa,457,206,251,45.08
Anivia,Xayah,373,207,166,55.5
Anivia,AurelionSol,344,179,165,52.03
Anivia,Khazix,343,172,171,50.15
Anivia,Nautilus,817,464,353,56.79
Anivia,Malphite,557,288,269,51.71
Anivia,Rengar,222,136,86,61.26
Anivia,Akali,638,345,293,54.08
Anivia,Ashe,1353,698,655,51.59
Anivia,Rakan,321,133,188,41.43
Anivia,Teemo,799,443,356,55.44
Anivia,Gragas,420,210,210,50
Anivia,Qiyana,145,89,56,61.38
Anivia,Caitlyn,1769,867,902,49.01
Anivia,Soraka,432,237,195,54.86
Anivia,Yasuo,1384,683,701,49.35
Anivia,Belveth,164,56,108,34.15
Anivia,Yone,1058,547,511,51.7
Anivia,Mordekaiser,990,483,507,48.79
Anivia,Alistar,298,162,136,54.36
Anivia,Sylas,936,468,468,50
Anivia,FiddleSticks,325,133,192,40.92
Anivia,Leblanc,412,197,215,47.82
Anivia,Aphelios,387,173,214,44.7
Anivia,Morgana,877,472,405,53.82
Anivia,Nasus,477,260,217,54.51
Anivia,Zed,761,383,378,50.33
Anivia,Malzahar,691,305,386,44.14
Anivia,Ezreal,1521,802,719,52.73
Anivia,Mel,1335,697,638,52.21
Anivia,Garen,1090,530,560,48.62
Anivia,LeeSin,1026,543,483,52.92
Anivia,Aurora,546,272,274,49.82
Anivia,MissFortune,1501,758,743,50.5
Anivia,Rell,381,220,161,57.74
Anivia,Heimerdinger,330,186,144,56.36
Anivia,Vi,660,316,344,47.88
Anivia,Vladimir,408,208,200,50.98
Anivia,Riven,334,167,167,50
Anivia,Katarina,567,327,240,57.67
Anivia,Kaisa,1296,667,629,51.47
Anivia,Kayle,560,275,285,49.11
Anivia,Trundle,402,201,201,50
Anivia,Senna,539,281,258,52.13
Anivia,Sett,1057,540,517,51.09
Anivia,Warwick,1031,520,511,50.44
Anivia,Smolder,465,242,223,52.04
Anivia,Seraphine,629,331,298,52.62
Anivia,Pantheon,1007,579,428,57.5
Anivia,Shaco,643,317,326,49.3
Anivia,Jhin,1352,759,593,56.14
Anivia,Ahri,962,469,493,48.75
Anivia,Pyke,596,293,303,49.16
Anivia,Nunu,403,212,191,52.61
Anivia,Thresh,983,480,503,48.83
Anivia,Syndra,643,328,315,51.01
Anivia,Tristana,797,412,385,51.69
Anivia,Zyra,667,339,328,50.82
Anivia,Evelynn,266,128,138,48.12
Anivia,Talon,463,236,227,50.97
Anivia,Irelia,536,259,277,48.32
Anivia,Yuumi,631,332,299,52.61
Anivia,Zac,339,181,158,53.39
Anivia,Viego,966,477,489,49.38
Anivia,Milio,413,202,211,48.91
Anivia,Hwei,423,177,246,41.84
Anivia,Volibear,778,442,336,56.81
Anivia,Naafiri,229,107,122,46.72
Anivia,XinZhao,433,209,224,48.27
Anivia,Veigar,730,403,327,55.21
Anivia,Draven,356,189,167,53.09
Anivia,Karma,887,441,446,49.72
Anivia,Orianna,350,204,146,58.29
Anivia,Lux,1610,791,819,49.13
Anivia,Shyvana,217,98,119,45.16
Anivia,Leona,583,298,285,51.11
Anivia,Kennen,203,96,107,47.29
Anivia,Ekko,565,285,280,50.44
Anivia,Varus,582,319,263,54.81
Anivia,Camille,289,161,128,55.71
Anivia,Jinx,1805,882,923,48.86
Anivia,Urgot,373,190,183,50.94
Anivia,Lucian,535,275,260,51.4
Anivia,Ornn,312,173,139,55.45
Anivia,Kayn,985,499,486,50.66
Anivia,Akshan,284,147,137,51.76
Anivia,Aatrox,670,353,317,52.69
Anivia,Lillia,337,211,126,62.61
Anivia,Galio,634,299,335,47.16
Anivia,Chogath,896,493,403,55.02
Anivia,Yorick,655,325,330,49.62
Anivia,Jax,620,328,292,52.9
Anivia,Janna,289,155,134,53.63
Anivia,TahmKench,565,300,265,53.1
Anivia,Brand,440,234,206,53.18
Anivia,Sion,624,323,301,51.76
Anivia,RekSai,108,54,54,50
Anivia,Viktor,667,398,269,59.67
Anivia,KogMaw,261,113,148,43.3
Anivia,Vayne,767,416,351,54.24
Anivia,Ivern,128,56,72,43.75
Anivia,Diana,1079,590,489,54.68
Anivia,Lulu,822,395,427,48.05
Anivia,Nocturne,769,387,382,50.33
Anivia,Samira,568,283,285,49.82
Anivia,Elise,546,299,247,54.76
Anivia,Blitzcrank,461,221,240,47.94
Anivia,Darius,1259,666,593,52.9
Anivia,DrMundo,456,252,204,55.26
Anivia,Maokai,361,210,151,58.17
Anivia,Gangplank,423,236,187,55.79
Anivia,Karthus,271,169,102,62.36
Anivia,Jayce,371,196,175,52.83
Anivia,Fiora,211,110,101,52.13
Anivia,Fizz,419,206,213,49.16
Anivia,Udyr,273,141,132,51.65
Anivia,Sejuani,324,134,190,41.36
Anivia,Gwen,376,203,173,53.99
Anivia,Nami,789,392,397,49.68
Anivia,Ryze,300,148,152,49.33
Anivia,Taliyah,186,105,81,56.45
Anivia,Kassadin,216,117,99,54.17
Anivia,MasterYi,818,400,418,48.9
Anivia,Sivir,406,189,217,46.55
Anivia,Skarner,194,93,101,47.94
Anivia,Briar,506,235,271,46.44
Anivia,Ziggs,288,146,142,50.69
Anivia,Tryndamere,386,193,193,50
Anivia,Kindred,308,137,171,44.48
Anivia,Rammus,223,98,125,43.95
Anivia,Illaoi,286,185,101,64.69
Anivia,Corki,248,146,102,58.87
Anivia,Lissandra,280,143,137,51.07
Anivia,JarvanIV,400,224,176,56
Anivia,Velkoz,469,231,238,49.25
Anivia,Renata,130,67,63,51.54
Anivia,Zilean,189,78,111,41.27
Anivia,Graves,474,300,174,63.29
Anivia,Gnar,372,176,196,47.31
Anivia,Swain,678,339,339,50
Anivia,Braum,411,191,220,46.47
Anivia,Vex,338,166,172,49.11
Anivia,Singed,205,112,93,54.63
Anivia,Neeko,341,190,151,55.72
Anivia,KSante,356,167,189,46.91
Anivia,Rumble,192,109,83,56.77
Anivia,Poppy,471,214,257,45.44
Anivia,Twitch,533,255,278,47.84
Anivia,Shen,446,204,242,45.74
Anivia,Xerath,606,350,256,57.76
Anivia,Hecarim,251,140,111,55.78
Anivia,Zeri,304,154,150,50.66
Anivia,Sona,204,107,97,52.45
Anivia,Zoe,301,147,154,48.84
Anivia,Annie,215,126,89,58.6
Anivia,Kalista,203,109,94,53.69
Anivia,Olaf,167,99,68,59.28
Anivia,Amumu,698,315,383,45.13
Anivia,Nilah,222,123,99,55.41
Anivia,Renekton,312,163,149,52.24
Anivia,Kled,118,54,64,45.76
Anivia,Bard,216,98,118,45.37
Anivia,Cassiopeia,289,144,145,49.83
Anivia,TwistedFate,262,126,136,48.09
Anivia,Quinn,180,95,85,52.78
Anivia,MonkeyKing,497,268,229,53.92
Anivia,Azir,214,116,98,54.21
Anivia,Taric,150,91,59,60.67
Anivia,Nidalee,193,116,77,60.1
KSante,Mordekaiser,1768,823,945,46.55
KSante,Vi,1138,547,591,48.07
KSante,Azir,424,195,229,45.99
KSante,MissFortune,2167,980,1187,45.22
KSante,Nautilus,1304,608,696,46.63
KSante,Volibear,1079,471,608,43.65
KSante,LeeSin,2077,959,1118,46.17
KSante,Kayle,698,296,402,42.41
KSante,Ezreal,2884,1463,1421,50.73
KSante,Morgana,1112,516,596,46.4
KSante,Sett,1811,827,984,45.67
KSante,Ambessa,1026,508,518,49.51
KSante,Smolder,755,382,373,50.6
KSante,Swain,1059,535,524,50.52
KSante,Malphite,924,481,443,52.06
KSante,FiddleSticks,569,233,336,40.95
KSante,Mel,2122,1036,1086,48.82
KSante,Soraka,618,262,356,42.39
KSante,Heimerdinger,356,149,207,41.85
KSante,Warwick,1258,630,628,50.08
KSante,Ashe,2473,1175,1298,47.51
KSante,Pyke,971,487,484,50.15
KSante,Sion,761,332,429,43.63
KSante,MasterYi,1137,562,575,49.43
KSante,AurelionSol,400,193,207,48.25
KSante,Nami,1044,443,601,42.43
KSante,Shyvana,253,128,125,50.59
KSante,Fizz,508,254,254,50
KSante,Nilah,344,156,188,45.35
KSante,Naafiri,318,127,191,39.94
KSante,Lux,2387,1118,1269,46.84
KSante,Aatrox,1358,647,711,47.64
KSante,Briar,698,317,381,45.42
KSante,Elise,924,451,473,48.81
KSante,Chogath,1118,518,600,46.33
KSante,Poppy,860,362,498,42.09
KSante,Irelia,975,482,493,49.44
KSante,Jhin,2096,948,1148,45.23
KSante,Leona,918,445,473,48.47
KSante,Aurora,827,416,411,50.3
KSante,Nocturne,1359,633,726,46.58
KSante,Leblanc,773,385,388,49.81
KSante,Janna,402,191,211,47.51
KSante,Akali,1295,581,714,44.86
KSante,Evelynn,384,173,211,45.05
KSante,Ahri,1526,731,795,47.9
KSante,Velkoz,548,243,305,44.34
KSante,Tristana,884,421,463,47.62
KSante,Vayne,1426,565,861,39.62
KSante,Zoe,441,176,265,39.91
KSante,Seraphine,809,358,451,44.25
KSante,Fiora,561,251,310,44.74
KSante,Shaco,1096,520,576,47.45
KSante,Nunu,525,286,239,54.48
KSante,Pantheon,1888,894,994,47.35
KSante,Yorick,809,286,523,35.35
KSante,Quinn,295,146,149,49.49
KSante,TahmKench,798,387,411,48.5
KSante,Gwen,745,358,387,48.05
KSante,Khazix,584,271,313,46.4
KSante,Katarina,815,389,426,47.73
KSante,Aphelios,680,315,365,46.32
KSante,Alistar,488,227,261,46.52
KSante,Garen,1995,828,1167,41.5
KSante,Diana,1850,869,981,46.97
KSante,Ryze,435,202,233,46.44
KSante,Darius,2212,1024,1188,46.29
KSante,Qiyana,258,114,144,44.19
KSante,Ziggs,369,185,184,50.14
KSante,JarvanIV,686,284,402,41.4
KSante,Ekko,992,484,508,48.79
KSante,Jinx,2906,1295,1611,44.56
KSante,Hecarim,504,232,272,46.03
KSante,Vex,515,238,277,46.21
KSante,Veigar,942,417,525,44.27
KSante,Amumu,949,395,554,41.62
KSante,Samira,789,343,446,43.47
KSante,Kayn,1389,586,803,42.19
KSante,Nasus,654,258,396,39.45
KSante,Xerath,1083,477,606,44.04
KSante,Thresh,1688,761,927,45.08
KSante,Vladimir,640,272,368,42.5
KSante,Caitlyn,2850,1396,1454,48.98
KSante,Yone,2067,936,1131,45.28
KSante,Lillia,692,271,421,39.16
KSante,Draven,575,280,295,48.7
KSante,Blitzcrank,870,409,461,47.01
KSante,Renekton,675,324,351,48
KSante,Lucian,852,397,455,46.6
KSante,Viego,1471,686,785,46.63
KSante,Viktor,1068,465,603,43.54
KSante,Ornn,626,320,306,51.12
KSante,Sylas,1700,866,834,50.94
KSante,Shen,671,302,369,45.01
KSante,Zed,1204,612,592,50.83
KSante,Brand,614,241,373,39.25
KSante,Kaisa,1968,910,1058,46.24
KSante,Riven,474,239,235,50.42
KSante,Rengar,462,266,196,57.58
KSante,Syndra,629,259,370,41.18
KSante,Twitch,778,347,431,44.6
KSante,Kled,213,103,110,48.36
KSante,Gragas,761,359,402,47.17
KSante,Teemo,831,352,479,42.36
KSante,Orianna,478,215,263,44.98
KSante,Rell,696,343,353,49.28
KSante,Singed,260,113,147,43.46
KSante,DrMundo,529,234,295,44.23
KSante,Yasuo,2277,1055,1222,46.33
KSante,Xayah,563,272,291,48.31
KSante,Trundle,595,207,388,34.79
KSante,Malzahar,1021,444,577,43.49
KSante,Varus,1100,546,554,49.64
KSante,Sona,292,123,169,42.12
KSante,Jax,888,432,456,48.65
KSante,Milio,624,280,344,44.87
KSante,Kassadin,244,104,140,42.62
KSante,Zyra,983,491,492,49.95
KSante,Camille,411,218,193,53.04
KSante,KogMaw,359,137,222,38.16
KSante,Yuumi,964,460,504,47.72
KSante,Senna,717,316,401,44.07
KSante,Gnar,588,263,325,44.73
KSante,Akshan,288,121,167,42.01
KSante,Urgot,456,229,227,50.22
KSante,Zac,686,326,360,47.52
KSante,Tryndamere,447,241,206,53.91
KSante,Karma,1553,671,882,43.21
KSante,Rakan,520,274,246,52.69
KSante,Gangplank,560,263,297,46.96
KSante,Corki,486,243,243,50
KSante,Sejuani,534,246,288,46.07
KSante,Nidalee,383,182,201,47.52
KSante,Illaoi,411,177,234,43.07
KSante,Udyr,445,257,188,57.75
KSante,Taric,210,89,121,42.38
KSante,MonkeyKing,742,322,420,43.4
KSante,Braum,657,270,387,41.1
KSante,Galio,1140,564,576,49.47
KSante,Ivern,212,69,143,32.55
KSante,Sivir,526,217,309,41.25
KSante,Zeri,627,262,365,41.79
KSante,Lulu,1745,825,920,47.28
KSante,Karthus,304,148,156,48.68
KSante,Annie,357,166,191,46.5
KSante,Taliyah,318,148,170,46.54
KSante,XinZhao,826,403,423,48.79
KSante,Jayce,672,294,378,43.75
KSante,Maokai,553,250,303,45.21
KSante,Rumble,356,194,162,54.49
KSante,Hwei,741,349,392,47.1
KSante,Renata,192,100,92,52.08
KSante,Graves,821,430,391,52.38
KSante,Lissandra,357,178,179,49.86
KSante,Kalista,349,194,155,55.59
KSante,Zilean,349,134,215,38.4
KSante,Belveth,275,137,138,49.82
KSante,TwistedFate,382,161,221,42.15
KSante,Talon,707,323,384,45.69
KSante,Anivia,356,189,167,53.09
KSante,Rammus,304,139,165,45.72
KSante,Olaf,260,132,128,50.77
KSante,Kindred,552,225,327,40.76
KSante,Kennen,251,97,154,38.65
KSante,Neeko,525,283,242,53.9
KSante,RekSai,219,104,115,47.49
KSante,Skarner,390,218,172,55.9
KSante,Bard,333,144,189,43.24
KSante,Cassiopeia,357,171,186,47.9
Tryndamere,Mordekaiser,1659,869,790,52.38
Tryndamere,Briar,855,415,440,48.54
Tryndamere,Zed,1169,633,536,54.15
Tryndamere,Jinx,3224,1567,1657,48.6
Tryndamere,Lulu,1321,681,640,51.55
Tryndamere,Nasus,928,403,525,43.43
Tryndamere,MonkeyKing,759,379,380,49.93
Tryndamere,Zoe,513,262,251,51.07
Tryndamere,Xayah,576,295,281,51.22
Tryndamere,Zac,396,207,189,52.27
Tryndamere,Jayce,465,223,242,47.96
Tryndamere,Rengar,472,229,243,48.52
Tryndamere,Swain,1142,520,622,45.53
Tryndamere,Ezreal,2353,1178,1175,50.06
Tryndamere,Sona,441,164,277,37.19
Tryndamere,Teemo,1549,724,825,46.74
Tryndamere,LeeSin,1450,838,612,57.79
Tryndamere,Chogath,1482,726,756,48.99
Tryndamere,Lucian,808,462,346,57.18
Tryndamere,Xerath,957,524,433,54.75
Tryndamere,Aatrox,935,444,491,47.49
Tryndamere,Twitch,923,480,443,52
Tryndamere,Veigar,1290,681,609,52.79
Tryndamere,Milio,742,344,398,46.36
Tryndamere,Darius,2442,1178,1264,48.24
Tryndamere,Aurora,884,506,378,57.24
Tryndamere,Brand,1013,510,503,50.35
Tryndamere,Thresh,1607,846,761,52.64
Tryndamere,FiddleSticks,602,289,313,48.01
Tryndamere,Viktor,900,428,472,47.56
Tryndamere,Pyke,1106,536,570,48.46
Tryndamere,Gnar,451,220,231,48.78
Tryndamere,Jax,1182,597,585,50.51
Tryndamere,Bard,359,149,210,41.5
Tryndamere,Yone,2146,1099,1047,51.21
Tryndamere,Kayn,1858,937,921,50.43
Tryndamere,Smolder,735,395,340,53.74
Tryndamere,Poppy,605,280,325,46.28
Tryndamere,Volibear,1460,682,778,46.71
Tryndamere,Ivern,164,83,81,50.61
Tryndamere,Irelia,902,475,427,52.66
Tryndamere,Caitlyn,3127,1495,1632,47.81
Tryndamere,Renekton,453,229,224,50.55
Tryndamere,Lillia,694,326,368,46.97
Tryndamere,Annie,372,152,220,40.86
Tryndamere,Kaisa,1661,857,804,51.6
Tryndamere,Singed,366,153,213,41.8
Tryndamere,Garen,2355,1220,1135,51.8
Tryndamere,KogMaw,401,208,193,51.87
Tryndamere,Lux,3237,1616,1621,49.92
Tryndamere,RekSai,136,60,76,44.12
Tryndamere,Leona,847,357,490,42.15
Tryndamere,Akshan,413,193,220,46.73
Tryndamere,Aphelios,620,305,315,49.19
Tryndamere,Braum,681,318,363,46.7
Tryndamere,Warwick,1979,865,1114,43.71
Tryndamere,Yasuo,2359,1218,1141,51.63
Tryndamere,Zilean,333,143,190,42.94
Tryndamere,Malphite,1601,730,871,45.6
Tryndamere,Samira,905,492,413,54.36
Tryndamere,Blitzcrank,846,379,467,44.8
Tryndamere,Ekko,1027,487,540,47.42
Tryndamere,Zeri,446,216,230,48.43
Tryndamere,Heimerdinger,658,316,342,48.02
Tryndamere,Udyr,498,259,239,52.01
Tryndamere,Akali,1194,573,621,47.99
Tryndamere,MissFortune,2793,1355,1438,48.51
Tryndamere,Gragas,649,294,355,45.3
Tryndamere,Fiora,441,230,211,52.15
Tryndamere,Shaco,1161,574,587,49.44
Tryndamere,Ahri,1522,749,773,49.21
Tryndamere,Nami,1123,551,572,49.07
Tryndamere,Jhin,2320,1186,1134,51.12
Tryndamere,Urgot,619,287,332,46.37
Tryndamere,Gwen,616,327,289,53.08
Tryndamere,JarvanIV,611,294,317,48.12
Tryndamere,Hwei,803,373,430,46.45
Tryndamere,Rammus,433,219,214,50.58
Tryndamere,Seraphine,914,478,436,52.3
Tryndamere,Velkoz,716,346,370,48.32
Tryndamere,Vladimir,696,376,320,54.02
Tryndamere,Zyra,913,442,471,48.41
Tryndamere,Corki,503,248,255,49.3
Tryndamere,Ziggs,442,228,214,51.58
Tryndamere,Camille,443,236,207,53.27
Tryndamere,Varus,930,427,503,45.91
Tryndamere,Yorick,1587,734,853,46.25
Tryndamere,Nunu,767,322,445,41.98
Tryndamere,Nidalee,312,165,147,52.88
Tryndamere,MasterYi,1489,753,736,50.57
Tryndamere,Kassadin,275,131,144,47.64
Tryndamere,Tristana,1218,630,588,51.72
Tryndamere,Trundle,778,410,368,52.7
Tryndamere,Rell,534,238,296,44.57
Tryndamere,Malzahar,1186,515,671,43.42
Tryndamere,Morgana,1564,743,821,47.51
Tryndamere,Graves,671,339,332,50.52
Tryndamere,Cassiopeia,403,200,203,49.63
Tryndamere,Ashe,2208,1083,1125,49.05
Tryndamere,Karma,1064,536,528,50.38
Tryndamere,Sett,1683,798,885,47.42
Tryndamere,Nocturne,1229,556,673,45.24
Tryndamere,Amumu,1207,550,657,45.57
Tryndamere,Ryze,414,195,219,47.1
Tryndamere,Senna,916,445,471,48.58
Tryndamere,Mel,2441,1230,1211,50.39
Tryndamere,Vi,1001,523,478,52.25
Tryndamere,Shen,767,385,382,50.2
Tryndamere,Leblanc,603,278,325,46.1
Tryndamere,TahmKench,1048,476,572,45.42
Tryndamere,Vayne,1362,650,712,47.72
Tryndamere,Diana,1711,860,851,50.26
Tryndamere,Qiyana,355,189,166,53.24
Tryndamere,Kindred,593,320,273,53.96
Tryndamere,Ambessa,799,398,401,49.81
Tryndamere,Vex,664,295,369,44.43
Tryndamere,Nautilus,1312,629,683,47.94
Tryndamere,Gangplank,581,283,298,48.71
Tryndamere,Riven,487,234,253,48.05
Tryndamere,Katarina,881,437,444,49.6
Tryndamere,Orianna,439,229,210,52.16
Tryndamere,Skarner,261,144,117,55.17
Tryndamere,Sylas,1296,643,653,49.61
Tryndamere,Janna,305,188,117,61.64
Tryndamere,KSante,447,206,241,46.09
Tryndamere,Yuumi,1028,586,442,57
Tryndamere,Sejuani,516,263,253,50.97
Tryndamere,Galio,879,460,419,52.33
Tryndamere,Soraka,701,320,381,45.65
Tryndamere,Karthus,290,145,145,50
Tryndamere,Pantheon,1808,881,927,48.73
Tryndamere,Olaf,270,127,143,47.04
Tryndamere,Kayle,836,407,429,48.68
Tryndamere,Draven,608,346,262,56.91
Tryndamere,Fizz,810,440,370,54.32
Tryndamere,Alistar,383,203,180,53
Tryndamere,Sion,944,447,497,47.35
Tryndamere,Viego,1688,860,828,50.95
Tryndamere,Naafiri,428,220,208,51.4
Tryndamere,Khazix,565,257,308,45.49
Tryndamere,Talon,644,312,332,48.45
Tryndamere,Belveth,302,156,146,51.66
Tryndamere,Rakan,527,292,235,55.41
Tryndamere,Ornn,466,237,229,50.86
Tryndamere,XinZhao,707,368,339,52.05
Tryndamere,Renata,236,115,121,48.73
Tryndamere,AurelionSol,510,243,267,47.65
Tryndamere,Azir,366,193,173,52.73
Tryndamere,Shyvana,258,107,151,41.47
Tryndamere,Quinn,473,256,217,54.12
Tryndamere,Taliyah,291,147,144,50.52
Tryndamere,Anivia,386,193,193,50
Tryndamere,Sivir,597,303,294,50.75
Tryndamere,Evelynn,440,251,189,57.05
Tryndamere,Elise,600,276,324,46
Tryndamere,Neeko,642,331,311,51.56
Tryndamere,Syndra,729,378,351,51.85
Tryndamere,Hecarim,463,241,222,52.05
Tryndamere,Nilah,611,249,362,40.75
Tryndamere,TwistedFate,376,195,181,51.86
Tryndamere,Taric,267,130,137,48.69
Tryndamere,Illaoi,602,294,308,48.84
Tryndamere,Maokai,426,241,185,56.57
Tryndamere,Kalista,423,180,243,42.55
Tryndamere,Rumble,185,115,70,62.16
Tryndamere,Kennen,283,150,133,53
Tryndamere,DrMundo,676,313,363,46.3
Tryndamere,Kled,231,105,126,45.45
Tryndamere,Lissandra,319,137,182,42.95
Janna,Mordekaiser,765,393,372,51.37
Janna,Briar,523,256,267,48.95
Janna,Zed,755,440,315,58.28
Janna,Jinx,1861,982,879,52.77
Janna,Lillia,370,170,200,45.95
Janna,Aatrox,664,370,294,55.72
Janna,Darius,1282,625,657,48.75
Janna,Aurora,586,307,279,52.39
Janna,Ezreal,1553,839,714,54.02
Janna,Brand,408,224,184,54.9
Janna,Gwen,420,255,165,60.71
Janna,Nunu,436,195,241,44.72
Janna,Caitlyn,1530,724,806,47.32
Janna,Vladimir,430,217,213,50.47
Janna,Lux,1455,683,772,46.94
Janna,Malphite,576,320,256,55.56
Janna,MonkeyKing,465,209,256,44.95
Janna,Sylas,746,422,324,56.57
Janna,Swain,682,370,312,54.25
Janna,Senna,563,288,275,51.15
Janna,Gangplank,415,230,185,55.42
Janna,Chogath,897,453,444,50.5
Janna,Galio,531,284,247,53.48
Janna,MissFortune,1338,670,668,50.07
Janna,Soraka,395,207,188,52.41
Janna,KSante,402,211,191,52.49
Janna,FiddleSticks,416,188,228,45.19
Janna,Ahri,825,408,417,49.45
Janna,Blitzcrank,518,251,267,48.46
Janna,Gragas,482,272,210,56.43
Janna,Veigar,597,271,326,45.39
Janna,Kalista,220,118,102,53.64
Janna,Zyra,543,268,275,49.36
Janna,Renekton,330,142,188,43.03
Janna,Kayn,1039,575,464,55.34
Janna,Leblanc,417,244,173,58.51
Janna,Mel,1371,721,650,52.59
Janna,Fiora,275,144,131,52.36
Janna,Evelynn,239,147,92,61.51
Janna,Tristana,672,382,290,56.85
Janna,Ambessa,499,270,229,54.11
Janna,Elise,642,321,321,50
Janna,Shen,468,231,237,49.36
Janna,Kaisa,1177,622,555,52.85
Janna,MasterYi,727,387,340,53.23
Janna,Ashe,1366,700,666,51.24
Janna,Kennen,282,150,132,53.19
Janna,Shaco,546,280,266,51.28
Janna,Twitch,581,305,276,52.5
Janna,Yuumi,598,346,252,57.86
Janna,Akali,692,388,304,56.07
Janna,Khazix,401,187,214,46.63
Janna,Irelia,562,255,307,45.37
Janna,Yorick,583,268,315,45.97
Janna,Vi,663,372,291,56.11
Janna,Katarina,584,281,303,48.12
Janna,Draven,376,168,208,44.68
Janna,Nautilus,779,376,403,48.27
Janna,Viego,882,393,489,44.56
Janna,Talon,466,260,206,55.79
Janna,Renata,140,58,82,41.43
Janna,Jayce,366,199,167,54.37
Janna,Neeko,365,194,171,53.15
Janna,Teemo,629,282,347,44.83
Janna,Yone,1131,578,553,51.11
Janna,Corki,301,177,124,58.8
Janna,Nasus,474,259,215,54.64
Janna,Rengar,301,160,141,53.16
Janna,Yasuo,1406,741,665,52.7
Janna,TahmKench,626,318,308,50.8
Janna,Warwick,895,451,444,50.39
Janna,Ekko,585,279,306,47.69
Janna,Seraphine,518,263,255,50.77
Janna,Sion,622,351,271,56.43
Janna,Xayah,367,213,154,58.04
Janna,Rakan,324,189,135,58.33
Janna,Nami,942,447,495,47.45
Janna,Jax,573,327,246,57.07
Janna,Amumu,652,310,342,47.55
Janna,LeeSin,952,556,396,58.4
Janna,Nocturne,715,364,351,50.91
Janna,Vayne,873,460,413,52.69
Janna,Milio,516,275,241,53.29
Janna,Kayle,473,205,268,43.34
Janna,Ornn,273,154,119,56.41
Janna,Thresh,1032,564,468,54.65
Janna,Qiyana,225,116,109,51.56
Janna,Viktor,660,331,329,50.15
Janna,Xerath,515,276,239,53.59
Janna,Kindred,318,201,117,63.21
Janna,Varus,585,333,252,56.92
Janna,Morgana,697,345,352,49.5
Janna,Samira,554,254,300,45.85
Janna,Rell,559,308,251,55.1
Janna,Leona,667,304,363,45.58
Janna,Zac,407,189,218,46.44
Janna,Pyke,616,333,283,54.06
Janna,Diana,1070,534,536,49.91
Janna,Tryndamere,305,117,188,38.36
Janna,Ziggs,258,132,126,51.16
Janna,JarvanIV,445,221,224,49.66
Janna,Karthus,209,94,115,44.98
Janna,Sett,835,424,411,50.78
Janna,Anivia,289,134,155,46.37
Janna,Karma,896,474,422,52.9
Janna,Garen,1083,522,561,48.2
Janna,Zoe,309,171,138,55.34
Janna,Gnar,331,169,162,51.06
Janna,Jhin,1289,688,601,53.37
Janna,Annie,206,119,87,57.77
Janna,Lucian,536,288,248,53.73
Janna,Udyr,275,167,108,60.73
Janna,Quinn,291,153,138,52.58
Janna,Aphelios,459,253,206,55.12
Janna,Hwei,479,268,211,55.95
Janna,Lulu,1101,564,537,51.23
Janna,Orianna,356,199,157,55.9
Janna,Volibear,770,375,395,48.7
Janna,Syndra,496,243,253,48.99
Janna,Naafiri,254,119,135,46.85
Janna,Bard,298,169,129,56.71
Janna,Malzahar,611,308,303,50.41
Janna,Sejuani,269,122,147,45.35
Janna,Zeri,327,165,162,50.46
Janna,Nidalee,173,98,75,56.65
Janna,Braum,369,177,192,47.97
Janna,Kassadin,150,81,69,54
Janna,Trundle,315,181,134,57.46
Janna,Urgot,378,153,225,40.48
Janna,DrMundo,296,126,170,42.57
Janna,Pantheon,1117,564,553,50.49
Janna,Riven,389,216,173,55.53
Janna,Lissandra,256,134,122,52.34
Janna,Sona,283,111,172,39.22
Janna,Olaf,198,112,86,56.57
Janna,Shyvana,192,109,83,56.77
Janna,Poppy,457,232,225,50.77
Janna,Singed,192,102,90,53.13
Janna,Ivern,102,45,57,44.12
Janna,Smolder,447,230,217,51.45
Janna,KogMaw,210,115,95,54.76
Janna,Fizz,360,185,175,51.39
Janna,AurelionSol,264,110,154,41.67
Janna,Graves,399,195,204,48.87
Janna,Sivir,390,177,213,45.38
Janna,Skarner,143,90,53,62.94
Janna,Kled,137,92,45,67.15
Janna,Cassiopeia,203,110,93,54.19
Janna,Zilean,267,139,128,52.06
Janna,Hecarim,307,169,138,55.05
Janna,Taliyah,216,132,84,61.11
Janna,Velkoz,383,187,196,48.83
Janna,Heimerdinger,267,113,154,42.32
Janna,Belveth,178,114,64,64.04
Janna,Alistar,320,152,168,47.5
Janna,Camille,364,189,175,51.92
Janna,Maokai,313,127,186,40.58
Janna,Rammus,232,135,97,58.19
Janna,Ryze,300,165,135,55
Janna,Azir,224,117,107,52.23
Janna,XinZhao,406,208,198,51.23
Janna,Vex,329,196,133,59.57
Janna,TwistedFate,210,105,105,50
Janna,Illaoi,283,165,118,58.3
Janna,Nilah,282,151,131,53.55
Janna,Taric,161,86,75,53.42
Janna,RekSai,108,50,58,46.3
Janna,Akshan,293,159,134,54.27
Janna,Rumble,180,105,75,58.33
Akshan,Darius,1399,705,694,50.39
Akshan,Samira,614,327,287,53.26
Akshan,Karma,790,345,445,43.67
Akshan,Rammus,235,113,122,48.09
Akshan,Blitzcrank,512,283,229,55.27
Akshan,DrMundo,437,211,226,48.28
Akshan,Ivern,165,93,72,56.36
Akshan,Mordekaiser,921,473,448,51.36
Akshan,Nilah,281,113,168,40.21
Akshan,Yuumi,611,293,318,47.95
Akshan,Teemo,963,497,466,51.61
Akshan,Amumu,740,289,451,39.05
Akshan,Garen,1107,536,571,48.42
Akshan,KogMaw,277,124,153,44.77
Akshan,Heimerdinger,403,208,195,51.61
Akshan,Vi,689,338,351,49.06
Akshan,Ahri,1085,508,577,46.82
Akshan,Maokai,339,172,167,50.74
Akshan,Kennen,185,93,92,50.27
Akshan,XinZhao,403,175,228,43.42
Akshan,Akali,766,464,302,60.57
Akshan,Kaisa,1074,550,524,51.21
Akshan,Caitlyn,1900,957,943,50.37
Akshan,Evelynn,262,138,124,52.67
Akshan,Sylas,792,432,360,54.55
Akshan,Ezreal,1456,774,682,53.16
Akshan,Seraphine,630,315,315,50
Akshan,Yasuo,1240,601,639,48.47
Akshan,Yone,1296,648,648,50
Akshan,Thresh,965,531,434,55.03
Akshan,Tryndamere,413,220,193,53.27
Akshan,MasterYi,793,417,376,52.59
Akshan,Orianna,333,167,166,50.15
Akshan,Tristana,746,347,399,46.51
Akshan,Lux,1930,924,1006,47.88
Akshan,TahmKench,691,371,320,53.69
Akshan,Nocturne,821,406,415,49.45
Akshan,Taric,157,74,83,47.13
Akshan,Sett,1010,465,545,46.04
Akshan,Elise,558,259,299,46.42
Akshan,Katarina,542,294,248,54.24
Akshan,MissFortune,1654,855,799,51.69
Akshan,Morgana,941,513,428,54.52
Akshan,Udyr,332,122,210,36.75
Akshan,Lulu,837,416,421,49.7
Akshan,Sejuani,284,166,118,58.45
Akshan,Jinx,1921,975,946,50.75
Akshan,Nautilus,747,349,398,46.72
Akshan,Warwick,1132,536,596,47.35
Akshan,Gangplank,422,211,211,50
Akshan,Poppy,456,244,212,53.51
Akshan,Riven,301,152,149,50.5
Akshan,Malzahar,807,390,417,48.33
Akshan,Bard,264,121,143,45.83
Akshan,Nunu,530,266,264,50.19
Akshan,Viktor,625,281,344,44.96
Akshan,Lucian,500,240,260,48
Akshan,Malphite,869,419,450,48.22
Akshan,Volibear,853,480,373,56.27
Akshan,Aurora,715,373,342,52.17
Akshan,Kayn,1104,639,465,57.88
Akshan,Smolder,500,282,218,56.4
Akshan,Alistar,247,108,139,43.72
Akshan,Shaco,650,343,307,52.77
Akshan,Mel,1528,813,715,53.21
Akshan,Milio,440,185,255,42.05
Akshan,Ryze,250,134,116,53.6
Akshan,Twitch,647,355,292,54.87
Akshan,Olaf,172,60,112,34.88
Akshan,Lillia,428,219,209,51.17
Akshan,Viego,1097,573,524,52.23
Akshan,Vladimir,510,221,289,43.33
Akshan,Nami,838,403,435,48.09
Akshan,Rengar,245,121,124,49.39
Akshan,Rell,344,195,149,56.69
Akshan,Jax,654,322,332,49.24
Akshan,Zed,779,409,370,52.5
Akshan,Ashe,1353,689,664,50.92
Akshan,Talon,440,209,231,47.5
Akshan,Shen,466,222,244,47.64
Akshan,Veigar,758,340,418,44.85
Akshan,Singed,189,83,106,43.92
Akshan,Jhin,1432,668,764,46.65
Akshan,Zyra,484,249,235,51.45
Akshan,Hecarim,351,168,183,47.86
Akshan,Syndra,399,199,200,49.87
Akshan,Kindred,293,126,167,43
Akshan,Taliyah,222,110,112,49.55
Akshan,Draven,458,231,227,50.44
Akshan,Xerath,541,278,263,51.39
Akshan,Zeri,332,187,145,56.33
Akshan,Pyke,600,322,278,53.67
Akshan,Ziggs,254,133,121,52.36
Akshan,Hwei,534,334,200,62.55
Akshan,Gwen,379,200,179,52.77
Akshan,Gragas,394,211,183,53.55
Akshan,Kalista,210,123,87,58.57
Akshan,Diana,990,480,510,48.48
Akshan,Cassiopeia,237,110,127,46.41
Akshan,Nasus,499,255,244,51.1
Akshan,KSante,288,167,121,57.99
Akshan,Fizz,380,187,193,49.21
Akshan,Graves,468,232,236,49.57
Akshan,Annie,232,95,137,40.95
Akshan,Anivia,284,137,147,48.24
Akshan,FiddleSticks,347,150,197,43.23
Akshan,Xayah,381,162,219,42.52
Akshan,Aatrox,660,344,316,52.12
Akshan,Kayle,565,312,253,55.22
Akshan,Varus,595,283,312,47.56
Akshan,Velkoz,410,228,182,55.61
Akshan,Sion,548,225,323,41.06
Akshan,JarvanIV,422,203,219,48.1
Akshan,Illaoi,336,209,127,62.2
Akshan,Neeko,403,231,172,57.32
Akshan,Swain,754,362,392,48.01
Akshan,Urgot,390,182,208,46.67
Akshan,LeeSin,840,433,407,51.55
Akshan,Renekton,367,174,193,47.41
Akshan,Kassadin,138,74,64,53.62
Akshan,Soraka,447,231,216,51.68
Akshan,Leona,603,302,301,50.08
Akshan,TwistedFate,278,151,127,54.32
Akshan,Vex,426,188,238,44.13
Akshan,Belveth,227,114,113,50.22
Akshan,Ambessa,511,252,259,49.32
Akshan,Vayne,996,476,520,47.79
Akshan,Trundle,470,185,285,39.36
Akshan,Naafiri,303,139,164,45.87
Akshan,Lissandra,215,106,109,49.3
Akshan,Ekko,672,342,330,50.89
Akshan,Corki,298,170,128,57.05
Akshan,Zac,305,166,139,54.43
Akshan,Briar,585,294,291,50.26
Akshan,Senna,612,288,324,47.06
Akshan,Fiora,343,191,152,55.69
Akshan,Leblanc,351,186,165,52.99
Akshan,Pantheon,1185,583,602,49.2
Akshan,Yorick,772,323,449,41.84
Akshan,Chogath,1014,522,492,51.48
Akshan,Rakan,380,184,196,48.42
Akshan,Brand,512,227,285,44.34
Akshan,AurelionSol,310,144,166,46.45
Akshan,Khazix,389,224,165,57.58
Akshan,Irelia,615,283,332,46.02
Akshan,Sivir,361,198,163,54.85
Akshan,Sona,210,118,92,56.19
Akshan,MonkeyKing,455,215,240,47.25
Akshan,Karthus,189,78,111,41.27
Akshan,RekSai,77,47,30,61.04
Akshan,Rumble,142,54,88,38.03
Akshan,Aphelios,467,250,217,53.53
Akshan,Jayce,338,147,191,43.49
Akshan,Ornn,316,129,187,40.82
Akshan,Galio,491,230,261,46.84
Akshan,Azir,264,135,129,51.14
Akshan,Qiyana,191,110,81,57.59
Akshan,Renata,200,85,115,42.5
Akshan,Zilean,227,115,112,50.66
Akshan,Quinn,274,161,113,58.76
Akshan,Gnar,265,141,124,53.21
Akshan,Janna,293,134,159,45.73
Akshan,Shyvana,182,108,74,59.34
Akshan,Camille,283,136,147,48.06
Akshan,Skarner,284,163,121,57.39
Akshan,Nidalee,235,131,104,55.74
Akshan,Zoe,391,223,168,57.03
Akshan,Kled,142,72,70,50.7
Akshan,Braum,387,171,216,44.19
Zilean,Chogath,833,433,400,51.98
Zilean,Morgana,798,449,349,56.27
Zilean,Yasuo,1263,621,642,49.17
Zilean,Jhin,1361,663,698,48.71
Zilean,Mel,1346,668,678,49.63
Zilean,Malphite,675,357,318,52.89
Zilean,Sett,859,409,450,47.61
Zilean,Sion,579,267,312,46.11
Zilean,Samira,449,234,215,52.12
Zilean,Alistar,294,173,121,58.84
Zilean,Poppy,387,213,174,55.04
Zilean,Khazix,369,183,186,49.59
Zilean,Irelia,566,278,288,49.12
Zilean,Tristana,552,288,264,52.17
Zilean,Neeko,332,204,128,61.45
Zilean,Jax,595,318,277,53.45
Zilean,Rammus,157,90,67,57.32
Zilean,Lux,1614,775,839,48.02
Zilean,Caitlyn,1756,904,852,51.48
Zilean,Nami,783,404,379,51.6
Zilean,Yone,1144,569,575,49.74
Zilean,Sylas,879,459,420,52.22
Zilean,Viktor,582,292,290,50.17
Zilean,Pyke,522,265,257,50.77
Zilean,Akali,562,293,269,52.14
Zilean,Warwick,820,403,417,49.15
Zilean,Aurora,551,270,281,49
Zilean,Xayah,272,147,125,54.04
Zilean,Nautilus,685,401,284,58.54
Zilean,Teemo,857,410,447,47.84
Zilean,Vi,594,306,288,51.52
Zilean,Bard,252,138,114,54.76
Zilean,Fiora,278,134,144,48.2
Zilean,Sejuani,267,117,150,43.82
Zilean,Ashe,1325,602,723,45.43
Zilean,Tryndamere,333,190,143,57.06
Zilean,Nocturne,922,466,456,50.54
Zilean,Seraphine,418,219,199,52.39
Zilean,Mordekaiser,813,364,449,44.77
Zilean,Galio,567,317,250,55.91
Zilean,Kayn,968,491,477,50.72
Zilean,Varus,583,307,276,52.66
Zilean,Blitzcrank,468,268,200,57.26
Zilean,Aatrox,707,369,338,52.19
Zilean,Kindred,316,188,128,59.49
Zilean,Swain,643,325,318,50.54
Zilean,Pantheon,1048,524,524,50
Zilean,Nilah,230,115,115,50
Zilean,Naafiri,241,125,116,51.87
Zilean,Draven,298,162,136,54.36
Zilean,Veigar,675,364,311,53.93
Zilean,Nasus,506,236,270,46.64
Zilean,Fizz,325,151,174,46.46
Zilean,Darius,1257,638,619,50.76
Zilean,MasterYi,719,382,337,53.13
Zilean,Kassadin,127,66,61,51.97
Zilean,Rell,340,178,162,52.35
Zilean,Yorick,582,287,295,49.31
Zilean,Lillia,370,189,181,51.08
Zilean,Trundle,300,160,140,53.33
Zilean,Vayne,733,377,356,51.43
Zilean,Thresh,1016,523,493,51.48
Zilean,Riven,319,149,170,46.71
Zilean,Singed,192,90,102,46.88
Zilean,Kennen,190,132,58,69.47
Zilean,Ekko,623,299,324,47.99
Zilean,Lucian,454,277,177,61.01
Zilean,Ambessa,384,213,171,55.47
Zilean,Qiyana,197,116,81,58.88
Zilean,Aphelios,405,195,210,48.15
Zilean,Velkoz,524,264,260,50.38
Zilean,Renekton,306,136,170,44.44
Zilean,Gwen,295,121,174,41.02
Zilean,Ornn,345,161,184,46.67
Zilean,MissFortune,1370,673,697,49.12
Zilean,Rakan,292,141,151,48.29
Zilean,Ahri,923,469,454,50.81
Zilean,Jinx,1735,893,842,51.47
Zilean,Soraka,389,194,195,49.87
Zilean,Zed,830,450,380,54.22
Zilean,Gangplank,340,182,158,53.53
Zilean,Quinn,230,111,119,48.26
Zilean,Viego,897,417,480,46.49
Zilean,Katarina,446,236,210,52.91
Zilean,Xerath,519,270,249,52.02
Zilean,Graves,459,240,219,52.29
Zilean,Diana,935,446,489,47.7
Zilean,Ezreal,1500,777,723,51.8
Zilean,Ziggs,229,120,109,52.4
Zilean,Malzahar,686,348,338,50.73
Zilean,Renata,145,75,70,51.72
Zilean,DrMundo,341,183,158,53.67
Zilean,Orianna,320,172,148,53.75
Zilean,Skarner,162,54,108,33.33
Zilean,Yuumi,621,290,331,46.7
Zilean,Lulu,1062,520,542,48.96
Zilean,Belveth,178,98,80,55.06
Zilean,Leona,536,271,265,50.56
Zilean,Gragas,412,218,194,52.91
Zilean,Rengar,244,148,96,60.66
Zilean,Illaoi,280,140,140,50
Zilean,Kaisa,1084,605,479,55.81
Zilean,Corki,302,158,144,52.32
Zilean,JarvanIV,431,203,228,47.1
Zilean,Twitch,571,317,254,55.52
Zilean,Sivir,401,196,205,48.88
Zilean,Ryze,254,124,130,48.82
Zilean,Senna,470,220,250,46.81
Zilean,Heimerdinger,347,189,158,54.47
Zilean,TahmKench,496,235,261,47.38
Zilean,Kled,147,79,68,53.74
Zilean,Evelynn,249,137,112,55.02
Zilean,Azir,251,128,123,51
Zilean,Volibear,729,381,348,52.26
Zilean,Shaco,622,344,278,55.31
Zilean,AurelionSol,270,138,132,51.11
Zilean,Smolder,467,253,214,54.18
Zilean,Gnar,285,149,136,52.28
Zilean,MonkeyKing,414,172,242,41.55
Zilean,Milio,401,181,220,45.14
Zilean,Braum,378,220,158,58.2
Zilean,Taric,85,48,37,56.47
Zilean,Sona,272,154,118,56.62
Zilean,Olaf,124,81,43,65.32
Zilean,Ivern,91,65,26,71.43
Zilean,Urgot,353,188,165,53.26
Zilean,Leblanc,310,156,154,50.32
Zilean,Kayle,466,251,215,53.86
Zilean,Syndra,420,238,182,56.67
Zilean,Amumu,690,322,368,46.67
Zilean,LeeSin,840,467,373,55.6
Zilean,Garen,1070,556,514,51.96
Zilean,Shyvana,158,103,55,65.19
Zilean,Briar,529,258,271,48.77
Zilean,Elise,444,254,190,57.21
Zilean,Karma,850,442,408,52
Zilean,Annie,210,96,114,45.71
Zilean,Zac,341,160,181,46.92
Zilean,KSante,349,215,134,61.6
Zilean,Hwei,466,255,211,54.72
Zilean,Zyra,502,252,250,50.2
Zilean,Hecarim,250,164,86,65.6
Zilean,Talon,410,203,207,49.51
Zilean,Nunu,383,195,188,50.91
Zilean,Vex,300,151,149,50.33
Zilean,Anivia,189,111,78,58.73
Zilean,Shen,463,212,251,45.79
Zilean,TwistedFate,223,125,98,56.05
Zilean,Udyr,275,132,143,48
Zilean,Brand,487,246,241,50.51
Zilean,Vladimir,438,230,208,52.51
Zilean,Jayce,397,211,186,53.15
Zilean,Janna,267,128,139,47.94
Zilean,Zoe,313,189,124,60.38
Zilean,KogMaw,216,96,120,44.44
Zilean,Zeri,272,160,112,58.82
Zilean,Rumble,183,111,72,60.66
Zilean,Lissandra,226,123,103,54.42
Zilean,Kalista,223,121,102,54.26
Zilean,Maokai,334,187,147,55.99
Zilean,FiddleSticks,338,171,167,50.59
Zilean,Karthus,224,114,110,50.89
Zilean,Nidalee,214,106,108,49.53
Zilean,Cassiopeia,171,98,73,57.31
Zilean,XinZhao,365,185,180,50.68
Zilean,Akshan,227,112,115,49.34
Zilean,Taliyah,205,91,114,44.39
Zilean,RekSai,82,42,40,51.22
Zilean,Camille,238,139,99,58.4
Olaf,Chogath,703,342,361,48.65
Olaf,Graves,332,155,177,46.69
Olaf,Leblanc,283,132,151,46.64
Olaf,Caitlyn,1248,621,627,49.76
Olaf,Milio,339,167,172,49.26
Olaf,Trundle,391,196,195,50.13
Olaf,Amumu,548,251,297,45.8
Olaf,Fizz,227,118,109,51.98
Olaf,Kaisa,790,403,387,51.01
Olaf,Pantheon,785,425,360,54.14
Olaf,Gangplank,261,152,109,58.24
Olaf,Warwick,772,394,378,51.04
Olaf,Malzahar,557,287,270,51.53
Olaf,Tristana,469,226,243,48.19
Olaf,Senna,411,158,253,38.44
Olaf,Darius,907,401,506,44.21
Olaf,Nami,454,249,205,54.85
Olaf,Rell,267,128,139,47.94
Olaf,Mordekaiser,1124,571,553,50.8
Olaf,Viego,730,311,419,42.6
Olaf,Irelia,286,138,148,48.25
Olaf,Udyr,184,96,88,52.17
Olaf,Aatrox,415,226,189,54.46
Olaf,Kayn,632,314,318,49.68
Olaf,Lux,1288,632,656,49.07
Olaf,Ezreal,1191,609,582,51.13
Olaf,Varus,560,299,261,53.39
Olaf,Briar,384,194,190,50.52
Olaf,Mel,1041,537,504,51.59
Olaf,Jinx,1240,664,576,53.55
Olaf,Blitzcrank,450,222,228,49.33
Olaf,Fiora,120,67,53,55.83
Olaf,Shaco,467,222,245,47.54
Olaf,Nunu,293,131,162,44.71
Olaf,Nilah,210,88,122,41.9
Olaf,Heimerdinger,287,129,158,44.95
Olaf,Evelynn,130,69,61,53.08
Olaf,Zoe,189,117,72,61.9
Olaf,Jax,502,237,265,47.21
Olaf,Yasuo,966,521,445,53.93
Olaf,Rengar,152,91,61,59.87
Olaf,Ivern,88,56,32,63.64
Olaf,Cassiopeia,217,126,91,58.06
Olaf,LeeSin,863,465,398,53.88
Olaf,Katarina,350,172,178,49.14
Olaf,MissFortune,1064,465,599,43.7
Olaf,Karma,545,242,303,44.4
Olaf,Yone,910,477,433,52.42
Olaf,Lulu,691,360,331,52.1
Olaf,Singed,143,52,91,36.36
Olaf,MonkeyKing,329,153,176,46.5
Olaf,Diana,646,313,333,48.45
Olaf,Volibear,551,269,282,48.82
Olaf,Talon,272,141,131,51.84
Olaf,Neeko,312,153,159,49.04
Olaf,Vladimir,304,132,172,43.42
Olaf,Akshan,172,112,60,65.12
Olaf,Pyke,441,250,191,56.69
Olaf,Ziggs,179,97,82,54.19
Olaf,Gragas,320,165,155,51.56
Olaf,Yuumi,413,198,215,47.94
Olaf,Camille,124,76,48,61.29
Olaf,Lillia,344,164,180,47.67
Olaf,Teemo,743,351,392,47.24
Olaf,Renekton,213,95,118,44.6
Olaf,TahmKench,467,234,233,50.11
Olaf,Kindred,279,145,134,51.97
Olaf,Ashe,1078,565,513,52.41
Olaf,Vex,309,178,131,57.61
Olaf,Aphelios,316,153,163,48.42
Olaf,Soraka,281,138,143,49.11
Olaf,Ornn,247,167,80,67.61
Olaf,Draven,298,130,168,43.62
Olaf,Sett,749,349,400,46.6
Olaf,Thresh,671,404,267,60.21
Olaf,MasterYi,558,230,328,41.22
Olaf,Galio,451,232,219,51.44
Olaf,Swain,482,244,238,50.62
Olaf,Lucian,391,196,195,50.13
Olaf,Nasus,355,193,162,54.37
Olaf,Kayle,279,120,159,43.01
Olaf,Akali,521,223,298,42.8
Olaf,Samira,285,152,133,53.33
Olaf,Renata,95,56,39,58.95
Olaf,Sejuani,202,108,94,53.47
Olaf,Ryze,192,89,103,46.35
Olaf,Velkoz,247,118,129,47.77
Olaf,Tryndamere,270,143,127,52.96
Olaf,Nautilus,707,364,343,51.49
Olaf,Nidalee,172,95,77,55.23
Olaf,Zed,506,269,237,53.16
Olaf,Veigar,519,259,260,49.9
Olaf,Vayne,568,284,284,50
Olaf,DrMundo,217,116,101,53.46
Olaf,Rammus,157,81,76,51.59
Olaf,Annie,160,72,88,45
Olaf,Garen,824,350,474,42.48
Olaf,Ahri,703,365,338,51.92
Olaf,JarvanIV,245,113,132,46.12
Olaf,Viktor,482,258,224,53.53
Olaf,Morgana,668,370,298,55.39
Olaf,Sylas,609,328,281,53.86
Olaf,Jhin,958,491,467,51.25
Olaf,Leona,453,237,216,52.32
Olaf,Vi,539,280,259,51.95
Olaf,Kled,102,40,62,39.22
Olaf,Nocturne,631,302,329,47.86
Olaf,Orianna,265,127,138,47.92
Olaf,AurelionSol,210,103,107,49.05
Olaf,Zyra,485,249,236,51.34
Olaf,Kassadin,68,31,37,45.59
Olaf,Braum,284,123,161,43.31
Olaf,Khazix,244,126,118,51.64
Olaf,Xerath,386,186,200,48.19
Olaf,Sivir,316,137,179,43.35
Olaf,Zilean,124,43,81,34.68
Olaf,TwistedFate,157,84,73,53.5
Olaf,Urgot,229,114,115,49.78
Olaf,Brand,308,138,170,44.81
Olaf,Xayah,277,139,138,50.18
Olaf,Seraphine,367,182,185,49.59
Olaf,Elise,337,173,164,51.34
Olaf,Poppy,358,219,139,61.17
Olaf,Malphite,460,286,174,62.17
Olaf,Taliyah,167,66,101,39.52
Olaf,Smolder,377,200,177,53.05
Olaf,Hwei,376,194,182,51.6
Olaf,Illaoi,286,132,154,46.15
Olaf,Janna,198,86,112,43.43
Olaf,Ekko,490,236,254,48.16
Olaf,Maokai,276,120,156,43.48
Olaf,Belveth,98,54,44,55.1
Olaf,Syndra,324,152,172,46.91
Olaf,Sona,131,44,87,33.59
Olaf,XinZhao,338,151,187,44.67
Olaf,Gwen,224,105,119,46.88
Olaf,Yorick,385,159,226,41.3
Olaf,Shyvana,106,52,54,49.06
Olaf,Lissandra,196,91,105,46.43
Olaf,Karthus,144,74,70,51.39
Olaf,Gnar,249,122,127,49
Olaf,Twitch,371,170,201,45.82
Olaf,Jayce,331,170,161,51.36
Olaf,Ambessa,313,155,158,49.52
Olaf,Shen,404,208,196,51.49
Olaf,Kalista,187,105,82,56.15
Olaf,Riven,166,89,77,53.61
Olaf,KSante,260,128,132,49.23
Olaf,Alistar,229,130,99,56.77
Olaf,Aurora,380,217,163,57.11
Olaf,Anivia,167,68,99,40.72
Olaf,Naafiri,142,69,73,48.59
Olaf,Sion,318,150,168,47.17
Olaf,Kennen,139,83,56,59.71
Olaf,Zac,234,126,108,53.85
Olaf,Azir,144,68,76,47.22
Olaf,Hecarim,184,91,93,49.46
Olaf,Quinn,151,70,81,46.36
Olaf,Bard,160,83,77,51.88
Olaf,Skarner,200,102,98,51
Olaf,Corki,218,101,117,46.33
Olaf,FiddleSticks,312,177,135,56.73
Olaf,Rakan,246,101,145,41.06
Olaf,Qiyana,165,94,71,56.97
Olaf,Zeri,264,150,114,56.82
Olaf,KogMaw,114,49,65,42.98
Olaf,Taric,92,35,57,38.04
Olaf,Rumble,219,116,103,52.97
Olaf,RekSai,43,22,21,51.16
Annie,Shen,358,165,193,46.09
Annie,Warwick,975,510,465,52.31
Annie,Diana,1034,495,539,47.87
Annie,Samira,510,254,256,49.8
Annie,Soraka,412,221,191,53.64
Annie,Kennen,169,90,79,53.25
Annie,Skarner,240,107,133,44.58
Annie,Malzahar,654,311,343,47.55
Annie,Jinx,1781,860,921,48.29
Annie,Yuumi,665,313,352,47.07
Annie,Tryndamere,372,220,152,59.14
Annie,Lux,1781,869,912,48.79
Annie,Sivir,382,159,223,41.62
Annie,Aatrox,675,318,357,47.11
Annie,Kayn,937,450,487,48.03
Annie,Veigar,735,352,383,47.89
Annie,Jhin,1340,661,679,49.33
Annie,Swain,741,326,415,43.99
Annie,Kled,126,69,57,54.76
Annie,Vi,621,295,326,47.5
Annie,Yasuo,1668,898,770,53.84
Annie,Zeri,332,161,171,48.49
Annie,Neeko,327,177,150,54.13
Annie,TahmKench,581,322,259,55.42
Annie,Gragas,451,237,214,52.55
Annie,Mel,1390,719,671,51.73
Annie,Gangplank,370,179,191,48.38
Annie,Sett,1046,444,602,42.45
Annie,Viktor,586,311,275,53.07
Annie,Caitlyn,1657,852,805,51.42
Annie,Lulu,910,457,453,50.22
Annie,Yorick,668,311,357,46.56
Annie,Ekko,559,292,267,52.24
Annie,Yone,1236,606,630,49.03
Annie,Thresh,923,426,497,46.15
Annie,Ivern,127,51,76,40.16
Annie,Katarina,567,263,304,46.38
Annie,Xayah,384,222,162,57.81
Annie,Garen,1026,484,542,47.17
Annie,Sion,495,252,243,50.91
Annie,Akali,747,398,349,53.28
Annie,Ezreal,1664,809,855,48.62
Annie,Varus,629,346,283,55.01
Annie,Viego,890,442,448,49.66
Annie,Fiora,264,127,137,48.11
Annie,Irelia,490,238,252,48.57
Annie,MasterYi,808,401,407,49.63
Annie,MissFortune,1424,706,718,49.58
Annie,Shaco,571,242,329,42.38
Annie,Rengar,221,141,80,63.8
Annie,Zed,780,415,365,53.21
Annie,Ashe,1520,727,793,47.83
Annie,Ambessa,429,208,221,48.48
Annie,Jax,633,317,316,50.08
Annie,Draven,405,199,206,49.14
Annie,Darius,1158,544,614,46.98
Annie,Sylas,764,407,357,53.27
Annie,Nidalee,233,129,104,55.36
Annie,Vex,438,220,218,50.23
Annie,Velkoz,397,173,224,43.58
Annie,Mordekaiser,852,373,479,43.78
Annie,Amumu,714,330,384,46.22
Annie,Kaisa,1131,642,489,56.76
Annie,Pyke,574,315,259,54.88
Annie,Kassadin,135,54,81,40
Annie,Galio,579,260,319,44.91
Annie,Poppy,386,223,163,57.77
Annie,Azir,224,123,101,54.91
Annie,Riven,335,159,176,47.46
Annie,Briar,464,207,257,44.61
Annie,Gnar,314,145,169,46.18
Annie,Teemo,946,467,479,49.37
Annie,Morgana,966,447,519,46.27
Annie,Aphelios,390,189,201,48.46
Annie,Pantheon,1026,560,466,54.58
Annie,Braum,379,190,189,50.13
Annie,Cassiopeia,215,112,103,52.09
Annie,Maokai,277,143,134,51.62
Annie,Kayle,466,235,231,50.43
Annie,LeeSin,1099,573,526,52.14
Annie,Nilah,228,111,117,48.68
Annie,Rell,335,169,166,50.45
Annie,Renekton,379,197,182,51.98
Annie,RekSai,127,59,68,46.46
Annie,Ziggs,251,116,135,46.22
Annie,Kindred,283,141,142,49.82
Annie,Lillia,389,205,184,52.7
Annie,Fizz,360,128,232,35.56
Annie,Corki,260,133,127,51.15
Annie,Bard,184,79,105,42.93
Annie,Ornn,320,176,144,55
Annie,Belveth,178,91,87,51.12
Annie,Taliyah,231,126,105,54.55
Annie,Camille,235,135,100,57.45
Annie,Gwen,374,167,207,44.65
Annie,Nasus,483,250,233,51.76
Annie,Akshan,232,137,95,59.05
Annie,Aurora,568,310,258,54.58
Annie,Evelynn,218,97,121,44.5
Annie,Malphite,625,344,281,55.04
Annie,Xerath,675,345,330,51.11
Annie,Seraphine,488,244,244,50
Annie,Nautilus,731,356,375,48.7
Annie,Illaoi,285,143,142,50.18
Annie,Nocturne,778,321,457,41.26
Annie,Ryze,193,103,90,53.37
Annie,Sona,232,141,91,60.78
Annie,Twitch,411,205,206,49.88
Annie,Graves,459,257,202,55.99
Annie,Elise,433,249,184,57.51
Annie,Smolder,414,209,205,50.48
Annie,Karthus,211,120,91,56.87
Annie,Heimerdinger,309,140,169,45.31
Annie,Senna,486,226,260,46.5
Annie,Khazix,360,159,201,44.17
Annie,Qiyana,162,88,74,54.32
Annie,Janna,206,87,119,42.23
Annie,Vladimir,444,249,195,56.08
Annie,Nami,719,337,382,46.87
Annie,Sejuani,340,159,181,46.76
Annie,MonkeyKing,375,196,179,52.27
Annie,Orianna,345,201,144,58.26
Annie,Olaf,160,88,72,55
Annie,Lucian,476,259,217,54.41
Annie,Vayne,762,411,351,53.94
Annie,KogMaw,221,123,98,55.66
Annie,Talon,454,226,228,49.78
Annie,Trundle,364,175,189,48.08
Annie,KSante,357,191,166,53.5
Annie,Ahri,1070,507,563,47.38
Annie,Blitzcrank,503,272,231,54.08
Annie,Zac,327,131,196,40.06
Annie,Nunu,424,209,215,49.29
Annie,Alistar,322,192,130,59.63
Annie,Singed,181,98,83,54.14
Annie,Rakan,312,145,167,46.47
Annie,Rammus,160,85,75,53.13
Annie,Lissandra,197,99,98,50.25
Annie,Leblanc,443,238,205,53.72
Annie,Hwei,413,233,180,56.42
Annie,Milio,374,142,232,37.97
Annie,Zilean,210,114,96,54.29
Annie,Leona,579,266,313,45.94
Annie,Zyra,631,320,311,50.71
Annie,Syndra,501,226,275,45.11
Annie,Naafiri,251,117,134,46.61
Annie,XinZhao,455,227,228,49.89
Annie,Chogath,839,381,458,45.41
Annie,Tristana,617,285,332,46.19
Annie,Quinn,259,129,130,49.81
Annie,Karma,784,409,375,52.17
Annie,Volibear,707,341,366,48.23
Annie,Shyvana,170,57,113,33.53
Annie,Zoe,259,124,135,47.88
Annie,Urgot,328,180,148,54.88
Annie,Rumble,199,104,95,52.26
Annie,Jayce,319,149,170,46.71
Annie,AurelionSol,268,127,141,47.39
Annie,Anivia,215,89,126,41.4
Annie,Kalista,179,94,85,52.51
Annie,Taric,139,59,80,42.45
Annie,DrMundo,405,171,234,42.22
Annie,TwistedFate,305,138,167,45.25
Annie,Hecarim,275,119,156,43.27
Annie,JarvanIV,455,199,256,43.74
Annie,Udyr,256,146,110,57.03
Annie,Renata,124,87,37,70.16
Annie,Brand,390,192,198,49.23
Annie,FiddleSticks,357,155,202,43.42
Camille,Gwen,389,192,197,49.36
Camille,Kayn,1037,514,523,49.57
Camille,Thresh,1109,556,553,50.14
Camille,Ezreal,2039,978,1061,47.96
Camille,Yuumi,794,390,404,49.12
Camille,Sett,1194,589,605,49.33
Camille,Ryze,286,153,133,53.5
Camille,Caitlyn,1847,885,962,47.92
Camille,Lulu,1162,537,625,46.21
Camille,Kalista,281,151,130,53.74
Camille,Gragas,509,270,239,53.05
Camille,Orianna,375,160,215,42.67
Camille,Gnar,319,174,145,54.55
Camille,Pyke,667,291,376,43.63
Camille,Aatrox,810,391,419,48.27
Camille,Chogath,840,400,440,47.62
Camille,Kaisa,1229,567,662,46.14
Camille,Morgana,788,351,437,44.54
Camille,Garen,1827,956,871,52.33
Camille,Rammus,237,113,124,47.68
Camille,Katarina,569,279,290,49.03
Camille,Milio,484,240,244,49.59
Camille,Shaco,700,348,352,49.71
Camille,Akali,753,396,357,52.59
Camille,Sivir,429,230,199,53.61
Camille,Renata,194,127,67,65.46
Camille,Renekton,461,248,213,53.8
Camille,Hecarim,310,167,143,53.87
Camille,Viktor,753,423,330,56.18
Camille,Jhin,1526,728,798,47.71
Camille,Leblanc,492,283,209,57.52
Camille,LeeSin,1224,616,608,50.33
Camille,TwistedFate,331,157,174,47.43
Camille,Zeri,401,199,202,49.63
Camille,Seraphine,619,322,297,52.02
Camille,Fiora,414,183,231,44.2
Camille,Nunu,461,222,239,48.16
Camille,Zed,894,442,452,49.44
Camille,Aphelios,448,216,232,48.21
Camille,Nami,865,449,416,51.91
Camille,Gangplank,389,147,242,37.79
Camille,Yone,1237,637,600,51.5
Camille,Lux,1857,886,971,47.71
Camille,Shen,572,271,301,47.38
Camille,Illaoi,351,171,180,48.72
Camille,Kindred,361,194,167,53.74
Camille,Talon,601,330,271,54.91
Camille,Varus,733,360,373,49.11
Camille,Mordekaiser,1045,452,593,43.25
Camille,Sejuani,381,166,215,43.57
Camille,Yasuo,1447,682,765,47.13
Camille,Velkoz,492,241,251,48.98
Camille,Darius,1382,709,673,51.3
Camille,Warwick,1091,491,600,45
Camille,Ashe,1626,810,816,49.82
Camille,Nautilus,819,368,451,44.93
Camille,Tryndamere,443,207,236,46.73
Camille,Zac,383,176,207,45.95
Camille,Galio,736,305,431,41.44
Camille,MissFortune,1504,715,789,47.54
Camille,Alistar,343,174,169,50.73
Camille,RekSai,87,39,48,44.83
Camille,Jax,766,327,439,42.69
Camille,Lucian,571,300,271,52.54
Camille,Riven,405,188,217,46.42
Camille,Khazix,434,194,240,44.7
Camille,Vex,424,204,220,48.11
Camille,Swain,665,251,414,37.74
Camille,Malzahar,638,355,283,55.64
Camille,Kled,123,54,69,43.9
Camille,Vi,736,380,356,51.63
Camille,Ahri,1074,555,519,51.68
Camille,Aurora,686,348,338,50.73
Camille,Lissandra,183,79,104,43.17
Camille,Briar,606,273,333,45.05
Camille,Mel,1653,835,818,50.51
Camille,Jinx,1910,873,1037,45.71
Camille,Pantheon,1283,601,682,46.84
Camille,Twitch,692,322,370,46.53
Camille,Vladimir,564,228,336,40.43
Camille,Braum,467,235,232,50.32
Camille,Karma,1047,477,570,45.56
Camille,Neeko,350,159,191,45.43
Camille,Volibear,843,381,462,45.2
Camille,Olaf,124,48,76,38.71
Camille,Diana,1185,564,621,47.59
Camille,Yorick,536,196,340,36.57
Camille,Brand,484,238,246,49.17
Camille,FiddleSticks,446,222,224,49.78
Camille,Sylas,1056,510,546,48.3
Camille,Poppy,502,240,262,47.81
Camille,Viego,935,398,537,42.57
Camille,Ziggs,289,124,165,42.91
Camille,Sona,238,72,166,30.25
Camille,Ekko,664,304,360,45.78
Camille,Vayne,960,471,489,49.06
Camille,TahmKench,634,311,323,49.05
Camille,Urgot,346,97,249,28.03
Camille,JarvanIV,488,215,273,44.06
Camille,Blitzcrank,549,274,275,49.91
Camille,Soraka,474,243,231,51.27
Camille,Shyvana,212,87,125,41.04
Camille,Senna,535,224,311,41.87
Camille,Trundle,300,175,125,58.33
Camille,Qiyana,216,93,123,43.06
Camille,Samira,511,236,275,46.18
Camille,Smolder,503,233,270,46.32
Camille,Tristana,716,371,345,51.82
Camille,Xerath,674,318,356,47.18
Camille,Malphite,639,303,336,47.42
Camille,Anivia,289,128,161,44.29
Camille,KSante,411,193,218,46.96
Camille,Zyra,681,321,360,47.14
Camille,Heimerdinger,238,103,135,43.28
Camille,Kayle,435,202,233,46.44
Camille,Amumu,672,308,364,45.83
Camille,Singed,218,106,112,48.62
Camille,Naafiri,272,104,168,38.24
Camille,MonkeyKing,557,242,315,43.45
Camille,Annie,235,100,135,42.55
Camille,Taliyah,226,101,125,44.69
Camille,Ivern,143,84,59,58.74
Camille,Kassadin,194,100,94,51.55
Camille,Irelia,548,303,245,55.29
Camille,Graves,629,302,327,48.01
Camille,Draven,407,190,217,46.68
Camille,Elise,650,325,325,50
Camille,Hwei,485,237,248,48.87
Camille,Rakan,345,134,211,38.84
Camille,Kennen,251,107,144,42.63
Camille,Maokai,294,139,155,47.28
Camille,Rengar,270,135,135,50
Camille,Cassiopeia,227,96,131,42.29
Camille,Belveth,161,76,85,47.2
Camille,KogMaw,222,111,111,50
Camille,Nocturne,900,388,512,43.11
Camille,Ambessa,773,414,359,53.56
Camille,MasterYi,855,410,445,47.95
Camille,DrMundo,382,177,205,46.34
Camille,Rumble,150,72,78,48
Camille,Zoe,356,209,147,58.71
Camille,Leona,580,296,284,51.03
Camille,Veigar,657,292,365,44.44
Camille,Rell,425,197,228,46.35
Camille,Ornn,359,163,196,45.4
Camille,Skarner,244,114,130,46.72
Camille,Nidalee,321,205,116,63.86
Camille,Karthus,238,102,136,42.86
Camille,Syndra,570,274,296,48.07
Camille,Teemo,820,358,462,43.66
Camille,Udyr,296,127,169,42.91
Camille,Sion,519,239,280,46.05
Camille,XinZhao,541,243,298,44.92
Camille,Fizz,392,150,242,38.27
Camille,Quinn,272,129,143,47.43
Camille,AurelionSol,323,145,178,44.89
Camille,Xayah,475,197,278,41.47
Camille,Lillia,414,260,154,62.8
Camille,Jayce,493,235,258,47.67
Camille,Evelynn,202,84,118,41.58
Camille,Nilah,284,115,169,40.49
Camille,Bard,310,138,172,44.52
Camille,Corki,415,195,220,46.99
Camille,Nasus,614,276,338,44.95
Camille,Azir,305,158,147,51.8
Camille,Janna,364,175,189,48.08
Camille,Taric,142,65,77,45.77
Camille,Akshan,283,147,136,51.94
Camille,Zilean,238,99,139,41.6
Nunu,Gnar,543,270,273,49.72
Nunu,Viego,1726,919,807,53.24
Nunu,Yone,2590,1304,1286,50.35
Nunu,Kaisa,1982,1014,968,51.16
Nunu,TahmKench,1097,523,574,47.68
Nunu,Jax,1128,607,521,53.81
Nunu,Elise,809,434,375,53.65
Nunu,Naafiri,547,274,273,50.09
Nunu,Jhin,2567,1324,1243,51.58
Nunu,Lulu,1365,696,669,50.99
Nunu,Sett,1980,880,1100,44.44
Nunu,Warwick,2075,969,1106,46.7
Nunu,Brand,1016,515,501,50.69
Nunu,Twitch,1057,554,503,52.41
Nunu,Morgana,1722,802,920,46.57
Nunu,TwistedFate,440,236,204,53.64
Nunu,LeeSin,1664,849,815,51.02
Nunu,Yasuo,2539,1186,1353,46.71
Nunu,Nilah,529,287,242,54.25
Nunu,Kennen,380,181,199,47.63
Nunu,MonkeyKing,810,391,419,48.27
Nunu,Vladimir,817,409,408,50.06
Nunu,Vayne,1407,717,690,50.96
Nunu,Thresh,1783,945,838,53
Nunu,Akali,1476,732,744,49.59
Nunu,Leblanc,603,289,314,47.93
Nunu,Tristana,1227,636,591,51.83
Nunu,Graves,849,377,472,44.41
Nunu,Katarina,952,503,449,52.84
Nunu,Seraphine,1194,607,587,50.84
Nunu,Heimerdinger,763,400,363,52.42
Nunu,Mordekaiser,2012,940,1072,46.72
Nunu,Ashe,2429,1094,1335,45.04
Nunu,Pyke,1258,690,568,54.85
Nunu,Samira,1093,584,509,53.43
Nunu,MasterYi,1543,701,842,45.43
Nunu,Orianna,534,257,277,48.13
Nunu,Malphite,1157,551,606,47.62
Nunu,Nautilus,1461,705,756,48.25
Nunu,Aatrox,1123,563,560,50.13
Nunu,Gragas,773,407,366,52.65
Nunu,Cassiopeia,389,206,183,52.96
Nunu,Irelia,1099,523,576,47.59
Nunu,Briar,1201,554,647,46.13
Nunu,Zoe,517,306,211,59.19
Nunu,Ezreal,2761,1507,1254,54.58
Nunu,Janna,436,241,195,55.28
Nunu,Kindred,617,347,270,56.24
Nunu,Yuumi,1192,644,548,54.03
Nunu,Darius,2462,1221,1241,49.59
Nunu,Senna,1036,471,565,45.46
Nunu,Azir,451,210,241,46.56
Nunu,Taric,283,124,159,43.82
Nunu,Rammus,309,191,118,61.81
Nunu,Renekton,630,327,303,51.9
Nunu,Zyra,1046,472,574,45.12
Nunu,KSante,525,239,286,45.52
Nunu,Olaf,293,159,134,54.27
Nunu,Aurora,1174,624,550,53.15
Nunu,Jinx,3170,1534,1636,48.39
Nunu,Lux,3558,1774,1784,49.86
Nunu,Nasus,960,488,472,50.83
Nunu,AurelionSol,579,260,319,44.91
Nunu,Rengar,506,255,251,50.4
Nunu,Ivern,265,142,123,53.58
Nunu,Garen,2111,1033,1078,48.93
Nunu,Diana,1904,887,1017,46.59
Nunu,Ryze,392,172,220,43.88
Nunu,Pantheon,2227,1080,1147,48.5
Nunu,Camille,461,239,222,51.84
Nunu,Lillia,880,432,448,49.09
Nunu,Udyr,524,305,219,58.21
Nunu,Skarner,425,218,207,51.29
Nunu,Rell,677,345,332,50.96
Nunu,Evelynn,558,298,260,53.41
Nunu,Taliyah,339,163,176,48.08
Nunu,Kayle,930,445,485,47.85
Nunu,Volibear,1506,762,744,50.6
Nunu,Rakan,583,281,302,48.2
Nunu,Singed,435,217,218,49.89
Nunu,Smolder,774,366,408,47.29
Nunu,Zed,1213,624,589,51.44
Nunu,Shen,837,434,403,51.85
Nunu,Veigar,1463,706,757,48.26
Nunu,MissFortune,3122,1544,1578,49.46
Nunu,Blitzcrank,1006,470,536,46.72
Nunu,Riven,545,300,245,55.05
Nunu,Akshan,530,264,266,49.81
Nunu,Poppy,760,351,409,46.18
Nunu,Anivia,403,191,212,47.39
Nunu,Kayn,1861,875,986,47.02
Nunu,Lucian,767,367,400,47.85
Nunu,Karma,1277,672,605,52.62
Nunu,Tryndamere,767,445,322,58.02
Nunu,Shaco,1227,689,538,56.15
Nunu,Talon,792,408,384,51.52
Nunu,Caitlyn,3470,1675,1795,48.27
Nunu,Malzahar,1350,642,708,47.56
Nunu,Teemo,1735,870,865,50.14
Nunu,Soraka,789,411,378,52.09
Nunu,Illaoi,709,336,373,47.39
Nunu,Chogath,1543,722,821,46.79
Nunu,Leona,1112,519,593,46.67
Nunu,Fiora,559,318,241,56.89
Nunu,Draven,658,339,319,51.52
Nunu,Vi,1163,597,566,51.33
Nunu,Kassadin,294,147,147,50
Nunu,Mel,2605,1351,1254,51.86
Nunu,Nidalee,354,183,171,51.69
Nunu,Vex,737,368,369,49.93
Nunu,Velkoz,813,380,433,46.74
Nunu,Hwei,925,460,465,49.73
Nunu,Sona,397,180,217,45.34
Nunu,Neeko,821,424,397,51.64
Nunu,Gwen,734,357,377,48.64
Nunu,Braum,690,312,378,45.22
Nunu,Ekko,1190,582,608,48.91
Nunu,Galio,1094,471,623,43.05
Nunu,Milio,682,357,325,52.35
Nunu,Alistar,405,221,184,54.57
Nunu,FiddleSticks,713,319,394,44.74
Nunu,Corki,527,264,263,50.09
Nunu,Swain,1282,516,766,40.25
Nunu,Amumu,1611,749,862,46.49
Nunu,Ahri,1757,937,820,53.33
Nunu,Xayah,762,402,360,52.76
Nunu,Sejuani,562,283,279,50.36
Nunu,Ziggs,516,272,244,52.71
Nunu,DrMundo,803,386,417,48.07
Nunu,Qiyana,343,181,162,52.77
Nunu,XinZhao,730,329,401,45.07
Nunu,Khazix,624,311,313,49.84
Nunu,Zac,541,304,237,56.19
Nunu,KogMaw,351,151,200,43.02
Nunu,Karthus,351,181,170,51.57
Nunu,Sion,1058,473,585,44.71
Nunu,Viktor,1010,555,455,54.95
Nunu,Sivir,713,356,357,49.93
Nunu,Varus,1203,623,580,51.79
Nunu,Belveth,320,145,175,45.31
Nunu,Shyvana,322,161,161,50
Nunu,Sylas,1674,847,827,50.6
Nunu,Nocturne,1563,791,772,50.61
Nunu,Aphelios,697,343,354,49.21
Nunu,Xerath,1041,476,565,45.73
Nunu,Bard,418,234,184,55.98
Nunu,Kled,161,67,94,41.61
Nunu,Yorick,1385,660,725,47.65
Nunu,Jayce,517,288,229,55.71
Nunu,Nami,1275,649,626,50.9
Nunu,Urgot,620,278,342,44.84
Nunu,Lissandra,420,198,222,47.14
Nunu,JarvanIV,767,357,410,46.54
Nunu,Ambessa,742,360,382,48.52
Nunu,Trundle,818,410,408,50.12
Nunu,Gangplank,524,256,268,48.85
Nunu,Maokai,648,347,301,53.55
Nunu,Annie,424,215,209,50.71
Nunu,Kalista,412,200,212,48.54
Nunu,Quinn,440,203,237,46.14
Nunu,Ornn,600,301,299,50.17
Nunu,Hecarim,610,329,281,53.93
Nunu,Fizz,715,365,350,51.05
Nunu,Zeri,562,300,262,53.38
Nunu,Zilean,383,188,195,49.09
Nunu,Rumble,286,145,141,50.7
Nunu,Syndra,800,401,399,50.13
Nunu,RekSai,194,101,93,52.06
Nunu,Renata,216,137,79,63.43
Lissandra,Sylas,896,420,476,46.88
Lissandra,Ekko,658,344,314,52.28
Lissandra,Talon,425,217,208,51.06
Lissandra,Jinx,1837,870,967,47.36
Lissandra,Pyke,543,294,249,54.14
Lissandra,Yone,1216,635,581,52.22
Lissandra,Yasuo,1732,865,867,49.94
Lissandra,Irelia,662,348,314,52.57
Lissandra,Morgana,826,371,455,44.92
Lissandra,Lux,1513,752,761,49.7
Lissandra,Fiora,257,142,115,55.25
Lissandra,Elise,504,284,220,56.35
Lissandra,Garen,1007,562,445,55.81
Lissandra,Ashe,1248,654,594,52.4
Lissandra,Senna,432,190,242,43.98
Lissandra,LeeSin,907,457,450,50.39
Lissandra,Hwei,401,150,251,37.41
Lissandra,Aurora,528,265,263,50.19
Lissandra,Yorick,628,294,334,46.82
Lissandra,Kayn,951,510,441,53.63
Lissandra,Jhin,1376,670,706,48.69
Lissandra,Thresh,981,538,443,54.84
Lissandra,DrMundo,304,167,137,54.93
Lissandra,Zed,1139,670,469,58.82
Lissandra,Caitlyn,1652,823,829,49.82
Lissandra,Lulu,982,510,472,51.93
Lissandra,Poppy,390,213,177,54.62
Lissandra,Kalista,256,122,134,47.66
Lissandra,Neeko,405,215,190,53.09
Lissandra,Kled,145,92,53,63.45
Lissandra,Nocturne,859,388,471,45.17
Lissandra,Malzahar,588,271,317,46.09
Lissandra,Kaisa,1117,597,520,53.45
Lissandra,Mel,1333,715,618,53.64
Lissandra,Zac,343,183,160,53.35
Lissandra,Amumu,661,337,324,50.98
Lissandra,Alistar,342,175,167,51.17
Lissandra,Camille,183,104,79,56.83
Lissandra,Karma,800,340,460,42.5
Lissandra,Kennen,201,81,120,40.3
Lissandra,Lucian,465,247,218,53.12
Lissandra,Nami,749,362,387,48.33
Lissandra,Teemo,795,376,419,47.3
Lissandra,Darius,1210,586,624,48.43
Lissandra,Seraphine,526,284,242,53.99
Lissandra,Velkoz,369,174,195,47.15
Lissandra,Shaco,656,348,308,53.05
Lissandra,Quinn,235,85,150,36.17
Lissandra,Briar,539,238,301,44.16
Lissandra,MasterYi,893,464,429,51.96
Lissandra,Milio,408,201,207,49.26
Lissandra,Diana,1090,569,521,52.2
Lissandra,Yuumi,620,332,288,53.55
Lissandra,Trundle,439,213,226,48.52
Lissandra,Katarina,587,296,291,50.43
Lissandra,Draven,352,211,141,59.94
Lissandra,Chogath,824,371,453,45.02
Lissandra,Taric,150,82,68,54.67
Lissandra,Ivern,89,46,43,51.69
Lissandra,Rell,384,223,161,58.07
Lissandra,Viego,921,426,495,46.25
Lissandra,Gnar,338,204,134,60.36
Lissandra,Lillia,405,244,161,60.25
Lissandra,Smolder,398,204,194,51.26
Lissandra,TahmKench,569,278,291,48.86
Lissandra,Pantheon,1048,546,502,52.1
Lissandra,Volibear,673,343,330,50.97
Lissandra,Tristana,656,328,328,50
Lissandra,Twitch,597,325,272,54.44
Lissandra,Ornn,253,110,143,43.48
Lissandra,Ezreal,1733,917,816,52.91
Lissandra,Blitzcrank,441,235,206,53.29
Lissandra,Sett,971,469,502,48.3
Lissandra,Khazix,384,217,167,56.51
Lissandra,Azir,219,96,123,43.84
Lissandra,Shen,477,270,207,56.6
Lissandra,Illaoi,341,159,182,46.63
Lissandra,Belveth,159,94,65,59.12
Lissandra,Xayah,375,184,191,49.07
Lissandra,Rakan,289,158,131,54.67
Lissandra,Sejuani,317,131,186,41.32
Lissandra,Leblanc,593,333,260,56.16
Lissandra,Swain,643,293,350,45.57
Lissandra,Sion,503,236,267,46.92
Lissandra,Aatrox,607,340,267,56.01
Lissandra,Vayne,852,453,399,53.17
Lissandra,Riven,347,171,176,49.28
Lissandra,Vi,621,312,309,50.24
Lissandra,Akali,811,325,486,40.07
Lissandra,Rumble,183,108,75,59.02
Lissandra,Vladimir,465,242,223,52.04
Lissandra,Ahri,925,456,469,49.3
Lissandra,Renata,139,91,48,65.47
Lissandra,MissFortune,1413,691,722,48.9
Lissandra,Gragas,432,224,208,51.85
Lissandra,Nasus,447,197,250,44.07
Lissandra,TwistedFate,267,150,117,56.18
Lissandra,Malphite,697,356,341,51.08
Lissandra,Gangplank,343,149,194,43.44
Lissandra,Braum,485,240,245,49.48
Lissandra,Varus,552,299,253,54.17
Lissandra,XinZhao,373,183,190,49.06
Lissandra,Gwen,354,167,187,47.18
Lissandra,Nunu,420,222,198,52.86
Lissandra,Mordekaiser,837,445,392,53.17
Lissandra,Viktor,598,282,316,47.16
Lissandra,Taliyah,177,88,89,49.72
Lissandra,Galio,569,305,264,53.6
Lissandra,Nautilus,772,412,360,53.37
Lissandra,Soraka,367,184,183,50.14
Lissandra,Zoe,263,163,100,61.98
Lissandra,Nilah,271,134,137,49.45
Lissandra,Ziggs,270,131,139,48.52
Lissandra,Cassiopeia,226,123,103,54.42
Lissandra,Leona,609,346,263,56.81
Lissandra,Syndra,375,215,160,57.33
Lissandra,FiddleSticks,313,184,129,58.79
Lissandra,Akshan,215,109,106,50.7
Lissandra,Qiyana,201,126,75,62.69
Lissandra,Rengar,282,160,122,56.74
Lissandra,Zyra,588,267,321,45.41
Lissandra,Renekton,373,210,163,56.3
Lissandra,Brand,419,216,203,51.55
Lissandra,Sivir,325,167,158,51.38
Lissandra,Nidalee,237,145,92,61.18
Lissandra,Kayle,462,213,249,46.1
Lissandra,Naafiri,260,140,120,53.85
Lissandra,Xerath,587,250,337,42.59
Lissandra,Graves,476,234,242,49.16
Lissandra,Zeri,276,162,114,58.7
Lissandra,Janna,256,122,134,47.66
Lissandra,Jayce,291,173,118,59.45
Lissandra,Aphelios,418,248,170,59.33
Lissandra,Annie,197,98,99,49.75
Lissandra,Warwick,977,437,540,44.73
Lissandra,Udyr,187,87,100,46.52
Lissandra,MonkeyKing,542,278,264,51.29
Lissandra,Samira,479,243,236,50.73
Lissandra,Rammus,235,120,115,51.06
Lissandra,KSante,357,179,178,50.14
Lissandra,AurelionSol,282,151,131,53.55
Lissandra,Shyvana,182,93,89,51.1
Lissandra,Ambessa,398,213,185,53.52
Lissandra,Maokai,281,128,153,45.55
Lissandra,Veigar,567,277,290,48.85
Lissandra,Urgot,334,156,178,46.71
Lissandra,JarvanIV,404,197,207,48.76
Lissandra,Anivia,280,137,143,48.93
Lissandra,Jax,530,269,261,50.75
Lissandra,Vex,290,123,167,42.41
Lissandra,Evelynn,281,155,126,55.16
Lissandra,Heimerdinger,308,147,161,47.73
Lissandra,Olaf,196,105,91,53.57
Lissandra,Karthus,152,96,56,63.16
Lissandra,Orianna,300,162,138,54
Lissandra,Corki,266,137,129,51.5
Lissandra,Zilean,226,103,123,45.58
Lissandra,Fizz,449,274,175,61.02
Lissandra,Ryze,198,121,77,61.11
Lissandra,Hecarim,249,142,107,57.03
Lissandra,RekSai,133,69,64,51.88
Lissandra,Singed,152,79,73,51.97
Lissandra,Sona,142,82,60,57.75
Lissandra,KogMaw,205,104,101,50.73
Lissandra,Bard,182,126,56,69.23
Lissandra,Kindred,263,118,145,44.87
Lissandra,Tryndamere,319,182,137,57.05
Lissandra,Skarner,168,92,76,54.76
Lissandra,Kassadin,152,62,90,40.79
Elise,Ryze,547,248,299,45.34
Elise,Nunu,809,375,434,46.35
Elise,Ahri,1955,976,979,49.92
Elise,Lucian,1124,582,542,51.78
Elise,Alistar,607,277,330,45.63
Elise,Yorick,1137,490,647,43.1
Elise,Volibear,1320,652,668,49.39
Elise,Veigar,1363,667,696,48.94
Elise,Caitlyn,3705,1898,1807,51.23
Elise,Sona,455,178,277,39.12
Elise,Ornn,659,318,341,48.25
Elise,Warwick,1736,751,985,43.26
Elise,TwistedFate,505,277,228,54.85
Elise,Morgana,1563,717,846,45.87
Elise,Gwen,788,349,439,44.29
Elise,Pantheon,2488,1298,1190,52.17
Elise,Mel,2761,1402,1359,50.78
Elise,Tristana,1314,622,692,47.34
Elise,Poppy,882,452,430,51.25
Elise,KSante,924,473,451,51.19
Elise,Jax,1346,677,669,50.3
Elise,Velkoz,840,359,481,42.74
Elise,Xayah,824,453,371,54.98
Elise,Rakan,829,418,411,50.42
Elise,Sett,2186,1024,1162,46.84
Elise,Talon,1082,562,520,51.94
Elise,Lissandra,504,220,284,43.65
Elise,Vayne,1841,902,939,49
Elise,Milio,926,423,503,45.68
Elise,Aurora,1212,540,672,44.55
Elise,Nocturne,1908,883,1025,46.28
Elise,Nilah,552,241,311,43.66
Elise,Soraka,888,454,434,51.13
Elise,Ambessa,1034,558,476,53.97
Elise,Sejuani,712,328,384,46.07
Elise,Karma,1939,910,1029,46.93
Elise,Nidalee,545,275,270,50.46
Elise,Vex,722,345,377,47.78
Elise,Sivir,829,424,405,51.15
Elise,TahmKench,1188,550,638,46.3
Elise,Gragas,997,492,505,49.35
Elise,Samira,896,434,462,48.44
Elise,Malphite,1342,650,692,48.44
Elise,Viktor,1458,789,669,54.12
Elise,Blitzcrank,1110,557,553,50.18
Elise,Rumble,449,231,218,51.45
Elise,Akshan,558,299,259,53.58
Elise,Ezreal,3996,2087,1909,52.23
Elise,Aatrox,1477,764,713,51.73
Elise,Chogath,1939,905,1034,46.67
Elise,Janna,642,321,321,50
Elise,Kayn,2068,992,1076,47.97
Elise,Graves,1015,479,536,47.19
Elise,Malzahar,1213,528,685,43.53
Elise,Ivern,293,143,150,48.81
Elise,FiddleSticks,772,399,373,51.68
Elise,Azir,554,277,277,50
Elise,Viego,2249,1101,1148,48.96
Elise,Aphelios,789,348,441,44.11
Elise,Diana,2214,1019,1195,46.03
Elise,Ashe,2999,1432,1567,47.75
Elise,Urgot,659,314,345,47.65
Elise,MasterYi,1605,829,776,51.65
Elise,Seraphine,1083,525,558,48.48
Elise,Garen,2256,964,1292,42.73
Elise,JarvanIV,951,457,494,48.05
Elise,Hwei,1140,621,519,54.47
Elise,Twitch,1104,549,555,49.73
Elise,Lulu,2117,1045,1072,49.36
Elise,Amumu,1351,593,758,43.89
Elise,Zed,1724,846,878,49.07
Elise,Ziggs,539,231,308,42.86
Elise,Rengar,627,330,297,52.63
Elise,Yasuo,2757,1322,1435,47.95
Elise,Nautilus,1599,820,779,51.28
Elise,MissFortune,2990,1293,1697,43.24
Elise,Pyke,1374,750,624,54.59
Elise,Renekton,931,473,458,50.81
Elise,Zeri,643,334,309,51.94
Elise,Shen,946,443,503,46.83
Elise,LeeSin,2777,1377,1400,49.59
Elise,Zac,810,407,403,50.25
Elise,Teemo,1608,706,902,43.91
Elise,AurelionSol,599,274,325,45.74
Elise,Fiora,650,286,364,44
Elise,Mordekaiser,1640,791,849,48.23
Elise,Briar,970,453,517,46.7
Elise,Rell,807,372,435,46.1
Elise,Kaisa,2700,1409,1291,52.19
Elise,Jinx,3728,1771,1957,47.51
Elise,XinZhao,1076,508,568,47.21
Elise,Yuumi,1300,671,629,51.62
Elise,Lillia,776,411,365,52.96
Elise,Draven,705,352,353,49.93
Elise,Thresh,2160,1074,1086,49.72
Elise,Naafiri,455,220,235,48.35
Elise,Kindred,730,347,383,47.53
Elise,Irelia,1221,588,633,48.16
Elise,Shaco,1504,738,766,49.07
Elise,Lux,3424,1679,1745,49.04
Elise,Swain,1269,654,615,51.54
Elise,Renata,265,143,122,53.96
Elise,Singed,383,195,188,50.91
Elise,Cassiopeia,486,261,225,53.7
Elise,Vladimir,1004,507,497,50.5
Elise,Belveth,379,203,176,53.56
Elise,Katarina,1186,639,547,53.88
Elise,Brand,967,542,425,56.05
Elise,Nasus,921,487,434,52.88
Elise,Vi,1369,684,685,49.96
Elise,Yone,2688,1291,1397,48.03
Elise,Darius,2708,1357,1351,50.11
Elise,Jhin,2846,1287,1559,45.22
Elise,Zyra,1242,549,693,44.2
Elise,Bard,541,283,258,52.31
Elise,Karthus,459,223,236,48.58
Elise,Nami,1663,776,887,46.66
Elise,Leblanc,970,514,456,52.99
Elise,Zoe,713,373,340,52.31
Elise,Ekko,1522,748,774,49.15
Elise,Kassadin,337,149,188,44.21
Elise,Sylas,2071,1027,1044,49.59
Elise,Smolder,937,476,461,50.8
Elise,Gangplank,915,470,445,51.37
Elise,Neeko,795,413,382,51.95
Elise,Braum,935,415,520,44.39
Elise,Quinn,490,213,277,43.47
Elise,Orianna,730,377,353,51.64
Elise,Leona,1125,599,526,53.24
Elise,Trundle,651,314,337,48.23
Elise,Skarner,502,287,215,57.17
Elise,Senna,1175,596,579,50.72
Elise,Sion,1168,502,666,42.98
Elise,MonkeyKing,884,442,442,50
Elise,Camille,650,325,325,50
Elise,Annie,433,184,249,42.49
Elise,Galio,1451,606,845,41.76
Elise,Varus,1404,696,708,49.57
Elise,Heimerdinger,585,279,306,47.69
Elise,Kled,319,132,187,41.38
Elise,Kayle,827,432,395,52.24
Elise,Illaoi,679,343,336,50.52
Elise,Gnar,697,392,305,56.24
Elise,Riven,727,366,361,50.34
Elise,Anivia,546,247,299,45.24
Elise,Rammus,378,178,200,47.09
Elise,Xerath,1425,674,751,47.3
Elise,Hecarim,631,320,311,50.71
Elise,Fizz,794,397,397,50
Elise,Syndra,1020,513,507,50.29
Elise,Akali,1483,746,737,50.3
Elise,Taric,351,145,206,41.31
Elise,Kalista,542,316,226,58.3
Elise,DrMundo,761,355,406,46.65
Elise,Olaf,337,161,176,47.77
Elise,Taliyah,381,204,177,53.54
Elise,Jayce,802,392,410,48.88
Elise,Zilean,444,190,254,42.79
Elise,Corki,676,344,332,50.89
Elise,Maokai,744,317,427,42.61
Elise,Shyvana,358,158,200,44.13
Elise,Tryndamere,600,324,276,54
Elise,Udyr,569,291,278,51.14
Elise,Qiyana,466,243,223,52.15
Elise,Khazix,840,411,429,48.93
Elise,Kennen,580,327,253,56.38
Elise,RekSai,240,98,142,40.83
Elise,KogMaw,462,235,227,50.87
Elise,Evelynn,627,270,357,43.06
Jayce,Tryndamere,465,242,223,52.04
Jayce,Gragas,697,321,376,46.05
Jayce,Irelia,1023,498,525,48.68
Jayce,Kalista,385,177,208,45.97
Jayce,Twitch,592,285,307,48.14
Jayce,DrMundo,555,241,314,43.42
Jayce,Shaco,925,474,451,51.24
Jayce,Leblanc,740,404,336,54.59
Jayce,Xayah,508,232,276,45.67
Jayce,Karma,1495,748,747,50.03
Jayce,Akali,1066,531,535,49.81
Jayce,Naafiri,285,122,163,42.81
Jayce,Kayle,518,245,273,47.3
Jayce,MissFortune,1846,861,985,46.64
Jayce,Smolder,647,327,320,50.54
Jayce,Trundle,469,231,238,49.25
Jayce,Ahri,1414,664,750,46.96
Jayce,Ashe,2305,1123,1182,48.72
Jayce,Nami,858,391,467,45.57
Jayce,TahmKench,711,329,382,46.27
Jayce,Jax,890,440,450,49.44
Jayce,Malzahar,852,386,466,45.31
Jayce,Jinx,2850,1424,1426,49.96
Jayce,Mordekaiser,1022,466,556,45.6
Jayce,Sett,1282,629,653,49.06
Jayce,LeeSin,2198,1093,1105,49.73
Jayce,Nasus,600,232,368,38.67
Jayce,Kaisa,1663,801,862,48.17
Jayce,Bard,370,165,205,44.59
Jayce,Gangplank,712,338,374,47.47
Jayce,Rengar,313,159,154,50.8
Jayce,Yasuo,1968,854,1114,43.39
Jayce,Kennen,390,174,216,44.62
Jayce,Aatrox,1227,552,675,44.99
Jayce,Diana,1629,747,882,45.86
Jayce,Mel,2008,999,1009,49.75
Jayce,Rell,496,248,248,50
Jayce,Amumu,878,423,455,48.18
Jayce,Senna,818,410,408,50.12
Jayce,Yone,2004,1078,926,53.79
Jayce,Viego,1496,681,815,45.52
Jayce,Ezreal,3140,1636,1504,52.1
Jayce,Blitzcrank,819,432,387,52.75
Jayce,Morgana,1011,442,569,43.72
Jayce,Vi,1146,620,526,54.1
Jayce,Yuumi,897,391,506,43.59
Jayce,Yorick,921,407,514,44.19
Jayce,Khazix,519,274,245,52.79
Jayce,Aurora,961,509,452,52.97
Jayce,Garen,1354,539,815,39.81
Jayce,Varus,1079,561,518,51.99
Jayce,Swain,884,428,456,48.42
Jayce,Darius,1791,886,905,49.47
Jayce,Kayn,1163,555,608,47.72
Jayce,Janna,366,167,199,45.63
Jayce,Talon,732,339,393,46.31
Jayce,Caitlyn,2484,1115,1369,44.89
Jayce,Lillia,599,322,277,53.76
Jayce,Briar,627,276,351,44.02
Jayce,Veigar,794,387,407,48.74
Jayce,Viktor,956,452,504,47.28
Jayce,Kindred,504,236,268,46.83
Jayce,Katarina,782,406,376,51.92
Jayce,Aphelios,545,273,272,50.09
Jayce,Brand,562,264,298,46.98
Jayce,Renekton,499,242,257,48.5
Jayce,Warwick,1122,542,580,48.31
Jayce,Gwen,382,178,204,46.6
Jayce,Tristana,803,395,408,49.19
Jayce,Illaoi,394,225,169,57.11
Jayce,Rammus,259,122,137,47.1
Jayce,Kled,165,84,81,50.91
Jayce,Alistar,455,247,208,54.29
Jayce,Pantheon,1561,741,820,47.47
Jayce,MasterYi,1090,534,556,48.99
Jayce,Ryze,358,151,207,42.18
Jayce,Pyke,915,453,462,49.51
Jayce,Galio,936,403,533,43.06
Jayce,Singed,301,144,157,47.84
Jayce,Lux,2030,973,1057,47.93
Jayce,AurelionSol,456,201,255,44.08
Jayce,Neeko,518,217,301,41.89
Jayce,Braum,627,342,285,54.55
Jayce,Nocturne,1062,487,575,45.86
Jayce,Hwei,636,282,354,44.34
Jayce,Draven,490,207,283,42.24
Jayce,Graves,875,491,384,56.11
Jayce,Samira,676,328,348,48.52
Jayce,Thresh,1559,763,796,48.94
Jayce,Seraphine,731,342,389,46.79
Jayce,TwistedFate,411,211,200,51.34
Jayce,Vayne,1096,508,588,46.35
Jayce,KogMaw,275,130,145,47.27
Jayce,Nunu,517,229,288,44.29
Jayce,Gnar,513,242,271,47.17
Jayce,Syndra,607,307,300,50.58
Jayce,Sejuani,477,207,270,43.4
Jayce,Chogath,1104,514,590,46.56
Jayce,Zed,1109,540,569,48.69
Jayce,Zac,509,237,272,46.56
Jayce,Xerath,1006,484,522,48.11
Jayce,Lucian,781,379,402,48.53
Jayce,Lulu,1567,835,732,53.29
Jayce,Ambessa,884,419,465,47.4
Jayce,Udyr,338,145,193,42.9
Jayce,Corki,437,206,231,47.14
Jayce,Poppy,682,329,353,48.24
Jayce,Ziggs,344,151,193,43.9
Jayce,Milio,518,206,312,39.77
Jayce,Orianna,592,329,263,55.57
Jayce,Ivern,207,93,114,44.93
Jayce,Shen,523,254,269,48.57
Jayce,Hecarim,412,238,174,57.77
Jayce,Ekko,756,380,376,50.26
Jayce,KSante,672,378,294,56.25
Jayce,Teemo,1251,583,668,46.6
Jayce,Skarner,256,170,86,66.41
Jayce,Cassiopeia,320,188,132,58.75
Jayce,Soraka,589,321,268,54.5
Jayce,Belveth,207,88,119,42.51
Jayce,Anivia,371,175,196,47.17
Jayce,Velkoz,532,245,287,46.05
Jayce,Nilah,341,133,208,39
Jayce,Sona,286,113,173,39.51
Jayce,Fiora,390,196,194,50.26
Jayce,Vladimir,696,348,348,50
Jayce,Nautilus,1152,546,606,47.4
Jayce,Taliyah,339,145,194,42.77
Jayce,Karthus,328,156,172,47.56
Jayce,Rakan,533,287,246,53.85
Jayce,Lissandra,291,118,173,40.55
Jayce,Azir,449,206,243,45.88
Jayce,Elise,802,410,392,51.12
Jayce,Quinn,415,170,245,40.96
Jayce,Malphite,1061,509,552,47.97
Jayce,Heimerdinger,509,210,299,41.26
Jayce,XinZhao,717,355,362,49.51
Jayce,Rumble,416,209,207,50.24
Jayce,Shyvana,182,95,87,52.2
Jayce,Riven,463,247,216,53.35
Jayce,Fizz,506,244,262,48.22
Jayce,Maokai,431,166,265,38.52
Jayce,Volibear,888,443,445,49.89
Jayce,Camille,493,258,235,52.33
Jayce,Jhin,2042,1005,1037,49.22
Jayce,Qiyana,334,178,156,53.29
Jayce,MonkeyKing,725,366,359,50.48
Jayce,Renata,189,98,91,51.85
Jayce,Zeri,548,303,245,55.29
Jayce,Zilean,397,186,211,46.85
Jayce,Sion,670,307,363,45.82
Jayce,Olaf,331,161,170,48.64
Jayce,Leona,762,371,391,48.69
Jayce,Sylas,1520,817,703,53.75
Jayce,Sivir,557,286,271,51.35
Jayce,Annie,319,170,149,53.29
Jayce,Zyra,1005,414,591,41.19
Jayce,Kassadin,203,117,86,57.64
Jayce,Urgot,388,178,210,45.88
Jayce,Evelynn,313,164,149,52.4
Jayce,Akshan,338,191,147,56.51
Jayce,Zoe,426,178,248,41.78
Jayce,JarvanIV,629,270,359,42.93
Jayce,FiddleSticks,541,273,268,50.46
Jayce,Ornn,363,157,206,43.25
Jayce,Vex,526,232,294,44.11
Jayce,Taric,189,78,111,41.27
Jayce,Nidalee,434,220,214,50.69
Jayce,RekSai,149,94,55,63.09
Sion,Teemo,2402,1244,1158,51.79
Sion,Amumu,1775,799,976,45.01
Sion,Garen,2476,1162,1314,46.93
Sion,KogMaw,583,265,318,45.45
Sion,Yuumi,1307,629,678,48.13
Sion,Fiora,739,369,370,49.93
Sion,Kayn,2302,1104,1198,47.96
Sion,Malzahar,1756,863,893,49.15
Sion,Aphelios,1105,621,484,56.2
Sion,Zilean,579,312,267,53.89
Sion,KSante,761,429,332,56.37
Sion,Udyr,722,358,364,49.58
Sion,Veigar,1639,752,887,45.88
Sion,Ashe,3067,1660,1407,54.12
Sion,Nautilus,1794,934,860,52.06
Sion,Yasuo,2939,1564,1375,53.22
Sion,Belveth,397,188,209,47.36
Sion,Yone,3059,1529,1530,49.98
Sion,Mordekaiser,2024,1004,1020,49.6
Sion,Alistar,699,352,347,50.36
Sion,Poppy,911,483,428,53.02
Sion,Khazix,867,497,370,57.32
Sion,Irelia,1278,646,632,50.55
Sion,Tristana,1539,783,756,50.88
Sion,Neeko,841,477,364,56.72
Sion,Gnar,662,350,312,52.87
Sion,Volibear,1752,857,895,48.92
Sion,Mel,3302,1785,1517,54.06
Sion,Samira,1161,664,497,57.19
Sion,Seraphine,1329,747,582,56.21
Sion,Nasus,1238,599,639,48.38
Sion,Pantheon,2515,1352,1163,53.76
Sion,Zoe,651,372,279,57.14
Sion,Senna,1273,665,608,52.24
Sion,TahmKench,1388,707,681,50.94
Sion,Jax,1234,620,614,50.24
Sion,Jinx,4070,2022,2048,49.68
Sion,Akali,1601,832,769,51.97
Sion,Zac,842,390,452,46.32
Sion,Diana,2389,1194,1195,49.98
Sion,Vayne,2195,1035,1160,47.15
Sion,Caitlyn,3952,2050,1902,51.87
Sion,Ornn,679,310,369,45.66
Sion,Shaco,1461,844,617,57.77
Sion,Hwei,1074,565,509,52.61
Sion,Karma,1655,824,831,49.79
Sion,Singed,606,248,358,40.92
Sion,Kindred,757,432,325,57.07
Sion,Katarina,1157,584,573,50.48
Sion,Kaisa,2567,1369,1198,53.33
Sion,Morgana,1818,916,902,50.39
Sion,Illaoi,710,360,350,50.7
Sion,Jhin,3064,1611,1453,52.58
Sion,Leona,1284,670,614,52.18
Sion,Darius,3177,1668,1509,52.5
Sion,Ekko,1404,742,662,52.85
Sion,Nami,1783,922,861,51.71
Sion,Viego,2342,1206,1136,51.49
Sion,Ezreal,3591,1869,1722,52.05
Sion,Blitzcrank,1140,600,540,52.63
Sion,Braum,884,443,441,50.11
Sion,Talon,998,562,436,56.31
Sion,Galio,1464,722,742,49.32
Sion,Lucian,1171,598,573,51.07
Sion,Milio,1022,517,505,50.59
Sion,Briar,1248,640,608,51.28
Sion,Annie,495,243,252,49.09
Sion,Xerath,1261,596,665,47.26
Sion,Thresh,2465,1314,1151,53.31
Sion,Warwick,2351,1183,1168,50.32
Sion,Kalista,444,248,196,55.86
Sion,Skarner,514,318,196,61.87
Sion,Lillia,997,467,530,46.84
Sion,Lulu,2106,1054,1052,50.05
Sion,Renekton,643,352,291,54.74
Sion,Gragas,962,506,456,52.6
Sion,Viktor,1285,618,667,48.09
Sion,MasterYi,1761,879,882,49.91
Sion,Taliyah,483,251,232,51.97
Sion,Smolder,1211,603,608,49.79
Sion,Graves,1016,499,517,49.11
Sion,Lux,3803,1986,1817,52.22
Sion,Soraka,950,485,465,51.05
Sion,DrMundo,782,397,385,50.77
Sion,Rengar,526,322,204,61.22
Sion,LeeSin,2070,1168,902,56.43
Sion,Zed,1843,1013,830,54.96
Sion,MissFortune,3476,1858,1618,53.45
Sion,Vi,1560,782,778,50.13
Sion,Ryze,512,262,250,51.17
Sion,Janna,622,271,351,43.57
Sion,Vladimir,1037,511,526,49.28
Sion,Draven,901,467,434,51.83
Sion,Swain,1524,718,806,47.11
Sion,Aurora,1257,668,589,53.14
Sion,Yorick,1597,791,806,49.53
Sion,Sett,2703,1369,1334,50.65
Sion,Varus,1439,775,664,53.86
Sion,Gwen,1200,624,576,52
Sion,AurelionSol,709,354,355,49.93
Sion,Sona,442,196,246,44.34
Sion,Malphite,1603,844,759,52.65
Sion,Qiyana,495,264,231,53.33
Sion,Ambessa,972,479,493,49.28
Sion,Vex,956,515,441,53.87
Sion,Pyke,1357,733,624,54.02
Sion,Trundle,1065,497,568,46.67
Sion,Zyra,1439,755,684,52.47
Sion,Syndra,1041,520,521,49.95
Sion,Shyvana,376,167,209,44.41
Sion,Nunu,1058,582,476,55.01
Sion,Nidalee,499,288,211,57.72
Sion,Sejuani,694,352,342,50.72
Sion,Lissandra,503,267,236,53.08
Sion,Aatrox,1494,704,790,47.12
Sion,Twitch,1388,686,702,49.42
Sion,Shen,1266,600,666,47.39
Sion,Riven,748,411,337,54.95
Sion,Xayah,855,423,432,49.47
Sion,Rakan,763,393,370,51.51
Sion,Azir,513,297,216,57.89
Sion,Gangplank,855,440,415,51.46
Sion,Elise,1168,663,505,56.76
Sion,Ziggs,585,272,313,46.5
Sion,Leblanc,773,371,402,47.99
Sion,JarvanIV,892,422,470,47.31
Sion,Corki,730,368,362,50.41
Sion,Akshan,548,323,225,58.94
Sion,XinZhao,1023,543,480,53.08
Sion,Bard,540,254,286,47.04
Sion,Fizz,876,461,415,52.63
Sion,Sylas,2008,1086,922,54.08
Sion,Orianna,687,376,311,54.73
Sion,Anivia,624,301,323,48.24
Sion,Sivir,828,401,427,48.43
Sion,Velkoz,978,518,460,52.97
Sion,Kayle,1107,547,560,49.41
Sion,Brand,1153,612,541,53.08
Sion,Ahri,2093,1094,999,52.27
Sion,Tryndamere,944,497,447,52.65
Sion,Rammus,461,246,215,53.36
Sion,Zeri,722,374,348,51.8
Sion,Maokai,746,426,320,57.1
Sion,FiddleSticks,841,431,410,51.25
Sion,Kassadin,339,189,150,55.75
Sion,Chogath,2180,1059,1121,48.58
Sion,TwistedFate,554,341,213,61.55
Sion,Nilah,630,313,317,49.68
Sion,MonkeyKing,1059,533,526,50.33
Sion,Ivern,256,126,130,49.22
Sion,Nocturne,1742,847,895,48.62
Sion,Cassiopeia,530,285,245,53.77
Sion,Urgot,862,450,412,52.2
Sion,Kled,295,167,128,56.61
Sion,Evelynn,688,382,306,55.52
Sion,Taric,378,165,213,43.65
Sion,Karthus,428,230,198,53.74
Sion,Rell,824,444,380,53.88
Sion,Camille,519,280,239,53.95
Sion,Kennen,451,214,237,47.45
Sion,Hecarim,674,376,298,55.79
Sion,RekSai,254,120,134,47.24
Sion,Quinn,610,286,324,46.89
Sion,Naafiri,502,291,211,57.97
Sion,Jayce,670,363,307,54.18
Sion,Rumble,392,224,168,57.14
Sion,Heimerdinger,825,417,408,50.55
Sion,Olaf,318,168,150,52.83
Sion,Renata,285,167,118,58.6
Shyvana,KSante,253,125,128,49.41
Shyvana,Kayn,830,486,344,58.55
Shyvana,Yasuo,954,485,469,50.84
Shyvana,MissFortune,1209,576,633,47.64
Shyvana,Lux,1382,711,671,51.45
Shyvana,Garen,996,504,492,50.6
Shyvana,Zed,475,273,202,57.47
Shyvana,Talon,347,212,135,61.1
Shyvana,Ashe,1036,591,445,57.05
Shyvana,Milio,284,124,160,43.66
Shyvana,Aurora,469,248,221,52.88
Shyvana,Briar,420,175,245,41.67
Shyvana,Fizz,333,183,150,54.95
Shyvana,Jinx,1426,699,727,49.02
Shyvana,Soraka,310,156,154,50.32
Shyvana,Vladimir,356,175,181,49.16
Shyvana,Ekko,504,260,244,51.59
Shyvana,Qiyana,127,74,53,58.27
Shyvana,Twitch,480,227,253,47.29
Shyvana,Senna,461,230,231,49.89
Shyvana,Fiora,200,80,120,40
Shyvana,Amumu,665,337,328,50.68
Shyvana,Samira,384,226,158,58.85
Shyvana,Seraphine,506,266,240,52.57
Shyvana,Darius,1096,506,590,46.17
Shyvana,Gragas,340,187,153,55
Shyvana,Veigar,553,301,252,54.43
Shyvana,KogMaw,181,88,93,48.62
Shyvana,Thresh,688,402,286,58.43
Shyvana,Evelynn,234,116,118,49.57
Shyvana,Tristana,545,267,278,48.99
Shyvana,Sylas,567,288,279,50.79
Shyvana,Mordekaiser,824,427,397,51.82
Shyvana,Nidalee,147,75,72,51.02
Shyvana,Orianna,255,137,118,53.73
Shyvana,Caitlyn,1380,736,644,53.33
Shyvana,Yuumi,492,260,232,52.85
Shyvana,Volibear,728,386,342,53.02
Shyvana,Yone,955,505,450,52.88
Shyvana,Lulu,635,292,343,45.98
Shyvana,Sett,820,384,436,46.83
Shyvana,Shaco,536,273,263,50.93
Shyvana,Mel,1077,552,525,51.25
Shyvana,Graves,365,221,144,60.55
Shyvana,Kayle,372,229,143,61.56
Shyvana,Ezreal,1149,640,509,55.7
Shyvana,Malzahar,605,299,306,49.42
Shyvana,Warwick,821,412,409,50.18
Shyvana,Teemo,710,362,348,50.99
Shyvana,Hecarim,271,143,128,52.77
Shyvana,Vayne,695,337,358,48.49
Shyvana,Chogath,604,295,309,48.84
Shyvana,Ambessa,333,174,159,52.25
Shyvana,Aphelios,309,152,157,49.19
Shyvana,Velkoz,296,148,148,50
Shyvana,RekSai,57,17,40,29.82
Shyvana,LeeSin,624,291,333,46.63
Shyvana,Nilah,217,112,105,51.61
Shyvana,Poppy,332,210,122,63.25
Shyvana,Galio,502,252,250,50.2
Shyvana,Yorick,576,269,307,46.7
Shyvana,Viktor,418,197,221,47.13
Shyvana,Zoe,223,117,106,52.47
Shyvana,Anivia,217,119,98,54.84
Shyvana,Camille,212,125,87,58.96
Shyvana,Zac,286,141,145,49.3
Shyvana,Morgana,626,303,323,48.4
Shyvana,Varus,462,263,199,56.93
Shyvana,Sion,376,209,167,55.59
Shyvana,Karma,512,259,253,50.59
Shyvana,Rakan,272,123,149,45.22
Shyvana,Gangplank,295,146,149,49.49
Shyvana,Kalista,194,107,87,55.15
Shyvana,Sejuani,185,106,79,57.3
Shyvana,Leblanc,247,125,122,50.61
Shyvana,Swain,644,341,303,52.95
Shyvana,Lillia,338,172,166,50.89
Shyvana,Draven,320,160,160,50
Shyvana,Leona,472,222,250,47.03
Shyvana,TahmKench,396,192,204,48.48
Shyvana,Akali,589,311,278,52.8
Shyvana,Kaisa,800,447,353,55.88
Shyvana,Braum,288,150,138,52.08
Shyvana,Nasus,343,185,158,53.94
Shyvana,Nunu,322,161,161,50
Shyvana,Pyke,470,255,215,54.26
Shyvana,FiddleSticks,248,134,114,54.03
Shyvana,Lucian,378,136,242,35.98
Shyvana,Blitzcrank,425,243,182,57.18
Shyvana,Khazix,282,180,102,63.83
Shyvana,Zyra,407,186,221,45.7
Shyvana,Gwen,343,163,180,47.52
Shyvana,Diana,878,458,420,52.16
Shyvana,Riven,217,95,122,43.78
Shyvana,Jax,417,225,192,53.96
Shyvana,Malphite,560,280,280,50
Shyvana,Pantheon,847,460,387,54.31
Shyvana,Renekton,223,121,102,54.26
Shyvana,Ahri,681,324,357,47.58
Shyvana,TwistedFate,186,91,95,48.92
Shyvana,Rammus,136,76,60,55.88
Shyvana,Ryze,162,75,87,46.3
Shyvana,Maokai,250,113,137,45.2
Shyvana,Skarner,199,112,87,56.28
Shyvana,AurelionSol,217,120,97,55.3
Shyvana,Xerath,458,211,247,46.07
Shyvana,Urgot,293,112,181,38.23
Shyvana,Nocturne,674,323,351,47.92
Shyvana,XinZhao,355,172,183,48.45
Shyvana,Ornn,206,103,103,50
Shyvana,Heimerdinger,275,150,125,54.55
Shyvana,Sivir,310,161,149,51.94
Shyvana,DrMundo,322,161,161,50
Shyvana,Nautilus,581,340,241,58.52
Shyvana,Smolder,449,202,247,44.99
Shyvana,Nami,529,239,290,45.18
Shyvana,Tryndamere,258,151,107,58.53
Shyvana,Azir,150,88,62,58.67
Shyvana,Zilean,158,55,103,34.81
Shyvana,Janna,192,83,109,43.23
Shyvana,Jhin,1025,527,498,51.41
Shyvana,Naafiri,256,165,91,64.45
Shyvana,Syndra,328,210,118,64.02
Shyvana,Kassadin,96,43,53,44.79
Shyvana,Alistar,264,156,108,59.09
Shyvana,Jayce,182,87,95,47.8
Shyvana,Belveth,139,77,62,55.4
Shyvana,Lissandra,182,89,93,48.9
Shyvana,Sona,188,87,101,46.28
Shyvana,Katarina,426,255,171,59.86
Shyvana,Elise,358,200,158,55.87
Shyvana,Hwei,326,172,154,52.76
Shyvana,MasterYi,604,275,329,45.53
Shyvana,Taric,77,57,20,74.03
Shyvana,Xayah,276,163,113,59.06
Shyvana,Rengar,148,84,64,56.76
Shyvana,Viego,707,403,304,57
Shyvana,Brand,393,222,171,56.49
Shyvana,Olaf,106,54,52,50.94
Shyvana,Annie,170,113,57,66.47
Shyvana,Illaoi,278,100,178,35.97
Shyvana,Gnar,249,115,134,46.18
Shyvana,Rell,261,147,114,56.32
Shyvana,Shen,379,175,204,46.17
Shyvana,Irelia,467,232,235,49.68
Shyvana,Vex,288,127,161,44.1
Shyvana,JarvanIV,322,158,164,49.07
Shyvana,Ivern,93,46,47,49.46
Shyvana,Neeko,311,154,157,49.52
Shyvana,Udyr,207,116,91,56.04
Shyvana,Trundle,246,130,116,52.85
Shyvana,Karthus,122,63,59,51.64
Shyvana,Kled,146,80,66,54.79
Shyvana,Vi,461,272,189,59
Shyvana,Corki,220,113,107,51.36
Shyvana,MonkeyKing,348,206,142,59.2
Shyvana,Zeri,204,82,122,40.2
Shyvana,Aatrox,378,231,147,61.11
Shyvana,Singed,134,52,82,38.81
Shyvana,Quinn,225,122,103,54.22
Shyvana,Ziggs,225,131,94,58.22
Shyvana,Kindred,246,125,121,50.81
Shyvana,Rumble,151,75,76,49.67
Shyvana,Akshan,182,74,108,40.66
Shyvana,Bard,159,87,72,54.72
Shyvana,Cassiopeia,155,95,60,61.29
Shyvana,Renata,86,33,53,38.37
Shyvana,Kennen,160,84,76,52.5
Shyvana,Taliyah,145,84,61,57.93
Quinn,Naafiri,272,139,133,51.1
Quinn,Volibear,757,385,372,50.86
Quinn,Lux,1861,993,868,53.36
Quinn,Ashe,1525,795,730,52.13
Quinn,Soraka,469,223,246,47.55
Quinn,Jax,595,337,258,56.64
Quinn,FiddleSticks,397,198,199,49.87
Quinn,Cassiopeia,231,116,115,50.22
Quinn,Caitlyn,1923,1028,895,53.46
Quinn,Milio,496,246,250,49.6
Quinn,Nasus,453,217,236,47.9
Quinn,Kindred,320,152,168,47.5
Quinn,Malzahar,642,348,294,54.21
Quinn,Tristana,791,436,355,55.12
Quinn,Nautilus,655,336,319,51.3
Quinn,Yone,1222,633,589,51.8
Quinn,Graves,482,260,222,53.94
Quinn,Akali,834,429,405,51.44
Quinn,Zeri,259,133,126,51.35
Quinn,Taric,162,95,67,58.64
Quinn,Malphite,1182,568,614,48.05
Quinn,Ivern,126,74,52,58.73
Quinn,Yasuo,1407,732,675,52.03
Quinn,Jhin,1524,819,705,53.74
Quinn,Pyke,668,339,329,50.75
Quinn,KSante,295,149,146,50.51
Quinn,Darius,1584,784,800,49.49
Quinn,Sylas,882,428,454,48.53
Quinn,Mel,1646,919,727,55.83
Quinn,Pantheon,1150,595,555,51.74
Quinn,Warwick,1145,597,548,52.14
Quinn,Viego,1044,531,513,50.86
Quinn,Ornn,293,152,141,51.88
Quinn,Shaco,711,367,344,51.62
Quinn,Irelia,577,288,289,49.91
Quinn,Evelynn,278,133,145,47.84
Quinn,Rammus,250,110,140,44
Quinn,Hwei,485,276,209,56.91
Quinn,Lulu,858,462,396,53.85
Quinn,Teemo,1110,491,619,44.23
Quinn,Ahri,926,465,461,50.22
Quinn,Yuumi,643,319,324,49.61
Quinn,Aurora,630,286,344,45.4
Quinn,KogMaw,252,119,133,47.22
Quinn,Kayle,529,281,248,53.12
Quinn,LeeSin,961,488,473,50.78
Quinn,Vex,390,202,188,51.79
Quinn,MissFortune,1671,846,825,50.63
Quinn,Kalista,185,110,75,59.46
Quinn,Vi,724,345,379,47.65
Quinn,Talon,450,257,193,57.11
Quinn,Briar,619,332,287,53.63
Quinn,Zoe,336,170,166,50.6
Quinn,Singed,231,91,140,39.39
Quinn,Ezreal,1620,863,757,53.27
Quinn,Velkoz,518,234,284,45.17
Quinn,Ambessa,467,259,208,55.46
Quinn,Lissandra,235,150,85,63.83
Quinn,Samira,519,275,244,52.99
Quinn,Thresh,999,528,471,52.85
Quinn,Rakan,310,146,164,47.1
Quinn,Morgana,961,556,405,57.86
Quinn,DrMundo,479,251,228,52.4
Quinn,Mordekaiser,886,450,436,50.79
Quinn,Seraphine,693,345,348,49.78
Quinn,Vladimir,437,210,227,48.05
Quinn,Sett,1038,489,549,47.11
Quinn,Nami,730,367,363,50.27
Quinn,Nocturne,916,462,454,50.44
Quinn,Aphelios,394,197,197,50
Quinn,Karma,819,407,412,49.69
Quinn,Gnar,336,173,163,51.49
Quinn,Qiyana,175,113,62,64.57
Quinn,Diana,978,483,495,49.39
Quinn,Zilean,230,119,111,51.74
Quinn,Renekton,420,249,171,59.29
Quinn,Twitch,640,333,307,52.03
Quinn,Braum,391,190,201,48.59
Quinn,Zed,956,530,426,55.44
Quinn,MasterYi,898,487,411,54.23
Quinn,Elise,490,277,213,56.53
Quinn,Vayne,968,490,478,50.62
Quinn,Gragas,442,196,246,44.34
Quinn,Udyr,308,165,143,53.57
Quinn,Poppy,405,205,200,50.62
Quinn,Swain,690,334,356,48.41
Quinn,Sejuani,260,122,138,46.92
Quinn,Kennen,238,133,105,55.88
Quinn,Kayn,1094,608,486,55.58
Quinn,Veigar,738,360,378,48.78
Quinn,Varus,659,346,313,52.5
Quinn,Senna,625,332,293,53.12
Quinn,Gangplank,443,202,241,45.6
Quinn,Garen,1315,659,656,50.11
Quinn,Rengar,303,191,112,63.04
Quinn,Smolder,520,301,219,57.88
Quinn,Skarner,233,112,121,48.07
Quinn,Jinx,2040,1016,1024,49.8
Quinn,Yorick,717,337,380,47
Quinn,TwistedFate,349,165,184,47.28
Quinn,Leona,541,258,283,47.69
Quinn,Heimerdinger,408,167,241,40.93
Quinn,Khazix,431,209,222,48.49
Quinn,Janna,291,138,153,47.42
Quinn,Brand,510,250,260,49.02
Quinn,Ekko,671,327,344,48.73
Quinn,Nidalee,231,135,96,58.44
Quinn,Lucian,452,240,212,53.1
Quinn,Chogath,834,439,395,52.64
Quinn,MonkeyKing,495,229,266,46.26
Quinn,Nilah,267,157,110,58.8
Quinn,Xerath,641,309,332,48.21
Quinn,TahmKench,585,308,277,52.65
Quinn,Amumu,734,323,411,44.01
Quinn,AurelionSol,313,134,179,42.81
Quinn,Zyra,667,349,318,52.32
Quinn,Sivir,411,179,232,43.55
Quinn,Katarina,670,305,365,45.52
Quinn,Galio,652,323,329,49.54
Quinn,Fizz,405,196,209,48.4
Quinn,Kaisa,1140,530,610,46.49
Quinn,Lillia,445,243,202,54.61
Quinn,Ryze,239,106,133,44.35
Quinn,Nunu,440,237,203,53.86
Quinn,Fiora,249,153,96,61.45
Quinn,Viktor,617,343,274,55.59
Quinn,Tryndamere,473,217,256,45.88
Quinn,JarvanIV,434,213,221,49.08
Quinn,Maokai,335,179,156,53.43
Quinn,Azir,281,115,166,40.93
Quinn,Jayce,415,245,170,59.04
Quinn,Xayah,325,156,169,48
Quinn,Karthus,248,121,127,48.79
Quinn,Bard,291,124,167,42.61
Quinn,Urgot,361,135,226,37.4
Quinn,Blitzcrank,569,259,310,45.52
Quinn,Camille,272,143,129,52.57
Quinn,Aatrox,638,286,352,44.83
Quinn,Leblanc,427,244,183,57.14
Quinn,Kassadin,141,87,54,61.7
Quinn,Riven,319,158,161,49.53
Quinn,Ziggs,258,129,129,50
Quinn,Annie,259,130,129,50.19
Quinn,Draven,461,233,228,50.54
Quinn,Sion,610,324,286,53.11
Quinn,Corki,368,190,178,51.63
Quinn,Rell,408,192,216,47.06
Quinn,Illaoi,275,148,127,53.82
Quinn,Hecarim,246,115,131,46.75
Quinn,Rumble,140,83,57,59.29
Quinn,Belveth,178,97,81,54.49
Quinn,Zac,282,157,125,55.67
Quinn,Orianna,334,190,144,56.89
Quinn,Sona,208,97,111,46.63
Quinn,Shen,370,211,159,57.03
Quinn,Neeko,407,226,181,55.53
Quinn,XinZhao,385,167,218,43.38
Quinn,Alistar,300,134,166,44.67
Quinn,Gwen,408,246,162,60.29
Quinn,Syndra,487,244,243,50.1
Quinn,Olaf,151,81,70,53.64
Quinn,Kled,115,61,54,53.04
Quinn,Trundle,320,146,174,45.63
Quinn,Taliyah,228,110,118,48.25
Quinn,Renata,105,51,54,48.57
Quinn,Shyvana,225,103,122,45.78
Quinn,Anivia,180,85,95,47.22
Quinn,Akshan,274,113,161,41.24
Quinn,RekSai,110,72,38,65.45
Kled,Sett,589,249,340,42.28
Kled,Karthus,100,66,34,66
Kled,Zed,386,207,179,53.63
Kled,Ashe,851,438,413,51.47
Kled,Maokai,192,83,109,43.23
Kled,Nasus,260,124,136,47.69
Kled,Udyr,130,76,54,58.46
Kled,Jhin,791,391,400,49.43
Kled,Alistar,137,56,81,40.88
Kled,Yone,717,345,372,48.12
Kled,Khazix,214,109,105,50.93
Kled,Varus,354,150,204,42.37
Kled,Samira,245,129,116,52.65
Kled,Yuumi,296,139,157,46.96
Kled,Urgot,235,123,112,52.34
Kled,Shaco,346,155,191,44.8
Kled,Annie,126,57,69,45.24
Kled,Ezreal,906,500,406,55.19
Kled,Lux,933,486,447,52.09
Kled,Ornn,201,116,85,57.71
Kled,Yorick,356,173,183,48.6
Kled,Zoe,178,81,97,45.51
Kled,Blitzcrank,259,123,136,47.49
Kled,Pantheon,579,257,322,44.39
Kled,Trundle,264,117,147,44.32
Kled,Yasuo,689,306,383,44.41
Kled,Leona,356,167,189,46.91
Kled,Chogath,492,251,241,51.02
Kled,Nocturne,423,189,234,44.68
Kled,Cassiopeia,137,69,68,50.36
Kled,Soraka,216,113,103,52.31
Kled,Ambessa,233,122,111,52.36
Kled,Evelynn,107,53,54,49.53
Kled,Katarina,279,147,132,52.69
Kled,Jinx,963,480,483,49.84
Kled,Singed,126,57,69,45.24
Kled,MonkeyKing,255,128,127,50.2
Kled,Diana,563,286,277,50.8
Kled,MissFortune,783,395,388,50.45
Kled,Amumu,445,205,240,46.07
Kled,Skarner,154,76,78,49.35
Kled,Warwick,582,294,288,50.52
Kled,Xerath,302,157,145,51.99
Kled,Brand,262,145,117,55.34
Kled,Camille,123,69,54,56.1
Kled,Lillia,193,133,60,68.91
Kled,Leblanc,246,127,119,51.63
Kled,Renata,104,64,40,61.54
Kled,Kayn,549,312,237,56.83
Kled,Lissandra,145,53,92,36.55
Kled,Kalista,149,93,56,62.42
Kled,JarvanIV,251,100,151,39.84
Kled,Rumble,149,96,53,64.43
Kled,XinZhao,220,108,112,49.09
Kled,Smolder,223,135,88,60.54
Kled,Seraphine,329,183,146,55.62
Kled,Garen,598,346,252,57.86
Kled,Vayne,496,224,272,45.16
Kled,Thresh,508,254,254,50
Kled,Shen,337,177,160,52.52
Kled,Lucian,282,146,136,51.77
Kled,Senna,262,150,112,57.25
Kled,Qiyana,107,60,47,56.07
Kled,Velkoz,247,104,143,42.11
Kled,Teemo,478,217,261,45.4
Kled,Ziggs,153,56,97,36.6
Kled,Pyke,392,224,168,57.14
Kled,Aatrox,428,222,206,51.87
Kled,AurelionSol,171,85,86,49.71
Kled,Aphelios,245,127,118,51.84
Kled,Milio,202,112,90,55.45
Kled,Ahri,485,234,251,48.25
Kled,Lulu,525,279,246,53.14
Kled,Rakan,149,76,73,51.01
Kled,Poppy,275,125,150,45.45
Kled,Viego,473,230,243,48.63
Kled,Irelia,280,132,148,47.14
Kled,Mel,854,472,382,55.27
Kled,Zyra,332,162,170,48.8
Kled,Ryze,120,67,53,55.83
Kled,Belveth,101,64,37,63.37
Kled,Heimerdinger,186,76,110,40.86
Kled,Gangplank,216,104,112,48.15
Kled,Vex,180,108,72,60
Kled,KSante,213,110,103,51.64
Kled,Mordekaiser,547,229,318,41.86
Kled,Veigar,406,224,182,55.17
Kled,Riven,168,121,47,72.02
Kled,Talon,255,132,123,51.76
Kled,Sona,123,69,54,56.1
Kled,Kayle,274,154,120,56.2
Kled,LeeSin,475,247,228,52
Kled,Sylas,516,280,236,54.26
Kled,MasterYi,377,196,181,51.99
Kled,Sivir,168,76,92,45.24
Kled,Renekton,208,119,89,57.21
Kled,Sejuani,158,67,91,42.41
Kled,Ekko,342,188,154,54.97
Kled,Jayce,165,81,84,49.09
Kled,Kaisa,616,306,310,49.68
Kled,Vi,355,190,165,53.52
Kled,Rammus,114,52,62,45.61
Kled,Jax,320,157,163,49.06
Kled,Morgana,470,240,230,51.06
Kled,Darius,792,362,430,45.71
Kled,TwistedFate,152,90,62,59.21
Kled,Nami,438,214,224,48.86
Kled,Volibear,469,240,229,51.17
Kled,Hecarim,143,91,52,63.64
Kled,Kassadin,77,33,44,42.86
Kled,Orianna,174,87,87,50
Kled,Kennen,117,69,48,58.97
Kled,Elise,319,187,132,58.62
Kled,Nilah,145,86,59,59.31
Kled,Nunu,161,94,67,58.39
Kled,Ivern,86,58,28,67.44
Kled,Nautilus,451,224,227,49.67
Kled,Briar,379,198,181,52.24
Kled,Hwei,261,148,113,56.7
Kled,Zilean,147,68,79,46.26
Kled,Vladimir,234,108,126,46.15
Kled,Caitlyn,1030,513,517,49.81
Kled,Gnar,170,82,88,48.24
Kled,Akali,442,232,210,52.49
Kled,TahmKench,318,197,121,61.95
Kled,Olaf,102,62,40,60.78
Kled,Malzahar,362,177,185,48.9
Kled,Gragas,224,119,105,53.13
Kled,Bard,95,39,56,41.05
Kled,Illaoi,158,86,72,54.43
Kled,FiddleSticks,210,103,107,49.05
Kled,Aurora,249,95,154,38.15
Kled,Sion,295,128,167,43.39
Kled,Fizz,236,119,117,50.42
Kled,Draven,194,88,106,45.36
Kled,Corki,176,102,74,57.95
Kled,Graves,227,120,107,52.86
Kled,Viktor,367,172,195,46.87
Kled,Neeko,178,78,100,43.82
Kled,Twitch,324,159,165,49.07
Kled,Janna,137,45,92,32.85
Kled,Naafiri,137,83,54,60.58
Kled,Swain,367,171,196,46.59
Kled,Braum,193,73,120,37.82
Kled,Gwen,225,125,100,55.56
Kled,RekSai,67,34,33,50.75
Kled,Fiora,152,79,73,51.97
Kled,Galio,296,147,149,49.66
Kled,Rengar,161,90,71,55.9
Kled,Shyvana,146,66,80,45.21
Kled,KogMaw,152,75,77,49.34
Kled,Rell,209,102,107,48.8
Kled,Xayah,209,113,96,54.07
Kled,Karma,422,188,234,44.55
Kled,Malphite,311,133,178,42.77
Kled,Zeri,163,98,65,60.12
Kled,Anivia,118,64,54,54.24
Kled,Quinn,115,54,61,46.96
Kled,Tristana,414,212,202,51.21
Kled,Taric,89,53,36,59.55
Kled,Nidalee,108,59,49,54.63
Kled,Tryndamere,231,126,105,54.55
Kled,Zac,204,77,127,37.75
Kled,Azir,160,99,61,61.88
Kled,DrMundo,264,131,133,49.62
Kled,Kindred,223,128,95,57.4
Kled,Syndra,274,134,140,48.91
Kled,Akshan,142,70,72,49.3
Kled,Taliyah,99,49,50,49.49
Rumble,Poppy,437,221,216,50.57
Rumble,Viego,815,378,437,46.38
Rumble,Zed,605,292,313,48.26
Rumble,Mel,1044,545,499,52.2
Rumble,Lux,1146,558,588,48.69
Rumble,Yorick,384,168,216,43.75
Rumble,Shaco,559,285,274,50.98
Rumble,Kalista,148,72,76,48.65
Rumble,Blitzcrank,386,198,188,51.3
Rumble,Sett,819,394,425,48.11
Rumble,Elise,449,218,231,48.55
Rumble,Katarina,436,207,229,47.48
Rumble,MissFortune,1129,579,550,51.28
Rumble,Morgana,592,257,335,43.41
Rumble,Aatrox,656,350,306,53.35
Rumble,Rengar,158,75,83,47.47
Rumble,RekSai,88,45,43,51.14
Rumble,Twitch,368,187,181,50.82
Rumble,Sona,139,57,82,41.01
Rumble,Kayle,321,137,184,42.68
Rumble,Warwick,768,328,440,42.71
Rumble,Fizz,261,137,124,52.49
Rumble,Tristana,536,248,288,46.27
Rumble,Seraphine,342,153,189,44.74
Rumble,Mordekaiser,665,273,392,41.05
Rumble,Graves,392,192,200,48.98
Rumble,Yasuo,1219,528,691,43.31
Rumble,Ezreal,1619,761,858,47
Rumble,Maokai,242,105,137,43.39
Rumble,Kled,149,53,96,35.57
Rumble,Varus,556,265,291,47.66
Rumble,Ekko,456,212,244,46.49
Rumble,Thresh,782,396,386,50.64
Rumble,Yone,1058,536,522,50.66
Rumble,LeeSin,1063,543,520,51.08
Rumble,Vladimir,409,213,196,52.08
Rumble,Gangplank,321,163,158,50.78
Rumble,MasterYi,575,259,316,45.04
Rumble,Aurora,473,211,262,44.61
Rumble,Chogath,551,280,271,50.82
Rumble,Darius,987,439,548,44.48
Rumble,Evelynn,226,90,136,39.82
Rumble,Irelia,500,208,292,41.6
Rumble,Jhin,1160,540,620,46.55
Rumble,Ivern,102,51,51,50
Rumble,Vex,257,111,146,43.19
Rumble,Shen,376,192,184,51.06
Rumble,Lissandra,183,75,108,40.98
Rumble,Soraka,283,136,147,48.06
Rumble,Kayn,738,335,403,45.39
Rumble,Akali,600,302,298,50.33
Rumble,Kaisa,918,493,425,53.7
Rumble,Briar,353,164,189,46.46
Rumble,Sivir,284,125,159,44.01
Rumble,JarvanIV,377,166,211,44.03
Rumble,Teemo,877,407,470,46.41
Rumble,Malzahar,495,225,270,45.45
Rumble,Aphelios,272,159,113,58.46
Rumble,Sylas,878,459,419,52.28
Rumble,Nasus,356,167,189,46.91
Rumble,Caitlyn,1301,632,669,48.58
Rumble,Pantheon,929,435,494,46.82
Rumble,Alistar,284,112,172,39.44
Rumble,Ahri,723,340,383,47.03
Rumble,Ornn,237,116,121,48.95
Rumble,Jax,454,220,234,48.46
Rumble,Ashe,1054,491,563,46.58
Rumble,Yuumi,449,226,223,50.33
Rumble,Gragas,360,148,212,41.11
Rumble,Neeko,205,97,108,47.32
Rumble,Karma,782,366,416,46.8
Rumble,Camille,150,78,72,52
Rumble,Kassadin,114,50,64,43.86
Rumble,Karthus,174,66,108,37.93
Rumble,TahmKench,434,215,219,49.54
Rumble,Lulu,844,417,427,49.41
Rumble,FiddleSticks,304,113,191,37.17
Rumble,Qiyana,172,103,69,59.88
Rumble,Samira,330,153,177,46.36
Rumble,Zac,303,187,116,61.72
Rumble,Lucian,436,238,198,54.59
Rumble,Renata,97,50,47,51.55
Rumble,Milio,314,145,169,46.18
Rumble,Pyke,498,238,260,47.79
Rumble,Talon,392,195,197,49.74
Rumble,Brand,303,147,156,48.51
Rumble,Braum,337,135,202,40.06
Rumble,Malphite,604,257,347,42.55
Rumble,Nocturne,586,273,313,46.59
Rumble,Udyr,211,115,96,54.5
Rumble,Illaoi,258,135,123,52.33
Rumble,Lillia,296,164,132,55.41
Rumble,Nami,474,231,243,48.73
Rumble,Volibear,430,200,230,46.51
Rumble,Vayne,649,340,309,52.39
Rumble,KSante,356,162,194,45.51
Rumble,Belveth,146,84,62,57.53
Rumble,Viktor,466,246,220,52.79
Rumble,Nautilus,633,302,331,47.71
Rumble,Gwen,253,132,121,52.17
Rumble,Jinx,1493,675,818,45.21
Rumble,Swain,495,256,239,51.72
Rumble,Skarner,199,96,103,48.24
Rumble,Senna,387,186,201,48.06
Rumble,Hwei,368,191,177,51.9
Rumble,Nidalee,236,107,129,45.34
Rumble,Taliyah,160,60,100,37.5
Rumble,Galio,659,318,341,48.25
Rumble,Urgot,224,89,135,39.73
Rumble,Sejuani,195,91,104,46.67
Rumble,TwistedFate,207,99,108,47.83
Rumble,Hecarim,239,129,110,53.97
Rumble,Draven,282,141,141,50
Rumble,Riven,287,158,129,55.05
Rumble,Jayce,416,207,209,49.76
Rumble,Orianna,298,104,194,34.9
Rumble,Zoe,238,117,121,49.16
Rumble,Garen,735,369,366,50.2
Rumble,Diana,909,422,487,46.42
Rumble,Singed,158,49,109,31.01
Rumble,Kennen,160,80,80,50
Rumble,Khazix,288,137,151,47.57
Rumble,Veigar,420,182,238,43.33
Rumble,Azir,194,114,80,58.76
Rumble,Leblanc,384,219,165,57.03
Rumble,DrMundo,323,152,171,47.06
Rumble,Vi,575,325,250,56.52
Rumble,Zyra,566,310,256,54.77
Rumble,Rammus,175,86,89,49.14
Rumble,Ambessa,350,153,197,43.71
Rumble,Heimerdinger,246,107,139,43.5
Rumble,Rakan,281,130,151,46.26
Rumble,Velkoz,297,128,169,43.1
Rumble,Gnar,269,131,138,48.7
Rumble,Ziggs,198,77,121,38.89
Rumble,Annie,199,95,104,47.74
Rumble,Anivia,192,83,109,43.23
Rumble,Trundle,229,123,106,53.71
Rumble,Tryndamere,185,70,115,37.84
Rumble,AurelionSol,162,93,69,57.41
Rumble,Syndra,333,185,148,55.56
Rumble,Zilean,183,72,111,39.34
Rumble,Sion,392,168,224,42.86
Rumble,Xerath,576,239,337,41.49
Rumble,Quinn,140,57,83,40.71
Rumble,Kindred,274,138,136,50.36
Rumble,Leona,477,233,244,48.85
Rumble,Akshan,142,88,54,61.97
Rumble,Cassiopeia,134,65,69,48.51
Rumble,Smolder,350,182,168,52
Rumble,Amumu,525,287,238,54.67
Rumble,KogMaw,196,71,125,36.22
Rumble,Ryze,177,83,94,46.89
Rumble,Naafiri,174,67,107,38.51
Rumble,Zeri,286,148,138,51.75
Rumble,Nunu,286,141,145,49.3
Rumble,Bard,186,89,97,47.85
Rumble,XinZhao,360,180,180,50
Rumble,Xayah,328,123,205,37.5
Rumble,Renekton,239,138,101,57.74
Rumble,MonkeyKing,338,131,207,38.76
Rumble,Shyvana,151,76,75,50.33
Rumble,Fiora,215,98,117,45.58
Rumble,Janna,180,75,105,41.67
Rumble,Taric,122,61,61,50
Rumble,Olaf,219,103,116,47.03
Rumble,Rell,327,156,171,47.71
Rumble,Nilah,108,63,45,58.33
Rumble,Corki,259,122,137,47.1
