Name,Games,Wins,Losses,Bans,EffectiveBans,WR
Nautilus,62335,30519,31816,78626,76455,48.96
MasterYi,64600,32700,31900,132253,125330,50.62
Darius,104435,52542,51893,190921,177617,50.31
Sylas,73007,35724,37283,66600,64567,48.93
Shaco,50956,24882,26074,222139,202097,48.83
Vayne,67372,34520,32852,48701,47801,51.24
Fizz,30432,15162,15270,51897,50668,49.82
Chogath,67504,34628,32876,33082,32473,51.3
Mel,112122,53836,58286,520204,423947,48.02
Ashe,110021,54491,55530,48089,46919,49.53
Sett,83879,43456,40423,39076,38348,51.81
Warwick,81008,42164,38844,152525,141297,52.05
Shen,35545,17861,17684,4251,4242,50.25
Tristana,52853,26220,26633,16058,15905,49.61
Blitzcrank,42087,20306,21781,139802,131527,48.25
Malphite,54555,27534,27021,42553,41894,50.47
Ekko,49187,24575,24612,12987,12933,49.96
Hwei,37651,18874,18777,26018,25751,50.13
Lucian,38645,18618,20027,7322,7304,48.18
Maokai,24942,12758,12184,5248,5239,51.15
Leblanc,31306,15225,16081,81826,77116,48.63
None,0,0,0,262039,213753,NaN
LeeSin,79648,38056,41592,76586,71348,47.78
Yorick,51408,27785,23623,86461,83057,54.05
Volibear,60903,30758,30145,35908,35421,50.5
Diana,85126,43141,41985,72640,70496,50.68
Rammus,17351,8837,8514,34476,33963,50.93
Yone,101820,48753,53067,70853,69002,47.88
Yasuo,108838,54537,54301,158371,148616,50.11
Jhin,107975,53954,54021,35570,34877,49.97
Lux,137500,68946,68554,145241,134622,50.14
Mordekaiser,74944,38816,36128,128515,121580,51.79
Qiyana,14912,6905,8007,2509,2496,46.3
Irelia,46484,22941,23543,75929,73087,49.35
Ezreal,127058,61353,65705,52173,50837,48.29
Rell,28320,14125,14195,12529,12458,49.88
Caitlyn,143844,72086,71758,195310,180210,50.11
Morgana,65874,33578,32296,181691,168167,50.97
Kalista,17624,8266,9358,6728,6711,46.9
Shyvana,14034,7239,6795,3670,3668,51.58
Sejuani,23751,11992,11759,3626,3619,50.49
Pantheon,88017,43869,44148,32938,32545,49.84
Singed,15256,8052,7204,4606,4592,52.78
Zed,59988,28737,31251,121221,115561,47.9
Teemo,68639,35713,32926,145032,135654,52.03
Lulu,68514,34054,34460,119620,111675,49.7
Sion,41930,21575,20355,12800,12627,51.45
Urgot,27060,14195,12865,17425,17276,52.46
Amumu,56251,29814,26437,55118,53491,53
Zac,25856,12992,12864,11295,11235,50.25
Poppy,33721,17003,16718,21472,21175,50.42
Twitch,43725,21697,22028,53549,52192,49.62
Fiora,21907,10664,11243,25306,24999,48.68
Katarina,43004,20635,22369,40103,39384,47.98
Viktor,47193,23666,23527,52785,51661,50.15
Braum,30926,15930,14996,14248,14118,51.51
Brand,39091,19654,19437,35125,34503,50.28
Karma,61671,31158,30513,45613,43864,50.52
Jayce,26431,12771,13660,15951,15695,48.32
Kaisa,89143,42843,46300,13351,13287,48.06
Pyke,49453,23272,26181,132679,125931,47.06
Renekton,27798,13785,14013,18143,17985,49.59
Kayn,78564,39384,39180,64279,62562,50.13
Draven,29120,14289,14831,95436,90896,49.07
Yuumi,47385,23421,23964,49473,47416,49.43
Zoe,22215,10427,11788,11291,11228,46.94
Taric,11882,6232,5650,3304,3293,52.45
Akali,58573,28745,29828,74005,71871,49.08
Gragas,32436,15414,17022,10899,10827,47.52
Zyra,47068,24380,22688,45555,44596,51.8
Aurora,43641,21205,22436,48142,47184,48.59
Khazix,29726,14172,15554,18787,18619,47.68
Nocturne,65204,34195,31009,133061,126059,52.44
Gangplank,28407,13946,14461,13663,13504,49.09
Gwen,29357,13953,15404,18890,18621,47.53
Vi,52366,26083,26283,14953,14849,49.81
Soraka,31222,16046,15176,13738,13588,51.39
Samira,42141,20664,21477,65419,63453,49.04
Illaoi,26049,13167,12882,88459,84963,50.55
Jax,49449,24374,25075,30851,30438,49.29
XinZhao,36122,18426,17696,8847,8784,51.01
Kennen,16355,7907,8448,6921,6912,48.35
Vladimir,34699,17382,17317,28174,27700,50.09
Viego,75426,37925,37501,72644,70598,50.28
Velkoz,32730,16944,15786,11218,11157,51.77
Tryndamere,30466,15051,15415,22209,22015,49.4
Aatrox,53310,25980,27330,62534,60801,48.73
Varus,48616,23744,24872,8972,8959,48.84
Kindred,26027,12468,13559,13391,13207,47.9
Milio,31633,16599,15034,13121,12998,52.47
KogMaw,17523,9093,8430,9517,9475,51.89
Ambessa,34767,16677,18090,82344,79282,47.97
Graves,35675,17575,18100,25206,24737,49.26
Ahri,73701,36300,37401,35332,34860,49.25
Nilah,20725,10691,10034,29203,28831,51.59
Belveth,13281,6491,6790,13460,13343,48.87
Sona,17518,9145,8373,1680,1680,52.2
Renata,10899,5369,5530,2221,2218,49.26
Ivern,9298,4439,4859,3385,3380,47.74
Veigar,56300,28852,27448,27920,27402,51.25
Jinx,143664,74314,69350,75253,73102,51.73
Seraphine,45594,22670,22924,15518,15366,49.72
Rakan,24680,12456,12224,2883,2877,50.47
Vex,30098,15199,14899,32685,32308,50.5
Corki,21789,10291,11498,10315,10210,47.23
Lillia,32050,15988,16062,27346,27077,49.88
Zeri,24140,11813,12327,3358,3352,48.94
Briar,42268,22108,20160,52948,51677,52.3
DrMundo,31157,16083,15074,23318,23060,51.62
Swain,54750,28667,26083,34478,33974,52.36
MonkeyKing,36228,18615,17613,19786,19613,51.38
Malzahar,54024,28358,25666,89226,85769,52.49
Orianna,24892,12306,12586,5382,5358,49.44
Kayle,37041,19146,17895,17665,17517,51.69
Leona,46515,23340,23175,55221,54052,50.18
Talon,32488,15468,17020,10294,10244,47.61
Alistar,23010,11360,11650,7767,7750,49.37
Garen,86981,44821,42160,67494,65657,51.53
Heimerdinger,26118,13668,12450,35060,34287,52.33
MissFortune,123698,62980,60718,97271,92377,50.91
Ryze,18969,9637,9332,2640,2640,50.8
TwistedFate,19581,9306,10275,1224,1224,47.53
Udyr,20943,10153,10790,11128,11062,48.48
Quinn,19390,9889,9501,9920,9876,51
Nami,54576,28129,26447,8121,8086,51.54
Azir,19914,9588,10326,3870,3860,48.15
Neeko,29148,14070,15078,10319,10248,48.27
FiddleSticks,27916,14143,13773,10845,10801,50.66
Smolder,37432,18029,19403,10014,9957,48.16
TahmKench,47253,23149,24104,65642,63730,48.99
Aphelios,31883,15844,16039,8222,8177,49.69
Evelynn,21582,10427,11155,16643,16521,48.31
Trundle,31066,16040,15026,14133,14029,51.63
Sivir,29296,14968,14328,6585,6574,51.09
Rengar,19208,8428,10780,10774,10690,43.88
Lissandra,17764,9043,8721,7651,7615,50.91
Nasus,39806,20492,19314,33488,33041,51.48
Naafiri,19572,9790,9782,11611,11569,50.02
Senna,41769,20944,20825,10046,10010,50.14
Galio,48583,25015,23568,33770,33231,51.49
Gnar,23225,11190,12035,6744,6720,48.18
Riven,24898,11869,13029,10495,10432,47.67
Hecarim,21759,10524,11235,12373,12244,48.37
AurelionSol,22687,11761,10926,9314,9259,51.84
Ornn,23799,12143,11656,4618,4607,51.02
Kassadin,11485,5849,5636,7471,7422,50.93
Nidalee,16485,7280,9205,6267,6213,44.16
JarvanIV,31605,16240,15365,7675,7628,51.38
Xayah,29464,14726,14738,4812,4797,49.98
Ziggs,21204,10796,10408,6859,6817,50.91
Taliyah,14296,7263,7033,2481,2476,50.8
Cassiopeia,17222,8622,8600,17560,17421,50.06
Kled,10147,5128,5019,4673,4655,50.54
Thresh,76926,38531,38395,35124,34543,50.09
RekSai,7284,3490,3794,2909,2906,47.91
Karthus,15695,7588,8107,11084,10801,48.35
Skarner,16243,7553,8690,26215,25788,46.5
KSante,28976,13453,15523,27442,27039,46.43
Syndra,33825,17092,16733,24681,24335,50.53
Zilean,17206,8830,8376,5265,5248,51.32
Bard,16863,8389,8474,3186,3183,49.75
Xerath,46995,23909,23086,51488,49713,50.88
Anivia,18263,9383,8880,12487,12381,51.38
Elise,38748,18915,19833,50563,47730,48.82
Janna,17962,9260,8702,3829,3815,51.55
Akshan,19052,9536,9516,15459,15352,50.05
Olaf,13291,6648,6643,7300,7275,50.02
Annie,17812,8836,8976,6212,6173,49.61
Camille,20371,9741,10630,9244,9197,47.82
Nunu,33923,16858,17065,10317,10271,49.69
Rumble,14447,6915,7532,4352,4346,47.86
