Name,Opponent,Games,Wins,Losses,WR
Sett,Malphite,2929,1432,1497,48.89
Sett,Ekko,2708,1409,1299,52.03
Sett,Hwei,2033,1099,934,54.06
Sett,Lucian,1897,1017,880,53.61
Sett,Maokai,1493,728,765,48.76
Sett,Yorick,2817,1335,1482,47.39
Sett,Viego,4352,2328,2024,53.49
Sett,Diana,4805,2491,2314,51.84
Sett,Seraphine,2740,1469,1271,53.61
Sett,Rakan,1306,648,658,49.62
Sett,Gwen,1732,1000,732,57.74
Sett,JarvanIV,1446,759,687,52.49
Sett,Yone,6352,3478,2874,54.75
Sett,Zyra,2576,1285,1291,49.88
Sett,Kayle,2135,1036,1099,48.52
Sett,MonkeyKing,1956,960,996,49.08
Sett,RekSai,329,202,127,61.4
Sett,Warwick,4934,2436,2498,49.37
Sett,Briar,2359,1211,1148,51.34
Sett,Yasuo,6476,3248,3228,50.15
Sett,Irelia,2806,1540,1266,54.88
Sett,Lux,7902,3995,3907,50.56
Sett,Pantheon,5099,2653,2446,52.03
Sett,Kayn,4596,2403,2193,52.28
Sett,Leblanc,1580,775,805,49.05
Sett,Sivir,1475,679,796,46.03
Sett,Pyke,2807,1502,1305,53.51
Sett,Braum,1580,795,785,50.32
Sett,XinZhao,1873,960,913,51.25
Sett,Chogath,4285,2310,1975,53.91
Sett,Taliyah,708,349,359,49.29
Sett,Darius,6908,3640,3268,52.69
Sett,Volibear,3877,1865,2012,48.1
Sett,Ezreal,6339,3378,2961,53.29
Sett,Brand,2129,1134,995,53.26
Sett,Singed,770,392,378,50.91
Sett,Ryze,901,469,432,52.05
Sett,Samira,2760,1432,1328,51.88
Sett,Soraka,1597,775,822,48.53
Sett,KSante,1634,882,752,53.98
Sett,Azir,1073,565,508,52.66
Sett,Aphelios,1604,893,711,55.67
Sett,Gnar,1264,642,622,50.79
Sett,Nunu,1926,1079,847,56.02
Sett,Jhin,5928,3104,2824,52.36
Sett,Shaco,2933,1427,1506,48.65
Sett,Ahri,4187,2116,2071,50.54
Sett,Ashe,6007,3114,2893,51.84
Sett,Poppy,1851,961,890,51.92
Sett,Nami,2803,1484,1319,52.94
Sett,Fiora,1231,709,522,57.6
Sett,Malzahar,3034,1404,1630,46.28
Sett,Zilean,811,426,385,52.53
Sett,Mel,6342,3379,2963,53.28
Sett,Tristana,3067,1660,1407,54.12
Sett,Camille,1083,539,544,49.77
Sett,MasterYi,3637,1913,1724,52.6
Sett,LeeSin,4147,2249,1898,54.23
Sett,Riven,1367,733,634,53.62
Sett,Jax,2822,1454,1368,51.52
Sett,Naafiri,1122,549,573,48.93
Sett,MissFortune,7296,3643,3653,49.93
Sett,Nocturne,3490,1704,1786,48.83
Sett,Aatrox,3063,1558,1505,50.87
Sett,Swain,3158,1509,1649,47.78
Sett,Jinx,7720,3786,3934,49.04
Sett,Ambessa,2030,1105,925,54.43
Sett,Nilah,1252,622,630,49.68
Sett,Kled,562,325,237,57.83
Sett,Leona,2748,1429,1319,52
Sett,Nasus,2068,983,1085,47.53
Sett,Kindred,1563,887,676,56.75
Sett,Nautilus,3446,1826,1620,52.99
Sett,Elise,2003,1063,940,53.07
Sett,Garen,5199,2618,2581,50.36
Sett,Senna,2328,1221,1107,52.45
Sett,Illaoi,1737,848,889,48.82
Sett,Sylas,3894,2153,1741,55.29
Sett,Cassiopeia,907,486,421,53.58
Sett,Caitlyn,8087,4290,3797,53.05
Sett,Teemo,3472,1725,1747,49.68
Sett,Mordekaiser,4930,2392,2538,48.52
Sett,Sejuani,1299,687,612,52.89
Sett,Alistar,1258,622,636,49.44
Sett,Lulu,3187,1593,1594,49.98
Sett,DrMundo,1953,965,988,49.41
Sett,Viktor,2443,1216,1227,49.77
Sett,Rammus,915,447,468,48.85
Sett,Fizz,1634,858,776,52.51
Sett,TahmKench,2836,1536,1300,54.16
Sett,Jayce,1225,623,602,50.86
Sett,Skarner,907,492,415,54.24
Sett,Veigar,3248,1619,1629,49.85
Sett,Karma,2806,1431,1375,51
Sett,AurelionSol,1225,629,596,51.35
Sett,Kalista,988,536,452,54.25
Sett,Talon,1757,1014,743,57.71
Sett,Evelynn,1198,601,597,50.17
Sett,Graves,1800,930,870,51.67
Sett,Twitch,2493,1377,1116,55.23
Sett,Kaisa,4670,2414,2256,51.69
Sett,Taric,628,278,350,44.27
Sett,Aurora,2282,1241,1041,54.38
Sett,Zeri,1185,641,544,54.09
Sett,Vayne,3491,1665,1826,47.69
Sett,Draven,1498,875,623,58.41
Sett,Vex,1644,832,812,50.61
Sett,Gragas,1793,958,835,53.43
Sett,Annie,983,569,414,57.88
Sett,Ornn,1315,696,619,52.93
Sett,Zed,3129,1629,1500,52.06
Sett,Ivern,495,240,255,48.48
Sett,Yuumi,2503,1317,1186,52.62
Sett,Rumble,756,392,364,51.85
Sett,Akshan,995,536,459,53.87
Sett,Sona,926,459,467,49.57
Sett,Morgana,3891,1920,1971,49.34
Sett,Ziggs,1222,629,593,51.47
Sett,Akali,3408,1833,1575,53.79
Sett,Shen,2104,1112,992,52.85
Sett,Khazix,1524,865,659,56.76
Sett,Varus,2796,1467,1329,52.47
Sett,Thresh,3920,1985,1935,50.64
Sett,Blitzcrank,2501,1354,1147,54.14
Sett,Urgot,1761,864,897,49.06
Sett,Anivia,979,475,504,48.52
Sett,Gangplank,1222,717,505,58.67
Sett,Bard,890,442,448,49.66
Sett,Kennen,928,499,429,53.77
Sett,TwistedFate,1031,536,495,51.99
Sett,Qiyana,824,534,290,64.81
Sett,Zoe,1205,655,550,54.36
Sett,Milio,1507,731,776,48.51
Sett,Rell,1671,859,812,51.41
Sett,Vladimir,1738,923,815,53.11
Sett,FiddleSticks,1567,813,754,51.88
Sett,Hecarim,1073,601,472,56.01
Sett,Shyvana,772,403,369,52.2
Sett,Smolder,2117,1145,972,54.09
Sett,Neeko,1709,941,768,55.06
Sett,Heimerdinger,1624,801,823,49.32
Sett,Zac,1387,721,666,51.98
Sett,Katarina,2551,1370,1181,53.7
Sett,Syndra,1718,845,873,49.19
Sett,Udyr,1223,625,598,51.1
Sett,Xayah,1710,938,772,54.85
Sett,Vi,2900,1432,1468,49.38
Sett,Tryndamere,1578,831,747,52.66
Sett,Orianna,1150,597,553,51.91
Sett,Kassadin,542,216,326,39.85
Sett,Karthus,850,447,403,52.59
Sett,Galio,2702,1341,1361,49.63
Sett,Sion,2592,1280,1312,49.38
Sett,Rengar,1005,617,388,61.39
Sett,Corki,1031,589,442,57.13
Sett,Renekton,1825,980,845,53.7
Sett,Xerath,2719,1425,1294,52.41
Sett,Trundle,1785,844,941,47.28
Sett,Lillia,1740,855,885,49.14
Sett,Quinn,984,519,465,52.74
Sett,Amumu,3274,1620,1654,49.48
Sett,Lissandra,887,466,421,52.54
Sett,Olaf,680,376,304,55.29
Sett,Nidalee,853,453,400,53.11
Sett,Renata,470,281,189,59.79
Sett,Janna,817,405,412,49.57
Sett,Velkoz,1830,966,864,52.79
Sett,KogMaw,994,455,539,45.77
Sett,Belveth,721,407,314,56.45
Warwick,Malphite,2737,1347,1390,49.21
Warwick,Ekko,2774,1399,1375,50.43
Warwick,Hwei,1866,958,908,51.34
Warwick,Lucian,1810,988,822,54.59
Warwick,Maokai,1288,708,580,54.97
Warwick,Aatrox,2540,1313,1227,51.69
Warwick,Sylas,3741,1964,1777,52.5
Warwick,Diana,4658,2575,2083,55.28
Warwick,Varus,2375,1309,1066,55.12
Warwick,Blitzcrank,2216,1264,952,57.04
Warwick,Vladimir,1594,834,760,52.32
Warwick,Darius,6173,3156,3017,51.13
Warwick,Lux,7841,4092,3749,52.19
Warwick,KogMaw,1007,476,531,47.27
Warwick,Yuumi,2257,1193,1064,52.86
Warwick,Illaoi,1561,852,709,54.58
Warwick,Nunu,2021,1073,948,53.09
Warwick,Irelia,2494,1334,1160,53.49
Warwick,Jhin,6101,3066,3035,50.25
Warwick,Swain,3195,1646,1549,51.52
Warwick,Mordekaiser,4930,2544,2386,51.6
Warwick,Viego,4100,2167,1933,52.85
Warwick,MonkeyKing,1978,1061,917,53.64
Warwick,Kayn,4999,2748,2251,54.97
Warwick,Yasuo,5997,3093,2904,51.58
Warwick,Kaisa,4279,2272,2007,53.1
Warwick,Milio,1765,869,896,49.24
Warwick,Yone,5558,3143,2415,56.55
Warwick,Tristana,3028,1609,1419,53.14
Warwick,Morgana,4033,2008,2025,49.79
Warwick,Yorick,3405,1714,1691,50.34
Warwick,LeeSin,3542,1892,1650,53.42
Warwick,MissFortune,7444,3872,3572,52.02
Warwick,Mel,6041,3339,2702,55.27
Warwick,Shaco,2883,1501,1382,52.06
Warwick,AurelionSol,1175,526,649,44.77
Warwick,Ashe,5578,2997,2581,53.73
Warwick,Velkoz,1793,955,838,53.26
Warwick,Teemo,3988,1994,1994,50
Warwick,Hecarim,1051,568,483,54.04
Warwick,Veigar,3371,1771,1600,52.54
Warwick,Thresh,3974,2089,1885,52.57
Warwick,Sett,4934,2498,2436,50.63
Warwick,Amumu,3735,1831,1904,49.02
Warwick,Caitlyn,7999,3968,4031,49.61
Warwick,Poppy,1697,912,785,53.74
Warwick,Zed,2988,1586,1402,53.08
Warwick,MasterYi,3986,2116,1870,53.09
Warwick,Rell,1556,761,795,48.91
Warwick,Jax,2960,1579,1381,53.34
Warwick,Briar,2720,1292,1428,47.5
Warwick,Ahri,4083,2205,1878,54
Warwick,Zeri,1212,629,583,51.9
Warwick,Leblanc,1419,793,626,55.88
Warwick,Ezreal,5568,3006,2562,53.99
Warwick,Kindred,1399,750,649,53.61
Warwick,Aphelios,1748,965,783,55.21
Warwick,Pyke,2718,1416,1302,52.1
Warwick,Vi,2918,1571,1347,53.84
Warwick,Azir,1016,569,447,56
Warwick,Nautilus,3292,1798,1494,54.62
Warwick,Gangplank,1108,584,524,52.71
Warwick,Annie,936,453,483,48.4
Warwick,Gwen,1808,1012,796,55.97
Warwick,Aurora,2066,1034,1032,50.05
Warwick,Karma,2534,1338,1196,52.8
Warwick,Garen,4690,2383,2307,50.81
Warwick,Gnar,1206,665,541,55.14
Warwick,Elise,1586,889,697,56.05
Warwick,Twitch,2563,1280,1283,49.94
Warwick,Heimerdinger,1615,777,838,48.11
Warwick,Trundle,2151,1114,1037,51.79
Warwick,Gragas,1595,848,747,53.17
Warwick,Vex,1681,901,780,53.6
Warwick,FiddleSticks,1387,709,678,51.12
Warwick,Soraka,1707,829,878,48.56
Warwick,KSante,1099,547,552,49.77
Warwick,Lulu,2890,1502,1388,51.97
Warwick,Corki,948,531,417,56.01
Warwick,Pantheon,4548,2377,2171,52.26
Warwick,Karthus,813,440,373,54.12
Warwick,Nilah,1230,601,629,48.86
Warwick,Braum,1400,651,749,46.5
Warwick,Akali,3276,1838,1438,56.11
Warwick,Nasus,2418,1211,1207,50.08
Warwick,Renata,568,287,281,50.53
Warwick,Lillia,1740,890,850,51.15
Warwick,Chogath,3915,1993,1922,50.91
Warwick,Alistar,1079,519,560,48.1
Warwick,Samira,2520,1396,1124,55.4
Warwick,Olaf,709,354,355,49.93
Warwick,Katarina,2294,1368,926,59.63
Warwick,Smolder,1907,1033,874,54.17
Warwick,Udyr,1155,577,578,49.96
Warwick,Galio,2498,1173,1325,46.96
Warwick,Fizz,1880,1000,880,53.19
Warwick,Taric,646,301,345,46.59
Warwick,Evelynn,1290,707,583,54.81
Warwick,Kayle,2061,1078,983,52.3
Warwick,Volibear,4097,2134,1963,52.09
Warwick,Rengar,1011,539,472,53.31
Warwick,Vayne,3674,1913,1761,52.07
Warwick,Senna,2349,1197,1152,50.96
Warwick,Zilean,763,390,373,51.11
Warwick,Fiora,1086,584,502,53.78
Warwick,Sivir,1507,861,646,57.13
Warwick,Xerath,2393,1201,1192,50.19
Warwick,Leona,2664,1378,1286,51.73
Warwick,Singed,763,368,395,48.23
Warwick,Belveth,738,365,373,49.46
Warwick,Neeko,1671,875,796,52.36
Warwick,Tryndamere,1862,1054,808,56.61
Warwick,Nocturne,3681,1841,1840,50.01
Warwick,Seraphine,2847,1461,1386,51.32
Warwick,Ivern,466,250,216,53.65
Warwick,Draven,1615,821,794,50.84
Warwick,Ryze,1044,486,558,46.55
Warwick,Nami,2720,1303,1417,47.9
Warwick,Ornn,1336,737,599,55.16
Warwick,Zoe,984,565,419,57.42
Warwick,Jinx,7854,3985,3869,50.74
Warwick,Graves,1557,786,771,50.48
Warwick,Syndra,1704,822,882,48.24
Warwick,Urgot,1624,733,891,45.14
Warwick,Qiyana,721,442,279,61.3
Warwick,Quinn,1082,530,552,48.98
Warwick,Kalista,932,526,406,56.44
Warwick,Akshan,1087,584,503,53.73
Warwick,Skarner,798,461,337,57.77
Warwick,Khazix,1465,825,640,56.31
Warwick,Ziggs,1182,609,573,51.52
Warwick,TahmKench,2758,1438,1320,52.14
Warwick,Kassadin,574,257,317,44.77
Warwick,Riven,1227,673,554,54.85
Warwick,Zac,1176,550,626,46.77
Warwick,Anivia,923,460,463,49.84
Warwick,Rumble,702,413,289,58.83
Warwick,Sejuani,1199,602,597,50.21
Warwick,Sona,1047,507,540,48.42
Warwick,Bard,792,460,332,58.08
Warwick,Sion,2237,1105,1132,49.4
Warwick,Ambessa,1669,895,774,53.62
Warwick,Camille,998,543,455,54.41
Warwick,Xayah,1441,722,719,50.1
Warwick,DrMundo,1843,942,901,51.11
Warwick,Kled,555,276,279,49.73
Warwick,Malzahar,2740,1373,1367,50.11
Warwick,Brand,2270,1162,1108,51.19
Warwick,JarvanIV,1417,668,749,47.14
Warwick,Shyvana,764,370,394,48.43
Warwick,XinZhao,1770,893,877,50.45
Warwick,Janna,847,426,421,50.3
Warwick,Jayce,1056,535,521,50.66
Warwick,Talon,1745,953,792,54.61
Warwick,Rakan,1269,669,600,52.72
Warwick,Shen,1810,978,832,54.03
Warwick,Viktor,2024,1048,976,51.78
Warwick,Rammus,1154,589,565,51.04
Warwick,Kennen,769,381,388,49.54
Warwick,Cassiopeia,983,504,479,51.27
Warwick,Naafiri,1205,613,592,50.87
Warwick,Renekton,1424,720,704,50.56
Warwick,RekSai,318,188,130,59.12
Warwick,Taliyah,627,310,317,49.44
Warwick,Zyra,2567,1355,1212,52.79
Warwick,TwistedFate,967,511,456,52.84
Warwick,Orianna,1279,696,583,54.42
Warwick,Nidalee,660,406,254,61.52
Warwick,Lissandra,926,504,422,54.43
Shen,Malphite,1071,554,517,51.73
Shen,Ekko,1134,580,554,51.15
Shen,Hwei,824,409,415,49.64
Shen,Lucian,835,434,401,51.98
Shen,Maokai,572,274,298,47.9
Shen,Annie,328,178,150,54.27
Shen,Kayn,1965,962,1003,48.96
Shen,Aatrox,1066,548,518,51.41
Shen,MissFortune,2951,1409,1542,47.75
Shen,Pyke,1211,662,549,54.67
Shen,Riven,625,310,315,49.6
Shen,Ivern,231,115,116,49.78
Shen,Yasuo,2544,1328,1216,52.2
Shen,Swain,1342,622,720,46.35
Shen,Nami,1210,537,673,44.38
Shen,Gangplank,658,313,345,47.57
Shen,Taliyah,328,145,183,44.21
Shen,Sivir,651,313,338,48.08
Shen,Soraka,807,424,383,52.54
Shen,Mordekaiser,1792,886,906,49.44
Shen,Diana,1863,958,905,51.42
Shen,Ezreal,2485,1356,1129,54.57
Shen,Thresh,1844,987,857,53.52
Shen,Samira,1012,536,476,52.96
Shen,MasterYi,1363,651,712,47.76
Shen,Orianna,661,305,356,46.14
Shen,Nautilus,1445,759,686,52.53
Shen,Lillia,764,376,388,49.21
Shen,Ashe,2353,1171,1182,49.77
Shen,Velkoz,864,429,435,49.65
Shen,Jax,1206,607,599,50.33
Shen,Katarina,954,558,396,58.49
Shen,Jhin,2438,1217,1221,49.92
Shen,Ambessa,887,535,352,60.32
Shen,Rammus,394,209,185,53.05
Shen,Aurora,1036,546,490,52.7
Shen,Caitlyn,3243,1708,1535,52.67
Shen,Talon,671,364,307,54.25
Shen,LeeSin,1513,809,704,53.47
Shen,Garen,2164,1054,1110,48.71
Shen,Senna,1061,506,555,47.69
Shen,Kayle,907,433,474,47.74
Shen,Morgana,1637,745,892,45.51
Shen,Yorick,1209,539,670,44.58
Shen,Volibear,1411,712,699,50.46
Shen,Blitzcrank,1040,496,544,47.69
Shen,Malzahar,1240,582,658,46.94
Shen,Viego,1769,900,869,50.88
Shen,Galio,1082,535,547,49.45
Shen,Vayne,1740,819,921,47.07
Shen,Sylas,1507,813,694,53.95
Shen,Renekton,528,286,242,54.17
Shen,Leona,1050,514,536,48.95
Shen,Sett,2104,992,1112,47.15
Shen,Rengar,529,294,235,55.58
Shen,Kalista,386,237,149,61.4
Shen,DrMundo,637,245,392,38.46
Shen,Darius,2360,1129,1231,47.84
Shen,Viktor,1060,492,568,46.42
Shen,Lulu,1494,705,789,47.19
Shen,Chogath,1582,759,823,47.98
Shen,Ryze,452,216,236,47.79
Shen,Janna,447,228,219,51.01
Shen,Zoe,470,272,198,57.87
Shen,Gragas,866,466,400,53.81
Shen,Pantheon,1942,996,946,51.29
Shen,Kaisa,2054,1088,966,52.97
Shen,XinZhao,760,414,346,54.47
Shen,Hecarim,508,250,258,49.21
Shen,Braum,738,376,362,50.95
Shen,Urgot,581,272,309,46.82
Shen,Tristana,1231,612,619,49.72
Shen,Zyra,1038,536,502,51.64
Shen,Illaoi,666,314,352,47.15
Shen,Lux,3218,1580,1638,49.1
Shen,Camille,512,271,241,52.93
Shen,Khazix,671,349,322,52.01
Shen,Heimerdinger,646,316,330,48.92
Shen,Mel,2471,1212,1259,49.05
Shen,MonkeyKing,816,404,412,49.51
Shen,Vladimir,803,381,422,47.45
Shen,Shaco,1280,669,611,52.27
Shen,Jinx,3284,1495,1789,45.52
Shen,Nunu,798,388,410,48.62
Shen,Twitch,1051,573,478,54.52
Shen,Karma,1335,655,680,49.06
Shen,Skarner,348,168,180,48.28
Shen,Yuumi,1057,534,523,50.52
Shen,Singed,444,218,226,49.1
Shen,Bard,462,241,221,52.16
Shen,Evelynn,490,235,255,47.96
Shen,Zeri,500,255,245,51
Shen,Ziggs,527,269,258,51.04
Shen,Brand,989,457,532,46.21
Shen,Seraphine,992,515,477,51.92
Shen,Sejuani,559,268,291,47.94
Shen,Poppy,814,414,400,50.86
Shen,Irelia,1035,558,477,53.91
Shen,Leblanc,655,299,356,45.65
Shen,Vi,1159,542,617,46.76
Shen,FiddleSticks,591,306,285,51.78
Shen,Nasus,829,420,409,50.66
Shen,Ahri,1642,836,806,50.91
Shen,Trundle,765,376,389,49.15
Shen,Briar,1011,492,519,48.66
Shen,KSante,584,318,266,54.45
Shen,Vex,630,320,310,50.79
Shen,Fiora,525,253,272,48.19
Shen,Elise,892,482,410,54.04
Shen,Draven,685,352,333,51.39
Shen,Kled,328,154,174,46.95
Shen,Syndra,747,356,391,47.66
Shen,Teemo,1474,792,682,53.73
Shen,Amumu,1410,631,779,44.75
Shen,Gnar,583,331,252,56.78
Shen,Smolder,903,475,428,52.6
Shen,Warwick,1810,832,978,45.97
Shen,Ornn,589,306,283,51.95
Shen,Tryndamere,728,367,361,50.41
Shen,Yone,2341,1283,1058,54.81
Shen,Varus,1103,549,554,49.77
Shen,Neeko,649,331,318,51
Shen,Nidalee,344,208,136,60.47
Shen,Azir,500,245,255,49
Shen,Alistar,500,260,240,52
Shen,Akshan,460,244,216,53.04
Shen,Rell,720,314,406,43.61
Shen,Xayah,766,380,386,49.61
Shen,Sona,403,171,232,42.43
Shen,Udyr,568,307,261,54.05
Shen,Aphelios,728,385,343,52.88
Shen,Veigar,1363,616,747,45.19
Shen,Zed,1383,692,691,50.04
Shen,Lissandra,438,192,246,43.84
Shen,AurelionSol,545,264,281,48.44
Shen,Sion,1194,627,567,52.51
Shen,Qiyana,373,220,153,58.98
Shen,Karthus,307,156,151,50.81
Shen,Nocturne,1341,609,732,45.41
Shen,Naafiri,510,274,236,53.73
Shen,Xerath,1029,527,502,51.21
Shen,Rumble,337,166,171,49.26
Shen,Corki,512,276,236,53.91
Shen,Nilah,512,223,289,43.55
Shen,Rakan,582,322,260,55.33
Shen,Renata,267,144,123,53.93
Shen,TahmKench,1078,597,481,55.38
Shen,Milio,672,340,332,50.6
Shen,Taric,287,130,157,45.3
Shen,Akali,1170,586,584,50.09
Shen,JarvanIV,801,399,402,49.81
Shen,RekSai,190,97,93,51.05
Shen,KogMaw,434,185,249,42.63
Shen,Jayce,469,230,239,49.04
Shen,Fizz,754,413,341,54.77
Shen,Gwen,840,441,399,52.5
Shen,Belveth,321,184,137,57.32
Shen,Kindred,619,345,274,55.74
Shen,Zac,534,263,271,49.25
Shen,Kassadin,277,157,120,56.68
Shen,Kennen,314,178,136,56.69
Shen,Zilean,418,233,185,55.74
Shen,Graves,735,359,376,48.84
Shen,Shyvana,343,189,154,55.1
Shen,Olaf,368,178,190,48.37
Shen,Anivia,416,224,192,53.85
Shen,TwistedFate,365,196,169,53.7
Shen,Quinn,358,153,205,42.74
Shen,Cassiopeia,314,157,157,50
Tristana,Malphite,1847,901,946,48.78
Tristana,Ekko,1737,846,891,48.7
Tristana,Hwei,1228,611,617,49.76
Tristana,Lucian,1222,643,579,52.62
Tristana,Maokai,800,427,373,53.37
Tristana,Renekton,914,448,466,49.02
Tristana,Kayn,2865,1432,1433,49.98
Tristana,Katarina,1502,815,687,54.26
Tristana,Draven,966,470,496,48.65
Tristana,Yuumi,1538,798,740,51.89
Tristana,Vladimir,1207,535,672,44.32
Tristana,Darius,3541,1721,1820,48.6
Tristana,Lux,4859,2378,2481,48.94
Tristana,KogMaw,552,264,288,47.83
Tristana,Ambessa,1044,489,555,46.84
Tristana,Rammus,697,328,369,47.06
Tristana,Mel,3814,2013,1801,52.78
Tristana,Blitzcrank,1469,801,668,54.53
Tristana,Mordekaiser,2596,1241,1355,47.8
Tristana,Qiyana,532,309,223,58.08
Tristana,Warwick,3028,1419,1609,46.86
Tristana,Nautilus,2131,977,1154,45.85
Tristana,Yasuo,3819,1848,1971,48.39
Tristana,Sylas,2318,1244,1074,53.67
Tristana,Zed,2026,1032,994,50.94
Tristana,Sivir,869,460,409,52.93
Tristana,Gwen,1103,559,544,50.68
Tristana,Skarner,554,297,257,53.61
Tristana,Yone,3428,1673,1755,48.8
Tristana,Kaisa,2887,1492,1395,51.68
Tristana,Seraphine,1628,873,755,53.62
Tristana,Garen,2881,1422,1459,49.36
Tristana,Rakan,810,412,398,50.86
Tristana,Volibear,2250,1070,1180,47.56
Tristana,AurelionSol,742,394,348,53.1
Tristana,Caitlyn,5269,2539,2730,48.19
Tristana,TahmKench,1728,877,851,50.75
Tristana,Heimerdinger,889,400,489,44.99
Tristana,LeeSin,2420,1276,1144,52.73
Tristana,Veigar,2133,1002,1131,46.98
Tristana,Irelia,1557,773,784,49.65
Tristana,Gragas,1009,540,469,53.52
Tristana,XinZhao,1190,641,549,53.87
Tristana,Velkoz,1241,630,611,50.77
Tristana,Sett,3067,1407,1660,45.88
Tristana,Elise,1188,620,568,52.19
Tristana,Galio,1539,687,852,44.64
Tristana,Twitch,1671,871,800,52.12
Tristana,Soraka,1072,456,616,42.54
Tristana,Trundle,941,468,473,49.73
Tristana,Amumu,1930,887,1043,45.96
Tristana,Fizz,1015,564,451,55.57
Tristana,Pantheon,2940,1437,1503,48.88
Tristana,Nunu,1191,573,618,48.11
Tristana,Vex,1153,553,600,47.96
Tristana,Jinx,5344,2644,2700,49.48
Tristana,Riven,862,519,343,60.21
Tristana,JarvanIV,1059,582,477,54.96
Tristana,Taliyah,479,228,251,47.6
Tristana,Thresh,2543,1250,1293,49.15
Tristana,Jax,1832,904,928,49.34
Tristana,Diana,2817,1390,1427,49.34
Tristana,Ahri,2524,1320,1204,52.3
Tristana,Aphelios,1025,513,512,50.05
Tristana,Senna,1401,697,704,49.75
Tristana,Aurora,1492,783,709,52.48
Tristana,FiddleSticks,910,472,438,51.87
Tristana,Jhin,4052,2153,1899,53.13
Tristana,Akali,1977,997,980,50.43
Tristana,Samira,1479,672,807,45.44
Tristana,Neeko,1007,457,550,45.38
Tristana,Kindred,845,402,443,47.57
Tristana,Corki,888,471,417,53.04
Tristana,Sion,1455,720,735,49.48
Tristana,Ezreal,4143,2078,2065,50.16
Tristana,Zilean,519,255,264,49.13
Tristana,Nocturne,2284,1052,1232,46.06
Tristana,Aatrox,1650,888,762,53.82
Tristana,Swain,1981,953,1028,48.11
Tristana,Ryze,633,296,337,46.76
Tristana,Nami,1629,804,825,49.36
Tristana,Nilah,718,374,344,52.09
Tristana,Quinn,776,349,427,44.97
Tristana,Talon,1073,591,482,55.08
Tristana,Syndra,1075,475,600,44.19
Tristana,Olaf,436,222,214,50.92
Tristana,Smolder,1316,648,668,49.24
Tristana,Braum,1114,560,554,50.27
Tristana,Karma,1921,947,974,49.3
Tristana,Vayne,2474,1234,1240,49.88
Tristana,Brand,1388,679,709,48.92
Tristana,TwistedFate,622,312,310,50.16
Tristana,Teemo,2401,1119,1282,46.61
Tristana,Khazix,1013,475,538,46.89
Tristana,Varus,1617,850,767,52.57
Tristana,Sejuani,719,339,380,47.15
Tristana,Ashe,3801,2085,1716,54.85
Tristana,Malzahar,1901,845,1056,44.45
Tristana,Yorick,1918,791,1127,41.24
Tristana,Lulu,2058,1033,1025,50.19
Tristana,Naafiri,688,372,316,54.07
Tristana,Morgana,2367,1172,1195,49.51
Tristana,KSante,782,409,373,52.3
Tristana,Nidalee,546,304,242,55.68
Tristana,MasterYi,2375,1183,1192,49.81
Tristana,Pyke,1813,993,820,54.77
Tristana,Akshan,704,375,329,53.27
Tristana,Zyra,1517,736,781,48.52
Tristana,Graves,1086,499,587,45.95
Tristana,Vi,1751,853,898,48.72
Tristana,Fiora,743,420,323,56.53
Tristana,Xerath,1524,810,714,53.15
Tristana,DrMundo,1199,567,632,47.29
Tristana,Poppy,1205,539,666,44.73
Tristana,Nasus,1229,640,589,52.07
Tristana,Briar,1447,741,706,51.21
Tristana,Shyvana,500,251,249,50.2
Tristana,Viktor,1442,706,736,48.96
Tristana,Janna,627,263,364,41.95
Tristana,Kalista,630,357,273,56.67
Tristana,Rell,1047,506,541,48.33
Tristana,Evelynn,845,450,395,53.25
Tristana,Kassadin,375,191,184,50.93
Tristana,Ziggs,701,351,350,50.07
Tristana,Gnar,751,366,385,48.74
Tristana,Shen,1231,619,612,50.28
Tristana,Rumble,485,270,215,55.67
Tristana,Shaco,1829,895,934,48.93
Tristana,MissFortune,5327,2532,2795,47.53
Tristana,Zeri,718,358,360,49.86
Tristana,Kayle,1405,748,657,53.24
Tristana,Viego,2603,1321,1282,50.75
Tristana,Zac,687,319,368,46.43
Tristana,Ornn,893,410,483,45.91
Tristana,Udyr,763,394,369,51.64
Tristana,Leblanc,902,424,478,47.01
Tristana,Tryndamere,1131,546,585,48.28
Tristana,Milio,1061,459,602,43.26
Tristana,Lillia,1061,535,526,50.42
Tristana,Anivia,725,337,388,46.48
Tristana,Illaoi,960,511,449,53.23
Tristana,Jayce,725,366,359,50.48
Tristana,Leona,1639,779,860,47.53
Tristana,Azir,715,345,370,48.25
Tristana,Belveth,471,220,251,46.71
Tristana,Chogath,2405,1158,1247,48.15
Tristana,Rengar,641,342,299,53.35
Tristana,Sona,622,244,378,39.23
Tristana,Karthus,538,268,270,49.81
Tristana,Alistar,752,394,358,52.39
Tristana,MonkeyKing,1218,557,661,45.73
Tristana,Xayah,902,485,417,53.77
Tristana,Kennen,564,281,283,49.82
Tristana,Taric,402,215,187,53.48
Tristana,Lissandra,605,298,307,49.26
Tristana,Camille,608,297,311,48.85
Tristana,Urgot,930,463,467,49.78
Tristana,Zoe,783,474,309,60.54
Tristana,Gangplank,910,495,415,54.4
Tristana,Hecarim,745,389,356,52.21
Tristana,Singed,588,298,290,50.68
Tristana,Cassiopeia,706,346,360,49.01
Tristana,Ivern,315,156,159,49.52
Tristana,RekSai,222,128,94,57.66
Tristana,Bard,629,296,333,47.06
Tristana,Orianna,825,407,418,49.33
Tristana,Annie,587,314,273,53.49
Tristana,Renata,405,207,198,51.11
Tristana,Kled,390,190,200,48.72
Blitzcrank,Malphite,1342,685,657,51.04
Blitzcrank,Ekko,1255,628,627,50.04
Blitzcrank,Hwei,1066,480,586,45.03
Blitzcrank,Lucian,1045,471,574,45.07
Blitzcrank,Maokai,668,259,409,38.77
Blitzcrank,Kennen,447,215,232,48.1
Blitzcrank,Warwick,2216,952,1264,42.96
Blitzcrank,Yasuo,2871,1443,1428,50.26
Blitzcrank,Kindred,713,333,380,46.7
Blitzcrank,Lux,4491,2243,2248,49.94
Blitzcrank,Talon,863,456,407,52.84
Blitzcrank,Aurora,1170,502,668,42.91
Blitzcrank,Tristana,1469,668,801,45.47
Blitzcrank,Alistar,835,412,423,49.34
Blitzcrank,Teemo,1862,868,994,46.62
Blitzcrank,TahmKench,1354,682,672,50.37
Blitzcrank,Jinx,3685,1698,1987,46.08
Blitzcrank,Zoe,660,336,324,50.91
Blitzcrank,Nami,1243,617,626,49.64
Blitzcrank,Evelynn,649,331,318,51
Blitzcrank,Irelia,1368,689,679,50.37
Blitzcrank,Thresh,2265,1031,1234,45.52
Blitzcrank,Pantheon,2660,1259,1401,47.33
Blitzcrank,Kayn,2169,1026,1143,47.3
Blitzcrank,Leblanc,942,473,469,50.21
Blitzcrank,Sivir,1141,500,641,43.82
Blitzcrank,Pyke,1456,727,729,49.93
Blitzcrank,Volibear,1628,776,852,47.67
Blitzcrank,Akshan,494,217,277,43.93
Blitzcrank,Katarina,1145,619,526,54.06
Blitzcrank,Khazix,766,369,397,48.17
Blitzcrank,Akali,1714,773,941,45.1
Blitzcrank,Draven,655,276,379,42.14
Blitzcrank,Mel,2847,1316,1531,46.22
Blitzcrank,Viego,2123,1099,1024,51.77
Blitzcrank,Yone,3004,1497,1507,49.83
Blitzcrank,Nocturne,1771,776,995,43.82
Blitzcrank,Aatrox,1523,760,763,49.9
Blitzcrank,Swain,1543,667,876,43.23
Blitzcrank,Cassiopeia,497,284,213,57.14
Blitzcrank,Shaco,1349,683,666,50.63
Blitzcrank,Riven,694,325,369,46.83
Blitzcrank,Caitlyn,4024,1963,2061,48.78
Blitzcrank,Senna,1132,517,615,45.67
Blitzcrank,MasterYi,1673,875,798,52.3
Blitzcrank,Azir,585,289,296,49.4
Blitzcrank,Rengar,514,287,227,55.84
Blitzcrank,Gragas,876,437,439,49.89
Blitzcrank,Zed,1569,745,824,47.48
Blitzcrank,MissFortune,3355,1643,1712,48.97
Blitzcrank,Poppy,857,358,499,41.77
Blitzcrank,Leona,1714,805,909,46.97
Blitzcrank,Janna,488,246,242,50.41
Blitzcrank,Shen,1040,544,496,52.31
Blitzcrank,MonkeyKing,924,427,497,46.21
Blitzcrank,Naafiri,559,313,246,55.99
Blitzcrank,Mordekaiser,2000,968,1032,48.4
Blitzcrank,Samira,1234,555,679,44.98
Blitzcrank,Neeko,806,367,439,45.53
Blitzcrank,Olaf,411,204,207,49.64
Blitzcrank,Diana,2207,1074,1133,48.66
Blitzcrank,Ashe,3117,1563,1554,50.14
Blitzcrank,LeeSin,2441,1187,1254,48.63
Blitzcrank,Varus,1357,683,674,50.33
Blitzcrank,Tryndamere,792,431,361,54.42
Blitzcrank,Elise,1020,496,524,48.63
Blitzcrank,Nautilus,1865,844,1021,45.25
Blitzcrank,Rakan,665,268,397,40.3
Blitzcrank,Rumble,350,167,183,47.71
Blitzcrank,Qiyana,397,196,201,49.37
Blitzcrank,Kled,232,124,108,53.45
Blitzcrank,Taliyah,402,187,215,46.52
Blitzcrank,Ezreal,3847,1910,1937,49.65
Blitzcrank,Yorick,1270,515,755,40.55
Blitzcrank,Illaoi,788,344,444,43.65
Blitzcrank,Fizz,764,393,371,51.44
Blitzcrank,Kaisa,2172,1064,1108,48.99
Blitzcrank,Sion,1068,507,561,47.47
Blitzcrank,Jayce,759,354,405,46.64
Blitzcrank,KogMaw,431,193,238,44.78
Blitzcrank,XinZhao,922,475,447,51.52
Blitzcrank,Hecarim,573,315,258,54.97
Blitzcrank,Jhin,2731,1420,1311,52
Blitzcrank,Velkoz,904,404,500,44.69
Blitzcrank,Sett,2501,1147,1354,45.86
Blitzcrank,Zilean,438,182,256,41.55
Blitzcrank,AurelionSol,637,288,349,45.21
Blitzcrank,Xayah,872,393,479,45.07
Blitzcrank,Singed,348,142,206,40.8
Blitzcrank,Orianna,718,349,369,48.61
Blitzcrank,Trundle,890,383,507,43.03
Blitzcrank,Ivern,239,140,99,58.58
Blitzcrank,Darius,2768,1298,1470,46.89
Blitzcrank,FiddleSticks,694,353,341,50.86
Blitzcrank,Chogath,1783,766,1017,42.96
Blitzcrank,Renekton,802,410,392,51.12
Blitzcrank,Seraphine,1237,685,552,55.38
Blitzcrank,Gwen,768,369,399,48.05
Blitzcrank,Zeri,662,331,331,50
Blitzcrank,Zyra,1390,641,749,46.12
Blitzcrank,Heimerdinger,720,342,378,47.5
Blitzcrank,DrMundo,832,442,390,53.13
Blitzcrank,Soraka,762,343,419,45.01
Blitzcrank,Ahri,2127,956,1171,44.95
Blitzcrank,Sylas,2305,1093,1212,47.42
Blitzcrank,Nunu,958,509,449,53.13
Blitzcrank,Twitch,1095,585,510,53.42
Blitzcrank,Karma,1550,744,806,48
Blitzcrank,Milio,788,388,400,49.24
Blitzcrank,KSante,795,416,379,52.33
Blitzcrank,Karthus,437,211,226,48.28
Blitzcrank,Morgana,2044,952,1092,46.58
Blitzcrank,Xerath,1432,657,775,45.88
Blitzcrank,Nidalee,442,250,192,56.56
Blitzcrank,Amumu,1480,696,784,47.03
Blitzcrank,Renata,228,114,114,50
Blitzcrank,Gangplank,720,386,334,53.61
Blitzcrank,Kayle,878,425,453,48.41
Blitzcrank,Sejuani,605,276,329,45.62
Blitzcrank,Nasus,1011,488,523,48.27
Blitzcrank,Rell,811,401,410,49.45
Blitzcrank,Ryze,519,256,263,49.33
Blitzcrank,Viktor,1216,548,668,45.07
Blitzcrank,Vladimir,864,428,436,49.54
Blitzcrank,Yuumi,1216,620,596,50.99
Blitzcrank,Brand,999,533,466,53.35
Blitzcrank,Malzahar,1314,585,729,44.52
Blitzcrank,Smolder,889,438,451,49.27
Blitzcrank,Garen,2260,1053,1207,46.59
Blitzcrank,JarvanIV,742,294,448,39.62
Blitzcrank,Galio,1174,573,601,48.81
Blitzcrank,Ziggs,611,304,307,49.75
Blitzcrank,Sona,370,192,178,51.89
Blitzcrank,Camille,492,242,250,49.19
Blitzcrank,Veigar,1580,752,828,47.59
Blitzcrank,Vex,884,442,442,50
Blitzcrank,Fiora,537,237,300,44.13
Blitzcrank,Nilah,507,208,299,41.03
Blitzcrank,Jax,1333,627,706,47.04
Blitzcrank,Lulu,1870,949,921,50.75
Blitzcrank,Syndra,890,446,444,50.11
Blitzcrank,Gnar,606,272,334,44.88
Blitzcrank,Vi,1329,671,658,50.49
Blitzcrank,Udyr,555,287,268,51.71
Blitzcrank,Braum,919,406,513,44.18
Blitzcrank,Kassadin,295,148,147,50.17
Blitzcrank,Lissandra,405,179,226,44.2
Blitzcrank,Vayne,1676,789,887,47.08
Blitzcrank,Ambessa,1048,559,489,53.34
Blitzcrank,Kalista,528,316,212,59.85
Blitzcrank,Corki,573,312,261,54.45
Blitzcrank,Lillia,986,455,531,46.15
Blitzcrank,Shyvana,404,170,234,42.08
Blitzcrank,Graves,934,432,502,46.25
Blitzcrank,TwistedFate,543,288,255,53.04
Blitzcrank,Zac,735,333,402,45.31
Blitzcrank,Aphelios,844,444,400,52.61
Blitzcrank,Annie,473,219,254,46.3
Blitzcrank,Anivia,416,219,197,52.64
Blitzcrank,Urgot,674,385,289,57.12
Blitzcrank,Taric,322,135,187,41.93
Blitzcrank,Ornn,688,328,360,47.67
Blitzcrank,Briar,1171,445,726,38
Blitzcrank,Bard,376,206,170,54.79
Blitzcrank,Skarner,461,257,204,55.75
Blitzcrank,Rammus,489,226,263,46.22
Blitzcrank,Belveth,310,158,152,50.97
Blitzcrank,Quinn,539,301,238,55.84
Blitzcrank,RekSai,209,109,100,52.15
Malphite,Sett,2929,1497,1432,51.11
Malphite,Warwick,2737,1390,1347,50.79
Malphite,Shen,1071,517,554,48.27
Malphite,Tristana,1847,946,901,51.22
Malphite,Blitzcrank,1342,657,685,48.96
Malphite,Pantheon,3273,1747,1526,53.38
Malphite,MasterYi,2185,1057,1128,48.38
Malphite,Sylas,3734,1660,2074,44.46
Malphite,Ashe,3586,1834,1752,51.14
Malphite,Karma,1951,922,1029,47.26
Malphite,Gangplank,834,440,394,52.76
Malphite,Brand,1314,617,697,46.96
Malphite,Irelia,1785,993,792,55.63
Malphite,Malzahar,1878,955,923,50.85
Malphite,Pyke,1836,1077,759,58.66
Malphite,Yasuo,4114,2155,1959,52.38
Malphite,Zed,2776,1551,1225,55.87
Malphite,Sivir,1059,521,538,49.2
Malphite,FiddleSticks,884,419,465,47.4
Malphite,Shaco,1771,907,864,51.21
Malphite,Syndra,1084,584,500,53.87
Malphite,Kalista,620,342,278,55.16
Malphite,Thresh,2603,1324,1279,50.86
Malphite,DrMundo,1033,465,568,45.01
Malphite,Belveth,487,296,191,60.78
Malphite,Leblanc,958,524,434,54.7
Malphite,Briar,1525,744,781,48.79
Malphite,Anivia,491,236,255,48.07
Malphite,Akali,1794,915,879,51
Malphite,Rammus,626,308,318,49.2
Malphite,Jinx,4946,2416,2530,48.85
Malphite,Zyra,1577,789,788,50.03
Malphite,Fiora,610,386,224,63.28
Malphite,Kayn,2977,1452,1525,48.77
Malphite,Aphelios,1117,617,500,55.24
Malphite,Zilean,591,294,297,49.75
Malphite,KSante,771,368,403,47.73
Malphite,Viego,2678,1365,1313,50.97
Malphite,Vex,981,525,456,53.52
Malphite,Senna,1535,841,694,54.79
Malphite,Jax,1565,801,764,51.18
Malphite,Evelynn,653,344,309,52.68
Malphite,Mel,3655,1858,1797,50.83
Malphite,Renata,383,209,174,54.57
Malphite,Heimerdinger,899,413,486,45.94
Malphite,Katarina,1409,752,657,53.37
Malphite,Caitlyn,4976,2541,2435,51.07
Malphite,Zac,813,416,397,51.17
Malphite,Nunu,1112,585,527,52.61
Malphite,Veigar,1974,925,1049,46.86
Malphite,Kaisa,2778,1474,1304,53.06
Malphite,Nasus,1500,732,768,48.8
Malphite,Vi,1710,869,841,50.82
Malphite,Lux,4998,2513,2485,50.28
Malphite,Alistar,737,357,380,48.44
Malphite,Samira,1426,740,686,51.89
Malphite,Chogath,2199,976,1223,44.38
Malphite,Lillia,1134,553,581,48.77
Malphite,Jhin,3601,1884,1717,52.32
Malphite,Janna,531,226,305,42.56
Malphite,Yorick,1711,779,932,45.53
Malphite,Kindred,904,501,403,55.42
Malphite,Lulu,2170,1189,981,54.79
Malphite,TahmKench,1630,768,862,47.12
Malphite,Diana,2675,1297,1378,48.49
Malphite,Darius,3255,1614,1641,49.59
Malphite,Twitch,1547,831,716,53.72
Malphite,Teemo,3519,1720,1799,48.88
Malphite,Bard,512,251,261,49.02
Malphite,Mordekaiser,2852,1239,1613,43.44
Malphite,Swain,1833,828,1005,45.17
Malphite,Tryndamere,1442,769,673,53.33
Malphite,Elise,1192,596,596,50
Malphite,Nautilus,2176,1142,1034,52.48
Malphite,Varus,1634,861,773,52.69
Malphite,Rakan,896,440,456,49.11
Malphite,Quinn,1116,566,550,50.72
Malphite,Aatrox,1792,876,916,48.88
Malphite,Rengar,667,379,288,56.82
Malphite,Galio,1683,797,886,47.36
Malphite,Sona,614,291,323,47.39
Malphite,Kennen,574,303,271,52.79
Malphite,MissFortune,4402,2158,2244,49.02
Malphite,Morgana,2343,1097,1246,46.82
Malphite,Viktor,1468,723,745,49.25
Malphite,Volibear,1898,961,937,50.63
Malphite,Azir,616,324,292,52.6
Malphite,Xayah,1100,504,596,45.82
Malphite,Garen,2762,1294,1468,46.85
Malphite,Singed,475,203,272,42.74
Malphite,Smolder,1364,741,623,54.33
Malphite,Skarner,466,247,219,53
Malphite,Aurora,1346,689,657,51.19
Malphite,Ryze,563,269,294,47.78
Malphite,Illaoi,923,459,464,49.73
Malphite,Yone,3871,2079,1792,53.71
Malphite,Akshan,821,429,392,52.25
Malphite,Yuumi,1558,791,767,50.77
Malphite,Amumu,1933,871,1062,45.06
Malphite,Ivern,253,126,127,49.8
Malphite,Soraka,920,488,432,53.04
Malphite,Kayle,1424,694,730,48.74
Malphite,Seraphine,1679,876,803,52.17
Malphite,JarvanIV,1115,555,560,49.78
Malphite,Draven,1017,549,468,53.98
Malphite,Gnar,1207,649,558,53.77
Malphite,Zoe,732,443,289,60.52
Malphite,Ezreal,4478,2238,2240,49.98
Malphite,Hwei,1186,624,562,52.61
Malphite,Graves,1098,645,453,58.74
Malphite,Orianna,743,369,374,49.66
Malphite,Neeko,953,467,486,49
Malphite,Ornn,831,395,436,47.53
Malphite,Ekko,1585,760,825,47.95
Malphite,Renekton,844,433,411,51.3
Malphite,Kassadin,386,190,196,49.22
Malphite,Gwen,1162,610,552,52.5
Malphite,Nami,1919,901,1018,46.95
Malphite,Poppy,1052,532,520,50.57
Malphite,AurelionSol,725,346,379,47.72
Malphite,Nilah,771,390,381,50.58
Malphite,Ziggs,788,335,453,42.51
Malphite,Leona,1803,893,910,49.53
Malphite,Riven,945,555,390,58.73
Malphite,Khazix,947,530,417,55.97
Malphite,Qiyana,574,321,253,55.92
Malphite,Gragas,951,557,394,58.57
Malphite,Velkoz,1160,580,580,50
Malphite,Nocturne,2242,1025,1217,45.72
Malphite,Udyr,765,390,375,50.98
Malphite,Sion,1459,687,772,47.09
Malphite,Trundle,1079,554,525,51.34
Malphite,Sejuani,757,394,363,52.05
Malphite,Ahri,2398,1238,1160,51.63
Malphite,Vayne,2871,1506,1365,52.46
Malphite,Xerath,1582,760,822,48.04
Malphite,Camille,522,282,240,54.02
Malphite,Naafiri,687,368,319,53.57
Malphite,Taliyah,476,257,219,53.99
Malphite,Lucian,1346,678,668,50.37
Malphite,Talon,1124,545,579,48.49
Malphite,Annie,577,257,320,44.54
Malphite,Cassiopeia,543,275,268,50.64
Malphite,Milio,1104,545,559,49.37
Malphite,XinZhao,1125,550,575,48.89
Malphite,Vladimir,1085,524,561,48.29
Malphite,Rell,962,457,505,47.51
Malphite,LeeSin,2540,1342,1198,52.83
Malphite,Shyvana,494,235,259,47.57
Malphite,TwistedFate,556,301,255,54.14
Malphite,Lissandra,631,317,314,50.24
Malphite,Fizz,973,448,525,46.04
Malphite,KogMaw,571,296,275,51.84
Malphite,Karthus,484,272,212,56.2
Malphite,Urgot,913,449,464,49.18
Malphite,Maokai,767,353,414,46.02
Malphite,Corki,652,316,336,48.47
Malphite,Ambessa,1084,652,432,60.15
Malphite,Nidalee,543,283,260,52.12
Malphite,Rumble,487,266,221,54.62
Malphite,RekSai,219,107,112,48.86
Malphite,Taric,387,203,184,52.45
Malphite,Olaf,406,156,250,38.42
Malphite,Hecarim,707,348,359,49.22
Malphite,Zeri,805,422,383,52.42
Malphite,Jayce,953,501,452,52.57
Malphite,MonkeyKing,1155,538,617,46.58
Malphite,Braum,1038,576,462,55.49
Malphite,Kled,287,169,118,58.89
Ekko,Sett,2708,1299,1409,47.97
Ekko,Warwick,2774,1375,1399,49.57
Ekko,Shen,1134,554,580,48.85
Ekko,Tristana,1737,891,846,51.3
Ekko,Blitzcrank,1255,627,628,49.96
Ekko,Mordekaiser,2277,1143,1134,50.2
Ekko,Viego,2470,1217,1253,49.27
Ekko,Kindred,891,414,477,46.46
Ekko,Jhin,3571,1828,1743,51.19
Ekko,TahmKench,1612,867,745,53.78
Ekko,Darius,3254,1566,1688,48.13
Ekko,Rengar,721,388,333,53.81
Ekko,Syndra,1187,593,594,49.96
Ekko,Caitlyn,4721,2242,2479,47.49
Ekko,Lux,4501,2178,2323,48.39
Ekko,Renekton,931,474,457,50.91
Ekko,Kayn,2751,1445,1306,52.53
Ekko,Vex,895,405,490,45.25
Ekko,Samira,1506,717,789,47.61
Ekko,Lulu,1998,1087,911,54.4
Ekko,Karma,1817,870,947,47.88
Ekko,Rammus,539,304,235,56.4
Ekko,Yone,3124,1671,1453,53.49
Ekko,Nocturne,2102,1013,1089,48.19
Ekko,Lissandra,628,299,329,47.61
Ekko,Pantheon,2809,1399,1410,49.8
Ekko,Ryze,611,304,307,49.75
Ekko,Jinx,4679,2331,2348,49.82
Ekko,Nami,1757,830,927,47.24
Ekko,Aatrox,1572,853,719,54.26
Ekko,Shaco,1808,932,876,51.55
Ekko,Leblanc,902,437,465,48.45
Ekko,Draven,961,468,493,48.7
Ekko,Hwei,1220,657,563,53.85
Ekko,Nasus,1189,562,627,47.27
Ekko,Zoe,767,410,357,53.46
Ekko,Ashe,3363,1658,1705,49.3
Ekko,Senna,1358,687,671,50.59
Ekko,Mel,3724,1885,1839,50.62
Ekko,Lucian,1211,631,580,52.11
Ekko,Thresh,2283,1162,1121,50.9
Ekko,RekSai,213,112,101,52.58
Ekko,Braum,984,468,516,47.56
Ekko,Illaoi,842,412,430,48.93
Ekko,MonkeyKing,1142,510,632,44.66
Ekko,Vayne,2265,1168,1097,51.57
Ekko,Morgana,2122,1045,1077,49.25
Ekko,XinZhao,1154,556,598,48.18
Ekko,Irelia,1517,731,786,48.19
Ekko,Soraka,1113,566,547,50.85
Ekko,Teemo,2182,1036,1146,47.48
Ekko,Khazix,948,504,444,53.16
Ekko,Vladimir,1086,561,525,51.66
Ekko,Corki,650,342,308,52.62
Ekko,Pyke,1615,856,759,53
Ekko,Singed,549,295,254,53.73
Ekko,Yasuo,3382,1707,1675,50.47
Ekko,Alistar,812,387,425,47.66
Ekko,Nautilus,1857,982,875,52.88
Ekko,Lillia,1133,556,577,49.07
Ekko,FiddleSticks,918,432,486,47.06
Ekko,Akali,1936,1008,928,52.07
Ekko,Evelynn,772,397,375,51.42
Ekko,Ahri,2391,1213,1178,50.73
Ekko,Chogath,2251,1109,1142,49.27
Ekko,Velkoz,1076,507,569,47.12
Ekko,Trundle,1044,460,584,44.06
Ekko,Leona,1638,754,884,46.03
Ekko,Heimerdinger,883,435,448,49.26
Ekko,Varus,1519,810,709,53.32
Ekko,Maokai,799,383,416,47.93
Ekko,MasterYi,2100,1045,1055,49.76
Ekko,Swain,1664,780,884,46.88
Ekko,MissFortune,3971,1949,2022,49.08
Ekko,Sion,1332,629,703,47.22
Ekko,Twitch,1574,817,757,51.91
Ekko,Rell,828,420,408,50.72
Ekko,Kayle,1265,609,656,48.14
Ekko,Shyvana,462,211,251,45.67
Ekko,Galio,1546,746,800,48.25
Ekko,Seraphine,1452,721,731,49.66
Ekko,Sona,638,308,330,48.28
Ekko,Ezreal,3881,2014,1867,51.89
Ekko,Garen,2741,1368,1373,49.91
Ekko,Tryndamere,952,483,469,50.74
Ekko,Ivern,281,141,140,50.18
Ekko,Graves,983,551,432,56.05
Ekko,Katarina,1380,763,617,55.29
Ekko,Annie,517,240,277,46.42
Ekko,Veigar,1910,910,1000,47.64
Ekko,Gangplank,824,400,424,48.54
Ekko,Volibear,2004,961,1043,47.95
Ekko,Qiyana,518,301,217,58.11
Ekko,Taliyah,477,217,260,45.49
Ekko,Urgot,896,378,518,42.19
Ekko,Xerath,1515,828,687,54.65
Ekko,Poppy,1090,524,566,48.07
Ekko,Talon,1100,513,587,46.64
Ekko,AurelionSol,669,325,344,48.58
Ekko,KSante,845,436,409,51.6
Ekko,Fiora,769,413,356,53.71
Ekko,Aurora,1285,683,602,53.15
Ekko,LeeSin,2454,1258,1196,51.26
Ekko,Xayah,861,464,397,53.89
Ekko,DrMundo,988,547,441,55.36
Ekko,JarvanIV,895,458,437,51.17
Ekko,Hecarim,724,371,353,51.24
Ekko,Orianna,747,395,352,52.88
Ekko,Zyra,1522,691,831,45.4
Ekko,Sejuani,657,307,350,46.73
Ekko,Bard,595,335,260,56.3
Ekko,Nilah,586,293,293,50
Ekko,Viktor,1600,801,799,50.06
Ekko,Zeri,730,326,404,44.66
Ekko,Brand,1256,569,687,45.3
Ekko,Diana,2693,1304,1389,48.42
Ekko,Ziggs,667,312,355,46.78
Ekko,Riven,984,517,467,52.54
Ekko,Briar,1459,706,753,48.39
Ekko,Kaisa,2570,1320,1250,51.36
Ekko,Jax,1586,736,850,46.41
Ekko,Sylas,2337,1195,1142,51.13
Ekko,Yuumi,1395,685,710,49.1
Ekko,Aphelios,1020,536,484,52.55
Ekko,Zed,2387,1220,1167,51.11
Ekko,Ornn,730,334,396,45.75
Ekko,Zac,821,418,403,50.91
Ekko,Belveth,332,161,171,48.49
Ekko,Naafiri,641,315,326,49.14
Ekko,Amumu,1922,912,1010,47.45
Ekko,Renata,291,154,137,52.92
Ekko,Zilean,578,306,272,52.94
Ekko,Rumble,420,223,197,53.1
Ekko,Smolder,1174,597,577,50.85
Ekko,Janna,561,291,270,51.87
Ekko,Neeko,860,445,415,51.74
Ekko,Kassadin,440,179,261,40.68
Ekko,Karthus,460,261,199,56.74
Ekko,Azir,609,304,305,49.92
Ekko,Sivir,910,465,445,51.1
Ekko,Malphite,1585,825,760,52.05
Ekko,Milio,1084,489,595,45.11
Ekko,Nunu,1184,605,579,51.1
Ekko,Fizz,1049,499,550,47.57
Ekko,Vi,1565,823,742,52.59
Ekko,Gragas,1066,574,492,53.85
Ekko,Malzahar,1753,886,867,50.54
Ekko,Kennen,499,276,223,55.31
Ekko,Kalista,505,270,235,53.47
Ekko,Udyr,659,325,334,49.32
Ekko,Gwen,980,484,496,49.39
Ekko,Kled,342,154,188,45.03
Ekko,Camille,592,315,277,53.21
Ekko,Gnar,667,408,259,61.17
Ekko,TwistedFate,588,274,314,46.6
Ekko,Anivia,505,250,255,49.5
Ekko,Yorick,1748,754,994,43.14
Ekko,Elise,1399,711,688,50.82
Ekko,KogMaw,526,287,239,54.56
Ekko,Nidalee,431,250,181,58
Ekko,Skarner,498,276,222,55.42
Ekko,Rakan,802,369,433,46.01
Ekko,Quinn,632,332,300,52.53
Ekko,Taric,396,181,215,45.71
Ekko,Ambessa,1132,573,559,50.62
Ekko,Jayce,717,361,356,50.35
Ekko,Akshan,636,309,327,48.58
Ekko,Olaf,439,230,209,52.39
Ekko,Cassiopeia,549,300,249,54.64
Hwei,Sett,2033,934,1099,45.94
Hwei,Warwick,1866,908,958,48.66
Hwei,Shen,824,415,409,50.36
Hwei,Tristana,1228,617,611,50.24
Hwei,Blitzcrank,1066,586,480,54.97
Hwei,Mordekaiser,1874,963,911,51.39
Hwei,Sejuani,586,274,312,46.76
Hwei,Yasuo,2477,1183,1294,47.76
Hwei,Lucian,831,453,378,54.51
Hwei,Pantheon,2178,1123,1055,51.56
Hwei,Fiora,569,237,332,41.65
Hwei,Katarina,1142,627,515,54.9
Hwei,Mel,2759,1482,1277,53.72
Hwei,Viktor,1516,702,814,46.31
Hwei,Gwen,775,409,366,52.77
Hwei,Vi,1311,631,680,48.13
Hwei,Zed,1393,633,760,45.44
Hwei,Jhin,2827,1341,1486,47.44
Hwei,Soraka,730,386,344,52.88
Hwei,Irelia,1186,536,650,45.19
Hwei,Kassadin,307,148,159,48.21
Hwei,Yuumi,1181,585,596,49.53
Hwei,Akali,1312,688,624,52.44
Hwei,Velkoz,847,383,464,45.22
Hwei,Yorick,1237,557,680,45.03
Hwei,Samira,1081,575,506,53.19
Hwei,Nami,1420,677,743,47.68
Hwei,Volibear,1481,770,711,51.99
Hwei,LeeSin,1875,1036,839,55.25
Hwei,Malzahar,1367,671,696,49.09
Hwei,Caitlyn,3582,1952,1630,54.49
Hwei,Pyke,1339,693,646,51.76
Hwei,Teemo,1621,827,794,51.02
Hwei,Khazix,879,460,419,52.33
Hwei,Smolder,866,417,449,48.15
Hwei,MissFortune,2866,1398,1468,48.78
Hwei,Rell,698,307,391,43.98
Hwei,Ekko,1220,563,657,46.15
Hwei,TahmKench,1242,627,615,50.48
Hwei,Gangplank,579,301,278,51.99
Hwei,Diana,1937,981,956,50.65
Hwei,Aphelios,910,427,483,46.92
Hwei,Leona,1111,536,575,48.24
Hwei,Illaoi,608,294,314,48.36
Hwei,Nocturne,1500,767,733,51.13
Hwei,Seraphine,1182,639,543,54.06
Hwei,Amumu,1289,656,633,50.89
Hwei,Lissandra,347,215,132,61.96
Hwei,Kayn,1884,909,975,48.25
Hwei,Ezreal,2923,1529,1394,52.31
Hwei,Yone,2358,1214,1144,51.48
Hwei,Darius,2708,1424,1284,52.58
Hwei,Ahri,2038,1040,998,51.03
Hwei,Jinx,3347,1596,1751,47.68
Hwei,Karma,1466,685,781,46.73
Hwei,Ambessa,792,396,396,50
Hwei,Ashe,2741,1467,1274,53.52
Hwei,Varus,1230,564,666,45.85
Hwei,Graves,734,382,352,52.04
Hwei,Neeko,780,402,378,51.54
Hwei,Rengar,498,287,211,57.63
Hwei,Syndra,1092,526,566,48.17
Hwei,Xayah,726,379,347,52.2
Hwei,Thresh,1800,903,897,50.17
Hwei,Sion,1017,479,538,47.1
Hwei,Xerath,1346,689,657,51.19
Hwei,Lulu,1692,890,802,52.6
Hwei,Nidalee,434,247,187,56.91
Hwei,KogMaw,390,162,228,41.54
Hwei,Nautilus,1482,778,704,52.5
Hwei,Veigar,1457,715,742,49.07
Hwei,FiddleSticks,652,324,328,49.69
Hwei,Gnar,562,311,251,55.34
Hwei,AurelionSol,573,271,302,47.29
Hwei,Poppy,792,403,389,50.88
Hwei,Ryze,437,225,212,51.49
Hwei,Udyr,540,300,240,55.56
Hwei,Briar,1133,580,553,51.19
Hwei,Renekton,622,350,272,56.27
Hwei,Kaisa,2015,1020,995,50.62
Hwei,Heimerdinger,644,302,342,46.89
Hwei,Braum,751,387,364,51.53
Hwei,Jax,1193,563,630,47.19
Hwei,Zeri,595,331,264,55.63
Hwei,Naafiri,431,198,233,45.94
Hwei,Lux,3506,1778,1728,50.71
Hwei,Bard,384,156,228,40.63
Hwei,Evelynn,562,256,306,45.55
Hwei,Viego,1888,930,958,49.26
Hwei,Qiyana,364,197,167,54.12
Hwei,Taric,257,106,151,41.25
Hwei,Vex,735,398,337,54.15
Hwei,Sona,419,208,211,49.64
Hwei,DrMundo,691,323,368,46.74
Hwei,Kayle,992,523,469,52.72
Hwei,Draven,766,361,405,47.13
Hwei,Tryndamere,770,412,358,53.51
Hwei,MonkeyKing,912,441,471,48.36
Hwei,Elise,1020,465,555,45.59
Hwei,Aurora,1113,620,493,55.71
Hwei,Quinn,461,200,261,43.38
Hwei,Galio,1265,613,652,48.46
Hwei,Kennen,461,251,210,54.45
Hwei,Belveth,339,139,200,41
Hwei,Brand,1026,542,484,52.83
Hwei,Gragas,745,359,386,48.19
Hwei,Morgana,1576,785,791,49.81
Hwei,Swain,1340,644,696,48.06
Hwei,Shaco,1213,587,626,48.39
Hwei,Zyra,1144,547,597,47.81
Hwei,Zoe,613,324,289,52.85
Hwei,Kindred,636,379,257,59.59
Hwei,Chogath,1638,847,791,51.71
Hwei,Malphite,1186,562,624,47.39
Hwei,Vladimir,814,394,420,48.4
Hwei,Nunu,883,447,436,50.62
Hwei,Cassiopeia,410,210,200,51.22
Hwei,Ornn,549,266,283,48.45
Hwei,Twitch,1055,490,565,46.45
Hwei,Vayne,1559,778,781,49.9
Hwei,Maokai,597,313,284,52.43
Hwei,Sivir,645,299,346,46.36
Hwei,Anivia,390,228,162,58.46
Hwei,Trundle,741,379,362,51.15
Hwei,JarvanIV,666,317,349,47.6
Hwei,Aatrox,1250,639,611,51.12
Hwei,Milio,826,424,402,51.33
Hwei,Ziggs,580,306,274,52.76
Hwei,Leblanc,751,391,360,52.06
Hwei,Senna,1063,527,536,49.58
Hwei,Karthus,392,198,194,50.51
Hwei,Akshan,504,185,319,36.71
Hwei,Kalista,465,272,193,58.49
Hwei,Garen,1939,972,967,50.13
Hwei,MasterYi,1413,712,701,50.39
Hwei,Nilah,567,254,313,44.8
Hwei,Lillia,718,363,355,50.56
Hwei,Fizz,705,340,365,48.23
Hwei,Nasus,914,429,485,46.94
Hwei,Orianna,592,256,336,43.24
Hwei,Jayce,570,318,252,55.79
Hwei,Camille,443,236,207,53.27
Hwei,Urgot,671,323,348,48.14
Hwei,XinZhao,777,369,408,47.49
Hwei,Hecarim,553,265,288,47.92
Hwei,Corki,497,260,237,52.31
Hwei,Sylas,1591,810,781,50.91
Hwei,Zac,625,333,292,53.28
Hwei,Janna,449,202,247,44.99
Hwei,Taliyah,441,198,243,44.9
Hwei,Riven,629,326,303,51.83
Hwei,Skarner,421,200,221,47.51
Hwei,RekSai,184,77,107,41.85
Hwei,Kled,246,104,142,42.28
Hwei,TwistedFate,497,249,248,50.1
Hwei,Alistar,470,241,229,51.28
Hwei,Talon,778,381,397,48.97
Hwei,Renata,239,118,121,49.37
Hwei,Singed,373,186,187,49.87
Hwei,Ivern,239,141,98,59
Hwei,Rakan,610,294,316,48.2
Hwei,Rammus,365,191,174,52.33
Hwei,KSante,624,335,289,53.69
Hwei,Olaf,328,155,173,47.26
Hwei,Rumble,329,162,167,49.24
Hwei,Annie,380,162,218,42.63
Hwei,Azir,526,237,289,45.06
Hwei,Zilean,439,199,240,45.33
Hwei,Shyvana,311,148,163,47.59
Lucian,Sett,1897,880,1017,46.39
Lucian,Warwick,1810,822,988,45.41
Lucian,Shen,835,401,434,48.02
Lucian,Tristana,1222,579,643,47.38
Lucian,Blitzcrank,1045,574,471,54.93
Lucian,Singed,376,168,208,44.68
Lucian,Shaco,1108,523,585,47.2
Lucian,Zed,1481,681,800,45.98
Lucian,Hwei,831,378,453,45.49
Lucian,Lux,3344,1585,1759,47.4
Lucian,DrMundo,691,266,425,38.49
Lucian,Lillia,734,314,420,42.78
Lucian,Viktor,1209,574,635,47.48
Lucian,Jhin,2852,1378,1474,48.32
Lucian,Pyke,1262,701,561,55.55
Lucian,Jax,1207,586,621,48.55
Lucian,Elise,998,476,522,47.7
Lucian,Naafiri,406,175,231,43.1
Lucian,Lulu,1818,916,902,50.39
Lucian,Gwen,755,386,369,51.13
Lucian,Tryndamere,715,301,414,42.1
Lucian,Velkoz,728,351,377,48.21
Lucian,Zeri,698,328,370,46.99
Lucian,Thresh,1828,865,963,47.32
Lucian,Brand,925,500,425,54.05
Lucian,Twitch,1096,567,529,51.73
Lucian,Morgana,1427,694,733,48.63
Lucian,Riven,671,291,380,43.37
Lucian,LeeSin,2060,989,1071,48.01
Lucian,Mel,2829,1373,1456,48.53
Lucian,Zac,661,299,362,45.23
Lucian,Volibear,1363,641,722,47.03
Lucian,Syndra,901,433,468,48.06
Lucian,Jinx,3586,1659,1927,46.26
Lucian,FiddleSticks,676,340,336,50.3
Lucian,Akali,1348,642,706,47.63
Lucian,Ambessa,863,393,470,45.54
Lucian,Yuumi,1153,551,602,47.79
Lucian,Qiyana,325,178,147,54.77
Lucian,Caitlyn,3507,1673,1834,47.7
Lucian,Illaoi,641,358,283,55.85
Lucian,Ekko,1211,580,631,47.89
Lucian,Leona,987,433,554,43.87
Lucian,Ashe,2747,1254,1493,45.65
Lucian,MasterYi,1401,658,743,46.97
Lucian,AurelionSol,542,225,317,41.51
Lucian,Ezreal,3530,1796,1734,50.88
Lucian,Seraphine,950,464,486,48.84
Lucian,Teemo,1556,792,764,50.9
Lucian,Rammus,397,167,230,42.07
Lucian,Fizz,783,360,423,45.98
Lucian,TahmKench,1211,513,698,42.36
Lucian,Briar,901,386,515,42.84
Lucian,Fiora,495,212,283,42.83
Lucian,Cassiopeia,370,174,196,47.03
Lucian,MonkeyKing,906,425,481,46.91
Lucian,Nilah,507,216,291,42.6
Lucian,Evelynn,450,246,204,54.67
Lucian,Ahri,1831,923,908,50.41
Lucian,Chogath,1508,748,760,49.6
Lucian,Nocturne,1637,818,819,49.97
Lucian,Irelia,1078,523,555,48.52
Lucian,Gnar,591,317,274,53.64
Lucian,Kayn,1887,953,934,50.5
Lucian,Katarina,983,458,525,46.59
Lucian,Renekton,607,298,309,49.09
Lucian,Leblanc,701,359,342,51.21
Lucian,Aphelios,738,354,384,47.97
Lucian,Graves,912,436,476,47.81
Lucian,Zoe,499,247,252,49.5
Lucian,Yasuo,2673,1279,1394,47.85
Lucian,Trundle,751,329,422,43.81
Lucian,Kayle,893,428,465,47.93
Lucian,Milio,744,345,399,46.37
Lucian,Sylas,1750,833,917,47.6
Lucian,Mordekaiser,1718,871,847,50.7
Lucian,Talon,874,383,491,43.82
Lucian,Yone,2367,1279,1088,54.03
Lucian,Varus,1145,603,542,52.66
Lucian,Sejuani,591,248,343,41.96
Lucian,Azir,520,230,290,44.23
Lucian,Yorick,1209,540,669,44.67
Lucian,Ivern,204,111,93,54.41
Lucian,Aatrox,1298,610,688,47
Lucian,Aurora,1088,482,606,44.3
Lucian,MissFortune,2889,1374,1515,47.56
Lucian,Braum,715,295,420,41.26
Lucian,Galio,1054,476,578,45.16
Lucian,Sona,410,185,225,45.12
Lucian,Soraka,733,325,408,44.34
Lucian,Sion,1048,507,541,48.38
Lucian,Diana,1983,929,1054,46.85
Lucian,Orianna,633,313,320,49.45
Lucian,Kaisa,2263,1185,1078,52.36
Lucian,Nami,1344,615,729,45.76
Lucian,Garen,1945,853,1092,43.86
Lucian,JarvanIV,721,308,413,42.72
Lucian,XinZhao,864,415,449,48.03
Lucian,Ziggs,474,255,219,53.8
Lucian,Xayah,715,362,353,50.63
Lucian,Akshan,461,233,228,50.54
Lucian,Camille,490,223,267,45.51
Lucian,Nautilus,1469,732,737,49.83
Lucian,KSante,672,362,310,53.87
Lucian,Skarner,382,178,204,46.6
Lucian,Nunu,719,382,337,53.13
Lucian,Urgot,611,276,335,45.17
Lucian,Kassadin,284,138,146,48.59
Lucian,Senna,985,450,535,45.69
Lucian,Darius,2574,1247,1327,48.45
Lucian,Heimerdinger,635,311,324,48.98
Lucian,Draven,696,291,405,41.81
Lucian,Smolder,832,421,411,50.6
Lucian,Pantheon,2148,1012,1136,47.11
Lucian,Gragas,835,387,448,46.35
Lucian,Amumu,1329,634,695,47.71
Lucian,Nasus,892,454,438,50.9
Lucian,Rell,666,340,326,51.05
Lucian,Neeko,696,340,356,48.85
Lucian,Vayne,1725,824,901,47.77
Lucian,Kennen,390,185,205,47.44
Lucian,Vi,1422,706,716,49.65
Lucian,Lissandra,435,203,232,46.67
Lucian,Zilean,427,168,259,39.34
Lucian,Khazix,757,358,399,47.29
Lucian,Rengar,469,255,214,54.37
Lucian,Rakan,675,362,313,53.63
Lucian,Kled,258,124,134,48.06
Lucian,Vladimir,801,361,440,45.07
Lucian,Karma,1527,709,818,46.43
Lucian,Corki,531,257,274,48.4
Lucian,Sivir,700,293,407,41.86
Lucian,Hecarim,526,244,282,46.39
Lucian,Renata,228,139,89,60.96
Lucian,Viego,1795,857,938,47.74
Lucian,Kindred,551,291,260,52.81
Lucian,Malzahar,1195,606,589,50.71
Lucian,Ryze,474,251,223,52.95
Lucian,Poppy,892,418,474,46.86
Lucian,Zyra,1197,550,647,45.95
Lucian,Karthus,392,186,206,47.45
Lucian,Anivia,448,224,224,50
Lucian,Malphite,1346,668,678,49.63
Lucian,Samira,951,461,490,48.48
Lucian,Taliyah,370,183,187,49.46
Lucian,Vex,717,328,389,45.75
Lucian,Shyvana,333,212,121,63.66
Lucian,Gangplank,718,320,398,44.57
Lucian,Alistar,553,272,281,49.19
Lucian,Olaf,331,162,169,48.94
Lucian,Xerath,1136,534,602,47.01
Lucian,Janna,500,233,267,46.6
Lucian,Quinn,410,182,228,44.39
Lucian,Taric,252,107,145,42.46
Lucian,Udyr,551,305,246,55.35
Lucian,Annie,431,187,244,43.39
Lucian,TwistedFate,536,252,284,47.01
Lucian,Veigar,1327,607,720,45.74
Lucian,Jayce,697,363,334,52.08
Lucian,Nidalee,424,232,192,54.72
Lucian,KogMaw,391,183,208,46.8
Lucian,Swain,1161,528,633,45.48
Lucian,Rumble,385,177,208,45.97
Lucian,Kalista,462,250,212,54.11
Lucian,Ornn,609,321,288,52.71
Lucian,Maokai,539,290,249,53.8
Lucian,Bard,388,183,205,47.16
Lucian,Belveth,299,122,177,40.8
Lucian,RekSai,178,94,84,52.81
Maokai,Sett,1493,765,728,51.24
Maokai,Warwick,1288,580,708,45.03
Maokai,Shen,572,298,274,52.1
Maokai,Tristana,800,373,427,46.63
Maokai,Blitzcrank,668,409,259,61.23
Maokai,Pantheon,1473,752,721,51.05
Maokai,MasterYi,937,487,450,51.97
Maokai,Sylas,1279,682,597,53.32
Maokai,Ashe,1640,885,755,53.96
Maokai,Karma,963,509,454,52.86
Maokai,Darius,1761,909,852,51.62
Maokai,Rengar,314,188,126,59.87
Maokai,Syndra,549,258,291,46.99
Maokai,Caitlyn,2325,1189,1136,51.14
Maokai,Lux,2258,1046,1212,46.32
Maokai,Kayn,1425,686,739,48.14
Maokai,Akali,880,452,428,51.36
Maokai,Akshan,324,161,163,49.69
Maokai,TahmKench,773,407,366,52.65
Maokai,Ivern,177,87,90,49.15
Maokai,Katarina,700,346,354,49.43
Maokai,Ezreal,2091,1101,990,52.65
Maokai,Kled,177,97,80,54.8
Maokai,Ambessa,625,347,278,55.52
Maokai,Diana,1383,674,709,48.73
Maokai,Nilah,473,210,263,44.4
Maokai,Leona,779,336,443,43.13
Maokai,Rammus,269,157,112,58.36
Maokai,Aurora,700,412,288,58.86
Maokai,Swain,923,405,518,43.88
Maokai,Chogath,1128,576,552,51.06
Maokai,Yasuo,1670,862,808,51.62
Maokai,Kaisa,1425,795,630,55.79
Maokai,Yuumi,756,388,368,51.32
Maokai,Kennen,260,162,98,62.31
Maokai,TwistedFate,275,145,130,52.73
Maokai,Cassiopeia,286,160,126,55.94
Maokai,Smolder,626,293,333,46.81
Maokai,Milio,515,251,264,48.74
Maokai,Mordekaiser,1234,591,643,47.89
Maokai,Veigar,875,450,425,51.43
Maokai,Thresh,1213,672,541,55.4
Maokai,XinZhao,528,274,254,51.89
Maokai,MissFortune,1965,1003,962,51.04
Maokai,Garen,1348,739,609,54.82
Maokai,Nocturne,1000,488,512,48.8
Maokai,Vladimir,538,256,282,47.58
Maokai,Ekko,799,416,383,52.07
Maokai,Singed,216,101,115,46.76
Maokai,Kindred,447,229,218,51.23
Maokai,Morgana,1191,549,642,46.1
Maokai,Lillia,552,281,271,50.91
Maokai,Pyke,898,481,417,53.56
Maokai,Ahri,1118,586,532,52.42
Maokai,Viego,1284,611,673,47.59
Maokai,Aatrox,825,428,397,51.88
Maokai,Renata,208,97,111,46.63
Maokai,Yorick,896,398,498,44.42
Maokai,Azir,346,180,166,52.02
Maokai,Twitch,687,356,331,51.82
Maokai,Lulu,1047,542,505,51.77
Maokai,Heimerdinger,368,168,200,45.65
Maokai,Briar,691,328,363,47.47
Maokai,Jinx,2222,1124,1098,50.59
Maokai,Nasus,661,323,338,48.87
Maokai,Shaco,782,377,405,48.21
Maokai,Sona,191,108,83,56.54
Maokai,Urgot,448,209,239,46.65
Maokai,Seraphine,823,422,401,51.28
Maokai,Jax,769,369,400,47.98
Maokai,Jhin,1608,898,710,55.85
Maokai,Braum,478,239,239,50
Maokai,Irelia,822,400,422,48.66
Maokai,Velkoz,556,305,251,54.86
Maokai,Renekton,430,185,245,43.02
Maokai,Nautilus,1032,606,426,58.72
Maokai,Zyra,853,421,432,49.36
Maokai,Yone,1616,814,802,50.37
Maokai,Amumu,897,469,428,52.29
Maokai,Zed,960,486,474,50.63
Maokai,Draven,463,223,240,48.16
Maokai,LeeSin,1255,741,514,59.04
Maokai,Vex,425,209,216,49.18
Maokai,FiddleSticks,427,219,208,51.29
Maokai,Volibear,1061,521,540,49.1
Maokai,Rumble,221,122,99,55.2
Maokai,Xayah,431,202,229,46.87
Maokai,Fiora,327,131,196,40.06
Maokai,Vayne,1292,622,670,48.14
Maokai,Khazix,375,198,177,52.8
Maokai,Qiyana,290,179,111,61.72
Maokai,RekSai,100,48,52,48
Maokai,Poppy,643,348,295,54.12
Maokai,Teemo,1179,582,597,49.36
Maokai,Mel,1837,963,874,52.42
Maokai,Gnar,349,166,183,47.56
Maokai,Hwei,597,284,313,47.57
Maokai,Aphelios,496,242,254,48.79
Maokai,Nami,775,379,396,48.9
Maokai,Orianna,459,230,229,50.11
Maokai,Udyr,412,233,179,56.55
Maokai,Annie,247,122,125,49.39
Maokai,Neeko,574,266,308,46.34
Maokai,Kassadin,215,89,126,41.4
Maokai,Riven,361,195,166,54.02
Maokai,Malzahar,868,505,363,58.18
Maokai,Zoe,394,235,159,59.64
Maokai,Sivir,421,209,212,49.64
Maokai,Viktor,922,464,458,50.33
Maokai,Camille,249,125,124,50.2
Maokai,Soraka,440,207,233,47.05
Maokai,Samira,768,376,392,48.96
Maokai,MonkeyKing,540,293,247,54.26
Maokai,Rell,519,262,257,50.48
Maokai,AurelionSol,362,185,177,51.1
Maokai,Shyvana,223,122,101,54.71
Maokai,Galio,742,390,352,52.56
Maokai,Xerath,719,331,388,46.04
Maokai,Gangplank,385,173,212,44.94
Maokai,Sion,722,311,411,43.07
Maokai,Nunu,630,289,341,45.87
Maokai,Belveth,234,134,100,57.26
Maokai,Malphite,767,414,353,53.98
Maokai,Anivia,307,121,186,39.41
Maokai,Varus,855,442,413,51.7
Maokai,DrMundo,535,292,243,54.58
Maokai,Vi,762,350,412,45.93
Maokai,Kalista,273,162,111,59.34
Maokai,Ornn,408,211,197,51.72
Maokai,Trundle,478,262,216,54.81
Maokai,KSante,478,261,217,54.6
Maokai,Gragas,557,344,213,61.76
Maokai,Quinn,323,150,173,46.44
Maokai,Leblanc,593,342,251,57.67
Maokai,Skarner,240,110,130,45.83
Maokai,Alistar,410,212,198,51.71
Maokai,Gwen,456,253,203,55.48
Maokai,Karthus,282,161,121,57.09
Maokai,Senna,714,358,356,50.14
Maokai,Lucian,539,249,290,46.2
Maokai,Illaoi,457,217,240,47.48
Maokai,Elise,699,397,302,56.8
Maokai,JarvanIV,435,213,222,48.97
Maokai,Olaf,258,144,114,55.81
Maokai,Lissandra,260,141,119,54.23
Maokai,Kayle,673,356,317,52.9
Maokai,KogMaw,316,123,193,38.92
Maokai,Jayce,416,262,154,62.98
Maokai,Evelynn,354,173,181,48.87
Maokai,Fizz,453,210,243,46.36
Maokai,Hecarim,355,185,170,52.11
Maokai,Zeri,393,210,183,53.44
Maokai,Graves,519,277,242,53.37
Maokai,Brand,652,319,333,48.93
Maokai,Ziggs,300,152,148,50.67
Maokai,Rakan,403,174,229,43.18
Maokai,Ryze,310,151,159,48.71
Maokai,Tryndamere,405,170,235,41.98
Maokai,Sejuani,395,209,186,52.91
Maokai,Taric,225,122,103,54.22
Maokai,Zac,406,223,183,54.93
Maokai,Corki,337,175,162,51.93
Maokai,Zilean,310,138,172,44.52
Maokai,Bard,305,179,126,58.69
Maokai,Janna,304,180,124,59.21
Maokai,Talon,549,305,244,55.56
Maokai,Naafiri,307,161,146,52.44
Maokai,Taliyah,242,130,112,53.72
Maokai,Nidalee,264,151,113,57.2
Yone,Mordekaiser,5196,2552,2644,49.11
Yone,Qiyana,966,492,474,50.93
Yone,Irelia,3761,1798,1963,47.81
Yone,Ezreal,8705,4252,4453,48.85
Yone,Rell,1773,863,910,48.67
Yone,Renekton,2245,949,1296,42.27
Yone,Kayn,5632,2651,2981,47.07
Yone,Katarina,2929,1486,1443,50.73
Yone,Draven,1854,900,954,48.54
Yone,Yuumi,3156,1628,1528,51.58
Yone,Kayle,2260,1138,1122,50.35
Yone,Sylas,5534,2746,2788,49.62
Yone,Caitlyn,9765,4602,5163,47.13
Yone,Renata,689,327,362,47.46
Yone,Warwick,5558,2415,3143,43.45
Yone,Mel,7586,3902,3684,51.44
Yone,Nautilus,4163,2051,2112,49.27
Yone,Gangplank,1641,847,794,51.61
Yone,Akali,5119,2378,2741,46.45
Yone,Sona,1163,498,665,42.82
Yone,Aatrox,3827,1909,1918,49.88
Yone,Sejuani,1400,624,776,44.57
Yone,Yasuo,9543,4604,4939,48.24
Yone,Jinx,9288,4272,5016,45.99
Yone,Pyke,3596,1788,1808,49.72
Yone,Heimerdinger,1935,860,1075,44.44
Yone,Neeko,2155,1040,1115,48.26
Yone,Leona,2986,1417,1569,47.45
Yone,Jax,3842,1810,2032,47.11
Yone,Nidalee,1067,581,486,54.45
Yone,Ahri,5046,2336,2710,46.29
Yone,Jhin,7255,3507,3748,48.34
Yone,Senna,2806,1299,1507,46.29
Yone,Sett,6352,2874,3478,45.25
Yone,Taliyah,848,420,428,49.53
Yone,Cassiopeia,1237,581,656,46.97
Yone,Kaisa,6196,3117,3079,50.31
Yone,Teemo,4478,1944,2534,43.41
Yone,Hecarim,1361,671,690,49.3
Yone,Veigar,3858,1823,2035,47.25
Yone,Ashe,7078,3449,3629,48.73
Yone,Thresh,5007,2358,2649,47.09
Yone,Morgana,4437,2057,2380,46.36
Yone,Viego,5110,2471,2639,48.36
Yone,Kindred,1730,832,898,48.09
Yone,TahmKench,3169,1547,1622,48.82
Yone,Diana,5522,2694,2828,48.79
Yone,Lux,9513,4508,5005,47.39
Yone,Tristana,3428,1755,1673,51.2
Yone,Vladimir,2461,1226,1235,49.82
Yone,Zac,1660,748,912,45.06
Yone,Amumu,3772,1588,2184,42.1
Yone,Xayah,1963,988,975,50.33
Yone,Darius,6666,3145,3521,47.18
Yone,AurelionSol,1378,685,693,49.71
Yone,MissFortune,8596,3996,4600,46.49
Yone,Talon,2228,1124,1104,50.45
Yone,Leblanc,2021,992,1029,49.08
Yone,Soraka,1887,863,1024,45.73
Yone,Naafiri,1518,839,679,55.27
Yone,Nunu,2509,1244,1265,49.58
Yone,Malzahar,3191,1520,1671,47.63
Yone,Zeri,1635,752,883,45.99
Yone,Ekko,3124,1453,1671,46.51
Yone,Riven,1594,710,884,44.54
Yone,Ivern,551,297,254,53.9
Yone,Swain,3586,1678,1908,46.79
Yone,Nami,3177,1532,1645,48.22
Yone,Sivir,1768,867,901,49.04
Yone,Trundle,2185,1020,1165,46.68
Yone,Gragas,2065,1080,985,52.3
Yone,Vex,2410,1188,1222,49.29
Yone,Kennen,1037,495,542,47.73
Yone,Rammus,1485,624,861,42.02
Yone,Nasus,2783,1333,1450,47.9
Yone,Smolder,2545,1287,1258,50.57
Yone,Sion,2864,1437,1427,50.17
Yone,Rengar,1360,691,669,50.81
Yone,Anivia,956,460,496,48.12
Yone,Poppy,2453,1180,1273,48.1
Yone,Illaoi,1919,869,1050,45.28
Yone,Aurora,3151,1543,1608,48.97
Yone,Tryndamere,2002,981,1021,49
Yone,Zyra,3065,1372,1693,44.76
Yone,Nilah,1278,543,735,42.49
Yone,FiddleSticks,1746,801,945,45.88
Yone,Blitzcrank,3004,1507,1497,50.17
Yone,Zed,3902,1942,1960,49.77
Yone,Rakan,1736,861,875,49.6
Yone,Evelynn,1532,753,779,49.15
Yone,Lissandra,1144,548,596,47.9
Yone,XinZhao,2317,1078,1239,46.53
Yone,Vayne,3967,1868,2099,47.09
Yone,Brand,2650,1266,1384,47.77
Yone,Pantheon,6637,3263,3374,49.16
Yone,Braum,1833,827,1006,45.12
Yone,Gnar,1513,757,756,50.03
Yone,Shaco,3508,1794,1714,51.14
Yone,Seraphine,3011,1498,1513,49.75
Yone,Nocturne,4034,1941,2093,48.12
Yone,Orianna,1437,750,687,52.19
Yone,LeeSin,5601,2841,2760,50.72
Yone,Garen,5745,2728,3017,47.48
Yone,Kled,660,336,324,50.91
Yone,Alistar,1491,720,771,48.29
Yone,DrMundo,2210,1055,1155,47.74
Yone,Akshan,1260,630,630,50
Yone,Zilean,1078,545,533,50.56
Yone,Hwei,2358,1144,1214,48.52
Yone,Azir,1242,587,655,47.26
Yone,Taric,743,308,435,41.45
Yone,Briar,2997,1314,1683,43.84
Yone,Ornn,1463,688,775,47.03
Yone,MasterYi,4229,2031,2198,48.03
Yone,Yorick,3621,1598,2023,44.13
Yone,Velkoz,2206,957,1249,43.38
Yone,Volibear,4136,1853,2283,44.8
Yone,Quinn,1159,550,609,47.45
Yone,Varus,3172,1602,1570,50.5
Yone,Fiora,1523,696,827,45.7
Yone,Twitch,2666,1291,1375,48.42
Yone,Lulu,4147,1880,2267,45.33
Yone,Xerath,2982,1405,1577,47.12
Yone,Annie,1167,591,576,50.64
Yone,Chogath,4638,2280,2358,49.16
Yone,Vi,3517,1658,1859,47.14
Yone,Galio,3256,1553,1703,47.7
Yone,Samira,3082,1433,1649,46.5
Yone,Lucian,2367,1088,1279,45.97
Yone,Jayce,1902,875,1027,46
Yone,KogMaw,1131,531,600,46.95
Yone,Ryze,1191,529,662,44.42
Yone,Zoe,1536,740,796,48.18
Yone,Gwen,1919,940,979,48.98
Yone,RekSai,397,203,194,51.13
Yone,MonkeyKing,2382,1059,1323,44.46
Yone,Kalista,1204,640,564,53.16
Yone,Camille,1120,546,574,48.75
Yone,Udyr,1344,687,657,51.12
Yone,TwistedFate,1158,639,519,55.18
Yone,Aphelios,2056,940,1116,45.72
Yone,KSante,1842,1005,837,54.56
Yone,Graves,2291,1071,1220,46.75
Yone,Olaf,850,403,447,47.41
Yone,Karma,3646,1728,1918,47.39
Yone,Viktor,2995,1466,1529,48.95
Yone,Bard,994,465,529,46.78
Yone,Karthus,1005,517,488,51.44
Yone,Malphite,3871,1792,2079,46.29
Yone,Ziggs,1460,699,761,47.88
Yone,Shyvana,892,414,478,46.41
Yone,Maokai,1616,802,814,49.63
Yone,Lillia,2206,1098,1108,49.77
Yone,Belveth,849,452,397,53.24
Yone,Janna,1083,526,557,48.57
Yone,Fizz,1920,815,1105,42.45
Yone,Singed,896,420,476,46.88
Yone,Khazix,1987,991,996,49.87
Yone,JarvanIV,1748,816,932,46.68
Yone,Shen,2341,1058,1283,45.19
Yone,Rumble,977,495,482,50.67
Yone,Elise,2463,1289,1174,52.33
Yone,Urgot,1592,688,904,43.22
Yone,Milio,1832,852,980,46.51
Yone,Kassadin,636,308,328,48.43
Yone,Syndra,2173,1013,1160,46.62
Yone,Ambessa,2305,1096,1209,47.55
Yone,Skarner,1083,553,530,51.06
Yone,Corki,1262,695,567,55.07
Darius,Mordekaiser,5732,2907,2825,50.72
Darius,Qiyana,952,568,384,59.66
Darius,Irelia,2911,1517,1394,52.11
Darius,Ezreal,7777,4220,3557,54.26
Darius,Rell,1905,906,999,47.56
Darius,Fiora,1420,765,655,53.87
Darius,Pantheon,5959,2927,3032,49.12
Darius,Katarina,2816,1429,1387,50.75
Darius,Mel,7455,3933,3522,52.76
Darius,Viktor,2841,1434,1407,50.48
Darius,Illaoi,1886,810,1076,42.95
Darius,Warwick,6173,3017,3156,48.87
Darius,Diana,5623,2772,2851,49.3
Darius,Tristana,3541,1820,1721,51.4
Darius,Milio,2182,1062,1120,48.67
Darius,Viego,4906,2476,2430,50.47
Darius,Jhin,7245,3650,3595,50.38
Darius,Lux,9292,4507,4785,48.5
Darius,Aatrox,3544,1830,1714,51.64
Darius,Ekko,3254,1688,1566,51.87
Darius,Orianna,1659,823,836,49.61
Darius,Malzahar,3558,1689,1869,47.47
Darius,Maokai,1761,852,909,48.38
Darius,Sett,6908,3268,3640,47.31
Darius,Zac,1522,798,724,52.43
Darius,Yasuo,7263,3863,3400,53.19
Darius,MissFortune,8475,4046,4429,47.74
Darius,Yone,6666,3521,3145,52.82
Darius,Galio,3000,1476,1524,49.2
Darius,Chogath,4712,2308,2404,48.98
Darius,Vladimir,2271,1220,1051,53.72
Darius,Evelynn,1408,690,718,49.01
Darius,Yuumi,3003,1520,1483,50.62
Darius,Poppy,2026,1016,1010,50.15
Darius,Veigar,3981,1947,2034,48.91
Darius,Heimerdinger,1982,935,1047,47.17
Darius,Ziggs,1411,688,723,48.76
Darius,Volibear,4683,2304,2379,49.2
Darius,Akshan,1339,661,678,49.37
Darius,Morgana,4392,2154,2238,49.04
Darius,FiddleSticks,1705,821,884,48.15
Darius,Singed,879,433,446,49.26
Darius,Pyke,3202,1614,1588,50.41
Darius,Lillia,2216,1174,1042,52.98
Darius,Jinx,9397,4537,4860,48.28
Darius,Lulu,4096,2160,1936,52.73
Darius,Nasus,2646,1336,1310,50.49
Darius,Khazix,1832,988,844,53.93
Darius,Urgot,1957,948,1009,48.44
Darius,Tryndamere,2274,1183,1091,52.02
Darius,Briar,3169,1528,1641,48.22
Darius,Janna,1204,624,580,51.83
Darius,Ambessa,2090,1166,924,55.79
Darius,Smolder,2617,1363,1254,52.08
Darius,Swain,3667,1802,1865,49.14
Darius,Kayn,5692,2847,2845,50.02
Darius,Akali,3491,1748,1743,50.07
Darius,TahmKench,3515,1815,1700,51.64
Darius,Kalista,1102,635,467,57.62
Darius,Thresh,5015,2542,2473,50.69
Darius,Udyr,1749,898,851,51.34
Darius,Yorick,3624,1609,2015,44.4
Darius,Karma,3656,1922,1734,52.57
Darius,Gnar,1610,826,784,51.3
Darius,Brand,2735,1314,1421,48.04
Darius,Caitlyn,9686,4864,4822,50.22
Darius,Velkoz,2270,1113,1157,49.03
Darius,XinZhao,2182,1029,1153,47.16
Darius,Samira,2947,1487,1460,50.46
Darius,Zed,4015,2145,1870,53.42
Darius,Graves,2171,1097,1074,50.53
Darius,Kassadin,795,390,405,49.06
Darius,Vex,1832,878,954,47.93
Darius,Vi,3363,1701,1662,50.58
Darius,Nilah,1431,692,739,48.36
Darius,Gangplank,1663,817,846,49.13
Darius,Nunu,2348,1184,1164,50.43
Darius,Soraka,2056,1007,1049,48.98
Darius,Aurora,2852,1490,1362,52.24
Darius,Nocturne,4130,1931,2199,46.76
Darius,Olaf,820,449,371,54.76
Darius,Ashe,7110,3671,3439,51.63
Darius,Kayle,2807,1406,1401,50.09
Darius,Vayne,4955,2418,2537,48.8
Darius,Hwei,2708,1284,1424,47.42
Darius,Senna,3026,1489,1537,49.21
Darius,Malphite,3255,1641,1614,50.41
Darius,Naafiri,1394,749,645,53.73
Darius,Trundle,2220,1026,1194,46.22
Darius,Riven,1840,934,906,50.76
Darius,Seraphine,3160,1540,1620,48.73
Darius,Sion,2970,1416,1554,47.68
Darius,Twitch,2887,1443,1444,49.98
Darius,Sylas,4247,2163,2084,50.93
Darius,Kaisa,5579,2806,2773,50.3
Darius,Renata,693,392,301,56.57
Darius,Aphelios,2099,1039,1060,49.5
Darius,Nautilus,4086,2136,1950,52.28
Darius,DrMundo,2268,1061,1207,46.78
Darius,Jax,3098,1526,1572,49.26
Darius,Shaco,3395,1719,1676,50.63
Darius,Talon,2037,1043,994,51.2
Darius,Taliyah,926,424,502,45.79
Darius,Zoe,1480,767,713,51.82
Darius,Quinn,1500,760,740,50.67
Darius,Shyvana,1009,539,470,53.42
Darius,Fizz,2170,1166,1004,53.73
Darius,Taric,899,440,459,48.94
Darius,Cassiopeia,1167,616,551,52.78
Darius,Ornn,1535,769,766,50.1
Darius,Shen,2360,1231,1129,52.16
Darius,MasterYi,4303,2178,2125,50.62
Darius,Nami,3674,1853,1821,50.44
Darius,AurelionSol,1499,755,744,50.37
Darius,Gragas,2010,1074,936,53.43
Darius,RekSai,503,267,236,53.08
Darius,KSante,1852,1017,835,54.91
Darius,Draven,1981,1045,936,52.75
Darius,Varus,3122,1631,1491,52.24
Darius,Sejuani,1549,774,775,49.97
Darius,Neeko,1976,1091,885,55.21
Darius,Kennen,1239,639,600,51.57
Darius,Garen,6722,3354,3368,49.9
Darius,Rakan,1677,802,875,47.82
Darius,Ryze,1277,671,606,52.55
Darius,Blitzcrank,2768,1470,1298,53.11
Darius,LeeSin,4864,2651,2213,54.5
Darius,Ahri,4727,2487,2240,52.61
Darius,Jayce,1590,797,793,50.13
Darius,Renekton,1888,970,918,51.38
Darius,Rammus,1153,601,552,52.12
Darius,Camille,1184,577,607,48.73
Darius,Xayah,1862,912,950,48.98
Darius,Sona,1244,638,606,51.29
Darius,Teemo,4955,2380,2575,48.03
Darius,Belveth,816,425,391,52.08
Darius,Azir,1312,659,653,50.23
Darius,Leblanc,1728,856,872,49.54
Darius,Amumu,3835,1750,2085,45.63
Darius,Skarner,1078,566,512,52.5
Darius,Zilean,1134,547,587,48.24
Darius,Lucian,2574,1327,1247,51.55
Darius,Syndra,2340,1163,1177,49.7
Darius,Hecarim,1512,830,682,54.89
Darius,KogMaw,1143,555,588,48.56
Darius,Rengar,1236,700,536,56.63
Darius,Zyra,3217,1422,1795,44.2
Darius,TwistedFate,1248,687,561,55.05
Darius,Leona,3023,1394,1629,46.11
Darius,Annie,1068,560,508,52.43
Darius,Xerath,2877,1368,1509,47.55
Darius,Sivir,1723,802,921,46.55
Darius,Zeri,1374,743,631,54.08
Darius,Karthus,1105,556,549,50.32
Darius,Kindred,1800,996,804,55.33
Darius,Lissandra,1060,546,514,51.51
Darius,Alistar,1363,712,651,52.24
Darius,Gwen,1813,898,915,49.53
Darius,Corki,1431,744,687,51.99
Darius,Nidalee,968,548,420,56.61
Darius,JarvanIV,1865,906,959,48.58
Darius,Elise,2333,1168,1165,50.06
Darius,Braum,1980,1012,968,51.11
Darius,Rumble,837,470,367,56.15
Darius,Bard,1173,653,520,55.67
Darius,Kled,741,409,332,55.2
Darius,MonkeyKing,2533,1264,1269,49.9
Darius,Ivern,643,353,290,54.9
Darius,Anivia,1118,524,594,46.87
Yasuo,Mordekaiser,5074,2378,2696,46.87
Yasuo,Qiyana,1042,586,456,56.24
Yasuo,Irelia,3800,1891,1909,49.76
Yasuo,Ezreal,8483,4462,4021,52.6
Yasuo,Rell,1923,948,975,49.3
Yasuo,Singed,1030,503,527,48.83
Yasuo,Shaco,3594,1889,1705,52.56
Yasuo,Zed,5091,2720,2371,53.43
Yasuo,Hwei,2477,1294,1183,52.24
Yasuo,Lux,9891,5113,4778,51.69
Yasuo,Renekton,2532,1237,1295,48.85
Yasuo,Khazix,2066,1133,933,54.84
Yasuo,Mel,8563,4502,4061,52.58
Yasuo,Jhin,7765,3898,3867,50.2
Yasuo,Aatrox,3558,1856,1702,52.16
Yasuo,Sylas,5542,2953,2589,53.28
Yasuo,Diana,5533,2776,2757,50.17
Yasuo,Varus,3246,1723,1523,53.08
Yasuo,Blitzcrank,2871,1428,1443,49.74
Yasuo,Ambessa,2504,1289,1215,51.48
Yasuo,Rammus,1593,697,896,43.75
Yasuo,Draven,2041,1124,917,55.07
Yasuo,Viego,5376,2639,2737,49.09
Yasuo,Teemo,5101,2529,2572,49.58
Yasuo,Warwick,5997,2904,3093,48.42
Yasuo,Azir,1419,657,762,46.3
Yasuo,MissFortune,8853,4459,4394,50.37
Yasuo,Neeko,2045,1091,954,53.35
Yasuo,Gangplank,1806,920,886,50.94
Yasuo,Brand,2721,1366,1355,50.2
Yasuo,Malzahar,3975,1915,2060,48.18
Yasuo,Pyke,3600,1881,1719,52.25
Yasuo,Briar,3072,1468,1604,47.79
Yasuo,Ryze,1307,662,645,50.65
Yasuo,Vex,2862,1331,1531,46.51
Yasuo,Yuumi,3278,1755,1523,53.54
Yasuo,Naafiri,1363,747,616,54.81
Yasuo,Yone,9543,4938,4605,51.74
Yasuo,Senna,3033,1497,1536,49.36
Yasuo,Galio,3087,1512,1575,48.98
Yasuo,TahmKench,3385,1822,1563,53.83
Yasuo,Hecarim,1523,755,768,49.57
Yasuo,Veigar,3954,1920,2034,48.56
Yasuo,Ashe,7495,3682,3813,49.13
Yasuo,Thresh,5278,2540,2738,48.12
Yasuo,Sett,6476,3228,3248,49.85
Yasuo,Amumu,3862,1800,2062,46.61
Yasuo,Caitlyn,10380,5226,5154,50.35
Yasuo,Poppy,2409,1186,1223,49.23
Yasuo,Malphite,4114,1959,2155,47.62
Yasuo,Evelynn,1586,824,762,51.95
Yasuo,Tristana,3819,1971,1848,51.61
Yasuo,Garen,6590,3195,3395,48.48
Yasuo,Kayn,5999,2931,3068,48.86
Yasuo,Riven,1865,918,947,49.22
Yasuo,Zoe,1456,862,594,59.2
Yasuo,Sona,1181,549,632,46.49
Yasuo,Nocturne,4464,1976,2488,44.27
Yasuo,Jinx,9736,4829,4907,49.6
Yasuo,Lulu,4450,2181,2269,49.01
Yasuo,Samira,3117,1595,1522,51.17
Yasuo,Darius,7263,3400,3863,46.81
Yasuo,Volibear,4388,2213,2175,50.43
Yasuo,Chogath,4858,2393,2465,49.26
Yasuo,Sivir,1919,998,921,52.01
Yasuo,Rakan,1738,832,906,47.87
Yasuo,Jax,3901,1969,1932,50.47
Yasuo,Xayah,2146,1010,1136,47.06
Yasuo,Karma,3965,1967,1998,49.61
Yasuo,Seraphine,3191,1646,1545,51.58
Yasuo,Zilean,1149,603,546,52.48
Yasuo,LeeSin,5402,2944,2458,54.5
Yasuo,Nami,3463,1696,1767,48.97
Yasuo,Aurora,2914,1494,1420,51.27
Yasuo,Kaisa,6182,3144,3038,50.86
Yasuo,Shen,2544,1216,1328,47.8
Yasuo,Gragas,2171,1159,1012,53.39
Yasuo,Alistar,1567,801,766,51.12
Yasuo,Kindred,1748,940,808,53.78
Yasuo,Nasus,3046,1539,1507,50.53
Yasuo,Urgot,1856,869,987,46.82
Yasuo,DrMundo,2193,1126,1067,51.35
Yasuo,Leblanc,1953,1031,922,52.79
Yasuo,Nunu,2452,1296,1156,52.85
Yasuo,Vladimir,2922,1427,1495,48.84
Yasuo,Zac,1717,871,846,50.73
Yasuo,Kalista,1123,512,611,45.59
Yasuo,Vi,3626,1807,1819,49.83
Yasuo,Orianna,1512,746,766,49.34
Yasuo,Kennen,1214,594,620,48.93
Yasuo,MonkeyKing,2505,1214,1291,48.46
Yasuo,Vayne,4801,2356,2445,49.07
Yasuo,Fiora,1621,855,766,52.75
Yasuo,Ziggs,1353,695,658,51.37
Yasuo,Nilah,1705,681,1024,39.94
Yasuo,JarvanIV,1912,900,1012,47.07
Yasuo,Taliyah,1165,632,533,54.25
Yasuo,Soraka,2078,1041,1037,50.1
Yasuo,Sion,2693,1264,1429,46.94
Yasuo,Rengar,1531,919,612,60.03
Yasuo,Ahri,4966,2495,2471,50.24
Yasuo,Anivia,1204,596,608,49.5
Yasuo,Sejuani,1486,782,704,52.62
Yasuo,AurelionSol,1566,794,772,50.7
Yasuo,Shyvana,894,439,455,49.11
Yasuo,Fizz,2163,1135,1028,52.47
Yasuo,Twitch,3095,1573,1522,50.82
Yasuo,Kayle,2722,1238,1484,45.48
Yasuo,FiddleSticks,1907,916,991,48.03
Yasuo,Katarina,3094,1660,1434,53.65
Yasuo,Lissandra,1573,780,793,49.59
Yasuo,XinZhao,2289,1082,1207,47.27
Yasuo,Ornn,1611,827,784,51.33
Yasuo,Smolder,2571,1313,1258,51.07
Yasuo,Swain,3972,1874,2098,47.18
Yasuo,Graves,2379,1216,1163,51.11
Yasuo,Kassadin,704,359,345,50.99
Yasuo,Maokai,1670,808,862,48.38
Yasuo,Ivern,685,367,318,53.58
Yasuo,Illaoi,1973,945,1028,47.9
Yasuo,Morgana,4712,2300,2412,48.81
Yasuo,Gwen,1833,918,915,50.08
Yasuo,RekSai,486,226,260,46.5
Yasuo,Leona,3156,1518,1638,48.1
Yasuo,Akali,4841,2427,2414,50.13
Yasuo,Pantheon,6565,3180,3385,48.44
Yasuo,Corki,1529,856,673,55.98
Yasuo,Viktor,2812,1327,1485,47.19
Yasuo,Akshan,1168,600,568,51.37
Yasuo,Lillia,2253,1068,1185,47.4
Yasuo,Velkoz,2274,1128,1146,49.6
Yasuo,Skarner,992,568,424,57.26
Yasuo,Ekko,3382,1675,1707,49.53
Yasuo,Xerath,3039,1588,1451,52.25
Yasuo,Trundle,2225,1097,1128,49.3
Yasuo,Aphelios,2295,1193,1102,51.98
Yasuo,Nautilus,4155,2123,2032,51.1
Yasuo,Zyra,3217,1687,1530,52.44
Yasuo,Annie,1551,722,829,46.55
Yasuo,Jayce,1761,991,770,56.27
Yasuo,Tryndamere,2206,1069,1137,48.46
Yasuo,MasterYi,4638,2143,2495,46.21
Yasuo,Zeri,1499,742,757,49.5
Yasuo,Taric,953,461,492,48.37
Yasuo,Quinn,1335,633,702,47.42
Yasuo,Udyr,1506,737,769,48.94
Yasuo,Lucian,2673,1394,1279,52.15
Yasuo,Kled,650,366,284,56.31
Yasuo,KogMaw,1140,541,599,47.46
Yasuo,Olaf,888,415,473,46.73
Yasuo,Syndra,1922,942,980,49.01
Yasuo,Talon,2518,1406,1112,55.84
Yasuo,Yorick,3727,1800,1927,48.3
Yasuo,Bard,1151,569,582,49.44
Yasuo,Camille,1252,663,589,52.96
Yasuo,Cassiopeia,1111,544,567,48.96
Yasuo,Milio,2148,993,1155,46.23
Yasuo,Renata,774,410,364,52.97
Yasuo,Elise,2472,1294,1178,52.35
Yasuo,Heimerdinger,1994,1032,962,51.76
Yasuo,Belveth,966,445,521,46.07
Yasuo,Janna,1319,629,690,47.69
Yasuo,Gnar,1605,841,764,52.4
Yasuo,Rumble,1078,607,471,56.31
Yasuo,Karthus,1040,509,531,48.94
Yasuo,Braum,2057,994,1063,48.32
Yasuo,KSante,1908,1009,899,52.88
Yasuo,Nidalee,1072,636,436,59.33
Yasuo,TwistedFate,1210,635,575,52.48
Jhin,Mordekaiser,5063,2397,2666,47.34
Jhin,Qiyana,1150,587,563,51.04
Jhin,Irelia,3342,1759,1583,52.63
Jhin,Ezreal,10002,5247,4755,52.46
Jhin,Rell,1939,1007,932,51.93
Jhin,Aurora,2912,1482,1430,50.89
Jhin,Volibear,4418,2262,2156,51.2
Jhin,Yasuo,7765,3867,3898,49.8
Jhin,Vayne,5015,2290,2725,45.66
Jhin,Shaco,3741,1905,1836,50.92
Jhin,Chogath,4774,2474,2300,51.82
Jhin,Kayn,5796,2792,3004,48.17
Jhin,Gangplank,1807,882,925,48.81
Jhin,Hwei,2827,1486,1341,52.56
Jhin,Warwick,6101,3032,3069,49.7
Jhin,Veigar,3916,1995,1921,50.94
Jhin,Ashe,8158,4066,4092,49.84
Jhin,Nami,3990,1967,2023,49.3
Jhin,Darius,7245,3595,3650,49.62
Jhin,Caitlyn,12937,6592,6345,50.95
Jhin,Morgana,4841,2420,2421,49.99
Jhin,Gragas,2091,1120,971,53.56
Jhin,TwistedFate,1503,869,634,57.82
Jhin,Lucian,2852,1474,1378,51.68
Jhin,Leona,3165,1550,1615,48.97
Jhin,Zed,4378,2191,2187,50.05
Jhin,Sona,1241,583,658,46.98
Jhin,Kaisa,6230,3034,3196,48.7
Jhin,Amumu,4076,2070,2006,50.79
Jhin,Riven,1782,890,892,49.94
Jhin,Ahri,5068,2574,2494,50.79
Jhin,Jinx,11114,5295,5819,47.64
Jhin,Nautilus,4221,2153,2068,51.01
Jhin,Gwen,1901,944,957,49.66
Jhin,Talon,2162,1091,1071,50.46
Jhin,Yone,7255,3748,3507,51.66
Jhin,MissFortune,9499,4735,4764,49.85
Jhin,Taric,759,355,404,46.77
Jhin,Nasus,2596,1271,1325,48.96
Jhin,Varus,3559,1843,1716,51.78
Jhin,Neeko,2096,1097,999,52.34
Jhin,Swain,3805,1745,2060,45.86
Jhin,Malzahar,3830,1905,1925,49.74
Jhin,Kalista,1250,650,600,52
Jhin,Poppy,2276,1126,1150,49.47
Jhin,Ekko,3571,1743,1828,48.81
Jhin,Pyke,3590,1962,1628,54.65
Jhin,Galio,3197,1518,1679,47.48
Jhin,Cassiopeia,1177,574,603,48.77
Jhin,Mel,8387,4405,3982,52.52
Jhin,Hecarim,1537,872,665,56.73
Jhin,Milio,2264,1082,1182,47.79
Jhin,Garen,5970,2841,3129,47.59
Jhin,Seraphine,3220,1637,1583,50.84
Jhin,Zilean,1295,650,645,50.19
Jhin,Soraka,2331,1095,1236,46.98
Jhin,Sylas,4773,2380,2393,49.86
Jhin,Ryze,1229,633,596,51.51
Jhin,Nunu,2483,1201,1282,48.37
Jhin,Alistar,1385,649,736,46.86
Jhin,Lillia,2262,1074,1188,47.48
Jhin,Vladimir,2634,1315,1319,49.92
Jhin,Lulu,4900,2438,2462,49.76
Jhin,Sett,5928,2824,3104,47.64
Jhin,Brand,2730,1418,1312,51.94
Jhin,Twitch,3303,1661,1642,50.29
Jhin,Zac,1710,796,914,46.55
Jhin,Gnar,1728,903,825,52.26
Jhin,Jax,3454,1836,1618,53.16
Jhin,Bard,1166,567,599,48.63
Jhin,Heimerdinger,1927,954,973,49.51
Jhin,FiddleSticks,1976,999,977,50.56
Jhin,Katarina,3160,1633,1527,51.68
Jhin,Akali,4253,2159,2094,50.76
Jhin,Naafiri,1501,768,733,51.17
Jhin,Kayle,2672,1298,1374,48.58
Jhin,Smolder,2836,1506,1330,53.1
Jhin,Sejuani,1551,796,755,51.32
Jhin,AurelionSol,1523,751,772,49.31
Jhin,Tristana,4052,1899,2153,46.87
Jhin,Rakan,1732,807,925,46.59
Jhin,Samira,3013,1536,1477,50.98
Jhin,Leblanc,2171,1123,1048,51.73
Jhin,Malphite,3601,1717,1884,47.68
Jhin,MonkeyKing,2409,1120,1289,46.49
Jhin,Senna,2863,1485,1378,51.87
Jhin,Shen,2438,1221,1217,50.08
Jhin,Ziggs,1500,734,766,48.93
Jhin,Kled,761,385,376,50.59
Jhin,XinZhao,2396,1084,1312,45.24
Jhin,Trundle,2173,1068,1105,49.15
Jhin,Aphelios,2286,1175,1111,51.4
Jhin,Viktor,3329,1722,1607,51.73
Jhin,Yuumi,3303,1675,1628,50.71
Jhin,Xerath,3473,1727,1746,49.73
Jhin,Rammus,1181,586,595,49.62
Jhin,Nocturne,4605,2145,2460,46.58
Jhin,Vex,2160,1056,1104,48.89
Jhin,KSante,1814,992,822,54.69
Jhin,Azir,1292,698,594,54.02
Jhin,Skarner,1108,621,487,56.05
Jhin,Lissandra,1277,646,631,50.59
Jhin,DrMundo,2205,1085,1120,49.21
Jhin,Pantheon,6047,2931,3116,48.47
Jhin,Annie,1280,643,637,50.23
Jhin,Syndra,2486,1202,1284,48.35
Jhin,Lux,10256,5270,4986,51.38
Jhin,Karma,4329,2035,2294,47.01
Jhin,Illaoi,1736,804,932,46.31
Jhin,Rengar,1446,811,635,56.09
Jhin,Xayah,2028,948,1080,46.75
Jhin,Thresh,5171,2467,2704,47.71
Jhin,Ornn,1728,844,884,48.84
Jhin,Yorick,3807,1747,2060,45.89
Jhin,Braum,2148,965,1183,44.93
Jhin,Sion,2917,1381,1536,47.34
Jhin,Evelynn,1466,760,706,51.84
Jhin,MasterYi,4439,2130,2309,47.98
Jhin,Kindred,1783,971,812,54.46
Jhin,Sivir,1960,988,972,50.41
Jhin,Quinn,1428,654,774,45.8
Jhin,Teemo,4844,2366,2478,48.84
Jhin,Camille,1397,723,674,51.75
Jhin,Zeri,1566,767,799,48.98
Jhin,Singed,975,451,524,46.26
Jhin,Aatrox,3436,1691,1745,49.21
Jhin,Khazix,2101,1066,1035,50.74
Jhin,Viego,5676,2869,2807,50.55
Jhin,Diana,5572,2771,2801,49.73
Jhin,Nilah,1399,708,691,50.61
Jhin,RekSai,461,200,261,43.38
Jhin,Velkoz,2385,1226,1159,51.4
Jhin,Vi,3373,1723,1650,51.08
Jhin,Kassadin,802,414,388,51.62
Jhin,Corki,1462,780,682,53.35
Jhin,Blitzcrank,2731,1311,1420,48
Jhin,Belveth,942,468,474,49.68
Jhin,Orianna,1504,768,736,51.06
Jhin,Tryndamere,2170,1059,1111,48.8
Jhin,Renekton,1984,1046,938,52.72
Jhin,Briar,3088,1447,1641,46.86
Jhin,Anivia,1235,539,696,43.64
Jhin,Zoe,1558,795,763,51.03
Jhin,Zyra,3502,1738,1764,49.63
Jhin,Kennen,1156,601,555,51.99
Jhin,Ambessa,2376,1194,1182,50.25
Jhin,Maokai,1608,710,898,44.15
Jhin,Graves,2412,1151,1261,47.72
Jhin,TahmKench,3189,1676,1513,52.56
Jhin,JarvanIV,2037,909,1128,44.62
Jhin,Fiora,1490,736,754,49.4
Jhin,KogMaw,1240,604,636,48.71
Jhin,LeeSin,5529,2949,2580,53.34
Jhin,Fizz,2264,1056,1208,46.64
Jhin,Draven,2119,1131,988,53.37
Jhin,Karthus,1124,539,585,47.95
Jhin,Udyr,1483,775,708,52.26
Jhin,Elise,2621,1445,1176,55.13
Jhin,Akshan,1387,734,653,52.92
Jhin,Taliyah,905,459,446,50.72
Jhin,Renata,724,345,379,47.65
Jhin,Urgot,1963,939,1024,47.83
Jhin,Rumble,1040,557,483,53.56
Jhin,Ivern,688,402,286,58.43
Jhin,Janna,1235,577,658,46.72
Jhin,Nidalee,1088,617,471,56.71
Jhin,Olaf,859,419,440,48.78
Jhin,Shyvana,938,459,479,48.93
Jhin,Jayce,1934,962,972,49.74
Lux,Mordekaiser,6924,3394,3530,49.02
Lux,Qiyana,1392,758,634,54.45
Lux,Irelia,4240,2150,2090,50.71
Lux,Ezreal,10276,5262,5014,51.21
Lux,Rell,2384,1222,1162,51.26
Lux,Sejuani,1938,976,962,50.36
Lux,Yasuo,9891,4778,5113,48.31
Lux,Lucian,3344,1759,1585,52.6
Lux,Pantheon,8056,4001,4055,49.66
Lux,Aurora,3889,2145,1744,55.16
Lux,Volibear,5950,2923,3027,49.13
Lux,Vayne,5799,2784,3015,48.01
Lux,Shaco,5010,2551,2459,50.92
Lux,Aatrox,4381,2272,2109,51.86
Lux,Sylas,5892,3024,2868,51.32
Lux,Diana,7721,3760,3961,48.7
Lux,Varus,4196,2154,2042,51.33
Lux,Blitzcrank,4491,2248,2243,50.06
Lux,Illaoi,2537,1299,1238,51.2
Lux,Warwick,7841,3749,4092,47.81
Lux,Tristana,4859,2481,2378,51.06
Lux,Milio,2907,1297,1610,44.62
Lux,Kayle,3509,1665,1844,47.45
Lux,Caitlyn,13645,6910,6735,50.64
Lux,Renata,926,456,470,49.24
Lux,Darius,9292,4785,4507,51.5
Lux,Morgana,8193,3951,4242,48.22
Lux,Brand,4414,2238,2176,50.7
Lux,Akali,5643,2819,2824,49.96
Lux,MissFortune,12507,6051,6456,48.38
Lux,Kassadin,1046,533,513,50.96
Lux,Kayn,7736,3942,3794,50.96
Lux,Sona,1695,879,816,51.86
Lux,Sett,7902,3907,3995,49.44
Lux,Amumu,5563,2628,2935,47.24
Lux,Poppy,2694,1347,1347,50
Lux,Teemo,6917,3257,3660,47.09
Lux,XinZhao,2898,1381,1517,47.65
Lux,Jinx,12535,6261,6274,49.95
Lux,Neeko,3185,1729,1456,54.29
Lux,Gwen,2555,1367,1188,53.5
Lux,Skarner,1341,676,665,50.41
Lux,Yone,9513,5005,4508,52.61
Lux,Kaisa,7489,3908,3581,52.18
Lux,Seraphine,5686,2888,2798,50.79
Lux,Ornn,2215,1033,1182,46.64
Lux,Ekko,4501,2323,2178,51.61
Lux,Orianna,2182,1133,1049,51.92
Lux,Malzahar,5071,2316,2755,45.67
Lux,Maokai,2258,1212,1046,53.68
Lux,Vi,4276,2092,2184,48.92
Lux,AurelionSol,2243,1031,1212,45.97
Lux,Corki,1930,1038,892,53.78
Lux,Chogath,6098,3087,3011,50.62
Lux,Yorick,5119,2239,2880,43.74
Lux,Sivir,2450,1226,1224,50.04
Lux,Xerath,5341,2594,2747,48.57
Lux,Vladimir,2874,1430,1444,49.76
Lux,Evelynn,2172,1060,1112,48.8
Lux,Yuumi,4284,2169,2115,50.63
Lux,Nasus,3715,1808,1907,48.67
Lux,MonkeyKing,3042,1554,1488,51.08
Lux,Zoe,2179,1149,1030,52.73
Lux,Xayah,2568,1348,1220,52.49
Lux,Zac,1952,989,963,50.67
Lux,Heimerdinger,2747,1390,1357,50.6
Lux,LeeSin,6301,3276,3025,51.99
Lux,Veigar,6026,3027,2999,50.23
Lux,Vex,3074,1484,1590,48.28
Lux,Rakan,2239,1107,1132,49.44
Lux,Gragas,2779,1508,1271,54.26
Lux,Soraka,3050,1481,1569,48.56
Lux,Garen,7811,3883,3928,49.71
Lux,Ziggs,2209,1139,1070,51.56
Lux,Zeri,1777,909,868,51.15
Lux,Zyra,4391,2095,2296,47.71
Lux,Talon,2637,1500,1137,56.88
Lux,Pyke,5085,2511,2574,49.38
Lux,Khazix,2886,1568,1318,54.33
Lux,Nautilus,5576,2864,2712,51.36
Lux,Twitch,4254,2182,2072,51.29
Lux,Kennen,1562,809,753,51.79
Lux,Naafiri,2018,938,1080,46.48
Lux,Nocturne,5915,2748,3167,46.46
Lux,Ashe,9581,4850,4731,50.62
Lux,Thresh,7118,3675,3443,51.63
Lux,Riven,2026,1108,918,54.69
Lux,JarvanIV,2546,1174,1372,46.11
Lux,Taliyah,1149,631,518,54.92
Lux,Draven,2721,1393,1328,51.19
Lux,Jax,4648,2424,2224,52.15
Lux,Mel,10350,5037,5313,48.67
Lux,Kalista,1606,855,751,53.24
Lux,Rammus,1501,768,733,51.17
Lux,TahmKench,5022,2491,2531,49.6
Lux,Katarina,3997,2074,1923,51.89
Lux,Shyvana,1280,626,654,48.91
Lux,Fizz,3150,1592,1558,50.54
Lux,Nilah,1915,945,970,49.35
Lux,Nami,5234,2548,2686,48.68
Lux,Malphite,4998,2485,2513,49.72
Lux,Gnar,1934,979,955,50.62
Lux,Samira,4240,2162,2078,50.99
Lux,Leblanc,2795,1468,1327,52.52
Lux,KSante,2138,1137,1001,53.18
Lux,Quinn,1768,829,939,46.89
Lux,FiddleSticks,2362,1225,1137,51.86
Lux,Cassiopeia,1338,690,648,51.57
Lux,Lillia,2763,1509,1254,54.61
Lux,Lissandra,1432,719,713,50.21
Lux,Renekton,2331,1186,1145,50.88
Lux,Annie,1658,846,812,51.03
Lux,Senna,3952,2019,1933,51.09
Lux,Alistar,1722,863,859,50.12
Lux,Briar,4189,1918,2271,45.79
Lux,Janna,1392,748,644,53.74
Lux,Zed,5568,2850,2718,51.19
Lux,Smolder,3331,1727,1604,51.85
Lux,Galio,4113,2057,2056,50.01
Lux,Swain,5290,2606,2684,49.26
Lux,Tryndamere,3057,1528,1529,49.98
Lux,Zilean,1533,794,739,51.79
Lux,Bard,1409,673,736,47.76
Lux,Rengar,1822,1032,790,56.64
Lux,Olaf,1174,596,578,50.77
Lux,MasterYi,6132,3073,3059,50.11
Lux,Velkoz,3604,1669,1935,46.31
Lux,Trundle,3126,1524,1602,48.75
Lux,Fiora,1989,1039,950,52.24
Lux,Ryze,1498,820,678,54.74
Lux,Jhin,10256,4983,5273,48.59
Lux,Aphelios,2785,1484,1301,53.29
Lux,Hecarim,1957,1008,949,51.51
Lux,Syndra,3061,1501,1560,49.04
Lux,Akshan,1852,970,882,52.38
Lux,Braum,2389,1148,1241,48.05
Lux,Singed,1324,661,663,49.92
Lux,Kindred,2450,1280,1170,52.24
Lux,Kled,888,420,468,47.3
Lux,Karma,5407,2758,2649,51.01
Lux,Ambessa,3012,1615,1397,53.62
Lux,Rumble,1032,537,495,52.03
Lux,Graves,2742,1366,1376,49.82
Lux,Ivern,728,374,354,51.37
Lux,Udyr,1791,893,898,49.86
Lux,Taric,1057,562,495,53.17
Lux,Nunu,3459,1739,1720,50.27
Lux,Viktor,3929,1971,1958,50.17
Lux,Urgot,2541,1303,1238,51.28
Lux,Lulu,5326,2661,2665,49.96
Lux,DrMundo,3181,1444,1737,45.39
Lux,Karthus,1384,747,637,53.97
Lux,Ahri,7251,3917,3334,54.02
Lux,Azir,1612,902,710,55.96
Lux,Viego,6616,3260,3356,49.27
Lux,Hwei,3506,1728,1778,49.29
Lux,Camille,1677,881,796,52.53
Lux,Shen,3218,1638,1580,50.9
Lux,TwistedFate,1779,950,829,53.4
Lux,Gangplank,2148,1061,1087,49.39
Lux,Sion,3602,1709,1893,47.45
Lux,Belveth,1173,618,555,52.69
Lux,Nidalee,1274,751,523,58.95
Lux,Leona,4273,2050,2223,47.98
Lux,Anivia,1487,765,722,51.45
Lux,Elise,3169,1604,1565,50.62
Lux,KogMaw,1576,747,829,47.4
Lux,Jayce,1901,1012,889,53.24
Lux,RekSai,526,295,231,56.08
Mordekaiser,Yone,5196,2644,2552,50.89
Mordekaiser,Darius,5732,2825,2907,49.28
Mordekaiser,Yasuo,5074,2696,2378,53.13
Mordekaiser,Jhin,5063,2666,2397,52.66
Mordekaiser,Lux,6924,3530,3394,50.98
Mordekaiser,Singed,708,320,388,45.2
Mordekaiser,Shaco,2526,1368,1158,54.16
Mordekaiser,Zed,2685,1452,1233,54.08
Mordekaiser,Hwei,1874,911,963,48.61
Mordekaiser,Fiora,1323,675,648,51.02
Mordekaiser,Belveth,674,324,350,48.07
Mordekaiser,Sylas,3173,1684,1489,53.07
Mordekaiser,Ezreal,5380,2834,2546,52.68
Mordekaiser,Yuumi,2267,1193,1074,52.62
Mordekaiser,Illaoi,1712,938,774,54.79
Mordekaiser,Nunu,1937,1036,901,53.48
Mordekaiser,Irelia,2132,1126,1006,52.81
Mordekaiser,Swain,2860,1526,1334,53.36
Mordekaiser,Warwick,4930,2386,2544,48.4
Mordekaiser,Caitlyn,7142,3614,3528,50.6
Mordekaiser,Morgana,3616,1857,1759,51.36
Mordekaiser,MonkeyKing,1747,890,857,50.94
Mordekaiser,Tristana,2596,1355,1241,52.2
Mordekaiser,Garen,4596,2548,2048,55.44
Mordekaiser,Diana,4144,2169,1975,52.34
Mordekaiser,Pyke,2449,1318,1131,53.82
Mordekaiser,Volibear,3713,1894,1819,51.01
Mordekaiser,Ekko,2277,1134,1143,49.8
Mordekaiser,Kalista,874,438,436,50.11
Mordekaiser,Kayn,4228,2189,2039,51.77
Mordekaiser,TwistedFate,813,424,389,52.15
Mordekaiser,Smolder,1759,991,768,56.34
Mordekaiser,Nautilus,2896,1519,1377,52.45
Mordekaiser,Renekton,1296,722,574,55.71
Mordekaiser,Vex,1483,784,699,52.87
Mordekaiser,Samira,2386,1314,1072,55.07
Mordekaiser,Lulu,2635,1414,1221,53.66
Mordekaiser,Urgot,1487,726,761,48.82
Mordekaiser,Rengar,1002,624,378,62.28
Mordekaiser,Ziggs,1152,569,583,49.39
Mordekaiser,Trundle,1789,885,904,49.47
Mordekaiser,Yorick,2957,1409,1548,47.65
Mordekaiser,Seraphine,2459,1280,1179,52.05
Mordekaiser,Sivir,1306,636,670,48.7
Mordekaiser,Xerath,2103,1053,1050,50.07
Mordekaiser,KSante,1492,783,709,52.48
Mordekaiser,Ashe,5004,2560,2444,51.16
Mordekaiser,Corki,770,464,306,60.26
Mordekaiser,Vladimir,1582,778,804,49.18
Mordekaiser,Tryndamere,1557,760,797,48.81
Mordekaiser,Milio,1459,754,705,51.68
Mordekaiser,Gangplank,1040,589,451,56.63
Mordekaiser,Mel,5731,3083,2648,53.8
Mordekaiser,Hecarim,1034,555,479,53.68
Mordekaiser,Heimerdinger,1424,662,762,46.49
Mordekaiser,Kindred,1239,702,537,56.66
Mordekaiser,Katarina,2061,1133,928,54.97
Mordekaiser,Janna,708,342,366,48.31
Mordekaiser,Teemo,3542,1840,1702,51.95
Mordekaiser,LeeSin,3084,1593,1491,51.65
Mordekaiser,Nami,2483,1247,1236,50.22
Mordekaiser,Amumu,3069,1566,1503,51.03
Mordekaiser,Kaisa,3834,2051,1783,53.5
Mordekaiser,Rakan,1134,598,536,52.73
Mordekaiser,Gnar,936,494,442,52.78
Mordekaiser,Viego,3419,1781,1638,52.09
Mordekaiser,TahmKench,2792,1454,1338,52.08
Mordekaiser,Akshan,885,430,455,48.59
Mordekaiser,FiddleSticks,1287,705,582,54.78
Mordekaiser,Nasus,2220,1120,1100,50.45
Mordekaiser,Neeko,1570,743,827,47.32
Mordekaiser,MissFortune,6869,3521,3348,51.26
Mordekaiser,Leblanc,1349,755,594,55.97
Mordekaiser,Karma,2423,1221,1202,50.39
Mordekaiser,Fizz,1612,892,720,55.33
Mordekaiser,Aatrox,2552,1377,1175,53.96
Mordekaiser,Aurora,2029,1076,953,53.03
Mordekaiser,Brand,2035,1024,1011,50.32
Mordekaiser,Gragas,1316,780,536,59.27
Mordekaiser,Kennen,750,399,351,53.2
Mordekaiser,Vayne,3540,1698,1842,47.97
Mordekaiser,Thresh,3615,1899,1716,52.53
Mordekaiser,Akali,2991,1623,1368,54.26
Mordekaiser,Jinx,6967,3593,3374,51.57
Mordekaiser,Xayah,1428,738,690,51.68
Mordekaiser,Senna,2088,1050,1038,50.29
Mordekaiser,Shen,1792,906,886,50.56
Mordekaiser,Rammus,831,482,349,58
Mordekaiser,Cassiopeia,853,412,441,48.3
Mordekaiser,Zeri,1027,580,447,56.48
Mordekaiser,Sion,1907,951,956,49.87
Mordekaiser,Ahri,3693,1875,1818,50.77
Mordekaiser,Anivia,864,432,432,50
Mordekaiser,Poppy,1663,835,828,50.21
Mordekaiser,Riven,1244,686,558,55.14
Mordekaiser,Briar,2424,1147,1277,47.32
Mordekaiser,Jayce,941,514,427,54.62
Mordekaiser,Sett,4930,2538,2392,51.48
Mordekaiser,Pantheon,4193,2260,1933,53.9
Mordekaiser,Braum,1439,762,677,52.95
Mordekaiser,Taric,652,301,351,46.17
Mordekaiser,Chogath,3665,2014,1651,54.95
Mordekaiser,Rell,1247,659,588,52.85
Mordekaiser,Olaf,983,499,484,50.76
Mordekaiser,Evelynn,1169,689,480,58.94
Mordekaiser,Leona,2313,1284,1029,55.51
Mordekaiser,Talon,1356,777,579,57.3
Mordekaiser,Maokai,1234,643,591,52.11
Mordekaiser,Zyra,2234,1077,1157,48.21
Mordekaiser,Malphite,2852,1613,1239,56.56
Mordekaiser,Veigar,3081,1515,1566,49.17
Mordekaiser,Blitzcrank,2000,1032,968,51.6
Mordekaiser,Orianna,1020,508,512,49.8
Mordekaiser,Draven,1306,673,633,51.53
Mordekaiser,Sejuani,1060,559,501,52.74
Mordekaiser,Gwen,1477,787,690,53.28
Mordekaiser,Malzahar,2525,1286,1239,50.93
Mordekaiser,Galio,2234,1109,1125,49.64
Mordekaiser,MasterYi,3220,1514,1706,47.02
Mordekaiser,Varus,2299,1152,1147,50.11
Mordekaiser,DrMundo,1629,773,856,47.45
Mordekaiser,Nilah,1062,537,525,50.56
Mordekaiser,Aphelios,1604,797,807,49.69
Mordekaiser,Nocturne,2896,1425,1471,49.21
Mordekaiser,Udyr,1049,564,485,53.77
Mordekaiser,JarvanIV,1238,644,594,52.02
Mordekaiser,Soraka,1567,781,786,49.84
Mordekaiser,Viktor,1930,997,933,51.66
Mordekaiser,Karthus,697,352,345,50.5
Mordekaiser,Qiyana,662,376,286,56.8
Mordekaiser,Lucian,1718,847,871,49.3
Mordekaiser,Naafiri,1096,609,487,55.57
Mordekaiser,Zilean,768,431,337,56.12
Mordekaiser,Kassadin,542,262,280,48.34
Mordekaiser,Graves,1454,739,715,50.83
Mordekaiser,Ivern,417,232,185,55.64
Mordekaiser,Velkoz,1570,714,856,45.48
Mordekaiser,Ryze,792,460,332,58.08
Mordekaiser,Sona,844,415,429,49.17
Mordekaiser,Kayle,2027,920,1107,45.39
Mordekaiser,Jax,2467,1294,1173,52.45
Mordekaiser,Khazix,1527,808,719,52.91
Mordekaiser,Camille,901,509,392,56.49
Mordekaiser,Shyvana,764,367,397,48.04
Mordekaiser,Taliyah,629,347,282,55.17
Mordekaiser,Twitch,2236,1181,1055,52.82
Mordekaiser,KogMaw,881,475,406,53.92
Mordekaiser,Skarner,801,453,348,56.55
Mordekaiser,Azir,899,500,399,55.62
Mordekaiser,Vi,2432,1199,1233,49.3
Mordekaiser,AurelionSol,1146,636,510,55.5
Mordekaiser,Zac,1082,528,554,48.8
Mordekaiser,XinZhao,1647,867,780,52.64
Mordekaiser,Rumble,605,353,252,58.35
Mordekaiser,Zoe,1066,548,518,51.41
Mordekaiser,Renata,543,254,289,46.78
Mordekaiser,Ornn,1280,647,633,50.55
Mordekaiser,Lillia,1595,854,741,53.54
Mordekaiser,Annie,792,440,352,55.56
Mordekaiser,Syndra,1587,847,740,53.37
Mordekaiser,Elise,1457,744,713,51.06
Mordekaiser,Kled,520,306,214,58.85
Mordekaiser,Alistar,1049,587,462,55.96
Mordekaiser,Nidalee,554,302,252,54.51
Mordekaiser,Quinn,841,409,432,48.63
Mordekaiser,Ambessa,1446,773,673,53.46
Mordekaiser,Bard,729,356,373,48.83
Mordekaiser,Lissandra,777,359,418,46.2
Mordekaiser,RekSai,332,173,159,52.11
Qiyana,Yone,966,474,492,49.07
Qiyana,Darius,952,384,568,40.34
Qiyana,Yasuo,1042,456,586,43.76
Qiyana,Jhin,1150,563,587,48.96
Qiyana,Lux,1392,634,758,45.55
Qiyana,Fiora,264,117,147,44.32
Qiyana,Belveth,144,85,59,59.03
Qiyana,Sylas,740,368,372,49.73
Qiyana,Ezreal,1231,566,665,45.98
Qiyana,Yuumi,471,186,285,39.49
Qiyana,Illaoi,260,130,130,50
Qiyana,Twitch,429,182,247,42.42
Qiyana,Velkoz,382,175,207,45.81
Qiyana,MonkeyKing,309,133,176,43.04
Qiyana,Tristana,532,223,309,41.92
Qiyana,Morgana,620,286,334,46.13
Qiyana,Teemo,607,248,359,40.86
Qiyana,Poppy,308,166,142,53.9
Qiyana,Akali,594,318,276,53.54
Qiyana,Caitlyn,1435,650,785,45.3
Qiyana,Leona,446,220,226,49.33
Qiyana,Zed,771,380,391,49.29
Qiyana,Shaco,493,221,272,44.83
Qiyana,Anivia,130,50,80,38.46
Qiyana,Garen,773,351,422,45.41
Qiyana,FiddleSticks,249,123,126,49.4
Qiyana,Brand,321,131,190,40.81
Qiyana,Yorick,476,222,254,46.64
Qiyana,Katarina,521,253,268,48.56
Qiyana,Lucian,325,147,178,45.23
Qiyana,Nautilus,630,282,348,44.76
Qiyana,Chogath,632,286,346,45.25
Qiyana,Talon,342,168,174,49.12
Qiyana,Nilah,222,97,125,43.69
Qiyana,Milio,389,193,196,49.61
Qiyana,Kindred,260,107,153,41.15
Qiyana,AurelionSol,213,112,101,52.58
Qiyana,Kalista,196,68,128,34.69
Qiyana,Kayle,338,161,177,47.63
Qiyana,Shyvana,124,50,74,40.32
Qiyana,Galio,368,165,203,44.84
Qiyana,Mel,1244,631,613,50.72
Qiyana,Blitzcrank,397,201,196,50.63
Qiyana,Urgot,258,105,153,40.7
Qiyana,Rakan,267,109,158,40.82
Qiyana,Kennen,141,64,77,45.39
Qiyana,JarvanIV,273,107,166,39.19
Qiyana,Karma,639,316,323,49.45
Qiyana,Soraka,302,134,168,44.37
Qiyana,Mordekaiser,662,286,376,43.2
Qiyana,Ekko,518,217,301,41.89
Qiyana,Irelia,451,231,220,51.22
Qiyana,Swain,565,228,337,40.35
Qiyana,Aatrox,558,295,263,52.87
Qiyana,Warwick,721,279,442,38.7
Qiyana,Fizz,290,137,153,47.24
Qiyana,Pyke,524,285,239,54.39
Qiyana,KSante,228,132,96,57.89
Qiyana,Draven,313,138,175,44.09
Qiyana,Renata,94,36,58,38.3
Qiyana,Hwei,364,167,197,45.88
Qiyana,Jinx,1368,638,730,46.64
Qiyana,Thresh,682,293,389,42.96
Qiyana,Volibear,613,316,297,51.55
Qiyana,Sett,824,290,534,35.19
Qiyana,Khazix,333,184,149,55.26
Qiyana,Ahri,703,325,378,46.23
Qiyana,DrMundo,278,101,177,36.33
Qiyana,Kayn,793,333,460,41.99
Qiyana,Sivir,240,111,129,46.25
Qiyana,Vi,454,196,258,43.17
Qiyana,Lulu,678,357,321,52.65
Qiyana,TahmKench,429,200,229,46.62
Qiyana,Veigar,538,272,266,50.56
Qiyana,Ashe,1070,540,530,50.47
Qiyana,Zilean,191,78,113,40.84
Qiyana,Ornn,266,119,147,44.74
Qiyana,Diana,817,369,448,45.17
Qiyana,Kled,104,44,60,42.31
Qiyana,Maokai,290,111,179,38.28
Qiyana,Riven,269,115,154,42.75
Qiyana,Orianna,313,160,153,51.12
Qiyana,Vladimir,378,189,189,50
Qiyana,Aphelios,354,149,205,42.09
Qiyana,Rengar,242,106,136,43.8
Qiyana,Rell,271,116,155,42.8
Qiyana,Gragas,378,195,183,51.59
Qiyana,Leblanc,202,106,96,52.48
Qiyana,Jax,494,203,291,41.09
Qiyana,Malphite,574,253,321,44.08
Qiyana,Udyr,217,92,125,42.4
Qiyana,Bard,187,68,119,36.36
Qiyana,Singed,152,74,78,48.68
Qiyana,MissFortune,1153,506,647,43.89
Qiyana,Tryndamere,337,160,177,47.48
Qiyana,Sion,477,219,258,45.91
Qiyana,Graves,344,159,185,46.22
Qiyana,Gnar,226,83,143,36.73
Qiyana,MasterYi,722,337,385,46.68
Qiyana,LeeSin,696,315,381,45.26
Qiyana,Azir,229,106,123,46.29
Qiyana,Nami,578,232,346,40.14
Qiyana,Nasus,413,204,209,49.39
Qiyana,Hecarim,257,125,132,48.64
Qiyana,Vayne,696,337,359,48.42
Qiyana,Seraphine,420,192,228,45.71
Qiyana,Janna,225,109,116,48.44
Qiyana,Pantheon,846,422,424,49.88
Qiyana,Camille,204,114,90,55.88
Qiyana,Syndra,346,153,193,44.22
Qiyana,Nunu,334,156,178,46.71
Qiyana,Ryze,220,110,110,50
Qiyana,Evelynn,242,97,145,40.08
Qiyana,Quinn,172,62,110,36.05
Qiyana,Viego,858,421,437,49.07
Qiyana,Xerath,386,157,229,40.67
Qiyana,Aurora,512,274,238,53.52
Qiyana,Briar,436,183,253,41.97
Qiyana,Kassadin,132,77,55,58.33
Qiyana,Gwen,314,174,140,55.41
Qiyana,Nocturne,565,253,312,44.78
Qiyana,Ambessa,377,138,239,36.6
Qiyana,Gangplank,244,119,125,48.77
Qiyana,Cassiopeia,178,90,88,50.56
Qiyana,Shen,373,153,220,41.02
Qiyana,Rammus,126,44,82,34.92
Qiyana,Heimerdinger,238,106,132,44.54
Qiyana,Vex,395,163,232,41.27
Qiyana,Amumu,563,231,332,41.03
Qiyana,Kaisa,782,412,370,52.69
Qiyana,Varus,489,213,276,43.56
Qiyana,Senna,529,213,316,40.26
Qiyana,XinZhao,332,177,155,53.31
Qiyana,Malzahar,441,177,264,40.14
Qiyana,Sejuani,235,132,103,56.17
Qiyana,Naafiri,209,90,119,43.06
Qiyana,Annie,153,68,85,44.44
Qiyana,Trundle,292,119,173,40.75
Qiyana,KogMaw,145,79,66,54.48
Qiyana,Ziggs,167,94,73,56.29
Qiyana,Corki,254,132,122,51.97
Qiyana,Zeri,278,140,138,50.36
Qiyana,Renekton,273,116,157,42.49
Qiyana,Rumble,157,63,94,40.13
Qiyana,Zyra,427,187,240,43.79
Qiyana,Ivern,111,71,40,63.96
Qiyana,Nidalee,169,79,90,46.75
Qiyana,Lissandra,195,69,126,35.38
Qiyana,Taric,107,57,50,53.27
Qiyana,Lillia,337,173,164,51.34
Qiyana,Samira,411,213,198,51.82
Qiyana,Elise,436,211,225,48.39
Qiyana,Jayce,316,144,172,45.57
Qiyana,Skarner,158,67,91,42.41
Qiyana,Zac,240,98,142,40.83
Qiyana,Smolder,321,169,152,52.65
Qiyana,Zoe,270,109,161,40.37
Qiyana,Alistar,257,146,111,56.81
Qiyana,Xayah,309,145,164,46.93
Qiyana,Viktor,472,247,225,52.33
Qiyana,Karthus,170,86,84,50.59
Qiyana,Neeko,236,98,138,41.53
Qiyana,TwistedFate,179,81,98,45.25
Qiyana,Braum,236,131,105,55.51
Qiyana,Taliyah,164,86,78,52.44
Qiyana,Akshan,191,81,110,42.41
Qiyana,Sona,137,61,76,44.53
Qiyana,Olaf,150,68,82,45.33
Qiyana,RekSai,73,30,43,41.1
Irelia,Yone,3761,1963,1798,52.19
Irelia,Darius,2911,1394,1517,47.89
Irelia,Yasuo,3800,1909,1891,50.24
Irelia,Jhin,3342,1583,1759,47.37
Irelia,Lux,4240,2085,2155,49.17
Irelia,Mordekaiser,2132,1006,1126,47.19
Irelia,Warwick,2494,1157,1337,46.39
Irelia,Veigar,1664,752,912,45.19
Irelia,Ashe,3388,1598,1790,47.17
Irelia,Nami,1554,694,860,44.66
Irelia,Caitlyn,4635,2411,2224,52.02
Irelia,Morgana,1910,871,1039,45.6
Irelia,Yorick,1827,851,976,46.58
Irelia,Kayn,2656,1317,1339,49.59
Irelia,Ryze,617,339,278,54.94
Irelia,Pantheon,2603,1272,1331,48.87
Irelia,TahmKench,1460,699,761,47.88
Irelia,Malphite,1785,792,993,44.37
Irelia,Aphelios,1112,567,545,50.99
Irelia,TwistedFate,556,325,231,58.45
Irelia,Gnar,862,481,381,55.8
Irelia,Jax,1799,974,825,54.14
Irelia,Neeko,1005,520,485,51.74
Irelia,Renekton,745,340,405,45.64
Irelia,JarvanIV,843,437,406,51.84
Irelia,Mel,3597,1760,1837,48.93
Irelia,Sylas,2223,1021,1202,45.93
Irelia,Singed,429,195,234,45.45
Irelia,Graves,943,448,495,47.51
Irelia,Fizz,908,443,465,48.79
Irelia,Ziggs,592,279,313,47.13
Irelia,Sett,2806,1266,1540,45.12
Irelia,Amumu,1740,778,962,44.71
Irelia,Poppy,1099,506,593,46.04
Irelia,Zed,2053,1003,1050,48.86
Irelia,Sivir,876,399,477,45.55
Irelia,Blitzcrank,1368,679,689,49.63
Irelia,Gangplank,867,443,424,51.1
Irelia,Kaisa,2908,1619,1289,55.67
Irelia,Galio,1403,657,746,46.83
Irelia,Cassiopeia,554,297,257,53.61
Irelia,Hwei,1186,650,536,54.81
Irelia,Gwen,854,460,394,53.86
Irelia,Skarner,506,266,240,52.57
Irelia,Seraphine,1472,669,803,45.45
Irelia,Ornn,756,387,369,51.19
Irelia,MissFortune,3813,1855,1958,48.65
Irelia,Brand,1232,659,573,53.49
Irelia,Teemo,1979,882,1097,44.57
Irelia,Shaco,1567,821,746,52.39
Irelia,Leblanc,890,438,452,49.21
Irelia,Ezreal,3862,1901,1961,49.22
Irelia,Thresh,2300,1120,1180,48.7
Irelia,Illaoi,862,384,478,44.55
Irelia,Aatrox,1679,898,781,53.48
Irelia,Gragas,929,468,461,50.38
Irelia,Garen,2598,1212,1386,46.65
Irelia,Volibear,2032,946,1086,46.56
Irelia,Tristana,1557,784,773,50.35
Irelia,Zeri,684,387,297,56.58
Irelia,Zyra,1500,745,755,49.67
Irelia,Jayce,960,486,474,50.63
Irelia,Rengar,683,400,283,58.57
Irelia,Swain,1703,845,858,49.62
Irelia,Sona,554,293,261,52.89
Irelia,Briar,1313,617,696,46.99
Irelia,Kennen,574,283,291,49.3
Irelia,Rammus,662,303,359,45.77
Irelia,Pyke,1563,899,664,57.52
Irelia,Riven,716,403,313,56.28
Irelia,Taliyah,439,219,220,49.89
Irelia,Draven,916,478,438,52.18
Irelia,Lulu,1864,946,918,50.75
Irelia,Akali,2076,1015,1061,48.89
Irelia,Naafiri,636,324,312,50.94
Irelia,Kayle,1342,681,661,50.75
Irelia,Smolder,1086,591,495,54.42
Irelia,Khazix,917,464,453,50.6
Irelia,Sion,1224,608,616,49.67
Irelia,FiddleSticks,802,419,383,52.24
Irelia,Zilean,533,267,266,50.09
Irelia,Tryndamere,875,406,469,46.4
Irelia,Nidalee,500,288,212,57.6
Irelia,Aurora,1402,654,748,46.65
Irelia,Nunu,1072,561,511,52.33
Irelia,Rakan,726,338,388,46.56
Irelia,Soraka,1031,524,507,50.82
Irelia,Lillia,1032,516,516,50
Irelia,Orianna,661,325,336,49.17
Irelia,Velkoz,1050,523,527,49.81
Irelia,Chogath,1945,938,1007,48.23
Irelia,Evelynn,693,369,324,53.25
Irelia,Lissandra,626,305,321,48.72
Irelia,Nilah,569,280,289,49.21
Irelia,Diana,2505,1225,1280,48.9
Irelia,MonkeyKing,1067,487,580,45.64
Irelia,Vex,958,490,468,51.15
Irelia,Vayne,2041,1046,995,51.25
Irelia,Ekko,1517,786,731,51.81
Irelia,Senna,1247,637,610,51.08
Irelia,Olaf,253,124,129,49.01
Irelia,Jinx,4357,2125,2232,48.77
Irelia,Leona,1559,767,792,49.2
Irelia,KSante,897,457,440,50.95
Irelia,Zac,710,322,388,45.35
Irelia,Azir,606,307,299,50.66
Irelia,Ahri,2244,1170,1074,52.14
Irelia,Twitch,1241,631,610,50.85
Irelia,MasterYi,2084,1042,1042,50
Irelia,Nasus,1083,514,569,47.46
Irelia,Malzahar,1652,772,880,46.73
Irelia,Braum,871,396,475,45.46
Irelia,Syndra,1000,489,511,48.9
Irelia,Karma,1828,896,932,49.02
Irelia,Nautilus,1965,975,990,49.62
Irelia,Lucian,1078,555,523,51.48
Irelia,Samira,1307,638,669,48.81
Irelia,Nocturne,2059,893,1166,43.37
Irelia,Trundle,914,425,489,46.5
Irelia,Heimerdinger,848,362,486,42.69
Irelia,Udyr,576,278,298,48.26
Irelia,Milio,948,402,546,42.41
Irelia,Vladimir,1165,592,573,50.82
Irelia,Qiyana,451,220,231,48.78
Irelia,Vi,1609,865,744,53.76
Irelia,Varus,1348,670,678,49.7
Irelia,Hecarim,643,321,322,49.92
Irelia,Karthus,460,238,222,51.74
Irelia,Kassadin,333,191,142,57.36
Irelia,Viktor,1419,697,722,49.12
Irelia,LeeSin,2403,1212,1191,50.44
Irelia,Kalista,572,298,274,52.1
Irelia,Sejuani,694,320,374,46.11
Irelia,Xayah,880,378,502,42.95
Irelia,Quinn,559,286,273,51.16
Irelia,Katarina,1417,730,687,51.52
Irelia,Janna,535,295,240,55.14
Irelia,Renata,359,193,166,53.76
Irelia,Maokai,822,422,400,51.34
Irelia,Urgot,793,349,444,44.01
Irelia,XinZhao,998,477,521,47.8
Irelia,Annie,469,243,226,51.81
Irelia,KogMaw,521,214,307,41.07
Irelia,Shen,1035,477,558,46.09
Irelia,Yuumi,1511,747,764,49.44
Irelia,Rell,870,437,433,50.23
Irelia,Anivia,482,241,241,50
Irelia,Belveth,365,181,184,49.59
Irelia,AurelionSol,578,263,315,45.5
Irelia,DrMundo,874,440,434,50.34
Irelia,Viego,2318,1161,1157,50.09
Irelia,Bard,474,225,249,47.47
Irelia,Kindred,802,415,387,51.75
Irelia,Zoe,714,420,294,58.82
Irelia,Talon,1071,595,476,55.56
Irelia,Ambessa,1124,618,506,54.98
Irelia,Kled,271,142,129,52.4
Irelia,Xerath,1417,671,746,47.35
Irelia,Alistar,711,328,383,46.13
Irelia,Elise,1173,603,570,51.41
Irelia,RekSai,193,75,118,38.86
Irelia,Corki,535,269,266,50.28
Irelia,Ivern,260,137,123,52.69
Irelia,Taric,297,147,150,49.49
Irelia,Rumble,473,274,199,57.93
Irelia,Fiora,706,335,371,47.45
Irelia,Camille,494,239,255,48.38
Irelia,Akshan,585,314,271,53.68
Irelia,Shyvana,452,229,223,50.66
Ezreal,Yone,8705,4453,4252,51.15
Ezreal,Darius,7777,3557,4220,45.74
Ezreal,Yasuo,8483,4019,4464,47.38
Ezreal,Jhin,10002,4755,5247,47.54
Ezreal,Lux,10276,5012,5264,48.77
Ezreal,Gwen,2228,1128,1100,50.63
Ezreal,Vi,4667,2226,2441,47.7
Ezreal,Zed,4897,2440,2457,49.83
Ezreal,Soraka,2191,1000,1191,45.64
Ezreal,Mordekaiser,5380,2546,2834,47.32
Ezreal,Kindred,1991,965,1026,48.47
Ezreal,Qiyana,1231,665,566,54.02
Ezreal,Ashe,10369,5194,5175,50.09
Ezreal,Sona,1305,560,745,42.91
Ezreal,Garen,6781,3175,3606,46.82
Ezreal,Briar,3024,1357,1667,44.87
Ezreal,Caitlyn,14457,7033,7424,48.65
Ezreal,Morgana,5083,2435,2648,47.9
Ezreal,Akali,4967,2536,2431,51.06
Ezreal,MissFortune,10172,4825,5347,47.43
Ezreal,Kassadin,929,460,469,49.52
Ezreal,Kayn,5876,2841,3035,48.35
Ezreal,Kayle,2676,1240,1436,46.34
Ezreal,MonkeyKing,2950,1431,1519,48.51
Ezreal,RekSai,631,294,337,46.59
Ezreal,Seraphine,3228,1591,1637,49.29
Ezreal,Irelia,3862,1959,1903,50.73
Ezreal,Warwick,5568,2562,3006,46.01
Ezreal,Galio,4097,1875,2222,45.77
Ezreal,Sivir,2727,1179,1548,43.23
Ezreal,Rell,2353,1102,1251,46.83
Ezreal,Sett,6339,2961,3378,46.71
Ezreal,Zac,2281,1127,1154,49.41
Ezreal,Yorick,3780,1764,2016,46.67
Ezreal,Xerath,4392,2135,2257,48.61
Ezreal,Fiora,1656,810,846,48.91
Ezreal,FiddleSticks,2100,957,1143,45.57
Ezreal,Syndra,2681,1314,1367,49.01
Ezreal,Vayne,5713,2732,2981,47.82
Ezreal,Viego,6234,3008,3226,48.25
Ezreal,AurelionSol,1690,825,865,48.82
Ezreal,Nautilus,5411,2593,2818,47.92
Ezreal,Jinx,12180,5665,6515,46.51
Ezreal,Lulu,6312,2951,3361,46.75
Ezreal,Camille,1736,929,807,53.51
Ezreal,Katarina,3093,1477,1616,47.75
Ezreal,Zyra,4033,1841,2192,45.65
Ezreal,Tryndamere,2140,1064,1076,49.72
Ezreal,Gragas,2917,1501,1416,51.46
Ezreal,Kalista,1637,752,885,45.94
Ezreal,Twitch,3009,1434,1575,47.66
Ezreal,Graves,2984,1500,1484,50.27
Ezreal,Sylas,7039,3540,3499,50.29
Ezreal,Leona,4054,1974,2080,48.69
Ezreal,KSante,2488,1232,1256,49.52
Ezreal,Nasus,2776,1299,1477,46.79
Ezreal,TahmKench,3377,1546,1831,45.78
Ezreal,Fizz,2218,1090,1128,49.14
Ezreal,Janna,1457,672,785,46.12
Ezreal,Nocturne,5018,2358,2660,46.99
Ezreal,Thresh,6500,3050,3450,46.92
Ezreal,Shen,2485,1129,1356,45.43
Ezreal,Rammus,1212,582,630,48.02
Ezreal,Cassiopeia,1289,602,687,46.7
Ezreal,Udyr,1667,820,847,49.19
Ezreal,Veigar,3873,1866,2007,48.18
Ezreal,Kennen,1340,670,670,50
Ezreal,XinZhao,2993,1434,1559,47.91
Ezreal,Kaisa,9955,4816,5139,48.38
Ezreal,Karthus,1338,682,656,50.97
Ezreal,Nilah,1394,608,786,43.62
Ezreal,Braum,2402,1120,1282,46.63
Ezreal,Maokai,2091,990,1101,47.35
Ezreal,Pantheon,7511,3706,3805,49.34
Ezreal,Aurora,3571,1767,1804,49.48
Ezreal,Teemo,5125,2357,2768,45.99
Ezreal,Yuumi,3304,1540,1764,46.61
Ezreal,Poppy,2511,1256,1255,50.02
Ezreal,Khazix,2378,1174,1204,49.37
Ezreal,Tristana,4143,2065,2078,49.84
Ezreal,Neeko,2188,1008,1180,46.07
Ezreal,Nunu,2644,1200,1444,45.39
Ezreal,Vladimir,2686,1272,1414,47.36
Ezreal,Gnar,1995,1015,980,50.88
Ezreal,Akshan,1363,646,717,47.4
Ezreal,Jax,4021,1876,2145,46.66
Ezreal,Velkoz,2520,1254,1266,49.76
Ezreal,Xayah,2210,1093,1117,49.46
Ezreal,Rakan,2023,1008,1015,49.83
Ezreal,MasterYi,4824,2345,2479,48.61
Ezreal,Shaco,4049,2083,1966,51.44
Ezreal,Azir,1645,838,807,50.94
Ezreal,Rengar,1573,847,726,53.85
Ezreal,Pyke,4169,2135,2034,51.21
Ezreal,Lucian,3530,1734,1796,49.12
Ezreal,Renekton,2335,1120,1215,47.97
Ezreal,Zoe,1828,865,963,47.32
Ezreal,LeeSin,8268,4268,4000,51.62
Ezreal,Hwei,2923,1394,1529,47.69
Ezreal,Lillia,2607,1257,1350,48.22
Ezreal,Milio,2403,1081,1322,44.99
Ezreal,Diana,6911,3275,3636,47.39
Ezreal,Olaf,1059,516,543,48.73
Ezreal,Volibear,4178,1924,2254,46.05
Ezreal,Mel,8687,4425,4262,50.94
Ezreal,Ambessa,3293,1631,1662,49.53
Ezreal,Evelynn,1548,716,832,46.25
Ezreal,Anivia,1284,623,661,48.52
Ezreal,Singed,1073,480,593,44.73
Ezreal,Karma,5496,2743,2753,49.91
Ezreal,Kled,855,379,476,44.33
Ezreal,Zeri,2180,1032,1148,47.34
Ezreal,Swain,3992,1795,2197,44.96
Ezreal,Talon,2868,1445,1423,50.38
Ezreal,Varus,4626,2283,2343,49.35
Ezreal,DrMundo,2273,1049,1224,46.15
Ezreal,Ekko,3881,1867,2014,48.11
Ezreal,Amumu,4076,1919,2157,47.08
Ezreal,Ryze,1657,712,945,42.97
Ezreal,Belveth,1105,540,565,48.87
Ezreal,Nami,3988,1805,2183,45.26
Ezreal,Ornn,1858,833,1025,44.83
Ezreal,Blitzcrank,3847,1937,1910,50.35
Ezreal,Elise,3627,1735,1892,47.84
Ezreal,Heimerdinger,1930,895,1035,46.37
Ezreal,Malzahar,4000,1776,2224,44.4
Ezreal,Vex,2297,1177,1120,51.24
Ezreal,Senna,3311,1580,1731,47.72
Ezreal,Brand,2854,1294,1560,45.34
Ezreal,Sion,3372,1617,1755,47.95
Ezreal,Jayce,2831,1348,1483,47.62
Ezreal,KogMaw,1273,601,672,47.21
Ezreal,Urgot,1837,826,1011,44.96
Ezreal,Skarner,1252,596,656,47.6
Ezreal,Ziggs,1622,781,841,48.15
Ezreal,Leblanc,3025,1506,1519,49.79
Ezreal,Riven,1955,953,1002,48.75
Ezreal,Annie,1535,786,749,51.21
Ezreal,Nidalee,1642,948,694,57.73
Ezreal,Orianna,2224,1134,1090,50.99
Ezreal,Smolder,3112,1543,1569,49.58
Ezreal,Chogath,4883,2199,2684,45.03
Ezreal,Naafiri,1377,648,729,47.06
Ezreal,Aatrox,4277,2101,2176,49.12
Ezreal,Aphelios,2558,1284,1274,50.2
Ezreal,Alistar,1871,973,898,52
Ezreal,Shyvana,1029,467,562,45.38
Ezreal,Rumble,1481,780,701,52.67
Ezreal,Hecarim,1748,848,900,48.51
Ezreal,Samira,3108,1574,1534,50.64
Ezreal,Bard,1402,685,717,48.86
Ezreal,Illaoi,1839,890,949,48.4
Ezreal,Draven,2229,1167,1062,52.36
Ezreal,Malphite,4478,2240,2238,50.02
Ezreal,Taliyah,1166,582,584,49.91
Ezreal,Quinn,1527,712,815,46.63
Ezreal,Renata,792,373,419,47.1
Ezreal,Trundle,2253,1028,1225,45.63
Ezreal,JarvanIV,2500,1152,1348,46.08
Ezreal,Ahri,5853,2852,3001,48.73
Ezreal,Sejuani,1934,941,993,48.66
Ezreal,Corki,1897,979,918,51.61
Ezreal,Ivern,781,387,394,49.55
Ezreal,Zilean,1389,681,708,49.03
Ezreal,Lissandra,1532,717,815,46.8
Ezreal,Gangplank,2203,1085,1118,49.25
Ezreal,TwistedFate,1626,833,793,51.23
Ezreal,Viktor,4184,2026,2158,48.42
Ezreal,Taric,860,397,463,46.16
Rell,Yone,1773,910,863,51.33
Rell,Darius,1905,999,906,52.44
Rell,Yasuo,1923,975,948,50.7
Rell,Jhin,1939,932,1007,48.07
Rell,Lux,2384,1162,1222,48.74
Rell,Ryze,369,194,175,52.57
Rell,Warwick,1556,795,761,51.09
Rell,Morgana,1185,555,630,46.84
Rell,Xayah,633,260,373,41.07
Rell,Veigar,1033,474,559,45.89
Rell,Poppy,715,343,372,47.97
Rell,Katarina,794,446,348,56.17
Rell,Twitch,792,445,347,56.19
Rell,Teemo,1213,558,655,46
Rell,Shaco,864,460,404,53.24
Rell,Leblanc,482,245,237,50.83
Rell,Ezreal,2353,1251,1102,53.17
Rell,Thresh,1590,814,776,51.19
Rell,FiddleSticks,484,256,228,52.89
Rell,Syndra,664,298,366,44.88
Rell,Kalista,265,133,132,50.19
Rell,Mel,2227,1131,1096,50.79
Rell,Singed,334,146,188,43.71
Rell,Pyke,920,497,423,54.02
Rell,Volibear,1203,659,544,54.78
Rell,Lillia,654,346,308,52.91
Rell,Vladimir,658,328,330,49.85
Rell,Jinx,2393,1104,1289,46.13
Rell,Lulu,1098,585,513,53.28
Rell,Yorick,964,386,578,40.04
Rell,Gragas,649,388,261,59.78
Rell,Zac,561,271,290,48.31
Rell,Amumu,1090,505,585,46.33
Rell,Chogath,1171,555,616,47.4
Rell,Kennen,282,143,139,50.71
Rell,Rammus,279,137,142,49.1
Rell,Caitlyn,2657,1353,1304,50.92
Rell,Zeri,437,221,216,50.57
Rell,Aatrox,1057,533,524,50.43
Rell,Belveth,279,139,140,49.82
Rell,Hwei,698,391,307,56.02
Rell,TahmKench,1024,542,482,52.93
Rell,Nasus,637,291,346,45.68
Rell,Udyr,356,189,167,53.09
Rell,Ashe,1967,1026,941,52.16
Rell,Alistar,628,318,310,50.64
Rell,Olaf,240,124,116,51.67
Rell,Mordekaiser,1247,588,659,47.15
Rell,Ornn,462,234,228,50.65
Rell,Vi,1011,517,494,51.14
Rell,Anivia,345,149,196,43.19
Rell,Yuumi,960,515,445,53.65
Rell,Ekko,828,408,420,49.28
Rell,Nami,1001,508,493,50.75
Rell,Jayce,451,230,221,51
Rell,DrMundo,534,286,248,53.56
Rell,TwistedFate,367,221,146,60.22
Rell,Samira,851,454,397,53.35
Rell,Seraphine,778,414,364,53.21
Rell,MasterYi,1057,544,513,51.47
Rell,Urgot,512,264,248,51.56
Rell,Xerath,760,368,392,48.42
Rell,Tristana,1047,541,506,51.67
Rell,Garen,1479,750,729,50.71
Rell,Briar,683,349,334,51.1
Rell,Zed,1002,485,517,48.4
Rell,Corki,507,260,247,51.28
Rell,Pantheon,1686,857,829,50.83
Rell,Diana,1479,762,717,51.52
Rell,MissFortune,2081,977,1104,46.95
Rell,Hecarim,406,197,209,48.52
Rell,Orianna,525,242,283,46.1
Rell,Zyra,870,395,475,45.4
Rell,Karthus,331,158,173,47.73
Rell,Kassadin,241,141,100,58.51
Rell,Nunu,650,314,336,48.31
Rell,Kaisa,1574,802,772,50.95
Rell,Jax,921,438,483,47.56
Rell,RekSai,130,54,76,41.54
Rell,Brand,679,330,349,48.6
Rell,Galio,828,387,441,46.74
Rell,Viego,1411,764,647,54.15
Rell,Rakan,495,251,244,50.71
Rell,Ahri,1424,729,695,51.19
Rell,Fiora,380,208,172,54.74
Rell,LeeSin,1369,675,694,49.31
Rell,Milio,586,283,303,48.29
Rell,Kindred,438,232,206,52.97
Rell,Sett,1671,812,859,48.59
Rell,Draven,508,266,242,52.36
Rell,Kayn,1435,709,726,49.41
Rell,Akali,1086,578,508,53.22
Rell,Sivir,490,246,244,50.2
Rell,Skarner,376,200,176,53.19
Rell,Zilean,337,159,178,47.18
Rell,Tryndamere,513,284,229,55.36
Rell,Bard,290,151,139,52.07
Rell,Leona,1063,542,521,50.99
Rell,JarvanIV,570,269,301,47.19
Rell,Lucian,666,326,340,48.95
Rell,Soraka,563,291,272,51.69
Rell,Riven,526,284,242,53.99
Rell,Karma,1057,508,549,48.06
Rell,Sylas,1296,663,633,51.16
Rell,Talon,593,334,259,56.32
Rell,Irelia,870,433,437,49.77
Rell,Fizz,458,208,250,45.41
Rell,Graves,683,315,368,46.12
Rell,Neeko,515,286,229,55.53
Rell,Gnar,417,217,200,52.04
Rell,Evelynn,407,205,202,50.37
Rell,Heimerdinger,461,240,221,52.06
Rell,Kayle,603,263,340,43.62
Rell,Swain,1024,440,584,42.97
Rell,Aphelios,656,314,342,47.87
Rell,Blitzcrank,811,410,401,50.55
Rell,Trundle,507,246,261,48.52
Rell,Elise,744,402,342,54.03
Rell,Malzahar,1087,543,544,49.95
Rell,Cassiopeia,373,191,182,51.21
Rell,Ambessa,615,348,267,56.59
Rell,Qiyana,271,155,116,57.2
Rell,Akshan,341,149,192,43.7
Rell,KSante,603,311,292,51.58
Rell,Aurora,857,440,417,51.34
Rell,Smolder,747,339,408,45.38
Rell,Lissandra,363,152,211,41.87
Rell,Senna,750,341,409,45.47
Rell,Renata,265,122,143,46.04
Rell,Nidalee,318,193,125,60.69
Rell,Annie,326,163,163,50
Rell,Sona,300,151,149,50.33
Rell,Gangplank,428,168,260,39.25
Rell,Shen,720,406,314,56.39
Rell,Viktor,850,395,455,46.47
Rell,Khazix,565,246,319,43.54
Rell,Janna,529,242,287,45.75
Rell,Vayne,1236,652,584,52.75
Rell,Nocturne,1218,557,661,45.73
Rell,Malphite,962,505,457,52.49
Rell,Gwen,565,287,278,50.8
Rell,Renekton,497,203,294,40.85
Rell,Illaoi,429,186,243,43.36
Rell,Rengar,358,173,185,48.32
Rell,Varus,845,456,389,53.96
Rell,Velkoz,642,297,345,46.26
Rell,Nilah,441,238,203,53.97
Rell,Braum,695,352,343,50.65
Rell,Maokai,519,257,262,49.52
Rell,Ivern,208,103,105,49.52
Rell,Nautilus,1331,675,656,50.71
Rell,Zoe,426,232,194,54.46
Rell,XinZhao,592,292,300,49.32
Rell,MonkeyKing,628,293,335,46.66
Rell,Camille,392,222,170,56.63
Rell,Taliyah,338,174,164,51.48
Rell,Ziggs,386,187,199,48.45
Rell,Vex,594,285,309,47.98
Rell,Sejuani,452,229,223,50.66
Rell,AurelionSol,511,220,291,43.05
Rell,Sion,806,374,432,46.4
Rell,Naafiri,297,113,184,38.05
Rell,Quinn,387,201,186,51.94
Rell,Shyvana,252,108,144,42.86
Rell,Taric,205,83,122,40.49
Rell,KogMaw,328,142,186,43.29
Rell,Azir,414,232,182,56.04
Rell,Kled,179,98,81,54.75
Rell,Rumble,303,159,144,52.48
Sejuani,Singed,258,136,122,52.71
Sejuani,Shaco,631,331,300,52.46
Sejuani,Zed,831,434,397,52.23
Sejuani,Hwei,586,312,274,53.24
Sejuani,Lux,1938,962,976,49.64
Sejuani,Naafiri,241,97,144,40.25
Sejuani,Briar,562,258,304,45.91
Sejuani,Yone,1400,776,624,55.43
Sejuani,MissFortune,1838,907,931,49.35
Sejuani,Senna,558,255,303,45.7
Sejuani,Volibear,1016,431,585,42.42
Sejuani,Lillia,557,243,314,43.63
Sejuani,Vladimir,594,256,338,43.1
Sejuani,Jinx,1990,1001,989,50.3
Sejuani,Lulu,999,482,517,48.25
Sejuani,Riven,367,173,194,47.14
Sejuani,Syndra,493,254,239,51.52
Sejuani,Pyke,740,404,336,54.59
Sejuani,Aurora,757,422,335,55.75
Sejuani,FiddleSticks,416,213,203,51.2
Sejuani,Yasuo,1486,704,782,47.38
Sejuani,Jhin,1551,755,796,48.68
Sejuani,Vex,504,253,251,50.2
Sejuani,Kayn,1244,576,668,46.3
Sejuani,Khazix,427,236,191,55.27
Sejuani,Seraphine,676,340,336,50.3
Sejuani,Sett,1299,612,687,47.11
Sejuani,Pantheon,1239,662,577,53.43
Sejuani,Ashe,1589,833,756,52.42
Sejuani,Braum,479,236,243,49.27
Sejuani,Nasus,560,265,295,47.32
Sejuani,Smolder,529,213,316,40.26
Sejuani,Galio,612,328,284,53.59
Sejuani,Ahri,1156,609,547,52.68
Sejuani,Tristana,719,380,339,52.85
Sejuani,Alistar,406,188,218,46.31
Sejuani,Amumu,940,435,505,46.28
Sejuani,Velkoz,486,248,238,51.03
Sejuani,Yorick,798,380,418,47.62
Sejuani,Rengar,319,193,126,60.5
Sejuani,Neeko,381,205,176,53.81
Sejuani,Gwen,509,245,264,48.13
Sejuani,Katarina,667,358,309,53.67
Sejuani,Elise,631,336,295,53.25
Sejuani,Teemo,984,469,515,47.66
Sejuani,Vi,820,408,412,49.76
Sejuani,Bard,292,126,166,43.15
Sejuani,Caitlyn,2174,1036,1138,47.65
Sejuani,Mordekaiser,1060,501,559,47.26
Sejuani,Aphelios,476,228,248,47.9
Sejuani,Zilean,249,144,105,57.83
Sejuani,Morgana,1032,540,492,52.33
Sejuani,Viego,1056,552,504,52.27
Sejuani,Samira,654,313,341,47.86
Sejuani,Leona,664,325,339,48.95
Sejuani,Aatrox,772,354,418,45.85
Sejuani,LeeSin,1346,711,635,52.82
Sejuani,Akshan,269,115,154,42.75
Sejuani,Zyra,647,325,322,50.23
Sejuani,Trundle,538,261,277,48.51
Sejuani,Rammus,257,122,135,47.47
Sejuani,Fizz,431,233,198,54.06
Sejuani,Sivir,415,195,220,46.99
Sejuani,Lucian,591,343,248,58.04
Sejuani,Darius,1549,775,774,50.03
Sejuani,Sona,240,126,114,52.5
Sejuani,Graves,514,288,226,56.03
Sejuani,Ziggs,304,157,147,51.64
Sejuani,Nocturne,930,422,508,45.38
Sejuani,Ekko,657,350,307,53.27
Sejuani,Irelia,694,374,320,53.89
Sejuani,Taric,184,78,106,42.39
Sejuani,Sylas,1220,612,608,50.16
Sejuani,Warwick,1199,597,602,49.79
Sejuani,Camille,309,170,139,55.02
Sejuani,Viktor,726,423,303,58.26
Sejuani,Mel,1553,854,699,54.99
Sejuani,Ambessa,533,316,217,59.29
Sejuani,Garen,1186,572,614,48.23
Sejuani,Soraka,471,186,285,39.49
Sejuani,Renekton,460,255,205,55.43
Sejuani,Thresh,1266,664,602,52.45
Sejuani,Shen,559,291,268,52.06
Sejuani,Gangplank,414,245,169,59.18
Sejuani,Gragas,510,266,244,52.16
Sejuani,Udyr,267,150,117,56.18
Sejuani,Ryze,229,116,113,50.66
Sejuani,Akali,810,415,395,51.23
Sejuani,Blitzcrank,605,329,276,54.38
Sejuani,Kindred,361,227,134,62.88
Sejuani,Draven,405,197,208,48.64
Sejuani,MasterYi,863,433,430,50.17
Sejuani,Nautilus,1009,548,461,54.31
Sejuani,Vayne,1108,573,535,51.71
Sejuani,Kennen,210,107,103,50.95
Sejuani,Varus,736,446,290,60.6
Sejuani,Yuumi,686,392,294,57.14
Sejuani,Gnar,393,220,173,55.98
Sejuani,Zeri,329,183,146,55.62
Sejuani,XinZhao,572,308,264,53.85
Sejuani,Veigar,807,386,421,47.83
Sejuani,Karma,898,424,474,47.22
Sejuani,Kled,152,91,61,59.87
Sejuani,Ezreal,1934,993,941,51.34
Sejuani,Diana,1169,561,608,47.99
Sejuani,TahmKench,673,342,331,50.82
Sejuani,Zoe,346,184,162,53.18
Sejuani,Twitch,638,319,319,50
Sejuani,Cassiopeia,293,149,144,50.85
Sejuani,Nilah,349,154,195,44.13
Sejuani,Nunu,535,267,268,49.91
Sejuani,Milio,548,246,302,44.89
Sejuani,Swain,815,355,460,43.56
Sejuani,Illaoi,345,187,158,54.2
Sejuani,Leblanc,455,236,219,51.87
Sejuani,Brand,544,259,285,47.61
Sejuani,Malphite,757,363,394,47.95
Sejuani,Kaisa,1336,732,604,54.79
Sejuani,Xerath,630,331,299,52.54
Sejuani,Jax,701,374,327,53.35
Sejuani,Chogath,984,499,485,50.71
Sejuani,RekSai,105,62,43,59.05
Sejuani,Malzahar,847,368,479,43.45
Sejuani,JarvanIV,523,253,270,48.37
Sejuani,Shyvana,161,67,94,41.61
Sejuani,Lissandra,269,165,104,61.34
Sejuani,Sion,631,324,307,51.35
Sejuani,DrMundo,506,270,236,53.36
Sejuani,Rakan,338,170,168,50.3
Sejuani,KogMaw,324,155,169,47.84
Sejuani,Corki,351,174,177,49.57
Sejuani,Tryndamere,468,232,236,49.57
Sejuani,KSante,456,249,207,54.61
Sejuani,Xayah,454,247,207,54.41
Sejuani,Quinn,239,123,116,51.46
Sejuani,Skarner,321,191,130,59.5
Sejuani,Qiyana,235,103,132,43.83
Sejuani,Olaf,169,85,84,50.3
Sejuani,Poppy,504,258,246,51.19
Sejuani,Annie,298,151,147,50.67
Sejuani,Kayle,479,233,246,48.64
Sejuani,Talon,482,286,196,59.34
Sejuani,MonkeyKing,541,245,296,45.29
Sejuani,Orianna,434,239,195,55.07
Sejuani,Jayce,411,240,171,58.39
Sejuani,Taliyah,223,97,126,43.5
Sejuani,Heimerdinger,334,160,174,47.9
Sejuani,Fiora,304,155,149,50.99
Sejuani,Nami,801,411,390,51.31
Sejuani,Ornn,307,139,168,45.28
Sejuani,Janna,245,135,110,55.1
Sejuani,Evelynn,339,172,167,50.74
Sejuani,Karthus,200,92,108,46
Sejuani,Kassadin,146,80,66,54.79
Sejuani,Anivia,276,160,116,57.97
Sejuani,AurelionSol,314,149,165,47.45
Sejuani,Rell,452,223,229,49.34
Sejuani,Hecarim,309,161,148,52.1
Sejuani,Kalista,259,141,118,54.44
Sejuani,Rumble,171,92,79,53.8
Sejuani,Zac,422,220,202,52.13
Sejuani,Belveth,134,53,81,39.55
Sejuani,Ivern,143,85,58,59.44
Sejuani,TwistedFate,275,147,128,53.45
Sejuani,Urgot,391,167,224,42.71
Sejuani,Renata,179,86,93,48.04
Sejuani,Azir,319,130,189,40.75
Sejuani,Maokai,395,186,209,47.09
Sejuani,Nidalee,205,94,111,45.85
Pantheon,Singed,738,350,388,47.43
Pantheon,Shaco,2889,1465,1424,50.71
Pantheon,Zed,3645,1949,1696,53.47
Pantheon,Hwei,2178,1055,1123,48.44
Pantheon,Lux,8056,4052,4004,50.3
Pantheon,Darius,5959,3032,2927,50.88
Pantheon,Zac,1459,775,684,53.12
Pantheon,Poppy,2128,1031,1097,48.45
Pantheon,Twitch,2465,1331,1134,54
Pantheon,Maokai,1473,721,752,48.95
Pantheon,Graves,1834,916,918,49.95
Pantheon,Ahri,4245,2142,2103,50.46
Pantheon,Nilah,1313,606,707,46.15
Pantheon,Malphite,3273,1526,1747,46.62
Pantheon,Garen,4961,2517,2444,50.74
Pantheon,Briar,2503,1190,1313,47.54
Pantheon,Caitlyn,8056,4006,4050,49.73
Pantheon,Morgana,3880,2015,1865,51.93
Pantheon,Aatrox,2858,1500,1358,52.48
Pantheon,Brand,2392,1137,1255,47.53
Pantheon,Irelia,2603,1331,1272,51.13
Pantheon,Milio,1850,902,948,48.76
Pantheon,Kayn,4846,2303,2543,47.52
Pantheon,Katarina,2581,1311,1270,50.79
Pantheon,Vayne,3772,1821,1951,48.28
Pantheon,DrMundo,1918,877,1041,45.72
Pantheon,Gangplank,1451,737,714,50.79
Pantheon,Kaisa,5037,2567,2470,50.96
Pantheon,Galio,2468,1125,1343,45.58
Pantheon,Cassiopeia,984,493,491,50.1
Pantheon,Sett,5099,2446,2653,47.97
Pantheon,Talon,1951,1006,945,51.56
Pantheon,FiddleSticks,1617,817,800,50.53
Pantheon,Ashe,5880,2899,2981,49.3
Pantheon,Blitzcrank,2660,1401,1259,52.67
Pantheon,Lillia,1904,1027,877,53.94
Pantheon,Sylas,4231,2325,1906,54.95
Pantheon,TahmKench,2776,1390,1386,50.07
Pantheon,Jax,2856,1415,1441,49.54
Pantheon,Heimerdinger,1489,665,824,44.66
Pantheon,Soraka,1778,757,1021,42.58
Pantheon,Elise,2296,1088,1208,47.39
Pantheon,Olaf,731,330,401,45.14
Pantheon,Hecarim,1164,572,592,49.14
Pantheon,Veigar,3188,1460,1728,45.8
Pantheon,Tristana,2940,1503,1437,51.12
Pantheon,Braum,1817,932,885,51.29
Pantheon,Ryze,1033,495,538,47.92
Pantheon,Lulu,3784,1838,1946,48.57
Pantheon,Gnar,1425,747,678,52.42
Pantheon,Warwick,4548,2168,2380,47.67
Pantheon,Malzahar,3003,1331,1672,44.32
Pantheon,XinZhao,1989,966,1023,48.57
Pantheon,Akali,3365,1672,1693,49.69
Pantheon,LeeSin,4834,2528,2306,52.3
Pantheon,Evelynn,1273,671,602,52.71
Pantheon,Ezreal,7511,3805,3706,50.66
Pantheon,Jinx,8108,3713,4395,45.79
Pantheon,Samira,2442,1309,1133,53.6
Pantheon,Ekko,2809,1410,1399,50.2
Pantheon,Chogath,3771,1737,2034,46.06
Pantheon,Yorick,2999,1423,1576,47.45
Pantheon,Sion,2380,1094,1286,45.97
Pantheon,MasterYi,3620,1734,1886,47.9
Pantheon,AurelionSol,1181,569,612,48.18
Pantheon,Seraphine,2787,1449,1338,51.99
Pantheon,Mordekaiser,4193,1933,2260,46.1
Pantheon,Sejuani,1239,577,662,46.57
Pantheon,Yone,6637,3374,3263,50.84
Pantheon,MissFortune,7012,3452,3560,49.23
Pantheon,Swain,3246,1500,1746,46.21
Pantheon,Yasuo,6565,3383,3182,51.53
Pantheon,Corki,1216,630,586,51.81
Pantheon,Karma,3342,1646,1696,49.25
Pantheon,Neeko,1812,884,928,48.79
Pantheon,Yuumi,2646,1401,1245,52.95
Pantheon,Rengar,1123,670,453,59.66
Pantheon,Jhin,6047,3116,2931,51.53
Pantheon,Kindred,1552,851,701,54.83
Pantheon,Alistar,1301,664,637,51.04
Pantheon,Volibear,3564,1752,1812,49.16
Pantheon,Velkoz,1902,870,1032,45.74
Pantheon,Varus,2838,1520,1318,53.56
Pantheon,Aurora,2677,1386,1291,51.77
Pantheon,Trundle,1673,854,819,51.05
Pantheon,Mel,6654,3534,3120,53.11
Pantheon,Illaoi,1512,742,770,49.07
Pantheon,Khazix,1727,867,860,50.2
Pantheon,Leona,2702,1289,1413,47.71
Pantheon,Draven,1657,793,864,47.86
Pantheon,Nautilus,3543,1818,1725,51.31
Pantheon,Viego,4542,2215,2327,48.77
Pantheon,KSante,1666,886,780,53.18
Pantheon,Kalista,980,555,425,56.63
Pantheon,Ivern,442,217,225,49.1
Pantheon,Quinn,1108,543,565,49.01
Pantheon,Nasus,2251,1143,1108,50.78
Pantheon,Kled,546,298,248,54.58
Pantheon,Taliyah,857,417,440,48.66
Pantheon,Sona,1017,471,546,46.31
Pantheon,RekSai,428,194,234,45.33
Pantheon,Zoe,1235,653,582,52.87
Pantheon,Nunu,2137,1102,1035,51.57
Pantheon,Thresh,4320,2105,2215,48.73
Pantheon,Shen,1942,946,996,48.71
Pantheon,Riven,1320,785,535,59.47
Pantheon,Rell,1686,829,857,49.17
Pantheon,Vladimir,2133,1130,1003,52.98
Pantheon,Kayle,2221,1241,980,55.88
Pantheon,Azir,1239,628,611,50.69
Pantheon,Xayah,1727,878,849,50.84
Pantheon,Orianna,1539,672,867,43.66
Pantheon,Ambessa,2079,1052,1027,50.6
Pantheon,Pyke,3321,1777,1544,53.51
Pantheon,Anivia,920,389,531,42.28
Pantheon,Nocturne,3768,1731,2037,45.94
Pantheon,Udyr,1229,686,543,55.82
Pantheon,Sivir,1753,861,892,49.12
Pantheon,Skarner,938,496,442,52.88
Pantheon,Gwen,1635,808,827,49.42
Pantheon,Rammus,1076,519,557,48.23
Pantheon,Viktor,2679,1415,1264,52.82
Pantheon,Fiora,1297,665,632,51.27
Pantheon,Vi,3035,1486,1549,48.96
Pantheon,TwistedFate,1140,600,540,52.63
Pantheon,Zilean,988,500,488,50.61
Pantheon,Ziggs,1193,611,582,51.22
Pantheon,Ornn,1444,692,752,47.92
Pantheon,Aphelios,1730,825,905,47.69
Pantheon,Lucian,2148,1136,1012,52.89
Pantheon,Camille,1172,625,547,53.33
Pantheon,MonkeyKing,2104,1014,1090,48.19
Pantheon,Rakan,1527,821,706,53.77
Pantheon,Renekton,1667,793,874,47.57
Pantheon,Zeri,1239,632,607,51.01
Pantheon,Kassadin,678,340,338,50.15
Pantheon,Leblanc,1825,969,856,53.1
Pantheon,Fizz,1742,907,835,52.07
Pantheon,Renata,545,248,297,45.5
Pantheon,Zyra,2726,1262,1464,46.29
Pantheon,Nami,2780,1322,1458,47.55
Pantheon,Diana,4973,2372,2601,47.7
Pantheon,Annie,957,436,521,45.56
Pantheon,Xerath,2513,1227,1286,48.83
Pantheon,Lissandra,970,457,513,47.11
Pantheon,Senna,2353,1225,1128,52.06
Pantheon,Naafiri,1086,544,542,50.09
Pantheon,Nidalee,1012,516,496,50.99
Pantheon,Teemo,3821,1860,1961,48.68
Pantheon,Qiyana,846,424,422,50.12
Pantheon,Jayce,1444,772,672,53.46
Pantheon,Gragas,2029,983,1046,48.45
Pantheon,Taric,724,321,403,44.34
Pantheon,Karthus,901,438,463,48.61
Pantheon,Smolder,2193,1176,1017,53.63
Pantheon,Tryndamere,1721,882,839,51.25
Pantheon,Amumu,3207,1442,1765,44.96
Pantheon,Rumble,851,443,408,52.06
Pantheon,Shyvana,775,357,418,46.06
Pantheon,KogMaw,934,443,491,47.43
Pantheon,Belveth,795,424,371,53.33
Pantheon,Syndra,1961,956,1005,48.75
Pantheon,Vex,1776,864,912,48.65
Pantheon,JarvanIV,1736,803,933,46.26
Pantheon,Urgot,1668,765,903,45.86
Pantheon,Janna,1066,544,522,51.03
Pantheon,Bard,987,502,485,50.86
Pantheon,Akshan,1140,578,562,50.7
Pantheon,Kennen,918,490,428,53.38
Singed,Mordekaiser,708,388,320,54.8
Singed,Sejuani,258,122,136,47.29
Singed,Yasuo,1030,527,503,51.17
Singed,Lucian,376,208,168,55.32
Singed,Pantheon,738,388,350,52.57
Singed,Irelia,429,234,195,54.55
Singed,Kayn,821,397,424,48.36
Singed,Katarina,452,270,182,59.73
Singed,Vayne,713,350,363,49.09
Singed,DrMundo,382,186,196,48.69
Singed,Heimerdinger,305,168,137,55.08
Singed,Talon,287,163,124,56.79
Singed,Ahri,609,347,262,56.98
Singed,Kalista,175,109,66,62.29
Singed,Brand,390,242,148,62.05
Singed,Sett,770,378,392,49.09
Singed,Vladimir,310,159,151,51.29
Singed,Kindred,232,128,104,55.17
Singed,Aphelios,311,150,161,48.23
Singed,Pyke,425,235,190,55.29
Singed,Darius,879,446,433,50.74
Singed,Poppy,342,167,175,48.83
Singed,Sylas,643,312,331,48.52
Singed,Rell,334,188,146,56.29
Singed,Kayle,455,189,266,41.54
Singed,Akali,546,320,226,58.61
Singed,Soraka,328,171,157,52.13
Singed,Swain,568,311,257,54.75
Singed,Jax,501,237,264,47.31
Singed,Morgana,654,308,346,47.09
Singed,Caitlyn,1413,740,673,52.37
Singed,Tryndamere,357,207,150,57.98
Singed,Nasus,532,239,293,44.92
Singed,Galio,478,244,234,51.05
Singed,Smolder,377,228,149,60.48
Singed,JarvanIV,298,151,147,50.67
Singed,Urgot,349,170,179,48.71
Singed,Ekko,549,254,295,46.27
Singed,Xerath,476,275,201,57.77
Singed,Warwick,763,395,368,51.77
Singed,Aurora,358,219,139,61.17
Singed,Samira,424,240,184,56.6
Singed,Neeko,260,143,117,55
Singed,Nocturne,661,325,336,49.17
Singed,Orianna,265,125,140,47.17
Singed,Ezreal,1073,593,480,55.27
Singed,Bard,171,105,66,61.4
Singed,Maokai,216,115,101,53.24
Singed,Sion,558,334,224,59.86
Singed,Lux,1324,663,661,50.08
Singed,Amumu,513,256,257,49.9
Singed,Mel,1203,646,557,53.7
Singed,Jhin,975,524,451,53.74
Singed,Yuumi,470,272,198,57.87
Singed,FiddleSticks,279,161,118,57.71
Singed,Zoe,254,161,93,63.39
Singed,Kaisa,870,441,429,50.69
Singed,Taric,110,51,59,46.36
Singed,Karma,653,312,341,47.78
Singed,Zed,578,330,248,57.09
Singed,Veigar,521,261,260,50.1
Singed,Rengar,200,83,117,41.5
Singed,Thresh,837,464,373,55.44
Singed,MasterYi,636,333,303,52.36
Singed,Gragas,328,181,147,55.18
Singed,Aatrox,546,333,213,60.99
Singed,Blitzcrank,348,206,142,59.2
Singed,LeeSin,688,373,315,54.22
Singed,MissFortune,1085,611,474,56.31
Singed,Nami,585,283,302,48.38
Singed,Zeri,246,138,108,56.1
Singed,Nunu,411,206,205,50.12
Singed,Malphite,475,272,203,57.26
Singed,Jinx,1391,676,715,48.6
Singed,Shen,444,226,218,50.9
Singed,Leblanc,292,149,143,51.03
Singed,Twitch,473,266,207,56.24
Singed,Velkoz,377,163,214,43.24
Singed,Olaf,125,82,43,65.6
Singed,Kled,123,66,57,53.66
Singed,Briar,356,183,173,51.4
Singed,Ziggs,186,113,73,60.75
Singed,Nautilus,562,290,272,51.6
Singed,Taliyah,158,91,67,57.59
Singed,Viego,712,368,344,51.69
Singed,Graves,386,234,152,60.62
Singed,AurelionSol,259,111,148,42.86
Singed,Corki,201,127,74,63.18
Singed,Nilah,254,147,107,57.87
Singed,TahmKench,481,275,206,57.17
Singed,Cassiopeia,146,53,93,36.3
Singed,Braum,323,149,174,46.13
Singed,Gangplank,271,129,142,47.6
Singed,Khazix,345,193,152,55.94
Singed,Malzahar,606,277,329,45.71
Singed,Ashe,1101,528,573,47.96
Singed,Zilean,189,102,87,53.97
Singed,Lulu,656,313,343,47.71
Singed,Yone,896,476,420,53.13
Singed,Skarner,161,118,43,73.29
Singed,Senna,421,215,206,51.07
Singed,Evelynn,204,110,94,53.92
Singed,Draven,305,170,135,55.74
Singed,Zyra,457,249,208,54.49
Singed,Udyr,229,88,141,38.43
Singed,Quinn,198,119,79,60.1
Singed,Renata,76,31,45,40.79
Singed,Fizz,279,152,127,54.48
Singed,Volibear,579,303,276,52.33
Singed,Teemo,642,358,284,55.76
Singed,Rammus,189,90,99,47.62
Singed,KSante,218,132,86,60.55
Singed,Shaco,441,278,163,63.04
Singed,Nidalee,111,73,38,65.77
Singed,Elise,353,173,180,49.01
Singed,Garen,848,408,440,48.11
Singed,Qiyana,152,78,74,51.32
Singed,Viktor,446,227,219,50.9
Singed,Seraphine,487,291,196,59.75
Singed,Riven,260,163,97,62.69
Singed,Lillia,342,175,167,51.17
Singed,Akshan,180,106,74,58.89
Singed,Varus,494,274,220,55.47
Singed,Rakan,230,121,109,52.61
Singed,Ambessa,355,182,173,51.27
Singed,Renekton,179,105,74,58.66
Singed,Zac,230,127,103,55.22
Singed,Alistar,235,123,112,52.34
Singed,Syndra,330,157,173,47.58
Singed,Jayce,274,148,126,54.01
Singed,Illaoi,255,137,118,53.73
Singed,Vex,300,169,131,56.33
Singed,Camille,191,97,94,50.79
Singed,Karthus,151,81,70,53.64
Singed,Diana,750,345,405,46
Singed,Chogath,633,325,308,51.34
Singed,Naafiri,220,129,91,58.64
Singed,Kennen,137,73,64,53.28
Singed,Vi,462,264,198,57.14
Singed,Xayah,296,176,120,59.46
Singed,Yorick,510,219,291,42.94
Singed,XinZhao,299,167,132,55.85
Singed,Kassadin,150,75,75,50
Singed,Tristana,588,290,298,49.32
Singed,Gnar,227,139,88,61.23
Singed,Milio,389,208,181,53.47
Singed,Belveth,150,67,83,44.67
Singed,Hecarim,246,135,111,54.88
Singed,Sivir,287,147,140,51.22
Singed,Hwei,373,187,186,50.13
Singed,Annie,166,80,86,48.19
Singed,TwistedFate,159,104,55,65.41
Singed,Janna,174,78,96,44.83
Singed,Ryze,196,89,107,45.41
Singed,Rumble,134,97,37,72.39
Singed,Trundle,281,134,147,47.69
Singed,MonkeyKing,311,183,128,58.84
Singed,KogMaw,114,38,76,33.33
Singed,Fiora,185,78,107,42.16
Singed,Ornn,230,122,108,53.04
Singed,Gwen,299,191,108,63.88
Singed,Ivern,95,25,70,26.32
Singed,Anivia,190,81,109,42.63
Singed,Azir,185,125,60,67.57
Singed,RekSai,90,43,47,47.78
Singed,Leona,387,211,176,54.52
Singed,Sona,147,71,76,48.3
Singed,Lissandra,146,67,79,45.89
Singed,Shyvana,125,76,49,60.8
Shaco,Mordekaiser,2526,1158,1368,45.84
Shaco,Sejuani,631,300,331,47.54
Shaco,Yasuo,3594,1705,1889,47.44
Shaco,Lucian,1108,585,523,52.8
Shaco,Pantheon,2889,1424,1465,49.29
Shaco,Renekton,868,433,435,49.88
Shaco,Kayn,2825,1332,1493,47.15
Shaco,Katarina,1596,804,792,50.38
Shaco,Draven,1002,479,523,47.8
Shaco,Yuumi,1534,737,797,48.04
Shaco,Khazix,1042,534,508,51.25
Shaco,Mel,3890,1912,1978,49.15
Shaco,Jhin,3741,1836,1905,49.08
Shaco,Lux,5010,2459,2551,49.08
Shaco,Heimerdinger,982,441,541,44.91
Shaco,Warwick,2883,1382,1501,47.94
Shaco,Neeko,941,441,500,46.87
Shaco,Leona,1456,810,646,55.63
Shaco,Fiora,742,380,362,51.21
Shaco,MasterYi,2172,1050,1122,48.34
Shaco,Karma,1963,966,997,49.21
Shaco,Irelia,1567,746,821,47.61
Shaco,Galio,1427,677,750,47.44
Shaco,Sivir,1048,529,519,50.48
Shaco,Rell,864,404,460,46.76
Shaco,Yorick,1869,820,1049,43.87
Shaco,Viego,2516,1248,1268,49.6
Shaco,Malphite,1771,864,907,48.79
Shaco,Kaisa,2857,1455,1402,50.93
Shaco,Briar,1448,719,729,49.65
Shaco,Zed,2091,1050,1041,50.22
Shaco,Jinx,4498,2085,2413,46.35
Shaco,Lulu,2065,1061,1004,51.38
Shaco,Teemo,2412,1102,1310,45.69
Shaco,Gragas,1098,647,451,58.93
Shaco,Qiyana,493,272,221,55.17
Shaco,Caitlyn,5027,2362,2665,46.99
Shaco,Soraka,1149,530,619,46.13
Shaco,Jayce,847,430,417,50.77
Shaco,Amumu,1851,791,1060,42.73
Shaco,Ashe,3479,1770,1709,50.88
Shaco,Milio,1087,499,588,45.91
Shaco,Sett,2933,1506,1427,51.35
Shaco,Ivern,285,168,117,58.95
Shaco,Senna,1501,718,783,47.83
Shaco,Jax,1586,814,772,51.32
Shaco,Diana,2858,1371,1487,47.97
Shaco,Ahri,2482,1343,1139,54.11
Shaco,Aphelios,995,514,481,51.66
Shaco,Illaoi,940,486,454,51.7
Shaco,Velkoz,1176,534,642,45.41
Shaco,Veigar,1972,902,1070,45.74
Shaco,Ekko,1808,876,932,48.45
Shaco,Kassadin,440,168,272,38.18
Shaco,TahmKench,1443,758,685,52.53
Shaco,Ambessa,1014,502,512,49.51
Shaco,LeeSin,2585,1286,1299,49.75
Shaco,Malzahar,1926,875,1051,45.43
Shaco,MissFortune,3965,1945,2020,49.05
Shaco,Blitzcrank,1349,666,683,49.37
Shaco,Volibear,2036,940,1096,46.17
Shaco,Nocturne,2357,1125,1232,47.73
Shaco,Xerath,1406,729,677,51.85
Shaco,Ezreal,4049,1966,2083,48.56
Shaco,Gangplank,878,414,464,47.15
Shaco,Yone,3508,1714,1794,48.86
Shaco,Twitch,1577,796,781,50.48
Shaco,Swain,1913,879,1034,45.95
Shaco,Rammus,398,214,184,53.77
Shaco,Chogath,2153,967,1186,44.91
Shaco,Nautilus,1895,972,923,51.29
Shaco,Cassiopeia,524,264,260,50.38
Shaco,Thresh,2297,1068,1229,46.5
Shaco,Aurora,1323,671,652,50.72
Shaco,Aatrox,1657,823,834,49.67
Shaco,Camille,607,292,315,48.11
Shaco,Azir,595,279,316,46.89
Shaco,Braum,892,412,480,46.19
Shaco,DrMundo,1075,482,593,44.84
Shaco,Naafiri,634,284,350,44.79
Shaco,Morgana,2436,1132,1304,46.47
Shaco,Sion,1407,587,820,41.72
Shaco,Kled,331,188,143,56.8
Shaco,Vi,1659,754,905,45.45
Shaco,Zeri,775,369,406,47.61
Shaco,Brand,1375,659,716,47.93
Shaco,Vladimir,1132,565,567,49.91
Shaco,Kindred,986,515,471,52.23
Shaco,Seraphine,1604,815,789,50.81
Shaco,Sona,658,310,348,47.11
Shaco,Sylas,2041,1036,1005,50.76
Shaco,Nilah,802,374,428,46.63
Shaco,Rumble,523,268,255,51.24
Shaco,KSante,955,477,478,49.95
Shaco,Olaf,431,227,204,52.67
Shaco,Darius,3395,1676,1719,49.37
Shaco,Vayne,2177,1058,1119,48.6
Shaco,Talon,1232,627,605,50.89
Shaco,Taliyah,410,209,201,50.98
Shaco,Zoe,718,379,339,52.79
Shaco,Udyr,754,399,355,52.92
Shaco,Leblanc,1052,569,483,54.09
Shaco,Nami,1850,875,975,47.3
Shaco,Ornn,673,332,341,49.33
Shaco,Rengar,709,374,335,52.75
Shaco,Kalista,546,292,254,53.48
Shaco,Samira,1499,748,751,49.9
Shaco,Evelynn,785,329,456,41.91
Shaco,Trundle,1071,498,573,46.5
Shaco,AurelionSol,812,355,457,43.72
Shaco,Maokai,782,405,377,51.79
Shaco,Vex,1080,543,537,50.28
Shaco,Gwen,834,440,394,52.76
Shaco,Lillia,1030,538,492,52.23
Shaco,Pyke,1641,849,792,51.74
Shaco,Fizz,1158,533,625,46.03
Shaco,Renata,341,143,198,41.94
Shaco,Karthus,675,373,302,55.26
Shaco,Tryndamere,1104,563,541,51
Shaco,Varus,1571,772,799,49.14
Shaco,FiddleSticks,991,489,502,49.34
Shaco,Ryze,612,267,345,43.63
Shaco,Janna,510,251,259,49.22
Shaco,Graves,1193,577,616,48.37
Shaco,Taric,375,166,209,44.27
Shaco,Kayle,1241,576,665,46.41
Shaco,Tristana,1829,934,895,51.07
Shaco,Garen,2691,1300,1391,48.31
Shaco,Kennen,544,263,281,48.35
Shaco,Quinn,669,320,349,47.83
Shaco,Shen,1280,611,669,47.73
Shaco,Viktor,1468,664,804,45.23
Shaco,Anivia,595,311,284,52.27
Shaco,Zyra,1716,863,853,50.29
Shaco,JarvanIV,933,410,523,43.94
Shaco,XinZhao,1058,514,544,48.58
Shaco,TwistedFate,709,398,311,56.14
Shaco,Shyvana,500,239,261,47.8
Shaco,Akshan,617,289,328,46.84
Shaco,Smolder,1324,635,689,47.96
Shaco,Nunu,1191,523,668,43.91
Shaco,Nidalee,487,316,171,64.89
Shaco,Annie,544,311,233,57.17
Shaco,RekSai,264,130,134,49.24
Shaco,Ziggs,729,392,337,53.77
Shaco,Xayah,963,503,460,52.23
Shaco,Syndra,1169,527,642,45.08
Shaco,Hwei,1213,626,587,51.61
Shaco,Akali,2071,1033,1038,49.88
Shaco,Rakan,753,378,375,50.2
Shaco,Belveth,424,198,226,46.7
Shaco,Corki,701,384,317,54.78
Shaco,Gnar,742,402,340,54.18
Shaco,Orianna,755,385,370,50.99
Shaco,Hecarim,805,409,396,50.81
Shaco,MonkeyKing,1152,563,589,48.87
Shaco,Lissandra,599,281,318,46.91
Shaco,Poppy,1101,547,554,49.68
Shaco,Bard,534,252,282,47.19
Shaco,Riven,791,421,370,53.22
Shaco,Zac,755,368,387,48.74
Shaco,Elise,1366,694,672,50.81
Shaco,Singed,441,163,278,36.96
Shaco,Urgot,884,462,422,52.26
Shaco,Alistar,735,357,378,48.57
Shaco,KogMaw,476,228,248,47.9
Shaco,Skarner,470,229,241,48.72
Shaco,Nasus,1285,607,678,47.24
Shaco,Zilean,580,257,323,44.31
Zed,Mordekaiser,2685,1233,1452,45.92
Zed,Sejuani,831,397,434,47.77
Zed,Yasuo,5091,2371,2720,46.57
Zed,Lucian,1481,800,681,54.02
Zed,Pantheon,3645,1696,1949,46.53
Zed,Chogath,2407,1107,1300,45.99
Zed,Kayn,3363,1624,1739,48.29
Zed,Gangplank,977,458,519,46.88
Zed,Ezreal,4897,2457,2440,50.17
Zed,Hwei,1393,760,633,54.56
Zed,Diana,3557,1688,1869,47.46
Zed,Yuumi,1721,859,862,49.91
Zed,Trundle,1061,474,587,44.67
Zed,MasterYi,2440,1128,1312,46.23
Zed,Veigar,2140,1173,967,54.81
Zed,Jhin,4378,2187,2191,49.95
Zed,Soraka,1167,595,572,50.99
Zed,Gnar,930,443,487,47.63
Zed,Jax,1878,960,918,51.12
Zed,Caitlyn,5782,2688,3094,46.49
Zed,Neeko,1038,489,549,47.11
Zed,Fiora,831,382,449,45.97
Zed,Mel,4210,2110,2100,50.12
Zed,Karma,2349,1131,1218,48.15
Zed,Malphite,2776,1225,1551,44.13
Zed,Evelynn,842,412,430,48.93
Zed,Irelia,2053,1050,1003,51.14
Zed,Tristana,2026,994,1032,49.06
Zed,Thresh,2946,1362,1584,46.23
Zed,Ryze,683,319,364,46.71
Zed,Warwick,2988,1402,1586,46.92
Zed,Morgana,2581,1153,1428,44.67
Zed,Xayah,1274,550,724,43.17
Zed,Vladimir,1454,692,762,47.59
Zed,Shaco,2091,1041,1050,49.78
Zed,Tryndamere,1073,488,585,45.48
Zed,Milio,1306,568,738,43.49
Zed,Heimerdinger,998,475,523,47.6
Zed,Kindred,919,444,475,48.31
Zed,Katarina,1732,873,859,50.4
Zed,Janna,719,303,416,42.14
Zed,Teemo,2709,1181,1528,43.6
Zed,Gragas,1317,714,603,54.21
Zed,Qiyana,771,391,380,50.71
Zed,Akali,2486,1238,1248,49.8
Zed,Jinx,5230,2423,2807,46.33
Zed,Leblanc,1261,632,629,50.12
Zed,Senna,1521,734,787,48.26
Zed,Amumu,2073,950,1123,45.83
Zed,Kaisa,3595,1732,1863,48.18
Zed,Seraphine,1585,773,812,48.77
Zed,Ashe,3958,1896,2062,47.9
Zed,Pyke,1946,1017,929,52.26
Zed,Darius,4015,1870,2145,46.58
Zed,Nami,2112,930,1182,44.03
Zed,Aatrox,1933,934,999,48.32
Zed,Cassiopeia,641,276,365,43.06
Zed,Yone,3902,1960,1942,50.23
Zed,Vayne,2554,1237,1317,48.43
Zed,Shyvana,424,172,252,40.57
Zed,Sylas,2924,1381,1543,47.23
Zed,Briar,1686,793,893,47.03
Zed,Kled,362,173,189,47.79
Zed,Ambessa,1454,785,669,53.99
Zed,Nilah,747,316,431,42.3
Zed,Leona,1664,819,845,49.22
Zed,Riven,1104,518,586,46.92
Zed,TwistedFate,801,362,439,45.19
Zed,Kennen,653,372,281,56.97
Zed,Ahri,2602,1229,1373,47.23
Zed,Lux,5568,2716,2852,48.78
Zed,TahmKench,1899,884,1015,46.55
Zed,MissFortune,4501,2099,2402,46.63
Zed,Blitzcrank,1569,824,745,52.52
Zed,Vex,1139,549,590,48.2
Zed,Vi,2083,959,1124,46.04
Zed,Swain,2038,963,1075,47.25
Zed,DrMundo,1178,537,641,45.59
Zed,Lillia,1202,576,626,47.92
Zed,Lissandra,1055,445,610,42.18
Zed,FiddleSticks,1065,464,601,43.57
Zed,Anivia,686,342,344,49.85
Zed,Poppy,1266,606,660,47.87
Zed,XinZhao,1395,634,761,45.45
Zed,Syndra,1369,684,685,49.96
Zed,Sett,3129,1500,1629,47.94
Zed,Rumble,530,262,268,49.43
Zed,Samira,1694,845,849,49.88
Zed,Talon,1440,726,714,50.42
Zed,Aurora,1648,896,752,54.37
Zed,Taliyah,406,218,188,53.69
Zed,Zoe,830,443,387,53.37
Zed,Twitch,1737,808,929,46.52
Zed,Viego,3054,1544,1510,50.56
Zed,Nautilus,2282,1111,1171,48.69
Zed,Urgot,886,401,485,45.26
Zed,Galio,1543,712,831,46.14
Zed,Lulu,2530,1248,1282,49.33
Zed,AurelionSol,693,344,349,49.64
Zed,Zyra,1840,824,1016,44.78
Zed,Singed,578,248,330,42.91
Zed,Orianna,811,405,406,49.94
Zed,Garen,3376,1568,1808,46.45
Zed,Malzahar,2311,1143,1168,49.46
Zed,Volibear,2446,1216,1230,49.71
Zed,Yorick,1900,784,1116,41.26
Zed,Ziggs,805,397,408,49.32
Zed,Nasus,1394,616,778,44.19
Zed,Rell,1002,517,485,51.6
Zed,LeeSin,3293,1660,1633,50.41
Zed,Camille,774,368,406,47.55
Zed,Kayle,1289,531,758,41.19
Zed,Zac,904,440,464,48.67
Zed,Braum,1135,530,605,46.7
Zed,Velkoz,1296,631,665,48.69
Zed,Ornn,888,406,482,45.72
Zed,Graves,1318,673,645,51.06
Zed,Bard,592,289,303,48.82
Zed,Gwen,940,483,457,51.38
Zed,Zeri,870,495,375,56.9
Zed,Hecarim,966,474,492,49.07
Zed,Nunu,1162,568,594,48.88
Zed,Skarner,593,330,263,55.65
Zed,Elise,1547,773,774,49.97
Zed,Renekton,1036,490,546,47.3
Zed,Aphelios,1261,562,699,44.57
Zed,Renata,418,211,207,50.48
Zed,Nocturne,2469,1182,1287,47.87
Zed,Annie,732,341,391,46.58
Zed,Udyr,829,459,370,55.37
Zed,Maokai,960,474,486,49.38
Zed,MonkeyKing,1257,530,727,42.16
Zed,Sion,1729,773,956,44.71
Zed,Rengar,796,395,401,49.62
Zed,Ekko,2387,1167,1220,48.89
Zed,Corki,804,375,429,46.64
Zed,Alistar,883,388,495,43.94
Zed,Fizz,1421,717,704,50.46
Zed,Smolder,1461,763,698,52.22
Zed,KSante,1024,517,507,50.49
Zed,Nidalee,606,311,295,51.32
Zed,Rakan,1002,446,556,44.51
Zed,Sivir,1034,555,479,53.68
Zed,Kassadin,301,158,143,52.49
Zed,Sona,632,259,373,40.98
Zed,Viktor,1629,776,853,47.64
Zed,Khazix,1176,567,609,48.21
Zed,Rammus,765,357,408,46.67
Zed,Zilean,761,350,411,45.99
Zed,Akshan,725,343,382,47.31
Zed,Ivern,446,211,235,47.31
Zed,Draven,1098,525,573,47.81
Zed,Illaoi,1013,544,469,53.7
Zed,Varus,1835,911,924,49.65
Zed,Xerath,1744,873,871,50.06
Zed,Shen,1383,691,692,49.96
Zed,Quinn,896,393,503,43.86
Zed,RekSai,300,155,145,51.67
Zed,KogMaw,559,244,315,43.65
Zed,Azir,730,411,319,56.3
Zed,Karthus,536,259,277,48.32
Zed,Brand,1536,803,733,52.28
Zed,Taric,486,227,259,46.71
Zed,Olaf,443,213,230,48.08
Zed,Naafiri,697,343,354,49.21
Zed,Jayce,1019,518,501,50.83
Zed,JarvanIV,1059,472,587,44.57
Zed,Belveth,420,196,224,46.67
Zed,Kalista,634,322,312,50.79
Zac,Fiora,398,216,182,54.27
Zac,Pantheon,1459,684,775,46.88
Zac,Katarina,720,415,305,57.64
Zac,Mel,1928,922,1006,47.82
Zac,Viktor,823,429,394,52.13
Zac,Ornn,391,199,192,50.9
Zac,Poppy,733,332,401,45.29
Zac,Yone,1660,912,748,54.94
Zac,MissFortune,1821,888,933,48.76
Zac,Brand,653,278,375,42.57
Zac,Darius,1522,724,798,47.57
Zac,Volibear,999,475,524,47.55
Zac,Chogath,1147,539,608,46.99
Zac,Ezreal,2281,1154,1127,50.59
Zac,Tryndamere,372,180,192,48.39
Zac,Kayn,1306,599,707,45.87
Zac,Aurora,694,351,343,50.58
Zac,Twitch,594,321,273,54.04
Zac,Lux,1952,963,989,49.33
Zac,Gragas,528,264,264,50
Zac,XinZhao,672,320,352,47.62
Zac,Yasuo,1717,846,871,49.27
Zac,Lucian,661,362,299,54.77
Zac,Velkoz,562,287,275,51.07
Zac,Yorick,839,414,425,49.34
Zac,Cassiopeia,303,155,148,51.16
Zac,Jhin,1710,914,796,53.45
Zac,Rell,561,290,271,51.69
Zac,Samira,686,367,319,53.5
Zac,MasterYi,757,367,390,48.48
Zac,Orianna,361,181,180,50.14
Zac,Malphite,813,397,416,48.83
Zac,Nautilus,1126,583,543,51.78
Zac,Ivern,127,58,69,45.67
Zac,Gnar,434,221,213,50.92
Zac,Seraphine,644,300,344,46.58
Zac,Irelia,710,388,322,54.65
Zac,Leona,702,361,341,51.42
Zac,Briar,655,350,305,53.44
Zac,Akali,938,485,453,51.71
Zac,Caitlyn,2492,1199,1293,48.11
Zac,Morgana,912,479,433,52.52
Zac,Sion,788,422,366,53.55
Zac,Ahri,1144,565,579,49.39
Zac,Draven,478,251,227,52.51
Zac,Kassadin,229,115,114,50.22
Zac,Renata,181,75,106,41.44
Zac,Teemo,1050,515,535,49.05
Zac,Rengar,345,201,144,58.26
Zac,Vladimir,637,336,301,52.75
Zac,Kaisa,1529,781,748,51.08
Zac,Xerath,843,426,417,50.53
Zac,Garen,1440,718,722,49.86
Zac,Warwick,1176,626,550,53.23
Zac,Xayah,606,295,311,48.68
Zac,Zed,904,464,440,51.33
Zac,Kindred,405,203,202,50.12
Zac,Diana,1447,739,708,51.07
Zac,Tristana,687,368,319,53.57
Zac,Yuumi,806,416,390,51.61
Zac,Ashe,1941,978,963,50.39
Zac,Riven,377,205,172,54.38
Zac,Nilah,316,133,183,42.09
Zac,Camille,359,195,164,54.32
Zac,Varus,978,501,477,51.23
Zac,Braum,538,247,291,45.91
Zac,Naafiri,279,137,142,49.1
Zac,Veigar,804,433,371,53.86
Zac,Neeko,396,230,166,58.08
Zac,Nasus,572,313,259,54.72
Zac,Pyke,708,359,349,50.71
Zac,Sett,1387,666,721,48.02
Zac,Ekko,821,403,418,49.09
Zac,Aphelios,569,280,289,49.21
Zac,Alistar,477,232,245,48.64
Zac,Mordekaiser,1082,554,528,51.2
Zac,Vi,1015,504,511,49.66
Zac,Senna,604,295,309,48.84
Zac,AurelionSol,337,144,193,42.73
Zac,Lissandra,313,148,165,47.28
Zac,TahmKench,677,348,329,51.4
Zac,Swain,828,324,504,39.13
Zac,Evelynn,332,172,160,51.81
Zac,Vex,460,211,249,45.87
Zac,Milio,483,242,241,50.1
Zac,Trundle,425,215,210,50.59
Zac,Lulu,1227,640,587,52.16
Zac,Hecarim,352,176,176,50
Zac,Khazix,474,267,207,56.33
Zac,MonkeyKing,656,352,304,53.66
Zac,Graves,610,301,309,49.34
Zac,Corki,440,196,244,44.55
Zac,Elise,753,376,377,49.93
Zac,Anivia,294,134,160,45.58
Zac,Gwen,579,320,259,55.27
Zac,Jinx,2158,1149,1009,53.24
Zac,Zyra,827,383,444,46.31
Zac,Sivir,504,251,253,49.8
Zac,Nidalee,357,213,144,59.66
Zac,Shaco,755,387,368,51.26
Zac,Shyvana,268,139,129,51.87
Zac,Udyr,392,186,206,47.45
Zac,Ziggs,309,166,143,53.72
Zac,Vayne,1154,630,524,54.59
Zac,Leblanc,562,283,279,50.36
Zac,Thresh,1344,693,651,51.56
Zac,Gangplank,415,208,207,50.12
Zac,Singed,230,103,127,44.78
Zac,Zeri,418,209,209,50
Zac,Sona,278,147,131,52.88
Zac,Viego,1397,721,676,51.61
Zac,DrMundo,455,211,244,46.37
Zac,Lillia,673,320,353,47.55
Zac,FiddleSticks,552,263,289,47.64
Zac,Nami,821,394,427,47.99
Zac,Urgot,396,210,186,53.03
Zac,Karma,1121,589,532,52.54
Zac,Azir,466,220,246,47.21
Zac,KogMaw,257,129,128,50.19
Zac,Nunu,517,231,286,44.68
Zac,Sylas,1328,689,639,51.88
Zac,Janna,389,209,180,53.73
Zac,Taric,247,132,115,53.44
Zac,Amumu,983,504,479,51.27
Zac,KSante,611,318,293,52.05
Zac,Jax,867,392,475,45.21
Zac,Blitzcrank,735,402,333,54.69
Zac,Galio,802,439,363,54.74
Zac,Ryze,325,196,129,60.31
Zac,Belveth,169,73,96,43.2
Zac,Malzahar,831,379,452,45.61
Zac,Hwei,625,292,333,46.72
Zac,Jayce,461,239,222,51.84
Zac,Kennen,283,180,103,63.6
Zac,Bard,305,167,138,54.75
Zac,LeeSin,1507,768,739,50.96
Zac,Smolder,668,307,361,45.96
Zac,Annie,312,187,125,59.94
Zac,Rammus,241,124,117,51.45
Zac,Nocturne,1044,547,497,52.39
Zac,Soraka,527,285,242,54.08
Zac,Fizz,460,180,280,39.13
Zac,Illaoi,395,225,170,56.96
Zac,Rakan,386,200,186,51.81
Zac,Rumble,267,101,166,37.83
Zac,Syndra,596,323,273,54.19
Zac,Ambessa,639,351,288,54.93
Zac,JarvanIV,496,256,240,51.61
Zac,Aatrox,929,429,500,46.18
Zac,Skarner,370,188,182,50.81
Zac,Renekton,602,253,349,42.03
Zac,Heimerdinger,408,211,197,51.72
Zac,Kalista,253,138,115,54.55
Zac,Kayle,548,253,295,46.17
Zac,RekSai,116,58,58,50
Zac,Shen,534,271,263,50.75
Zac,Akshan,281,127,154,45.2
Zac,Sejuani,422,202,220,47.87
Zac,Zilean,314,163,151,51.91
Zac,Karthus,284,171,113,60.21
Zac,TwistedFate,340,205,135,60.29
Zac,Talon,514,291,223,56.61
Zac,Qiyana,240,142,98,59.17
Zac,Maokai,406,183,223,45.07
Zac,Quinn,258,113,145,43.8
Zac,Olaf,210,99,111,47.14
Zac,Taliyah,276,133,143,48.19
Zac,Kled,192,118,74,61.46
Zac,Zoe,367,176,191,47.96
Poppy,Fiora,506,302,204,59.68
Poppy,Pantheon,2128,1097,1031,51.55
Poppy,Katarina,938,525,413,55.97
Poppy,Mel,2461,1275,1186,51.81
Poppy,Viktor,1121,570,551,50.85
Poppy,Lillia,812,401,411,49.38
Poppy,Aurora,960,486,474,50.63
Poppy,Zeri,686,362,324,52.77
Poppy,Rakan,786,369,417,46.95
Poppy,Renekton,698,368,330,52.72
Poppy,JarvanIV,749,356,393,47.53
Poppy,Jhin,2276,1150,1126,50.53
Poppy,Sylas,1446,792,654,54.77
Poppy,Warwick,1697,785,912,46.26
Poppy,Briar,979,496,483,50.66
Poppy,Yasuo,2409,1223,1186,50.77
Poppy,Irelia,1099,593,506,53.96
Poppy,Lux,2694,1347,1347,50
Poppy,Jax,1227,614,613,50.04
Poppy,Ahri,1648,886,762,53.76
Poppy,Rell,715,372,343,52.03
Poppy,Vladimir,923,447,476,48.43
Poppy,Zac,733,401,332,54.71
Poppy,Cassiopeia,396,210,186,53.03
Poppy,Ambessa,888,482,406,54.28
Poppy,Xayah,731,363,368,49.66
Poppy,AurelionSol,458,204,254,44.54
Poppy,Khazix,667,347,320,52.02
Poppy,Nautilus,1629,879,750,53.96
Poppy,Darius,2026,1010,1016,49.85
Poppy,Volibear,1331,648,683,48.69
Poppy,Caitlyn,3019,1489,1530,49.32
Poppy,TahmKench,1093,567,526,51.88
Poppy,Chogath,1384,603,781,43.57
Poppy,Talon,796,456,340,57.29
Poppy,Qiyana,308,142,166,46.1
Poppy,Seraphine,921,438,483,47.56
Poppy,FiddleSticks,584,264,320,45.21
Poppy,Singed,342,175,167,51.17
Poppy,Pyke,1311,693,618,52.86
Poppy,Sett,1851,890,961,48.08
Poppy,Ivern,206,115,91,55.83
Poppy,Neeko,648,355,293,54.78
Poppy,Senna,1013,498,515,49.16
Poppy,Elise,819,400,419,48.84
Poppy,Galio,1109,548,561,49.41
Poppy,Twitch,896,417,479,46.54
Poppy,Soraka,596,257,339,43.12
Poppy,Belveth,337,219,118,64.99
Poppy,Yone,2453,1273,1180,51.9
Poppy,Mordekaiser,1663,828,835,49.79
Poppy,Alistar,624,279,345,44.71
Poppy,Tryndamere,581,307,274,52.84
Poppy,Zyra,1041,463,578,44.48
Poppy,Nilah,435,236,199,54.25
Poppy,Sion,869,413,456,47.53
Poppy,Ezreal,2511,1255,1256,49.98
Poppy,Zilean,363,159,204,43.8
Poppy,Aatrox,1036,496,540,47.88
Poppy,Gragas,660,345,315,52.27
Poppy,Teemo,1272,638,634,50.16
Poppy,Evelynn,450,210,240,46.67
Poppy,Corki,519,273,246,52.6
Poppy,Rammus,400,205,195,51.25
Poppy,LeeSin,2230,1256,974,56.32
Poppy,Nasus,853,394,459,46.19
Poppy,Kaisa,2128,1131,997,53.15
Poppy,Bard,434,195,239,44.93
Poppy,Rengar,488,268,220,54.92
Poppy,Vayne,1649,786,863,47.67
Poppy,Blitzcrank,857,499,358,58.23
Poppy,KSante,764,450,314,58.9
Poppy,Azir,465,271,194,58.28
Poppy,Zed,1266,660,606,52.13
Poppy,Malzahar,1107,546,561,49.32
Poppy,Nidalee,445,211,234,47.42
Poppy,Vex,653,330,323,50.54
Poppy,Sivir,612,267,345,43.63
Poppy,Karma,1252,622,630,49.68
Poppy,Gangplank,531,262,269,49.34
Poppy,Lulu,1379,679,700,49.24
Poppy,Ashe,2359,1246,1113,52.82
Poppy,MasterYi,1222,586,636,47.95
Poppy,Diana,1891,955,936,50.5
Poppy,Varus,1140,538,602,47.19
Poppy,Rumble,419,213,206,50.84
Poppy,Samira,968,533,435,55.06
Poppy,Kayn,1693,938,755,55.4
Poppy,Hwei,792,389,403,49.12
Poppy,Draven,579,303,276,52.33
Poppy,Gnar,569,288,281,50.62
Poppy,Nocturne,1344,627,717,46.65
Poppy,Trundle,695,363,332,52.23
Poppy,XinZhao,801,400,401,49.94
Poppy,Tristana,1205,666,539,55.27
Poppy,Orianna,599,299,300,49.92
Poppy,Milio,642,283,359,44.08
Poppy,Illaoi,558,282,276,50.54
Poppy,Morgana,1322,673,649,50.91
Poppy,Urgot,524,249,275,47.52
Poppy,Xerath,945,415,530,43.92
Poppy,Veigar,1139,508,631,44.6
Poppy,Ekko,1090,566,524,51.93
Poppy,Heimerdinger,486,199,287,40.95
Poppy,Kalista,497,276,221,55.53
Poppy,Thresh,1807,942,865,52.13
Poppy,Akshan,447,206,241,46.09
Poppy,Nami,1010,483,527,47.82
Poppy,Aphelios,689,330,359,47.9
Poppy,Lissandra,354,159,195,44.92
Poppy,Riven,614,351,263,57.17
Poppy,Yuumi,1053,583,470,55.37
Poppy,MonkeyKing,692,322,370,46.53
Poppy,MissFortune,2468,1258,1210,50.97
Poppy,Amumu,1238,556,682,44.91
Poppy,Nunu,730,397,333,54.38
Poppy,Vi,1303,674,629,51.73
Poppy,Velkoz,655,337,318,51.45
Poppy,RekSai,216,131,85,60.65
Poppy,Ziggs,380,203,177,53.42
Poppy,Shen,814,400,414,49.14
Poppy,Brand,736,379,357,51.49
Poppy,Graves,717,383,334,53.42
Poppy,Ornn,501,248,253,49.5
Poppy,TwistedFate,502,263,239,52.39
Poppy,Jinx,2983,1460,1523,48.94
Poppy,Swain,1075,489,586,45.49
Poppy,Annie,353,151,202,42.78
Poppy,Leona,1407,713,694,50.68
Poppy,Shyvana,314,116,198,36.94
Poppy,Maokai,643,295,348,45.88
Poppy,Kled,257,138,119,53.7
Poppy,Shaco,1101,554,547,50.32
Poppy,Yorick,1004,462,542,46.02
Poppy,Kindred,587,294,293,50.09
Poppy,DrMundo,691,307,384,44.43
Poppy,Udyr,434,234,200,53.92
Poppy,Malphite,1052,520,532,49.43
Poppy,Kassadin,243,110,133,45.27
Poppy,Garen,1702,882,820,51.82
Poppy,Taric,310,133,177,42.9
Poppy,Camille,436,229,207,52.52
Poppy,Naafiri,392,209,183,53.32
Poppy,Syndra,802,396,406,49.38
Poppy,Lucian,892,474,418,53.14
Poppy,Viego,1607,805,802,50.09
Poppy,Akali,1272,708,564,55.66
Poppy,Kennen,339,148,191,43.66
Poppy,Zoe,484,266,218,54.96
Poppy,Kayle,781,456,325,58.39
Poppy,Leblanc,752,397,355,52.79
Poppy,Renata,312,146,166,46.79
Poppy,Quinn,390,188,202,48.21
Poppy,Taliyah,315,164,151,52.06
Poppy,Sona,364,169,195,46.43
Poppy,Braum,739,344,395,46.55
Poppy,Hecarim,448,232,216,51.79
Poppy,Sejuani,504,246,258,48.81
Poppy,Fizz,654,346,308,52.91
Poppy,Jayce,628,335,293,53.34
Poppy,Skarner,320,169,151,52.81
Poppy,Smolder,728,316,412,43.41
Poppy,Karthus,322,159,163,49.38
Poppy,Ryze,436,178,258,40.83
Poppy,Olaf,328,133,195,40.55
Poppy,KogMaw,388,164,224,42.27
Poppy,Janna,442,216,226,48.87
Poppy,Gwen,682,420,262,61.58
Poppy,Anivia,432,236,196,54.63
Twitch,Fiora,758,434,324,57.26
Twitch,Pantheon,2465,1134,1331,46
Twitch,Katarina,1213,621,592,51.2
Twitch,Mel,3401,1748,1653,51.4
Twitch,Viktor,1332,678,654,50.9
Twitch,Kayle,1182,516,666,43.65
Twitch,Sylas,1722,921,801,53.48
Twitch,Qiyana,429,247,182,57.58
Twitch,Caitlyn,4145,1970,2175,47.53
Twitch,Renata,353,149,204,42.21
Twitch,Samira,1217,593,624,48.73
Twitch,Kayn,2480,1261,1219,50.85
Twitch,Nilah,725,351,374,48.41
Twitch,Leona,1242,615,627,49.52
Twitch,Riven,762,396,366,51.97
Twitch,Amumu,1764,777,987,44.05
Twitch,Zoe,641,327,314,51.01
Twitch,MissFortune,3732,1772,1960,47.48
Twitch,Sona,531,281,250,52.92
Twitch,Jax,1387,679,708,48.95
Twitch,Briar,1335,705,630,52.81
Twitch,Ahri,1994,962,1032,48.24
Twitch,Zeri,660,355,305,53.79
Twitch,Rell,792,347,445,43.81
Twitch,Nasus,1075,509,566,47.35
Twitch,MonkeyKing,1089,527,562,48.39
Twitch,Xayah,823,388,435,47.14
Twitch,Zac,594,273,321,45.96
Twitch,Jayce,553,283,270,51.18
Twitch,Rengar,613,314,299,51.22
Twitch,Swain,1563,789,774,50.48
Twitch,Ezreal,3009,1573,1436,52.28
Twitch,Neeko,770,406,364,52.73
Twitch,Morgana,1910,981,929,51.36
Twitch,Tryndamere,875,416,459,47.54
Twitch,Graves,899,449,450,49.94
Twitch,Gnar,684,384,300,56.14
Twitch,Nunu,1039,494,545,47.55
Twitch,Lucian,1096,529,567,48.27
Twitch,Jhin,3303,1642,1661,49.71
Twitch,Lux,4254,2070,2184,48.66
Twitch,Ornn,699,350,349,50.07
Twitch,Warwick,2563,1283,1280,50.06
Twitch,TwistedFate,632,341,291,53.96
Twitch,Gangplank,716,369,347,51.54
Twitch,Taliyah,383,211,172,55.09
Twitch,Sivir,714,382,332,53.5
Twitch,Soraka,985,494,491,50.15
Twitch,Yorick,1651,823,828,49.85
Twitch,Volibear,1884,905,979,48.04
Twitch,Cassiopeia,537,213,324,39.66
Twitch,Gwen,928,475,453,51.19
Twitch,Tristana,1671,800,871,47.88
Twitch,Poppy,896,479,417,53.46
Twitch,Draven,873,415,458,47.54
Twitch,KogMaw,689,354,335,51.38
Twitch,Yuumi,1351,622,729,46.04
Twitch,Khazix,934,490,444,52.46
Twitch,Yasuo,3095,1522,1573,49.18
Twitch,Seraphine,1493,757,736,50.7
Twitch,Vi,1339,589,750,43.99
Twitch,Nocturne,1846,854,992,46.26
Twitch,Corki,709,374,335,52.75
Twitch,Shaco,1577,781,796,49.52
Twitch,Naafiri,619,307,312,49.6
Twitch,Xerath,1271,671,600,52.79
Twitch,Rammus,519,276,243,53.18
Twitch,Nami,1695,877,818,51.74
Twitch,Irelia,1241,610,631,49.15
Twitch,Malphite,1547,716,831,46.28
Twitch,Vladimir,1047,519,528,49.57
Twitch,Senna,1310,682,628,52.06
Twitch,Aatrox,1378,672,706,48.77
Twitch,Trundle,993,471,522,47.43
Twitch,Sett,2493,1116,1377,44.77
Twitch,Jinx,5161,2630,2531,50.96
Twitch,Karma,1608,868,740,53.98
Twitch,Darius,2887,1444,1443,50.02
Twitch,Ekko,1574,757,817,48.09
Twitch,Teemo,2027,956,1071,47.16
Twitch,Shyvana,456,235,221,51.54
Twitch,Galio,1235,640,595,51.82
Twitch,Thresh,2097,1004,1093,47.88
Twitch,Viego,1922,974,948,50.68
Twitch,Kalista,507,236,271,46.55
Twitch,FiddleSticks,849,460,389,54.18
Twitch,Diana,2505,1283,1222,51.22
Twitch,Yone,2666,1375,1291,51.58
Twitch,Maokai,687,331,356,48.18
Twitch,Zed,1737,929,808,53.48
Twitch,Rumble,338,163,175,48.22
Twitch,Nautilus,1684,851,833,50.53
Twitch,Garen,2429,1228,1201,50.56
Twitch,Fizz,940,442,498,47.02
Twitch,Kaisa,2377,1273,1104,53.55
Twitch,Ryze,576,263,313,45.66
Twitch,Janna,548,264,284,48.18
Twitch,Heimerdinger,786,397,389,50.51
Twitch,Kindred,733,392,341,53.48
Twitch,TahmKench,1395,674,721,48.32
Twitch,Pyke,1243,639,604,51.41
Twitch,Shen,1051,478,573,45.48
Twitch,Veigar,1663,829,834,49.85
Twitch,Blitzcrank,1095,510,585,46.58
Twitch,Elise,1026,525,501,51.17
Twitch,Chogath,2060,927,1133,45
Twitch,Mordekaiser,2236,1055,1181,47.18
Twitch,Lillia,924,472,452,51.08
Twitch,Singed,473,207,266,43.76
Twitch,Bard,558,262,296,46.95
Twitch,MasterYi,1940,949,991,48.92
Twitch,Akali,1478,752,726,50.88
Twitch,LeeSin,1826,922,904,50.49
Twitch,Varus,1432,728,704,50.84
Twitch,Rakan,707,322,385,45.54
Twitch,Ambessa,922,513,409,55.64
Twitch,Akshan,638,283,355,44.36
Twitch,Zyra,1206,583,623,48.34
Twitch,Vayne,2108,1017,1091,48.24
Twitch,Azir,535,303,232,56.64
Twitch,Ashe,3200,1662,1538,51.94
Twitch,Gragas,923,490,433,53.09
Twitch,AurelionSol,650,292,358,44.92
Twitch,Taric,354,142,212,40.11
Twitch,Evelynn,727,412,315,56.67
Twitch,Vex,824,439,385,53.28
Twitch,Brand,1161,587,574,50.56
Twitch,Aphelios,953,471,482,49.42
Twitch,Camille,650,346,304,53.23
Twitch,Illaoi,686,337,349,49.13
Twitch,Hwei,1055,565,490,53.55
Twitch,KSante,676,377,299,55.77
Twitch,Kassadin,388,186,202,47.94
Twitch,Udyr,710,373,337,52.54
Twitch,Malzahar,1556,745,811,47.88
Twitch,Leblanc,814,403,411,49.51
Twitch,Sejuani,638,319,319,50
Twitch,Lulu,1938,1011,927,52.17
Twitch,JarvanIV,837,335,502,40.02
Twitch,Renekton,829,417,412,50.3
Twitch,Syndra,1060,465,595,43.87
Twitch,Alistar,516,274,242,53.1
Twitch,Lissandra,546,245,301,44.87
Twitch,Aurora,1358,725,633,53.39
Twitch,Urgot,858,400,458,46.62
Twitch,Braum,929,412,517,44.35
Twitch,Quinn,619,304,315,49.11
Twitch,Skarner,442,233,209,52.71
Twitch,Smolder,1165,630,535,54.08
Twitch,DrMundo,959,433,526,45.15
Twitch,Sion,1325,675,650,50.94
Twitch,Hecarim,639,356,283,55.71
Twitch,Ziggs,579,342,237,59.07
Twitch,Kennen,484,251,233,51.86
Twitch,Orianna,716,380,336,53.07
Twitch,XinZhao,898,449,449,50
Twitch,Talon,981,538,443,54.84
Twitch,Annie,384,185,199,48.18
Twitch,Velkoz,1019,517,502,50.74
Twitch,Milio,1080,529,551,48.98
Twitch,Zilean,550,239,311,43.45
Twitch,RekSai,227,114,113,50.22
Twitch,Nidalee,326,179,147,54.91
Twitch,Belveth,359,190,169,52.92
Twitch,Kled,315,162,153,51.43
Twitch,Karthus,431,255,176,59.16
Twitch,Ivern,246,120,126,48.78
Twitch,Olaf,341,183,158,53.67
Twitch,Anivia,485,260,225,53.61
Fiora,Darius,1420,655,765,46.13
Fiora,Zac,398,182,216,45.73
Fiora,Hwei,569,332,237,58.35
Fiora,Poppy,506,204,302,40.32
Fiora,Twitch,758,324,434,42.74
Fiora,Mordekaiser,1323,648,675,48.98
Fiora,Kindred,401,160,241,39.9
Fiora,Qiyana,264,147,117,55.68
Fiora,Ashe,1558,769,789,49.36
Fiora,Sona,241,125,116,51.87
Fiora,Leblanc,373,212,161,56.84
Fiora,Briar,711,325,386,45.71
Fiora,Zoe,345,192,153,55.65
Fiora,Jinx,2002,937,1065,46.8
Fiora,Nasus,591,283,308,47.88
Fiora,Shaco,742,362,380,48.79
Fiora,Zed,831,449,382,54.03
Fiora,Varus,620,268,352,43.23
Fiora,Neeko,404,194,210,48.02
Fiora,Udyr,325,175,150,53.85
Fiora,Yorick,682,307,375,45.01
Fiora,Sivir,429,228,201,53.15
Fiora,Nautilus,1030,508,522,49.32
Fiora,Gangplank,352,199,153,56.53
Fiora,Karthus,213,105,108,49.3
Fiora,Aurora,703,347,356,49.36
Fiora,Ezreal,1656,846,810,51.09
Fiora,Senna,580,276,304,47.59
Fiora,Viego,1055,540,515,51.18
Fiora,AurelionSol,309,138,171,44.66
Fiora,MissFortune,1650,826,824,50.06
Fiora,Malphite,610,224,386,36.72
Fiora,Sett,1231,522,709,42.4
Fiora,Sion,691,337,354,48.77
Fiora,Samira,672,321,351,47.77
Fiora,Alistar,281,134,147,47.69
Fiora,Viktor,720,390,330,54.17
Fiora,Nocturne,812,356,456,43.84
Fiora,Yasuo,1621,766,855,47.25
Fiora,Nilah,322,156,166,48.45
Fiora,Bard,243,135,108,55.56
Fiora,Jax,755,419,336,55.5
Fiora,Diana,1192,525,667,44.04
Fiora,Ahri,976,441,535,45.18
Fiora,Aphelios,494,242,252,48.99
Fiora,Aatrox,828,388,440,46.86
Fiora,Draven,421,243,178,57.72
Fiora,Talon,496,265,231,53.43
Fiora,Lissandra,242,106,136,43.8
Fiora,Vayne,828,373,455,45.05
Fiora,Milio,485,228,257,47.01
Fiora,Chogath,1206,555,651,46.02
Fiora,Galio,765,368,397,48.1
Fiora,Soraka,428,214,214,50
Fiora,Mel,1639,858,781,52.35
Fiora,Velkoz,515,252,263,48.93
Fiora,Kayle,523,216,307,41.3
Fiora,Sylas,890,439,451,49.33
Fiora,Lucian,495,283,212,57.17
Fiora,Nami,843,451,392,53.5
Fiora,MasterYi,846,376,470,44.44
Fiora,Yuumi,634,300,334,47.32
Fiora,Kayn,1165,566,599,48.58
Fiora,Warwick,1086,502,584,46.22
Fiora,Ziggs,310,153,157,49.35
Fiora,Malzahar,686,303,383,44.17
Fiora,Braum,499,249,250,49.9
Fiora,XinZhao,488,234,254,47.95
Fiora,Lux,1989,950,1039,47.76
Fiora,Vi,741,344,397,46.42
Fiora,Zilean,266,141,125,53.01
Fiora,LeeSin,1021,476,545,46.62
Fiora,Akali,781,394,387,50.45
Fiora,Shyvana,173,108,65,62.43
Fiora,Garen,1144,508,636,44.41
Fiora,Veigar,749,322,427,42.99
Fiora,Zyra,574,280,294,48.78
Fiora,KSante,477,256,221,53.67
Fiora,Olaf,114,53,61,46.49
Fiora,Yone,1523,827,696,54.3
Fiora,Morgana,932,459,473,49.25
Fiora,Tristana,743,323,420,43.47
Fiora,Lulu,893,409,484,45.8
Fiora,Janna,266,125,141,46.99
Fiora,Caitlyn,1866,879,987,47.11
Fiora,Ivern,106,44,62,41.51
Fiora,Tryndamere,417,196,221,47
Fiora,Ekko,769,356,413,46.29
Fiora,Thresh,1023,471,552,46.04
Fiora,Camille,366,207,159,56.56
Fiora,Lillia,427,225,202,52.69
Fiora,Xerath,677,338,339,49.93
Fiora,Pyke,714,390,324,54.62
Fiora,Evelynn,342,174,168,50.88
Fiora,Riven,486,235,251,48.35
Fiora,Katarina,631,244,387,38.67
Fiora,Xayah,344,160,184,46.51
Fiora,Illaoi,333,178,155,53.45
Fiora,Rell,380,172,208,45.26
Fiora,Volibear,798,385,413,48.25
Fiora,Taliyah,194,78,116,40.21
Fiora,Pantheon,1297,632,665,48.73
Fiora,Annie,255,134,121,52.55
Fiora,Swain,794,405,389,51.01
Fiora,Orianna,286,135,151,47.2
Fiora,Seraphine,705,360,345,51.06
Fiora,Teemo,728,328,400,45.05
Fiora,Vex,354,171,183,48.31
Fiora,Naafiri,268,110,158,41.04
Fiora,Gragas,467,262,205,56.1
Fiora,Maokai,327,196,131,59.94
Fiora,TahmKench,781,408,373,52.24
Fiora,Renekton,334,161,173,48.2
Fiora,Nunu,538,235,303,43.68
Fiora,Zeri,335,142,193,42.39
Fiora,Shen,525,272,253,51.81
Fiora,Jhin,1490,754,736,50.6
Fiora,Kaisa,1175,583,592,49.62
Fiora,Ornn,535,257,278,48.04
Fiora,Elise,578,319,259,55.19
Fiora,Leona,602,253,349,42.03
Fiora,Ambessa,488,250,238,51.23
Fiora,Karma,889,398,491,44.77
Fiora,Vladimir,514,251,263,48.83
Fiora,Amumu,769,411,358,53.45
Fiora,Smolder,438,211,227,48.17
Fiora,Blitzcrank,537,300,237,55.87
Fiora,MonkeyKing,507,272,235,53.65
Fiora,Gwen,577,251,326,43.5
Fiora,Cassiopeia,232,129,103,55.6
Fiora,Rakan,350,145,205,41.43
Fiora,Azir,275,138,137,50.18
Fiora,Kalista,239,131,108,54.81
Fiora,Urgot,318,126,192,39.62
Fiora,Corki,291,130,161,44.67
Fiora,Brand,489,209,280,42.74
Fiora,Irelia,706,371,335,52.55
Fiora,Graves,418,198,220,47.37
Fiora,Ryze,294,133,161,45.24
Fiora,Gnar,248,132,116,53.23
Fiora,Renata,169,71,98,42.01
Fiora,Trundle,360,166,194,46.11
Fiora,Rammus,265,146,119,55.09
Fiora,KogMaw,291,138,153,47.42
Fiora,Sejuani,304,149,155,49.01
Fiora,Rengar,300,178,122,59.33
Fiora,Heimerdinger,353,161,192,45.61
Fiora,Khazix,468,264,204,56.41
Fiora,DrMundo,428,176,252,41.12
Fiora,Anivia,190,95,95,50
Fiora,Syndra,464,276,188,59.48
Fiora,Taric,150,61,89,40.67
Fiora,Jayce,351,167,184,47.58
Fiora,Quinn,243,96,147,39.51
Fiora,Skarner,243,148,95,60.91
Fiora,Kassadin,126,64,62,50.79
Fiora,Akshan,325,143,182,44
Fiora,Fizz,374,190,184,50.8
Fiora,Singed,185,107,78,57.84
Fiora,TwistedFate,254,121,133,47.64
Fiora,Hecarim,320,159,161,49.69
Fiora,Kled,152,73,79,48.03
Fiora,FiddleSticks,364,181,183,49.73
Fiora,JarvanIV,343,172,171,50.15
Fiora,RekSai,90,53,37,58.89
Fiora,Belveth,249,118,131,47.39
Fiora,Rumble,209,117,92,55.98
Fiora,Nidalee,192,120,72,62.5
Fiora,Kennen,182,92,90,50.55
Katarina,Darius,2816,1387,1429,49.25
Katarina,Zac,720,305,415,42.36
Katarina,Hwei,1142,515,627,45.1
Katarina,Poppy,938,413,525,44.03
Katarina,Twitch,1213,592,621,48.8
Katarina,Yone,2929,1443,1486,49.27
Katarina,Shaco,1596,792,804,49.62
Katarina,Mel,3512,1795,1717,51.11
Katarina,Tristana,1502,687,815,45.74
Katarina,Pyke,1416,729,687,51.48
Katarina,Singed,452,182,270,40.27
Katarina,Graves,899,493,406,54.84
Katarina,Fizz,897,395,502,44.04
Katarina,Ziggs,602,265,337,44.02
Katarina,Pantheon,2581,1270,1311,49.21
Katarina,Jax,1310,658,652,50.23
Katarina,Briar,1353,620,733,45.82
Katarina,Ahri,2227,1077,1150,48.36
Katarina,Zeri,613,354,259,57.75
Katarina,Rell,794,348,446,43.83
Katarina,Aatrox,1464,743,721,50.75
Katarina,Gwen,945,501,444,53.02
Katarina,Syndra,1020,541,479,53.04
Katarina,Ashe,3040,1415,1625,46.55
Katarina,Lulu,1909,885,1024,46.36
Katarina,Mordekaiser,2061,928,1133,45.03
Katarina,Zed,1732,859,873,49.6
Katarina,Jinx,3827,1792,2035,46.83
Katarina,Lillia,854,402,452,47.07
Katarina,Samira,1287,610,677,47.4
Katarina,Karma,1657,825,832,49.79
Katarina,Rammus,526,216,310,41.06
Katarina,Blitzcrank,1145,526,619,45.94
Katarina,Kayn,2319,1117,1202,48.17
Katarina,Thresh,2093,1065,1028,50.88
Katarina,Ezreal,3093,1616,1477,52.25
Katarina,Yuumi,1352,707,645,52.29
Katarina,Yorick,1491,654,837,43.86
Katarina,Nunu,916,428,488,46.72
Katarina,Draven,864,408,456,47.22
Katarina,KogMaw,516,204,312,39.53
Katarina,Illaoi,703,329,374,46.8
Katarina,Khazix,928,456,472,49.14
Katarina,Kaisa,2380,1287,1093,54.08
Katarina,Lux,3997,1923,2074,48.11
Katarina,Malphite,1409,657,752,46.63
Katarina,Udyr,601,278,323,46.26
Katarina,Jhin,3160,1527,1633,48.32
Katarina,Evelynn,637,290,347,45.53
Katarina,XinZhao,994,482,512,48.49
Katarina,Akali,1761,806,955,45.77
Katarina,Caitlyn,4107,1975,2132,48.09
Katarina,Maokai,700,354,346,50.57
Katarina,Yasuo,3094,1434,1660,46.35
Katarina,Naafiri,506,212,294,41.9
Katarina,Leblanc,767,365,402,47.59
Katarina,MissFortune,3564,1527,2037,42.85
Katarina,Nami,1605,724,881,45.11
Katarina,Gangplank,754,367,387,48.67
Katarina,Nocturne,1587,728,859,45.87
Katarina,Corki,692,363,329,52.46
Katarina,Ambessa,986,490,496,49.7
Katarina,Qiyana,521,268,253,51.44
Katarina,LeeSin,2079,1116,963,53.68
Katarina,Nasus,1158,459,699,39.64
Katarina,Zoe,665,348,317,52.33
Katarina,Senna,1090,512,578,46.97
Katarina,Shen,954,396,558,41.51
Katarina,Amumu,1500,648,852,43.2
Katarina,Leona,1245,572,673,45.94
Katarina,Warwick,2294,926,1368,40.37
Katarina,Malzahar,1354,573,781,42.32
Katarina,Soraka,902,454,448,50.33
Katarina,Heimerdinger,792,349,443,44.07
Katarina,Viktor,1193,529,664,44.34
Katarina,Morgana,1947,934,1013,47.97
Katarina,Vayne,1717,768,949,44.73
Katarina,Aurora,1158,610,548,52.68
Katarina,Nilah,647,339,308,52.4
Katarina,Cassiopeia,466,222,244,47.64
Katarina,Swain,1515,706,809,46.6
Katarina,Camille,497,242,255,48.69
Katarina,Hecarim,672,324,348,48.21
Katarina,TwistedFate,522,236,286,45.21
Katarina,Nautilus,1596,756,840,47.37
Katarina,Sejuani,667,309,358,46.33
Katarina,Veigar,1937,940,997,48.53
Katarina,Garen,2418,1111,1307,45.95
Katarina,MasterYi,1797,888,909,49.42
Katarina,Sion,1121,555,566,49.51
Katarina,Lucian,983,525,458,53.41
Katarina,Karthus,423,193,230,45.63
Katarina,TahmKench,1282,631,651,49.22
Katarina,Renekton,816,392,424,48.04
Katarina,KSante,716,378,338,52.79
Katarina,Belveth,405,209,196,51.6
Katarina,Riven,772,375,397,48.58
Katarina,Rumble,397,205,192,51.64
Katarina,Akshan,527,242,285,45.92
Katarina,Sona,499,237,262,47.49
Katarina,Ornn,592,332,260,56.08
Katarina,Skarner,464,248,216,53.45
Katarina,Ekko,1380,617,763,44.71
Katarina,Diana,2378,1169,1209,49.16
Katarina,AurelionSol,618,324,294,52.43
Katarina,Neeko,804,367,437,45.65
Katarina,Vi,1405,647,758,46.05
Katarina,Vladimir,1127,528,599,46.85
Katarina,Anivia,522,216,306,41.38
Katarina,Seraphine,1293,591,702,45.71
Katarina,Gragas,938,456,482,48.61
Katarina,Urgot,764,331,433,43.32
Katarina,Kindred,670,298,372,44.48
Katarina,Fiora,631,387,244,61.33
Katarina,Annie,546,301,245,55.13
Katarina,Bard,472,251,221,53.18
Katarina,Kennen,429,186,243,43.36
Katarina,Rengar,580,337,243,58.1
Katarina,Ivern,270,128,142,47.41
Katarina,Olaf,329,163,166,49.54
Katarina,Irelia,1417,687,730,48.48
Katarina,Ryze,471,225,246,47.77
Katarina,Xerath,1255,621,634,49.48
Katarina,Orianna,630,363,267,57.62
Katarina,Kled,273,132,141,48.35
Katarina,Galio,1483,644,839,43.43
Katarina,Brand,1087,533,554,49.03
Katarina,Kayle,1161,508,653,43.76
Katarina,Smolder,1086,509,577,46.87
Katarina,Janna,557,285,272,51.17
Katarina,MonkeyKing,1056,488,568,46.21
Katarina,Trundle,874,377,497,43.14
Katarina,Kalista,521,280,241,53.74
Katarina,Velkoz,916,432,484,47.16
Katarina,Vex,839,341,498,40.64
Katarina,Milio,1083,473,610,43.67
Katarina,Viego,2297,1147,1150,49.93
Katarina,Chogath,1855,778,1077,41.94
Katarina,Alistar,600,304,296,50.67
Katarina,Nidalee,410,230,180,56.1
Katarina,JarvanIV,771,328,443,42.54
Katarina,Sylas,1860,915,945,49.19
Katarina,Sett,2551,1181,1370,46.3
Katarina,Xayah,876,409,467,46.69
Katarina,Sivir,686,353,333,51.46
Katarina,Volibear,1809,840,969,46.43
Katarina,Gnar,626,325,301,51.92
Katarina,Jayce,713,340,373,47.69
Katarina,FiddleSticks,664,340,324,51.2
Katarina,Azir,552,263,289,47.64
Katarina,Rakan,727,332,395,45.67
Katarina,Teemo,1853,903,950,48.73
Katarina,Lissandra,536,270,266,50.37
Katarina,Taliyah,346,189,157,54.62
Katarina,Zyra,1312,538,774,41.01
Katarina,Kassadin,369,177,192,47.97
Katarina,DrMundo,932,406,526,43.56
Katarina,Elise,1078,496,582,46.01
Katarina,Renata,306,152,154,49.67
Katarina,Aphelios,907,449,458,49.5
Katarina,Braum,841,426,415,50.65
Katarina,Zilean,428,195,233,45.56
Katarina,Tryndamere,815,411,404,50.43
Katarina,Talon,955,519,436,54.35
Katarina,Varus,1440,669,771,46.46
Katarina,RekSai,190,96,94,50.53
Katarina,Quinn,634,344,290,54.26
Katarina,Taric,339,191,148,56.34
Katarina,Shyvana,402,156,246,38.81
Mel,Darius,7455,3522,3933,47.24
Mel,Zac,1928,1006,922,52.18
Mel,Hwei,2759,1277,1482,46.28
Mel,Poppy,2461,1186,1275,48.19
Mel,Twitch,3401,1653,1748,48.6
Mel,Renekton,2150,1113,1037,51.77
Mel,Kayn,6121,2923,3198,47.75
Mel,Katarina,3512,1717,1795,48.89
Mel,Draven,2289,1066,1223,46.57
Mel,Yuumi,3538,1629,1909,46.04
Mel,Aurora,3057,1531,1526,50.08
Mel,Volibear,4595,2185,2410,47.55
Mel,Yasuo,8563,4061,4502,47.42
Mel,Vayne,4985,2346,2639,47.06
Mel,Shaco,3890,1978,1912,50.85
Mel,Talon,2345,1137,1208,48.49
Mel,Tristana,3814,1801,2013,47.22
Mel,Alistar,1806,901,905,49.89
Mel,Yorick,4014,1752,2262,43.65
Mel,FiddleSticks,1972,1009,963,51.17
Mel,Smolder,2858,1456,1402,50.94
Mel,Nautilus,4613,2213,2400,47.97
Mel,Illaoi,1850,865,985,46.76
Mel,MonkeyKing,2584,1262,1322,48.84
Mel,Yone,7586,3684,3902,48.56
Mel,Morgana,4900,2369,2531,48.35
Mel,Gangplank,1738,935,803,53.8
Mel,Warwick,6041,2702,3339,44.73
Mel,Akali,4589,2206,2383,48.07
Mel,Caitlyn,10534,5117,5417,48.58
Mel,Sona,1450,666,784,45.93
Mel,Riven,1961,932,1029,47.53
Mel,Ahri,4485,2288,2197,51.01
Mel,Jinx,10676,5000,5676,46.83
Mel,Nasus,3094,1411,1683,45.6
Mel,Zed,4210,2100,2110,49.88
Mel,Varus,3605,1750,1855,48.54
Mel,Neeko,2312,1216,1096,52.6
Mel,Swain,4086,1944,2142,47.58
Mel,Malzahar,4059,1914,2145,47.15
Mel,Irelia,3597,1837,1760,51.07
Mel,Kalista,1429,782,647,54.72
Mel,Gwen,2101,1060,1041,50.45
Mel,Skarner,1156,571,585,49.39
Mel,Kaisa,6360,3121,3239,49.07
Mel,Seraphine,3246,1571,1675,48.4
Mel,Briar,3445,1533,1912,44.5
Mel,Vex,1718,895,823,52.1
Mel,Milio,2477,1045,1432,42.19
Mel,Mordekaiser,5731,2648,3083,46.2
Mel,Jhin,8387,3982,4405,47.48
Mel,Velkoz,2530,1175,1355,46.44
Mel,Garen,6404,3034,3370,47.38
Mel,Zilean,1256,633,623,50.4
Mel,Teemo,5329,2451,2878,45.99
Mel,Leona,3957,1759,2198,44.45
Mel,Sylas,5372,2599,2773,48.38
Mel,Kindred,1768,843,925,47.68
Mel,Rell,2227,1096,1131,49.21
Mel,Gnar,1679,847,832,50.45
Mel,Leblanc,2029,1055,974,52
Mel,Karma,4326,1954,2372,45.17
Mel,Lillia,2294,1056,1238,46.03
Mel,Vladimir,2708,1195,1513,44.13
Mel,Lulu,4666,2173,2493,46.57
Mel,Veigar,4052,1972,2080,48.67
Mel,Kennen,1183,620,563,52.41
Mel,Naafiri,1536,770,766,50.13
Mel,Xayah,2209,1053,1156,47.67
Mel,Soraka,2593,1212,1381,46.74
Mel,Gragas,2187,1095,1092,50.07
Mel,XinZhao,2516,1127,1389,44.79
Mel,Lucian,2829,1456,1373,51.47
Mel,Aatrox,3607,1767,1840,48.99
Mel,Viego,5655,2705,2950,47.83
Mel,Ashe,7642,3755,3887,49.14
Mel,Blitzcrank,2847,1531,1316,53.78
Mel,Cassiopeia,1465,667,798,45.53
Mel,Sett,6342,2963,3379,46.72
Mel,Elise,2527,1245,1282,49.27
Mel,Galio,3708,1710,1998,46.12
Mel,KSante,1855,936,919,50.46
Mel,Senna,3333,1572,1761,47.16
Mel,Thresh,5369,2581,2788,48.07
Mel,Viktor,3897,1848,2049,47.42
Mel,Pyke,3799,1907,1892,50.2
Mel,Nilah,1685,658,1027,39.05
Mel,Malphite,3655,1797,1858,49.17
Mel,Diana,6522,3065,3457,46.99
Mel,Lux,10350,5313,5037,51.33
Mel,Orianna,2422,1088,1334,44.92
Mel,Udyr,1601,777,824,48.53
Mel,Sion,3161,1457,1704,46.09
Mel,AurelionSol,2207,1035,1172,46.9
Mel,Samira,3185,1657,1528,52.03
Mel,Jax,3462,1710,1752,49.39
Mel,Rakan,2067,1009,1058,48.81
Mel,Ekko,3724,1839,1885,49.38
Mel,Fizz,3085,1497,1588,48.53
Mel,Fiora,1639,781,858,47.65
Mel,Ziggs,1733,691,1042,39.87
Mel,LeeSin,5596,2754,2842,49.21
Mel,Chogath,5535,2607,2928,47.1
Mel,Ezreal,8687,4262,4425,49.06
Mel,RekSai,491,285,206,58.04
Mel,Evelynn,1643,844,799,51.37
Mel,Anivia,1206,572,634,47.43
Mel,Olaf,948,456,492,48.1
Mel,MissFortune,9318,4395,4923,47.17
Mel,Pantheon,6654,3120,3534,46.89
Mel,KogMaw,1222,588,634,48.12
Mel,Urgot,1934,931,1003,48.14
Mel,Amumu,4253,1935,2318,45.5
Mel,Annie,1318,632,686,47.95
Mel,Ivern,613,330,283,53.83
Mel,Rumble,954,463,491,48.53
Mel,Zoe,1458,760,698,52.13
Mel,Renata,652,313,339,48.01
Mel,Qiyana,1244,613,631,49.28
Mel,MasterYi,4740,2238,2502,47.22
Mel,TahmKench,3701,1844,1857,49.82
Mel,Trundle,2450,1106,1344,45.14
Mel,Singed,1203,557,646,46.3
Mel,Quinn,1553,687,866,44.24
Mel,Jayce,1852,937,915,50.59
Mel,Zyra,3350,1641,1709,48.99
Mel,Nami,3869,1884,1985,48.69
Mel,Kayle,2971,1411,1560,47.49
Mel,Rengar,1560,883,677,56.6
Mel,Janna,1308,614,694,46.94
Mel,Nocturne,4552,1951,2601,42.86
Mel,Hecarim,1668,825,843,49.46
Mel,Kassadin,1202,543,659,45.17
Mel,JarvanIV,2128,977,1151,45.91
Mel,DrMundo,2385,1066,1319,44.7
Mel,Heimerdinger,1941,874,1067,45.03
Mel,Ryze,1403,704,699,50.18
Mel,Braum,2122,976,1146,45.99
Mel,Shen,2471,1259,1212,50.95
Mel,Aphelios,2458,1161,1297,47.23
Mel,Bard,1307,612,695,46.82
Mel,Sivir,2129,996,1133,46.78
Mel,Sejuani,1553,699,854,45.01
Mel,Ornn,1583,779,804,49.21
Mel,Ambessa,2544,1283,1261,50.43
Mel,Shyvana,1002,486,516,48.5
Mel,Akshan,1483,697,786,47
Mel,Vi,3790,1859,1931,49.05
Mel,Xerath,4344,1963,2381,45.19
Mel,Syndra,2399,1144,1255,47.69
Mel,TwistedFate,1196,584,612,48.83
Mel,Lissandra,1267,594,673,46.88
Mel,Brand,2825,1352,1473,47.86
Mel,Khazix,2104,1087,1017,51.66
Mel,Camille,1503,743,760,49.43
Mel,Nunu,2551,1227,1324,48.1
Mel,Maokai,1837,874,963,47.58
Mel,Kled,809,358,451,44.25
Mel,Zeri,1759,874,885,49.69
Mel,Tryndamere,2279,1145,1134,50.24
Mel,Azir,1699,773,926,45.5
Mel,Rammus,1078,552,526,51.21
Mel,Corki,1513,770,743,50.89
Mel,Karthus,1131,546,585,48.28
Mel,Graves,2286,1155,1131,50.52
Mel,Taric,888,433,455,48.76
Mel,Nidalee,1146,573,573,50
Mel,Taliyah,1093,525,568,48.03
Mel,Belveth,942,425,517,45.12
Viktor,Darius,2841,1407,1434,49.52
Viktor,Zac,823,394,429,47.87
Viktor,Hwei,1516,814,702,53.69
Viktor,Poppy,1121,551,570,49.15
Viktor,Twitch,1332,654,678,49.1
Viktor,Gangplank,782,309,473,39.51
Viktor,Gragas,1067,592,475,55.48
Viktor,TwistedFate,681,387,294,56.83
Viktor,Lucian,1209,635,574,52.52
Viktor,Leona,1312,668,644,50.91
Viktor,Tryndamere,825,427,398,51.76
Viktor,Amumu,1610,765,845,47.52
Viktor,Mel,3897,2049,1848,52.58
Viktor,Kaisa,2691,1364,1327,50.69
Viktor,Seraphine,1218,593,625,48.69
Viktor,Fiora,720,330,390,45.83
Viktor,LeeSin,2626,1357,1269,51.68
Viktor,Ziggs,592,271,321,45.78
Viktor,Jinx,4476,2223,2253,49.66
Viktor,Senna,1280,605,675,47.27
Viktor,Kennen,485,259,226,53.4
Viktor,Skarner,556,333,223,59.89
Viktor,Malzahar,1819,879,940,48.32
Viktor,Yuumi,1276,625,651,48.98
Viktor,Ivern,289,141,148,48.79
Viktor,Katarina,1193,663,530,55.57
Viktor,Jhin,3329,1606,1723,48.24
Viktor,Nami,1723,806,917,46.78
Viktor,Sett,2443,1227,1216,50.23
Viktor,Rammus,484,244,240,50.41
Viktor,Chogath,1912,964,948,50.42
Viktor,Yasuo,2812,1485,1327,52.81
Viktor,Nautilus,1920,993,927,51.72
Viktor,Ahri,1996,998,998,50
Viktor,Zilean,516,266,250,51.55
Viktor,Aurora,1520,795,725,52.3
Viktor,Annie,529,242,287,45.75
Viktor,Elise,1299,591,708,45.5
Viktor,Ashe,3254,1587,1667,48.77
Viktor,Camille,681,294,387,43.17
Viktor,Kayn,2168,1103,1065,50.88
Viktor,Zeri,725,397,328,54.76
Viktor,Illaoi,690,351,339,50.87
Viktor,Volibear,1687,831,856,49.26
Viktor,Naafiri,517,233,284,45.07
Viktor,Lux,3929,1958,1971,49.83
Viktor,Yorick,1312,592,720,45.12
Viktor,Mordekaiser,1930,933,997,48.34
Viktor,Evelynn,684,309,375,45.18
Viktor,Tristana,1442,736,706,51.04
Viktor,Sylas,2247,1107,1140,49.27
Viktor,Shen,1060,568,492,53.58
Viktor,MasterYi,1810,862,948,47.62
Viktor,TahmKench,1426,685,741,48.04
Viktor,Malphite,1468,745,723,50.75
Viktor,Viego,2352,1201,1151,51.06
Viktor,Galio,1385,693,692,50.04
Viktor,Samira,1137,596,541,52.42
Viktor,Braum,935,465,470,49.73
Viktor,Jax,1444,725,719,50.21
Viktor,Graves,1050,516,534,49.14
Viktor,Irelia,1419,722,697,50.88
Viktor,Caitlyn,4280,2107,2173,49.23
Viktor,Soraka,971,464,507,47.79
Viktor,Kindred,720,369,351,51.25
Viktor,Talon,1067,534,533,50.05
Viktor,Varus,1407,724,683,51.46
Viktor,Lulu,2271,1231,1040,54.21
Viktor,Sejuani,726,303,423,41.74
Viktor,Aphelios,876,473,403,54
Viktor,Velkoz,1048,496,552,47.33
Viktor,MonkeyKing,1174,603,571,51.36
Viktor,Vladimir,930,529,401,56.88
Viktor,MissFortune,3206,1546,1660,48.22
Viktor,Shaco,1468,804,664,54.77
Viktor,Ekko,1600,799,801,49.94
Viktor,Bard,536,267,269,49.81
Viktor,Orianna,953,519,434,54.46
Viktor,Pantheon,2679,1264,1415,47.18
Viktor,Riven,729,367,362,50.34
Viktor,Yone,2995,1529,1466,51.05
Viktor,Akshan,589,314,275,53.31
Viktor,Xayah,781,394,387,50.45
Viktor,Rakan,682,334,348,48.97
Viktor,Sion,1204,637,567,52.91
Viktor,Nidalee,519,315,204,60.69
Viktor,KSante,894,519,375,58.05
Viktor,Ambessa,1203,590,613,49.04
Viktor,Vi,1584,783,801,49.43
Viktor,Corki,705,362,343,51.35
Viktor,Zyra,1594,794,800,49.81
Viktor,Heimerdinger,677,331,346,48.89
Viktor,Briar,1144,578,566,50.52
Viktor,Taric,369,169,200,45.8
Viktor,Jayce,893,467,426,52.3
Viktor,Nasus,1175,595,580,50.64
Viktor,Cassiopeia,600,287,313,47.83
Viktor,Alistar,731,380,351,51.98
Viktor,Pyke,1372,737,635,53.72
Viktor,Lillia,979,509,470,51.99
Viktor,Draven,841,415,426,49.35
Viktor,Milio,1049,510,539,48.62
Viktor,Zoe,652,323,329,49.54
Viktor,Nilah,504,203,301,40.28
Viktor,Gnar,758,367,391,48.42
Viktor,Zed,1629,853,776,52.36
Viktor,Trundle,833,404,429,48.5
Viktor,Veigar,1814,839,975,46.25
Viktor,Warwick,2024,975,1049,48.17
Viktor,Thresh,2317,1178,1139,50.84
Viktor,Blitzcrank,1216,668,548,54.93
Viktor,Sona,531,263,268,49.53
Viktor,Taliyah,383,158,225,41.25
Viktor,XinZhao,1070,499,571,46.64
Viktor,Brand,1172,600,572,51.19
Viktor,Shyvana,391,209,182,53.45
Viktor,Vayne,2046,1033,1013,50.49
Viktor,Morgana,1881,895,986,47.58
Viktor,Teemo,1879,891,988,47.42
Viktor,Xerath,1529,727,802,47.55
Viktor,Renekton,811,421,390,51.91
Viktor,FiddleSticks,778,383,395,49.23
Viktor,Akali,1859,881,978,47.39
Viktor,Singed,446,219,227,49.1
Viktor,Smolder,1163,640,523,55.03
Viktor,Karma,2084,991,1093,47.55
Viktor,Kayle,1100,550,550,50
Viktor,Janna,609,305,304,50.08
Viktor,Fizz,841,429,412,51.01
Viktor,Rell,850,455,395,53.53
Viktor,Vex,937,459,478,48.99
Viktor,Karthus,437,211,226,48.28
Viktor,Neeko,832,419,413,50.36
Viktor,Nunu,959,434,525,45.26
Viktor,Kassadin,348,137,211,39.37
Viktor,Swain,1618,743,875,45.92
Viktor,Nocturne,1790,896,894,50.06
Viktor,Maokai,922,458,464,49.67
Viktor,Diana,2423,1184,1239,48.87
Viktor,Ezreal,4184,2158,2026,51.58
Viktor,Kalista,533,302,231,56.66
Viktor,Aatrox,1490,779,711,52.28
Viktor,Ryze,646,342,304,52.94
Viktor,Rengar,587,296,291,50.43
Viktor,Leblanc,900,522,378,58
Viktor,Renata,355,194,161,54.65
Viktor,JarvanIV,972,505,467,51.95
Viktor,Anivia,580,242,338,41.72
Viktor,AurelionSol,688,320,368,46.51
Viktor,Sivir,927,435,492,46.93
Viktor,Azir,638,360,278,56.43
Viktor,Olaf,398,185,213,46.48
Viktor,Garen,2480,1179,1301,47.54
Viktor,Ornn,735,370,365,50.34
Viktor,Lissandra,529,265,264,50.09
Viktor,DrMundo,889,451,438,50.73
Viktor,Hecarim,717,330,387,46.03
Viktor,Syndra,1290,626,664,48.53
Viktor,Urgot,879,415,464,47.21
Viktor,RekSai,205,100,105,48.78
Viktor,Gwen,930,484,446,52.04
Viktor,Udyr,646,357,289,55.26
Viktor,Rumble,406,199,207,49.01
Viktor,KogMaw,522,262,260,50.19
Viktor,Quinn,584,265,319,45.38
Viktor,Belveth,398,206,192,51.76
Viktor,Kled,346,192,154,55.49
Viktor,Khazix,965,500,465,51.81
Viktor,Qiyana,472,225,247,47.67
Pyke,Renekton,885,396,489,44.75
Pyke,Kayn,2659,1188,1471,44.68
Pyke,Katarina,1416,686,730,48.45
Pyke,Draven,897,464,433,51.73
Pyke,Yuumi,1643,698,945,42.48
Pyke,Gangplank,796,421,375,52.89
Pyke,Gragas,951,446,505,46.9
Pyke,TwistedFate,656,331,325,50.46
Pyke,Lucian,1262,561,701,44.45
Pyke,Leona,1544,762,782,49.35
Pyke,TahmKench,1620,761,859,46.98
Pyke,Malphite,1836,759,1077,41.34
Pyke,Yasuo,3600,1718,1882,47.72
Pyke,Aphelios,1062,506,556,47.65
Pyke,Mordekaiser,2449,1131,1318,46.18
Pyke,Briar,1476,635,841,43.02
Pyke,Ryze,601,277,324,46.09
Pyke,Vex,951,435,516,45.74
Pyke,Naafiri,764,364,400,47.64
Pyke,Yone,3596,1808,1788,50.28
Pyke,MissFortune,3804,1817,1987,47.77
Pyke,Senna,1416,690,726,48.73
Pyke,Viego,2624,1193,1431,45.46
Pyke,Kindred,994,521,473,52.41
Pyke,Jhin,3590,1628,1962,45.35
Pyke,Sett,2807,1305,1502,46.49
Pyke,Talon,1076,489,587,45.45
Pyke,FiddleSticks,906,450,456,49.67
Pyke,Ashe,3526,1664,1862,47.19
Pyke,Blitzcrank,1456,729,727,50.07
Pyke,Warwick,2718,1299,1419,47.79
Pyke,Singed,425,190,235,44.71
Pyke,Samira,1432,677,755,47.28
Pyke,Soraka,1033,442,591,42.79
Pyke,Shen,1211,549,662,45.33
Pyke,Diana,2574,1294,1280,50.27
Pyke,DrMundo,1041,467,574,44.86
Pyke,Ivern,283,138,145,48.76
Pyke,Nilah,759,302,457,39.79
Pyke,Nocturne,1908,996,912,52.2
Pyke,Lissandra,501,228,273,45.51
Pyke,Lux,5085,2571,2514,50.56
Pyke,Darius,3202,1588,1614,49.59
Pyke,Poppy,1311,618,693,47.14
Pyke,Sylas,2536,1243,1293,49.01
Pyke,Rell,920,423,497,45.98
Pyke,Fizz,973,425,548,43.68
Pyke,Gnar,686,339,347,49.42
Pyke,Caitlyn,4744,2299,2445,48.46
Pyke,Neeko,1063,474,589,44.59
Pyke,Irelia,1563,664,899,42.48
Pyke,Tryndamere,1046,546,500,52.2
Pyke,Amumu,1806,854,952,47.29
Pyke,Mel,3799,1892,1907,49.8
Pyke,Kaisa,2868,1316,1552,45.89
Pyke,Seraphine,1392,718,674,51.58
Pyke,Zed,1946,929,1017,47.74
Pyke,Nunu,1240,565,675,45.56
Pyke,KSante,836,400,436,47.85
Pyke,Zeri,813,385,428,47.36
Pyke,Lulu,1906,899,1007,47.17
Pyke,Azir,661,308,353,46.6
Pyke,Sejuani,740,336,404,45.41
Pyke,Udyr,710,331,379,46.62
Pyke,Evelynn,843,403,440,47.81
Pyke,Khazix,1029,539,490,52.38
Pyke,Camille,622,352,270,56.59
Pyke,LeeSin,2563,1278,1285,49.86
Pyke,Jax,1911,939,972,49.14
Pyke,JarvanIV,777,367,410,47.23
Pyke,Hwei,1339,646,693,48.24
Pyke,Bard,517,232,285,44.87
Pyke,Morgana,2151,1031,1120,47.93
Pyke,Ambessa,1042,486,556,46.64
Pyke,XinZhao,1057,471,586,44.56
Pyke,Volibear,2168,920,1248,42.44
Pyke,Xerath,1462,725,737,49.59
Pyke,Ezreal,4169,2034,2135,48.79
Pyke,Heimerdinger,920,416,504,45.22
Pyke,Aatrox,1592,680,912,42.71
Pyke,Taric,391,141,250,36.06
Pyke,Varus,1575,719,856,45.65
Pyke,Garen,2699,1172,1527,43.42
Pyke,Ekko,1615,759,856,47
Pyke,Ahri,2392,1214,1178,50.75
Pyke,Jinx,4609,2259,2350,49.01
Pyke,Zilean,495,248,247,50.1
Pyke,Chogath,2220,973,1247,43.83
Pyke,Yorick,1708,722,986,42.27
Pyke,Thresh,2713,1290,1423,47.55
Pyke,Trundle,954,436,518,45.7
Pyke,MasterYi,2108,1023,1085,48.53
Pyke,Sivir,1103,463,640,41.98
Pyke,Tristana,1813,820,993,45.23
Pyke,Gwen,1033,471,562,45.6
Pyke,Maokai,898,417,481,46.44
Pyke,Veigar,1893,834,1059,44.06
Pyke,Brand,1310,617,693,47.1
Pyke,Urgot,837,386,451,46.12
Pyke,Zyra,1388,651,737,46.9
Pyke,Malzahar,1606,687,919,42.78
Pyke,Quinn,635,305,330,48.03
Pyke,Teemo,2589,1187,1402,45.85
Pyke,Galio,1443,740,703,51.28
Pyke,Nasus,1277,546,731,42.76
Pyke,AurelionSol,782,349,433,44.63
Pyke,Qiyana,524,239,285,45.61
Pyke,Nami,1600,772,828,48.25
Pyke,Orianna,790,373,417,47.22
Pyke,RekSai,250,150,100,60
Pyke,Shaco,1641,792,849,48.26
Pyke,Kayle,1352,608,744,44.97
Pyke,Aurora,1454,657,797,45.19
Pyke,Fiora,714,324,390,45.38
Pyke,Nautilus,2216,975,1241,44
Pyke,Akali,2076,986,1090,47.5
Pyke,Hecarim,720,334,386,46.39
Pyke,Smolder,1258,623,635,49.52
Pyke,Pantheon,3321,1544,1777,46.49
Pyke,MonkeyKing,1114,468,646,42.01
Pyke,Vladimir,1012,479,533,47.33
Pyke,Twitch,1243,604,639,48.59
Pyke,Anivia,554,291,263,52.53
Pyke,Ziggs,670,333,337,49.7
Pyke,Elise,1308,597,711,45.64
Pyke,Leblanc,943,414,529,43.9
Pyke,Vi,1571,714,857,45.45
Pyke,Xayah,861,436,425,50.64
Pyke,Zac,708,349,359,49.29
Pyke,Lillia,975,457,518,46.87
Pyke,Rammus,696,297,399,42.67
Pyke,Illaoi,880,416,464,47.27
Pyke,Belveth,414,160,254,38.65
Pyke,Zoe,737,365,372,49.53
Pyke,Viktor,1372,635,737,46.28
Pyke,Milio,907,435,472,47.96
Pyke,Nidalee,485,218,267,44.95
Pyke,Kled,380,159,221,41.84
Pyke,Annie,547,247,300,45.16
Pyke,Olaf,417,179,238,42.93
Pyke,Swain,1818,796,1022,43.78
Pyke,Vayne,1953,930,1023,47.62
Pyke,Riven,744,405,339,54.44
Pyke,Kassadin,370,179,191,48.38
Pyke,Sion,1282,606,676,47.27
Pyke,Rengar,683,381,302,55.78
Pyke,Akshan,573,266,307,46.42
Pyke,Rakan,891,426,465,47.81
Pyke,Skarner,514,326,188,63.42
Pyke,Jayce,855,426,429,49.82
Pyke,Janna,586,274,312,46.76
Pyke,Graves,1181,569,612,48.18
Pyke,Syndra,1035,481,554,46.47
Pyke,Shyvana,452,209,243,46.24
Pyke,Karma,1881,859,1022,45.67
Pyke,Corki,732,344,388,46.99
Pyke,Ornn,742,341,401,45.96
Pyke,Kennen,516,239,277,46.32
Pyke,Renata,300,161,139,53.67
Pyke,Alistar,721,371,350,51.46
Pyke,Karthus,439,212,227,48.29
Pyke,Rumble,474,251,223,52.95
Pyke,Braum,1032,450,582,43.6
Pyke,Cassiopeia,619,300,319,48.47
Pyke,KogMaw,511,251,260,49.12
Pyke,Taliyah,401,176,225,43.89
Pyke,Sona,570,227,343,39.82
Pyke,Kalista,575,263,312,45.74
Pyke,Velkoz,988,480,508,48.58
Renekton,Yone,2245,1296,949,57.73
Renekton,Shaco,868,435,433,50.12
Renekton,Mel,2150,1037,1113,48.23
Renekton,Tristana,914,466,448,50.98
Renekton,Pyke,885,489,396,55.25
Renekton,Aurora,885,452,433,51.07
Renekton,Volibear,1113,528,585,47.44
Renekton,Yasuo,2532,1295,1237,51.15
Renekton,Vayne,1128,543,585,48.14
Renekton,Swain,941,406,535,43.15
Renekton,Malzahar,836,401,435,47.97
Renekton,Irelia,745,405,340,54.36
Renekton,Kalista,358,161,197,44.97
Renekton,Poppy,698,330,368,47.28
Renekton,Smolder,692,368,324,53.18
Renekton,Ekko,931,457,474,49.09
Renekton,Mordekaiser,1296,574,722,44.29
Renekton,Yuumi,748,410,338,54.81
Renekton,Jax,943,500,443,53.02
Renekton,FiddleSticks,406,187,219,46.06
Renekton,Cassiopeia,308,123,185,39.94
Renekton,Caitlyn,2443,1223,1220,50.06
Renekton,Milio,494,224,270,45.34
Renekton,Tryndamere,429,215,214,50.12
Renekton,Diana,1496,737,759,49.26
Renekton,Lux,2331,1145,1186,49.12
Renekton,Sivir,449,206,243,45.88
Renekton,Soraka,554,258,296,46.57
Renekton,Kayn,1302,623,679,47.85
Renekton,Ezreal,2335,1215,1120,52.03
Renekton,Brand,534,285,249,53.37
Renekton,Nunu,612,294,318,48.04
Renekton,Kaisa,1675,893,782,53.31
Renekton,Nami,985,412,573,41.83
Renekton,Camille,404,177,227,43.81
Renekton,Katarina,816,424,392,51.96
Renekton,Zeri,474,219,255,46.2
Renekton,Rengar,346,207,139,59.83
Renekton,Akali,1018,540,478,53.05
Renekton,Lucian,607,309,298,50.91
Renekton,Viego,1517,788,729,51.94
Renekton,Samira,804,397,407,49.38
Renekton,Leona,889,427,462,48.03
Renekton,Shen,528,242,286,45.83
Renekton,Leblanc,538,267,271,49.63
Renekton,Hwei,622,272,350,43.73
Renekton,Kayle,541,302,239,55.82
Renekton,Janna,315,182,133,57.78
Renekton,Zoe,421,167,254,39.67
Renekton,Gragas,531,270,261,50.85
Renekton,Garen,1637,722,915,44.11
Renekton,Nilah,379,196,183,51.72
Renekton,Thresh,1424,740,684,51.97
Renekton,Kennen,272,138,134,50.74
Renekton,Evelynn,321,171,150,53.27
Renekton,Trundle,586,306,280,52.22
Renekton,Rammus,301,123,178,40.86
Renekton,Sylas,1362,694,668,50.95
Renekton,Xayah,552,266,286,48.19
Renekton,Blitzcrank,802,392,410,48.88
Renekton,MonkeyKing,608,294,314,48.36
Renekton,Vex,553,260,293,47.02
Renekton,Jhin,1984,938,1046,47.28
Renekton,Nautilus,1140,594,546,52.11
Renekton,Darius,1888,918,970,48.62
Renekton,Senna,740,385,355,52.03
Renekton,Ashe,2010,984,1026,48.96
Renekton,Sion,607,279,328,45.96
Renekton,Nidalee,327,187,140,57.19
Renekton,Jinx,2420,1228,1192,50.74
Renekton,KSante,582,312,270,53.61
Renekton,Sejuani,460,205,255,44.57
Renekton,Zed,1036,546,490,52.7
Renekton,Naafiri,362,158,204,43.65
Renekton,Draven,535,237,298,44.3
Renekton,Veigar,983,520,463,52.9
Renekton,Neeko,505,249,256,49.31
Renekton,Nasus,790,386,404,48.86
Renekton,Gangplank,375,175,200,46.67
Renekton,Belveth,234,132,102,56.41
Renekton,Maokai,430,245,185,56.98
Renekton,Riven,676,383,293,56.66
Renekton,Karma,1135,544,591,47.93
Renekton,Ambessa,1015,569,446,56.06
Renekton,Graves,660,293,367,44.39
Renekton,Ahri,1340,656,684,48.96
Renekton,Teemo,931,375,556,40.28
Renekton,Briar,676,315,361,46.6
Renekton,Rakan,425,205,220,48.24
Renekton,Jayce,451,230,221,51
Renekton,LeeSin,1549,761,788,49.13
Renekton,Zilean,291,161,130,55.33
Renekton,Fiora,334,173,161,51.8
Renekton,Elise,832,404,428,48.56
Renekton,Pantheon,1667,874,793,52.43
Renekton,Khazix,476,198,278,41.6
Renekton,Braum,578,244,334,42.21
Renekton,Velkoz,624,274,350,43.91
Renekton,Malphite,844,411,433,48.7
Renekton,Lillia,619,301,318,48.63
Renekton,Ryze,344,183,161,53.2
Renekton,Vi,983,534,449,54.32
Renekton,Fizz,559,276,283,49.37
Renekton,Vladimir,675,338,337,50.07
Renekton,Kled,202,86,116,42.57
Renekton,Morgana,1156,577,579,49.91
Renekton,Seraphine,739,387,352,52.37
Renekton,Sett,1825,845,980,46.3
Renekton,Viktor,811,390,421,48.09
Renekton,Aatrox,1107,643,464,58.08
Renekton,Warwick,1424,704,720,49.44
Renekton,Xerath,844,433,411,51.3
Renekton,Olaf,192,112,80,58.33
Renekton,MissFortune,2051,994,1057,48.46
Renekton,Kindred,383,194,189,50.65
Renekton,Gnar,427,221,206,51.76
Renekton,Karthus,232,127,105,54.74
Renekton,Twitch,829,412,417,49.7
Renekton,JarvanIV,638,307,331,48.12
Renekton,Bard,356,160,196,44.94
Renekton,Udyr,342,171,171,50
Renekton,MasterYi,1083,561,522,51.8
Renekton,Annie,352,167,185,47.44
Renekton,Zyra,788,381,407,48.35
Renekton,Gwen,517,255,262,49.32
Renekton,Syndra,617,254,363,41.17
Renekton,Ziggs,367,175,192,47.68
Renekton,Singed,179,74,105,41.34
Renekton,Alistar,406,227,179,55.91
Renekton,Sona,339,173,166,51.03
Renekton,RekSai,130,77,53,59.23
Renekton,Quinn,405,168,237,41.48
Renekton,DrMundo,416,214,202,51.44
Renekton,Nocturne,974,484,490,49.69
Renekton,Orianna,449,250,199,55.68
Renekton,Galio,826,409,417,49.52
Renekton,Illaoi,562,228,334,40.57
Renekton,TwistedFate,358,165,193,46.09
Renekton,TahmKench,793,431,362,54.35
Renekton,Rell,497,294,203,59.15
Renekton,Kassadin,228,104,124,45.61
Renekton,KogMaw,289,126,163,43.6
Renekton,Shyvana,199,84,115,42.21
Renekton,Azir,344,170,174,49.42
Renekton,Akshan,343,178,165,51.9
Renekton,Yorick,1008,442,566,43.85
Renekton,Corki,402,200,202,49.75
Renekton,Lulu,1128,498,630,44.15
Renekton,Talon,669,373,296,55.75
Renekton,Chogath,1029,470,559,45.68
Renekton,Qiyana,273,157,116,57.51
Renekton,XinZhao,634,312,322,49.21
Renekton,Heimerdinger,387,198,189,51.16
Renekton,Amumu,1012,484,528,47.83
Renekton,Urgot,478,213,265,44.56
Renekton,Lissandra,343,157,186,45.77
Renekton,Zac,602,349,253,57.97
Renekton,Renata,195,112,83,57.44
Renekton,Ornn,372,160,212,43.01
Renekton,Skarner,376,203,173,53.99
Renekton,Varus,845,393,452,46.51
Renekton,Taric,222,108,114,48.65
Renekton,Taliyah,276,127,149,46.01
Renekton,Hecarim,385,204,181,52.99
Renekton,AurelionSol,372,178,194,47.85
Renekton,Anivia,294,140,154,47.62
Renekton,Rumble,221,89,132,40.27
Renekton,Aphelios,524,244,280,46.56
Renekton,Ivern,173,77,96,44.51
Kayn,Yone,5632,2981,2651,52.93
Kayn,Shaco,2825,1493,1332,52.85
Kayn,Mel,6121,3198,2923,52.25
Kayn,Tristana,2865,1433,1432,50.02
Kayn,Pyke,2659,1471,1188,55.32
Kayn,Gwen,1441,750,691,52.05
Kayn,Vi,2786,1390,1396,49.89
Kayn,Zed,3363,1739,1624,51.71
Kayn,Jhin,5796,3004,2792,51.83
Kayn,Soraka,1707,785,922,45.99
Kayn,Aatrox,2594,1396,1198,53.82
Kayn,Brand,2230,1174,1056,52.65
Kayn,Irelia,2656,1339,1317,50.41
Kayn,Caitlyn,7701,3740,3961,48.57
Kayn,Milio,1717,711,1006,41.41
Kayn,Teemo,3858,1791,2067,46.42
Kayn,Warwick,4999,2251,2748,45.03
Kayn,Azir,805,445,360,55.28
Kayn,MissFortune,6817,3493,3324,51.24
Kayn,Neeko,1636,865,771,52.87
Kayn,Trundle,1707,883,824,51.73
Kayn,MasterYi,3888,1773,2115,45.6
Kayn,Veigar,3221,1529,1692,47.47
Kayn,Gangplank,1273,654,619,51.37
Kayn,Ivern,472,251,221,53.18
Kayn,Swain,2836,1386,1450,48.87
Kayn,Ornn,1280,593,687,46.33
Kayn,Udyr,1236,681,555,55.1
Kayn,Lux,7736,3794,3942,49.04
Kayn,Ezreal,5876,3035,2841,51.65
Kayn,Singed,821,424,397,51.64
Kayn,Graves,1838,891,947,48.48
Kayn,Fizz,1805,870,935,48.2
Kayn,Ziggs,1133,575,558,50.75
Kayn,Pantheon,4846,2543,2303,52.48
Kayn,XinZhao,1674,847,827,50.6
Kayn,Yasuo,5999,3068,2931,51.14
Kayn,Jinx,7614,3693,3921,48.5
Kayn,FiddleSticks,1599,769,830,48.09
Kayn,Akali,3012,1634,1378,54.25
Kayn,Twitch,2480,1219,1261,49.15
Kayn,Senna,2185,1118,1067,51.17
Kayn,Riven,1278,671,607,52.5
Kayn,Amumu,3144,1508,1636,47.96
Kayn,Zoe,1152,566,586,49.13
Kayn,Sona,1018,467,551,45.87
Kayn,Heimerdinger,1512,701,811,46.36
Kayn,Talon,1639,908,731,55.4
Kayn,Ahri,3752,1808,1944,48.19
Kayn,Kalista,929,488,441,52.53
Kayn,Sett,4596,2193,2403,47.72
Kayn,Ashe,5427,2837,2590,52.28
Kayn,Blitzcrank,2169,1143,1026,52.7
Kayn,Mordekaiser,4228,2039,2189,48.23
Kayn,Sylas,3359,1815,1544,54.03
Kayn,Xayah,1500,656,844,43.73
Kayn,Smolder,1938,999,939,51.55
Kayn,Ekko,2751,1306,1445,47.47
Kayn,Yuumi,2413,1193,1220,49.44
Kayn,Cassiopeia,902,479,423,53.1
Kayn,Nasus,2179,1058,1121,48.55
Kayn,MonkeyKing,1898,897,1001,47.26
Kayn,Zac,1306,707,599,54.13
Kayn,Shen,1965,1003,962,51.04
Kayn,Diana,4903,2458,2445,50.13
Kayn,Samira,2504,1244,1260,49.68
Kayn,Camille,977,487,490,49.85
Kayn,Katarina,2319,1202,1117,51.83
Kayn,Zyra,2436,1193,1243,48.97
Kayn,Lulu,3196,1550,1646,48.5
Kayn,Volibear,3626,1857,1769,51.21
Kayn,Vayne,3494,1668,1826,47.74
Kayn,Briar,2560,1212,1348,47.34
Kayn,Nautilus,3151,1678,1473,53.25
Kayn,Darius,5692,2845,2847,49.98
Kayn,Maokai,1425,739,686,51.86
Kayn,Malphite,2977,1525,1452,51.23
Kayn,Sion,2221,1153,1068,51.91
Kayn,Alistar,1038,569,469,54.82
Kayn,Rammus,964,503,461,52.18
Kayn,Sivir,1430,705,725,49.3
Kayn,Xerath,2492,1245,1247,49.96
Kayn,Gragas,1585,848,737,53.5
Kayn,LeeSin,3639,2032,1607,55.84
Kayn,Shyvana,809,338,471,41.78
Kayn,Nilah,1185,593,592,50.04
Kayn,Nami,2904,1398,1506,48.14
Kayn,Sejuani,1244,668,576,53.7
Kayn,Tryndamere,1795,891,904,49.64
Kayn,TahmKench,2530,1331,1199,52.61
Kayn,Naafiri,1131,539,592,47.66
Kayn,Jax,2710,1363,1347,50.3
Kayn,Morgana,3649,1756,1893,48.12
Kayn,Galio,2270,1125,1145,49.56
Kayn,Illaoi,1510,667,843,44.17
Kayn,Leona,2603,1251,1352,48.06
Kayn,Vex,1599,762,837,47.65
Kayn,Thresh,3694,1823,1871,49.35
Kayn,Nocturne,3460,1604,1856,46.36
Kayn,Orianna,1214,574,640,47.28
Kayn,Khazix,1639,812,827,49.54
Kayn,Varus,2321,1219,1102,52.52
Kayn,Malzahar,2873,1267,1606,44.1
Kayn,Renekton,1302,679,623,52.15
Kayn,Viego,4398,2311,2087,52.55
Kayn,Skarner,862,481,381,55.8
Kayn,DrMundo,1713,800,913,46.7
Kayn,Hwei,1884,975,909,51.75
Kayn,Aurora,1960,972,988,49.59
Kayn,Lillia,1726,865,861,50.12
Kayn,Lissandra,900,423,477,47
Kayn,Garen,4546,2241,2305,49.3
Kayn,TwistedFate,1006,487,519,48.41
Kayn,Annie,889,466,423,52.42
Kayn,Olaf,605,312,293,51.57
Kayn,Fiora,1165,599,566,51.42
Kayn,Kaisa,4251,2212,2039,52.03
Kayn,Ryze,840,366,474,43.57
Kayn,Rengar,1186,663,523,55.9
Kayn,Syndra,1821,912,909,50.08
Kayn,JarvanIV,1529,749,780,48.99
Kayn,Lucian,1887,934,953,49.5
Kayn,Karthus,844,469,375,55.57
Kayn,Karma,2771,1381,1390,49.84
Kayn,Gnar,1046,543,503,51.91
Kayn,AurelionSol,1093,555,538,50.78
Kayn,Vladimir,1904,929,975,48.79
Kayn,Hecarim,1163,559,604,48.07
Kayn,Viktor,2168,1065,1103,49.12
Kayn,Leblanc,1340,705,635,52.61
Kayn,Poppy,1693,755,938,44.6
Kayn,Kayle,1935,959,976,49.56
Kayn,Janna,1009,452,557,44.8
Kayn,Ambessa,1749,972,777,55.57
Kayn,Zilean,914,453,461,49.56
Kayn,Taric,646,297,349,45.98
Kayn,Braum,1606,805,801,50.12
Kayn,Elise,1948,1019,929,52.31
Kayn,Nidalee,743,456,287,61.37
Kayn,Aphelios,1689,907,782,53.7
Kayn,Rakan,1372,676,696,49.27
Kayn,Yorick,2895,1399,1496,48.32
Kayn,Evelynn,1172,613,559,52.3
Kayn,RekSai,324,133,191,41.05
Kayn,Kennen,799,365,434,45.68
Kayn,Velkoz,1791,945,846,52.76
Kayn,KSante,1248,719,529,57.61
Kayn,Jayce,1094,569,525,52.01
Kayn,Renata,604,323,281,53.48
Kayn,Kindred,1500,778,722,51.87
Kayn,Qiyana,793,460,333,58.01
Kayn,Rell,1435,726,709,50.59
Kayn,Akshan,1092,462,630,42.31
Kayn,Nunu,1819,965,854,53.05
Kayn,KogMaw,906,457,449,50.44
Kayn,Corki,1256,706,550,56.21
Kayn,Chogath,3594,1856,1738,51.64
Kayn,Urgot,1510,658,852,43.58
Kayn,Kled,531,231,300,43.5
Kayn,Seraphine,2454,1218,1236,49.63
Kayn,Draven,1563,777,786,49.71
Kayn,Kassadin,623,367,256,58.91
Kayn,Belveth,677,367,310,54.21
Kayn,Taliyah,688,339,349,49.27
Kayn,Zeri,1038,524,514,50.48
Kayn,Anivia,934,453,481,48.5
Kayn,Bard,833,428,405,51.38
Kayn,Rumble,702,385,317,54.84
Kayn,Quinn,1064,468,596,43.98
Draven,Yone,1854,954,900,51.46
Draven,Shaco,1002,523,479,52.2
Draven,Mel,2289,1223,1066,53.43
Draven,Tristana,966,496,470,51.35
Draven,Pyke,897,433,464,48.27
Draven,Talon,605,280,325,46.28
Draven,Aurora,857,439,418,51.23
Draven,Yasuo,2041,917,1124,44.93
Draven,Alistar,465,213,252,45.81
Draven,Gangplank,539,263,276,48.79
Draven,MasterYi,1068,518,550,48.5
Draven,Veigar,1189,537,652,45.16
Draven,Swain,957,403,554,42.11
Draven,AurelionSol,383,170,213,44.39
Draven,Ashe,2148,1061,1087,49.39
Draven,Velkoz,717,359,358,50.07
Draven,Aatrox,996,599,397,60.14
Draven,Viego,1378,618,760,44.85
Draven,Sylas,1194,575,619,48.16
Draven,Blitzcrank,655,379,276,57.86
Draven,Urgot,601,278,323,46.26
Draven,LeeSin,1352,679,673,50.22
Draven,TwistedFate,491,247,244,50.31
Draven,Rakan,443,172,271,38.83
Draven,Evelynn,384,185,199,48.18
Draven,Irelia,916,438,478,47.82
Draven,Lux,2721,1328,1393,48.81
Draven,Jax,832,372,460,44.71
Draven,Graves,674,344,330,51.04
Draven,Katarina,864,456,408,52.78
Draven,Twitch,873,458,415,52.46
Draven,Seraphine,845,434,411,51.36
Draven,Kalista,382,204,178,53.4
Draven,Gragas,701,346,355,49.36
Draven,Orianna,415,233,182,56.14
Draven,Gnar,391,209,182,53.45
Draven,Fiora,421,178,243,42.28
Draven,Ekko,961,493,468,51.3
Draven,Kassadin,186,96,90,51.61
Draven,Caitlyn,2707,1287,1420,47.54
Draven,TahmKench,873,431,442,49.37
Draven,Akali,950,515,435,54.21
Draven,Zac,478,227,251,47.49
Draven,Diana,1547,723,824,46.74
Draven,Vayne,1408,662,746,47.02
Draven,Mordekaiser,1306,633,673,48.47
Draven,Zeri,446,204,242,45.74
Draven,Sett,1498,623,875,41.59
Draven,Volibear,1243,615,628,49.48
Draven,KogMaw,319,184,135,57.68
Draven,Gwen,554,269,285,48.56
Draven,JarvanIV,630,332,298,52.7
Draven,Senna,804,408,396,50.75
Draven,Pantheon,1657,864,793,52.14
Draven,Vex,473,212,261,44.82
Draven,Kaisa,1637,894,743,54.61
Draven,Poppy,579,276,303,47.67
Draven,Warwick,1615,794,821,49.16
Draven,Ryze,358,163,195,45.53
Draven,Garen,1469,696,773,47.38
Draven,Briar,898,426,472,47.44
Draven,Malzahar,982,455,527,46.33
Draven,Fizz,576,270,306,46.88
Draven,Teemo,1320,630,690,47.73
Draven,Zoe,446,243,203,54.48
Draven,Darius,1981,936,1045,47.25
Draven,Qiyana,313,175,138,55.91
Draven,Ziggs,419,186,233,44.39
Draven,MissFortune,2396,1187,1209,49.54
Draven,Nami,1242,587,655,47.26
Draven,RekSai,129,81,48,62.79
Draven,Brand,787,389,398,49.43
Draven,Vladimir,644,302,342,46.89
Draven,Soraka,689,334,355,48.48
Draven,Cassiopeia,354,176,178,49.72
Draven,Karma,1072,539,533,50.28
Draven,Chogath,1231,585,646,47.52
Draven,Aphelios,591,288,303,48.73
Draven,Smolder,722,376,346,52.08
Draven,Hwei,766,405,361,52.87
Draven,Milio,607,254,353,41.85
Draven,KSante,494,262,232,53.04
Draven,Nautilus,1161,531,630,45.74
Draven,Kayle,765,336,429,43.92
Draven,Amumu,1056,471,585,44.6
Draven,Janna,358,190,168,53.07
Draven,DrMundo,575,245,330,42.61
Draven,Kindred,561,308,253,54.9
Draven,Rell,508,242,266,47.64
Draven,Renekton,535,298,237,55.7
Draven,Zilean,274,127,147,46.35
Draven,Nocturne,1139,536,603,47.06
Draven,Lucian,696,405,291,58.19
Draven,Udyr,451,195,256,43.24
Draven,Annie,372,185,187,49.73
Draven,Maokai,463,240,223,51.84
Draven,Trundle,555,255,300,45.95
Draven,Samira,921,442,479,47.99
Draven,Yorick,1036,408,628,39.38
Draven,Neeko,557,256,301,45.96
Draven,Leblanc,560,295,265,52.68
Draven,Hecarim,528,271,257,51.33
Draven,MonkeyKing,674,357,317,52.97
Draven,Ezreal,2229,1062,1167,47.64
Draven,Malphite,1017,468,549,46.02
Draven,Heimerdinger,472,221,251,46.82
Draven,Naafiri,341,159,182,46.63
Draven,Thresh,1542,691,851,44.81
Draven,Viktor,841,426,415,50.65
Draven,Nunu,637,307,330,48.19
Draven,Shen,685,333,352,48.61
Draven,Singed,305,135,170,44.26
Draven,Lulu,1197,629,568,52.55
Draven,Sejuani,405,208,197,51.36
Draven,Leona,857,385,472,44.92
Draven,Azir,375,198,177,52.8
Draven,Sivir,478,238,240,49.79
Draven,Sion,850,413,437,48.59
Draven,Jinx,2761,1323,1438,47.92
Draven,Ahri,1212,607,605,50.08
Draven,Ambessa,622,376,246,60.45
Draven,Morgana,1183,596,587,50.38
Draven,Kayn,1563,786,777,50.29
Draven,Jhin,2119,988,1131,46.63
Draven,Lissandra,325,126,199,38.77
Draven,Syndra,736,349,387,47.42
Draven,Illaoi,426,186,240,43.66
Draven,Taliyah,270,112,158,41.48
Draven,Zyra,792,332,460,41.92
Draven,Riven,605,308,297,50.91
Draven,XinZhao,643,279,364,43.39
Draven,Kennen,319,173,146,54.23
Draven,Elise,630,305,325,48.41
Draven,Zed,1098,573,525,52.19
Draven,Braum,744,362,382,48.66
Draven,Anivia,329,161,168,48.94
Draven,Varus,931,462,469,49.62
Draven,Lillia,619,330,289,53.31
Draven,Nilah,359,160,199,44.57
Draven,Olaf,280,156,124,55.71
Draven,Rengar,395,205,190,51.9
Draven,Akshan,440,221,219,50.23
Draven,Khazix,574,290,284,50.52
Draven,Belveth,267,125,142,46.82
Draven,Xayah,536,255,281,47.57
Draven,Galio,898,380,518,42.32
Draven,Shyvana,302,145,157,48.01
Draven,Taric,216,106,110,49.07
Draven,Jayce,439,256,183,58.31
Draven,Karthus,285,159,126,55.79
Draven,Sona,366,135,231,36.89
Draven,Yuumi,867,468,399,53.98
Draven,Skarner,276,144,132,52.17
Draven,Nasus,696,271,425,38.94
Draven,Camille,371,196,175,52.83
Draven,Ivern,195,91,104,46.67
Draven,Tryndamere,566,238,328,42.05
Draven,Corki,417,186,231,44.6
Draven,Rammus,376,200,176,53.19
Draven,Xerath,877,412,465,46.98
Draven,Nidalee,276,150,126,54.35
Draven,Vi,941,491,450,52.18
Draven,Bard,321,138,183,42.99
Draven,Renata,209,108,101,51.67
Draven,Kled,191,106,85,55.5
Draven,FiddleSticks,432,204,228,47.22
Draven,Rumble,249,123,126,49.4
Draven,Ornn,463,215,248,46.44
Draven,Quinn,434,213,221,49.08
Yuumi,Yone,3156,1528,1628,48.42
Yuumi,Shaco,1534,797,737,51.96
Yuumi,Mel,3538,1909,1629,53.96
Yuumi,Tristana,1538,740,798,48.11
Yuumi,Pyke,1643,945,698,57.52
Yuumi,Illaoi,778,376,402,48.33
Yuumi,Warwick,2257,1064,1193,47.14
Yuumi,Diana,2429,1110,1319,45.7
Yuumi,Milio,1047,513,534,49
Yuumi,Mordekaiser,2267,1074,1193,47.38
Yuumi,Kindred,785,433,352,55.16
Yuumi,Qiyana,471,285,186,60.51
Yuumi,Ashe,3230,1574,1656,48.73
Yuumi,Sona,605,259,346,42.81
Yuumi,Garen,2513,1180,1333,46.96
Yuumi,Briar,1295,621,674,47.95
Yuumi,Zed,1721,862,859,50.09
Yuumi,Caitlyn,4201,2045,2156,48.68
Yuumi,Morgana,2035,949,1086,46.63
Yuumi,Yasuo,3278,1523,1755,46.46
Yuumi,Gangplank,762,385,377,50.52
Yuumi,Kaisa,2698,1359,1339,50.37
Yuumi,Galio,1304,623,681,47.78
Yuumi,Cassiopeia,479,212,267,44.26
Yuumi,Hwei,1181,596,585,50.47
Yuumi,Renekton,748,338,410,45.19
Yuumi,Kayn,2413,1220,1193,50.56
Yuumi,Vex,897,424,473,47.27
Yuumi,Samira,1405,696,709,49.54
Yuumi,Lulu,2374,1158,1216,48.78
Yuumi,Darius,3003,1483,1520,49.38
Yuumi,Lux,4284,2115,2169,49.37
Yuumi,Sivir,619,336,283,54.28
Yuumi,Rakan,805,373,432,46.34
Yuumi,Jinx,4143,1980,2163,47.79
Yuumi,Volibear,1830,847,983,46.28
Yuumi,Camille,644,320,324,49.69
Yuumi,Katarina,1352,645,707,47.71
Yuumi,MissFortune,3608,1764,1844,48.89
Yuumi,Zyra,1340,664,676,49.55
Yuumi,Yorick,1476,683,793,46.27
Yuumi,Akshan,578,303,275,52.42
Yuumi,FiddleSticks,896,435,461,48.55
Yuumi,Sion,1196,615,581,51.42
Yuumi,Bard,582,326,256,56.01
Yuumi,Kennen,463,280,183,60.48
Yuumi,Naafiri,593,289,304,48.74
Yuumi,Xayah,1004,464,540,46.22
Yuumi,Soraka,980,496,484,50.61
Yuumi,Ornn,657,328,329,49.92
Yuumi,TwistedFate,558,320,238,57.35
Yuumi,Jax,1371,654,717,47.7
Yuumi,Graves,1045,579,466,55.41
Yuumi,Twitch,1351,729,622,53.96
Yuumi,Seraphine,1349,657,692,48.7
Yuumi,Viktor,1276,651,625,51.02
Yuumi,Nocturne,1880,925,955,49.2
Yuumi,Annie,590,310,280,52.54
Yuumi,KogMaw,527,255,272,48.39
Yuumi,Alistar,546,289,257,52.93
Yuumi,Akali,1861,1009,852,54.22
Yuumi,Ezreal,3304,1764,1540,53.39
Yuumi,Nasus,1106,541,565,48.92
Yuumi,Vi,1648,789,859,47.88
Yuumi,Renata,275,154,121,56
Yuumi,Aatrox,1635,868,767,53.09
Yuumi,Chogath,1991,966,1025,48.52
Yuumi,Lucian,1153,602,551,52.21
Yuumi,Nautilus,1879,869,1010,46.25
Yuumi,Nunu,1162,539,623,46.39
Yuumi,Teemo,2148,1088,1060,50.65
Yuumi,Kassadin,342,152,190,44.44
Yuumi,Kalista,620,294,326,47.42
Yuumi,Maokai,756,368,388,48.68
Yuumi,Kled,260,136,124,52.31
Yuumi,AurelionSol,659,334,325,50.68
Yuumi,Jhin,3303,1628,1675,49.29
Yuumi,MonkeyKing,928,393,535,42.35
Yuumi,Vayne,1869,905,964,48.42
Yuumi,Pantheon,2646,1245,1401,47.05
Yuumi,Swain,1648,839,809,50.91
Yuumi,Fiora,634,334,300,52.68
Yuumi,Viego,2154,1033,1121,47.96
Yuumi,Vladimir,1039,579,460,55.73
Yuumi,LeeSin,2313,1160,1153,50.15
Yuumi,Aurora,1342,689,653,51.34
Yuumi,Rell,960,445,515,46.35
Yuumi,Neeko,801,396,405,49.44
Yuumi,Hecarim,616,334,282,54.22
Yuumi,Leblanc,912,480,432,52.63
Yuumi,Trundle,899,427,472,47.5
Yuumi,Singed,470,198,272,42.13
Yuumi,Thresh,2279,1121,1158,49.19
Yuumi,Sett,2503,1186,1317,47.38
Yuumi,Karma,1885,976,909,51.78
Yuumi,Gwen,940,494,446,52.55
Yuumi,Khazix,784,410,374,52.3
Yuumi,Aphelios,1025,497,528,48.49
Yuumi,Smolder,1154,630,524,54.59
Yuumi,Ziggs,521,279,242,53.55
Yuumi,Malzahar,1445,677,768,46.85
Yuumi,Senna,1310,705,605,53.82
Yuumi,Rammus,585,260,325,44.44
Yuumi,Fizz,895,418,477,46.7
Yuumi,Jayce,795,440,355,55.35
Yuumi,Gragas,1032,526,506,50.97
Yuumi,Leona,1451,640,811,44.11
Yuumi,Nidalee,517,294,223,56.87
Yuumi,Ahri,2116,1044,1072,49.34
Yuumi,MasterYi,1825,877,948,48.05
Yuumi,Ryze,544,230,314,42.28
Yuumi,Janna,535,222,313,41.5
Yuumi,Rengar,693,387,306,55.84
Yuumi,TahmKench,1254,565,689,45.06
Yuumi,Amumu,1588,821,767,51.7
Yuumi,Varus,1536,776,760,50.52
Yuumi,Zoe,731,391,340,53.49
Yuumi,Shyvana,429,208,221,48.48
Yuumi,Zac,806,390,416,48.39
Yuumi,Shen,1057,523,534,49.48
Yuumi,Poppy,1053,470,583,44.63
Yuumi,Quinn,601,303,298,50.42
Yuumi,Skarner,545,273,272,50.09
Yuumi,Nami,1845,929,916,50.35
Yuumi,Braum,848,393,455,46.34
Yuumi,Malphite,1558,767,791,49.23
Yuumi,Orianna,645,334,311,51.78
Yuumi,Nilah,649,334,315,51.46
Yuumi,Urgot,781,372,409,47.63
Yuumi,Sylas,1955,964,991,49.31
Yuumi,Ekko,1395,710,685,50.9
Yuumi,Zeri,724,382,342,52.76
Yuumi,Irelia,1511,764,747,50.56
Yuumi,Heimerdinger,707,307,400,43.42
Yuumi,Corki,671,351,320,52.31
Yuumi,Veigar,1671,726,945,43.45
Yuumi,Anivia,523,245,278,46.85
Yuumi,Belveth,407,200,207,49.14
Yuumi,Azir,678,387,291,57.08
Yuumi,Velkoz,943,476,467,50.48
Yuumi,Evelynn,662,341,321,51.51
Yuumi,Lissandra,539,255,284,47.31
Yuumi,Olaf,350,182,168,52
Yuumi,Lillia,912,462,450,50.66
Yuumi,Gnar,670,322,348,48.06
Yuumi,Blitzcrank,1216,596,620,49.01
Yuumi,DrMundo,980,470,510,47.96
Yuumi,Elise,1108,524,584,47.29
Yuumi,Brand,1178,624,554,52.97
Yuumi,Xerath,1370,700,670,51.09
Yuumi,Riven,710,382,328,53.8
Yuumi,Sejuani,686,294,392,42.86
Yuumi,Syndra,1140,520,620,45.61
Yuumi,XinZhao,1033,515,518,49.85
Yuumi,KSante,805,411,394,51.06
Yuumi,Tryndamere,905,391,514,43.2
Yuumi,Zilean,549,298,251,54.28
Yuumi,Udyr,617,314,303,50.89
Yuumi,Draven,867,399,468,46.02
Yuumi,Taliyah,402,173,229,43.03
Yuumi,Ambessa,1044,499,545,47.8
Yuumi,JarvanIV,877,451,426,51.43
Yuumi,Talon,1063,455,608,42.8
Yuumi,Kayle,1137,578,559,50.84
Yuumi,Rumble,407,205,202,50.37
Yuumi,RekSai,222,91,131,40.99
Yuumi,Taric,382,160,222,41.88
Yuumi,Ivern,302,159,143,52.65
Yuumi,Karthus,491,279,212,56.82
Aurora,Renekton,885,433,452,48.93
Aurora,Khazix,915,402,513,43.93
Aurora,Mel,3057,1526,1531,49.92
Aurora,Jhin,2912,1430,1482,49.11
Aurora,Lux,3889,1744,2145,44.84
Aurora,Leblanc,939,465,474,49.52
Aurora,Briar,1200,517,683,43.08
Aurora,Zoe,663,380,283,57.32
Aurora,Jinx,3908,1816,2092,46.47
Aurora,Poppy,960,474,486,49.38
Aurora,Ambessa,1022,497,525,48.63
Aurora,Rammus,385,204,181,52.99
Aurora,Draven,857,418,439,48.77
Aurora,Blitzcrank,1170,668,502,57.09
Aurora,Fiora,703,356,347,50.64
Aurora,FiddleSticks,823,377,446,45.81
Aurora,Syndra,1087,508,579,46.73
Aurora,Vayne,1856,886,970,47.74
Aurora,Morgana,1748,864,884,49.43
Aurora,Nasus,1099,469,630,42.68
Aurora,MonkeyKing,979,505,474,51.58
Aurora,Xayah,878,457,421,52.05
Aurora,Zac,694,343,351,49.42
Aurora,Smolder,948,489,459,51.58
Aurora,Warwick,2066,1032,1034,49.95
Aurora,Yasuo,2914,1420,1494,48.73
Aurora,Caitlyn,3891,1801,2090,46.29
Aurora,Velkoz,919,445,474,48.42
Aurora,Tryndamere,848,369,479,43.51
Aurora,Mordekaiser,2029,953,1076,46.97
Aurora,MissFortune,3417,1609,1808,47.09
Aurora,Janna,550,264,286,48
Aurora,Gragas,876,411,465,46.92
Aurora,Sylas,2191,1087,1104,49.61
Aurora,Taliyah,367,155,212,42.23
Aurora,Senna,1138,442,696,38.84
Aurora,Riven,656,362,294,55.18
Aurora,Sejuani,757,335,422,44.25
Aurora,AurelionSol,569,254,315,44.64
Aurora,Tristana,1492,709,783,47.52
Aurora,Rakan,744,333,411,44.76
Aurora,Gwen,855,455,400,53.22
Aurora,Karthus,479,242,237,50.52
Aurora,Yone,3151,1608,1543,51.03
Aurora,Nilah,643,311,332,48.37
Aurora,Braum,753,325,428,43.16
Aurora,LeeSin,2338,1117,1221,47.78
Aurora,Evelynn,678,350,328,51.62
Aurora,Ezreal,3571,1804,1767,50.52
Aurora,Brand,986,503,483,51.01
Aurora,Volibear,1630,846,784,51.9
Aurora,Ivern,245,135,110,55.1
Aurora,Irelia,1402,748,654,53.35
Aurora,Swain,1633,744,889,45.56
Aurora,Gangplank,717,368,349,51.32
Aurora,Diana,2633,1269,1364,48.2
Aurora,Aphelios,891,479,412,53.76
Aurora,Leona,1315,639,676,48.59
Aurora,TwistedFate,568,302,266,53.17
Aurora,Nami,1402,679,723,48.43
Aurora,Shen,1036,490,546,47.3
Aurora,Ahri,2339,1105,1234,47.24
Aurora,Samira,1197,680,517,56.81
Aurora,Maokai,700,288,412,41.14
Aurora,Kayle,1033,484,549,46.85
Aurora,Kindred,785,398,387,50.7
Aurora,Veigar,1516,678,838,44.72
Aurora,Lulu,1938,1013,925,52.27
Aurora,Garen,2296,1044,1252,45.47
Aurora,Shyvana,433,194,239,44.8
Aurora,Seraphine,1313,629,684,47.91
Aurora,Ziggs,543,243,300,44.75
Aurora,Darius,2852,1362,1490,47.76
Aurora,Corki,610,315,295,51.64
Aurora,Elise,1116,636,480,56.99
Aurora,Katarina,1158,548,610,47.32
Aurora,Karma,1822,913,909,50.11
Aurora,Yorick,1287,569,718,44.21
Aurora,Akali,1794,867,927,48.33
Aurora,Lissandra,492,242,250,49.19
Aurora,Kayn,1960,988,972,50.41
Aurora,KSante,722,354,368,49.03
Aurora,Rengar,582,333,249,57.22
Aurora,Shaco,1323,652,671,49.28
Aurora,Galio,1462,655,807,44.8
Aurora,Kaisa,2568,1389,1179,54.09
Aurora,Zilean,518,269,249,51.93
Aurora,Aatrox,1493,725,768,48.56
Aurora,Varus,1275,619,656,48.55
Aurora,RekSai,169,108,61,63.91
Aurora,Jax,1333,627,706,47.04
Aurora,Viktor,1520,725,795,47.7
Aurora,Sett,2282,1041,1241,45.62
Aurora,Zyra,1449,732,717,50.52
Aurora,Ornn,701,339,362,48.36
Aurora,Vi,1414,697,717,49.29
Aurora,Anivia,486,241,245,49.59
Aurora,Ashe,3212,1599,1613,49.78
Aurora,Yuumi,1342,653,689,48.66
Aurora,Nidalee,470,266,204,56.6
Aurora,Vex,963,484,479,50.26
Aurora,Sivir,919,453,466,49.29
Aurora,Singed,358,139,219,38.83
Aurora,Pantheon,2677,1291,1386,48.23
Aurora,Kalista,483,220,263,45.55
Aurora,Kennen,508,222,286,43.7
Aurora,Nunu,1141,532,609,46.63
Aurora,Zed,1648,752,896,45.63
Aurora,Heimerdinger,783,368,415,47
Aurora,Trundle,848,421,427,49.65
Aurora,Orianna,783,359,424,45.85
Aurora,TahmKench,1260,596,664,47.3
Aurora,Hecarim,670,358,312,53.43
Aurora,Kassadin,313,153,160,48.88
Aurora,Amumu,1449,655,794,45.2
Aurora,Nautilus,1730,839,891,48.5
Aurora,Teemo,1990,922,1068,46.33
Aurora,Ekko,1285,602,683,46.85
Aurora,Lucian,1088,606,482,55.7
Aurora,Pyke,1454,797,657,54.81
Aurora,Vladimir,997,547,450,54.86
Aurora,Jayce,904,431,473,47.68
Aurora,Fizz,781,421,360,53.91
Aurora,Zeri,703,342,361,48.65
Aurora,Hwei,1113,493,620,44.29
Aurora,Malphite,1346,657,689,48.81
Aurora,JarvanIV,833,392,441,47.06
Aurora,Milio,985,482,503,48.93
Aurora,XinZhao,943,467,476,49.52
Aurora,Quinn,606,332,274,54.79
Aurora,Akshan,679,321,358,47.28
Aurora,Chogath,1889,879,1010,46.53
Aurora,MasterYi,1771,908,863,51.27
Aurora,Azir,689,352,337,51.09
Aurora,Neeko,973,510,463,52.42
Aurora,Thresh,2199,1089,1110,49.52
Aurora,Camille,617,305,312,49.43
Aurora,Lillia,914,473,441,51.75
Aurora,Renata,309,144,165,46.6
Aurora,Soraka,860,395,465,45.93
Aurora,Cassiopeia,580,286,294,49.31
Aurora,Alistar,570,293,277,51.4
Aurora,Illaoi,738,378,360,51.22
Aurora,Gnar,662,323,339,48.79
Aurora,Udyr,620,335,285,54.03
Aurora,Sion,1182,553,629,46.79
Aurora,Talon,960,424,536,44.17
Aurora,Viego,2120,1113,1007,52.5
Aurora,Naafiri,630,354,276,56.19
Aurora,Taric,353,141,212,39.94
Aurora,Rell,857,417,440,48.66
Aurora,Malzahar,1438,617,821,42.91
Aurora,DrMundo,951,412,539,43.32
Aurora,Graves,891,446,445,50.06
Aurora,Skarner,470,261,209,55.53
Aurora,Sona,495,207,288,41.82
Aurora,Urgot,727,360,367,49.52
Aurora,Ryze,530,260,270,49.06
Aurora,Bard,524,259,265,49.43
Aurora,Qiyana,512,238,274,46.48
Aurora,Twitch,1358,633,725,46.61
Aurora,Rumble,428,235,193,54.91
Aurora,Annie,535,246,289,45.98
Aurora,Xerath,1195,547,648,45.77
Aurora,KogMaw,484,235,249,48.55
Aurora,Nocturne,1719,793,926,46.13
Aurora,Kled,231,139,92,60.17
Aurora,Olaf,347,148,199,42.65
Aurora,Belveth,365,170,195,46.58
Volibear,Renekton,1113,585,528,52.56
Volibear,Khazix,1120,620,500,55.36
Volibear,Mel,4595,2409,2186,52.43
Volibear,Jhin,4418,2156,2262,48.8
Volibear,Lux,5950,3027,2923,50.87
Volibear,Mordekaiser,3713,1819,1894,48.99
Volibear,Viego,3100,1540,1560,49.68
Volibear,Kindred,1004,517,487,51.49
Volibear,TahmKench,2054,1093,961,53.21
Volibear,Sett,3877,2012,1865,51.9
Volibear,Zac,999,524,475,52.45
Volibear,Yasuo,4388,2175,2213,49.57
Volibear,MissFortune,5357,2621,2736,48.93
Volibear,Tristana,2250,1180,1070,52.44
Volibear,Poppy,1331,683,648,51.31
Volibear,Veigar,2442,1233,1209,50.49
Volibear,Heimerdinger,1065,543,522,50.99
Volibear,Ziggs,915,444,471,48.52
Volibear,Darius,4683,2378,2305,50.78
Volibear,Samira,1781,932,849,52.33
Volibear,Karma,2037,1001,1036,49.14
Volibear,Rammus,661,343,318,51.89
Volibear,Blitzcrank,1628,852,776,52.33
Volibear,LeeSin,2463,1238,1225,50.26
Volibear,Irelia,2032,1086,946,53.44
Volibear,Yuumi,1830,983,847,53.72
Volibear,Gnar,888,453,435,51.01
Volibear,Kayn,3626,1769,1857,48.79
Volibear,Leblanc,1130,624,506,55.22
Volibear,Caitlyn,5956,2981,2975,50.05
Volibear,Sejuani,1016,585,431,57.58
Volibear,Rell,1203,544,659,45.22
Volibear,Teemo,2883,1340,1543,46.48
Volibear,Trundle,1622,742,880,45.75
Volibear,Elise,1236,623,613,50.4
Volibear,KSante,944,533,411,56.46
Volibear,Ashe,4128,2105,2023,50.99
Volibear,Nasus,1890,926,964,48.99
Volibear,Fizz,1290,695,595,53.88
Volibear,Azir,796,409,387,51.38
Volibear,Aphelios,1255,538,717,42.87
Volibear,Soraka,1291,602,689,46.63
Volibear,Aatrox,1908,1015,893,53.2
Volibear,Sylas,2540,1290,1250,50.79
Volibear,Amumu,2553,1218,1335,47.71
Volibear,Chogath,2951,1436,1515,48.66
Volibear,Twitch,1884,979,905,51.96
Volibear,Illaoi,1321,655,666,49.58
Volibear,Syndra,1247,641,606,51.4
Volibear,Kaisa,3326,1794,1532,53.94
Volibear,Lucian,1363,722,641,52.97
Volibear,Seraphine,2121,1122,999,52.9
Volibear,Jax,2095,1054,1041,50.31
Volibear,JarvanIV,1184,595,589,50.25
Volibear,Hwei,1481,711,770,48.01
Volibear,Bard,683,340,343,49.78
Volibear,Sion,1674,868,806,51.85
Volibear,AurelionSol,886,411,475,46.39
Volibear,Tryndamere,1400,745,655,53.21
Volibear,Nidalee,485,295,190,60.82
Volibear,Aurora,1630,784,846,48.1
Volibear,Nami,2229,1035,1194,46.43
Volibear,Quinn,715,348,367,48.67
Volibear,Thresh,2908,1490,1418,51.24
Volibear,Diana,3458,1762,1696,50.95
Volibear,MasterYi,2579,1289,1290,49.98
Volibear,Shaco,2036,1096,940,53.83
Volibear,Rengar,814,420,394,51.6
Volibear,Pyke,2168,1248,920,57.56
Volibear,Udyr,1034,504,530,48.74
Volibear,Warwick,4097,1963,2134,47.91
Volibear,Leona,1844,905,939,49.08
Volibear,Galio,1737,856,881,49.28
Volibear,Shen,1411,699,712,49.54
Volibear,MonkeyKing,1519,779,740,51.28
Volibear,Naafiri,876,459,417,52.4
Volibear,Ezreal,4178,2254,1924,53.95
Volibear,Varus,1975,1073,902,54.33
Volibear,Ambessa,1261,685,576,54.32
Volibear,Nilah,917,411,506,44.82
Volibear,DrMundo,1414,654,760,46.25
Volibear,Pantheon,3564,1812,1752,50.84
Volibear,Nautilus,2325,1253,1072,53.89
Volibear,Braum,1192,586,606,49.16
Volibear,Skarner,705,396,309,56.17
Volibear,Vayne,2794,1295,1499,46.35
Volibear,Malzahar,2159,1022,1137,47.34
Volibear,Draven,1243,628,615,50.52
Volibear,Briar,1835,891,944,48.56
Volibear,Yone,4136,2283,1853,55.2
Volibear,Hecarim,750,422,328,56.27
Volibear,Velkoz,1379,687,692,49.82
Volibear,Yorick,2142,1000,1142,46.69
Volibear,KogMaw,829,404,425,48.73
Volibear,Vi,2172,1098,1074,50.55
Volibear,FiddleSticks,1088,583,505,53.58
Volibear,Taliyah,566,259,307,45.76
Volibear,Viktor,1687,856,831,50.74
Volibear,Ekko,2004,1043,961,52.05
Volibear,Swain,2485,1221,1264,49.13
Volibear,Garen,3668,1793,1875,48.88
Volibear,Talon,1135,605,530,53.3
Volibear,Zed,2446,1230,1216,50.29
Volibear,Kalista,586,344,242,58.7
Volibear,Nocturne,2745,1319,1426,48.05
Volibear,Malphite,1898,937,961,49.37
Volibear,Xayah,1114,554,560,49.73
Volibear,Rakan,861,410,451,47.62
Volibear,Vex,1130,525,605,46.46
Volibear,Nunu,1470,729,741,49.59
Volibear,Akali,2388,1268,1120,53.1
Volibear,Lillia,1390,701,689,50.43
Volibear,Qiyana,613,297,316,48.45
Volibear,Morgana,2827,1345,1482,47.58
Volibear,Lulu,2352,1196,1156,50.85
Volibear,Ryze,669,345,324,51.57
Volibear,Brand,1792,900,892,50.22
Volibear,Gragas,1315,652,663,49.58
Volibear,Fiora,798,413,385,51.75
Volibear,XinZhao,1357,692,665,50.99
Volibear,Akshan,829,361,468,43.55
Volibear,Shyvana,683,312,371,45.68
Volibear,Jinx,5875,2883,2992,49.07
Volibear,Sona,705,319,386,45.25
Volibear,Xerath,2001,1047,954,52.32
Volibear,Sivir,1157,611,546,52.81
Volibear,Ornn,915,482,433,52.68
Volibear,Gangplank,947,486,461,51.32
Volibear,Zeri,909,481,428,52.92
Volibear,Olaf,521,270,251,51.82
Volibear,Senna,1629,902,727,55.37
Volibear,Graves,1120,576,544,51.43
Volibear,Urgot,1272,580,692,45.6
Volibear,Maokai,1061,540,521,50.9
Volibear,Alistar,799,376,423,47.06
Volibear,Katarina,1809,969,840,53.57
Volibear,Ahri,2966,1558,1408,52.53
Volibear,Milio,1249,555,694,44.44
Volibear,Camille,801,432,369,53.93
Volibear,Taric,501,228,273,45.51
Volibear,Renata,455,236,219,51.87
Volibear,Singed,579,276,303,47.67
Volibear,Anivia,709,303,406,42.74
Volibear,Riven,943,537,406,56.95
Volibear,Vladimir,1269,670,599,52.8
Volibear,Kayle,1582,761,821,48.1
Volibear,Orianna,921,462,459,50.16
Volibear,Lissandra,628,306,322,48.73
Volibear,Neeko,1260,676,584,53.65
Volibear,Corki,822,436,386,53.04
Volibear,Gwen,1253,697,556,55.63
Volibear,Zoe,762,438,324,57.48
Volibear,Kassadin,419,236,183,56.32
Volibear,Kled,451,223,228,49.45
Volibear,Evelynn,976,537,439,55.02
Volibear,TwistedFate,679,327,352,48.16
Volibear,Smolder,1442,747,695,51.8
Volibear,RekSai,327,169,158,51.68
Volibear,Janna,746,383,363,51.34
Volibear,Zilean,684,333,351,48.68
Volibear,Belveth,530,249,281,46.98
Volibear,Ivern,424,206,218,48.58
Volibear,Cassiopeia,671,291,380,43.37
Volibear,Zyra,1726,800,926,46.35
Volibear,Rumble,388,200,188,51.55
Volibear,Karthus,550,260,290,47.27
Volibear,Kennen,514,300,214,58.37
Volibear,Jayce,822,406,416,49.39
Volibear,Annie,668,345,323,51.65
Vayne,Renekton,1128,585,543,51.86
Vayne,Khazix,1165,629,536,53.99
Vayne,Mel,4985,2639,2346,52.94
Vayne,Jhin,5015,2725,2290,54.34
Vayne,Lux,5799,3015,2784,51.99
Vayne,Teemo,2892,1336,1556,46.2
Vayne,TahmKench,2594,1431,1163,55.17
Vayne,Jinx,6740,3167,3573,46.99
Vayne,Zoe,986,550,436,55.78
Vayne,Nami,2285,1128,1157,49.37
Vayne,Singed,713,363,350,50.91
Vayne,Graves,1339,692,647,51.68
Vayne,Fizz,1407,744,663,52.88
Vayne,Ziggs,872,440,432,50.46
Vayne,Pantheon,3772,1951,1821,51.72
Vayne,Aatrox,2036,1099,937,53.98
Vayne,Gwen,1124,608,516,54.09
Vayne,Syndra,1574,798,776,50.7
Vayne,Ashe,4371,2227,2144,50.95
Vayne,Lulu,2583,1286,1297,49.79
Vayne,Gangplank,990,469,521,47.37
Vayne,Karthus,673,365,308,54.23
Vayne,Aurora,1856,970,886,52.26
Vayne,Ezreal,5713,2981,2732,52.18
Vayne,Senna,1742,834,908,47.88
Vayne,Kennen,788,443,345,56.22
Vayne,Kayn,3494,1826,1668,52.26
Vayne,Naafiri,801,377,424,47.07
Vayne,Xayah,1317,637,680,48.37
Vayne,Soraka,1283,606,677,47.23
Vayne,Mordekaiser,3540,1842,1698,52.03
Vayne,Ahri,3015,1536,1479,50.95
Vayne,Nunu,1371,669,702,48.8
Vayne,Yasuo,4801,2445,2356,50.93
Vayne,Zyra,1890,938,952,49.63
Vayne,Garen,4246,2229,2017,52.5
Vayne,Zed,2554,1317,1237,51.57
Vayne,Talon,1290,723,567,56.05
Vayne,Milio,1315,678,637,51.56
Vayne,Fiora,828,455,373,54.95
Vayne,Elise,1634,822,812,50.31
Vayne,Yone,3967,2099,1868,52.91
Vayne,Tristana,2474,1240,1234,50.12
Vayne,Sivir,1141,651,490,57.06
Vayne,Katarina,1717,949,768,55.27
Vayne,Kayle,1658,838,820,50.54
Vayne,Ekko,2265,1097,1168,48.43
Vayne,Irelia,2041,995,1046,48.75
Vayne,Yuumi,1869,964,905,51.58
Vayne,Nasus,1903,945,958,49.66
Vayne,Galio,1976,1032,944,52.23
Vayne,Smolder,1636,849,787,51.89
Vayne,JarvanIV,1312,631,681,48.09
Vayne,Amumu,2391,1191,1200,49.81
Vayne,Velkoz,1520,768,752,50.53
Vayne,Poppy,1649,863,786,52.33
Vayne,Warwick,3674,1761,1913,47.93
Vayne,Leona,2225,1144,1081,51.42
Vayne,MissFortune,5553,2813,2740,50.66
Vayne,Darius,4955,2537,2418,51.2
Vayne,Sion,2039,1073,966,52.62
Vayne,Draven,1408,746,662,52.98
Vayne,Sett,3491,1826,1665,52.31
Vayne,Volibear,2794,1499,1295,53.65
Vayne,KogMaw,819,366,453,44.69
Vayne,Seraphine,1843,900,943,48.83
Vayne,Leblanc,1143,613,530,53.63
Vayne,Samira,2027,1011,1016,49.88
Vayne,Shen,1740,921,819,52.93
Vayne,KSante,1189,720,469,60.56
Vayne,Evelynn,908,466,442,51.32
Vayne,MasterYi,2872,1605,1267,55.88
Vayne,Shaco,2177,1119,1058,51.4
Vayne,Kaisa,4230,2257,1973,53.36
Vayne,Braum,1411,689,722,48.83
Vayne,Diana,3497,1808,1689,51.7
Vayne,Briar,1844,855,989,46.37
Vayne,Caitlyn,6159,3018,3141,49
Vayne,Akali,2541,1431,1110,56.32
Vayne,Brand,1637,845,792,51.62
Vayne,Sona,771,360,411,46.69
Vayne,Illaoi,1153,573,580,49.7
Vayne,Vex,1284,645,639,50.23
Vayne,Ornn,1141,581,560,50.92
Vayne,Nautilus,2971,1505,1466,50.66
Vayne,Orianna,1104,592,512,53.62
Vayne,Morgana,2814,1461,1353,51.92
Vayne,Veigar,2491,1229,1262,49.34
Vayne,Rammus,905,472,433,52.15
Vayne,Zeri,988,544,444,55.06
Vayne,Taric,574,295,279,51.39
Vayne,Nilah,905,475,430,52.49
Vayne,Swain,2436,1226,1210,50.33
Vayne,Sylas,2809,1498,1311,53.33
Vayne,Viego,3153,1622,1531,51.44
Vayne,Xerath,1952,993,959,50.87
Vayne,Twitch,2108,1091,1017,51.76
Vayne,Jax,2017,1015,1002,50.32
Vayne,DrMundo,1534,773,761,50.39
Vayne,Vi,2230,1097,1133,49.19
Vayne,Varus,2035,1048,987,51.5
Vayne,Kalista,696,399,297,57.33
Vayne,Zilean,682,329,353,48.24
Vayne,MonkeyKing,1574,758,816,48.16
Vayne,Lucian,1725,901,824,52.23
Vayne,Bard,680,317,363,46.62
Vayne,Rengar,851,500,351,58.75
Vayne,Shyvana,629,319,310,50.72
Vayne,Karma,2392,1312,1080,54.85
Vayne,LeeSin,2911,1572,1339,54
Vayne,Cassiopeia,738,345,393,46.75
Vayne,Alistar,1179,573,606,48.6
Vayne,Gragas,1427,760,667,53.26
Vayne,Maokai,1292,670,622,51.86
Vayne,Kled,487,272,215,55.85
Vayne,Kindred,1072,557,515,51.96
Vayne,Azir,739,367,372,49.66
Vayne,Neeko,1216,673,543,55.35
Vayne,Rakan,1143,577,566,50.48
Vayne,Pyke,1953,1023,930,52.38
Vayne,Ryze,878,447,431,50.91
Vayne,Hwei,1559,781,778,50.1
Vayne,FiddleSticks,1135,526,609,46.34
Vayne,Malzahar,2232,1057,1175,47.36
Vayne,Vladimir,1688,887,801,52.55
Vayne,Sejuani,1108,535,573,48.29
Vayne,Viktor,2046,1013,1033,49.51
Vayne,XinZhao,1550,818,732,52.77
Vayne,Trundle,1403,718,685,51.18
Vayne,Tryndamere,1263,658,605,52.1
Vayne,Aphelios,1365,675,690,49.45
Vayne,Yorick,2366,1087,1279,45.94
Vayne,Camille,831,429,402,51.62
Vayne,Chogath,3378,1804,1574,53.4
Vayne,Janna,828,395,433,47.71
Vayne,Kassadin,597,282,315,47.24
Vayne,Renata,408,193,215,47.3
Vayne,Belveth,548,279,269,50.91
Vayne,Skarner,749,407,342,54.34
Vayne,Qiyana,696,359,337,51.58
Vayne,Zac,1154,524,630,45.41
Vayne,Riven,1123,530,593,47.2
Vayne,Lillia,1399,745,654,53.25
Vayne,Corki,1040,566,474,54.42
Vayne,Malphite,2871,1365,1506,47.54
Vayne,Gnar,945,502,443,53.12
Vayne,AurelionSol,973,502,471,51.59
Vayne,Quinn,896,442,454,49.33
Vayne,Blitzcrank,1676,887,789,52.92
Vayne,Nocturne,2601,1344,1257,51.67
Vayne,Heimerdinger,1105,490,615,44.34
Vayne,Lissandra,789,375,414,47.53
Vayne,Udyr,919,494,425,53.75
Vayne,Ambessa,1501,870,631,57.96
Vayne,Rell,1236,584,652,47.25
Vayne,Urgot,1160,586,574,50.52
Vayne,Hecarim,989,492,497,49.75
Vayne,Olaf,499,251,248,50.3
Vayne,Ivern,387,178,209,45.99
Vayne,Thresh,3162,1599,1563,50.57
Vayne,Annie,708,321,387,45.34
Vayne,Jayce,979,534,445,54.55
Vayne,Taliyah,620,291,329,46.94
Vayne,Anivia,704,333,371,47.3
Vayne,RekSai,235,150,85,63.83
Vayne,Akshan,942,496,446,52.65
Vayne,Nidalee,558,304,254,54.48
Vayne,Rumble,559,255,304,45.62
Vayne,TwistedFate,795,411,384,51.7
Khazix,Aurora,915,513,402,56.07
Khazix,Volibear,1120,500,620,44.64
Khazix,Yasuo,2066,932,1134,45.11
Khazix,Vayne,1165,536,629,46.01
Khazix,Shaco,1042,508,534,48.75
Khazix,Poppy,667,320,347,47.98
Khazix,Diana,1537,741,796,48.21
Khazix,Anivia,310,150,160,48.39
Khazix,Caitlyn,2870,1322,1548,46.06
Khazix,Thresh,1395,688,707,49.32
Khazix,Garen,1588,665,923,41.88
Khazix,FiddleSticks,596,316,280,53.02
Khazix,Lux,2886,1318,1568,45.67
Khazix,Brand,814,363,451,44.59
Khazix,Darius,1832,844,988,46.07
Khazix,Amumu,1026,412,614,40.16
Khazix,MissFortune,2194,941,1253,42.89
Khazix,Swain,964,484,480,50.21
Khazix,Aatrox,1018,520,498,51.08
Khazix,Viego,1635,744,891,45.5
Khazix,Sylas,1292,620,672,47.99
Khazix,Ashe,1971,863,1108,43.78
Khazix,Blitzcrank,766,397,369,51.83
Khazix,Evelynn,522,240,282,45.98
Khazix,Katarina,928,471,457,50.75
Khazix,Nocturne,1170,531,639,45.38
Khazix,Neeko,612,295,317,48.2
Khazix,Sejuani,427,191,236,44.73
Khazix,LeeSin,1574,756,818,48.03
Khazix,Irelia,917,453,464,49.4
Khazix,Twitch,934,444,490,47.54
Khazix,Pyke,1029,490,539,47.62
Khazix,Sion,810,337,473,41.6
Khazix,Ezreal,2378,1204,1174,50.63
Khazix,Zilean,336,174,162,51.79
Khazix,Belveth,243,124,119,51.03
Khazix,Hwei,879,419,460,47.67
Khazix,Jinx,2529,1113,1416,44.01
Khazix,TahmKench,834,401,433,48.08
Khazix,Jax,896,412,484,45.98
Khazix,Cassiopeia,327,173,154,52.91
Khazix,Milio,609,296,313,48.6
Khazix,Ambessa,593,303,290,51.1
Khazix,Rammus,305,129,176,42.3
Khazix,Kled,193,87,106,45.08
Khazix,Kayn,1639,827,812,50.46
Khazix,AurelionSol,367,180,187,49.05
Khazix,Tristana,1013,538,475,53.11
Khazix,Ekko,948,444,504,46.84
Khazix,Pantheon,1727,860,867,49.8
Khazix,Azir,415,197,218,47.47
Khazix,Ziggs,376,172,204,45.74
Khazix,Lulu,1222,570,652,46.64
Khazix,KSante,518,295,223,56.95
Khazix,Riven,517,242,275,46.81
Khazix,Jhin,2101,1035,1066,49.26
Khazix,Yuumi,784,374,410,47.7
Khazix,Sett,1524,659,865,43.24
Khazix,Rengar,658,343,315,52.13
Khazix,Kennen,352,174,178,49.43
Khazix,Morgana,1286,569,717,44.25
Khazix,Warwick,1465,640,825,43.69
Khazix,Kaisa,1743,919,824,52.73
Khazix,Jayce,468,227,241,48.5
Khazix,Senna,752,394,358,52.39
Khazix,Chogath,1211,519,692,42.86
Khazix,Galio,760,337,423,44.34
Khazix,Shen,671,322,349,47.99
Khazix,Aphelios,697,342,355,49.07
Khazix,Illaoi,480,234,246,48.75
Khazix,Taliyah,265,90,175,33.96
Khazix,Sivir,503,246,257,48.91
Khazix,Velkoz,613,323,290,52.69
Khazix,Mordekaiser,1527,719,808,47.09
Khazix,Akali,1021,538,483,52.69
Khazix,Seraphine,958,483,475,50.42
Khazix,Briar,862,379,483,43.97
Khazix,Janna,365,190,175,52.05
Khazix,Gangplank,460,244,216,53.04
Khazix,Qiyana,333,149,184,44.74
Khazix,Zoe,497,261,236,52.52
Khazix,Sona,410,178,232,43.41
Khazix,Fizz,582,260,322,44.67
Khazix,Samira,861,375,486,43.55
Khazix,Ornn,410,168,242,40.98
Khazix,Ivern,156,84,72,53.85
Khazix,Nilah,418,179,239,42.82
Khazix,Teemo,1252,547,705,43.69
Khazix,Camille,389,213,176,54.76
Khazix,Leblanc,564,282,282,50
Khazix,Singed,345,152,193,44.06
Khazix,XinZhao,610,298,312,48.85
Khazix,Yorick,946,366,580,38.69
Khazix,KogMaw,289,131,158,45.33
Khazix,Nautilus,1047,465,582,44.41
Khazix,DrMundo,646,295,351,45.67
Khazix,Nasus,714,335,379,46.92
Khazix,Mel,2104,1017,1087,48.34
Khazix,Vladimir,633,309,324,48.82
Khazix,MasterYi,1259,577,682,45.83
Khazix,Lucian,757,399,358,52.71
Khazix,Maokai,375,177,198,47.2
Khazix,Rakan,523,278,245,53.15
Khazix,Renekton,476,278,198,58.4
Khazix,Veigar,1014,475,539,46.84
Khazix,Ahri,1387,637,750,45.93
Khazix,Talon,740,380,360,51.35
Khazix,Yone,1987,996,991,50.13
Khazix,Zac,474,207,267,43.67
Khazix,Hecarim,436,221,215,50.69
Khazix,Renata,184,62,122,33.7
Khazix,Zed,1176,609,567,51.79
Khazix,Trundle,565,254,311,44.96
Khazix,Xayah,503,224,279,44.53
Khazix,Lillia,677,354,323,52.29
Khazix,Vex,560,252,308,45
Khazix,Karma,1255,574,681,45.74
Khazix,Gnar,456,219,237,48.03
Khazix,Vi,919,457,462,49.73
Khazix,Zeri,516,219,297,42.44
Khazix,Kayle,704,283,421,40.2
Khazix,Varus,984,502,482,51.02
Khazix,Malphite,947,417,530,44.03
Khazix,Udyr,332,194,138,58.43
Khazix,Bard,259,97,162,37.45
Khazix,Zyra,914,448,466,49.02
Khazix,Urgot,504,179,325,35.52
Khazix,JarvanIV,512,235,277,45.9
Khazix,MonkeyKing,736,296,440,40.22
Khazix,Nami,1186,584,602,49.24
Khazix,Heimerdinger,503,202,301,40.16
Khazix,Nunu,612,310,302,50.65
Khazix,Gwen,513,251,262,48.93
Khazix,Naafiri,337,143,194,42.43
Khazix,Braum,532,216,316,40.6
Khazix,Ryze,286,153,133,53.5
Khazix,Draven,574,284,290,49.48
Khazix,Smolder,764,375,389,49.08
Khazix,Lissandra,366,152,214,41.53
Khazix,Rell,565,319,246,56.46
Khazix,Gragas,638,346,292,54.23
Khazix,Leona,702,321,381,45.73
Khazix,Orianna,523,218,305,41.68
Khazix,Corki,427,234,193,54.8
Khazix,Shyvana,255,87,168,34.12
Khazix,Soraka,552,266,286,48.19
Khazix,TwistedFate,403,209,194,51.86
Khazix,Annie,333,180,153,54.05
Khazix,Kassadin,212,98,114,46.23
Khazix,Graves,754,417,337,55.31
Khazix,Quinn,413,207,206,50.12
Khazix,Skarner,300,105,195,35
Khazix,Kalista,295,144,151,48.81
Khazix,Malzahar,953,424,529,44.49
Khazix,Alistar,372,166,206,44.62
Khazix,Tryndamere,526,284,242,53.99
Khazix,Nidalee,398,215,183,54.02
Khazix,Fiora,468,204,264,43.59
Khazix,Olaf,205,97,108,47.32
Khazix,Karthus,323,188,135,58.2
Khazix,Xerath,886,388,498,43.79
Khazix,Syndra,697,343,354,49.21
Khazix,Rumble,252,133,119,52.78
Khazix,Kindred,500,245,255,49
Khazix,Elise,756,384,372,50.79
Khazix,Akshan,383,159,224,41.51
Khazix,Viktor,965,465,500,48.19
Khazix,Taric,221,71,150,32.13
Khazix,RekSai,91,59,32,64.84
Chogath,Gwen,1724,908,816,52.67
Chogath,Vi,2379,1226,1153,51.53
Chogath,Zed,2407,1300,1107,54.01
Chogath,Jhin,4774,2300,2474,48.18
Chogath,Soraka,1450,792,658,54.62
Chogath,Sett,4285,1975,2310,46.09
Chogath,AurelionSol,1119,539,580,48.17
Chogath,Corki,876,491,385,56.05
Chogath,Milio,1340,660,680,49.25
Chogath,Zac,1147,608,539,53.01
Chogath,Yasuo,4858,2465,2393,50.74
Chogath,MissFortune,5593,2773,2820,49.58
Chogath,Lux,6098,3011,3087,49.38
Chogath,Darius,4712,2404,2308,51.02
Chogath,Viego,3180,1633,1547,51.35
Chogath,Nautilus,2695,1419,1276,52.65
Chogath,Garen,4075,2151,1924,52.79
Chogath,Malzahar,2447,1170,1277,47.81
Chogath,Seraphine,1966,954,1012,48.52
Chogath,Zilean,782,376,406,48.08
Chogath,Olaf,652,334,318,51.23
Chogath,LeeSin,2972,1664,1308,55.99
Chogath,Diana,3677,1962,1715,53.36
Chogath,Karma,2419,1239,1180,51.22
Chogath,Teemo,3494,1891,1603,54.12
Chogath,Poppy,1384,781,603,56.43
Chogath,Akali,2553,1434,1119,56.17
Chogath,Caitlyn,6317,3310,3007,52.4
Chogath,Leona,2261,1115,1146,49.31
Chogath,Tryndamere,1413,711,702,50.32
Chogath,Velkoz,1518,736,782,48.48
Chogath,Zeri,1037,568,469,54.77
Chogath,Thresh,3340,1736,1604,51.98
Chogath,Ivern,489,247,242,50.51
Chogath,Neeko,1283,694,589,54.09
Chogath,Senna,1976,967,1009,48.94
Chogath,Yorick,2830,1456,1374,51.45
Chogath,Volibear,2951,1515,1436,51.34
Chogath,Cassiopeia,853,475,378,55.69
Chogath,Rell,1171,616,555,52.6
Chogath,Rammus,706,412,294,58.36
Chogath,Jinx,6560,3185,3375,48.55
Chogath,TahmKench,2454,1256,1198,51.18
Chogath,DrMundo,1837,844,993,45.94
Chogath,Trundle,1506,734,772,48.74
Chogath,Ahri,3297,1636,1661,49.62
Chogath,Ashe,4549,2385,2164,52.43
Chogath,Nami,2598,1308,1290,50.35
Chogath,Camille,747,389,358,52.07
Chogath,Pantheon,3771,2034,1737,53.94
Chogath,Xayah,1320,716,604,54.24
Chogath,Yuumi,1991,1025,966,51.48
Chogath,Warwick,3915,1922,1993,49.09
Chogath,Irelia,1945,1007,938,51.77
Chogath,Samira,1854,1077,777,58.09
Chogath,Malphite,2199,1223,976,55.62
Chogath,MonkeyKing,1377,733,644,53.23
Chogath,Sylas,3110,1595,1515,51.29
Chogath,Swain,2617,1267,1350,48.41
Chogath,Fiora,1206,651,555,53.98
Chogath,Amumu,2801,1370,1431,48.91
Chogath,Vladimir,1644,859,785,52.25
Chogath,Varus,2020,1065,955,52.72
Chogath,Janna,867,423,444,48.79
Chogath,Graves,1469,804,665,54.73
Chogath,Kassadin,497,255,242,51.31
Chogath,Kalista,714,403,311,56.44
Chogath,Maokai,1128,552,576,48.94
Chogath,Shaco,2153,1186,967,55.09
Chogath,Viktor,1912,948,964,49.58
Chogath,Mordekaiser,3665,1651,2014,45.05
Chogath,Morgana,2964,1484,1480,50.07
Chogath,Kaisa,3600,1808,1792,50.22
Chogath,Qiyana,632,346,286,54.75
Chogath,Mel,5535,2928,2607,52.9
Chogath,KSante,980,522,458,53.27
Chogath,Azir,915,487,428,53.22
Chogath,Pyke,2220,1247,973,56.17
Chogath,Veigar,2765,1460,1305,52.8
Chogath,Ekko,2251,1142,1109,50.73
Chogath,Lucian,1508,760,748,50.4
Chogath,XinZhao,1447,755,692,52.18
Chogath,Leblanc,1183,670,513,56.64
Chogath,Aatrox,2054,1036,1018,50.44
Chogath,Ryze,801,410,391,51.19
Chogath,Jax,2025,1128,897,55.7
Chogath,Galio,1915,987,928,51.54
Chogath,Yone,4638,2358,2280,50.84
Chogath,Urgot,1257,583,674,46.38
Chogath,Lillia,1605,716,889,44.61
Chogath,Lulu,2830,1482,1348,52.37
Chogath,Briar,1941,940,1001,48.43
Chogath,Ambessa,1277,665,612,52.08
Chogath,Elise,1777,938,839,52.79
Chogath,Shen,1582,823,759,52.02
Chogath,Brand,1794,906,888,50.5
Chogath,FiddleSticks,1214,667,547,54.94
Chogath,Braum,1444,717,727,49.65
Chogath,Aphelios,1392,733,659,52.66
Chogath,Kayle,1814,846,968,46.64
Chogath,Khazix,1211,692,519,57.14
Chogath,Blitzcrank,1783,1017,766,57.04
Chogath,Nilah,1005,509,496,50.65
Chogath,Kled,474,235,239,49.58
Chogath,Vex,1378,755,623,54.79
Chogath,Nocturne,2701,1244,1457,46.06
Chogath,Draven,1231,646,585,52.48
Chogath,Riven,1003,561,442,55.93
Chogath,Twitch,2060,1133,927,55
Chogath,Skarner,656,295,361,44.97
Chogath,Aurora,1889,1010,879,53.47
Chogath,KogMaw,829,407,422,49.1
Chogath,MasterYi,2929,1522,1407,51.96
Chogath,Orianna,1008,520,488,51.59
Chogath,Rengar,817,489,328,59.85
Chogath,Smolder,1755,863,892,49.17
Chogath,Kayn,3594,1738,1856,48.36
Chogath,Talon,1385,727,658,52.49
Chogath,Ezreal,4883,2684,2199,54.97
Chogath,Katarina,1855,1077,778,58.06
Chogath,RekSai,280,192,88,68.57
Chogath,Ziggs,978,466,512,47.65
Chogath,Nasus,1669,859,810,51.47
Chogath,Evelynn,1031,572,459,55.48
Chogath,Zyra,1898,909,989,47.89
Chogath,Hecarim,925,434,491,46.92
Chogath,Illaoi,1316,636,680,48.33
Chogath,Zoe,937,479,458,51.12
Chogath,Hwei,1638,791,847,48.29
Chogath,Shyvana,562,282,280,50.18
Chogath,Nunu,1510,812,698,53.77
Chogath,Nidalee,593,348,245,58.68
Chogath,Tristana,2405,1247,1158,51.85
Chogath,Fizz,1311,628,683,47.9
Chogath,Lissandra,770,429,341,55.71
Chogath,Gragas,1325,712,613,53.74
Chogath,Sivir,1255,632,623,50.36
Chogath,Syndra,1512,779,733,51.52
Chogath,Gangplank,1037,535,502,51.59
Chogath,Vayne,3378,1574,1804,46.6
Chogath,Heimerdinger,1177,611,566,51.91
Chogath,Sejuani,984,485,499,49.29
Chogath,Kennen,846,434,412,51.3
Chogath,Rumble,509,262,247,51.47
Chogath,Udyr,1016,510,506,50.2
Chogath,Alistar,985,532,453,54.01
Chogath,Rakan,1212,621,591,51.24
Chogath,Sona,772,368,404,47.67
Chogath,Singed,633,308,325,48.66
Chogath,Kindred,1022,569,453,55.68
Chogath,Anivia,809,373,436,46.11
Chogath,Karthus,654,357,297,54.59
Chogath,Taliyah,584,275,309,47.09
Chogath,Gnar,1066,518,548,48.59
Chogath,Quinn,804,377,427,46.89
Chogath,JarvanIV,1393,651,742,46.73
Chogath,Xerath,1903,956,947,50.24
Chogath,Belveth,561,261,300,46.52
Chogath,Jayce,1008,551,457,54.66
Chogath,Renekton,1029,559,470,54.32
Chogath,TwistedFate,812,435,377,53.57
Chogath,Renata,426,221,205,51.88
Chogath,Taric,648,301,347,46.45
Chogath,Sion,2051,1046,1005,51
Chogath,Ornn,1160,571,589,49.22
Chogath,Bard,832,376,456,45.19
Chogath,Naafiri,955,495,460,51.83
Chogath,Akshan,981,477,504,48.62
Chogath,Annie,791,440,351,55.63
Gangplank,Gwen,460,238,222,51.74
Gangplank,Vi,864,434,430,50.23
Gangplank,Zed,977,519,458,53.12
Gangplank,Jhin,1807,925,882,51.19
Gangplank,Soraka,557,265,292,47.58
Gangplank,Garen,1266,543,723,42.89
Gangplank,Briar,734,375,359,51.09
Gangplank,Caitlyn,2393,1151,1242,48.1
Gangplank,Morgana,1060,558,502,52.64
Gangplank,DrMundo,482,212,270,43.98
Gangplank,Lillia,450,256,194,56.89
Gangplank,Viktor,782,473,309,60.49
Gangplank,Pyke,796,375,421,47.11
Gangplank,Yorick,772,386,386,50
Gangplank,FiddleSticks,385,165,220,42.86
Gangplank,Draven,539,276,263,51.21
Gangplank,Smolder,527,280,247,53.13
Gangplank,Nautilus,953,469,484,49.21
Gangplank,TahmKench,628,318,310,50.64
Gangplank,Malphite,834,394,440,47.24
Gangplank,Yasuo,1806,886,920,49.06
Gangplank,Aphelios,521,242,279,46.45
Gangplank,TwistedFate,442,189,253,42.76
Gangplank,LeeSin,1513,749,764,49.5
Gangplank,Yone,1641,794,847,48.39
Gangplank,MissFortune,1797,895,902,49.81
Gangplank,Mel,1738,803,935,46.2
Gangplank,Riven,438,214,224,48.86
Gangplank,Kayn,1273,619,654,48.63
Gangplank,Ahri,1290,669,621,51.86
Gangplank,Jinx,2300,1118,1182,48.61
Gangplank,Irelia,867,424,443,48.9
Gangplank,Pantheon,1451,714,737,49.21
Gangplank,Kassadin,198,105,93,53.03
Gangplank,Yuumi,762,377,385,49.48
Gangplank,Fiora,352,153,199,43.47
Gangplank,Syndra,509,248,261,48.72
Gangplank,Vayne,990,521,469,52.63
Gangplank,Mordekaiser,1040,451,589,43.37
Gangplank,Warwick,1108,524,584,47.29
Gangplank,Akali,840,430,410,51.19
Gangplank,Velkoz,565,284,281,50.27
Gangplank,Vladimir,660,316,344,47.88
Gangplank,Diana,1361,644,717,47.32
Gangplank,Karma,1169,575,594,49.19
Gangplank,Shen,658,345,313,52.43
Gangplank,Teemo,1184,596,588,50.34
Gangplank,Twitch,716,347,369,48.46
Gangplank,Ornn,436,222,214,50.92
Gangplank,Amumu,816,345,471,42.28
Gangplank,Katarina,754,387,367,51.33
Gangplank,Senna,652,299,353,45.86
Gangplank,Graves,679,346,333,50.96
Gangplank,Aurora,717,349,368,48.68
Gangplank,Nilah,366,186,180,50.82
Gangplank,Hwei,579,278,301,48.01
Gangplank,Olaf,207,85,122,41.06
Gangplank,Aatrox,1144,589,555,51.49
Gangplank,Braum,486,242,244,49.79
Gangplank,Varus,818,382,436,46.7
Gangplank,Janna,373,161,212,43.16
Gangplank,Gnar,438,233,205,53.2
Gangplank,Shaco,878,464,414,52.85
Gangplank,Xayah,474,195,279,41.14
Gangplank,Seraphine,662,365,297,55.14
Gangplank,Darius,1663,846,817,50.87
Gangplank,XinZhao,592,261,331,44.09
Gangplank,Zeri,390,159,231,40.77
Gangplank,Taric,217,84,133,38.71
Gangplank,Rengar,336,152,184,45.24
Gangplank,Thresh,1224,538,686,43.95
Gangplank,Kalista,261,130,131,49.81
Gangplank,Nasus,555,325,230,58.56
Gangplank,Jayce,565,299,266,52.92
Gangplank,JarvanIV,539,262,277,48.61
Gangplank,Poppy,531,269,262,50.66
Gangplank,Gragas,626,298,328,47.6
Gangplank,Annie,289,152,137,52.6
Gangplank,Ekko,824,424,400,51.46
Gangplank,Akshan,377,199,178,52.79
Gangplank,Nami,925,457,468,49.41
Gangplank,Veigar,819,395,424,48.23
Gangplank,Malzahar,940,407,533,43.3
Gangplank,Camille,290,188,102,64.83
Gangplank,Evelynn,324,171,153,52.78
Gangplank,Taliyah,243,106,137,43.62
Gangplank,Sett,1222,505,717,41.33
Gangplank,Ashe,1726,843,883,48.84
Gangplank,Viego,1330,667,663,50.15
Gangplank,Khazix,460,216,244,46.96
Gangplank,Nocturne,1107,467,640,42.19
Gangplank,Xerath,802,401,401,50
Gangplank,Lux,2148,1087,1061,50.61
Gangplank,Sona,316,140,176,44.3
Gangplank,Renekton,375,200,175,53.33
Gangplank,Leblanc,530,267,263,50.38
Gangplank,MonkeyKing,634,315,319,49.68
Gangplank,Jax,830,391,439,47.11
Gangplank,Talon,585,298,287,50.94
Gangplank,Volibear,947,461,486,48.68
Gangplank,Singed,271,142,129,52.4
Gangplank,Sejuani,414,169,245,40.82
Gangplank,Sylas,1303,678,625,52.03
Gangplank,Illaoi,348,156,192,44.83
Gangplank,Belveth,238,121,117,50.84
Gangplank,Orianna,419,212,207,50.6
Gangplank,Alistar,425,227,198,53.41
Gangplank,Nidalee,235,121,114,51.49
Gangplank,Ziggs,338,150,188,44.38
Gangplank,Blitzcrank,720,334,386,46.39
Gangplank,Kled,189,100,89,52.91
Gangplank,MasterYi,848,413,435,48.7
Gangplank,Zyra,816,376,440,46.08
Gangplank,Kaisa,1513,770,743,50.89
Gangplank,Urgot,473,200,273,42.28
Gangplank,Swain,773,348,425,45.02
Gangplank,Rammus,252,113,139,44.84
Gangplank,Zilean,265,128,137,48.3
Gangplank,Hecarim,407,196,211,48.16
Gangplank,Milio,623,263,360,42.22
Gangplank,Kayle,694,280,414,40.35
Gangplank,Chogath,1037,502,535,48.41
Gangplank,Vex,437,223,214,51.03
Gangplank,Skarner,281,139,142,49.47
Gangplank,Renata,190,83,107,43.68
Gangplank,Zac,415,207,208,49.88
Gangplank,Rell,428,260,168,60.75
Gangplank,Leona,675,366,309,54.22
Gangplank,Tryndamere,470,235,235,50
Gangplank,Sivir,503,244,259,48.51
Gangplank,Rumble,255,128,127,50.2
Gangplank,Ivern,136,69,67,50.74
Gangplank,Ryze,312,119,193,38.14
Gangplank,Shyvana,238,119,119,50
Gangplank,Elise,702,349,353,49.72
Gangplank,Rakan,374,193,181,51.6
Gangplank,Kennen,323,162,161,50.15
Gangplank,Ezreal,2203,1118,1085,50.75
Gangplank,Qiyana,244,125,119,51.23
Gangplank,Lulu,1169,599,570,51.24
Gangplank,Sion,732,352,380,48.09
Gangplank,KSante,386,204,182,52.85
Gangplank,Tristana,910,415,495,45.6
Gangplank,Fizz,506,241,265,47.63
Gangplank,Lucian,718,398,320,55.43
Gangplank,Galio,742,326,416,43.94
Gangplank,Neeko,508,218,290,42.91
Gangplank,Quinn,377,208,169,55.17
Gangplank,Kindred,376,179,197,47.61
Gangplank,Zoe,422,233,189,55.21
Gangplank,Cassiopeia,288,122,166,42.36
Gangplank,Lissandra,262,140,122,53.44
Gangplank,KogMaw,289,139,150,48.1
Gangplank,Brand,480,207,273,43.13
Gangplank,Maokai,385,212,173,55.06
Gangplank,Nunu,473,247,226,52.22
Gangplank,Anivia,324,139,185,42.9
Gangplank,Samira,662,322,340,48.64
Gangplank,Naafiri,305,139,166,45.57
Gangplank,Corki,337,165,172,48.96
Gangplank,Bard,311,175,136,56.27
Gangplank,Ambessa,564,319,245,56.56
Gangplank,Udyr,331,164,167,49.55
Gangplank,Karthus,275,151,124,54.91
Gangplank,Heimerdinger,427,211,216,49.41
Gangplank,Trundle,468,200,268,42.74
Gangplank,AurelionSol,316,145,171,45.89
Gangplank,Azir,362,164,198,45.3
Gangplank,RekSai,152,56,96,36.84
Gwen,Chogath,1724,816,908,47.33
Gwen,Kayn,1441,691,750,47.95
Gwen,Gangplank,460,222,238,48.26
Gwen,Ezreal,2228,1100,1128,49.37
Gwen,Hwei,775,366,409,47.23
Gwen,Jax,908,398,510,43.83
Gwen,Nidalee,276,154,122,55.8
Gwen,Ahri,1470,718,752,48.84
Gwen,Jhin,1901,957,944,50.34
Gwen,Senna,795,364,431,45.79
Gwen,Sett,1732,732,1000,42.26
Gwen,Taliyah,289,141,148,48.79
Gwen,Cassiopeia,324,178,146,54.94
Gwen,Kaisa,1660,826,834,49.76
Gwen,Neeko,611,305,306,49.92
Gwen,Irelia,854,394,460,46.14
Gwen,Diana,1787,816,971,45.66
Gwen,Lux,2555,1188,1367,46.5
Gwen,Tristana,1103,544,559,49.32
Gwen,Mel,2101,1041,1060,49.55
Gwen,XinZhao,688,328,360,47.67
Gwen,Katarina,945,444,501,46.98
Gwen,Teemo,1122,466,656,41.53
Gwen,Vayne,1124,516,608,45.91
Gwen,TwistedFate,340,147,193,43.24
Gwen,Riven,599,310,289,51.75
Gwen,Nocturne,1208,589,619,48.76
Gwen,Zoe,493,270,223,54.77
Gwen,Jinx,2758,1283,1475,46.52
Gwen,Lulu,1115,560,555,50.22
Gwen,Camille,344,170,174,49.42
Gwen,Warwick,1808,796,1012,44.03
Gwen,MissFortune,2475,1085,1390,43.84
Gwen,Zyra,879,421,458,47.9
Gwen,LeeSin,1254,621,633,49.52
Gwen,Lucian,755,369,386,48.87
Gwen,Xerath,792,381,411,48.11
Gwen,Elise,698,394,304,56.45
Gwen,Galio,954,447,507,46.86
Gwen,Twitch,928,453,475,48.81
Gwen,Soraka,652,309,343,47.39
Gwen,Illaoi,583,263,320,45.11
Gwen,Aurora,855,400,455,46.78
Gwen,Vi,968,411,557,42.46
Gwen,Briar,810,383,427,47.28
Gwen,Janna,414,159,255,38.41
Gwen,Gnar,402,171,231,42.54
Gwen,Yasuo,1833,915,918,49.92
Gwen,Zeri,441,174,267,39.46
Gwen,Taric,255,113,142,44.31
Gwen,Ambessa,643,315,328,48.99
Gwen,Sejuani,509,264,245,51.87
Gwen,Veigar,1061,452,609,42.6
Gwen,Nilah,403,196,207,48.64
Gwen,Karma,983,432,551,43.95
Gwen,Lillia,547,287,260,52.47
Gwen,Pyke,1033,562,471,54.4
Gwen,Viego,1353,605,748,44.72
Gwen,Mordekaiser,1477,690,787,46.72
Gwen,Akali,1111,471,640,42.39
Gwen,Sylas,1230,617,613,50.16
Gwen,Draven,554,285,269,51.44
Gwen,Velkoz,665,326,339,49.02
Gwen,KSante,643,336,307,52.26
Gwen,Belveth,312,157,155,50.32
Gwen,Yuumi,940,446,494,47.45
Gwen,Rengar,438,242,196,55.25
Gwen,Ashe,1956,910,1046,46.52
Gwen,Kennen,270,162,108,60
Gwen,Shaco,834,394,440,47.24
Gwen,Brand,671,299,372,44.56
Gwen,Sona,405,198,207,48.89
Gwen,FiddleSticks,496,219,277,44.15
Gwen,Yone,1919,979,940,51.02
Gwen,Caitlyn,2583,1250,1333,48.39
Gwen,Tryndamere,583,286,297,49.06
Gwen,Zed,940,457,483,48.62
Gwen,Blitzcrank,768,399,369,51.95
Gwen,Garen,1759,746,1013,42.41
Gwen,Trundle,611,281,330,45.99
Gwen,Samira,894,442,452,49.44
Gwen,Heimerdinger,484,212,272,43.8
Gwen,Alistar,371,185,186,49.87
Gwen,Orianna,430,210,220,48.84
Gwen,Pantheon,1635,827,808,50.58
Gwen,AurelionSol,445,180,265,40.45
Gwen,MasterYi,1219,559,660,45.86
Gwen,Fizz,612,280,332,45.75
Gwen,Nami,1118,485,633,43.38
Gwen,Malzahar,1041,459,582,44.09
Gwen,Seraphine,976,453,523,46.41
Gwen,Rammus,381,210,171,55.12
Gwen,Aatrox,883,445,438,50.4
Gwen,Leona,904,464,440,51.33
Gwen,Nasus,758,353,405,46.57
Gwen,Xayah,556,246,310,44.24
Gwen,Rakan,510,182,328,35.69
Gwen,Morgana,1430,585,845,40.91
Gwen,Jayce,349,186,163,53.3
Gwen,Zilean,274,162,112,59.12
Gwen,Graves,633,284,349,44.87
Gwen,Hecarim,372,194,178,52.15
Gwen,Nautilus,1247,617,630,49.48
Gwen,Nunu,716,368,348,51.4
Gwen,Darius,1813,915,898,50.47
Gwen,Yorick,1239,513,726,41.4
Gwen,Zac,579,259,320,44.73
Gwen,Malphite,1162,552,610,47.5
Gwen,Evelynn,408,216,192,52.94
Gwen,Sion,1155,549,606,47.53
Gwen,Ekko,980,496,484,50.61
Gwen,Varus,931,484,447,51.99
Gwen,Leblanc,503,251,252,49.9
Gwen,Vladimir,753,327,426,43.43
Gwen,Ivern,225,115,110,51.11
Gwen,Smolder,724,348,376,48.07
Gwen,Milio,654,319,335,48.78
Gwen,Renekton,517,262,255,50.68
Gwen,Karthus,274,126,148,45.99
Gwen,Braum,576,248,328,43.06
Gwen,Fiora,577,326,251,56.5
Gwen,Corki,406,196,210,48.28
Gwen,Khazix,513,262,251,51.07
Gwen,TahmKench,1132,529,603,46.73
Gwen,Amumu,1168,556,612,47.6
Gwen,Volibear,1253,556,697,44.37
Gwen,Gragas,564,260,304,46.1
Gwen,Naafiri,411,187,224,45.5
Gwen,Akshan,364,173,191,47.53
Gwen,Aphelios,631,312,319,49.45
Gwen,Sivir,531,220,311,41.43
Gwen,Qiyana,314,140,174,44.59
Gwen,Annie,359,198,161,55.15
Gwen,JarvanIV,611,249,362,40.75
Gwen,Ziggs,414,220,194,53.14
Gwen,Shyvana,328,174,154,53.05
Gwen,Ryze,352,169,183,48.01
Gwen,Rell,565,278,287,49.2
Gwen,Talon,526,261,265,49.62
Gwen,Thresh,1447,641,806,44.3
Gwen,MonkeyKing,680,333,347,48.97
Gwen,Swain,1000,457,543,45.7
Gwen,Ornn,592,292,300,49.32
Gwen,Lissandra,333,175,158,52.55
Gwen,Udyr,502,237,265,47.21
Gwen,Vex,587,278,309,47.36
Gwen,Renata,210,107,103,50.95
Gwen,KogMaw,379,187,192,49.34
Gwen,Urgot,531,294,237,55.37
Gwen,Kindred,525,281,244,53.52
Gwen,Shen,840,399,441,47.5
Gwen,Skarner,305,159,146,52.13
Gwen,Syndra,567,241,326,42.5
Gwen,Anivia,352,161,191,45.74
Gwen,Kayle,722,326,396,45.15
Gwen,Viktor,930,446,484,47.96
Gwen,Rumble,235,112,123,47.66
Gwen,Maokai,456,203,253,44.52
Gwen,DrMundo,763,420,343,55.05
Gwen,Bard,396,190,206,47.98
Gwen,Poppy,682,262,420,38.42
Gwen,Kalista,304,164,140,53.95
Gwen,Azir,325,182,143,56
Gwen,Kassadin,247,99,148,40.08
Gwen,Olaf,218,119,99,54.59
Gwen,Singed,299,108,191,36.12
Gwen,Kled,210,88,122,41.9
Gwen,Quinn,393,156,237,39.69
Gwen,RekSai,137,67,70,48.91
Vi,Chogath,2379,1153,1226,48.47
Vi,Kayn,2786,1396,1390,50.11
Vi,Gangplank,864,430,434,49.77
Vi,Ezreal,4667,2441,2226,52.3
Vi,Hwei,1311,680,631,51.87
Vi,Braum,1100,535,565,48.64
Vi,XinZhao,1304,628,676,48.16
Vi,Lux,4276,2184,2092,51.08
Vi,Taliyah,561,306,255,54.55
Vi,Yorick,1528,686,842,44.9
Vi,Seraphine,1393,687,706,49.32
Vi,Sivir,1001,458,543,45.75
Vi,Xerath,1806,867,939,48.01
Vi,KSante,970,486,484,50.1
Vi,Warwick,2918,1347,1571,46.16
Vi,Diana,2980,1398,1582,46.91
Vi,Ashe,3579,1775,1804,49.59
Vi,Corki,718,399,319,55.57
Vi,Akali,1886,1007,879,53.39
Vi,Akshan,653,330,323,50.54
Vi,TahmKench,1583,821,762,51.86
Vi,Urgot,886,447,439,50.45
Vi,LeeSin,3522,1883,1639,53.46
Vi,TwistedFate,724,369,355,50.97
Vi,Yasuo,3626,1819,1807,50.17
Vi,Rakan,895,461,434,51.51
Vi,Kennen,544,267,277,49.08
Vi,Kaisa,3006,1543,1463,51.33
Vi,Caitlyn,5016,2526,2490,50.36
Vi,Malphite,1710,841,869,49.18
Vi,Vex,1029,537,492,52.19
Vi,Twitch,1339,748,591,55.86
Vi,Yuumi,1648,859,789,52.12
Vi,Gwen,968,557,411,57.54
Vi,Udyr,696,376,320,54.02
Vi,Orianna,824,427,397,51.82
Vi,Nautilus,2052,1057,995,51.51
Vi,Darius,3363,1662,1701,49.42
Vi,Zed,2083,1124,959,53.96
Vi,Syndra,1178,572,606,48.56
Vi,Senna,1367,591,776,43.23
Vi,Sejuani,820,412,408,50.24
Vi,Heimerdinger,851,408,443,47.94
Vi,Jinx,4836,2371,2465,49.03
Vi,Zilean,552,267,285,48.37
Vi,Garen,2976,1422,1554,47.78
Vi,Aurora,1414,717,697,50.71
Vi,MissFortune,4064,1910,2154,47
Vi,Rell,1011,494,517,48.86
Vi,Fiora,741,397,344,53.58
Vi,Sylas,2654,1351,1303,50.9
Vi,Ornn,850,408,442,48
Vi,Shaco,1659,905,754,54.55
Vi,Annie,570,302,268,52.98
Vi,Volibear,2172,1073,1099,49.4
Vi,Teemo,2177,1005,1172,46.16
Vi,Tristana,1751,898,853,51.28
Vi,Thresh,2582,1250,1332,48.41
Vi,Yone,3517,1859,1658,52.86
Vi,Rengar,593,357,236,60.2
Vi,KogMaw,625,317,308,50.72
Vi,Zoe,838,486,352,58
Vi,Anivia,588,311,277,52.89
Vi,JarvanIV,1154,575,579,49.83
Vi,Katarina,1405,758,647,53.95
Vi,Aatrox,1686,887,799,52.61
Vi,FiddleSticks,834,422,412,50.6
Vi,Jayce,1077,481,596,44.66
Vi,Gragas,1250,649,601,51.92
Vi,Hecarim,774,394,380,50.9
Vi,Jhin,3373,1650,1723,48.92
Vi,Velkoz,1053,479,574,45.49
Vi,Irelia,1609,742,867,46.12
Vi,Zyra,1657,763,894,46.05
Vi,Morgana,2336,1148,1188,49.14
Vi,Rammus,524,227,297,43.32
Vi,Alistar,828,416,412,50.24
Vi,Kassadin,421,186,235,44.18
Vi,Milio,1065,502,563,47.14
Vi,Veigar,1847,878,969,47.54
Vi,Kayle,1322,605,717,45.76
Vi,Amumu,1729,800,929,46.27
Vi,AurelionSol,790,396,394,50.13
Vi,Smolder,1189,586,603,49.29
Vi,Janna,627,276,351,44.02
Vi,Pantheon,3035,1549,1486,51.04
Vi,Lillia,1120,566,554,50.54
Vi,Lulu,2147,1071,1076,49.88
Vi,Jax,1659,816,843,49.19
Vi,Nilah,662,295,367,44.56
Vi,Karma,2199,1149,1050,52.25
Vi,Ziggs,696,308,388,44.25
Vi,Pyke,1571,857,714,54.55
Vi,Mordekaiser,2432,1233,1199,50.7
Vi,Qiyana,454,258,196,56.83
Vi,Brand,1272,667,605,52.44
Vi,Poppy,1303,629,674,48.27
Vi,Viego,2672,1233,1439,46.15
Vi,Mel,3790,1931,1859,50.95
Vi,Gnar,820,419,401,51.1
Vi,Malzahar,1690,833,857,49.29
Vi,Ryze,588,301,287,51.19
Vi,Viktor,1584,801,783,50.57
Vi,Quinn,697,366,331,52.51
Vi,Xayah,1189,562,627,47.27
Vi,Neeko,988,486,502,49.19
Vi,Talon,1174,611,563,52.04
Vi,Leona,1603,894,709,55.77
Vi,Shen,1159,617,542,53.24
Vi,Nami,1846,861,985,46.64
Vi,Zac,1015,511,504,50.34
Vi,Camille,664,329,335,49.55
Vi,Leblanc,1043,557,486,53.4
Vi,Renata,429,221,208,51.52
Vi,Vayne,2230,1133,1097,50.81
Vi,Zeri,957,539,418,56.32
Vi,MasterYi,2206,1174,1032,53.22
Vi,Fizz,1027,518,509,50.44
Vi,Ivern,336,176,160,52.38
Vi,Sett,2900,1468,1432,50.62
Vi,Samira,1272,668,604,52.52
Vi,Briar,1516,696,820,45.91
Vi,Lucian,1422,716,706,50.35
Vi,Ambessa,1286,681,605,52.95
Vi,Graves,1103,511,592,46.33
Vi,Nunu,1124,560,564,49.82
Vi,Sion,1476,739,737,50.07
Vi,Skarner,574,333,241,58.01
Vi,Vladimir,1063,445,618,41.86
Vi,Aphelios,1029,502,527,48.79
Vi,Nidalee,534,312,222,58.43
Vi,Ekko,1565,742,823,47.41
Vi,Cassiopeia,608,294,314,48.36
Vi,Tryndamere,944,463,481,49.05
Vi,Swain,1850,828,1022,44.76
Vi,Khazix,919,462,457,50.27
Vi,Ahri,2600,1270,1330,48.85
Vi,Soraka,1024,440,584,42.97
Vi,Renekton,983,449,534,45.68
Vi,Nocturne,2261,1000,1261,44.23
Vi,Elise,1258,622,636,49.44
Vi,Illaoi,909,458,451,50.39
Vi,Riven,845,464,381,54.91
Vi,Blitzcrank,1329,658,671,49.51
Vi,Kled,331,156,175,47.13
Vi,Varus,1647,854,793,51.85
Vi,Galio,1683,748,935,44.44
Vi,Belveth,432,229,203,53.01
Vi,Evelynn,770,457,313,59.35
Vi,Taric,406,202,204,49.75
Vi,Naafiri,633,337,296,53.24
Vi,Singed,462,198,264,42.86
Vi,Lissandra,540,270,270,50
Vi,Kindred,830,447,383,53.86
Vi,Nasus,1343,736,607,54.8
Vi,DrMundo,1059,526,533,49.67
Vi,Karthus,504,248,256,49.21
Vi,Olaf,479,241,238,50.31
Vi,Draven,941,450,491,47.82
Vi,Maokai,762,412,350,54.07
Vi,Sona,482,227,255,47.1
Vi,RekSai,211,98,113,46.45
Vi,Bard,531,258,273,48.59
Vi,Azir,650,379,271,58.31
Vi,MonkeyKing,1385,717,668,51.77
Vi,Trundle,976,437,539,44.77
Vi,Rumble,533,229,304,42.96
Vi,Kalista,534,266,268,49.81
Vi,Shyvana,410,171,239,41.71
Soraka,Chogath,1450,658,792,45.38
Soraka,Kayn,1707,922,785,54.01
Soraka,Gangplank,557,292,265,52.42
Soraka,Ezreal,2191,1191,1000,54.36
Soraka,Hwei,730,344,386,47.12
Soraka,Zed,1167,572,595,49.01
Soraka,Sona,395,219,176,55.44
Soraka,Kaisa,1749,961,788,54.95
Soraka,Amumu,1068,544,524,50.94
Soraka,Sett,1597,822,775,51.47
Soraka,Vladimir,621,371,250,59.74
Soraka,Kindred,545,314,231,57.61
Soraka,Aphelios,739,386,353,52.23
Soraka,Pyke,1033,591,442,57.21
Soraka,Teemo,1462,752,710,51.44
Soraka,LeeSin,1439,781,658,54.27
Soraka,Yone,1887,1024,863,54.27
Soraka,Jhin,2331,1236,1095,53.02
Soraka,Nami,1407,686,721,48.76
Soraka,Annie,373,176,197,47.18
Soraka,Aatrox,954,479,475,50.21
Soraka,MissFortune,2371,1170,1201,49.35
Soraka,Diana,1469,690,779,46.97
Soraka,Akali,1223,706,517,57.73
Soraka,Caitlyn,2755,1471,1284,53.39
Soraka,Karma,1304,663,641,50.84
Soraka,Shaco,1149,619,530,53.87
Soraka,Anivia,390,177,213,45.38
Soraka,Lux,3050,1569,1481,51.44
Soraka,Morgana,1408,686,722,48.72
Soraka,Volibear,1291,689,602,53.37
Soraka,Ambessa,708,339,369,47.88
Soraka,Smolder,723,370,353,51.18
Soraka,Swain,1128,559,569,49.56
Soraka,Vayne,1283,677,606,52.77
Soraka,Briar,975,501,474,51.38
Soraka,Mel,2593,1381,1212,53.26
Soraka,Yuumi,980,484,496,49.39
Soraka,Shen,807,383,424,47.46
Soraka,Twitch,985,491,494,49.85
Soraka,Nautilus,1208,655,553,54.22
Soraka,Pantheon,1778,1021,757,57.42
Soraka,Warwick,1707,878,829,51.44
Soraka,Leblanc,532,276,256,51.88
Soraka,Leona,1000,562,438,56.2
Soraka,Gwen,652,343,309,52.61
Soraka,Tristana,1072,616,456,57.46
Soraka,Poppy,596,339,257,56.88
Soraka,KSante,528,293,235,55.49
Soraka,Viego,1515,730,785,48.18
Soraka,Vex,593,256,337,43.17
Soraka,Jinx,2959,1493,1466,50.46
Soraka,Senna,932,454,478,48.71
Soraka,Ivern,198,99,99,50
Soraka,Yasuo,2078,1037,1041,49.9
Soraka,Evelynn,453,249,204,54.97
Soraka,Brand,756,395,361,52.25
Soraka,Udyr,404,213,191,52.72
Soraka,Orianna,464,238,226,51.29
Soraka,Ashe,2097,1104,993,52.65
Soraka,Irelia,1031,507,524,49.18
Soraka,Quinn,457,243,214,53.17
Soraka,Thresh,1455,704,751,48.38
Soraka,Renekton,554,296,258,53.43
Soraka,Lillia,625,277,348,44.32
Soraka,Xerath,937,513,424,54.75
Soraka,Rammus,403,218,185,54.09
Soraka,Garen,1618,769,849,47.53
Soraka,Talon,688,413,275,60.03
Soraka,Milio,819,410,409,50.06
Soraka,Singed,328,157,171,47.87
Soraka,Galio,897,458,439,51.06
Soraka,Riven,561,286,275,50.98
Soraka,TwistedFate,396,193,203,48.74
Soraka,Fiora,428,214,214,50
Soraka,Varus,982,490,492,49.9
Soraka,Janna,374,179,195,47.86
Soraka,MonkeyKing,725,395,330,54.48
Soraka,Katarina,902,448,454,49.67
Soraka,Darius,2056,1049,1007,51.02
Soraka,Jax,1046,506,540,48.37
Soraka,Ekko,1113,547,566,49.15
Soraka,Shyvana,286,142,144,49.65
Soraka,Taliyah,277,172,105,62.09
Soraka,Corki,461,278,183,60.3
Soraka,Elise,792,395,397,49.87
Soraka,Seraphine,1021,491,530,48.09
Soraka,Mordekaiser,1567,786,781,50.16
Soraka,Qiyana,302,168,134,55.63
Soraka,Neeko,578,290,288,50.17
Soraka,Sylas,1312,680,632,51.83
Soraka,Gragas,629,405,224,64.39
Soraka,Nilah,395,158,237,40
Soraka,Kennen,378,188,190,49.74
Soraka,Malzahar,1065,569,496,53.43
Soraka,Yorick,1123,514,609,45.77
Soraka,Lulu,1566,753,813,48.08
Soraka,Viktor,971,507,464,52.21
Soraka,Lucian,733,408,325,55.66
Soraka,Braum,603,315,288,52.24
Soraka,Ornn,512,262,250,51.17
Soraka,Graves,643,367,276,57.08
Soraka,MasterYi,1213,565,648,46.58
Soraka,Draven,689,355,334,51.52
Soraka,Hecarim,493,235,258,47.67
Soraka,Ahri,1458,783,675,53.7
Soraka,Blitzcrank,762,419,343,54.99
Soraka,Zeri,501,260,241,51.9
Soraka,Kayle,795,410,385,51.57
Soraka,Kled,201,97,104,48.26
Soraka,Veigar,1262,644,618,51.03
Soraka,Sejuani,471,285,186,60.51
Soraka,Sion,893,444,449,49.72
Soraka,Alistar,415,198,217,47.71
Soraka,Malphite,920,432,488,46.96
Soraka,Nunu,777,378,399,48.65
Soraka,Nasus,869,452,417,52.01
Soraka,Rell,563,272,291,48.31
Soraka,KogMaw,391,199,192,50.9
Soraka,Aurora,860,465,395,54.07
Soraka,Bard,404,245,159,60.64
Soraka,TahmKench,930,498,432,53.55
Soraka,Rengar,403,197,206,48.88
Soraka,Cassiopeia,355,188,167,52.96
Soraka,Naafiri,437,221,216,50.57
Soraka,Trundle,672,319,353,47.47
Soraka,Zilean,359,180,179,50.14
Soraka,Velkoz,729,367,362,50.34
Soraka,Ziggs,468,232,236,49.57
Soraka,Azir,364,173,191,47.53
Soraka,Sivir,521,239,282,45.87
Soraka,Zyra,1004,530,474,52.79
Soraka,Vi,1024,584,440,57.03
Soraka,Zoe,493,256,237,51.93
Soraka,DrMundo,551,277,274,50.27
Soraka,FiddleSticks,535,255,280,47.66
Soraka,Camille,429,210,219,48.95
Soraka,Olaf,245,125,120,51.02
Soraka,Gnar,438,228,210,52.05
Soraka,Syndra,722,398,324,55.12
Soraka,Nidalee,310,179,131,57.74
Soraka,Fizz,565,284,281,50.27
Soraka,Taric,231,127,104,54.98
Soraka,Karthus,385,215,170,55.84
Soraka,Illaoi,568,282,286,49.65
Soraka,AurelionSol,476,209,267,43.91
Soraka,JarvanIV,671,356,315,53.06
Soraka,Heimerdinger,538,273,265,50.74
Soraka,Samira,846,397,449,46.93
Soraka,Rumble,262,135,127,51.53
Soraka,Khazix,552,286,266,51.81
Soraka,Tryndamere,656,360,296,54.88
Soraka,Kassadin,247,123,124,49.8
Soraka,Maokai,440,233,207,52.95
Soraka,Nocturne,1190,600,590,50.42
Soraka,Renata,201,112,89,55.72
Soraka,XinZhao,633,354,279,55.92
Soraka,Akshan,429,207,222,48.25
Soraka,Ryze,330,179,151,54.24
Soraka,Xayah,597,303,294,50.75
Soraka,Rakan,493,268,225,54.36
Soraka,Zac,527,242,285,45.92
Soraka,Jayce,544,244,300,44.85
Soraka,Lissandra,334,165,169,49.4
Soraka,Skarner,300,155,145,51.67
Soraka,Urgot,486,222,264,45.68
Soraka,Kalista,402,209,193,51.99
Soraka,RekSai,132,69,63,52.27
Soraka,Belveth,329,170,159,51.67
Jax,Vladimir,1201,567,634,47.21
Jax,Viego,2495,1283,1212,51.42
Jax,Velkoz,959,424,535,44.21
Jax,Kaisa,2869,1458,1411,50.82
Jax,Karma,1870,851,1019,45.51
Jax,Irelia,1799,825,974,45.86
Jax,Zed,1878,918,960,48.88
Jax,Galio,1643,729,914,44.37
Jax,MissFortune,4059,1863,2196,45.9
Jax,TahmKench,1409,721,688,51.17
Jax,Gwen,908,510,398,56.17
Jax,Talon,937,466,471,49.73
Jax,Yone,3842,2032,1810,52.89
Jax,Taric,350,130,220,37.14
Jax,Poppy,1227,613,614,49.96
Jax,Warwick,2960,1378,1582,46.55
Jax,Katarina,1310,652,658,49.77
Jax,Twitch,1387,708,679,51.05
Jax,Morgana,2233,1106,1127,49.53
Jax,Briar,1407,751,656,53.38
Jax,Vex,972,533,439,54.84
Jax,Jinx,4708,2284,2424,48.51
Jax,Milio,1069,506,563,47.33
Jax,Akali,1991,960,1031,48.22
Jax,Rammus,582,230,352,39.52
Jax,Yasuo,3901,1932,1969,49.53
Jax,Zyra,1480,658,822,44.46
Jax,Ryze,514,270,244,52.53
Jax,Nunu,1089,503,586,46.19
Jax,Ahri,2371,1204,1167,50.78
Jax,Lucian,1207,621,586,51.45
Jax,Alistar,773,408,365,52.78
Jax,Ornn,698,341,357,48.85
Jax,TwistedFate,690,353,337,51.16
Jax,Caitlyn,4620,2146,2474,46.45
Jax,Pantheon,2856,1441,1415,50.46
Jax,Leblanc,1064,513,551,48.21
Jax,Aphelios,935,531,404,56.79
Jax,Leona,1525,756,769,49.57
Jax,Yorick,1710,770,940,45.03
Jax,Draven,832,460,372,55.29
Jax,KogMaw,628,322,306,51.27
Jax,Yuumi,1371,717,654,52.3
Jax,Tryndamere,1113,555,558,49.87
Jax,Sylas,2381,1239,1142,52.04
Jax,Taliyah,509,246,263,48.33
Jax,Jhin,3454,1618,1836,46.84
Jax,Senna,1401,724,677,51.68
Jax,Malphite,1565,764,801,48.82
Jax,Diana,2781,1360,1421,48.9
Jax,Lux,4648,2224,2424,47.85
Jax,Fiora,755,336,419,44.5
Jax,Shaco,1586,772,814,48.68
Jax,Fizz,1059,501,558,47.31
Jax,Tristana,1832,928,904,50.66
Jax,Rakan,820,376,444,45.85
Jax,Sett,2822,1368,1454,48.48
Jax,FiddleSticks,834,402,432,48.2
Jax,Samira,1357,670,687,49.37
Jax,Neeko,989,498,491,50.35
Jax,Volibear,2095,1041,1054,49.69
Jax,LeeSin,2612,1356,1256,51.91
Jax,Malzahar,1603,728,875,45.41
Jax,Pyke,1911,972,939,50.86
Jax,Renekton,943,443,500,46.98
Jax,Khazix,896,484,412,54.02
Jax,Quinn,577,252,325,43.67
Jax,Kayn,2710,1347,1363,49.7
Jax,Aatrox,1575,834,741,52.95
Jax,Mel,3462,1752,1710,50.61
Jax,Ezreal,4021,2145,1876,53.34
Jax,Elise,1277,633,644,49.57
Jax,Shen,1206,599,607,49.67
Jax,Amumu,1724,761,963,44.14
Jax,Ziggs,713,313,400,43.9
Jax,Jayce,845,423,422,50.06
Jax,Swain,1838,806,1032,43.85
Jax,Sion,1192,605,587,50.76
Jax,XinZhao,1145,560,585,48.91
Jax,Soraka,1046,540,506,51.63
Jax,Singed,501,264,237,52.69
Jax,Garen,3627,1594,2033,43.95
Jax,Zilean,556,265,291,47.66
Jax,Rengar,630,389,241,61.75
Jax,Aurora,1333,706,627,52.96
Jax,Seraphine,1484,709,775,47.78
Jax,Gragas,1342,662,680,49.33
Jax,Veigar,1942,960,982,49.43
Jax,Kalista,567,274,293,48.32
Jax,Trundle,1209,645,564,53.35
Jax,MonkeyKing,1079,544,535,50.42
Jax,Darius,3098,1572,1526,50.74
Jax,Chogath,2025,897,1128,44.3
Jax,Evelynn,742,367,375,49.46
Jax,Nocturne,2145,1043,1102,48.62
Jax,Thresh,2293,1087,1206,47.41
Jax,Olaf,463,244,219,52.7
Jax,Ashe,3502,1730,1772,49.4
Jax,AurelionSol,739,353,386,47.77
Jax,Nilah,622,336,286,54.02
Jax,Riven,763,392,371,51.38
Jax,Syndra,1080,508,572,47.04
Jax,MasterYi,2622,1308,1314,49.89
Jax,Xayah,984,505,479,51.32
Jax,Hwei,1193,630,563,52.81
Jax,Illaoi,1000,432,568,43.2
Jax,Mordekaiser,2467,1173,1294,47.55
Jax,Nami,1579,771,808,48.83
Jax,Nautilus,1887,932,955,49.39
Jax,Viktor,1444,719,725,49.79
Jax,DrMundo,1173,548,625,46.72
Jax,Rell,921,483,438,52.44
Jax,Zoe,726,384,342,52.89
Jax,Udyr,591,313,278,52.96
Jax,Lulu,2188,1025,1163,46.85
Jax,Teemo,2180,1042,1138,47.8
Jax,Lillia,1124,514,610,45.73
Jax,Graves,1210,621,589,51.32
Jax,Kennen,499,283,216,56.71
Jax,Brand,1268,631,637,49.76
Jax,Maokai,769,400,369,52.02
Jax,Camille,691,394,297,57.02
Jax,Skarner,583,283,300,48.54
Jax,Vi,1659,843,816,50.81
Jax,Xerath,1504,726,778,48.27
Jax,Kayle,1417,720,697,50.81
Jax,Ekko,1586,850,736,53.59
Jax,Urgot,800,375,425,46.88
Jax,Ivern,234,100,134,42.74
Jax,Kassadin,384,220,164,57.29
Jax,Gangplank,830,439,391,52.89
Jax,Hecarim,732,362,370,49.45
Jax,Annie,597,301,296,50.42
Jax,Vayne,2017,1002,1015,49.68
Jax,Corki,706,372,334,52.69
Jax,Ambessa,1216,579,637,47.62
Jax,Varus,1590,837,753,52.64
Jax,Heimerdinger,784,342,442,43.62
Jax,Azir,626,311,315,49.68
Jax,Akshan,633,326,307,51.5
Jax,Sona,609,292,317,47.95
Jax,Qiyana,494,291,203,58.91
Jax,Braum,1052,502,550,47.72
Jax,Cassiopeia,528,263,265,49.81
Jax,KSante,795,417,378,52.45
Jax,Janna,552,246,306,44.57
Jax,Naafiri,586,267,319,45.56
Jax,Blitzcrank,1333,706,627,52.96
Jax,Nasus,1168,548,620,46.92
Jax,Gnar,535,273,262,51.03
Jax,Sejuani,701,327,374,46.65
Jax,Smolder,1225,632,593,51.59
Jax,Karthus,431,239,192,55.45
Jax,Kled,296,157,139,53.04
Jax,Anivia,566,274,292,48.41
Jax,Kindred,807,409,398,50.68
Jax,Nidalee,487,261,226,53.59
Jax,JarvanIV,923,474,449,51.35
Jax,Zac,867,475,392,54.79
Jax,Belveth,357,202,155,56.58
Jax,Renata,380,217,163,57.11
Jax,Sivir,1033,493,540,47.73
Jax,Shyvana,399,183,216,45.86
Jax,Orianna,782,382,400,48.85
Jax,Rumble,421,222,199,52.73
Jax,Zeri,780,440,340,56.41
Jax,RekSai,199,69,130,34.67
Jax,Lissandra,497,255,242,51.31
Jax,Bard,575,288,287,50.09
XinZhao,Vladimir,736,385,351,52.31
XinZhao,Viego,1775,866,909,48.79
XinZhao,Velkoz,766,395,371,51.57
XinZhao,Kaisa,2020,1064,956,52.67
XinZhao,Karma,1453,628,825,43.22
XinZhao,Garen,1941,856,1085,44.1
XinZhao,Kayn,1674,827,847,49.4
XinZhao,Lux,2898,1517,1381,52.35
XinZhao,Caitlyn,3063,1574,1489,51.39
XinZhao,Thresh,1815,888,927,48.93
XinZhao,Aatrox,1131,565,566,49.96
XinZhao,Gwen,688,360,328,52.33
XinZhao,Syndra,793,351,442,44.26
XinZhao,Ashe,2515,1297,1218,51.57
XinZhao,Lulu,1546,802,744,51.88
XinZhao,Sett,1873,913,960,48.75
XinZhao,Vi,1304,676,628,51.84
XinZhao,AurelionSol,379,177,202,46.7
XinZhao,Corki,454,248,206,54.63
XinZhao,Milio,586,270,316,46.08
XinZhao,Riven,634,383,251,60.41
XinZhao,LeeSin,2279,1215,1064,53.31
XinZhao,Mel,2516,1389,1127,55.21
XinZhao,Tristana,1190,549,641,46.13
XinZhao,Zac,672,352,320,52.38
XinZhao,FiddleSticks,648,315,333,48.61
XinZhao,Brand,832,473,359,56.85
XinZhao,Jinx,3042,1490,1552,48.98
XinZhao,Amumu,1255,576,679,45.9
XinZhao,Akshan,379,216,163,56.99
XinZhao,Ezreal,2993,1557,1436,52.02
XinZhao,Darius,2182,1153,1029,52.84
XinZhao,Ivern,167,88,79,52.69
XinZhao,Katarina,994,512,482,51.51
XinZhao,Pantheon,1989,1021,968,51.33
XinZhao,Rammus,367,170,197,46.32
XinZhao,Yasuo,2289,1207,1082,52.73
XinZhao,Pyke,1057,586,471,55.44
XinZhao,Yone,2317,1239,1078,53.47
XinZhao,Sivir,547,277,270,50.64
XinZhao,Ahri,1726,889,837,51.51
XinZhao,Diana,1939,975,964,50.28
XinZhao,Jhin,2396,1312,1084,54.76
XinZhao,RekSai,185,94,91,50.81
XinZhao,Gangplank,592,331,261,55.91
XinZhao,Leona,1097,572,525,52.14
XinZhao,Jax,1145,585,560,51.09
XinZhao,Ekko,1154,598,556,51.82
XinZhao,Trundle,752,367,385,48.8
XinZhao,Aphelios,643,302,341,46.97
XinZhao,Ambessa,839,467,372,55.66
XinZhao,Veigar,1183,648,535,54.78
XinZhao,MissFortune,2632,1346,1286,51.14
XinZhao,Nautilus,1348,656,692,48.66
XinZhao,Chogath,1447,692,755,47.82
XinZhao,Zed,1395,761,634,54.55
XinZhao,Galio,978,500,478,51.12
XinZhao,Maokai,528,254,274,48.11
XinZhao,Fiora,488,254,234,52.05
XinZhao,DrMundo,635,304,331,47.87
XinZhao,Poppy,801,401,400,50.06
XinZhao,TwistedFate,391,209,182,53.45
XinZhao,Samira,901,438,463,48.61
XinZhao,Seraphine,1083,589,494,54.39
XinZhao,Urgot,555,210,345,37.84
XinZhao,Sylas,1695,836,859,49.32
XinZhao,Rakan,585,343,242,58.63
XinZhao,Shen,760,346,414,45.53
XinZhao,Kassadin,214,117,97,54.67
XinZhao,Blitzcrank,922,447,475,48.48
XinZhao,MonkeyKing,863,311,552,36.04
XinZhao,Vex,724,346,378,47.79
XinZhao,TahmKench,967,486,481,50.26
XinZhao,Cassiopeia,438,250,188,57.08
XinZhao,Lucian,864,449,415,51.97
XinZhao,Nami,1239,623,616,50.28
XinZhao,Ornn,528,247,281,46.78
XinZhao,Aurora,943,476,467,50.48
XinZhao,Xayah,723,391,332,54.08
XinZhao,Kayle,723,357,366,49.38
XinZhao,Volibear,1357,665,692,49.01
XinZhao,Shaco,1058,544,514,51.42
XinZhao,Yorick,1326,672,654,50.68
XinZhao,Irelia,998,521,477,52.2
XinZhao,MasterYi,1355,707,648,52.18
XinZhao,Akali,1415,728,687,51.45
XinZhao,Lillia,693,379,314,54.69
XinZhao,Khazix,610,312,298,51.15
XinZhao,Varus,1134,615,519,54.23
XinZhao,Mordekaiser,1647,780,867,47.36
XinZhao,Warwick,1770,877,893,49.55
XinZhao,Naafiri,397,205,192,51.64
XinZhao,Ziggs,529,243,286,45.94
XinZhao,Kled,196,101,95,51.53
XinZhao,Gnar,548,307,241,56.02
XinZhao,Nasus,846,419,427,49.53
XinZhao,Ryze,421,221,200,52.49
XinZhao,Bard,349,203,146,58.17
XinZhao,Viktor,1070,571,499,53.36
XinZhao,Draven,643,364,279,56.61
XinZhao,Elise,938,499,439,53.2
XinZhao,Udyr,447,253,194,56.6
XinZhao,Vayne,1550,732,818,47.23
XinZhao,Anivia,352,185,167,52.56
XinZhao,Sejuani,572,264,308,46.15
XinZhao,Braum,723,365,358,50.48
XinZhao,Kennen,286,128,158,44.76
XinZhao,Gragas,644,348,296,54.04
XinZhao,Heimerdinger,568,260,308,45.77
XinZhao,Morgana,1405,686,719,48.83
XinZhao,Briar,969,436,533,44.99
XinZhao,Taric,319,170,149,53.29
XinZhao,Belveth,333,184,149,55.26
XinZhao,Nunu,685,386,299,56.35
XinZhao,Kindred,551,304,247,55.17
XinZhao,Taliyah,361,211,150,58.45
XinZhao,Nilah,460,228,232,49.57
XinZhao,Illaoi,536,307,229,57.28
XinZhao,Xerath,1112,587,525,52.79
XinZhao,Yuumi,1033,518,515,50.15
XinZhao,Smolder,844,477,367,56.52
XinZhao,Twitch,898,449,449,50
XinZhao,Senna,882,437,445,49.55
XinZhao,Malzahar,1189,572,617,48.11
XinZhao,Malphite,1125,575,550,51.11
XinZhao,Nidalee,358,184,174,51.4
XinZhao,Kalista,384,211,173,54.95
XinZhao,Zyra,1035,528,507,51.01
XinZhao,Skarner,391,251,140,64.19
XinZhao,Qiyana,332,155,177,46.69
XinZhao,Evelynn,432,239,193,55.32
XinZhao,Sona,386,204,182,52.85
XinZhao,Singed,299,132,167,44.15
XinZhao,Alistar,516,244,272,47.29
XinZhao,Sion,924,438,486,47.4
XinZhao,Teemo,1318,635,683,48.18
XinZhao,Nocturne,1550,784,766,50.58
XinZhao,Hwei,777,408,369,52.51
XinZhao,Soraka,633,279,354,44.08
XinZhao,JarvanIV,809,404,405,49.94
XinZhao,Graves,777,417,360,53.67
XinZhao,Zoe,439,259,180,59
XinZhao,Talon,759,432,327,56.92
XinZhao,Lissandra,328,160,168,48.78
XinZhao,Azir,484,223,261,46.07
XinZhao,KSante,676,345,331,51.04
XinZhao,Rell,592,300,292,50.68
XinZhao,Renekton,634,322,312,50.79
XinZhao,Swain,1321,613,708,46.4
XinZhao,Tryndamere,629,303,326,48.17
XinZhao,Rengar,342,193,149,56.43
XinZhao,Shyvana,322,162,160,50.31
XinZhao,Camille,445,256,189,57.53
XinZhao,Zeri,468,237,231,50.64
XinZhao,Jayce,639,335,304,52.43
XinZhao,Fizz,718,353,365,49.16
XinZhao,Olaf,278,151,127,54.32
XinZhao,Leblanc,769,376,393,48.89
XinZhao,KogMaw,380,166,214,43.68
XinZhao,Orianna,561,279,282,49.73
XinZhao,Annie,404,204,200,50.5
XinZhao,Hecarim,472,269,203,56.99
XinZhao,Karthus,323,157,166,48.61
XinZhao,Quinn,343,188,155,54.81
XinZhao,Janna,382,186,196,48.69
XinZhao,Rumble,300,144,156,48
XinZhao,Zilean,317,159,158,50.16
XinZhao,Neeko,698,365,333,52.29
XinZhao,Renata,217,134,83,61.75
Kennen,Vladimir,450,233,217,51.78
Kennen,Viego,930,411,519,44.19
Kennen,Velkoz,321,125,196,38.94
Kennen,Kaisa,892,467,425,52.35
Kennen,Karma,615,296,319,48.13
Kennen,Aatrox,649,330,319,50.85
Kennen,Sylas,871,390,481,44.78
Kennen,Diana,930,446,484,47.96
Kennen,Varus,525,309,216,58.86
Kennen,Blitzcrank,447,232,215,51.9
Kennen,Vayne,788,345,443,43.78
Kennen,Briar,400,141,259,35.25
Kennen,Lux,1562,750,812,48.02
Kennen,Mel,1183,563,620,47.59
Kennen,Yuumi,463,183,280,39.52
Kennen,Yone,1037,542,495,52.27
Kennen,Gragas,375,197,178,52.53
Kennen,Irelia,574,291,283,50.7
Kennen,TahmKench,501,231,270,46.11
Kennen,Rell,282,139,143,49.29
Kennen,Mordekaiser,750,351,399,46.8
Kennen,Ahri,845,404,441,47.81
Kennen,Nunu,359,190,169,52.92
Kennen,Yasuo,1214,620,594,51.07
Kennen,Zyra,465,241,224,51.83
Kennen,Viktor,485,223,262,45.98
Kennen,Nocturne,631,321,310,50.87
Kennen,Annie,157,73,84,46.5
Kennen,KogMaw,208,109,99,52.4
Kennen,Alistar,282,134,148,47.52
Kennen,Vi,544,277,267,50.92
Kennen,Amumu,563,231,332,41.03
Kennen,Akshan,176,86,90,48.86
Kennen,Ezreal,1340,670,670,50
Kennen,Zed,653,281,372,43.03
Kennen,TwistedFate,182,104,78,57.14
Kennen,Teemo,844,403,441,47.75
Kennen,Maokai,260,98,162,37.69
Kennen,Corki,248,148,100,59.68
Kennen,Taric,123,47,76,38.21
Kennen,Jayce,357,204,153,57.14
Kennen,JarvanIV,310,129,181,41.61
Kennen,Aurora,508,286,222,56.3
Kennen,Caitlyn,1429,663,766,46.4
Kennen,Akali,633,314,319,49.61
Kennen,MasterYi,683,320,363,46.85
Kennen,Swain,610,296,314,48.52
Kennen,MissFortune,1302,547,755,42.01
Kennen,Thresh,836,415,421,49.64
Kennen,Qiyana,141,77,64,54.61
Kennen,Neeko,409,228,181,55.75
Kennen,Malphite,574,271,303,47.21
Kennen,Khazix,352,178,174,50.57
Kennen,Lulu,720,396,324,55
Kennen,Gwen,270,108,162,40
Kennen,Lillia,362,193,169,53.31
Kennen,Morgana,589,287,302,48.73
Kennen,Soraka,378,190,188,50.26
Kennen,Renekton,272,134,138,49.26
Kennen,Darius,1239,600,639,48.43
Kennen,FiddleSticks,313,164,149,52.4
Kennen,Ryze,206,116,90,56.31
Kennen,Kalista,221,125,96,56.56
Kennen,Janna,267,123,144,46.07
Kennen,Kayn,799,434,365,54.32
Kennen,Xayah,359,193,166,53.76
Kennen,Shaco,544,281,263,51.65
Kennen,Sett,928,429,499,46.23
Kennen,Katarina,429,243,186,56.64
Kennen,Rengar,195,117,78,60
Kennen,Seraphine,458,214,244,46.72
Kennen,Urgot,347,147,200,42.36
Kennen,Hwei,461,210,251,45.55
Kennen,Jhin,1156,555,601,48.01
Kennen,Jax,499,216,283,43.29
Kennen,Zoe,243,149,94,61.32
Kennen,Ashe,1085,486,599,44.79
Kennen,Kindred,267,148,119,55.43
Kennen,Galio,471,222,249,47.13
Kennen,Lucian,390,205,185,52.56
Kennen,Yorick,463,199,264,42.98
Kennen,Rammus,146,66,80,45.21
Kennen,Milio,340,150,190,44.12
Kennen,DrMundo,389,138,251,35.48
Kennen,Lissandra,186,111,75,59.68
Kennen,Zilean,187,55,132,29.41
Kennen,Udyr,228,107,121,46.93
Kennen,Orianna,266,124,142,46.62
Kennen,Trundle,292,143,149,48.97
Kennen,Rakan,257,131,126,50.97
Kennen,Gnar,280,160,120,57.14
Kennen,Cassiopeia,214,107,107,50
Kennen,Nami,557,244,313,43.81
Kennen,Evelynn,294,133,161,45.24
Kennen,Zeri,230,112,118,48.7
Kennen,Leona,442,240,202,54.3
Kennen,Leblanc,346,150,196,43.35
Kennen,Jinx,1401,737,664,52.61
Kennen,Warwick,769,388,381,50.46
Kennen,Sejuani,210,103,107,49.05
Kennen,Malzahar,557,271,286,48.65
Kennen,Ekko,499,223,276,44.69
Kennen,Draven,319,146,173,45.77
Kennen,Nautilus,566,273,293,48.23
Kennen,Riven,328,143,185,43.6
Kennen,Tristana,564,283,281,50.18
Kennen,LeeSin,837,472,365,56.39
Kennen,Xerath,487,238,249,48.87
Kennen,Nasus,500,213,287,42.6
Kennen,XinZhao,286,158,128,55.24
Kennen,Syndra,339,188,151,55.46
Kennen,Nilah,185,91,94,49.19
Kennen,Veigar,655,280,375,42.75
Kennen,Anivia,194,101,93,52.06
Kennen,Poppy,339,191,148,56.34
Kennen,Naafiri,250,132,118,52.8
Kennen,Chogath,846,412,434,48.7
Kennen,Vex,308,142,166,46.1
Kennen,Kayle,392,167,225,42.6
Kennen,Gangplank,323,161,162,49.85
Kennen,Smolder,452,200,252,44.25
Kennen,Samira,472,227,245,48.09
Kennen,Singed,137,64,73,46.72
Kennen,Garen,777,324,453,41.7
Kennen,Hecarim,233,88,145,37.77
Kennen,Fizz,302,151,151,50
Kennen,Twitch,484,233,251,48.14
Kennen,Belveth,127,51,76,40.16
Kennen,Senna,430,250,180,58.14
Kennen,Camille,215,120,95,55.81
Kennen,Quinn,217,99,118,45.62
Kennen,Sona,205,95,110,46.34
Kennen,Illaoi,182,87,95,47.8
Kennen,Brand,419,167,252,39.86
Kennen,Braum,319,159,160,49.84
Kennen,Kled,108,45,63,41.67
Kennen,Aphelios,420,189,231,45
Kennen,Skarner,158,76,82,48.1
Kennen,Zac,283,103,180,36.4
Kennen,Pyke,516,277,239,53.68
Kennen,Ambessa,382,243,139,63.61
Kennen,Renata,140,53,87,37.86
Kennen,Heimerdinger,310,140,170,45.16
Kennen,Ivern,110,56,54,50.91
Kennen,Karthus,211,97,114,45.97
Kennen,Sion,430,222,208,51.63
Kennen,Kassadin,108,37,71,34.26
Kennen,Azir,153,92,61,60.13
Kennen,Shen,314,136,178,43.31
Kennen,Volibear,514,214,300,41.63
Kennen,Rumble,145,71,74,48.97
Kennen,Graves,350,204,146,58.29
Kennen,Pantheon,918,428,490,46.62
Kennen,MonkeyKing,364,168,196,46.15
Kennen,RekSai,61,32,29,52.46
Kennen,Talon,364,155,209,42.58
Kennen,Elise,532,223,309,41.92
Kennen,Tryndamere,265,121,144,45.66
Kennen,KSante,200,127,73,63.5
Kennen,Olaf,118,47,71,39.83
Kennen,Ziggs,181,83,98,45.86
Kennen,Nidalee,178,106,72,59.55
Kennen,Ornn,271,105,166,38.75
Kennen,AurelionSol,200,99,101,49.5
Kennen,Taliyah,147,73,74,49.66
Kennen,Sivir,279,114,165,40.86
Kennen,Fiora,182,90,92,49.45
Kennen,Bard,223,105,118,47.09
Kennen,Shyvana,142,76,66,53.52
Kalista,Vladimir,394,189,205,47.97
Kalista,Viego,866,393,473,45.38
Kalista,Velkoz,313,122,191,38.98
Kalista,Kaisa,970,496,474,51.13
Kalista,Karma,674,331,343,49.11
Kalista,Renekton,358,197,161,55.03
Kalista,JarvanIV,383,188,195,49.09
Kalista,Mel,1429,647,782,45.28
Kalista,Jhin,1250,600,650,48
Kalista,Sylas,820,340,480,41.46
Kalista,Mordekaiser,874,436,438,49.89
Kalista,Kindred,319,177,142,55.49
Kalista,TahmKench,591,265,326,44.84
Kalista,Yorick,494,175,319,35.43
Kalista,AurelionSol,284,105,179,36.97
Kalista,Kayn,929,441,488,47.47
Kalista,Singed,175,66,109,37.71
Kalista,Udyr,228,100,128,43.86
Kalista,Malphite,620,278,342,44.84
Kalista,Rell,265,132,133,49.81
Kalista,Jayce,352,190,162,53.98
Kalista,Rengar,271,151,120,55.72
Kalista,Swain,622,264,358,42.44
Kalista,Ezreal,1637,885,752,54.06
Kalista,Sona,187,79,108,42.25
Kalista,Darius,1102,467,635,42.38
Kalista,Trundle,336,145,191,43.15
Kalista,Gragas,357,167,190,46.78
Kalista,Yasuo,1123,611,512,54.41
Kalista,Vex,370,182,188,49.19
Kalista,Diana,959,475,484,49.53
Kalista,Akali,764,366,398,47.91
Kalista,Jinx,1470,672,798,45.71
Kalista,Lux,1606,751,855,46.76
Kalista,Camille,257,121,136,47.08
Kalista,LeeSin,940,483,457,51.38
Kalista,Draven,382,178,204,46.6
Kalista,Senna,430,211,219,49.07
Kalista,Chogath,714,311,403,43.56
Kalista,Yuumi,620,326,294,52.58
Kalista,Ornn,284,125,159,44.01
Kalista,Briar,509,200,309,39.29
Kalista,Caitlyn,1575,678,897,43.05
Kalista,Morgana,753,376,377,49.93
Kalista,Ashe,1176,565,611,48.04
Kalista,Alistar,262,122,140,46.56
Kalista,Nocturne,662,322,340,48.64
Kalista,Qiyana,196,128,68,65.31
Kalista,Sett,988,452,536,45.75
Kalista,Jax,567,293,274,51.68
Kalista,Janna,211,96,115,45.5
Kalista,Gangplank,261,131,130,50.19
Kalista,MissFortune,1471,686,785,46.63
Kalista,Aurora,483,263,220,54.45
Kalista,Aatrox,610,311,299,50.98
Kalista,Rumble,121,67,54,55.37
Kalista,Leona,465,224,241,48.17
Kalista,Urgot,295,117,178,39.66
Kalista,Twitch,507,271,236,53.45
Kalista,Teemo,746,332,414,44.5
Kalista,Pantheon,980,425,555,43.37
Kalista,Graves,372,178,194,47.85
Kalista,Leblanc,386,160,226,41.45
Kalista,Garen,1060,483,577,45.57
Kalista,Syndra,371,197,174,53.1
Kalista,Rammus,205,87,118,42.44
Kalista,Fizz,287,148,139,51.57
Kalista,Sivir,270,118,152,43.7
Kalista,Shaco,546,254,292,46.52
Kalista,Taliyah,221,97,124,43.89
Kalista,Shen,386,149,237,38.6
Kalista,Volibear,586,242,344,41.3
Kalista,Tristana,630,273,357,43.33
Kalista,Nami,530,228,302,43.02
Kalista,Poppy,497,221,276,44.47
Kalista,Warwick,932,406,526,43.56
Kalista,Illaoi,294,137,157,46.6
Kalista,Nautilus,714,362,352,50.7
Kalista,Kennen,221,96,125,43.44
Kalista,Yone,1204,564,640,46.84
Kalista,Ziggs,267,118,149,44.19
Kalista,Braum,330,142,188,43.03
Kalista,Irelia,572,274,298,47.9
Kalista,MasterYi,725,323,402,44.55
Kalista,Aphelios,476,239,237,50.21
Kalista,Lissandra,241,128,113,53.11
Kalista,Sion,429,190,239,44.29
Kalista,Katarina,521,241,280,46.26
Kalista,Talon,360,192,168,53.33
Kalista,Lillia,368,171,197,46.47
Kalista,Quinn,170,75,95,44.12
Kalista,Xayah,338,144,194,42.6
Kalista,Neeko,364,169,195,46.43
Kalista,Rakan,287,121,166,42.16
Kalista,Kled,140,56,84,40
Kalista,Malzahar,620,247,373,39.84
Kalista,Vayne,696,297,399,42.67
Kalista,Thresh,862,400,462,46.4
Kalista,Cassiopeia,227,84,143,37
Kalista,Heimerdinger,277,116,161,41.88
Kalista,Samira,479,191,288,39.87
Kalista,Kayle,511,241,270,47.16
Kalista,Ahri,922,399,523,43.28
Kalista,FiddleSticks,261,110,151,42.15
Kalista,Ekko,505,235,270,46.53
Kalista,Xerath,496,230,266,46.37
Kalista,Seraphine,526,248,278,47.15
Kalista,Hwei,465,193,272,41.51
Kalista,Ambessa,416,225,191,54.09
Kalista,Akshan,204,87,117,42.65
Kalista,Zoe,263,111,152,42.21
Kalista,Fiora,239,108,131,45.19
Kalista,Milio,367,178,189,48.5
Kalista,Shyvana,179,87,92,48.6
Kalista,Smolder,568,248,320,43.66
Kalista,Zeri,245,130,115,53.06
Kalista,Blitzcrank,528,212,316,40.15
Kalista,Viktor,533,231,302,43.34
Kalista,Veigar,758,278,480,36.68
Kalista,Nasus,449,212,237,47.22
Kalista,XinZhao,384,173,211,45.05
Kalista,Kassadin,184,89,95,48.37
Kalista,KogMaw,165,81,84,49.09
Kalista,Ryze,235,130,105,55.32
Kalista,Khazix,295,151,144,51.19
Kalista,TwistedFate,209,103,106,49.28
Kalista,Ivern,110,37,73,33.64
Kalista,Orianna,300,139,161,46.33
Kalista,Gnar,273,133,140,48.72
Kalista,MonkeyKing,363,157,206,43.25
Kalista,Varus,624,289,335,46.31
Kalista,Maokai,273,111,162,40.66
Kalista,Lucian,462,212,250,45.89
Kalista,Elise,482,199,283,41.29
Kalista,Lulu,656,306,350,46.65
Kalista,Nunu,397,200,197,50.38
Kalista,Zac,253,115,138,45.45
Kalista,Sejuani,259,118,141,45.56
Kalista,Galio,526,253,273,48.1
Kalista,Zyra,446,205,241,45.96
Kalista,Riven,253,137,116,54.15
Kalista,Pyke,575,312,263,54.26
Kalista,Corki,201,114,87,56.72
Kalista,KSante,304,134,170,44.08
Kalista,Skarner,214,123,91,57.48
Kalista,Gwen,304,140,164,46.05
Kalista,Zed,634,312,322,49.21
Kalista,Naafiri,189,87,102,46.03
Kalista,Soraka,402,193,209,48.01
Kalista,Belveth,197,94,103,47.72
Kalista,Brand,407,205,202,50.37
Kalista,Vi,534,268,266,50.19
Kalista,Azir,258,154,104,59.69
Kalista,Amumu,569,222,347,39.02
Kalista,Nilah,287,90,197,31.36
Kalista,RekSai,83,42,41,50.6
Kalista,Olaf,178,79,99,44.38
Kalista,Taric,179,83,96,46.37
Kalista,Tryndamere,402,225,177,55.97
Kalista,Renata,164,53,111,32.32
Kalista,Zilean,214,99,115,46.26
Kalista,Evelynn,328,161,167,49.09
Kalista,Annie,167,76,91,45.51
Kalista,Anivia,182,79,103,43.41
Kalista,Karthus,131,70,61,53.44
Kalista,Bard,241,107,134,44.4
Kalista,DrMundo,351,164,187,46.72
Kalista,Hecarim,281,141,140,50.18
Kalista,Nidalee,182,82,100,45.05
Lulu,Vladimir,1707,821,886,48.1
Lulu,Viego,3198,1554,1644,48.59
Lulu,Velkoz,1395,685,710,49.1
Lulu,Kaisa,3679,1986,1693,53.98
Lulu,Karma,3465,1687,1778,48.69
Lulu,Yorick,1958,926,1032,47.29
Lulu,Diana,3607,1808,1799,50.12
Lulu,Seraphine,1938,845,1093,43.6
Lulu,Rakan,1059,553,506,52.22
Lulu,XinZhao,1546,744,802,48.12
Lulu,Katarina,1909,1024,885,53.64
Lulu,Teemo,2476,1213,1263,48.99
Lulu,Vayne,2583,1297,1286,50.21
Lulu,TwistedFate,884,419,465,47.4
Lulu,Gragas,1554,834,720,53.67
Lulu,Gwen,1115,555,560,49.78
Lulu,Yasuo,4450,2269,2181,50.99
Lulu,Zeri,1069,520,549,48.64
Lulu,Bard,780,348,432,44.62
Lulu,Smolder,1560,880,680,56.41
Lulu,Ekko,1998,911,1087,45.6
Lulu,Mordekaiser,2635,1221,1414,46.34
Lulu,Yuumi,2374,1216,1158,51.22
Lulu,Shaco,2065,1004,1061,48.62
Lulu,Tryndamere,1159,568,591,49.01
Lulu,Ezreal,6312,3359,2953,53.22
Lulu,Milio,1986,946,1040,47.63
Lulu,Ryze,886,448,438,50.56
Lulu,Nunu,1281,636,645,49.65
Lulu,Ahri,3081,1534,1547,49.79
Lulu,Lucian,1818,902,916,49.61
Lulu,Alistar,983,477,506,48.52
Lulu,Nasus,1467,732,735,49.9
Lulu,Kayn,3196,1646,1550,51.5
Lulu,Neeko,975,485,490,49.74
Lulu,MissFortune,4552,2275,2277,49.98
Lulu,Morgana,2468,1182,1286,47.89
Lulu,Darius,4096,1936,2160,47.27
Lulu,Sejuani,999,517,482,51.75
Lulu,Mel,4666,2493,2173,53.43
Lulu,Jhin,4900,2462,2438,50.24
Lulu,Rell,1098,513,585,46.72
Lulu,Amumu,1947,890,1057,45.71
Lulu,Swain,2087,969,1118,46.43
Lulu,Urgot,1116,581,535,52.06
Lulu,LeeSin,3767,2003,1764,53.17
Lulu,Heimerdinger,926,504,422,54.43
Lulu,Warwick,2890,1388,1502,48.03
Lulu,Ashe,4645,2187,2458,47.08
Lulu,Pyke,1906,1007,899,52.83
Lulu,Camille,964,490,474,50.83
Lulu,MasterYi,2342,1142,1200,48.76
Lulu,Irelia,1864,918,946,49.25
Lulu,Pantheon,3784,1946,1838,51.43
Lulu,DrMundo,1103,524,579,47.51
Lulu,Trundle,1093,500,593,45.75
Lulu,Nami,3358,1577,1781,46.96
Lulu,Nocturne,2744,1269,1475,46.25
Lulu,Aurora,1938,925,1013,47.73
Lulu,Jinx,5845,2817,3028,48.2
Lulu,Ivern,479,239,240,49.9
Lulu,Sett,3187,1594,1593,50.02
Lulu,Malphite,2170,981,1189,45.21
Lulu,Tristana,2058,1025,1033,49.81
Lulu,Ziggs,785,346,439,44.08
Lulu,Lillia,1324,614,710,46.37
Lulu,Lissandra,832,385,447,46.27
Lulu,FiddleSticks,1185,576,609,48.61
Lulu,Ornn,987,474,513,48.02
Lulu,Hwei,1692,802,890,47.4
Lulu,Caitlyn,5663,2714,2949,47.93
Lulu,Illaoi,918,475,443,51.74
Lulu,Malzahar,2272,1137,1135,50.04
Lulu,Khazix,1222,652,570,53.36
Lulu,Leona,1696,861,835,50.77
Lulu,Poppy,1379,700,679,50.76
Lulu,Annie,799,399,400,49.94
Lulu,Nautilus,2645,1370,1275,51.8
Lulu,Yone,4147,2267,1880,54.67
Lulu,Maokai,1047,505,542,48.23
Lulu,Fiora,893,484,409,54.2
Lulu,Riven,1117,570,547,51.03
Lulu,Akshan,804,397,407,49.38
Lulu,Xerath,1859,897,962,48.25
Lulu,Chogath,2830,1348,1482,47.63
Lulu,Zed,2530,1282,1248,50.67
Lulu,Lux,5326,2663,2663,50
Lulu,Rengar,924,493,431,53.35
Lulu,Galio,2060,988,1072,47.96
Lulu,Samira,1558,841,717,53.98
Lulu,Sona,736,378,358,51.36
Lulu,Shen,1494,789,705,52.81
Lulu,TahmKench,1665,813,852,48.83
Lulu,Kennen,720,324,396,45
Lulu,Syndra,1677,809,868,48.24
Lulu,Akali,2385,1231,1154,51.61
Lulu,Soraka,1566,813,753,51.92
Lulu,Evelynn,905,480,425,53.04
Lulu,Briar,1620,806,814,49.75
Lulu,Viktor,2271,1040,1231,45.79
Lulu,Jax,2188,1163,1025,53.15
Lulu,Corki,1129,628,501,55.62
Lulu,Volibear,2352,1156,1196,49.15
Lulu,Rammus,726,346,380,47.66
Lulu,Cassiopeia,707,375,332,53.04
Lulu,MonkeyKing,1614,840,774,52.04
Lulu,Elise,1811,886,925,48.92
Lulu,Quinn,774,354,420,45.74
Lulu,Talon,1548,800,748,51.68
Lulu,Varus,2134,1054,1080,49.39
Lulu,Aatrox,2261,1150,1111,50.86
Lulu,Olaf,580,274,306,47.24
Lulu,Vex,903,462,441,51.16
Lulu,Thresh,3512,1632,1880,46.47
Lulu,Kindred,1099,521,578,47.41
Lulu,Vi,2147,1074,1073,50.02
Lulu,Sion,1920,971,949,50.57
Lulu,Garen,3428,1697,1731,49.5
Lulu,Shyvana,557,301,256,54.04
Lulu,Sivir,1092,577,515,52.84
Lulu,Qiyana,678,321,357,47.35
Lulu,Ambessa,1694,907,787,53.54
Lulu,Zyra,1993,923,1070,46.31
Lulu,Graves,1579,769,810,48.7
Lulu,Nidalee,716,389,327,54.33
Lulu,Senna,1987,1030,957,51.84
Lulu,Fizz,1160,600,560,51.72
Lulu,Sylas,3156,1562,1594,49.49
Lulu,Xayah,1212,587,625,48.43
Lulu,Leblanc,1356,741,615,54.65
Lulu,Gnar,1059,530,529,50.05
Lulu,Zac,1227,587,640,47.84
Lulu,Singed,656,343,313,52.29
Lulu,Braum,1410,665,745,47.16
Lulu,Zoe,927,466,461,50.27
Lulu,Naafiri,780,377,403,48.33
Lulu,Skarner,724,363,361,50.14
Lulu,Draven,1197,568,629,47.45
Lulu,Azir,933,486,447,52.09
Lulu,Kled,468,216,252,46.15
Lulu,Belveth,538,293,245,54.46
Lulu,Hecarim,1101,556,545,50.5
Lulu,Nilah,714,353,361,49.44
Lulu,Kassadin,434,217,217,50
Lulu,Twitch,1938,927,1011,47.83
Lulu,Udyr,876,424,452,48.4
Lulu,Aphelios,1453,645,808,44.39
Lulu,Blitzcrank,1870,921,949,49.25
Lulu,Renata,515,280,235,54.37
Lulu,Veigar,2111,1016,1095,48.13
Lulu,KogMaw,785,380,405,48.41
Lulu,Gangplank,1169,570,599,48.76
Lulu,JarvanIV,1449,629,820,43.41
Lulu,Orianna,1129,608,521,53.85
Lulu,Zilean,948,482,466,50.84
Lulu,Karthus,656,357,299,54.42
Lulu,Brand,1528,755,773,49.41
Lulu,Kayle,1495,652,843,43.61
Lulu,Anivia,684,355,329,51.9
Lulu,Janna,999,474,525,47.45
Lulu,KSante,1334,737,597,55.25
Lulu,Jayce,1372,624,748,45.48
Lulu,AurelionSol,821,401,420,48.84
Lulu,Renekton,1128,630,498,55.85
Lulu,Rumble,736,367,369,49.86
Lulu,Taliyah,695,348,347,50.07
Lulu,RekSai,308,165,143,53.57
Lulu,Kalista,656,350,306,53.35
Lulu,Taric,536,268,268,50
Vladimir,Jax,1201,634,567,52.79
Vladimir,XinZhao,736,351,385,47.69
Vladimir,Kennen,450,217,233,48.22
Vladimir,Kalista,394,205,189,52.03
Vladimir,Lulu,1707,886,821,51.9
Vladimir,Illaoi,501,248,253,49.5
Vladimir,Warwick,1594,760,834,47.68
Vladimir,Diana,1870,868,1002,46.42
Vladimir,Tristana,1207,672,535,55.68
Vladimir,Milio,807,356,451,44.11
Vladimir,Ornn,542,239,303,44.1
Vladimir,Poppy,923,476,447,51.57
Vladimir,Yone,2461,1235,1226,50.18
Vladimir,MissFortune,2517,1237,1280,49.15
Vladimir,Brand,947,481,466,50.79
Vladimir,Singed,310,151,159,48.71
Vladimir,Ryze,559,294,265,52.59
Vladimir,Samira,904,416,488,46.02
Vladimir,Soraka,621,250,371,40.26
Vladimir,Mordekaiser,1582,804,778,50.82
Vladimir,Briar,949,452,497,47.63
Vladimir,Zed,1454,762,692,52.41
Vladimir,Jinx,3295,1631,1664,49.5
Vladimir,Darius,2271,1051,1220,46.28
Vladimir,Garen,1651,826,825,50.03
Vladimir,Lux,2874,1444,1430,50.24
Vladimir,Sivir,693,286,407,41.27
Vladimir,Rakan,681,326,355,47.87
Vladimir,Gangplank,660,344,316,52.12
Vladimir,Lillia,673,298,375,44.28
Vladimir,Sejuani,594,338,256,56.9
Vladimir,Mel,2708,1513,1195,55.87
Vladimir,Jhin,2634,1319,1315,50.08
Vladimir,Rell,658,330,328,50.15
Vladimir,TwistedFate,341,168,173,49.27
Vladimir,LeeSin,1718,911,807,53.03
Vladimir,Yasuo,2922,1495,1427,51.16
Vladimir,Nilah,482,203,279,42.12
Vladimir,Ahri,1640,838,802,51.1
Vladimir,Nunu,796,405,391,50.88
Vladimir,Zyra,1143,548,595,47.94
Vladimir,Zoe,496,265,231,53.43
Vladimir,Ezreal,2686,1414,1272,52.64
Vladimir,Janna,412,201,211,48.79
Vladimir,Chogath,1644,785,859,47.75
Vladimir,Galio,988,510,478,51.62
Vladimir,Yorick,1086,458,628,42.17
Vladimir,Kindred,604,309,295,51.16
Vladimir,Ashe,2383,1188,1195,49.85
Vladimir,Ekko,1086,525,561,48.34
Vladimir,Caitlyn,3244,1591,1653,49.04
Vladimir,Kayle,982,487,495,49.59
Vladimir,Sona,387,175,212,45.22
Vladimir,Twitch,1047,528,519,50.43
Vladimir,Teemo,1625,794,831,48.86
Vladimir,Aatrox,1036,505,531,48.75
Vladimir,MasterYi,1420,696,724,49.01
Vladimir,Yuumi,1039,460,579,44.27
Vladimir,Heimerdinger,644,316,328,49.07
Vladimir,Varus,961,512,449,53.28
Vladimir,Maokai,538,282,256,52.42
Vladimir,Veigar,1183,534,649,45.14
Vladimir,Shyvana,329,172,157,52.28
Vladimir,Morgana,1340,669,671,49.93
Vladimir,Riven,651,339,312,52.07
Vladimir,Shaco,1132,567,565,50.09
Vladimir,Thresh,1671,858,813,51.35
Vladimir,Kayn,1904,975,929,51.21
Vladimir,Seraphine,906,499,407,55.08
Vladimir,DrMundo,741,357,384,48.18
Vladimir,Irelia,1165,573,592,49.18
Vladimir,Swain,1324,642,682,48.49
Vladimir,Nasus,894,404,490,45.19
Vladimir,Zac,637,301,336,47.25
Vladimir,Kaisa,2012,1038,974,51.59
Vladimir,Anivia,384,191,193,49.74
Vladimir,JarvanIV,673,333,340,49.48
Vladimir,Katarina,1127,599,528,53.15
Vladimir,TahmKench,1002,480,522,47.9
Vladimir,Akali,1336,713,623,53.37
Vladimir,FiddleSticks,676,299,377,44.23
Vladimir,Rengar,451,272,179,60.31
Vladimir,Belveth,338,184,154,54.44
Vladimir,Pantheon,2133,1003,1130,47.02
Vladimir,Amumu,1283,582,701,45.36
Vladimir,Nami,1252,598,654,47.76
Vladimir,Aurora,997,450,547,45.14
Vladimir,Aphelios,727,338,389,46.49
Vladimir,Draven,644,342,302,53.11
Vladimir,Shen,803,422,381,52.55
Vladimir,Pyke,1012,533,479,52.67
Vladimir,Viktor,930,401,529,43.12
Vladimir,Senna,885,433,452,48.93
Vladimir,Tryndamere,639,281,358,43.97
Vladimir,Neeko,584,300,284,51.37
Vladimir,KSante,562,326,236,58.01
Vladimir,Taric,282,149,133,52.84
Vladimir,Talon,851,488,363,57.34
Vladimir,Sett,1738,815,923,46.89
Vladimir,Leona,1000,502,498,50.2
Vladimir,Viego,1795,808,987,45.01
Vladimir,Orianna,699,335,364,47.93
Vladimir,Smolder,800,396,404,49.5
Vladimir,Syndra,729,344,385,47.19
Vladimir,Velkoz,745,343,402,46.04
Vladimir,Sylas,1619,822,797,50.77
Vladimir,KogMaw,439,238,201,54.21
Vladimir,Nautilus,1359,705,654,51.88
Vladimir,Evelynn,478,255,223,53.35
Vladimir,Alistar,530,254,276,47.92
Vladimir,Karthus,363,211,152,58.13
Vladimir,Khazix,633,324,309,51.18
Vladimir,Leblanc,726,389,337,53.58
Vladimir,Camille,498,297,201,59.64
Vladimir,Lucian,801,440,361,54.93
Vladimir,Nidalee,388,191,197,49.23
Vladimir,Vex,558,327,231,58.6
Vladimir,Hwei,814,420,394,51.6
Vladimir,Vi,1063,618,445,58.14
Vladimir,Olaf,286,163,123,56.99
Vladimir,Sion,959,481,478,50.16
Vladimir,Akshan,495,277,218,55.96
Vladimir,Urgot,556,259,297,46.58
Vladimir,Qiyana,378,189,189,50
Vladimir,Rammus,371,160,211,43.13
Vladimir,Vayne,1688,801,887,47.45
Vladimir,Gnar,541,314,227,58.04
Vladimir,Zeri,545,271,274,49.72
Vladimir,Blitzcrank,864,436,428,50.46
Vladimir,Azir,429,226,203,52.68
Vladimir,Fiora,514,263,251,51.17
Vladimir,AurelionSol,474,213,261,44.94
Vladimir,Corki,553,296,257,53.53
Vladimir,Bard,381,213,168,55.91
Vladimir,Volibear,1269,599,670,47.2
Vladimir,Braum,750,355,395,47.33
Vladimir,Renekton,675,337,338,49.93
Vladimir,Naafiri,404,197,207,48.76
Vladimir,Trundle,620,298,322,48.06
Vladimir,Fizz,831,444,387,53.43
Vladimir,Ziggs,444,222,222,50
Vladimir,Rumble,370,178,192,48.11
Vladimir,Quinn,422,218,204,51.66
Vladimir,Gwen,753,426,327,56.57
Vladimir,Elise,938,467,471,49.79
Vladimir,Ivern,215,97,118,45.12
Vladimir,Nocturne,1477,745,732,50.44
Vladimir,Kassadin,341,153,188,44.87
Vladimir,Xayah,690,367,323,53.19
Vladimir,Malzahar,1248,566,682,45.35
Vladimir,Ambessa,704,350,354,49.72
Vladimir,Skarner,338,184,154,54.44
Vladimir,Graves,707,352,355,49.79
Vladimir,Taliyah,301,169,132,56.15
Vladimir,Karma,1444,762,682,52.77
Vladimir,Gragas,749,410,339,54.74
Vladimir,MonkeyKing,795,426,369,53.58
Vladimir,Malphite,1085,561,524,51.71
Vladimir,Udyr,458,241,217,52.62
Vladimir,Lissandra,429,199,230,46.39
Vladimir,RekSai,148,77,71,52.03
Vladimir,Hecarim,532,277,255,52.07
Vladimir,Annie,414,180,234,43.48
Vladimir,Renata,248,122,126,49.19
Vladimir,Xerath,845,392,453,46.39
Vladimir,Kled,225,123,102,54.67
Vladimir,Jayce,642,315,327,49.07
Vladimir,Cassiopeia,467,251,216,53.75
Vladimir,Zilean,390,190,200,48.72
Viego,Jax,2495,1212,1283,48.58
Viego,XinZhao,1775,909,866,51.21
Viego,Kennen,930,519,411,55.81
Viego,Kalista,866,473,393,54.62
Viego,Lulu,3198,1644,1554,51.41
Viego,Sett,4352,2024,2328,46.51
Viego,Ivern,463,270,193,58.32
Viego,Veigar,2851,1395,1456,48.93
Viego,Jinx,7207,3496,3711,48.51
Viego,Darius,4906,2430,2476,49.53
Viego,Warwick,4100,1933,2167,47.15
Viego,Yasuo,5376,2737,2639,50.91
Viego,Caitlyn,7034,3637,3397,51.71
Viego,Morgana,2978,1443,1535,48.46
Viego,Volibear,3100,1560,1540,50.32
Viego,Ekko,2470,1253,1217,50.73
Viego,Yone,5110,2639,2471,51.64
Viego,Pyke,2624,1431,1193,54.54
Viego,Illaoi,1168,599,569,51.28
Viego,Aatrox,2745,1383,1362,50.38
Viego,Ashe,5484,2835,2649,51.7
Viego,Aphelios,1481,709,772,47.87
Viego,Gragas,1520,820,700,53.95
Viego,FiddleSticks,1259,574,685,45.59
Viego,Shaco,2516,1268,1248,50.4
Viego,Syndra,1752,852,900,48.63
Viego,Thresh,3947,1941,2006,49.18
Viego,Fiora,1055,515,540,48.82
Viego,Galio,2366,1188,1178,50.21
Viego,Ezreal,6234,3226,3008,51.75
Viego,Chogath,3180,1547,1633,48.65
Viego,Naafiri,979,516,463,52.71
Viego,Nunu,1690,792,898,46.86
Viego,Malzahar,2393,1141,1252,47.68
Viego,Zeri,1137,610,527,53.65
Viego,Mordekaiser,3419,1638,1781,47.91
Viego,Khazix,1635,891,744,54.5
Viego,Akali,2933,1456,1477,49.64
Viego,Draven,1378,760,618,55.15
Viego,Mel,5655,2950,2705,52.17
Viego,Malphite,2678,1313,1365,49.03
Viego,MissFortune,5970,2978,2992,49.88
Viego,Soraka,1515,785,730,51.82
Viego,Ambessa,1942,993,949,51.13
Viego,Vex,1435,695,740,48.43
Viego,Blitzcrank,2123,1024,1099,48.23
Viego,Heimerdinger,1126,544,582,48.31
Viego,Seraphine,2278,1223,1055,53.69
Viego,Ziggs,1044,525,519,50.29
Viego,Yorick,2626,1169,1457,44.52
Viego,Kayn,4398,2087,2311,47.45
Viego,Nasus,1915,895,1020,46.74
Viego,Smolder,1754,886,868,50.51
Viego,JarvanIV,1423,658,765,46.24
Viego,Olaf,661,380,281,57.49
Viego,Evelynn,1103,561,542,50.86
Viego,Leona,2257,1116,1141,49.45
Viego,MasterYi,3201,1591,1610,49.7
Viego,Ahri,3401,1652,1749,48.57
Viego,Sivir,1343,661,682,49.22
Viego,Yuumi,2154,1121,1033,52.04
Viego,Orianna,1274,689,585,54.08
Viego,Nautilus,3277,1587,1690,48.43
Viego,Gwen,1353,748,605,55.28
Viego,Maokai,1284,673,611,52.41
Viego,Brand,1740,963,777,55.34
Viego,TahmKench,2322,1204,1118,51.85
Viego,Leblanc,1569,774,795,49.33
Viego,Samira,2102,1123,979,53.43
Viego,Shen,1769,869,900,49.12
Viego,Graves,1741,867,874,49.8
Viego,Taric,560,319,241,56.96
Viego,Rumble,731,392,339,53.63
Viego,Pantheon,4542,2327,2215,51.23
Viego,Urgot,1231,596,635,48.42
Viego,Twitch,1922,948,974,49.32
Viego,Kaisa,4462,2281,2181,51.12
Viego,Teemo,3322,1625,1697,48.92
Viego,Renekton,1517,729,788,48.06
Viego,Sejuani,1056,504,552,47.73
Viego,Taliyah,678,342,336,50.44
Viego,Diana,4519,2314,2205,51.21
Viego,MonkeyKing,2061,1026,1035,49.78
Viego,Karma,2980,1490,1490,50
Viego,Garen,4010,1933,2077,48.2
Viego,Jhin,5676,2807,2869,49.45
Viego,Trundle,1491,739,752,49.56
Viego,Zed,3054,1510,1544,49.44
Viego,Fizz,1459,693,766,47.5
Viego,Quinn,984,480,504,48.78
Viego,Sion,2207,1073,1134,48.62
Viego,Jayce,1373,761,612,55.43
Viego,KogMaw,828,374,454,45.17
Viego,Viktor,2352,1151,1201,48.94
Viego,Riven,1303,646,657,49.58
Viego,Neeko,1496,766,730,51.2
Viego,Elise,2075,1058,1017,50.99
Viego,Lux,6616,3356,3260,50.73
Viego,Ornn,1182,592,590,50.08
Viego,Hwei,1888,958,930,50.74
Viego,Gangplank,1330,663,667,49.85
Viego,Rell,1411,647,764,45.85
Viego,Kindred,1232,692,540,56.17
Viego,Tristana,2603,1282,1321,49.25
Viego,Hecarim,1183,626,557,52.92
Viego,Milio,1470,685,785,46.6
Viego,LeeSin,5292,2746,2546,51.89
Viego,AurelionSol,1071,594,477,55.46
Viego,Annie,821,415,406,50.55
Viego,Singed,712,344,368,48.31
Viego,Nilah,1005,490,515,48.76
Viego,Janna,834,468,366,56.12
Viego,Nocturne,2944,1469,1475,49.9
Viego,Vayne,3153,1531,1622,48.56
Viego,Kayle,1637,827,810,50.52
Viego,Amumu,2879,1313,1566,45.61
Viego,KSante,1276,689,587,54
Viego,Vladimir,1795,987,808,54.99
Viego,Vi,2672,1439,1233,53.85
Viego,Katarina,2297,1150,1147,50.07
Viego,Varus,2368,1177,1191,49.7
Viego,Velkoz,1450,712,738,49.1
Viego,DrMundo,1526,791,735,51.83
Viego,Rengar,928,496,432,53.45
Viego,Nami,2542,1225,1317,48.19
Viego,Belveth,765,394,371,51.5
Viego,Sylas,3761,1972,1789,52.43
Viego,Senna,2056,1036,1020,50.39
Viego,Swain,2623,1374,1249,52.38
Viego,Irelia,2318,1157,1161,49.91
Viego,Anivia,867,453,414,52.25
Viego,Kled,437,234,203,53.55
Viego,Gnar,1158,612,546,52.85
Viego,TwistedFate,915,480,435,52.46
Viego,Akshan,1040,494,546,47.5
Viego,Sona,737,387,350,52.51
Viego,Corki,1120,588,532,52.5
Viego,Skarner,743,451,292,60.7
Viego,Lillia,1679,828,851,49.32
Viego,Aurora,2120,1007,1113,47.5
Viego,Lissandra,858,465,393,54.2
Viego,Lucian,1795,938,857,52.26
Viego,Udyr,1086,517,569,47.61
Viego,Talon,1708,959,749,56.15
Viego,Xerath,2413,1179,1234,48.86
Viego,Camille,833,471,362,56.54
Viego,Briar,2027,1030,997,50.81
Viego,Poppy,1607,802,805,49.91
Viego,Kassadin,548,282,266,51.46
Viego,Zyra,2369,1260,1109,53.19
Viego,Xayah,1257,653,604,51.95
Viego,Qiyana,858,437,421,50.93
Viego,Zilean,843,456,387,54.09
Viego,Azir,1000,592,408,59.2
Viego,Renata,535,301,234,56.26
Viego,Zac,1397,676,721,48.39
Viego,Braum,1546,649,897,41.98
Viego,Cassiopeia,795,383,412,48.18
Viego,RekSai,415,251,164,60.48
Viego,Karthus,689,333,356,48.33
Viego,Nidalee,817,457,360,55.94
Viego,Zoe,1182,627,555,53.05
Viego,Ryze,947,474,473,50.05
Viego,Tryndamere,1571,756,815,48.12
Viego,Rakan,1259,696,563,55.28
Viego,Rammus,939,450,489,47.92
Viego,Alistar,1263,590,673,46.71
Viego,Shyvana,677,292,385,43.13
Viego,Bard,877,409,468,46.64
Velkoz,Jax,959,535,424,55.79
Velkoz,XinZhao,766,371,395,48.43
Velkoz,Kennen,321,196,125,61.06
Velkoz,Kalista,313,191,122,61.02
Velkoz,Lulu,1395,710,685,50.9
Velkoz,Kayle,871,421,450,48.34
Velkoz,Sylas,1255,716,539,57.05
Velkoz,Qiyana,382,207,175,54.19
Velkoz,Caitlyn,3283,1692,1591,51.54
Velkoz,Renata,192,124,68,64.58
Velkoz,Heimerdinger,578,302,276,52.25
Velkoz,Warwick,1793,838,955,46.74
Velkoz,Neeko,635,376,259,59.21
Velkoz,Draven,717,358,359,49.93
Velkoz,Leona,952,477,475,50.11
Velkoz,Gangplank,565,281,284,49.73
Velkoz,Hwei,847,464,383,54.78
Velkoz,Mel,2530,1355,1175,53.56
Velkoz,Hecarim,580,318,262,54.83
Velkoz,Milio,617,324,293,52.51
Velkoz,Teemo,1671,773,898,46.26
Velkoz,Briar,973,506,467,52
Velkoz,Aurora,919,474,445,51.58
Velkoz,Kaisa,1794,967,827,53.9
Velkoz,Karma,1254,603,651,48.09
Velkoz,LeeSin,1550,801,749,51.68
Velkoz,Chogath,1518,782,736,51.52
Velkoz,Lucian,728,377,351,51.79
Velkoz,Xerath,1232,629,603,51.06
Velkoz,Riven,541,279,262,51.57
Velkoz,Tristana,1241,611,630,49.23
Velkoz,Zac,562,275,287,48.93
Velkoz,Darius,2270,1157,1113,50.97
Velkoz,Shaco,1176,642,534,54.59
Velkoz,Veigar,1415,753,662,53.22
Velkoz,Ashe,2091,1146,945,54.81
Velkoz,Azir,396,213,183,53.79
Velkoz,Yorick,1196,577,619,48.24
Velkoz,MasterYi,1416,726,690,51.27
Velkoz,Irelia,1050,527,523,50.19
Velkoz,Shen,864,435,429,50.35
Velkoz,Nami,1226,618,608,50.41
Velkoz,Aatrox,1037,556,481,53.62
Velkoz,Ezreal,2520,1266,1254,50.24
Velkoz,Elise,795,445,350,55.97
Velkoz,Fiora,515,263,252,51.07
Velkoz,Gragas,677,385,292,56.87
Velkoz,Seraphine,1166,590,576,50.6
Velkoz,Ziggs,499,235,264,47.09
Velkoz,Vayne,1520,752,768,49.47
Velkoz,Jinx,3076,1540,1536,50.07
Velkoz,Yasuo,2274,1146,1128,50.4
Velkoz,Sejuani,486,238,248,48.97
Velkoz,TahmKench,1097,566,531,51.6
Velkoz,DrMundo,757,331,426,43.73
Velkoz,Lux,3604,1935,1669,53.69
Velkoz,Pantheon,1902,1032,870,54.26
Velkoz,KSante,506,284,222,56.13
Velkoz,MonkeyKing,708,372,336,52.54
Velkoz,Ekko,1076,569,507,52.88
Velkoz,Senna,946,520,426,54.97
Velkoz,Gwen,665,339,326,50.98
Velkoz,JarvanIV,666,336,330,50.45
Velkoz,Yone,2206,1249,957,56.62
Velkoz,Volibear,1379,692,687,50.18
Velkoz,Talon,619,359,260,58
Velkoz,AurelionSol,528,267,261,50.57
Velkoz,Jhin,2385,1159,1226,48.6
Velkoz,Vi,1053,574,479,54.51
Velkoz,Kassadin,273,154,119,56.41
Velkoz,Corki,507,288,219,56.8
Velkoz,Blitzcrank,904,500,404,55.31
Velkoz,Mordekaiser,1570,856,714,54.52
Velkoz,Nidalee,330,174,156,52.73
Velkoz,Ahri,1586,797,789,50.25
Velkoz,Sona,384,201,183,52.34
Velkoz,Garen,1896,954,942,50.32
Velkoz,Zed,1296,665,631,51.31
Velkoz,Aphelios,706,350,356,49.58
Velkoz,Thresh,1672,906,766,54.19
Velkoz,Khazix,613,290,323,47.31
Velkoz,Taric,292,144,148,49.32
Velkoz,Swain,1232,580,652,47.08
Velkoz,Camille,465,242,223,52.04
Velkoz,Viktor,1048,552,496,52.67
Velkoz,Kayn,1791,846,945,47.24
Velkoz,Tryndamere,698,361,337,51.72
Velkoz,FiddleSticks,551,270,281,49
Velkoz,Singed,377,214,163,56.76
Velkoz,Galio,986,490,496,49.7
Velkoz,Bard,363,188,175,51.79
Velkoz,Diana,1776,976,800,54.95
Velkoz,Rakan,593,286,307,48.23
Velkoz,Malzahar,1216,557,659,45.81
Velkoz,TwistedFate,386,232,154,60.1
Velkoz,Maokai,556,251,305,45.14
Velkoz,Gnar,503,289,214,57.46
Velkoz,Katarina,916,484,432,52.84
Velkoz,Samira,978,518,460,52.97
Velkoz,Poppy,655,318,337,48.55
Velkoz,Viego,1450,738,712,50.9
Velkoz,Orianna,503,252,251,50.1
Velkoz,Vladimir,745,402,343,53.96
Velkoz,Rammus,351,207,144,58.97
Velkoz,Nautilus,1377,753,624,54.68
Velkoz,Naafiri,516,251,265,48.64
Velkoz,Zeri,490,254,236,51.84
Velkoz,Brand,953,464,489,48.69
Velkoz,Smolder,743,389,354,52.36
Velkoz,Shyvana,278,136,142,48.92
Velkoz,Zilean,503,251,252,49.9
Velkoz,Kled,238,137,101,57.56
Velkoz,Nunu,798,424,374,53.13
Velkoz,Annie,385,215,170,55.84
Velkoz,MissFortune,2757,1500,1257,54.41
Velkoz,Yuumi,943,467,476,49.52
Velkoz,Nasus,827,468,359,56.59
Velkoz,Udyr,468,278,190,59.4
Velkoz,Quinn,494,263,231,53.24
Velkoz,Kindred,530,296,234,55.85
Velkoz,Lissandra,336,186,150,55.36
Velkoz,Renekton,624,350,274,56.09
Velkoz,Soraka,729,362,367,49.66
Velkoz,Syndra,772,390,382,50.52
Velkoz,Zyra,932,450,482,48.28
Velkoz,Cassiopeia,399,225,174,56.39
Velkoz,Alistar,416,194,222,46.63
Velkoz,Rengar,503,294,209,58.45
Velkoz,Ryze,440,215,225,48.86
Velkoz,Malphite,1160,580,580,50
Velkoz,Leblanc,632,357,275,56.49
Velkoz,Akali,1155,572,583,49.52
Velkoz,Fizz,771,359,412,46.56
Velkoz,Vex,623,339,284,54.41
Velkoz,Morgana,1507,789,718,52.36
Velkoz,Illaoi,522,324,198,62.07
Velkoz,Xayah,577,305,272,52.86
Velkoz,Braum,658,367,291,55.78
Velkoz,Sett,1830,864,966,47.21
Velkoz,Akshan,389,170,219,43.7
Velkoz,Varus,1033,530,503,51.31
Velkoz,Olaf,232,123,109,53.02
Velkoz,Nocturne,1450,732,718,50.48
Velkoz,Twitch,1019,502,517,49.26
Velkoz,Ambessa,751,428,323,56.99
Velkoz,Rell,642,345,297,53.74
Velkoz,Graves,684,388,296,56.73
Velkoz,Sion,933,439,494,47.05
Velkoz,Zoe,488,290,198,59.43
Velkoz,Ornn,544,279,265,51.29
Velkoz,Evelynn,525,258,267,49.14
Velkoz,Belveth,291,130,161,44.67
Velkoz,Jayce,508,278,230,54.72
Velkoz,Trundle,630,334,296,53.02
Velkoz,Amumu,1339,600,739,44.81
Velkoz,Taliyah,282,147,135,52.13
Velkoz,Nilah,537,307,230,57.17
Velkoz,Anivia,457,232,225,50.77
Velkoz,Rumble,273,154,119,56.41
Velkoz,Pyke,988,508,480,51.42
Velkoz,Lillia,610,356,254,58.36
Velkoz,Janna,368,193,175,52.45
Velkoz,Karthus,285,167,118,58.6
Velkoz,Urgot,611,263,348,43.04
Velkoz,Sivir,633,321,312,50.71
Velkoz,Skarner,313,172,141,54.95
Velkoz,Ivern,214,116,98,54.21
Velkoz,KogMaw,401,193,208,48.13
Velkoz,RekSai,130,63,67,48.46
Kaisa,Jax,2869,1411,1458,49.18
Kaisa,XinZhao,2020,956,1064,47.33
Kaisa,Kennen,892,425,467,47.65
Kaisa,Kalista,970,474,496,48.87
Kaisa,Lulu,3679,1693,1986,46.02
Kaisa,Teemo,3572,1550,2022,43.39
Kaisa,Warwick,4279,2004,2275,46.83
Kaisa,Azir,1162,612,550,52.67
Kaisa,MissFortune,6978,3330,3648,47.72
Kaisa,Neeko,1384,658,726,47.54
Kaisa,Trundle,1643,783,860,47.66
Kaisa,MasterYi,3293,1524,1769,46.28
Kaisa,Veigar,2897,1359,1538,46.91
Kaisa,Jhin,6230,3196,3034,51.3
Kaisa,Soraka,1749,788,961,45.05
Kaisa,TahmKench,2588,1294,1294,50
Kaisa,Jinx,8878,4174,4704,47.02
Kaisa,Zoe,1344,700,644,52.08
Kaisa,Nami,2880,1415,1465,49.13
Kaisa,Gwen,1660,834,826,50.24
Kaisa,JarvanIV,1776,884,892,49.77
Kaisa,Yone,6196,3079,3117,49.69
Kaisa,Zyra,2680,1193,1487,44.51
Kaisa,Seraphine,2434,1175,1259,48.27
Kaisa,Irelia,2908,1289,1619,44.33
Kaisa,Pantheon,5037,2468,2569,49
Kaisa,Kassadin,661,290,371,43.87
Kaisa,Yuumi,2698,1339,1359,49.63
Kaisa,Diana,4780,2270,2510,47.49
Kaisa,Lux,7489,3581,3908,47.82
Kaisa,Tristana,2887,1395,1492,48.32
Kaisa,Mel,6360,3236,3124,50.88
Kaisa,FiddleSticks,1513,691,822,45.67
Kaisa,Shaco,2857,1402,1455,49.07
Kaisa,Syndra,1974,1010,964,51.17
Kaisa,Thresh,4573,2207,2366,48.26
Kaisa,Mordekaiser,3834,1783,2051,46.5
Kaisa,Karma,3578,1739,1839,48.6
Kaisa,Naafiri,1079,485,594,44.95
Kaisa,Nunu,1889,935,954,49.5
Kaisa,Malzahar,2800,1281,1519,45.75
Kaisa,Zeri,1427,695,732,48.7
Kaisa,Smolder,2083,988,1095,47.43
Kaisa,Yasuo,6182,3038,3144,49.14
Kaisa,Caitlyn,8023,3740,4283,46.62
Kaisa,Velkoz,1794,827,967,46.1
Kaisa,Ornn,1346,604,742,44.87
Kaisa,TwistedFate,1222,600,622,49.1
Kaisa,Morgana,3363,1599,1764,47.55
Kaisa,Yorick,2582,1166,1416,45.16
Kaisa,Samira,2419,1211,1208,50.06
Kaisa,Zed,3595,1863,1732,51.82
Kaisa,Viktor,2691,1327,1364,49.31
Kaisa,Pyke,2868,1552,1316,54.11
Kaisa,Olaf,697,339,358,48.64
Kaisa,Hecarim,1300,635,665,48.85
Kaisa,Braum,1959,906,1053,46.25
Kaisa,Volibear,3326,1532,1794,46.06
Kaisa,Evelynn,1161,549,612,47.29
Kaisa,Katarina,2380,1093,1287,45.92
Kaisa,Nocturne,3722,1755,1967,47.15
Kaisa,Vi,3006,1463,1543,48.67
Kaisa,Amumu,3074,1318,1756,42.88
Kaisa,Akshan,996,485,511,48.69
Kaisa,Ezreal,9955,5137,4818,51.6
Kaisa,Orianna,1388,680,708,48.99
Kaisa,Malphite,2778,1304,1474,46.94
Kaisa,Nautilus,3367,1589,1778,47.19
Kaisa,Akali,3532,1649,1883,46.69
Kaisa,LeeSin,5024,2583,2441,51.41
Kaisa,Camille,1073,578,495,53.87
Kaisa,Xayah,2138,931,1207,43.55
Kaisa,Tryndamere,1505,717,788,47.64
Kaisa,Sivir,1656,753,903,45.47
Kaisa,Graves,2208,1106,1102,50.09
Kaisa,Maokai,1425,630,795,44.21
Kaisa,Gnar,1302,614,688,47.16
Kaisa,Taric,647,290,357,44.82
Kaisa,Jayce,1477,760,717,51.46
Kaisa,Skarner,983,492,491,50.05
Kaisa,Poppy,2128,997,1131,46.85
Kaisa,Chogath,3600,1792,1808,49.78
Kaisa,Talon,1966,994,972,50.56
Kaisa,Nilah,1232,533,699,43.26
Kaisa,Milio,1673,762,911,45.55
Kaisa,Leona,2647,1303,1344,49.23
Kaisa,Aurora,2568,1179,1389,45.91
Kaisa,Kayn,4251,2039,2212,47.97
Kaisa,Ziggs,1032,500,532,48.45
Kaisa,Senna,2391,1143,1248,47.8
Kaisa,Sett,4670,2256,2414,48.31
Kaisa,Renata,656,332,324,50.61
Kaisa,Rammus,918,432,486,47.06
Kaisa,Renekton,1675,782,893,46.69
Kaisa,Sion,2402,1141,1261,47.5
Kaisa,Ashe,6126,2846,3280,46.46
Kaisa,Briar,2244,1017,1227,45.32
Kaisa,Draven,1637,743,894,45.39
Kaisa,Darius,5579,2773,2806,49.7
Kaisa,Viego,4462,2181,2281,48.88
Kaisa,Vayne,4230,1973,2257,46.64
Kaisa,Taliyah,855,385,470,45.03
Kaisa,Singed,870,429,441,49.31
Kaisa,Brand,2019,1016,1003,50.32
Kaisa,Nasus,2031,871,1160,42.89
Kaisa,Zac,1529,745,784,48.72
Kaisa,Swain,3156,1365,1791,43.25
Kaisa,Rengar,1089,615,474,56.47
Kaisa,Hwei,2015,995,1020,49.38
Kaisa,KogMaw,923,383,540,41.5
Kaisa,Heimerdinger,1325,584,741,44.08
Kaisa,Urgot,1587,685,902,43.16
Kaisa,Xerath,2511,1218,1293,48.51
Kaisa,Aatrox,2899,1420,1479,48.98
Kaisa,Ryze,1121,473,648,42.19
Kaisa,Janna,1108,513,595,46.3
Kaisa,Vladimir,2012,974,1038,48.41
Kaisa,Aphelios,1839,842,997,45.79
Kaisa,Alistar,1340,632,708,47.16
Kaisa,Twitch,2377,1104,1273,46.45
Kaisa,Blitzcrank,2172,1108,1064,51.01
Kaisa,Shen,2054,966,1088,47.03
Kaisa,Lillia,1824,919,905,50.38
Kaisa,Khazix,1743,824,919,47.27
Kaisa,Anivia,1140,557,583,48.86
Kaisa,DrMundo,1860,891,969,47.9
Kaisa,Kayle,1876,828,1048,44.14
Kaisa,Udyr,1193,557,636,46.69
Kaisa,Rell,1574,772,802,49.05
Kaisa,Galio,2858,1279,1579,44.75
Kaisa,Lucian,2263,1078,1185,47.64
Kaisa,Ekko,2570,1250,1320,48.64
Kaisa,Riven,1430,697,733,48.74
Kaisa,Ahri,4100,1931,2169,47.1
Kaisa,Garen,4604,2081,2523,45.2
Kaisa,Nidalee,1031,534,497,51.79
Kaisa,Lissandra,985,463,522,47.01
Kaisa,Sylas,4403,2223,2180,50.49
Kaisa,Bard,971,436,535,44.9
Kaisa,Kindred,1572,836,736,53.18
Kaisa,Ambessa,2053,1087,966,52.95
Kaisa,Varus,2780,1445,1335,51.98
Kaisa,Illaoi,1443,722,721,50.03
Kaisa,Annie,1041,456,585,43.8
Kaisa,Fiora,1175,592,583,50.38
Kaisa,KSante,1638,869,769,53.05
Kaisa,Karthus,966,389,577,40.27
Kaisa,Belveth,780,407,373,52.18
Kaisa,Leblanc,1797,900,897,50.08
Kaisa,Gangplank,1513,743,770,49.11
Kaisa,Elise,2349,1135,1214,48.32
Kaisa,Corki,1277,690,587,54.03
Kaisa,Cassiopeia,966,487,479,50.41
Kaisa,Rakan,1553,677,876,43.59
Kaisa,Vex,1563,722,841,46.19
Kaisa,Ivern,508,241,267,47.44
Kaisa,Fizz,1730,833,897,48.15
Kaisa,Gragas,1740,822,918,47.24
Kaisa,Sejuani,1336,604,732,45.21
Kaisa,Kled,574,287,287,50
Kaisa,Sona,955,444,511,46.49
Kaisa,AurelionSol,1193,560,633,46.94
Kaisa,Shyvana,713,302,411,42.36
Kaisa,Qiyana,782,370,412,47.31
Kaisa,Rumble,852,410,442,48.12
Kaisa,Zilean,958,413,545,43.11
Kaisa,RekSai,395,203,192,51.39
Kaisa,MonkeyKing,1932,816,1116,42.24
Kaisa,Quinn,1053,562,491,53.37
Karma,Jax,1870,1019,851,54.49
Karma,XinZhao,1453,825,628,56.78
Karma,Kennen,615,319,296,51.87
Karma,Kalista,674,343,331,50.89
Karma,Lulu,3465,1778,1687,51.31
Karma,Maokai,963,454,509,47.14
Karma,Graves,1490,759,731,50.94
Karma,Ahri,2852,1369,1483,48
Karma,Nilah,641,289,352,45.09
Karma,Malphite,1951,1029,922,52.74
Karma,Nasus,1364,660,704,48.39
Karma,Shaco,1963,997,966,50.79
Karma,Zed,2349,1218,1131,51.85
Karma,Varus,1983,1058,925,53.35
Karma,Neeko,950,433,517,45.58
Karma,Volibear,2037,1036,1001,50.86
Karma,Ekko,1817,947,870,52.12
Karma,Akshan,748,427,321,57.09
Karma,Yasuo,3965,1998,1967,50.39
Karma,Katarina,1657,832,825,50.21
Karma,Chogath,2419,1180,1239,48.78
Karma,Leblanc,1421,722,699,50.81
Karma,Caitlyn,5704,2881,2823,50.51
Karma,Milio,1433,676,757,47.17
Karma,Sylas,2698,1447,1251,53.63
Karma,Amumu,1917,922,995,48.1
Karma,Vex,1030,531,499,51.55
Karma,Kaisa,3578,1839,1739,51.4
Karma,Rakan,996,508,488,51
Karma,Gangplank,1169,594,575,50.81
Karma,Lillia,1182,596,586,50.42
Karma,MissFortune,4104,2033,2071,49.54
Karma,Soraka,1304,641,663,49.16
Karma,Smolder,1339,739,600,55.19
Karma,Warwick,2534,1196,1338,47.2
Karma,Velkoz,1254,651,603,51.91
Karma,Mordekaiser,2423,1202,1221,49.61
Karma,Mel,4326,2372,1954,54.83
Karma,Ashe,4500,2246,2254,49.91
Karma,Jayce,1330,666,664,50.08
Karma,Gragas,1307,684,623,52.33
Karma,Darius,3656,1734,1922,47.43
Karma,MasterYi,2178,1068,1110,49.04
Karma,Taric,371,180,191,48.52
Karma,Garen,3265,1614,1651,49.43
Karma,Talon,1387,651,736,46.94
Karma,Tristana,1921,974,947,50.7
Karma,Aurora,1822,909,913,49.89
Karma,Nocturne,2322,1141,1181,49.14
Karma,Pantheon,3342,1696,1646,50.75
Karma,Sett,2806,1375,1431,49
Karma,Samira,1325,686,639,51.77
Karma,Illaoi,776,428,348,55.15
Karma,Evelynn,781,362,419,46.35
Karma,Hwei,1466,781,685,53.27
Karma,Senna,1589,780,809,49.09
Karma,Gwen,983,551,432,56.05
Karma,Elise,1705,918,787,53.84
Karma,Aatrox,1909,986,923,51.65
Karma,Twitch,1608,740,868,46.02
Karma,Ryze,875,420,455,48
Karma,Jhin,4329,2294,2035,52.99
Karma,Nautilus,2275,1119,1156,49.19
Karma,Poppy,1252,630,622,50.32
Karma,Nami,2721,1260,1461,46.31
Karma,Irelia,1828,932,896,50.98
Karma,Orianna,1040,546,494,52.5
Karma,Ezreal,5496,2753,2743,50.09
Karma,Bard,829,409,420,49.34
Karma,Sion,1538,783,755,50.91
Karma,Yorick,1847,943,904,51.06
Karma,Xerath,2250,1114,1136,49.51
Karma,Akali,2293,1135,1158,49.5
Karma,Kayn,2771,1390,1381,50.16
Karma,Ziggs,821,380,441,46.29
Karma,Naafiri,626,306,320,48.88
Karma,Lux,5407,2649,2758,48.99
Karma,Belveth,518,218,300,42.08
Karma,Viego,2980,1490,1490,50
Karma,Yuumi,1885,909,976,48.22
Karma,Qiyana,639,323,316,50.55
Karma,Singed,653,341,312,52.22
Karma,Riven,1102,561,541,50.91
Karma,LeeSin,3892,2086,1806,53.6
Karma,Olaf,458,264,194,57.64
Karma,Draven,1072,533,539,49.72
Karma,Thresh,3066,1511,1555,49.28
Karma,Swain,1951,960,991,49.21
Karma,Shen,1335,680,655,50.94
Karma,Veigar,1706,876,830,51.35
Karma,Blitzcrank,1550,806,744,52
Karma,Ambessa,1525,788,737,51.67
Karma,Jinx,5269,2551,2718,48.42
Karma,Brand,1226,689,537,56.2
Karma,Fizz,1062,555,507,52.26
Karma,Yone,3646,1918,1728,52.61
Karma,Karthus,665,371,294,55.79
Karma,Diana,3240,1497,1743,46.2
Karma,Skarner,586,319,267,54.44
Karma,Malzahar,2065,1041,1024,50.41
Karma,Vi,2199,1050,1149,47.75
Karma,Gnar,875,491,384,56.11
Karma,FiddleSticks,1077,570,507,52.92
Karma,Leona,1656,874,782,52.78
Karma,Nunu,1181,560,621,47.42
Karma,Zoe,935,498,437,53.26
Karma,TahmKench,1590,848,742,53.33
Karma,Renekton,1135,591,544,52.07
Karma,Rammus,526,260,266,49.43
Karma,Hecarim,931,508,423,54.56
Karma,Briar,1514,695,819,45.9
Karma,KogMaw,644,346,298,53.73
Karma,Seraphine,1713,851,862,49.68
Karma,Rell,1057,549,508,51.94
Karma,Kayle,1340,572,768,42.69
Karma,Vayne,2392,1080,1312,45.15
Karma,Lissandra,689,391,298,56.75
Karma,Morgana,2533,1369,1164,54.05
Karma,Camille,876,480,396,54.79
Karma,Lucian,1527,818,709,53.57
Karma,Tryndamere,962,468,494,48.65
Karma,Sona,690,279,411,40.43
Karma,Sivir,1243,603,640,48.51
Karma,Trundle,1071,513,558,47.9
Karma,Khazix,1255,681,574,54.26
Karma,Galio,1841,870,971,47.26
Karma,Braum,1343,634,709,47.21
Karma,Alistar,780,418,362,53.59
Karma,Zyra,2140,1039,1101,48.55
Karma,Fiora,889,491,398,55.23
Karma,Cassiopeia,603,305,298,50.58
Karma,Anivia,761,380,381,49.93
Karma,Sejuani,898,474,424,52.78
Karma,Kindred,898,492,406,54.79
Karma,Viktor,2084,1093,991,52.45
Karma,DrMundo,1070,490,580,45.79
Karma,Quinn,756,376,380,49.74
Karma,Xayah,961,528,433,54.94
Karma,Syndra,1509,786,723,52.09
Karma,Zac,1121,532,589,47.46
Karma,Ornn,876,403,473,46
Karma,Shyvana,470,226,244,48.09
Karma,Rengar,810,473,337,58.4
Karma,Ivern,378,202,176,53.44
Karma,Corki,877,442,435,50.4
Karma,RekSai,249,116,133,46.59
Karma,Vladimir,1444,682,762,47.23
Karma,KSante,1247,726,521,58.22
Karma,Udyr,795,428,367,53.84
Karma,Janna,815,383,432,46.99
Karma,Teemo,2383,1157,1226,48.55
Karma,Kassadin,491,221,270,45.01
Karma,Zeri,1023,562,461,54.94
Karma,Pyke,1881,1022,859,54.33
Karma,Azir,766,425,341,55.48
Karma,Nidalee,769,426,343,55.4
Karma,MonkeyKing,1487,736,751,49.5
Karma,JarvanIV,1200,560,640,46.67
Karma,Rumble,680,365,315,53.68
Karma,Heimerdinger,868,399,469,45.97
Karma,Taliyah,644,353,291,54.81
Karma,Urgot,1078,530,548,49.17
Karma,TwistedFate,791,446,345,56.38
Karma,AurelionSol,736,335,401,45.52
Karma,Aphelios,1204,659,545,54.73
Karma,Renata,464,236,228,50.86
Karma,Zilean,757,381,376,50.33
Karma,Annie,700,348,352,49.71
Karma,Kled,401,225,176,56.11
Aatrox,Kennen,649,319,330,49.15
Aatrox,Warwick,2540,1227,1313,48.31
Aatrox,Yasuo,3558,1702,1856,47.84
Aatrox,Kindred,882,465,417,52.72
Aatrox,Lux,4381,2109,2272,48.14
Aatrox,Yorick,1506,620,886,41.17
Aatrox,Kayn,2594,1198,1396,46.18
Aatrox,Ryze,647,403,244,62.29
Aatrox,Pantheon,2858,1358,1500,47.52
Aatrox,Naafiri,686,297,389,43.29
Aatrox,Briar,1441,668,773,46.36
Aatrox,Yone,3827,1917,1910,50.09
Aatrox,MissFortune,3750,1759,1991,46.91
Aatrox,Senna,1234,604,630,48.95
Aatrox,Kayle,1238,573,665,46.28
Aatrox,Viego,2745,1362,1383,49.62
Aatrox,Irelia,1679,781,898,46.52
Aatrox,Jinx,4674,2196,2478,46.98
Aatrox,Thresh,2828,1390,1438,49.15
Aatrox,Darius,3544,1714,1830,48.36
Aatrox,Rengar,676,431,245,63.76
Aatrox,Syndra,1066,466,600,43.71
Aatrox,Caitlyn,4556,2097,2459,46.03
Aatrox,XinZhao,1131,566,565,50.04
Aatrox,Katarina,1464,721,743,49.25
Aatrox,Teemo,2558,1161,1397,45.39
Aatrox,Vayne,2036,937,1099,46.02
Aatrox,TwistedFate,732,381,351,52.05
Aatrox,Shen,1066,518,548,48.59
Aatrox,Diana,2723,1327,1396,48.73
Aatrox,Samira,1417,696,721,49.12
Aatrox,Soraka,954,475,479,49.79
Aatrox,Garen,2884,1359,1525,47.12
Aatrox,FiddleSticks,907,468,439,51.6
Aatrox,Brand,1153,558,595,48.4
Aatrox,Tryndamere,848,449,399,52.95
Aatrox,Graves,1295,659,636,50.89
Aatrox,Sylas,2374,1144,1230,48.19
Aatrox,Leona,1532,773,759,50.46
Aatrox,Mordekaiser,2552,1175,1377,46.04
Aatrox,Janna,619,279,340,45.07
Aatrox,Volibear,1908,893,1015,46.8
Aatrox,Khazix,1018,498,520,48.92
Aatrox,Akali,1937,960,977,49.56
Aatrox,Draven,996,397,599,39.86
Aatrox,Mel,3607,1840,1767,51.01
Aatrox,Smolder,1209,658,551,54.43
Aatrox,Rell,1057,524,533,49.57
Aatrox,Sett,3063,1505,1558,49.13
Aatrox,Tristana,1650,762,888,46.18
Aatrox,Blitzcrank,1523,763,760,50.1
Aatrox,Poppy,1036,540,496,52.12
Aatrox,Nunu,1078,536,542,49.72
Aatrox,Zed,1933,999,934,51.68
Aatrox,Rakan,906,465,441,51.32
Aatrox,Fiora,828,440,388,53.14
Aatrox,Ekko,1572,719,853,45.74
Aatrox,Kassadin,385,221,164,57.4
Aatrox,TahmKench,1578,830,748,52.6
Aatrox,Camille,690,359,331,52.03
Aatrox,Xayah,941,499,442,53.03
Aatrox,Yuumi,1635,767,868,46.91
Aatrox,Veigar,1729,816,913,47.19
Aatrox,KSante,1088,579,509,53.22
Aatrox,Jax,1575,741,834,47.05
Aatrox,Velkoz,1037,481,556,46.38
Aatrox,Gangplank,1144,555,589,48.51
Aatrox,Malzahar,1689,761,928,45.06
Aatrox,Heimerdinger,795,345,450,43.4
Aatrox,Ashe,3700,1874,1826,50.65
Aatrox,Pyke,1592,912,680,57.29
Aatrox,Nasus,1193,542,651,45.43
Aatrox,Azir,682,336,346,49.27
Aatrox,Nami,1900,894,1006,47.05
Aatrox,Shaco,1657,834,823,50.33
Aatrox,Annie,603,318,285,52.74
Aatrox,Olaf,325,135,190,41.54
Aatrox,Aurora,1493,768,725,51.44
Aatrox,Vladimir,1036,531,505,51.25
Aatrox,Gnar,774,432,342,55.81
Aatrox,Twitch,1378,706,672,51.23
Aatrox,Xerath,1626,797,829,49.02
Aatrox,Morgana,2019,931,1088,46.11
Aatrox,Zoe,740,373,367,50.41
Aatrox,Karma,1909,923,986,48.35
Aatrox,Ornn,819,394,425,48.11
Aatrox,Kalista,610,299,311,49.02
Aatrox,Chogath,2054,1018,1036,49.56
Aatrox,Hecarim,690,340,350,49.28
Aatrox,Malphite,1792,916,876,51.12
Aatrox,Maokai,825,397,428,48.12
Aatrox,Sona,510,243,267,47.65
Aatrox,Ivern,254,163,91,64.17
Aatrox,Belveth,414,222,192,53.62
Aatrox,Jhin,3436,1745,1691,50.79
Aatrox,LeeSin,3059,1552,1507,50.74
Aatrox,Lillia,1037,566,471,54.58
Aatrox,Jayce,1071,588,483,54.9
Aatrox,DrMundo,1184,576,608,48.65
Aatrox,Seraphine,1487,659,828,44.32
Aatrox,Galio,1527,755,772,49.44
Aatrox,Nilah,702,327,375,46.58
Aatrox,Urgot,1011,458,553,45.3
Aatrox,MasterYi,1910,867,1043,45.39
Aatrox,Sejuani,772,418,354,54.15
Aatrox,Amumu,1471,651,820,44.26
Aatrox,Ahri,2374,1201,1173,50.59
Aatrox,Nautilus,2015,974,1041,48.34
Aatrox,Qiyana,558,263,295,47.13
Aatrox,Rumble,563,270,293,47.96
Aatrox,Ambessa,1176,522,654,44.39
Aatrox,Elise,1282,632,650,49.3
Aatrox,Kaisa,2899,1479,1420,51.02
Aatrox,Vi,1686,799,887,47.39
Aatrox,Vex,1039,556,483,53.51
Aatrox,Milio,1122,488,634,43.49
Aatrox,Zeri,853,409,444,47.95
Aatrox,Singed,546,213,333,39.01
Aatrox,Orianna,774,325,449,41.99
Aatrox,Zilean,644,308,336,47.83
Aatrox,Lucian,1298,688,610,53
Aatrox,Cassiopeia,603,333,270,55.22
Aatrox,Aphelios,1033,492,541,47.63
Aatrox,MonkeyKing,1088,531,557,48.81
Aatrox,Trundle,846,382,464,45.15
Aatrox,Illaoi,820,397,423,48.41
Aatrox,Gragas,1221,567,654,46.44
Aatrox,Braum,927,418,509,45.09
Aatrox,Nidalee,658,408,250,62.01
Aatrox,Lulu,2261,1111,1150,49.14
Aatrox,Karthus,530,298,232,56.23
Aatrox,Neeko,976,480,496,49.18
Aatrox,Ziggs,748,337,411,45.05
Aatrox,JarvanIV,952,494,458,51.89
Aatrox,Evelynn,733,346,387,47.2
Aatrox,Leblanc,1122,608,514,54.19
Aatrox,Ezreal,4277,2176,2101,50.88
Aatrox,Gwen,883,438,445,49.6
Aatrox,Skarner,530,285,245,53.77
Aatrox,Varus,1671,818,853,48.95
Aatrox,Corki,655,345,310,52.67
Aatrox,Rammus,577,254,323,44.02
Aatrox,Fizz,954,440,514,46.12
Aatrox,Swain,1830,884,946,48.31
Aatrox,Kled,386,188,198,48.7
Aatrox,Sivir,950,464,486,48.84
Aatrox,Udyr,753,373,380,49.54
Aatrox,Riven,709,368,341,51.9
Aatrox,Renekton,1107,464,643,41.92
Aatrox,Hwei,1250,611,639,48.88
Aatrox,KogMaw,541,193,348,35.67
Aatrox,RekSai,205,101,104,49.27
Aatrox,Anivia,556,239,317,42.99
Aatrox,Alistar,794,366,428,46.1
Aatrox,Sion,1407,751,656,53.38
Aatrox,Talon,1099,543,556,49.41
Aatrox,Akshan,594,283,311,47.64
Aatrox,Lissandra,538,225,313,41.82
Aatrox,Renata,382,176,206,46.07
Aatrox,Nocturne,2071,892,1179,43.07
Aatrox,Viktor,1490,711,779,47.72
Aatrox,AurelionSol,740,318,422,42.97
Aatrox,Zac,929,500,429,53.82
Aatrox,Bard,602,323,279,53.65
Aatrox,Taliyah,495,216,279,43.64
Aatrox,Zyra,1480,676,804,45.68
Aatrox,Quinn,575,316,259,54.96
Aatrox,Taric,339,203,136,59.88
Aatrox,Shyvana,306,126,180,41.18
Sylas,Kennen,871,481,390,55.22
Sylas,Warwick,3741,1777,1964,47.5
Sylas,Yasuo,5542,2589,2953,46.72
Sylas,Kindred,1120,559,561,49.91
Sylas,Lux,5892,2868,3024,48.68
Sylas,Maokai,1279,597,682,46.68
Sylas,Graves,1831,840,991,45.88
Sylas,Ahri,3975,1997,1978,50.24
Sylas,Nilah,906,450,456,49.67
Sylas,Malphite,3734,2074,1660,55.54
Sylas,Mordekaiser,3173,1489,1684,46.93
Sylas,Qiyana,740,372,368,50.27
Sylas,Ashe,5625,2844,2781,50.56
Sylas,Sona,757,392,365,51.78
Sylas,Illaoi,1194,491,703,41.12
Sylas,Twitch,1722,801,921,46.52
Sylas,Yone,5534,2788,2746,50.38
Sylas,Velkoz,1255,539,716,42.95
Sylas,Swain,2816,1305,1511,46.34
Sylas,Malzahar,2036,946,1090,46.46
Sylas,Irelia,2223,1202,1021,54.07
Sylas,Kalista,820,480,340,58.54
Sylas,Poppy,1446,654,792,45.23
Sylas,Kayle,1607,756,851,47.04
Sylas,MonkeyKing,1696,765,931,45.11
Sylas,RekSai,277,146,131,52.71
Sylas,Seraphine,2085,1025,1060,49.16
Sylas,Briar,1714,742,972,43.29
Sylas,Evelynn,887,456,431,51.41
Sylas,Tristana,2318,1074,1244,46.33
Sylas,Thresh,3484,1619,1865,46.47
Sylas,Ryze,1055,467,588,44.27
Sylas,Morgana,2730,1276,1454,46.74
Sylas,Xayah,1412,652,760,46.18
Sylas,Veigar,2435,1213,1222,49.82
Sylas,FiddleSticks,1448,713,735,49.24
Sylas,Akali,3532,1826,1706,51.7
Sylas,Senna,1689,821,868,48.61
Sylas,Kayn,3359,1544,1815,45.97
Sylas,TwistedFate,976,472,504,48.36
Sylas,Smolder,1591,807,784,50.72
Sylas,Nautilus,3197,1633,1564,51.08
Sylas,Diana,4115,1972,2143,47.92
Sylas,MissFortune,5590,2623,2967,46.92
Sylas,Karma,2698,1251,1447,46.37
Sylas,Pantheon,4231,1906,2325,45.05
Sylas,Garen,4081,1937,2144,47.46
Sylas,Ziggs,822,427,395,51.95
Sylas,Zeri,1147,604,543,52.66
Sylas,Zyra,2327,1142,1185,49.08
Sylas,Nocturne,3252,1659,1593,51.01
Sylas,Lissandra,794,413,381,52.02
Sylas,Jhin,4773,2393,2380,50.14
Sylas,Mel,5372,2773,2599,51.62
Sylas,Singed,643,331,312,51.48
Sylas,Pyke,2536,1293,1243,50.99
Sylas,Aatrox,2374,1230,1144,51.81
Sylas,Ezreal,7039,3499,3540,49.71
Sylas,Milio,1242,611,631,49.19
Sylas,Yorick,1965,1008,957,51.3
Sylas,Gragas,1643,823,820,50.09
Sylas,Volibear,2540,1250,1290,49.21
Sylas,Khazix,1292,672,620,52.01
Sylas,Draven,1194,619,575,51.84
Sylas,Gnar,1197,642,555,53.63
Sylas,Jax,2381,1142,1239,47.96
Sylas,Aurora,2191,1104,1087,50.39
Sylas,Bard,793,371,422,46.78
Sylas,Riven,1093,534,559,48.86
Sylas,Syndra,1209,604,605,49.96
Sylas,Jinx,6405,3052,3353,47.65
Sylas,Zed,2924,1543,1381,52.77
Sylas,Talon,1754,950,804,54.16
Sylas,Rammus,718,349,369,48.61
Sylas,Akshan,738,327,411,44.31
Sylas,Chogath,3110,1515,1595,48.71
Sylas,Lillia,1480,680,800,45.95
Sylas,Vex,1614,698,916,43.25
Sylas,Janna,692,297,395,42.92
Sylas,Sett,3894,1741,2153,44.71
Sylas,Cassiopeia,842,367,475,43.59
Sylas,Fiora,890,451,439,50.67
Sylas,LeeSin,4816,2455,2361,50.98
Sylas,Zilean,804,384,420,47.76
Sylas,Rengar,719,352,367,48.96
Sylas,Anivia,813,408,405,50.18
Sylas,Galio,2990,1404,1586,46.96
Sylas,Naafiri,928,432,496,46.55
Sylas,Vi,2654,1303,1351,49.1
Sylas,Aphelios,1375,643,732,46.76
Sylas,Heimerdinger,1196,444,752,37.12
Sylas,Varus,2501,1232,1269,49.26
Sylas,Gwen,1230,613,617,49.84
Sylas,JarvanIV,1424,727,697,51.05
Sylas,Leblanc,1531,796,735,51.99
Sylas,Samira,1927,903,1024,46.86
Sylas,Shen,1507,694,813,46.05
Sylas,Darius,4247,2084,2163,49.07
Sylas,Shaco,2041,1005,1036,49.24
Sylas,Zoe,1074,515,559,47.95
Sylas,Ivern,402,173,229,43.03
Sylas,Quinn,834,430,404,51.56
Sylas,TahmKench,2005,1008,997,50.27
Sylas,XinZhao,1695,859,836,50.68
Sylas,AurelionSol,770,369,401,47.92
Sylas,Rakan,1225,619,606,50.53
Sylas,Shyvana,522,261,261,50
Sylas,Viktor,2247,1140,1107,50.73
Sylas,Lucian,1750,917,833,52.4
Sylas,Soraka,1312,632,680,48.17
Sylas,Neeko,1402,711,691,50.71
Sylas,Xerath,2241,1099,1142,49.04
Sylas,Renekton,1362,668,694,49.05
Sylas,Sivir,1404,650,754,46.3
Sylas,Sejuani,1220,608,612,49.84
Sylas,Blitzcrank,2305,1212,1093,52.58
Sylas,Ornn,1268,576,692,45.43
Sylas,Vayne,2809,1311,1498,46.67
Sylas,Nasus,1704,814,890,47.77
Sylas,Amumu,2679,1272,1407,47.48
Sylas,Caitlyn,6534,3236,3298,49.53
Sylas,KogMaw,703,356,347,50.64
Sylas,Ekko,2337,1142,1195,48.87
Sylas,Yuumi,1955,991,964,50.69
Sylas,Katarina,1860,945,915,50.81
Sylas,Lulu,3156,1594,1562,50.51
Sylas,Gangplank,1303,625,678,47.97
Sylas,Skarner,823,426,397,51.76
Sylas,Vladimir,1619,797,822,49.23
Sylas,Rell,1296,633,663,48.84
Sylas,Viego,3761,1789,1972,47.57
Sylas,KSante,1508,744,764,49.34
Sylas,Teemo,2967,1365,1602,46.01
Sylas,Braum,1542,703,839,45.59
Sylas,Kaisa,4403,2180,2223,49.51
Sylas,DrMundo,1302,667,635,51.23
Sylas,Annie,722,330,392,45.71
Sylas,Urgot,1105,535,570,48.42
Sylas,Kassadin,467,205,262,43.9
Sylas,Taliyah,753,364,389,48.34
Sylas,Kled,462,209,253,45.24
Sylas,Nami,2076,986,1090,47.5
Sylas,Udyr,875,419,456,47.89
Sylas,Camille,879,447,432,50.85
Sylas,Nidalee,807,418,389,51.8
Sylas,MasterYi,2616,1222,1394,46.71
Sylas,Corki,1009,516,493,51.14
Sylas,Orianna,1219,622,597,51.03
Sylas,Elise,1864,942,922,50.54
Sylas,Zac,1328,639,689,48.12
Sylas,Alistar,1525,819,706,53.7
Sylas,Tryndamere,1152,578,574,50.17
Sylas,Leona,2445,1209,1236,49.45
Sylas,Ambessa,1649,815,834,49.42
Sylas,Nunu,1596,791,805,49.56
Sylas,Azir,1047,524,523,50.05
Sylas,Rumble,800,374,426,46.75
Sylas,Sion,1882,865,1017,45.96
Sylas,Belveth,570,287,283,50.35
Sylas,Hwei,1591,781,810,49.09
Sylas,Hecarim,1130,622,508,55.04
Sylas,Taric,513,225,288,43.86
Sylas,Olaf,561,245,316,43.67
Sylas,Fizz,1332,688,644,51.65
Sylas,Brand,1551,770,781,49.65
Sylas,Renata,441,225,216,51.02
Sylas,Trundle,1286,614,672,47.74
Sylas,Karthus,709,347,362,48.94
Sylas,Jayce,1397,646,751,46.24
Diana,Kennen,930,484,446,52.04
Diana,Warwick,4658,2083,2575,44.72
Diana,Yasuo,5533,2757,2776,49.83
Diana,Kindred,1441,772,669,53.57
Diana,Lux,7721,3961,3760,51.3
Diana,Vladimir,1870,1002,868,53.58
Diana,Darius,5623,2851,2772,50.7
Diana,KogMaw,904,465,439,51.44
Diana,Yuumi,2429,1319,1110,54.3
Diana,Sett,4805,2314,2491,48.16
Diana,Ivern,480,271,209,56.46
Diana,Veigar,3308,1673,1635,50.57
Diana,Jinx,7711,3650,4061,47.33
Diana,Lulu,3607,1799,1808,49.88
Diana,Garen,4722,2365,2357,50.08
Diana,Briar,2461,1177,1284,47.83
Diana,Zed,3557,1869,1688,52.54
Diana,Caitlyn,7980,4116,3864,51.58
Diana,Morgana,3849,1988,1861,51.65
Diana,Mordekaiser,4144,1975,2169,47.66
Diana,Ryze,966,488,478,50.52
Diana,Vex,1723,870,853,50.49
Diana,Gwen,1787,971,816,54.34
Diana,Skarner,835,426,409,51.02
Diana,Yone,5522,2828,2694,51.21
Diana,Kaisa,4780,2510,2270,52.51
Diana,Seraphine,2460,1280,1180,52.03
Diana,Ambessa,1922,973,949,50.62
Diana,Xayah,1593,792,801,49.72
Diana,AurelionSol,1082,545,537,50.37
Diana,Khazix,1537,796,741,51.79
Diana,Nautilus,3345,1704,1641,50.94
Diana,Vi,2980,1582,1398,53.09
Diana,Azir,1139,586,553,51.45
Diana,MissFortune,7176,3691,3485,51.44
Diana,Chogath,3677,1715,1962,46.64
Diana,Graves,1887,949,938,50.29
Diana,Leblanc,1762,915,847,51.93
Diana,Milio,1600,759,841,47.44
Diana,Annie,956,479,477,50.1
Diana,Kayn,4903,2445,2458,49.87
Diana,Aatrox,2723,1396,1327,51.27
Diana,Pyke,2574,1280,1294,49.73
Diana,Sylas,4115,2143,1972,52.08
Diana,Amumu,3384,1591,1793,47.02
Diana,Rakan,1242,606,636,48.79
Diana,Gangplank,1361,717,644,52.68
Diana,Lillia,1785,968,817,54.23
Diana,Soraka,1469,779,690,53.03
Diana,Nasus,2126,1039,1087,48.87
Diana,Neeko,1586,831,755,52.4
Diana,Swain,2811,1347,1464,47.92
Diana,Shen,1863,905,958,48.58
Diana,Rammus,844,449,395,53.2
Diana,Cassiopeia,1055,520,535,49.29
Diana,Sivir,1576,698,878,44.29
Diana,Xerath,2541,1242,1299,48.88
Diana,Jax,2781,1421,1360,51.1
Diana,Evelynn,1359,715,644,52.61
Diana,Mel,6522,3457,3065,53.01
Diana,Kalista,959,484,475,50.47
Diana,Renata,574,315,259,54.88
Diana,Fiora,1192,667,525,55.96
Diana,Shaco,2858,1487,1371,52.03
Diana,Fizz,1666,878,788,52.7
Diana,Tristana,2817,1427,1390,50.66
Diana,Renekton,1496,759,737,50.74
Diana,Karthus,969,503,466,51.91
Diana,Ashe,5753,3058,2695,53.15
Diana,Maokai,1383,709,674,51.27
Diana,Aurora,2633,1364,1269,51.8
Diana,Nilah,1068,521,547,48.78
Diana,Hwei,1937,956,981,49.35
Diana,Volibear,3458,1696,1762,49.05
Diana,XinZhao,1939,964,975,49.72
Diana,Irelia,2505,1280,1225,51.1
Diana,Nami,3115,1546,1569,49.63
Diana,Samira,2299,1114,1185,48.46
Diana,Malphite,2675,1378,1297,51.51
Diana,Sion,2203,1102,1101,50.02
Diana,Ahri,4167,2205,1962,52.92
Diana,Draven,1547,824,723,53.26
Diana,Akali,3380,1756,1624,51.95
Diana,Ezreal,6911,3636,3275,52.61
Diana,Senna,2183,1082,1101,49.56
Diana,Yorick,2845,1379,1466,48.47
Diana,Malzahar,3039,1539,1500,50.64
Diana,Aphelios,1856,913,943,49.19
Diana,Braum,1641,812,829,49.48
Diana,Trundle,1656,781,875,47.16
Diana,Blitzcrank,2207,1133,1074,51.34
Diana,Poppy,1891,936,955,49.5
Diana,Twitch,2505,1222,1283,48.78
Diana,Viego,4519,2205,2314,48.79
Diana,Katarina,2378,1209,1169,50.84
Diana,Jayce,1479,798,681,53.96
Diana,Jhin,5572,2801,2771,50.27
Diana,Thresh,4160,2013,2147,48.39
Diana,Illaoi,1519,721,798,47.47
Diana,MasterYi,3743,1853,1890,49.51
Diana,Vayne,3497,1689,1808,48.3
Diana,Sona,994,484,510,48.69
Diana,Kayle,2053,1065,988,51.88
Diana,JarvanIV,1571,810,761,51.56
Diana,LeeSin,4640,2347,2293,50.58
Diana,Naafiri,1144,575,569,50.26
Diana,KSante,1511,783,728,51.82
Diana,Nunu,1823,978,845,53.65
Diana,Teemo,4043,1977,2066,48.9
Diana,Kassadin,711,340,371,47.82
Diana,Ziggs,1245,564,681,45.3
Diana,RekSai,305,174,131,57.05
Diana,Talon,1902,980,922,51.52
Diana,Rell,1479,717,762,48.48
Diana,Leona,2530,1318,1212,52.09
Diana,Elise,2001,1078,923,53.87
Diana,Rengar,1025,601,424,58.63
Diana,Galio,2917,1345,1572,46.11
Diana,Lucian,1983,1054,929,53.15
Diana,Hecarim,1028,534,494,51.95
Diana,Ekko,2693,1389,1304,51.58
Diana,Zac,1447,708,739,48.93
Diana,Riven,1308,719,589,54.97
Diana,Gragas,1715,949,766,55.34
Diana,Olaf,571,300,271,52.54
Diana,Kled,518,256,262,49.42
Diana,Karma,3240,1743,1497,53.8
Diana,Velkoz,1776,800,976,45.05
Diana,Brand,2183,1008,1175,46.17
Diana,Bard,870,434,436,49.89
Diana,Heimerdinger,1447,657,790,45.4
Diana,TahmKench,2514,1333,1181,53.02
Diana,Qiyana,817,448,369,54.83
Diana,Nocturne,3567,1735,1832,48.64
Diana,Varus,2585,1312,1273,50.75
Diana,Lissandra,991,476,515,48.03
Diana,Camille,1062,549,513,51.69
Diana,Pantheon,4973,2601,2372,52.3
Diana,DrMundo,1772,855,917,48.25
Diana,Nidalee,897,517,380,57.64
Diana,Smolder,2133,1090,1043,51.1
Diana,Zoe,1184,616,568,52.03
Diana,Udyr,1168,605,563,51.8
Diana,Tryndamere,1585,773,812,48.77
Diana,Alistar,1304,695,609,53.3
Diana,Sejuani,1169,608,561,52.01
Diana,Zyra,2733,1353,1380,49.51
Diana,FiddleSticks,1539,772,767,50.16
Diana,Ornn,1291,684,607,52.98
Diana,MonkeyKing,1997,897,1100,44.92
Diana,Quinn,921,462,459,50.16
Diana,Zilean,845,441,404,52.19
Diana,Taric,693,325,368,46.9
Diana,Akshan,936,483,453,51.6
Diana,Gnar,1221,669,552,54.79
Diana,Singed,750,405,345,54
Diana,Janna,977,485,492,49.64
Diana,Taliyah,754,413,341,54.77
Diana,Corki,1058,550,508,51.98
Diana,Viktor,2423,1239,1184,51.13
Diana,Orianna,1297,755,542,58.21
Diana,TwistedFate,1086,590,496,54.33
Diana,Shyvana,803,384,419,47.82
Diana,Anivia,923,426,497,46.15
Diana,Urgot,1520,742,778,48.82
Diana,Syndra,1934,905,1029,46.79
Diana,Belveth,656,358,298,54.57
Diana,Zeri,1258,642,616,51.03
Diana,Rumble,810,421,389,51.98
Varus,Kennen,525,216,309,41.14
Varus,Warwick,2375,1066,1309,44.88
Varus,Yasuo,3246,1523,1723,46.92
Varus,Kindred,733,372,361,50.75
Varus,Lux,4196,2039,2157,48.59
Varus,Fiora,620,352,268,56.77
Varus,MasterYi,2007,981,1026,48.88
Varus,Mel,3605,1855,1750,51.46
Varus,Jhin,3559,1716,1843,48.22
Varus,Karma,1983,925,1058,46.65
Varus,Fizz,929,466,463,50.16
Varus,Gnar,799,423,376,52.94
Varus,Caitlyn,5077,2540,2537,50.03
Varus,Neeko,970,495,475,51.03
Varus,Gangplank,818,436,382,53.3
Varus,Chogath,2020,955,1065,47.28
Varus,Galio,1498,737,761,49.2
Varus,MissFortune,3890,1855,2035,47.69
Varus,Soraka,982,492,490,50.1
Varus,Kled,342,201,141,58.77
Varus,Kayn,2321,1102,1219,47.48
Varus,AurelionSol,646,345,301,53.41
Varus,Tristana,1617,767,850,47.43
Varus,Pyke,1575,856,719,54.35
Varus,Nasus,1094,518,576,47.35
Varus,FiddleSticks,760,396,364,52.11
Varus,Azir,625,341,284,54.56
Varus,Xayah,760,389,371,51.18
Varus,Nami,1713,837,876,48.86
Varus,Olaf,506,240,266,47.43
Varus,Volibear,1975,902,1073,45.67
Varus,Aurora,1275,656,619,51.45
Varus,Ashe,3875,1956,1919,50.48
Varus,Smolder,1158,588,570,50.78
Varus,Rengar,677,365,312,53.91
Varus,Hwei,1230,666,564,54.15
Varus,Thresh,2359,1144,1215,48.5
Varus,Pantheon,2838,1318,1520,46.44
Varus,Xerath,1590,691,899,43.46
Varus,Morgana,1957,949,1008,48.49
Varus,Braum,914,433,481,47.37
Varus,Skarner,527,285,242,54.08
Varus,Syndra,1120,501,619,44.73
Varus,Hecarim,759,376,383,49.54
Varus,Talon,1104,602,502,54.53
Varus,Samira,1292,661,631,51.16
Varus,Blitzcrank,1357,674,683,49.67
Varus,Garen,2738,1241,1497,45.33
Varus,Nocturne,1847,837,1010,45.32
Varus,Vladimir,961,449,512,46.72
Varus,Sylas,2501,1269,1232,50.74
Varus,Ekko,1519,709,810,46.68
Varus,Malphite,1634,773,861,47.31
Varus,Poppy,1140,602,538,52.81
Varus,Ornn,839,452,387,53.87
Varus,Ambessa,1270,618,652,48.66
Varus,Zoe,725,398,327,54.9
Varus,Swain,1736,821,915,47.29
Varus,Mordekaiser,2299,1147,1152,49.89
Varus,Amumu,1768,786,982,44.46
Varus,Yone,3172,1570,1602,49.5
Varus,Zyra,1633,861,772,52.73
Varus,Ezreal,4626,2343,2283,50.65
Varus,Seraphine,1410,707,703,50.14
Varus,MonkeyKing,1132,552,580,48.76
Varus,Rakan,773,364,409,47.09
Varus,Sett,2796,1329,1467,47.53
Varus,Lucian,1145,542,603,47.34
Varus,Veigar,1715,826,889,48.16
Varus,Zilean,550,270,280,49.09
Varus,Irelia,1348,678,670,50.3
Varus,Darius,3122,1491,1631,47.76
Varus,Shaco,1571,799,772,50.86
Varus,Ahri,2291,1154,1137,50.37
Varus,Graves,1131,545,586,48.19
Varus,Taliyah,512,233,279,45.51
Varus,Yuumi,1536,760,776,49.48
Varus,Camille,664,346,318,52.11
Varus,Briar,1224,558,666,45.59
Varus,Viktor,1407,680,727,48.33
Varus,Jinx,4824,2327,2497,48.24
Varus,Senna,1325,636,689,48
Varus,Jayce,998,476,522,47.7
Varus,Malzahar,1680,780,900,46.43
Varus,Lulu,2134,1080,1054,50.61
Varus,Annie,581,250,331,43.03
Varus,Tryndamere,882,479,403,54.31
Varus,Zac,978,477,501,48.77
Varus,Alistar,641,282,359,43.99
Varus,Leona,1484,672,812,45.28
Varus,Viego,2368,1191,1177,50.3
Varus,Orianna,869,372,497,42.81
Varus,Twitch,1432,704,728,49.16
Varus,LeeSin,2658,1330,1328,50.04
Varus,Illaoi,787,372,415,47.27
Varus,XinZhao,1134,519,615,45.77
Varus,Teemo,2145,1001,1144,46.67
Varus,Akali,1802,951,851,52.77
Varus,Vayne,2035,987,1048,48.5
Varus,Nautilus,1838,922,916,50.16
Varus,Aatrox,1671,853,818,51.05
Varus,Rumble,520,279,241,53.65
Varus,TahmKench,1473,730,743,49.56
Varus,Kaisa,2780,1335,1445,48.02
Varus,Ziggs,690,283,407,41.01
Varus,Jax,1590,753,837,47.36
Varus,Diana,2585,1273,1312,49.25
Varus,Heimerdinger,703,307,396,43.67
Varus,Milio,969,479,490,49.43
Varus,Urgot,774,361,413,46.64
Varus,Shen,1103,554,549,50.23
Varus,KogMaw,587,251,336,42.76
Varus,Lillia,995,501,494,50.35
Varus,Khazix,984,482,502,48.98
Varus,Sion,1346,610,736,45.32
Varus,Sejuani,736,290,446,39.4
Varus,KSante,974,482,492,49.49
Varus,Gwen,931,447,484,48.01
Varus,Gragas,1053,509,544,48.34
Varus,Sona,554,279,275,50.36
Varus,Ivern,280,125,155,44.64
Varus,Kassadin,399,187,212,46.87
Varus,Evelynn,620,309,311,49.84
Varus,Draven,931,469,462,50.38
Varus,Zed,1835,924,911,50.35
Varus,Singed,494,220,274,44.53
Varus,Renata,289,132,157,45.67
Varus,Trundle,864,408,456,47.22
Varus,Shyvana,438,187,251,42.69
Varus,Taric,385,211,174,54.81
Varus,Corki,690,397,293,57.54
Varus,Anivia,522,236,286,45.21
Varus,Sivir,1016,524,492,51.57
Varus,Vi,1647,793,854,48.15
Varus,Rammus,533,295,238,55.35
Varus,Janna,555,234,321,42.16
Varus,Karthus,509,211,298,41.45
Varus,DrMundo,977,473,504,48.41
Varus,Nunu,1164,562,602,48.28
Varus,Leblanc,1049,555,494,52.91
Varus,Katarina,1440,771,669,53.54
Varus,Akshan,571,303,268,53.06
Varus,Brand,1118,546,572,48.84
Varus,Quinn,635,301,334,47.4
Varus,Qiyana,489,276,213,56.44
Varus,Nilah,576,252,324,43.75
Varus,Vex,932,459,473,49.25
Varus,TwistedFate,623,316,307,50.72
Varus,JarvanIV,1021,491,530,48.09
Varus,Riven,725,346,379,47.72
Varus,Velkoz,1033,503,530,48.69
Varus,Rell,845,389,456,46.04
Varus,Cassiopeia,524,251,273,47.9
Varus,Nidalee,538,309,229,57.43
Varus,Aphelios,1026,515,511,50.19
Varus,Elise,1287,648,639,50.35
Varus,Ryze,651,316,335,48.54
Varus,Zeri,857,449,408,52.39
Varus,Bard,511,253,258,49.51
Varus,Lissandra,519,232,287,44.7
Varus,Yorick,1680,773,907,46.01
Varus,Naafiri,579,320,259,55.27
Varus,Udyr,659,353,306,53.57
Varus,Belveth,452,196,256,43.36
Varus,Maokai,855,413,442,48.3
Varus,Kalista,624,335,289,53.69
Varus,Kayle,1157,528,629,45.64
Varus,Renekton,845,452,393,53.49
Varus,RekSai,210,123,87,58.57
Kindred,Aatrox,882,417,465,47.28
Kindred,Sylas,1120,561,559,50.09
Kindred,Diana,1441,669,772,46.43
Kindred,Varus,733,361,372,49.25
Kindred,Blitzcrank,713,380,333,53.3
Kindred,Fiora,401,241,160,60.1
Kindred,Belveth,235,124,111,52.77
Kindred,Ezreal,1991,1026,965,51.53
Kindred,Yuumi,785,352,433,44.84
Kindred,Volibear,1004,487,517,48.51
Kindred,Ekko,891,477,414,53.54
Kindred,Yone,1730,898,832,51.91
Kindred,Kalista,319,142,177,44.51
Kindred,Pyke,994,473,521,47.59
Kindred,Warwick,1399,649,750,46.39
Kindred,Singed,232,104,128,44.83
Kindred,Ryze,294,125,169,42.52
Kindred,Samira,724,295,429,40.75
Kindred,Soraka,545,231,314,42.39
Kindred,Mordekaiser,1239,537,702,43.34
Kindred,Briar,779,298,481,38.25
Kindred,Zed,919,475,444,51.69
Kindred,Jinx,2572,1245,1327,48.41
Kindred,Lillia,615,314,301,51.06
Kindred,Yasuo,1748,808,940,46.22
Kindred,FiddleSticks,488,269,219,55.12
Kindred,Mel,1768,925,843,52.32
Kindred,Amumu,1047,416,631,39.73
Kindred,Thresh,1235,576,659,46.64
Kindred,Gnar,383,188,195,49.09
Kindred,Malzahar,952,398,554,41.81
Kindred,Tristana,845,443,402,52.43
Kindred,Brand,671,303,368,45.16
Kindred,Quinn,308,159,149,51.62
Kindred,Talon,569,279,290,49.03
Kindred,Syndra,491,219,272,44.6
Kindred,Caitlyn,2366,1077,1289,45.52
Kindred,Sett,1563,676,887,43.25
Kindred,MasterYi,990,455,535,45.96
Kindred,AurelionSol,354,184,170,51.98
Kindred,Seraphine,781,359,422,45.97
Kindred,Nasus,732,272,460,37.16
Kindred,Nocturne,1094,532,562,48.63
Kindred,Aurora,785,387,398,49.3
Kindred,Nunu,608,267,341,43.91
Kindred,TwistedFate,333,133,200,39.94
Kindred,Teemo,1213,520,693,42.87
Kindred,Malphite,904,403,501,44.58
Kindred,Vladimir,604,295,309,48.84
Kindred,Ziggs,385,191,194,49.61
Kindred,Urgot,475,259,216,54.53
Kindred,Xerath,721,315,406,43.69
Kindred,Pantheon,1552,701,851,45.17
Kindred,TahmKench,797,372,425,46.68
Kindred,Qiyana,260,153,107,58.85
Kindred,Ashe,1749,824,925,47.11
Kindred,Garen,1571,735,836,46.79
Kindred,Maokai,447,218,229,48.77
Kindred,Sion,700,298,402,42.57
Kindred,Akali,963,434,529,45.07
Kindred,Lux,2450,1170,1280,47.76
Kindred,Riven,407,189,218,46.44
Kindred,Shaco,986,471,515,47.77
Kindred,Jhin,1783,812,971,45.54
Kindred,Senna,796,379,417,47.61
Kindred,Milio,498,226,272,45.38
Kindred,Naafiri,357,186,171,52.1
Kindred,Orianna,422,219,203,51.9
Kindred,Zilean,301,125,176,41.53
Kindred,Vex,564,270,294,47.87
Kindred,Illaoi,404,216,188,53.47
Kindred,MonkeyKing,600,305,295,50.83
Kindred,Twitch,733,341,392,46.52
Kindred,Nautilus,1001,504,497,50.35
Kindred,Galio,833,422,411,50.66
Kindred,Sona,359,172,187,47.91
Kindred,Hecarim,410,179,231,43.66
Kindred,Zyra,810,356,454,43.95
Kindred,Trundle,558,263,295,47.13
Kindred,Katarina,670,372,298,55.52
Kindred,Rengar,332,215,117,64.76
Kindred,Ivern,173,81,92,46.82
Kindred,Viego,1232,540,692,43.83
Kindred,Ahri,1275,628,647,49.25
Kindred,Camille,331,155,176,46.83
Kindred,Viktor,720,351,369,48.75
Kindred,Kayn,1500,722,778,48.13
Kindred,Zac,405,202,203,49.88
Kindred,Rell,438,206,232,47.03
Kindred,Rammus,282,146,136,51.77
Kindred,Draven,561,253,308,45.1
Kindred,Lulu,1099,578,521,52.59
Kindred,Leona,715,313,402,43.78
Kindred,Nilah,416,203,213,48.8
Kindred,Bard,307,182,125,59.28
Kindred,Taric,132,46,86,34.85
Kindred,Hwei,636,257,379,40.41
Kindred,Rakan,385,184,201,47.79
Kindred,Veigar,1076,503,573,46.75
Kindred,Skarner,251,119,132,47.41
Kindred,Kennen,267,119,148,44.57
Kindred,LeeSin,1272,628,644,49.37
Kindred,Cassiopeia,282,110,172,39.01
Kindred,Alistar,342,133,209,38.89
Kindred,Kaisa,1572,736,836,46.82
Kindred,Zeri,390,218,172,55.9
Kindred,Jayce,447,235,212,52.57
Kindred,Irelia,802,387,415,48.25
Kindred,Vayne,1072,515,557,48.04
Kindred,Aphelios,625,323,302,51.68
Kindred,Sejuani,361,134,227,37.12
Kindred,MissFortune,2063,1010,1053,48.96
Kindred,Braum,448,180,268,40.18
Kindred,Darius,1800,804,996,44.67
Kindred,Velkoz,530,234,296,44.15
Kindred,Udyr,382,200,182,52.36
Kindred,Nami,1009,505,504,50.05
Kindred,JarvanIV,471,203,268,43.1
Kindred,Poppy,587,293,294,49.91
Kindred,Azir,349,166,183,47.56
Kindred,Lucian,551,260,291,47.19
Kindred,Elise,637,335,302,52.59
Kindred,Olaf,255,122,133,47.84
Kindred,Xayah,409,187,222,45.72
Kindred,Karma,898,406,492,45.21
Kindred,Gragas,598,367,231,61.37
Kindred,Renekton,383,189,194,49.35
Kindred,Tryndamere,560,258,302,46.07
Kindred,Swain,1005,491,514,48.86
Kindred,Annie,262,136,126,51.91
Kindred,Morgana,1191,610,581,51.22
Kindred,Akshan,284,158,126,55.63
Kindred,XinZhao,551,247,304,44.83
Kindred,Kassadin,182,98,84,53.85
Kindred,KogMaw,241,94,147,39
Kindred,Janna,306,111,195,36.27
Kindred,Chogath,1022,453,569,44.32
Kindred,Jax,807,398,409,49.32
Kindred,Evelynn,358,172,186,48.04
Kindred,Zoe,327,181,146,55.35
Kindred,Vi,830,383,447,46.14
Kindred,Leblanc,506,242,264,47.83
Kindred,Gangplank,376,197,179,52.39
Kindred,Neeko,519,244,275,47.01
Kindred,Smolder,585,289,296,49.4
Kindred,Heimerdinger,440,211,229,47.95
Kindred,Fizz,508,265,243,52.17
Kindred,Gwen,525,244,281,46.48
Kindred,Taliyah,255,91,164,35.69
Kindred,Corki,394,213,181,54.06
Kindred,Yorick,889,425,464,47.81
Kindred,Nidalee,282,151,131,53.55
Kindred,DrMundo,498,227,271,45.58
Kindred,Renata,206,136,70,66.02
Kindred,Ornn,441,191,250,43.31
Kindred,Kayle,700,278,422,39.71
Kindred,Sivir,523,263,260,50.29
Kindred,Shen,619,274,345,44.26
Kindred,Ambessa,492,208,284,42.28
Kindred,Karthus,287,123,164,42.86
Kindred,Anivia,290,168,122,57.93
Kindred,Graves,597,287,310,48.07
Kindred,Khazix,500,255,245,51
Kindred,Rumble,250,124,126,49.6
Kindred,KSante,462,276,186,59.74
Kindred,RekSai,104,56,48,53.85
Kindred,Lissandra,245,133,112,54.29
Kindred,Shyvana,231,106,125,45.89
Kindred,Kled,211,89,122,42.18
Illaoi,Vladimir,501,253,248,50.5
Illaoi,Darius,1886,1076,810,57.05
Illaoi,Lux,2537,1238,1299,48.8
Illaoi,KogMaw,273,136,137,49.82
Illaoi,Yuumi,778,402,376,51.67
Illaoi,Mordekaiser,1712,774,938,45.21
Illaoi,Warwick,1561,709,852,45.42
Illaoi,Veigar,1068,505,563,47.28
Illaoi,Ashe,1953,981,972,50.23
Illaoi,Nami,860,379,481,44.07
Illaoi,Kayle,713,312,401,43.76
Illaoi,Sylas,1194,703,491,58.88
Illaoi,Qiyana,260,130,130,50
Illaoi,Caitlyn,2563,1317,1246,51.39
Illaoi,Renata,190,98,92,51.58
Illaoi,Mel,1850,985,865,53.24
Illaoi,Nautilus,1058,540,518,51.04
Illaoi,Viego,1168,569,599,48.72
Illaoi,Irelia,862,478,384,55.45
Illaoi,Jinx,2445,1209,1236,49.45
Illaoi,Thresh,1196,608,588,50.84
Illaoi,Volibear,1321,666,655,50.42
Illaoi,Evelynn,336,175,161,52.08
Illaoi,Katarina,703,374,329,53.2
Illaoi,Nocturne,1070,542,528,50.65
Illaoi,Neeko,544,306,238,56.25
Illaoi,Gwen,583,320,263,54.89
Illaoi,Karthus,231,120,111,51.95
Illaoi,Yone,1919,1050,869,54.72
Illaoi,Nilah,365,178,187,48.77
Illaoi,Braum,484,243,241,50.21
Illaoi,Shaco,940,454,486,48.3
Illaoi,Azir,334,200,134,59.88
Illaoi,Samira,866,469,397,54.16
Illaoi,Kayn,1510,843,667,55.83
Illaoi,Lucian,641,283,358,44.15
Illaoi,Sett,1737,889,848,51.18
Illaoi,RekSai,93,48,45,51.61
Illaoi,Hwei,608,314,294,51.64
Illaoi,Ekko,842,430,412,51.07
Illaoi,Yasuo,1973,1027,946,52.05
Illaoi,Ahri,1254,668,586,53.27
Illaoi,Karma,776,348,428,44.85
Illaoi,Skarner,293,172,121,58.7
Illaoi,Syndra,499,277,222,55.51
Illaoi,Jhin,1736,932,804,53.69
Illaoi,Sion,653,329,324,50.38
Illaoi,Pantheon,1512,770,742,50.93
Illaoi,Ziggs,369,203,166,55.01
Illaoi,Lulu,918,443,475,48.26
Illaoi,Viktor,690,339,351,49.13
Illaoi,Briar,781,361,420,46.22
Illaoi,Teemo,1081,465,616,43.02
Illaoi,Blitzcrank,788,444,344,56.35
Illaoi,Diana,1519,798,721,52.53
Illaoi,Poppy,558,276,282,49.46
Illaoi,Heimerdinger,505,203,302,40.2
Illaoi,Kalista,294,157,137,53.4
Illaoi,Swain,930,479,451,51.51
Illaoi,AurelionSol,385,183,202,47.53
Illaoi,Xayah,494,229,265,46.36
Illaoi,Rakan,450,241,209,53.56
Illaoi,Jax,1000,568,432,56.8
Illaoi,MissFortune,2474,1250,1224,50.53
Illaoi,Morgana,1306,611,695,46.78
Illaoi,Kindred,404,188,216,46.53
Illaoi,Ryze,304,129,175,42.43
Illaoi,Orianna,433,215,218,49.65
Illaoi,Shen,666,352,314,52.85
Illaoi,Aatrox,820,422,398,51.46
Illaoi,Khazix,480,246,234,51.25
Illaoi,Vex,490,199,291,40.61
Illaoi,Vayne,1153,580,573,50.3
Illaoi,Malzahar,880,410,470,46.59
Illaoi,Camille,333,171,162,51.35
Illaoi,Rammus,334,191,143,57.19
Illaoi,Alistar,399,240,159,60.15
Illaoi,TwistedFate,362,183,179,50.55
Illaoi,Fiora,333,155,178,46.55
Illaoi,LeeSin,1168,628,540,53.77
Illaoi,Kassadin,168,53,115,31.55
Illaoi,Milio,513,285,228,55.56
Illaoi,Malphite,923,464,459,50.27
Illaoi,Sona,316,159,157,50.32
Illaoi,Rengar,280,176,104,62.86
Illaoi,TahmKench,977,547,430,55.99
Illaoi,Garen,1614,726,888,44.98
Illaoi,Lillia,516,265,251,51.36
Illaoi,Smolder,624,305,319,48.88
Illaoi,Tristana,960,449,511,46.77
Illaoi,Zyra,801,370,431,46.19
Illaoi,Gangplank,348,192,156,55.17
Illaoi,Varus,787,415,372,52.73
Illaoi,Pyke,880,464,416,52.73
Illaoi,Chogath,1316,680,636,51.67
Illaoi,Hecarim,311,189,122,60.77
Illaoi,MonkeyKing,574,321,253,55.92
Illaoi,Ezreal,1839,949,890,51.6
Illaoi,Brand,742,364,378,49.06
Illaoi,Nunu,694,361,333,52.02
Illaoi,Aurora,738,360,378,48.78
Illaoi,Leona,791,397,394,50.19
Illaoi,Xerath,821,403,418,49.09
Illaoi,Ornn,397,188,209,47.36
Illaoi,Twitch,686,349,337,50.87
Illaoi,Amumu,1054,481,573,45.64
Illaoi,Kaisa,1443,721,722,49.97
Illaoi,Jayce,376,163,213,43.35
Illaoi,Zeri,320,159,161,49.69
Illaoi,FiddleSticks,510,254,256,49.8
Illaoi,Aphelios,504,248,256,49.21
Illaoi,Draven,426,240,186,56.34
Illaoi,Ambessa,538,312,226,57.99
Illaoi,Talon,419,254,165,60.62
Illaoi,Nidalee,268,152,116,56.72
Illaoi,Zed,1013,469,544,46.3
Illaoi,Yorick,1055,448,607,42.46
Illaoi,Gnar,336,183,153,54.46
Illaoi,Vi,909,451,458,49.61
Illaoi,Zoe,316,159,157,50.32
Illaoi,Sejuani,345,158,187,45.8
Illaoi,Leblanc,457,234,223,51.2
Illaoi,Seraphine,788,408,380,51.78
Illaoi,Riven,414,247,167,59.66
Illaoi,Trundle,663,331,332,49.92
Illaoi,Cassiopeia,220,124,96,56.36
Illaoi,XinZhao,536,229,307,42.72
Illaoi,Taric,204,93,111,45.59
Illaoi,Ivern,123,65,58,52.85
Illaoi,Velkoz,522,198,324,37.93
Illaoi,Lissandra,326,176,150,53.99
Illaoi,Galio,785,425,360,54.14
Illaoi,Corki,352,174,178,49.43
Illaoi,Singed,255,118,137,46.27
Illaoi,Soraka,568,286,282,50.35
Illaoi,Annie,264,124,140,46.97
Illaoi,MasterYi,1168,593,575,50.77
Illaoi,Renekton,562,334,228,59.43
Illaoi,KSante,375,216,159,57.6
Illaoi,Fizz,492,286,206,58.13
Illaoi,Kennen,182,95,87,52.2
Illaoi,Udyr,342,170,172,49.71
Illaoi,Zilean,256,125,131,48.83
Illaoi,Taliyah,236,123,113,52.12
Illaoi,Akshan,324,118,206,36.42
Illaoi,Rell,429,243,186,56.64
Illaoi,Naafiri,360,149,211,41.39
Illaoi,Nasus,824,390,434,47.33
Illaoi,Elise,628,306,322,48.73
Illaoi,Sivir,529,269,260,50.85
Illaoi,Akali,1048,531,517,50.67
Illaoi,Zac,395,170,225,43.04
Illaoi,Gragas,566,316,250,55.83
Illaoi,Bard,277,156,121,56.32
Illaoi,JarvanIV,462,217,245,46.97
Illaoi,Kled,155,72,83,46.45
Illaoi,Rumble,246,123,123,50
Illaoi,Olaf,271,148,123,54.61
Illaoi,Graves,446,195,251,43.72
Illaoi,Urgot,428,214,214,50
Illaoi,Maokai,457,240,217,52.52
Illaoi,Anivia,265,92,173,34.72
Illaoi,Senna,710,336,374,47.32
Illaoi,DrMundo,652,302,350,46.32
Illaoi,Shyvana,266,172,94,64.66
Illaoi,Quinn,266,121,145,45.49
Illaoi,Tryndamere,557,281,276,50.45
Illaoi,Belveth,252,135,117,53.57
Illaoi,Janna,262,109,153,41.6
Milio,Vladimir,807,451,356,55.89
Milio,Darius,2182,1120,1062,51.33
Milio,Lux,2907,1610,1297,55.38
Milio,KogMaw,432,223,209,51.62
Milio,Yuumi,1047,534,513,51
Milio,Yorick,1145,578,567,50.48
Milio,Kayn,1717,1006,711,58.59
Milio,Ryze,336,149,187,44.35
Milio,Pantheon,1850,946,904,51.14
Milio,Teemo,1305,642,663,49.2
Milio,Warwick,1765,896,869,50.76
Milio,Azir,404,186,218,46.04
Milio,MissFortune,2326,1228,1098,52.79
Milio,Neeko,540,275,265,50.93
Milio,Akali,1122,556,566,49.55
Milio,Kassadin,284,134,150,47.18
Milio,Sona,469,236,233,50.32
Milio,Braum,632,315,317,49.84
Milio,XinZhao,586,316,270,53.92
Milio,Chogath,1340,680,660,50.75
Milio,Taliyah,335,156,179,46.57
Milio,Mordekaiser,1459,705,754,48.32
Milio,Briar,806,402,404,49.88
Milio,Zed,1306,738,568,56.51
Milio,Jinx,2835,1376,1459,48.54
Milio,Lulu,1986,1040,946,52.37
Milio,Jax,1069,563,506,52.67
Milio,Talon,692,396,296,57.23
Milio,Leblanc,527,273,254,51.8
Milio,Mel,2477,1432,1045,57.81
Milio,Jhin,2264,1182,1082,52.21
Milio,Velkoz,617,293,324,47.49
Milio,Olaf,324,163,161,50.31
Milio,LeeSin,1383,733,650,53
Milio,Diana,1600,841,759,52.56
Milio,Seraphine,981,570,411,58.1
Milio,Karma,1433,757,676,52.83
Milio,Tryndamere,709,374,335,52.75
Milio,Graves,700,363,337,51.86
Milio,Sylas,1242,631,611,50.81
Milio,Leona,935,456,479,48.77
Milio,DrMundo,638,342,296,53.61
Milio,Shaco,1087,588,499,54.09
Milio,Xayah,545,299,246,54.86
Milio,Morgana,1438,750,688,52.16
Milio,Ashe,2325,1284,1041,55.23
Milio,Renekton,494,270,224,54.66
Milio,Khazix,609,313,296,51.4
Milio,Malzahar,1194,612,582,51.26
Milio,Quinn,481,247,234,51.35
Milio,Vayne,1315,637,678,48.44
Milio,Shyvana,269,145,124,53.9
Milio,Soraka,819,409,410,49.94
Milio,Fiora,485,257,228,52.99
Milio,Elise,848,467,381,55.07
Milio,Garen,1790,879,911,49.11
Milio,Senna,992,503,489,50.71
Milio,Maokai,515,264,251,51.26
Milio,Corki,521,292,229,56.05
Milio,Taric,257,109,148,42.41
Milio,Camille,460,232,228,50.43
Milio,Hecarim,533,277,256,51.97
Milio,TwistedFate,432,273,159,63.19
Milio,Ezreal,2403,1320,1083,54.93
Milio,Nautilus,1326,784,542,59.13
Milio,Kaisa,1673,911,762,54.45
Milio,Qiyana,389,196,193,50.39
Milio,Swain,1047,512,535,48.9
Milio,Ziggs,429,226,203,52.68
Milio,Nasus,697,344,353,49.35
Milio,Xerath,933,492,441,52.73
Milio,Caitlyn,3118,1623,1495,52.05
Milio,Irelia,948,546,402,57.59
Milio,Amumu,1280,594,686,46.41
Milio,Poppy,642,359,283,55.92
Milio,Veigar,1108,527,581,47.56
Milio,Gnar,522,326,196,62.45
Milio,Lucian,744,399,345,53.63
Milio,Nami,1586,840,746,52.96
Milio,Aatrox,1122,634,488,56.51
Milio,FiddleSticks,608,317,291,52.14
Milio,Kindred,498,272,226,54.62
Milio,Aphelios,770,406,364,52.73
Milio,Rengar,497,255,242,51.31
Milio,Sion,974,487,487,50
Milio,Orianna,578,288,290,49.83
Milio,Illaoi,513,228,285,44.44
Milio,Vi,1065,563,502,52.86
Milio,Yasuo,2148,1155,993,53.77
Milio,Rell,586,303,283,51.71
Milio,Sivir,552,303,249,54.89
Milio,Aurora,985,503,482,51.07
Milio,Sett,1507,776,731,51.49
Milio,Gragas,689,350,339,50.8
Milio,Viego,1470,785,685,53.4
Milio,Draven,607,353,254,58.15
Milio,Blitzcrank,788,400,388,50.76
Milio,Ahri,1512,823,689,54.43
Milio,Katarina,1083,610,473,56.33
Milio,Evelynn,486,276,210,56.79
Milio,Akshan,407,231,176,56.76
Milio,Smolder,831,444,387,53.43
Milio,MasterYi,1255,643,612,51.24
Milio,Tristana,1061,602,459,56.74
Milio,Thresh,1634,822,812,50.31
Milio,MonkeyKing,755,427,328,56.56
Milio,Urgot,557,290,267,52.06
Milio,Zac,483,241,242,49.9
Milio,Volibear,1249,694,555,55.56
Milio,Kennen,340,190,150,55.88
Milio,Rammus,334,179,155,53.59
Milio,Zeri,502,217,285,43.23
Milio,Pyke,907,472,435,52.04
Milio,Viktor,1049,539,510,51.38
Milio,Riven,605,312,293,51.57
Milio,Syndra,791,384,407,48.55
Milio,Kled,190,85,105,44.74
Milio,Lillia,697,364,333,52.22
Milio,Ekko,1084,595,489,54.89
Milio,Anivia,362,181,181,50
Milio,Samira,879,482,397,54.84
Milio,Ornn,547,236,311,43.14
Milio,Lissandra,384,189,195,49.22
Milio,Varus,969,490,479,50.57
Milio,TahmKench,928,516,412,55.6
Milio,Nunu,649,316,333,48.69
Milio,Heimerdinger,424,205,219,48.35
Milio,Trundle,617,303,314,49.11
Milio,Gangplank,623,360,263,57.78
Milio,Alistar,469,239,230,50.96
Milio,Hwei,826,402,424,48.67
Milio,JarvanIV,683,366,317,53.59
Milio,KSante,519,287,232,55.3
Milio,Gwen,654,335,319,51.22
Milio,Yone,1832,980,852,53.49
Milio,Janna,498,235,263,47.19
Milio,Sejuani,548,302,246,55.11
Milio,Brand,676,390,286,57.69
Milio,Renata,279,135,144,48.39
Milio,Vex,555,322,233,58.02
Milio,Udyr,487,251,236,51.54
Milio,Kalista,367,189,178,51.5
Milio,Fizz,674,386,288,57.27
Milio,AurelionSol,418,215,203,51.44
Milio,Galio,823,414,409,50.3
Milio,Naafiri,409,177,232,43.28
Milio,Ivern,262,158,104,60.31
Milio,Nilah,360,199,161,55.28
Milio,Kayle,837,406,431,48.51
Milio,Ambessa,727,403,324,55.43
Milio,Malphite,1104,559,545,50.63
Milio,Bard,401,226,175,56.36
Milio,Zyra,939,466,473,49.63
Milio,Twitch,1080,551,529,51.02
Milio,Shen,672,332,340,49.4
Milio,Zoe,456,231,225,50.66
Milio,Singed,389,181,208,46.53
Milio,Rakan,473,256,217,54.12
Milio,Jayce,473,288,185,60.89
Milio,Rumble,293,157,136,53.58
Milio,Zilean,365,196,169,53.7
Milio,Cassiopeia,273,142,131,52.01
Milio,Nocturne,1128,580,548,51.42
Milio,Belveth,299,129,170,43.14
Milio,Skarner,344,192,152,55.81
Milio,Karthus,324,190,134,58.64
Milio,RekSai,174,79,95,45.4
Milio,Annie,338,211,127,62.43
Milio,Nidalee,308,174,134,56.49
KogMaw,Illaoi,273,137,136,50.18
KogMaw,Warwick,1007,531,476,52.73
KogMaw,Diana,904,439,465,48.56
KogMaw,Tristana,552,288,264,52.17
KogMaw,Milio,432,209,223,48.38
KogMaw,Sion,547,300,247,54.84
KogMaw,Akshan,268,150,118,55.97
KogMaw,Jinx,1885,1018,867,54.01
KogMaw,Bard,205,109,96,53.17
KogMaw,Jax,628,306,322,48.73
KogMaw,Graves,355,155,200,43.66
KogMaw,Katarina,516,312,204,60.47
KogMaw,Twitch,689,335,354,48.62
KogMaw,Seraphine,532,267,265,50.19
KogMaw,Kennen,208,99,109,47.6
KogMaw,Skarner,206,120,86,58.25
KogMaw,Malzahar,628,332,296,52.87
KogMaw,Yuumi,527,272,255,51.61
KogMaw,Swain,660,349,311,52.88
KogMaw,Morgana,828,433,395,52.29
KogMaw,Caitlyn,1667,818,849,49.07
KogMaw,Tryndamere,362,178,184,49.17
KogMaw,Vayne,819,453,366,55.31
KogMaw,Draven,319,135,184,42.32
KogMaw,Mel,1222,634,588,51.88
KogMaw,Volibear,829,425,404,51.27
KogMaw,MasterYi,579,321,258,55.44
KogMaw,Hwei,390,228,162,58.46
KogMaw,Samira,493,242,251,49.09
KogMaw,Shyvana,169,81,88,47.93
KogMaw,Fizz,364,172,192,47.25
KogMaw,Yasuo,1140,599,541,52.54
KogMaw,Taric,149,72,77,48.32
KogMaw,Gnar,212,98,114,46.23
KogMaw,Vi,625,308,317,49.28
KogMaw,Kaisa,923,540,383,58.5
KogMaw,Nautilus,688,401,287,58.28
KogMaw,Yone,1131,600,531,53.05
KogMaw,Viego,828,454,374,54.83
KogMaw,Ezreal,1273,672,601,52.79
KogMaw,Blitzcrank,431,238,193,55.22
KogMaw,Mordekaiser,881,406,475,46.08
KogMaw,Talon,318,163,155,51.26
KogMaw,Quinn,243,130,113,53.5
KogMaw,Briar,514,220,294,42.8
KogMaw,Chogath,829,422,407,50.9
KogMaw,Sylas,703,347,356,49.36
KogMaw,Smolder,413,217,196,52.54
KogMaw,Neeko,349,205,144,58.74
KogMaw,Teemo,827,412,415,49.82
KogMaw,Kayn,906,449,457,49.56
KogMaw,Renata,138,88,50,63.77
KogMaw,Darius,1143,588,555,51.44
KogMaw,LeeSin,669,375,294,56.05
KogMaw,Irelia,521,307,214,58.93
KogMaw,Karma,644,298,346,46.27
KogMaw,Vladimir,439,201,238,45.79
KogMaw,Khazix,289,158,131,54.67
KogMaw,Kayle,443,231,212,52.14
KogMaw,MissFortune,1412,748,664,52.97
KogMaw,Soraka,391,192,199,49.1
KogMaw,Zoe,293,168,125,57.34
KogMaw,Garen,1008,535,473,53.08
KogMaw,Ahri,796,432,364,54.27
KogMaw,Jhin,1240,636,604,51.29
KogMaw,Rakan,251,104,147,41.43
KogMaw,Varus,587,336,251,57.24
KogMaw,Nasus,488,235,253,48.16
KogMaw,Zyra,486,266,220,54.73
KogMaw,Aatrox,541,348,193,64.33
KogMaw,Rengar,162,110,52,67.9
KogMaw,Lux,1576,829,747,52.6
KogMaw,Kindred,241,147,94,61
KogMaw,Veigar,636,335,301,52.67
KogMaw,Ekko,526,239,287,45.44
KogMaw,Yorick,623,272,351,43.66
KogMaw,Lillia,387,207,180,53.49
KogMaw,KSante,302,183,119,60.6
KogMaw,Zac,257,128,129,49.81
KogMaw,Galio,544,244,300,44.85
KogMaw,Sona,300,169,131,56.33
KogMaw,Nunu,327,191,136,58.41
KogMaw,Shaco,476,248,228,52.1
KogMaw,Taliyah,176,97,79,55.11
KogMaw,Xayah,302,144,158,47.68
KogMaw,Lulu,785,405,380,51.59
KogMaw,Zed,559,315,244,56.35
KogMaw,Hecarim,313,164,149,52.4
KogMaw,Sejuani,324,169,155,52.16
KogMaw,Ambessa,438,235,203,53.65
KogMaw,TahmKench,601,265,336,44.09
KogMaw,Urgot,307,136,171,44.3
KogMaw,Vex,317,149,168,47
KogMaw,FiddleSticks,399,194,205,48.62
KogMaw,Evelynn,264,123,141,46.59
KogMaw,Ivern,124,84,40,67.74
KogMaw,Aurora,484,249,235,51.45
KogMaw,Camille,201,96,105,47.76
KogMaw,Renekton,289,163,126,56.4
KogMaw,Kalista,165,84,81,50.91
KogMaw,Sivir,349,201,148,57.59
KogMaw,Nami,638,304,334,47.65
KogMaw,Sett,994,539,455,54.23
KogMaw,Pantheon,934,491,443,52.57
KogMaw,Amumu,699,354,345,50.64
KogMaw,Brand,451,202,249,44.79
KogMaw,Qiyana,145,66,79,45.52
KogMaw,Aphelios,277,140,137,50.54
KogMaw,Anivia,222,124,98,55.86
KogMaw,Jayce,257,133,124,51.75
KogMaw,Alistar,241,133,108,55.19
KogMaw,Annie,197,86,111,43.65
KogMaw,Malphite,571,275,296,48.16
KogMaw,Gangplank,289,150,139,51.9
KogMaw,Thresh,854,441,413,51.64
KogMaw,Riven,291,146,145,50.17
KogMaw,AurelionSol,285,123,162,43.16
KogMaw,Corki,255,157,98,61.57
KogMaw,Fiora,291,153,138,52.58
KogMaw,Syndra,428,205,223,47.9
KogMaw,Nilah,162,69,93,42.59
KogMaw,Leblanc,357,202,155,56.58
KogMaw,Gwen,379,192,187,50.66
KogMaw,Ornn,234,117,117,50
KogMaw,Lucian,391,208,183,53.2
KogMaw,Shen,434,249,185,57.37
KogMaw,Senna,536,274,262,51.12
KogMaw,Ashe,1212,645,567,53.22
KogMaw,Rammus,218,112,106,51.38
KogMaw,Xerath,448,218,230,48.66
KogMaw,Ryze,226,118,108,52.21
KogMaw,DrMundo,382,200,182,52.36
KogMaw,Orianna,330,161,169,48.79
KogMaw,Viktor,522,260,262,49.81
KogMaw,Poppy,388,224,164,57.73
KogMaw,Nocturne,631,297,334,47.07
KogMaw,Pyke,511,260,251,50.88
KogMaw,Leona,490,247,243,50.41
KogMaw,Gragas,354,179,175,50.56
KogMaw,Akali,546,317,229,58.06
KogMaw,MonkeyKing,323,174,149,53.87
KogMaw,Braum,401,257,144,64.09
KogMaw,TwistedFate,195,107,88,54.87
KogMaw,Ziggs,242,122,120,50.41
KogMaw,Janna,189,86,103,45.5
KogMaw,Azir,171,96,75,56.14
KogMaw,Trundle,341,171,170,50.15
KogMaw,Maokai,316,193,123,61.08
KogMaw,XinZhao,380,214,166,56.32
KogMaw,Singed,114,76,38,66.67
KogMaw,Karthus,179,101,78,56.42
KogMaw,Zilean,204,114,90,55.88
KogMaw,JarvanIV,352,206,146,58.52
KogMaw,Belveth,123,79,44,64.23
KogMaw,Rell,328,186,142,56.71
KogMaw,Kassadin,137,73,64,53.28
KogMaw,Elise,417,203,214,48.68
KogMaw,Kled,152,77,75,50.66
KogMaw,Rumble,175,116,59,66.29
KogMaw,Udyr,273,169,104,61.9
KogMaw,Lissandra,187,92,95,49.2
KogMaw,Cassiopeia,200,103,97,51.5
KogMaw,Naafiri,224,110,114,49.11
KogMaw,Zeri,247,118,129,47.77
KogMaw,Olaf,111,65,46,58.56
KogMaw,Heimerdinger,301,172,129,57.14
KogMaw,Nidalee,163,94,69,57.67
KogMaw,Velkoz,401,208,193,51.87
KogMaw,RekSai,60,35,25,58.33
MasterYi,Maokai,937,450,487,48.03
MasterYi,Graves,1268,619,649,48.82
MasterYi,Ahri,2852,1438,1414,50.42
MasterYi,Nilah,917,459,458,50.05
MasterYi,Malphite,2185,1128,1057,51.62
MasterYi,Yorick,2431,1072,1359,44.1
MasterYi,FiddleSticks,1119,555,564,49.6
MasterYi,Draven,1068,550,518,51.5
MasterYi,Smolder,1556,890,666,57.2
MasterYi,Nautilus,2686,1295,1391,48.21
MasterYi,Kayn,3888,2115,1773,54.4
MasterYi,Zed,2440,1312,1128,53.77
MasterYi,Sona,756,336,420,44.44
MasterYi,Kaisa,3293,1769,1524,53.72
MasterYi,Amumu,2592,1247,1345,48.11
MasterYi,Nasus,1880,890,990,47.34
MasterYi,Shaco,2172,1122,1050,51.66
MasterYi,Varus,2007,1026,981,51.12
MasterYi,Neeko,1384,692,692,50
MasterYi,Ryze,629,332,297,52.78
MasterYi,Warwick,3986,1867,2119,46.84
MasterYi,Morgana,2917,1519,1398,52.07
MasterYi,Xayah,1240,582,658,46.94
MasterYi,Veigar,2484,1193,1291,48.03
MasterYi,Sett,3637,1724,1913,47.4
MasterYi,Caitlyn,6104,3064,3040,50.2
MasterYi,Lulu,2342,1200,1142,51.24
MasterYi,KSante,954,494,460,51.78
MasterYi,Udyr,925,454,471,49.08
MasterYi,Ashe,4537,2403,2134,52.96
MasterYi,Akali,2548,1388,1160,54.47
MasterYi,Jinx,6006,3030,2976,50.45
MasterYi,Karma,2178,1110,1068,50.96
MasterYi,Zac,757,390,367,51.52
MasterYi,Nunu,1468,797,671,54.29
MasterYi,Shen,1363,712,651,52.24
MasterYi,Riven,934,456,478,48.82
MasterYi,Lillia,1088,581,507,53.4
MasterYi,Orianna,1022,510,512,49.9
MasterYi,Velkoz,1416,690,726,48.73
MasterYi,Volibear,2579,1290,1289,50.02
MasterYi,Nocturne,2831,1452,1379,51.29
MasterYi,Xerath,1864,957,907,51.34
MasterYi,Ezreal,4824,2479,2345,51.39
MasterYi,Blitzcrank,1673,798,875,47.7
MasterYi,Pantheon,3620,1886,1734,52.1
MasterYi,Kindred,990,535,455,54.04
MasterYi,Teemo,3116,1538,1578,49.36
MasterYi,Lucian,1401,743,658,53.03
MasterYi,Zyra,1840,872,968,47.39
MasterYi,Gnar,856,413,443,48.25
MasterYi,Seraphine,1919,960,959,50.03
MasterYi,TahmKench,2179,1087,1092,49.89
MasterYi,Briar,2035,1023,1012,50.27
MasterYi,Heimerdinger,1099,536,563,48.77
MasterYi,MissFortune,5579,2843,2736,50.96
MasterYi,Fiora,846,470,376,55.56
MasterYi,Viego,3201,1610,1591,50.3
MasterYi,Vladimir,1420,724,696,50.99
MasterYi,Pyke,2108,1085,1023,51.47
MasterYi,Irelia,2084,1042,1042,50
MasterYi,DrMundo,1355,628,727,46.35
MasterYi,Lux,6132,3059,3073,49.89
MasterYi,Bard,639,361,278,56.49
MasterYi,Katarina,1797,909,888,50.58
MasterYi,Tristana,2375,1192,1183,50.19
MasterYi,Yone,4229,2198,2031,51.97
MasterYi,Akshan,754,352,402,46.68
MasterYi,Aphelios,1193,579,614,48.53
MasterYi,Braum,1252,566,686,45.21
MasterYi,Kennen,683,363,320,53.15
MasterYi,Ekko,2100,1055,1045,50.24
MasterYi,Poppy,1222,636,586,52.05
MasterYi,Yasuo,4638,2495,2143,53.79
MasterYi,Nidalee,488,284,204,58.2
MasterYi,Mordekaiser,3220,1706,1514,52.98
MasterYi,KogMaw,579,258,321,44.56
MasterYi,Ornn,901,453,448,50.28
MasterYi,Ambessa,1287,717,570,55.71
MasterYi,Zoe,913,476,437,52.14
MasterYi,Jhin,4439,2309,2130,52.02
MasterYi,Swain,2337,1198,1139,51.26
MasterYi,Samira,1781,943,838,52.95
MasterYi,Mel,4740,2502,2238,52.78
MasterYi,Vayne,2872,1267,1605,44.12
MasterYi,Thresh,2905,1515,1390,52.15
MasterYi,Urgot,1264,602,662,47.63
MasterYi,Galio,1883,902,981,47.9
MasterYi,Rell,1057,513,544,48.53
MasterYi,Diana,3743,1890,1853,50.49
MasterYi,Aatrox,1910,1043,867,54.61
MasterYi,Darius,4303,2125,2178,49.38
MasterYi,Viktor,1810,948,862,52.38
MasterYi,Alistar,837,411,426,49.1
MasterYi,Fizz,1364,752,612,55.13
MasterYi,Nami,2003,1025,978,51.17
MasterYi,Singed,636,303,333,47.64
MasterYi,Garen,3570,1860,1710,52.1
MasterYi,Corki,743,396,347,53.3
MasterYi,JarvanIV,1114,560,554,50.27
MasterYi,Janna,691,328,363,47.47
MasterYi,Evelynn,945,476,469,50.37
MasterYi,Jax,2622,1314,1308,50.11
MasterYi,Zeri,837,399,438,47.67
MasterYi,Yuumi,1825,948,877,51.95
MasterYi,Gragas,1234,656,578,53.16
MasterYi,LeeSin,2878,1540,1338,53.51
MasterYi,Syndra,1304,641,663,49.16
MasterYi,Kalista,725,402,323,55.45
MasterYi,Soraka,1213,648,565,53.42
MasterYi,Hecarim,785,404,381,51.46
MasterYi,Ivern,350,193,157,55.14
MasterYi,Trundle,1340,643,697,47.99
MasterYi,Elise,1419,695,724,48.98
MasterYi,Senna,1647,833,814,50.58
MasterYi,Belveth,485,248,237,51.13
MasterYi,Brand,1781,977,804,54.86
MasterYi,Sion,1608,792,816,49.25
MasterYi,Talon,1201,652,549,54.29
MasterYi,Renata,490,281,209,57.35
MasterYi,Gwen,1219,660,559,54.14
MasterYi,RekSai,225,110,115,48.89
MasterYi,Aurora,1771,863,908,48.73
MasterYi,Chogath,2929,1407,1522,48.04
MasterYi,Naafiri,777,427,350,54.95
MasterYi,XinZhao,1355,648,707,47.82
MasterYi,Malzahar,2149,983,1166,45.74
MasterYi,Twitch,1940,991,949,51.08
MasterYi,Skarner,566,304,262,53.71
MasterYi,Zilean,665,325,340,48.87
MasterYi,Annie,748,374,374,50
MasterYi,Tryndamere,1396,688,708,49.28
MasterYi,Milio,1255,612,643,48.76
MasterYi,MonkeyKing,1478,681,797,46.08
MasterYi,Azir,708,389,319,54.94
MasterYi,Vi,2206,1032,1174,46.78
MasterYi,Khazix,1259,682,577,54.17
MasterYi,Rengar,825,495,330,60
MasterYi,Kassadin,463,230,233,49.68
MasterYi,Rakan,1047,536,511,51.19
MasterYi,Sejuani,863,430,433,49.83
MasterYi,Leona,2091,930,1161,44.48
MasterYi,Lissandra,809,384,425,47.47
MasterYi,Gangplank,848,435,413,51.3
MasterYi,Taric,574,255,319,44.43
MasterYi,Kled,347,166,181,47.84
MasterYi,Ziggs,855,423,432,49.47
MasterYi,Cassiopeia,620,343,277,55.32
MasterYi,Rammus,1960,853,1107,43.52
MasterYi,Qiyana,722,385,337,53.32
MasterYi,Renekton,1083,522,561,48.2
MasterYi,Taliyah,533,269,264,50.47
MasterYi,Karthus,668,345,323,51.65
MasterYi,TwistedFate,795,418,377,52.58
MasterYi,AurelionSol,921,454,467,49.29
MasterYi,Sylas,2616,1394,1222,53.29
MasterYi,Kayle,1577,818,759,51.87
MasterYi,Jayce,967,496,471,51.29
MasterYi,Rumble,503,280,223,55.67
MasterYi,Hwei,1413,701,712,49.61
MasterYi,Vex,1155,624,531,54.03
MasterYi,Quinn,841,393,448,46.73
MasterYi,Illaoi,1168,575,593,49.23
MasterYi,Sivir,1103,551,552,49.95
MasterYi,Olaf,477,271,206,56.81
MasterYi,Leblanc,1129,612,517,54.21
MasterYi,Camille,729,385,344,52.81
MasterYi,Anivia,707,364,343,51.49
MasterYi,Shyvana,532,287,245,53.95
Ashe,Maokai,1640,755,885,46.04
Ashe,Graves,2413,1206,1207,49.98
Ashe,Ahri,5284,2674,2610,50.61
Ashe,Nilah,1365,736,629,53.92
Ashe,Malphite,3586,1752,1834,48.86
Ashe,Fiora,1558,789,769,50.64
Ashe,Belveth,923,491,432,53.2
Ashe,Sylas,5625,2781,2844,49.44
Ashe,Ezreal,10369,5175,5194,49.91
Ashe,Yuumi,3230,1656,1574,51.27
Ashe,Illaoi,1953,972,981,49.77
Ashe,Nunu,2306,1272,1034,55.16
Ashe,Irelia,3388,1790,1598,52.83
Ashe,Jhin,8158,4092,4066,50.16
Ashe,Swain,3928,1969,1959,50.13
Ashe,Heimerdinger,1898,964,934,50.79
Ashe,Warwick,5578,2581,2997,46.27
Ashe,Neeko,2136,1113,1023,52.11
Ashe,Draven,2148,1087,1061,50.61
Ashe,Leona,3198,1619,1579,50.63
Ashe,Evelynn,1544,798,746,51.68
Ashe,Yasuo,7495,3813,3682,50.87
Ashe,Yone,7078,3629,3449,51.27
Ashe,Kayle,2301,1143,1158,49.67
Ashe,Viego,5484,2649,2835,48.3
Ashe,Jinx,11890,5830,6060,49.03
Ashe,Thresh,5311,2621,2690,49.35
Ashe,XinZhao,2515,1218,1297,48.43
Ashe,Katarina,3040,1625,1415,53.45
Ashe,Teemo,4745,2240,2505,47.21
Ashe,Vayne,4371,2144,2227,49.05
Ashe,TwistedFate,1337,686,651,51.31
Ashe,Pantheon,5880,2981,2899,50.7
Ashe,Kayn,5427,2590,2837,47.72
Ashe,Leblanc,2371,1146,1225,48.33
Ashe,Sivir,2321,1143,1178,49.25
Ashe,Pyke,3526,1862,1664,52.81
Ashe,Smolder,2283,1218,1065,53.35
Ashe,Nautilus,4202,2015,2187,47.95
Ashe,DrMundo,2220,1045,1175,47.07
Ashe,Briar,2949,1340,1609,45.44
Ashe,Anivia,1194,580,614,48.58
Ashe,Mordekaiser,5004,2444,2560,48.84
Ashe,Vi,3579,1804,1775,50.41
Ashe,Azir,1432,760,672,53.07
Ashe,MissFortune,9951,4778,5173,48.02
Ashe,Riven,1606,856,750,53.3
Ashe,Ivern,652,344,308,52.76
Ashe,Nami,3505,1705,1800,48.64
Ashe,Gnar,1510,765,745,50.66
Ashe,Caitlyn,11726,5789,5937,49.37
Ashe,Karma,4500,2254,2246,50.09
Ashe,Volibear,4128,2023,2105,49.01
Ashe,LeeSin,6260,3304,2956,52.78
Ashe,Morgana,4780,2274,2506,47.57
Ashe,Shaco,3479,1709,1770,49.12
Ashe,Xayah,1917,996,921,51.96
Ashe,Sett,6007,2893,3114,48.16
Ashe,Senna,2902,1446,1456,49.83
Ashe,Yorick,3602,1550,2052,43.03
Ashe,Gragas,2066,1074,992,51.98
Ashe,Lux,9581,4731,4850,49.38
Ashe,Aphelios,2104,1086,1018,51.62
Ashe,Khazix,1971,1108,863,56.22
Ashe,Akali,4298,2174,2124,50.58
Ashe,Mel,7642,3887,3755,50.86
Ashe,Zed,3958,2062,1896,52.1
Ashe,KSante,2095,1082,1013,51.65
Ashe,Zeri,1656,868,788,52.42
Ashe,Lulu,4645,2458,2187,52.92
Ashe,Sion,2782,1257,1525,45.18
Ashe,MasterYi,4537,2134,2403,47.04
Ashe,AurelionSol,1434,699,735,48.74
Ashe,FiddleSticks,1873,933,940,49.81
Ashe,Brand,2777,1252,1525,45.08
Ashe,Milio,2325,1041,1284,44.77
Ashe,Velkoz,2091,945,1146,45.19
Ashe,Soraka,2097,993,1104,47.35
Ashe,Chogath,4549,2164,2385,47.57
Ashe,Jayce,2065,1068,997,51.72
Ashe,Samira,2730,1316,1414,48.21
Ashe,Quinn,1402,664,738,47.36
Ashe,Shen,2353,1182,1171,50.23
Ashe,Shyvana,931,400,531,42.96
Ashe,Seraphine,3134,1487,1647,47.45
Ashe,Kled,773,368,405,47.61
Ashe,Ambessa,2533,1271,1262,50.18
Ashe,Diana,5753,2695,3058,46.85
Ashe,Ekko,3363,1705,1658,50.7
Ashe,Talon,2223,1126,1097,50.65
Ashe,Lissandra,1095,519,576,47.4
Ashe,Lucian,2747,1493,1254,54.35
Ashe,Nocturne,4424,2091,2333,47.26
Ashe,Sejuani,1589,756,833,47.58
Ashe,Rell,1967,941,1026,47.84
Ashe,Aatrox,3700,1826,1874,49.35
Ashe,Fizz,2008,935,1073,46.56
Ashe,Taric,796,398,398,50
Ashe,Tristana,3801,1716,2085,45.15
Ashe,Alistar,1509,742,767,49.17
Ashe,Vladimir,2383,1195,1188,50.15
Ashe,Ziggs,1568,819,749,52.23
Ashe,Darius,7110,3439,3671,48.37
Ashe,Rammus,1277,588,689,46.05
Ashe,TahmKench,3146,1577,1569,50.13
Ashe,Rengar,1288,689,599,53.49
Ashe,Galio,3296,1605,1691,48.7
Ashe,Urgot,1720,800,920,46.51
Ashe,Xerath,3312,1656,1656,50
Ashe,Kalista,1176,611,565,51.96
Ashe,Sona,1263,578,685,45.76
Ashe,Garen,5833,2687,3146,46.07
Ashe,Kindred,1749,925,824,52.89
Ashe,Varus,3875,1919,1956,49.52
Ashe,Hwei,2741,1274,1467,46.48
Ashe,Aurora,3212,1613,1599,50.22
Ashe,Malzahar,3594,1699,1895,47.27
Ashe,Braum,1996,870,1126,43.59
Ashe,Zoe,1596,856,740,53.63
Ashe,Zilean,1181,666,515,56.39
Ashe,Hecarim,1476,751,725,50.88
Ashe,Blitzcrank,3117,1554,1563,49.86
Ashe,Veigar,3948,1926,2022,48.78
Ashe,Karthus,1086,524,562,48.25
Ashe,Kaisa,6126,3280,2846,53.54
Ashe,Poppy,2359,1113,1246,47.18
Ashe,Viktor,3254,1667,1587,51.23
Ashe,Udyr,1525,825,700,54.1
Ashe,Nasus,2695,1296,1399,48.09
Ashe,Lillia,2316,1103,1213,47.63
Ashe,Gwen,1956,1046,910,53.48
Ashe,Jax,3502,1772,1730,50.6
Ashe,Amumu,3725,1819,1906,48.83
Ashe,JarvanIV,2059,984,1075,47.79
Ashe,Janna,1252,606,646,48.4
Ashe,Syndra,2303,1146,1157,49.76
Ashe,Gangplank,1726,883,843,51.16
Ashe,Vex,2073,1051,1022,50.7
Ashe,Rakan,1723,871,852,50.55
Ashe,MonkeyKing,2403,1174,1229,48.86
Ashe,Bard,1058,530,528,50.09
Ashe,Elise,2627,1381,1246,52.57
Ashe,Zyra,3468,1619,1849,46.68
Ashe,Renekton,2010,1026,984,51.04
Ashe,Renata,752,399,353,53.06
Ashe,Ornn,1665,815,850,48.95
Ashe,Camille,1386,702,684,50.65
Ashe,Zac,1941,963,978,49.61
Ashe,Nidalee,1362,771,591,56.61
Ashe,Taliyah,1023,501,522,48.97
Ashe,Orianna,1767,929,838,52.57
Ashe,Kennen,1085,599,486,55.21
Ashe,Annie,1394,730,664,52.37
Ashe,Twitch,3200,1538,1662,48.06
Ashe,Corki,1602,833,769,52
Ashe,Singed,1101,573,528,52.04
Ashe,Qiyana,1070,530,540,49.53
Ashe,Tryndamere,2031,1023,1008,50.37
Ashe,Cassiopeia,1046,537,509,51.34
Ashe,Ryze,1196,543,653,45.4
Ashe,Akshan,1242,604,638,48.63
Ashe,Naafiri,1348,665,683,49.33
Ashe,Olaf,925,447,478,48.32
Ashe,Skarner,1200,645,555,53.75
Ashe,Trundle,2237,1066,1171,47.65
Ashe,Kassadin,719,322,397,44.78
Ashe,RekSai,482,261,221,54.15
Ashe,Rumble,931,488,443,52.42
Ashe,KogMaw,1212,567,645,46.78
Graves,Pantheon,1834,918,916,50.05
Graves,MasterYi,1268,649,619,51.18
Graves,Sylas,1831,991,840,54.12
Graves,Ashe,2413,1207,1206,50.02
Graves,Karma,1490,731,759,49.06
Graves,Irelia,943,495,448,52.49
Graves,Kayn,1838,947,891,51.52
Graves,Katarina,899,406,493,45.16
Graves,Vayne,1339,647,692,48.32
Graves,DrMundo,592,319,273,53.89
Graves,Olaf,299,165,134,55.18
Graves,LeeSin,2655,1373,1282,51.71
Graves,Diana,1887,938,949,49.71
Graves,Seraphine,826,401,425,48.55
Graves,Aatrox,1295,636,659,49.11
Graves,Twitch,899,450,449,50.06
Graves,Veigar,1132,535,597,47.26
Graves,Ezreal,2984,1484,1500,49.73
Graves,Milio,700,337,363,48.14
Graves,Yorick,983,437,546,44.46
Graves,Nunu,798,439,359,55.01
Graves,Draven,674,330,344,48.96
Graves,KogMaw,355,200,155,56.34
Graves,Yuumi,1045,466,579,44.59
Graves,Gangplank,679,333,346,49.04
Graves,Aphelios,643,354,289,55.05
Graves,Leona,1015,531,484,52.32
Graves,Darius,2171,1074,1097,49.47
Graves,Chogath,1469,665,804,45.27
Graves,Yasuo,2379,1163,1216,48.89
Graves,Kaisa,2208,1102,1106,49.91
Graves,Trundle,571,311,260,54.47
Graves,Caitlyn,3071,1488,1583,48.45
Graves,Sett,1800,870,930,48.33
Graves,Smolder,856,430,426,50.23
Graves,Rengar,473,271,202,57.29
Graves,Hwei,734,352,382,47.96
Graves,Thresh,1931,1010,921,52.3
Graves,Quinn,437,201,236,46
Graves,Viego,1741,874,867,50.2
Graves,MissFortune,2539,1278,1261,50.33
Graves,Neeko,664,326,338,49.1
Graves,Tristana,1086,587,499,54.05
Graves,Lux,2742,1376,1366,50.18
Graves,Ornn,486,253,233,52.06
Graves,Skarner,343,199,144,58.02
Graves,Ekko,983,432,551,43.95
Graves,Lucian,912,476,436,52.19
Graves,Senna,818,408,410,49.88
Graves,Briar,847,369,478,43.57
Graves,Vex,585,308,277,52.65
Graves,Morgana,1335,708,627,53.03
Graves,Naafiri,385,165,220,42.86
Graves,Ziggs,459,212,247,46.19
Graves,Kalista,372,194,178,52.15
Graves,Swain,1082,476,606,43.99
Graves,Warwick,1557,771,786,49.52
Graves,Gragas,712,414,298,58.15
Graves,Hecarim,515,271,244,52.62
Graves,Kassadin,225,123,102,54.67
Graves,Mordekaiser,1454,715,739,49.17
Graves,Jinx,3208,1494,1714,46.57
Graves,Elise,817,434,383,53.12
Graves,Sejuani,514,226,288,43.97
Graves,MonkeyKing,874,425,449,48.63
Graves,Viktor,1050,534,516,50.86
Graves,Shaco,1193,616,577,51.63
Graves,Zed,1318,645,673,48.94
Graves,Varus,1131,586,545,51.81
Graves,Soraka,643,276,367,42.92
Graves,Yone,2291,1220,1071,53.25
Graves,Lillia,667,348,319,52.17
Graves,Akali,1231,629,602,51.1
Graves,Udyr,427,226,201,52.93
Graves,Jax,1210,589,621,48.68
Graves,Singed,386,152,234,39.38
Graves,Braum,740,339,401,45.81
Graves,Sion,899,463,436,51.5
Graves,Jhin,2412,1261,1151,52.28
Graves,Xerath,1149,573,576,49.87
Graves,TahmKench,987,518,469,52.48
Graves,Cassiopeia,300,148,152,49.33
Graves,Garen,1831,777,1054,42.44
Graves,Ryze,444,217,227,48.87
Graves,Renekton,660,367,293,55.61
Graves,Zeri,503,244,259,48.51
Graves,Lulu,1579,810,769,51.3
Graves,Volibear,1120,544,576,48.57
Graves,Tryndamere,584,293,291,50.17
Graves,Xayah,608,299,309,49.18
Graves,Kayle,837,429,408,51.25
Graves,AurelionSol,560,260,300,46.43
Graves,Rell,683,368,315,53.88
Graves,Heimerdinger,450,206,244,45.78
Graves,Shyvana,317,120,197,37.85
Graves,Taric,195,103,92,52.82
Graves,Poppy,717,334,383,46.58
Graves,Rumble,311,155,156,49.84
Graves,Nautilus,1477,714,763,48.34
Graves,Rakan,598,300,298,50.17
Graves,Gwen,633,349,284,55.13
Graves,Vi,1103,592,511,53.67
Graves,Zoe,508,270,238,53.15
Graves,Teemo,1321,592,729,44.81
Graves,Malphite,1098,453,645,41.26
Graves,Alistar,543,260,283,47.88
Graves,Rammus,361,162,199,44.88
Graves,Bard,362,157,205,43.37
Graves,Zac,610,309,301,50.66
Graves,Belveth,283,122,161,43.11
Graves,Evelynn,442,175,267,39.59
Graves,Ahri,1578,841,737,53.3
Graves,Orianna,511,240,271,46.97
Graves,FiddleSticks,581,275,306,47.33
Graves,Aurora,891,445,446,49.94
Graves,Sivir,579,274,305,47.32
Graves,Nidalee,514,286,228,55.64
Graves,Brand,743,385,358,51.82
Graves,Samira,935,424,511,45.35
Graves,Riven,530,254,276,47.92
Graves,Qiyana,344,185,159,53.78
Graves,Vladimir,707,355,352,50.21
Graves,Zilean,402,192,210,47.76
Graves,Mel,2286,1131,1155,49.48
Graves,Nasus,786,364,422,46.31
Graves,Akshan,417,206,211,49.4
Graves,Sona,328,157,171,47.87
Graves,Pyke,1181,611,570,51.74
Graves,Fiora,418,220,198,52.63
Graves,Malzahar,1127,570,557,50.58
Graves,Gnar,529,274,255,51.8
Graves,Jayce,791,348,443,43.99
Graves,Camille,524,276,248,52.67
Graves,Annie,381,163,218,42.78
Graves,Blitzcrank,934,502,432,53.75
Graves,Galio,1048,551,497,52.58
Graves,TwistedFate,547,267,280,48.81
Graves,Khazix,754,336,418,44.56
Graves,Taliyah,354,149,205,42.09
Graves,Syndra,846,409,437,48.35
Graves,Renata,240,119,121,49.58
Graves,Velkoz,684,296,388,43.27
Graves,Leblanc,804,403,401,50.12
Graves,Nocturne,1361,592,769,43.5
Graves,Urgot,539,285,254,52.88
Graves,Zyra,1034,437,597,42.26
Graves,JarvanIV,672,317,355,47.17
Graves,XinZhao,777,360,417,46.33
Graves,Nami,1097,497,600,45.31
Graves,Ambessa,819,408,411,49.82
Graves,Talon,833,419,414,50.3
Graves,Ivern,262,108,154,41.22
Graves,Lissandra,413,206,207,49.88
Graves,KSante,623,304,319,48.8
Graves,Illaoi,446,251,195,56.28
Graves,Fizz,645,304,341,47.13
Graves,Corki,456,201,255,44.08
Graves,Kindred,597,310,287,51.93
Graves,Kennen,350,146,204,41.71
Graves,Janna,339,165,174,48.67
Graves,Kled,221,104,117,47.06
Graves,RekSai,174,94,80,54.02
Graves,Amumu,1177,571,606,48.51
Graves,Anivia,378,144,234,38.1
Graves,Shen,735,376,359,51.16
Graves,Maokai,519,242,277,46.63
Graves,Karthus,414,178,236,43
Graves,Nilah,398,176,222,44.22
Graves,Azir,429,218,211,50.82
Ahri,Pantheon,4245,2103,2142,49.54
Ahri,MasterYi,2852,1414,1438,49.58
Ahri,Sylas,3975,1978,1997,49.76
Ahri,Ashe,5284,2610,2674,49.39
Ahri,Karma,2852,1483,1369,52
Ahri,Gangplank,1290,621,669,48.14
Ahri,Ivern,400,195,205,48.75
Ahri,Mel,4485,2197,2288,48.99
Ahri,Jhin,5068,2494,2574,49.21
Ahri,Swain,2775,1270,1505,45.77
Ahri,Gwen,1470,752,718,51.16
Ahri,Talon,1567,841,726,53.67
Ahri,Yone,5046,2710,2336,53.71
Ahri,MissFortune,6168,3040,3128,49.29
Ahri,Taric,551,241,310,43.74
Ahri,Teemo,3261,1536,1725,47.1
Ahri,Hecarim,1073,611,462,56.94
Ahri,Veigar,3042,1427,1615,46.91
Ahri,Thresh,3463,1739,1724,50.22
Ahri,Poppy,1648,762,886,46.24
Ahri,Warwick,4083,1878,2205,46
Ahri,Katarina,2227,1150,1077,51.64
Ahri,Twitch,1994,1032,962,51.76
Ahri,Morgana,3183,1584,1599,49.76
Ahri,Yorick,2598,1158,1440,44.57
Ahri,AurelionSol,1067,528,539,49.48
Ahri,Kayn,3752,1944,1808,51.81
Ahri,Singed,609,262,347,43.02
Ahri,Udyr,951,465,486,48.9
Ahri,Jax,2371,1167,1204,49.22
Ahri,Elise,1742,880,862,50.52
Ahri,Naafiri,849,409,440,48.17
Ahri,Lulu,3081,1547,1534,50.21
Ahri,Nasus,1923,912,1011,47.43
Ahri,Neeko,1526,768,758,50.33
Ahri,Sett,4187,2071,2116,49.46
Ahri,Senna,2191,1039,1152,47.42
Ahri,Akali,2661,1268,1393,47.65
Ahri,Akshan,1052,559,493,53.14
Ahri,TahmKench,2133,1030,1103,48.29
Ahri,Kennen,845,441,404,52.19
Ahri,MonkeyKing,1657,780,877,47.07
Ahri,Vladimir,1640,802,838,48.9
Ahri,Vayne,3015,1479,1536,49.05
Ahri,Fiora,976,535,441,54.82
Ahri,Shaco,2482,1139,1343,45.89
Ahri,Fizz,1334,598,736,44.83
Ahri,Tristana,2524,1204,1320,47.7
Ahri,Rakan,1197,622,575,51.96
Ahri,Yasuo,4966,2471,2495,49.76
Ahri,Belveth,588,256,332,43.54
Ahri,Mordekaiser,3693,1818,1875,49.23
Ahri,Alistar,991,480,511,48.44
Ahri,Chogath,3297,1661,1636,50.38
Ahri,Briar,2212,1066,1146,48.19
Ahri,Jayce,1312,690,622,52.59
Ahri,Samira,2023,985,1038,48.69
Ahri,XinZhao,1726,837,889,48.49
Ahri,Brand,2088,990,1098,47.41
Ahri,Ambessa,1568,812,756,51.79
Ahri,Rammus,800,382,418,47.75
Ahri,Aurora,2339,1234,1105,52.76
Ahri,Caitlyn,7016,3400,3616,48.46
Ahri,Riven,1094,622,472,56.86
Ahri,Zed,2602,1373,1229,52.77
Ahri,Smolder,1742,840,902,48.22
Ahri,Galio,2477,1216,1261,49.09
Ahri,Sejuani,1156,547,609,47.32
Ahri,Malzahar,2568,1126,1442,43.85
Ahri,Amumu,2731,1231,1500,45.08
Ahri,DrMundo,1539,696,843,45.22
Ahri,Viktor,1996,998,998,50
Ahri,Pyke,2392,1178,1214,49.25
Ahri,Nocturne,2963,1375,1588,46.41
Ahri,Leblanc,1676,868,808,51.79
Ahri,Irelia,2244,1074,1170,47.86
Ahri,Janna,792,399,393,50.38
Ahri,Jinx,6623,3139,3484,47.4
Ahri,Nautilus,2927,1522,1405,52
Ahri,Zac,1144,579,565,50.61
Ahri,Diana,4167,1962,2205,47.08
Ahri,Illaoi,1254,586,668,46.73
Ahri,Evelynn,1129,602,527,53.32
Ahri,Hwei,2038,998,1040,48.97
Ahri,Viego,3401,1749,1652,51.43
Ahri,KSante,1310,714,596,54.5
Ahri,Ekko,2391,1178,1213,49.27
Ahri,Lucian,1831,908,923,49.59
Ahri,Kassadin,604,287,317,47.52
Ahri,Renata,541,296,245,54.71
Ahri,Maokai,1118,532,586,47.58
Ahri,Ornn,1089,500,589,45.91
Ahri,Zoe,1117,529,588,47.36
Ahri,Aatrox,2374,1173,1201,49.41
Ahri,LeeSin,3531,1803,1728,51.06
Ahri,Zyra,2112,877,1235,41.52
Ahri,Karthus,636,325,311,51.1
Ahri,Xayah,1391,666,725,47.88
Ahri,FiddleSticks,1202,626,576,52.08
Ahri,Lux,7251,3334,3917,45.98
Ahri,Velkoz,1586,789,797,49.75
Ahri,Nilah,1087,534,553,49.13
Ahri,Yuumi,2116,1072,1044,50.66
Ahri,Tryndamere,1420,740,680,52.11
Ahri,Varus,2291,1137,1154,49.63
Ahri,Seraphine,2276,1137,1139,49.96
Ahri,Soraka,1458,675,783,46.3
Ahri,Rengar,907,501,406,55.24
Ahri,Kindred,1275,647,628,50.75
Ahri,Vex,1650,783,867,47.45
Ahri,Darius,4727,2240,2487,47.39
Ahri,Anivia,857,445,412,51.93
Ahri,Blitzcrank,2127,1171,956,55.05
Ahri,Qiyana,703,378,325,53.77
Ahri,Sona,886,424,462,47.86
Ahri,Gragas,1467,719,748,49.01
Ahri,Rell,1424,695,729,48.81
Ahri,Nami,2514,1208,1306,48.05
Ahri,Quinn,872,422,450,48.39
Ahri,RekSai,372,204,168,54.84
Ahri,Ryze,968,458,510,47.31
Ahri,Taliyah,812,411,401,50.62
Ahri,Skarner,802,426,376,53.12
Ahri,Xerath,2190,1049,1141,47.9
Ahri,Milio,1512,689,823,45.57
Ahri,Kaisa,4100,2169,1931,52.9
Ahri,Renekton,1340,684,656,51.04
Ahri,Lillia,1533,733,800,47.81
Ahri,Zeri,1139,577,562,50.66
Ahri,Trundle,1477,688,789,46.58
Ahri,Kayle,1838,873,965,47.5
Ahri,Shen,1642,806,836,49.09
Ahri,Braum,1528,737,791,48.23
Ahri,Camille,948,459,489,48.42
Ahri,Volibear,2966,1408,1558,47.47
Ahri,Azir,959,517,442,53.91
Ahri,Khazix,1387,750,637,54.07
Ahri,Draven,1212,605,607,49.92
Ahri,Kled,461,242,219,52.49
Ahri,KogMaw,796,364,432,45.73
Ahri,Zilean,854,409,445,47.89
Ahri,Graves,1578,737,841,46.7
Ahri,Cassiopeia,933,460,473,49.3
Ahri,Ezreal,5853,3001,2852,51.27
Ahri,Ziggs,894,431,463,48.21
Ahri,JarvanIV,1571,729,842,46.4
Ahri,Kalista,922,523,399,56.72
Ahri,Vi,2600,1330,1270,51.15
Ahri,Nunu,1703,790,913,46.39
Ahri,Aphelios,1550,787,763,50.77
Ahri,Leona,2120,1077,1043,50.8
Ahri,Gnar,1162,618,544,53.18
Ahri,TwistedFate,935,490,445,52.41
Ahri,Malphite,2398,1160,1238,48.37
Ahri,Garen,3979,2046,1933,51.42
Ahri,Nidalee,713,395,318,55.4
Ahri,Urgot,1357,589,768,43.4
Ahri,Corki,950,473,477,49.79
Ahri,Lissandra,847,430,417,50.77
Ahri,Syndra,2063,963,1100,46.68
Ahri,Shyvana,633,336,297,53.08
Ahri,Sivir,1402,670,732,47.79
Ahri,Olaf,625,308,317,49.28
Ahri,Orianna,1344,642,702,47.77
Ahri,Sion,1961,939,1022,47.88
Ahri,Rumble,642,332,310,51.71
Ahri,Annie,986,515,471,52.23
Ahri,Bard,895,400,495,44.69
Ahri,Heimerdinger,1253,574,679,45.81
Nilah,Pantheon,1313,707,606,53.85
Nilah,MasterYi,917,458,459,49.95
Nilah,Sylas,906,456,450,50.33
Nilah,Ashe,1365,629,736,46.08
Nilah,Karma,641,352,289,54.91
Nilah,Swain,871,382,489,43.86
Nilah,FiddleSticks,389,174,215,44.73
Nilah,Akali,793,418,375,52.71
Nilah,Twitch,725,374,351,51.59
Nilah,Senna,583,295,288,50.6
Nilah,Yorick,666,302,364,45.35
Nilah,Akshan,272,165,107,60.66
Nilah,Samira,1049,579,470,55.2
Nilah,Pyke,759,457,302,60.21
Nilah,TahmKench,680,338,342,49.71
Nilah,Nunu,520,239,281,45.96
Nilah,Vladimir,482,279,203,57.88
Nilah,Nami,819,416,403,50.79
Nilah,Fiora,322,166,156,51.55
Nilah,LeeSin,814,410,404,50.37
Nilah,Ziggs,311,148,163,47.59
Nilah,Jinx,1917,925,992,48.25
Nilah,Nasus,639,293,346,45.85
Nilah,Gragas,443,234,209,52.82
Nilah,Yasuo,1705,1024,681,60.06
Nilah,Smolder,533,314,219,58.91
Nilah,Mel,1685,1027,658,60.95
Nilah,KSante,317,176,141,55.52
Nilah,Kayn,1185,592,593,49.96
Nilah,MissFortune,2025,1022,1003,50.47
Nilah,Lux,1915,970,945,50.65
Nilah,Illaoi,365,187,178,51.23
Nilah,Warwick,1230,629,601,51.14
Nilah,Aurora,643,332,311,51.63
Nilah,Ezreal,1394,786,608,56.38
Nilah,Neeko,445,241,204,54.16
Nilah,Yone,1278,735,543,57.51
Nilah,Poppy,435,199,236,45.75
Nilah,Thresh,991,536,455,54.09
Nilah,Sett,1252,630,622,50.32
Nilah,Rammus,219,90,129,41.1
Nilah,Tristana,718,344,374,47.91
Nilah,Karthus,239,119,120,49.79
Nilah,Zed,747,431,316,57.7
Nilah,Maokai,473,263,210,55.6
Nilah,Gangplank,366,180,186,49.18
Nilah,Diana,1068,547,521,51.22
Nilah,Irelia,569,289,280,50.79
Nilah,Aphelios,526,265,261,50.38
Nilah,Leona,702,400,302,56.98
Nilah,Darius,1431,739,692,51.64
Nilah,Syndra,464,251,213,54.09
Nilah,Corki,326,153,173,46.93
Nilah,Elise,534,299,235,55.99
Nilah,Katarina,647,308,339,47.6
Nilah,Kaisa,1232,699,533,56.74
Nilah,Qiyana,222,125,97,56.31
Nilah,Volibear,917,506,411,55.18
Nilah,Gwen,403,207,196,51.36
Nilah,DrMundo,487,258,229,52.98
Nilah,Lucian,507,291,216,57.4
Nilah,Belveth,207,122,85,58.94
Nilah,AurelionSol,321,159,162,49.53
Nilah,Briar,734,354,380,48.23
Nilah,Kassadin,154,95,59,61.69
Nilah,Renata,214,110,104,51.4
Nilah,Mordekaiser,1062,525,537,49.44
Nilah,Shaco,802,428,374,53.37
Nilah,Zoe,326,210,116,64.42
Nilah,Seraphine,745,352,393,47.25
Nilah,Olaf,195,116,79,59.49
Nilah,Morgana,1081,562,519,51.99
Nilah,Teemo,1016,477,539,46.95
Nilah,Aatrox,702,375,327,53.42
Nilah,Jhin,1399,691,708,49.39
Nilah,Renekton,379,183,196,48.28
Nilah,Jax,622,286,336,45.98
Nilah,Soraka,395,237,158,60
Nilah,Nidalee,182,103,79,56.59
Nilah,Ahri,1087,553,534,50.87
Nilah,Sona,269,117,152,43.49
Nilah,Amumu,801,346,455,43.2
Nilah,Caitlyn,1877,947,930,50.45
Nilah,Xayah,541,250,291,46.21
Nilah,Ekko,586,293,293,50
Nilah,Chogath,1005,496,509,49.35
Nilah,Ryze,217,98,119,45.16
Nilah,Xerath,571,280,291,49.04
Nilah,Zac,316,183,133,57.91
Nilah,Skarner,200,119,81,59.5
Nilah,Malzahar,750,335,415,44.67
Nilah,Vi,662,367,295,55.44
Nilah,Viego,1005,515,490,51.24
Nilah,Vayne,905,430,475,47.51
Nilah,Zilean,206,106,100,51.46
Nilah,Singed,254,107,147,42.13
Nilah,Kindred,416,213,203,51.2
Nilah,Yuumi,649,315,334,48.54
Nilah,Garen,1282,664,618,51.79
Nilah,Khazix,418,239,179,57.18
Nilah,Brand,623,307,316,49.28
Nilah,Evelynn,398,179,219,44.97
Nilah,Leblanc,273,154,119,56.41
Nilah,Kayle,547,287,260,52.47
Nilah,Viktor,504,301,203,59.72
Nilah,Veigar,837,424,413,50.66
Nilah,Shyvana,205,105,100,51.22
Nilah,Orianna,373,193,180,51.74
Nilah,Ambessa,492,304,188,61.79
Nilah,Ornn,341,131,210,38.42
Nilah,Naafiri,331,189,142,57.1
Nilah,Riven,324,213,111,65.74
Nilah,Lulu,714,361,353,50.56
Nilah,Nocturne,873,406,467,46.51
Nilah,Malphite,771,381,390,49.42
Nilah,Trundle,512,224,288,43.75
Nilah,Sejuani,349,195,154,55.87
Nilah,Kennen,185,94,91,50.81
Nilah,Blitzcrank,507,299,208,58.97
Nilah,Annie,210,108,102,51.43
Nilah,Draven,359,199,160,55.43
Nilah,Taliyah,182,58,124,31.87
Nilah,Heimerdinger,340,130,210,38.24
Nilah,XinZhao,460,232,228,50.43
Nilah,Azir,260,114,146,43.85
Nilah,Braum,409,227,182,55.5
Nilah,Cassiopeia,270,145,125,53.7
Nilah,Hwei,567,313,254,55.2
Nilah,Vex,474,214,260,45.15
Nilah,Milio,360,161,199,44.72
Nilah,Gnar,287,174,113,60.63
Nilah,Nautilus,840,491,349,58.45
Nilah,Galio,592,278,314,46.96
Nilah,Shen,512,289,223,56.45
Nilah,Hecarim,215,111,104,51.63
Nilah,Varus,576,324,252,56.25
Nilah,JarvanIV,389,191,198,49.1
Nilah,Udyr,253,161,92,63.64
Nilah,Rengar,355,227,128,63.94
Nilah,Kled,142,56,86,39.44
Nilah,Quinn,249,104,145,41.77
Nilah,Rell,441,203,238,46.03
Nilah,KogMaw,162,93,69,57.41
Nilah,Sion,612,314,298,51.31
Nilah,TwistedFate,273,141,132,51.65
Nilah,Lillia,515,232,283,45.05
Nilah,Lissandra,259,128,131,49.42
Nilah,Zeri,306,170,136,55.56
Nilah,Jayce,317,193,124,60.88
Nilah,Rakan,301,123,178,40.86
Nilah,Alistar,342,165,177,48.25
Nilah,MonkeyKing,498,247,251,49.6
Nilah,Sivir,294,147,147,50
Nilah,Zyra,566,297,269,52.47
Nilah,Fizz,344,182,162,52.91
Nilah,Ivern,122,72,50,59.02
Nilah,Velkoz,537,230,307,42.83
Nilah,Camille,281,166,115,59.07
Nilah,Tryndamere,587,350,237,59.63
Nilah,Kalista,287,197,90,68.64
Nilah,RekSai,102,60,42,58.82
Nilah,Talon,359,174,185,48.47
Nilah,Bard,262,100,162,38.17
Nilah,Anivia,201,87,114,43.28
Nilah,Urgot,391,181,210,46.29
Nilah,Janna,264,125,139,47.35
Nilah,Graves,398,222,176,55.78
Nilah,Taric,168,92,76,54.76
Nilah,Rumble,102,42,60,41.18
Belveth,Mordekaiser,674,350,324,51.93
Belveth,Kindred,235,111,124,47.23
Belveth,Qiyana,144,59,85,40.97
Belveth,Ashe,923,432,491,46.8
Belveth,Sona,146,75,71,51.37
Belveth,Malphite,487,191,296,39.22
Belveth,Rengar,198,95,103,47.98
Belveth,Akali,510,239,271,46.86
Belveth,Rakan,216,113,103,52.31
Belveth,Sion,382,206,176,53.93
Belveth,Ahri,588,332,256,56.46
Belveth,Anivia,149,102,47,68.46
Belveth,Poppy,337,118,219,35.01
Belveth,Teemo,652,289,363,44.33
Belveth,Khazix,243,119,124,48.97
Belveth,Smolder,319,161,158,50.47
Belveth,MissFortune,1037,518,519,49.95
Belveth,Rell,279,140,139,50.18
Belveth,Warwick,738,373,365,50.54
Belveth,Briar,451,232,219,51.44
Belveth,Nilah,207,85,122,41.06
Belveth,Morgana,529,266,263,50.28
Belveth,Aatrox,414,192,222,46.38
Belveth,Veigar,484,195,289,40.29
Belveth,Ezreal,1105,565,540,51.13
Belveth,Karma,518,300,218,57.92
Belveth,Gwen,312,155,157,49.68
Belveth,Katarina,405,196,209,48.4
Belveth,Aphelios,304,169,135,55.59
Belveth,Alistar,153,62,91,40.52
Belveth,Vladimir,338,154,184,45.56
Belveth,Jhin,942,474,468,50.32
Belveth,Seraphine,398,173,225,43.47
Belveth,Urgot,248,103,145,41.53
Belveth,MasterYi,485,237,248,48.87
Belveth,Hwei,339,200,139,59
Belveth,Xayah,329,177,152,53.8
Belveth,Darius,816,391,425,47.92
Belveth,Evelynn,141,42,99,29.79
Belveth,Renekton,234,102,132,43.59
Belveth,Lux,1173,555,618,47.31
Belveth,Jinx,1264,538,726,42.56
Belveth,Caitlyn,1155,555,600,48.05
Belveth,Nautilus,536,297,239,55.41
Belveth,Garen,734,338,396,46.05
Belveth,Shaco,424,226,198,53.3
Belveth,Yone,849,397,452,46.76
Belveth,Yorick,491,232,259,47.25
Belveth,Irelia,365,184,181,50.41
Belveth,Yasuo,966,521,445,53.93
Belveth,TahmKench,436,215,221,49.31
Belveth,Viego,765,371,394,48.5
Belveth,Pyke,414,254,160,61.35
Belveth,Ekko,332,171,161,51.51
Belveth,Vex,228,110,118,48.25
Belveth,Gangplank,238,117,121,49.16
Belveth,Yuumi,407,207,200,50.86
Belveth,Gragas,288,149,139,51.74
Belveth,Naafiri,152,84,68,55.26
Belveth,Kayle,355,181,174,50.99
Belveth,Graves,283,161,122,56.89
Belveth,Galio,416,217,199,52.16
Belveth,Tristana,471,251,220,53.29
Belveth,Lulu,538,245,293,45.54
Belveth,Kled,95,31,64,32.63
Belveth,Ivern,93,56,37,60.22
Belveth,Nasus,388,183,205,47.16
Belveth,Kaisa,780,373,407,47.82
Belveth,Elise,346,161,185,46.53
Belveth,Ryze,180,76,104,42.22
Belveth,Vayne,548,269,279,49.09
Belveth,XinZhao,333,149,184,44.74
Belveth,Kayn,677,310,367,45.79
Belveth,Taric,115,64,51,55.65
Belveth,Amumu,544,267,277,49.08
Belveth,Annie,160,75,85,46.88
Belveth,Leona,441,214,227,48.53
Belveth,Lissandra,147,65,82,44.22
Belveth,Vi,432,203,229,46.99
Belveth,Draven,267,142,125,53.18
Belveth,Braum,294,109,185,37.07
Belveth,Udyr,189,96,93,50.79
Belveth,Kennen,127,76,51,59.84
Belveth,Nunu,317,175,142,55.21
Belveth,Leblanc,245,111,134,45.31
Belveth,Zilean,157,71,86,45.22
Belveth,Skarner,174,118,56,67.82
Belveth,Orianna,235,125,110,53.19
Belveth,Cassiopeia,197,119,78,60.41
Belveth,Renata,137,64,73,46.72
Belveth,Jax,357,155,202,43.42
Belveth,Mel,942,517,425,54.88
Belveth,Camille,152,79,73,51.97
Belveth,Pantheon,795,371,424,46.67
Belveth,Trundle,304,127,177,41.78
Belveth,Sylas,570,283,287,49.65
Belveth,Zac,169,96,73,56.8
Belveth,Chogath,561,300,261,53.48
Belveth,Heimerdinger,255,110,145,43.14
Belveth,LeeSin,567,311,256,54.85
Belveth,Ambessa,369,200,169,54.2
Belveth,Maokai,234,100,134,42.74
Belveth,Ziggs,171,79,92,46.2
Belveth,Singed,150,83,67,55.33
Belveth,Akshan,221,107,114,48.42
Belveth,Velkoz,291,161,130,55.33
Belveth,Varus,452,256,196,56.64
Belveth,Zeri,207,110,97,53.14
Belveth,Sett,721,314,407,43.55
Belveth,MonkeyKing,282,154,128,54.61
Belveth,Volibear,530,281,249,53.02
Belveth,Sivir,211,104,107,49.29
Belveth,Tryndamere,284,140,144,49.3
Belveth,Samira,355,148,207,41.69
Belveth,Senna,379,178,201,46.97
Belveth,Diana,656,298,358,45.43
Belveth,Brand,384,164,220,42.71
Belveth,Jayce,192,110,82,57.29
Belveth,Nidalee,138,64,74,46.38
Belveth,Twitch,359,169,190,47.08
Belveth,Nami,544,257,287,47.24
Belveth,Malzahar,451,133,318,29.49
Belveth,Milio,299,170,129,56.86
Belveth,Rumble,143,62,81,43.36
Belveth,Shen,321,137,184,42.68
Belveth,Kassadin,87,40,47,45.98
Belveth,Zed,420,224,196,53.33
Belveth,FiddleSticks,289,143,146,49.48
Belveth,Fizz,241,100,141,41.49
Belveth,Blitzcrank,310,152,158,49.03
Belveth,Sejuani,134,81,53,60.45
Belveth,Shyvana,124,59,65,47.58
Belveth,Viktor,398,192,206,48.24
Belveth,Azir,184,80,104,43.48
Belveth,Olaf,89,41,48,46.07
Belveth,Riven,182,95,87,52.2
Belveth,Swain,488,213,275,43.65
Belveth,Neeko,195,114,81,58.46
Belveth,JarvanIV,227,82,145,36.12
Belveth,Zyra,400,196,204,49
Belveth,KSante,239,123,116,51.46
Belveth,Kalista,197,103,94,52.28
Belveth,Thresh,706,359,347,50.85
Belveth,Taliyah,136,52,84,38.24
Belveth,Nocturne,588,226,362,38.44
Belveth,Talon,283,125,158,44.17
Belveth,Lucian,299,177,122,59.2
Belveth,Soraka,329,159,170,48.33
Belveth,Lillia,235,104,131,44.26
Belveth,KogMaw,123,44,79,35.77
Belveth,AurelionSol,186,87,99,46.77
Belveth,Syndra,293,147,146,50.17
Belveth,Janna,172,61,111,35.47
Belveth,Illaoi,252,117,135,46.43
Belveth,Quinn,169,72,97,42.6
Belveth,Xerath,434,231,203,53.23
Belveth,Ornn,210,117,93,55.71
Belveth,Karthus,137,71,66,51.82
Belveth,Corki,219,116,103,52.97
Belveth,DrMundo,261,141,120,54.02
Belveth,Gnar,174,96,78,55.17
Belveth,Bard,123,64,59,52.03
Belveth,Hecarim,209,100,109,47.85
Belveth,Aurora,365,195,170,53.42
Belveth,Fiora,249,131,118,52.61
Belveth,Zoe,175,78,97,44.57
Belveth,Rammus,179,84,95,46.93
Belveth,RekSai,62,42,20,67.74
Belveth,TwistedFate,155,82,73,52.9
Sona,Fiora,241,116,125,48.13
Sona,Belveth,146,71,75,48.63
Sona,Sylas,757,365,392,48.22
Sona,Ezreal,1305,745,560,57.09
Sona,Yuumi,605,346,259,57.19
Sona,Trundle,369,204,165,55.28
Sona,MasterYi,756,420,336,55.56
Sona,Veigar,700,333,367,47.57
Sona,Jhin,1241,658,583,53.02
Sona,Soraka,395,176,219,44.56
Sona,Yorick,694,294,400,42.36
Sona,LeeSin,643,379,264,58.94
Sona,Yone,1163,665,498,57.18
Sona,MissFortune,1439,658,781,45.73
Sona,Mel,1450,784,666,54.07
Sona,Ornn,293,133,160,45.39
Sona,Udyr,239,90,149,37.66
Sona,Lux,1695,816,879,48.14
Sona,Milio,469,233,236,49.68
Sona,Urgot,413,174,239,42.13
Sona,Kayn,1018,551,467,54.13
Sona,Yasuo,1181,632,549,53.51
Sona,Twitch,531,250,281,47.08
Sona,Neeko,382,218,164,57.07
Sona,Tryndamere,411,262,149,63.75
Sona,Gragas,327,171,156,52.29
Sona,Irelia,554,261,293,47.11
Sona,Kalista,187,108,79,57.75
Sona,Teemo,930,474,456,50.97
Sona,Leblanc,316,173,143,54.75
Sona,Elise,434,262,172,60.37
Sona,Rammus,170,75,95,44.12
Sona,Fizz,382,215,167,56.28
Sona,DrMundo,389,190,199,48.84
Sona,TahmKench,559,269,290,48.12
Sona,Vladimir,387,212,175,54.78
Sona,Ashe,1263,685,578,54.24
Sona,Swain,729,373,356,51.17
Sona,Riven,340,173,167,50.88
Sona,Shaco,658,348,310,52.89
Sona,Ekko,638,330,308,51.72
Sona,Thresh,792,390,402,49.24
Sona,Aatrox,510,267,243,52.35
Sona,Nocturne,747,340,407,45.52
Sona,Aphelios,360,199,161,55.28
Sona,Nautilus,609,351,258,57.64
Sona,Sett,926,467,459,50.43
Sona,Katarina,499,262,237,52.51
Sona,Morgana,927,465,462,50.16
Sona,Diana,994,510,484,51.31
Sona,Briar,524,262,262,50
Sona,Pantheon,1017,546,471,53.69
Sona,Caitlyn,1683,920,763,54.66
Sona,Rumble,127,76,51,59.84
Sona,Malphite,614,323,291,52.61
Sona,Lulu,736,358,378,48.64
Sona,Ambessa,373,194,179,52.01
Sona,Maokai,191,83,108,43.46
Sona,Gwen,405,207,198,51.11
Sona,Lillia,446,245,201,54.93
Sona,Vayne,771,411,360,53.31
Sona,Velkoz,384,183,201,47.66
Sona,Nilah,269,152,117,56.51
Sona,Sejuani,240,114,126,47.5
Sona,Malzahar,629,359,270,57.07
Sona,Jinx,1771,845,926,47.71
Sona,Smolder,393,205,188,52.16
Sona,Mordekaiser,844,429,415,50.83
Sona,Gnar,219,101,118,46.12
Sona,Kindred,359,187,172,52.09
Sona,Lucian,410,225,185,54.88
Sona,Warwick,1047,540,507,51.58
Sona,TwistedFate,235,105,130,44.68
Sona,Akali,693,342,351,49.35
Sona,Taliyah,167,88,79,52.69
Sona,Hwei,419,211,208,50.36
Sona,Khazix,410,232,178,56.59
Sona,Ahri,886,462,424,52.14
Sona,Illaoi,316,157,159,49.68
Sona,Darius,1244,606,638,48.71
Sona,Xayah,278,128,150,46.04
Sona,Rakan,300,148,152,49.33
Sona,Gangplank,316,176,140,55.7
Sona,Volibear,705,386,319,54.75
Sona,Syndra,333,174,159,52.25
Sona,Nidalee,189,114,75,60.32
Sona,Vex,382,206,176,53.93
Sona,Samira,497,264,233,53.12
Sona,Nunu,385,214,171,55.58
Sona,Cassiopeia,246,160,86,65.04
Sona,Karma,690,411,279,59.57
Sona,Xerath,505,235,270,46.53
Sona,Evelynn,256,143,113,55.86
Sona,Zed,632,373,259,59.02
Sona,JarvanIV,348,183,165,52.59
Sona,Zyra,551,275,276,49.91
Sona,Amumu,598,260,338,43.48
Sona,Heimerdinger,391,201,190,51.41
Sona,Seraphine,687,394,293,57.35
Sona,Viego,737,350,387,47.49
Sona,Nami,773,383,390,49.55
Sona,Kled,120,51,69,42.5
Sona,Rengar,240,148,92,61.67
Sona,Viktor,531,268,263,50.47
Sona,Tristana,622,378,244,60.77
Sona,Galio,502,258,244,51.39
Sona,KSante,253,142,111,56.13
Sona,Jax,609,317,292,52.05
Sona,Sion,430,237,193,55.12
Sona,FiddleSticks,352,186,166,52.84
Sona,Varus,554,275,279,49.64
Sona,Aurora,495,288,207,58.18
Sona,Brand,448,246,202,54.91
Sona,Kayle,521,253,268,48.56
Sona,Alistar,207,124,83,59.9
Sona,Camille,226,157,69,69.47
Sona,Naafiri,242,137,105,56.61
Sona,Blitzcrank,370,178,192,48.11
Sona,Rell,300,149,151,49.67
Sona,Ziggs,270,154,116,57.04
Sona,Zac,278,131,147,47.12
Sona,Renekton,339,166,173,48.97
Sona,Azir,226,128,98,56.64
Sona,Kaisa,955,511,444,53.51
Sona,Renata,147,69,78,46.94
Sona,Shen,403,232,171,57.57
Sona,Leona,510,242,268,47.45
Sona,Senna,583,280,303,48.03
Sona,KogMaw,300,131,169,43.67
Sona,Karthus,193,97,96,50.26
Sona,Graves,328,171,157,52.13
Sona,Chogath,772,404,368,52.33
Sona,Draven,366,231,135,63.11
Sona,Annie,217,88,129,40.55
Sona,Ivern,141,70,71,49.65
Sona,AurelionSol,246,129,117,52.44
Sona,Kassadin,135,85,50,62.96
Sona,Kennen,205,110,95,53.66
Sona,Talon,354,206,148,58.19
Sona,Poppy,364,195,169,53.57
Sona,XinZhao,386,182,204,47.15
Sona,Zeri,216,130,86,60.19
Sona,Zilean,254,109,145,42.91
Sona,Ryze,178,96,82,53.93
Sona,Vi,482,255,227,52.9
Sona,Taric,160,94,66,58.75
Sona,Jayce,274,170,104,62.04
Sona,MonkeyKing,382,196,186,51.31
Sona,Janna,268,166,102,61.94
Sona,Braum,247,132,115,53.44
Sona,Garen,985,487,498,49.44
Sona,Pyke,570,343,227,60.18
Sona,Nasus,483,246,237,50.93
Sona,Shyvana,173,89,84,51.45
Sona,Olaf,107,69,38,64.49
Sona,Hecarim,282,127,155,45.04
Sona,Akshan,207,89,118,43
Sona,Sivir,305,153,152,50.16
Sona,Orianna,221,120,101,54.3
Sona,Bard,195,124,71,63.59
Sona,Zoe,208,120,88,57.69
Sona,Skarner,197,114,83,57.87
Sona,Anivia,189,88,101,46.56
Sona,Singed,147,76,71,51.7
Sona,Quinn,196,99,97,50.51
Sona,Corki,196,95,101,48.47
Sona,RekSai,105,67,38,63.81
Sona,Lissandra,127,57,70,44.88
Sona,Qiyana,137,76,61,55.47
Ivern,Yorick,313,145,168,46.33
Ivern,Viego,463,193,270,41.68
Ivern,Diana,480,209,271,43.54
Ivern,Seraphine,234,104,130,44.44
Ivern,Rakan,138,49,89,35.51
Ivern,Riven,187,66,121,35.29
Ivern,Kayn,472,221,251,46.82
Ivern,Ahri,400,205,195,51.25
Ivern,Jinx,792,376,416,47.47
Ivern,Nautilus,374,185,189,49.47
Ivern,Akshan,156,69,87,44.23
Ivern,FiddleSticks,154,91,63,59.09
Ivern,Samira,238,120,118,50.42
Ivern,Pyke,283,145,138,51.24
Ivern,Shen,231,116,115,50.22
Ivern,Gragas,197,88,109,44.67
Ivern,Yone,551,254,297,46.1
Ivern,Ashe,652,308,344,47.24
Ivern,Alistar,146,68,78,46.58
Ivern,Chogath,489,242,247,49.49
Ivern,Shaco,285,117,168,41.05
Ivern,Poppy,206,91,115,44.17
Ivern,Garen,581,291,290,50.09
Ivern,Rammus,98,40,58,40.82
Ivern,Soraka,198,99,99,50
Ivern,TahmKench,282,140,142,49.65
Ivern,Zac,127,69,58,54.33
Ivern,XinZhao,167,79,88,47.31
Ivern,Akali,412,200,212,48.54
Ivern,Caitlyn,811,380,431,46.86
Ivern,Maokai,177,90,87,50.85
Ivern,Tryndamere,152,72,80,47.37
Ivern,Nidalee,88,61,27,69.32
Ivern,Aurora,245,110,135,44.9
Ivern,MissFortune,685,296,389,43.21
Ivern,Nami,412,219,193,53.16
Ivern,Heimerdinger,142,55,87,38.73
Ivern,Viktor,289,148,141,51.21
Ivern,Yasuo,685,318,367,46.42
Ivern,Lulu,479,240,239,50.1
Ivern,Warwick,466,216,250,46.35
Ivern,Mel,613,283,330,46.17
Ivern,Quinn,123,49,74,39.84
Ivern,Teemo,413,175,238,42.37
Ivern,Sett,495,255,240,51.52
Ivern,Lux,728,354,374,48.63
Ivern,Pantheon,442,225,217,50.9
Ivern,Nocturne,366,179,187,48.91
Ivern,Sylas,402,229,173,56.97
Ivern,Aatrox,254,91,163,35.83
Ivern,Vex,175,85,90,48.57
Ivern,Nasus,229,97,132,42.36
Ivern,Briar,183,78,105,42.62
Ivern,Ekko,281,140,141,49.82
Ivern,Zeri,139,59,80,42.45
Ivern,Xerath,258,105,153,40.7
Ivern,Olaf,76,29,47,38.16
Ivern,Nunu,259,120,139,46.33
Ivern,Thresh,462,186,276,40.26
Ivern,Skarner,108,38,70,35.19
Ivern,Fiora,106,62,44,58.49
Ivern,Mordekaiser,417,185,232,44.36
Ivern,Veigar,276,103,173,37.32
Ivern,Elise,248,123,125,49.6
Ivern,Lucian,204,93,111,45.59
Ivern,Senna,272,161,111,59.19
Ivern,Kindred,173,92,81,53.18
Ivern,Blitzcrank,239,99,140,41.42
Ivern,Annie,124,76,48,61.29
Ivern,Bard,127,69,58,54.33
Ivern,MasterYi,350,157,193,44.86
Ivern,Swain,314,138,176,43.95
Ivern,Ambessa,259,117,142,45.17
Ivern,Katarina,270,142,128,52.59
Ivern,Braum,226,76,150,33.63
Ivern,MonkeyKing,232,110,122,47.41
Ivern,Khazix,156,72,84,46.15
Ivern,Jax,234,134,100,57.26
Ivern,Karthus,105,54,51,51.43
Ivern,Malphite,253,127,126,50.2
Ivern,Vi,336,160,176,47.62
Ivern,Smolder,249,91,158,36.55
Ivern,Belveth,93,37,56,39.78
Ivern,Kassadin,89,37,52,41.57
Ivern,Lissandra,77,37,40,48.05
Ivern,Zed,446,235,211,52.69
Ivern,Brand,208,112,96,53.85
Ivern,Varus,280,155,125,55.36
Ivern,Gnar,129,54,75,41.86
Ivern,Gwen,225,110,115,48.89
Ivern,Vladimir,215,118,97,54.88
Ivern,Kaisa,508,267,241,52.56
Ivern,Kayle,186,83,103,44.62
Ivern,Rengar,161,94,67,58.39
Ivern,Ezreal,781,394,387,50.45
Ivern,Illaoi,123,58,65,47.15
Ivern,Evelynn,142,64,78,45.07
Ivern,Gangplank,136,67,69,49.26
Ivern,Orianna,192,91,101,47.4
Ivern,Sivir,220,101,119,45.91
Ivern,Karma,378,176,202,46.56
Ivern,Irelia,260,123,137,47.31
Ivern,Urgot,176,78,98,44.32
Ivern,Rumble,93,45,48,48.39
Ivern,Syndra,223,113,110,50.67
Ivern,Milio,262,104,158,39.69
Ivern,Camille,128,47,81,36.72
Ivern,Ziggs,136,85,51,62.5
Ivern,Corki,147,60,87,40.82
Ivern,Ryze,98,50,48,51.02
Ivern,Jhin,688,286,402,41.57
Ivern,Sona,141,71,70,50.35
Ivern,KogMaw,124,40,84,32.26
Ivern,Darius,643,290,353,45.1
Ivern,Leblanc,160,71,89,44.38
Ivern,Draven,195,104,91,53.33
Ivern,Aphelios,217,128,89,58.99
Ivern,KSante,176,110,66,62.5
Ivern,Vayne,387,209,178,54.01
Ivern,Kled,86,28,58,32.56
Ivern,Anivia,119,66,53,55.46
Ivern,Rell,208,105,103,50.48
Ivern,Kalista,110,73,37,66.36
Ivern,LeeSin,390,177,213,45.38
Ivern,Jayce,180,102,78,56.67
Ivern,Azir,121,51,70,42.15
Ivern,Qiyana,111,40,71,36.04
Ivern,Tristana,315,159,156,50.48
Ivern,Volibear,424,218,206,51.42
Ivern,Kennen,110,54,56,49.09
Ivern,Hwei,239,98,141,41
Ivern,Renata,77,45,32,58.44
Ivern,Sion,247,127,120,51.42
Ivern,Morgana,336,176,160,52.38
Ivern,Malzahar,287,135,152,47.04
Ivern,Neeko,175,97,78,55.43
Ivern,Hecarim,118,62,56,52.54
Ivern,Zilean,88,26,62,29.55
Ivern,DrMundo,213,101,112,47.42
Ivern,Graves,262,154,108,58.78
Ivern,Amumu,294,151,143,51.36
Ivern,Fizz,156,54,102,34.62
Ivern,Trundle,192,86,106,44.79
Ivern,Janna,102,57,45,55.88
Ivern,Yuumi,302,143,159,47.35
Ivern,Zyra,277,107,170,38.63
Ivern,Lillia,170,86,84,50.59
Ivern,Sejuani,143,58,85,40.56
Ivern,Nilah,122,50,72,40.98
Ivern,Zoe,139,70,69,50.36
Ivern,Taliyah,61,40,21,65.57
Ivern,Twitch,246,126,120,51.22
Ivern,Taric,69,36,33,52.17
Ivern,JarvanIV,195,108,87,55.38
Ivern,Singed,95,70,25,73.68
Ivern,Leona,260,163,97,62.69
Ivern,TwistedFate,109,74,35,67.89
Ivern,Xayah,211,88,123,41.71
Ivern,Udyr,116,55,61,47.41
Ivern,AurelionSol,167,62,105,37.13
Ivern,Shyvana,78,41,37,52.56
Ivern,Naafiri,126,51,75,40.48
Ivern,Galio,241,92,149,38.17
Ivern,Cassiopeia,99,48,51,48.48
Ivern,Velkoz,214,98,116,45.79
Ivern,Talon,186,90,96,48.39
Ivern,Renekton,173,96,77,55.49
Ivern,Ornn,118,66,52,55.93
Ivern,RekSai,42,18,24,42.86
Veigar,Yorick,2334,1076,1258,46.1
Veigar,Viego,2851,1456,1395,51.07
Veigar,Diana,3308,1635,1673,49.43
Veigar,Seraphine,1817,917,900,50.47
Veigar,Rakan,900,466,434,51.78
Veigar,Illaoi,1068,563,505,52.72
Veigar,Nunu,1424,739,685,51.9
Veigar,Irelia,1664,912,752,54.81
Veigar,Jhin,3916,1921,1995,49.06
Veigar,Swain,2204,1072,1132,48.64
Veigar,FiddleSticks,972,479,493,49.28
Veigar,Draven,1189,652,537,54.84
Veigar,Smolder,1452,819,633,56.4
Veigar,Nautilus,2342,1240,1102,52.95
Veigar,Kayn,3221,1692,1529,52.53
Veigar,Zed,2140,967,1173,45.19
Veigar,Sona,700,367,333,52.43
Veigar,Kaisa,2897,1535,1362,52.99
Veigar,Amumu,2470,1212,1258,49.07
Veigar,Warwick,3371,1600,1771,47.46
Veigar,Evelynn,898,521,377,58.02
Veigar,Ahri,3042,1615,1427,53.09
Veigar,Yasuo,3954,2034,1920,51.44
Veigar,Yone,3858,2035,1823,52.75
Veigar,Sylas,2435,1222,1213,50.18
Veigar,Caitlyn,5572,2828,2744,50.75
Veigar,MasterYi,2484,1288,1196,51.85
Veigar,Rell,1033,559,474,54.11
Veigar,Darius,3981,2034,1947,51.09
Veigar,Volibear,2442,1209,1233,49.51
Veigar,AurelionSol,1010,475,535,47.03
Veigar,TahmKench,2137,1094,1043,51.19
Veigar,Garen,3377,1685,1692,49.9
Veigar,Tristana,2133,1131,1002,53.02
Veigar,Lux,6026,2999,3027,49.77
Veigar,Morgana,2926,1482,1444,50.65
Veigar,Tryndamere,1245,591,654,47.47
Veigar,Graves,1132,597,535,52.74
Veigar,MissFortune,5133,2631,2502,51.26
Veigar,Leona,1725,885,840,51.3
Veigar,Teemo,3065,1577,1488,51.45
Veigar,Trundle,1169,599,570,51.24
Veigar,Mel,4052,2080,1972,51.33
Veigar,Leblanc,983,483,500,49.14
Veigar,Elise,1273,654,619,51.37
Veigar,Fizz,1568,829,739,52.87
Veigar,Pantheon,3188,1728,1460,54.2
Veigar,Sion,1591,866,725,54.43
Veigar,Ezreal,3873,2007,1866,51.82
Veigar,Nami,2029,1003,1026,49.43
Veigar,Gnar,828,436,392,52.66
Veigar,Malzahar,2153,1029,1124,47.79
Veigar,Brand,1680,811,869,48.27
Veigar,Velkoz,1415,662,753,46.78
Veigar,Samira,1691,912,779,53.93
Veigar,Orianna,859,499,360,58.09
Veigar,Malphite,1974,1049,925,53.14
Veigar,Akali,2168,1160,1008,53.51
Veigar,Shaco,1972,1070,902,54.26
Veigar,Aatrox,1729,913,816,52.81
Veigar,Briar,1664,828,836,49.76
Veigar,Jinx,5513,2704,2809,49.05
Veigar,Nasus,1603,764,839,47.66
Veigar,Nocturne,2290,1112,1178,48.56
Veigar,Aurora,1516,838,678,55.28
Veigar,Neeko,1181,604,577,51.14
Veigar,Heimerdinger,1191,622,569,52.23
Veigar,Sett,3248,1629,1619,50.15
Veigar,Vex,1234,636,598,51.54
Veigar,Senna,1673,849,824,50.75
Veigar,TwistedFate,668,349,319,52.25
Veigar,Annie,711,371,340,52.18
Veigar,Chogath,2765,1305,1460,47.2
Veigar,Talon,1007,546,461,54.22
Veigar,Maokai,875,425,450,48.57
Veigar,Gwen,1061,609,452,57.4
Veigar,Katarina,1937,997,940,51.47
Veigar,XinZhao,1183,535,648,45.22
Veigar,Aphelios,1161,626,535,53.92
Veigar,Braum,1079,556,523,51.53
Veigar,Mordekaiser,3081,1566,1515,50.83
Veigar,Jax,1942,979,963,50.41
Veigar,Janna,582,317,265,54.47
Veigar,Bard,668,375,293,56.14
Veigar,Lillia,1155,553,602,47.88
Veigar,Pyke,1893,1059,834,55.94
Veigar,Ashe,3948,2022,1926,51.22
Veigar,Vladimir,1183,649,534,54.86
Veigar,Thresh,2488,1363,1125,54.78
Veigar,Naafiri,828,488,340,58.94
Veigar,Syndra,1267,634,633,50.04
Veigar,Fiora,749,427,322,57.01
Veigar,Sivir,1096,583,513,53.19
Veigar,Hwei,1457,742,715,50.93
Veigar,Ryze,679,311,368,45.8
Veigar,Belveth,484,289,195,59.71
Veigar,Gragas,1147,637,510,55.54
Veigar,Ekko,1910,1000,910,52.36
Veigar,Shyvana,517,231,286,44.68
Veigar,Taric,430,199,231,46.28
Veigar,Singed,521,260,261,49.9
Veigar,Milio,1108,581,527,52.44
Veigar,Kayle,1531,774,757,50.56
Veigar,Poppy,1139,631,508,55.4
Veigar,Varus,1715,889,826,51.84
Veigar,Skarner,534,297,237,55.62
Veigar,Gangplank,819,424,395,51.77
Veigar,RekSai,254,134,120,52.76
Veigar,Ivern,276,173,103,62.68
Veigar,JarvanIV,1016,459,557,45.18
Veigar,KSante,837,483,354,57.71
Veigar,Rengar,705,361,344,51.21
Veigar,Twitch,1663,834,829,50.15
Veigar,Karma,1706,830,876,48.65
Veigar,Vi,1847,969,878,52.46
Veigar,Vayne,2491,1262,1229,50.66
Veigar,Soraka,1262,618,644,48.97
Veigar,Ornn,803,458,345,57.04
Veigar,LeeSin,2229,1197,1032,53.7
Veigar,Zac,804,371,433,46.14
Veigar,Renekton,983,463,520,47.1
Veigar,Zilean,621,308,313,49.6
Veigar,Jayce,737,380,357,51.56
Veigar,Ziggs,850,397,453,46.71
Veigar,Yuumi,1671,945,726,56.55
Veigar,Nidalee,476,264,212,55.46
Veigar,Kindred,1076,573,503,53.25
Veigar,Ambessa,1074,549,525,51.12
Veigar,Qiyana,538,266,272,49.44
Veigar,Taliyah,428,234,194,54.67
Veigar,Khazix,1014,539,475,53.16
Veigar,Nilah,837,413,424,49.34
Veigar,Viktor,1814,975,839,53.75
Veigar,Kled,379,173,206,45.65
Veigar,DrMundo,1257,642,615,51.07
Veigar,Azir,604,319,285,52.81
Veigar,Anivia,667,294,373,44.08
Veigar,Sejuani,807,421,386,52.17
Veigar,Kassadin,477,218,259,45.7
Veigar,Akshan,740,412,328,55.68
Veigar,Blitzcrank,1580,828,752,52.41
Veigar,Riven,886,513,373,57.9
Veigar,Kennen,655,375,280,57.25
Veigar,Xayah,1112,617,495,55.49
Veigar,Alistar,730,316,414,43.29
Veigar,Corki,726,375,351,51.65
Veigar,KogMaw,636,301,335,47.33
Veigar,Shen,1363,747,616,54.81
Veigar,Galio,1578,825,753,52.28
Veigar,Karthus,550,283,267,51.45
Veigar,MonkeyKing,1331,640,691,48.08
Veigar,Lulu,2111,1095,1016,51.87
Veigar,Udyr,824,473,351,57.4
Veigar,Urgot,1075,582,493,54.14
Veigar,Quinn,711,372,339,52.32
Veigar,Renata,364,214,150,58.79
Veigar,Kalista,758,480,278,63.32
Veigar,Zyra,1640,783,857,47.74
Veigar,Olaf,474,242,232,51.05
Veigar,Zeri,769,452,317,58.78
Veigar,Hecarim,747,461,286,61.71
Veigar,Xerath,1885,942,943,49.97
Veigar,Lucian,1327,720,607,54.26
Veigar,Rammus,629,312,317,49.6
Veigar,Camille,600,338,262,56.33
Veigar,Cassiopeia,665,352,313,52.93
Veigar,Lissandra,534,275,259,51.5
Veigar,Rumble,384,217,167,56.51
Veigar,Zoe,964,494,470,51.24
Jinx,Yorick,4838,2314,2524,47.83
Jinx,Viego,7207,3711,3496,51.49
Jinx,Diana,7711,4061,3650,52.67
Jinx,Seraphine,4284,2123,2161,49.56
Jinx,Rakan,2298,1254,1044,54.57
Jinx,Fiora,2002,1065,937,53.2
Jinx,Lillia,2858,1542,1316,53.95
Jinx,Aurora,3908,2092,1816,53.53
Jinx,Zeri,2325,1239,1086,53.29
Jinx,Naafiri,1822,951,871,52.2
Jinx,Briar,4300,2195,2105,51.05
Jinx,Yone,9288,5015,4273,53.99
Jinx,MissFortune,13928,7043,6885,50.57
Jinx,Senna,4020,2068,1952,51.44
Jinx,Gangplank,2300,1182,1118,51.39
Jinx,Ivern,792,416,376,52.53
Jinx,Mel,10676,5675,5001,53.16
Jinx,Jhin,11114,5819,5295,52.36
Jinx,Swain,5075,2508,2567,49.42
Jinx,Vayne,6740,3573,3167,53.01
Jinx,Nocturne,5868,2854,3014,48.64
Jinx,Kaisa,8878,4701,4177,52.95
Jinx,Galio,4219,2172,2047,51.48
Jinx,Blitzcrank,3685,1987,1698,53.92
Jinx,Garen,7918,4043,3875,51.06
Jinx,Kayn,7614,3921,3693,51.5
Jinx,Lux,12535,6274,6261,50.05
Jinx,Caitlyn,16453,8393,8060,51.01
Jinx,Thresh,6731,3476,3255,51.64
Jinx,Illaoi,2445,1235,1210,50.51
Jinx,Aatrox,4674,2478,2196,53.02
Jinx,Ashe,11890,6060,5830,50.97
Jinx,Aphelios,3571,1868,1703,52.31
Jinx,Gragas,2971,1581,1390,53.21
Jinx,Gwen,2758,1475,1283,53.48
Jinx,Yasuo,9736,4906,4830,50.39
Jinx,Bard,1548,797,751,51.49
Jinx,Vladimir,3295,1664,1631,50.5
Jinx,Shaco,4498,2413,2085,53.65
Jinx,Tryndamere,2999,1522,1477,50.75
Jinx,Ezreal,12180,6513,5667,53.47
Jinx,Milio,2835,1459,1376,51.46
Jinx,Jax,4708,2424,2284,51.49
Jinx,Talon,2891,1559,1332,53.93
Jinx,Leblanc,2747,1466,1281,53.37
Jinx,Yuumi,4143,2163,1980,52.21
Jinx,Malphite,4946,2530,2416,51.15
Jinx,Neeko,2635,1352,1283,51.31
Jinx,Xayah,2656,1438,1218,54.14
Jinx,Heimerdinger,2523,1286,1237,50.97
Jinx,Kindred,2572,1327,1245,51.59
Jinx,Katarina,3827,2034,1793,53.15
Jinx,Janna,1765,840,925,47.59
Jinx,Lissandra,1699,883,816,51.97
Jinx,Darius,9397,4859,4538,51.71
Jinx,Sejuani,1990,989,1001,49.7
Jinx,Rell,2393,1289,1104,53.87
Jinx,Teemo,6331,3182,3149,50.26
Jinx,Amumu,5514,2644,2870,47.95
Jinx,KogMaw,1885,867,1018,45.99
Jinx,FiddleSticks,2468,1319,1149,53.44
Jinx,Soraka,2959,1466,1493,49.54
Jinx,Mordekaiser,6967,3374,3593,48.43
Jinx,Zed,5230,2807,2423,53.67
Jinx,Vex,2849,1518,1331,53.28
Jinx,Samira,4414,2342,2072,53.06
Jinx,Viktor,4476,2253,2223,50.34
Jinx,Nilah,1917,992,925,51.75
Jinx,Akali,5401,2719,2682,50.34
Jinx,Tristana,5344,2700,2644,50.52
Jinx,Evelynn,1974,1044,930,52.89
Jinx,Kalista,1470,798,672,54.29
Jinx,Renata,1026,513,513,50
Jinx,Chogath,6560,3375,3185,51.45
Jinx,Azir,1759,957,802,54.41
Jinx,Sylas,6405,3353,3052,52.35
Jinx,Lucian,3586,1927,1659,53.74
Jinx,MasterYi,6006,2976,3030,49.55
Jinx,Taric,1203,623,580,51.79
Jinx,XinZhao,3042,1552,1490,51.02
Jinx,Morgana,6539,3210,3329,49.09
Jinx,Braum,2706,1344,1362,49.67
Jinx,Annie,1634,846,788,51.77
Jinx,Alistar,2079,1139,940,54.79
Jinx,Pantheon,8108,4393,3715,54.18
Jinx,Khazix,2529,1416,1113,55.99
Jinx,Smolder,3584,1936,1648,54.02
Jinx,Sett,7720,3934,3786,50.96
Jinx,Ekko,4679,2348,2331,50.18
Jinx,Veigar,5513,2809,2704,50.95
Jinx,Nasus,3800,1840,1960,48.42
Jinx,Zoe,2097,1122,975,53.51
Jinx,Jayce,2634,1336,1298,50.72
Jinx,Rammus,1658,873,785,52.65
Jinx,Sion,3836,1937,1899,50.5
Jinx,Kayle,3578,1788,1790,49.97
Jinx,Lulu,5845,3028,2817,51.8
Jinx,Udyr,1973,1054,919,53.42
Jinx,TahmKench,4209,2137,2072,50.77
Jinx,Shyvana,1318,673,645,51.06
Jinx,Taliyah,1295,701,594,54.13
Jinx,Ziggs,2110,1087,1023,51.52
Jinx,LeeSin,6919,3679,3240,53.17
Jinx,Pyke,4609,2350,2259,50.99
Jinx,Irelia,4357,2232,2125,51.23
Jinx,Velkoz,3076,1536,1540,49.93
Jinx,Ahri,6623,3484,3139,52.6
Jinx,Rengar,1811,949,862,52.4
Jinx,Hwei,3347,1751,1596,52.32
Jinx,Sivir,2637,1280,1357,48.54
Jinx,Vi,4836,2464,2372,50.95
Jinx,DrMundo,3106,1599,1507,51.48
Jinx,Twitch,5161,2531,2630,49.04
Jinx,Ryze,1546,799,747,51.68
Jinx,Nautilus,5628,3090,2538,54.9
Jinx,Olaf,1120,543,577,48.48
Jinx,Orianna,2445,1251,1194,51.17
Jinx,Urgot,2644,1352,1292,51.13
Jinx,Hecarim,2154,1194,960,55.43
Jinx,Xerath,4247,2116,2131,49.82
Jinx,Nunu,3041,1573,1468,51.73
Jinx,Syndra,3049,1481,1568,48.57
Jinx,Maokai,2222,1098,1124,49.41
Jinx,Akshan,1858,904,954,48.65
Jinx,Zyra,4495,2201,2294,48.97
Jinx,Warwick,7854,3869,3985,49.26
Jinx,Karthus,1477,793,684,53.69
Jinx,Gnar,2251,1189,1062,52.82
Jinx,Nami,5293,2745,2548,51.86
Jinx,Trundle,2964,1576,1388,53.17
Jinx,RekSai,599,315,284,52.59
Jinx,Graves,3208,1713,1495,53.4
Jinx,Malzahar,5180,2674,2506,51.62
Jinx,KSante,2543,1419,1124,55.8
Jinx,Sona,1771,926,845,52.29
Jinx,Cassiopeia,1529,850,679,55.59
Jinx,Qiyana,1368,730,638,53.36
Jinx,MonkeyKing,3355,1707,1648,50.88
Jinx,Varus,4824,2497,2327,51.76
Jinx,Singed,1391,715,676,51.4
Jinx,Riven,2333,1279,1054,54.82
Jinx,TwistedFate,1695,936,759,55.22
Jinx,Shen,3284,1789,1495,54.48
Jinx,Ornn,2218,1091,1127,49.19
Jinx,Karma,5269,2718,2551,51.58
Jinx,Kled,906,451,455,49.78
Jinx,Renekton,2420,1192,1228,49.26
Jinx,Volibear,5875,2992,2883,50.93
Jinx,Belveth,1264,726,538,57.44
Jinx,AurelionSol,2045,1038,1007,50.76
Jinx,Brand,3642,1957,1685,53.73
Jinx,Nidalee,1365,775,590,56.78
Jinx,Camille,1667,896,771,53.75
Jinx,Leona,4284,2267,2017,52.92
Jinx,Poppy,2983,1523,1460,51.06
Jinx,Kassadin,1080,542,538,50.19
Jinx,Draven,2761,1438,1323,52.08
Jinx,Ambessa,3126,1662,1464,53.17
Jinx,Zilean,1615,788,827,48.79
Jinx,Elise,3347,1759,1588,52.55
Jinx,Zac,2158,1009,1149,46.76
Jinx,Kennen,1401,664,737,47.39
Jinx,Corki,1888,988,900,52.33
Jinx,Skarner,1398,807,591,57.73
Jinx,Anivia,1583,803,780,50.73
Jinx,JarvanIV,2943,1457,1486,49.51
Jinx,Fizz,2794,1403,1391,50.21
Jinx,Quinn,1932,970,962,50.21
Jinx,Rumble,1337,731,606,54.67
Yorick,Sett,2817,1482,1335,52.61
Yorick,Ivern,313,168,145,53.67
Yorick,Veigar,2334,1258,1076,53.9
Yorick,Jinx,4838,2524,2314,52.17
Yorick,Lulu,1958,1032,926,52.71
Yorick,Aatrox,1506,886,620,58.83
Yorick,Brand,1525,763,762,50.03
Yorick,Irelia,1827,976,851,53.42
Yorick,Caitlyn,5292,2937,2355,55.5
Yorick,Milio,1145,567,578,49.52
Yorick,Gangplank,772,386,386,50
Yorick,MasterYi,2431,1359,1072,55.9
Yorick,Mel,4014,2261,1753,56.33
Yorick,Swain,1865,884,981,47.4
Yorick,Warwick,3405,1691,1714,49.66
Yorick,Akali,1890,1014,876,53.65
Yorick,Sona,694,400,294,57.64
Yorick,Heimerdinger,1019,540,479,52.99
Yorick,Talon,992,525,467,52.92
Yorick,Ahri,2598,1440,1158,55.43
Yorick,Kalista,494,319,175,64.57
Yorick,FiddleSticks,817,423,394,51.77
Yorick,Shaco,1869,1049,820,56.13
Yorick,Syndra,1210,637,573,52.64
Yorick,Thresh,2508,1328,1180,52.95
Yorick,Urgot,1246,658,588,52.81
Yorick,Rengar,656,377,279,57.47
Yorick,Ziggs,723,412,311,56.98
Yorick,Trundle,1347,736,611,54.64
Yorick,Fiora,682,375,307,54.99
Yorick,Mordekaiser,2957,1548,1409,52.35
Yorick,Vi,1528,841,687,55.04
Yorick,Cassiopeia,587,326,261,55.54
Yorick,Ezreal,3780,2016,1764,53.33
Yorick,Lux,5119,2880,2239,56.26
Yorick,DrMundo,1066,589,477,55.25
Yorick,Nilah,666,364,302,54.65
Yorick,Yuumi,1476,793,683,53.73
Yorick,Teemo,2836,1473,1363,51.94
Yorick,Leblanc,902,455,447,50.44
Yorick,Elise,1050,593,457,56.48
Yorick,Sylas,1965,957,1008,48.7
Yorick,Nocturne,2136,1014,1122,47.47
Yorick,Rell,964,578,386,59.96
Yorick,Ashe,3602,2052,1550,56.97
Yorick,Briar,1697,870,827,51.27
Yorick,Hwei,1237,680,557,54.97
Yorick,Kaisa,2582,1413,1169,54.73
Yorick,TahmKench,1608,858,750,53.36
Yorick,Zac,839,425,414,50.66
Yorick,Amumu,2158,1163,995,53.89
Yorick,Chogath,2830,1374,1456,48.55
Yorick,Twitch,1651,828,823,50.15
Yorick,Jax,1710,940,770,54.97
Yorick,Graves,983,546,437,55.54
Yorick,Katarina,1491,837,654,56.14
Yorick,Seraphine,1738,976,762,56.16
Yorick,Darius,3624,2014,1610,55.57
Yorick,Neeko,1059,612,447,57.79
Yorick,Taric,422,253,169,59.95
Yorick,Riven,690,371,319,53.77
Yorick,Lillia,1116,563,553,50.45
Yorick,Orianna,902,511,391,56.65
Yorick,Velkoz,1196,619,577,51.76
Yorick,Ambessa,977,548,429,56.09
Yorick,Qiyana,476,254,222,53.36
Yorick,LeeSin,1978,1103,875,55.76
Yorick,Nasus,1550,874,676,56.39
Yorick,Pantheon,2999,1576,1423,52.55
Yorick,Zoe,693,406,287,58.59
Yorick,Senna,1540,881,659,57.21
Yorick,Viego,2626,1457,1169,55.48
Yorick,Skarner,539,321,218,59.55
Yorick,Malphite,1711,932,779,54.47
Yorick,Vladimir,1086,628,458,57.83
Yorick,Tristana,1918,1127,791,58.76
Yorick,Aurora,1287,718,569,55.79
Yorick,MissFortune,4598,2389,2209,51.96
Yorick,Gragas,987,562,425,56.94
Yorick,Rammus,618,278,340,44.98
Yorick,Nami,1971,1050,921,53.27
Yorick,Lissandra,601,325,276,54.08
Yorick,Pyke,1708,986,722,57.73
Yorick,Sejuani,798,418,380,52.38
Yorick,Shen,1209,670,539,55.42
Yorick,MonkeyKing,1192,658,534,55.2
Yorick,Naafiri,774,407,367,52.58
Yorick,Diana,2845,1466,1379,51.53
Yorick,Morgana,2401,1265,1136,52.69
Yorick,Ornn,779,426,353,54.69
Yorick,Karma,1847,904,943,48.94
Yorick,Yone,3621,2023,1598,55.87
Yorick,Jhin,3807,2060,1747,54.11
Yorick,Volibear,2142,1142,1000,53.31
Yorick,Samira,1500,847,653,56.47
Yorick,Rumble,354,201,153,56.78
Yorick,Leona,1587,838,749,52.8
Yorick,Maokai,896,498,398,55.58
Yorick,KSante,737,478,259,64.86
Yorick,Kled,347,174,173,50.14
Yorick,Taliyah,390,222,168,56.92
Yorick,Annie,638,333,305,52.19
Yorick,Blitzcrank,1270,755,515,59.45
Yorick,Viktor,1312,720,592,54.88
Yorick,Karthus,475,288,187,60.63
Yorick,Xayah,927,488,439,52.64
Yorick,Rakan,714,374,340,52.38
Yorick,Fizz,1131,656,475,58
Yorick,Sivir,991,490,501,49.45
Yorick,Zed,1900,1116,784,58.74
Yorick,Nautilus,2196,1147,1049,52.23
Yorick,Zyra,1514,793,721,52.38
Yorick,Vex,1034,544,490,52.61
Yorick,Lucian,1209,669,540,55.33
Yorick,Braum,994,506,488,50.91
Yorick,Kayn,2895,1496,1399,51.68
Yorick,Yasuo,3727,1927,1800,51.7
Yorick,Soraka,1123,609,514,54.23
Yorick,Jayce,876,487,389,55.59
Yorick,AurelionSol,853,414,439,48.53
Yorick,Kayle,1491,745,746,49.97
Yorick,Hecarim,649,391,258,60.25
Yorick,Smolder,1366,760,606,55.64
Yorick,Janna,580,315,265,54.31
Yorick,Tryndamere,1530,817,713,53.4
Yorick,Corki,643,348,295,54.12
Yorick,Aphelios,1185,630,555,53.16
Yorick,TwistedFate,632,362,270,57.28
Yorick,Malzahar,1966,1065,901,54.17
Yorick,XinZhao,1326,654,672,49.32
Yorick,Evelynn,720,410,310,56.94
Yorick,Xerath,1512,769,743,50.86
Yorick,Zeri,732,357,375,48.77
Yorick,Belveth,491,259,232,52.75
Yorick,Khazix,946,580,366,61.31
Yorick,Draven,1036,628,408,60.62
Yorick,Renata,345,172,173,49.86
Yorick,Zilean,540,280,260,51.85
Yorick,Kennen,463,264,199,57.02
Yorick,Bard,587,336,251,57.24
Yorick,Sion,1555,779,776,50.1
Yorick,Gwen,1239,726,513,58.6
Yorick,Galio,1489,803,686,53.93
Yorick,Shyvana,558,298,260,53.41
Yorick,Camille,512,331,181,64.65
Yorick,Poppy,1004,542,462,53.98
Yorick,Azir,578,340,238,58.82
Yorick,Illaoi,1055,607,448,57.54
Yorick,Vayne,2366,1279,1087,54.06
Yorick,Ekko,1748,994,754,56.86
Yorick,Alistar,692,391,301,56.5
Yorick,KogMaw,623,351,272,56.34
Yorick,Gnar,754,425,329,56.37
Yorick,JarvanIV,1036,507,529,48.94
Yorick,Anivia,607,306,301,50.41
Yorick,Kassadin,349,155,194,44.41
Yorick,Udyr,749,453,296,60.48
Yorick,Nidalee,436,261,175,59.86
Yorick,Quinn,696,371,325,53.3
Yorick,Garen,2903,1553,1350,53.5
Yorick,Singed,510,291,219,57.06
Yorick,Nunu,1355,713,642,52.62
Yorick,Renekton,1008,566,442,56.15
Yorick,Varus,1680,907,773,53.99
Yorick,RekSai,220,133,87,60.45
Yorick,Ryze,611,326,285,53.36
Yorick,Kindred,889,464,425,52.19
Yorick,Akshan,757,437,320,57.73
Yorick,Olaf,349,211,138,60.46
Seraphine,Sett,2740,1271,1469,46.39
Seraphine,Ivern,234,130,104,55.56
Seraphine,Veigar,1817,900,917,49.53
Seraphine,Jinx,4284,2161,2123,50.44
Seraphine,Lulu,1938,1093,845,56.4
Seraphine,Taliyah,339,156,183,46.02
Seraphine,Cassiopeia,526,262,264,49.81
Seraphine,Kaisa,2434,1259,1175,51.73
Seraphine,Neeko,1199,639,560,53.29
Seraphine,Sylas,2085,1060,1025,50.84
Seraphine,Ezreal,3228,1637,1591,50.71
Seraphine,Morgana,2474,1217,1257,49.19
Seraphine,Irelia,1472,803,669,54.55
Seraphine,Diana,2460,1180,1280,47.97
Seraphine,Lux,5686,2798,2888,49.21
Seraphine,Tristana,1628,755,873,46.38
Seraphine,Mel,3246,1675,1571,51.6
Seraphine,Mordekaiser,2459,1179,1280,47.95
Seraphine,Vi,1393,706,687,50.68
Seraphine,Chogath,1966,1012,954,51.48
Seraphine,Yasuo,3191,1545,1646,48.42
Seraphine,Jhin,3220,1583,1637,49.16
Seraphine,Graves,826,425,401,51.45
Seraphine,Leblanc,799,408,391,51.06
Seraphine,Caitlyn,4657,2432,2225,52.22
Seraphine,Milio,981,411,570,41.9
Seraphine,Teemo,2266,1099,1167,48.5
Seraphine,Poppy,921,483,438,52.44
Seraphine,Akali,1833,976,857,53.25
Seraphine,Leona,1386,692,694,49.93
Seraphine,Thresh,2108,1155,953,54.79
Seraphine,FiddleSticks,891,399,492,44.78
Seraphine,Zed,1585,812,773,51.23
Seraphine,Viktor,1218,625,593,51.31
Seraphine,Pyke,1392,674,718,48.42
Seraphine,Yorick,1738,762,976,43.84
Seraphine,Nunu,1164,575,589,49.4
Seraphine,Draven,845,411,434,48.64
Seraphine,KogMaw,532,265,267,49.81
Seraphine,Yuumi,1349,692,657,51.3
Seraphine,Riven,713,383,330,53.72
Seraphine,Volibear,2121,999,1122,47.1
Seraphine,Syndra,861,437,424,50.75
Seraphine,Sejuani,676,336,340,49.7
Seraphine,LeeSin,1897,994,903,52.4
Seraphine,Twitch,1493,736,757,49.3
Seraphine,Sion,1233,525,708,42.58
Seraphine,Zac,644,344,300,53.42
Seraphine,AurelionSol,735,386,349,52.52
Seraphine,Gnar,611,326,285,53.36
Seraphine,Rammus,491,251,240,51.12
Seraphine,Akshan,600,297,303,49.5
Seraphine,Ashe,3134,1647,1487,52.55
Seraphine,RekSai,232,119,113,51.29
Seraphine,Hwei,1182,543,639,45.94
Seraphine,Braum,846,428,418,50.59
Seraphine,Pantheon,2787,1338,1449,48.01
Seraphine,Kindred,781,422,359,54.03
Seraphine,Lucian,950,486,464,51.16
Seraphine,Zyra,1528,738,790,48.3
Seraphine,Gangplank,662,297,365,44.86
Seraphine,MasterYi,1919,959,960,49.97
Seraphine,Yone,3011,1513,1498,50.25
Seraphine,Swain,1664,827,837,49.7
Seraphine,Kayle,1351,653,698,48.33
Seraphine,Aurora,1313,684,629,52.09
Seraphine,Viego,2278,1055,1223,46.31
Seraphine,Velkoz,1166,576,590,49.4
Seraphine,Briar,1529,758,771,49.57
Seraphine,Soraka,1021,530,491,51.91
Seraphine,DrMundo,1013,514,499,50.74
Seraphine,Jax,1484,775,709,52.22
Seraphine,Vayne,1843,943,900,51.17
Seraphine,Malzahar,1690,842,848,49.82
Seraphine,Darius,3160,1620,1540,51.27
Seraphine,Warwick,2847,1386,1461,48.68
Seraphine,Zilean,397,193,204,48.61
Seraphine,Shaco,1604,789,815,49.19
Seraphine,Ekko,1452,731,721,50.34
Seraphine,Shyvana,488,234,254,47.95
Seraphine,Garen,2626,1272,1354,48.44
Seraphine,KSante,719,409,310,56.88
Seraphine,Evelynn,696,371,325,53.3
Seraphine,Sivir,880,444,436,50.45
Seraphine,Vladimir,906,407,499,44.92
Seraphine,Talon,888,429,459,48.31
Seraphine,Varus,1410,703,707,49.86
Seraphine,Nilah,745,393,352,52.75
Seraphine,Nasus,1381,648,733,46.92
Seraphine,Zeri,546,270,276,49.45
Seraphine,Xerath,1267,628,639,49.57
Seraphine,Aatrox,1487,828,659,55.68
Seraphine,XinZhao,1083,494,589,45.61
Seraphine,Rell,778,364,414,46.79
Seraphine,Camille,559,273,286,48.84
Seraphine,Rengar,590,343,247,58.14
Seraphine,Amumu,1785,844,941,47.28
Seraphine,MissFortune,4197,1990,2207,47.41
Seraphine,Heimerdinger,1017,438,579,43.07
Seraphine,Katarina,1293,702,591,54.29
Seraphine,Belveth,398,225,173,56.53
Seraphine,Ahri,2276,1139,1137,50.04
Seraphine,Aphelios,966,504,462,52.17
Seraphine,Anivia,569,268,301,47.1
Seraphine,Urgot,897,431,466,48.05
Seraphine,Trundle,1118,533,585,47.67
Seraphine,Xayah,835,426,409,51.02
Seraphine,Blitzcrank,1237,552,685,44.62
Seraphine,Zoe,624,315,309,50.48
Seraphine,Rakan,762,403,359,52.89
Seraphine,Rumble,318,174,144,54.72
Seraphine,Nautilus,1745,876,869,50.2
Seraphine,Samira,1631,762,869,46.72
Seraphine,Galio,1324,659,665,49.77
Seraphine,Senna,1435,693,742,48.29
Seraphine,Kennen,458,244,214,53.28
Seraphine,Khazix,958,475,483,49.58
Seraphine,Orianna,702,336,366,47.86
Seraphine,Nocturne,1895,898,997,47.39
Seraphine,Elise,1002,522,480,52.1
Seraphine,Maokai,823,401,422,48.72
Seraphine,Smolder,1085,597,488,55.02
Seraphine,Gragas,777,395,382,50.84
Seraphine,Ryze,484,275,209,56.82
Seraphine,Tryndamere,878,421,457,47.95
Seraphine,Ambessa,909,435,474,47.85
Seraphine,Fiora,705,345,360,48.94
Seraphine,Brand,1348,622,726,46.14
Seraphine,Fizz,978,482,496,49.28
Seraphine,Gwen,976,523,453,53.59
Seraphine,Karma,1713,862,851,50.32
Seraphine,Shen,992,477,515,48.08
Seraphine,Malphite,1679,803,876,47.83
Seraphine,Kayn,2454,1236,1218,50.37
Seraphine,Kled,323,146,177,45.2
Seraphine,Janna,506,249,257,49.21
Seraphine,Nami,1591,783,808,49.21
Seraphine,Kassadin,368,167,201,45.38
Seraphine,MonkeyKing,960,502,458,52.29
Seraphine,Lissandra,490,227,263,46.33
Seraphine,JarvanIV,789,378,411,47.91
Seraphine,Sona,687,293,394,42.65
Seraphine,Lillia,948,453,495,47.78
Seraphine,Udyr,634,312,322,49.21
Seraphine,Vex,1015,509,506,50.15
Seraphine,Ziggs,739,366,373,49.53
Seraphine,Quinn,672,336,336,50
Seraphine,Renekton,739,352,387,47.63
Seraphine,Singed,487,196,291,40.25
Seraphine,Skarner,491,271,220,55.19
Seraphine,Illaoi,788,380,408,48.22
Seraphine,Qiyana,420,228,192,54.29
Seraphine,TahmKench,1522,791,731,51.97
Seraphine,Kalista,526,278,248,52.85
Seraphine,Annie,458,229,229,50
Seraphine,Renata,301,143,158,47.51
Seraphine,Nidalee,428,260,168,60.75
Seraphine,Karthus,410,226,184,55.12
Seraphine,Corki,527,281,246,53.32
Seraphine,Jayce,671,365,306,54.4
Seraphine,TwistedFate,563,306,257,54.35
Seraphine,Hecarim,565,315,250,55.75
Seraphine,Azir,526,293,233,55.7
Seraphine,Bard,477,234,243,49.06
Seraphine,Alistar,470,228,242,48.51
Seraphine,Naafiri,737,405,332,54.95
Seraphine,Olaf,343,170,173,49.56
Seraphine,Ornn,737,375,362,50.88
Seraphine,Taric,326,188,138,57.67
Rakan,Sett,1306,658,648,50.38
Rakan,Ivern,138,89,49,64.49
Rakan,Veigar,900,434,466,48.22
Rakan,Jinx,2298,1044,1254,45.43
Rakan,Lulu,1059,506,553,47.78
Rakan,Leblanc,496,205,291,41.33
Rakan,Briar,726,372,354,51.24
Rakan,Zoe,354,201,153,56.78
Rakan,Poppy,786,417,369,53.05
Rakan,DrMundo,506,252,254,49.8
Rakan,Belveth,216,103,113,47.69
Rakan,Anivia,303,170,133,56.11
Rakan,Vladimir,681,355,326,52.13
Rakan,Evelynn,437,252,185,57.67
Rakan,Yasuo,1738,906,832,52.13
Rakan,Tristana,810,398,412,49.14
Rakan,Yuumi,805,432,373,53.66
Rakan,Akali,1022,559,463,54.7
Rakan,Rammus,317,164,153,51.74
Rakan,Zyra,650,261,389,40.15
Rakan,Mordekaiser,1134,536,598,47.27
Rakan,Diana,1242,636,606,51.21
Rakan,Lux,2239,1132,1107,50.56
Rakan,MissFortune,1936,900,1036,46.49
Rakan,Karma,996,488,508,49
Rakan,Caitlyn,2161,1027,1134,47.52
Rakan,Vi,895,434,461,48.49
Rakan,Orianna,405,211,194,52.1
Rakan,Draven,443,271,172,61.17
Rakan,Xayah,505,267,238,52.87
Rakan,Senna,781,402,379,51.47
Rakan,Jax,820,444,376,54.15
Rakan,Ahri,1197,575,622,48.04
Rakan,Aphelios,508,253,255,49.8
Rakan,Aurora,744,411,333,55.24
Rakan,FiddleSticks,436,188,248,43.12
Rakan,Jhin,1732,925,807,53.41
Rakan,Vex,552,264,288,47.83
Rakan,Samira,697,410,287,58.82
Rakan,Neeko,513,262,251,51.07
Rakan,Aatrox,906,441,465,48.68
Rakan,Gragas,473,230,243,48.63
Rakan,Cassiopeia,296,130,166,43.92
Rakan,Irelia,726,388,338,53.44
Rakan,Yone,1736,875,861,50.4
Rakan,Mel,2067,1058,1009,51.19
Rakan,Ezreal,2023,1015,1008,50.17
Rakan,Elise,784,384,400,48.98
Rakan,Nasus,614,313,301,50.98
Rakan,Amumu,892,412,480,46.19
Rakan,Naafiri,326,188,138,57.67
Rakan,Xerath,667,324,343,48.58
Rakan,Malphite,896,456,440,50.89
Rakan,Blitzcrank,665,397,268,59.7
Rakan,XinZhao,585,242,343,41.37
Rakan,Qiyana,267,158,109,59.18
Rakan,AurelionSol,366,189,177,51.64
Rakan,Teemo,948,488,460,51.48
Rakan,Sylas,1225,606,619,49.47
Rakan,Varus,773,409,364,52.91
Rakan,Yorick,714,340,374,47.62
Rakan,Volibear,861,451,410,52.38
Rakan,Azir,319,151,168,47.34
Rakan,Thresh,1410,683,727,48.44
Rakan,Illaoi,450,209,241,46.44
Rakan,Nocturne,899,463,436,51.5
Rakan,Ryze,306,156,150,50.98
Rakan,Kayn,1372,696,676,50.73
Rakan,Morgana,1083,517,566,47.74
Rakan,Darius,1677,875,802,52.18
Rakan,Taliyah,244,125,119,51.23
Rakan,LeeSin,1329,696,633,52.37
Rakan,Kayle,584,304,280,52.05
Rakan,Seraphine,762,359,403,47.11
Rakan,Garen,1552,725,827,46.71
Rakan,Nunu,565,284,281,50.27
Rakan,Rell,495,244,251,49.29
Rakan,Ashe,1723,852,871,49.45
Rakan,Swain,885,396,489,44.75
Rakan,Riven,419,183,236,43.68
Rakan,Talon,521,294,227,56.43
Rakan,Viktor,682,348,334,51.03
Rakan,Sona,300,152,148,50.67
Rakan,Ornn,416,208,208,50
Rakan,Ziggs,356,206,150,57.87
Rakan,Galio,741,344,397,46.42
Rakan,Velkoz,593,307,286,51.77
Rakan,Leona,655,324,331,49.47
Rakan,Twitch,707,385,322,54.46
Rakan,Brand,518,276,242,53.28
Rakan,Shaco,753,375,378,49.8
Rakan,Kalista,287,166,121,57.84
Rakan,Gwen,510,328,182,64.31
Rakan,Kindred,385,201,184,52.21
Rakan,JarvanIV,442,235,207,53.17
Rakan,Gnar,355,173,182,48.73
Rakan,Renekton,425,220,205,51.76
Rakan,Graves,598,298,300,49.83
Rakan,Lucian,675,313,362,46.37
Rakan,Pantheon,1527,706,821,46.23
Rakan,Warwick,1269,600,669,47.28
Rakan,Zed,1002,556,446,55.49
Rakan,Vayne,1143,566,577,49.52
Rakan,Janna,315,132,183,41.9
Rakan,Katarina,727,395,332,54.33
Rakan,Khazix,523,245,278,46.85
Rakan,Zilean,283,151,132,53.36
Rakan,Kennen,257,126,131,49.03
Rakan,TahmKench,771,408,363,52.92
Rakan,Kled,149,73,76,48.99
Rakan,KogMaw,251,147,104,58.57
Rakan,Quinn,295,155,140,52.54
Rakan,MasterYi,1047,511,536,48.81
Rakan,Kassadin,189,114,75,60.32
Rakan,Kaisa,1553,876,677,56.41
Rakan,Fizz,453,223,230,49.23
Rakan,Sivir,445,210,235,47.19
Rakan,Taric,156,76,80,48.72
Rakan,Urgot,414,203,211,49.03
Rakan,Nautilus,973,553,420,56.83
Rakan,Singed,230,109,121,47.39
Rakan,Shyvana,263,146,117,55.51
Rakan,Pyke,891,465,426,52.19
Rakan,Fiora,350,205,145,58.57
Rakan,Smolder,658,319,339,48.48
Rakan,Lillia,523,284,239,54.3
Rakan,Lissandra,274,125,149,45.62
Rakan,Braum,573,322,251,56.2
Rakan,Gangplank,374,181,193,48.4
Rakan,Chogath,1212,591,621,48.76
Rakan,Rengar,383,235,148,61.36
Rakan,RekSai,137,61,76,44.53
Rakan,Sion,730,352,378,48.22
Rakan,Sejuani,338,168,170,49.7
Rakan,Ambessa,584,370,214,63.36
Rakan,KSante,454,216,238,47.58
Rakan,Nami,957,451,506,47.13
Rakan,Ekko,802,433,369,53.99
Rakan,Heimerdinger,397,191,206,48.11
Rakan,Camille,303,184,119,60.73
Rakan,Shen,582,260,322,44.67
Rakan,Skarner,269,126,143,46.84
Rakan,Syndra,608,276,332,45.39
Rakan,Udyr,345,182,163,52.75
Rakan,Alistar,370,171,199,46.22
Rakan,Malzahar,818,407,411,49.76
Rakan,Trundle,502,238,264,47.41
Rakan,Soraka,493,225,268,45.64
Rakan,Nidalee,262,167,95,63.74
Rakan,MonkeyKing,599,291,308,48.58
Rakan,Renata,196,59,137,30.1
Rakan,TwistedFate,368,208,160,56.52
Rakan,Viego,1259,563,696,44.72
Rakan,Milio,473,217,256,45.88
Rakan,Zac,386,186,200,48.19
Rakan,Tryndamere,503,226,277,44.93
Rakan,Nilah,301,178,123,59.14
Rakan,Hwei,610,316,294,51.8
Rakan,Annie,312,167,145,53.53
Rakan,Jayce,503,231,272,45.92
Rakan,Karthus,292,161,131,55.14
Rakan,Bard,351,173,178,49.29
Rakan,Zeri,360,180,180,50
Rakan,Corki,385,212,173,55.06
Rakan,Akshan,359,190,169,52.92
Rakan,Rumble,272,148,124,54.41
Rakan,Hecarim,316,131,185,41.46
Rakan,Maokai,403,229,174,56.82
Rakan,Olaf,231,139,92,60.17
Lillia,Leblanc,668,298,370,44.61
Lillia,Briar,1023,460,563,44.97
Lillia,Zoe,444,233,211,52.48
Lillia,Jinx,2858,1316,1542,46.05
Lillia,Poppy,812,411,401,50.62
Lillia,Gangplank,450,194,256,43.11
Lillia,Gragas,664,373,291,56.17
Lillia,TwistedFate,446,221,225,49.55
Lillia,Lucian,734,420,314,57.22
Lillia,Leona,990,457,533,46.16
Lillia,Heimerdinger,636,304,332,47.8
Lillia,Kindred,615,301,314,48.94
Lillia,Katarina,854,452,402,52.93
Lillia,Caitlyn,3059,1477,1582,48.28
Lillia,Janna,361,194,167,53.74
Lillia,Vladimir,673,375,298,55.72
Lillia,Diana,1785,817,968,45.77
Lillia,Akali,1296,657,639,50.69
Lillia,Karma,1182,586,596,49.58
Lillia,Pantheon,1904,877,1027,46.06
Lillia,Garen,1950,952,998,48.82
Lillia,Ziggs,436,190,246,43.58
Lillia,Zeri,471,249,222,52.87
Lillia,Zyra,953,478,475,50.16
Lillia,Darius,2216,1042,1174,47.02
Lillia,Sejuani,557,314,243,56.37
Lillia,Mel,2294,1238,1056,53.97
Lillia,Jhin,2262,1188,1074,52.52
Lillia,Rell,654,308,346,47.09
Lillia,Yorick,1116,553,563,49.55
Lillia,MasterYi,1088,507,581,46.6
Lillia,Irelia,1032,516,516,50
Lillia,Shen,764,388,376,50.79
Lillia,Nami,943,421,522,44.64
Lillia,Teemo,1450,699,751,48.21
Lillia,Warwick,1740,850,890,48.85
Lillia,Samira,845,459,386,54.32
Lillia,Lux,2763,1254,1509,45.39
Lillia,Tryndamere,640,347,293,54.22
Lillia,Sivir,572,268,304,46.85
Lillia,Soraka,625,348,277,55.68
Lillia,Malphite,1134,581,553,51.23
Lillia,MonkeyKing,732,355,377,48.5
Lillia,Sylas,1480,800,680,54.05
Lillia,Swain,1318,644,674,48.86
Lillia,Senna,973,433,540,44.5
Lillia,Kayle,810,346,464,42.72
Lillia,Kayn,1726,861,865,49.88
Lillia,Yasuo,2253,1185,1068,52.6
Lillia,Ezreal,2607,1350,1257,51.78
Lillia,Morgana,1481,698,783,47.13
Lillia,DrMundo,891,469,422,52.64
Lillia,Ekko,1133,577,556,50.93
Lillia,Zed,1202,626,576,52.08
Lillia,Lulu,1324,710,614,53.63
Lillia,Gwen,547,260,287,47.53
Lillia,Maokai,552,271,281,49.09
Lillia,Veigar,1155,602,553,52.12
Lillia,Brand,824,403,421,48.91
Lillia,Aatrox,1037,471,566,45.42
Lillia,Ashe,2316,1213,1103,52.37
Lillia,Chogath,1605,889,716,55.39
Lillia,Kennen,362,169,193,46.69
Lillia,Shaco,1030,492,538,47.77
Lillia,Kaisa,1824,905,919,49.62
Lillia,Sona,446,201,245,45.07
Lillia,Fiora,427,202,225,47.31
Lillia,Nunu,874,445,429,50.92
Lillia,Aphelios,701,340,361,48.5
Lillia,LeeSin,1705,956,749,56.07
Lillia,MissFortune,2720,1312,1408,48.24
Lillia,Xayah,564,317,247,56.21
Lillia,Volibear,1390,689,701,49.57
Lillia,Jax,1124,610,514,54.27
Lillia,Taliyah,301,155,146,51.5
Lillia,Twitch,924,452,472,48.92
Lillia,KSante,632,391,241,61.87
Lillia,Graves,667,319,348,47.83
Lillia,Taric,235,128,107,54.47
Lillia,Vi,1120,554,566,49.46
Lillia,Sion,949,506,443,53.32
Lillia,Skarner,433,256,177,59.12
Lillia,Xerath,894,423,471,47.32
Lillia,Jayce,539,253,286,46.94
Lillia,Kalista,368,197,171,53.53
Lillia,Neeko,625,324,301,51.84
Lillia,XinZhao,693,314,379,45.31
Lillia,Tristana,1061,526,535,49.58
Lillia,Hecarim,509,243,266,47.74
Lillia,Malzahar,1052,538,514,51.14
Lillia,Fizz,625,315,310,50.4
Lillia,Pyke,975,518,457,53.13
Lillia,Illaoi,516,251,265,48.64
Lillia,Ahri,1533,800,733,52.19
Lillia,Talon,680,298,382,43.82
Lillia,Nocturne,1306,613,693,46.94
Lillia,Trundle,595,255,340,42.86
Lillia,Yone,2206,1108,1098,50.23
Lillia,Kled,181,60,121,33.15
Lillia,Aurora,914,441,473,48.25
Lillia,Thresh,1674,830,844,49.58
Lillia,Zilean,358,175,183,48.88
Lillia,Gnar,441,259,182,58.73
Lillia,Viktor,979,470,509,48.01
Lillia,Syndra,703,306,397,43.53
Lillia,Mordekaiser,1595,741,854,46.46
Lillia,Akshan,419,206,213,49.16
Lillia,Amumu,1240,647,593,52.18
Lillia,Azir,409,221,188,54.03
Lillia,AurelionSol,520,303,217,58.27
Lillia,Milio,697,333,364,47.78
Lillia,Ambessa,760,390,370,51.32
Lillia,Khazix,677,323,354,47.71
Lillia,Viego,1679,851,828,50.68
Lillia,Olaf,326,168,158,51.53
Lillia,Yuumi,912,450,462,49.34
Lillia,Naafiri,423,193,230,45.63
Lillia,Orianna,472,254,218,53.81
Lillia,Renekton,619,318,301,51.37
Lillia,Seraphine,948,495,453,52.22
Lillia,JarvanIV,622,312,310,50.16
Lillia,Galio,1056,481,575,45.55
Lillia,FiddleSticks,618,306,312,49.51
Lillia,Varus,995,494,501,49.65
Lillia,Elise,722,338,384,46.81
Lillia,Ryze,316,145,171,45.89
Lillia,TahmKench,1140,609,531,53.42
Lillia,Kassadin,303,156,147,51.49
Lillia,Lissandra,375,149,226,39.73
Lillia,Sett,1740,885,855,50.86
Lillia,Alistar,445,222,223,49.89
Lillia,Draven,619,289,330,46.69
Lillia,Singed,342,167,175,48.83
Lillia,Annie,380,181,199,47.63
Lillia,Vayne,1399,654,745,46.75
Lillia,Braum,603,304,299,50.41
Lillia,Evelynn,534,278,256,52.06
Lillia,Zac,673,353,320,52.45
Lillia,Udyr,522,249,273,47.7
Lillia,KogMaw,387,180,207,46.51
Lillia,Vex,740,397,343,53.65
Lillia,Smolder,787,400,387,50.83
Lillia,Rakan,523,239,284,45.7
Lillia,Corki,403,219,184,54.34
Lillia,Hwei,718,355,363,49.44
Lillia,Anivia,313,108,205,34.5
Lillia,Rammus,452,241,211,53.32
Lillia,Nautilus,1311,687,624,52.4
Lillia,Riven,468,263,205,56.2
Lillia,Renata,189,107,82,56.61
Lillia,Shyvana,323,157,166,48.61
Lillia,Blitzcrank,986,531,455,53.85
Lillia,Cassiopeia,394,184,210,46.7
Lillia,Rengar,347,199,148,57.35
Lillia,Nasus,870,466,404,53.56
Lillia,Nilah,515,283,232,54.95
Lillia,Ornn,479,256,223,53.44
Lillia,Karthus,333,152,181,45.65
Lillia,Rumble,266,120,146,45.11
Lillia,Quinn,433,193,240,44.57
Lillia,Ivern,170,84,86,49.41
Lillia,Urgot,520,291,229,55.96
Lillia,Qiyana,337,164,173,48.66
Lillia,Camille,381,139,242,36.48
Lillia,Bard,373,176,197,47.18
Lillia,Nidalee,291,152,139,52.23
Lillia,Velkoz,610,254,356,41.64
Lillia,Belveth,235,131,104,55.74
Lillia,RekSai,156,75,81,48.08
Zeri,Leblanc,500,249,251,49.8
Zeri,Briar,641,293,348,45.71
Zeri,Zoe,378,194,184,51.32
Zeri,Jinx,2325,1086,1239,46.71
Zeri,Poppy,686,324,362,47.23
Zeri,Warwick,1212,583,629,48.1
Zeri,Katarina,613,259,354,42.25
Zeri,Twitch,660,305,355,46.21
Zeri,Morgana,927,397,530,42.83
Zeri,Riven,412,217,195,52.67
Zeri,Nocturne,951,525,426,55.21
Zeri,Lulu,1069,549,520,51.36
Zeri,Gnar,367,197,170,53.68
Zeri,Viego,1137,527,610,46.35
Zeri,Yone,1635,883,752,54.01
Zeri,Kaisa,1427,732,695,51.3
Zeri,TahmKench,656,335,321,51.07
Zeri,Irelia,684,297,387,43.42
Zeri,Lillia,471,222,249,47.13
Zeri,Sylas,1147,543,604,47.34
Zeri,Caitlyn,1875,934,941,49.81
Zeri,Lux,1777,868,909,48.85
Zeri,Teemo,1054,538,516,51.04
Zeri,LeeSin,1397,695,702,49.75
Zeri,Chogath,1037,469,568,45.23
Zeri,Lucian,698,370,328,53.01
Zeri,Xerath,606,284,322,46.86
Zeri,Gragas,538,290,248,53.9
Zeri,Rell,437,216,221,49.43
Zeri,Heimerdinger,358,187,171,52.23
Zeri,Mordekaiser,1027,447,580,43.52
Zeri,Ashe,1656,788,868,47.58
Zeri,Pyke,813,428,385,52.64
Zeri,Gwen,441,267,174,60.54
Zeri,RekSai,111,52,59,46.85
Zeri,Gangplank,390,231,159,59.23
Zeri,Leona,826,428,398,51.82
Zeri,Sett,1185,544,641,45.91
Zeri,Orianna,397,218,179,54.91
Zeri,Draven,446,242,204,54.26
Zeri,Nautilus,1001,498,503,49.75
Zeri,Urgot,429,196,233,45.69
Zeri,Shaco,775,406,369,52.39
Zeri,Annie,314,162,152,51.59
Zeri,Ezreal,2180,1148,1032,52.66
Zeri,Quinn,250,123,127,49.2
Zeri,Yasuo,1499,757,742,50.5
Zeri,MissFortune,1751,885,866,50.54
Zeri,Neeko,485,273,212,56.29
Zeri,Renekton,474,255,219,53.8
Zeri,Hecarim,369,187,182,50.68
Zeri,Viktor,725,328,397,45.24
Zeri,Jhin,1566,799,767,51.02
Zeri,Tryndamere,413,212,201,51.33
Zeri,Ivern,139,80,59,57.55
Zeri,Seraphine,546,276,270,50.55
Zeri,Kayle,510,225,285,44.12
Zeri,FiddleSticks,433,223,210,51.5
Zeri,Taric,179,85,94,47.49
Zeri,Camille,323,157,166,48.61
Zeri,Rengar,369,204,165,55.28
Zeri,Aatrox,853,444,409,52.05
Zeri,MasterYi,837,438,399,52.33
Zeri,Xayah,529,244,285,46.12
Zeri,Hwei,595,264,331,44.37
Zeri,Zed,870,375,495,43.1
Zeri,Blitzcrank,662,331,331,50
Zeri,Ambessa,633,332,301,52.45
Zeri,Singed,246,108,138,43.9
Zeri,Talon,547,240,307,43.88
Zeri,Ekko,730,404,326,55.34
Zeri,Tristana,718,360,358,50.14
Zeri,Soraka,501,241,260,48.1
Zeri,Nasus,645,289,356,44.81
Zeri,Aurora,703,361,342,51.35
Zeri,Vayne,988,444,544,44.94
Zeri,MonkeyKing,478,249,229,52.09
Zeri,Samira,678,340,338,50.15
Zeri,Volibear,909,428,481,47.08
Zeri,Graves,503,259,244,51.49
Zeri,Ahri,1139,562,577,49.34
Zeri,Yorick,732,375,357,51.23
Zeri,Velkoz,490,236,254,48.16
Zeri,DrMundo,429,195,234,45.45
Zeri,Shen,500,245,255,49
Zeri,Fizz,409,225,184,55.01
Zeri,Yuumi,724,342,382,47.24
Zeri,Vi,957,418,539,43.68
Zeri,Swain,716,304,412,42.46
Zeri,Akali,915,433,482,47.32
Zeri,Kindred,390,172,218,44.1
Zeri,Naafiri,250,94,156,37.6
Zeri,Milio,502,285,217,56.77
Zeri,Fiora,335,193,142,57.61
Zeri,Elise,538,261,277,48.51
Zeri,Pantheon,1239,607,632,48.99
Zeri,Malzahar,745,331,414,44.43
Zeri,Darius,1374,631,743,45.92
Zeri,Udyr,341,169,172,49.56
Zeri,Cassiopeia,320,136,184,42.5
Zeri,Nami,812,370,442,45.57
Zeri,Illaoi,320,161,159,50.31
Zeri,Rammus,229,135,94,58.95
Zeri,Kennen,230,118,112,51.3
Zeri,Mel,1759,885,874,50.31
Zeri,Zyra,823,429,394,52.13
Zeri,Vladimir,545,274,271,50.28
Zeri,Khazix,516,297,219,57.56
Zeri,Thresh,1187,576,611,48.53
Zeri,Sejuani,329,146,183,44.38
Zeri,Renata,144,68,76,47.22
Zeri,Corki,365,173,192,47.4
Zeri,Bard,300,159,141,53
Zeri,Zac,418,209,209,50
Zeri,Akshan,317,139,178,43.85
Zeri,Ziggs,291,157,134,53.95
Zeri,Kayn,1038,514,524,49.52
Zeri,Smolder,631,335,296,53.09
Zeri,AurelionSol,326,156,170,47.85
Zeri,Garen,1292,583,709,45.12
Zeri,Evelynn,287,142,145,49.48
Zeri,Karma,1023,461,562,45.06
Zeri,Kalista,245,115,130,46.94
Zeri,Azir,371,240,131,64.69
Zeri,Vex,435,218,217,50.11
Zeri,Galio,793,364,429,45.9
Zeri,Varus,857,408,449,47.61
Zeri,Veigar,769,317,452,41.22
Zeri,KSante,513,293,220,57.12
Zeri,Jax,780,340,440,43.59
Zeri,Ornn,334,167,167,50
Zeri,Qiyana,278,138,140,49.64
Zeri,Sona,216,86,130,39.81
Zeri,Sion,683,327,356,47.88
Zeri,Alistar,423,204,219,48.23
Zeri,Sivir,434,184,250,42.4
Zeri,Trundle,399,199,200,49.87
Zeri,Belveth,207,97,110,46.86
Zeri,Amumu,769,331,438,43.04
Zeri,Brand,452,213,239,47.12
Zeri,Janna,300,156,144,52
Zeri,Nilah,306,136,170,44.44
Zeri,Diana,1258,616,642,48.97
Zeri,Lissandra,231,93,138,40.26
Zeri,Aphelios,546,260,286,47.62
Zeri,Malphite,805,383,422,47.58
Zeri,Kassadin,175,104,71,59.43
Zeri,XinZhao,468,231,237,49.36
Zeri,Ryze,323,162,161,50.15
Zeri,JarvanIV,484,219,265,45.25
Zeri,Karthus,272,140,132,51.47
Zeri,Rakan,360,180,180,50
Zeri,Nunu,532,241,291,45.3
Zeri,Senna,666,323,343,48.5
Zeri,Maokai,393,183,210,46.56
Zeri,Syndra,616,327,289,53.08
Zeri,Jayce,494,227,267,45.95
Zeri,Taliyah,248,121,127,48.79
Zeri,Nidalee,272,149,123,54.78
Zeri,Zilean,239,109,130,45.61
Zeri,Anivia,268,138,130,51.49
Zeri,TwistedFate,294,185,109,62.93
Zeri,Shyvana,186,110,76,59.14
Zeri,Rumble,265,126,139,47.55
Zeri,Kled,133,59,74,44.36
Zeri,Skarner,268,136,132,50.75
Zeri,KogMaw,247,129,118,52.23
Zeri,Olaf,240,111,129,46.25
Zeri,Braum,424,241,183,56.84
Leblanc,Fiora,373,161,212,43.16
Leblanc,Lillia,668,370,298,55.39
Leblanc,Aurora,939,474,465,50.48
Leblanc,Zeri,500,251,249,50.2
Leblanc,Rakan,496,291,205,58.67
Leblanc,Irelia,890,452,438,50.79
Leblanc,Warwick,1419,626,793,44.12
Leblanc,Galio,1192,570,622,47.82
Leblanc,Sivir,554,254,300,45.85
Leblanc,Rell,482,237,245,49.17
Leblanc,Sett,1580,805,775,50.95
Leblanc,Talon,721,362,359,50.21
Leblanc,FiddleSticks,533,283,250,53.1
Leblanc,Ashe,2371,1225,1146,51.67
Leblanc,Blitzcrank,942,469,473,49.79
Leblanc,Malphite,958,434,524,45.3
Leblanc,Rengar,445,240,205,53.93
Leblanc,Akali,1185,591,594,49.87
Leblanc,Yone,2021,1029,992,50.92
Leblanc,Briar,754,313,441,41.51
Leblanc,Vex,900,429,471,47.67
Leblanc,Jinx,2747,1281,1466,46.63
Leblanc,Milio,527,254,273,48.2
Leblanc,Olaf,241,130,111,53.94
Leblanc,LeeSin,2151,1109,1042,51.56
Leblanc,Diana,1762,847,915,48.07
Leblanc,Seraphine,799,391,408,48.94
Leblanc,Karma,1421,699,722,49.19
Leblanc,Mordekaiser,1349,594,755,44.03
Leblanc,Volibear,1130,506,624,44.78
Leblanc,Mel,2029,973,1056,47.95
Leblanc,Neeko,561,297,264,52.94
Leblanc,Yorick,902,447,455,49.56
Leblanc,Veigar,983,500,483,50.86
Leblanc,Caitlyn,2765,1359,1406,49.15
Leblanc,Sona,316,143,173,45.25
Leblanc,Jayce,635,300,335,47.24
Leblanc,Amumu,944,475,469,50.32
Leblanc,Yasuo,1953,921,1032,47.16
Leblanc,Jax,1064,551,513,51.79
Leblanc,Heimerdinger,408,156,252,38.24
Leblanc,Soraka,532,256,276,48.12
Leblanc,Zed,1261,629,632,49.88
Leblanc,Samira,867,419,448,48.33
Leblanc,Ambessa,824,417,407,50.61
Leblanc,Nunu,564,299,265,53.01
Leblanc,Kayle,653,311,342,47.63
Leblanc,Katarina,767,401,366,52.28
Leblanc,Jhin,2171,1048,1123,48.27
Leblanc,Lux,2795,1327,1468,47.48
Leblanc,Ekko,902,465,437,51.55
Leblanc,Kassadin,265,124,141,46.79
Leblanc,TahmKench,690,334,356,48.41
Leblanc,Gnar,475,267,208,56.21
Leblanc,KSante,653,319,334,48.85
Leblanc,Ahri,1676,808,868,48.21
Leblanc,Anivia,352,185,167,52.56
Leblanc,Xayah,575,316,259,54.96
Leblanc,Chogath,1183,513,670,43.36
Leblanc,MissFortune,2347,1088,1259,46.36
Leblanc,Malzahar,1063,481,582,45.25
Leblanc,Viego,1569,795,774,50.67
Leblanc,Vayne,1143,530,613,46.37
Leblanc,Sylas,1531,735,796,48.01
Leblanc,Camille,429,176,253,41.03
Leblanc,Kayn,1340,635,705,47.39
Leblanc,Yuumi,912,432,480,47.37
Leblanc,Lucian,701,342,359,48.79
Leblanc,Nami,1027,513,514,49.95
Leblanc,Teemo,1267,623,644,49.17
Leblanc,Shaco,1052,483,569,45.91
Leblanc,Naafiri,464,163,301,35.13
Leblanc,Ziggs,324,166,158,51.23
Leblanc,Kalista,386,226,160,58.55
Leblanc,Swain,911,393,518,43.14
Leblanc,Renekton,538,271,267,50.37
Leblanc,Leona,894,401,493,44.85
Leblanc,Janna,387,158,229,40.83
Leblanc,JarvanIV,564,260,304,46.1
Leblanc,Udyr,354,173,181,48.87
Leblanc,Skarner,376,199,177,52.93
Leblanc,Ezreal,3025,1519,1506,50.21
Leblanc,Trundle,541,262,279,48.43
Leblanc,Rammus,299,153,146,51.17
Leblanc,MonkeyKing,718,373,345,51.95
Leblanc,Nautilus,1230,604,626,49.11
Leblanc,Garen,1614,774,840,47.96
Leblanc,Singed,292,143,149,48.97
Leblanc,Bard,335,163,172,48.66
Leblanc,Nocturne,1284,582,702,45.33
Leblanc,Darius,1728,871,857,50.41
Leblanc,Gragas,765,391,374,51.11
Leblanc,Gangplank,530,263,267,49.62
Leblanc,Tristana,902,478,424,52.99
Leblanc,Pyke,943,529,414,56.1
Leblanc,Aatrox,1122,514,608,45.81
Leblanc,Riven,457,224,233,49.02
Leblanc,Aphelios,582,310,272,53.26
Leblanc,DrMundo,593,293,300,49.41
Leblanc,Thresh,1692,894,798,52.84
Leblanc,Khazix,564,282,282,50
Leblanc,Shen,655,356,299,54.35
Leblanc,Nilah,273,119,154,43.59
Leblanc,Kled,222,110,112,49.55
Leblanc,Vi,1043,485,558,46.5
Leblanc,Draven,560,265,295,47.32
Leblanc,Lulu,1356,615,741,45.35
Leblanc,Vladimir,726,337,389,46.42
Leblanc,Brand,680,322,358,47.35
Leblanc,Zoe,538,279,259,51.86
Leblanc,Pantheon,1825,856,969,46.9
Leblanc,Evelynn,411,197,214,47.93
Leblanc,Azir,442,215,227,48.64
Leblanc,Fizz,588,300,288,51.02
Leblanc,Kaisa,1797,894,903,49.75
Leblanc,Tryndamere,510,265,245,51.96
Leblanc,Kennen,346,196,150,56.65
Leblanc,Qiyana,202,96,106,47.52
Leblanc,Karthus,359,200,159,55.71
Leblanc,Twitch,814,411,403,50.49
Leblanc,Gwen,503,252,251,50.1
Leblanc,AurelionSol,319,184,135,57.68
Leblanc,Morgana,1133,549,584,48.46
Leblanc,Velkoz,632,275,357,43.51
Leblanc,Smolder,753,318,435,42.23
Leblanc,Illaoi,457,223,234,48.8
Leblanc,Sejuani,455,219,236,48.13
Leblanc,Ornn,447,183,264,40.94
Leblanc,Zac,562,279,283,49.64
Leblanc,Elise,847,381,466,44.98
Leblanc,Hwei,751,360,391,47.94
Leblanc,Braum,645,258,387,40
Leblanc,Poppy,752,355,397,47.21
Leblanc,Shyvana,226,113,113,50
Leblanc,Lissandra,515,221,294,42.91
Leblanc,Orianna,565,272,293,48.14
Leblanc,Nasus,656,311,345,47.41
Leblanc,MasterYi,1129,517,612,45.79
Leblanc,TwistedFate,366,206,160,56.28
Leblanc,Belveth,245,134,111,54.69
Leblanc,Senna,727,362,365,49.79
Leblanc,Varus,1049,494,555,47.09
Leblanc,Sion,674,342,332,50.74
Leblanc,Hecarim,377,204,173,54.11
Leblanc,Kindred,506,264,242,52.17
Leblanc,Ivern,160,89,71,55.63
Leblanc,Nidalee,376,159,217,42.29
Leblanc,Alistar,547,284,263,51.92
Leblanc,Viktor,900,378,522,42
Leblanc,Graves,804,400,404,49.75
Leblanc,Ryze,332,140,192,42.17
Leblanc,Syndra,679,322,357,47.42
Leblanc,KogMaw,357,155,202,43.42
Leblanc,Zyra,1019,450,569,44.16
Leblanc,Corki,532,280,252,52.63
Leblanc,Zilean,280,136,144,48.57
Leblanc,Maokai,593,251,342,42.33
Leblanc,Annie,386,172,214,44.56
Leblanc,Urgot,475,200,275,42.11
Leblanc,Akshan,339,159,180,46.9
Leblanc,Xerath,1068,535,533,50.09
Leblanc,Rumble,345,144,201,41.74
Leblanc,XinZhao,769,393,376,51.11
Leblanc,Quinn,379,162,217,42.74
Leblanc,Taric,153,66,87,43.14
Leblanc,RekSai,112,41,71,36.61
Leblanc,Renata,190,105,85,55.26
Leblanc,Taliyah,241,115,126,47.72
Leblanc,Cassiopeia,226,128,98,56.64
Briar,Fiora,711,386,325,54.29
Briar,Lillia,1023,563,460,55.03
Briar,Aurora,1200,683,517,56.92
Briar,Zeri,641,348,293,54.29
Briar,Rakan,726,354,372,48.76
Briar,Pantheon,2503,1313,1190,52.46
Briar,Diana,2461,1284,1177,52.17
Briar,Gangplank,734,359,375,48.91
Briar,Ezreal,3024,1667,1357,55.13
Briar,Yuumi,1295,674,621,52.05
Briar,Garen,2315,1151,1164,49.72
Briar,Yasuo,3072,1604,1468,52.21
Briar,Caitlyn,4100,2063,2037,50.32
Briar,Pyke,1476,841,635,56.98
Briar,Aatrox,1441,773,668,53.64
Briar,Sejuani,562,304,258,54.09
Briar,Jinx,4300,2105,2195,48.95
Briar,Sett,2359,1148,1211,48.66
Briar,Amumu,1663,724,939,43.54
Briar,Sylas,1714,972,742,56.71
Briar,Poppy,979,483,496,49.34
Briar,Warwick,2720,1428,1292,52.5
Briar,Katarina,1353,733,620,54.18
Briar,Twitch,1335,630,705,47.19
Briar,Morgana,2036,1025,1011,50.34
Briar,Malphite,1525,781,744,51.21
Briar,Rengar,573,355,218,61.95
Briar,Akali,1696,820,876,48.35
Briar,Ashe,2949,1609,1340,54.56
Briar,Vladimir,949,497,452,52.37
Briar,Shaco,1448,729,719,50.35
Briar,Tryndamere,813,416,397,51.17
Briar,Milio,806,404,402,50.12
Briar,Jax,1407,656,751,46.62
Briar,Talon,750,439,311,58.53
Briar,Leblanc,754,441,313,58.49
Briar,Mel,3445,1912,1533,55.5
Briar,Heimerdinger,765,422,343,55.16
Briar,Kindred,779,481,298,61.75
Briar,Janna,508,258,250,50.79
Briar,Smolder,1017,579,438,56.93
Briar,Velkoz,973,467,506,48
Briar,Darius,3169,1641,1528,51.78
Briar,Brand,1251,630,621,50.36
Briar,Kennen,400,259,141,64.75
Briar,Kayn,2560,1348,1212,52.66
Briar,Naafiri,667,347,320,52.02
Briar,Xayah,796,401,395,50.38
Briar,Soraka,975,474,501,48.62
Briar,Yorick,1697,827,870,48.73
Briar,Irelia,1313,696,617,53.01
Briar,Samira,1347,685,662,50.85
Briar,Nami,1353,649,704,47.97
Briar,DrMundo,1013,483,530,47.68
Briar,Trundle,1032,524,508,50.78
Briar,Ahri,2212,1146,1066,51.81
Briar,Gwen,810,427,383,52.72
Briar,Nunu,1159,617,542,53.24
Briar,Lux,4189,2271,1918,54.21
Briar,Mordekaiser,2424,1277,1147,52.68
Briar,Zed,1686,893,793,52.97
Briar,MissFortune,3712,1967,1745,52.99
Briar,Veigar,1664,836,828,50.24
Briar,KSante,653,351,302,53.75
Briar,Gragas,845,438,407,51.83
Briar,MasterYi,2035,1012,1023,49.73
Briar,Shyvana,399,239,160,59.9
Briar,Taliyah,409,192,217,46.94
Briar,Swain,1524,760,764,49.87
Briar,Kayle,1143,621,522,54.33
Briar,Nocturne,1978,997,981,50.4
Briar,Lucian,901,515,386,57.16
Briar,Seraphine,1529,771,758,50.43
Briar,Ambessa,894,477,417,53.36
Briar,Zac,655,305,350,46.56
Briar,Kalista,509,309,200,60.71
Briar,Olaf,351,172,179,49
Briar,Yone,2997,1683,1314,56.16
Briar,Belveth,451,219,232,48.56
Briar,AurelionSol,726,342,384,47.11
Briar,Neeko,842,431,411,51.19
Briar,Nilah,734,380,354,51.77
Briar,Zyra,1281,681,600,53.16
Briar,Volibear,1835,944,891,51.44
Briar,Vex,911,520,391,57.08
Briar,Kaisa,2244,1227,1017,54.68
Briar,Ivern,183,105,78,57.38
Briar,Syndra,845,394,451,46.63
Briar,Maokai,691,363,328,52.53
Briar,Illaoi,781,420,361,53.78
Briar,Hwei,1133,553,580,48.81
Briar,Graves,847,478,369,56.43
Briar,Zoe,566,288,278,50.88
Briar,Tristana,1447,706,741,48.79
Briar,Vayne,1844,989,855,53.63
Briar,Sona,524,262,262,50
Briar,Chogath,1941,1001,940,51.57
Briar,Draven,898,472,426,52.56
Briar,Teemo,2113,890,1223,42.12
Briar,Xerath,1237,667,570,53.92
Briar,Nasus,1200,622,578,51.83
Briar,Riven,691,377,314,54.56
Briar,Rell,683,334,349,48.9
Briar,Nidalee,366,223,143,60.93
Briar,Hecarim,547,322,225,58.87
Briar,Varus,1224,666,558,54.41
Briar,Lulu,1620,814,806,50.25
Briar,Ornn,625,312,313,49.92
Briar,Jhin,3088,1641,1447,53.14
Briar,Nautilus,1612,868,744,53.85
Briar,Sion,1197,578,619,48.29
Briar,Khazix,862,483,379,56.03
Briar,Ekko,1459,753,706,51.61
Briar,Singed,356,173,183,48.6
Briar,Leona,1428,755,673,52.87
Briar,KogMaw,514,294,220,57.2
Briar,Thresh,2012,1037,975,51.54
Briar,Fizz,895,456,439,50.95
Briar,Jayce,606,333,273,54.95
Briar,Ziggs,587,339,248,57.75
Briar,TahmKench,1500,789,711,52.6
Briar,Cassiopeia,551,277,274,50.27
Briar,Braum,819,392,427,47.86
Briar,Renekton,676,361,315,53.4
Briar,Galio,1291,695,596,53.83
Briar,Malzahar,1482,736,746,49.66
Briar,Karma,1514,819,695,54.1
Briar,MonkeyKing,842,394,448,46.79
Briar,Aphelios,935,478,457,51.12
Briar,Viktor,1144,566,578,49.48
Briar,Shen,1011,519,492,51.34
Briar,Renata,309,147,162,47.57
Briar,Vi,1516,820,696,54.09
Briar,Camille,546,300,246,54.95
Briar,Quinn,613,287,326,46.82
Briar,Lissandra,518,283,235,54.63
Briar,Elise,916,484,432,52.84
Briar,Kassadin,287,167,120,58.19
Briar,Evelynn,713,377,336,52.88
Briar,Karthus,416,270,146,64.9
Briar,Annie,452,254,198,56.19
Briar,LeeSin,1776,977,799,55.01
Briar,Senna,1236,677,559,54.77
Briar,Skarner,388,213,175,54.9
Briar,Corki,454,227,227,50
Briar,Viego,2027,997,1030,49.19
Briar,XinZhao,969,533,436,55.01
Briar,Ryze,604,336,268,55.63
Briar,Udyr,589,282,307,47.88
Briar,Qiyana,436,253,183,58.03
Briar,Taric,344,154,190,44.77
Briar,FiddleSticks,767,441,326,57.5
Briar,Bard,442,200,242,45.25
Briar,Rumble,326,177,149,54.29
Briar,JarvanIV,737,397,340,53.87
Briar,Sivir,778,373,405,47.94
Briar,Urgot,814,434,380,53.32
Briar,Azir,518,287,231,55.41
Briar,Alistar,565,329,236,58.23
Briar,TwistedFate,488,277,211,56.76
Briar,Orianna,652,326,326,50
Briar,Kled,367,175,192,47.68
Briar,Gnar,588,341,247,57.99
Briar,RekSai,188,109,79,57.98
Briar,Blitzcrank,1171,726,445,62
Briar,Akshan,576,285,291,49.48
Briar,Zilean,496,256,240,51.61
Briar,Anivia,470,241,229,51.28
Briar,Rammus,711,349,362,49.09
Zoe,Fiora,345,153,192,44.35
Zoe,Lillia,444,211,233,47.52
Zoe,Aurora,663,283,380,42.68
Zoe,Zeri,378,184,194,48.68
Zoe,Rakan,354,153,201,43.22
Zoe,Vayne,986,436,550,44.22
Zoe,Nocturne,843,383,460,45.43
Zoe,Kaisa,1344,644,700,47.92
Zoe,Galio,779,328,451,42.11
Zoe,Blitzcrank,660,324,336,49.09
Zoe,Urgot,363,130,233,35.81
Zoe,Kayn,1152,586,566,50.87
Zoe,Yasuo,1456,594,862,40.8
Zoe,Twitch,641,314,327,48.99
Zoe,Neeko,467,255,212,54.6
Zoe,Gragas,487,269,218,55.24
Zoe,Gwen,493,223,270,45.23
Zoe,Bard,280,149,131,53.21
Zoe,Tryndamere,471,230,241,48.83
Zoe,Lux,2179,1030,1149,47.27
Zoe,Nunu,508,205,303,40.35
Zoe,Caitlyn,2032,999,1033,49.16
Zoe,Vladimir,496,231,265,46.57
Zoe,Yorick,693,287,406,41.41
Zoe,Ekko,767,357,410,46.54
Zoe,Katarina,665,317,348,47.67
Zoe,Jinx,2097,975,1122,46.49
Zoe,Sion,627,267,360,42.58
Zoe,Evelynn,313,152,161,48.56
Zoe,Akali,808,391,417,48.39
Zoe,Ezreal,1828,963,865,52.68
Zoe,Aatrox,740,367,373,49.59
Zoe,Naafiri,394,219,175,55.58
Zoe,Ashe,1596,740,856,46.37
Zoe,Morgana,1027,480,547,46.74
Zoe,Trundle,437,202,235,46.22
Zoe,MasterYi,913,437,476,47.86
Zoe,Ahri,1117,588,529,52.64
Zoe,Varus,725,327,398,45.1
Zoe,KSante,408,244,164,59.8
Zoe,Sivir,402,204,198,50.75
Zoe,Mel,1458,698,760,47.87
Zoe,DrMundo,499,223,276,44.69
Zoe,Sylas,1074,559,515,52.05
Zoe,Nilah,326,116,210,35.58
Zoe,Darius,1480,713,767,48.18
Zoe,Shaco,718,339,379,47.21
Zoe,Zed,830,387,443,46.63
Zoe,Braum,488,217,271,44.47
Zoe,Kled,175,94,81,53.71
Zoe,Warwick,984,419,565,42.58
Zoe,Taliyah,222,84,138,37.84
Zoe,TahmKench,580,285,295,49.14
Zoe,Ornn,367,176,191,47.96
Zoe,Skarner,248,117,131,47.18
Zoe,Lucian,499,252,247,50.5
Zoe,Senna,585,245,340,41.88
Zoe,Nasus,449,164,285,36.53
Zoe,Briar,566,278,288,49.12
Zoe,AurelionSol,317,157,160,49.53
Zoe,Singed,254,93,161,36.61
Zoe,TwistedFate,344,147,197,42.73
Zoe,Brand,586,250,336,42.66
Zoe,Gnar,344,154,190,44.77
Zoe,Vi,838,352,486,42
Zoe,Nautilus,871,382,489,43.86
Zoe,Olaf,168,72,96,42.86
Zoe,Pantheon,1235,582,653,47.13
Zoe,Renekton,421,254,167,60.33
Zoe,MissFortune,1683,732,951,43.49
Zoe,Thresh,1055,516,539,48.91
Zoe,Yone,1536,796,740,51.82
Zoe,Draven,446,203,243,45.52
Zoe,Shen,470,198,272,42.13
Zoe,Jax,726,342,384,47.11
Zoe,Hecarim,255,121,134,47.45
Zoe,Seraphine,624,309,315,49.52
Zoe,Sett,1205,550,655,45.64
Zoe,Khazix,497,236,261,47.48
Zoe,Jhin,1558,763,795,48.97
Zoe,Yuumi,731,340,391,46.51
Zoe,Xayah,403,172,231,42.68
Zoe,Kennen,243,94,149,38.68
Zoe,Karma,935,437,498,46.74
Zoe,Corki,375,197,178,52.53
Zoe,Hwei,613,289,324,47.15
Zoe,Mordekaiser,1066,518,548,48.59
Zoe,Chogath,937,458,479,48.88
Zoe,Pyke,737,372,365,50.47
Zoe,Garen,1072,466,606,43.47
Zoe,Rengar,347,155,192,44.67
Zoe,Xerath,685,322,363,47.01
Zoe,Samira,579,262,317,45.25
Zoe,Malphite,732,289,443,39.48
Zoe,Amumu,774,358,416,46.25
Zoe,MonkeyKing,455,253,202,55.6
Zoe,Quinn,321,160,161,49.84
Zoe,Ambessa,525,233,292,44.38
Zoe,Graves,508,238,270,46.85
Zoe,Irelia,714,294,420,41.18
Zoe,Lulu,927,461,466,49.73
Zoe,KogMaw,293,125,168,42.66
Zoe,Nami,804,378,426,47.01
Zoe,Viktor,652,329,323,50.46
Zoe,Leblanc,538,259,279,48.14
Zoe,Ryze,296,156,140,52.7
Zoe,Leona,638,297,341,46.55
Zoe,Malzahar,750,297,453,39.6
Zoe,Zyra,690,321,369,46.52
Zoe,Riven,356,179,177,50.28
Zoe,Shyvana,220,103,117,46.82
Zoe,Cassiopeia,275,151,124,54.91
Zoe,Soraka,493,237,256,48.07
Zoe,Diana,1184,568,616,47.97
Zoe,Kassadin,114,53,61,46.49
Zoe,LeeSin,1184,581,603,49.07
Zoe,Swain,715,264,451,36.92
Zoe,Sejuani,346,162,184,46.82
Zoe,Illaoi,316,157,159,49.68
Zoe,Poppy,484,218,266,45.04
Zoe,Elise,674,319,355,47.33
Zoe,Smolder,456,245,211,53.73
Zoe,Maokai,394,159,235,40.36
Zoe,Orianna,344,190,154,55.23
Zoe,Volibear,762,324,438,42.52
Zoe,Aphelios,508,244,264,48.03
Zoe,Kalista,263,152,111,57.79
Zoe,Teemo,976,403,573,41.29
Zoe,Tristana,783,309,474,39.46
Zoe,Syndra,629,330,299,52.46
Zoe,Azir,311,173,138,55.63
Zoe,Ziggs,378,196,182,51.85
Zoe,JarvanIV,380,175,205,46.05
Zoe,Viego,1182,555,627,46.95
Zoe,Kindred,327,146,181,44.65
Zoe,Janna,285,123,162,43.16
Zoe,Gangplank,422,189,233,44.79
Zoe,Velkoz,488,198,290,40.57
Zoe,XinZhao,439,180,259,41
Zoe,Milio,456,225,231,49.34
Zoe,Rell,426,194,232,45.54
Zoe,Heimerdinger,309,121,188,39.16
Zoe,Camille,341,138,203,40.47
Zoe,Nidalee,253,134,119,52.96
Zoe,Fizz,427,166,261,38.88
Zoe,Lissandra,227,85,142,37.44
Zoe,FiddleSticks,372,165,207,44.35
Zoe,Alistar,310,157,153,50.65
Zoe,Udyr,306,159,147,51.96
Zoe,Vex,379,175,204,46.17
Zoe,Rumble,226,121,105,53.54
Zoe,Ivern,139,69,70,49.64
Zoe,Veigar,964,470,494,48.76
Zoe,Annie,229,111,118,48.47
Zoe,Zilean,295,121,174,41.02
Zoe,Kayle,490,226,264,46.12
Zoe,Qiyana,270,161,109,59.63
Zoe,Sona,208,88,120,42.31
Zoe,Anivia,271,142,129,52.4
Zoe,Karthus,260,122,138,46.92
Zoe,Renata,174,97,77,55.75
Zoe,Talon,489,223,266,45.6
Zoe,Jayce,396,230,166,58.08
Zoe,Belveth,175,97,78,55.43
Zoe,Zac,367,191,176,52.04
Zoe,Taric,147,56,91,38.1
Zoe,Akshan,370,159,211,42.97
Zoe,RekSai,134,57,77,42.54
Zoe,Rammus,228,96,132,42.11
Nunu,Mordekaiser,1937,901,1036,46.52
Nunu,Warwick,2021,948,1073,46.91
Nunu,Veigar,1424,685,739,48.1
Nunu,Ashe,2306,1034,1272,44.84
Nunu,Nami,1227,625,602,50.94
Nunu,Gnar,525,264,261,50.29
Nunu,Viego,1690,898,792,53.14
Nunu,Yone,2509,1265,1244,50.42
Nunu,Kaisa,1889,954,935,50.5
Nunu,TahmKench,1058,502,556,47.45
Nunu,Jax,1089,586,503,53.81
Nunu,Elise,770,410,360,53.25
Nunu,Naafiri,541,271,270,50.09
Nunu,Jhin,2483,1282,1201,51.63
Nunu,Lulu,1281,645,636,50.35
Nunu,Sett,1926,847,1079,43.98
Nunu,Brand,992,500,492,50.4
Nunu,Twitch,1039,545,494,52.45
Nunu,Morgana,1686,787,899,46.68
Nunu,TwistedFate,419,224,195,53.46
Nunu,LeeSin,1583,810,773,51.17
Nunu,Yasuo,2452,1156,1296,47.15
Nunu,Nilah,520,281,239,54.04
Nunu,Kennen,359,169,190,47.08
Nunu,MonkeyKing,768,373,395,48.57
Nunu,Vladimir,796,391,405,49.12
Nunu,Vayne,1371,702,669,51.2
Nunu,Thresh,1726,909,817,52.67
Nunu,Akali,1437,717,720,49.9
Nunu,Leblanc,564,265,299,46.99
Nunu,Tristana,1191,618,573,51.89
Nunu,Graves,798,359,439,44.99
Nunu,Katarina,916,488,428,53.28
Nunu,Seraphine,1164,589,575,50.6
Nunu,Heimerdinger,754,394,360,52.25
Nunu,Pyke,1240,675,565,54.44
Nunu,Samira,1072,572,500,53.36
Nunu,MasterYi,1468,671,797,45.71
Nunu,Orianna,528,251,277,47.54
Nunu,Malphite,1112,527,585,47.39
Nunu,Nautilus,1404,672,732,47.86
Nunu,Aatrox,1078,542,536,50.28
Nunu,Gragas,731,377,354,51.57
Nunu,Cassiopeia,359,188,171,52.37
Nunu,Irelia,1072,511,561,47.67
Nunu,Briar,1159,542,617,46.76
Nunu,Zoe,508,303,205,59.65
Nunu,Ezreal,2644,1444,1200,54.61
Nunu,Janna,424,232,192,54.72
Nunu,Kindred,608,341,267,56.09
Nunu,Yuumi,1162,623,539,53.61
Nunu,Darius,2348,1164,1184,49.57
Nunu,Senna,1000,444,556,44.4
Nunu,Azir,445,207,238,46.52
Nunu,Taric,277,121,156,43.68
Nunu,Rammus,306,188,118,61.44
Nunu,Renekton,612,318,294,51.96
Nunu,Zyra,995,448,547,45.03
Nunu,KSante,468,209,259,44.66
Nunu,Olaf,287,153,134,53.31
Nunu,Aurora,1141,609,532,53.37
Nunu,Jinx,3041,1468,1573,48.27
Nunu,Lux,3459,1717,1742,49.64
Nunu,Nasus,927,476,451,51.35
Nunu,AurelionSol,546,242,304,44.32
Nunu,Rengar,497,246,251,49.5
Nunu,Ivern,259,139,120,53.67
Nunu,Garen,2018,985,1033,48.81
Nunu,Diana,1823,845,978,46.35
Nunu,Ryze,362,163,199,45.03
Nunu,Pantheon,2137,1035,1102,48.43
Nunu,Camille,440,233,207,52.95
Nunu,Lillia,874,429,445,49.08
Nunu,Udyr,509,296,213,58.15
Nunu,Skarner,413,212,201,51.33
Nunu,Rell,650,336,314,51.69
Nunu,Evelynn,546,289,257,52.93
Nunu,Taliyah,327,160,167,48.93
Nunu,Kayle,915,436,479,47.65
Nunu,Volibear,1470,741,729,50.41
Nunu,Rakan,565,281,284,49.73
Nunu,Singed,411,205,206,49.88
Nunu,Smolder,753,357,396,47.41
Nunu,Zed,1162,594,568,51.12
Nunu,Shen,798,410,388,51.38
Nunu,MissFortune,3011,1493,1518,49.58
Nunu,Blitzcrank,958,449,509,46.87
Nunu,Riven,521,288,233,55.28
Nunu,Akshan,521,261,260,50.1
Nunu,Poppy,730,333,397,45.62
Nunu,Anivia,382,176,206,46.07
Nunu,Kayn,1819,854,965,46.95
Nunu,Lucian,719,337,382,46.87
Nunu,Karma,1181,621,560,52.58
Nunu,Tryndamere,743,433,310,58.28
Nunu,Shaco,1191,668,523,56.09
Nunu,Talon,756,390,366,51.59
Nunu,Caitlyn,3377,1618,1759,47.91
Nunu,Malzahar,1299,618,681,47.58
Nunu,Teemo,1696,858,838,50.59
Nunu,Soraka,777,399,378,51.35
Nunu,Illaoi,694,333,361,47.98
Nunu,Chogath,1510,698,812,46.23
Nunu,Leona,1079,504,575,46.71
Nunu,Fiora,538,303,235,56.32
Nunu,Draven,637,330,307,51.81
Nunu,Vi,1124,564,560,50.18
Nunu,Kassadin,288,147,141,51.04
Nunu,Mel,2551,1324,1227,51.9
Nunu,Nidalee,327,171,156,52.29
Nunu,Vex,719,359,360,49.93
Nunu,Velkoz,798,374,424,46.87
Nunu,Hwei,883,436,447,49.38
Nunu,Sona,385,171,214,44.42
Nunu,Neeko,794,415,379,52.27
Nunu,Gwen,716,348,368,48.6
Nunu,Braum,669,306,363,45.74
Nunu,Ekko,1184,579,605,48.9
Nunu,Galio,1052,447,605,42.49
Nunu,Milio,649,333,316,51.31
Nunu,Alistar,396,215,181,54.29
Nunu,FiddleSticks,671,310,361,46.2
Nunu,Corki,506,252,254,49.8
Nunu,Swain,1225,498,727,40.65
Nunu,Amumu,1569,728,841,46.4
Nunu,Ahri,1703,913,790,53.61
Nunu,Xayah,720,381,339,52.92
Nunu,Sejuani,535,268,267,50.09
Nunu,Ziggs,498,257,241,51.61
Nunu,DrMundo,785,377,408,48.03
Nunu,Qiyana,334,178,156,53.29
Nunu,XinZhao,685,299,386,43.65
Nunu,Khazix,612,302,310,49.35
Nunu,Zac,517,286,231,55.32
Nunu,KogMaw,327,136,191,41.59
Nunu,Karthus,342,175,167,51.17
Nunu,Sion,1034,452,582,43.71
Nunu,Viktor,959,522,437,54.43
Nunu,Sivir,701,353,348,50.36
Nunu,Varus,1164,602,562,51.72
Nunu,Belveth,317,142,175,44.79
Nunu,Shyvana,316,158,158,50
Nunu,Sylas,1596,805,791,50.44
Nunu,Nocturne,1476,728,748,49.32
Nunu,Aphelios,664,328,336,49.4
Nunu,Xerath,1011,458,553,45.3
Nunu,Bard,394,216,178,54.82
Nunu,Kled,158,64,94,40.51
Nunu,Yorick,1355,642,713,47.38
Nunu,Jayce,484,273,211,56.4
Nunu,Urgot,608,275,333,45.23
Nunu,Lissandra,408,189,219,46.32
Nunu,JarvanIV,719,336,383,46.73
Nunu,Ambessa,721,345,376,47.85
Nunu,Trundle,803,398,405,49.56
Nunu,Gangplank,473,226,247,47.78
Nunu,Maokai,630,341,289,54.13
Nunu,Annie,418,212,206,50.72
Nunu,Kalista,397,197,200,49.62
Nunu,Quinn,431,200,231,46.4
Nunu,Ornn,582,289,293,49.66
Nunu,Hecarim,592,317,275,53.55
Nunu,Fizz,694,356,338,51.3
Nunu,Zeri,532,291,241,54.7
Nunu,Zilean,368,179,189,48.64
Nunu,Rumble,277,139,138,50.18
Nunu,Syndra,767,386,381,50.33
Nunu,RekSai,179,98,81,54.75
Nunu,Renata,213,134,79,62.91
Swain,Mordekaiser,2860,1334,1526,46.64
Swain,Warwick,3195,1549,1646,48.48
Swain,Veigar,2204,1132,1072,51.36
Swain,Ashe,3928,1959,1969,49.87
Swain,Nami,1778,822,956,46.23
Swain,Yorick,1865,981,884,52.6
Swain,FiddleSticks,970,532,438,54.85
Swain,Draven,957,554,403,57.89
Swain,Smolder,1384,757,627,54.7
Swain,Nautilus,2361,1361,1000,57.65
Swain,Riven,876,465,411,53.08
Swain,Kayn,2836,1450,1386,51.13
Swain,Ahri,2775,1505,1270,54.23
Swain,Jinx,5075,2566,2509,50.56
Swain,Renekton,941,535,406,56.85
Swain,JarvanIV,984,513,471,52.13
Swain,Mel,4086,2142,1944,52.42
Swain,Jhin,3805,2060,1745,54.14
Swain,Sylas,2816,1511,1305,53.66
Swain,Samira,1650,891,759,54
Swain,Nilah,871,489,382,56.14
Swain,Leona,1735,961,774,55.39
Swain,Shen,1342,720,622,53.65
Swain,Gragas,1108,605,503,54.6
Swain,Yone,3586,1908,1678,53.21
Swain,Alistar,867,493,374,56.86
Swain,Tryndamere,1052,568,484,53.99
Swain,Irelia,1703,858,845,50.38
Swain,Kalista,622,358,264,57.56
Swain,Twitch,1563,774,789,49.52
Swain,Nasus,1547,782,765,50.55
Swain,Khazix,964,480,484,49.79
Swain,Diana,2811,1464,1347,52.08
Swain,Urgot,977,494,483,50.56
Swain,Lulu,2087,1118,969,53.57
Swain,KSante,924,449,475,48.59
Swain,Darius,3667,1865,1802,50.86
Swain,Azir,683,377,306,55.2
Swain,Aphelios,1160,653,507,56.29
Swain,Soraka,1128,569,559,50.44
Swain,Taliyah,444,218,226,49.1
Swain,Senna,1631,836,795,51.26
Swain,Sett,3158,1649,1509,52.22
Swain,Akali,2102,1152,950,54.8
Swain,Tristana,1981,1028,953,51.89
Swain,Blitzcrank,1543,876,667,56.77
Swain,Nidalee,467,298,169,63.81
Swain,Aurora,1633,889,744,54.44
Swain,MissFortune,4643,2437,2206,52.49
Swain,Chogath,2617,1350,1267,51.59
Swain,Lillia,1318,674,644,51.14
Swain,Vex,1065,597,468,56.06
Swain,Janna,643,291,352,45.26
Swain,TahmKench,1853,1061,792,57.26
Swain,Jax,1838,1032,806,56.15
Swain,Malzahar,2213,1102,1111,49.8
Swain,Pantheon,3246,1746,1500,53.79
Swain,Yasuo,3972,2097,1875,52.79
Swain,Braum,1179,596,583,50.55
Swain,Maokai,923,518,405,56.12
Swain,Gnar,865,493,372,56.99
Swain,Shaco,1913,1034,879,54.05
Swain,Xayah,978,491,487,50.2
Swain,Seraphine,1664,837,827,50.3
Swain,Briar,1524,764,760,50.13
Swain,Fizz,1044,559,485,53.54
Swain,Singed,568,257,311,45.25
Swain,Garen,3266,1683,1583,51.53
Swain,Zed,2038,1075,963,52.75
Swain,KogMaw,660,311,349,47.12
Swain,Lux,5290,2682,2608,50.7
Swain,Katarina,1515,809,706,53.4
Swain,Neeko,1161,683,478,58.83
Swain,Caitlyn,5251,2577,2674,49.08
Swain,Yuumi,1648,809,839,49.09
Swain,Talon,1044,530,514,50.77
Swain,Milio,1047,535,512,51.1
Swain,Ornn,869,477,392,54.89
Swain,Morgana,2490,1135,1355,45.58
Swain,TwistedFate,686,366,320,53.35
Swain,Annie,684,379,305,55.41
Swain,Kayle,1411,740,671,52.45
Swain,Sona,729,356,373,48.83
Swain,Rengar,684,425,259,62.13
Swain,Malphite,1833,1005,828,54.83
Swain,Zyra,1690,845,845,50
Swain,Kennen,610,314,296,51.48
Swain,Ekko,1664,884,780,53.13
Swain,Ezreal,3992,2195,1797,54.98
Swain,Trundle,1186,569,617,47.98
Swain,MasterYi,2337,1139,1198,48.74
Swain,Varus,1736,915,821,52.71
Swain,Heimerdinger,1013,507,506,50.05
Swain,DrMundo,1192,642,550,53.86
Swain,Graves,1082,606,476,56.01
Swain,Leblanc,911,518,393,56.86
Swain,Vladimir,1324,682,642,51.51
Swain,Volibear,2485,1264,1221,50.87
Swain,Qiyana,565,337,228,59.65
Swain,Teemo,2529,1250,1279,49.43
Swain,Kaisa,3156,1791,1365,56.75
Swain,Xerath,1524,778,746,51.05
Swain,Illaoi,930,451,479,48.49
Swain,Naafiri,725,444,281,61.24
Swain,Orianna,774,427,347,55.17
Swain,Zilean,592,291,301,49.16
Swain,Ivern,314,176,138,56.05
Swain,Velkoz,1232,652,580,52.92
Swain,Rakan,885,489,396,55.25
Swain,Karma,1951,991,960,50.79
Swain,Jayce,815,420,395,51.53
Swain,Vayne,2436,1210,1226,49.67
Swain,MonkeyKing,1223,623,600,50.94
Swain,Brand,1648,871,777,52.85
Swain,Fiora,794,389,405,48.99
Swain,Camille,611,378,233,61.87
Swain,LeeSin,2425,1361,1064,56.12
Swain,Syndra,1124,549,575,48.84
Swain,Hwei,1340,696,644,51.94
Swain,Thresh,2941,1592,1349,54.13
Swain,Ryze,590,326,264,55.25
Swain,Zeri,716,412,304,57.54
Swain,Zac,828,504,324,60.87
Swain,Viego,2623,1249,1374,47.62
Swain,Bard,509,274,235,53.83
Swain,Cassiopeia,682,336,346,49.27
Swain,Poppy,1075,586,489,54.51
Swain,Kassadin,455,203,252,44.62
Swain,Karthus,564,290,274,51.42
Swain,Pyke,1818,1022,796,56.22
Swain,Nocturne,2143,1170,973,54.6
Swain,Galio,1854,915,939,49.35
Swain,Sion,1461,785,676,53.73
Swain,Aatrox,1830,945,885,51.64
Swain,Rammus,558,271,287,48.57
Swain,Rell,1024,584,440,57.03
Swain,Corki,668,387,281,57.93
Swain,Skarner,543,311,232,57.27
Swain,Gangplank,773,425,348,54.98
Swain,Udyr,789,392,397,49.68
Swain,Vi,1850,1020,830,55.14
Swain,Nunu,1225,727,498,59.35
Swain,Taric,445,235,210,52.81
Swain,Zoe,715,451,264,63.08
Swain,Elise,1155,564,591,48.83
Swain,Kindred,1005,514,491,51.14
Swain,Sejuani,815,460,355,56.44
Swain,Ziggs,755,423,332,56.03
Swain,Evelynn,748,450,298,60.16
Swain,Amumu,2126,1047,1079,49.25
Swain,Shyvana,596,270,326,45.3
Swain,Lissandra,595,329,266,55.29
Swain,Viktor,1618,875,743,54.08
Swain,Olaf,443,217,226,48.98
Swain,Ambessa,1184,686,498,57.94
Swain,Sivir,993,511,482,51.46
Swain,Quinn,666,338,328,50.75
Swain,Akshan,724,368,356,50.83
Swain,Gwen,1000,543,457,54.3
Swain,Lucian,1161,633,528,54.52
Swain,XinZhao,1321,708,613,53.6
Swain,AurelionSol,776,361,415,46.52
Swain,Hecarim,725,397,328,54.76
Swain,Rumble,441,215,226,48.75
Swain,Belveth,488,275,213,56.35
Swain,Anivia,618,300,318,48.54
Swain,Kled,358,193,165,53.91
Swain,Renata,403,215,188,53.35
Swain,RekSai,228,119,109,52.19
Nami,Illaoi,860,481,379,55.93
Nami,Nunu,1227,602,625,49.06
Nami,Irelia,1554,860,694,55.34
Nami,Jhin,3990,2022,1968,50.68
Nami,Swain,1778,956,822,53.77
Nami,Vayne,2285,1157,1128,50.63
Nami,Nocturne,2197,1029,1168,46.84
Nami,Kaisa,2880,1465,1415,50.87
Nami,Galio,1581,753,828,47.63
Nami,Blitzcrank,1243,626,617,50.36
Nami,Mordekaiser,2483,1236,1247,49.78
Nami,Amumu,2033,980,1053,48.2
Nami,Yasuo,3463,1767,1696,51.03
Nami,Caitlyn,4946,2494,2452,50.42
Nami,Soraka,1407,721,686,51.24
Nami,Shen,1210,673,537,55.62
Nami,Gragas,1108,591,517,53.34
Nami,Yone,3177,1645,1532,51.78
Nami,Ashe,3505,1800,1705,51.36
Nami,Alistar,664,369,295,55.57
Nami,TwistedFate,769,419,350,54.49
Nami,LeeSin,2221,1265,956,56.96
Nami,Nilah,819,403,416,49.21
Nami,Brand,1287,656,631,50.97
Nami,Sett,2803,1319,1484,47.06
Nami,Briar,1353,704,649,52.03
Nami,Hwei,1420,743,677,52.32
Nami,TahmKench,1656,859,797,51.87
Nami,KSante,843,478,365,56.7
Nami,Udyr,799,455,344,56.95
Nami,Veigar,2029,1026,1003,50.57
Nami,Nautilus,1954,1110,844,56.81
Nami,Kayn,2904,1506,1398,51.86
Nami,MissFortune,4126,2199,1927,53.3
Nami,Lux,5234,2684,2550,51.28
Nami,Volibear,2229,1194,1035,53.57
Nami,Ivern,412,193,219,46.84
Nami,Chogath,2598,1290,1308,49.65
Nami,Jayce,792,427,365,53.91
Nami,Samira,1494,783,711,52.41
Nami,Lulu,3358,1781,1577,53.04
Nami,Zed,2112,1182,930,55.97
Nami,Ekko,1757,927,830,52.76
Nami,Tristana,1629,825,804,50.64
Nami,Kayle,1505,783,722,52.03
Nami,FiddleSticks,938,437,501,46.59
Nami,Katarina,1605,880,725,54.83
Nami,Riven,987,545,442,55.22
Nami,Lillia,943,522,421,55.36
Nami,Orianna,914,480,434,52.52
Nami,Velkoz,1226,608,618,49.59
Nami,Garen,3039,1406,1633,46.27
Nami,Aurora,1402,723,679,51.57
Nami,Heimerdinger,876,384,492,43.84
Nami,Viktor,1723,917,806,53.22
Nami,Aatrox,1900,1006,894,52.95
Nami,Cassiopeia,596,276,320,46.31
Nami,Varus,1713,876,837,51.14
Nami,Morgana,2153,1098,1055,51
Nami,Olaf,415,184,231,44.34
Nami,Yorick,1971,921,1050,46.73
Nami,Diana,3115,1569,1546,50.37
Nami,Akali,1838,954,884,51.9
Nami,Twitch,1695,818,877,48.26
Nami,Zilean,714,358,356,50.14
Nami,Fiora,843,392,451,46.5
Nami,Rammus,542,275,267,50.74
Nami,Renekton,985,573,412,58.17
Nami,Zyra,1707,757,950,44.35
Nami,Nidalee,495,302,193,61.01
Nami,Vex,854,437,417,51.17
Nami,Sivir,1016,551,465,54.23
Nami,Karma,2721,1461,1260,53.69
Nami,Sion,1708,837,871,49
Nami,Evelynn,809,402,407,49.69
Nami,Rell,1001,493,508,49.25
Nami,Leblanc,1027,514,513,50.05
Nami,Aphelios,1134,592,542,52.2
Nami,Warwick,2720,1416,1304,52.06
Nami,Ezreal,3988,2183,1805,54.74
Nami,Teemo,2388,1211,1177,50.71
Nami,Shaco,1850,975,875,52.7
Nami,Nasus,1182,622,560,52.62
Nami,Mel,3869,1985,1884,51.31
Nami,Thresh,2636,1386,1250,52.58
Nami,Fizz,1097,612,485,55.79
Nami,Jinx,5293,2548,2745,48.14
Nami,Milio,1586,746,840,47.04
Nami,Talon,1117,531,586,47.54
Nami,Kalista,530,302,228,56.98
Nami,Pyke,1600,828,772,51.75
Nami,MasterYi,2003,978,1025,48.83
Nami,Darius,3674,1821,1853,49.56
Nami,Gangplank,925,468,457,50.59
Nami,Poppy,1010,527,483,52.18
Nami,Tryndamere,1036,527,509,50.87
Nami,Singed,585,302,283,51.62
Nami,Draven,1242,655,587,52.74
Nami,Neeko,994,516,478,51.91
Nami,Camille,757,368,389,48.61
Nami,Jax,1579,808,771,51.17
Nami,Vladimir,1252,654,598,52.24
Nami,Skarner,570,320,250,56.14
Nami,Rengar,845,502,343,59.41
Nami,Naafiri,710,358,352,50.42
Nami,Lucian,1344,729,615,54.24
Nami,Ahri,2514,1306,1208,51.95
Nami,Ziggs,698,367,331,52.58
Nami,XinZhao,1239,616,623,49.72
Nami,Taric,403,174,229,43.18
Nami,Yuumi,1845,916,929,49.65
Nami,Leona,1468,739,729,50.34
Nami,AurelionSol,729,334,395,45.82
Nami,Gwen,1118,633,485,56.62
Nami,Urgot,1075,510,565,47.44
Nami,Kassadin,497,232,265,46.68
Nami,Senna,1594,854,740,53.58
Nami,Renata,452,241,211,53.32
Nami,Viego,2542,1317,1225,51.81
Nami,Braum,1207,616,591,51.04
Nami,Vi,1846,985,861,53.36
Nami,Syndra,1373,733,640,53.39
Nami,Gnar,900,484,416,53.78
Nami,Xayah,1022,552,470,54.01
Nami,DrMundo,1140,494,646,43.33
Nami,Lissandra,695,369,326,53.09
Nami,Ornn,875,504,371,57.6
Nami,Seraphine,1591,808,783,50.79
Nami,Corki,884,481,403,54.41
Nami,Zoe,804,426,378,52.99
Nami,Kennen,557,313,244,56.19
Nami,Kindred,1009,504,505,49.95
Nami,Zeri,812,442,370,54.43
Nami,Akshan,784,411,373,52.42
Nami,Sona,773,390,383,50.45
Nami,Maokai,775,396,379,51.1
Nami,Pantheon,2780,1458,1322,52.45
Nami,Malphite,1919,1018,901,53.05
Nami,Sylas,2076,1090,986,52.5
Nami,Janna,903,471,432,52.16
Nami,Ryze,631,302,329,47.86
Nami,Trundle,985,464,521,47.11
Nami,Quinn,700,351,349,50.14
Nami,Khazix,1186,602,584,50.76
Nami,Qiyana,578,346,232,59.86
Nami,Taliyah,553,298,255,53.89
Nami,Elise,1447,782,665,54.04
Nami,Ambessa,1199,656,543,54.71
Nami,Zac,821,427,394,52.01
Nami,RekSai,284,147,137,51.76
Nami,Malzahar,2017,1019,998,50.52
Nami,Smolder,1426,742,684,52.03
Nami,JarvanIV,1229,640,589,52.07
Nami,Rakan,957,506,451,52.87
Nami,Hecarim,813,428,385,52.64
Nami,Kled,411,209,202,50.85
Nami,Xerath,1593,781,812,49.03
Nami,KogMaw,638,334,304,52.35
Nami,Annie,656,340,316,51.83
Nami,MonkeyKing,1256,674,582,53.66
Nami,Azir,607,299,308,49.26
Nami,Graves,1097,600,497,54.69
Nami,Sejuani,801,390,411,48.69
Nami,Karthus,536,322,214,60.07
Nami,Belveth,544,287,257,52.76
Nami,Rumble,432,228,204,52.78
Nami,Anivia,705,355,350,50.35
Nami,Bard,724,342,382,47.24
Nami,Shyvana,499,266,233,53.31
Kayle,Illaoi,713,401,312,56.24
Kayle,Twitch,1182,666,516,56.35
Kayle,Yone,2260,1122,1138,49.65
Kayle,Lux,3509,1844,1665,52.55
Kayle,Velkoz,871,450,421,51.66
Kayle,Sett,2135,1099,1036,51.48
Kayle,Taliyah,313,173,140,55.27
Kayle,Sylas,1607,851,756,52.96
Kayle,Ezreal,2676,1434,1242,53.59
Kayle,Morgana,1824,955,869,52.36
Kayle,Aatrox,1238,665,573,53.72
Kayle,Ashe,2301,1158,1143,50.33
Kayle,Aphelios,839,489,350,58.28
Kayle,Gragas,794,404,390,50.88
Kayle,KSante,629,348,281,55.33
Kayle,Nasus,1212,554,658,45.71
Kayle,TahmKench,1072,537,535,50.09
Kayle,Fizz,768,400,368,52.08
Kayle,Irelia,1342,661,681,49.25
Kayle,Nocturne,1434,771,663,53.77
Kayle,Jayce,491,258,233,52.55
Kayle,Jhin,2672,1374,1298,51.42
Kayle,Senna,1182,606,576,51.27
Kayle,Yasuo,2722,1483,1239,54.48
Kayle,Naafiri,511,269,242,52.64
Kayle,Leblanc,653,342,311,52.37
Kayle,MissFortune,3104,1560,1544,50.26
Kayle,Nami,1505,720,785,47.84
Kayle,Singed,455,266,189,58.46
Kayle,Galio,1059,485,574,45.8
Kayle,Smolder,1057,563,494,53.26
Kayle,Brand,988,533,455,53.95
Kayle,Aurora,1033,549,484,53.15
Kayle,Jinx,3578,1790,1788,50.03
Kayle,Seraphine,1351,698,653,51.67
Kayle,MonkeyKing,795,416,379,52.33
Kayle,Vex,747,375,372,50.2
Kayle,Vayne,1658,820,838,49.46
Kayle,Briar,1143,522,621,45.67
Kayle,Fiora,523,307,216,58.7
Kayle,Cassiopeia,457,223,234,48.8
Kayle,Darius,2807,1401,1406,49.91
Kayle,Warwick,2061,983,1078,47.7
Kayle,Shen,907,474,433,52.26
Kayle,Lillia,810,464,346,57.28
Kayle,Sivir,614,311,303,50.65
Kayle,Neeko,681,386,295,56.68
Kayle,Vladimir,982,495,487,50.41
Kayle,Rammus,441,218,223,49.43
Kayle,Swain,1411,671,740,47.55
Kayle,Ekko,1265,656,609,51.86
Kayle,Qiyana,338,177,161,52.37
Kayle,Zeri,510,285,225,55.88
Kayle,TwistedFate,521,292,229,56.05
Kayle,Gnar,453,241,212,53.2
Kayle,Diana,2053,988,1065,48.12
Kayle,Veigar,1531,757,774,49.44
Kayle,Lucian,893,465,428,52.07
Kayle,Renekton,541,239,302,44.18
Kayle,Kayn,1935,976,959,50.44
Kayle,Caitlyn,3733,1858,1875,49.77
Kayle,Mel,2971,1560,1411,52.51
Kayle,Pantheon,2221,980,1241,44.12
Kayle,Zed,1289,756,533,58.65
Kayle,Nautilus,1359,734,625,54.01
Kayle,Mordekaiser,2027,1107,920,54.61
Kayle,Anivia,539,276,263,51.21
Kayle,Pyke,1352,744,608,55.03
Kayle,Chogath,1814,968,846,53.36
Kayle,Kaisa,1876,1048,828,55.86
Kayle,Yorick,1491,746,745,50.03
Kayle,Nunu,915,479,436,52.35
Kayle,Rakan,584,280,304,47.95
Kayle,Rumble,291,163,128,56.01
Kayle,Shaco,1241,665,576,53.59
Kayle,Talon,797,441,356,55.33
Kayle,Tristana,1405,657,748,46.76
Kayle,Soraka,795,385,410,48.43
Kayle,JarvanIV,781,366,415,46.86
Kayle,LeeSin,1341,709,632,52.87
Kayle,Hwei,992,469,523,47.28
Kayle,Ornn,612,323,289,52.78
Kayle,Xayah,678,328,350,48.38
Kayle,Zyra,1033,517,516,50.05
Kayle,Corki,520,292,228,56.15
Kayle,Ziggs,454,221,233,48.68
Kayle,Vi,1322,717,605,54.24
Kayle,Katarina,1161,652,509,56.16
Kayle,Draven,765,429,336,56.08
Kayle,XinZhao,723,366,357,50.62
Kayle,Viego,1637,810,827,49.48
Kayle,Quinn,502,233,269,46.41
Kayle,DrMundo,753,381,372,50.6
Kayle,Jax,1417,697,720,49.19
Kayle,Malphite,1424,730,694,51.26
Kayle,Ahri,1838,965,873,52.5
Kayle,Renata,245,115,130,46.94
Kayle,Teemo,1801,880,921,48.86
Kayle,Samira,1127,605,522,53.68
Kayle,Graves,837,407,430,48.63
Kayle,Shyvana,357,140,217,39.22
Kayle,Amumu,1520,722,798,47.5
Kayle,Garen,2545,1410,1135,55.4
Kayle,KogMaw,443,212,231,47.86
Kayle,Karma,1340,768,572,57.31
Kayle,Evelynn,613,335,278,54.65
Kayle,Nilah,547,260,287,47.53
Kayle,Leona,1051,544,507,51.76
Kayle,Akali,1420,745,675,52.46
Kayle,Blitzcrank,878,453,425,51.59
Kayle,Malzahar,1445,721,724,49.9
Kayle,Rell,603,340,263,56.38
Kayle,Belveth,355,174,181,49.01
Kayle,Kled,268,120,148,44.78
Kayle,Kalista,511,270,241,52.84
Kayle,Khazix,704,421,283,59.8
Kayle,AurelionSol,544,275,269,50.55
Kayle,Thresh,1709,874,835,51.14
Kayle,Gangplank,694,414,280,59.65
Kayle,Volibear,1582,821,761,51.9
Kayle,Sona,521,268,253,51.44
Kayle,Braum,788,405,383,51.4
Kayle,Ryze,433,215,218,49.65
Kayle,Annie,445,210,235,47.19
Kayle,Udyr,521,273,248,52.4
Kayle,Hecarim,583,308,275,52.83
Kayle,Janna,455,256,199,56.26
Kayle,Poppy,781,325,456,41.61
Kayle,Viktor,1100,550,550,50
Kayle,Ivern,186,103,83,55.38
Kayle,MasterYi,1577,759,818,48.13
Kayle,Camille,396,209,187,52.78
Kayle,Kennen,392,225,167,57.4
Kayle,FiddleSticks,649,332,317,51.16
Kayle,Kassadin,330,154,176,46.67
Kayle,Heimerdinger,597,278,319,46.57
Kayle,Akshan,556,250,306,44.96
Kayle,Milio,837,431,406,51.49
Kayle,Olaf,261,153,108,58.62
Kayle,Xerath,1139,541,598,47.5
Kayle,Ambessa,720,383,337,53.19
Kayle,Tryndamere,803,402,401,50.06
Kayle,Sejuani,479,246,233,51.36
Kayle,Elise,791,371,420,46.9
Kayle,Yuumi,1137,559,578,49.16
Kayle,Sion,1074,548,526,51.02
Kayle,Lulu,1495,843,652,56.39
Kayle,Alistar,463,245,218,52.92
Kayle,Urgot,827,414,413,50.06
Kayle,Riven,531,284,247,53.48
Kayle,Skarner,397,239,158,60.2
Kayle,Nidalee,334,215,119,64.37
Kayle,Gwen,722,396,326,54.85
Kayle,Syndra,828,446,382,53.86
Kayle,Zilean,457,212,245,46.39
Kayle,Lissandra,432,228,204,52.78
Kayle,Kindred,700,422,278,60.29
Kayle,Zac,548,295,253,53.83
Kayle,Karthus,382,219,163,57.33
Kayle,Varus,1157,629,528,54.36
Kayle,Trundle,691,335,356,48.48
Kayle,Maokai,673,317,356,47.1
Kayle,Taric,353,170,183,48.16
Kayle,RekSai,166,92,74,55.42
Kayle,Azir,441,231,210,52.38
Kayle,Bard,410,200,210,48.78
Kayle,Zoe,490,264,226,53.88
Kayle,Orianna,504,218,286,43.25
Kayle,Rengar,494,264,230,53.44
Caitlyn,Illaoi,2563,1246,1317,48.61
Caitlyn,Twitch,4145,2175,1970,52.47
Caitlyn,Yone,9765,5163,4602,52.87
Caitlyn,Lux,13645,6735,6910,49.36
Caitlyn,Velkoz,3283,1591,1692,48.46
Caitlyn,Pantheon,8056,4050,4006,50.27
Caitlyn,Diana,7980,3864,4116,48.42
Caitlyn,Gangplank,2393,1242,1151,51.9
Caitlyn,Ezreal,14457,7422,7035,51.34
Caitlyn,Yuumi,4201,2156,2045,51.32
Caitlyn,Mordekaiser,7142,3528,3614,49.4
Caitlyn,Viego,7034,3397,3637,48.29
Caitlyn,Irelia,4635,2224,2411,47.98
Caitlyn,Jhin,12937,6345,6592,49.05
Caitlyn,Yorick,5292,2354,2938,44.48
Caitlyn,Kayn,7701,3961,3740,51.43
Caitlyn,Ryze,1718,868,850,50.52
Caitlyn,Briar,4100,2037,2063,49.68
Caitlyn,Vex,2841,1362,1479,47.94
Caitlyn,LeeSin,6925,3611,3314,52.14
Caitlyn,MissFortune,14303,6981,7322,48.81
Caitlyn,Mel,10534,5417,5117,51.42
Caitlyn,Zed,5782,3092,2690,53.48
Caitlyn,Galio,4186,2190,1996,52.32
Caitlyn,TahmKench,4555,2387,2168,52.4
Caitlyn,Warwick,7999,4031,3968,50.39
Caitlyn,Yasuo,10380,5154,5226,49.65
Caitlyn,Teemo,6830,3345,3485,48.98
Caitlyn,XinZhao,3063,1489,1574,48.61
Caitlyn,Jinx,16453,8059,8394,48.98
Caitlyn,Neeko,2860,1420,1440,49.65
Caitlyn,Morgana,6303,3061,3242,48.56
Caitlyn,Xayah,2862,1475,1387,51.54
Caitlyn,Veigar,5572,2744,2828,49.25
Caitlyn,Aatrox,4556,2459,2097,53.97
Caitlyn,Ekko,4721,2479,2242,52.51
Caitlyn,Orianna,2273,1139,1134,50.11
Caitlyn,Malzahar,5132,2420,2712,47.16
Caitlyn,Maokai,2325,1136,1189,48.86
Caitlyn,Ambessa,3129,1648,1481,52.67
Caitlyn,AurelionSol,2120,1040,1080,49.06
Caitlyn,Khazix,2870,1548,1322,53.94
Caitlyn,Nautilus,5763,2764,2999,47.96
Caitlyn,Lillia,3059,1582,1477,51.72
Caitlyn,Tristana,5269,2730,2539,51.81
Caitlyn,Poppy,3019,1530,1489,50.68
Caitlyn,Heimerdinger,2522,1200,1322,47.58
Caitlyn,Ziggs,2391,1194,1197,49.94
Caitlyn,Olaf,1131,576,555,50.93
Caitlyn,Seraphine,4657,2225,2432,47.78
Caitlyn,Karma,5704,2823,2881,49.49
Caitlyn,Nami,4946,2450,2496,49.53
Caitlyn,Rakan,2161,1134,1027,52.48
Caitlyn,Soraka,2755,1284,1471,46.61
Caitlyn,Aurora,3891,2090,1801,53.71
Caitlyn,Kaisa,8023,4280,3743,53.35
Caitlyn,Chogath,6317,3007,3310,47.6
Caitlyn,Talon,2903,1592,1311,54.84
Caitlyn,Qiyana,1435,785,650,54.7
Caitlyn,Shaco,5027,2665,2362,53.01
Caitlyn,Anivia,1595,821,774,51.47
Caitlyn,Garen,8105,4051,4054,49.98
Caitlyn,Zeri,1875,941,934,50.19
Caitlyn,Zyra,4653,2261,2392,48.59
Caitlyn,Volibear,5956,2974,2982,49.93
Caitlyn,Ashe,11726,5937,5789,50.63
Caitlyn,Trundle,3116,1583,1533,50.8
Caitlyn,Leblanc,2765,1405,1360,50.81
Caitlyn,Elise,3453,1663,1790,48.16
Caitlyn,Amumu,5524,2645,2879,47.88
Caitlyn,Pyke,4744,2445,2299,51.54
Caitlyn,Varus,5077,2534,2543,49.91
Caitlyn,Thresh,6744,3500,3244,51.9
Caitlyn,Jax,4620,2471,2149,53.48
Caitlyn,Gragas,2871,1569,1302,54.65
Caitlyn,Rell,2657,1304,1353,49.08
Caitlyn,Camille,1673,872,801,52.12
Caitlyn,MasterYi,6104,3037,3067,49.75
Caitlyn,Malphite,4976,2435,2541,48.93
Caitlyn,Udyr,2054,1083,971,52.73
Caitlyn,Evelynn,2083,1071,1012,51.42
Caitlyn,Akali,5554,2948,2606,53.08
Caitlyn,Vi,5016,2490,2526,49.64
Caitlyn,Akshan,1822,901,921,49.45
Caitlyn,Darius,9686,4822,4864,49.78
Caitlyn,Azir,1822,923,899,50.66
Caitlyn,Ivern,811,431,380,53.14
Caitlyn,Katarina,4107,2132,1975,51.91
Caitlyn,JarvanIV,2601,1173,1428,45.1
Caitlyn,Hwei,3582,1630,1952,45.51
Caitlyn,Bard,1643,898,745,54.66
Caitlyn,Tryndamere,2938,1548,1390,52.69
Caitlyn,Nidalee,1387,735,652,52.99
Caitlyn,Draven,2707,1420,1287,52.46
Caitlyn,Renekton,2443,1220,1223,49.94
Caitlyn,Quinn,1842,852,990,46.25
Caitlyn,Zoe,2032,1033,999,50.84
Caitlyn,Janna,1449,767,682,52.93
Caitlyn,Lucian,3507,1834,1673,52.3
Caitlyn,Nasus,3828,2003,1825,52.32
Caitlyn,Kindred,2366,1289,1077,54.48
Caitlyn,Riven,2182,1178,1004,53.99
Caitlyn,TwistedFate,1882,1005,877,53.4
Caitlyn,Sett,8087,3797,4290,46.95
Caitlyn,Blitzcrank,4024,2061,1963,51.22
Caitlyn,Shen,3243,1535,1708,47.33
Caitlyn,Ahri,7016,3616,3400,51.54
Caitlyn,Samira,4254,2276,1978,53.5
Caitlyn,MonkeyKing,3271,1628,1643,49.77
Caitlyn,Smolder,3785,1994,1791,52.68
Caitlyn,Brand,4092,2020,2072,49.36
Caitlyn,Skarner,1348,743,605,55.12
Caitlyn,Singed,1413,673,740,47.63
Caitlyn,KogMaw,1667,849,818,50.93
Caitlyn,Vladimir,3244,1653,1591,50.96
Caitlyn,Corki,1829,1025,804,56.04
Caitlyn,Cassiopeia,1643,810,833,49.3
Caitlyn,Swain,5251,2674,2577,50.92
Caitlyn,Zilean,1600,786,814,49.13
Caitlyn,Rammus,1597,734,863,45.96
Caitlyn,Hecarim,1980,991,989,50.05
Caitlyn,Zac,2492,1293,1199,51.89
Caitlyn,Kalista,1575,897,678,56.95
Caitlyn,Nocturne,5924,2699,3225,45.56
Caitlyn,Sion,3751,1803,1948,48.07
Caitlyn,Gnar,2138,1065,1073,49.81
Caitlyn,Graves,3071,1583,1488,51.55
Caitlyn,Sejuani,2174,1138,1036,52.35
Caitlyn,Lissandra,1544,793,751,51.36
Caitlyn,FiddleSticks,2509,1312,1197,52.29
Caitlyn,Milio,3118,1495,1623,47.95
Caitlyn,Xerath,4809,2299,2510,47.81
Caitlyn,Lulu,5663,2949,2714,52.07
Caitlyn,Rengar,1725,947,778,54.9
Caitlyn,Kennen,1429,763,666,53.39
Caitlyn,Annie,1558,748,810,48.01
Caitlyn,Senna,4158,2086,2072,50.17
Caitlyn,Aphelios,3163,1570,1593,49.64
Caitlyn,Vayne,6159,3141,3018,51
Caitlyn,Sona,1683,763,920,45.34
Caitlyn,Kayle,3733,1875,1858,50.23
Caitlyn,Fiora,1866,987,879,52.89
Caitlyn,Gwen,2583,1333,1250,51.61
Caitlyn,Braum,3012,1506,1506,50
Caitlyn,Leona,4255,2171,2084,51.02
Caitlyn,Karthus,1298,683,615,52.62
Caitlyn,Kassadin,1104,582,522,52.72
Caitlyn,Viktor,4280,2173,2107,50.77
Caitlyn,Urgot,2650,1192,1458,44.98
Caitlyn,Nilah,1877,930,947,49.55
Caitlyn,Taliyah,1187,605,582,50.97
Caitlyn,Sivir,2893,1414,1479,48.88
Caitlyn,Syndra,3218,1586,1632,49.29
Caitlyn,Shyvana,1296,593,703,45.76
Caitlyn,KSante,2559,1340,1219,52.36
Caitlyn,RekSai,572,299,273,52.27
Caitlyn,Sylas,6534,3298,3236,50.47
Caitlyn,Naafiri,1948,965,983,49.54
Caitlyn,Belveth,1155,600,555,51.95
Caitlyn,Alistar,2018,1050,968,52.03
Caitlyn,Nunu,3377,1756,1621,52
Caitlyn,Jayce,2331,1294,1037,55.51
Caitlyn,Ornn,2173,1070,1103,49.24
Caitlyn,Fizz,2920,1517,1403,51.95
Caitlyn,Taric,1096,526,570,47.99
Caitlyn,DrMundo,2945,1360,1585,46.18
Caitlyn,Renata,943,510,433,54.08
Caitlyn,Rumble,1163,597,566,51.33
Caitlyn,Kled,985,499,486,50.66
Renata,Illaoi,190,92,98,48.42
Renata,Twitch,353,204,149,57.79
Renata,Yone,689,362,327,52.54
Renata,Lux,926,470,456,50.76
Renata,Velkoz,192,68,124,35.42
Renata,Malphite,383,174,209,45.43
Renata,Diana,574,259,315,45.12
Renata,Akali,442,214,228,48.42
Renata,Jinx,1026,513,513,50
Renata,Warwick,568,281,287,49.47
Renata,Vex,169,77,92,45.56
Renata,Yuumi,275,121,154,44
Renata,Camille,185,67,118,36.22
Renata,Azir,171,78,93,45.61
Renata,Kaisa,656,324,332,49.39
Renata,Braum,215,111,104,51.63
Renata,Naafiri,144,82,62,56.94
Renata,Zac,181,106,75,58.56
Renata,Ahri,541,245,296,45.29
Renata,Nilah,214,104,110,48.6
Renata,Zyra,293,144,149,49.15
Renata,Darius,693,301,392,43.43
Renata,Mel,652,339,313,51.99
Renata,TwistedFate,162,90,72,55.56
Renata,Maokai,208,111,97,53.37
Renata,Shaco,341,198,143,58.06
Renata,Qiyana,94,58,36,61.7
Renata,Ziggs,129,52,77,40.31
Renata,Kayn,604,281,323,46.52
Renata,Senna,352,164,188,46.59
Renata,Ashe,752,353,399,46.94
Renata,Irelia,359,166,193,46.24
Renata,Teemo,502,280,222,55.78
Renata,MasterYi,490,209,281,42.65
Renata,Yasuo,774,364,410,47.03
Renata,Aphelios,266,122,144,45.86
Renata,Janna,134,76,58,56.72
Renata,LeeSin,507,289,218,57
Renata,Zed,418,207,211,49.52
Renata,KogMaw,138,50,88,36.23
Renata,Nami,452,211,241,46.68
Renata,Garen,611,302,309,49.43
Renata,Kayle,245,130,115,53.06
Renata,Kled,98,40,58,40.82
Renata,Vi,429,208,221,48.48
Renata,Aurora,309,165,144,53.4
Renata,Thresh,584,286,298,48.97
Renata,Yorick,345,173,172,50.14
Renata,Briar,309,162,147,52.43
Renata,Neeko,258,137,121,53.1
Renata,Nautilus,550,269,281,48.91
Renata,Mordekaiser,543,289,254,53.22
Renata,Ekko,291,137,154,47.08
Renata,Heimerdinger,180,105,75,58.33
Renata,Blitzcrank,228,114,114,50
Renata,Singed,76,45,31,59.21
Renata,Ezreal,792,419,373,52.9
Renata,Volibear,455,219,236,48.13
Renata,Khazix,184,122,62,66.3
Renata,Lucian,228,89,139,39.04
Renata,Ambessa,249,146,103,58.63
Renata,Pantheon,545,297,248,54.5
Renata,Zeri,144,76,68,52.78
Renata,Elise,241,116,125,48.13
Renata,Fizz,189,84,105,44.44
Renata,Samira,372,191,181,51.34
Renata,Rell,265,143,122,53.96
Renata,Cassiopeia,109,50,59,45.87
Renata,Riven,200,106,94,53
Renata,Vayne,408,215,193,52.7
Renata,JarvanIV,268,149,119,55.6
Renata,Katarina,306,154,152,50.33
Renata,Morgana,431,222,209,51.51
Renata,Milio,279,144,135,51.61
Renata,Gangplank,190,107,83,56.32
Renata,Varus,289,157,132,54.33
Renata,Lulu,515,235,280,45.63
Renata,Viego,535,234,301,43.74
Renata,Sona,147,78,69,53.06
Renata,Zilean,130,64,66,49.23
Renata,Jhin,724,379,345,52.35
Renata,Sett,470,189,281,40.21
Renata,Caitlyn,943,433,510,45.92
Renata,Seraphine,301,158,143,52.49
Renata,Aatrox,382,206,176,53.93
Renata,Lillia,189,82,107,43.39
Renata,Taliyah,120,49,71,40.83
Renata,Poppy,312,166,146,53.21
Renata,MissFortune,830,395,435,47.59
Renata,Karthus,77,39,38,50.65
Renata,Gnar,247,126,121,51.01
Renata,Fiora,169,98,71,57.99
Renata,Olaf,80,33,47,41.25
Renata,Veigar,364,150,214,41.21
Renata,FiddleSticks,210,90,120,42.86
Renata,Xayah,223,112,111,50.22
Renata,Belveth,137,73,64,53.28
Renata,Syndra,245,116,129,47.35
Renata,Jax,380,163,217,42.89
Renata,Amumu,349,160,189,45.85
Renata,Corki,151,59,92,39.07
Renata,Alistar,213,99,114,46.48
Renata,Shen,267,123,144,46.07
Renata,Lissandra,133,48,85,36.09
Renata,RekSai,55,28,27,50.91
Renata,Evelynn,154,73,81,47.4
Renata,Soraka,201,89,112,44.28
Renata,Trundle,194,93,101,47.94
Renata,Graves,240,121,119,50.42
Renata,Malzahar,397,173,224,43.58
Renata,Viktor,355,161,194,45.35
Renata,Smolder,326,190,136,58.28
Renata,Galio,324,163,161,50.31
Renata,Vladimir,248,126,122,50.81
Renata,Pyke,300,139,161,46.33
Renata,Gwen,210,103,107,49.05
Renata,Nocturne,452,221,231,48.89
Renata,Kennen,140,87,53,62.14
Renata,Gragas,215,106,109,49.3
Renata,Rakan,196,137,59,69.9
Renata,Chogath,426,205,221,48.12
Renata,Rumble,88,41,47,46.59
Renata,Hwei,239,121,118,50.63
Renata,Ivern,77,32,45,41.56
Renata,TahmKench,347,164,183,47.26
Renata,Urgot,197,88,109,44.67
Renata,Tryndamere,230,118,112,51.3
Renata,Karma,464,228,236,49.14
Renata,Orianna,182,94,88,51.65
Renata,MonkeyKing,255,118,137,46.27
Renata,Sylas,441,216,225,48.98
Renata,Renekton,195,83,112,42.56
Renata,Kindred,206,70,136,33.98
Renata,Draven,209,101,108,48.33
Renata,AurelionSol,146,65,81,44.52
Renata,Rengar,195,110,85,56.41
Renata,KSante,171,80,91,46.78
Renata,Talon,224,142,82,63.39
Renata,Brand,222,105,117,47.3
Renata,Anivia,112,57,55,50.89
Renata,Hecarim,121,68,53,56.2
Renata,Sejuani,179,93,86,51.96
Renata,Ornn,182,76,106,41.76
Renata,Ryze,139,74,65,53.24
Renata,Jayce,162,79,83,48.77
Renata,Sivir,236,107,129,45.34
Renata,Swain,403,188,215,46.65
Renata,Tristana,405,198,207,48.89
Renata,Kalista,164,111,53,67.68
Renata,Udyr,109,58,51,53.21
Renata,Zoe,174,77,97,44.25
Renata,Nasus,286,151,135,52.8
Renata,DrMundo,192,83,109,43.23
Renata,Annie,118,37,81,31.36
Renata,Bard,134,56,78,41.79
Renata,Leona,288,163,125,56.6
Renata,Rammus,100,61,39,61
Renata,Akshan,197,115,82,58.38
Renata,Quinn,99,51,48,51.52
Renata,Sion,258,112,146,43.41
Renata,Nidalee,95,47,48,49.47
Renata,Leblanc,190,85,105,44.74
Renata,Xerath,299,127,172,42.47
Renata,Skarner,125,64,61,51.2
Renata,Taric,91,46,45,50.55
Renata,Shyvana,83,50,33,60.24
Renata,Kassadin,66,16,50,24.24
Renata,XinZhao,217,83,134,38.25
Renata,Nunu,213,79,134,37.09
Ambessa,Talon,734,369,365,50.27
Ambessa,Aurora,1022,525,497,51.37
Ambessa,Yasuo,2504,1215,1289,48.52
Ambessa,Tristana,1044,555,489,53.16
Ambessa,Alistar,525,287,238,54.67
Ambessa,Poppy,888,406,482,45.72
Ambessa,Diana,1922,949,973,49.38
Ambessa,Anivia,412,233,179,56.55
Ambessa,Caitlyn,3129,1481,1648,47.33
Ambessa,Thresh,1785,886,899,49.64
Ambessa,KSante,921,458,463,49.73
Ambessa,Darius,2090,924,1166,44.21
Ambessa,Azir,534,264,270,49.44
Ambessa,Aphelios,689,312,377,45.28
Ambessa,Soraka,708,369,339,52.12
Ambessa,Akali,1346,656,690,48.74
Ambessa,Viego,1942,949,993,48.87
Ambessa,Leblanc,824,407,417,49.39
Ambessa,Sett,2030,925,1105,45.57
Ambessa,Rammus,351,176,175,50.14
Ambessa,Pyke,1042,556,486,53.36
Ambessa,Yorick,977,429,548,43.91
Ambessa,Shaco,1014,512,502,50.49
Ambessa,Katarina,986,496,490,50.3
Ambessa,Lucian,863,470,393,54.46
Ambessa,Nautilus,1417,672,745,47.42
Ambessa,Karthus,390,205,185,52.56
Ambessa,Zed,1454,669,785,46.01
Ambessa,Ashe,2533,1262,1271,49.82
Ambessa,Maokai,625,278,347,44.48
Ambessa,Garen,1800,761,1039,42.28
Ambessa,Shen,887,352,535,39.68
Ambessa,Khazix,593,290,303,48.9
Ambessa,Ahri,1568,756,812,48.21
Ambessa,Samira,911,407,504,44.68
Ambessa,Ornn,604,309,295,51.16
Ambessa,Briar,894,417,477,46.64
Ambessa,Morgana,1187,578,609,48.69
Ambessa,Volibear,1261,576,685,45.68
Ambessa,Gwen,643,328,315,51.01
Ambessa,Elise,941,422,519,44.85
Ambessa,Smolder,858,439,419,51.17
Ambessa,Rengar,427,215,212,50.35
Ambessa,Hwei,792,396,396,50
Ambessa,XinZhao,839,372,467,44.34
Ambessa,Ezreal,3293,1662,1631,50.47
Ambessa,Leona,1088,554,534,50.92
Ambessa,Trundle,617,288,329,46.68
Ambessa,MasterYi,1287,570,717,44.29
Ambessa,Varus,1270,652,618,51.34
Ambessa,Lux,3012,1397,1615,46.38
Ambessa,Aatrox,1176,654,522,55.61
Ambessa,Chogath,1277,612,665,47.92
Ambessa,Ryze,489,213,276,43.56
Ambessa,Janna,460,205,255,44.57
Ambessa,Nasus,754,372,382,49.34
Ambessa,Kayn,1749,777,972,44.43
Ambessa,MissFortune,2394,1170,1224,48.87
Ambessa,Sona,373,179,194,47.99
Ambessa,Nocturne,1502,629,873,41.88
Ambessa,Neeko,635,281,354,44.25
Ambessa,LeeSin,2181,1088,1093,49.89
Ambessa,Zeri,633,301,332,47.55
Ambessa,Pantheon,2079,1027,1052,49.4
Ambessa,Sejuani,533,217,316,40.71
Ambessa,Ivern,259,142,117,54.83
Ambessa,Urgot,523,245,278,46.85
Ambessa,Jhin,2376,1182,1194,49.75
Ambessa,Karma,1525,737,788,48.33
Ambessa,Taric,269,136,133,50.56
Ambessa,Kled,209,102,107,48.8
Ambessa,Warwick,1669,774,895,46.38
Ambessa,Seraphine,909,474,435,52.15
Ambessa,Teemo,1253,561,692,44.77
Ambessa,Mel,2544,1261,1283,49.57
Ambessa,Viktor,1203,613,590,50.96
Ambessa,Twitch,922,409,513,44.36
Ambessa,Lulu,1694,787,907,46.46
Ambessa,Renekton,1015,446,569,43.94
Ambessa,Udyr,508,291,217,57.28
Ambessa,Annie,411,212,199,51.58
Ambessa,Amumu,1120,534,586,47.68
Ambessa,Braum,743,354,389,47.64
Ambessa,Shyvana,315,150,165,47.62
Ambessa,TahmKench,1021,531,490,52.01
Ambessa,Veigar,1074,525,549,48.88
Ambessa,Zilean,363,168,195,46.28
Ambessa,Vi,1286,605,681,47.05
Ambessa,Zoe,525,292,233,55.62
Ambessa,Kaisa,2053,966,1087,47.05
Ambessa,Jax,1216,637,579,52.38
Ambessa,Evelynn,480,241,239,50.21
Ambessa,Draven,622,246,376,39.55
Ambessa,Jinx,3126,1464,1662,46.83
Ambessa,Xayah,671,305,366,45.45
Ambessa,Renata,249,103,146,41.37
Ambessa,Quinn,449,193,256,42.98
Ambessa,Irelia,1124,506,618,45.02
Ambessa,Lillia,760,370,390,48.68
Ambessa,Nilah,492,188,304,38.21
Ambessa,Hecarim,534,284,250,53.18
Ambessa,Rell,615,267,348,43.41
Ambessa,Fiora,488,238,250,48.77
Ambessa,Naafiri,430,217,213,50.47
Ambessa,Orianna,715,353,362,49.37
Ambessa,Illaoi,538,226,312,42.01
Ambessa,Heimerdinger,451,199,252,44.12
Ambessa,Brand,774,383,391,49.48
Ambessa,Cassiopeia,334,175,159,52.4
Ambessa,Riven,656,280,376,42.68
Ambessa,Gnar,544,309,235,56.8
Ambessa,DrMundo,586,295,291,50.34
Ambessa,Mordekaiser,1446,673,773,46.54
Ambessa,Gragas,825,411,414,49.82
Ambessa,Galio,1177,511,666,43.42
Ambessa,Tryndamere,751,380,371,50.6
Ambessa,Sion,906,475,431,52.43
Ambessa,Senna,887,404,483,45.55
Ambessa,Syndra,774,379,395,48.97
Ambessa,Zyra,1160,514,646,44.31
Ambessa,Vladimir,704,354,350,50.28
Ambessa,Singed,355,173,182,48.73
Ambessa,Ziggs,454,219,235,48.24
Ambessa,Nami,1199,543,656,45.29
Ambessa,Malzahar,1035,484,551,46.76
Ambessa,Kalista,416,191,225,45.91
Ambessa,Qiyana,377,239,138,63.4
Ambessa,Yone,2305,1209,1096,52.45
Ambessa,TwistedFate,443,194,249,43.79
Ambessa,Rakan,584,214,370,36.64
Ambessa,Sylas,1649,834,815,50.58
Ambessa,Swain,1184,498,686,42.06
Ambessa,Bard,439,237,202,53.99
Ambessa,KogMaw,438,203,235,46.35
Ambessa,Vayne,1501,631,870,42.04
Ambessa,FiddleSticks,612,315,297,51.47
Ambessa,Blitzcrank,1048,489,559,46.66
Ambessa,Milio,727,324,403,44.57
Ambessa,JarvanIV,688,319,369,46.37
Ambessa,Kassadin,262,126,136,48.09
Ambessa,Fizz,546,230,316,42.12
Ambessa,Velkoz,751,323,428,43.01
Ambessa,Kayle,720,337,383,46.81
Ambessa,Camille,686,311,375,45.34
Ambessa,Yuumi,1044,545,499,52.2
Ambessa,AurelionSol,499,242,257,48.5
Ambessa,Jayce,812,438,374,53.94
Ambessa,Kennen,382,139,243,36.39
Ambessa,Sivir,677,334,343,49.34
Ambessa,Nunu,721,376,345,52.15
Ambessa,Belveth,369,169,200,45.8
Ambessa,Ekko,1132,559,573,49.38
Ambessa,MonkeyKing,818,367,451,44.87
Ambessa,Malphite,1084,432,652,39.85
Ambessa,Zac,639,288,351,45.07
Ambessa,Akshan,496,253,243,51.01
Ambessa,Taliyah,366,162,204,44.26
Ambessa,Graves,819,411,408,50.18
Ambessa,Xerath,1039,430,609,41.39
Ambessa,Nidalee,444,229,215,51.58
Ambessa,Skarner,400,246,154,61.5
Ambessa,Vex,676,308,368,45.56
Ambessa,Kindred,492,284,208,57.72
Ambessa,Gangplank,564,245,319,43.44
Ambessa,Lissandra,380,170,210,44.74
Ambessa,Corki,525,289,236,55.05
Ambessa,Rumble,320,176,144,55
Ambessa,Olaf,289,149,140,51.56
Ambessa,RekSai,148,63,85,42.57
Rammus,Talon,359,212,147,59.05
Rammus,Aurora,385,181,204,47.01
Rammus,Yasuo,1593,896,697,56.25
Rammus,Tristana,697,369,328,52.94
Rammus,Alistar,245,127,118,51.84
Rammus,Malphite,626,318,308,50.8
Rammus,Jax,582,352,230,60.48
Rammus,Neeko,319,177,142,55.49
Rammus,Xayah,356,194,162,54.49
Rammus,Rakan,317,153,164,48.26
Rammus,Volibear,661,318,343,48.11
Rammus,Ekko,539,235,304,43.6
Rammus,Akshan,232,119,113,51.29
Rammus,Katarina,526,310,216,58.94
Rammus,Yone,1485,861,624,57.98
Rammus,Gragas,312,171,141,54.81
Rammus,Irelia,662,359,303,54.23
Rammus,TahmKench,464,210,254,45.26
Rammus,Rell,279,142,137,50.9
Rammus,Mordekaiser,831,349,482,42
Rammus,Kayn,964,461,503,47.82
Rammus,Diana,844,395,449,46.8
Rammus,Ezreal,1212,628,584,51.82
Rammus,Thresh,820,415,405,50.61
Rammus,Chogath,706,294,412,41.64
Rammus,Ivern,98,58,40,59.18
Rammus,Lux,1501,731,770,48.7
Rammus,Ambessa,351,175,176,49.86
Rammus,XinZhao,367,197,170,53.68
Rammus,Nilah,219,129,90,58.9
Rammus,Soraka,403,185,218,45.91
Rammus,Teemo,727,385,342,52.96
Rammus,Evelynn,169,63,106,37.28
Rammus,Sylas,718,369,349,51.39
Rammus,Seraphine,491,240,251,48.88
Rammus,Malzahar,637,287,350,45.05
Rammus,Jinx,1658,785,873,47.35
Rammus,Shen,394,185,209,46.95
Rammus,Khazix,305,176,129,57.7
Rammus,Ahri,800,418,382,52.25
Rammus,Samira,507,287,220,56.61
Rammus,Maokai,269,112,157,41.64
Rammus,DrMundo,307,141,166,45.93
Rammus,Shaco,398,184,214,46.23
Rammus,Viktor,484,240,244,49.59
Rammus,Jhin,1181,595,586,50.38
Rammus,Poppy,400,195,205,48.75
Rammus,Garen,968,481,487,49.69
Rammus,Sett,915,468,447,51.15
Rammus,Lucian,397,230,167,57.93
Rammus,Sona,170,95,75,55.88
Rammus,Yorick,618,340,278,55.02
Rammus,Akali,658,338,320,51.37
Rammus,Twitch,519,243,276,46.82
Rammus,Zilean,154,67,87,43.51
Rammus,LeeSin,828,447,381,53.99
Rammus,Caitlyn,1597,863,734,54.04
Rammus,Ashe,1277,689,588,53.95
Rammus,Camille,213,115,98,53.99
Rammus,Hecarim,236,124,112,52.54
Rammus,TwistedFate,205,113,92,55.12
Rammus,Nautilus,710,395,315,55.63
Rammus,Rengar,237,151,86,63.71
Rammus,Galio,607,292,315,48.11
Rammus,Kayle,441,223,218,50.57
Rammus,Nunu,306,118,188,38.56
Rammus,Kaisa,918,486,432,52.94
Rammus,Nami,542,267,275,49.26
Rammus,Smolder,394,212,182,53.81
Rammus,MonkeyKing,328,167,161,50.91
Rammus,Sejuani,257,135,122,52.53
Rammus,Kalista,205,118,87,57.56
Rammus,Yuumi,585,325,260,55.56
Rammus,Amumu,631,259,372,41.05
Rammus,MissFortune,1346,676,670,50.22
Rammus,Renekton,301,178,123,59.14
Rammus,Leblanc,299,146,153,48.83
Rammus,Corki,218,115,103,52.75
Rammus,Morgana,787,386,401,49.05
Rammus,Illaoi,334,143,191,42.81
Rammus,Vi,524,295,229,56.3
Rammus,Syndra,354,183,171,51.69
Rammus,Lulu,726,380,346,52.34
Rammus,Darius,1153,552,601,47.88
Rammus,Quinn,244,140,104,57.38
Rammus,Orianna,268,119,149,44.4
Rammus,Pantheon,1076,557,519,51.77
Rammus,Tryndamere,412,202,210,49.03
Rammus,FiddleSticks,267,103,164,38.58
Rammus,Vayne,905,433,472,47.85
Rammus,Kindred,282,136,146,48.23
Rammus,Riven,345,207,138,60
Rammus,Karma,526,266,260,50.57
Rammus,Velkoz,351,144,207,41.03
Rammus,Pyke,696,399,297,57.33
Rammus,Gwen,381,171,210,44.88
Rammus,Brand,412,196,216,47.57
Rammus,Karthus,167,73,94,43.71
Rammus,Senna,483,278,205,57.56
Rammus,Kennen,146,80,66,54.79
Rammus,Leona,602,285,317,47.34
Rammus,Naafiri,209,126,83,60.29
Rammus,Milio,334,155,179,46.41
Rammus,Aatrox,577,323,254,55.98
Rammus,JarvanIV,294,183,111,62.24
Rammus,Cassiopeia,213,61,152,28.64
Rammus,Zyra,463,243,220,52.48
Rammus,Graves,361,199,162,55.12
Rammus,Swain,558,287,271,51.43
Rammus,Jayce,217,122,95,56.22
Rammus,Zeri,229,94,135,41.05
Rammus,Zed,765,408,357,53.33
Rammus,Gangplank,252,139,113,55.16
Rammus,Vex,341,187,154,54.84
Rammus,Singed,189,99,90,52.38
Rammus,Mel,1078,526,552,48.79
Rammus,Warwick,1154,565,589,48.96
Rammus,Vladimir,371,211,160,56.87
Rammus,Gnar,216,123,93,56.94
Rammus,MasterYi,1960,1107,853,56.48
Rammus,Fizz,392,227,165,57.91
Rammus,Kled,111,62,49,55.86
Rammus,Varus,533,238,295,44.65
Rammus,Lillia,452,211,241,46.68
Rammus,Qiyana,126,82,44,65.08
Rammus,Nasus,413,219,194,53.03
Rammus,Xerath,470,215,255,45.74
Rammus,Trundle,471,248,223,52.65
Rammus,Olaf,145,73,72,50.34
Rammus,Shyvana,136,60,76,44.12
Rammus,Ryze,224,123,101,54.91
Rammus,Sivir,248,131,117,52.82
Rammus,Sion,449,206,243,45.88
Rammus,Fiora,265,119,146,44.91
Rammus,Kassadin,152,81,71,53.29
Rammus,Ornn,214,94,120,43.93
Rammus,Elise,330,179,151,54.24
Rammus,Draven,376,176,200,46.81
Rammus,Zac,241,117,124,48.55
Rammus,Azir,207,136,71,65.7
Rammus,Heimerdinger,276,138,138,50
Rammus,AurelionSol,231,104,127,45.02
Rammus,Viego,939,489,450,52.08
Rammus,Veigar,629,317,312,50.4
Rammus,Aphelios,356,185,171,51.97
Rammus,Blitzcrank,489,263,226,53.78
Rammus,KogMaw,218,106,112,48.62
Rammus,Taliyah,132,76,56,57.58
Rammus,Urgot,382,199,183,52.09
Rammus,Ziggs,280,131,149,46.79
Rammus,Nocturne,745,338,407,45.37
Rammus,Hwei,365,174,191,47.67
Rammus,Braum,374,192,182,51.34
Rammus,Annie,154,69,85,44.81
Rammus,Lissandra,229,112,117,48.91
Rammus,Anivia,199,110,89,55.28
Rammus,RekSai,92,52,40,56.52
Rammus,Briar,711,362,349,50.91
Rammus,Rumble,160,80,80,50
Rammus,Taric,130,48,82,36.92
Rammus,KSante,259,147,112,56.76
Rammus,Renata,100,39,61,39
Rammus,Janna,214,85,129,39.72
Rammus,Nidalee,133,83,50,62.41
Rammus,Bard,146,85,61,58.22
Rammus,Udyr,176,97,79,55.11
Rammus,Belveth,179,95,84,53.07
Rammus,Skarner,97,65,32,67.01
Rammus,Zoe,228,132,96,57.89
Talon,Ambessa,734,365,369,49.73
Talon,Rammus,359,147,212,40.95
Talon,Mel,2345,1208,1137,51.51
Talon,Draven,605,325,280,53.72
Talon,Blitzcrank,863,407,456,47.16
Talon,Jax,937,471,466,50.27
Talon,Nidalee,399,242,157,60.65
Talon,Ahri,1567,726,841,46.33
Talon,Jhin,2162,1071,1091,49.54
Talon,Senna,961,419,542,43.6
Talon,Yorick,992,467,525,47.08
Talon,AurelionSol,399,167,232,41.85
Talon,Kayn,1639,731,908,44.6
Talon,Singed,287,124,163,43.21
Talon,Udyr,458,234,224,51.09
Talon,Pantheon,1951,945,1006,48.44
Talon,Leblanc,721,359,362,49.79
Talon,Sivir,674,352,322,52.23
Talon,Pyke,1076,587,489,54.55
Talon,Yone,2228,1104,1124,49.55
Talon,Briar,750,311,439,41.47
Talon,Vex,613,299,314,48.78
Talon,Jinx,2891,1332,1559,46.07
Talon,Milio,692,296,396,42.77
Talon,Teemo,1405,610,795,43.42
Talon,Poppy,796,340,456,42.71
Talon,Akali,1340,604,736,45.07
Talon,Caitlyn,2903,1311,1592,45.16
Talon,Leona,899,468,431,52.06
Talon,Nocturne,1275,681,594,53.41
Talon,Lissandra,389,184,205,47.3
Talon,Lux,2637,1137,1500,43.12
Talon,Vayne,1290,567,723,43.95
Talon,Shyvana,302,114,188,37.75
Talon,Sylas,1754,804,950,45.84
Talon,Karma,1387,736,651,53.06
Talon,Soraka,688,275,413,39.97
Talon,Nasus,601,316,285,52.58
Talon,Kindred,569,290,279,50.97
Talon,Malzahar,1129,493,636,43.67
Talon,Tristana,1073,482,591,44.92
Talon,Nautilus,1296,607,689,46.84
Talon,Fiora,496,231,265,46.57
Talon,Elise,1007,478,529,47.47
Talon,Garen,1604,694,910,43.27
Talon,Ashe,2223,1097,1126,49.35
Talon,Trundle,603,330,273,54.73
Talon,Naafiri,454,218,236,48.02
Talon,Aphelios,649,297,352,45.76
Talon,Shen,671,307,364,45.75
Talon,Amumu,1117,463,654,41.45
Talon,MissFortune,2492,1157,1335,46.43
Talon,Xerath,918,424,494,46.19
Talon,LeeSin,1964,1064,900,54.18
Talon,Kaisa,1966,972,994,49.44
Talon,Qiyana,342,174,168,50.88
Talon,Swain,1044,514,530,49.23
Talon,Sett,1757,743,1014,42.29
Talon,Mordekaiser,1356,579,777,42.7
Talon,Veigar,1007,461,546,45.78
Talon,Thresh,1566,675,891,43.1
Talon,Varus,1104,502,602,45.47
Talon,Zyra,969,443,526,45.72
Talon,Galio,941,450,491,47.82
Talon,Ezreal,2868,1423,1445,49.62
Talon,Seraphine,888,459,429,51.69
Talon,Darius,2037,994,1043,48.8
Talon,Shaco,1232,605,627,49.11
Talon,Zed,1440,714,726,49.58
Talon,Braum,594,260,334,43.77
Talon,Volibear,1135,530,605,46.7
Talon,Nami,1117,586,531,52.46
Talon,Rengar,474,238,236,50.21
Talon,Lucian,874,491,383,56.18
Talon,Ekko,1100,587,513,53.36
Talon,Velkoz,619,260,359,42
Talon,Yasuo,2518,1112,1406,44.16
Talon,Diana,1902,922,980,48.48
Talon,Sion,938,409,529,43.6
Talon,Orianna,519,245,274,47.21
Talon,Camille,547,238,309,43.51
Talon,Viktor,1067,533,534,49.95
Talon,Zeri,547,307,240,56.12
Talon,Kayle,797,356,441,44.67
Talon,Brand,736,349,387,47.42
Talon,Rakan,521,227,294,43.57
Talon,Lulu,1548,748,800,48.32
Talon,KogMaw,318,155,163,48.74
Talon,MasterYi,1201,549,652,45.71
Talon,Janna,451,197,254,43.68
Talon,Vladimir,851,363,488,42.66
Talon,Alistar,475,205,270,43.16
Talon,Gangplank,585,287,298,49.06
Talon,Nunu,756,366,390,48.41
Talon,Jayce,675,357,318,52.89
Talon,Kalista,360,168,192,46.67
Talon,Neeko,687,368,319,53.57
Talon,Chogath,1385,658,727,47.51
Talon,Quinn,426,187,239,43.9
Talon,Lillia,680,382,298,56.18
Talon,Gragas,716,308,408,43.02
Talon,Xayah,690,306,384,44.35
Talon,Vi,1174,563,611,47.96
Talon,Evelynn,518,265,253,51.16
Talon,Rell,593,259,334,43.68
Talon,Anivia,406,206,200,50.74
Talon,Urgot,537,244,293,45.44
Talon,Olaf,254,125,129,49.21
Talon,Irelia,1071,476,595,44.44
Talon,Warwick,1745,792,953,45.39
Talon,Khazix,740,360,380,48.65
Talon,Aurora,960,536,424,55.83
Talon,Karthus,363,169,194,46.56
Talon,Gnar,456,218,238,47.81
Talon,Morgana,1252,603,649,48.16
Talon,Syndra,669,295,374,44.1
Talon,Kled,243,117,126,48.15
Talon,DrMundo,603,235,368,38.97
Talon,Smolder,777,399,378,51.35
Talon,Illaoi,419,165,254,39.38
Talon,Viego,1708,749,959,43.85
Talon,Fizz,641,321,320,50.08
Talon,Samira,810,385,425,47.53
Talon,Akshan,416,216,200,51.92
Talon,Taric,188,100,88,53.19
Talon,Malphite,1124,579,545,51.51
Talon,Aatrox,1099,556,543,50.59
Talon,Katarina,955,436,519,45.65
Talon,TahmKench,961,406,555,42.25
Talon,Ziggs,467,244,223,52.25
Talon,Twitch,981,443,538,45.16
Talon,Sona,354,148,206,41.81
Talon,Heimerdinger,504,181,323,35.91
Talon,Gwen,526,265,261,50.38
Talon,Sejuani,482,196,286,40.66
Talon,Yuumi,1063,608,455,57.2
Talon,Azir,435,251,184,57.7
Talon,Annie,415,210,205,50.6
Talon,XinZhao,759,327,432,43.08
Talon,Renekton,669,296,373,44.25
Talon,MonkeyKing,777,282,495,36.29
Talon,JarvanIV,553,281,272,50.81
Talon,Riven,568,261,307,45.95
Talon,Tryndamere,620,317,303,51.13
Talon,Hecarim,497,225,272,45.27
Talon,Hwei,778,397,381,51.03
Talon,Rumble,359,179,180,49.86
Talon,Graves,833,414,419,49.7
Talon,Cassiopeia,426,207,219,48.59
Talon,Ryze,403,181,222,44.91
Talon,Renata,224,82,142,36.61
Talon,FiddleSticks,592,259,333,43.75
Talon,Kassadin,241,123,118,51.04
Talon,RekSai,177,80,97,45.2
Talon,Zilean,377,204,173,54.11
Talon,Belveth,283,158,125,55.83
Talon,Corki,444,245,199,55.18
Talon,KSante,623,339,284,54.41
Talon,Zac,514,223,291,43.39
Talon,Taliyah,298,147,151,49.33
Talon,TwistedFate,420,207,213,49.29
Talon,Skarner,305,162,143,53.11
Talon,Kennen,364,209,155,57.42
Talon,Zoe,489,266,223,54.4
Talon,Nilah,359,185,174,51.53
Talon,Bard,359,145,214,40.39
Talon,Maokai,549,244,305,44.44
Talon,Ornn,525,223,302,42.48
Talon,Ivern,186,96,90,51.61
Alistar,Ambessa,525,238,287,45.33
Alistar,Rammus,245,118,127,48.16
Alistar,Mel,1806,905,901,50.11
Alistar,Draven,465,252,213,54.19
Alistar,Blitzcrank,835,423,412,50.66
Alistar,Jax,773,365,408,47.22
Alistar,Elise,550,312,238,56.73
Alistar,Naafiri,245,129,116,52.65
Alistar,Jhin,1385,736,649,53.14
Alistar,Lulu,983,506,477,51.48
Alistar,Riven,352,209,143,59.38
Alistar,Ivern,146,78,68,53.42
Alistar,Yasuo,1567,766,801,48.88
Alistar,Swain,867,374,493,43.14
Alistar,Nami,664,295,369,44.43
Alistar,Fiora,281,147,134,52.31
Alistar,Kayn,1038,469,569,45.18
Alistar,Malzahar,757,322,435,42.54
Alistar,Aphelios,376,197,179,52.39
Alistar,Zilean,255,109,146,42.75
Alistar,Sion,657,329,328,50.08
Alistar,Rengar,333,194,139,58.26
Alistar,Ahri,991,511,480,51.56
Alistar,Anivia,244,118,126,48.36
Alistar,Poppy,624,345,279,55.29
Alistar,Kennen,282,148,134,52.48
Alistar,Skarner,285,147,138,51.58
Alistar,Jinx,2079,940,1139,45.21
Alistar,Yuumi,546,257,289,47.07
Alistar,Warwick,1079,560,519,51.9
Alistar,Malphite,737,380,357,51.56
Alistar,Lux,1722,859,863,49.88
Alistar,Kled,131,81,50,61.83
Alistar,Gragas,508,249,259,49.02
Alistar,Rell,628,310,318,49.36
Alistar,Sett,1258,636,622,50.56
Alistar,Sejuani,406,218,188,53.69
Alistar,Yone,1491,771,720,51.71
Alistar,Ashe,1509,767,742,50.83
Alistar,Urgot,410,182,228,44.39
Alistar,Ekko,812,425,387,52.34
Alistar,Xerath,610,295,315,48.36
Alistar,Kalista,262,140,122,53.44
Alistar,Pantheon,1301,637,664,48.96
Alistar,Orianna,371,195,176,52.56
Alistar,Nautilus,1314,672,642,51.14
Alistar,KSante,416,216,200,51.92
Alistar,Belveth,153,91,62,59.48
Alistar,MasterYi,837,426,411,50.9
Alistar,Kaisa,1340,708,632,52.84
Alistar,Gwen,371,186,185,50.13
Alistar,Illaoi,399,159,240,39.85
Alistar,Vi,828,412,416,49.76
Alistar,Syndra,518,246,272,47.49
Alistar,Camille,289,142,147,49.13
Alistar,Varus,641,359,282,56.01
Alistar,Braum,501,264,237,52.69
Alistar,Talon,475,270,205,56.84
Alistar,Thresh,1419,711,708,50.11
Alistar,MonkeyKing,581,251,330,43.2
Alistar,Akshan,235,130,105,55.32
Alistar,Caitlyn,2018,968,1050,47.97
Alistar,Soraka,415,217,198,52.29
Alistar,Katarina,600,296,304,49.33
Alistar,Samira,748,429,319,57.35
Alistar,Ezreal,1871,898,973,48
Alistar,Zac,477,245,232,51.36
Alistar,Zed,883,495,388,56.06
Alistar,Bard,229,133,96,58.08
Alistar,Volibear,799,423,376,52.94
Alistar,Smolder,559,270,289,48.3
Alistar,Teemo,984,425,559,43.19
Alistar,AurelionSol,289,122,167,42.21
Alistar,Lissandra,306,155,151,50.65
Alistar,Senna,527,285,242,54.08
Alistar,Vladimir,530,276,254,52.08
Alistar,Hecarim,319,181,138,56.74
Alistar,Akali,793,472,321,59.52
Alistar,TwistedFate,289,160,129,55.36
Alistar,Aurora,570,277,293,48.6
Alistar,Kindred,342,209,133,61.11
Alistar,Viktor,731,351,380,48.02
Alistar,Vayne,1179,606,573,51.4
Alistar,Gangplank,425,198,227,46.59
Alistar,Brand,488,232,256,47.54
Alistar,Trundle,427,229,198,53.63
Alistar,Darius,1363,651,712,47.76
Alistar,Graves,543,283,260,52.12
Alistar,Neeko,387,219,168,56.59
Alistar,Gnar,411,229,182,55.72
Alistar,Karma,780,362,418,46.41
Alistar,Mordekaiser,1049,462,587,44.04
Alistar,Nunu,396,181,215,45.71
Alistar,Shen,500,240,260,48
Alistar,Tristana,752,358,394,47.61
Alistar,Velkoz,416,222,194,53.37
Alistar,LeeSin,1226,613,613,50
Alistar,Milio,469,230,239,49.04
Alistar,Diana,1304,609,695,46.7
Alistar,Irelia,711,383,328,53.87
Alistar,Lillia,445,223,222,50.11
Alistar,Sona,207,83,124,40.1
Alistar,Leona,825,427,398,51.76
Alistar,Yorick,692,301,391,43.5
Alistar,Veigar,730,414,316,56.71
Alistar,MissFortune,1568,749,819,47.77
Alistar,Renekton,406,179,227,44.09
Alistar,Twitch,516,242,274,46.9
Alistar,Jayce,404,193,211,47.77
Alistar,Singed,235,112,123,47.66
Alistar,TahmKench,708,365,343,51.55
Alistar,Shaco,735,378,357,51.43
Alistar,Sylas,1525,706,819,46.3
Alistar,Chogath,985,453,532,45.99
Alistar,Taliyah,214,104,110,48.6
Alistar,Xayah,503,266,237,52.88
Alistar,Aatrox,794,428,366,53.9
Alistar,Galio,683,316,367,46.27
Alistar,Evelynn,278,144,134,51.8
Alistar,FiddleSticks,370,173,197,46.76
Alistar,Fizz,408,211,197,51.72
Alistar,Lucian,553,281,272,50.81
Alistar,Morgana,730,310,420,42.47
Alistar,Renata,213,114,99,53.52
Alistar,XinZhao,516,272,244,52.71
Alistar,Rumble,248,148,100,59.68
Alistar,Azir,347,180,167,51.87
Alistar,Nocturne,865,361,504,41.73
Alistar,Leblanc,547,263,284,48.08
Alistar,Sivir,493,208,285,42.19
Alistar,Rakan,370,199,171,53.78
Alistar,Tryndamere,347,174,173,50.14
Alistar,KogMaw,241,108,133,44.81
Alistar,Kayle,463,218,245,47.08
Alistar,Vex,396,186,210,46.97
Alistar,Briar,565,236,329,41.77
Alistar,Ziggs,275,126,149,45.82
Alistar,Seraphine,470,242,228,51.49
Alistar,Khazix,372,206,166,55.38
Alistar,Hwei,470,229,241,48.72
Alistar,Pyke,721,350,371,48.54
Alistar,Zeri,423,219,204,51.77
Alistar,Zyra,595,289,306,48.57
Alistar,Annie,298,118,180,39.6
Alistar,Kassadin,157,89,68,56.69
Alistar,Nasus,494,208,286,42.11
Alistar,Garen,1269,588,681,46.34
Alistar,Karthus,235,102,133,43.4
Alistar,Corki,396,222,174,56.06
Alistar,Nilah,342,177,165,51.75
Alistar,DrMundo,415,221,194,53.25
Alistar,Amumu,774,375,399,48.45
Alistar,Taric,202,88,114,43.56
Alistar,Ornn,366,187,179,51.09
Alistar,Cassiopeia,250,104,146,41.6
Alistar,JarvanIV,525,218,307,41.52
Alistar,Viego,1263,673,590,53.29
Alistar,Zoe,310,153,157,49.35
Alistar,Maokai,410,198,212,48.29
Alistar,Ryze,247,117,130,47.37
Alistar,Shyvana,240,93,147,38.75
Alistar,Heimerdinger,355,147,208,41.41
Alistar,Qiyana,257,111,146,43.19
Alistar,Olaf,193,84,109,43.52
Alistar,Udyr,345,199,146,57.68
Alistar,RekSai,108,64,44,59.26
Alistar,Janna,305,159,146,52.13
Alistar,Quinn,285,157,128,55.09
Alistar,Nidalee,200,101,99,50.5
Garen,Pantheon,4961,2444,2517,49.26
Garen,Diana,4722,2357,2365,49.92
Garen,Gangplank,1266,723,543,57.11
Garen,Ezreal,6781,3606,3175,53.18
Garen,Yuumi,2513,1333,1180,53.04
Garen,Mordekaiser,4596,2048,2548,44.56
Garen,Briar,2315,1164,1151,50.28
Garen,Ryze,1028,480,548,46.69
Garen,Vex,1654,906,748,54.78
Garen,Teemo,4105,1876,2229,45.7
Garen,XinZhao,1941,1085,856,55.9
Garen,Yasuo,6590,3395,3195,51.52
Garen,Jinx,7918,3875,4043,48.94
Garen,Neeko,1699,926,773,54.5
Garen,Vladimir,1651,825,826,49.97
Garen,Evelynn,1168,633,535,54.2
Garen,Tristana,2881,1459,1422,50.64
Garen,Chogath,4075,1924,2151,47.21
Garen,Morgana,3607,1838,1769,50.96
Garen,Jhin,5970,3128,2842,52.4
Garen,Mel,6404,3370,3034,52.62
Garen,Heimerdinger,1417,712,705,50.25
Garen,LeeSin,3919,2127,1792,54.27
Garen,Veigar,3377,1692,1685,50.1
Garen,Irelia,2598,1384,1214,53.27
Garen,Lillia,1950,998,952,51.18
Garen,Sylas,4081,2144,1937,52.54
Garen,Caitlyn,8105,4054,4051,50.02
Garen,Lux,7811,3928,3883,50.29
Garen,Aatrox,2884,1525,1359,52.88
Garen,Khazix,1588,923,665,58.12
Garen,Qiyana,773,422,351,54.59
Garen,MissFortune,7047,3614,3433,51.28
Garen,Nautilus,3526,1776,1750,50.37
Garen,Sion,2272,1212,1060,53.35
Garen,Warwick,4690,2306,2384,49.17
Garen,Akshan,1059,541,518,51.09
Garen,Bard,942,503,439,53.4
Garen,Ivern,581,290,291,49.91
Garen,Vayne,4246,2017,2229,47.5
Garen,Shyvana,915,450,465,49.18
Garen,Karma,3265,1651,1614,50.57
Garen,Soraka,1618,849,769,52.47
Garen,Sett,5199,2581,2618,49.64
Garen,Talon,1604,910,694,56.73
Garen,Lissandra,878,397,481,45.22
Garen,Milio,1790,911,879,50.89
Garen,Aphelios,1834,833,1001,45.42
Garen,Leona,2637,1324,1313,50.21
Garen,Riven,1558,903,655,57.96
Garen,Ambessa,1800,1039,761,57.72
Garen,TwistedFate,1146,622,524,54.28
Garen,Nami,3039,1633,1406,53.73
Garen,Yone,5745,3017,2728,52.52
Garen,Trundle,1921,1044,877,54.35
Garen,Naafiri,1149,593,556,51.61
Garen,Shen,2164,1110,1054,51.29
Garen,Aurora,2296,1252,1044,54.53
Garen,Fizz,1939,1007,932,51.93
Garen,Swain,3266,1581,1685,48.41
Garen,Jax,3627,2033,1594,56.05
Garen,Tryndamere,2181,1060,1121,48.6
Garen,Corki,1311,759,552,57.89
Garen,Pyke,2699,1527,1172,56.58
Garen,Rammus,968,485,483,50.1
Garen,DrMundo,1913,1006,907,52.59
Garen,TahmKench,2798,1474,1324,52.68
Garen,Camille,1626,787,839,48.4
Garen,Hecarim,1222,656,566,53.68
Garen,Kayn,4546,2305,2241,50.7
Garen,Nocturne,3669,1822,1847,49.66
Garen,Ashe,5833,3146,2687,53.93
Garen,Ornn,1396,661,735,47.35
Garen,Vi,2976,1554,1422,52.22
Garen,Anivia,958,500,458,52.19
Garen,Kindred,1571,836,735,53.21
Garen,Varus,2738,1497,1241,54.67
Garen,Maokai,1348,609,739,45.18
Garen,Katarina,2418,1306,1112,54.01
Garen,Fiora,1144,636,508,55.59
Garen,Amumu,3240,1563,1677,48.24
Garen,Samira,2275,1246,1029,54.77
Garen,Seraphine,2626,1354,1272,51.56
Garen,Thresh,4211,2266,1945,53.81
Garen,Viego,4010,2077,1933,51.8
Garen,Ekko,2741,1373,1368,50.09
Garen,Senna,2311,1150,1161,49.76
Garen,Kalista,1060,577,483,54.43
Garen,Zed,3376,1808,1568,53.55
Garen,Draven,1469,773,696,52.62
Garen,Volibear,3668,1875,1793,51.12
Garen,Cassiopeia,952,525,427,55.15
Garen,JarvanIV,1745,902,843,51.69
Garen,Twitch,2429,1199,1230,49.36
Garen,KSante,1704,990,714,58.1
Garen,Nunu,2018,1033,985,51.19
Garen,Nasus,2526,1356,1170,53.68
Garen,MasterYi,3570,1710,1860,47.9
Garen,Rell,1479,729,750,49.29
Garen,Renekton,1637,915,722,55.89
Garen,Azir,1035,547,488,52.85
Garen,Xayah,1731,910,821,52.57
Garen,Akali,3391,1785,1606,52.64
Garen,FiddleSticks,1472,758,714,51.49
Garen,Zac,1440,722,718,50.14
Garen,Darius,6722,3368,3354,50.1
Garen,Velkoz,1896,942,954,49.68
Garen,Rakan,1552,827,725,53.29
Garen,Shaco,2691,1391,1300,51.69
Garen,Gwen,1759,1013,746,57.59
Garen,Rengar,1128,590,538,52.3
Garen,Malphite,2762,1468,1294,53.15
Garen,Annie,945,503,442,53.23
Garen,Jayce,1216,736,480,60.53
Garen,MonkeyKing,2045,1046,999,51.15
Garen,Lucian,1945,1092,853,56.14
Garen,Elise,2013,1157,856,57.48
Garen,Xerath,2382,1200,1182,50.38
Garen,Sejuani,1186,614,572,51.77
Garen,Leblanc,1614,840,774,52.04
Garen,Lulu,3428,1729,1699,50.44
Garen,AurelionSol,1187,657,530,55.35
Garen,Nilah,1282,618,664,48.21
Garen,Kassadin,596,285,311,47.82
Garen,Graves,1831,1054,777,57.56
Garen,Illaoi,1614,888,726,55.02
Garen,Kaisa,4604,2523,2081,54.8
Garen,Renata,611,309,302,50.57
Garen,Brand,2306,1280,1026,55.51
Garen,Belveth,734,396,338,53.95
Garen,Nidalee,790,481,309,60.89
Garen,Taric,705,342,363,48.51
Garen,Kayle,2545,1135,1410,44.6
Garen,Malzahar,3001,1497,1504,49.88
Garen,Zoe,1072,606,466,56.53
Garen,Gnar,1253,625,628,49.88
Garen,Smolder,1981,1026,955,51.79
Garen,Kled,562,243,319,43.24
Garen,Syndra,1941,1047,894,53.94
Garen,KogMaw,1008,473,535,46.92
Garen,Galio,2670,1322,1348,49.51
Garen,Zyra,2534,1275,1259,50.32
Garen,Skarner,783,426,357,54.41
Garen,Ziggs,1196,664,532,55.52
Garen,Poppy,1702,820,882,48.18
Garen,Blitzcrank,2260,1207,1053,53.41
Garen,Singed,848,440,408,51.89
Garen,Gragas,1695,960,735,56.64
Garen,Hwei,1939,967,972,49.87
Garen,Ahri,3979,1933,2046,48.58
Garen,Sivir,1653,778,875,47.07
Garen,Karthus,881,466,415,52.89
Garen,Braum,1823,943,880,51.73
Garen,Udyr,1239,630,609,50.85
Garen,Kennen,777,453,324,58.3
Garen,Zeri,1292,709,583,54.88
Garen,Urgot,1641,881,760,53.69
Garen,Janna,1014,510,504,50.3
Garen,Quinn,1261,638,623,50.59
Garen,Yorick,2903,1350,1553,46.5
Garen,Olaf,737,420,317,56.99
Garen,Viktor,2480,1301,1179,52.46
Garen,Orianna,1386,732,654,52.81
Garen,Taliyah,800,447,353,55.88
Garen,RekSai,291,169,122,58.08
Garen,Alistar,1269,681,588,53.66
Garen,Zilean,956,472,484,49.37
Garen,Sona,985,498,487,50.56
Garen,Rumble,627,300,327,47.85
Morgana,Pantheon,3880,1865,2015,48.07
Morgana,Diana,3849,1861,1988,48.35
Morgana,Gangplank,1060,502,558,47.36
Morgana,Ezreal,5083,2648,2435,52.1
Morgana,Yuumi,2035,1086,949,53.37
Morgana,Mordekaiser,3616,1759,1857,48.64
Morgana,Viego,2978,1535,1443,51.54
Morgana,Irelia,1910,1039,871,54.4
Morgana,Jhin,4841,2421,2420,50.01
Morgana,Lux,8193,4242,3951,51.78
Morgana,Qiyana,620,334,286,53.87
Morgana,Warwick,4033,2025,2008,50.21
Morgana,Mel,4900,2531,2369,51.65
Morgana,Nautilus,2782,1438,1344,51.69
Morgana,Kayle,1824,869,955,47.64
Morgana,MonkeyKing,1399,714,685,51.04
Morgana,RekSai,288,156,132,54.17
Morgana,Yone,4437,2380,2057,53.64
Morgana,Seraphine,2474,1257,1217,50.81
Morgana,Sylas,2730,1454,1276,53.26
Morgana,Caitlyn,6303,3242,3061,51.44
Morgana,Zed,2581,1428,1153,55.33
Morgana,MasterYi,2917,1398,1519,47.93
Morgana,Rell,1185,630,555,53.16
Morgana,Jax,2233,1127,1106,50.47
Morgana,Briar,2036,1011,1025,49.66
Morgana,Ahri,3183,1599,1584,50.24
Morgana,Zeri,927,530,397,57.17
Morgana,Karthus,629,316,313,50.24
Morgana,Aurora,1748,884,864,50.57
Morgana,Senna,2061,1012,1049,49.1
Morgana,Garen,3607,1769,1838,49.04
Morgana,Darius,4392,2238,2154,50.96
Morgana,Malzahar,2297,1104,1193,48.06
Morgana,Zilean,744,328,416,44.09
Morgana,Heimerdinger,1365,624,741,45.71
Morgana,LeeSin,2899,1601,1298,55.23
Morgana,Veigar,2926,1444,1482,49.35
Morgana,Teemo,3208,1523,1685,47.48
Morgana,Gragas,1274,729,545,57.22
Morgana,Soraka,1408,722,686,51.28
Morgana,Twitch,1910,929,981,48.64
Morgana,Lulu,2468,1286,1182,52.11
Morgana,KSante,995,536,459,53.87
Morgana,Ashe,4780,2506,2274,52.43
Morgana,Nasus,1778,874,904,49.16
Morgana,TahmKench,2129,1211,918,56.88
Morgana,Fizz,1447,705,742,48.72
Morgana,Gnar,895,470,425,52.51
Morgana,Nunu,1686,899,787,53.32
Morgana,Lucian,1427,733,694,51.37
Morgana,Elise,1422,780,642,54.85
Morgana,Kaisa,3363,1764,1599,52.45
Morgana,Riven,995,550,445,55.28
Morgana,FiddleSticks,1261,610,651,48.37
Morgana,Brand,2082,1044,1038,50.14
Morgana,Jinx,6539,3329,3210,50.91
Morgana,Milio,1438,688,750,47.84
Morgana,Camille,713,401,312,56.24
Morgana,Xayah,1232,652,580,52.92
Morgana,Evelynn,1189,646,543,54.33
Morgana,Lissandra,793,431,362,54.35
Morgana,MissFortune,5859,3013,2846,51.43
Morgana,Pyke,2151,1120,1031,52.07
Morgana,Kayn,3649,1893,1756,51.88
Morgana,Katarina,1947,1013,934,52.03
Morgana,Ekko,2122,1077,1045,50.75
Morgana,Yasuo,4712,2412,2300,51.19
Morgana,Singed,654,346,308,52.91
Morgana,KogMaw,828,395,433,47.71
Morgana,Azir,811,451,360,55.61
Morgana,Nami,2153,1055,1098,49
Morgana,Chogath,2964,1480,1484,49.93
Morgana,Shen,1637,892,745,54.49
Morgana,Lillia,1481,783,698,52.87
Morgana,Sivir,1420,686,734,48.31
Morgana,Neeko,1533,746,787,48.66
Morgana,Ambessa,1187,609,578,51.31
Morgana,Zac,912,433,479,47.48
Morgana,Kalista,753,377,376,50.07
Morgana,Swain,2490,1355,1135,54.42
Morgana,Rengar,764,417,347,54.58
Morgana,Anivia,823,384,439,46.66
Morgana,Galio,2018,1004,1014,49.75
Morgana,Aatrox,2019,1088,931,53.89
Morgana,Varus,1957,1008,949,51.51
Morgana,Shaco,2436,1304,1132,53.53
Morgana,Tristana,2367,1195,1172,50.49
Morgana,Zoe,1027,547,480,53.26
Morgana,Belveth,529,263,266,49.72
Morgana,AurelionSol,898,487,411,54.23
Morgana,Yorick,2401,1136,1265,47.31
Morgana,Maokai,1191,642,549,53.9
Morgana,Sion,1734,866,868,49.94
Morgana,Akali,2612,1433,1179,54.86
Morgana,Sejuani,1032,492,540,47.67
Morgana,Vladimir,1340,671,669,50.07
Morgana,Fiora,932,473,459,50.75
Morgana,Nilah,1081,519,562,48.01
Morgana,Rumble,535,311,224,58.13
Morgana,Akshan,902,410,492,45.45
Morgana,Sona,927,462,465,49.84
Morgana,Samira,2008,1125,883,56.03
Morgana,Sett,3891,1971,1920,50.66
Morgana,Graves,1335,627,708,46.97
Morgana,Urgot,1186,569,617,47.98
Morgana,Poppy,1322,649,673,49.09
Morgana,Malphite,2343,1246,1097,53.18
Morgana,Khazix,1286,717,569,55.75
Morgana,Jayce,954,524,430,54.93
Morgana,Kennen,589,302,287,51.27
Morgana,Taric,477,213,264,44.65
Morgana,Braum,1104,582,522,52.72
Morgana,Aphelios,1340,670,670,50
Morgana,DrMundo,1605,792,813,49.35
Morgana,Cassiopeia,812,419,393,51.6
Morgana,Rakan,1083,566,517,52.26
Morgana,Illaoi,1306,695,611,53.22
Morgana,Amumu,2631,1275,1356,48.46
Morgana,Vi,2336,1188,1148,50.86
Morgana,Bard,640,339,301,52.97
Morgana,Rammus,787,401,386,50.95
Morgana,Vex,1461,769,692,52.64
Morgana,Volibear,2827,1482,1345,52.42
Morgana,Vayne,2814,1353,1461,48.08
Morgana,Skarner,629,383,246,60.89
Morgana,Nocturne,2776,1288,1488,46.4
Morgana,Ryze,751,335,416,44.61
Morgana,Thresh,3244,1719,1525,52.99
Morgana,Blitzcrank,2044,1092,952,53.42
Morgana,Nidalee,572,290,282,50.7
Morgana,Hwei,1576,791,785,50.19
Morgana,Xerath,2274,1149,1125,50.53
Morgana,Ornn,1010,541,469,53.56
Morgana,Trundle,1450,726,724,50.07
Morgana,Tryndamere,1498,797,701,53.2
Morgana,TwistedFate,742,405,337,54.58
Morgana,Orianna,1021,510,511,49.95
Morgana,Hecarim,821,421,400,51.28
Morgana,Gwen,1430,845,585,59.09
Morgana,Smolder,1568,825,743,52.61
Morgana,Karma,2533,1164,1369,45.95
Morgana,Naafiri,916,454,462,49.56
Morgana,Leona,2179,1166,1013,53.51
Morgana,Udyr,959,505,454,52.66
Morgana,Syndra,1363,688,675,50.48
Morgana,Draven,1183,587,596,49.62
Morgana,Ziggs,1111,592,519,53.29
Morgana,Talon,1252,649,603,51.84
Morgana,Quinn,901,378,523,41.95
Morgana,Viktor,1881,986,895,52.42
Morgana,Zyra,2273,1079,1194,47.47
Morgana,Annie,924,489,435,52.92
Morgana,Renekton,1156,579,577,50.09
Morgana,Corki,786,414,372,52.67
Morgana,Leblanc,1133,584,549,51.54
Morgana,XinZhao,1405,719,686,51.17
Morgana,Shyvana,584,302,282,51.71
Morgana,Renata,431,209,222,48.49
Morgana,Kindred,1191,581,610,48.78
Morgana,Velkoz,1507,718,789,47.64
Morgana,Janna,670,337,333,50.3
Morgana,Kled,455,224,231,49.23
Morgana,Taliyah,473,262,211,55.39
Morgana,Alistar,730,420,310,57.53
Morgana,Kassadin,524,273,251,52.1
Morgana,JarvanIV,1015,436,579,42.96
Morgana,Olaf,626,277,349,44.25
Morgana,Ivern,336,160,176,47.62
Ryze,Aatrox,647,244,403,37.71
Ryze,Brand,371,190,181,51.21
Ryze,Irelia,617,278,339,45.06
Ryze,Caitlyn,1718,850,868,49.48
Ryze,Milio,336,187,149,55.65
Ryze,Garen,1028,548,480,53.31
Ryze,Diana,966,478,488,49.48
Ryze,Yasuo,1307,645,662,49.35
Ryze,Pyke,601,324,277,53.91
Ryze,Sylas,1055,588,467,55.73
Ryze,Zed,683,364,319,53.29
Ryze,MasterYi,629,297,332,47.22
Ryze,Rell,369,175,194,47.43
Ryze,Sett,901,432,469,47.95
Ryze,Vladimir,559,265,294,47.41
Ryze,Kindred,294,169,125,57.48
Ryze,Aphelios,326,157,169,48.16
Ryze,Jax,514,244,270,47.47
Ryze,Elise,499,272,227,54.51
Ryze,Naafiri,238,126,112,52.94
Ryze,Jhin,1229,596,633,48.49
Ryze,Lulu,886,438,448,49.44
Ryze,Camille,268,127,141,47.39
Ryze,LeeSin,1135,570,565,50.22
Ryze,Pantheon,1033,538,495,52.08
Ryze,Samira,583,289,294,49.57
Ryze,Ekko,611,307,304,50.25
Ryze,Tristana,633,337,296,53.24
Ryze,Kayn,840,474,366,56.43
Ryze,Lux,1498,678,820,45.26
Ryze,Jinx,1546,747,799,48.32
Ryze,Karma,875,455,420,52
Ryze,Chogath,801,391,410,48.81
Ryze,Hwei,437,212,225,48.51
Ryze,Draven,358,195,163,54.47
Ryze,Warwick,1044,558,486,53.45
Ryze,Veigar,679,368,311,54.2
Ryze,Ezreal,1657,945,712,57.03
Ryze,Ambessa,489,276,213,56.44
Ryze,Shen,452,236,216,52.21
Ryze,Kaisa,1121,648,473,57.81
Ryze,KSante,378,203,175,53.7
Ryze,Nunu,362,199,163,54.97
Ryze,Yone,1191,662,529,55.58
Ryze,Thresh,1034,572,462,55.32
Ryze,Mordekaiser,792,332,460,41.92
Ryze,Teemo,973,473,500,48.61
Ryze,AurelionSol,275,132,143,48
Ryze,Xayah,305,169,136,55.41
Ryze,Rakan,306,150,156,49.02
Ryze,Kennen,206,90,116,43.69
Ryze,Shaco,612,345,267,56.37
Ryze,Twitch,576,313,263,54.34
Ryze,Yuumi,544,314,230,57.72
Ryze,Illaoi,304,175,129,57.57
Ryze,MonkeyKing,412,218,194,52.91
Ryze,Vex,312,158,154,50.64
Ryze,Mel,1403,699,704,49.82
Ryze,Darius,1277,606,671,47.45
Ryze,FiddleSticks,304,161,143,52.96
Ryze,Azir,314,152,162,48.41
Ryze,Volibear,669,324,345,48.43
Ryze,Trundle,329,179,150,54.41
Ryze,TahmKench,531,263,268,49.53
Ryze,Amumu,645,314,331,48.68
Ryze,Ziggs,232,127,105,54.74
Ryze,Malphite,563,294,269,52.22
Ryze,Katarina,471,246,225,52.23
Ryze,Nilah,217,119,98,54.84
Ryze,Seraphine,484,209,275,43.18
Ryze,Karthus,183,91,92,49.73
Ryze,Taliyah,189,105,84,55.56
Ryze,Morgana,751,416,335,55.39
Ryze,Ahri,968,510,458,52.69
Ryze,Nautilus,789,419,370,53.11
Ryze,Cassiopeia,269,147,122,54.65
Ryze,MissFortune,1336,672,664,50.3
Ryze,Braum,425,186,239,43.76
Ryze,Graves,444,227,217,51.13
Ryze,Fizz,311,167,144,53.7
Ryze,Vi,588,287,301,48.81
Ryze,Akshan,238,116,122,48.74
Ryze,Corki,289,162,127,56.06
Ryze,Zyra,542,237,305,43.73
Ryze,Senna,503,283,220,56.26
Ryze,DrMundo,443,238,205,53.72
Ryze,Swain,590,264,326,44.75
Ryze,Sejuani,229,113,116,49.34
Ryze,Neeko,265,126,139,47.55
Ryze,Akali,697,367,330,52.65
Ryze,Sion,485,238,247,49.07
Ryze,XinZhao,421,200,221,47.51
Ryze,Tryndamere,381,198,183,51.97
Ryze,Vayne,878,431,447,49.09
Ryze,Blitzcrank,519,263,256,50.67
Ryze,Kled,111,47,64,42.34
Ryze,Zoe,296,140,156,47.3
Ryze,Renekton,344,161,183,46.8
Ryze,Udyr,312,155,157,49.68
Ryze,Lillia,316,171,145,54.11
Ryze,Malzahar,679,239,440,35.2
Ryze,Ashe,1196,653,543,54.6
Ryze,Riven,254,121,133,47.64
Ryze,Nocturne,811,382,429,47.1
Ryze,Hecarim,268,146,122,54.48
Ryze,Velkoz,440,225,215,51.14
Ryze,Lucian,474,223,251,47.05
Ryze,Nami,631,329,302,52.14
Ryze,Belveth,180,104,76,57.78
Ryze,Heimerdinger,306,165,141,53.92
Ryze,Kayle,433,218,215,50.35
Ryze,Briar,604,268,336,44.37
Ryze,Aurora,530,270,260,50.94
Ryze,Taric,117,61,56,52.14
Ryze,Qiyana,220,110,110,50
Ryze,Gragas,420,237,183,56.43
Ryze,Gangplank,312,193,119,61.86
Ryze,Khazix,286,133,153,46.5
Ryze,Jayce,328,186,142,56.71
Ryze,Leona,571,308,263,53.94
Ryze,Urgot,289,142,147,49.13
Ryze,Kassadin,172,100,72,58.14
Ryze,Xerath,559,309,250,55.28
Ryze,Annie,175,84,91,48
Ryze,Ivern,98,48,50,48.98
Ryze,Fiora,294,161,133,54.76
Ryze,TwistedFate,244,132,112,54.1
Ryze,Rengar,247,116,131,46.96
Ryze,Gwen,352,183,169,51.99
Ryze,Olaf,174,94,80,54.02
Ryze,Viktor,646,304,342,47.06
Ryze,Kalista,235,105,130,44.68
Ryze,Sivir,348,165,183,47.41
Ryze,Varus,651,335,316,51.46
Ryze,Zac,325,129,196,39.69
Ryze,Nasus,436,241,195,55.28
Ryze,Viego,947,473,474,49.95
Ryze,Rammus,224,101,123,45.09
Ryze,Leblanc,332,192,140,57.83
Ryze,Soraka,330,151,179,45.76
Ryze,JarvanIV,383,184,199,48.04
Ryze,Zilean,245,127,118,51.84
Ryze,Gnar,299,154,145,51.51
Ryze,Shyvana,150,87,63,58
Ryze,Galio,598,313,285,52.34
Ryze,Yorick,611,285,326,46.64
Ryze,Ornn,306,168,138,54.9
Ryze,Poppy,436,258,178,59.17
Ryze,Sona,178,82,96,46.07
Ryze,Smolder,423,240,183,56.74
Ryze,KogMaw,226,108,118,47.79
Ryze,Anivia,255,125,130,49.02
Ryze,Quinn,221,127,94,57.47
Ryze,Talon,403,222,181,55.09
Ryze,Skarner,212,120,92,56.6
Ryze,Singed,196,107,89,54.59
Ryze,Alistar,247,130,117,52.63
Ryze,Orianna,290,136,154,46.9
Ryze,Zeri,323,161,162,49.85
Ryze,Renata,139,65,74,46.76
Ryze,Maokai,310,159,151,51.29
Ryze,Syndra,327,158,169,48.32
Ryze,Lissandra,177,77,100,43.5
Ryze,Janna,270,123,147,45.56
Ryze,Rumble,153,79,74,51.63
Ryze,Evelynn,239,113,126,47.28
Ryze,Nidalee,203,142,61,69.95
Ryze,Bard,210,118,92,56.19
Ryze,RekSai,101,53,48,52.48
Brand,Yorick,1525,762,763,49.97
Brand,Kayn,2230,1056,1174,47.35
Brand,Ryze,371,181,190,48.79
Brand,Lux,4414,2176,2238,49.3
Brand,Pantheon,2392,1255,1137,52.47
Brand,TahmKench,1476,779,697,52.78
Brand,Malphite,1314,697,617,53.04
Brand,Yasuo,2721,1355,1366,49.8
Brand,Aphelios,775,390,385,50.32
Brand,TwistedFate,464,216,248,46.55
Brand,Vladimir,947,466,481,49.21
Brand,Zac,653,375,278,57.43
Brand,Cassiopeia,398,205,193,51.51
Brand,Irelia,1232,573,659,46.51
Brand,AurelionSol,585,290,295,49.57
Brand,Singed,390,148,242,37.95
Brand,Udyr,549,299,250,54.46
Brand,Sett,2129,995,1134,46.74
Brand,MissFortune,3736,1939,1797,51.9
Brand,Aatrox,1153,595,558,51.6
Brand,Khazix,814,451,363,55.41
Brand,Qiyana,321,190,131,59.19
Brand,Nautilus,1715,945,770,55.1
Brand,Tryndamere,968,479,489,49.48
Brand,Briar,1251,621,630,49.64
Brand,Mordekaiser,2035,1011,1024,49.68
Brand,Janna,384,169,215,44.01
Brand,Gnar,596,302,294,50.67
Brand,Nunu,992,492,500,49.6
Brand,Lucian,925,425,500,45.95
Brand,Jhin,2730,1312,1418,48.06
Brand,Samira,1210,578,632,47.77
Brand,Nami,1287,631,656,49.03
Brand,XinZhao,832,359,473,43.15
Brand,Morgana,2082,1038,1044,49.86
Brand,Ashe,2777,1525,1252,54.92
Brand,Braum,760,384,376,50.53
Brand,Darius,2735,1421,1314,51.96
Brand,Kindred,671,368,303,54.84
Brand,Veigar,1680,869,811,51.73
Brand,Corki,452,233,219,51.55
Brand,Nocturne,1742,851,891,48.85
Brand,Aurora,986,483,503,48.99
Brand,Soraka,756,361,395,47.75
Brand,Kayle,988,455,533,46.05
Brand,Akali,1480,762,718,51.49
Brand,Yone,2650,1384,1266,52.23
Brand,Tristana,1388,709,679,51.08
Brand,Sivir,714,318,396,44.54
Brand,Ahri,2088,1098,990,52.59
Brand,Neeko,949,497,452,52.37
Brand,Heimerdinger,812,416,396,51.23
Brand,Renekton,534,249,285,46.63
Brand,Caitlyn,4092,2072,2020,50.64
Brand,Lillia,824,421,403,51.09
Brand,Pyke,1310,693,617,52.9
Brand,Viego,1740,777,963,44.66
Brand,Urgot,766,351,415,45.82
Brand,Amumu,1563,756,807,48.37
Brand,Shaco,1375,716,659,52.07
Brand,FiddleSticks,642,338,304,52.65
Brand,Zoe,586,336,250,57.34
Brand,Kaisa,2019,1003,1016,49.68
Brand,Taric,247,119,128,48.18
Brand,Chogath,1794,888,906,49.5
Brand,Ezreal,2854,1560,1294,54.66
Brand,Gwen,671,372,299,55.44
Brand,Vayne,1637,792,845,48.38
Brand,LeeSin,1580,755,825,47.78
Brand,Thresh,1769,945,824,53.42
Brand,DrMundo,1058,479,579,45.27
Brand,Draven,787,398,389,50.57
Brand,Rell,679,349,330,51.4
Brand,Talon,736,387,349,52.58
Brand,Ekko,1256,687,569,54.7
Brand,Volibear,1792,892,900,49.78
Brand,MasterYi,1781,804,977,45.14
Brand,Hwei,1026,484,542,47.17
Brand,Karma,1226,537,689,43.8
Brand,Katarina,1087,554,533,50.97
Brand,Jax,1268,637,631,50.24
Brand,Kled,253,108,145,42.69
Brand,Xerath,1262,578,684,45.8
Brand,Nidalee,314,161,153,51.27
Brand,Swain,1648,777,871,47.15
Brand,Vi,1272,605,667,47.56
Brand,Jinx,3642,1685,1957,46.27
Brand,Riven,518,264,254,50.97
Brand,Nilah,623,316,307,50.72
Brand,Trundle,874,414,460,47.37
Brand,Diana,2183,1175,1008,53.83
Brand,Seraphine,1348,726,622,53.86
Brand,Velkoz,953,489,464,51.31
Brand,Teemo,2034,968,1066,47.59
Brand,Senna,1100,545,555,49.55
Brand,Shen,989,532,457,53.79
Brand,Rakan,518,242,276,46.72
Brand,Garen,2306,1026,1280,44.49
Brand,Rammus,412,216,196,52.43
Brand,Ornn,515,235,280,45.63
Brand,Poppy,736,357,379,48.51
Brand,Warwick,2270,1108,1162,48.81
Brand,KSante,536,328,208,61.19
Brand,Illaoi,742,378,364,50.94
Brand,Rengar,517,318,199,61.51
Brand,Mel,2825,1473,1352,52.14
Brand,Leblanc,680,358,322,52.65
Brand,Twitch,1161,574,587,49.44
Brand,Jayce,520,277,243,53.27
Brand,Orianna,471,194,277,41.19
Brand,Alistar,488,256,232,52.46
Brand,Karthus,372,177,195,47.58
Brand,Leona,1181,599,582,50.72
Brand,Fizz,962,478,484,49.69
Brand,Zyra,1298,603,695,46.46
Brand,Viktor,1172,572,600,48.81
Brand,Camille,433,225,208,51.96
Brand,Azir,386,219,167,56.74
Brand,Blitzcrank,999,466,533,46.65
Brand,Ambessa,774,391,383,50.52
Brand,Malzahar,1445,680,765,47.06
Brand,Yuumi,1178,554,624,47.03
Brand,Sona,448,202,246,45.09
Brand,Ivern,208,96,112,46.15
Brand,Kassadin,316,130,186,41.14
Brand,Elise,907,404,503,44.54
Brand,Graves,743,358,385,48.18
Brand,Milio,676,286,390,42.31
Brand,Bard,400,201,199,50.25
Brand,Sejuani,544,285,259,52.39
Brand,MonkeyKing,919,467,452,50.82
Brand,Galio,1359,654,705,48.12
Brand,Nasus,1183,670,513,56.64
Brand,Fiora,489,280,209,57.26
Brand,Gragas,777,438,339,56.37
Brand,Anivia,398,188,210,47.24
Brand,Xayah,651,340,311,52.23
Brand,Varus,1118,572,546,51.16
Brand,Zed,1536,733,803,47.72
Brand,Quinn,486,245,241,50.41
Brand,Kennen,419,252,167,60.14
Brand,KogMaw,451,249,202,55.21
Brand,Ziggs,494,245,249,49.6
Brand,Lulu,1528,773,755,50.59
Brand,Hecarim,562,310,252,55.16
Brand,Sion,1093,517,576,47.3
Brand,Gangplank,480,273,207,56.88
Brand,Vex,789,412,377,52.22
Brand,Evelynn,589,315,274,53.48
Brand,JarvanIV,727,371,356,51.03
Brand,Zeri,452,239,213,52.88
Brand,Sylas,1551,781,770,50.35
Brand,Belveth,384,220,164,57.29
Brand,Rumble,270,147,123,54.44
Brand,Lissandra,395,191,204,48.35
Brand,Olaf,287,161,126,56.1
Brand,Naafiri,531,255,276,48.02
Brand,Smolder,988,518,470,52.43
Brand,Syndra,723,361,362,49.93
Brand,Taliyah,272,136,136,50
Brand,Skarner,368,209,159,56.79
Brand,Renata,222,117,105,52.7
Brand,Akshan,488,264,224,54.1
Brand,Kalista,407,202,205,49.63
Brand,Shyvana,369,156,213,42.28
Brand,Zilean,445,217,228,48.76
Brand,Maokai,652,333,319,51.07
Brand,RekSai,162,85,77,52.47
Brand,Annie,366,180,186,49.18
DrMundo,Gangplank,482,270,212,56.02
DrMundo,Gragas,631,327,304,51.82
DrMundo,TwistedFate,368,213,155,57.88
DrMundo,Lucian,691,425,266,61.51
DrMundo,Leona,993,491,502,49.45
DrMundo,Singed,382,196,186,51.31
DrMundo,Graves,592,273,319,46.11
DrMundo,Fizz,677,347,330,51.26
DrMundo,Ziggs,460,222,238,48.26
DrMundo,Pantheon,1918,1041,877,54.28
DrMundo,Malphite,1033,568,465,54.99
DrMundo,Rengar,400,220,180,55
DrMundo,Akali,1191,609,582,51.13
DrMundo,Ashe,2220,1175,1045,52.93
DrMundo,Rakan,506,254,252,50.2
DrMundo,Yorick,1066,474,592,44.47
DrMundo,Akshan,431,223,208,51.74
DrMundo,FiddleSticks,635,349,286,54.96
DrMundo,Samira,963,537,426,55.76
DrMundo,Pyke,1041,574,467,55.14
DrMundo,Jayce,525,308,217,58.67
DrMundo,Amumu,1270,606,664,47.72
DrMundo,Yasuo,2193,1067,1126,48.65
DrMundo,Milio,638,296,342,46.39
DrMundo,Chogath,1837,993,844,54.06
DrMundo,Briar,1013,530,483,52.32
DrMundo,Lulu,1103,579,524,52.49
DrMundo,Sett,1953,988,965,50.59
DrMundo,Rammus,307,166,141,54.07
DrMundo,Nautilus,1247,686,561,55.01
DrMundo,Kayn,1713,913,800,53.3
DrMundo,Zed,1178,641,537,54.41
DrMundo,Yone,2210,1154,1056,52.22
DrMundo,MissFortune,2677,1444,1233,53.94
DrMundo,Senna,846,452,394,53.43
DrMundo,Garen,1913,907,1006,47.41
DrMundo,Ahri,1539,843,696,54.78
DrMundo,Sona,389,199,190,51.16
DrMundo,Teemo,1497,800,697,53.44
DrMundo,Jhin,2205,1120,1085,50.79
DrMundo,Volibear,1414,760,654,53.75
DrMundo,MasterYi,1355,727,628,53.65
DrMundo,Seraphine,1013,499,514,49.26
DrMundo,Nilah,487,229,258,47.02
DrMundo,Velkoz,757,426,331,56.27
DrMundo,Shaco,1075,593,482,55.16
DrMundo,Lillia,891,422,469,47.36
DrMundo,Lissandra,295,134,161,45.42
DrMundo,Jinx,3106,1504,1602,48.42
DrMundo,Mordekaiser,1629,856,773,52.55
DrMundo,Zoe,499,276,223,55.31
DrMundo,Ezreal,2273,1224,1049,53.85
DrMundo,Darius,2268,1207,1061,53.22
DrMundo,Aphelios,635,319,316,50.24
DrMundo,Neeko,592,307,285,51.86
DrMundo,Aatrox,1184,608,576,51.35
DrMundo,XinZhao,635,331,304,52.13
DrMundo,Vladimir,741,384,357,51.82
DrMundo,Tristana,1199,632,567,52.71
DrMundo,Rell,534,248,286,46.44
DrMundo,Swain,1192,549,643,46.06
DrMundo,Shen,637,392,245,61.54
DrMundo,Lux,3181,1737,1444,54.61
DrMundo,TahmKench,1139,616,523,54.08
DrMundo,Morgana,1605,813,792,50.65
DrMundo,Urgot,591,346,245,58.54
DrMundo,Skarner,342,167,175,48.83
DrMundo,Ekko,988,441,547,44.64
DrMundo,Kaisa,1860,969,891,52.1
DrMundo,Mel,2385,1316,1069,55.18
DrMundo,Jax,1173,625,548,53.28
DrMundo,RekSai,112,51,61,45.54
DrMundo,Brand,1058,579,479,54.73
DrMundo,Smolder,849,436,413,51.35
DrMundo,Riven,388,218,170,56.19
DrMundo,Hwei,691,368,323,53.26
DrMundo,Blitzcrank,832,390,442,46.88
DrMundo,Draven,575,330,245,57.39
DrMundo,Warwick,1843,901,942,48.89
DrMundo,Qiyana,278,177,101,63.67
DrMundo,Xayah,605,283,322,46.78
DrMundo,Evelynn,523,292,231,55.83
DrMundo,Kayle,753,372,381,49.4
DrMundo,Leblanc,593,297,296,50.08
DrMundo,Sion,767,382,385,49.8
DrMundo,Viego,1526,735,791,48.17
DrMundo,Braum,585,290,295,49.57
DrMundo,Zyra,1023,567,456,55.43
DrMundo,Zeri,429,234,195,54.55
DrMundo,Vayne,1534,761,773,49.61
DrMundo,Ryze,443,205,238,46.28
DrMundo,Karthus,340,202,138,59.41
DrMundo,Udyr,453,205,248,45.25
DrMundo,AurelionSol,489,234,255,47.85
DrMundo,Khazix,646,351,295,54.33
DrMundo,Irelia,874,434,440,49.66
DrMundo,Malzahar,1115,586,529,52.56
DrMundo,Hecarim,476,277,199,58.19
DrMundo,Sylas,1302,635,667,48.77
DrMundo,Nami,1140,646,494,56.67
DrMundo,Kennen,389,251,138,64.52
DrMundo,MonkeyKing,705,342,363,48.51
DrMundo,Veigar,1257,615,642,48.93
DrMundo,KSante,502,286,216,56.97
DrMundo,Diana,1772,917,855,51.75
DrMundo,Talon,603,368,235,61.03
DrMundo,Quinn,473,225,248,47.57
DrMundo,Aurora,951,539,412,56.68
DrMundo,Yuumi,980,510,470,52.04
DrMundo,Corki,405,209,196,51.6
DrMundo,Poppy,691,384,307,55.57
DrMundo,Katarina,932,526,406,56.44
DrMundo,LeeSin,1349,684,665,50.7
DrMundo,Vex,592,305,287,51.52
DrMundo,Xerath,937,493,444,52.61
DrMundo,Caitlyn,2945,1585,1360,53.82
DrMundo,Soraka,551,274,277,49.73
DrMundo,Ambessa,586,291,295,49.66
DrMundo,Kassadin,263,132,131,50.19
DrMundo,Nunu,785,408,377,51.97
DrMundo,Karma,1070,580,490,54.21
DrMundo,Gnar,459,246,213,53.59
DrMundo,Zac,455,241,214,52.97
DrMundo,Zilean,329,155,174,47.11
DrMundo,Renekton,416,202,214,48.56
DrMundo,Twitch,959,526,433,54.85
DrMundo,Varus,977,504,473,51.59
DrMundo,Sejuani,506,236,270,46.64
DrMundo,Nidalee,309,176,133,56.96
DrMundo,Naafiri,396,196,200,49.49
DrMundo,Heimerdinger,625,295,330,47.2
DrMundo,Vi,1059,533,526,50.33
DrMundo,Sivir,506,271,235,53.56
DrMundo,Olaf,208,98,110,47.12
DrMundo,Galio,1001,545,456,54.45
DrMundo,Thresh,1408,685,723,48.65
DrMundo,Ornn,531,284,247,53.48
DrMundo,Camille,352,187,165,53.13
DrMundo,Viktor,889,438,451,49.27
DrMundo,Trundle,829,356,473,42.94
DrMundo,Nocturne,1311,670,641,51.11
DrMundo,Anivia,417,192,225,46.04
DrMundo,Maokai,535,243,292,45.42
DrMundo,Fiora,428,252,176,58.88
DrMundo,Alistar,415,194,221,46.75
DrMundo,Kindred,498,271,227,54.42
DrMundo,Ivern,213,112,101,52.58
DrMundo,Orianna,526,315,211,59.89
DrMundo,Janna,287,167,120,58.19
DrMundo,Elise,725,391,334,53.93
DrMundo,Shyvana,316,155,161,49.05
DrMundo,Nasus,752,356,396,47.34
DrMundo,KogMaw,382,182,200,47.64
DrMundo,Taliyah,286,154,132,53.85
DrMundo,Gwen,763,343,420,44.95
DrMundo,JarvanIV,487,224,263,46
DrMundo,Bard,370,189,181,51.08
DrMundo,Rumble,296,153,143,51.69
DrMundo,Taric,289,145,144,50.17
DrMundo,Illaoi,652,349,303,53.53
DrMundo,Cassiopeia,390,185,205,47.44
DrMundo,Syndra,610,342,268,56.07
DrMundo,Annie,393,228,165,58.02
DrMundo,Tryndamere,637,339,298,53.22
DrMundo,Renata,192,109,83,56.77
DrMundo,Belveth,261,120,141,45.98
DrMundo,Azir,334,153,181,45.81
DrMundo,Kalista,351,187,164,53.28
DrMundo,Kled,252,127,125,50.4
Gragas,DrMundo,631,304,327,48.18
Gragas,Lillia,664,291,373,43.83
Gragas,Viktor,1067,475,592,44.52
Gragas,Jhin,2091,971,1120,46.44
Gragas,Pyke,951,504,447,53
Gragas,Kayle,794,389,405,48.99
Gragas,Viego,1520,700,820,46.05
Gragas,Irelia,929,461,468,49.62
Gragas,Jinx,2971,1389,1582,46.75
Gragas,Thresh,1778,784,994,44.09
Gragas,Riven,513,251,262,48.93
Gragas,Nocturne,1180,530,650,44.92
Gragas,Zoe,487,218,269,44.76
Gragas,Lulu,1554,720,834,46.33
Gragas,Zed,1317,603,714,45.79
Gragas,Shaco,1098,451,647,41.07
Gragas,Anivia,378,186,192,49.21
Gragas,Lux,2779,1271,1508,45.74
Gragas,Morgana,1274,545,729,42.78
Gragas,Ivern,197,109,88,55.33
Gragas,Yasuo,2171,1012,1159,46.61
Gragas,Swain,1108,503,605,45.4
Gragas,Nami,1108,517,591,46.66
Gragas,Jayce,637,355,282,55.73
Gragas,Rengar,456,249,207,54.61
Gragas,Ezreal,2917,1416,1501,48.54
Gragas,Sona,327,156,171,47.71
Gragas,LeeSin,2033,1005,1028,49.43
Gragas,Mel,2187,1092,1095,49.93
Gragas,Tristana,1009,469,540,46.48
Gragas,Zac,528,264,264,50
Gragas,Sylas,1643,820,823,49.91
Gragas,Rell,649,261,388,40.22
Gragas,Ashe,2066,992,1074,48.02
Gragas,Mordekaiser,1316,536,780,40.73
Gragas,Warwick,1595,747,848,46.83
Gragas,Yone,2065,985,1080,47.7
Gragas,Kalista,357,190,167,53.22
Gragas,Kennen,375,178,197,47.47
Gragas,Rammus,312,141,171,45.19
Gragas,Caitlyn,2871,1302,1569,45.35
Gragas,Zeri,538,248,290,46.1
Gragas,Kayn,1585,737,848,46.5
Gragas,Aurora,876,465,411,53.08
Gragas,Nilah,443,209,234,47.18
Gragas,Karma,1307,623,684,47.67
Gragas,Camille,434,194,240,44.7
Gragas,Draven,701,355,346,50.64
Gragas,Senna,881,434,447,49.26
Gragas,Poppy,660,315,345,47.73
Gragas,Nunu,731,354,377,48.43
Gragas,MissFortune,2278,1042,1236,45.74
Gragas,Rakan,473,243,230,51.37
Gragas,Nasus,728,297,431,40.8
Gragas,Udyr,506,230,276,45.45
Gragas,Alistar,508,259,249,50.98
Gragas,TahmKench,977,465,512,47.59
Gragas,Briar,845,407,438,48.17
Gragas,Heimerdinger,495,219,276,44.24
Gragas,Blitzcrank,876,439,437,50.11
Gragas,Velkoz,677,292,385,43.13
Gragas,Yorick,987,425,562,43.06
Gragas,Evelynn,373,194,179,52.01
Gragas,Akali,1153,548,605,47.53
Gragas,Neeko,585,274,311,46.84
Gragas,Jax,1342,680,662,50.67
Gragas,Janna,467,201,266,43.04
Gragas,Sett,1793,835,958,46.57
Gragas,Nautilus,1445,762,683,52.73
Gragas,Elise,922,475,447,51.52
Gragas,Annie,412,187,225,45.39
Gragas,Ziggs,456,211,245,46.27
Gragas,Naafiri,368,164,204,44.57
Gragas,Gangplank,626,328,298,52.4
Gragas,Ornn,544,251,293,46.14
Gragas,Sivir,539,231,308,42.86
Gragas,Veigar,1147,510,637,44.46
Gragas,Samira,945,458,487,48.47
Gragas,Tryndamere,616,337,279,54.71
Gragas,Shyvana,313,147,166,46.96
Gragas,Fizz,565,270,295,47.79
Gragas,Taric,251,101,150,40.24
Gragas,Singed,328,147,181,44.82
Gragas,Darius,2010,936,1074,46.57
Gragas,Shen,866,400,466,46.19
Gragas,Vi,1250,601,649,48.08
Gragas,Yuumi,1032,506,526,49.03
Gragas,Graves,712,298,414,41.85
Gragas,Renekton,531,261,270,49.15
Gragas,Soraka,629,224,405,35.61
Gragas,Katarina,938,482,456,51.39
Gragas,Gnar,543,287,256,52.85
Gragas,Xerath,988,449,539,45.45
Gragas,Leona,950,495,455,52.11
Gragas,Aphelios,703,361,342,51.35
Gragas,MasterYi,1234,578,656,46.84
Gragas,Zyra,1045,447,598,42.78
Gragas,Aatrox,1221,654,567,53.56
Gragas,TwistedFate,418,201,217,48.09
Gragas,Seraphine,777,382,395,49.16
Gragas,Teemo,1299,513,786,39.49
Gragas,Volibear,1315,663,652,50.42
Gragas,Ahri,1467,748,719,50.99
Gragas,Diana,1715,766,949,44.66
Gragas,Milio,689,339,350,49.2
Gragas,Sion,917,438,479,47.76
Gragas,Nidalee,376,180,196,47.87
Gragas,Hwei,745,386,359,51.81
Gragas,Leblanc,765,373,392,48.76
Gragas,Smolder,873,428,445,49.03
Gragas,Syndra,740,350,390,47.3
Gragas,Malzahar,912,420,492,46.05
Gragas,Talon,716,408,308,56.98
Gragas,Lucian,835,448,387,53.65
Gragas,Twitch,923,433,490,46.91
Gragas,Orianna,545,275,270,50.46
Gragas,Sejuani,510,244,266,47.84
Gragas,FiddleSticks,539,240,299,44.53
Gragas,Fiora,467,205,262,43.9
Gragas,Vayne,1427,667,760,46.74
Gragas,Belveth,288,139,149,48.26
Gragas,Corki,511,253,258,49.51
Gragas,Karthus,337,204,133,60.53
Gragas,KSante,686,360,326,52.48
Gragas,Olaf,305,143,162,46.89
Gragas,Ekko,1066,492,574,46.15
Gragas,Galio,1028,434,594,42.22
Gragas,Chogath,1325,613,712,46.26
Gragas,Qiyana,378,183,195,48.41
Gragas,Hecarim,520,295,225,56.73
Gragas,Xayah,628,254,374,40.45
Gragas,Varus,1053,544,509,51.66
Gragas,Garen,1695,735,960,43.36
Gragas,Kindred,598,231,367,38.63
Gragas,Malphite,951,394,557,41.43
Gragas,Ambessa,825,414,411,50.18
Gragas,XinZhao,644,296,348,45.96
Gragas,Kaisa,1740,918,822,52.76
Gragas,Ryze,420,183,237,43.57
Gragas,Gwen,564,304,260,53.9
Gragas,Pantheon,2029,1046,983,51.55
Gragas,Akshan,373,171,202,45.84
Gragas,Quinn,421,234,187,55.58
Gragas,Bard,407,206,201,50.61
Gragas,Khazix,638,291,347,45.61
Gragas,Skarner,325,175,150,53.85
Gragas,Vladimir,749,339,410,45.26
Gragas,MonkeyKing,740,402,338,54.32
Gragas,Trundle,634,325,309,51.26
Gragas,Braum,676,316,360,46.75
Gragas,Azir,474,238,236,50.21
Gragas,Brand,777,339,438,43.63
Gragas,Zilean,379,179,200,47.23
Gragas,Urgot,489,199,290,40.7
Gragas,Kassadin,314,154,160,49.04
Gragas,Vex,665,283,382,42.56
Gragas,Lissandra,387,184,203,47.55
Gragas,JarvanIV,676,304,372,44.97
Gragas,Rumble,312,188,124,60.26
Gragas,Amumu,1121,492,629,43.89
Gragas,Renata,215,109,106,50.7
Gragas,Taliyah,306,139,167,45.42
Gragas,Illaoi,566,250,316,44.17
Gragas,Kled,206,99,107,48.06
Gragas,RekSai,122,49,73,40.16
Gragas,Cassiopeia,324,137,187,42.28
Gragas,Maokai,557,213,344,38.24
Gragas,AurelionSol,426,199,227,46.71
Gragas,KogMaw,354,175,179,49.44
TwistedFate,DrMundo,368,155,213,42.12
TwistedFate,Lillia,446,225,221,50.45
TwistedFate,Viktor,681,294,387,43.17
TwistedFate,Jhin,1503,634,869,42.18
TwistedFate,Pyke,656,325,331,49.54
TwistedFate,Gangplank,442,253,189,57.24
TwistedFate,Brand,464,248,216,53.45
TwistedFate,Irelia,556,231,325,41.55
TwistedFate,Malzahar,817,410,407,50.18
TwistedFate,Aatrox,732,351,381,47.95
TwistedFate,Gwen,340,193,147,56.76
TwistedFate,Syndra,432,191,241,44.21
TwistedFate,Ashe,1337,651,686,48.69
TwistedFate,Lulu,884,465,419,52.6
TwistedFate,Mordekaiser,813,389,424,47.85
TwistedFate,Amumu,721,306,415,42.44
TwistedFate,Sylas,976,504,472,51.64
TwistedFate,Xayah,368,186,182,50.54
TwistedFate,TahmKench,580,280,300,48.28
TwistedFate,Nunu,419,195,224,46.54
TwistedFate,Vladimir,341,173,168,50.73
TwistedFate,Samira,492,256,236,52.03
TwistedFate,Nami,769,350,419,45.51
TwistedFate,Jax,690,337,353,48.84
TwistedFate,Elise,469,219,250,46.7
TwistedFate,Kaisa,1222,622,600,50.9
TwistedFate,Twitch,632,291,341,46.04
TwistedFate,Yuumi,558,238,320,42.65
TwistedFate,Vi,724,355,369,49.03
TwistedFate,Orianna,360,204,156,56.67
TwistedFate,Draven,491,244,247,49.69
TwistedFate,Garen,1146,524,622,45.72
TwistedFate,Zed,801,439,362,54.81
TwistedFate,Aurora,568,266,302,46.83
TwistedFate,Caitlyn,1882,877,1005,46.6
TwistedFate,Soraka,396,203,193,51.26
TwistedFate,Kindred,333,200,133,60.06
TwistedFate,Kennen,182,78,104,42.86
TwistedFate,Tristana,622,310,312,49.84
TwistedFate,Teemo,860,348,512,40.47
TwistedFate,Maokai,275,130,145,47.27
TwistedFate,Corki,311,170,141,54.66
TwistedFate,Taric,181,83,98,45.86
TwistedFate,Rammus,205,92,113,44.88
TwistedFate,Katarina,522,286,236,54.79
TwistedFate,Milio,432,159,273,36.81
TwistedFate,Kayn,1006,519,487,51.59
TwistedFate,Veigar,668,319,349,47.75
TwistedFate,Swain,686,320,366,46.65
TwistedFate,Renata,162,72,90,44.44
TwistedFate,XinZhao,391,182,209,46.55
TwistedFate,Rell,367,146,221,39.78
TwistedFate,Kayle,521,229,292,43.95
TwistedFate,FiddleSticks,307,152,155,49.51
TwistedFate,Zoe,344,197,147,57.27
TwistedFate,Camille,292,153,139,52.4
TwistedFate,Rengar,247,146,101,59.11
TwistedFate,Sett,1031,495,536,48.01
TwistedFate,MissFortune,1468,707,761,48.16
TwistedFate,Sona,235,130,105,55.32
TwistedFate,Jinx,1695,759,936,44.78
TwistedFate,Yone,1158,519,639,44.82
TwistedFate,Illaoi,362,179,183,49.45
TwistedFate,Gragas,418,217,201,51.91
TwistedFate,Lux,1779,829,950,46.6
TwistedFate,Leona,528,258,270,48.86
TwistedFate,Pantheon,1140,540,600,47.37
TwistedFate,Akali,708,295,413,41.67
TwistedFate,Shaco,709,311,398,43.86
TwistedFate,Velkoz,386,154,232,39.9
TwistedFate,Yorick,632,270,362,42.72
TwistedFate,Zyra,614,257,357,41.86
TwistedFate,Karthus,223,98,125,43.95
TwistedFate,Mel,1196,612,584,51.17
TwistedFate,Morgana,742,337,405,45.42
TwistedFate,Darius,1248,561,687,44.95
TwistedFate,Poppy,502,239,263,47.61
TwistedFate,Bard,200,98,102,49
TwistedFate,Galio,563,258,305,45.83
TwistedFate,Alistar,289,129,160,44.64
TwistedFate,LeeSin,1139,583,556,51.19
TwistedFate,Kassadin,166,83,83,50
TwistedFate,Viego,915,435,480,47.54
TwistedFate,Hecarim,306,136,170,44.44
TwistedFate,Thresh,1051,522,529,49.67
TwistedFate,MonkeyKing,401,199,202,49.63
TwistedFate,Ekko,588,314,274,53.4
TwistedFate,Ahri,935,445,490,47.59
TwistedFate,MasterYi,795,377,418,47.42
TwistedFate,Nautilus,695,340,355,48.92
TwistedFate,Vex,306,133,173,43.46
TwistedFate,Yasuo,1210,575,635,47.52
TwistedFate,Trundle,423,188,235,44.44
TwistedFate,Ezreal,1626,793,833,48.77
TwistedFate,Ambessa,443,249,194,56.21
TwistedFate,AurelionSol,294,134,160,45.58
TwistedFate,Udyr,308,163,145,52.92
TwistedFate,Leblanc,366,160,206,43.72
TwistedFate,Renekton,358,193,165,53.91
TwistedFate,Kled,137,59,78,43.07
TwistedFate,Ryze,244,112,132,45.9
TwistedFate,Diana,1086,496,590,45.67
TwistedFate,Fizz,451,183,268,40.58
TwistedFate,Varus,623,307,316,49.28
TwistedFate,Khazix,403,194,209,48.14
TwistedFate,Naafiri,226,72,154,31.86
TwistedFate,Quinn,319,169,150,52.98
TwistedFate,Blitzcrank,543,255,288,46.96
TwistedFate,Volibear,679,352,327,51.84
TwistedFate,Graves,547,280,267,51.19
TwistedFate,Seraphine,563,257,306,45.65
TwistedFate,Malphite,556,255,301,45.86
TwistedFate,Sivir,367,153,214,41.69
TwistedFate,Senna,508,280,228,55.12
TwistedFate,Jayce,381,185,196,48.56
TwistedFate,Shyvana,162,83,79,51.23
TwistedFate,Lissandra,240,99,141,41.25
TwistedFate,Nasus,489,204,285,41.72
TwistedFate,Neeko,358,182,176,50.84
TwistedFate,Braum,445,230,215,51.69
TwistedFate,Kalista,209,106,103,50.72
TwistedFate,Warwick,967,456,511,47.16
TwistedFate,Lucian,536,284,252,52.99
TwistedFate,Briar,488,211,277,43.24
TwistedFate,Akshan,260,115,145,44.23
TwistedFate,Chogath,812,377,435,46.43
TwistedFate,Hwei,497,248,249,49.9
TwistedFate,Heimerdinger,290,117,173,40.34
TwistedFate,Rakan,368,160,208,43.48
TwistedFate,Sion,521,195,326,37.43
TwistedFate,JarvanIV,423,215,208,50.83
TwistedFate,Azir,282,123,159,43.62
TwistedFate,Nilah,273,132,141,48.35
TwistedFate,Karma,791,345,446,43.62
TwistedFate,Urgot,353,170,183,48.16
TwistedFate,Olaf,154,73,81,47.4
TwistedFate,Singed,159,55,104,34.59
TwistedFate,Nocturne,774,323,451,41.73
TwistedFate,Riven,327,174,153,53.21
TwistedFate,Rumble,189,99,90,52.38
TwistedFate,Smolder,471,251,220,53.29
TwistedFate,KogMaw,195,88,107,45.13
TwistedFate,Xerath,628,246,382,39.17
TwistedFate,Vayne,795,384,411,48.3
TwistedFate,Skarner,181,94,87,51.93
TwistedFate,Sejuani,275,128,147,46.55
TwistedFate,KSante,322,179,143,55.59
TwistedFate,Zilean,211,95,116,45.02
TwistedFate,Zac,340,135,205,39.71
TwistedFate,Talon,420,213,207,50.71
TwistedFate,Tryndamere,361,172,189,47.65
TwistedFate,Ziggs,271,138,133,50.92
TwistedFate,Ivern,109,35,74,32.11
TwistedFate,Fiora,254,133,121,52.36
TwistedFate,Aphelios,436,223,213,51.15
TwistedFate,Ornn,243,114,129,46.91
TwistedFate,Shen,365,169,196,46.3
TwistedFate,Taliyah,215,86,129,40
TwistedFate,Annie,287,158,129,55.05
TwistedFate,Gnar,320,174,146,54.38
TwistedFate,Qiyana,179,98,81,54.75
TwistedFate,Zeri,294,109,185,37.07
TwistedFate,Nidalee,255,107,148,41.96
TwistedFate,Evelynn,265,122,143,46.04
TwistedFate,Janna,204,99,105,48.53
TwistedFate,Anivia,208,106,102,50.96
TwistedFate,Cassiopeia,225,109,116,48.44
TwistedFate,RekSai,95,53,42,55.79
TwistedFate,Belveth,155,73,82,47.1
Leona,DrMundo,993,502,491,50.55
Leona,Lillia,990,533,457,53.84
Leona,Viktor,1312,644,668,49.09
Leona,Jhin,3165,1615,1550,51.03
Leona,Pyke,1544,782,762,50.65
Leona,Yone,2986,1569,1417,52.55
Leona,Shaco,1456,646,810,44.37
Leona,AurelionSol,744,353,391,47.45
Leona,Ashe,3198,1579,1619,49.37
Leona,Velkoz,952,475,477,49.89
Leona,Swain,1735,774,961,44.61
Leona,FiddleSticks,828,410,418,49.52
Leona,Akali,1692,853,839,50.41
Leona,Twitch,1242,627,615,50.48
Leona,Senna,1166,638,528,54.72
Leona,Chogath,2261,1146,1115,50.69
Leona,Talon,899,431,468,47.94
Leona,Qiyana,446,226,220,50.67
Leona,Mel,3957,2198,1759,55.55
Leona,Seraphine,1386,694,692,50.07
Leona,Aatrox,1532,759,773,49.54
Leona,Veigar,1725,840,885,48.7
Leona,Ezreal,4054,2080,1974,51.31
Leona,Milio,935,479,456,51.23
Leona,Jax,1525,766,759,50.23
Leona,Heimerdinger,768,351,417,45.7
Leona,Soraka,1000,438,562,43.8
Leona,Sett,2748,1319,1429,48
Leona,Karthus,426,199,227,46.71
Leona,Zed,1664,845,819,50.78
Leona,Maokai,779,443,336,56.87
Leona,Samira,1314,703,611,53.5
Leona,Kayn,2603,1352,1251,51.94
Leona,Lucian,987,554,433,56.13
Leona,Thresh,2597,1228,1369,47.29
Leona,Garen,2637,1313,1324,49.79
Leona,Graves,1015,484,531,47.68
Leona,Aurora,1315,676,639,51.41
Leona,Nilah,702,302,400,43.02
Leona,Hwei,1111,575,536,51.76
Leona,Katarina,1245,673,572,54.06
Leona,Gnar,704,363,341,51.56
Leona,XinZhao,1097,525,572,47.86
Leona,Yasuo,3156,1638,1518,51.9
Leona,Zeri,826,398,428,48.18
Leona,Taric,427,191,236,44.73
Leona,Nasus,1287,579,708,44.99
Leona,Galio,1594,755,839,47.37
Leona,Smolder,1142,578,564,50.61
Leona,JarvanIV,836,438,398,52.39
Leona,Mordekaiser,2313,1029,1284,44.49
Leona,Viego,2257,1141,1116,50.55
Leona,Irelia,1559,792,767,50.8
Leona,Kaisa,2647,1341,1306,50.66
Leona,Udyr,641,334,307,52.11
Leona,Volibear,1844,939,905,50.92
Leona,Rengar,512,286,226,55.86
Leona,Vayne,2225,1081,1144,48.58
Leona,Blitzcrank,1714,909,805,53.03
Leona,KSante,798,404,394,50.63
Leona,Zac,702,341,361,48.58
Leona,Azir,663,340,323,51.28
Leona,Ambessa,1088,534,554,49.08
Leona,MissFortune,3666,1821,1845,49.67
Leona,Nautilus,2183,1125,1058,51.53
Leona,Warwick,2664,1286,1378,48.27
Leona,Tryndamere,790,448,342,56.71
Leona,LeeSin,2225,1207,1018,54.25
Leona,Ekko,1638,884,754,53.97
Leona,Sion,1221,581,640,47.58
Leona,Pantheon,2702,1413,1289,52.29
Leona,Ziggs,519,284,235,54.72
Leona,Lulu,1696,835,861,49.23
Leona,Hecarim,621,334,287,53.78
Leona,Yorick,1587,749,838,47.2
Leona,Kalista,465,241,224,51.83
Leona,Renekton,889,462,427,51.97
Leona,Sejuani,664,339,325,51.05
Leona,Taliyah,492,227,265,46.14
Leona,Kled,344,183,161,53.2
Leona,Shen,1050,536,514,51.05
Leona,Leblanc,894,493,401,55.15
Leona,Yuumi,1451,811,640,55.89
Leona,Teemo,2095,1013,1082,48.35
Leona,Gragas,950,455,495,47.89
Leona,Diana,2530,1212,1318,47.91
Leona,Caitlyn,4255,2084,2171,48.98
Leona,TwistedFate,528,270,258,51.14
Leona,MonkeyKing,1056,537,519,50.85
Leona,Briar,1428,673,755,47.13
Leona,TahmKench,1523,775,748,50.89
Leona,Evelynn,574,310,264,54.01
Leona,Varus,1484,812,672,54.72
Leona,Nami,1468,729,739,49.66
Leona,Kindred,715,402,313,56.22
Leona,Vladimir,1000,498,502,49.8
Leona,Nocturne,2021,943,1078,46.66
Leona,Karma,1656,782,874,47.22
Leona,Rakan,655,331,324,50.53
Leona,Lux,4273,2223,2050,52.02
Leona,Syndra,1087,566,521,52.07
Leona,Zyra,1529,703,826,45.98
Leona,Rell,1063,521,542,49.01
Leona,Vi,1603,709,894,44.23
Leona,Gwen,904,440,464,48.67
Leona,Kayle,1051,507,544,48.24
Leona,Darius,3023,1629,1394,53.89
Leona,Rammus,602,317,285,52.66
Leona,Illaoi,791,394,397,49.81
Leona,Nunu,1079,575,504,53.29
Leona,Amumu,1848,813,1035,43.99
Leona,Jinx,4284,2017,2267,47.08
Leona,Morgana,2179,1013,1166,46.49
Leona,Draven,857,472,385,55.08
Leona,Malzahar,1548,694,854,44.83
Leona,Tristana,1639,860,779,52.47
Leona,Poppy,1407,694,713,49.32
Leona,Orianna,771,372,399,48.25
Leona,Aphelios,943,450,493,47.72
Leona,Brand,1181,582,599,49.28
Leona,Kennen,442,202,240,45.7
Leona,Neeko,814,382,432,46.93
Leona,MasterYi,2091,1158,933,55.38
Leona,Zoe,638,341,297,53.45
Leona,Fiora,602,349,253,57.97
Leona,Ahri,2120,1043,1077,49.2
Leona,Xerath,1343,730,613,54.36
Leona,Malphite,1803,910,893,50.47
Leona,Anivia,526,252,274,47.91
Leona,Alistar,825,398,427,48.24
Leona,Gangplank,675,309,366,45.78
Leona,Belveth,441,227,214,51.47
Leona,Sona,510,268,242,52.55
Leona,Urgot,769,368,401,47.85
Leona,Janna,637,342,295,53.69
Leona,Ryze,571,263,308,46.06
Leona,Riven,595,325,270,54.62
Leona,Elise,1038,487,551,46.92
Leona,Sylas,2445,1236,1209,50.55
Leona,Khazix,702,381,321,54.27
Leona,Sivir,994,444,550,44.67
Leona,Shyvana,463,247,216,53.35
Leona,Zilean,488,235,253,48.16
Leona,Skarner,487,263,224,54
Leona,Vex,965,533,432,55.23
Leona,Quinn,517,274,243,53
Leona,Trundle,933,453,480,48.55
Leona,Akshan,573,286,287,49.91
Leona,Braum,1072,486,586,45.34
Leona,Naafiri,589,291,298,49.41
Leona,Olaf,402,195,207,48.51
Leona,Nidalee,402,243,159,60.45
Leona,RekSai,223,119,104,53.36
Leona,Camille,529,254,275,48.02
Leona,Lissandra,555,248,307,44.68
Leona,Xayah,861,443,418,51.45
Leona,Corki,635,319,316,50.24
Leona,Ornn,759,362,397,47.69
Leona,KogMaw,490,243,247,49.59
Leona,Fizz,938,488,450,52.03
Leona,Bard,451,214,237,47.45
Leona,Annie,549,295,254,53.73
Leona,Cassiopeia,548,309,239,56.39
Leona,Kassadin,346,192,154,55.49
Leona,Ivern,260,97,163,37.31
Leona,Jayce,699,361,338,51.65
Leona,Singed,387,176,211,45.48
Leona,Rumble,453,238,215,52.54
Leona,Renata,288,125,163,43.4
MonkeyKing,Teemo,1459,787,672,53.94
MonkeyKing,Warwick,1978,917,1061,46.36
MonkeyKing,Azir,543,310,233,57.09
MonkeyKing,MissFortune,2842,1386,1456,48.77
MonkeyKing,Neeko,605,317,288,52.4
MonkeyKing,Mordekaiser,1747,857,890,49.06
MonkeyKing,Qiyana,309,176,133,56.96
MonkeyKing,Mel,2584,1322,1262,51.16
MonkeyKing,Nautilus,1362,728,634,53.45
MonkeyKing,Sett,1956,996,960,50.92
MonkeyKing,Taliyah,360,150,210,41.67
MonkeyKing,Sylas,1696,931,765,54.89
MonkeyKing,Ezreal,2950,1519,1431,51.49
MonkeyKing,Morgana,1399,685,714,48.96
MonkeyKing,Tryndamere,711,356,355,50.07
MonkeyKing,Kayn,1898,1001,897,52.74
MonkeyKing,Aurora,979,474,505,48.42
MonkeyKing,Twitch,1089,562,527,51.61
MonkeyKing,Lux,3042,1488,1554,48.92
MonkeyKing,Ahri,1657,877,780,52.93
MonkeyKing,Nunu,768,395,373,51.43
MonkeyKing,Yasuo,2505,1291,1214,51.54
MonkeyKing,Zyra,1173,604,569,51.49
MonkeyKing,Chogath,1377,644,733,46.77
MonkeyKing,Lillia,732,377,355,51.5
MonkeyKing,Vex,600,288,312,48
MonkeyKing,Jhin,2409,1289,1120,53.51
MonkeyKing,Janna,444,244,200,54.95
MonkeyKing,LeeSin,1866,1012,854,54.23
MonkeyKing,Caitlyn,3271,1643,1628,50.23
MonkeyKing,Soraka,725,330,395,45.52
MonkeyKing,Kayle,795,379,416,47.67
MonkeyKing,Ekko,1142,632,510,55.34
MonkeyKing,Irelia,1067,580,487,54.36
MonkeyKing,Yuumi,928,535,393,57.65
MonkeyKing,Yorick,1192,534,658,44.8
MonkeyKing,Volibear,1519,740,779,48.72
MonkeyKing,Lucian,906,481,425,53.09
MonkeyKing,Blitzcrank,924,497,427,53.79
MonkeyKing,Akali,1347,731,616,54.27
MonkeyKing,Evelynn,457,216,241,47.26
MonkeyKing,Velkoz,708,336,372,47.46
MonkeyKing,Jax,1079,535,544,49.58
MonkeyKing,Braum,768,379,389,49.35
MonkeyKing,Viego,2061,1035,1026,50.22
MonkeyKing,Heimerdinger,566,304,262,53.71
MonkeyKing,Udyr,524,254,270,48.47
MonkeyKing,Malzahar,1266,633,633,50
MonkeyKing,Xayah,668,338,330,50.6
MonkeyKing,Rammus,328,161,167,49.09
MonkeyKing,Varus,1132,580,552,51.24
MonkeyKing,Yone,2382,1323,1059,55.54
MonkeyKing,Graves,874,449,425,51.37
MonkeyKing,Aatrox,1088,557,531,51.19
MonkeyKing,Ziggs,469,251,218,53.52
MonkeyKing,Kindred,600,295,305,49.17
MonkeyKing,Ryze,412,194,218,47.09
MonkeyKing,Karthus,321,168,153,52.34
MonkeyKing,Kassadin,264,156,108,59.09
MonkeyKing,Renekton,608,314,294,51.64
MonkeyKing,XinZhao,863,552,311,63.96
MonkeyKing,Leblanc,718,345,373,48.05
MonkeyKing,Jinx,3355,1648,1707,49.12
MonkeyKing,Shen,816,412,404,50.49
MonkeyKing,Pyke,1114,646,468,57.99
MonkeyKing,Viktor,1174,571,603,48.64
MonkeyKing,Ashe,2403,1229,1174,51.14
MonkeyKing,Senna,1006,563,443,55.96
MonkeyKing,Garen,2045,999,1046,48.85
MonkeyKing,JarvanIV,819,413,406,50.43
MonkeyKing,Hwei,912,471,441,51.64
MonkeyKing,Lulu,1614,774,840,47.96
MonkeyKing,Leona,1056,519,537,49.15
MonkeyKing,Ivern,232,122,110,52.59
MonkeyKing,Olaf,272,146,126,53.68
MonkeyKing,Katarina,1056,568,488,53.79
MonkeyKing,Kled,240,124,116,51.67
MonkeyKing,Poppy,692,370,322,53.47
MonkeyKing,Swain,1223,600,623,49.06
MonkeyKing,Zeri,478,229,249,47.91
MonkeyKing,Gangplank,634,319,315,50.32
MonkeyKing,Smolder,838,482,356,57.52
MonkeyKing,Alistar,581,330,251,56.8
MonkeyKing,Urgot,655,340,315,51.91
MonkeyKing,MasterYi,1478,797,681,53.92
MonkeyKing,Zed,1257,727,530,57.84
MonkeyKing,Milio,755,328,427,43.44
MonkeyKing,Briar,842,448,394,53.21
MonkeyKing,Illaoi,574,253,321,44.08
MonkeyKing,Shaco,1152,589,563,51.13
MonkeyKing,Draven,674,317,357,47.03
MonkeyKing,Vayne,1574,816,758,51.84
MonkeyKing,Nasus,871,409,462,46.96
MonkeyKing,Zoe,455,202,253,44.4
MonkeyKing,Pantheon,2104,1090,1014,51.81
MonkeyKing,DrMundo,705,363,342,51.49
MonkeyKing,Seraphine,960,458,502,47.71
MonkeyKing,Zac,656,304,352,46.34
MonkeyKing,AurelionSol,492,234,258,47.56
MonkeyKing,Aphelios,654,346,308,52.91
MonkeyKing,Tristana,1218,661,557,54.27
MonkeyKing,TwistedFate,401,202,199,50.37
MonkeyKing,Taric,236,130,106,55.08
MonkeyKing,Khazix,736,440,296,59.78
MonkeyKing,Fiora,507,235,272,46.35
MonkeyKing,Diana,1997,1100,897,55.08
MonkeyKing,Brand,919,452,467,49.18
MonkeyKing,Veigar,1331,691,640,51.92
MonkeyKing,Camille,494,291,203,58.91
MonkeyKing,Vladimir,795,369,426,46.42
MonkeyKing,Gragas,740,338,402,45.68
MonkeyKing,FiddleSticks,618,309,309,50
MonkeyKing,Orianna,538,277,261,51.49
MonkeyKing,Elise,809,394,415,48.7
MonkeyKing,Riven,624,342,282,54.81
MonkeyKing,Darius,2533,1269,1264,50.1
MonkeyKing,KSante,619,348,271,56.22
MonkeyKing,Thresh,1828,899,929,49.18
MonkeyKing,Xerath,951,478,473,50.26
MonkeyKing,Fizz,699,355,344,50.79
MonkeyKing,Annie,327,146,181,44.65
MonkeyKing,Maokai,540,247,293,45.74
MonkeyKing,Quinn,450,239,211,53.11
MonkeyKing,Sejuani,541,296,245,54.71
MonkeyKing,Gwen,680,347,333,51.03
MonkeyKing,Nami,1256,582,674,46.34
MonkeyKing,Kaisa,1932,1116,816,57.76
MonkeyKing,Bard,405,221,184,54.57
MonkeyKing,Karma,1487,751,736,50.5
MonkeyKing,Galio,998,504,494,50.5
MonkeyKing,Rakan,599,308,291,51.42
MonkeyKing,Trundle,683,337,346,49.34
MonkeyKing,Nidalee,380,184,196,48.42
MonkeyKing,Talon,777,495,282,63.71
MonkeyKing,Rell,628,335,293,53.34
MonkeyKing,Ambessa,818,451,367,55.13
MonkeyKing,Kalista,363,206,157,56.75
MonkeyKing,Sivir,625,288,337,46.08
MonkeyKing,Amumu,1228,614,614,50
MonkeyKing,Belveth,282,128,154,45.39
MonkeyKing,Zilean,378,221,157,58.47
MonkeyKing,Sion,975,478,497,49.03
MonkeyKing,Syndra,729,367,362,50.34
MonkeyKing,Nocturne,1643,805,838,49
MonkeyKing,Gnar,475,219,256,46.11
MonkeyKing,RekSai,119,49,70,41.18
MonkeyKing,TahmKench,1104,570,534,51.63
MonkeyKing,Ornn,549,274,275,49.91
MonkeyKing,Renata,255,137,118,53.73
MonkeyKing,Sona,382,186,196,48.69
MonkeyKing,Hecarim,458,281,177,61.35
MonkeyKing,Cassiopeia,446,212,234,47.53
MonkeyKing,Nilah,498,251,247,50.4
MonkeyKing,Naafiri,417,200,217,47.96
MonkeyKing,KogMaw,323,149,174,46.13
MonkeyKing,Malphite,1155,617,538,53.42
MonkeyKing,Lissandra,515,261,254,50.68
MonkeyKing,Vi,1385,668,717,48.23
MonkeyKing,Singed,311,128,183,41.16
MonkeyKing,Jayce,638,317,321,49.69
MonkeyKing,Kennen,364,196,168,53.85
MonkeyKing,Akshan,425,216,209,50.82
MonkeyKing,Samira,1018,586,432,57.56
MonkeyKing,Rengar,403,270,133,67
MonkeyKing,Shyvana,318,136,182,42.77
MonkeyKing,Corki,544,318,226,58.46
MonkeyKing,Skarner,410,249,161,60.73
MonkeyKing,Rumble,296,177,119,59.8
MonkeyKing,Anivia,425,196,229,46.12
Teemo,MonkeyKing,1459,672,787,46.06
Teemo,Kayn,3858,2067,1791,53.58
Teemo,Yasuo,5101,2572,2529,50.42
Teemo,Kaisa,3572,2022,1550,56.61
Teemo,Milio,1305,663,642,50.8
Teemo,Vayne,2892,1556,1336,53.8
Teemo,Nocturne,2962,1471,1491,49.66
Teemo,Galio,2164,1106,1058,51.11
Teemo,Blitzcrank,1862,994,868,53.38
Teemo,Warwick,3988,1994,1994,50
Teemo,Evelynn,1144,707,437,61.8
Teemo,Ahri,3261,1725,1536,52.9
Teemo,Yone,4478,2534,1944,56.59
Teemo,Garen,4105,2229,1876,54.3
Teemo,Lux,6917,3658,3259,52.88
Teemo,Caitlyn,6830,3483,3347,51
Teemo,Thresh,3130,1635,1495,52.24
Teemo,Irelia,1979,1097,882,55.43
Teemo,Sivir,1346,717,629,53.27
Teemo,Rell,1213,655,558,54
Teemo,Aatrox,2558,1397,1161,54.61
Teemo,Gwen,1122,656,466,58.47
Teemo,Syndra,1502,740,762,49.27
Teemo,Ashe,4745,2505,2240,52.79
Teemo,Lulu,2476,1263,1213,51.01
Teemo,Mordekaiser,3542,1702,1840,48.05
Teemo,Amumu,2888,1423,1465,49.27
Teemo,Soraka,1462,710,752,48.56
Teemo,Smolder,1751,923,828,52.71
Teemo,Velkoz,1671,898,773,53.74
Teemo,Chogath,3494,1603,1891,45.88
Teemo,Talon,1405,795,610,56.58
Teemo,Qiyana,607,359,248,59.14
Teemo,Mel,5329,2878,2451,54.01
Teemo,Seraphine,2266,1167,1099,51.5
Teemo,Zed,2709,1528,1181,56.4
Teemo,Shaco,2412,1310,1102,54.31
Teemo,Anivia,730,326,404,44.66
Teemo,Morgana,3208,1685,1523,52.52
Teemo,Tryndamere,1441,771,670,53.5
Teemo,Zeri,1054,516,538,48.96
Teemo,Yorick,2836,1363,1473,48.06
Teemo,Volibear,2883,1543,1340,53.52
Teemo,Veigar,3065,1488,1577,48.55
Teemo,Sona,930,456,474,49.03
Teemo,Sion,2300,1107,1193,48.13
Teemo,Akshan,936,454,482,48.5
Teemo,Jinx,6331,3149,3182,49.74
Teemo,Bard,694,369,325,53.17
Teemo,Gangplank,1184,588,596,49.66
Teemo,Taliyah,596,356,240,59.73
Teemo,Akali,2813,1506,1307,53.54
Teemo,Ezreal,5125,2768,2357,54.01
Teemo,Belveth,652,363,289,55.67
Teemo,Hwei,1621,794,827,48.98
Teemo,TahmKench,2087,1103,984,52.85
Teemo,MissFortune,6209,3165,3044,50.97
Teemo,Lillia,1450,751,699,51.79
Teemo,Gnar,1003,539,464,53.74
Teemo,Rammus,727,342,385,47.04
Teemo,Poppy,1272,634,638,49.84
Teemo,Sett,3472,1747,1725,50.32
Teemo,MasterYi,3116,1578,1538,50.64
Teemo,AurelionSol,1014,526,488,51.87
Teemo,Kindred,1213,693,520,57.13
Teemo,Kennen,844,441,403,52.25
Teemo,Tristana,2401,1282,1119,53.39
Teemo,Yuumi,2148,1060,1088,49.35
Teemo,Ekko,2182,1146,1036,52.52
Teemo,Lucian,1556,764,792,49.1
Teemo,TwistedFate,860,512,348,59.53
Teemo,Cassiopeia,1043,566,477,54.27
Teemo,LeeSin,2884,1560,1324,54.09
Teemo,DrMundo,1497,697,800,46.56
Teemo,Nautilus,2792,1527,1265,54.69
Teemo,Trundle,1410,710,700,50.35
Teemo,Aphelios,1441,827,614,57.39
Teemo,Malphite,3519,1799,1720,51.12
Teemo,Vladimir,1625,831,794,51.14
Teemo,Senna,1953,1000,953,51.2
Teemo,Ziggs,1182,640,542,54.15
Teemo,Sejuani,984,515,469,52.34
Teemo,Heimerdinger,1559,755,804,48.43
Teemo,Zilean,830,435,395,52.41
Teemo,Hecarim,941,471,470,50.05
Teemo,Twitch,2027,1071,956,52.84
Teemo,Ivern,413,238,175,57.63
Teemo,Jhin,4844,2478,2366,51.16
Teemo,Pyke,2589,1402,1187,54.15
Teemo,Viego,3322,1697,1625,51.08
Teemo,Kalista,746,414,332,55.5
Teemo,FiddleSticks,1307,590,717,45.14
Teemo,Udyr,918,479,439,52.18
Teemo,Leblanc,1267,644,623,50.83
Teemo,Nami,2388,1177,1211,49.29
Teemo,Vi,2177,1172,1005,53.84
Teemo,Nilah,1016,539,477,53.05
Teemo,Samira,2174,1113,1061,51.2
Teemo,Taric,534,266,268,49.81
Teemo,Ornn,1022,485,537,47.46
Teemo,Skarner,665,317,348,47.67
Teemo,Illaoi,1081,616,465,56.98
Teemo,Naafiri,962,500,462,51.98
Teemo,Xayah,1202,631,571,52.5
Teemo,Rakan,948,460,488,48.52
Teemo,Nasus,2069,1030,1039,49.78
Teemo,Zac,1050,535,515,50.95
Teemo,Swain,2529,1279,1250,50.57
Teemo,Briar,2113,1223,890,57.88
Teemo,Urgot,1260,659,601,52.3
Teemo,Draven,1320,690,630,52.27
Teemo,Vex,1549,787,762,50.81
Teemo,Diana,4043,2066,1977,51.1
Teemo,Leona,2095,1082,1013,51.65
Teemo,Ryze,973,500,473,51.39
Teemo,Aurora,1990,1068,922,53.67
Teemo,Braum,1303,630,673,48.35
Teemo,Jax,2180,1138,1042,52.2
Teemo,Zyra,2250,1106,1144,49.16
Teemo,Gragas,1299,786,513,60.51
Teemo,Xerath,2101,1114,987,53.02
Teemo,Quinn,1056,592,464,56.06
Teemo,Darius,4955,2575,2380,51.97
Teemo,Renata,502,222,280,44.22
Teemo,Ambessa,1253,692,561,55.23
Teemo,KogMaw,827,415,412,50.18
Teemo,Nunu,1696,838,858,49.41
Teemo,Azir,728,389,339,53.43
Teemo,Renekton,931,556,375,59.72
Teemo,Khazix,1252,705,547,56.31
Teemo,Brand,2034,1066,968,52.41
Teemo,Neeko,1587,865,722,54.51
Teemo,Fiora,728,400,328,54.95
Teemo,Malzahar,2664,1336,1328,50.15
Teemo,Kayle,1801,919,882,51.03
Teemo,Corki,814,450,364,55.28
Teemo,Janna,605,335,270,55.37
Teemo,Fizz,1479,734,745,49.63
Teemo,Alistar,984,559,425,56.81
Teemo,Sylas,2967,1602,1365,53.99
Teemo,Varus,2145,1144,1001,53.33
Teemo,Shyvana,677,330,347,48.74
Teemo,Lissandra,753,395,358,52.46
Teemo,Kled,454,252,202,55.51
Teemo,Graves,1321,729,592,55.19
Teemo,Orianna,974,541,433,55.54
Teemo,Shen,1474,682,792,46.27
Teemo,Elise,1503,836,667,55.62
Teemo,Rengar,855,494,361,57.78
Teemo,Maokai,1179,597,582,50.64
Teemo,Singed,642,284,358,44.24
Teemo,Riven,1007,549,458,54.52
Teemo,Katarina,1853,950,903,51.27
Teemo,Olaf,710,374,336,52.68
Teemo,KSante,747,443,304,59.3
Teemo,Kassadin,447,235,212,52.57
Teemo,Karthus,748,372,376,49.73
Teemo,Annie,898,461,437,51.34
Teemo,Viktor,1879,988,891,52.58
Teemo,Pantheon,3821,1961,1860,51.32
Teemo,Nidalee,667,397,270,59.52
Teemo,JarvanIV,1177,534,643,45.37
Teemo,Zoe,976,573,403,58.71
Teemo,Karma,2383,1226,1157,51.45
Teemo,Rumble,805,431,374,53.54
Teemo,XinZhao,1318,683,635,51.82
Teemo,RekSai,282,177,105,62.77
Teemo,Jayce,1179,647,532,54.88
Teemo,Camille,754,426,328,56.5
Azir,MonkeyKing,543,233,310,42.91
Azir,Kayn,805,360,445,44.72
Azir,Yasuo,1419,762,657,53.7
Azir,Kaisa,1162,550,612,47.33
Azir,Milio,404,218,186,53.96
Azir,KSante,352,181,171,51.42
Azir,Warwick,1016,447,569,44
Azir,Diana,1139,553,586,48.55
Azir,Ashe,1432,672,760,46.93
Azir,Corki,294,150,144,51.02
Azir,Sett,1073,508,565,47.34
Azir,Volibear,796,387,409,48.62
Azir,Ambessa,534,270,264,50.56
Azir,Smolder,497,267,230,53.72
Azir,Swain,683,306,377,44.8
Azir,Riven,268,156,112,58.21
Azir,Syndra,495,221,274,44.65
Azir,Jinx,1759,802,957,45.59
Azir,Pyke,661,353,308,53.4
Azir,Illaoi,334,134,200,40.12
Azir,Caitlyn,1822,899,923,49.34
Azir,Velkoz,396,183,213,46.21
Azir,Nocturne,747,327,420,43.78
Azir,Xerath,696,321,375,46.12
Azir,Ezreal,1645,807,838,49.06
Azir,Blitzcrank,585,296,289,50.6
Azir,Aatrox,682,346,336,50.73
Azir,Cassiopeia,254,151,103,59.45
Azir,Varus,625,284,341,45.44
Azir,Morgana,811,360,451,44.39
Azir,Chogath,915,428,487,46.78
Azir,Poppy,465,194,271,41.72
Azir,Irelia,606,299,307,49.34
Azir,Jhin,1292,594,698,45.98
Azir,Leona,663,323,340,48.72
Azir,Shaco,595,316,279,53.11
Azir,Akali,713,356,357,49.93
Azir,Sivir,406,181,225,44.58
Azir,Renata,171,93,78,54.39
Azir,Nunu,445,238,207,53.48
Azir,Yone,1242,655,587,52.74
Azir,Malzahar,679,337,342,49.63
Azir,Khazix,415,218,197,52.53
Azir,Nasus,436,200,236,45.87
Azir,Maokai,346,166,180,47.98
Azir,Elise,503,247,256,49.11
Azir,Vex,383,148,235,38.64
Azir,Lucian,520,290,230,55.77
Azir,Senna,561,310,251,55.26
Azir,Malphite,616,292,324,47.4
Azir,Xayah,424,237,187,55.9
Azir,Rakan,319,168,151,52.66
Azir,Garen,1035,488,547,47.15
Azir,Lux,1612,710,902,44.04
Azir,Ryze,314,162,152,51.59
Azir,Pantheon,1239,611,628,49.31
Azir,Darius,1312,653,659,49.77
Azir,Mordekaiser,899,399,500,44.38
Azir,Evelynn,247,125,122,50.61
Azir,Aurora,689,337,352,48.91
Azir,Naafiri,234,100,134,42.74
Azir,MasterYi,708,319,389,45.06
Azir,Twitch,535,232,303,43.36
Azir,Teemo,728,339,389,46.57
Azir,Vayne,739,372,367,50.34
Azir,Ahri,959,442,517,46.09
Azir,Katarina,552,289,263,52.36
Azir,Yuumi,678,291,387,42.92
Azir,Gnar,337,147,190,43.62
Azir,Annie,206,92,114,44.66
Azir,Tristana,715,370,345,51.75
Azir,Ekko,609,305,304,50.08
Azir,Lillia,409,188,221,45.97
Azir,Draven,375,177,198,47.2
Azir,Lulu,933,447,486,47.91
Azir,Leblanc,442,227,215,51.36
Azir,Jax,626,315,311,50.32
Azir,Trundle,428,219,209,51.17
Azir,Soraka,364,191,173,52.47
Azir,TahmKench,581,261,320,44.92
Azir,Udyr,305,170,135,55.74
Azir,Orianna,344,181,163,52.62
Azir,Mel,1699,926,773,54.5
Azir,Veigar,604,285,319,47.19
Azir,Braum,468,203,265,43.38
Azir,Rengar,306,171,135,55.88
Azir,Yorick,578,238,340,41.18
Azir,Kindred,349,183,166,52.44
Azir,Vladimir,429,203,226,47.32
Azir,Brand,386,167,219,43.26
Azir,FiddleSticks,331,148,183,44.71
Azir,Shen,500,255,245,51
Azir,Skarner,245,119,126,48.57
Azir,Samira,541,248,293,45.84
Azir,Qiyana,229,123,106,53.71
Azir,Zyra,545,279,266,51.19
Azir,Viego,1000,408,592,40.8
Azir,Nilah,260,146,114,56.15
Azir,Sona,226,98,128,43.36
Azir,Zac,466,246,220,52.79
Azir,Galio,605,313,292,51.74
Azir,Fiora,275,137,138,49.82
Azir,Lissandra,201,114,87,56.72
Azir,Thresh,992,502,490,50.6
Azir,MissFortune,1382,663,719,47.97
Azir,Sion,489,201,288,41.1
Azir,Zed,730,319,411,43.7
Azir,Taric,151,64,87,42.38
Azir,Amumu,597,266,331,44.56
Azir,Zoe,311,138,173,44.37
Azir,Zeri,371,131,240,35.31
Azir,Gragas,474,236,238,49.79
Azir,Sylas,1047,523,524,49.95
Azir,Taliyah,185,98,87,52.97
Azir,Karma,766,341,425,44.52
Azir,Aphelios,405,172,233,42.47
Azir,Seraphine,526,233,293,44.3
Azir,Alistar,347,167,180,48.13
Azir,Briar,518,231,287,44.59
Azir,Nautilus,800,440,360,55
Azir,Renekton,344,174,170,50.58
Azir,Bard,172,75,97,43.6
Azir,Viktor,638,278,360,43.57
Azir,Talon,435,184,251,42.3
Azir,XinZhao,484,261,223,53.93
Azir,Nami,607,308,299,50.74
Azir,Karthus,227,102,125,44.93
Azir,Neeko,342,167,175,48.83
Azir,Rammus,207,71,136,34.3
Azir,Zilean,221,102,119,46.15
Azir,JarvanIV,369,210,159,56.91
Azir,Ivern,121,70,51,57.85
Azir,TwistedFate,282,159,123,56.38
Azir,Tryndamere,348,167,181,47.99
Azir,Shyvana,135,56,79,41.48
Azir,Quinn,260,157,103,60.38
Azir,LeeSin,1189,579,610,48.7
Azir,Jayce,425,237,188,55.76
Azir,Kassadin,107,58,49,54.21
Azir,Heimerdinger,298,117,181,39.26
Azir,Nidalee,217,121,96,55.76
Azir,Ziggs,172,76,96,44.19
Azir,Kennen,153,61,92,39.87
Azir,Urgot,333,164,169,49.25
Azir,KogMaw,171,75,96,43.86
Azir,Vi,650,271,379,41.69
Azir,Ornn,343,157,186,45.77
Azir,Hwei,526,289,237,54.94
Azir,Gwen,325,143,182,44
Azir,Fizz,251,122,129,48.61
Azir,Belveth,184,104,80,56.52
Azir,Rumble,170,68,102,40
Azir,Kalista,258,104,154,40.31
Azir,Kayle,441,210,231,47.62
Azir,Sejuani,319,189,130,59.25
Azir,Camille,251,129,122,51.39
Azir,Singed,185,60,125,32.43
Azir,Rell,414,182,232,43.96
Azir,RekSai,121,59,62,48.76
Azir,Janna,218,104,114,47.71
Azir,Gangplank,362,198,164,54.7
Azir,Olaf,135,67,68,49.63
Azir,AurelionSol,250,91,159,36.4
Azir,Akshan,240,111,129,46.25
Azir,DrMundo,334,181,153,54.19
Azir,Hecarim,277,114,163,41.16
Azir,Graves,429,211,218,49.18
Azir,Kled,157,61,96,38.85
Azir,Anivia,181,83,98,45.86
MissFortune,MonkeyKing,2842,1456,1386,51.23
MissFortune,Kayn,6817,3324,3493,48.76
MissFortune,Yasuo,8853,4393,4460,49.62
MissFortune,Kaisa,6978,3648,3330,52.28
MissFortune,Milio,2326,1098,1228,47.21
MissFortune,Gangplank,1797,902,895,50.19
MissFortune,Warwick,7444,3571,3873,47.97
MissFortune,Akali,5307,2655,2652,50.03
MissFortune,Caitlyn,14303,7322,6981,51.19
MissFortune,Sona,1439,781,658,54.27
MissFortune,Aatrox,3750,1990,1760,53.07
MissFortune,Sejuani,1838,931,907,50.65
MissFortune,Jinx,13928,6884,7044,49.43
MissFortune,Pyke,3804,1984,1820,52.16
MissFortune,Gnar,1832,978,854,53.38
MissFortune,Jax,4059,2196,1863,54.1
MissFortune,Neeko,2831,1561,1270,55.14
MissFortune,Ornn,1762,849,913,48.18
MissFortune,Udyr,1600,862,738,53.87
MissFortune,Lux,12507,6456,6051,51.62
MissFortune,Ezreal,10172,5347,4825,52.57
MissFortune,Nidalee,1117,635,482,56.85
MissFortune,Ahri,6168,3128,3040,50.71
MissFortune,Jhin,9499,4760,4739,50.11
MissFortune,Senna,3294,1686,1608,51.18
MissFortune,Urgot,2401,1177,1224,49.02
MissFortune,Twitch,3732,1960,1772,52.52
MissFortune,Vladimir,2517,1280,1237,50.85
MissFortune,Zac,1821,933,888,51.24
MissFortune,Cassiopeia,1401,732,669,52.25
MissFortune,Irelia,3813,1955,1858,51.27
MissFortune,Darius,8475,4429,4046,52.26
MissFortune,Volibear,5357,2736,2621,51.07
MissFortune,Chogath,5593,2820,2773,50.42
MissFortune,Brand,3736,1797,1939,48.1
MissFortune,Fiora,1650,824,826,49.94
MissFortune,Yone,8596,4600,3996,53.51
MissFortune,Galio,3622,1742,1880,48.09
MissFortune,KSante,1900,1040,860,54.74
MissFortune,Diana,7176,3485,3691,48.56
MissFortune,Ashe,9951,5173,4778,51.98
MissFortune,Corki,1633,892,741,54.62
MissFortune,Shen,2951,1542,1409,52.25
MissFortune,Samira,3875,1956,1919,50.48
MissFortune,Soraka,2371,1201,1170,50.65
MissFortune,Sylas,5590,2967,2623,53.08
MissFortune,Amumu,4705,2224,2481,47.27
MissFortune,Vex,2560,1270,1290,49.61
MissFortune,Rakan,1936,1036,900,53.51
MissFortune,Gwen,2475,1390,1085,56.16
MissFortune,Thresh,5602,2961,2641,52.86
MissFortune,Yuumi,3608,1844,1764,51.11
MissFortune,Karma,4104,2071,2033,50.46
MissFortune,Garen,7047,3433,3614,48.72
MissFortune,FiddleSticks,2128,1032,1096,48.5
MissFortune,Mordekaiser,6869,3348,3521,48.74
MissFortune,Lulu,4552,2277,2275,50.02
MissFortune,Veigar,5133,2502,2631,48.74
MissFortune,Nasus,3501,1714,1787,48.96
MissFortune,Khazix,2194,1253,941,57.11
MissFortune,Aurora,3417,1808,1609,52.91
MissFortune,Viego,5970,2992,2978,50.12
MissFortune,Nocturne,5214,2582,2632,49.52
MissFortune,Jayce,1663,900,763,54.12
MissFortune,Sett,7296,3653,3643,50.07
MissFortune,Shyvana,1128,591,537,52.39
MissFortune,Fizz,2860,1556,1304,54.41
MissFortune,Nilah,2025,1003,1022,49.53
MissFortune,Nami,4126,1927,2199,46.7
MissFortune,LeeSin,5461,2806,2655,51.38
MissFortune,Evelynn,1796,926,870,51.56
MissFortune,Belveth,1037,519,518,50.05
MissFortune,Hwei,2866,1468,1398,51.22
MissFortune,TahmKench,4020,2120,1900,52.74
MissFortune,Orianna,1777,896,881,50.42
MissFortune,Nautilus,4873,2648,2225,54.34
MissFortune,Ivern,685,389,296,56.79
MissFortune,Swain,4643,2206,2437,47.51
MissFortune,Kayle,3104,1544,1560,49.74
MissFortune,Katarina,3564,2036,1528,57.13
MissFortune,Gragas,2278,1236,1042,54.26
MissFortune,Teemo,6209,3044,3165,49.03
MissFortune,Morgana,5859,2846,3013,48.57
MissFortune,Briar,3712,1745,1967,47.01
MissFortune,RekSai,469,221,248,47.12
MissFortune,Braum,2731,1354,1377,49.58
MissFortune,Varus,3890,2035,1855,52.31
MissFortune,Janna,1263,632,631,50.04
MissFortune,Shaco,3965,2020,1945,50.95
MissFortune,Riven,1728,951,777,55.03
MissFortune,Pantheon,7012,3557,3455,50.73
MissFortune,Zed,4501,2402,2099,53.37
MissFortune,MasterYi,5579,2736,2843,49.04
MissFortune,Trundle,2832,1323,1509,46.72
MissFortune,Malzahar,4440,2128,2312,47.93
MissFortune,Talon,2492,1335,1157,53.57
MissFortune,DrMundo,2677,1232,1445,46.02
MissFortune,Yorick,4598,2209,2389,48.04
MissFortune,Blitzcrank,3355,1712,1643,51.03
MissFortune,Smolder,2822,1494,1328,52.94
MissFortune,JarvanIV,2117,1068,1049,50.45
MissFortune,Rengar,1511,862,649,57.05
MissFortune,Vayne,5553,2740,2813,49.34
MissFortune,XinZhao,2632,1286,1346,48.86
MissFortune,Leona,3666,1845,1821,50.33
MissFortune,Vi,4064,2154,1910,53
MissFortune,Anivia,1384,698,686,50.43
MissFortune,Leblanc,2347,1259,1088,53.64
MissFortune,Maokai,1965,962,1003,48.96
MissFortune,Mel,9318,4923,4395,52.83
MissFortune,Kalista,1471,785,686,53.37
MissFortune,Kennen,1302,755,547,57.99
MissFortune,Ekko,3971,2022,1949,50.92
MissFortune,Graves,2539,1261,1278,49.67
MissFortune,Zeri,1751,866,885,49.46
MissFortune,Taric,936,474,462,50.64
MissFortune,Rumble,1021,493,528,48.29
MissFortune,Akshan,1609,781,828,48.54
MissFortune,Tryndamere,2646,1363,1283,51.51
MissFortune,Malphite,4402,2244,2158,50.98
MissFortune,Zoe,1683,951,732,56.51
MissFortune,Heimerdinger,2540,1279,1261,50.35
MissFortune,Ambessa,2394,1224,1170,51.13
MissFortune,Rammus,1346,670,676,49.78
MissFortune,Seraphine,4197,2207,1990,52.59
MissFortune,Ziggs,1805,826,979,45.76
MissFortune,Karthus,1151,628,523,54.56
MissFortune,AurelionSol,1985,932,1053,46.95
MissFortune,Rell,2081,1104,977,53.05
MissFortune,Xayah,2353,1248,1105,53.04
MissFortune,Lucian,2889,1515,1374,52.44
MissFortune,Singed,1085,474,611,43.69
MissFortune,Draven,2396,1209,1187,50.46
MissFortune,Lillia,2720,1408,1312,51.76
MissFortune,Illaoi,2474,1224,1250,49.47
MissFortune,Hecarim,1598,837,761,52.38
MissFortune,Tristana,5327,2795,2532,52.47
MissFortune,Aphelios,2362,1202,1160,50.89
MissFortune,TwistedFate,1468,761,707,51.84
MissFortune,Viktor,3206,1660,1546,51.78
MissFortune,Olaf,953,536,417,56.24
MissFortune,Nunu,3011,1518,1493,50.42
MissFortune,Camille,1336,702,634,52.54
MissFortune,Kled,726,355,371,48.9
MissFortune,Poppy,2468,1210,1258,49.03
MissFortune,Skarner,1154,671,483,58.15
MissFortune,Xerath,3745,1759,1986,46.97
MissFortune,Elise,2774,1568,1206,56.52
MissFortune,Quinn,1617,795,822,49.17
MissFortune,Kassadin,877,383,494,43.67
MissFortune,Annie,1322,667,655,50.45
MissFortune,Ryze,1336,664,672,49.7
MissFortune,Zyra,3940,1928,2012,48.93
MissFortune,Sivir,2471,1224,1247,49.53
MissFortune,KogMaw,1412,664,748,47.03
MissFortune,Sion,3248,1522,1726,46.86
MissFortune,Naafiri,1659,850,809,51.24
MissFortune,Velkoz,2757,1257,1500,45.59
MissFortune,Zilean,1259,655,604,52.03
MissFortune,Kindred,2063,1053,1010,51.04
MissFortune,Syndra,2486,1286,1200,51.73
MissFortune,Qiyana,1153,647,506,56.11
MissFortune,Renekton,2051,1057,994,51.54
MissFortune,Bard,1155,553,602,47.88
MissFortune,Alistar,1568,819,749,52.23
MissFortune,Taliyah,895,410,485,45.81
MissFortune,Azir,1382,719,663,52.03
MissFortune,Renata,830,435,395,52.41
MissFortune,Lissandra,1293,638,655,49.34
Neeko,MonkeyKing,605,288,317,47.6
Neeko,Kayn,1636,771,865,47.13
Neeko,Yasuo,2045,954,1091,46.65
Neeko,Kaisa,1384,726,658,52.46
Neeko,Milio,540,265,275,49.07
Neeko,Irelia,1005,485,520,48.26
Neeko,Zed,1038,549,489,52.89
Neeko,Galio,876,372,504,42.47
Neeko,MissFortune,2831,1270,1561,44.86
Neeko,TahmKench,968,465,503,48.04
Neeko,Yone,2155,1115,1040,51.74
Neeko,Shaco,941,500,441,53.13
Neeko,AurelionSol,451,183,268,40.58
Neeko,Ashe,2136,1023,1113,47.89
Neeko,Velkoz,635,259,376,40.79
Neeko,Fiora,404,210,194,51.98
Neeko,MasterYi,1384,692,692,50
Neeko,Mel,2312,1096,1216,47.4
Neeko,Jhin,2096,999,1097,47.66
Neeko,Karma,950,517,433,54.42
Neeko,Gwen,611,306,305,50.08
Neeko,JarvanIV,376,166,210,44.15
Neeko,Zyra,1038,464,574,44.7
Neeko,Seraphine,1199,560,639,46.71
Neeko,Garen,1699,773,926,45.5
Neeko,Lux,3185,1456,1729,45.71
Neeko,Caitlyn,2860,1440,1420,50.35
Neeko,Thresh,1417,749,668,52.86
Neeko,Riven,458,231,227,50.44
Neeko,Amumu,1236,573,663,46.36
Neeko,Zoe,467,212,255,45.4
Neeko,Sona,382,164,218,42.93
Neeko,Akali,1180,583,597,49.41
Neeko,Rammus,319,142,177,44.51
Neeko,Jinx,2635,1283,1352,48.69
Neeko,Mordekaiser,1570,827,743,52.68
Neeko,Diana,1586,755,831,47.6
Neeko,Ahri,1526,758,768,49.67
Neeko,Twitch,770,364,406,47.27
Neeko,Lulu,975,490,485,50.26
Neeko,Gnar,431,220,211,51.04
Neeko,Leblanc,561,264,297,47.06
Neeko,Pyke,1063,589,474,55.41
Neeko,Varus,970,475,495,48.97
Neeko,Chogath,1283,589,694,45.91
Neeko,Poppy,648,293,355,45.22
Neeko,Illaoi,544,238,306,43.75
Neeko,Khazix,612,317,295,51.8
Neeko,Syndra,594,269,325,45.29
Neeko,Udyr,391,158,233,40.41
Neeko,Yorick,1059,447,612,42.21
Neeko,Jax,989,491,498,49.65
Neeko,Naafiri,420,220,200,52.38
Neeko,Tristana,1007,550,457,54.62
Neeko,Rakan,513,251,262,48.93
Neeko,Karthus,287,120,167,41.81
Neeko,Nilah,445,204,241,45.84
Neeko,Braum,528,230,298,43.56
Neeko,Sion,814,355,459,43.61
Neeko,FiddleSticks,445,216,229,48.54
Neeko,Ezreal,2188,1180,1008,53.93
Neeko,Zilean,296,116,180,39.19
Neeko,Trundle,593,293,300,49.41
Neeko,Nocturne,1172,541,631,46.16
Neeko,Orianna,450,199,251,44.22
Neeko,Veigar,1181,577,604,48.86
Neeko,Brand,949,452,497,47.63
Neeko,Cassiopeia,417,186,231,44.6
Neeko,Pantheon,1812,928,884,51.21
Neeko,Swain,1161,478,683,41.17
Neeko,Gragas,585,311,274,53.16
Neeko,LeeSin,1271,670,601,52.71
Neeko,Kayle,681,295,386,43.32
Neeko,Morgana,1533,787,746,51.34
Neeko,Sejuani,381,176,205,46.19
Neeko,Smolder,607,273,334,44.98
Neeko,Rengar,378,222,156,58.73
Neeko,Hwei,780,378,402,48.46
Neeko,Singed,260,117,143,45
Neeko,Yuumi,801,405,396,50.56
Neeko,Blitzcrank,806,439,367,54.47
Neeko,Warwick,1671,796,875,47.64
Neeko,Briar,842,411,431,48.81
Neeko,Senna,844,400,444,47.39
Neeko,Urgot,598,234,364,39.13
Neeko,Annie,315,144,171,45.71
Neeko,Graves,664,338,326,50.9
Neeko,Zeri,485,212,273,43.71
Neeko,Taric,222,88,134,39.64
Neeko,DrMundo,592,285,307,48.14
Neeko,Samira,969,478,491,49.33
Neeko,Kennen,409,181,228,44.25
Neeko,Katarina,804,437,367,54.35
Neeko,Soraka,578,288,290,49.83
Neeko,Ambessa,635,354,281,55.75
Neeko,Darius,1976,885,1091,44.79
Neeko,Viego,1496,730,766,48.8
Neeko,Sylas,1402,691,711,49.29
Neeko,Nami,994,478,516,48.09
Neeko,Aphelios,599,273,326,45.58
Neeko,Lissandra,387,175,212,45.22
Neeko,Vladimir,584,284,300,48.63
Neeko,Corki,361,201,160,55.68
Neeko,Ziggs,360,151,209,41.94
Neeko,Aatrox,976,496,480,50.82
Neeko,Xayah,614,257,357,41.86
Neeko,Skarner,323,188,135,58.2
Neeko,Xerath,879,375,504,42.66
Neeko,Zac,396,166,230,41.92
Neeko,Renekton,505,256,249,50.69
Neeko,Sett,1709,768,941,44.94
Neeko,KogMaw,349,144,205,41.26
Neeko,Janna,353,168,185,47.59
Neeko,Talon,687,319,368,46.43
Neeko,Lillia,625,301,324,48.16
Neeko,Hecarim,438,220,218,50.23
Neeko,Malzahar,936,431,505,46.05
Neeko,Fizz,604,287,317,47.52
Neeko,Kalista,364,195,169,53.57
Neeko,Vi,988,502,486,50.81
Neeko,Teemo,1587,722,865,45.49
Neeko,Aurora,973,463,510,47.58
Neeko,Rell,515,229,286,44.47
Neeko,Nasus,840,363,477,43.21
Neeko,Draven,557,301,256,54.04
Neeko,Renata,258,121,137,46.9
Neeko,Lucian,696,356,340,51.15
Neeko,Vex,643,318,325,49.46
Neeko,Ryze,265,139,126,52.45
Neeko,Olaf,294,153,141,52.04
Neeko,Vayne,1216,543,673,44.65
Neeko,Ekko,860,415,445,48.26
Neeko,Nunu,794,379,415,47.73
Neeko,Evelynn,481,214,267,44.49
Neeko,Malphite,953,486,467,51
Neeko,Alistar,387,168,219,43.41
Neeko,Camille,341,188,153,55.13
Neeko,Leona,814,432,382,53.07
Neeko,Shen,649,318,331,49
Neeko,Nautilus,1158,541,617,46.72
Neeko,Sivir,555,246,309,44.32
Neeko,Nidalee,334,180,154,53.89
Neeko,Kassadin,228,109,119,47.81
Neeko,Maokai,574,308,266,53.66
Neeko,Volibear,1260,584,676,46.35
Neeko,Taliyah,247,108,139,43.72
Neeko,Elise,747,370,377,49.53
Neeko,Bard,278,161,117,57.91
Neeko,Heimerdinger,653,287,366,43.95
Neeko,Viktor,832,413,419,49.64
Neeko,Jayce,488,283,205,57.99
Neeko,Gangplank,508,290,218,57.09
Neeko,Akshan,391,169,222,43.22
Neeko,Kindred,519,275,244,52.99
Neeko,TwistedFate,358,176,182,49.16
Neeko,Rumble,199,108,91,54.27
Neeko,Azir,342,175,167,51.17
Neeko,Ornn,409,189,220,46.21
Neeko,Ivern,175,78,97,44.57
Neeko,Belveth,195,81,114,41.54
Neeko,RekSai,134,67,67,50
Neeko,Tryndamere,609,290,319,47.62
Neeko,Kled,166,91,75,54.82
Neeko,Anivia,311,136,175,43.73
Neeko,Shyvana,299,148,151,49.5
Neeko,Qiyana,236,138,98,58.47
Neeko,Quinn,386,169,217,43.78
Neeko,KSante,483,218,265,45.13
Neeko,XinZhao,698,333,365,47.71
FiddleSticks,Gangplank,385,220,165,57.14
FiddleSticks,MasterYi,1119,564,555,50.4
FiddleSticks,Veigar,972,493,479,50.72
FiddleSticks,Mel,1972,963,1009,48.83
FiddleSticks,Swain,970,438,532,45.15
FiddleSticks,Samira,747,429,318,57.43
FiddleSticks,Kayn,1599,830,769,51.91
FiddleSticks,Sylas,1448,735,713,50.76
FiddleSticks,Nilah,389,215,174,55.27
FiddleSticks,Leona,828,418,410,50.48
FiddleSticks,Pantheon,1617,800,817,49.47
FiddleSticks,Leblanc,533,250,283,46.9
FiddleSticks,Sivir,536,294,242,54.85
FiddleSticks,Pyke,906,456,450,50.33
FiddleSticks,Yorick,817,394,423,48.23
FiddleSticks,Viego,1259,685,574,54.41
FiddleSticks,Malphite,884,465,419,52.6
FiddleSticks,Kaisa,1513,822,691,54.33
FiddleSticks,Rell,484,228,256,47.11
FiddleSticks,Karthus,314,169,145,53.82
FiddleSticks,Aurora,823,446,377,54.19
FiddleSticks,Ezreal,2100,1143,957,54.43
FiddleSticks,Senna,747,344,403,46.05
FiddleSticks,DrMundo,635,286,349,45.04
FiddleSticks,Ivern,154,63,91,40.91
FiddleSticks,Mordekaiser,1287,582,705,45.22
FiddleSticks,Yuumi,896,461,435,51.45
FiddleSticks,Aatrox,907,439,468,48.4
FiddleSticks,Khazix,596,280,316,46.98
FiddleSticks,Qiyana,249,126,123,50.6
FiddleSticks,MissFortune,2128,1096,1032,51.5
FiddleSticks,Nautilus,1141,575,566,50.39
FiddleSticks,Darius,1705,884,821,51.85
FiddleSticks,Poppy,584,320,264,54.79
FiddleSticks,Kindred,488,219,269,44.88
FiddleSticks,Warwick,1387,678,709,48.88
FiddleSticks,Aphelios,612,302,310,49.35
FiddleSticks,KSante,470,279,191,59.36
FiddleSticks,Vex,560,291,269,51.96
FiddleSticks,Jinx,2468,1149,1319,46.56
FiddleSticks,Tryndamere,518,271,247,52.32
FiddleSticks,Amumu,1018,512,506,50.29
FiddleSticks,Seraphine,891,492,399,55.22
FiddleSticks,Udyr,392,195,197,49.74
FiddleSticks,Jhin,1976,977,999,49.44
FiddleSticks,Evelynn,339,188,151,55.46
FiddleSticks,XinZhao,648,333,315,51.39
FiddleSticks,Morgana,1261,651,610,51.63
FiddleSticks,Ashe,1873,940,933,50.19
FiddleSticks,Braum,574,310,264,54.01
FiddleSticks,Riven,538,290,248,53.9
FiddleSticks,Sejuani,416,203,213,48.8
FiddleSticks,AurelionSol,374,166,208,44.39
FiddleSticks,Tristana,910,438,472,48.13
FiddleSticks,Rakan,436,248,188,56.88
FiddleSticks,Jax,834,432,402,51.8
FiddleSticks,Naafiri,366,192,174,52.46
FiddleSticks,Irelia,802,383,419,47.76
FiddleSticks,Neeko,445,229,216,51.46
FiddleSticks,Yone,1746,945,801,54.12
FiddleSticks,Nocturne,1110,530,580,47.75
FiddleSticks,Lucian,676,336,340,49.7
FiddleSticks,Yasuo,1907,991,916,51.97
FiddleSticks,Nami,938,501,437,53.41
FiddleSticks,Renekton,406,219,187,53.94
FiddleSticks,Malzahar,891,355,536,39.84
FiddleSticks,Lux,2362,1137,1225,48.14
FiddleSticks,Quinn,376,184,192,48.94
FiddleSticks,Cassiopeia,278,117,161,42.09
FiddleSticks,Varus,760,364,396,47.89
FiddleSticks,Janna,398,216,182,54.27
FiddleSticks,Rengar,350,225,125,64.29
FiddleSticks,Anivia,283,168,115,59.36
FiddleSticks,Xayah,608,305,303,50.16
FiddleSticks,Galio,856,421,435,49.18
FiddleSticks,Ekko,918,486,432,52.94
FiddleSticks,Zed,1065,601,464,56.43
FiddleSticks,Caitlyn,2509,1197,1312,47.71
FiddleSticks,Lulu,1185,609,576,51.39
FiddleSticks,Akali,1003,558,445,55.63
FiddleSticks,Ziggs,348,148,200,42.53
FiddleSticks,Volibear,1088,505,583,46.42
FiddleSticks,Hwei,652,328,324,50.31
FiddleSticks,Urgot,439,213,226,48.52
FiddleSticks,Twitch,849,389,460,45.82
FiddleSticks,Teemo,1307,717,590,54.86
FiddleSticks,Singed,279,118,161,42.29
FiddleSticks,Zeri,433,210,223,48.5
FiddleSticks,TwistedFate,307,155,152,50.49
FiddleSticks,Brand,642,304,338,47.35
FiddleSticks,Vladimir,676,377,299,55.77
FiddleSticks,Vi,834,412,422,49.4
FiddleSticks,Ahri,1202,576,626,47.92
FiddleSticks,Milio,608,291,317,47.86
FiddleSticks,Chogath,1214,547,667,45.06
FiddleSticks,TahmKench,842,470,372,55.82
FiddleSticks,Gwen,496,277,219,55.85
FiddleSticks,Elise,694,328,366,47.26
FiddleSticks,Kennen,313,149,164,47.6
FiddleSticks,Shaco,991,502,489,50.66
FiddleSticks,Hecarim,464,230,234,49.57
FiddleSticks,Garen,1472,714,758,48.51
FiddleSticks,Ryze,304,143,161,47.04
FiddleSticks,Blitzcrank,694,341,353,49.14
FiddleSticks,Rammus,267,164,103,61.42
FiddleSticks,Velkoz,551,281,270,51
FiddleSticks,Sett,1567,754,813,48.12
FiddleSticks,Karma,1077,507,570,47.08
FiddleSticks,Shen,591,285,306,48.22
FiddleSticks,LeeSin,1232,606,626,49.19
FiddleSticks,Syndra,623,304,319,48.8
FiddleSticks,Zyra,855,429,426,50.18
FiddleSticks,Maokai,427,208,219,48.71
FiddleSticks,Gragas,539,299,240,55.47
FiddleSticks,Thresh,1301,621,680,47.73
FiddleSticks,Katarina,664,324,340,48.8
FiddleSticks,Nasus,735,378,357,51.43
FiddleSticks,Xerath,744,359,385,48.25
FiddleSticks,Graves,581,306,275,52.67
FiddleSticks,Illaoi,510,256,254,50.2
FiddleSticks,Vayne,1135,609,526,53.66
FiddleSticks,Trundle,583,330,253,56.6
FiddleSticks,Camille,353,182,171,51.56
FiddleSticks,Azir,331,183,148,55.29
FiddleSticks,Kalista,261,151,110,57.85
FiddleSticks,Lillia,618,312,306,50.49
FiddleSticks,Nunu,671,361,310,53.8
FiddleSticks,Sona,352,166,186,47.16
FiddleSticks,Taric,219,84,135,38.36
FiddleSticks,Viktor,778,395,383,50.77
FiddleSticks,Nidalee,268,142,126,52.99
FiddleSticks,Soraka,535,280,255,52.34
FiddleSticks,Diana,1539,767,772,49.84
FiddleSticks,Zac,552,289,263,52.36
FiddleSticks,Corki,361,196,165,54.29
FiddleSticks,Heimerdinger,458,215,243,46.94
FiddleSticks,Akshan,335,188,147,56.12
FiddleSticks,Taliyah,246,108,138,43.9
FiddleSticks,Kayle,649,317,332,48.84
FiddleSticks,Orianna,478,263,215,55.02
FiddleSticks,Briar,767,326,441,42.5
FiddleSticks,Ambessa,612,297,315,48.53
FiddleSticks,MonkeyKing,618,309,309,50
FiddleSticks,Shyvana,221,108,113,48.87
FiddleSticks,Alistar,370,197,173,53.24
FiddleSticks,Smolder,658,354,304,53.8
FiddleSticks,Gnar,405,202,203,49.88
FiddleSticks,Renata,210,120,90,57.14
FiddleSticks,KogMaw,399,205,194,51.38
FiddleSticks,Ornn,433,188,245,43.42
FiddleSticks,Sion,754,365,389,48.41
FiddleSticks,Rumble,256,161,95,62.89
FiddleSticks,Zoe,372,207,165,55.65
FiddleSticks,Kled,198,104,94,52.53
FiddleSticks,Lissandra,274,102,172,37.23
FiddleSticks,Skarner,297,134,163,45.12
FiddleSticks,Fizz,553,316,237,57.14
FiddleSticks,Belveth,289,146,143,50.52
FiddleSticks,Draven,432,228,204,52.78
FiddleSticks,Talon,592,333,259,56.25
FiddleSticks,Kassadin,254,111,143,43.7
FiddleSticks,Bard,356,180,176,50.56
FiddleSticks,RekSai,122,74,48,60.66
FiddleSticks,Fiora,364,183,181,50.27
FiddleSticks,Zilean,317,155,162,48.9
FiddleSticks,JarvanIV,535,269,266,50.28
FiddleSticks,Annie,309,166,143,53.72
FiddleSticks,Olaf,285,126,159,44.21
FiddleSticks,Jayce,499,235,264,47.09
Smolder,Gangplank,527,247,280,46.87
Smolder,MasterYi,1556,666,890,42.8
Smolder,Veigar,1452,633,819,43.6
Smolder,Mel,2858,1402,1456,49.06
Smolder,Swain,1384,627,757,45.3
Smolder,Mordekaiser,1759,768,991,43.66
Smolder,Amumu,1423,654,769,45.96
Smolder,Sylas,1591,784,807,49.28
Smolder,Xayah,665,341,324,51.28
Smolder,Ashe,2283,1065,1218,46.65
Smolder,Renekton,692,324,368,46.82
Smolder,Kayn,1938,939,999,48.45
Smolder,Vex,652,323,329,49.54
Smolder,Samira,1101,572,529,51.95
Smolder,Lulu,1560,680,880,43.59
Smolder,Teemo,1751,828,923,47.29
Smolder,Briar,1017,438,579,43.07
Smolder,Aurora,948,459,489,48.42
Smolder,Kaisa,2083,1095,988,52.57
Smolder,Karma,1339,600,739,44.81
Smolder,KSante,650,307,343,47.23
Smolder,Darius,2617,1254,1363,47.92
Smolder,Azir,497,230,267,46.28
Smolder,Aphelios,910,465,445,51.1
Smolder,Soraka,723,353,370,48.82
Smolder,Yone,2545,1258,1287,49.43
Smolder,Nilah,533,219,314,41.09
Smolder,Irelia,1086,495,591,45.58
Smolder,Nocturne,1528,678,850,44.37
Smolder,Jayce,590,290,300,49.15
Smolder,Jhin,2836,1330,1506,46.9
Smolder,Senna,976,447,529,45.8
Smolder,Tryndamere,708,334,374,47.18
Smolder,Zyra,1022,495,527,48.43
Smolder,TahmKench,1233,643,590,52.15
Smolder,Aatrox,1209,551,658,45.57
Smolder,Belveth,319,158,161,49.53
Smolder,Hwei,866,449,417,51.85
Smolder,Jinx,3584,1648,1936,45.98
Smolder,Kayle,1057,494,563,46.74
Smolder,Akali,1245,622,623,49.96
Smolder,Yasuo,2571,1258,1313,48.93
Smolder,Warwick,1907,874,1033,45.83
Smolder,Malzahar,1720,877,843,50.99
Smolder,Tristana,1316,668,648,50.76
Smolder,Sejuani,529,316,213,59.74
Smolder,Ahri,1742,902,840,51.78
Smolder,Caitlyn,3785,1791,1994,47.32
Smolder,Lux,3331,1604,1727,48.15
Smolder,Maokai,626,333,293,53.19
Smolder,Corki,447,209,238,46.76
Smolder,Taric,337,146,191,43.32
Smolder,Singed,377,149,228,39.52
Smolder,Viego,1754,868,886,49.49
Smolder,Vayne,1636,787,849,48.11
Smolder,MissFortune,2822,1328,1494,47.06
Smolder,Leona,1142,564,578,49.39
Smolder,Ambessa,858,419,439,48.83
Smolder,Varus,1158,570,588,49.22
Smolder,Graves,856,426,430,49.77
Smolder,Neeko,607,334,273,55.02
Smolder,Nasus,977,466,511,47.7
Smolder,Thresh,1857,906,951,48.79
Smolder,Rammus,394,182,212,46.19
Smolder,Yuumi,1154,524,630,45.41
Smolder,LeeSin,1718,823,895,47.9
Smolder,Sona,393,188,205,47.84
Smolder,Anivia,414,199,215,48.07
Smolder,Braum,692,347,345,50.14
Smolder,DrMundo,849,413,436,48.65
Smolder,Nunu,753,396,357,52.59
Smolder,Malphite,1364,623,741,45.67
Smolder,Pyke,1258,635,623,50.48
Smolder,Skarner,391,201,190,51.41
Smolder,Ezreal,3112,1569,1543,50.42
Smolder,Seraphine,1085,488,597,44.98
Smolder,Draven,722,346,376,47.92
Smolder,Yorick,1366,606,760,44.36
Smolder,Vi,1189,603,586,50.71
Smolder,Katarina,1086,577,509,53.13
Smolder,Nautilus,1581,783,798,49.53
Smolder,Ziggs,510,217,293,42.55
Smolder,Sion,1136,572,564,50.35
Smolder,Gragas,873,445,428,50.97
Smolder,MonkeyKing,838,356,482,42.48
Smolder,Akshan,473,200,273,42.28
Smolder,Sett,2117,972,1145,45.91
Smolder,Shaco,1324,689,635,52.04
Smolder,KogMaw,413,196,217,47.46
Smolder,Milio,831,387,444,46.57
Smolder,Vladimir,800,404,396,50.5
Smolder,Gnar,543,259,284,47.7
Smolder,Chogath,1755,892,863,50.83
Smolder,Illaoi,624,319,305,51.12
Smolder,Fizz,778,363,415,46.66
Smolder,Lucian,832,411,421,49.4
Smolder,Urgot,703,320,383,45.52
Smolder,Zed,1461,698,763,47.78
Smolder,Alistar,559,289,270,51.7
Smolder,Evelynn,506,237,269,46.84
Smolder,Heimerdinger,660,298,362,45.15
Smolder,Morgana,1568,743,825,47.39
Smolder,Garen,1981,955,1026,48.21
Smolder,Trundle,790,401,389,50.76
Smolder,Velkoz,743,354,389,47.64
Smolder,Kled,211,85,126,40.28
Smolder,Ekko,1174,577,597,49.15
Smolder,Sivir,675,343,332,50.81
Smolder,Rengar,516,287,229,55.62
Smolder,Galio,1196,528,668,44.15
Smolder,Ivern,249,158,91,63.45
Smolder,Shen,903,428,475,47.4
Smolder,Cassiopeia,430,225,205,52.33
Smolder,Rell,747,408,339,54.62
Smolder,Diana,2133,1043,1090,48.9
Smolder,Talon,777,378,399,48.65
Smolder,Blitzcrank,889,451,438,50.73
Smolder,Lissandra,362,179,183,49.45
Smolder,Fiora,438,227,211,51.83
Smolder,Gwen,724,376,348,51.93
Smolder,Viktor,1163,523,640,44.97
Smolder,Leblanc,753,435,318,57.77
Smolder,Ornn,618,305,313,49.35
Smolder,Jax,1225,593,632,48.41
Smolder,Zoe,456,211,245,46.27
Smolder,Camille,431,225,206,52.2
Smolder,Taliyah,336,162,174,48.21
Smolder,Zeri,631,296,335,46.91
Smolder,Elise,844,410,434,48.58
Smolder,Twitch,1165,535,630,45.92
Smolder,XinZhao,844,367,477,43.48
Smolder,Lillia,787,387,400,49.17
Smolder,Rakan,658,339,319,51.52
Smolder,Khazix,764,389,375,50.92
Smolder,Kennen,452,252,200,55.75
Smolder,Kalista,568,320,248,56.34
Smolder,Karthus,342,181,161,52.92
Smolder,Nami,1426,684,742,47.97
Smolder,Pantheon,2193,1017,1176,46.37
Smolder,FiddleSticks,658,304,354,46.2
Smolder,Annie,399,193,206,48.37
Smolder,Quinn,499,204,295,40.88
Smolder,Riven,541,264,277,48.8
Smolder,Renata,326,136,190,41.72
Smolder,Kindred,585,296,289,50.6
Smolder,Syndra,831,417,414,50.18
Smolder,Naafiri,523,259,264,49.52
Smolder,Volibear,1442,695,747,48.2
Smolder,Xerath,1123,521,602,46.39
Smolder,Zac,668,361,307,54.04
Smolder,Bard,425,179,246,42.12
Smolder,Nidalee,357,182,175,50.98
Smolder,Zilean,416,187,229,44.95
Smolder,JarvanIV,767,389,378,50.72
Smolder,Poppy,728,412,316,56.59
Smolder,Ryze,423,183,240,43.26
Smolder,Udyr,484,215,269,44.42
Smolder,Shyvana,425,232,193,54.59
Smolder,AurelionSol,522,222,300,42.53
Smolder,Orianna,489,226,263,46.22
Smolder,Olaf,329,150,179,45.59
Smolder,Brand,988,470,518,47.57
Smolder,Hecarim,608,323,285,53.13
Smolder,TwistedFate,471,220,251,46.71
Smolder,Janna,429,205,224,47.79
Smolder,Qiyana,321,152,169,47.35
Smolder,RekSai,187,90,97,48.13
Smolder,Rumble,293,144,149,49.15
Smolder,Kassadin,316,145,171,45.89
Nautilus,Gangplank,953,484,469,50.79
Nautilus,MasterYi,2686,1391,1295,51.79
Nautilus,Veigar,2342,1102,1240,47.05
Nautilus,Mel,4613,2400,2213,52.03
Nautilus,Swain,2361,1000,1361,42.35
Nautilus,Illaoi,1058,518,540,48.96
Nautilus,MonkeyKing,1362,634,728,46.55
Nautilus,Yone,4163,2112,2051,50.73
Nautilus,Tristana,2131,1154,977,54.15
Nautilus,Morgana,2782,1344,1438,48.31
Nautilus,Ivern,374,189,185,50.53
Nautilus,Jhin,4221,2068,2153,48.99
Nautilus,Mordekaiser,2896,1377,1519,47.55
Nautilus,Amumu,2609,1156,1453,44.31
Nautilus,Sylas,3197,1564,1633,48.92
Nautilus,Xayah,1417,612,805,43.19
Nautilus,Ashe,4202,2187,2015,52.05
Nautilus,Urgot,1137,493,644,43.36
Nautilus,Rengar,699,379,320,54.22
Nautilus,Ziggs,903,442,461,48.95
Nautilus,Trundle,1242,536,706,43.16
Nautilus,Fiora,1030,522,508,50.68
Nautilus,Poppy,1629,750,879,46.04
Nautilus,Diana,3345,1641,1704,49.06
Nautilus,Anivia,718,311,407,43.31
Nautilus,Caitlyn,5763,2999,2764,52.04
Nautilus,Thresh,3445,1735,1710,50.36
Nautilus,Galio,2042,975,1067,47.75
Nautilus,Ezreal,5411,2818,2593,52.08
Nautilus,Chogath,2695,1276,1419,47.35
Nautilus,KSante,1139,606,533,53.2
Nautilus,Warwick,3292,1494,1798,45.38
Nautilus,Corki,858,417,441,48.6
Nautilus,Garen,3526,1750,1776,49.63
Nautilus,FiddleSticks,1141,566,575,49.61
Nautilus,Lux,5576,2712,2864,48.64
Nautilus,Brand,1715,770,945,44.9
Nautilus,Kayn,3151,1473,1678,46.75
Nautilus,Taliyah,604,273,331,45.2
Nautilus,Sivir,1232,486,746,39.45
Nautilus,Soraka,1208,553,655,45.78
Nautilus,Sion,1686,797,889,47.27
Nautilus,AurelionSol,893,454,439,50.84
Nautilus,Nami,1954,844,1110,43.19
Nautilus,Zac,1126,543,583,48.22
Nautilus,Nunu,1404,732,672,52.14
Nautilus,Kaisa,3367,1778,1589,52.81
Nautilus,Shen,1445,686,759,47.47
Nautilus,Riven,979,502,477,51.28
Nautilus,Vi,2052,995,1057,48.49
Nautilus,MissFortune,4873,2225,2648,45.66
Nautilus,Ambessa,1417,745,672,52.58
Nautilus,Yuumi,1879,1010,869,53.75
Nautilus,Qiyana,630,348,282,55.24
Nautilus,LeeSin,3197,1651,1546,51.64
Nautilus,Quinn,616,292,324,47.4
Nautilus,Talon,1296,689,607,53.16
Nautilus,Syndra,1475,729,746,49.42
Nautilus,Sett,3446,1620,1826,47.01
Nautilus,DrMundo,1247,561,686,44.99
Nautilus,Shaco,1895,923,972,48.71
Nautilus,Viktor,1920,927,993,48.28
Nautilus,Rammus,710,315,395,44.37
Nautilus,Katarina,1596,840,756,52.63
Nautilus,Milio,1326,542,784,40.87
Nautilus,Teemo,2792,1265,1527,45.31
Nautilus,Ahri,2927,1405,1522,48
Nautilus,Senna,1784,870,914,48.77
Nautilus,Ekko,1857,875,982,47.12
Nautilus,Aphelios,1269,582,687,45.86
Nautilus,Nasus,1504,670,834,44.55
Nautilus,Zilean,646,266,380,41.18
Nautilus,Volibear,2325,1072,1253,46.11
Nautilus,XinZhao,1348,692,656,51.34
Nautilus,Leona,2183,1058,1125,48.47
Nautilus,Yasuo,4155,2032,2123,48.9
Nautilus,Jinx,5628,2538,3090,45.1
Nautilus,Karma,2275,1156,1119,50.81
Nautilus,Braum,1858,841,1017,45.26
Nautilus,Skarner,797,362,435,45.42
Nautilus,Viego,3277,1690,1587,51.57
Nautilus,Irelia,1965,990,975,50.38
Nautilus,Zeri,1001,503,498,50.25
Nautilus,Alistar,1314,642,672,48.86
Nautilus,Akali,2266,1116,1150,49.25
Nautilus,Pantheon,3543,1725,1818,48.69
Nautilus,Vex,1288,638,650,49.53
Nautilus,Gragas,1445,683,762,47.27
Nautilus,Lulu,2645,1275,1370,48.2
Nautilus,Malphite,2176,1034,1142,47.52
Nautilus,Samira,1543,756,787,49
Nautilus,Blitzcrank,1865,1021,844,54.75
Nautilus,Hwei,1482,704,778,47.5
Nautilus,Darius,4086,1950,2136,47.72
Nautilus,Malzahar,2056,956,1100,46.5
Nautilus,Sona,609,258,351,42.36
Nautilus,Zed,2282,1171,1111,51.31
Nautilus,Heimerdinger,994,486,508,48.89
Nautilus,Udyr,889,477,412,53.66
Nautilus,Aatrox,2015,1041,974,51.66
Nautilus,Akshan,714,377,337,52.8
Nautilus,Zyra,1751,831,920,47.46
Nautilus,KogMaw,688,287,401,41.72
Nautilus,Zoe,871,489,382,56.14
Nautilus,RekSai,219,114,105,52.05
Nautilus,Twitch,1684,833,851,49.47
Nautilus,Yorick,2196,1049,1147,47.77
Nautilus,Kalista,714,352,362,49.3
Nautilus,JarvanIV,1236,557,679,45.06
Nautilus,Aurora,1730,891,839,51.5
Nautilus,TahmKench,2093,1052,1041,50.26
Nautilus,Kayle,1359,625,734,45.99
Nautilus,Kindred,1001,497,504,49.65
Nautilus,Jax,1887,955,932,50.61
Nautilus,Xerath,1998,905,1093,45.3
Nautilus,Pyke,2216,1241,975,56
Nautilus,Fizz,1214,597,617,49.18
Nautilus,Seraphine,1745,869,876,49.8
Nautilus,Renekton,1140,546,594,47.89
Nautilus,Leblanc,1230,626,604,50.89
Nautilus,Vayne,2971,1466,1505,49.34
Nautilus,Briar,1612,744,868,46.15
Nautilus,Orianna,1069,512,557,47.9
Nautilus,Draven,1161,630,531,54.26
Nautilus,Ornn,1043,467,576,44.77
Nautilus,Camille,708,394,314,55.65
Nautilus,Smolder,1581,798,783,50.47
Nautilus,Janna,752,385,367,51.2
Nautilus,Ryze,789,370,419,46.89
Nautilus,Lucian,1469,737,732,50.17
Nautilus,Singed,562,272,290,48.4
Nautilus,Elise,1461,713,748,48.8
Nautilus,Belveth,536,239,297,44.59
Nautilus,Maokai,1032,426,606,41.28
Nautilus,Cassiopeia,737,356,381,48.3
Nautilus,Velkoz,1377,624,753,45.32
Nautilus,Gnar,965,459,506,47.56
Nautilus,Taric,691,311,380,45.01
Nautilus,Bard,638,311,327,48.75
Nautilus,Vladimir,1359,654,705,48.12
Nautilus,Khazix,1047,582,465,55.59
Nautilus,Renata,550,281,269,51.09
Nautilus,Varus,1838,916,922,49.84
Nautilus,Graves,1477,763,714,51.66
Nautilus,Evelynn,815,448,367,54.97
Nautilus,Kassadin,467,235,232,50.32
Nautilus,Gwen,1247,630,617,50.52
Nautilus,Sejuani,1009,461,548,45.69
Nautilus,Kennen,566,293,273,51.77
Nautilus,Neeko,1158,617,541,53.28
Nautilus,Nocturne,2446,1155,1291,47.22
Nautilus,Rakan,973,420,553,43.17
Nautilus,Naafiri,696,367,329,52.73
Nautilus,Hecarim,886,433,453,48.87
Nautilus,Karthus,614,304,310,49.51
Nautilus,Tryndamere,1213,620,593,51.11
Nautilus,TwistedFate,695,355,340,51.08
Nautilus,Lillia,1311,624,687,47.6
Nautilus,Nidalee,680,435,245,63.97
Nautilus,Annie,686,357,329,52.04
Nautilus,Nilah,840,349,491,41.55
Nautilus,Olaf,647,319,328,49.3
Nautilus,Azir,800,360,440,45
Nautilus,Rell,1331,656,675,49.29
Nautilus,Kled,436,218,218,50
Nautilus,Lissandra,691,318,373,46.02
Nautilus,Jayce,1062,546,516,51.41
Nautilus,Rumble,558,289,269,51.79
Nautilus,Shyvana,536,211,325,39.37
TahmKench,Gangplank,628,310,318,49.36
TahmKench,Brand,1476,697,779,47.22
TahmKench,Irelia,1460,761,699,52.12
TahmKench,Malzahar,1776,780,996,43.92
TahmKench,Pyke,1620,859,761,53.02
TahmKench,Gnar,835,466,369,55.81
TahmKench,Jax,1409,688,721,48.83
TahmKench,Yasuo,3385,1563,1822,46.17
TahmKench,Caitlyn,4555,2168,2387,47.6
TahmKench,Neeko,968,503,465,51.96
TahmKench,Vayne,2594,1163,1431,44.83
TahmKench,Nocturne,1901,932,969,49.03
TahmKench,Kaisa,2588,1294,1294,50
TahmKench,Galio,1299,587,712,45.19
TahmKench,Blitzcrank,1354,672,682,49.63
TahmKench,Volibear,2054,961,1093,46.79
TahmKench,Ekko,1612,745,867,46.22
TahmKench,Yone,3169,1622,1547,51.18
TahmKench,Kalista,591,326,265,55.16
TahmKench,Tristana,1728,851,877,49.25
TahmKench,Poppy,1093,526,567,48.12
TahmKench,Veigar,2137,1043,1094,48.81
TahmKench,Heimerdinger,893,431,462,48.26
TahmKench,Ziggs,681,314,367,46.11
TahmKench,Naafiri,674,300,374,44.51
TahmKench,Nunu,1058,556,502,52.55
TahmKench,Zeri,656,321,335,48.93
TahmKench,Mordekaiser,2792,1338,1454,47.92
TahmKench,LeeSin,1964,1023,941,52.09
TahmKench,Kayle,1072,535,537,49.91
TahmKench,Ezreal,3377,1831,1546,54.22
TahmKench,Morgana,2129,918,1211,43.12
TahmKench,TwistedFate,580,300,280,51.72
TahmKench,Nilah,680,342,338,50.29
TahmKench,Vi,1583,762,821,48.14
TahmKench,Ahri,2133,1103,1030,51.71
TahmKench,Darius,3515,1700,1815,48.36
TahmKench,Maokai,773,366,407,47.35
TahmKench,Yorick,1608,750,858,46.64
TahmKench,Pantheon,2776,1386,1390,49.93
TahmKench,Samira,1343,544,799,40.51
TahmKench,Nami,1656,797,859,48.13
TahmKench,Kennen,501,270,231,53.89
TahmKench,Rammus,464,254,210,54.74
TahmKench,Chogath,2454,1198,1256,48.82
TahmKench,Ivern,282,142,140,50.35
TahmKench,Lux,5022,2531,2491,50.4
TahmKench,Kayn,2530,1199,1331,47.39
TahmKench,Smolder,1233,590,643,47.85
TahmKench,Thresh,2392,1165,1227,48.7
TahmKench,Teemo,2087,984,1103,47.15
TahmKench,Khazix,834,433,401,51.92
TahmKench,MissFortune,4020,1900,2120,47.26
TahmKench,Rell,1024,482,542,47.07
TahmKench,Aatrox,1578,748,830,47.4
TahmKench,Shaco,1443,685,758,47.47
TahmKench,Leblanc,690,356,334,51.59
TahmKench,Draven,873,442,431,50.63
TahmKench,Hwei,1242,615,627,49.52
TahmKench,Cassiopeia,561,245,316,43.67
TahmKench,Riven,657,335,322,50.99
TahmKench,Senna,1379,686,693,49.75
TahmKench,Jayce,666,352,314,52.85
TahmKench,Swain,1853,792,1061,42.74
TahmKench,Sion,1304,645,659,49.46
TahmKench,Gragas,977,512,465,52.41
TahmKench,Zed,1899,1015,884,53.45
TahmKench,Jinx,4209,2072,2137,49.23
TahmKench,MasterYi,2179,1092,1087,50.11
TahmKench,Garen,2798,1324,1474,47.32
TahmKench,Sett,2836,1300,1536,45.84
TahmKench,Lucian,1211,698,513,57.64
TahmKench,Sona,559,290,269,51.88
TahmKench,Vex,845,403,442,47.69
TahmKench,Malphite,1630,862,768,52.88
TahmKench,Amumu,1911,820,1091,42.91
TahmKench,Ashe,3146,1569,1577,49.87
TahmKench,Velkoz,1097,531,566,48.4
TahmKench,Kindred,797,425,372,53.32
TahmKench,AurelionSol,754,328,426,43.5
TahmKench,Urgot,1006,482,524,47.91
TahmKench,Viego,2322,1118,1204,48.15
TahmKench,Katarina,1282,651,631,50.78
TahmKench,Elise,1107,602,505,54.38
TahmKench,Annie,548,247,301,45.07
TahmKench,Nasus,1257,573,684,45.58
TahmKench,Mel,3701,1857,1844,50.18
TahmKench,Rengar,649,358,291,55.16
TahmKench,Akali,1687,811,876,48.07
TahmKench,KSante,726,375,351,51.65
TahmKench,Sylas,2005,997,1008,49.73
TahmKench,Trundle,1276,602,674,47.18
TahmKench,Akshan,664,296,368,44.58
TahmKench,Corki,598,328,270,54.85
TahmKench,Ornn,710,329,381,46.34
TahmKench,Zoe,580,295,285,50.86
TahmKench,DrMundo,1139,523,616,45.92
TahmKench,Viktor,1426,741,685,51.96
TahmKench,Lulu,1665,852,813,51.17
TahmKench,Vladimir,1002,522,480,52.1
TahmKench,Evelynn,738,377,361,51.08
TahmKench,Aurora,1260,664,596,52.7
TahmKench,Warwick,2758,1320,1438,47.86
TahmKench,FiddleSticks,842,372,470,44.18
TahmKench,Nautilus,2093,1041,1052,49.74
TahmKench,Yuumi,1254,689,565,54.94
TahmKench,Ryze,531,268,263,50.47
TahmKench,Twitch,1395,721,674,51.68
TahmKench,Xerath,1254,640,614,51.04
TahmKench,XinZhao,967,481,486,49.74
TahmKench,JarvanIV,784,389,395,49.62
TahmKench,Zyra,1415,643,772,45.44
TahmKench,Sivir,799,383,416,47.93
TahmKench,Leona,1523,748,775,49.11
TahmKench,Karma,1590,742,848,46.67
TahmKench,Illaoi,977,430,547,44.01
TahmKench,Jhin,3189,1513,1676,47.44
TahmKench,Aphelios,946,451,495,47.67
TahmKench,Graves,987,469,518,47.52
TahmKench,Briar,1500,711,789,47.4
TahmKench,Singed,481,206,275,42.83
TahmKench,Belveth,436,221,215,50.69
TahmKench,Janna,581,281,300,48.36
TahmKench,Zac,677,329,348,48.6
TahmKench,Bard,528,283,245,53.6
TahmKench,Diana,2514,1181,1333,46.98
TahmKench,Soraka,930,432,498,46.45
TahmKench,Ambessa,1021,490,531,47.99
TahmKench,Qiyana,429,229,200,53.38
TahmKench,Fiora,781,373,408,47.76
TahmKench,Varus,1473,743,730,50.44
TahmKench,Rakan,771,363,408,47.08
TahmKench,Azir,581,320,261,55.08
TahmKench,Tryndamere,994,533,461,53.62
TahmKench,Milio,928,412,516,44.4
TahmKench,Hecarim,689,392,297,56.89
TahmKench,Udyr,643,309,334,48.06
TahmKench,Lillia,1140,531,609,46.58
TahmKench,Lissandra,530,267,263,50.38
TahmKench,Nidalee,460,243,217,52.83
TahmKench,Sejuani,673,331,342,49.18
TahmKench,Olaf,425,221,204,52
TahmKench,Camille,574,281,293,48.95
TahmKench,Kassadin,345,169,176,48.99
TahmKench,Syndra,957,493,464,51.52
TahmKench,Seraphine,1522,731,791,48.03
TahmKench,Braum,1018,472,546,46.37
TahmKench,Xayah,873,428,445,49.03
TahmKench,Alistar,708,343,365,48.45
TahmKench,Gwen,1132,603,529,53.27
TahmKench,Skarner,468,250,218,53.42
TahmKench,Karthus,431,236,195,54.76
TahmKench,Talon,961,555,406,57.75
TahmKench,Taliyah,440,245,195,55.68
TahmKench,Shyvana,360,186,174,51.67
TahmKench,Fizz,921,464,457,50.38
TahmKench,KogMaw,601,336,265,55.91
TahmKench,Anivia,508,238,270,46.85
TahmKench,Renekton,793,362,431,45.65
TahmKench,Orianna,690,350,340,50.72
TahmKench,Shen,1078,481,597,44.62
TahmKench,RekSai,155,77,78,49.68
TahmKench,Quinn,552,259,293,46.92
TahmKench,Rumble,413,219,194,53.03
TahmKench,Zilean,469,246,223,52.45
TahmKench,Kled,303,109,194,35.97
TahmKench,Renata,347,183,164,52.74
TahmKench,MonkeyKing,1104,534,570,48.37
TahmKench,Taric,433,210,223,48.5
Aphelios,Gangplank,521,279,242,53.55
Aphelios,Brand,775,385,390,49.68
Aphelios,Irelia,1112,545,567,49.01
Aphelios,Malzahar,1239,573,666,46.25
Aphelios,Pyke,1062,556,506,52.35
Aphelios,Kayle,839,350,489,41.72
Aphelios,Viego,1481,772,709,52.13
Aphelios,Jinx,3571,1703,1868,47.69
Aphelios,Thresh,1645,812,833,49.36
Aphelios,Warwick,1748,783,965,44.79
Aphelios,Singed,311,161,150,51.77
Aphelios,Ryze,326,169,157,51.84
Aphelios,Samira,891,433,458,48.6
Aphelios,Soraka,739,353,386,47.77
Aphelios,Sett,1604,711,893,44.33
Aphelios,Volibear,1255,717,538,57.13
Aphelios,Ambessa,689,377,312,54.72
Aphelios,Smolder,910,445,465,48.9
Aphelios,Swain,1160,507,653,43.71
Aphelios,Malphite,1117,500,617,44.76
Aphelios,Sion,1048,463,585,44.18
Aphelios,Alistar,376,179,197,47.61
Aphelios,Jax,935,404,531,43.21
Aphelios,FiddleSticks,612,310,302,50.65
Aphelios,Heimerdinger,548,229,319,41.79
Aphelios,Ashe,2104,1018,1086,48.38
Aphelios,Fiora,494,252,242,51.01
Aphelios,Shaco,995,481,514,48.34
Aphelios,Fizz,577,334,243,57.89
Aphelios,Tristana,1025,512,513,49.95
Aphelios,Rakan,508,255,253,50.2
Aphelios,Garen,1834,1001,833,54.58
Aphelios,Graves,643,289,354,44.95
Aphelios,Aurora,891,412,479,46.24
Aphelios,Nilah,526,261,265,49.62
Aphelios,Hwei,910,483,427,53.08
Aphelios,Talon,649,352,297,54.24
Aphelios,LeeSin,1575,826,749,52.44
Aphelios,Jhin,2286,1111,1175,48.6
Aphelios,Senna,967,459,508,47.47
Aphelios,XinZhao,643,341,302,53.03
Aphelios,Nautilus,1269,687,582,54.14
Aphelios,Teemo,1441,614,827,42.61
Aphelios,Yasuo,2295,1102,1193,48.02
Aphelios,Rengar,390,216,174,55.38
Aphelios,Anivia,345,181,164,52.46
Aphelios,Xayah,547,328,219,59.96
Aphelios,Galio,820,407,413,49.63
Aphelios,Diana,1856,943,913,50.81
Aphelios,Veigar,1161,535,626,46.08
Aphelios,Sejuani,476,248,228,52.1
Aphelios,Sylas,1375,732,643,53.24
Aphelios,Lux,2785,1301,1484,46.71
Aphelios,Tryndamere,584,303,281,51.88
Aphelios,MasterYi,1193,614,579,51.47
Aphelios,Orianna,597,283,314,47.4
Aphelios,Darius,2099,1060,1039,50.5
Aphelios,Caitlyn,3163,1593,1570,50.36
Aphelios,Sona,360,161,199,44.72
Aphelios,DrMundo,635,316,319,49.76
Aphelios,Mordekaiser,1604,807,797,50.31
Aphelios,Akali,1126,606,520,53.82
Aphelios,Lucian,738,384,354,52.03
Aphelios,Nami,1134,542,592,47.8
Aphelios,KSante,590,317,273,53.73
Aphelios,Belveth,304,135,169,44.41
Aphelios,Riven,515,286,229,55.53
Aphelios,Yuumi,1025,528,497,51.51
Aphelios,Kaisa,1839,997,842,54.21
Aphelios,Kayn,1689,782,907,46.3
Aphelios,Amumu,1228,561,667,45.68
Aphelios,Chogath,1392,659,733,47.34
Aphelios,Morgana,1340,670,670,50
Aphelios,Camille,412,217,195,52.67
Aphelios,Lillia,701,361,340,51.5
Aphelios,Aatrox,1033,541,492,52.37
Aphelios,Elise,723,399,324,55.19
Aphelios,Seraphine,966,462,504,47.83
Aphelios,Gragas,703,342,361,48.65
Aphelios,Milio,770,364,406,47.27
Aphelios,Vladimir,727,389,338,53.51
Aphelios,Velkoz,706,356,350,50.42
Aphelios,Khazix,697,355,342,50.93
Aphelios,Mel,2458,1297,1161,52.77
Aphelios,Vex,618,310,308,50.16
Aphelios,MissFortune,2362,1160,1202,49.11
Aphelios,Viktor,876,403,473,46
Aphelios,Nocturne,1255,572,683,45.58
Aphelios,Yone,2056,1116,940,54.28
Aphelios,Draven,591,303,288,51.27
Aphelios,Poppy,689,359,330,52.1
Aphelios,Kalista,476,237,239,49.79
Aphelios,Neeko,599,326,273,54.42
Aphelios,Renata,266,144,122,54.14
Aphelios,Yorick,1185,555,630,46.84
Aphelios,Zed,1261,699,562,55.43
Aphelios,Evelynn,542,285,257,52.58
Aphelios,Leblanc,582,272,310,46.74
Aphelios,TahmKench,946,495,451,52.33
Aphelios,RekSai,155,68,87,43.87
Aphelios,Pantheon,1730,905,825,52.31
Aphelios,Ekko,1020,484,536,47.45
Aphelios,Urgot,534,251,283,47
Aphelios,Briar,935,457,478,48.88
Aphelios,Ezreal,2558,1274,1284,49.8
Aphelios,Zac,569,289,280,50.79
Aphelios,Bard,443,216,227,48.76
Aphelios,Jayce,527,266,261,50.47
Aphelios,Twitch,953,482,471,50.58
Aphelios,Shyvana,291,151,140,51.89
Aphelios,Zilean,363,186,177,51.24
Aphelios,Gnar,395,204,191,51.65
Aphelios,Kindred,625,302,323,48.32
Aphelios,Cassiopeia,420,216,204,51.43
Aphelios,Karthus,361,207,154,57.34
Aphelios,Leona,943,493,450,52.28
Aphelios,Kled,224,112,112,50
Aphelios,MonkeyKing,654,308,346,47.09
Aphelios,Vi,1029,527,502,51.21
Aphelios,Nasus,824,390,434,47.33
Aphelios,Rell,656,342,314,52.13
Aphelios,Illaoi,504,256,248,50.79
Aphelios,Maokai,496,254,242,51.21
Aphelios,Qiyana,354,205,149,57.91
Aphelios,Ahri,1550,763,787,49.23
Aphelios,Vayne,1365,690,675,50.55
Aphelios,Annie,351,177,174,50.43
Aphelios,Hecarim,434,222,212,51.15
Aphelios,Naafiri,390,185,205,47.44
Aphelios,Lulu,1453,808,645,55.61
Aphelios,Olaf,292,151,141,51.71
Aphelios,Katarina,907,458,449,50.5
Aphelios,Quinn,385,191,194,49.61
Aphelios,Ziggs,451,207,244,45.9
Aphelios,Braum,606,286,320,47.19
Aphelios,Xerath,847,401,446,47.34
Aphelios,Shen,728,343,385,47.12
Aphelios,Zoe,508,264,244,51.97
Aphelios,Zyra,981,458,523,46.69
Aphelios,AurelionSol,440,221,219,50.23
Aphelios,Gwen,631,319,312,50.55
Aphelios,JarvanIV,549,260,289,47.36
Aphelios,Taliyah,330,186,144,56.36
Aphelios,Corki,470,266,204,56.6
Aphelios,Nunu,664,336,328,50.6
Aphelios,Udyr,377,173,204,45.89
Aphelios,Rumble,251,107,144,42.63
Aphelios,Sivir,610,267,343,43.77
Aphelios,Varus,1026,511,515,49.81
Aphelios,Kennen,420,231,189,55
Aphelios,Azir,405,233,172,57.53
Aphelios,Blitzcrank,844,400,444,47.39
Aphelios,Ivern,217,89,128,41.01
Aphelios,KogMaw,277,137,140,49.46
Aphelios,Janna,435,197,238,45.29
Aphelios,Kassadin,229,118,111,51.53
Aphelios,Rammus,356,171,185,48.03
Aphelios,Karma,1204,545,659,45.27
Aphelios,Syndra,693,337,356,48.63
Aphelios,Ornn,539,260,279,48.24
Aphelios,Trundle,613,311,302,50.73
Aphelios,Zeri,546,286,260,52.38
Aphelios,Lissandra,385,161,224,41.82
Aphelios,Skarner,341,163,178,47.8
Aphelios,Nidalee,348,208,140,59.77
Aphelios,TwistedFate,436,213,223,48.85
Aphelios,Taric,254,136,118,53.54
Aphelios,Akshan,464,214,250,46.12
Aphelios,Renekton,524,280,244,53.44
Malzahar,TahmKench,1776,996,780,56.08
Malzahar,Malphite,1878,923,955,49.15
Malzahar,Yasuo,3975,2058,1917,51.77
Malzahar,Aphelios,1239,666,573,53.75
Malzahar,TwistedFate,817,407,410,49.82
Malzahar,Renekton,836,435,401,52.03
Malzahar,JarvanIV,1121,576,545,51.38
Malzahar,Mel,4059,2145,1914,52.85
Malzahar,Jhin,3830,1925,1905,50.26
Malzahar,Sylas,2036,1090,946,53.54
Malzahar,Darius,3558,1869,1689,52.53
Malzahar,Rengar,673,382,291,56.76
Malzahar,Syndra,1317,677,640,51.4
Malzahar,Caitlyn,5132,2712,2420,52.84
Malzahar,Lux,5071,2755,2316,54.33
Malzahar,Chogath,2447,1277,1170,52.19
Malzahar,Morgana,2297,1193,1104,51.94
Malzahar,Gnar,816,435,381,53.31
Malzahar,Viego,2393,1252,1141,52.32
Malzahar,Yone,3191,1671,1520,52.37
Malzahar,Kaisa,2800,1517,1283,54.18
Malzahar,Sett,3034,1630,1404,53.72
Malzahar,Sion,1639,827,812,50.46
Malzahar,Samira,1415,827,588,58.45
Malzahar,Alistar,757,435,322,57.46
Malzahar,Viktor,1819,940,879,51.68
Malzahar,Nocturne,2309,1055,1254,45.69
Malzahar,Annie,600,313,287,52.17
Malzahar,KogMaw,628,296,332,47.13
Malzahar,Kindred,952,554,398,58.19
Malzahar,Veigar,2153,1124,1029,52.21
Malzahar,Corki,696,377,319,54.17
Malzahar,Pantheon,3003,1672,1331,55.68
Malzahar,Jax,1603,875,728,54.59
Malzahar,Hwei,1367,696,671,50.91
Malzahar,Bard,546,313,233,57.33
Malzahar,FiddleSticks,891,536,355,60.16
Malzahar,Cassiopeia,600,296,304,49.33
Malzahar,Milio,1194,580,614,48.58
Malzahar,Quinn,600,276,324,46
Malzahar,Talon,1129,636,493,56.33
Malzahar,Olaf,467,234,233,50.11
Malzahar,Aatrox,1689,928,761,54.94
Malzahar,Katarina,1354,781,573,57.68
Malzahar,Smolder,1720,843,877,49.01
Malzahar,Braum,1058,543,515,51.32
Malzahar,Shaco,1926,1051,875,54.57
Malzahar,Riven,790,434,356,54.94
Malzahar,Senna,1516,823,693,54.29
Malzahar,Jayce,768,430,338,55.99
Malzahar,Rammus,637,350,287,54.95
Malzahar,Swain,2213,1111,1102,50.2
Malzahar,Kayn,2873,1606,1267,55.9
Malzahar,Ahri,2568,1442,1126,56.15
Malzahar,Tristana,1901,1056,845,55.55
Malzahar,Nasus,1299,668,631,51.42
Malzahar,Amumu,2020,978,1042,48.42
Malzahar,Naafiri,728,338,390,46.43
Malzahar,MissFortune,4440,2312,2128,52.07
Malzahar,Xerath,1745,889,856,50.95
Malzahar,Trundle,1171,576,595,49.19
Malzahar,Irelia,1652,880,772,53.27
Malzahar,Evelynn,712,422,290,59.27
Malzahar,Anivia,631,353,278,55.94
Malzahar,Poppy,1107,561,546,50.68
Malzahar,Fiora,686,383,303,55.83
Malzahar,Diana,3039,1500,1539,49.36
Malzahar,Ashe,3594,1895,1699,52.73
Malzahar,Volibear,2159,1137,1022,52.66
Malzahar,Seraphine,1690,848,842,50.18
Malzahar,Azir,679,342,337,50.37
Malzahar,Ziggs,785,410,375,52.23
Malzahar,Lulu,2272,1135,1137,49.96
Malzahar,Mordekaiser,2525,1239,1286,49.07
Malzahar,Leblanc,1063,582,481,54.75
Malzahar,Shen,1240,658,582,53.06
Malzahar,Pyke,1606,919,687,57.22
Malzahar,Nautilus,2056,1100,956,53.5
Malzahar,MonkeyKing,1266,633,633,50
Malzahar,Akali,1761,956,805,54.29
Malzahar,Ezreal,4000,2224,1776,55.6
Malzahar,Zed,2311,1168,1143,50.54
Malzahar,Draven,982,527,455,53.67
Malzahar,Yuumi,1445,768,677,53.15
Malzahar,Jinx,5180,2504,2676,48.34
Malzahar,Elise,1078,604,474,56.03
Malzahar,Gangplank,940,533,407,56.7
Malzahar,Xayah,1042,550,492,52.78
Malzahar,Sona,629,270,359,42.93
Malzahar,Soraka,1065,496,569,46.57
Malzahar,Akshan,777,399,378,51.35
Malzahar,Illaoi,880,470,410,53.41
Malzahar,Nidalee,473,288,185,60.89
Malzahar,Orianna,879,478,401,54.38
Malzahar,Zyra,1607,823,784,51.21
Malzahar,Varus,1680,900,780,53.57
Malzahar,Nilah,750,415,335,55.33
Malzahar,Karma,2065,1024,1041,49.59
Malzahar,Velkoz,1216,659,557,54.19
Malzahar,Yorick,1966,901,1065,45.83
Malzahar,Warwick,2740,1367,1373,49.89
Malzahar,MasterYi,2149,1166,983,54.26
Malzahar,Nunu,1299,681,618,52.42
Malzahar,Gragas,912,492,420,53.95
Malzahar,Gwen,1041,582,459,55.91
Malzahar,Vi,1690,857,833,50.71
Malzahar,Lillia,1052,514,538,48.86
Malzahar,Neeko,936,505,431,53.95
Malzahar,Briar,1482,746,736,50.34
Malzahar,Urgot,969,463,506,47.78
Malzahar,Camille,581,265,316,45.61
Malzahar,Tryndamere,1093,620,473,56.72
Malzahar,Teemo,2664,1328,1336,49.85
Malzahar,Heimerdinger,904,485,419,53.65
Malzahar,Lissandra,534,290,244,54.31
Malzahar,Kalista,620,373,247,60.16
Malzahar,DrMundo,1115,529,586,47.44
Malzahar,Shyvana,554,273,281,49.28
Malzahar,Garen,3001,1504,1497,50.12
Malzahar,Singed,606,329,277,54.29
Malzahar,Thresh,2679,1426,1253,53.23
Malzahar,Udyr,782,436,346,55.75
Malzahar,Kayle,1445,724,721,50.1
Malzahar,Leona,1548,854,694,55.17
Malzahar,Zeri,745,414,331,55.57
Malzahar,Kassadin,369,181,188,49.05
Malzahar,Rell,1087,544,543,50.05
Malzahar,Ornn,854,448,406,52.46
Malzahar,Zoe,750,453,297,60.4
Malzahar,Ekko,1753,867,886,49.46
Malzahar,Vayne,2232,1175,1057,52.64
Malzahar,Kennen,557,286,271,51.35
Malzahar,Aurora,1438,821,617,57.09
Malzahar,Brand,1445,765,680,52.94
Malzahar,KSante,880,487,393,55.34
Malzahar,Twitch,1556,811,745,52.12
Malzahar,Ryze,679,440,239,64.8
Malzahar,Lucian,1195,589,606,49.29
Malzahar,Blitzcrank,1314,729,585,55.48
Malzahar,LeeSin,2294,1282,1012,55.88
Malzahar,Taric,421,220,201,52.26
Malzahar,Vladimir,1248,682,566,54.65
Malzahar,Maokai,868,363,505,41.82
Malzahar,Vex,1009,551,458,54.61
Malzahar,Zilean,608,311,297,51.15
Malzahar,Ambessa,1035,551,484,53.24
Malzahar,Karthus,544,330,214,60.66
Malzahar,Hecarim,733,359,374,48.98
Malzahar,Sejuani,847,479,368,56.55
Malzahar,Galio,1791,898,893,50.14
Malzahar,Nami,2017,998,1019,49.48
Malzahar,Graves,1127,557,570,49.42
Malzahar,XinZhao,1189,615,574,51.72
Malzahar,Skarner,549,313,236,57.01
Malzahar,Qiyana,441,264,177,59.86
Malzahar,Rumble,411,222,189,54.01
Malzahar,Sivir,990,515,475,52.02
Malzahar,Fizz,1191,641,550,53.82
Malzahar,AurelionSol,1063,492,571,46.28
Malzahar,Renata,397,224,173,56.42
Malzahar,Rakan,818,411,407,50.24
Malzahar,Zac,831,452,379,54.39
Malzahar,Khazix,953,529,424,55.51
Malzahar,Janna,572,288,284,50.35
Malzahar,Kled,341,170,171,49.85
Malzahar,Ivern,287,152,135,52.96
Malzahar,Belveth,451,318,133,70.51
Malzahar,Taliyah,443,224,219,50.56
Malzahar,RekSai,228,129,99,56.58
Amumu,Trundle,1372,660,712,48.1
Amumu,MasterYi,2592,1345,1247,51.89
Amumu,Veigar,2470,1258,1212,50.93
Amumu,Jhin,4076,2006,2070,49.21
Amumu,Soraka,1068,524,544,49.06
Amumu,Warwick,3735,1904,1831,50.98
Amumu,Briar,1663,939,724,56.46
Amumu,Yasuo,3862,2062,1800,53.39
Amumu,Irelia,1740,962,778,55.29
Amumu,Lux,5563,2935,2628,52.76
Amumu,Urgot,1075,565,510,52.56
Amumu,Kayn,3144,1636,1508,52.04
Amumu,Twitch,1764,987,777,55.95
Amumu,Neeko,1236,663,573,53.64
Amumu,Yone,3772,2184,1588,57.9
Amumu,TwistedFate,721,415,306,57.56
Amumu,Smolder,1423,769,654,54.04
Amumu,Nautilus,2609,1453,1156,55.69
Amumu,Teemo,2888,1465,1423,50.73
Amumu,LeeSin,2281,1220,1061,53.49
Amumu,Nami,2033,1053,980,51.8
Amumu,Mordekaiser,3069,1503,1566,48.97
Amumu,Diana,3384,1793,1591,52.98
Amumu,MissFortune,4705,2481,2224,52.73
Amumu,Karma,1917,995,922,51.9
Amumu,Nasus,1478,708,770,47.9
Amumu,Khazix,1026,614,412,59.84
Amumu,Lulu,1947,1057,890,54.29
Amumu,Kindred,1047,631,416,60.27
Amumu,Fizz,1193,600,593,50.29
Amumu,Gnar,842,476,366,56.53
Amumu,Caitlyn,5524,2879,2645,52.12
Amumu,Sion,1682,937,745,55.71
Amumu,Akshan,710,430,280,60.56
Amumu,Jinx,5514,2870,2644,52.05
Amumu,Bard,637,328,309,51.49
Amumu,DrMundo,1270,664,606,52.28
Amumu,Shaco,1851,1060,791,57.27
Amumu,Leblanc,944,469,475,49.68
Amumu,Xayah,1138,649,489,57.03
Amumu,Yorick,2158,995,1163,46.11
Amumu,Volibear,2553,1335,1218,52.29
Amumu,Cassiopeia,697,395,302,56.67
Amumu,Rell,1090,585,505,53.67
Amumu,Thresh,2463,1359,1104,55.18
Amumu,FiddleSticks,1018,506,512,49.71
Amumu,Zed,2073,1123,950,54.17
Amumu,Viktor,1610,845,765,52.48
Amumu,Pyke,1806,952,854,52.71
Amumu,Olaf,488,273,215,55.94
Amumu,Hecarim,854,470,384,55.04
Amumu,Tristana,1930,1043,887,54.04
Amumu,Braum,1155,619,536,53.59
Amumu,Kennen,563,332,231,58.97
Amumu,XinZhao,1255,679,576,54.1
Amumu,Akali,2140,1222,918,57.1
Amumu,Kaisa,3074,1756,1318,57.12
Amumu,Gangplank,816,471,345,57.72
Amumu,Nocturne,2585,1345,1240,52.03
Amumu,Corki,707,401,306,56.72
Amumu,Jax,1724,963,761,55.86
Amumu,Katarina,1500,852,648,56.8
Amumu,Chogath,2801,1431,1370,51.09
Amumu,Galio,1782,939,843,52.69
Amumu,Hwei,1289,633,656,49.11
Amumu,Ahri,2731,1500,1231,54.92
Amumu,Malzahar,2020,1042,978,51.58
Amumu,Talon,1117,654,463,58.55
Amumu,Rakan,892,480,412,53.81
Amumu,Senna,1615,812,803,50.28
Amumu,Vayne,2391,1200,1191,50.19
Amumu,Sejuani,940,505,435,53.72
Amumu,TahmKench,1911,1091,820,57.09
Amumu,Brand,1563,807,756,51.63
Amumu,Mel,4253,2318,1935,54.5
Amumu,Zyra,1715,926,789,53.99
Amumu,Varus,1768,982,786,55.54
Amumu,Shyvana,641,307,334,47.89
Amumu,Garen,3240,1677,1563,51.76
Amumu,Singed,513,257,256,50.1
Amumu,Ezreal,4076,2157,1919,52.92
Amumu,Jayce,794,425,369,53.53
Amumu,Aatrox,1471,820,651,55.74
Amumu,JarvanIV,1164,589,575,50.6
Amumu,Karthus,585,309,276,52.82
Amumu,Orianna,891,474,417,53.2
Amumu,Milio,1280,686,594,53.59
Amumu,Rammus,631,372,259,58.95
Amumu,Ashe,3725,1906,1819,51.17
Amumu,Seraphine,1785,941,844,52.72
Amumu,Aurora,1449,794,655,54.8
Amumu,Aphelios,1228,667,561,54.32
Amumu,KSante,850,482,368,56.71
Amumu,Vladimir,1283,701,582,54.64
Amumu,Nilah,801,455,346,56.8
Amumu,Yuumi,1588,767,821,48.3
Amumu,Vex,1217,615,602,50.53
Amumu,Morgana,2631,1356,1275,51.54
Amumu,Skarner,600,355,245,59.17
Amumu,Ryze,645,331,314,51.32
Amumu,Elise,1228,686,542,55.86
Amumu,Vi,1729,929,800,53.73
Amumu,Draven,1056,585,471,55.4
Amumu,Kled,409,219,190,53.55
Amumu,Poppy,1238,682,556,55.09
Amumu,AurelionSol,919,501,418,54.52
Amumu,Sylas,2679,1407,1272,52.52
Amumu,Xerath,1729,903,826,52.23
Amumu,Darius,3835,2085,1750,54.37
Amumu,Malphite,1933,1062,871,54.94
Amumu,Viego,2879,1566,1313,54.39
Amumu,Maokai,897,428,469,47.71
Amumu,Rengar,675,323,352,47.85
Amumu,Syndra,1118,562,556,50.27
Amumu,Lucian,1329,695,634,52.29
Amumu,Lissandra,616,300,316,48.7
Amumu,Samira,1664,925,739,55.59
Amumu,Kayle,1520,798,722,52.5
Amumu,Ambessa,1120,586,534,52.32
Amumu,Taliyah,527,296,231,56.17
Amumu,Ekko,1922,1010,912,52.55
Amumu,Heimerdinger,1041,536,505,51.49
Amumu,Blitzcrank,1480,784,696,52.97
Amumu,Zoe,774,416,358,53.75
Amumu,Evelynn,792,448,344,56.57
Amumu,Ornn,784,396,388,50.51
Amumu,Naafiri,755,414,341,54.83
Amumu,Leona,1848,1035,813,56.01
Amumu,Tryndamere,1144,624,520,54.55
Amumu,Illaoi,1054,573,481,54.36
Amumu,Annie,687,366,321,53.28
Amumu,Sona,598,338,260,56.52
Amumu,Lillia,1240,593,647,47.82
Amumu,Shen,1410,779,631,55.25
Amumu,Riven,857,482,375,56.24
Amumu,Ziggs,748,379,369,50.67
Amumu,Fiora,769,358,411,46.55
Amumu,Nunu,1569,841,728,53.6
Amumu,Janna,637,339,298,53.22
Amumu,Sett,3274,1654,1620,50.52
Amumu,Gwen,1168,612,556,52.4
Amumu,Swain,2126,1079,1047,50.75
Amumu,Belveth,544,277,267,50.92
Amumu,Camille,624,337,287,54.01
Amumu,Sivir,1078,579,499,53.71
Amumu,Zac,983,479,504,48.73
Amumu,Kassadin,416,241,175,57.93
Amumu,Nidalee,504,292,212,57.94
Amumu,Qiyana,563,332,231,58.97
Amumu,Azir,597,331,266,55.44
Amumu,Renata,349,189,160,54.15
Amumu,Pantheon,3207,1765,1442,55.04
Amumu,Taric,473,225,248,47.57
Amumu,KogMaw,699,345,354,49.36
Amumu,RekSai,207,121,86,58.45
Amumu,Quinn,689,396,293,57.47
Amumu,Gragas,1121,629,492,56.11
Amumu,MonkeyKing,1228,614,614,50
Amumu,Renekton,1012,528,484,52.17
Amumu,Zeri,769,438,331,56.96
Amumu,Udyr,734,383,351,52.18
Amumu,Alistar,774,399,375,51.55
Amumu,Zilean,636,332,304,52.2
Amumu,Ivern,294,143,151,48.64
Amumu,Velkoz,1339,739,600,55.19
Amumu,Graves,1177,606,571,51.49
Amumu,Kalista,569,347,222,60.98
Amumu,Rumble,495,232,263,46.87
Amumu,Anivia,632,329,303,52.06
Trundle,Kayn,1707,824,883,48.27
Trundle,Zed,1061,587,474,55.33
Trundle,Sona,369,165,204,44.72
Trundle,Kaisa,1643,860,783,52.34
Trundle,Amumu,1372,712,660,51.9
Trundle,Mordekaiser,1789,904,885,50.53
Trundle,Udyr,412,237,175,57.52
Trundle,Yorick,1347,611,736,45.36
Trundle,Sivir,572,292,280,51.05
Trundle,Nautilus,1242,706,536,56.84
Trundle,Volibear,1622,880,742,54.25
Trundle,Veigar,1169,570,599,48.76
Trundle,Caitlyn,3116,1533,1583,49.2
Trundle,Warwick,2151,1037,1114,48.21
Trundle,Yone,2185,1165,1020,53.32
Trundle,Kalista,336,191,145,56.85
Trundle,Thresh,1420,722,698,50.85
Trundle,Olaf,361,180,181,49.86
Trundle,Hecarim,447,245,202,54.81
Trundle,Tristana,941,473,468,50.27
Trundle,Braum,664,344,320,51.81
Trundle,Chogath,1506,772,734,51.26
Trundle,Briar,1032,508,524,49.22
Trundle,Jayce,448,229,219,51.12
Trundle,Samira,949,518,431,54.58
Trundle,Lulu,1093,593,500,54.25
Trundle,MissFortune,2832,1509,1323,53.28
Trundle,Neeko,593,300,293,50.59
Trundle,Heimerdinger,558,305,253,54.66
Trundle,Talon,603,273,330,45.27
Trundle,LeeSin,1187,631,556,53.16
Trundle,Garen,1921,877,1044,45.65
Trundle,Jhin,2173,1105,1068,50.85
Trundle,Senna,857,440,417,51.34
Trundle,Pyke,954,518,436,54.3
Trundle,XinZhao,752,385,367,51.2
Trundle,Teemo,1410,700,710,49.65
Trundle,Yasuo,2225,1128,1097,50.7
Trundle,Gnar,408,196,212,48.04
Trundle,Graves,571,260,311,45.53
Trundle,Twitch,993,522,471,52.57
Trundle,Malzahar,1171,595,576,50.81
Trundle,Ekko,1044,584,460,55.94
Trundle,Galio,969,560,409,57.79
Trundle,Lux,3126,1602,1524,51.25
Trundle,Darius,2220,1194,1026,53.78
Trundle,Diana,1656,875,781,52.84
Trundle,Pantheon,1673,819,854,48.95
Trundle,Jax,1209,564,645,46.65
Trundle,Ornn,527,273,254,51.8
Trundle,Ambessa,617,329,288,53.32
Trundle,Zoe,437,235,202,53.78
Trundle,Swain,1186,617,569,52.02
Trundle,Mel,2450,1344,1106,54.86
Trundle,Yuumi,899,472,427,52.5
Trundle,TahmKench,1276,674,602,52.82
Trundle,Irelia,914,489,425,53.5
Trundle,Poppy,695,332,363,47.77
Trundle,Kled,246,135,111,54.88
Trundle,Viego,1491,752,739,50.44
Trundle,Lucian,751,422,329,56.19
Trundle,Sejuani,538,277,261,51.49
Trundle,Jinx,2964,1388,1576,46.83
Trundle,Shaco,1071,573,498,53.5
Trundle,Aurora,848,427,421,50.35
Trundle,Aatrox,846,464,382,54.85
Trundle,Anivia,375,186,189,49.6
Trundle,Kindred,558,295,263,52.87
Trundle,Blitzcrank,890,507,383,56.97
Trundle,Renekton,586,280,306,47.78
Trundle,Rengar,338,191,147,56.51
Trundle,Leblanc,541,279,262,51.57
Trundle,Seraphine,1118,585,533,52.33
Trundle,Gwen,611,330,281,54.01
Trundle,MasterYi,1340,697,643,52.01
Trundle,Ryze,329,150,179,45.59
Trundle,Katarina,874,497,377,56.86
Trundle,Brand,874,460,414,52.63
Trundle,Tryndamere,730,350,380,47.95
Trundle,Ahri,1477,789,688,53.42
Trundle,Draven,555,300,255,54.05
Trundle,Bard,335,183,152,54.63
Trundle,Morgana,1450,724,726,49.93
Trundle,Lillia,595,340,255,57.14
Trundle,Shen,765,389,376,50.85
Trundle,Nocturne,1402,645,757,46.01
Trundle,Zilean,276,134,142,48.55
Trundle,Zac,425,210,215,49.41
Trundle,Smolder,790,389,401,49.24
Trundle,Alistar,427,198,229,46.37
Trundle,JarvanIV,505,267,238,52.87
Trundle,Cassiopeia,345,146,199,42.32
Trundle,Zyra,924,450,474,48.7
Trundle,Kennen,292,149,143,51.03
Trundle,Riven,454,273,181,60.13
Trundle,Syndra,680,337,343,49.56
Trundle,Ezreal,2253,1225,1028,54.37
Trundle,Viktor,833,429,404,51.5
Trundle,Nasus,1011,493,518,48.76
Trundle,Soraka,672,353,319,52.53
Trundle,Akali,1190,654,536,54.96
Trundle,Khazix,565,311,254,55.04
Trundle,Azir,428,209,219,48.83
Trundle,Rell,507,261,246,51.48
Trundle,Lissandra,421,226,195,53.68
Trundle,Ziggs,430,203,227,47.21
Trundle,Karma,1071,558,513,52.1
Trundle,Evelynn,469,253,216,53.94
Trundle,Taric,259,145,114,55.98
Trundle,FiddleSticks,583,253,330,43.4
Trundle,Vex,587,252,335,42.93
Trundle,Milio,617,314,303,50.89
Trundle,Hwei,741,362,379,48.85
Trundle,Corki,417,248,169,59.47
Trundle,KSante,532,352,180,66.17
Trundle,Vayne,1403,685,718,48.82
Trundle,Vladimir,620,322,298,51.94
Trundle,Xayah,595,321,274,53.95
Trundle,Sett,1785,941,844,52.72
Trundle,Nami,985,521,464,52.89
Trundle,Nilah,512,288,224,56.25
Trundle,Malphite,1079,525,554,48.66
Trundle,Sion,1005,538,467,53.53
Trundle,Camille,276,116,160,42.03
Trundle,Varus,864,456,408,52.78
Trundle,Illaoi,663,332,331,50.08
Trundle,Ashe,2237,1171,1066,52.35
Trundle,Elise,621,322,299,51.85
Trundle,Orianna,441,250,191,56.69
Trundle,TwistedFate,423,235,188,55.56
Trundle,Gragas,634,309,325,48.74
Trundle,Kassadin,248,139,109,56.05
Trundle,Leona,933,480,453,51.45
Trundle,Rammus,471,223,248,47.35
Trundle,Qiyana,292,173,119,59.25
Trundle,Karthus,270,159,111,58.89
Trundle,Renata,194,101,93,52.06
Trundle,Fiora,360,194,166,53.89
Trundle,Belveth,304,177,127,58.22
Trundle,Rakan,502,264,238,52.59
Trundle,Annie,352,180,172,51.14
Trundle,MonkeyKing,683,346,337,50.66
Trundle,AurelionSol,539,261,278,48.42
Trundle,Urgot,603,287,316,47.6
Trundle,DrMundo,829,473,356,57.06
Trundle,Nunu,803,405,398,50.44
Trundle,Zeri,399,200,199,50.13
Trundle,Akshan,449,276,173,61.47
Trundle,Maokai,478,216,262,45.19
Trundle,Janna,300,128,172,42.67
Trundle,Velkoz,630,296,334,46.98
Trundle,Skarner,308,170,138,55.19
Trundle,Aphelios,613,302,311,49.27
Trundle,Ivern,192,106,86,55.21
Trundle,Kayle,691,356,335,51.52
Trundle,Fizz,612,299,313,48.86
Trundle,KogMaw,341,170,171,49.85
Trundle,Sylas,1286,672,614,52.26
Trundle,Singed,281,147,134,52.31
Trundle,Vi,976,539,437,55.23
Trundle,Xerath,974,467,507,47.95
Trundle,Taliyah,251,141,110,56.18
Trundle,Gangplank,468,268,200,57.26
Trundle,RekSai,126,68,58,53.97
Trundle,Rumble,199,91,108,45.73
Trundle,Naafiri,393,189,204,48.09
Trundle,Nidalee,270,143,127,52.96
Trundle,Shyvana,228,110,118,48.25
Trundle,Quinn,302,168,134,55.63
Vex,Garen,1654,748,906,45.22
Vex,Diana,1723,853,870,49.51
Vex,Yasuo,2862,1531,1331,53.49
Vex,Caitlyn,2841,1479,1362,52.06
Vex,Pyke,951,516,435,54.26
Vex,Smolder,652,329,323,50.46
Vex,Ekko,895,490,405,54.75
Vex,Mordekaiser,1483,699,784,47.13
Vex,Yuumi,897,473,424,52.73
Vex,Jax,972,439,533,45.16
Vex,Talon,613,314,299,51.22
Vex,Leblanc,900,471,429,52.33
Vex,Mel,1718,823,895,47.9
Vex,Lux,3074,1590,1484,51.72
Vex,MissFortune,2560,1290,1270,50.39
Vex,Karma,1030,499,531,48.45
Vex,Warwick,1681,780,901,46.4
Vex,Yone,2410,1222,1188,50.71
Vex,Kalista,370,188,182,50.81
Vex,Thresh,1465,734,731,50.1
Vex,Malphite,981,456,525,46.48
Vex,FiddleSticks,560,269,291,48.04
Vex,Soraka,593,337,256,56.83
Vex,Akali,1417,799,618,56.39
Vex,Jinx,2849,1331,1518,46.72
Vex,Xayah,644,329,315,51.09
Vex,Senna,830,439,391,52.89
Vex,Viego,1435,740,695,51.57
Vex,Tristana,1153,600,553,52.04
Vex,Riven,414,213,201,51.45
Vex,Sejuani,504,251,253,49.8
Vex,AurelionSol,321,141,180,43.93
Vex,Rakan,552,288,264,52.17
Vex,Nasus,701,323,378,46.08
Vex,Vi,1029,492,537,47.81
Vex,Renata,169,92,77,54.44
Vex,MonkeyKing,600,312,288,52
Vex,Sylas,1614,916,698,56.75
Vex,Swain,1065,468,597,43.94
Vex,Darius,1832,954,878,52.07
Vex,Kayn,1599,837,762,52.35
Vex,Zed,1139,590,549,51.8
Vex,Syndra,652,312,340,47.85
Vex,Kayle,747,372,375,49.8
Vex,Irelia,958,468,490,48.85
Vex,TahmKench,845,442,403,52.31
Vex,Veigar,1234,598,636,48.46
Vex,Jhin,2160,1104,1056,51.11
Vex,Poppy,653,323,330,49.46
Vex,Elise,656,335,321,51.07
Vex,Aurora,963,479,484,49.74
Vex,Nami,854,417,437,48.83
Vex,Sett,1644,812,832,49.39
Vex,Briar,911,391,520,42.92
Vex,Draven,473,261,212,55.18
Vex,Nautilus,1288,650,638,50.47
Vex,Rengar,388,239,149,61.6
Vex,Ivern,175,90,85,51.43
Vex,Graves,585,277,308,47.35
Vex,Ezreal,2297,1120,1177,48.76
Vex,Teemo,1549,762,787,49.19
Vex,Aatrox,1039,483,556,46.49
Vex,Shaco,1080,537,543,49.72
Vex,Azir,383,235,148,61.36
Vex,Yorick,1034,490,544,47.39
Vex,Kindred,564,294,270,52.13
Vex,Heimerdinger,608,335,273,55.1
Vex,Ryze,312,154,158,49.36
Vex,KSante,455,235,220,51.65
Vex,Volibear,1130,605,525,53.54
Vex,Karthus,339,174,165,51.33
Vex,Kassadin,216,99,117,45.83
Vex,Illaoi,490,291,199,59.39
Vex,Amumu,1217,602,615,49.47
Vex,Ashe,2073,1022,1051,49.3
Vex,Vayne,1284,639,645,49.77
Vex,Renekton,553,293,260,52.98
Vex,XinZhao,724,378,346,52.21
Vex,Ahri,1650,867,783,52.55
Vex,Corki,350,184,166,52.57
Vex,Morgana,1461,692,769,47.36
Vex,Hwei,735,337,398,45.85
Vex,Aphelios,618,308,310,49.84
Vex,Nidalee,288,160,128,55.56
Vex,Orianna,438,239,199,54.57
Vex,Chogath,1378,623,755,45.21
Vex,Nocturne,1336,670,666,50.15
Vex,Cassiopeia,411,226,185,54.99
Vex,Ornn,479,233,246,48.64
Vex,Lulu,903,441,462,48.84
Vex,Skarner,251,113,138,45.02
Vex,Katarina,839,498,341,59.36
Vex,Quinn,381,182,199,47.77
Vex,Camille,364,193,171,53.02
Vex,LeeSin,1337,754,583,56.39
Vex,Hecarim,370,187,183,50.54
Vex,Maokai,425,216,209,50.82
Vex,Fiora,354,183,171,51.69
Vex,Naafiri,457,224,233,49.02
Vex,Belveth,228,118,110,51.75
Vex,Twitch,824,385,439,46.72
Vex,Zac,460,249,211,54.13
Vex,Neeko,643,325,318,50.54
Vex,Shen,630,310,320,49.21
Vex,Vladimir,558,231,327,41.4
Vex,Nunu,719,360,359,50.07
Vex,Annie,405,200,205,49.38
Vex,Sona,382,176,206,46.07
Vex,Kled,171,72,99,42.11
Vex,Khazix,560,308,252,55
Vex,Galio,796,339,457,42.59
Vex,Braum,610,320,290,52.46
Vex,Trundle,587,335,252,57.07
Vex,Rammus,341,154,187,45.16
Vex,Seraphine,1015,506,509,49.85
Vex,DrMundo,592,287,305,48.48
Vex,Kaisa,1563,841,722,53.81
Vex,Gangplank,437,214,223,48.97
Vex,Blitzcrank,884,442,442,50
Vex,Olaf,255,110,145,43.14
Vex,JarvanIV,537,279,258,51.96
Vex,Tryndamere,625,348,277,55.68
Vex,Sion,905,423,482,46.74
Vex,Malzahar,1009,458,551,45.39
Vex,Samira,769,404,365,52.54
Vex,Xerath,999,499,500,49.95
Vex,Viktor,937,478,459,51.01
Vex,Milio,555,233,322,41.98
Vex,Velkoz,623,284,339,45.59
Vex,TwistedFate,306,173,133,56.54
Vex,Lillia,740,343,397,46.35
Vex,Kennen,308,166,142,53.9
Vex,MasterYi,1155,531,624,45.97
Vex,Singed,300,131,169,43.67
Vex,Nilah,474,260,214,54.85
Vex,Taliyah,210,105,105,50
Vex,Qiyana,395,232,163,58.73
Vex,Lucian,717,389,328,54.25
Vex,Rumble,224,131,93,58.48
Vex,KogMaw,317,168,149,53
Vex,Leona,965,432,533,44.77
Vex,Varus,932,473,459,50.75
Vex,Sivir,539,265,274,49.17
Vex,Gragas,665,382,283,57.44
Vex,Zeri,435,217,218,49.89
Vex,Zyra,961,475,486,49.43
Vex,Alistar,396,210,186,53.03
Vex,Pantheon,1776,912,864,51.35
Vex,Akshan,408,223,185,54.66
Vex,Gwen,587,309,278,52.64
Vex,Brand,789,377,412,47.78
Vex,Urgot,482,242,240,50.21
Vex,Evelynn,463,240,223,51.84
Vex,Rell,594,309,285,52.02
Vex,Ambessa,676,368,308,54.44
Vex,Udyr,384,221,163,57.55
Vex,Bard,318,186,132,58.49
Vex,Zoe,379,204,175,53.83
Vex,Gnar,470,248,222,52.77
Vex,Fizz,597,311,286,52.09
Vex,Ziggs,416,157,259,37.74
Vex,Zilean,288,149,139,51.74
Vex,Lissandra,260,155,105,59.62
Vex,Anivia,302,157,145,51.99
Vex,Shyvana,264,149,115,56.44
Vex,Taric,207,110,97,53.14
Vex,Janna,323,127,196,39.32
Vex,RekSai,106,66,40,62.26
Vex,Jayce,478,276,202,57.74
LeeSin,Gangplank,1513,764,749,50.5
LeeSin,Warwick,3542,1650,1892,46.58
LeeSin,Akali,3188,1589,1599,49.84
LeeSin,Caitlyn,6925,3314,3611,47.86
LeeSin,Sona,643,264,379,41.06
LeeSin,Garen,3919,1792,2127,45.73
LeeSin,Volibear,2463,1224,1239,49.7
LeeSin,Tristana,2420,1144,1276,47.27
LeeSin,Lux,6301,3025,3276,48.01
LeeSin,Morgana,2899,1298,1601,44.77
LeeSin,Chogath,2972,1308,1664,44.01
LeeSin,Graves,2655,1282,1373,48.29
LeeSin,Leblanc,2151,1041,1110,48.4
LeeSin,Milio,1383,650,733,47
LeeSin,Mordekaiser,3084,1491,1593,48.35
LeeSin,Amumu,2281,1061,1220,46.51
LeeSin,Yasuo,5402,2458,2944,45.5
LeeSin,Soraka,1439,658,781,45.73
LeeSin,Gwen,1254,633,621,50.48
LeeSin,Tryndamere,1300,537,763,41.31
LeeSin,Velkoz,1550,749,801,48.32
LeeSin,Zeri,1397,702,695,50.25
LeeSin,Thresh,4234,2019,2215,47.69
LeeSin,KSante,1837,983,854,53.51
LeeSin,Ashe,6260,2956,3304,47.22
LeeSin,Nasus,1644,729,915,44.34
LeeSin,TahmKench,1964,941,1023,47.91
LeeSin,Fizz,1217,592,625,48.64
LeeSin,Nunu,1583,773,810,48.83
LeeSin,Vladimir,1718,807,911,46.97
LeeSin,Samira,1892,939,953,49.63
LeeSin,Nami,2221,956,1265,43.04
LeeSin,Gragas,2033,1028,1005,50.57
LeeSin,XinZhao,2279,1064,1215,46.69
LeeSin,Lucian,2060,1071,989,51.99
LeeSin,Vi,3522,1639,1883,46.54
LeeSin,Orianna,1416,663,753,46.82
LeeSin,Draven,1352,673,679,49.78
LeeSin,Lulu,3767,1764,2003,46.83
LeeSin,Viktor,2626,1269,1357,48.32
LeeSin,Nocturne,3305,1459,1846,44.15
LeeSin,Nilah,814,404,410,49.63
LeeSin,Bard,940,403,537,42.87
LeeSin,Sett,4147,1898,2249,45.77
LeeSin,Kayn,3639,1607,2032,44.16
LeeSin,Ryze,1135,565,570,49.78
LeeSin,Khazix,1574,818,756,51.97
LeeSin,MissFortune,5461,2655,2806,48.62
LeeSin,Seraphine,1897,903,994,47.6
LeeSin,Kalista,940,457,483,48.62
LeeSin,Gnar,1173,585,588,49.87
LeeSin,Pyke,2563,1285,1278,50.14
LeeSin,Pantheon,4834,2306,2528,47.7
LeeSin,Aurora,2338,1221,1117,52.22
LeeSin,Jax,2612,1256,1356,48.09
LeeSin,JarvanIV,1596,709,887,44.42
LeeSin,Hwei,1875,839,1036,44.75
LeeSin,Kaisa,5024,2441,2583,48.59
LeeSin,Yorick,1978,874,1104,44.19
LeeSin,Shaco,2585,1299,1286,50.25
LeeSin,Katarina,2079,963,1116,46.32
LeeSin,Nautilus,3197,1546,1651,48.36
LeeSin,Riven,1173,501,672,42.71
LeeSin,MonkeyKing,1866,854,1012,45.77
LeeSin,Yone,5601,2760,2841,49.28
LeeSin,Trundle,1187,556,631,46.84
LeeSin,Naafiri,888,393,495,44.26
LeeSin,Aphelios,1575,749,826,47.56
LeeSin,Shen,1513,704,809,46.53
LeeSin,Rammus,828,381,447,46.01
LeeSin,Teemo,2884,1324,1560,45.91
LeeSin,Jayce,2012,1009,1003,50.15
LeeSin,Skarner,868,412,456,47.47
LeeSin,Jinx,6919,3239,3680,46.81
LeeSin,Poppy,2230,974,1256,43.68
LeeSin,Neeko,1271,601,670,47.29
LeeSin,Sylas,4816,2361,2455,49.02
LeeSin,Lissandra,799,393,406,49.19
LeeSin,Ezreal,8268,4000,4268,48.38
LeeSin,Mel,5596,2842,2754,50.79
LeeSin,Talon,1964,900,1064,45.82
LeeSin,RekSai,510,237,273,46.47
LeeSin,Leona,2225,1018,1207,45.75
LeeSin,Ornn,1329,650,679,48.91
LeeSin,Anivia,891,420,471,47.14
LeeSin,Yuumi,2313,1153,1160,49.85
LeeSin,Fiora,1021,545,476,53.38
LeeSin,Hecarim,1262,648,614,51.35
LeeSin,Blitzcrank,2441,1254,1187,51.37
LeeSin,Ziggs,862,415,447,48.14
LeeSin,Evelynn,1002,497,505,49.6
LeeSin,Sivir,1436,694,742,48.33
LeeSin,Aatrox,3059,1507,1552,49.26
LeeSin,Xerath,2798,1329,1469,47.5
LeeSin,Sejuani,1346,635,711,47.18
LeeSin,Ahri,3531,1728,1803,48.94
LeeSin,Camille,1014,509,505,50.2
LeeSin,Rengar,909,485,424,53.36
LeeSin,Diana,4640,2293,2347,49.42
LeeSin,Singed,688,315,373,45.78
LeeSin,Zed,3293,1633,1660,49.59
LeeSin,Urgot,1000,459,541,45.9
LeeSin,Ekko,2454,1196,1258,48.74
LeeSin,Lillia,1705,749,956,43.93
LeeSin,Smolder,1718,895,823,52.1
LeeSin,Braum,1588,746,842,46.98
LeeSin,Brand,1580,825,755,52.22
LeeSin,Xayah,1261,596,665,47.26
LeeSin,Irelia,2403,1191,1212,49.56
LeeSin,MasterYi,2878,1338,1540,46.49
LeeSin,Rakan,1329,633,696,47.63
LeeSin,Darius,4864,2213,2651,45.5
LeeSin,Karma,3892,1806,2086,46.4
LeeSin,Taliyah,814,387,427,47.54
LeeSin,Ambessa,2181,1093,1088,50.11
LeeSin,Olaf,773,338,435,43.73
LeeSin,Kayle,1341,632,709,47.13
LeeSin,Illaoi,1168,540,628,46.23
LeeSin,Rell,1369,694,675,50.69
LeeSin,Viego,5292,2546,2746,48.11
LeeSin,Veigar,2229,1032,1197,46.3
LeeSin,Quinn,886,427,459,48.19
LeeSin,Cassiopeia,775,326,449,42.06
LeeSin,Renata,507,218,289,43
LeeSin,Twitch,1826,904,922,49.51
LeeSin,Sion,1923,842,1081,43.79
LeeSin,KogMaw,669,294,375,43.95
LeeSin,Vex,1337,583,754,43.61
LeeSin,Swain,2425,1064,1361,43.88
LeeSin,Heimerdinger,1121,473,648,42.19
LeeSin,Varus,2658,1328,1330,49.96
LeeSin,FiddleSticks,1232,626,606,50.81
LeeSin,Maokai,1255,514,741,40.96
LeeSin,Kindred,1272,644,628,50.63
LeeSin,Vayne,2911,1339,1572,46
LeeSin,Renekton,1549,788,761,50.87
LeeSin,Udyr,962,450,512,46.78
LeeSin,Shyvana,531,285,246,53.67
LeeSin,Kassadin,509,249,260,48.92
LeeSin,Corki,1161,590,571,50.82
LeeSin,Elise,2507,1256,1251,50.1
LeeSin,TwistedFate,1139,556,583,48.81
LeeSin,Jhin,5529,2580,2949,46.66
LeeSin,Kled,433,204,229,47.11
LeeSin,DrMundo,1349,665,684,49.3
LeeSin,Briar,1776,799,977,44.99
LeeSin,AurelionSol,945,452,493,47.83
LeeSin,Janna,856,339,517,39.6
LeeSin,Zyra,2815,1307,1508,46.43
LeeSin,Alistar,1226,613,613,50
LeeSin,Zoe,1184,603,581,50.93
LeeSin,Senna,1734,853,881,49.19
LeeSin,Karthus,785,392,393,49.94
LeeSin,Malzahar,2294,1012,1282,44.12
LeeSin,Rumble,955,481,474,50.37
LeeSin,Kennen,837,365,472,43.61
LeeSin,Annie,1009,472,537,46.78
LeeSin,Galio,2484,1155,1329,46.5
LeeSin,Qiyana,696,381,315,54.74
LeeSin,Syndra,1626,810,816,49.82
LeeSin,Taric,539,257,282,47.68
LeeSin,Malphite,2540,1198,1342,47.17
LeeSin,Akshan,771,374,397,48.51
LeeSin,Belveth,567,256,311,45.15
LeeSin,Zac,1507,739,768,49.04
LeeSin,Ivern,390,213,177,54.62
LeeSin,Nidalee,1444,779,665,53.95
LeeSin,Zilean,711,310,401,43.6
LeeSin,Azir,1189,610,579,51.3
Akali,Yorick,1890,876,1014,46.35
Akali,LeeSin,3188,1599,1589,50.16
Akali,Yone,5119,2741,2378,53.55
Akali,MissFortune,5307,2652,2655,49.97
Akali,Mel,4589,2383,2206,51.93
Akali,Ornn,913,452,461,49.51
Akali,Udyr,755,400,355,52.98
Akali,Lux,5643,2821,2822,49.99
Akali,Ezreal,4967,2431,2536,48.94
Akali,Milio,1122,566,556,50.45
Akali,Samira,1588,749,839,47.17
Akali,Kayn,3012,1378,1634,45.75
Akali,Sylas,3532,1706,1826,48.3
Akali,Nilah,793,375,418,47.29
Akali,Leona,1692,839,853,49.59
Akali,DrMundo,1191,582,609,48.87
Akali,Belveth,510,271,239,53.14
Akali,Leblanc,1185,594,591,50.13
Akali,Briar,1696,876,820,51.65
Akali,Anivia,596,275,321,46.14
Akali,Malphite,1794,879,915,49
Akali,Jax,1991,1031,960,51.78
Akali,Neeko,1180,597,583,50.59
Akali,Xayah,1149,562,587,48.91
Akali,Rakan,1022,463,559,45.3
Akali,Gangplank,840,410,430,48.81
Akali,Hwei,1312,624,688,47.56
Akali,Hecarim,793,388,405,48.93
Akali,Lillia,1296,639,657,49.31
Akali,Soraka,1223,517,706,42.27
Akali,Chogath,2553,1119,1434,43.83
Akali,Talon,1340,736,604,54.93
Akali,Qiyana,594,276,318,46.46
Akali,Seraphine,1833,857,976,46.75
Akali,Heimerdinger,1020,440,580,43.14
Akali,Vi,1886,879,1007,46.61
Akali,Ahri,2661,1393,1268,52.35
Akali,Darius,3491,1743,1748,49.93
Akali,Maokai,880,428,452,48.64
Akali,Aatrox,1937,977,960,50.44
Akali,Viego,2933,1477,1456,50.36
Akali,Ashe,4298,2124,2174,49.42
Akali,Blitzcrank,1714,941,773,54.9
Akali,Mordekaiser,2991,1368,1623,45.74
Akali,Zed,2486,1248,1238,50.2
Akali,Vex,1417,618,799,43.61
Akali,Ambessa,1346,690,656,51.26
Akali,Nunu,1437,720,717,50.1
Akali,Jinx,5401,2682,2719,49.66
Akali,Evelynn,883,482,401,54.59
Akali,Kalista,764,398,366,52.09
Akali,Renata,442,228,214,51.58
Akali,MasterYi,2548,1160,1388,45.53
Akali,Caitlyn,5554,2603,2951,46.87
Akali,Taric,418,175,243,41.87
Akali,Amumu,2140,918,1222,42.9
Akali,Akshan,748,287,461,38.37
Akali,Irelia,2076,1061,1015,51.11
Akali,Nocturne,2328,1143,1185,49.1
Akali,Jayce,985,484,501,49.14
Akali,Jhin,4253,2094,2159,49.24
Akali,Senna,1610,768,842,47.7
Akali,Riven,910,429,481,47.14
Akali,Naafiri,840,373,467,44.4
Akali,Tristana,1977,980,997,49.57
Akali,Ivern,412,212,200,51.46
Akali,Katarina,1761,955,806,54.23
Akali,Pantheon,3365,1693,1672,50.31
Akali,Teemo,2813,1307,1506,46.46
Akali,Warwick,3276,1438,1838,43.89
Akali,Veigar,2168,1008,1160,46.49
Akali,Kaisa,3532,1883,1649,53.31
Akali,Yuumi,1861,852,1009,45.78
Akali,Lucian,1348,706,642,52.37
Akali,Swain,2102,950,1152,45.2
Akali,Singed,546,226,320,41.39
Akali,Galio,2231,1054,1177,47.24
Akali,Smolder,1245,623,622,50.04
Akali,Brand,1480,718,762,48.51
Akali,Yasuo,4841,2414,2427,49.87
Akali,Thresh,2792,1343,1449,48.1
Akali,Skarner,653,339,314,51.91
Akali,Aurora,1794,927,867,51.67
Akali,Zoe,808,417,391,51.61
Akali,Gragas,1153,605,548,52.47
Akali,Rammus,658,320,338,48.63
Akali,Nami,1838,884,954,48.1
Akali,Zac,938,453,485,48.29
Akali,Sion,1532,730,802,47.65
Akali,Draven,950,435,515,45.79
Akali,Nasus,1470,693,777,47.14
Akali,Diana,3380,1624,1756,48.05
Akali,Zilean,532,254,278,47.74
Akali,Camille,675,330,345,48.89
Akali,Azir,713,357,356,50.07
Akali,Braum,1086,486,600,44.75
Akali,KSante,1148,627,521,54.62
Akali,MonkeyKing,1347,616,731,45.73
Akali,Ekko,1936,928,1008,47.93
Akali,Fiora,781,387,394,49.55
Akali,Kindred,963,529,434,54.93
Akali,Morgana,2612,1179,1433,45.14
Akali,Gwen,1111,640,471,57.61
Akali,JarvanIV,986,479,507,48.58
Akali,Kennen,633,319,314,50.39
Akali,Nautilus,2266,1150,1116,50.75
Akali,FiddleSticks,1003,445,558,44.37
Akali,Karma,2293,1158,1135,50.5
Akali,Quinn,810,402,408,49.63
Akali,Sivir,1107,539,568,48.69
Akali,Gnar,859,448,411,52.15
Akali,AurelionSol,683,315,368,46.12
Akali,Renekton,1018,478,540,46.95
Akali,Aphelios,1126,520,606,46.18
Akali,TahmKench,1687,876,811,51.93
Akali,Malzahar,1761,805,956,45.71
Akali,Sett,3408,1575,1833,46.21
Akali,Vayne,2541,1110,1431,43.68
Akali,Tryndamere,1122,579,543,51.6
Akali,Fizz,1178,572,606,48.56
Akali,Vladimir,1336,623,713,46.63
Akali,Garen,3391,1606,1785,47.36
Akali,Lulu,2385,1154,1231,48.39
Akali,RekSai,221,84,137,38.01
Akali,Pyke,2076,1090,986,52.5
Akali,Volibear,2388,1120,1268,46.9
Akali,Sona,693,351,342,50.65
Akali,Annie,702,322,380,45.87
Akali,Khazix,1021,483,538,47.31
Akali,Orianna,862,395,467,45.82
Akali,Janna,641,277,364,43.21
Akali,Zyra,1843,891,952,48.35
Akali,Corki,724,352,372,48.62
Akali,Ziggs,875,431,444,49.26
Akali,Graves,1231,602,629,48.9
Akali,TwistedFate,708,413,295,58.33
Akali,Rell,1086,508,578,46.78
Akali,Syndra,1046,543,503,51.91
Akali,XinZhao,1415,687,728,48.55
Akali,Twitch,1478,726,752,49.12
Akali,Shaco,2071,1038,1033,50.12
Akali,Varus,1802,851,951,47.23
Akali,Zeri,915,482,433,52.68
Akali,Alistar,793,321,472,40.48
Akali,Ryze,697,330,367,47.35
Akali,Kayle,1420,675,745,47.54
Akali,Sejuani,810,395,415,48.77
Akali,Kassadin,424,213,211,50.24
Akali,Trundle,1190,536,654,45.04
Akali,Xerath,1767,872,895,49.35
Akali,Viktor,1859,975,884,52.45
Akali,Urgot,955,409,546,42.83
Akali,Poppy,1272,564,708,44.34
Akali,Velkoz,1155,583,572,50.48
Akali,Rengar,672,405,267,60.27
Akali,Nidalee,668,345,323,51.65
Akali,Shyvana,550,251,299,45.64
Akali,Lissandra,751,450,301,59.92
Akali,Rumble,543,265,278,48.8
Akali,Olaf,482,277,205,57.47
Akali,Cassiopeia,615,280,335,45.53
Akali,Shen,1170,584,586,49.91
Akali,Illaoi,1048,517,531,49.33
Akali,Kled,421,198,223,47.03
Akali,Elise,1360,659,701,48.46
Akali,KogMaw,546,229,317,41.94
Akali,Karthus,628,293,335,46.66
Akali,Bard,616,308,308,50
Akali,Taliyah,569,275,294,48.33
Naafiri,Aatrox,686,389,297,56.71
Naafiri,Sejuani,241,144,97,59.75
Naafiri,Yasuo,1363,616,747,45.19
Naafiri,Jinx,1822,868,954,47.64
Naafiri,Pyke,764,400,364,52.36
Naafiri,Gnar,306,156,150,50.98
Naafiri,Viego,979,463,516,47.29
Naafiri,Yone,1518,679,839,44.73
Naafiri,Kaisa,1079,594,485,55.05
Naafiri,TahmKench,674,374,300,55.49
Naafiri,Ryze,238,112,126,47.06
Naafiri,Nunu,541,270,271,49.91
Naafiri,Ahri,849,440,409,51.83
Naafiri,Lucian,406,231,175,56.9
Naafiri,Alistar,245,116,129,47.35
Naafiri,Vayne,801,424,377,52.93
Naafiri,Briar,667,320,347,47.98
Naafiri,Lux,2018,1080,938,53.52
Naafiri,Mel,1536,763,773,49.67
Naafiri,Yuumi,593,304,289,51.26
Naafiri,Irelia,636,312,324,49.06
Naafiri,Nocturne,807,351,456,43.49
Naafiri,Jayce,270,154,116,57.04
Naafiri,Jhin,1501,733,768,48.83
Naafiri,Senna,552,261,291,47.28
Naafiri,Sett,1122,573,549,51.07
Naafiri,FiddleSticks,366,174,192,47.54
Naafiri,Akali,840,467,373,55.6
Naafiri,Samira,597,293,304,49.08
Naafiri,Neeko,420,200,220,47.62
Naafiri,Kayle,511,242,269,47.36
Naafiri,Katarina,506,294,212,58.1
Naafiri,KSante,276,167,109,60.51
Naafiri,Kayn,1131,592,539,52.34
Naafiri,Quinn,260,130,130,50
Naafiri,Thresh,847,425,422,50.18
Naafiri,Talon,454,236,218,51.98
Naafiri,LeeSin,888,495,393,55.74
Naafiri,Garen,1149,556,593,48.39
Naafiri,Malzahar,728,390,338,53.57
Naafiri,Twitch,619,312,307,50.4
Naafiri,Rakan,326,138,188,42.33
Naafiri,Yorick,774,364,410,47.03
Naafiri,Volibear,876,417,459,47.6
Naafiri,Blitzcrank,559,246,313,44.01
Naafiri,Shaco,634,350,284,55.21
Naafiri,Darius,1394,645,749,46.27
Naafiri,Sylas,928,496,432,53.45
Naafiri,Tristana,688,316,372,45.93
Naafiri,Zoe,394,175,219,44.42
Naafiri,Kassadin,126,61,65,48.41
Naafiri,Renata,144,62,82,43.06
Naafiri,Gragas,368,204,164,55.43
Naafiri,Karma,626,320,306,51.12
Naafiri,Veigar,828,340,488,41.06
Naafiri,Viktor,517,284,233,54.93
Naafiri,Teemo,962,460,502,47.82
Naafiri,Graves,385,220,165,57.14
Naafiri,Leblanc,464,298,166,64.22
Naafiri,Mordekaiser,1096,487,609,44.43
Naafiri,Diana,1144,569,575,49.74
Naafiri,Kindred,357,171,186,47.9
Naafiri,Swain,725,281,444,38.76
Naafiri,JarvanIV,376,186,190,49.47
Naafiri,Hwei,431,233,198,54.06
Naafiri,Riven,293,167,126,57
Naafiri,Nami,710,350,360,49.3
Naafiri,Xayah,374,174,200,46.52
Naafiri,Evelynn,337,223,114,66.17
Naafiri,Zac,279,139,140,49.82
Naafiri,Renekton,362,204,158,56.35
Naafiri,Caitlyn,1948,983,965,50.46
Naafiri,Zilean,220,113,107,51.36
Naafiri,MasterYi,777,350,427,45.05
Naafiri,Azir,234,134,100,57.26
Naafiri,Ezreal,1377,727,650,52.8
Naafiri,Velkoz,516,265,251,51.36
Naafiri,Vex,457,233,224,50.98
Naafiri,Bard,231,129,102,55.84
Naafiri,Ekko,641,326,315,50.86
Naafiri,Fiora,268,158,110,58.96
Naafiri,XinZhao,397,192,205,48.36
Naafiri,Draven,341,182,159,53.37
Naafiri,Rammus,209,83,126,39.71
Naafiri,Zeri,250,156,94,62.4
Naafiri,Amumu,755,341,414,45.17
Naafiri,MissFortune,1659,809,850,48.76
Naafiri,Morgana,916,462,454,50.44
Naafiri,Syndra,443,239,204,53.95
Naafiri,Lulu,780,403,377,51.67
Naafiri,Belveth,152,68,84,44.74
Naafiri,Soraka,437,216,221,49.43
Naafiri,Ambessa,430,213,217,49.53
Naafiri,Lillia,423,230,193,54.37
Naafiri,Aurora,630,276,354,43.81
Naafiri,Cassiopeia,207,108,99,52.17
Naafiri,Nilah,331,142,189,42.9
Naafiri,Ornn,284,123,161,43.31
Naafiri,Heimerdinger,393,179,214,45.55
Naafiri,Anivia,199,104,95,52.26
Naafiri,Udyr,259,142,117,54.83
Naafiri,Nasus,556,244,312,43.88
Naafiri,Warwick,1205,592,613,49.13
Naafiri,Elise,437,232,205,53.09
Naafiri,Jax,586,319,267,54.44
Naafiri,Vladimir,404,207,197,51.24
Naafiri,Nautilus,696,329,367,47.27
Naafiri,Ashe,1348,683,665,50.67
Naafiri,Rengar,247,138,109,55.87
Naafiri,Poppy,392,183,209,46.68
Naafiri,Galio,513,241,272,46.98
Naafiri,Ziggs,277,137,140,49.46
Naafiri,Sona,242,105,137,43.39
Naafiri,Aphelios,390,205,185,52.56
Naafiri,Pantheon,1086,542,544,49.91
Naafiri,Kennen,250,118,132,47.2
Naafiri,Khazix,337,194,143,57.57
Naafiri,Gwen,411,224,187,54.5
Naafiri,Xerath,553,304,249,54.97
Naafiri,Malphite,687,319,368,46.43
Naafiri,Camille,254,162,92,63.78
Naafiri,Fizz,377,184,193,48.81
Naafiri,Singed,220,91,129,41.36
Naafiri,RekSai,52,22,30,42.31
Naafiri,AurelionSol,332,183,149,55.12
Naafiri,Milio,409,232,177,56.72
Naafiri,Vi,633,296,337,46.76
Naafiri,Orianna,337,145,192,43.03
Naafiri,Shen,510,236,274,46.27
Naafiri,DrMundo,396,200,196,50.51
Naafiri,Corki,253,140,113,55.34
Naafiri,TwistedFate,226,154,72,68.14
Naafiri,Qiyana,209,119,90,56.94
Naafiri,Illaoi,360,211,149,58.61
Naafiri,Smolder,523,264,259,50.48
Naafiri,Zed,697,352,345,50.5
Naafiri,Leona,589,298,291,50.59
Naafiri,Tryndamere,422,202,220,47.87
Naafiri,Varus,579,259,320,44.73
Naafiri,Urgot,373,162,211,43.43
Naafiri,Janna,239,126,113,52.72
Naafiri,Akshan,300,164,136,54.67
Naafiri,Gangplank,305,166,139,54.43
Naafiri,Seraphine,737,332,405,45.05
Naafiri,Zyra,620,289,331,46.61
Naafiri,Brand,531,276,255,51.98
Naafiri,Lissandra,245,114,131,46.53
Naafiri,MonkeyKing,417,217,200,52.04
Naafiri,Shyvana,241,85,156,35.27
Naafiri,Hecarim,297,138,159,46.46
Naafiri,Karthus,194,97,97,50
Naafiri,Chogath,955,460,495,48.17
Naafiri,Kalista,189,102,87,53.97
Naafiri,Taliyah,199,91,108,45.73
Naafiri,Annie,248,131,117,52.82
Naafiri,Rell,297,184,113,61.95
Naafiri,Kled,131,51,80,38.93
Naafiri,Sion,490,202,288,41.22
Naafiri,Braum,330,150,180,45.45
Naafiri,Nidalee,168,111,57,66.07
Naafiri,Skarner,228,125,103,54.82
Naafiri,Trundle,393,204,189,51.91
Naafiri,Sivir,334,191,143,57.19
Naafiri,Olaf,133,70,63,52.63
Naafiri,Maokai,307,146,161,47.56
Naafiri,Ivern,126,75,51,59.52
Naafiri,Rumble,162,104,58,64.2
Naafiri,KogMaw,224,114,110,50.89
Naafiri,Taric,145,86,59,59.31
Senna,Aatrox,1234,630,604,51.05
Senna,Sejuani,558,303,255,54.3
Senna,Yasuo,3033,1536,1497,50.64
Senna,Jinx,4020,1952,2068,48.56
Senna,Pyke,1416,726,690,51.27
Senna,Gwen,795,431,364,54.21
Senna,Talon,961,542,419,56.4
Senna,Yone,2806,1507,1299,53.71
Senna,MissFortune,3294,1607,1687,48.79
Senna,Taric,300,140,160,46.67
Senna,Samira,1223,644,579,52.66
Senna,Kayn,2185,1067,1118,48.83
Senna,Sylas,1689,868,821,51.39
Senna,Nilah,583,288,295,49.4
Senna,Leona,1166,525,641,45.03
Senna,Fiora,580,304,276,52.41
Senna,FiddleSticks,747,403,344,53.95
Senna,Syndra,781,381,400,48.78
Senna,Vayne,1742,908,834,52.12
Senna,Morgana,2061,1049,1012,50.9
Senna,Chogath,1976,1009,967,51.06
Senna,Shaco,1501,783,718,52.17
Senna,Ahri,2191,1152,1039,52.58
Senna,Ashe,2902,1456,1446,50.17
Senna,Poppy,1013,515,498,50.84
Senna,Malphite,1535,694,841,45.21
Senna,Mel,3333,1761,1572,52.84
Senna,Soraka,932,478,454,51.29
Senna,Mordekaiser,2088,1038,1050,49.71
Senna,Zed,1521,787,734,51.74
Senna,Vex,830,391,439,47.11
Senna,Rakan,781,379,402,48.53
Senna,Viktor,1280,674,606,52.66
Senna,Nocturne,1714,776,938,45.27
Senna,Bard,522,284,238,54.41
Senna,Gnar,673,340,333,50.52
Senna,Jax,1401,677,724,48.32
Senna,Aurora,1138,696,442,61.16
Senna,Swain,1631,795,836,48.74
Senna,Fizz,850,410,440,48.24
Senna,Tristana,1401,704,697,50.25
Senna,Akali,1610,842,768,52.3
Senna,Naafiri,552,291,261,52.72
Senna,Kayle,1182,576,606,48.73
Senna,Smolder,976,529,447,54.2
Senna,Kalista,430,219,211,50.93
Senna,Gragas,881,447,434,50.74
Senna,Orianna,674,334,340,49.55
Senna,Gangplank,652,353,299,54.14
Senna,Corki,573,307,266,53.58
Senna,Lux,3952,1933,2019,48.91
Senna,Yorick,1540,659,881,42.79
Senna,Ekko,1358,671,687,49.41
Senna,Katarina,1090,578,512,53.03
Senna,Sion,1222,572,650,46.81
Senna,Sett,2328,1107,1221,47.55
Senna,Lissandra,396,221,175,55.81
Senna,Milio,992,489,503,49.29
Senna,Lillia,973,540,433,55.5
Senna,Jhin,2863,1378,1485,48.13
Senna,Janna,548,269,279,49.09
Senna,Olaf,369,229,140,62.06
Senna,Braum,837,462,375,55.2
Senna,TahmKench,1379,693,686,50.25
Senna,Malzahar,1516,693,823,45.71
Senna,Blitzcrank,1132,615,517,54.33
Senna,Vi,1367,776,591,56.77
Senna,Thresh,2082,969,1113,46.54
Senna,Trundle,857,417,440,48.66
Senna,Aphelios,967,508,459,52.53
Senna,Shen,1061,555,506,52.31
Senna,Nunu,1000,556,444,55.6
Senna,DrMundo,846,394,452,46.57
Senna,Amumu,1615,803,812,49.72
Senna,Irelia,1247,610,637,48.92
Senna,Warwick,2349,1149,1200,48.91
Senna,Veigar,1673,821,852,49.07
Senna,Nautilus,1784,914,870,51.23
Senna,Darius,3026,1537,1489,50.79
Senna,Karma,1589,809,780,50.91
Senna,Diana,2183,1101,1082,50.44
Senna,Twitch,1310,628,682,47.94
Senna,Teemo,1953,953,1000,48.8
Senna,Kaisa,2391,1248,1143,52.2
Senna,Evelynn,581,304,277,52.32
Senna,Velkoz,946,426,520,45.03
Senna,Nasus,1049,564,485,53.77
Senna,Neeko,844,444,400,52.61
Senna,Draven,804,396,408,49.25
Senna,Shyvana,443,222,221,50.11
Senna,Galio,1241,621,620,50.04
Senna,Caitlyn,4158,2069,2089,49.76
Senna,Garen,2311,1160,1151,50.19
Senna,Graves,818,410,408,50.12
Senna,Zoe,585,340,245,58.12
Senna,Jayce,746,366,380,49.06
Senna,Ezreal,3311,1731,1580,52.28
Senna,Kindred,796,417,379,52.39
Senna,Yuumi,1310,605,705,46.18
Senna,Azir,561,251,310,44.74
Senna,Ivern,272,111,161,40.81
Senna,Anivia,485,234,251,48.25
Senna,Hecarim,581,299,282,51.46
Senna,Khazix,752,358,394,47.61
Senna,Sivir,775,369,406,47.61
Senna,Seraphine,1435,742,693,51.71
Senna,MonkeyKing,1006,443,563,44.04
Senna,Vladimir,885,452,433,51.07
Senna,Varus,1325,689,636,52
Senna,Urgot,837,391,446,46.71
Senna,MasterYi,1647,814,833,49.42
Senna,Renekton,740,355,385,47.97
Senna,Renata,352,188,164,53.41
Senna,Karthus,447,208,239,46.53
Senna,Lucian,985,535,450,54.31
Senna,Nami,1594,739,855,46.36
Senna,Volibear,1629,727,902,44.63
Senna,Lulu,1987,957,1030,48.16
Senna,Brand,1100,555,545,50.45
Senna,Ryze,503,220,283,43.74
Senna,Zac,604,309,295,51.16
Senna,Ziggs,620,279,341,45
Senna,Viego,2056,1020,1036,49.61
Senna,Alistar,527,242,285,45.92
Senna,Rammus,483,205,278,42.44
Senna,Nidalee,405,225,180,55.56
Senna,Kled,238,106,132,44.54
Senna,Udyr,623,341,282,54.74
Senna,Xerath,1187,576,611,48.53
Senna,Ornn,772,382,390,49.48
Senna,Singed,421,206,215,48.93
Senna,Kassadin,281,136,145,48.4
Senna,Tryndamere,868,441,427,50.81
Senna,Riven,704,356,348,50.57
Senna,Rell,750,409,341,54.53
Senna,Briar,1236,559,677,45.23
Senna,LeeSin,1734,881,853,50.81
Senna,Pantheon,2353,1128,1225,47.94
Senna,Camille,484,281,203,58.06
Senna,Ambessa,887,483,404,54.45
Senna,Skarner,406,245,161,60.34
Senna,Hwei,1063,536,527,50.42
Senna,Heimerdinger,694,321,373,46.25
Senna,Rengar,454,221,233,48.68
Senna,Sona,583,303,280,51.97
Senna,KSante,648,365,283,56.33
Senna,Xayah,824,403,421,48.91
Senna,Kennen,430,180,250,41.86
Senna,Leblanc,727,365,362,50.21
Senna,Elise,1082,531,551,49.08
Senna,XinZhao,882,445,437,50.45
Senna,Quinn,598,281,317,46.99
Senna,Qiyana,529,316,213,59.74
Senna,Annie,462,245,217,53.03
Senna,TwistedFate,508,228,280,44.88
Senna,AurelionSol,706,360,346,50.99
Senna,Zilean,455,241,214,52.97
Senna,Zyra,1415,707,708,49.96
Senna,KogMaw,536,262,274,48.88
Senna,Cassiopeia,518,253,265,48.84
Senna,Belveth,379,201,178,53.03
Senna,Taliyah,455,217,238,47.69
Senna,JarvanIV,829,414,415,49.94
Senna,Rumble,351,183,168,52.14
Senna,Akshan,603,321,282,53.23
Senna,Maokai,714,356,358,49.86
Senna,Illaoi,710,374,336,52.68
Senna,Zeri,666,343,323,51.5
Senna,RekSai,162,101,61,62.35
Galio,Gnar,680,357,323,52.5
Galio,Jax,1643,914,729,55.63
Galio,Yasuo,3087,1575,1512,51.02
Galio,Caitlyn,4186,1996,2190,47.68
Galio,Neeko,876,504,372,57.53
Galio,Teemo,2164,1058,1106,48.89
Galio,TahmKench,1299,712,587,54.81
Galio,Jinx,4219,2047,2172,48.52
Galio,Zoe,779,451,328,57.89
Galio,Nami,1581,828,753,52.37
Galio,Irelia,1403,746,657,53.17
Galio,Pantheon,2468,1343,1125,54.42
Galio,Kassadin,334,183,151,54.79
Galio,Jhin,3197,1679,1518,52.52
Galio,Yuumi,1304,681,623,52.22
Galio,Shaco,1427,750,677,52.56
Galio,Leblanc,1192,622,570,52.18
Galio,Ezreal,4097,2222,1875,54.23
Galio,Thresh,2395,1172,1223,48.94
Galio,Darius,3000,1524,1476,50.8
Galio,Viego,2366,1178,1188,49.79
Galio,AurelionSol,690,355,335,51.45
Galio,MissFortune,3622,1880,1742,51.91
Galio,Nautilus,2042,1067,975,52.25
Galio,Gwen,954,507,447,53.14
Galio,Mel,3708,1998,1710,53.88
Galio,Tristana,1539,852,687,55.36
Galio,Poppy,1109,561,548,50.59
Galio,Kayle,1059,574,485,54.2
Galio,Kayn,2270,1145,1125,50.44
Galio,Akali,2231,1177,1054,52.76
Galio,Soraka,897,439,458,48.94
Galio,Fiora,765,397,368,51.9
Galio,Amumu,1782,843,939,47.31
Galio,Vladimir,988,478,510,48.38
Galio,Varus,1498,761,737,50.8
Galio,Janna,489,229,260,46.83
Galio,Warwick,2498,1325,1173,53.04
Galio,Sejuani,612,284,328,46.41
Galio,Ahri,2477,1261,1216,50.91
Galio,Lux,4113,2056,2057,49.99
Galio,Singed,478,234,244,48.95
Galio,Vayne,1976,944,1032,47.77
Galio,Leona,1594,839,755,52.63
Galio,Volibear,1737,881,856,50.72
Galio,Rammus,607,315,292,51.89
Galio,Aurora,1462,807,655,55.2
Galio,Ashe,3296,1691,1605,51.3
Galio,Sylas,2990,1586,1404,53.04
Galio,FiddleSticks,856,435,421,50.82
Galio,Aphelios,820,413,407,50.37
Galio,Morgana,2018,1014,1004,50.25
Galio,Trundle,969,409,560,42.21
Galio,XinZhao,978,478,500,48.88
Galio,Mordekaiser,2234,1125,1109,50.36
Galio,Samira,1084,554,530,51.11
Galio,Shen,1082,547,535,50.55
Galio,Ekko,1546,800,746,51.75
Galio,Qiyana,368,203,165,55.16
Galio,Twitch,1235,595,640,48.18
Galio,Senna,1241,620,621,49.96
Galio,Talon,941,491,450,52.18
Galio,Chogath,1915,928,987,48.46
Galio,MasterYi,1883,981,902,52.1
Galio,Zed,1543,831,712,53.86
Galio,Aatrox,1527,772,755,50.56
Galio,Pyke,1443,703,740,48.72
Galio,Malphite,1683,886,797,52.64
Galio,Yone,3256,1703,1553,52.3
Galio,Lulu,2060,1072,988,52.04
Galio,Skarner,512,274,238,53.52
Galio,Zilean,489,214,275,43.76
Galio,Viktor,1385,692,693,49.96
Galio,Kindred,833,411,422,49.34
Galio,Lucian,1054,578,476,54.84
Galio,Sion,1338,688,650,51.42
Galio,Diana,2917,1572,1345,53.89
Galio,Orianna,680,362,318,53.24
Galio,Kaisa,2858,1579,1279,55.25
Galio,Khazix,760,423,337,55.66
Galio,Rell,828,441,387,53.26
Galio,Seraphine,1324,665,659,50.23
Galio,Rengar,581,355,226,61.1
Galio,Hwei,1265,652,613,51.54
Galio,Katarina,1483,839,644,56.57
Galio,Velkoz,986,496,490,50.3
Galio,Camille,610,356,254,58.36
Galio,Braum,805,440,365,54.66
Galio,Xayah,965,458,507,47.46
Galio,Rakan,741,397,344,53.58
Galio,Briar,1291,596,695,46.17
Galio,Heimerdinger,813,434,379,53.38
Galio,Zyra,1537,788,749,51.27
Galio,Fizz,1006,530,476,52.68
Galio,Sivir,915,480,435,52.46
Galio,Xerath,1415,674,741,47.63
Galio,Kennen,471,249,222,52.87
Galio,TwistedFate,563,305,258,54.17
Galio,Nocturne,1891,916,975,48.44
Galio,Annie,504,283,221,56.15
Galio,Swain,1854,939,915,50.65
Galio,Shyvana,436,214,222,49.08
Galio,Belveth,416,199,217,47.84
Galio,Smolder,1196,668,528,55.85
Galio,Sett,2702,1361,1341,50.37
Galio,Garen,2670,1348,1322,50.49
Galio,Yorick,1489,686,803,46.07
Galio,Vex,796,457,339,57.41
Galio,Karma,1841,971,870,52.74
Galio,Gragas,1028,594,434,57.78
Galio,Nunu,1052,605,447,57.51
Galio,Sona,502,244,258,48.61
Galio,Lillia,1056,575,481,54.45
Galio,Ziggs,742,416,326,56.06
Galio,Nasus,1113,563,550,50.58
Galio,Naafiri,513,272,241,53.02
Galio,Syndra,993,490,503,49.35
Galio,Blitzcrank,1174,601,573,51.19
Galio,LeeSin,2484,1329,1155,53.5
Galio,Ambessa,1177,666,511,56.58
Galio,Brand,1359,705,654,51.88
Galio,Azir,605,292,313,48.26
Galio,KogMaw,544,300,244,55.15
Galio,Nidalee,543,285,258,52.49
Galio,Evelynn,644,364,280,56.52
Galio,Riven,741,397,344,53.58
Galio,Vi,1683,935,748,55.56
Galio,Veigar,1578,753,825,47.72
Galio,Jayce,822,488,334,59.37
Galio,Illaoi,785,360,425,45.86
Galio,Malzahar,1791,893,898,49.86
Galio,Anivia,535,290,245,54.21
Galio,Draven,898,518,380,57.68
Galio,Alistar,683,367,316,53.73
Galio,RekSai,237,112,125,47.26
Galio,Taliyah,393,183,210,46.56
Galio,Renekton,826,417,409,50.48
Galio,Milio,823,409,414,49.7
Galio,Olaf,382,192,190,50.26
Galio,Tryndamere,789,368,421,46.64
Galio,Nilah,592,314,278,53.04
Galio,Gangplank,742,416,326,56.06
Galio,Graves,1048,497,551,47.42
Galio,Elise,1256,710,546,56.53
Galio,Cassiopeia,510,262,248,51.37
Galio,Corki,831,437,394,52.59
Galio,KSante,978,498,480,50.92
Galio,Zeri,793,429,364,54.1
Galio,Zac,802,363,439,45.26
Galio,DrMundo,1001,456,545,45.55
Galio,Renata,324,161,163,49.69
Galio,MonkeyKing,998,494,504,49.5
Galio,Ryze,598,285,313,47.66
Galio,Maokai,742,352,390,47.44
Galio,Quinn,610,305,305,50
Galio,Ornn,769,363,406,47.2
Galio,Lissandra,506,237,269,46.84
Galio,JarvanIV,951,448,503,47.11
Galio,Hecarim,598,353,245,59.03
Galio,Udyr,660,361,299,54.7
Galio,Kalista,526,273,253,51.9
Galio,Rumble,572,290,282,50.7
Galio,Karthus,480,263,217,54.79
Galio,Bard,512,273,239,53.32
Galio,Urgot,712,368,344,51.69
Galio,Taric,326,153,173,46.93
Galio,Kled,272,140,132,51.47
Galio,Akshan,458,249,209,54.37
Galio,Ivern,241,149,92,61.83
Gnar,Irelia,862,381,481,44.2
Gnar,Zed,930,487,443,52.37
Gnar,Galio,680,323,357,47.5
Gnar,MissFortune,1832,854,978,46.62
Gnar,TahmKench,835,369,466,44.19
Gnar,Naafiri,306,150,156,49.02
Gnar,Nunu,525,261,264,49.71
Gnar,Malzahar,816,381,435,46.69
Gnar,Zeri,367,170,197,46.32
Gnar,Mordekaiser,936,442,494,47.22
Gnar,Volibear,888,435,453,48.99
Gnar,Mel,1679,832,847,49.55
Gnar,Ashe,1510,745,765,49.34
Gnar,Neeko,431,211,220,48.96
Gnar,Amumu,842,366,476,43.47
Gnar,Pyke,686,347,339,50.58
Gnar,Varus,799,376,423,47.06
Gnar,Thresh,1176,568,608,48.3
Gnar,Sett,1264,622,642,49.21
Gnar,Warwick,1206,541,665,44.86
Gnar,Brand,596,294,302,49.33
Gnar,Twitch,684,300,384,43.86
Gnar,Morgana,895,425,470,47.49
Gnar,Tryndamere,421,213,208,50.59
Gnar,Sylas,1197,555,642,46.37
Gnar,Taliyah,241,114,127,47.3
Gnar,Jhin,1728,825,903,47.74
Gnar,Senna,673,333,340,49.48
Gnar,Darius,1610,784,826,48.7
Gnar,Kindred,383,195,188,50.91
Gnar,Veigar,828,392,436,47.34
Gnar,Corki,349,159,190,45.56
Gnar,Pantheon,1425,678,747,47.58
Gnar,Camille,298,136,162,45.64
Gnar,LeeSin,1173,588,585,50.13
Gnar,Draven,391,182,209,46.55
Gnar,Sion,638,297,341,46.55
Gnar,Zac,434,213,221,49.08
Gnar,AurelionSol,347,154,193,44.38
Gnar,Lux,1934,955,979,49.38
Gnar,Teemo,1003,464,539,46.26
Gnar,Evelynn,392,199,193,50.77
Gnar,Ezreal,1995,980,1015,49.12
Gnar,Seraphine,611,285,326,46.64
Gnar,Gangplank,438,205,233,46.8
Gnar,MasterYi,856,443,413,51.75
Gnar,Yone,1513,756,757,49.97
Gnar,Swain,865,372,493,43.01
Gnar,Gwen,402,231,171,57.46
Gnar,RekSai,135,78,57,57.78
Gnar,Kaisa,1302,688,614,52.84
Gnar,Leona,704,341,363,48.44
Gnar,Leblanc,475,208,267,43.79
Gnar,Aatrox,774,342,432,44.19
Gnar,Trundle,408,212,196,51.96
Gnar,Caitlyn,2138,1073,1065,50.19
Gnar,Lucian,591,274,317,46.36
Gnar,Karthus,272,158,114,58.09
Gnar,Kayn,1046,503,543,48.09
Gnar,Akali,859,411,448,47.85
Gnar,Sivir,438,237,201,54.11
Gnar,Hwei,562,251,311,44.66
Gnar,Poppy,569,281,288,49.38
Gnar,Kayle,453,212,241,46.8
Gnar,Fizz,414,205,209,49.52
Gnar,Jinx,2251,1062,1189,47.18
Gnar,Milio,522,196,326,37.55
Gnar,Rengar,314,177,137,56.37
Gnar,KogMaw,212,114,98,53.77
Gnar,Zoe,344,190,154,55.23
Gnar,Gragas,543,256,287,47.15
Gnar,Xayah,511,257,254,50.29
Gnar,Tristana,751,385,366,51.26
Gnar,Sona,219,118,101,53.88
Gnar,Nocturne,991,497,494,50.15
Gnar,Velkoz,503,214,289,42.54
Gnar,Karma,875,384,491,43.89
Gnar,Smolder,543,284,259,52.3
Gnar,Syndra,514,226,288,43.97
Gnar,Vi,820,401,419,48.9
Gnar,Nautilus,965,506,459,52.44
Gnar,Shaco,742,340,402,45.82
Gnar,Katarina,626,301,325,48.08
Gnar,Nami,900,416,484,46.22
Gnar,Yasuo,1605,764,841,47.6
Gnar,Lillia,441,182,259,41.27
Gnar,Malphite,1207,558,649,46.23
Gnar,Rakan,355,182,173,51.27
Gnar,Rell,417,200,217,47.96
Gnar,Garen,1253,628,625,50.12
Gnar,Lulu,1059,529,530,49.95
Gnar,Aphelios,395,191,204,48.35
Gnar,Azir,337,190,147,56.38
Gnar,Kennen,280,120,160,42.86
Gnar,Aurora,662,339,323,51.21
Gnar,XinZhao,548,241,307,43.98
Gnar,Viktor,758,391,367,51.58
Gnar,Kassadin,218,104,114,47.71
Gnar,Viego,1158,546,612,47.15
Gnar,Alistar,411,182,229,44.28
Gnar,Shen,583,252,331,43.22
Gnar,Maokai,349,183,166,52.44
Gnar,Nasus,512,249,263,48.63
Gnar,Talon,456,238,218,52.19
Gnar,Cassiopeia,259,102,157,39.38
Gnar,Vladimir,541,227,314,41.96
Gnar,Khazix,456,237,219,51.97
Gnar,Yuumi,670,348,322,51.94
Gnar,Sejuani,393,173,220,44.02
Gnar,Annie,284,145,139,51.06
Gnar,Lissandra,320,125,195,39.06
Gnar,Ivern,129,75,54,58.14
Gnar,Ambessa,544,235,309,43.2
Gnar,Zyra,690,310,380,44.93
Gnar,Illaoi,336,153,183,45.54
Gnar,Ekko,667,259,408,38.83
Gnar,Ahri,1162,544,618,46.82
Gnar,Samira,534,221,313,41.39
Gnar,Renekton,427,206,221,48.24
Gnar,Rammus,216,93,123,43.06
Gnar,Qiyana,226,143,83,63.27
Gnar,Udyr,346,177,169,51.16
Gnar,Soraka,438,210,228,47.95
Gnar,DrMundo,459,213,246,46.41
Gnar,Blitzcrank,606,334,272,55.12
Gnar,Jax,535,262,273,48.97
Gnar,Quinn,318,154,164,48.43
Gnar,Xerath,691,334,357,48.34
Gnar,Vayne,945,443,502,46.88
Gnar,KSante,501,280,221,55.89
Gnar,Diana,1221,552,669,45.21
Gnar,Bard,229,110,119,48.03
Gnar,Yorick,754,329,425,43.63
Gnar,Skarner,284,149,135,52.46
Gnar,Nilah,287,113,174,39.37
Gnar,JarvanIV,449,228,221,50.78
Gnar,Riven,318,145,173,45.6
Gnar,Graves,529,255,274,48.2
Gnar,Braum,483,245,238,50.72
Gnar,Renata,247,121,126,48.99
Gnar,Ziggs,292,112,180,38.36
Gnar,Janna,322,153,169,47.52
Gnar,Fiora,248,116,132,46.77
Gnar,FiddleSticks,405,203,202,50.12
Gnar,Chogath,1066,548,518,51.41
Gnar,Ornn,379,153,226,40.37
Gnar,Jayce,489,262,227,53.58
Gnar,Singed,227,88,139,38.77
Gnar,Heimerdinger,336,154,182,45.83
Gnar,Orianna,386,184,202,47.67
Gnar,Elise,634,263,371,41.48
Gnar,Kalista,273,140,133,51.28
Gnar,Nidalee,248,131,117,52.82
Gnar,Ryze,299,145,154,48.49
Gnar,Hecarim,284,129,155,45.42
Gnar,Kled,161,79,82,49.07
Gnar,Briar,588,247,341,42.01
Gnar,Zilean,270,127,143,47.04
Gnar,Urgot,420,177,243,42.14
Gnar,MonkeyKing,475,256,219,53.89
Gnar,Vex,470,222,248,47.23
Gnar,Anivia,333,172,161,51.65
Gnar,Rumble,248,123,125,49.6
Gnar,Shyvana,231,125,106,54.11
Gnar,Olaf,225,115,110,51.11
Gnar,TwistedFate,320,146,174,45.63
Gnar,Belveth,174,78,96,44.83
Gnar,Taric,196,88,108,44.9
Gnar,Akshan,262,124,138,47.33
Riven,Gangplank,438,224,214,51.14
Riven,Ivern,187,121,66,64.71
Riven,Mel,1961,1029,932,52.47
Riven,Jhin,1782,892,890,50.06
Riven,Swain,876,411,465,46.92
Riven,Urgot,556,253,303,45.5
Riven,Kayn,1278,607,671,47.5
Riven,Yasuo,1865,947,918,50.78
Riven,Twitch,762,366,396,48.03
Riven,Neeko,458,227,231,49.56
Riven,Gragas,513,262,251,51.07
Riven,Gwen,599,289,310,48.25
Riven,Zeri,412,195,217,47.33
Riven,Bard,296,139,157,46.96
Riven,Shen,625,315,310,50.4
Riven,Yone,1594,884,710,55.46
Riven,Ashe,1606,750,856,46.7
Riven,Alistar,352,143,209,40.63
Riven,XinZhao,634,251,383,39.59
Riven,Lucian,671,380,291,56.63
Riven,Velkoz,541,262,279,48.43
Riven,Evelynn,411,184,227,44.77
Riven,Irelia,716,313,403,43.72
Riven,Tristana,862,343,519,39.79
Riven,Lux,2026,918,1108,45.31
Riven,Azir,268,112,156,41.79
Riven,Sejuani,367,194,173,52.86
Riven,Sylas,1093,559,534,51.14
Riven,Seraphine,713,330,383,46.28
Riven,Mordekaiser,1244,558,686,44.86
Riven,Morgana,995,445,550,44.72
Riven,Braum,535,261,274,48.79
Riven,Aurora,656,294,362,44.82
Riven,FiddleSticks,538,248,290,46.1
Riven,Vex,414,201,213,48.55
Riven,Sett,1367,634,733,46.38
Riven,Akali,910,481,429,52.86
Riven,Samira,734,401,333,54.63
Riven,Udyr,329,142,187,43.16
Riven,Orianna,410,229,181,55.85
Riven,Nautilus,979,477,502,48.72
Riven,Yorick,690,319,371,46.23
Riven,MasterYi,934,475,459,50.86
Riven,Nami,987,442,545,44.78
Riven,Garen,1558,655,903,42.04
Riven,Zed,1104,586,518,53.08
Riven,Caitlyn,2182,1004,1178,46.01
Riven,Soraka,561,275,286,49.02
Riven,TahmKench,657,322,335,49.01
Riven,Malzahar,790,356,434,45.06
Riven,MissFortune,1728,777,951,44.97
Riven,Blitzcrank,694,369,325,53.17
Riven,LeeSin,1173,672,501,57.29
Riven,Ahri,1094,472,622,43.14
Riven,Darius,1840,906,934,49.24
Riven,Vladimir,651,312,339,47.93
Riven,Kindred,407,218,189,53.56
Riven,Sona,340,167,173,49.12
Riven,Khazix,517,275,242,53.19
Riven,Katarina,772,397,375,51.42
Riven,Aphelios,515,229,286,44.47
Riven,Lulu,1117,547,570,48.97
Riven,Briar,691,314,377,45.44
Riven,Corki,384,197,187,51.3
Riven,Pantheon,1320,535,785,40.53
Riven,Warwick,1227,554,673,45.15
Riven,Heimerdinger,303,158,145,52.15
Riven,Anivia,316,155,161,49.05
Riven,Viego,1303,657,646,50.42
Riven,Jax,763,368,395,48.23
Riven,Xayah,420,215,205,51.19
Riven,Fiora,486,251,235,51.65
Riven,Ezreal,1955,1002,953,51.25
Riven,Akshan,277,140,137,50.54
Riven,Syndra,615,292,323,47.48
Riven,Xerath,680,345,335,50.74
Riven,Karma,1102,541,561,49.09
Riven,Rengar,332,166,166,50
Riven,Naafiri,293,126,167,43
Riven,DrMundo,388,170,218,43.81
Riven,Jinx,2333,1054,1279,45.18
Riven,Ekko,984,467,517,47.46
Riven,Rakan,419,236,183,56.32
Riven,Diana,1308,589,719,45.03
Riven,Chogath,1003,442,561,44.07
Riven,Nunu,521,233,288,44.72
Riven,Viktor,729,362,367,49.66
Riven,Poppy,614,263,351,42.83
Riven,Zac,377,172,205,45.62
Riven,Kaisa,1430,730,700,51.05
Riven,Leblanc,457,233,224,50.98
Riven,Renekton,676,293,383,43.34
Riven,Rammus,345,138,207,40
Riven,Brand,518,254,264,49.03
Riven,Hecarim,380,170,210,44.74
Riven,Camille,366,199,167,54.37
Riven,Rell,526,242,284,46.01
Riven,JarvanIV,466,223,243,47.85
Riven,Zilean,295,158,137,53.56
Riven,KSante,417,190,227,45.56
Riven,Trundle,454,181,273,39.87
Riven,Kassadin,234,108,126,46.15
Riven,Milio,605,293,312,48.43
Riven,Nidalee,269,151,118,56.13
Riven,Pyke,744,339,405,45.56
Riven,Teemo,1007,458,549,45.48
Riven,Senna,704,345,359,49.01
Riven,Amumu,857,375,482,43.76
Riven,Qiyana,269,154,115,57.25
Riven,Zoe,356,177,179,49.72
Riven,Kled,156,44,112,28.21
Riven,Draven,605,297,308,49.09
Riven,Volibear,943,406,537,43.05
Riven,Yuumi,710,328,382,46.2
Riven,Annie,320,167,153,52.19
Riven,Nilah,324,111,213,34.26
Riven,Aatrox,709,341,368,48.1
Riven,Shaco,791,370,421,46.78
Riven,Thresh,1268,571,697,45.03
Riven,Kennen,328,185,143,56.4
Riven,Ryze,254,133,121,52.36
Riven,Taric,264,106,158,40.15
Riven,Malphite,945,390,555,41.27
Riven,Ambessa,656,376,280,57.32
Riven,Singed,260,97,163,37.31
Riven,Renata,200,94,106,47
Riven,Vi,845,381,464,45.09
Riven,Ziggs,380,191,189,50.26
Riven,Veigar,886,373,513,42.1
Riven,Graves,530,276,254,52.08
Riven,Cassiopeia,258,126,132,48.84
Riven,Maokai,361,166,195,45.98
Riven,Vayne,1123,593,530,52.8
Riven,Zyra,671,322,349,47.99
Riven,Illaoi,414,167,247,40.34
Riven,Galio,741,344,397,46.42
Riven,Tryndamere,472,250,222,52.97
Riven,Lillia,468,205,263,43.8
Riven,Leona,595,270,325,45.38
Riven,Sion,721,319,402,44.24
Riven,Skarner,257,140,117,54.47
Riven,Lissandra,302,152,150,50.33
Riven,Karthus,266,133,133,50
Riven,Gnar,318,173,145,54.4
Riven,MonkeyKing,624,282,342,45.19
Riven,Sivir,479,212,267,44.26
Riven,Varus,725,379,346,52.28
Riven,Shyvana,196,104,92,53.06
Riven,Smolder,541,277,264,51.2
Riven,Elise,679,337,342,49.63
Riven,Hwei,629,303,326,48.17
Riven,KogMaw,291,145,146,49.83
Riven,Ornn,374,138,236,36.9
Riven,Fizz,499,207,292,41.48
Riven,Talon,568,307,261,54.05
Riven,Kayle,531,247,284,46.52
Riven,AurelionSol,307,126,181,41.04
Riven,Nocturne,892,420,472,47.09
Riven,Janna,365,158,207,43.29
Riven,Nasus,623,282,341,45.26
Riven,TwistedFate,327,153,174,46.79
Riven,Kalista,253,116,137,45.85
Riven,Rumble,257,117,140,45.53
Riven,Jayce,439,210,229,47.84
Riven,Belveth,182,87,95,47.8
Riven,Taliyah,235,101,134,42.98
Riven,Quinn,310,155,155,50
Riven,Olaf,151,71,80,47.02
Riven,RekSai,135,63,72,46.67
AurelionSol,Heimerdinger,409,202,207,49.39
AurelionSol,Warwick,1175,649,526,55.23
AurelionSol,Neeko,451,268,183,59.42
AurelionSol,Draven,383,213,170,55.61
AurelionSol,Leona,744,391,353,52.55
AurelionSol,Talon,399,232,167,58.15
AurelionSol,Ahri,1067,539,528,50.52
AurelionSol,Kalista,284,179,105,63.03
AurelionSol,Brand,585,295,290,50.43
AurelionSol,Braum,480,266,214,55.42
AurelionSol,XinZhao,379,202,177,53.3
AurelionSol,Lux,2243,1212,1031,54.03
AurelionSol,Chogath,1119,580,539,51.83
AurelionSol,Taliyah,239,140,99,58.58
AurelionSol,Poppy,458,254,204,55.46
AurelionSol,Diana,1082,537,545,49.63
AurelionSol,Anivia,302,138,164,45.7
AurelionSol,Caitlyn,2120,1080,1040,50.94
AurelionSol,Thresh,974,462,512,47.43
AurelionSol,Fiora,309,171,138,55.34
AurelionSol,Yone,1378,693,685,50.29
AurelionSol,Galio,690,335,355,48.55
AurelionSol,Ezreal,1690,865,825,51.18
AurelionSol,Tristana,742,348,394,46.9
AurelionSol,Veigar,1010,535,475,52.97
AurelionSol,Ziggs,369,157,212,42.55
AurelionSol,KSante,346,171,175,49.42
AurelionSol,Udyr,316,182,134,57.59
AurelionSol,Ashe,1434,735,699,51.26
AurelionSol,Nautilus,893,439,454,49.16
AurelionSol,Aurora,569,315,254,55.36
AurelionSol,FiddleSticks,374,208,166,55.61
AurelionSol,Yasuo,1566,772,794,49.3
AurelionSol,Jhin,1523,772,751,50.69
AurelionSol,Vex,321,180,141,56.07
AurelionSol,Gnar,347,193,154,55.62
AurelionSol,Volibear,886,475,411,53.61
AurelionSol,Mel,2207,1172,1035,53.1
AurelionSol,Samira,640,354,286,55.31
AurelionSol,Seraphine,735,349,386,47.48
AurelionSol,Pantheon,1181,612,569,51.82
AurelionSol,Kindred,354,170,184,48.02
AurelionSol,Teemo,1014,488,526,48.13
AurelionSol,Lucian,542,317,225,58.49
AurelionSol,Zyra,632,305,327,48.26
AurelionSol,Khazix,367,187,180,50.95
AurelionSol,Varus,646,301,345,46.59
AurelionSol,Yuumi,659,325,334,49.32
AurelionSol,TahmKench,754,426,328,56.5
AurelionSol,Nocturne,906,474,432,52.32
AurelionSol,Qiyana,213,101,112,47.42
AurelionSol,Sett,1225,596,629,48.65
AurelionSol,Briar,726,384,342,52.89
AurelionSol,Nilah,321,162,159,50.47
AurelionSol,Morgana,898,411,487,45.77
AurelionSol,Kayn,1093,538,555,49.22
AurelionSol,Akali,683,368,315,53.88
AurelionSol,Sivir,432,206,226,47.69
AurelionSol,Hwei,573,302,271,52.71
AurelionSol,Urgot,461,216,245,46.85
AurelionSol,Sylas,770,401,369,52.08
AurelionSol,Zed,693,349,344,50.36
AurelionSol,Rakan,366,177,189,48.36
AurelionSol,Zoe,317,160,157,50.47
AurelionSol,Nunu,546,304,242,55.68
AurelionSol,Katarina,618,294,324,47.57
AurelionSol,Pyke,782,433,349,55.37
AurelionSol,Ekko,669,344,325,51.42
AurelionSol,Shaco,812,457,355,56.28
AurelionSol,Velkoz,528,261,267,49.43
AurelionSol,Darius,1499,744,755,49.63
AurelionSol,Jax,739,386,353,52.23
AurelionSol,MissFortune,1985,1053,932,53.05
AurelionSol,Illaoi,385,202,183,52.47
AurelionSol,Ryze,275,143,132,52
AurelionSol,Blitzcrank,637,349,288,54.79
AurelionSol,Yorick,853,439,414,51.47
AurelionSol,Viego,1071,477,594,44.54
AurelionSol,Vi,790,394,396,49.87
AurelionSol,Singed,259,148,111,57.14
AurelionSol,Gwen,445,265,180,59.55
AurelionSol,Amumu,919,418,501,45.48
AurelionSol,Garen,1187,530,657,44.65
AurelionSol,Jinx,2045,1007,1038,49.24
AurelionSol,Nami,729,395,334,54.18
AurelionSol,Mordekaiser,1146,510,636,44.5
AurelionSol,Rengar,245,133,112,54.29
AurelionSol,Hecarim,363,180,183,49.59
AurelionSol,Twitch,650,358,292,55.08
AurelionSol,DrMundo,489,255,234,52.15
AurelionSol,Graves,560,300,260,53.57
AurelionSol,Zac,337,193,144,57.27
AurelionSol,Irelia,578,315,263,54.5
AurelionSol,Alistar,289,167,122,57.79
AurelionSol,Evelynn,384,254,130,66.15
AurelionSol,Syndra,571,308,263,53.94
AurelionSol,Kled,165,83,82,50.3
AurelionSol,Lillia,520,217,303,41.73
AurelionSol,MonkeyKing,492,258,234,52.44
AurelionSol,Elise,545,295,250,54.13
AurelionSol,Kayle,544,269,275,49.45
AurelionSol,Vladimir,474,261,213,55.06
AurelionSol,Malphite,725,379,346,52.28
AurelionSol,Kassadin,148,70,78,47.3
AurelionSol,Sion,661,334,327,50.53
AurelionSol,Leblanc,319,135,184,42.32
AurelionSol,LeeSin,945,493,452,52.17
AurelionSol,MasterYi,921,467,454,50.71
AurelionSol,Kaisa,1193,633,560,53.06
AurelionSol,Vayne,973,471,502,48.41
AurelionSol,Nidalee,230,116,114,50.43
AurelionSol,Aphelios,440,219,221,49.77
AurelionSol,Xerath,598,303,295,50.67
AurelionSol,Soraka,476,267,209,56.09
AurelionSol,Jayce,411,228,183,55.47
AurelionSol,Milio,418,203,215,48.56
AurelionSol,Shen,545,281,264,51.56
AurelionSol,Naafiri,332,149,183,44.88
AurelionSol,Zeri,326,170,156,52.15
AurelionSol,TwistedFate,294,160,134,54.42
AurelionSol,Sona,246,117,129,47.56
AurelionSol,Malzahar,1063,571,492,53.72
AurelionSol,Aatrox,740,422,318,57.03
AurelionSol,Karthus,238,109,129,45.8
AurelionSol,Taric,240,135,105,56.25
AurelionSol,Ambessa,499,257,242,51.5
AurelionSol,Viktor,688,368,320,53.49
AurelionSol,Senna,706,346,360,49.01
AurelionSol,KogMaw,285,162,123,56.84
AurelionSol,Maokai,362,177,185,48.9
AurelionSol,Quinn,286,164,122,57.34
AurelionSol,Lulu,821,420,401,51.16
AurelionSol,Trundle,539,278,261,51.58
AurelionSol,Ornn,314,157,157,50
AurelionSol,JarvanIV,455,235,220,51.65
AurelionSol,Shyvana,193,85,108,44.04
AurelionSol,Fizz,511,246,265,48.14
AurelionSol,Rammus,231,127,104,54.98
AurelionSol,Zilean,219,111,108,50.68
AurelionSol,Xayah,370,218,152,58.92
AurelionSol,Karma,736,401,335,54.48
AurelionSol,Nasus,692,346,346,50
AurelionSol,Olaf,189,95,94,50.26
AurelionSol,Riven,307,181,126,58.96
AurelionSol,Swain,776,415,361,53.48
AurelionSol,Tryndamere,492,255,237,51.83
AurelionSol,Sejuani,314,165,149,52.55
AurelionSol,Gragas,426,227,199,53.29
AurelionSol,Smolder,522,300,222,57.47
AurelionSol,Skarner,239,123,116,51.46
AurelionSol,Renata,146,81,65,55.48
AurelionSol,Rell,511,291,220,56.95
AurelionSol,RekSai,96,50,46,52.08
AurelionSol,Corki,269,157,112,58.36
AurelionSol,Orianna,362,191,171,52.76
AurelionSol,Bard,233,130,103,55.79
AurelionSol,Lissandra,246,113,133,45.93
AurelionSol,Camille,278,160,118,57.55
AurelionSol,Janna,255,151,104,59.22
AurelionSol,Akshan,283,148,135,52.3
AurelionSol,Rumble,156,63,93,40.38
AurelionSol,Ivern,167,105,62,62.87
AurelionSol,Belveth,186,99,87,53.23
AurelionSol,Annie,253,132,121,52.17
AurelionSol,Gangplank,316,171,145,54.11
AurelionSol,Renekton,372,194,178,52.15
AurelionSol,Azir,250,159,91,63.6
AurelionSol,Kennen,200,101,99,50.5
AurelionSol,Cassiopeia,233,88,145,37.77
Heimerdinger,Yone,1935,1075,860,55.56
Heimerdinger,Shaco,982,541,441,55.09
Heimerdinger,AurelionSol,409,207,202,50.61
Heimerdinger,Ashe,1898,934,964,49.21
Heimerdinger,Velkoz,578,276,302,47.75
Heimerdinger,Yorick,1019,479,540,47.01
Heimerdinger,Kayn,1512,811,701,53.64
Heimerdinger,Singed,305,137,168,44.92
Heimerdinger,Udyr,307,168,139,54.72
Heimerdinger,Mordekaiser,1424,762,662,53.51
Heimerdinger,Briar,765,343,422,44.84
Heimerdinger,Zed,998,523,475,52.4
Heimerdinger,Jinx,2523,1237,1286,49.03
Heimerdinger,Lillia,636,332,304,52.2
Heimerdinger,Darius,1982,1047,935,52.83
Heimerdinger,Volibear,1065,522,543,49.01
Heimerdinger,Caitlyn,2522,1322,1200,52.42
Heimerdinger,TahmKench,893,462,431,51.74
Heimerdinger,Garen,1417,705,712,49.75
Heimerdinger,Tristana,889,489,400,55.01
Heimerdinger,Lux,2747,1357,1390,49.4
Heimerdinger,Morgana,1365,741,624,54.29
Heimerdinger,Warwick,1615,838,777,51.89
Heimerdinger,Akali,1020,580,440,56.86
Heimerdinger,Akshan,394,186,208,47.21
Heimerdinger,Pantheon,1489,824,665,55.34
Heimerdinger,Leblanc,408,252,156,61.76
Heimerdinger,Aphelios,548,319,229,58.21
Heimerdinger,Leona,768,417,351,54.3
Heimerdinger,Nunu,754,360,394,47.75
Heimerdinger,KSante,317,183,134,57.73
Heimerdinger,Zeri,358,171,187,47.77
Heimerdinger,Lulu,926,422,504,45.57
Heimerdinger,Malphite,899,486,413,54.06
Heimerdinger,Jhin,1927,973,954,50.49
Heimerdinger,Evelynn,374,209,165,55.88
Heimerdinger,Gragas,495,276,219,55.76
Heimerdinger,Pyke,920,504,416,54.78
Heimerdinger,MasterYi,1099,563,536,51.23
Heimerdinger,Aatrox,795,450,345,56.6
Heimerdinger,Viego,1126,582,544,51.69
Heimerdinger,Fizz,578,315,263,54.5
Heimerdinger,Taric,182,96,86,52.75
Heimerdinger,Trundle,558,253,305,45.34
Heimerdinger,Nocturne,1073,554,519,51.63
Heimerdinger,Orianna,461,234,227,50.76
Heimerdinger,Veigar,1191,569,622,47.77
Heimerdinger,Brand,812,396,416,48.77
Heimerdinger,Ivern,142,87,55,61.27
Heimerdinger,Katarina,792,443,349,55.93
Heimerdinger,Nami,876,492,384,56.16
Heimerdinger,Teemo,1559,804,755,51.57
Heimerdinger,Vi,851,443,408,52.06
Heimerdinger,Bard,227,120,107,52.86
Heimerdinger,Vladimir,644,328,316,50.93
Heimerdinger,Sylas,1196,752,444,62.88
Heimerdinger,Ekko,883,448,435,50.74
Heimerdinger,Syndra,667,347,320,52.02
Heimerdinger,Samira,803,422,381,52.55
Heimerdinger,Maokai,368,200,168,54.35
Heimerdinger,Swain,1013,506,507,49.95
Heimerdinger,MonkeyKing,566,262,304,46.29
Heimerdinger,Ezreal,1930,1035,895,53.63
Heimerdinger,Tryndamere,631,330,301,52.3
Heimerdinger,Irelia,848,486,362,57.31
Heimerdinger,Nautilus,994,508,486,51.11
Heimerdinger,Olaf,263,140,123,53.23
Heimerdinger,Aurora,783,415,368,53
Heimerdinger,Kaisa,1325,741,584,55.92
Heimerdinger,Poppy,486,287,199,59.05
Heimerdinger,Illaoi,505,302,203,59.8
Heimerdinger,Anivia,306,126,180,41.18
Heimerdinger,JarvanIV,335,161,174,48.06
Heimerdinger,MissFortune,2540,1261,1279,49.65
Heimerdinger,RekSai,120,66,54,55
Heimerdinger,Seraphine,1017,579,438,56.93
Heimerdinger,Riven,303,145,158,47.85
Heimerdinger,Hwei,644,342,302,53.11
Heimerdinger,Vex,608,273,335,44.9
Heimerdinger,Mel,1941,1067,874,54.97
Heimerdinger,Twitch,786,389,397,49.49
Heimerdinger,Xayah,498,262,236,52.61
Heimerdinger,Rengar,287,143,144,49.83
Heimerdinger,Shen,646,330,316,51.08
Heimerdinger,Thresh,1101,602,499,54.68
Heimerdinger,Gwen,484,272,212,56.2
Heimerdinger,Blitzcrank,720,378,342,52.5
Heimerdinger,Xerath,712,364,348,51.12
Heimerdinger,Yasuo,1994,962,1032,48.24
Heimerdinger,Sett,1624,823,801,50.68
Heimerdinger,Lucian,635,324,311,51.02
Heimerdinger,LeeSin,1121,648,473,57.81
Heimerdinger,Malzahar,904,419,485,46.35
Heimerdinger,Galio,813,379,434,46.62
Heimerdinger,Yuumi,707,400,307,56.58
Heimerdinger,Viktor,677,346,331,51.11
Heimerdinger,Graves,450,244,206,54.22
Heimerdinger,Diana,1447,790,657,54.6
Heimerdinger,Draven,472,251,221,53.18
Heimerdinger,Nidalee,233,122,111,52.36
Heimerdinger,Amumu,1041,505,536,48.51
Heimerdinger,Renata,180,75,105,41.67
Heimerdinger,Smolder,660,362,298,54.85
Heimerdinger,Rell,461,221,240,47.94
Heimerdinger,Varus,703,396,307,56.33
Heimerdinger,Jax,784,442,342,56.38
Heimerdinger,Sivir,434,244,190,56.22
Heimerdinger,Sona,391,190,201,48.59
Heimerdinger,Kled,177,104,73,58.76
Heimerdinger,Nasus,876,441,435,50.34
Heimerdinger,Kalista,277,161,116,58.12
Heimerdinger,Ambessa,451,252,199,55.88
Heimerdinger,Naafiri,393,214,179,54.45
Heimerdinger,Milio,424,219,205,51.65
Heimerdinger,Ryze,306,141,165,46.08
Heimerdinger,XinZhao,568,308,260,54.23
Heimerdinger,Chogath,1177,566,611,48.09
Heimerdinger,Khazix,503,301,202,59.84
Heimerdinger,Nilah,340,210,130,61.76
Heimerdinger,Senna,694,373,321,53.75
Heimerdinger,Zyra,834,396,438,47.48
Heimerdinger,Ziggs,442,229,213,51.81
Heimerdinger,FiddleSticks,458,243,215,53.06
Heimerdinger,Braum,477,239,238,50.1
Heimerdinger,Camille,220,123,97,55.91
Heimerdinger,Vayne,1105,615,490,55.66
Heimerdinger,Neeko,653,366,287,56.05
Heimerdinger,Qiyana,238,132,106,55.46
Heimerdinger,Soraka,538,265,273,49.26
Heimerdinger,Kayle,597,319,278,53.43
Heimerdinger,Corki,293,184,109,62.8
Heimerdinger,Taliyah,227,114,113,50.22
Heimerdinger,Rakan,397,206,191,51.89
Heimerdinger,Annie,288,160,128,55.56
Heimerdinger,Talon,504,323,181,64.09
Heimerdinger,Quinn,384,223,161,58.07
Heimerdinger,DrMundo,625,330,295,52.8
Heimerdinger,Elise,552,285,267,51.63
Heimerdinger,Gnar,336,182,154,54.17
Heimerdinger,Belveth,255,145,110,56.86
Heimerdinger,Urgot,432,199,233,46.06
Heimerdinger,Kindred,440,229,211,52.05
Heimerdinger,Karma,868,469,399,54.03
Heimerdinger,Sejuani,334,174,160,52.1
Heimerdinger,Zoe,309,188,121,60.84
Heimerdinger,Zilean,332,146,186,43.98
Heimerdinger,TwistedFate,290,173,117,59.66
Heimerdinger,Rammus,276,138,138,50
Heimerdinger,Fiora,353,192,161,54.39
Heimerdinger,Renekton,387,189,198,48.84
Heimerdinger,Ahri,1253,679,574,54.19
Heimerdinger,Kennen,310,170,140,54.84
Heimerdinger,Shyvana,263,116,147,44.11
Heimerdinger,Zac,408,197,211,48.28
Heimerdinger,Jayce,485,293,192,60.41
Heimerdinger,Azir,298,181,117,60.74
Heimerdinger,Ornn,367,207,160,56.4
Heimerdinger,Skarner,250,144,106,57.6
Heimerdinger,Gangplank,427,216,211,50.59
Heimerdinger,Alistar,355,208,147,58.59
Heimerdinger,Lissandra,278,140,138,50.36
Heimerdinger,Rumble,231,127,104,54.98
Heimerdinger,Karthus,272,100,172,36.76
Heimerdinger,Sion,777,378,399,48.65
Heimerdinger,Janna,252,148,104,58.73
Heimerdinger,Kassadin,224,77,147,34.38
Heimerdinger,Cassiopeia,284,138,146,48.59
Heimerdinger,KogMaw,301,129,172,42.86
Heimerdinger,Hecarim,291,163,128,56.01
Nocturne,Teemo,2962,1491,1471,50.34
Nocturne,TahmKench,1901,969,932,50.97
Nocturne,Jinx,5868,3010,2858,51.3
Nocturne,Zoe,843,460,383,54.57
Nocturne,Nami,2197,1168,1029,53.16
Nocturne,Gragas,1180,650,530,55.08
Nocturne,Gwen,1208,619,589,51.24
Nocturne,Yasuo,4464,2487,1977,55.71
Nocturne,Zeri,951,426,525,44.79
Nocturne,Bard,644,295,349,45.81
Nocturne,Sylas,3252,1593,1659,48.99
Nocturne,Ekko,2102,1089,1013,51.81
Nocturne,Talon,1275,594,681,46.59
Nocturne,Pyke,1908,912,996,47.8
Nocturne,Yorick,2136,1119,1017,52.39
Nocturne,Ezreal,5018,2660,2358,53.01
Nocturne,Lux,5915,3167,2748,53.54
Nocturne,Fiora,812,456,356,56.16
Nocturne,LeeSin,3305,1846,1459,55.85
Nocturne,Ziggs,839,431,408,51.37
Nocturne,Senna,1714,938,776,54.73
Nocturne,Illaoi,1070,528,542,49.35
Nocturne,Khazix,1170,639,531,54.62
Nocturne,Syndra,1410,755,655,53.55
Nocturne,Kaisa,3722,1967,1755,52.85
Nocturne,Kennen,631,310,321,49.13
Nocturne,Skarner,599,329,270,54.92
Nocturne,Malzahar,2309,1254,1055,54.31
Nocturne,Yuumi,1880,955,925,50.8
Nocturne,Akali,2328,1185,1143,50.9
Nocturne,Naafiri,807,456,351,56.51
Nocturne,Kayle,1434,663,771,46.23
Nocturne,MissFortune,5214,2632,2582,50.48
Nocturne,Smolder,1528,850,678,55.63
Nocturne,Evelynn,1001,554,447,55.34
Nocturne,Brand,1742,891,851,51.15
Nocturne,Sett,3490,1786,1704,51.17
Nocturne,FiddleSticks,1110,580,530,52.25
Nocturne,Tristana,2284,1232,1052,53.94
Nocturne,Blitzcrank,1771,995,776,56.18
Nocturne,Ornn,1028,524,504,50.97
Nocturne,Amumu,2585,1240,1345,47.97
Nocturne,Katarina,1587,859,728,54.13
Nocturne,Twitch,1846,992,854,53.74
Nocturne,RekSai,258,125,133,48.45
Nocturne,Hwei,1500,733,767,48.87
Nocturne,Ashe,4424,2333,2091,52.74
Nocturne,Braum,1294,671,623,51.85
Nocturne,MasterYi,2831,1379,1452,48.71
Nocturne,Shaco,2357,1232,1125,52.27
Nocturne,Azir,747,420,327,56.22
Nocturne,Rengar,833,475,358,57.02
Nocturne,Kindred,1094,562,532,51.37
Nocturne,Veigar,2290,1178,1112,51.44
Nocturne,Yone,4034,2093,1941,51.88
Nocturne,Lulu,2744,1475,1269,53.75
Nocturne,Neeko,1172,631,541,53.84
Nocturne,Kayn,3460,1856,1604,53.64
Nocturne,Heimerdinger,1073,519,554,48.37
Nocturne,Corki,992,567,425,57.16
Nocturne,Elise,1701,899,802,52.85
Nocturne,Darius,4130,2199,1931,53.24
Nocturne,Karma,2322,1181,1141,50.86
Nocturne,Briar,1978,981,997,49.6
Nocturne,Cassiopeia,597,323,274,54.1
Nocturne,Jhin,4605,2460,2145,53.42
Nocturne,KSante,1134,621,513,54.76
Nocturne,Ahri,2963,1588,1375,53.59
Nocturne,Caitlyn,5924,3225,2699,54.44
Nocturne,Garen,3669,1847,1822,50.34
Nocturne,AurelionSol,906,432,474,47.68
Nocturne,Kalista,662,340,322,51.36
Nocturne,Singed,661,336,325,50.83
Nocturne,Varus,1847,1010,837,54.68
Nocturne,Maokai,1000,512,488,51.2
Nocturne,Warwick,3681,1840,1841,49.99
Nocturne,Lucian,1637,819,818,50.03
Nocturne,Zilean,847,411,436,48.52
Nocturne,Sona,747,407,340,54.48
Nocturne,Ivern,366,187,179,51.09
Nocturne,Irelia,2059,1166,893,56.63
Nocturne,Poppy,1344,717,627,53.35
Nocturne,Mordekaiser,2896,1471,1425,50.79
Nocturne,Akshan,773,385,388,49.81
Nocturne,Jax,2145,1102,1043,51.38
Nocturne,Volibear,2745,1426,1319,51.95
Nocturne,Ambessa,1502,873,629,58.12
Nocturne,Mel,4552,2598,1954,57.07
Nocturne,Xayah,1273,656,617,51.53
Nocturne,Rakan,899,436,463,48.5
Nocturne,Sejuani,930,508,422,54.62
Nocturne,Urgot,1192,575,617,48.24
Nocturne,Seraphine,1895,997,898,52.61
Nocturne,Gangplank,1107,640,467,57.81
Nocturne,Kled,393,210,183,53.44
Nocturne,Pantheon,3768,2037,1731,54.06
Nocturne,Vex,1336,666,670,49.85
Nocturne,Chogath,2701,1457,1244,53.94
Nocturne,Aphelios,1255,683,572,54.42
Nocturne,Karthus,633,324,309,51.18
Nocturne,Taliyah,533,305,228,57.22
Nocturne,Morgana,2776,1488,1288,53.6
Nocturne,Viego,2944,1475,1469,50.1
Nocturne,Leblanc,1284,699,585,54.44
Nocturne,Gnar,991,494,497,49.85
Nocturne,Samira,1567,748,819,47.73
Nocturne,Leona,2021,1078,943,53.34
Nocturne,Draven,1139,603,536,52.94
Nocturne,Zed,2469,1287,1182,52.13
Nocturne,Lillia,1306,693,613,53.06
Nocturne,Trundle,1402,757,645,53.99
Nocturne,Lissandra,718,387,331,53.9
Nocturne,JarvanIV,1358,661,697,48.67
Nocturne,Tryndamere,1130,616,514,54.51
Nocturne,Orianna,982,491,491,50
Nocturne,Diana,3567,1832,1735,51.36
Nocturne,Kassadin,483,222,261,45.96
Nocturne,Galio,1891,975,916,51.56
Nocturne,Swain,2143,973,1170,45.4
Nocturne,Nilah,873,467,406,53.49
Nocturne,Nautilus,2446,1291,1155,52.78
Nocturne,Nasus,1526,773,753,50.66
Nocturne,Zyra,2126,1074,1052,50.52
Nocturne,Ryze,811,429,382,52.9
Nocturne,Janna,640,318,322,49.69
Nocturne,Vi,2261,1261,1000,55.77
Nocturne,Vladimir,1477,732,745,49.56
Nocturne,Malphite,2242,1217,1025,54.28
Nocturne,Thresh,3027,1557,1470,51.44
Nocturne,Quinn,850,424,426,49.88
Nocturne,Hecarim,856,441,415,51.52
Nocturne,Renekton,974,490,484,50.31
Nocturne,Qiyana,565,312,253,55.22
Nocturne,Vayne,2601,1257,1344,48.33
Nocturne,Viktor,1790,894,896,49.94
Nocturne,Annie,700,412,288,58.86
Nocturne,Shen,1341,732,609,54.59
Nocturne,Jayce,963,536,427,55.66
Nocturne,Aatrox,2071,1178,893,56.88
Nocturne,Nunu,1476,748,728,50.68
Nocturne,Fizz,1253,637,616,50.84
Nocturne,Rell,1218,661,557,54.27
Nocturne,Sivir,1264,632,632,50
Nocturne,Velkoz,1450,718,732,49.52
Nocturne,Camille,759,443,316,58.37
Nocturne,Soraka,1190,590,600,49.58
Nocturne,Alistar,865,504,361,58.27
Nocturne,XinZhao,1550,766,784,49.42
Nocturne,Graves,1361,769,592,56.5
Nocturne,Anivia,661,334,327,50.53
Nocturne,Aurora,1719,926,793,53.87
Nocturne,Renata,452,231,221,51.11
Nocturne,Zac,1044,494,550,47.32
Nocturne,DrMundo,1311,640,671,48.82
Nocturne,Olaf,547,290,257,53.02
Nocturne,Xerath,1987,1106,881,55.66
Nocturne,Taric,443,218,225,49.21
Nocturne,MonkeyKing,1643,838,805,51
Nocturne,Rumble,511,283,228,55.38
Nocturne,Sion,1616,814,802,50.37
Nocturne,Shyvana,605,315,290,52.07
Nocturne,Milio,1128,548,580,48.58
Nocturne,Udyr,847,421,426,49.7
Nocturne,Riven,892,472,420,52.91
Nocturne,KogMaw,631,334,297,52.93
Nocturne,Rammus,745,407,338,54.63
Nocturne,TwistedFate,774,451,323,58.27
Nocturne,Nidalee,653,364,289,55.74
Nocturne,Belveth,588,362,226,61.56
Ornn,Akali,913,461,452,50.49
Ornn,MissFortune,1762,913,849,51.82
Ornn,Kassadin,181,79,102,43.65
Ornn,Kayn,1280,687,593,53.67
Ornn,Sona,293,160,133,54.61
Ornn,Vladimir,542,303,239,55.9
Ornn,Zac,391,192,199,49.1
Ornn,Cassiopeia,234,124,110,52.99
Ornn,Irelia,756,369,387,48.81
Ornn,Lux,2215,1182,1033,53.36
Ornn,Jax,698,357,341,51.15
Ornn,Elise,602,317,285,52.66
Ornn,Kaisa,1346,742,604,55.13
Ornn,Twitch,699,349,350,49.93
Ornn,Yuumi,657,329,328,50.08
Ornn,Gangplank,436,214,222,49.08
Ornn,Nocturne,1028,504,524,49.03
Ornn,Yasuo,1611,784,827,48.67
Ornn,Corki,341,159,182,46.63
Ornn,Ambessa,604,295,309,48.84
Ornn,Kalista,284,159,125,55.99
Ornn,Swain,869,392,477,45.11
Ornn,Garen,1396,735,661,52.65
Ornn,LeeSin,1329,679,650,51.09
Ornn,Aurora,701,362,339,51.64
Ornn,Rell,462,228,234,49.35
Ornn,Aatrox,819,425,394,51.89
Ornn,Vi,850,442,408,52
Ornn,Yone,1463,775,688,52.97
Ornn,Nasus,559,276,283,49.37
Ornn,Sion,634,348,286,54.89
Ornn,Yorick,779,353,426,45.31
Ornn,Xerath,703,380,323,54.05
Ornn,Jhin,1728,884,844,51.16
Ornn,Lulu,987,513,474,51.98
Ornn,Trundle,527,254,273,48.2
Ornn,MasterYi,901,448,453,49.72
Ornn,Ahri,1089,589,500,54.09
Ornn,Varus,839,387,452,46.13
Ornn,Gragas,544,293,251,53.86
Ornn,Syndra,573,306,267,53.4
Ornn,Sett,1315,619,696,47.07
Ornn,Kled,198,85,113,42.93
Ornn,Warwick,1336,599,737,44.84
Ornn,Taliyah,232,127,105,54.74
Ornn,Ezreal,1858,1025,833,55.17
Ornn,TahmKench,710,381,329,53.66
Ornn,Teemo,1022,537,485,52.54
Ornn,Graves,486,233,253,47.94
Ornn,Zoe,367,191,176,52.04
Ornn,Katarina,592,260,332,43.92
Ornn,Quinn,287,135,152,47.04
Ornn,Shaco,673,341,332,50.67
Ornn,Darius,1535,766,769,49.9
Ornn,Braum,507,236,271,46.55
Ornn,Viego,1182,590,592,49.92
Ornn,Zed,888,482,406,54.28
Ornn,Soraka,512,250,262,48.83
Ornn,Vayne,1141,560,581,49.08
Ornn,Briar,625,313,312,50.08
Ornn,Orianna,453,208,245,45.92
Ornn,Mel,1583,804,779,50.79
Ornn,Jinx,2218,1127,1091,50.81
Ornn,Thresh,1078,557,521,51.67
Ornn,Kayle,612,289,323,47.22
Ornn,XinZhao,528,281,247,53.22
Ornn,Vex,479,246,233,51.36
Ornn,Ashe,1665,850,815,51.05
Ornn,Veigar,803,345,458,42.96
Ornn,Tristana,893,483,410,54.09
Ornn,Nautilus,1043,576,467,55.23
Ornn,Khazix,410,242,168,59.02
Ornn,Sylas,1268,692,576,54.57
Ornn,Xayah,478,229,249,47.91
Ornn,Rakan,416,208,208,50
Ornn,Fizz,435,193,242,44.37
Ornn,Pantheon,1444,752,692,52.08
Ornn,Volibear,915,433,482,47.32
Ornn,Morgana,1010,469,541,46.44
Ornn,Ekko,730,396,334,54.25
Ornn,Caitlyn,2173,1103,1070,50.76
Ornn,Brand,515,280,235,54.37
Ornn,KSante,551,270,281,49
Ornn,Poppy,501,253,248,50.5
Ornn,Bard,315,157,158,49.84
Ornn,Nami,875,371,504,42.4
Ornn,Amumu,784,388,396,49.49
Ornn,Qiyana,266,147,119,55.26
Ornn,Mordekaiser,1280,633,647,49.45
Ornn,Illaoi,397,209,188,52.64
Ornn,Hwei,549,283,266,51.55
Ornn,Evelynn,327,179,148,54.74
Ornn,Senna,772,390,382,50.52
Ornn,Zilean,336,178,158,52.98
Ornn,Malphite,831,436,395,52.47
Ornn,Fiora,535,278,257,51.96
Ornn,Milio,547,311,236,56.86
Ornn,Shen,589,283,306,48.05
Ornn,Malzahar,854,406,448,47.54
Ornn,Nilah,341,210,131,61.58
Ornn,Ziggs,365,184,181,50.41
Ornn,JarvanIV,488,238,250,48.77
Ornn,Naafiri,284,161,123,56.69
Ornn,Leblanc,447,264,183,59.06
Ornn,Smolder,618,313,305,50.65
Ornn,Janna,264,119,145,45.08
Ornn,Diana,1291,607,684,47.02
Ornn,Samira,658,334,324,50.76
Ornn,Zyra,692,362,330,52.31
Ornn,Olaf,226,77,149,34.07
Ornn,Annie,305,135,170,44.26
Ornn,Karma,876,473,403,54
Ornn,Hecarim,349,154,195,44.13
Ornn,Lissandra,232,134,98,57.76
Ornn,Anivia,294,127,167,43.2
Ornn,Sivir,400,216,184,54
Ornn,Taric,184,93,91,50.54
Ornn,Udyr,284,155,129,54.58
Ornn,FiddleSticks,433,245,188,56.58
Ornn,Gnar,379,226,153,59.63
Ornn,Rengar,348,203,145,58.33
Ornn,Gwen,592,300,292,50.68
Ornn,DrMundo,531,247,284,46.52
Ornn,Velkoz,544,265,279,48.71
Ornn,Rumble,216,112,104,51.85
Ornn,Viktor,735,365,370,49.66
Ornn,Pyke,742,401,341,54.04
Ornn,Riven,374,236,138,63.1
Ornn,Rammus,214,120,94,56.07
Ornn,Zeri,334,167,167,50
Ornn,Skarner,241,137,104,56.85
Ornn,AurelionSol,314,157,157,50
Ornn,KogMaw,234,117,117,50
Ornn,Blitzcrank,688,360,328,52.33
Ornn,Sejuani,307,168,139,54.72
Ornn,Galio,769,406,363,52.8
Ornn,Urgot,394,211,183,53.55
Ornn,Lillia,479,223,256,46.56
Ornn,Chogath,1160,589,571,50.78
Ornn,Tryndamere,439,220,219,50.11
Ornn,Camille,326,181,145,55.52
Ornn,Ryze,306,138,168,45.1
Ornn,Maokai,408,197,211,48.28
Ornn,Neeko,409,220,189,53.79
Ornn,MonkeyKing,549,275,274,50.09
Ornn,Aphelios,539,279,260,51.76
Ornn,Shyvana,197,100,97,50.76
Ornn,Alistar,366,179,187,48.91
Ornn,Lucian,609,288,321,47.29
Ornn,Kindred,441,250,191,56.69
Ornn,Renekton,372,212,160,56.99
Ornn,Leona,759,397,362,52.31
Ornn,Nunu,582,293,289,50.34
Ornn,Seraphine,737,362,375,49.12
Ornn,Heimerdinger,367,160,207,43.6
Ornn,Draven,463,248,215,53.56
Ornn,Azir,343,186,157,54.23
Ornn,Renata,182,106,76,58.24
Ornn,Singed,230,108,122,46.96
Ornn,TwistedFate,243,129,114,53.09
Ornn,Belveth,210,93,117,44.29
Ornn,Akshan,289,175,114,60.55
Ornn,Talon,525,302,223,57.52
Ornn,Kennen,271,166,105,61.25
Ornn,RekSai,116,54,62,46.55
Ornn,Jayce,327,185,142,56.57
Ornn,Nidalee,280,187,93,66.79
Ornn,Ivern,118,52,66,44.07
Ornn,Karthus,197,94,103,47.72
Udyr,Akali,755,355,400,47.02
Udyr,MissFortune,1600,738,862,46.13
Udyr,Kassadin,118,59,59,50
Udyr,Kayn,1236,555,681,44.9
Udyr,Sona,239,149,90,62.34
Udyr,Heimerdinger,307,139,168,45.28
Udyr,Talon,458,224,234,48.91
Udyr,Ahri,951,486,465,51.1
Udyr,Kalista,228,128,100,56.14
Udyr,Brand,549,250,299,45.54
Udyr,Urgot,450,200,250,44.44
Udyr,Rengar,258,118,140,45.74
Udyr,Ziggs,299,174,125,58.19
Udyr,Trundle,412,175,237,42.48
Udyr,Fiora,325,150,175,46.15
Udyr,Sion,704,364,340,51.7
Udyr,MasterYi,925,471,454,50.92
Udyr,AurelionSol,316,134,182,42.41
Udyr,Ezreal,1667,847,820,50.81
Udyr,Nami,799,344,455,43.05
Udyr,FiddleSticks,392,197,195,50.26
Udyr,Katarina,601,323,278,53.74
Udyr,Caitlyn,2054,971,1083,47.27
Udyr,Pyke,710,379,331,53.38
Udyr,Darius,1749,851,898,48.66
Udyr,Neeko,391,233,158,59.59
Udyr,Taric,201,100,101,49.75
Udyr,Riven,329,187,142,56.84
Udyr,Vi,696,320,376,45.98
Udyr,Mel,1601,824,777,51.47
Udyr,Soraka,404,191,213,47.28
Udyr,Kled,127,54,73,42.52
Udyr,Warwick,1155,578,577,50.04
Udyr,Gragas,506,276,230,54.55
Udyr,Jinx,1973,919,1054,46.58
Udyr,Rell,356,167,189,46.91
Udyr,Olaf,175,82,93,46.86
Udyr,Evelynn,329,157,172,47.72
Udyr,Volibear,1034,530,504,51.26
Udyr,Leona,641,307,334,47.89
Udyr,Teemo,918,439,479,47.82
Udyr,Shaco,754,355,399,47.08
Udyr,Yasuo,1506,769,737,51.06
Udyr,Ashe,1525,700,825,45.9
Udyr,Lux,1791,898,893,50.14
Udyr,Akshan,329,210,119,63.83
Udyr,Hwei,540,240,300,44.44
Udyr,Xerath,579,285,294,49.22
Udyr,Mordekaiser,1049,485,564,46.23
Udyr,MonkeyKing,524,270,254,51.53
Udyr,Tryndamere,477,230,247,48.22
Udyr,Irelia,576,298,278,51.74
Udyr,Nautilus,889,412,477,46.34
Udyr,Nunu,509,213,296,41.85
Udyr,Leblanc,354,181,173,51.13
Udyr,Kaisa,1193,636,557,53.31
Udyr,Jax,591,278,313,47.04
Udyr,Yone,1344,657,687,48.88
Udyr,Samira,592,309,283,52.2
Udyr,Thresh,1151,587,564,51
Udyr,Pantheon,1229,543,686,44.18
Udyr,Graves,427,201,226,47.07
Udyr,Tristana,763,369,394,48.36
Udyr,Ambessa,508,217,291,42.72
Udyr,Zed,829,370,459,44.63
Udyr,Draven,451,256,195,56.76
Udyr,Bard,276,155,121,56.16
Udyr,DrMundo,453,248,205,54.75
Udyr,Sett,1223,598,625,48.9
Udyr,Sejuani,267,117,150,43.82
Udyr,LeeSin,962,512,450,53.22
Udyr,Cassiopeia,242,102,140,42.15
Udyr,Senna,623,282,341,45.26
Udyr,Kennen,228,121,107,53.07
Udyr,Malzahar,782,346,436,44.25
Udyr,Morgana,959,454,505,47.34
Udyr,Singed,229,141,88,61.57
Udyr,Velkoz,468,190,278,40.6
Udyr,Kindred,382,182,200,47.64
Udyr,Aurora,620,285,335,45.97
Udyr,Zeri,341,172,169,50.44
Udyr,Azir,305,135,170,44.26
Udyr,Swain,789,397,392,50.32
Udyr,Aatrox,753,380,373,50.46
Udyr,Seraphine,634,322,312,50.79
Udyr,Jhin,1483,708,775,47.74
Udyr,Ekko,659,334,325,50.68
Udyr,XinZhao,447,194,253,43.4
Udyr,Sylas,875,456,419,52.11
Udyr,Naafiri,259,117,142,45.17
Udyr,Poppy,434,200,234,46.08
Udyr,Twitch,710,337,373,47.46
Udyr,Ryze,312,157,155,50.32
Udyr,TahmKench,643,334,309,51.94
Udyr,Diana,1168,563,605,48.2
Udyr,Viego,1086,569,517,52.39
Udyr,Maokai,412,179,233,43.45
Udyr,Khazix,332,138,194,41.57
Udyr,Qiyana,217,125,92,57.6
Udyr,Lulu,876,452,424,51.6
Udyr,Malphite,765,375,390,49.02
Udyr,Kayle,521,248,273,47.6
Udyr,Zac,392,206,186,52.55
Udyr,Renekton,342,171,171,50
Udyr,Gnar,346,169,177,48.84
Udyr,Shen,568,261,307,45.95
Udyr,Lillia,522,273,249,52.3
Udyr,Orianna,282,98,184,34.75
Udyr,Briar,589,307,282,52.12
Udyr,Chogath,1016,506,510,49.8
Udyr,Blitzcrank,555,268,287,48.29
Udyr,Milio,487,236,251,48.46
Udyr,Veigar,824,351,473,42.6
Udyr,Skarner,226,117,109,51.77
Udyr,Karma,795,367,428,46.16
Udyr,Vayne,919,425,494,46.25
Udyr,Garen,1239,609,630,49.15
Udyr,Quinn,299,137,162,45.82
Udyr,Belveth,189,93,96,49.21
Udyr,Nasus,474,217,257,45.78
Udyr,TwistedFate,308,145,163,47.08
Udyr,Xayah,375,201,174,53.6
Udyr,Hecarim,333,185,148,55.56
Udyr,Yuumi,617,303,314,49.11
Udyr,Yorick,749,296,453,39.52
Udyr,KSante,424,182,242,42.92
Udyr,Ornn,284,129,155,45.42
Udyr,Zyra,574,288,286,50.17
Udyr,Vladimir,458,217,241,47.38
Udyr,Aphelios,377,204,173,54.11
Udyr,Illaoi,342,172,170,50.29
Udyr,Corki,331,195,136,58.91
Udyr,Karthus,192,110,82,57.29
Udyr,Nilah,253,92,161,36.36
Udyr,Janna,266,102,164,38.35
Udyr,Lucian,551,246,305,44.65
Udyr,Rakan,345,163,182,47.25
Udyr,Gwen,502,265,237,52.79
Udyr,Jayce,323,187,136,57.89
Udyr,Nidalee,269,181,88,67.29
Udyr,Sivir,393,177,216,45.04
Udyr,Varus,659,306,353,46.43
Udyr,Amumu,734,351,383,47.82
Udyr,JarvanIV,428,177,251,41.36
Udyr,Syndra,505,227,278,44.95
Udyr,Rumble,193,90,103,46.63
Udyr,Anivia,246,123,123,50
Udyr,Smolder,484,269,215,55.58
Udyr,Nocturne,847,426,421,50.3
Udyr,Galio,660,299,361,45.3
Udyr,Viktor,646,289,357,44.74
Udyr,Camille,290,166,124,57.24
Udyr,Lissandra,181,94,87,51.93
Udyr,Vex,384,163,221,42.45
Udyr,Zoe,306,147,159,48.04
Udyr,Taliyah,205,102,103,49.76
Udyr,Elise,527,260,267,49.34
Udyr,Gangplank,331,167,164,50.45
Udyr,Fizz,397,214,183,53.9
Udyr,Zilean,257,137,120,53.31
Udyr,Braum,421,236,185,56.06
Udyr,Ivern,116,61,55,52.59
Udyr,Renata,109,51,58,46.79
Udyr,RekSai,123,76,47,61.79
Udyr,Alistar,345,146,199,42.32
Udyr,Shyvana,201,88,113,43.78
Udyr,Annie,238,107,131,44.96
Udyr,KogMaw,273,104,169,38.1
Udyr,Rammus,176,79,97,44.89
Kassadin,Ornn,181,102,79,56.35
Kassadin,Udyr,118,59,59,50
Kassadin,Lux,1046,513,533,49.04
Kassadin,Ezreal,929,469,460,50.48
Kassadin,Milio,284,150,134,52.82
Kassadin,Gangplank,198,93,105,46.97
Kassadin,Kaisa,661,371,290,56.13
Kassadin,Galio,334,151,183,45.21
Kassadin,Cassiopeia,113,60,53,53.1
Kassadin,Hwei,307,159,148,51.79
Kassadin,Aatrox,385,164,221,42.6
Kassadin,Shaco,440,272,168,61.82
Kassadin,Leblanc,265,141,124,53.21
Kassadin,Draven,186,90,96,48.39
Kassadin,Darius,795,405,390,50.94
Kassadin,Chogath,497,242,255,48.69
Kassadin,Yasuo,704,345,359,49.01
Kassadin,Yuumi,342,190,152,55.56
Kassadin,Naafiri,126,65,61,51.59
Kassadin,Zac,229,114,115,49.78
Kassadin,Ahri,604,317,287,52.48
Kassadin,Nilah,154,59,95,38.31
Kassadin,Zyra,310,171,139,55.16
Kassadin,XinZhao,214,97,117,45.33
Kassadin,Hecarim,178,86,92,48.31
Kassadin,Jhin,802,388,414,48.38
Kassadin,Velkoz,273,119,154,43.59
Kassadin,Mordekaiser,542,280,262,51.66
Kassadin,Diana,711,371,340,52.18
Kassadin,Tristana,375,184,191,49.07
Kassadin,Taric,93,45,48,48.39
Kassadin,Warwick,574,317,257,55.23
Kassadin,Graves,225,102,123,45.33
Kassadin,Aurora,313,160,153,51.12
Kassadin,Mel,1202,659,543,54.83
Kassadin,Irelia,333,142,191,42.64
Kassadin,MonkeyKing,264,108,156,40.91
Kassadin,Vex,216,117,99,54.17
Kassadin,Caitlyn,1104,522,582,47.28
Kassadin,Rell,241,100,141,41.49
Kassadin,Illaoi,168,115,53,68.45
Kassadin,Vi,421,235,186,55.82
Kassadin,Sivir,227,124,103,54.63
Kassadin,Jax,384,164,220,42.71
Kassadin,Karthus,118,71,47,60.17
Kassadin,Lucian,284,146,138,51.41
Kassadin,Nami,497,265,232,53.32
Kassadin,Garen,596,311,285,52.18
Kassadin,Skarner,98,56,42,57.14
Kassadin,Zilean,127,61,66,48.03
Kassadin,MissFortune,877,494,383,56.33
Kassadin,Tryndamere,254,138,116,54.33
Kassadin,Evelynn,211,103,108,48.82
Kassadin,Syndra,273,157,116,57.51
Kassadin,Xerath,331,157,174,47.43
Kassadin,Nunu,288,141,147,48.96
Kassadin,Seraphine,368,201,167,54.62
Kassadin,Nautilus,467,232,235,49.68
Kassadin,Zed,301,143,158,47.51
Kassadin,Pantheon,678,338,340,49.85
Kassadin,Nocturne,483,261,222,54.04
Kassadin,Akali,424,211,213,49.76
Kassadin,Jinx,1080,538,542,49.81
Kassadin,Annie,120,72,48,60
Kassadin,Sett,542,326,216,60.15
Kassadin,Ekko,440,261,179,59.32
Kassadin,Swain,455,252,203,55.38
Kassadin,LeeSin,509,260,249,51.08
Kassadin,Riven,234,126,108,53.85
Kassadin,Rengar,172,105,67,61.05
Kassadin,Gnar,218,114,104,52.29
Kassadin,MasterYi,463,233,230,50.32
Kassadin,TwistedFate,166,83,83,50
Kassadin,Senna,281,145,136,51.6
Kassadin,Kayn,623,256,367,41.09
Kassadin,Malzahar,369,188,181,50.95
Kassadin,Malphite,386,196,190,50.78
Kassadin,Sylas,467,262,205,56.1
Kassadin,Rakan,189,75,114,39.68
Kassadin,Ivern,89,52,37,58.43
Kassadin,Katarina,369,192,177,52.03
Kassadin,Teemo,447,212,235,47.43
Kassadin,Briar,287,120,167,41.81
Kassadin,Twitch,388,202,186,52.06
Kassadin,Poppy,243,133,110,54.73
Kassadin,AurelionSol,148,78,70,52.7
Kassadin,Zoe,114,61,53,53.51
Kassadin,Lillia,303,147,156,48.51
Kassadin,Lulu,434,217,217,50
Kassadin,Veigar,477,259,218,54.3
Kassadin,Brand,316,186,130,58.86
Kassadin,Pyke,370,191,179,51.62
Kassadin,Varus,399,212,187,53.13
Kassadin,DrMundo,263,131,132,49.81
Kassadin,Vladimir,341,188,153,55.13
Kassadin,Neeko,228,119,109,52.19
Kassadin,KSante,220,122,98,55.45
Kassadin,Vayne,597,315,282,52.76
Kassadin,TahmKench,345,176,169,51.01
Kassadin,Maokai,215,126,89,58.6
Kassadin,Orianna,171,79,92,46.2
Kassadin,Viego,548,266,282,48.54
Kassadin,Xayah,210,88,122,41.9
Kassadin,Kindred,182,84,98,46.15
Kassadin,Urgot,257,109,148,42.41
Kassadin,Elise,322,179,143,55.59
Kassadin,Braum,257,146,111,56.81
Kassadin,Nasus,326,151,175,46.32
Kassadin,Yone,636,328,308,51.57
Kassadin,Blitzcrank,295,147,148,49.83
Kassadin,Qiyana,132,55,77,41.67
Kassadin,Ziggs,171,105,66,61.4
Kassadin,Amumu,416,175,241,42.07
Kassadin,Viktor,348,211,137,60.63
Kassadin,Thresh,635,297,338,46.77
Kassadin,Volibear,419,183,236,43.68
Kassadin,Yorick,349,194,155,55.59
Kassadin,Kayle,330,176,154,53.33
Kassadin,Ashe,719,397,322,55.22
Kassadin,Ryze,172,72,100,41.86
Kassadin,Camille,167,88,79,52.69
Kassadin,Corki,227,165,62,72.69
Kassadin,Karma,491,270,221,54.99
Kassadin,Sona,135,50,85,37.04
Kassadin,Fizz,259,136,123,52.51
Kassadin,Trundle,248,109,139,43.95
Kassadin,Soraka,247,124,123,50.2
Kassadin,Gragas,314,160,154,50.96
Kassadin,Ambessa,262,136,126,51.91
Kassadin,Kled,71,41,30,57.75
Kassadin,Khazix,212,114,98,53.77
Kassadin,Renekton,228,124,104,54.39
Kassadin,Kalista,184,95,89,51.63
Kassadin,Morgana,524,251,273,47.9
Kassadin,Singed,150,75,75,50
Kassadin,Samira,310,148,162,47.74
Kassadin,Akshan,132,64,68,48.48
Kassadin,RekSai,62,32,30,51.61
Kassadin,Rammus,152,71,81,46.71
Kassadin,Rumble,96,58,38,60.42
Kassadin,Sion,330,144,186,43.64
Kassadin,JarvanIV,195,94,101,48.21
Kassadin,Aphelios,229,111,118,48.47
Kassadin,Alistar,157,68,89,43.31
Kassadin,Olaf,65,34,31,52.31
Kassadin,Sejuani,146,66,80,45.21
Kassadin,Janna,144,66,78,45.83
Kassadin,Belveth,87,47,40,54.02
Kassadin,Anivia,207,93,114,44.93
Kassadin,Bard,173,90,83,52.02
Kassadin,Taliyah,106,50,56,47.17
Kassadin,Fiora,126,62,64,49.21
Kassadin,Azir,107,49,58,45.79
Kassadin,Shyvana,96,53,43,55.21
Kassadin,Shen,277,120,157,43.32
Kassadin,Zeri,175,71,104,40.57
Kassadin,Kennen,108,71,37,65.74
Kassadin,Talon,241,118,123,48.96
Kassadin,Gwen,247,148,99,59.92
Kassadin,Leona,346,154,192,44.51
Kassadin,Quinn,135,48,87,35.56
Kassadin,FiddleSticks,254,143,111,56.3
Kassadin,Nidalee,122,89,33,72.95
Kassadin,KogMaw,137,64,73,46.72
Kassadin,Heimerdinger,224,147,77,65.63
Kassadin,Jayce,194,80,114,41.24
Kassadin,Smolder,316,171,145,54.11
Kassadin,Renata,66,50,16,75.76
Kassadin,Lissandra,149,87,62,58.39
Taric,Jax,350,220,130,62.86
Taric,Nidalee,101,47,54,46.53
Taric,Ahri,551,310,241,56.26
Taric,Jhin,759,404,355,53.23
Taric,Senna,300,160,140,53.33
Taric,Udyr,201,101,100,50.25
Taric,Yorick,422,169,253,40.05
Taric,Akali,418,243,175,58.13
Taric,Jinx,1203,580,623,48.21
Taric,Karma,371,191,180,51.48
Taric,Heimerdinger,182,86,96,47.25
Taric,Warwick,646,345,301,53.41
Taric,Mordekaiser,652,351,301,53.83
Taric,Ashe,796,398,398,50
Taric,Pyke,391,250,141,63.94
Taric,Gwen,255,142,113,55.69
Taric,RekSai,47,37,10,78.72
Taric,Gangplank,217,133,84,61.29
Taric,Kaisa,647,357,290,55.18
Taric,Leona,427,236,191,55.27
Taric,Kennen,123,76,47,61.79
Taric,TwistedFate,181,98,83,54.14
Taric,Cassiopeia,163,94,69,57.67
Taric,Smolder,337,191,146,56.68
Taric,Milio,257,148,109,57.59
Taric,Sett,628,350,278,55.73
Taric,Nunu,277,156,121,56.32
Taric,Yone,743,435,308,58.55
Taric,Quinn,162,67,95,41.36
Taric,Viego,560,241,319,43.04
Taric,Yasuo,953,492,461,51.63
Taric,MissFortune,936,462,474,49.36
Taric,Neeko,222,134,88,60.36
Taric,Teemo,534,268,266,50.19
Taric,Akshan,154,83,71,53.9
Taric,Corki,200,118,82,59
Taric,Lux,1057,495,562,46.83
Taric,Singed,110,59,51,53.64
Taric,Zeri,179,94,85,52.51
Taric,Brand,247,128,119,51.82
Taric,Darius,899,459,440,51.06
Taric,Gragas,251,150,101,59.76
Taric,Veigar,430,231,199,53.72
Taric,KogMaw,149,77,72,51.68
Taric,Thresh,712,387,325,54.35
Taric,Kayn,646,349,297,54.02
Taric,Kassadin,93,48,45,51.61
Taric,Ziggs,149,81,68,54.36
Taric,Morgana,477,264,213,55.35
Taric,Shaco,375,209,166,55.73
Taric,Hwei,257,151,106,58.75
Taric,Sejuani,184,106,78,57.61
Taric,Taliyah,154,73,81,47.4
Taric,Sivir,221,131,90,59.28
Taric,Velkoz,292,148,144,50.68
Taric,Ambessa,269,133,136,49.44
Taric,Lillia,235,107,128,45.53
Taric,Vladimir,282,133,149,47.16
Taric,Vayne,574,279,295,48.61
Taric,Nami,403,229,174,56.82
Taric,Viktor,369,200,169,54.2
Taric,Xayah,212,101,111,47.64
Taric,Nautilus,691,380,311,54.99
Taric,Garen,705,363,342,51.49
Taric,Kindred,132,86,46,65.15
Taric,Graves,195,92,103,47.18
Taric,Twitch,354,212,142,59.89
Taric,Volibear,501,273,228,54.49
Taric,Evelynn,160,72,88,45
Taric,Trundle,259,114,145,44.02
Taric,JarvanIV,227,117,110,51.54
Taric,Aurora,353,212,141,60.06
Taric,MasterYi,574,319,255,55.57
Taric,Lissandra,135,59,76,43.7
Taric,Caitlyn,1096,570,526,52.01
Taric,Rakan,156,80,76,51.28
Taric,Riven,264,158,106,59.85
Taric,FiddleSticks,219,135,84,61.64
Taric,Tristana,402,187,215,46.52
Taric,Swain,445,210,235,47.19
Taric,Talon,188,88,100,46.81
Taric,Orianna,215,97,118,45.12
Taric,MonkeyKing,236,106,130,44.92
Taric,Malzahar,421,201,220,47.74
Taric,Poppy,310,177,133,57.1
Taric,XinZhao,319,149,170,46.71
Taric,Ryze,117,56,61,47.86
Taric,Varus,385,174,211,45.19
Taric,Belveth,115,51,64,44.35
Taric,Illaoi,204,111,93,54.41
Taric,Urgot,239,112,127,46.86
Taric,Diana,693,368,325,53.1
Taric,Soraka,231,104,127,45.02
Taric,Mel,888,455,433,51.24
Taric,LeeSin,539,282,257,52.32
Taric,Zac,247,115,132,46.56
Taric,Pantheon,724,403,321,55.66
Taric,Briar,344,190,154,55.23
Taric,Irelia,297,150,147,50.51
Taric,Nasus,257,119,138,46.3
Taric,Vi,406,204,202,50.25
Taric,Azir,151,87,64,57.62
Taric,Draven,216,110,106,50.93
Taric,Ornn,184,91,93,49.46
Taric,KSante,189,109,80,57.67
Taric,Zed,486,259,227,53.29
Taric,Samira,332,225,107,67.77
Taric,Amumu,473,248,225,52.43
Taric,Lucian,252,145,107,57.54
Taric,AurelionSol,240,105,135,43.75
Taric,Shen,287,157,130,54.7
Taric,Karthus,110,44,66,40
Taric,Ekko,396,215,181,54.29
Taric,Ezreal,860,463,397,53.84
Taric,Sylas,513,288,225,56.14
Taric,Blitzcrank,322,187,135,58.07
Taric,Chogath,648,347,301,53.55
Taric,Zyra,317,159,158,50.16
Taric,Nocturne,443,225,218,50.79
Taric,Fizz,281,138,143,49.11
Taric,Zilean,79,34,45,43.04
Taric,Elise,312,182,130,58.33
Taric,Sona,160,66,94,41.25
Taric,Malphite,387,184,203,47.55
Taric,Alistar,202,114,88,56.44
Taric,Fiora,150,89,61,59.33
Taric,Yuumi,382,222,160,58.12
Taric,Katarina,339,148,191,43.66
Taric,Sion,366,207,159,56.56
Taric,Braum,247,118,129,47.77
Taric,Lulu,536,268,268,50
Taric,Qiyana,107,50,57,46.73
Taric,Kayle,353,183,170,51.84
Taric,Seraphine,326,138,188,42.33
Taric,Renekton,222,114,108,51.35
Taric,Aatrox,339,136,203,40.12
Taric,DrMundo,289,144,145,49.83
Taric,Shyvana,71,17,54,23.94
Taric,Ivern,69,33,36,47.83
Taric,Galio,326,173,153,53.07
Taric,TahmKench,433,223,210,51.5
Taric,Leblanc,153,87,66,56.86
Taric,Vex,207,97,110,46.86
Taric,Aphelios,254,118,136,46.46
Taric,Tryndamere,264,134,130,50.76
Taric,Kalista,179,96,83,53.63
Taric,Rell,205,122,83,59.51
Taric,Rammus,130,82,48,63.08
Taric,Maokai,225,103,122,45.78
Taric,Annie,130,77,53,59.23
Taric,Khazix,221,150,71,67.87
Taric,Syndra,275,121,154,44
Taric,Hecarim,153,100,53,65.36
Taric,Rengar,151,75,76,49.67
Taric,Camille,136,74,62,54.41
Taric,Xerath,316,168,148,53.16
Taric,Kled,80,36,44,45
Taric,Janna,149,69,80,46.31
Taric,Gnar,196,108,88,55.1
Taric,Skarner,100,65,35,65
Taric,Bard,117,53,64,45.3
Taric,Naafiri,145,59,86,40.69
Taric,Renata,91,45,46,49.45
Taric,Olaf,89,57,32,64.04
Taric,Rumble,113,55,58,48.67
Taric,Nilah,168,76,92,45.24
Taric,Jayce,180,105,75,58.33
Taric,Zoe,147,91,56,61.9
Taric,Anivia,141,56,85,39.72
Nidalee,Gwen,276,122,154,44.2
Nidalee,Talon,399,157,242,39.35
Nidalee,Yone,1067,486,581,45.55
Nidalee,MissFortune,1117,482,635,43.15
Nidalee,Taric,101,54,47,53.47
Nidalee,Volibear,485,190,295,39.18
Nidalee,Ivern,88,27,61,30.68
Nidalee,Irelia,500,212,288,42.4
Nidalee,Caitlyn,1387,652,735,47.01
Nidalee,Swain,467,169,298,36.19
Nidalee,Poppy,445,234,211,52.58
Nidalee,Elise,485,255,230,52.58
Nidalee,Aurora,470,204,266,43.4
Nidalee,Tristana,546,242,304,44.32
Nidalee,Nami,495,193,302,38.99
Nidalee,MasterYi,488,204,284,41.8
Nidalee,Hwei,434,187,247,43.09
Nidalee,Samira,451,184,267,40.8
Nidalee,Kayn,743,287,456,38.63
Nidalee,Briar,366,143,223,39.07
Nidalee,Velkoz,330,156,174,47.27
Nidalee,Nilah,182,79,103,43.41
Nidalee,Yuumi,517,223,294,43.13
Nidalee,Aatrox,658,250,408,37.99
Nidalee,Shyvana,120,51,69,42.5
Nidalee,Vex,288,128,160,44.44
Nidalee,Ezreal,1642,694,948,42.27
Nidalee,Malzahar,473,185,288,39.11
Nidalee,Renekton,327,140,187,42.81
Nidalee,Gragas,376,196,180,52.13
Nidalee,Viktor,519,204,315,39.31
Nidalee,Ashe,1362,591,771,43.39
Nidalee,Morgana,572,282,290,49.3
Nidalee,Tryndamere,276,132,144,47.83
Nidalee,Shaco,487,171,316,35.11
Nidalee,Brand,314,153,161,48.73
Nidalee,Lux,1274,523,751,41.05
Nidalee,Blitzcrank,442,192,250,43.44
Nidalee,Kaisa,1031,497,534,48.21
Nidalee,Lulu,716,327,389,45.67
Nidalee,Katarina,410,180,230,43.9
Nidalee,Jinx,1365,590,775,43.22
Nidalee,Garen,790,309,481,39.11
Nidalee,Veigar,476,212,264,44.54
Nidalee,Bard,175,78,97,44.57
Nidalee,Heimerdinger,233,111,122,47.64
Nidalee,Zed,606,295,311,48.68
Nidalee,Senna,405,180,225,44.44
Nidalee,Gangplank,235,114,121,48.51
Nidalee,Pyke,485,267,218,55.05
Nidalee,Vladimir,388,197,191,50.77
Nidalee,Nunu,327,156,171,47.71
Nidalee,Annie,215,95,120,44.19
Nidalee,Sona,189,75,114,39.68
Nidalee,Riven,269,118,151,43.87
Nidalee,Vi,534,222,312,41.57
Nidalee,Chogath,593,245,348,41.32
Nidalee,Fizz,248,98,150,39.52
Nidalee,Ziggs,252,98,154,38.89
Nidalee,Darius,968,420,548,43.39
Nidalee,Diana,897,380,517,42.36
Nidalee,Mordekaiser,554,252,302,45.49
Nidalee,Shen,344,136,208,39.53
Nidalee,Zac,357,144,213,40.34
Nidalee,Yasuo,1072,436,636,40.67
Nidalee,TahmKench,460,217,243,47.17
Nidalee,Graves,514,228,286,44.36
Nidalee,Illaoi,268,116,152,43.28
Nidalee,FiddleSticks,268,126,142,47.01
Nidalee,Singed,111,38,73,34.23
Nidalee,Orianna,314,144,170,45.86
Nidalee,Corki,214,91,123,42.52
Nidalee,Neeko,334,154,180,46.11
Nidalee,Rell,318,125,193,39.31
Nidalee,Pantheon,1012,496,516,49.01
Nidalee,Sylas,807,389,418,48.2
Nidalee,Galio,543,258,285,47.51
Nidalee,Zyra,594,244,350,41.08
Nidalee,AurelionSol,230,114,116,49.57
Nidalee,Soraka,310,131,179,42.26
Nidalee,Viego,817,360,457,44.06
Nidalee,Teemo,667,270,397,40.48
Nidalee,Ekko,431,181,250,42
Nidalee,Mel,1146,573,573,50
Nidalee,Sion,466,196,270,42.06
Nidalee,Sett,853,400,453,46.89
Nidalee,Nautilus,680,245,435,36.03
Nidalee,DrMundo,309,133,176,43.04
Nidalee,JarvanIV,344,161,183,46.8
Nidalee,Amumu,504,212,292,42.06
Nidalee,Akali,668,323,345,48.35
Nidalee,Ahri,713,318,395,44.6
Nidalee,KSante,320,189,131,59.06
Nidalee,Jax,487,226,261,46.41
Nidalee,Seraphine,428,168,260,39.25
Nidalee,Nasus,389,149,240,38.3
Nidalee,XinZhao,358,174,184,48.6
Nidalee,Jhin,1088,471,617,43.29
Nidalee,Yorick,436,175,261,40.14
Nidalee,Olaf,157,68,89,43.31
Nidalee,Varus,538,229,309,42.57
Nidalee,Quinn,210,84,126,40
Nidalee,Leblanc,376,217,159,57.71
Nidalee,Cassiopeia,202,84,118,41.58
Nidalee,Karma,769,343,426,44.6
Nidalee,Gnar,248,117,131,47.18
Nidalee,Udyr,269,88,181,32.71
Nidalee,Rakan,262,95,167,36.26
Nidalee,MonkeyKing,380,196,184,51.58
Nidalee,LeeSin,1444,665,779,46.05
Nidalee,Twitch,326,147,179,45.09
Nidalee,Lucian,424,192,232,45.28
Nidalee,Draven,276,126,150,45.65
Nidalee,Leona,402,159,243,39.55
Nidalee,Zoe,253,119,134,47.04
Nidalee,Smolder,357,175,182,49.02
Nidalee,Khazix,398,183,215,45.98
Nidalee,Malphite,543,260,283,47.88
Nidalee,Qiyana,169,90,79,53.25
Nidalee,Belveth,138,74,64,53.62
Nidalee,Kayle,334,119,215,35.63
Nidalee,Xerath,580,243,337,41.9
Nidalee,Xayah,288,124,164,43.06
Nidalee,Vayne,558,254,304,45.52
Nidalee,Kindred,282,131,151,46.45
Nidalee,Janna,155,66,89,42.58
Nidalee,Warwick,660,254,406,38.48
Nidalee,Camille,282,116,166,41.13
Nidalee,Lissandra,213,83,130,38.97
Nidalee,Urgot,288,122,166,42.36
Nidalee,Sivir,303,134,169,44.22
Nidalee,Syndra,354,150,204,42.37
Nidalee,Ambessa,444,215,229,48.42
Nidalee,Rumble,209,114,95,54.55
Nidalee,Hecarim,222,98,124,44.14
Nidalee,Taliyah,185,93,92,50.27
Nidalee,Azir,217,96,121,44.24
Nidalee,Nocturne,653,289,364,44.26
Nidalee,Aphelios,348,140,208,40.23
Nidalee,Zeri,272,123,149,45.22
Nidalee,Lillia,291,139,152,47.77
Nidalee,Karthus,200,103,97,51.5
Nidalee,Thresh,886,400,486,45.15
Nidalee,Kassadin,122,33,89,27.05
Nidalee,Milio,308,134,174,43.51
Nidalee,Sejuani,205,111,94,54.15
Nidalee,Naafiri,168,57,111,33.93
Nidalee,Trundle,270,127,143,47.04
Nidalee,Skarner,149,86,63,57.72
Nidalee,Braum,357,159,198,44.54
Nidalee,Rengar,210,115,95,54.76
Nidalee,Zilean,190,102,88,53.68
Nidalee,TwistedFate,255,148,107,58.04
Nidalee,Rammus,133,50,83,37.59
Nidalee,Evelynn,215,94,121,43.72
Nidalee,Kled,96,40,56,41.67
Nidalee,Kennen,178,72,106,40.45
Nidalee,Renata,95,48,47,50.53
Nidalee,Ryze,203,61,142,30.05
Nidalee,Kalista,182,100,82,54.95
Nidalee,RekSai,84,47,37,55.95
Nidalee,Fiora,192,72,120,37.5
Nidalee,Ornn,280,93,187,33.21
Nidalee,Maokai,264,113,151,42.8
Nidalee,KogMaw,163,69,94,42.33
Nidalee,Akshan,211,92,119,43.6
Nidalee,Alistar,200,99,101,49.5
Nidalee,Jayce,371,184,187,49.6
Nidalee,Anivia,160,56,104,35
Nasus,Fiora,591,308,283,52.12
Nasus,MasterYi,1880,990,890,52.66
Nasus,Mel,3094,1683,1411,54.4
Nasus,Jhin,2596,1322,1274,50.92
Nasus,Karma,1364,704,660,51.61
Nasus,Tryndamere,850,489,361,57.53
Nasus,Kayn,2179,1121,1058,51.45
Nasus,Aurora,1099,630,469,57.32
Nasus,Twitch,1075,566,509,52.65
Nasus,Lux,3715,1907,1808,51.33
Nasus,Mordekaiser,2220,1100,1120,49.55
Nasus,Diana,2126,1087,1039,51.13
Nasus,Ahri,1923,1011,912,52.57
Nasus,Lulu,1467,735,732,50.1
Nasus,Darius,2646,1310,1336,49.51
Nasus,Amumu,1478,770,708,52.1
Nasus,Yasuo,3046,1507,1539,49.47
Nasus,MissFortune,3501,1787,1714,51.04
Nasus,Swain,1547,765,782,49.45
Nasus,Volibear,1890,964,926,51.01
Nasus,LeeSin,1644,915,729,55.66
Nasus,Kayle,1212,657,555,54.21
Nasus,Ezreal,2776,1477,1299,53.21
Nasus,Morgana,1778,904,874,50.84
Nasus,Yone,2783,1450,1333,52.1
Nasus,Nilah,639,346,293,54.15
Nasus,Malphite,1500,768,732,51.2
Nasus,Warwick,2418,1207,1211,49.92
Nasus,Vex,701,378,323,53.92
Nasus,Yuumi,1106,565,541,51.08
Nasus,Yorick,1550,676,874,43.61
Nasus,Ekko,1189,627,562,52.73
Nasus,Katarina,1158,699,459,60.36
Nasus,Jinx,3800,1959,1841,51.55
Nasus,Sion,1130,582,548,51.5
Nasus,Quinn,426,218,208,51.17
Nasus,Talon,601,285,316,47.42
Nasus,Syndra,842,411,431,48.81
Nasus,Caitlyn,3828,1825,2003,47.68
Nasus,Sett,2068,1085,983,52.47
Nasus,Kindred,732,460,272,62.84
Nasus,Veigar,1603,839,764,52.34
Nasus,Kled,239,118,121,49.37
Nasus,Gragas,728,431,297,59.2
Nasus,Rell,637,346,291,54.32
Nasus,Sejuani,560,295,265,52.68
Nasus,Malzahar,1299,631,668,48.58
Nasus,Rakan,614,301,313,49.02
Nasus,Aatrox,1193,651,542,54.57
Nasus,Cassiopeia,468,221,247,47.22
Nasus,Varus,1094,576,518,52.65
Nasus,Jayce,549,338,211,61.57
Nasus,Skarner,350,187,163,53.43
Nasus,Poppy,853,459,394,53.81
Nasus,Singed,532,293,239,55.08
Nasus,Viego,1915,1020,895,53.26
Nasus,Vayne,1903,958,945,50.34
Nasus,Leona,1287,708,579,55.01
Nasus,Akali,1470,777,693,52.86
Nasus,Xayah,735,379,356,51.56
Nasus,Nautilus,1504,834,670,55.45
Nasus,Milio,697,353,344,50.65
Nasus,Irelia,1083,566,517,52.26
Nasus,Evelynn,618,284,334,45.95
Nasus,Anivia,423,196,227,46.34
Nasus,Ornn,559,283,276,50.63
Nasus,Gangplank,555,230,325,41.44
Nasus,Senna,1049,485,564,46.23
Nasus,Smolder,977,511,466,52.3
Nasus,TahmKench,1257,684,573,54.42
Nasus,Azir,436,236,200,54.13
Nasus,Pantheon,2251,1105,1146,49.09
Nasus,Nami,1182,560,622,47.38
Nasus,Xerath,1101,601,500,54.59
Nasus,Ashe,2695,1399,1296,51.91
Nasus,Ivern,229,132,97,57.64
Nasus,Seraphine,1381,733,648,53.08
Nasus,Zoe,449,285,164,63.47
Nasus,Nunu,927,451,476,48.65
Nasus,Tristana,1229,589,640,47.93
Nasus,Pyke,1277,727,550,56.93
Nasus,Teemo,2069,1039,1030,50.22
Nasus,Rengar,463,283,180,61.12
Nasus,Vladimir,894,490,404,54.81
Nasus,Kaisa,2031,1160,871,57.11
Nasus,Ambessa,754,382,372,50.66
Nasus,Maokai,661,338,323,51.13
Nasus,Garen,2526,1170,1356,46.32
Nasus,Briar,1200,578,622,48.17
Nasus,Zed,1394,778,616,55.81
Nasus,Corki,468,231,237,49.36
Nasus,Karthus,300,183,117,61
Nasus,KSante,552,342,210,61.96
Nasus,Zeri,645,356,289,55.19
Nasus,Sylas,1704,890,814,52.23
Nasus,Zac,572,259,313,45.28
Nasus,Renekton,790,404,386,51.14
Nasus,Zilean,449,240,209,53.45
Nasus,Ziggs,522,265,257,50.77
Nasus,JarvanIV,703,361,342,51.35
Nasus,Lucian,892,438,454,49.1
Nasus,Soraka,869,417,452,47.99
Nasus,Shen,829,409,420,49.34
Nasus,Chogath,1669,810,859,48.53
Nasus,Braum,728,387,341,53.16
Nasus,Janna,435,200,235,45.98
Nasus,Gwen,758,405,353,53.43
Nasus,Neeko,840,477,363,56.79
Nasus,Taliyah,260,112,148,43.08
Nasus,Khazix,714,378,336,52.94
Nasus,Viktor,1175,580,595,49.36
Nasus,Thresh,1873,961,912,51.31
Nasus,MonkeyKing,871,462,409,53.04
Nasus,Samira,1275,724,551,56.78
Nasus,FiddleSticks,735,357,378,48.57
Nasus,Velkoz,827,359,468,43.41
Nasus,XinZhao,846,427,419,50.47
Nasus,Trundle,1011,518,493,51.24
Nasus,Fizz,797,451,346,56.59
Nasus,Aphelios,824,434,390,52.67
Nasus,Blitzcrank,1011,523,488,51.73
Nasus,Belveth,388,205,183,52.84
Nasus,Heimerdinger,876,435,441,49.66
Nasus,Gnar,512,263,249,51.37
Nasus,Hecarim,587,300,287,51.11
Nasus,Zyra,1007,500,507,49.65
Nasus,Nocturne,1526,753,773,49.34
Nasus,KogMaw,488,253,235,51.84
Nasus,Naafiri,556,312,244,56.12
Nasus,Galio,1113,550,563,49.42
Nasus,Elise,792,371,421,46.84
Nasus,Kennen,500,287,213,57.4
Nasus,Qiyana,413,209,204,50.61
Nasus,Jax,1168,620,548,53.08
Nasus,Kassadin,326,175,151,53.68
Nasus,Urgot,899,440,459,48.94
Nasus,Akshan,484,232,252,47.93
Nasus,Bard,366,197,169,53.83
Nasus,Graves,786,422,364,53.69
Nasus,Annie,432,203,229,46.99
Nasus,Brand,1183,513,670,43.36
Nasus,Taric,257,138,119,53.7
Nasus,Shaco,1285,678,607,52.76
Nasus,Hwei,914,485,429,53.06
Nasus,Udyr,474,257,217,54.22
Nasus,Leblanc,656,344,312,52.44
Nasus,Shyvana,325,146,179,44.92
Nasus,Vi,1343,607,736,45.2
Nasus,Draven,696,425,271,61.06
Nasus,Olaf,325,150,175,46.15
Nasus,Sivir,719,379,340,52.71
Nasus,Nidalee,389,240,149,61.7
Nasus,Kalista,449,237,212,52.78
Nasus,Rammus,413,194,219,46.97
Nasus,Rumble,314,162,152,51.59
Nasus,Illaoi,824,434,390,52.67
Nasus,Lissandra,414,229,185,55.31
Nasus,TwistedFate,489,285,204,58.28
Nasus,Ryze,436,195,241,44.72
Nasus,Lillia,870,404,466,46.44
Nasus,Orianna,524,226,298,43.13
Nasus,Alistar,494,286,208,57.89
Nasus,AurelionSol,692,346,346,50
Nasus,DrMundo,752,396,356,52.66
Nasus,RekSai,149,97,52,65.1
Nasus,Riven,623,341,282,54.74
Nasus,Sona,483,237,246,49.07
Nasus,Camille,536,302,234,56.34
Nasus,Renata,286,135,151,47.2
JarvanIV,Swain,984,470,514,47.76
JarvanIV,Malzahar,1121,545,576,48.62
JarvanIV,Irelia,843,406,437,48.16
JarvanIV,Kalista,383,195,188,50.91
JarvanIV,Poppy,749,393,356,52.47
JarvanIV,Sett,1446,687,759,47.51
JarvanIV,Taliyah,256,138,118,53.91
JarvanIV,Cassiopeia,391,194,197,49.62
JarvanIV,Kaisa,1776,892,884,50.23
JarvanIV,Neeko,376,210,166,55.85
JarvanIV,Yasuo,1912,1012,900,52.93
JarvanIV,Evelynn,357,173,184,48.46
JarvanIV,Tristana,1059,477,582,45.04
JarvanIV,Lux,2546,1372,1174,53.89
JarvanIV,Volibear,1184,589,595,49.75
JarvanIV,LeeSin,1596,887,709,55.58
JarvanIV,Caitlyn,2601,1428,1173,54.9
JarvanIV,Pyke,777,410,367,52.77
JarvanIV,Singed,298,147,151,49.33
JarvanIV,Viego,1423,765,658,53.76
JarvanIV,Vayne,1312,681,631,51.91
JarvanIV,MissFortune,2117,1048,1069,49.5
JarvanIV,Leona,836,398,438,47.61
JarvanIV,Gangplank,539,277,262,51.39
JarvanIV,Rengar,414,251,163,60.63
JarvanIV,Kennen,310,181,129,58.39
JarvanIV,Akali,986,507,479,51.42
JarvanIV,Kayn,1529,780,749,51.01
JarvanIV,Sylas,1424,697,727,48.95
JarvanIV,Draven,630,298,332,47.3
JarvanIV,Velkoz,666,330,336,49.55
JarvanIV,Mordekaiser,1238,594,644,47.98
JarvanIV,Amumu,1164,575,589,49.4
JarvanIV,Qiyana,273,166,107,60.81
JarvanIV,Garen,1745,843,902,48.31
JarvanIV,Diana,1571,761,810,48.44
JarvanIV,Heimerdinger,335,174,161,51.94
JarvanIV,Vi,1154,579,575,50.17
JarvanIV,Vladimir,673,340,333,50.52
JarvanIV,Leblanc,564,304,260,53.9
JarvanIV,Veigar,1016,557,459,54.82
JarvanIV,Ashe,2059,1075,984,52.21
JarvanIV,Nautilus,1236,679,557,54.94
JarvanIV,KSante,557,339,218,60.86
JarvanIV,MasterYi,1114,554,560,49.73
JarvanIV,Mel,2128,1151,977,54.09
JarvanIV,Ekko,895,437,458,48.83
JarvanIV,Naafiri,376,190,186,50.53
JarvanIV,Kayle,781,415,366,53.14
JarvanIV,Tryndamere,563,293,270,52.04
JarvanIV,MonkeyKing,819,406,413,49.57
JarvanIV,Lucian,721,413,308,57.28
JarvanIV,Elise,810,416,394,51.36
JarvanIV,TahmKench,784,395,389,50.38
JarvanIV,Shaco,933,523,410,56.06
JarvanIV,Aurora,833,441,392,52.94
JarvanIV,Xayah,565,310,255,54.87
JarvanIV,Aatrox,952,458,494,48.11
JarvanIV,Skarner,305,176,129,57.7
JarvanIV,Nasus,703,342,361,48.65
JarvanIV,Katarina,771,443,328,57.46
JarvanIV,Rell,570,301,269,52.81
JarvanIV,Kled,233,139,94,59.66
JarvanIV,Nocturne,1358,696,662,51.25
JarvanIV,Malphite,1115,560,555,50.22
JarvanIV,Warwick,1417,749,668,52.86
JarvanIV,Rakan,442,207,235,46.83
JarvanIV,Riven,466,243,223,52.15
JarvanIV,Jhin,2037,1128,909,55.38
JarvanIV,Thresh,1602,792,810,49.44
JarvanIV,Trundle,505,238,267,47.13
JarvanIV,Rammus,294,111,183,37.76
JarvanIV,Fizz,631,299,332,47.39
JarvanIV,Sona,348,165,183,47.41
JarvanIV,Kindred,471,268,203,56.9
JarvanIV,Ezreal,2500,1348,1152,53.92
JarvanIV,Seraphine,789,411,378,52.09
JarvanIV,Yone,1748,931,817,53.26
JarvanIV,Taric,227,110,117,48.46
JarvanIV,Lillia,622,310,312,49.84
JarvanIV,Ahri,1571,842,729,53.6
JarvanIV,Ornn,488,250,238,51.23
JarvanIV,Hwei,666,349,317,52.4
JarvanIV,Darius,1865,959,906,51.42
JarvanIV,Hecarim,462,230,232,49.78
JarvanIV,Twitch,837,502,335,59.98
JarvanIV,Blitzcrank,742,448,294,60.38
JarvanIV,Camille,413,237,176,57.38
JarvanIV,Khazix,512,277,235,54.1
JarvanIV,Milio,683,317,366,46.41
JarvanIV,Renekton,638,331,307,51.88
JarvanIV,Renata,268,119,149,44.4
JarvanIV,Vex,537,258,279,48.04
JarvanIV,Sejuani,523,270,253,51.63
JarvanIV,Teemo,1177,643,534,54.63
JarvanIV,Nidalee,344,183,161,53.2
JarvanIV,Lulu,1449,820,629,56.59
JarvanIV,Yorick,1036,529,507,51.06
JarvanIV,Aphelios,549,289,260,52.64
JarvanIV,Janna,403,203,200,50.37
JarvanIV,Soraka,671,315,356,46.94
JarvanIV,Gnar,449,221,228,49.22
JarvanIV,Zoe,380,205,175,53.95
JarvanIV,Gwen,611,362,249,59.25
JarvanIV,Jinx,2943,1486,1457,50.49
JarvanIV,Nami,1229,589,640,47.93
JarvanIV,Sion,781,419,362,53.65
JarvanIV,Jax,923,449,474,48.65
JarvanIV,Ambessa,688,369,319,53.63
JarvanIV,Rumble,296,166,130,56.08
JarvanIV,Briar,737,340,397,46.13
JarvanIV,Nilah,389,198,191,50.9
JarvanIV,Akshan,383,204,179,53.26
JarvanIV,Varus,1021,530,491,51.91
JarvanIV,Braum,688,339,349,49.27
JarvanIV,Yuumi,877,426,451,48.57
JarvanIV,Chogath,1393,742,651,53.27
JarvanIV,Sivir,584,284,300,48.63
JarvanIV,Gragas,676,372,304,55.03
JarvanIV,Viktor,972,467,505,48.05
JarvanIV,Zilean,389,210,179,53.98
JarvanIV,XinZhao,809,405,404,50.06
JarvanIV,Morgana,1015,579,436,57.04
JarvanIV,Graves,672,355,317,52.83
JarvanIV,Shen,801,402,399,50.19
JarvanIV,Olaf,179,87,92,48.6
JarvanIV,Bard,396,216,180,54.55
JarvanIV,Ryze,383,199,184,51.96
JarvanIV,Syndra,719,364,355,50.63
JarvanIV,Zyra,912,447,465,49.01
JarvanIV,Karma,1200,640,560,53.33
JarvanIV,Samira,619,296,323,47.82
JarvanIV,Nunu,719,383,336,53.27
JarvanIV,Xerath,918,495,423,53.92
JarvanIV,AurelionSol,455,220,235,48.35
JarvanIV,Talon,553,272,281,49.19
JarvanIV,Pantheon,1736,933,803,53.74
JarvanIV,Azir,369,159,210,43.09
JarvanIV,TwistedFate,423,208,215,49.17
JarvanIV,Kassadin,195,101,94,51.79
JarvanIV,Smolder,767,378,389,49.28
JarvanIV,Zed,1059,587,472,55.43
JarvanIV,Brand,727,356,371,48.97
JarvanIV,Zac,496,240,256,48.39
JarvanIV,Senna,829,415,414,50.06
JarvanIV,Illaoi,462,244,218,52.81
JarvanIV,Orianna,471,240,231,50.96
JarvanIV,Udyr,428,251,177,58.64
JarvanIV,Galio,951,503,448,52.89
JarvanIV,Urgot,457,223,234,48.8
JarvanIV,Corki,539,280,259,51.95
JarvanIV,Alistar,525,307,218,58.48
JarvanIV,Quinn,389,188,201,48.33
JarvanIV,Karthus,277,120,157,43.32
JarvanIV,DrMundo,487,263,224,54
JarvanIV,Zeri,484,265,219,54.75
JarvanIV,Maokai,435,222,213,51.03
JarvanIV,Belveth,227,145,82,63.88
JarvanIV,Lissandra,341,171,170,50.15
JarvanIV,Anivia,343,161,182,46.94
JarvanIV,Ivern,195,87,108,44.62
JarvanIV,Ziggs,376,160,216,42.55
JarvanIV,Shyvana,277,143,134,51.62
JarvanIV,KogMaw,352,146,206,41.48
JarvanIV,Annie,395,226,169,57.22
JarvanIV,RekSai,137,69,68,50.36
JarvanIV,Fiora,343,171,172,49.85
JarvanIV,FiddleSticks,535,266,269,49.72
JarvanIV,Jayce,551,305,246,55.35
Fizz,Irelia,908,465,443,51.21
Fizz,Kayn,1805,935,870,51.8
Fizz,Katarina,897,502,395,55.96
Fizz,Vayne,1407,663,744,47.12
Fizz,DrMundo,677,330,347,48.74
Fizz,Mordekaiser,1612,720,892,44.67
Fizz,Amumu,1193,593,600,49.71
Fizz,Pyke,973,548,425,56.32
Fizz,Varus,929,463,466,49.84
Fizz,Thresh,1444,737,707,51.04
Fizz,Volibear,1290,595,695,46.12
Fizz,LeeSin,1217,625,592,51.36
Fizz,Kayle,768,368,400,47.92
Fizz,Ezreal,2218,1128,1090,50.86
Fizz,Morgana,1447,742,705,51.28
Fizz,Olaf,218,106,112,48.62
Fizz,Hecarim,405,206,199,50.86
Fizz,Veigar,1568,739,829,47.13
Fizz,Tristana,1015,451,564,44.43
Fizz,Braum,580,236,344,40.69
Fizz,Jax,1059,558,501,52.69
Fizz,Diana,1666,788,878,47.3
Fizz,Ahri,1334,736,598,55.17
Fizz,Aphelios,577,243,334,42.11
Fizz,Senna,850,440,410,51.76
Fizz,KSante,439,215,224,48.97
Fizz,Yasuo,2163,1028,1135,47.53
Fizz,MissFortune,2860,1304,1556,45.59
Fizz,Lux,3150,1558,1592,49.46
Fizz,Heimerdinger,578,263,315,45.5
Fizz,Warwick,1880,880,1000,46.81
Fizz,Ashe,2008,1073,935,53.44
Fizz,Garen,1939,932,1007,48.07
Fizz,Shyvana,315,141,174,44.76
Fizz,Mel,3085,1588,1497,51.47
Fizz,Taliyah,232,101,131,43.53
Fizz,Swain,1044,485,559,46.46
Fizz,Sett,1634,776,858,47.49
Fizz,Lucian,783,423,360,54.02
Fizz,Sona,382,167,215,43.72
Fizz,Darius,2170,1004,1166,46.27
Fizz,Gragas,565,295,270,52.21
Fizz,KogMaw,364,192,172,52.75
Fizz,Gnar,414,209,205,50.48
Fizz,Nami,1097,485,612,44.21
Fizz,Yorick,1131,475,656,42
Fizz,Sejuani,431,198,233,45.94
Fizz,Kalista,287,139,148,48.43
Fizz,Yuumi,895,477,418,53.3
Fizz,Urgot,606,272,334,44.88
Fizz,Viego,1459,766,693,52.5
Fizz,Qiyana,290,153,137,52.76
Fizz,Draven,576,306,270,53.13
Fizz,MasterYi,1364,612,752,44.87
Fizz,Akali,1178,606,572,51.44
Fizz,Twitch,940,498,442,52.98
Fizz,Blitzcrank,764,371,393,48.56
Fizz,Shaco,1158,625,533,53.97
Fizz,Ziggs,474,243,231,51.27
Fizz,Rumble,243,112,131,46.09
Fizz,Aurora,781,360,421,46.09
Fizz,Nautilus,1214,617,597,50.82
Fizz,Xerath,1080,532,548,49.26
Fizz,Khazix,582,322,260,55.33
Fizz,Karma,1062,507,555,47.74
Fizz,Gwen,612,332,280,54.25
Fizz,Briar,895,439,456,49.05
Fizz,Zilean,295,159,136,53.9
Fizz,RekSai,117,42,75,35.9
Fizz,Ornn,435,242,193,55.63
Fizz,Seraphine,978,496,482,50.72
Fizz,Lillia,625,310,315,49.6
Fizz,Samira,890,463,427,52.02
Fizz,Neeko,604,317,287,52.48
Fizz,Ryze,311,144,167,46.3
Fizz,Smolder,778,415,363,53.34
Fizz,Zyra,950,508,442,53.47
Fizz,Zeri,409,184,225,44.99
Fizz,Zed,1421,704,717,49.54
Fizz,Lulu,1160,560,600,48.28
Fizz,Teemo,1479,745,734,50.37
Fizz,Vi,1027,509,518,49.56
Fizz,Galio,1006,476,530,47.32
Fizz,Rell,458,250,208,54.59
Fizz,Yone,1920,1105,815,57.55
Fizz,Aatrox,954,514,440,53.88
Fizz,JarvanIV,631,332,299,52.61
Fizz,Cassiopeia,292,166,126,56.85
Fizz,Nasus,797,346,451,43.41
Fizz,Pantheon,1742,835,907,47.93
Fizz,Singed,279,127,152,45.52
Fizz,Caitlyn,2920,1403,1517,48.05
Fizz,Chogath,1311,683,628,52.1
Fizz,Ekko,1049,550,499,52.43
Fizz,Leblanc,588,288,300,48.98
Fizz,Jhin,2264,1208,1056,53.36
Fizz,Nidalee,248,150,98,60.48
Fizz,Brand,962,484,478,50.31
Fizz,Renekton,559,283,276,50.63
Fizz,Rakan,453,230,223,50.77
Fizz,Vladimir,831,387,444,46.57
Fizz,Xayah,645,336,309,52.09
Fizz,Talon,641,320,321,49.92
Fizz,Renata,189,105,84,55.56
Fizz,Kaisa,1730,897,833,51.85
Fizz,Evelynn,489,272,217,55.62
Fizz,Syndra,810,389,421,48.02
Fizz,Annie,348,220,128,63.22
Fizz,Rammus,392,165,227,42.09
Fizz,Velkoz,771,412,359,53.44
Fizz,Viktor,841,412,429,48.99
Fizz,Soraka,565,281,284,49.73
Fizz,Corki,342,172,170,50.29
Fizz,Akshan,377,193,184,51.19
Fizz,Milio,674,288,386,42.73
Fizz,Naafiri,377,193,184,51.19
Fizz,Hwei,705,365,340,51.77
Fizz,Kennen,302,151,151,50
Fizz,TahmKench,921,457,464,49.62
Fizz,Gangplank,506,265,241,52.37
Fizz,Alistar,408,197,211,48.28
Fizz,Illaoi,492,206,286,41.87
Fizz,Nocturne,1253,616,637,49.16
Fizz,Kassadin,259,123,136,47.49
Fizz,TwistedFate,451,268,183,59.42
Fizz,Jinx,2794,1391,1403,49.79
Fizz,Ambessa,546,316,230,57.88
Fizz,Malzahar,1191,550,641,46.18
Fizz,Sion,822,388,434,47.2
Fizz,MonkeyKing,699,344,355,49.21
Fizz,Orianna,430,228,202,53.02
Fizz,Malphite,973,525,448,53.96
Fizz,Tryndamere,780,358,422,45.9
Fizz,Poppy,654,308,346,47.09
Fizz,Kindred,508,243,265,47.83
Fizz,Rengar,380,216,164,56.84
Fizz,Sylas,1332,644,688,48.35
Fizz,Skarner,244,136,108,55.74
Fizz,AurelionSol,511,265,246,51.86
Fizz,Elise,740,373,367,50.41
Fizz,Quinn,387,200,187,51.68
Fizz,Zac,460,280,180,60.87
Fizz,Riven,499,292,207,58.52
Fizz,Zoe,427,261,166,61.12
Fizz,Shen,754,341,413,45.23
Fizz,Taric,281,143,138,50.89
Fizz,Anivia,380,192,188,50.53
Fizz,Kled,221,108,113,48.87
Fizz,FiddleSticks,553,237,316,42.86
Fizz,Ivern,156,102,54,65.38
Fizz,Belveth,241,141,100,58.51
Fizz,Leona,938,450,488,47.97
Fizz,Camille,377,239,138,63.4
Fizz,Sivir,450,219,231,48.67
Fizz,Karthus,224,89,135,39.73
Fizz,Trundle,612,313,299,51.14
Fizz,XinZhao,718,365,353,50.84
Fizz,Azir,251,129,122,51.39
Fizz,Jayce,473,244,229,51.59
Fizz,Janna,333,157,176,47.15
Fizz,Fiora,374,184,190,49.2
Fizz,Vex,597,286,311,47.91
Fizz,Nunu,694,338,356,48.7
Fizz,Graves,645,341,304,52.87
Fizz,Nilah,344,162,182,47.09
Fizz,Bard,311,148,163,47.59
Fizz,Udyr,397,183,214,46.1
Fizz,Maokai,453,243,210,53.64
Fizz,Lissandra,419,157,262,37.47
Ziggs,Irelia,592,313,279,52.87
Ziggs,Kayn,1133,558,575,49.25
Ziggs,Katarina,602,337,265,55.98
Ziggs,Vayne,872,432,440,49.54
Ziggs,DrMundo,460,238,222,51.74
Ziggs,Mordekaiser,1152,583,569,50.61
Ziggs,Udyr,299,125,174,41.81
Ziggs,Yorick,723,311,412,43.02
Ziggs,Sivir,387,204,183,52.71
Ziggs,Nautilus,903,461,442,51.05
Ziggs,Darius,1411,723,688,51.24
Ziggs,Volibear,915,471,444,51.48
Ziggs,AurelionSol,369,212,157,57.45
Ziggs,Caitlyn,2391,1194,1197,49.94
Ziggs,TahmKench,681,367,314,53.89
Ziggs,Lillia,436,246,190,56.42
Ziggs,Sylas,822,395,427,48.05
Ziggs,Lux,2209,1070,1139,48.44
Ziggs,Viktor,592,321,271,54.22
Ziggs,Nocturne,839,408,431,48.63
Ziggs,Yasuo,1353,658,695,48.63
Ziggs,Nilah,311,163,148,52.41
Ziggs,Bard,230,119,111,51.74
Ziggs,Jax,713,400,313,56.1
Ziggs,Jhin,1500,766,734,51.07
Ziggs,Thresh,965,556,409,57.62
Ziggs,Aurora,543,300,243,55.25
Ziggs,Viego,1044,519,525,49.71
Ziggs,Mel,1733,1042,691,60.13
Ziggs,Jinx,2110,1023,1087,48.48
Ziggs,Velkoz,499,264,235,52.91
Ziggs,Kindred,385,194,191,50.39
Ziggs,Lulu,785,439,346,55.92
Ziggs,Ashe,1568,749,819,47.77
Ziggs,Fiora,310,157,153,50.65
Ziggs,Teemo,1182,542,640,45.85
Ziggs,Kaisa,1032,532,500,51.55
Ziggs,Milio,429,203,226,47.32
Ziggs,Illaoi,369,166,203,44.99
Ziggs,Malzahar,785,375,410,47.77
Ziggs,Khazix,376,204,172,54.26
Ziggs,Leona,519,232,287,44.7
Ziggs,FiddleSticks,348,200,148,57.47
Ziggs,Gragas,456,245,211,53.73
Ziggs,LeeSin,862,447,415,51.86
Ziggs,Karma,821,441,380,53.71
Ziggs,Sett,1222,593,629,48.53
Ziggs,Graves,459,247,212,53.81
Ziggs,Leblanc,324,158,166,48.77
Ziggs,Yuumi,521,242,279,46.45
Ziggs,KSante,354,178,176,50.28
Ziggs,Zed,805,408,397,50.68
Ziggs,Fizz,474,231,243,48.73
Ziggs,Draven,419,233,186,55.61
Ziggs,Renata,129,77,52,59.69
Ziggs,Warwick,1182,570,612,48.22
Ziggs,MissFortune,1805,979,826,54.24
Ziggs,Diana,1245,681,564,54.7
Ziggs,Tristana,701,350,351,49.93
Ziggs,Taric,149,68,81,45.64
Ziggs,Sejuani,304,147,157,48.36
Ziggs,MonkeyKing,469,218,251,46.48
Ziggs,Kalista,267,149,118,55.81
Ziggs,Ezreal,1622,841,781,51.85
Ziggs,Ekko,667,355,312,53.22
Ziggs,Nami,698,331,367,47.42
Ziggs,Cassiopeia,272,165,107,60.66
Ziggs,Lucian,474,219,255,46.2
Ziggs,Skarner,236,126,110,53.39
Ziggs,Ryze,232,105,127,45.26
Ziggs,Elise,491,284,207,57.84
Ziggs,Kayle,454,233,221,51.32
Ziggs,Tryndamere,415,202,213,48.67
Ziggs,Akali,875,444,431,50.74
Ziggs,Neeko,360,209,151,58.06
Ziggs,Yone,1460,761,699,52.12
Ziggs,Singed,186,73,113,39.25
Ziggs,Smolder,510,293,217,57.45
Ziggs,Pyke,670,337,333,50.3
Ziggs,Aatrox,748,411,337,54.95
Ziggs,Xayah,397,217,180,54.66
Ziggs,Rakan,356,150,206,42.13
Ziggs,Rengar,230,136,94,59.13
Ziggs,Vi,696,388,308,55.75
Ziggs,Pantheon,1193,582,611,48.78
Ziggs,Evelynn,318,204,114,64.15
Ziggs,Nasus,522,257,265,49.23
Ziggs,Briar,587,248,339,42.25
Ziggs,Veigar,850,450,400,52.94
Ziggs,Shen,527,258,269,48.96
Ziggs,Shaco,729,337,392,46.23
Ziggs,Chogath,978,512,466,52.35
Ziggs,Poppy,380,177,203,46.58
Ziggs,Senna,620,341,279,55
Ziggs,XinZhao,529,286,243,54.06
Ziggs,Taliyah,217,123,94,56.68
Ziggs,Samira,592,320,272,54.05
Ziggs,Kled,147,91,56,61.9
Ziggs,Varus,690,407,283,58.99
Ziggs,Gangplank,338,188,150,55.62
Ziggs,Olaf,170,82,88,48.24
Ziggs,Nidalee,252,154,98,61.11
Ziggs,Morgana,1111,519,592,46.71
Ziggs,Soraka,468,236,232,50.43
Ziggs,Trundle,430,227,203,52.79
Ziggs,Ahri,894,463,431,51.79
Ziggs,Ornn,365,181,184,49.59
Ziggs,Amumu,748,369,379,49.33
Ziggs,Galio,742,326,416,43.94
Ziggs,Seraphine,739,373,366,50.47
Ziggs,Zyra,648,332,316,51.23
Ziggs,Malphite,788,453,335,57.49
Ziggs,Garen,1196,532,664,44.48
Ziggs,Vladimir,444,222,222,50
Ziggs,MasterYi,855,432,423,50.53
Ziggs,Camille,259,144,115,55.6
Ziggs,Naafiri,277,140,137,50.54
Ziggs,Syndra,494,255,239,51.62
Ziggs,Blitzcrank,611,307,304,50.25
Ziggs,Riven,380,186,194,48.95
Ziggs,Hwei,580,274,306,47.24
Ziggs,Nunu,498,241,257,48.39
Ziggs,Zac,309,143,166,46.28
Ziggs,Annie,224,123,101,54.91
Ziggs,Renekton,367,192,175,52.32
Ziggs,Swain,755,332,423,43.97
Ziggs,Aphelios,451,244,207,54.1
Ziggs,Ambessa,454,235,219,51.76
Ziggs,Sona,270,116,154,42.96
Ziggs,Xerath,641,367,274,57.25
Ziggs,Zeri,291,134,157,46.05
Ziggs,Zilean,220,106,114,48.18
Ziggs,Akshan,245,118,127,48.16
Ziggs,Heimerdinger,442,213,229,48.19
Ziggs,Kassadin,171,66,105,38.6
Ziggs,Karthus,176,85,91,48.3
Ziggs,Twitch,579,237,342,40.93
Ziggs,Janna,255,126,129,49.41
Ziggs,Urgot,420,221,199,52.62
Ziggs,Ivern,136,51,85,37.5
Ziggs,Sion,546,301,245,55.13
Ziggs,Zoe,378,182,196,48.15
Ziggs,Talon,467,223,244,47.75
Ziggs,Gnar,292,180,112,61.64
Ziggs,Braum,387,197,190,50.9
Ziggs,Gwen,414,194,220,46.86
Ziggs,Corki,262,142,120,54.2
Ziggs,Brand,494,249,245,50.4
Ziggs,Qiyana,167,73,94,43.71
Ziggs,Hecarim,280,152,128,54.29
Ziggs,Alistar,275,149,126,54.18
Ziggs,Jayce,317,172,145,54.26
Ziggs,Orianna,332,177,155,53.31
Ziggs,RekSai,96,57,39,59.38
Ziggs,Belveth,171,92,79,53.8
Ziggs,Lissandra,264,136,128,51.52
Ziggs,Rell,386,199,187,51.55
Ziggs,Rammus,280,149,131,53.21
Ziggs,Azir,172,96,76,55.81
Ziggs,Anivia,243,118,125,48.56
Ziggs,KogMaw,242,120,122,49.59
Ziggs,Vex,416,259,157,62.26
Ziggs,Quinn,252,126,126,50
Ziggs,JarvanIV,376,216,160,57.45
Ziggs,Rumble,180,115,65,63.89
Ziggs,TwistedFate,271,133,138,49.08
Ziggs,Maokai,300,148,152,49.33
Ziggs,Kennen,181,98,83,54.14
Ziggs,Shyvana,213,85,128,39.91
Zyra,Sett,2576,1291,1285,50.12
Zyra,Taliyah,413,204,209,49.39
Zyra,Cassiopeia,490,260,230,53.06
Zyra,Kaisa,2680,1487,1193,55.49
Zyra,Neeko,1038,574,464,55.3
Zyra,Malphite,1577,788,789,49.97
Zyra,Jax,1480,822,658,55.54
Zyra,Xayah,745,422,323,56.64
Zyra,Rakan,650,389,261,59.85
Zyra,Gwen,879,458,421,52.1
Zyra,Kayn,2436,1243,1193,51.03
Zyra,Thresh,2247,1233,1014,54.87
Zyra,Ezreal,4033,2192,1841,54.35
Zyra,Yuumi,1340,676,664,50.45
Zyra,Irelia,1500,755,745,50.33
Zyra,Lillia,953,475,478,49.84
Zyra,Sylas,2327,1185,1142,50.92
Zyra,Caitlyn,4653,2392,2261,51.41
Zyra,Lux,4391,2296,2095,52.29
Zyra,Kennen,465,224,241,48.17
Zyra,MonkeyKing,1173,569,604,48.51
Zyra,Vladimir,1143,595,548,52.06
Zyra,Vayne,1890,952,938,50.37
Zyra,Yone,3065,1693,1372,55.24
Zyra,Smolder,1022,527,495,51.57
Zyra,Poppy,1041,578,463,55.52
Zyra,MasterYi,1840,968,872,52.61
Zyra,AurelionSol,632,327,305,51.74
Zyra,Seraphine,1528,790,738,51.7
Zyra,Mordekaiser,2234,1157,1077,51.79
Zyra,Nunu,995,547,448,54.97
Zyra,Aurora,1449,717,732,49.48
Zyra,Nami,1707,950,757,55.65
Zyra,Swain,1690,845,845,50
Zyra,Janna,516,257,259,49.81
Zyra,Briar,1281,600,681,46.84
Zyra,Kassadin,310,139,171,44.84
Zyra,Yasuo,3217,1530,1687,47.56
Zyra,Renata,293,149,144,50.85
Zyra,Amumu,1715,789,926,46.01
Zyra,Tristana,1517,781,736,51.48
Zyra,Pyke,1388,737,651,53.1
Zyra,Fiora,574,294,280,51.22
Zyra,Samira,1249,669,580,53.56
Zyra,Talon,969,526,443,54.28
Zyra,Varus,1633,772,861,47.27
Zyra,Urgot,816,416,400,50.98
Zyra,Zed,1840,1016,824,55.22
Zyra,Mel,3350,1709,1641,51.01
Zyra,Sejuani,647,322,325,49.77
Zyra,Ahri,2112,1235,877,58.48
Zyra,Jinx,4495,2294,2201,51.03
Zyra,Nautilus,1751,920,831,52.54
Zyra,Yorick,1514,721,793,47.62
Zyra,Vi,1657,894,763,53.95
Zyra,Shen,1038,502,536,48.36
Zyra,Kindred,810,454,356,56.05
Zyra,Ekko,1522,831,691,54.6
Zyra,Rell,870,475,395,54.6
Zyra,Gragas,1045,598,447,57.22
Zyra,Blitzcrank,1390,749,641,53.88
Zyra,Teemo,2250,1144,1106,50.84
Zyra,Shaco,1716,853,863,49.71
Zyra,Malzahar,1607,784,823,48.79
Zyra,Ashe,3468,1849,1619,53.32
Zyra,TahmKench,1415,772,643,54.56
Zyra,Kayle,1033,516,517,49.95
Zyra,Tryndamere,841,444,397,52.79
Zyra,Akali,1843,952,891,51.65
Zyra,Jhin,3502,1764,1738,50.37
Zyra,Maokai,853,432,421,50.64
Zyra,Ryze,542,305,237,56.27
Zyra,Viktor,1594,800,794,50.19
Zyra,Twitch,1206,623,583,51.66
Zyra,Lulu,1993,1070,923,53.69
Zyra,DrMundo,1023,456,567,44.57
Zyra,Fizz,950,442,508,46.53
Zyra,Leona,1529,826,703,54.02
Zyra,Darius,3217,1795,1422,55.8
Zyra,FiddleSticks,855,426,429,49.82
Zyra,Hwei,1144,597,547,52.19
Zyra,Anivia,610,304,306,49.84
Zyra,Illaoi,801,431,370,53.81
Zyra,Chogath,1898,989,909,52.11
Zyra,MissFortune,3940,2012,1928,51.07
Zyra,Braum,875,461,414,52.69
Zyra,Galio,1537,749,788,48.73
Zyra,TwistedFate,614,357,257,58.14
Zyra,Singed,457,208,249,45.51
Zyra,Trundle,924,474,450,51.3
Zyra,Rammus,463,220,243,47.52
Zyra,Sona,551,276,275,50.09
Zyra,Kled,320,167,153,52.19
Zyra,Zeri,823,394,429,47.87
Zyra,Pantheon,2726,1464,1262,53.71
Zyra,Gangplank,816,440,376,53.92
Zyra,Zoe,690,369,321,53.48
Zyra,Draven,792,460,332,58.08
Zyra,Katarina,1312,774,538,58.99
Zyra,Garen,2534,1259,1275,49.68
Zyra,Brand,1298,695,603,53.54
Zyra,Zac,827,444,383,53.69
Zyra,Karma,2140,1101,1039,51.45
Zyra,Velkoz,932,482,450,51.72
Zyra,Hecarim,700,375,325,53.57
Zyra,Soraka,1004,474,530,47.21
Zyra,Evelynn,617,343,274,55.59
Zyra,Morgana,2273,1194,1079,52.53
Zyra,Nasus,1007,507,500,50.35
Zyra,Skarner,404,236,168,58.42
Zyra,Ziggs,648,316,332,48.77
Zyra,Sivir,969,519,450,53.56
Zyra,Nocturne,2126,1052,1074,49.48
Zyra,KogMaw,486,220,266,45.27
Zyra,LeeSin,2815,1508,1307,53.57
Zyra,Orianna,711,341,370,47.96
Zyra,Gnar,690,380,310,55.07
Zyra,Khazix,914,466,448,50.98
Zyra,Diana,2733,1380,1353,50.49
Zyra,KSante,884,435,449,49.21
Zyra,Syndra,1128,585,543,51.86
Zyra,Ambessa,1160,646,514,55.69
Zyra,Elise,1158,639,519,55.18
Zyra,Akshan,466,226,240,48.5
Zyra,Sion,1370,648,722,47.3
Zyra,Renekton,788,407,381,51.65
Zyra,Viego,2369,1109,1260,46.81
Zyra,Riven,671,349,322,52.01
Zyra,Azir,545,266,279,48.81
Zyra,Ornn,692,330,362,47.69
Zyra,Lucian,1197,647,550,54.05
Zyra,Karthus,580,341,239,58.79
Zyra,Heimerdinger,834,438,396,52.52
Zyra,Camille,573,309,264,53.93
Zyra,Nidalee,594,350,244,58.92
Zyra,Aphelios,981,523,458,53.31
Zyra,Xerath,1756,833,923,47.44
Zyra,RekSai,189,102,87,53.97
Zyra,Warwick,2567,1212,1355,47.21
Zyra,Shyvana,386,212,174,54.92
Zyra,Udyr,574,286,288,49.83
Zyra,Milio,939,473,466,50.37
Zyra,XinZhao,1035,507,528,48.99
Zyra,Veigar,1640,857,783,52.26
Zyra,Vex,961,486,475,50.57
Zyra,Graves,1034,597,437,57.74
Zyra,JarvanIV,912,465,447,50.99
Zyra,Rengar,461,244,217,52.93
Zyra,Senna,1415,708,707,50.04
Zyra,Quinn,631,300,331,47.54
Zyra,Corki,634,337,297,53.15
Zyra,Taric,317,158,159,49.84
Zyra,Alistar,595,306,289,51.43
Zyra,Leblanc,1019,569,450,55.84
Zyra,Qiyana,427,240,187,56.21
Zyra,Olaf,446,218,228,48.88
Zyra,Volibear,1726,926,800,53.65
Zyra,Lissandra,552,303,249,54.89
Zyra,Bard,580,297,283,51.21
Zyra,Naafiri,620,331,289,53.39
Zyra,Kalista,446,241,205,54.04
Zyra,Ivern,277,170,107,61.37
Zyra,Nilah,566,269,297,47.53
Zyra,Aatrox,1480,804,676,54.32
Zyra,Zilean,472,247,225,52.33
Zyra,Belveth,400,204,196,51
Zyra,Annie,607,299,308,49.26
Zyra,Rumble,512,232,280,45.31
Zyra,Jayce,945,558,387,59.05
Taliyah,Gwen,289,148,141,51.21
Taliyah,JarvanIV,256,118,138,46.09
Taliyah,Yone,848,428,420,50.47
Taliyah,Zyra,413,209,204,50.61
Taliyah,Seraphine,339,183,156,53.98
Taliyah,Kayle,313,140,173,44.73
Taliyah,MonkeyKing,360,210,150,58.33
Taliyah,RekSai,56,29,27,51.79
Taliyah,Sett,708,359,349,50.71
Taliyah,Vi,561,255,306,45.45
Taliyah,AurelionSol,239,99,140,41.42
Taliyah,Corki,223,110,113,49.33
Taliyah,Milio,335,179,156,53.43
Taliyah,Shen,328,183,145,55.79
Taliyah,Teemo,596,240,356,40.27
Taliyah,Twitch,383,172,211,44.91
Taliyah,Nautilus,604,331,273,54.8
Taliyah,Yasuo,1165,533,632,45.75
Taliyah,Evelynn,153,78,75,50.98
Taliyah,Irelia,439,220,219,50.11
Taliyah,Tristana,479,251,228,52.4
Taliyah,Lux,1149,518,631,45.08
Taliyah,Gnar,241,127,114,52.7
Taliyah,Jax,509,263,246,51.67
Taliyah,Aurora,367,212,155,57.77
Taliyah,Swain,444,226,218,50.9
Taliyah,Bard,200,106,94,53
Taliyah,Briar,409,217,192,53.06
Taliyah,Fizz,232,131,101,56.47
Taliyah,Jinx,1295,594,701,45.87
Taliyah,Soraka,277,105,172,37.91
Taliyah,Volibear,566,307,259,54.24
Taliyah,Viego,678,336,342,49.56
Taliyah,Samira,340,199,141,58.53
Taliyah,Leona,492,265,227,53.86
Taliyah,Darius,926,502,424,54.21
Taliyah,Shaco,410,201,209,49.02
Taliyah,Zed,406,188,218,46.31
Taliyah,Kaisa,855,470,385,54.97
Taliyah,Braum,330,180,150,54.55
Taliyah,Ornn,232,105,127,45.26
Taliyah,Yorick,390,168,222,43.08
Taliyah,Zoe,222,138,84,62.16
Taliyah,Blitzcrank,402,215,187,53.48
Taliyah,Pantheon,857,440,417,51.34
Taliyah,Rengar,224,123,101,54.91
Taliyah,Ekko,477,260,217,54.51
Taliyah,Kalista,221,124,97,56.11
Taliyah,Thresh,792,453,339,57.2
Taliyah,Gangplank,243,137,106,56.38
Taliyah,Nunu,327,167,160,51.07
Taliyah,Rakan,244,119,125,48.77
Taliyah,Varus,512,279,233,54.49
Taliyah,Khazix,265,175,90,66.04
Taliyah,Caitlyn,1187,582,605,49.03
Taliyah,Taric,154,81,73,52.6
Taliyah,LeeSin,814,427,387,52.46
Taliyah,Sona,167,79,88,47.31
Taliyah,Mordekaiser,629,282,347,44.83
Taliyah,Lillia,301,146,155,48.5
Taliyah,Fiora,194,116,78,59.79
Taliyah,Nocturne,533,228,305,42.78
Taliyah,Ryze,189,84,105,44.44
Taliyah,Sion,477,229,248,48.01
Taliyah,Ahri,812,401,411,49.38
Taliyah,Ashe,1023,522,501,51.03
Taliyah,Singed,158,67,91,42.41
Taliyah,Nasus,260,148,112,56.92
Taliyah,Amumu,527,231,296,43.83
Taliyah,Ezreal,1166,584,582,50.09
Taliyah,Veigar,428,194,234,45.33
Taliyah,Ziggs,217,94,123,43.32
Taliyah,Sylas,753,389,364,51.66
Taliyah,Viktor,383,225,158,58.75
Taliyah,Draven,270,158,112,58.52
Taliyah,Katarina,346,157,189,45.38
Taliyah,MasterYi,533,264,269,49.53
Taliyah,Nilah,182,124,58,68.13
Taliyah,Nami,553,255,298,46.11
Taliyah,Kayn,688,349,339,50.73
Taliyah,Akshan,210,112,98,53.33
Taliyah,XinZhao,361,150,211,41.55
Taliyah,MissFortune,895,485,410,54.19
Taliyah,Jhin,905,446,459,49.28
Taliyah,Neeko,247,139,108,56.28
Taliyah,Vladimir,301,132,169,43.85
Taliyah,Smolder,336,174,162,51.79
Taliyah,Malphite,476,219,257,46.01
Taliyah,Annie,219,96,123,43.84
Taliyah,KogMaw,176,79,97,44.89
Taliyah,Alistar,214,110,104,51.4
Taliyah,Galio,393,210,183,53.44
Taliyah,FiddleSticks,246,138,108,56.1
Taliyah,Xerath,407,176,231,43.24
Taliyah,Lucian,370,187,183,50.54
Taliyah,Skarner,196,105,91,53.57
Taliyah,Diana,754,341,413,45.23
Taliyah,Vex,210,105,105,50
Taliyah,Karthus,211,117,94,55.45
Taliyah,TahmKench,440,195,245,44.32
Taliyah,Camille,199,107,92,53.77
Taliyah,Aphelios,330,144,186,43.64
Taliyah,Renata,120,71,49,59.17
Taliyah,Warwick,627,317,310,50.56
Taliyah,Morgana,473,211,262,44.61
Taliyah,Yuumi,402,229,173,56.97
Taliyah,Mel,1093,568,525,51.97
Taliyah,Cassiopeia,148,88,60,59.46
Taliyah,Heimerdinger,227,113,114,49.78
Taliyah,Azir,185,87,98,47.03
Taliyah,Chogath,584,309,275,52.91
Taliyah,Poppy,315,151,164,47.94
Taliyah,Illaoi,236,113,123,47.88
Taliyah,Graves,354,205,149,57.91
Taliyah,Vayne,620,329,291,53.06
Taliyah,Hwei,441,243,198,55.1
Taliyah,Sejuani,223,126,97,56.5
Taliyah,KSante,276,149,127,53.99
Taliyah,Karma,644,291,353,45.19
Taliyah,Gragas,306,167,139,54.58
Taliyah,Lissandra,159,77,82,48.43
Taliyah,Lulu,695,347,348,49.93
Taliyah,Garen,800,353,447,44.13
Taliyah,Urgot,259,116,143,44.79
Taliyah,Kindred,255,164,91,64.31
Taliyah,Senna,455,238,217,52.31
Taliyah,Rell,338,164,174,48.52
Taliyah,Ambessa,366,204,162,55.74
Taliyah,Rammus,132,56,76,42.42
Taliyah,Jayce,309,170,139,55.02
Taliyah,Orianna,287,147,140,51.22
Taliyah,Olaf,149,86,63,57.72
Taliyah,Elise,345,162,183,46.96
Taliyah,Pyke,401,225,176,56.11
Taliyah,Anivia,168,78,90,46.43
Taliyah,Kassadin,106,56,50,52.83
Taliyah,Malzahar,443,219,224,49.44
Taliyah,Rumble,154,97,57,62.99
Taliyah,DrMundo,286,132,154,46.15
Taliyah,Nidalee,185,92,93,49.73
Taliyah,Brand,272,136,136,50
Taliyah,Aatrox,495,279,216,56.36
Taliyah,Tryndamere,264,129,135,48.86
Taliyah,Velkoz,282,135,147,47.87
Taliyah,Udyr,205,103,102,50.24
Taliyah,Hecarim,223,117,106,52.47
Taliyah,Naafiri,199,108,91,54.27
Taliyah,Ivern,61,21,40,34.43
Taliyah,Riven,235,134,101,57.02
Taliyah,Belveth,136,84,52,61.76
Taliyah,Xayah,266,110,156,41.35
Taliyah,Akali,569,294,275,51.67
Taliyah,Renekton,276,149,127,53.99
Taliyah,Trundle,251,110,141,43.82
Taliyah,Talon,298,151,147,50.67
Taliyah,Zeri,248,127,121,51.21
Taliyah,Janna,204,78,126,38.24
Taliyah,TwistedFate,215,129,86,60
Taliyah,Syndra,327,148,179,45.26
Taliyah,Qiyana,164,78,86,47.56
Taliyah,Zac,276,143,133,51.81
Taliyah,Quinn,216,112,104,51.85
Taliyah,Maokai,242,112,130,46.28
Taliyah,Sivir,224,93,131,41.52
Taliyah,Zilean,196,105,91,53.57
Taliyah,Leblanc,241,126,115,52.28
Taliyah,Kennen,147,74,73,50.34
Taliyah,Kled,93,47,46,50.54
Taliyah,Shyvana,133,55,78,41.35
Cassiopeia,Gwen,324,146,178,45.06
Cassiopeia,JarvanIV,391,197,194,50.38
Cassiopeia,Yone,1237,656,581,53.03
Cassiopeia,Zyra,490,230,260,46.94
Cassiopeia,Seraphine,526,264,262,50.19
Cassiopeia,Irelia,554,257,297,46.39
Cassiopeia,Pantheon,984,491,493,49.9
Cassiopeia,Kassadin,113,53,60,46.9
Cassiopeia,Jhin,1177,603,574,51.23
Cassiopeia,Yuumi,479,267,212,55.74
Cassiopeia,Ornn,234,110,124,47.01
Cassiopeia,Poppy,396,186,210,46.97
Cassiopeia,MissFortune,1401,669,732,47.75
Cassiopeia,Brand,398,193,205,48.49
Cassiopeia,Yorick,587,261,326,44.46
Cassiopeia,Kayn,902,423,479,46.9
Cassiopeia,Sivir,309,176,133,56.96
Cassiopeia,Xerath,623,296,327,47.51
Cassiopeia,Zac,303,148,155,48.84
Cassiopeia,Amumu,697,302,395,43.33
Cassiopeia,Chogath,853,378,475,44.31
Cassiopeia,Twitch,537,324,213,60.34
Cassiopeia,Mel,1465,798,667,54.47
Cassiopeia,Mordekaiser,853,441,412,51.7
Cassiopeia,Diana,1055,535,520,50.71
Cassiopeia,Ezreal,1289,687,602,53.3
Cassiopeia,Thresh,879,460,419,52.33
Cassiopeia,Nunu,359,171,188,47.63
Cassiopeia,Zed,641,365,276,56.94
Cassiopeia,Rakan,296,166,130,56.08
Cassiopeia,Renekton,308,185,123,60.06
Cassiopeia,Khazix,327,154,173,47.09
Cassiopeia,Malzahar,600,304,296,50.67
Cassiopeia,Lux,1338,648,690,48.43
Cassiopeia,Quinn,228,115,113,50.44
Cassiopeia,TahmKench,561,316,245,56.33
Cassiopeia,Sett,907,421,486,46.42
Cassiopeia,Blitzcrank,497,213,284,42.86
Cassiopeia,Katarina,466,244,222,52.36
Cassiopeia,Shaco,524,260,264,49.62
Cassiopeia,Neeko,417,231,186,55.4
Cassiopeia,Caitlyn,1643,833,810,50.7
Cassiopeia,Nasus,468,247,221,52.78
Cassiopeia,FiddleSticks,278,161,117,57.91
Cassiopeia,Azir,254,103,151,40.55
Cassiopeia,Xayah,294,151,143,51.36
Cassiopeia,Nami,596,320,276,53.69
Cassiopeia,Teemo,1043,477,566,45.73
Cassiopeia,Maokai,286,126,160,44.06
Cassiopeia,Sylas,842,475,367,56.41
Cassiopeia,Corki,225,134,91,59.56
Cassiopeia,Taric,163,69,94,42.33
Cassiopeia,Kayle,457,234,223,51.2
Cassiopeia,Nocturne,597,274,323,45.9
Cassiopeia,Lucian,370,196,174,52.97
Cassiopeia,Garen,952,427,525,44.85
Cassiopeia,Darius,1167,551,616,47.22
Cassiopeia,Aatrox,603,270,333,44.78
Cassiopeia,Jinx,1529,679,850,44.41
Cassiopeia,Morgana,812,393,419,48.4
Cassiopeia,Olaf,199,85,114,42.71
Cassiopeia,Draven,354,178,176,50.28
Cassiopeia,Kled,131,62,69,47.33
Cassiopeia,Vex,411,185,226,45.01
Cassiopeia,Yasuo,1111,567,544,51.04
Cassiopeia,Lulu,707,332,375,46.96
Cassiopeia,XinZhao,438,188,250,42.92
Cassiopeia,Ziggs,272,107,165,39.34
Cassiopeia,LeeSin,775,449,326,57.94
Cassiopeia,Graves,300,152,148,50.67
Cassiopeia,Briar,551,274,277,49.73
Cassiopeia,Ryze,269,122,147,45.35
Cassiopeia,Singed,146,93,53,63.7
Cassiopeia,Nautilus,737,381,356,51.7
Cassiopeia,Aurora,580,294,286,50.69
Cassiopeia,Kindred,282,172,110,60.99
Cassiopeia,Viktor,600,313,287,52.17
Cassiopeia,Vayne,738,393,345,53.25
Cassiopeia,Tryndamere,370,191,179,51.62
Cassiopeia,Hwei,410,200,210,48.78
Cassiopeia,Sona,246,86,160,34.96
Cassiopeia,Udyr,242,140,102,57.85
Cassiopeia,Swain,682,346,336,50.73
Cassiopeia,Kalista,227,143,84,63
Cassiopeia,Aphelios,420,204,216,48.57
Cassiopeia,Soraka,355,167,188,47.04
Cassiopeia,Trundle,345,199,146,57.68
Cassiopeia,Rammus,213,152,61,71.36
Cassiopeia,Fizz,292,126,166,43.15
Cassiopeia,Ashe,1046,509,537,48.66
Cassiopeia,Kennen,214,107,107,50
Cassiopeia,Zeri,320,184,136,57.5
Cassiopeia,Rengar,213,103,110,48.36
Cassiopeia,Ahri,933,473,460,50.7
Cassiopeia,Orianna,255,123,132,48.24
Cassiopeia,Smolder,430,205,225,47.67
Cassiopeia,Gnar,259,157,102,60.62
Cassiopeia,Vi,608,314,294,51.64
Cassiopeia,Rell,373,182,191,48.79
Cassiopeia,Kaisa,966,479,487,49.59
Cassiopeia,Zoe,275,124,151,45.09
Cassiopeia,Naafiri,207,99,108,47.83
Cassiopeia,Hecarim,280,143,137,51.07
Cassiopeia,Velkoz,399,174,225,43.61
Cassiopeia,Warwick,983,479,504,48.73
Cassiopeia,Ambessa,334,159,175,47.6
Cassiopeia,Karma,603,298,305,49.42
Cassiopeia,Jax,528,265,263,50.19
Cassiopeia,Samira,542,281,261,51.85
Cassiopeia,Elise,450,201,249,44.67
Cassiopeia,Sejuani,293,144,149,49.15
Cassiopeia,MasterYi,620,277,343,44.68
Cassiopeia,Annie,200,94,106,47
Cassiopeia,Renata,109,59,50,54.13
Cassiopeia,Riven,258,132,126,51.16
Cassiopeia,Illaoi,220,96,124,43.64
Cassiopeia,Urgot,299,160,139,53.51
Cassiopeia,Viego,795,412,383,51.82
Cassiopeia,Fiora,232,103,129,44.4
Cassiopeia,Akshan,231,124,107,53.68
Cassiopeia,Nilah,270,125,145,46.3
Cassiopeia,Qiyana,178,88,90,49.44
Cassiopeia,Malphite,543,268,275,49.36
Cassiopeia,Lillia,394,210,184,53.3
Cassiopeia,Taliyah,148,60,88,40.54
Cassiopeia,Belveth,197,78,119,39.59
Cassiopeia,Syndra,556,247,309,44.42
Cassiopeia,Camille,203,116,87,57.14
Cassiopeia,Galio,510,248,262,48.63
Cassiopeia,Varus,524,273,251,52.1
Cassiopeia,Gangplank,288,166,122,57.64
Cassiopeia,Akali,615,335,280,54.47
Cassiopeia,Nidalee,202,118,84,58.42
Cassiopeia,Tristana,706,360,346,50.99
Cassiopeia,Senna,518,265,253,51.16
Cassiopeia,Jayce,308,126,182,40.91
Cassiopeia,Veigar,665,313,352,47.07
Cassiopeia,Evelynn,264,148,116,56.06
Cassiopeia,Milio,273,131,142,47.99
Cassiopeia,Lissandra,214,97,117,45.33
Cassiopeia,Volibear,671,380,291,56.63
Cassiopeia,Sion,521,239,282,45.87
Cassiopeia,Gragas,324,187,137,57.72
Cassiopeia,Pyke,619,319,300,51.53
Cassiopeia,Alistar,250,146,104,58.4
Cassiopeia,Talon,426,219,207,51.41
Cassiopeia,MonkeyKing,446,234,212,52.47
Cassiopeia,Vladimir,467,216,251,46.25
Cassiopeia,Leona,548,239,309,43.61
Cassiopeia,Ekko,549,249,300,45.36
Cassiopeia,Janna,188,93,95,49.47
Cassiopeia,DrMundo,390,205,185,52.56
Cassiopeia,Braum,337,168,169,49.85
Cassiopeia,Bard,192,90,102,46.88
Cassiopeia,Rumble,125,69,56,55.2
Cassiopeia,Zilean,159,73,86,45.91
Cassiopeia,Heimerdinger,284,146,138,51.41
Cassiopeia,Shen,314,157,157,50
Cassiopeia,Ivern,99,51,48,51.52
Cassiopeia,Anivia,271,139,132,51.29
Cassiopeia,KogMaw,200,97,103,48.5
Cassiopeia,Karthus,143,79,64,55.24
Cassiopeia,TwistedFate,225,116,109,51.56
Cassiopeia,AurelionSol,233,145,88,62.23
Cassiopeia,Shyvana,146,54,92,36.99
Cassiopeia,RekSai,63,42,21,66.67
Cassiopeia,KSante,306,162,144,52.94
Cassiopeia,Skarner,180,101,79,56.11
Cassiopeia,Leblanc,226,98,128,43.36
Evelynn,Teemo,1144,437,707,38.2
Evelynn,Hecarim,254,140,114,55.12
Evelynn,Veigar,898,377,521,41.98
Evelynn,Ashe,1544,746,798,48.32
Evelynn,Thresh,859,395,464,45.98
Evelynn,Yasuo,1586,762,824,48.05
Evelynn,Sylas,887,431,456,48.59
Evelynn,Zed,842,430,412,51.07
Evelynn,Sivir,386,158,228,40.93
Evelynn,Blitzcrank,649,318,331,49
Evelynn,Darius,1408,718,690,50.99
Evelynn,Garen,1168,535,633,45.8
Evelynn,Lux,2172,1109,1063,51.06
Evelynn,Rakan,437,185,252,42.33
Evelynn,Riven,411,227,184,55.23
Evelynn,JarvanIV,357,184,173,51.54
Evelynn,Taliyah,153,75,78,49.02
Evelynn,Draven,384,199,185,51.82
Evelynn,Malphite,653,309,344,47.32
Evelynn,Diana,1359,644,715,47.39
Evelynn,Akali,883,401,482,45.41
Evelynn,Jinx,1974,930,1044,47.11
Evelynn,Illaoi,336,161,175,47.92
Evelynn,Khazix,522,282,240,54.02
Evelynn,Syndra,472,247,225,52.33
Evelynn,Kaisa,1161,612,549,52.71
Evelynn,Heimerdinger,374,165,209,44.12
Evelynn,FiddleSticks,339,151,188,44.54
Evelynn,Katarina,637,347,290,54.47
Evelynn,Caitlyn,2083,1012,1071,48.58
Evelynn,Pyke,843,440,403,52.19
Evelynn,Pantheon,1273,602,671,47.29
Evelynn,Nocturne,1001,447,554,44.66
Evelynn,Aurora,678,328,350,48.38
Evelynn,MissFortune,1796,867,929,48.27
Evelynn,Soraka,453,204,249,45.03
Evelynn,Yone,1532,779,753,50.85
Evelynn,Irelia,693,324,369,46.75
Evelynn,Morgana,1189,543,646,45.67
Evelynn,Gnar,392,193,199,49.23
Evelynn,Rammus,169,106,63,62.72
Evelynn,Akshan,250,121,129,48.4
Evelynn,Poppy,450,240,210,53.33
Evelynn,Warwick,1290,580,710,44.96
Evelynn,Zoe,313,161,152,51.44
Evelynn,Gragas,373,179,194,47.99
Evelynn,Mordekaiser,1169,480,689,41.06
Evelynn,Viego,1103,542,561,49.14
Evelynn,Udyr,329,172,157,52.28
Evelynn,Ahri,1129,527,602,46.68
Evelynn,Karma,781,419,362,53.65
Evelynn,Sett,1198,597,601,49.83
Evelynn,KSante,339,178,161,52.51
Evelynn,MonkeyKing,457,241,216,52.74
Evelynn,Ekko,772,375,397,48.58
Evelynn,Lucian,450,204,246,45.33
Evelynn,Senna,581,277,304,47.68
Evelynn,Nasus,618,331,287,53.56
Evelynn,Malzahar,712,290,422,40.73
Evelynn,Ezreal,1548,832,716,53.75
Evelynn,Mel,1643,799,844,48.63
Evelynn,Jhin,1466,706,760,48.16
Evelynn,Nami,809,407,402,50.31
Evelynn,Vayne,908,442,466,48.68
Evelynn,LeeSin,1002,505,497,50.4
Evelynn,Seraphine,696,325,371,46.7
Evelynn,Shyvana,228,118,110,51.75
Evelynn,Viktor,684,375,309,54.82
Evelynn,Janna,233,89,144,38.2
Evelynn,Jax,742,375,367,50.54
Evelynn,Olaf,124,61,63,49.19
Evelynn,Shaco,785,456,329,58.09
Evelynn,TahmKench,738,361,377,48.92
Evelynn,RekSai,66,20,46,30.3
Evelynn,Tristana,845,395,450,46.75
Evelynn,Xayah,526,260,266,49.43
Evelynn,MasterYi,945,469,476,49.63
Evelynn,Renekton,321,150,171,46.73
Evelynn,Fiora,342,168,174,49.12
Evelynn,Kayn,1172,559,613,47.7
Evelynn,Gangplank,324,153,171,47.22
Evelynn,Nunu,546,257,289,47.07
Evelynn,Hwei,562,306,256,54.45
Evelynn,Lulu,905,425,480,46.96
Evelynn,Quinn,275,142,133,51.64
Evelynn,Kled,98,51,47,52.04
Evelynn,Samira,675,349,326,51.7
Evelynn,Leona,574,264,310,45.99
Evelynn,DrMundo,523,231,292,44.17
Evelynn,Belveth,141,99,42,70.21
Evelynn,Azir,247,122,125,49.39
Evelynn,Aphelios,542,257,285,47.42
Evelynn,Naafiri,337,114,223,33.83
Evelynn,Aatrox,733,387,346,52.8
Evelynn,Milio,486,210,276,43.21
Evelynn,Ziggs,318,114,204,35.85
Evelynn,Nilah,398,219,179,55.03
Evelynn,Yorick,720,310,410,43.06
Evelynn,Kassadin,211,108,103,51.18
Evelynn,Shen,490,255,235,52.04
Evelynn,Talon,518,253,265,48.84
Evelynn,Chogath,1031,459,572,44.52
Evelynn,Braum,457,246,211,53.83
Evelynn,Anivia,245,126,119,51.43
Evelynn,Corki,243,141,102,58.02
Evelynn,Vladimir,478,223,255,46.65
Evelynn,Nautilus,815,367,448,45.03
Evelynn,Twitch,727,315,412,43.33
Evelynn,Kayle,613,278,335,45.35
Evelynn,Zac,332,160,172,48.19
Evelynn,Amumu,792,344,448,43.43
Evelynn,Smolder,506,269,237,53.16
Evelynn,Rell,407,202,205,49.63
Evelynn,Ornn,327,148,179,45.26
Evelynn,Singed,204,94,110,46.08
Evelynn,Sona,256,113,143,44.14
Evelynn,Neeko,481,267,214,55.51
Evelynn,AurelionSol,384,130,254,33.85
Evelynn,Ambessa,480,239,241,49.79
Evelynn,Taric,160,88,72,55
Evelynn,Kennen,294,161,133,54.76
Evelynn,Yuumi,662,321,341,48.49
Evelynn,Graves,442,267,175,60.41
Evelynn,Leblanc,411,214,197,52.07
Evelynn,Trundle,469,216,253,46.06
Evelynn,Gwen,408,192,216,47.06
Evelynn,Briar,713,336,377,47.12
Evelynn,Zyra,617,274,343,44.41
Evelynn,Rengar,284,196,88,69.01
Evelynn,Varus,620,311,309,50.16
Evelynn,Fizz,489,217,272,44.38
Evelynn,Lillia,534,256,278,47.94
Evelynn,Qiyana,242,145,97,59.92
Evelynn,Swain,748,298,450,39.84
Evelynn,Ivern,142,78,64,54.93
Evelynn,Galio,644,280,364,43.48
Evelynn,Annie,206,115,91,55.83
Evelynn,Vi,770,313,457,40.65
Evelynn,Alistar,278,134,144,48.2
Evelynn,Rumble,208,121,87,58.17
Evelynn,Zeri,287,145,142,50.52
Evelynn,Kindred,358,186,172,51.96
Evelynn,Volibear,976,439,537,44.98
Evelynn,XinZhao,432,193,239,44.68
Evelynn,KogMaw,264,141,123,53.41
Evelynn,Renata,154,81,73,52.6
Evelynn,Bard,244,109,135,44.67
Evelynn,Velkoz,525,267,258,50.86
Evelynn,Brand,589,274,315,46.52
Evelynn,Zilean,240,112,128,46.67
Evelynn,Sejuani,339,167,172,49.26
Evelynn,Cassiopeia,264,116,148,43.94
Evelynn,Orianna,309,171,138,55.34
Evelynn,Vex,463,223,240,48.16
Evelynn,Sion,661,297,364,44.93
Evelynn,Karthus,225,95,130,42.22
Evelynn,Urgot,436,201,235,46.1
Evelynn,Xerath,594,302,292,50.84
Evelynn,Tryndamere,419,180,239,42.96
Evelynn,Camille,181,100,81,55.25
Evelynn,Maokai,354,181,173,51.13
Evelynn,Lissandra,257,123,134,47.86
Evelynn,Kalista,328,167,161,50.91
Evelynn,Jayce,301,146,155,48.5
Evelynn,Elise,597,345,252,57.79
Evelynn,TwistedFate,265,143,122,53.96
Evelynn,Nidalee,215,121,94,56.28
Evelynn,Ryze,239,126,113,52.72
Evelynn,Skarner,229,118,111,51.53
Hecarim,Warwick,1051,482,569,45.86
Hecarim,Evelynn,254,114,140,44.88
Hecarim,Ahri,1073,462,611,43.06
Hecarim,Yasuo,1523,768,755,50.43
Hecarim,Yone,1361,690,671,50.7
Hecarim,Mordekaiser,1034,479,555,46.32
Hecarim,Akali,793,405,388,51.07
Hecarim,Jhin,1537,664,873,43.2
Hecarim,Velkoz,580,262,318,45.17
Hecarim,Trundle,447,202,245,45.19
Hecarim,Amumu,854,384,470,44.96
Hecarim,Fizz,405,199,206,49.14
Hecarim,Kaisa,1300,665,635,51.15
Hecarim,Pantheon,1164,592,572,50.86
Hecarim,Garen,1222,566,656,46.32
Hecarim,Rammus,236,112,124,47.46
Hecarim,Katarina,672,347,325,51.64
Hecarim,Caitlyn,1980,989,991,49.95
Hecarim,Milio,533,256,277,48.03
Hecarim,Ashe,1476,725,751,49.12
Hecarim,LeeSin,1262,614,648,48.65
Hecarim,Varus,759,383,376,50.46
Hecarim,Lux,1957,949,1008,48.49
Hecarim,Aatrox,690,350,340,50.72
Hecarim,Volibear,750,328,422,43.73
Hecarim,Teemo,941,470,471,49.95
Hecarim,Jinx,2154,960,1194,44.57
Hecarim,Leona,621,287,334,46.22
Hecarim,Camille,280,125,155,44.64
Hecarim,Kayn,1163,604,559,51.93
Hecarim,Zeri,369,182,187,49.32
Hecarim,Yuumi,616,282,334,45.78
Hecarim,Shen,508,258,250,50.79
Hecarim,Vi,774,380,394,49.1
Hecarim,Kassadin,178,92,86,51.69
Hecarim,Corki,369,199,170,53.93
Hecarim,Blitzcrank,573,258,315,45.03
Hecarim,Graves,515,244,271,47.38
Hecarim,Aurora,670,312,358,46.57
Hecarim,Mel,1668,843,825,50.54
Hecarim,KSante,456,245,211,53.73
Hecarim,FiddleSticks,464,234,230,50.43
Hecarim,Irelia,643,322,321,50.08
Hecarim,Senna,581,281,300,48.36
Hecarim,Kindred,410,231,179,56.34
Hecarim,Ekko,724,353,371,48.76
Hecarim,Rell,406,209,197,51.48
Hecarim,Briar,547,225,322,41.13
Hecarim,Zoe,255,134,121,52.55
Hecarim,MissFortune,1598,761,837,47.62
Hecarim,Soraka,493,258,235,52.33
Hecarim,MasterYi,785,381,404,48.54
Hecarim,Zed,966,492,474,50.93
Hecarim,Pyke,720,386,334,53.61
Hecarim,Yorick,649,258,391,39.75
Hecarim,Diana,1028,494,534,48.05
Hecarim,Viego,1183,557,626,47.08
Hecarim,Samira,585,276,309,47.18
Hecarim,Thresh,1066,533,533,50
Hecarim,Sett,1073,472,601,43.99
Hecarim,Riven,380,210,170,55.26
Hecarim,Darius,1512,682,830,45.11
Hecarim,AurelionSol,363,183,180,50.41
Hecarim,Karma,931,423,508,45.44
Hecarim,Lillia,509,266,243,52.26
Hecarim,Jax,732,370,362,50.55
Hecarim,Neeko,438,218,220,49.77
Hecarim,Chogath,925,491,434,53.08
Hecarim,Vex,370,183,187,49.46
Hecarim,DrMundo,476,199,277,41.81
Hecarim,Ezreal,1748,900,848,51.49
Hecarim,Morgana,821,400,421,48.72
Hecarim,Illaoi,311,122,189,39.23
Hecarim,Shaco,805,396,409,49.19
Hecarim,Draven,528,257,271,48.67
Hecarim,Alistar,319,138,181,43.26
Hecarim,Shyvana,265,125,140,47.17
Hecarim,Gwen,372,178,194,47.85
Hecarim,Zac,352,176,176,50
Hecarim,Khazix,436,215,221,49.31
Hecarim,Lucian,526,282,244,53.61
Hecarim,Ambessa,534,250,284,46.82
Hecarim,Nasus,587,287,300,48.89
Hecarim,TwistedFate,306,170,136,55.56
Hecarim,Gangplank,407,211,196,51.84
Hecarim,Lulu,1101,545,556,49.5
Hecarim,TahmKench,689,297,392,43.11
Hecarim,Cassiopeia,280,137,143,48.93
Hecarim,Gragas,520,225,295,43.27
Hecarim,Bard,319,154,165,48.28
Hecarim,Zyra,700,325,375,46.43
Hecarim,JarvanIV,462,232,230,50.22
Hecarim,Aphelios,434,212,222,48.85
Hecarim,Ryze,268,122,146,45.52
Hecarim,Nautilus,886,453,433,51.13
Hecarim,Kayle,583,275,308,47.17
Hecarim,Akshan,339,177,162,52.21
Hecarim,Skarner,235,124,111,52.77
Hecarim,Qiyana,257,132,125,51.36
Hecarim,Nocturne,856,415,441,48.48
Hecarim,Malzahar,733,374,359,51.02
Hecarim,Ornn,349,195,154,55.87
Hecarim,Twitch,639,283,356,44.29
Hecarim,Rengar,366,231,135,63.11
Hecarim,KogMaw,313,149,164,47.6
Hecarim,Kennen,233,145,88,62.23
Hecarim,Udyr,333,148,185,44.44
Hecarim,Leblanc,377,173,204,45.89
Hecarim,Nilah,215,104,111,48.37
Hecarim,Nami,813,385,428,47.36
Hecarim,Vayne,989,497,492,50.25
Hecarim,Tristana,745,356,389,47.79
Hecarim,Kled,137,52,85,37.96
Hecarim,Seraphine,565,250,315,44.25
Hecarim,Vladimir,532,255,277,47.93
Hecarim,Poppy,448,216,232,48.21
Hecarim,Hwei,553,288,265,52.08
Hecarim,Sivir,435,212,223,48.74
Hecarim,Brand,562,252,310,44.84
Hecarim,Sylas,1130,508,622,44.96
Hecarim,Veigar,747,286,461,38.29
Hecarim,Ziggs,280,128,152,45.71
Hecarim,Gnar,284,155,129,54.58
Hecarim,Elise,583,287,296,49.23
Hecarim,Jayce,382,155,227,40.58
Hecarim,Viktor,717,387,330,53.97
Hecarim,Singed,246,111,135,45.12
Hecarim,Talon,497,272,225,54.73
Hecarim,Braum,446,247,199,55.38
Hecarim,Ivern,118,56,62,47.46
Hecarim,Galio,598,245,353,40.97
Hecarim,Sejuani,309,148,161,47.9
Hecarim,Malphite,707,359,348,50.78
Hecarim,MonkeyKing,458,177,281,38.65
Hecarim,Swain,725,328,397,45.24
Hecarim,Smolder,608,285,323,46.88
Hecarim,Nunu,592,275,317,46.45
Hecarim,Naafiri,297,159,138,53.54
Hecarim,Nidalee,222,124,98,55.86
Hecarim,Xayah,380,201,179,52.89
Hecarim,Karthus,247,156,91,63.16
Hecarim,Rumble,224,104,120,46.43
Hecarim,Syndra,571,274,297,47.99
Hecarim,Urgot,348,142,206,40.8
Hecarim,Sona,282,155,127,54.96
Hecarim,Taliyah,223,106,117,47.53
Hecarim,Zilean,232,83,149,35.78
Hecarim,Sion,635,277,358,43.62
Hecarim,Tryndamere,439,210,229,47.84
Hecarim,Renata,121,53,68,43.8
Hecarim,Maokai,355,170,185,47.89
Hecarim,Xerath,709,324,385,45.7
Hecarim,Janna,292,135,157,46.23
Hecarim,Quinn,234,125,109,53.42
Hecarim,XinZhao,472,203,269,43.01
Hecarim,Rakan,316,185,131,58.54
Hecarim,Fiora,320,161,159,50.31
Hecarim,Anivia,233,105,128,45.06
Hecarim,Annie,266,153,113,57.52
Hecarim,Lissandra,234,101,133,43.16
Hecarim,Taric,153,53,100,34.64
Hecarim,Renekton,385,181,204,47.01
Hecarim,Orianna,357,184,173,51.54
Hecarim,Olaf,166,84,82,50.6
Hecarim,Belveth,209,109,100,52.15
Hecarim,Azir,277,163,114,58.84
Hecarim,Kalista,281,140,141,49.82
Hecarim,RekSai,119,36,83,30.25
Hecarim,Heimerdinger,291,128,163,43.99
Thresh,Warwick,3974,1885,2089,47.43
Thresh,Evelynn,859,464,395,54.02
Thresh,Ahri,3463,1724,1739,49.78
Thresh,Yasuo,5278,2738,2540,51.88
Thresh,Yone,5007,2649,2358,52.91
Thresh,Sylas,3484,1865,1619,53.53
Thresh,Zed,2946,1584,1362,53.77
Thresh,Sivir,1427,687,740,48.14
Thresh,Blitzcrank,2265,1234,1031,54.48
Thresh,Teemo,3130,1495,1635,47.76
Thresh,XinZhao,1815,927,888,51.07
Thresh,Jinx,6731,3252,3479,48.31
Thresh,Neeko,1417,668,749,47.14
Thresh,Irelia,2300,1180,1120,51.3
Thresh,Galio,2395,1223,1172,51.06
Thresh,Rell,1590,776,814,48.81
Thresh,Illaoi,1196,588,608,49.16
Thresh,Aatrox,2828,1438,1390,50.85
Thresh,Ashe,5311,2690,2621,50.65
Thresh,Aphelios,1645,833,812,50.64
Thresh,Gragas,1778,994,784,55.91
Thresh,Yorick,2508,1177,1331,46.93
Thresh,Viego,3947,2006,1941,50.82
Thresh,Malphite,2603,1279,1324,49.14
Thresh,Kaisa,4573,2366,2207,51.74
Thresh,Ambessa,1785,899,886,50.36
Thresh,Xayah,1508,750,758,49.73
Thresh,AurelionSol,974,512,462,52.57
Thresh,Khazix,1395,707,688,50.68
Thresh,Nautilus,3445,1710,1735,49.64
Thresh,Camille,926,472,454,50.97
Thresh,Katarina,2093,1028,1065,49.12
Thresh,MissFortune,5602,2641,2961,47.14
Thresh,Zyra,2247,1014,1233,45.13
Thresh,LeeSin,4234,2215,2019,52.31
Thresh,Chogath,3340,1604,1736,48.02
Thresh,Lucian,1828,963,865,52.68
Thresh,Xerath,2239,1131,1108,50.51
Thresh,Kindred,1235,659,576,53.36
Thresh,Fizz,1444,707,737,48.96
Thresh,Gnar,1176,608,568,51.7
Thresh,Caitlyn,6744,3244,3500,48.1
Thresh,Ezreal,6500,3450,3050,53.08
Thresh,Lux,7118,3443,3675,48.37
Thresh,Darius,5015,2473,2542,49.31
Thresh,Trundle,1420,698,722,49.15
Thresh,Vex,1465,731,734,49.9
Thresh,Mordekaiser,3615,1716,1899,47.47
Thresh,Nunu,1726,817,909,47.33
Thresh,Shen,1844,857,987,46.48
Thresh,Rammus,820,405,415,49.39
Thresh,Cassiopeia,879,419,460,47.67
Thresh,Tryndamere,1472,698,774,47.42
Thresh,Amumu,2463,1104,1359,44.82
Thresh,Mel,5369,2785,2584,51.87
Thresh,Seraphine,2108,953,1155,45.21
Thresh,Tristana,2543,1293,1250,50.85
Thresh,Nilah,991,455,536,45.91
Thresh,TahmKench,2392,1227,1165,51.3
Thresh,Naafiri,847,422,425,49.82
Thresh,Volibear,2908,1418,1490,48.76
Thresh,Soraka,1455,751,704,51.62
Thresh,Ekko,2283,1121,1162,49.1
Thresh,Leona,2597,1369,1228,52.71
Thresh,Ziggs,965,409,556,42.38
Thresh,Kayn,3694,1871,1823,50.65
Thresh,Syndra,1715,868,847,50.61
Thresh,Senna,2082,1113,969,53.46
Thresh,Akali,2792,1449,1343,51.9
Thresh,Akshan,911,404,507,44.35
Thresh,Skarner,790,427,363,54.05
Thresh,Shaco,2297,1229,1068,53.5
Thresh,Lissandra,894,407,487,45.53
Thresh,Pyke,2713,1423,1290,52.45
Thresh,Talon,1566,891,675,56.9
Thresh,Maokai,1213,541,672,44.6
Thresh,Varus,2359,1215,1144,51.5
Thresh,Graves,1931,921,1010,47.7
Thresh,Gangplank,1224,686,538,56.05
Thresh,Hwei,1800,897,903,49.83
Thresh,Jhin,5171,2704,2467,52.29
Thresh,Kennen,836,421,415,50.36
Thresh,Karthus,772,396,376,51.3
Thresh,Veigar,2488,1125,1363,45.22
Thresh,Vladimir,1671,813,858,48.65
Thresh,Sona,792,402,390,50.76
Thresh,Urgot,1184,566,618,47.8
Thresh,Twitch,2097,1093,1004,52.12
Thresh,MasterYi,2905,1390,1515,47.85
Thresh,Smolder,1857,951,906,51.21
Thresh,Yuumi,2279,1158,1121,50.81
Thresh,Garen,4211,1945,2266,46.19
Thresh,Vi,2582,1332,1250,51.59
Thresh,Diana,4160,2147,2013,51.61
Thresh,Annie,839,428,411,51.01
Thresh,Shyvana,628,268,360,42.68
Thresh,Taric,712,325,387,45.65
Thresh,Nami,2636,1250,1386,47.42
Thresh,Singed,837,373,464,44.56
Thresh,Taliyah,792,339,453,42.8
Thresh,Jax,2293,1206,1087,52.59
Thresh,Zoe,1055,539,516,51.09
Thresh,Poppy,1807,865,942,47.87
Thresh,Sett,3920,1935,1985,49.36
Thresh,Rengar,935,527,408,56.36
Thresh,Ivern,462,276,186,59.74
Thresh,Ryze,1034,462,572,44.68
Thresh,Pantheon,4320,2215,2105,51.27
Thresh,Renekton,1424,684,740,48.03
Thresh,Fiora,1023,552,471,53.96
Thresh,Rakan,1410,727,683,51.56
Thresh,Brand,1769,824,945,46.58
Thresh,Velkoz,1672,766,906,45.81
Thresh,Heimerdinger,1101,499,602,45.32
Thresh,Qiyana,682,389,293,57.04
Thresh,Udyr,1151,564,587,49
Thresh,Karma,3066,1555,1511,50.72
Thresh,Ornn,1078,521,557,48.33
Thresh,KSante,1388,765,623,55.12
Thresh,Sion,2288,1067,1221,46.63
Thresh,Hecarim,1066,533,533,50
Thresh,Lulu,3512,1880,1632,53.53
Thresh,Samira,1996,1019,977,51.05
Thresh,Morgana,3244,1525,1719,47.01
Thresh,Alistar,1419,708,711,49.89
Thresh,Briar,2012,975,1037,48.46
Thresh,Anivia,902,470,432,52.11
Thresh,Leblanc,1692,795,897,46.99
Thresh,Milio,1634,812,822,49.69
Thresh,Sejuani,1266,602,664,47.55
Thresh,Corki,1108,569,539,51.35
Thresh,Swain,2941,1349,1592,45.87
Thresh,Aurora,2199,1110,1089,50.48
Thresh,Lillia,1674,844,830,50.42
Thresh,Renata,584,298,286,51.03
Thresh,FiddleSticks,1301,680,621,52.27
Thresh,Kalista,862,462,400,53.6
Thresh,Zilean,950,475,475,50
Thresh,JarvanIV,1602,810,792,50.56
Thresh,Malzahar,2679,1253,1426,46.77
Thresh,Draven,1542,851,691,55.19
Thresh,Nasus,1873,912,961,48.69
Thresh,Rumble,689,335,354,48.62
Thresh,Kled,475,239,236,50.32
Thresh,Quinn,924,441,483,47.73
Thresh,Viktor,2317,1139,1178,49.16
Thresh,TwistedFate,1051,529,522,50.33
Thresh,Zeri,1187,611,576,51.47
Thresh,Kayle,1709,835,874,48.86
Thresh,Elise,1899,957,942,50.39
Thresh,Riven,1268,697,571,54.97
Thresh,Nocturne,3027,1470,1557,48.56
Thresh,Janna,987,447,540,45.29
Thresh,Zac,1344,648,696,48.21
Thresh,Braum,2013,984,1029,48.88
Thresh,Olaf,617,258,359,41.82
Thresh,Kassadin,635,338,297,53.23
Thresh,Orianna,1211,660,551,54.5
Thresh,Azir,992,490,502,49.4
Thresh,Jayce,1451,739,712,50.93
Thresh,MonkeyKing,1828,929,899,50.82
Thresh,Gwen,1447,806,641,55.7
Thresh,Vayne,3162,1563,1599,49.43
Thresh,KogMaw,854,413,441,48.36
Thresh,DrMundo,1408,723,685,51.35
Thresh,Bard,918,416,502,45.32
Thresh,RekSai,309,157,152,50.81
Thresh,Belveth,706,347,359,49.15
Thresh,Nidalee,886,486,400,54.85
RekSai,Sett,329,127,202,38.6
RekSai,Taliyah,56,27,29,48.21
RekSai,Sylas,277,131,146,47.29
RekSai,Ezreal,631,337,294,53.41
RekSai,Morgana,288,132,156,45.83
RekSai,Illaoi,93,45,48,48.39
RekSai,Nocturne,258,133,125,51.55
RekSai,Ekko,213,101,112,47.42
RekSai,MissFortune,469,248,221,52.88
RekSai,Seraphine,232,113,119,48.71
RekSai,Gnar,135,57,78,42.22
RekSai,XinZhao,185,91,94,49.19
RekSai,Yasuo,486,260,226,53.5
RekSai,Zeri,111,59,52,53.15
RekSai,Taric,47,10,37,21.28
RekSai,Tryndamere,124,67,57,54.03
RekSai,LeeSin,510,273,237,53.53
RekSai,Aurora,169,61,108,36.09
RekSai,Mel,491,206,285,41.96
RekSai,Rumble,79,40,39,50.63
RekSai,Pantheon,428,234,194,54.67
RekSai,Jhin,461,261,200,56.62
RekSai,Nautilus,219,105,114,47.95
RekSai,Darius,503,236,267,46.92
RekSai,Evelynn,66,46,20,69.7
RekSai,Heimerdinger,120,54,66,45
RekSai,Jinx,599,284,315,47.41
RekSai,Pyke,250,100,150,40
RekSai,Diana,305,131,174,42.95
RekSai,Yone,397,194,203,48.87
RekSai,Veigar,254,120,134,47.24
RekSai,DrMundo,112,61,51,54.46
RekSai,Kayn,324,191,133,58.95
RekSai,Akali,221,137,84,61.99
RekSai,Draven,129,48,81,37.21
RekSai,Rell,130,76,54,58.46
RekSai,Camille,60,39,21,65
RekSai,Ahri,372,168,204,45.16
RekSai,Caitlyn,572,273,299,47.73
RekSai,Fizz,117,75,42,64.1
RekSai,MasterYi,225,115,110,51.11
RekSai,Aphelios,155,87,68,56.13
RekSai,Shaco,264,134,130,50.76
RekSai,Chogath,280,88,192,31.43
RekSai,Poppy,216,85,131,39.35
RekSai,Shyvana,57,40,17,70.18
RekSai,Maokai,100,52,48,52
RekSai,Warwick,318,130,188,40.88
RekSai,Irelia,193,118,75,61.14
RekSai,Sivir,145,56,89,38.62
RekSai,Annie,115,62,53,53.91
RekSai,Renekton,130,53,77,40.77
RekSai,Sejuani,105,43,62,40.95
RekSai,Urgot,138,51,87,36.96
RekSai,Viego,415,164,251,39.52
RekSai,Aatrox,205,104,101,50.73
RekSai,Zed,300,145,155,48.33
RekSai,Karma,249,133,116,53.41
RekSai,Galio,237,125,112,52.74
RekSai,Nami,284,137,147,48.24
RekSai,Naafiri,52,30,22,57.69
RekSai,Zyra,189,87,102,46.03
RekSai,Xayah,173,92,81,53.18
RekSai,Rakan,137,76,61,55.47
RekSai,Vladimir,148,71,77,47.97
RekSai,Renata,55,27,28,49.09
RekSai,Teemo,282,105,177,37.23
RekSai,Anivia,90,42,48,46.67
RekSai,TahmKench,155,78,77,50.32
RekSai,Twitch,227,113,114,49.78
RekSai,Kaisa,395,192,203,48.61
RekSai,Ashe,482,221,261,45.85
RekSai,Kassadin,62,30,32,48.39
RekSai,Shen,190,93,97,48.95
RekSai,Volibear,327,158,169,48.32
RekSai,Amumu,207,86,121,41.55
RekSai,Katarina,190,94,96,49.47
RekSai,Vayne,235,85,150,36.17
RekSai,Yorick,220,87,133,39.55
RekSai,Hwei,184,107,77,58.15
RekSai,Mordekaiser,332,159,173,47.89
RekSai,Ziggs,96,39,57,40.63
RekSai,Samira,189,81,108,42.86
RekSai,Leona,223,104,119,46.64
RekSai,Garen,291,122,169,41.92
RekSai,Briar,188,79,109,42.02
RekSai,Thresh,309,152,157,49.19
RekSai,Yuumi,222,131,91,59.01
RekSai,Gragas,122,73,49,59.84
RekSai,Lulu,308,143,165,46.43
RekSai,Malphite,219,112,107,51.14
RekSai,MonkeyKing,119,70,49,58.82
RekSai,Tristana,222,94,128,42.34
RekSai,Viktor,205,105,100,51.22
RekSai,Nasus,149,52,97,34.9
RekSai,Vi,211,113,98,53.55
RekSai,AurelionSol,96,46,50,47.92
RekSai,Milio,174,95,79,54.6
RekSai,Zac,116,58,58,50
RekSai,Kayle,166,74,92,44.58
RekSai,Malzahar,228,99,129,43.42
RekSai,Lux,526,231,295,43.92
RekSai,Talon,177,97,80,54.8
RekSai,Neeko,134,67,67,50
RekSai,Jax,199,130,69,65.33
RekSai,Rammus,92,40,52,43.48
RekSai,Graves,174,80,94,45.98
RekSai,Soraka,132,63,69,47.73
RekSai,Sion,239,128,111,53.56
RekSai,Syndra,170,64,106,37.65
RekSai,Braum,178,77,101,43.26
RekSai,Trundle,126,58,68,46.03
RekSai,Kalista,83,41,42,49.4
RekSai,Swain,228,109,119,47.81
RekSai,Kennen,61,29,32,47.54
RekSai,Smolder,187,97,90,51.87
RekSai,FiddleSticks,122,48,74,39.34
RekSai,Kled,64,30,34,46.88
RekSai,Nilah,102,42,60,41.18
RekSai,Singed,90,47,43,52.22
RekSai,Brand,162,77,85,47.53
RekSai,Udyr,123,47,76,38.21
RekSai,Akshan,74,30,44,40.54
RekSai,Xerath,169,74,95,43.79
RekSai,Elise,201,118,83,58.71
RekSai,Alistar,108,44,64,40.74
RekSai,Varus,210,87,123,41.43
RekSai,Lissandra,115,64,51,55.65
RekSai,Kindred,104,48,56,46.15
RekSai,Azir,121,62,59,51.24
RekSai,JarvanIV,137,68,69,49.64
RekSai,Leblanc,112,71,41,63.39
RekSai,Karthus,103,45,58,43.69
RekSai,Orianna,140,78,62,55.71
RekSai,KSante,174,100,74,57.47
RekSai,Sona,105,38,67,36.19
RekSai,Gangplank,152,96,56,63.16
RekSai,Bard,68,35,33,51.47
RekSai,Fiora,90,37,53,41.11
RekSai,Ornn,116,62,54,53.45
RekSai,Khazix,91,32,59,35.16
RekSai,Vex,106,40,66,37.74
RekSai,Janna,99,52,47,52.53
RekSai,Nidalee,84,37,47,44.05
RekSai,Corki,113,38,75,33.63
RekSai,Zilean,70,40,30,57.14
RekSai,Hecarim,119,83,36,69.75
RekSai,Ambessa,148,85,63,57.43
RekSai,Cassiopeia,63,21,42,33.33
RekSai,Senna,162,61,101,37.65
RekSai,Riven,135,72,63,53.33
RekSai,Belveth,62,20,42,32.26
RekSai,TwistedFate,95,42,53,44.21
RekSai,Qiyana,73,43,30,58.9
RekSai,Velkoz,130,67,63,51.54
RekSai,Lillia,156,81,75,51.92
RekSai,Lucian,178,84,94,47.19
RekSai,Gwen,137,70,67,51.09
RekSai,Blitzcrank,209,100,109,47.85
RekSai,Quinn,95,32,63,33.68
RekSai,Zoe,134,77,57,57.46
RekSai,Nunu,179,81,98,45.25
RekSai,Rengar,98,52,46,53.06
RekSai,Ryze,101,48,53,47.52
RekSai,Skarner,58,35,23,60.34
RekSai,KogMaw,60,25,35,41.67
RekSai,Ivern,42,24,18,57.14
RekSai,Jayce,122,43,79,35.25
RekSai,Olaf,40,18,22,45
Sivir,Malphite,1059,538,521,50.8
Sivir,Evelynn,386,228,158,59.07
Sivir,Irelia,876,477,399,54.45
Sivir,Tristana,869,409,460,47.07
Sivir,Thresh,1427,740,687,51.86
Sivir,Teemo,1346,629,717,46.73
Sivir,Shaco,1048,519,529,49.52
Sivir,Leblanc,554,300,254,54.15
Sivir,Ezreal,2727,1548,1179,56.77
Sivir,Sett,1475,796,679,53.97
Sivir,Talon,674,322,352,47.77
Sivir,FiddleSticks,536,242,294,45.15
Sivir,Ashe,2321,1178,1143,50.75
Sivir,Blitzcrank,1141,641,500,56.18
Sivir,Urgot,488,255,233,52.25
Sivir,Rengar,292,191,101,65.41
Sivir,Ziggs,387,183,204,47.29
Sivir,Trundle,572,280,292,48.95
Sivir,Fiora,429,201,228,46.85
Sivir,Mordekaiser,1306,670,636,51.3
Sivir,Vi,1001,543,458,54.25
Sivir,Cassiopeia,309,133,176,43.04
Sivir,Lux,2450,1224,1226,49.96
Sivir,Vladimir,693,407,286,58.73
Sivir,Yasuo,1919,921,998,47.99
Sivir,Yuumi,619,283,336,45.72
Sivir,Shen,651,338,313,51.92
Sivir,Yone,1768,901,867,50.96
Sivir,Twitch,714,332,382,46.5
Sivir,Nautilus,1232,746,486,60.55
Sivir,Kayn,1430,725,705,50.7
Sivir,Diana,1576,878,698,55.71
Sivir,Renekton,449,243,206,54.12
Sivir,Lillia,572,304,268,53.15
Sivir,Annie,349,202,147,57.88
Sivir,Kaisa,1656,903,753,54.53
Sivir,Xerath,863,459,404,53.19
Sivir,XinZhao,547,270,277,49.36
Sivir,Vayne,1141,490,651,42.94
Sivir,Brand,714,396,318,55.46
Sivir,Kayle,614,303,311,49.35
Sivir,Morgana,1420,734,686,51.69
Sivir,Viego,1343,682,661,50.78
Sivir,Jinx,2637,1357,1280,51.46
Sivir,Pyke,1103,640,463,58.02
Sivir,Camille,372,163,209,43.82
Sivir,Warwick,1507,646,861,42.87
Sivir,Azir,406,225,181,55.42
Sivir,Braum,507,255,252,50.3
Sivir,Poppy,612,345,267,56.37
Sivir,Elise,712,336,376,47.19
Sivir,Aurora,919,466,453,50.71
Sivir,Nami,1016,465,551,45.77
Sivir,Akali,1107,568,539,51.31
Sivir,Gragas,539,308,231,57.14
Sivir,Syndra,655,347,308,52.98
Sivir,Veigar,1096,513,583,46.81
Sivir,Gnar,438,201,237,45.89
Sivir,AurelionSol,432,226,206,52.31
Sivir,LeeSin,1436,742,694,51.67
Sivir,Zoe,402,198,204,49.25
Sivir,Jhin,1960,972,988,49.59
Sivir,Seraphine,880,436,444,49.55
Sivir,Yorick,991,501,490,50.55
Sivir,Sejuani,415,220,195,53.01
Sivir,Kalista,270,152,118,56.3
Sivir,Khazix,503,257,246,51.09
Sivir,Caitlyn,2893,1479,1414,51.12
Sivir,Taric,221,90,131,40.72
Sivir,Mel,2129,1133,996,53.22
Sivir,Sylas,1404,754,650,53.7
Sivir,Senna,775,406,369,52.39
Sivir,Pantheon,1753,892,861,50.88
Sivir,Kassadin,227,103,124,45.37
Sivir,Milio,552,249,303,45.11
Sivir,TahmKench,799,416,383,52.07
Sivir,Qiyana,240,129,111,53.75
Sivir,Rell,490,244,246,49.8
Sivir,Volibear,1157,546,611,47.19
Sivir,Lulu,1092,515,577,47.16
Sivir,Katarina,686,333,353,48.54
Sivir,Galio,915,435,480,47.54
Sivir,MissFortune,2471,1247,1224,50.47
Sivir,Smolder,675,332,343,49.19
Sivir,Zed,1034,479,555,46.32
Sivir,Darius,1723,921,802,53.45
Sivir,Karma,1243,640,603,51.49
Sivir,Ekko,910,445,465,48.9
Sivir,Lucian,700,407,293,58.14
Sivir,Draven,478,240,238,50.21
Sivir,Heimerdinger,434,190,244,43.78
Sivir,Aatrox,950,486,464,51.16
Sivir,Hwei,645,346,299,53.64
Sivir,Chogath,1255,623,632,49.64
Sivir,Soraka,521,282,239,54.13
Sivir,Kled,147,80,67,54.42
Sivir,Zac,504,253,251,50.2
Sivir,Rakan,445,235,210,52.81
Sivir,Zyra,969,450,519,46.44
Sivir,Graves,579,305,274,52.68
Sivir,Neeko,555,309,246,55.68
Sivir,RekSai,145,89,56,61.38
Sivir,Maokai,421,212,209,50.36
Sivir,Orianna,425,174,251,40.94
Sivir,Varus,1016,492,524,48.43
Sivir,Gangplank,503,259,244,51.49
Sivir,Gwen,531,311,220,58.57
Sivir,Ivern,220,119,101,54.09
Sivir,Garen,1653,875,778,52.93
Sivir,Amumu,1078,499,579,46.29
Sivir,MasterYi,1103,552,551,50.05
Sivir,Nunu,701,348,353,49.64
Sivir,Leona,994,550,444,55.33
Sivir,Ornn,400,184,216,46
Sivir,Swain,993,482,511,48.54
Sivir,Vex,539,274,265,50.83
Sivir,Riven,479,267,212,55.74
Sivir,Nocturne,1264,632,632,50
Sivir,Rumble,245,147,98,60
Sivir,Nasus,719,340,379,47.29
Sivir,Karthus,298,155,143,52.01
Sivir,Malzahar,990,475,515,47.98
Sivir,Aphelios,610,343,267,56.23
Sivir,Jax,1033,540,493,52.27
Sivir,Briar,778,405,373,52.06
Sivir,Corki,416,231,185,55.53
Sivir,Ryze,348,183,165,52.59
Sivir,KogMaw,349,148,201,42.41
Sivir,JarvanIV,584,300,284,51.37
Sivir,DrMundo,506,235,271,46.44
Sivir,TwistedFate,367,214,153,58.31
Sivir,Hecarim,435,223,212,51.26
Sivir,Ahri,1402,732,670,52.21
Sivir,Alistar,493,285,208,57.81
Sivir,Sion,771,394,377,51.1
Sivir,Illaoi,529,260,269,49.15
Sivir,Viktor,927,492,435,53.07
Sivir,KSante,421,261,160,62
Sivir,Rammus,248,117,131,47.18
Sivir,Zilean,365,190,175,52.05
Sivir,Udyr,393,216,177,54.96
Sivir,Quinn,375,217,158,57.87
Sivir,Ambessa,677,343,334,50.66
Sivir,Zeri,434,250,184,57.6
Sivir,Singed,287,140,147,48.78
Sivir,MonkeyKing,625,337,288,53.92
Sivir,Belveth,211,107,104,50.71
Sivir,Olaf,289,164,125,56.75
Sivir,Lissandra,280,137,143,48.93
Sivir,Shyvana,271,131,140,48.34
Sivir,Nidalee,303,169,134,55.78
Sivir,Skarner,289,165,124,57.09
Sivir,Kindred,523,260,263,49.71
Sivir,Anivia,349,190,159,54.44
Sivir,Nilah,294,147,147,50
Sivir,Fizz,450,231,219,51.33
Sivir,Tryndamere,543,267,276,49.17
Sivir,Janna,357,189,168,52.94
Sivir,Akshan,346,157,189,45.38
Sivir,Sona,305,152,153,49.84
Sivir,Renata,236,129,107,54.66
Sivir,Samira,770,382,388,49.61
Sivir,Jayce,500,241,259,48.2
Sivir,Naafiri,334,143,191,42.81
Sivir,Velkoz,633,312,321,49.29
Sivir,Xayah,488,254,234,52.05
Sivir,Bard,322,168,154,52.17
Sivir,Taliyah,224,131,93,58.48
Sivir,Kennen,279,165,114,59.14
Xayah,Sylas,1412,760,652,53.82
Xayah,Caitlyn,2862,1387,1475,48.46
Xayah,Zed,1274,724,550,56.83
Xayah,MasterYi,1240,658,582,53.06
Xayah,Rell,633,373,260,58.93
Xayah,Yone,1963,975,988,49.67
Xayah,Kayn,1500,844,656,56.27
Xayah,TwistedFate,368,182,186,49.46
Xayah,Smolder,665,324,341,48.72
Xayah,Nautilus,1417,805,612,56.81
Xayah,Poppy,731,368,363,50.34
Xayah,Diana,1593,801,792,50.28
Xayah,Anivia,346,151,195,43.64
Xayah,Thresh,1508,758,750,50.27
Xayah,Akali,1149,587,562,51.09
Xayah,Rammus,356,162,194,45.51
Xayah,Yasuo,2146,1136,1010,52.94
Xayah,Jinx,2656,1218,1438,45.86
Xayah,Zyra,745,323,422,43.36
Xayah,Tryndamere,543,272,271,50.09
Xayah,Aurora,878,421,457,47.95
Xayah,Twitch,823,435,388,52.86
Xayah,Lux,2568,1220,1348,47.51
Xayah,Jayce,478,261,217,54.6
Xayah,Amumu,1138,489,649,42.97
Xayah,Ashe,1917,921,996,48.04
Xayah,Milio,545,246,299,45.14
Xayah,Vayne,1317,680,637,51.63
Xayah,Briar,796,395,401,49.62
Xayah,Mel,2209,1156,1053,52.33
Xayah,Yuumi,1004,540,464,53.78
Xayah,Mordekaiser,1428,690,738,48.32
Xayah,Vex,644,315,329,48.91
Xayah,Samira,941,512,429,54.41
Xayah,Rakan,505,238,267,47.13
Xayah,Aatrox,941,442,499,46.97
Xayah,Chogath,1320,604,716,45.76
Xayah,Kaisa,2138,1207,931,56.45
Xayah,Morgana,1232,580,652,47.08
Xayah,Ezreal,2210,1117,1093,50.54
Xayah,Elise,755,341,414,45.17
Xayah,Gangplank,474,279,195,58.86
Xayah,Swain,978,487,491,49.8
Xayah,Cassiopeia,294,143,151,48.64
Xayah,Varus,760,371,389,48.82
Xayah,Nasus,735,356,379,48.44
Xayah,Zilean,257,122,135,47.47
Xayah,FiddleSticks,608,303,305,49.84
Xayah,Leblanc,575,259,316,45.04
Xayah,Aphelios,547,219,328,40.04
Xayah,Hwei,726,347,379,47.8
Xayah,Jhin,2028,1080,948,53.25
Xayah,MonkeyKing,668,330,338,49.4
Xayah,Teemo,1202,571,631,47.5
Xayah,Yorick,927,439,488,47.36
Xayah,Ahri,1391,725,666,52.12
Xayah,Riven,420,205,215,48.81
Xayah,Malzahar,1042,492,550,47.22
Xayah,Syndra,655,311,344,47.48
Xayah,Volibear,1114,560,554,50.27
Xayah,Evelynn,526,266,260,50.57
Xayah,Azir,424,187,237,44.1
Xayah,Illaoi,494,265,229,53.64
Xayah,Nocturne,1273,617,656,48.47
Xayah,Ryze,305,136,169,44.59
Xayah,MissFortune,2353,1105,1248,46.96
Xayah,Blitzcrank,872,479,393,54.93
Xayah,Garen,1731,821,910,47.43
Xayah,Jax,984,479,505,48.68
Xayah,Gnar,511,254,257,49.71
Xayah,Zeri,529,285,244,53.88
Xayah,Xerath,818,409,409,50
Xayah,Urgot,387,206,181,53.23
Xayah,Skarner,319,176,143,55.17
Xayah,Ekko,861,397,464,46.11
Xayah,Heimerdinger,498,236,262,47.39
Xayah,Zac,606,311,295,51.32
Xayah,LeeSin,1261,665,596,52.74
Xayah,Fiora,344,184,160,53.49
Xayah,Pantheon,1727,849,878,49.16
Xayah,Annie,363,159,204,43.8
Xayah,Bard,329,172,157,52.28
Xayah,Renekton,552,286,266,51.81
Xayah,Rengar,505,308,197,60.99
Xayah,Seraphine,835,409,426,48.98
Xayah,Kennen,359,166,193,46.24
Xayah,Lillia,564,247,317,43.79
Xayah,Irelia,880,502,378,57.05
Xayah,Nilah,541,291,250,53.79
Xayah,Malphite,1100,596,504,54.18
Xayah,JarvanIV,565,255,310,45.13
Xayah,Lucian,715,353,362,49.37
Xayah,Kayle,678,350,328,51.62
Xayah,XinZhao,723,332,391,45.92
Xayah,Darius,1862,950,912,51.02
Xayah,Warwick,1441,719,722,49.9
Xayah,Viktor,781,387,394,49.55
Xayah,Sona,278,150,128,53.96
Xayah,Ornn,478,249,229,52.09
Xayah,Neeko,614,357,257,58.14
Xayah,Ziggs,397,180,217,45.34
Xayah,Galio,965,507,458,52.54
Xayah,Zoe,403,231,172,57.32
Xayah,DrMundo,605,322,283,53.22
Xayah,Belveth,329,152,177,46.2
Xayah,Naafiri,374,200,174,53.48
Xayah,Pyke,861,425,436,49.36
Xayah,Kalista,338,194,144,57.4
Xayah,Vi,1189,627,562,52.73
Xayah,Talon,690,384,306,55.65
Xayah,Shaco,963,460,503,47.77
Xayah,Graves,608,309,299,50.82
Xayah,Lulu,1212,625,587,51.57
Xayah,Katarina,876,467,409,53.31
Xayah,Taric,212,111,101,52.36
Xayah,Gwen,556,310,246,55.76
Xayah,Sett,1710,772,938,45.15
Xayah,Nami,1022,470,552,45.99
Xayah,Maokai,431,229,202,53.13
Xayah,Janna,355,151,204,42.54
Xayah,Ambessa,671,366,305,54.55
Xayah,Khazix,503,279,224,55.47
Xayah,KSante,473,252,221,53.28
Xayah,Gragas,628,374,254,59.55
Xayah,Nunu,720,339,381,47.08
Xayah,Tristana,902,417,485,46.23
Xayah,Trundle,595,274,321,46.05
Xayah,Fizz,645,309,336,47.91
Xayah,Kindred,409,222,187,54.28
Xayah,Vladimir,690,323,367,46.81
Xayah,Kassadin,210,122,88,58.1
Xayah,Viego,1257,604,653,48.05
Xayah,Veigar,1112,495,617,44.51
Xayah,TahmKench,873,445,428,50.97
Xayah,Karma,961,433,528,45.06
Xayah,Shen,766,386,380,50.39
Xayah,Senna,824,421,403,51.09
Xayah,Lissandra,348,176,172,50.57
Xayah,Draven,536,281,255,52.43
Xayah,Braum,524,271,253,51.72
Xayah,KogMaw,302,158,144,52.32
Xayah,Alistar,503,237,266,47.12
Xayah,Akshan,363,213,150,58.68
Xayah,RekSai,173,81,92,46.82
Xayah,Velkoz,577,272,305,47.14
Xayah,Sion,804,405,399,50.37
Xayah,Udyr,375,174,201,46.4
Xayah,Sejuani,454,207,247,45.59
Xayah,Brand,651,311,340,47.77
Xayah,Orianna,437,218,219,49.89
Xayah,Singed,296,120,176,40.54
Xayah,Renata,223,111,112,49.78
Xayah,Soraka,597,294,303,49.25
Xayah,AurelionSol,370,152,218,41.08
Xayah,Leona,861,418,443,48.55
Xayah,Nidalee,288,164,124,56.94
Xayah,Olaf,250,132,118,52.8
Xayah,Karthus,333,171,162,51.35
Xayah,Corki,423,227,196,53.66
Xayah,Quinn,307,163,144,53.09
Xayah,Hecarim,380,179,201,47.11
Xayah,Camille,409,251,158,61.37
Xayah,Taliyah,266,156,110,58.65
Xayah,Shyvana,264,107,157,40.53
Xayah,Ivern,211,123,88,58.29
Xayah,Qiyana,309,164,145,53.07
Xayah,Kled,191,78,113,40.84
Xayah,Sivir,488,234,254,47.95
Xayah,Rumble,286,178,108,62.24
Samira,Swain,1650,759,891,46
Samira,FiddleSticks,747,318,429,42.57
Samira,Akali,1588,839,749,52.83
Samira,Twitch,1217,624,593,51.27
Samira,Senna,1223,579,644,47.34
Samira,Smolder,1101,529,572,48.05
Samira,Ekko,1506,789,717,52.39
Samira,Mordekaiser,2386,1072,1314,44.93
Samira,Yasuo,3117,1522,1595,48.83
Samira,Yuumi,1405,709,696,50.46
Samira,Sett,2760,1328,1432,48.12
Samira,Vladimir,904,488,416,53.98
Samira,Kindred,724,429,295,59.25
Samira,Aphelios,891,458,433,51.4
Samira,Pyke,1432,755,677,52.72
Samira,Volibear,1781,849,932,47.67
Samira,Akshan,605,281,324,46.45
Samira,Katarina,1287,677,610,52.6
Samira,Annie,492,247,245,50.2
Samira,Kayn,2504,1260,1244,50.32
Samira,Aatrox,1417,721,696,50.88
Samira,MissFortune,3875,1919,1956,49.52
Samira,DrMundo,963,426,537,44.24
Samira,Ivern,238,118,120,49.58
Samira,Nilah,1049,470,579,44.8
Samira,TwistedFate,492,236,256,47.97
Samira,LeeSin,1892,953,939,50.37
Samira,Brand,1210,632,578,52.23
Samira,Briar,1347,662,685,49.15
Samira,Hwei,1081,506,575,46.81
Samira,Kaisa,2419,1208,1211,49.94
Samira,TahmKench,1343,799,544,59.49
Samira,Fiora,672,351,321,52.23
Samira,Malzahar,1415,588,827,41.55
Samira,Zilean,440,212,228,48.18
Samira,Jinx,4414,2072,2342,46.94
Samira,Leblanc,867,448,419,51.67
Samira,Xayah,941,429,512,45.59
Samira,Riven,734,333,401,45.37
Samira,Jax,1357,687,670,50.63
Samira,Naafiri,597,304,293,50.92
Samira,Tristana,1479,807,672,54.56
Samira,Rakan,697,287,410,41.18
Samira,Zac,686,319,367,46.5
Samira,Nunu,1072,500,572,46.64
Samira,Veigar,1691,779,912,46.07
Samira,Shen,1012,476,536,47.04
Samira,Sion,1125,488,637,43.38
Samira,AurelionSol,640,286,354,44.69
Samira,Jhin,3013,1477,1536,49.02
Samira,Lux,4240,2078,2162,49.01
Samira,Trundle,949,431,518,45.42
Samira,Ahri,2023,1038,985,51.31
Samira,Ashe,2730,1414,1316,51.79
Samira,Nami,1494,711,783,47.59
Samira,Darius,2947,1460,1487,49.54
Samira,Pantheon,2442,1133,1309,46.4
Samira,Ryze,583,294,289,50.43
Samira,Lillia,845,386,459,45.68
Samira,Chogath,1854,777,1077,41.91
Samira,Mel,3185,1528,1657,47.97
Samira,Warwick,2520,1124,1396,44.6
Samira,Malphite,1426,686,740,48.11
Samira,Illaoi,866,397,469,45.84
Samira,Leona,1314,611,703,46.5
Samira,Ambessa,911,504,407,55.32
Samira,Rammus,507,220,287,43.39
Samira,Aurora,1197,517,680,43.19
Samira,Caitlyn,4254,1978,2276,46.5
Samira,Kled,233,113,120,48.5
Samira,Diana,2299,1185,1114,51.54
Samira,Karma,1325,639,686,48.23
Samira,Singed,424,184,240,43.4
Samira,Blitzcrank,1234,679,555,55.02
Samira,Varus,1292,631,661,48.84
Samira,Irelia,1307,669,638,51.19
Samira,Elise,848,432,416,50.94
Samira,Viego,2102,979,1123,46.57
Samira,Galio,1084,530,554,48.89
Samira,Vayne,2027,1016,1011,50.12
Samira,Sylas,1927,1024,903,53.14
Samira,Tryndamere,878,401,477,45.67
Samira,Nautilus,1543,787,756,51
Samira,Yorick,1500,653,847,43.53
Samira,Nidalee,451,267,184,59.2
Samira,KogMaw,493,251,242,50.91
Samira,Poppy,968,435,533,44.94
Samira,Zed,1694,849,845,50.12
Samira,Shyvana,372,152,220,40.86
Samira,MasterYi,1781,838,943,47.05
Samira,Garen,2275,1029,1246,45.23
Samira,Zyra,1249,580,669,46.44
Samira,Neeko,969,491,478,50.67
Samira,Renekton,804,407,397,50.62
Samira,Sejuani,654,341,313,52.14
Samira,Taliyah,340,141,199,41.47
Samira,Teemo,2174,1061,1113,48.8
Samira,Corki,652,291,361,44.63
Samira,Heimerdinger,803,381,422,47.45
Samira,Gragas,945,487,458,51.53
Samira,Morgana,2008,883,1125,43.97
Samira,XinZhao,901,463,438,51.39
Samira,Rell,851,397,454,46.65
Samira,Shaco,1499,751,748,50.1
Samira,Yone,3082,1649,1433,53.5
Samira,Lulu,1558,717,841,46.02
Samira,Viktor,1137,541,596,47.58
Samira,KSante,699,395,304,56.51
Samira,Gwen,894,452,442,50.56
Samira,Seraphine,1631,869,762,53.28
Samira,Udyr,592,283,309,47.8
Samira,Hecarim,585,309,276,52.82
Samira,Khazix,861,486,375,56.45
Samira,Karthus,382,221,161,57.85
Samira,Thresh,1996,977,1019,48.95
Samira,Braum,741,341,400,46.02
Samira,Evelynn,675,326,349,48.3
Samira,Nocturne,1567,819,748,52.27
Samira,Velkoz,978,460,518,47.03
Samira,Urgot,760,315,445,41.45
Samira,Zeri,678,338,340,49.85
Samira,Fizz,890,427,463,47.98
Samira,Draven,921,479,442,52.01
Samira,Bard,476,267,209,56.09
Samira,Alistar,748,319,429,42.65
Samira,Kayle,1127,522,605,46.32
Samira,Amumu,1664,739,925,44.41
Samira,Ezreal,3108,1534,1574,49.36
Samira,Vi,1272,604,668,47.48
Samira,Zoe,579,317,262,54.75
Samira,Sona,497,233,264,46.88
Samira,Nasus,1275,551,724,43.22
Samira,Ziggs,592,272,320,45.95
Samira,Milio,879,397,482,45.16
Samira,Quinn,504,241,263,47.82
Samira,Kalista,479,288,191,60.13
Samira,Xerath,1259,581,678,46.15
Samira,Cassiopeia,542,261,281,48.15
Samira,Orianna,622,314,308,50.48
Samira,Talon,810,425,385,52.47
Samira,Renata,372,181,191,48.66
Samira,Rengar,536,308,228,57.46
Samira,Graves,935,511,424,54.65
Samira,Gnar,534,313,221,58.61
Samira,Azir,541,293,248,54.16
Samira,Ornn,658,324,334,49.24
Samira,Camille,469,251,218,53.52
Samira,Vex,769,365,404,47.46
Samira,Janna,527,288,239,54.65
Samira,Lucian,951,490,461,51.52
Samira,Soraka,846,449,397,53.07
Samira,Kennen,472,245,227,51.91
Samira,Skarner,518,227,291,43.82
Samira,Olaf,276,127,149,46.01
Samira,Syndra,865,416,449,48.09
Samira,Jayce,643,327,316,50.86
Samira,Taric,332,107,225,32.23
Samira,Maokai,768,392,376,51.04
Samira,Kassadin,310,162,148,52.26
Samira,Anivia,535,267,268,49.91
Samira,JarvanIV,619,323,296,52.18
Samira,RekSai,189,108,81,57.14
Samira,Rumble,297,159,138,53.54
Samira,Belveth,355,207,148,58.31
Samira,Gangplank,662,340,322,51.36
Samira,Lissandra,446,224,222,50.22
Samira,Qiyana,411,198,213,48.18
Samira,Sivir,770,388,382,50.39
Samira,MonkeyKing,1018,432,586,42.44
Skarner,Irelia,506,240,266,47.43
Skarner,Diana,835,409,426,48.98
Skarner,Lux,1341,665,676,49.59
Skarner,Tristana,554,257,297,46.39
Skarner,Mel,1156,585,571,50.61
Skarner,Viktor,556,223,333,40.11
Skarner,Nocturne,599,270,329,45.08
Skarner,Annie,219,118,101,53.88
Skarner,KogMaw,206,86,120,41.75
Skarner,Alistar,285,138,147,48.42
Skarner,Yorick,539,218,321,40.45
Skarner,Kayn,862,381,481,44.2
Skarner,Akali,653,314,339,48.09
Skarner,Caitlyn,1348,605,743,44.88
Skarner,Sett,907,415,492,45.76
Skarner,LeeSin,868,456,412,52.53
Skarner,Nasus,350,163,187,46.57
Skarner,Kaisa,983,491,492,49.95
Skarner,Bard,187,88,99,47.06
Skarner,Yasuo,992,424,568,42.74
Skarner,Jhin,1108,487,621,43.95
Skarner,Thresh,790,363,427,45.95
Skarner,Illaoi,293,121,172,41.3
Skarner,Volibear,705,309,396,43.83
Skarner,Varus,527,242,285,45.92
Skarner,Nautilus,797,435,362,54.58
Skarner,Teemo,665,348,317,52.33
Skarner,Graves,343,144,199,41.98
Skarner,Zoe,248,131,117,52.82
Skarner,Katarina,464,216,248,46.55
Skarner,Galio,512,238,274,46.48
Skarner,Warwick,798,337,461,42.23
Skarner,Veigar,534,237,297,44.38
Skarner,Ivern,108,70,38,64.81
Skarner,Ezreal,1252,656,596,52.4
Skarner,Xayah,319,143,176,44.83
Skarner,DrMundo,342,175,167,51.17
Skarner,Nunu,413,201,212,48.67
Skarner,Leblanc,376,177,199,47.07
Skarner,Nami,570,250,320,43.86
Skarner,Smolder,391,190,201,48.59
Skarner,Zed,593,263,330,44.35
Skarner,Morgana,629,246,383,39.11
Skarner,Pantheon,938,442,496,47.12
Skarner,Amumu,600,245,355,40.83
Skarner,Ziggs,236,110,126,46.61
Skarner,Malphite,466,219,247,47
Skarner,Sion,475,181,294,38.11
Skarner,Shen,348,180,168,51.72
Skarner,Jax,583,300,283,51.46
Skarner,Rengar,253,143,110,56.52
Skarner,Nilah,200,81,119,40.5
Skarner,Karma,586,267,319,45.56
Skarner,Chogath,656,361,295,55.03
Skarner,JarvanIV,305,129,176,42.3
Skarner,Vex,251,138,113,54.98
Skarner,Mordekaiser,801,348,453,43.45
Skarner,Lucian,382,204,178,53.4
Skarner,Yuumi,545,272,273,49.91
Skarner,Kled,148,72,76,48.65
Skarner,Lillia,433,177,256,40.88
Skarner,Ahri,802,376,426,46.88
Skarner,MissFortune,1154,483,671,41.85
Skarner,Neeko,323,135,188,41.8
Skarner,Darius,1078,512,566,47.5
Skarner,MasterYi,566,262,304,46.29
Skarner,Kassadin,98,42,56,42.86
Skarner,Rell,376,176,200,46.81
Skarner,Aatrox,530,245,285,46.23
Skarner,Sylas,823,397,426,48.24
Skarner,Kindred,251,132,119,52.59
Skarner,Singed,161,43,118,26.71
Skarner,Vi,574,241,333,41.99
Skarner,Lulu,724,361,363,49.86
Skarner,Viego,743,292,451,39.3
Skarner,Swain,543,232,311,42.73
Skarner,Aurora,470,209,261,44.47
Skarner,Zyra,404,168,236,41.58
Skarner,Garen,783,357,426,45.59
Skarner,Azir,245,126,119,51.43
Skarner,Briar,388,175,213,45.1
Skarner,Gangplank,281,142,139,50.53
Skarner,Urgot,232,93,139,40.09
Skarner,Jinx,1398,591,807,42.27
Skarner,Seraphine,491,220,271,44.81
Skarner,Hecarim,235,111,124,47.23
Skarner,Ashe,1200,555,645,46.25
Skarner,Vayne,749,342,407,45.66
Skarner,Vladimir,338,154,184,45.56
Skarner,Senna,406,161,245,39.66
Skarner,Twitch,442,209,233,47.29
Skarner,Pyke,514,188,326,36.58
Skarner,Shaco,470,241,229,51.28
Skarner,Tryndamere,252,114,138,45.24
Skarner,Udyr,226,109,117,48.23
Skarner,Syndra,347,175,172,50.43
Skarner,TahmKench,468,218,250,46.58
Skarner,Taliyah,196,91,105,46.43
Skarner,Zilean,150,102,48,68
Skarner,Gragas,325,150,175,46.15
Skarner,Elise,427,176,251,41.22
Skarner,Gnar,284,135,149,47.54
Skarner,Orianna,330,165,165,50
Skarner,Ekko,498,222,276,44.58
Skarner,Riven,257,117,140,45.53
Skarner,Samira,518,291,227,56.18
Skarner,Draven,276,132,144,47.83
Skarner,Belveth,174,56,118,32.18
Skarner,Leona,487,224,263,46
Skarner,Quinn,227,115,112,50.66
Skarner,XinZhao,391,140,251,35.81
Skarner,Malzahar,549,236,313,42.99
Skarner,Sejuani,321,130,191,40.5
Skarner,Rakan,269,143,126,53.16
Skarner,Khazix,300,195,105,65
Skarner,Kennen,158,82,76,51.9
Skarner,Yone,1083,530,553,48.94
Skarner,Ornn,241,104,137,43.15
Skarner,Hwei,421,221,200,52.49
Skarner,Corki,199,115,84,57.79
Skarner,Shyvana,184,81,103,44.02
Skarner,Fizz,244,108,136,44.26
Skarner,Poppy,320,151,169,47.19
Skarner,Jayce,247,77,170,31.17
Skarner,Kayle,397,158,239,39.8
Skarner,Gwen,305,146,159,47.87
Skarner,Zac,370,182,188,49.19
Skarner,FiddleSticks,297,163,134,54.88
Skarner,Xerath,491,283,208,57.64
Skarner,Blitzcrank,461,204,257,44.25
Skarner,Soraka,300,145,155,48.33
Skarner,Camille,226,115,111,50.88
Skarner,Milio,344,152,192,44.19
Skarner,Trundle,308,138,170,44.81
Skarner,Sivir,289,124,165,42.91
Skarner,AurelionSol,239,116,123,48.54
Skarner,Fiora,243,95,148,39.09
Skarner,Ambessa,400,154,246,38.5
Skarner,Maokai,240,130,110,54.17
Skarner,Ryze,212,92,120,43.4
Skarner,Anivia,176,89,87,50.57
Skarner,Rumble,181,91,90,50.28
Skarner,Karthus,145,75,70,51.72
Skarner,Renekton,376,173,203,46.01
Skarner,Brand,368,159,209,43.21
Skarner,Kalista,214,91,123,42.52
Skarner,Aphelios,341,178,163,52.2
Skarner,TwistedFate,181,87,94,48.07
Skarner,Heimerdinger,250,106,144,42.4
Skarner,Janna,143,53,90,37.06
Skarner,Qiyana,158,91,67,57.59
Skarner,Talon,305,143,162,46.89
Skarner,Sona,197,83,114,42.13
Skarner,Braum,406,181,225,44.58
Skarner,Naafiri,228,103,125,45.18
Skarner,Nidalee,149,63,86,42.28
Skarner,Velkoz,313,141,172,45.05
Skarner,KSante,330,148,182,44.85
Skarner,Olaf,173,86,87,49.71
Skarner,Zeri,268,132,136,49.25
Skarner,Evelynn,229,111,118,48.47
Skarner,MonkeyKing,410,161,249,39.27
Skarner,Taric,100,35,65,35
Skarner,Renata,125,61,64,48.8
Skarner,Rammus,97,32,65,32.99
Skarner,Akshan,281,118,163,41.99
Skarner,Cassiopeia,180,79,101,43.89
Skarner,Lissandra,156,70,86,44.87
Skarner,RekSai,58,23,35,39.66
Urgot,Riven,556,303,253,54.5
Urgot,Amumu,1075,510,565,47.44
Urgot,Zoe,363,233,130,64.19
Urgot,MissFortune,2401,1224,1177,50.98
Urgot,Sona,413,239,174,57.87
Urgot,Mordekaiser,1487,761,726,51.18
Urgot,Udyr,450,250,200,55.56
Urgot,Yorick,1246,588,658,47.19
Urgot,Sivir,488,233,255,47.75
Urgot,Nautilus,1137,644,493,56.64
Urgot,Darius,1957,1009,948,51.56
Urgot,Yasuo,1856,987,869,53.18
Urgot,Swain,977,483,494,49.44
Urgot,Vi,886,439,447,49.55
Urgot,Orianna,421,223,198,52.97
Urgot,Draven,601,323,278,53.74
Urgot,Lulu,1116,535,581,47.94
Urgot,Singed,349,179,170,51.29
Urgot,Kindred,475,216,259,45.47
Urgot,Ashe,1720,920,800,53.49
Urgot,Alistar,410,228,182,55.61
Urgot,Kled,223,106,117,47.53
Urgot,Zeri,429,233,196,54.31
Urgot,Neeko,598,364,234,60.87
Urgot,TahmKench,1006,524,482,52.09
Urgot,Brand,766,415,351,54.18
Urgot,Mel,1934,1003,931,51.86
Urgot,Jinx,2644,1292,1352,48.87
Urgot,Pyke,837,451,386,53.88
Urgot,Thresh,1184,618,566,52.2
Urgot,Viego,1231,635,596,51.58
Urgot,Kalista,295,178,117,60.34
Urgot,FiddleSticks,439,226,213,51.48
Urgot,Chogath,1257,674,583,53.62
Urgot,MasterYi,1264,662,602,52.37
Urgot,Zed,886,485,401,54.74
Urgot,Lux,2541,1238,1303,48.72
Urgot,Morgana,1186,617,569,52.02
Urgot,Aatrox,1011,553,458,54.7
Urgot,XinZhao,555,345,210,62.16
Urgot,Qiyana,258,153,105,59.3
Urgot,AurelionSol,461,245,216,53.15
Urgot,Zyra,816,400,416,49.02
Urgot,Warwick,1624,891,733,54.86
Urgot,Fizz,606,334,272,55.12
Urgot,Teemo,1260,601,659,47.7
Urgot,Poppy,524,275,249,52.48
Urgot,Ekko,896,518,378,57.81
Urgot,Kaisa,1587,902,685,56.84
Urgot,Rell,512,248,264,48.44
Urgot,Sett,1761,897,864,50.94
Urgot,LeeSin,1000,541,459,54.1
Urgot,Ezreal,1837,1011,826,55.04
Urgot,Xayah,387,181,206,46.77
Urgot,DrMundo,591,245,346,41.46
Urgot,Shen,581,309,272,53.18
Urgot,Tryndamere,577,308,269,53.38
Urgot,Katarina,764,433,331,56.68
Urgot,Seraphine,897,466,431,51.95
Urgot,Caitlyn,2650,1458,1192,55.02
Urgot,Nocturne,1192,617,575,51.76
Urgot,Elise,617,336,281,54.46
Urgot,Senna,837,446,391,53.29
Urgot,Maokai,448,239,209,53.35
Urgot,Kennen,347,200,147,57.64
Urgot,Belveth,248,145,103,58.47
Urgot,Ambessa,523,278,245,53.15
Urgot,Irelia,793,444,349,55.99
Urgot,Samira,760,445,315,58.55
Urgot,Yuumi,781,409,372,52.37
Urgot,Jax,800,425,375,53.13
Urgot,Karthus,242,135,107,55.79
Urgot,MonkeyKing,655,315,340,48.09
Urgot,Lucian,611,335,276,54.83
Urgot,Nami,1075,565,510,52.56
Urgot,Malzahar,969,506,463,52.22
Urgot,Aphelios,534,283,251,53
Urgot,Milio,557,267,290,47.94
Urgot,Kayn,1510,852,658,56.42
Urgot,Volibear,1272,692,580,54.4
Urgot,Smolder,703,383,320,54.48
Urgot,Talon,537,293,244,54.56
Urgot,Sylas,1105,570,535,51.58
Urgot,Vladimir,556,297,259,53.42
Urgot,Gangplank,473,273,200,57.72
Urgot,Varus,774,413,361,53.36
Urgot,Rakan,414,211,203,50.97
Urgot,Aurora,727,367,360,50.48
Urgot,Braum,601,251,350,41.76
Urgot,Yone,1592,904,688,56.78
Urgot,Camille,313,219,94,69.97
Urgot,Khazix,504,325,179,64.48
Urgot,Akali,955,546,409,57.17
Urgot,Skarner,232,139,93,59.91
Urgot,Shaco,884,422,462,47.74
Urgot,Zac,396,186,210,46.97
Urgot,Kassadin,257,148,109,57.59
Urgot,Twitch,858,458,400,53.38
Urgot,Nasus,899,459,440,51.06
Urgot,Cassiopeia,299,139,160,46.49
Urgot,RekSai,138,87,51,63.04
Urgot,Leona,769,401,368,52.15
Urgot,Taric,239,127,112,53.14
Urgot,Anivia,340,174,166,51.18
Urgot,KSante,405,200,205,49.38
Urgot,Fiora,318,192,126,60.38
Urgot,Veigar,1075,493,582,45.86
Urgot,Ivern,176,98,78,55.68
Urgot,Jhin,1963,1024,939,52.17
Urgot,Ryze,289,147,142,50.87
Urgot,Ziggs,420,199,221,47.38
Urgot,Tristana,930,467,463,50.22
Urgot,Garen,1641,760,881,46.31
Urgot,Ahri,1357,768,589,56.6
Urgot,Vayne,1160,574,586,49.48
Urgot,KogMaw,307,171,136,55.7
Urgot,Xerath,840,459,381,54.64
Urgot,Gragas,489,290,199,59.3
Urgot,Akshan,369,193,176,52.3
Urgot,Briar,814,380,434,46.68
Urgot,Hwei,671,348,323,51.86
Urgot,Graves,539,254,285,47.12
Urgot,Heimerdinger,432,233,199,53.94
Urgot,Nunu,608,333,275,54.77
Urgot,Diana,1520,778,742,51.18
Urgot,Kayle,827,413,414,49.94
Urgot,Trundle,603,316,287,52.4
Urgot,Vex,482,240,242,49.79
Urgot,Malphite,913,464,449,50.82
Urgot,Gwen,531,237,294,44.63
Urgot,Blitzcrank,674,289,385,42.88
Urgot,Naafiri,373,211,162,56.57
Urgot,Ornn,394,183,211,46.45
Urgot,Karma,1078,548,530,50.83
Urgot,Taliyah,259,143,116,55.21
Urgot,Pantheon,1668,903,765,54.14
Urgot,Shyvana,287,178,109,62.02
Urgot,Gnar,420,243,177,57.86
Urgot,TwistedFate,353,183,170,51.84
Urgot,Renata,197,109,88,55.33
Urgot,JarvanIV,457,234,223,51.2
Urgot,Viktor,879,464,415,52.79
Urgot,Renekton,478,265,213,55.44
Urgot,Sion,805,385,420,47.83
Urgot,Janna,366,216,150,59.02
Urgot,Olaf,211,109,102,51.66
Urgot,Nidalee,288,166,122,57.64
Urgot,Zilean,332,156,176,46.99
Urgot,Rammus,382,183,199,47.91
Urgot,Evelynn,436,235,201,53.9
Urgot,Leblanc,475,275,200,57.89
Urgot,Rumble,212,123,89,58.02
Urgot,Azir,333,169,164,50.75
Urgot,Bard,319,184,135,57.68
Urgot,Soraka,486,264,222,54.32
Urgot,Illaoi,428,214,214,50
Urgot,Quinn,343,214,129,62.39
Urgot,Hecarim,348,206,142,59.2
Urgot,Lillia,520,229,291,44.04
Urgot,Corki,409,226,183,55.26
Urgot,Lissandra,319,169,150,52.98
Urgot,Rengar,395,250,145,63.29
Urgot,Galio,712,344,368,48.31
Urgot,Sejuani,391,224,167,57.29
Urgot,Syndra,565,304,261,53.81
Urgot,Annie,313,139,174,44.41
Urgot,Jayce,349,201,148,57.59
Urgot,Velkoz,611,348,263,56.96
Urgot,Nilah,391,210,181,53.71
Orianna,Darius,1659,836,823,50.39
Orianna,Rengar,345,189,156,54.78
Orianna,Syndra,708,353,355,49.86
Orianna,Caitlyn,2273,1134,1139,49.89
Orianna,Lux,2182,1049,1133,48.08
Orianna,Urgot,421,198,223,47.03
Orianna,LeeSin,1416,753,663,53.18
Orianna,TwistedFate,360,156,204,43.33
Orianna,Yasuo,1512,766,746,50.66
Orianna,Rakan,405,194,211,47.9
Orianna,Camille,339,200,139,59
Orianna,Mel,2422,1334,1088,55.08
Orianna,Draven,415,182,233,43.86
Orianna,Senna,674,340,334,50.45
Orianna,Zac,361,180,181,49.86
Orianna,Nunu,528,277,251,52.46
Orianna,Veigar,859,360,499,41.91
Orianna,Kaisa,1388,708,680,51.01
Orianna,Shen,661,356,305,53.86
Orianna,Riven,410,181,229,44.15
Orianna,Vi,824,397,427,48.18
Orianna,MissFortune,1777,881,896,49.58
Orianna,Soraka,464,226,238,48.71
Orianna,Yorick,902,391,511,43.35
Orianna,MasterYi,1022,512,510,50.1
Orianna,Irelia,661,336,325,50.83
Orianna,Nami,914,434,480,47.48
Orianna,Yone,1437,687,750,47.81
Orianna,Neeko,450,251,199,55.78
Orianna,Kayn,1214,640,574,52.72
Orianna,Heimerdinger,461,227,234,49.24
Orianna,Mordekaiser,1020,512,508,50.2
Orianna,Viego,1274,585,689,45.92
Orianna,Zeri,397,179,218,45.09
Orianna,Alistar,371,176,195,47.44
Orianna,Singed,265,140,125,52.83
Orianna,Karma,1040,494,546,47.5
Orianna,Jinx,2445,1194,1251,48.83
Orianna,Akshan,324,160,164,49.38
Orianna,Aphelios,597,314,283,52.6
Orianna,Braum,499,249,250,49.9
Orianna,Amumu,891,417,474,46.8
Orianna,Zed,811,406,405,50.06
Orianna,Poppy,599,300,299,50.08
Orianna,Pyke,790,417,373,52.78
Orianna,Aurora,783,424,359,54.15
Orianna,Aatrox,774,449,325,58.01
Orianna,Kindred,422,203,219,48.1
Orianna,Swain,774,347,427,44.83
Orianna,Blitzcrank,718,369,349,51.39
Orianna,Ekko,747,352,395,47.12
Orianna,Rell,525,283,242,53.9
Orianna,Illaoi,433,218,215,50.35
Orianna,Jhin,1504,736,768,48.94
Orianna,Talon,519,274,245,52.79
Orianna,Galio,680,318,362,46.76
Orianna,Lucian,633,320,313,50.55
Orianna,Milio,578,290,288,50.17
Orianna,Ornn,453,245,208,54.08
Orianna,Pantheon,1539,867,672,56.34
Orianna,Nautilus,1069,557,512,52.1
Orianna,Akali,862,467,395,54.18
Orianna,Vayne,1104,512,592,46.38
Orianna,Seraphine,702,366,336,52.14
Orianna,Shyvana,231,112,119,48.48
Orianna,Vex,438,199,239,45.43
Orianna,Ezreal,2224,1090,1134,49.01
Orianna,Malzahar,879,401,478,45.62
Orianna,Gwen,430,220,210,51.16
Orianna,Rammus,268,149,119,55.6
Orianna,Katarina,630,267,363,42.38
Orianna,Viktor,953,434,519,45.54
Orianna,Ashe,1767,838,929,47.43
Orianna,Yuumi,645,311,334,48.22
Orianna,Fiora,286,151,135,52.8
Orianna,Vladimir,699,364,335,52.07
Orianna,Varus,869,497,372,57.19
Orianna,Velkoz,503,251,252,49.9
Orianna,Chogath,1008,488,520,48.41
Orianna,Gragas,545,270,275,49.54
Orianna,Shaco,755,370,385,49.01
Orianna,Morgana,1021,511,510,50.05
Orianna,Bard,325,155,170,47.69
Orianna,Gangplank,419,207,212,49.4
Orianna,Brand,471,277,194,58.81
Orianna,Sett,1150,553,597,48.09
Orianna,Nocturne,982,491,491,50
Orianna,Kennen,266,142,124,53.38
Orianna,Teemo,974,433,541,44.46
Orianna,Malphite,743,374,369,50.34
Orianna,Karthus,220,127,93,57.73
Orianna,Nilah,373,180,193,48.26
Orianna,Leona,771,399,372,51.75
Orianna,Xerath,873,372,501,42.61
Orianna,Graves,511,271,240,53.03
Orianna,Cassiopeia,255,132,123,51.76
Orianna,Qiyana,313,153,160,48.88
Orianna,Azir,344,163,181,47.38
Orianna,KSante,379,203,176,53.56
Orianna,Ambessa,715,362,353,50.63
Orianna,Lillia,472,218,254,46.19
Orianna,Samira,622,308,314,49.52
Orianna,Maokai,459,229,230,49.89
Orianna,Anivia,299,122,177,40.8
Orianna,Volibear,921,459,462,49.84
Orianna,Zyra,711,370,341,52.04
Orianna,Nidalee,314,170,144,54.14
Orianna,Taric,215,118,97,54.88
Orianna,Kassadin,171,92,79,53.8
Orianna,Udyr,282,184,98,65.25
Orianna,Sylas,1219,597,622,48.97
Orianna,Zilean,305,142,163,46.56
Orianna,Zoe,344,154,190,44.77
Orianna,Sivir,425,251,174,59.06
Orianna,Renekton,449,199,250,44.32
Orianna,Ivern,192,101,91,52.6
Orianna,Elise,673,326,347,48.44
Orianna,Tryndamere,400,186,214,46.5
Orianna,Thresh,1211,551,660,45.5
Orianna,FiddleSticks,478,215,263,44.98
Orianna,Trundle,441,191,250,43.31
Orianna,Leblanc,565,293,272,51.86
Orianna,Lulu,1129,521,608,46.15
Orianna,Naafiri,337,192,145,56.97
Orianna,Skarner,330,165,165,50
Orianna,Khazix,523,305,218,58.32
Orianna,Hwei,592,336,256,56.76
Orianna,Diana,1297,542,755,41.79
Orianna,Twitch,716,336,380,46.93
Orianna,MonkeyKing,538,261,277,48.51
Orianna,Belveth,235,110,125,46.81
Orianna,Xayah,437,219,218,50.11
Orianna,TahmKench,690,340,350,49.28
Orianna,Kled,168,84,84,50
Orianna,Jax,782,400,382,51.15
Orianna,Fizz,430,202,228,46.98
Orianna,Annie,330,138,192,41.82
Orianna,Sion,633,293,340,46.29
Orianna,Sejuani,434,195,239,44.93
Orianna,Ahri,1344,702,642,52.23
Orianna,Warwick,1279,583,696,45.58
Orianna,Gnar,386,202,184,52.33
Orianna,Kalista,300,161,139,53.67
Orianna,Janna,335,148,187,44.18
Orianna,Briar,652,326,326,50
Orianna,Nasus,524,298,226,56.87
Orianna,Ziggs,332,155,177,46.69
Orianna,Garen,1386,654,732,47.19
Orianna,Jayce,550,248,302,45.09
Orianna,Olaf,244,123,121,50.41
Orianna,Evelynn,309,138,171,44.66
Orianna,JarvanIV,471,231,240,49.04
Orianna,DrMundo,526,211,315,40.11
Orianna,Renata,182,88,94,48.35
Orianna,KogMaw,330,169,161,51.21
Orianna,Taliyah,287,140,147,48.78
Orianna,Smolder,489,263,226,53.78
Orianna,Ryze,290,154,136,53.1
Orianna,AurelionSol,362,171,191,47.24
Orianna,Rumble,265,170,95,64.15
Orianna,Corki,429,230,199,53.61
Orianna,Tristana,825,418,407,50.67
Orianna,XinZhao,561,282,279,50.27
Orianna,Sona,221,101,120,45.7
Orianna,Kayle,504,286,218,56.75
Orianna,Lissandra,261,120,141,45.98
Orianna,Quinn,319,138,181,43.26
Orianna,Hecarim,357,173,184,48.46
Orianna,RekSai,140,62,78,44.29
Rengar,Aatrox,676,245,431,36.24
Rengar,Ekko,721,333,388,46.19
Rengar,Orianna,345,156,189,45.22
Rengar,Malzahar,673,291,382,43.24
Rengar,Maokai,314,126,188,40.13
Rengar,Mordekaiser,1002,378,624,37.72
Rengar,Udyr,258,140,118,54.26
Rengar,Yorick,656,279,377,42.53
Rengar,Sivir,292,101,191,34.59
Rengar,Nautilus,699,320,379,45.78
Rengar,DrMundo,400,180,220,45
Rengar,Belveth,198,103,95,52.02
Rengar,Leblanc,445,205,240,46.07
Rengar,Briar,573,218,355,38.05
Rengar,Anivia,216,83,133,38.43
Rengar,Tryndamere,466,240,226,51.5
Rengar,Gragas,456,207,249,45.39
Rengar,Irelia,683,283,400,41.43
Rengar,Kalista,271,120,151,44.28
Rengar,Twitch,613,299,314,48.78
Rengar,Yasuo,1531,612,919,39.97
Rengar,Yone,1360,669,691,49.19
Rengar,Alistar,333,139,194,41.74
Rengar,Volibear,814,394,420,48.4
Rengar,Nocturne,833,358,475,42.98
Rengar,Xerath,523,212,311,40.54
Rengar,Ezreal,1573,726,847,46.15
Rengar,Blitzcrank,514,227,287,44.16
Rengar,Poppy,488,220,268,45.08
Rengar,Warwick,1011,472,539,46.69
Rengar,Leona,512,226,286,44.14
Rengar,MissFortune,1511,649,862,42.95
Rengar,Lux,1822,788,1034,43.25
Rengar,Rammus,237,86,151,36.29
Rengar,Aurora,582,249,333,42.78
Rengar,Ashe,1288,599,689,46.51
Rengar,Pantheon,1123,453,670,40.34
Rengar,Jax,630,241,389,38.25
Rengar,Sejuani,319,126,193,39.5
Rengar,Syndra,451,190,261,42.13
Rengar,Jinx,1811,862,949,47.6
Rengar,Swain,684,259,425,37.87
Rengar,Sylas,719,367,352,51.04
Rengar,FiddleSticks,350,125,225,35.71
Rengar,Aphelios,390,174,216,44.62
Rengar,Morgana,764,347,417,45.42
Rengar,Ambessa,427,212,215,49.65
Rengar,Varus,677,312,365,46.09
Rengar,Graves,473,202,271,42.71
Rengar,Neeko,378,156,222,41.27
Rengar,Gangplank,336,184,152,54.76
Rengar,Kayn,1186,523,663,44.1
Rengar,Hwei,498,211,287,42.37
Rengar,Jhin,1446,635,811,43.91
Rengar,Jayce,301,151,150,50.17
Rengar,JarvanIV,414,163,251,39.37
Rengar,Caitlyn,1725,776,949,44.99
Rengar,Vex,388,149,239,38.4
Rengar,Renekton,346,139,207,40.17
Rengar,TahmKench,649,291,358,44.84
Rengar,Gwen,438,196,242,44.75
Rengar,LeeSin,909,424,485,46.64
Rengar,TwistedFate,247,101,146,40.89
Rengar,Zeri,369,165,204,44.72
Rengar,Seraphine,590,247,343,41.86
Rengar,Nasus,463,180,283,38.88
Rengar,Zac,345,144,201,41.74
Rengar,Mel,1560,677,883,43.4
Rengar,Singed,200,117,83,58.5
Rengar,Shaco,709,335,374,47.25
Rengar,Taliyah,224,101,123,45.09
Rengar,Shen,529,235,294,44.42
Rengar,Gnar,314,137,177,43.63
Rengar,Vi,593,236,357,39.8
Rengar,Kaisa,1089,474,615,43.53
Rengar,Rumble,155,83,72,53.55
Rengar,Malphite,667,288,379,43.18
Rengar,Lulu,924,431,493,46.65
Rengar,Khazix,658,315,343,47.87
Rengar,Talon,474,236,238,49.79
Rengar,Thresh,935,408,527,43.64
Rengar,Olaf,140,55,85,39.29
Rengar,Nunu,497,251,246,50.5
Rengar,Vladimir,451,179,272,39.69
Rengar,Diana,1025,424,601,41.37
Rengar,Veigar,705,344,361,48.79
Rengar,Milio,497,242,255,48.69
Rengar,Kindred,332,117,215,35.24
Rengar,Heimerdinger,287,144,143,50.17
Rengar,Yuumi,693,306,387,44.16
Rengar,Trundle,338,147,191,43.49
Rengar,Xayah,505,197,308,39.01
Rengar,Riven,332,166,166,50
Rengar,Ahri,907,406,501,44.76
Rengar,Nami,845,343,502,40.59
Rengar,Garen,1128,538,590,47.7
Rengar,Galio,581,226,355,38.9
Rengar,Katarina,580,243,337,41.9
Rengar,Braum,419,155,264,36.99
Rengar,Kennen,195,78,117,40
Rengar,Skarner,253,110,143,43.48
Rengar,Illaoi,280,104,176,37.14
Rengar,Ziggs,230,94,136,40.87
Rengar,Elise,588,273,315,46.43
Rengar,Sion,520,201,319,38.65
Rengar,Viego,928,432,496,46.55
Rengar,Annie,218,77,141,35.32
Rengar,AurelionSol,245,112,133,45.71
Rengar,Chogath,817,328,489,40.15
Rengar,Darius,1236,536,700,43.37
Rengar,Zed,796,401,395,50.38
Rengar,Amumu,675,352,323,52.15
Rengar,Janna,292,138,154,47.26
Rengar,Vayne,851,351,500,41.25
Rengar,Brand,517,199,318,38.49
Rengar,Zoe,347,192,155,55.33
Rengar,MasterYi,825,330,495,40
Rengar,Soraka,403,206,197,51.12
Rengar,Lucian,469,214,255,45.63
Rengar,KSante,423,178,245,42.08
Rengar,Kassadin,172,67,105,38.95
Rengar,Teemo,855,361,494,42.22
Rengar,Smolder,516,229,287,44.38
Rengar,Cassiopeia,213,110,103,51.64
Rengar,Sona,240,92,148,38.33
Rengar,Qiyana,242,136,106,56.2
Rengar,Akshan,239,124,115,51.88
Rengar,Tristana,641,299,342,46.65
Rengar,Azir,306,135,171,44.12
Rengar,Karthus,257,118,139,45.91
Rengar,Corki,332,146,186,43.98
Rengar,Bard,301,133,168,44.19
Rengar,Sett,1005,388,617,38.61
Rengar,Evelynn,284,88,196,30.99
Rengar,Naafiri,247,107,140,43.32
Rengar,Velkoz,503,209,294,41.55
Rengar,Samira,536,228,308,42.54
Rengar,KogMaw,162,52,110,32.1
Rengar,Ivern,161,67,94,41.61
Rengar,Draven,395,190,205,48.1
Rengar,Pyke,683,302,381,44.22
Rengar,Senna,454,233,221,51.32
Rengar,Akali,672,267,405,39.73
Rengar,Karma,810,337,473,41.6
Rengar,Rakan,383,148,235,38.64
Rengar,Hecarim,366,135,231,36.89
Rengar,Zilean,241,96,145,39.83
Rengar,Ryze,247,131,116,53.04
Rengar,Quinn,303,112,191,36.96
Rengar,Camille,264,135,129,51.14
Rengar,Rell,358,185,173,51.68
Rengar,Viktor,587,291,296,49.57
Rengar,Nilah,355,128,227,36.06
Rengar,Ornn,348,145,203,41.67
Rengar,Lillia,347,148,199,42.65
Rengar,Zyra,461,217,244,47.07
Rengar,Fizz,380,164,216,43.16
Rengar,Fiora,300,122,178,40.67
Rengar,XinZhao,342,149,193,43.57
Rengar,Lissandra,270,119,151,44.07
Rengar,Renata,195,85,110,43.59
Rengar,Urgot,395,145,250,36.71
Rengar,Shyvana,139,58,81,41.73
Rengar,Taric,151,76,75,50.33
Rengar,MonkeyKing,403,133,270,33
Rengar,Kled,161,71,90,44.1
Rengar,Nidalee,210,95,115,45.24
Rengar,Kayle,494,228,266,46.15
Rengar,RekSai,98,46,52,46.94
Syndra,Aatrox,1066,600,466,56.29
Syndra,Ekko,1187,594,593,50.04
Syndra,Orianna,708,355,353,50.14
Syndra,Malzahar,1317,640,677,48.6
Syndra,Maokai,549,291,258,53.01
Syndra,XinZhao,793,442,351,55.74
Syndra,Katarina,1020,479,541,46.96
Syndra,Teemo,1502,762,740,50.73
Syndra,Vayne,1574,776,798,49.3
Syndra,TwistedFate,432,241,191,55.79
Syndra,Yorick,1210,573,637,47.36
Syndra,Viego,1752,900,852,51.37
Syndra,Malphite,1084,500,584,46.13
Syndra,Kaisa,1974,964,1010,48.83
Syndra,Rell,664,366,298,55.12
Syndra,Gangplank,509,261,248,51.28
Syndra,Karthus,369,205,164,55.56
Syndra,Aurora,1087,579,508,53.27
Syndra,Ezreal,2681,1367,1314,50.99
Syndra,Senna,781,400,381,51.22
Syndra,Volibear,1247,606,641,48.6
Syndra,Evelynn,472,225,247,47.67
Syndra,Nocturne,1410,655,755,46.45
Syndra,Neeko,594,325,269,54.71
Syndra,Azir,495,274,221,55.35
Syndra,Sejuani,493,239,254,48.48
Syndra,Sylas,1209,605,604,50.04
Syndra,Lucian,901,468,433,51.94
Syndra,Seraphine,861,424,437,49.25
Syndra,Nasus,842,431,411,51.19
Syndra,Kindred,491,272,219,55.4
Syndra,Tristana,1075,600,475,55.81
Syndra,Nautilus,1475,746,729,50.58
Syndra,Vex,652,340,312,52.15
Syndra,Vi,1178,606,572,51.44
Syndra,Nilah,464,213,251,45.91
Syndra,Thresh,1715,847,868,49.39
Syndra,Rengar,451,261,190,57.87
Syndra,Jhin,2486,1284,1202,51.65
Syndra,Illaoi,499,222,277,44.49
Syndra,Irelia,1000,509,491,50.9
Syndra,Varus,1120,619,501,55.27
Syndra,Kayn,1821,909,912,49.92
Syndra,Hwei,1092,566,526,51.83
Syndra,Lux,3061,1560,1501,50.96
Syndra,Ornn,573,267,306,46.6
Syndra,Zed,1369,685,684,50.04
Syndra,Sivir,655,308,347,47.02
Syndra,Veigar,1267,633,634,49.96
Syndra,Heimerdinger,667,320,347,47.98
Syndra,Briar,845,451,394,53.37
Syndra,Jinx,3049,1568,1481,51.43
Syndra,Warwick,1704,882,822,51.76
Syndra,Kalista,371,174,197,46.9
Syndra,Yasuo,1922,980,942,50.99
Syndra,Jax,1080,572,508,52.96
Syndra,Xayah,655,344,311,52.52
Syndra,Lulu,1677,866,811,51.64
Syndra,MasterYi,1304,663,641,50.84
Syndra,Ashe,2303,1157,1146,50.24
Syndra,Riven,615,323,292,52.52
Syndra,Bard,425,225,200,52.94
Syndra,Rammus,354,169,185,47.74
Syndra,Caitlyn,3218,1632,1586,50.71
Syndra,Alistar,518,272,246,52.51
Syndra,Braum,712,316,396,44.38
Syndra,Gragas,740,390,350,52.7
Syndra,Akali,1046,503,543,48.09
Syndra,Kassadin,273,116,157,42.49
Syndra,Vladimir,729,385,344,52.81
Syndra,Gnar,514,288,226,56.03
Syndra,Sona,333,159,174,47.75
Syndra,Darius,2340,1177,1163,50.3
Syndra,Leona,1087,521,566,47.93
Syndra,Swain,1124,573,551,50.98
Syndra,Shaco,1169,642,527,54.92
Syndra,Amumu,1118,556,562,49.73
Syndra,Mel,2399,1255,1144,52.31
Syndra,Nami,1373,640,733,46.61
Syndra,FiddleSticks,623,319,304,51.2
Syndra,Anivia,565,273,292,48.32
Syndra,Sett,1718,873,845,50.81
Syndra,Shen,747,391,356,52.34
Syndra,Garen,1941,894,1047,46.06
Syndra,Naafiri,443,204,239,46.05
Syndra,Lillia,703,397,306,56.47
Syndra,Mordekaiser,1587,740,847,46.63
Syndra,AurelionSol,571,263,308,46.06
Syndra,Morgana,1363,675,688,49.52
Syndra,KSante,554,340,214,61.37
Syndra,Trundle,680,343,337,50.44
Syndra,Milio,791,407,384,51.45
Syndra,Talon,669,374,295,55.9
Syndra,Draven,736,387,349,52.58
Syndra,MissFortune,2486,1200,1286,48.27
Syndra,Xerath,1169,522,647,44.65
Syndra,Chogath,1512,733,779,48.48
Syndra,Velkoz,772,382,390,49.48
Syndra,Yuumi,1140,620,520,54.39
Syndra,Poppy,802,406,396,50.62
Syndra,Galio,993,503,490,50.65
Syndra,Ziggs,494,239,255,48.38
Syndra,Kennen,339,151,188,44.54
Syndra,TahmKench,957,464,493,48.48
Syndra,Twitch,1060,593,467,55.94
Syndra,Ambessa,774,395,379,51.03
Syndra,Zyra,1128,543,585,48.14
Syndra,Akshan,390,197,193,50.51
Syndra,LeeSin,1626,816,810,50.18
Syndra,Sion,1014,518,496,51.08
Syndra,Blitzcrank,890,444,446,49.89
Syndra,Fizz,810,421,389,51.98
Syndra,Soraka,722,324,398,44.88
Syndra,Renekton,617,363,254,58.83
Syndra,Qiyana,346,193,153,55.78
Syndra,Karma,1509,723,786,47.91
Syndra,Singed,330,173,157,52.42
Syndra,Yone,2173,1160,1013,53.38
Syndra,Skarner,347,172,175,49.57
Syndra,Ivern,223,110,113,49.33
Syndra,Pyke,1035,554,481,53.53
Syndra,Zoe,629,299,330,47.54
Syndra,Cassiopeia,556,309,247,55.58
Syndra,Renata,245,129,116,52.65
Syndra,Samira,865,449,416,51.91
Syndra,Ahri,2063,1100,963,53.32
Syndra,Graves,846,437,409,51.65
Syndra,Rakan,608,332,276,54.61
Syndra,Smolder,831,414,417,49.82
Syndra,Pantheon,1961,1005,956,51.25
Syndra,Jayce,568,285,283,50.18
Syndra,JarvanIV,719,355,364,49.37
Syndra,Leblanc,679,357,322,52.58
Syndra,Janna,460,235,225,51.09
Syndra,KogMaw,428,223,205,52.1
Syndra,Diana,1934,1029,905,53.21
Syndra,Elise,924,459,465,49.68
Syndra,Zac,596,273,323,45.81
Syndra,MonkeyKing,729,362,367,49.66
Syndra,Viktor,1290,664,626,51.47
Syndra,Udyr,505,278,227,55.05
Syndra,Lissandra,351,145,206,41.31
Syndra,Aphelios,693,356,337,51.37
Syndra,Fiora,464,188,276,40.52
Syndra,Gwen,567,326,241,57.5
Syndra,Kayle,828,382,446,46.14
Syndra,Zilean,414,182,232,43.96
Syndra,Camille,510,263,247,51.57
Syndra,Nidalee,354,204,150,57.63
Syndra,Brand,723,362,361,50.07
Syndra,Shyvana,313,109,204,34.82
Syndra,Hecarim,571,297,274,52.01
Syndra,Khazix,697,354,343,50.79
Syndra,Olaf,294,160,134,54.42
Syndra,Annie,477,263,214,55.14
Syndra,Tryndamere,693,333,360,48.05
Syndra,Urgot,565,261,304,46.19
Syndra,Zeri,616,289,327,46.92
Syndra,RekSai,170,106,64,62.35
Syndra,Rumble,303,139,164,45.87
Syndra,Corki,529,316,213,59.74
Syndra,DrMundo,610,268,342,43.93
Syndra,Belveth,293,146,147,49.83
Syndra,Ryze,327,169,158,51.68
Syndra,Taric,275,154,121,56
Syndra,Taliyah,327,179,148,54.74
Syndra,Quinn,469,231,238,49.25
Syndra,Nunu,767,381,386,49.67
Syndra,Kled,259,131,128,50.58
Braum,Sett,1580,785,795,49.68
Braum,Vi,1100,565,535,51.36
Braum,AurelionSol,480,214,266,44.58
Braum,Corki,552,267,285,48.37
Braum,Milio,632,317,315,50.16
Braum,Trundle,664,320,344,48.19
Braum,Amumu,1155,536,619,46.41
Braum,Fizz,580,344,236,59.31
Braum,Kaisa,1959,1053,906,53.75
Braum,Pantheon,1817,885,932,48.71
Braum,Riven,535,274,261,51.21
Braum,FiddleSticks,574,264,310,45.99
Braum,Brand,760,376,384,49.47
Braum,Jinx,2706,1362,1344,50.33
Braum,Illaoi,484,241,243,49.79
Braum,Warwick,1400,749,651,53.5
Braum,Aurora,753,428,325,56.84
Braum,Ezreal,2402,1282,1120,53.37
Braum,Neeko,528,298,230,56.44
Braum,Nocturne,1294,623,671,48.15
Braum,Ekko,984,516,468,52.44
Braum,MissFortune,2731,1377,1354,50.42
Braum,Seraphine,846,418,428,49.41
Braum,Gangplank,486,244,242,50.21
Braum,Malzahar,1058,515,543,48.68
Braum,Tristana,1114,554,560,49.73
Braum,Senna,837,375,462,44.8
Braum,Mordekaiser,1439,677,762,47.05
Braum,Sejuani,479,243,236,50.73
Braum,Yone,1833,1006,827,54.88
Braum,Swain,1179,583,596,49.45
Braum,Shaco,892,480,412,53.81
Braum,Akali,1086,600,486,55.25
Braum,Sivir,507,252,255,49.7
Braum,Renata,215,104,111,48.37
Braum,Fiora,499,250,249,50.1
Braum,Diana,1641,829,812,50.52
Braum,Veigar,1079,523,556,48.47
Braum,Ashe,1996,1126,870,56.41
Braum,Volibear,1192,606,586,50.84
Braum,Irelia,871,475,396,54.54
Braum,Varus,914,481,433,52.63
Braum,Nautilus,1858,1017,841,54.74
Braum,Tryndamere,642,342,300,53.27
Braum,MasterYi,1252,686,566,54.79
Braum,Orianna,499,250,249,50.1
Braum,Lux,2389,1241,1148,51.95
Braum,MonkeyKing,768,389,379,50.65
Braum,Jhin,2148,1183,965,55.07
Braum,Vayne,1411,722,689,51.17
Braum,Talon,594,334,260,56.23
Braum,Taliyah,330,150,180,45.45
Braum,Zoe,488,271,217,55.53
Braum,Shen,738,362,376,49.05
Braum,Kayn,1606,801,805,49.88
Braum,Chogath,1444,727,717,50.35
Braum,Viktor,935,470,465,50.27
Braum,Morgana,1104,522,582,47.28
Braum,Hwei,751,364,387,48.47
Braum,Caitlyn,3012,1506,1506,50
Braum,Teemo,1303,673,630,51.65
Braum,Lucian,715,420,295,58.74
Braum,Ornn,507,271,236,53.45
Braum,Yorick,994,488,506,49.09
Braum,Kalista,330,188,142,56.97
Braum,LeeSin,1588,842,746,53.02
Braum,Mel,2122,1146,976,54.01
Braum,Smolder,692,345,347,49.86
Braum,Zed,1135,605,530,53.3
Braum,Sion,833,411,422,49.34
Braum,Soraka,603,288,315,47.76
Braum,Aatrox,927,509,418,54.91
Braum,Rengar,419,264,155,63.01
Braum,Ivern,226,150,76,66.37
Braum,Syndra,712,396,316,55.62
Braum,Samira,741,400,341,53.98
Braum,Maokai,478,239,239,50
Braum,Zac,538,291,247,54.09
Braum,Galio,805,365,440,45.34
Braum,Alistar,501,237,264,47.31
Braum,Graves,740,401,339,54.19
Braum,Yuumi,848,455,393,53.66
Braum,DrMundo,585,295,290,50.43
Braum,Nami,1207,591,616,48.96
Braum,Briar,819,427,392,52.14
Braum,Ryze,425,239,186,56.24
Braum,Singed,323,174,149,53.87
Braum,Nasus,728,341,387,46.84
Braum,Evelynn,457,211,246,46.17
Braum,Ahri,1528,791,737,51.77
Braum,Zyra,875,414,461,47.31
Braum,Ambessa,743,389,354,52.36
Braum,Sylas,1542,839,703,54.41
Braum,Camille,425,211,214,49.65
Braum,Karthus,304,144,160,47.37
Braum,Yasuo,2057,1063,994,51.68
Braum,Lulu,1410,745,665,52.84
Braum,Kindred,448,268,180,59.82
Braum,Nunu,669,363,306,54.26
Braum,Renekton,578,334,244,57.79
Braum,Vex,610,290,320,47.54
Braum,Karma,1343,709,634,52.79
Braum,Azir,468,265,203,56.62
Braum,Jax,1052,550,502,52.28
Braum,Draven,744,382,362,51.34
Braum,Vladimir,750,395,355,52.67
Braum,XinZhao,723,358,365,49.52
Braum,Urgot,601,350,251,58.24
Braum,Annie,358,174,184,48.6
Braum,Kayle,788,383,405,48.6
Braum,Gwen,576,328,248,56.94
Braum,Katarina,841,415,426,49.35
Braum,Aphelios,606,320,286,52.81
Braum,TahmKench,1018,546,472,53.63
Braum,Lillia,603,299,304,49.59
Braum,Kassadin,257,111,146,43.19
Braum,Twitch,929,517,412,55.65
Braum,Leblanc,645,387,258,60
Braum,Nilah,409,182,227,44.5
Braum,Thresh,2013,1029,984,51.12
Braum,Viego,1546,897,649,58.02
Braum,Heimerdinger,477,238,239,49.9
Braum,Quinn,364,189,175,51.92
Braum,Khazix,532,316,216,59.4
Braum,Xerath,785,393,392,50.06
Braum,Darius,1980,968,1012,48.89
Braum,Blitzcrank,919,513,406,55.82
Braum,Belveth,294,185,109,62.93
Braum,Xayah,524,253,271,48.28
Braum,Rakan,573,251,322,43.8
Braum,Elise,839,475,364,56.62
Braum,Garen,1823,880,943,48.27
Braum,Velkoz,658,291,367,44.22
Braum,Jayce,582,270,312,46.39
Braum,Shyvana,261,120,141,45.98
Braum,Gnar,483,238,245,49.28
Braum,Gragas,676,360,316,53.25
Braum,Ziggs,387,190,197,49.1
Braum,JarvanIV,688,349,339,50.73
Braum,KSante,609,360,249,59.11
Braum,Poppy,739,395,344,53.45
Braum,Kennen,319,160,159,50.16
Braum,TwistedFate,445,215,230,48.31
Braum,Lissandra,449,227,222,50.56
Braum,Rell,695,343,352,49.35
Braum,Leona,1072,586,486,54.66
Braum,Zilean,360,158,202,43.89
Braum,Hecarim,446,199,247,44.62
Braum,Rumble,286,169,117,59.09
Braum,Pyke,1032,582,450,56.4
Braum,Janna,360,186,174,51.67
Braum,Olaf,260,152,108,58.46
Braum,Taric,247,129,118,52.23
Braum,Rammus,374,182,192,48.66
Braum,Sona,247,115,132,46.56
Braum,Malphite,1038,462,576,44.51
Braum,KogMaw,401,144,257,35.91
Braum,Bard,439,190,249,43.28
Braum,Udyr,421,185,236,43.94
Braum,Anivia,384,205,179,53.39
Braum,Naafiri,330,180,150,54.55
Braum,Kled,184,117,67,63.59
Braum,RekSai,178,101,77,56.74
Braum,Cassiopeia,337,169,168,50.15
Braum,Skarner,406,225,181,55.42
Braum,Nidalee,357,198,159,55.46
Braum,Qiyana,236,105,131,44.49
Braum,Zeri,424,183,241,43.16
Braum,Akshan,378,210,168,55.56
Corki,Braum,552,285,267,51.63
Corki,XinZhao,454,206,248,45.37
Corki,Lux,1930,892,1038,46.22
Corki,Chogath,876,385,491,43.95
Corki,Taliyah,223,113,110,50.67
Corki,Mordekaiser,770,306,464,39.74
Corki,Vi,718,319,399,44.43
Corki,Azir,294,144,150,48.98
Corki,MissFortune,1633,741,892,45.38
Corki,Nautilus,858,441,417,51.4
Corki,Gnar,349,190,159,54.44
Corki,Warwick,948,417,531,43.99
Corki,Malzahar,696,319,377,45.83
Corki,Tristana,888,417,471,46.96
Corki,Brand,452,219,233,48.45
Corki,Ornn,341,182,159,53.37
Corki,Amumu,707,306,401,43.28
Corki,Katarina,692,329,363,47.54
Corki,Twitch,709,335,374,47.25
Corki,Senna,573,266,307,46.42
Corki,Garen,1311,552,759,42.11
Corki,Ekko,650,308,342,47.38
Corki,Yasuo,1529,673,856,44.02
Corki,Caitlyn,1829,804,1025,43.96
Corki,Poppy,519,246,273,47.4
Corki,Aurora,610,295,315,48.36
Corki,Nocturne,992,425,567,42.84
Corki,Pantheon,1216,586,630,48.19
Corki,Nilah,326,173,153,53.07
Corki,Soraka,461,183,278,39.7
Corki,Kennen,248,100,148,40.32
Corki,TwistedFate,311,141,170,45.34
Corki,Cassiopeia,225,91,134,40.44
Corki,Smolder,447,238,209,53.24
Corki,Milio,521,229,292,43.95
Corki,TahmKench,598,270,328,45.15
Corki,Samira,652,361,291,55.37
Corki,Taric,200,82,118,41
Corki,Hecarim,369,170,199,46.07
Corki,Jhin,1462,682,780,46.65
Corki,Velkoz,507,219,288,43.2
Corki,Nasus,468,237,231,50.64
Corki,MasterYi,743,347,396,46.7
Corki,Riven,384,187,197,48.7
Corki,Rell,507,247,260,48.72
Corki,Rammus,218,103,115,47.25
Corki,Vex,350,166,184,47.43
Corki,Lulu,1129,501,628,44.38
Corki,Kayle,520,228,292,43.85
Corki,Tryndamere,464,222,242,47.84
Corki,Akali,724,372,352,51.38
Corki,Neeko,361,160,201,44.32
Corki,Yorick,643,295,348,45.88
Corki,Singed,201,74,127,36.82
Corki,Ryze,289,127,162,43.94
Corki,Kayn,1256,550,706,43.79
Corki,Viktor,705,343,362,48.65
Corki,Zed,804,429,375,53.36
Corki,Ashe,1602,769,833,48
Corki,Thresh,1108,539,569,48.65
Corki,Jax,706,334,372,47.31
Corki,Shaco,701,317,384,45.22
Corki,Zoe,375,178,197,47.47
Corki,Yuumi,671,320,351,47.69
Corki,Teemo,814,364,450,44.72
Corki,Evelynn,243,102,141,41.98
Corki,Janna,295,121,174,41.02
Corki,Aatrox,655,310,345,47.33
Corki,Lucian,531,274,257,51.6
Corki,Nami,884,403,481,45.59
Corki,LeeSin,1161,571,590,49.18
Corki,Zac,440,244,196,55.45
Corki,Gragas,511,258,253,50.49
Corki,Viego,1120,532,588,47.5
Corki,Darius,1431,687,744,48.01
Corki,Kaisa,1277,587,690,45.97
Corki,Swain,668,281,387,42.07
Corki,DrMundo,405,196,209,48.4
Corki,Trundle,417,169,248,40.53
Corki,Rengar,332,186,146,56.02
Corki,Vladimir,553,257,296,46.47
Corki,Mel,1513,743,770,49.11
Corki,Sett,1031,442,589,42.87
Corki,Nunu,506,254,252,50.2
Corki,Jinx,1888,900,988,47.67
Corki,Briar,454,227,227,50
Corki,Ezreal,1897,918,979,48.39
Corki,Morgana,786,372,414,47.33
Corki,Nidalee,214,123,91,57.48
Corki,Volibear,822,386,436,46.96
Corki,Annie,236,118,118,50
Corki,Vayne,1040,474,566,45.58
Corki,Zeri,365,192,173,52.6
Corki,Gwen,406,210,196,51.72
Corki,Veigar,726,351,375,48.35
Corki,Sylas,1009,493,516,48.86
Corki,Varus,690,293,397,42.46
Corki,Irelia,535,266,269,49.72
Corki,FiddleSticks,361,165,196,45.71
Corki,Illaoi,352,178,174,50.57
Corki,Lillia,403,184,219,45.66
Corki,Fizz,342,170,172,49.71
Corki,Karma,877,435,442,49.6
Corki,Fiora,291,161,130,55.33
Corki,Ivern,147,87,60,59.18
Corki,Kassadin,227,62,165,27.31
Corki,Aphelios,470,204,266,43.4
Corki,Diana,1058,508,550,48.02
Corki,Sejuani,351,177,174,50.43
Corki,Shen,512,236,276,46.09
Corki,KSante,423,213,210,50.35
Corki,Khazix,427,193,234,45.2
Corki,Blitzcrank,573,261,312,45.55
Corki,Heimerdinger,293,109,184,37.2
Corki,Renata,151,92,59,60.93
Corki,Udyr,331,136,195,41.09
Corki,Zilean,293,138,155,47.1
Corki,Sion,682,338,344,49.56
Corki,Ziggs,262,120,142,45.8
Corki,Pyke,732,388,344,53.01
Corki,Naafiri,253,113,140,44.66
Corki,Ahri,950,477,473,50.21
Corki,Sivir,416,185,231,44.47
Corki,Seraphine,527,246,281,46.68
Corki,Galio,831,394,437,47.41
Corki,Draven,417,231,186,55.4
Corki,Hwei,497,237,260,47.69
Corki,Qiyana,254,122,132,48.03
Corki,Renekton,402,202,200,50.25
Corki,Jayce,401,213,188,53.12
Corki,KogMaw,255,98,157,38.43
Corki,Zyra,634,297,337,46.85
Corki,Skarner,199,84,115,42.21
Corki,Malphite,652,336,316,51.53
Corki,Leblanc,532,252,280,47.37
Corki,Kindred,394,181,213,45.94
Corki,Alistar,396,174,222,43.94
Corki,Leona,635,316,319,49.76
Corki,JarvanIV,539,259,280,48.05
Corki,Akshan,280,116,164,41.43
Corki,Xayah,423,196,227,46.34
Corki,Gangplank,337,172,165,51.04
Corki,AurelionSol,269,112,157,41.64
Corki,Bard,305,139,166,45.57
Corki,Kled,167,65,102,38.92
Corki,Yone,1262,567,695,44.93
Corki,Kalista,201,87,114,43.28
Corki,Elise,631,314,317,49.76
Corki,Ambessa,525,236,289,44.95
Corki,Orianna,429,199,230,46.39
Corki,Urgot,409,183,226,44.74
Corki,Rakan,385,173,212,44.94
Corki,Graves,456,255,201,55.92
Corki,Anivia,200,72,128,36
Corki,Xerath,526,228,298,43.35
Corki,Talon,444,199,245,44.82
Corki,Karthus,212,87,125,41.04
Corki,Camille,364,199,165,54.67
Corki,Quinn,356,169,187,47.47
Corki,Lissandra,245,114,131,46.53
Corki,Syndra,529,213,316,40.26
Corki,Maokai,337,162,175,48.07
Corki,Sona,196,101,95,51.53
Corki,Shyvana,217,107,110,49.31
Corki,Belveth,219,103,116,47.03
Corki,Olaf,191,102,89,53.4
Corki,MonkeyKing,544,226,318,41.54
Corki,RekSai,113,75,38,66.37
Corki,Rumble,241,128,113,53.11
Bard,Riven,296,157,139,53.04
Bard,Nocturne,644,349,295,54.19
Bard,Zoe,280,131,149,46.79
Bard,Jinx,1548,751,797,48.51
Bard,Lulu,780,432,348,55.38
Bard,Teemo,694,325,369,46.83
Bard,Amumu,637,309,328,48.51
Bard,Garen,942,439,503,46.6
Bard,KogMaw,205,96,109,46.83
Bard,Yuumi,582,256,326,43.99
Bard,Fiora,243,108,135,44.44
Bard,LeeSin,940,537,403,57.13
Bard,Ziggs,230,111,119,48.26
Bard,Senna,522,238,284,45.59
Bard,Tryndamere,338,195,143,57.69
Bard,Sylas,793,422,371,53.22
Bard,Taliyah,200,94,106,47
Bard,Jhin,1166,599,567,51.37
Bard,Volibear,683,343,340,50.22
Bard,Malzahar,546,233,313,42.67
Bard,Caitlyn,1643,745,898,45.34
Bard,Pyke,517,285,232,55.13
Bard,Jayce,340,193,147,56.76
Bard,Skarner,187,99,88,52.94
Bard,Lux,1409,736,673,52.24
Bard,Poppy,434,239,195,55.07
Bard,Malphite,512,261,251,50.98
Bard,Sejuani,292,166,126,56.85
Bard,Heimerdinger,227,107,120,47.14
Bard,Zilean,246,111,135,45.12
Bard,Singed,171,66,105,38.6
Bard,MasterYi,639,278,361,43.51
Bard,Veigar,668,293,375,43.86
Bard,Karma,829,420,409,50.66
Bard,Yasuo,1151,582,569,50.56
Bard,Ekko,595,260,335,43.7
Bard,Hwei,384,228,156,59.38
Bard,Sett,890,448,442,50.34
Bard,Ivern,127,58,69,45.67
Bard,Katarina,472,221,251,46.82
Bard,Xayah,329,157,172,47.72
Bard,Mel,1307,695,612,53.18
Bard,Zed,592,303,289,51.18
Bard,Morgana,640,301,339,47.03
Bard,Akshan,261,143,118,54.79
Bard,Syndra,425,200,225,47.06
Bard,Xerath,555,305,250,54.95
Bard,Warwick,792,332,460,41.92
Bard,Viktor,536,269,267,50.19
Bard,Ashe,1058,528,530,49.91
Bard,Yone,994,529,465,53.22
Bard,Shen,462,221,241,47.84
Bard,Leblanc,335,172,163,51.34
Bard,Twitch,558,296,262,53.05
Bard,Velkoz,363,175,188,48.21
Bard,Kindred,307,125,182,40.72
Bard,Trundle,335,152,183,45.37
Bard,Udyr,276,121,155,43.84
Bard,Samira,476,209,267,43.91
Bard,Rell,290,139,151,47.93
Bard,Aphelios,443,227,216,51.24
Bard,Alistar,229,96,133,41.92
Bard,Nidalee,175,97,78,55.43
Bard,Naafiri,231,102,129,44.16
Bard,Nautilus,638,327,311,51.25
Bard,TahmKench,528,245,283,46.4
Bard,Diana,870,436,434,50.11
Bard,Ezreal,1402,717,685,51.14
Bard,Swain,509,235,274,46.17
Bard,Irelia,474,249,225,52.53
Bard,Orianna,325,170,155,52.31
Bard,Vayne,680,363,317,53.38
Bard,Soraka,404,159,245,39.36
Bard,Ornn,315,158,157,50.16
Bard,TwistedFate,200,102,98,51
Bard,Kaisa,971,535,436,55.1
Bard,Yorick,587,251,336,42.76
Bard,XinZhao,349,146,203,41.83
Bard,Graves,362,205,157,56.63
Bard,Shaco,534,282,252,52.81
Bard,Hecarim,319,165,154,51.72
Bard,Rengar,301,168,133,55.81
Bard,Vladimir,381,168,213,44.09
Bard,Karthus,187,91,96,48.66
Bard,Khazix,259,162,97,62.55
Bard,Qiyana,187,119,68,63.64
Bard,Renekton,356,196,160,55.06
Bard,Aurora,524,265,259,50.57
Bard,MissFortune,1155,602,553,52.12
Bard,Elise,514,249,265,48.44
Bard,Brand,400,199,201,49.75
Bard,Annie,178,99,79,55.62
Bard,Zeri,300,141,159,47
Bard,Mordekaiser,729,373,356,51.17
Bard,Nasus,366,169,197,46.17
Bard,Kayn,833,405,428,48.62
Bard,Gnar,229,119,110,51.97
Bard,Neeko,278,117,161,42.09
Bard,Gragas,407,201,206,49.39
Bard,Ambessa,439,202,237,46.01
Bard,Briar,442,242,200,54.75
Bard,Darius,1173,520,653,44.33
Bard,Milio,401,175,226,43.64
Bard,Sion,513,274,239,53.41
Bard,Nunu,394,178,216,45.18
Bard,Evelynn,244,135,109,55.33
Bard,Varus,511,258,253,50.49
Bard,MonkeyKing,405,184,221,45.43
Bard,Azir,172,97,75,56.4
Bard,Seraphine,477,243,234,50.94
Bard,JarvanIV,396,180,216,45.45
Bard,Zac,305,138,167,45.25
Bard,Ahri,895,495,400,55.31
Bard,Thresh,918,502,416,54.68
Bard,Smolder,425,246,179,57.88
Bard,Janna,289,129,160,44.64
Bard,Kled,95,56,39,58.95
Bard,Illaoi,277,121,156,43.68
Bard,Blitzcrank,376,170,206,45.21
Bard,Chogath,832,456,376,54.81
Bard,Tristana,629,333,296,52.94
Bard,Draven,321,183,138,57.01
Bard,Aatrox,602,279,323,46.35
Bard,Zyra,580,283,297,48.79
Bard,Nami,724,382,342,52.76
Bard,Kassadin,173,83,90,47.98
Bard,Gangplank,311,136,175,43.73
Bard,Pantheon,987,485,502,49.14
Bard,Corki,305,166,139,54.43
Bard,Vex,318,132,186,41.51
Bard,Vi,531,273,258,51.41
Bard,AurelionSol,233,103,130,44.21
Bard,Leona,451,237,214,52.55
Bard,Gwen,396,206,190,52.02
Bard,Rakan,351,178,173,50.71
Bard,DrMundo,370,181,189,48.92
Bard,Urgot,319,135,184,42.32
Bard,Galio,512,239,273,46.68
Bard,Quinn,282,158,124,56.03
Bard,Braum,439,249,190,56.72
Bard,Akali,616,308,308,50
Bard,Lucian,388,205,183,52.84
Bard,Fizz,311,163,148,52.41
Bard,Camille,286,163,123,56.99
Bard,Jax,575,287,288,49.91
Bard,Lillia,373,197,176,52.82
Bard,Viego,877,468,409,53.36
Bard,Kayle,410,210,200,51.22
Bard,FiddleSticks,356,176,180,49.44
Bard,Sona,195,71,124,36.41
Bard,Cassiopeia,192,102,90,53.13
Bard,Talon,359,214,145,59.61
Bard,Maokai,305,126,179,41.31
Bard,Renata,134,78,56,58.21
Bard,Nilah,262,162,100,61.83
Bard,Belveth,123,59,64,47.97
Bard,Rumble,168,88,80,52.38
Bard,Kalista,241,134,107,55.6
Bard,Olaf,151,74,77,49.01
Bard,Rammus,146,61,85,41.78
Bard,Anivia,198,112,86,56.57
Bard,Sivir,322,154,168,47.83
Bard,Lissandra,179,56,123,31.28
Bard,RekSai,68,33,35,48.53
Bard,KSante,300,174,126,58
Bard,Shyvana,150,66,84,44
Bard,Taric,117,64,53,54.7
Bard,Kennen,223,118,105,52.91
Bard,Ryze,210,92,118,43.81
Xerath,Mordekaiser,2103,1050,1053,49.93
Xerath,Vi,1806,939,867,51.99
Xerath,Cassiopeia,623,327,296,52.49
Xerath,Ezreal,4392,2255,2137,51.34
Xerath,Lux,5341,2747,2594,51.43
Xerath,Gwen,792,411,381,51.89
Xerath,Tryndamere,909,406,503,44.66
Xerath,Velkoz,1232,603,629,48.94
Xerath,Zeri,606,322,284,53.14
Xerath,Thresh,2239,1108,1131,49.49
Xerath,Kayn,2492,1247,1245,50.04
Xerath,Diana,2541,1299,1242,51.12
Xerath,Sivir,863,404,459,46.81
Xerath,Soraka,937,424,513,45.25
Xerath,MasterYi,1864,907,957,48.66
Xerath,Shaco,1406,677,729,48.15
Xerath,Azir,696,375,321,53.88
Xerath,Rengar,523,309,214,59.08
Xerath,Pyke,1462,734,728,50.21
Xerath,Malzahar,1745,856,889,49.05
Xerath,Twitch,1271,600,671,47.21
Xerath,Talon,918,494,424,53.81
Xerath,Jhin,3473,1743,1730,50.19
Xerath,Rakan,667,343,324,51.42
Xerath,Singed,476,201,275,42.23
Xerath,Kindred,721,406,315,56.31
Xerath,Yasuo,3039,1449,1590,47.68
Xerath,Ashe,3312,1656,1656,50
Xerath,Alistar,610,315,295,51.64
Xerath,Aatrox,1626,829,797,50.98
Xerath,Warwick,2393,1192,1201,49.81
Xerath,Varus,1590,899,691,56.54
Xerath,Milio,933,439,494,47.05
Xerath,Ornn,703,323,380,45.95
Xerath,Hwei,1346,657,689,48.81
Xerath,Caitlyn,4809,2510,2299,52.19
Xerath,Karma,2250,1136,1114,50.49
Xerath,Nasus,1101,500,601,45.41
Xerath,LeeSin,2798,1469,1329,52.5
Xerath,Ivern,258,153,105,59.3
Xerath,Jinx,4247,2129,2118,50.13
Xerath,Seraphine,1267,639,628,50.43
Xerath,Yone,2982,1577,1405,52.88
Xerath,Udyr,579,294,285,50.78
Xerath,Tristana,1524,714,810,46.85
Xerath,Lulu,1859,962,897,51.75
Xerath,Zac,843,417,426,49.47
Xerath,Swain,1524,746,778,48.95
Xerath,Briar,1237,570,667,46.08
Xerath,Poppy,945,530,415,56.08
Xerath,Ekko,1515,687,828,45.35
Xerath,Kaisa,2511,1291,1220,51.41
Xerath,Rell,760,392,368,51.58
Xerath,Gragas,988,539,449,54.55
Xerath,Xayah,818,409,409,50
Xerath,Fiora,677,339,338,50.07
Xerath,Sylas,2241,1142,1099,50.96
Xerath,Nautilus,1998,1093,905,54.7
Xerath,Riven,680,335,345,49.26
Xerath,Bard,555,250,305,45.05
Xerath,Karthus,458,248,210,54.15
Xerath,KSante,975,537,438,55.08
Xerath,TahmKench,1254,614,640,48.96
Xerath,Sion,1180,629,551,53.31
Xerath,Garen,2382,1182,1200,49.62
Xerath,Teemo,2101,985,1116,46.88
Xerath,Katarina,1255,634,621,50.52
Xerath,Nilah,571,291,280,50.96
Xerath,Fizz,1080,548,532,50.74
Xerath,Gangplank,802,401,401,50
Xerath,Kled,281,136,145,48.4
Xerath,Lillia,894,471,423,52.68
Xerath,Ahri,2190,1141,1049,52.1
Xerath,MissFortune,3745,1986,1759,53.03
Xerath,Neeko,879,504,375,57.34
Xerath,Graves,1149,576,573,50.13
Xerath,Vayne,1952,959,993,49.13
Xerath,Jax,1504,778,726,51.73
Xerath,Amumu,1729,826,903,47.77
Xerath,Heimerdinger,712,348,364,48.88
Xerath,Volibear,2001,954,1047,47.68
Xerath,Morgana,2274,1125,1149,49.47
Xerath,Brand,1262,684,578,54.2
Xerath,Blitzcrank,1432,775,657,54.12
Xerath,Yorick,1512,743,769,49.14
Xerath,Kassadin,331,174,157,52.57
Xerath,Mel,4344,2381,1963,54.81
Xerath,Galio,1415,741,674,52.37
Xerath,Zoe,685,363,322,52.99
Xerath,Darius,2877,1509,1368,52.45
Xerath,FiddleSticks,744,385,359,51.75
Xerath,Senna,1187,611,576,51.47
Xerath,Illaoi,821,418,403,50.91
Xerath,Sona,505,270,235,53.47
Xerath,Irelia,1417,743,674,52.43
Xerath,Orianna,873,501,372,57.39
Xerath,Syndra,1169,647,522,55.35
Xerath,Samira,1259,678,581,53.85
Xerath,Yuumi,1370,670,700,48.91
Xerath,DrMundo,937,444,493,47.39
Xerath,Viktor,1529,802,727,52.45
Xerath,Leona,1343,613,730,45.64
Xerath,Sett,2719,1294,1425,47.59
Xerath,Renekton,844,411,433,48.7
Xerath,Pantheon,2513,1283,1230,51.05
Xerath,Viego,2413,1234,1179,51.14
Xerath,Akali,1767,895,872,50.65
Xerath,Kennen,487,249,238,51.13
Xerath,Kalista,496,266,230,53.63
Xerath,Janna,494,221,273,44.74
Xerath,Akshan,514,251,263,48.83
Xerath,Ziggs,641,274,367,42.75
Xerath,Sejuani,630,299,331,47.46
Xerath,Malphite,1582,822,760,51.96
Xerath,Vex,999,500,499,50.05
Xerath,Gnar,691,357,334,51.66
Xerath,Qiyana,386,229,157,59.33
Xerath,Zilean,474,231,243,48.73
Xerath,XinZhao,1112,523,589,47.03
Xerath,Aphelios,847,446,401,52.66
Xerath,Camille,590,311,279,52.71
Xerath,Naafiri,553,249,304,45.03
Xerath,Zed,1744,869,875,49.83
Xerath,Braum,785,392,393,49.94
Xerath,Zyra,1756,923,833,52.56
Xerath,AurelionSol,598,295,303,49.33
Xerath,Annie,639,303,336,47.42
Xerath,Aurora,1195,648,547,54.23
Xerath,Taliyah,407,231,176,56.76
Xerath,Shen,1029,502,527,48.79
Xerath,Ryze,559,250,309,44.72
Xerath,Urgot,840,381,459,45.36
Xerath,Rammus,470,255,215,54.26
Xerath,Lucian,1136,602,534,52.99
Xerath,Nami,1593,810,783,50.85
Xerath,Nunu,1011,553,458,54.7
Xerath,Kayle,1139,598,541,52.5
Xerath,MonkeyKing,951,473,478,49.74
Xerath,Chogath,1903,947,956,49.76
Xerath,Quinn,617,317,300,51.38
Xerath,Veigar,1885,943,942,50.03
Xerath,Jayce,916,468,448,51.09
Xerath,Smolder,1123,602,521,53.61
Xerath,Maokai,719,388,331,53.96
Xerath,Elise,1308,694,614,53.06
Xerath,Draven,877,465,412,53.02
Xerath,JarvanIV,918,423,495,46.08
Xerath,Vladimir,845,453,392,53.61
Xerath,Shyvana,419,217,202,51.79
Xerath,Nocturne,1987,881,1106,44.34
Xerath,Nidalee,580,337,243,58.1
Xerath,Skarner,491,208,283,42.36
Xerath,Olaf,350,179,171,51.14
Xerath,Ambessa,1039,609,430,58.61
Xerath,KogMaw,448,230,218,51.34
Xerath,Lissandra,518,298,220,57.53
Xerath,Khazix,886,498,388,56.21
Xerath,TwistedFate,628,382,246,60.83
Xerath,Evelynn,594,289,305,48.65
Xerath,Corki,526,298,228,56.65
Xerath,Leblanc,1068,533,535,49.91
Xerath,Trundle,974,507,467,52.05
Xerath,Hecarim,709,385,324,54.3
Xerath,Anivia,555,235,320,42.34
Xerath,Rumble,534,322,212,60.3
Xerath,RekSai,169,95,74,56.21
Xerath,Belveth,434,203,231,46.77
Xerath,Taric,316,148,168,46.84
Xerath,Renata,299,172,127,57.53
Karthus,Fiora,213,108,105,50.7
Karthus,FiddleSticks,314,145,169,46.18
Karthus,Syndra,369,164,205,44.44
Karthus,Vayne,673,308,365,45.77
Karthus,Morgana,629,313,316,49.76
Karthus,Illaoi,231,111,120,48.05
Karthus,Warwick,813,373,440,45.88
Karthus,Aurora,479,237,242,49.48
Karthus,Ezreal,1338,656,682,49.03
Karthus,Neeko,287,167,120,58.19
Karthus,Kled,94,34,60,36.17
Karthus,Ambessa,390,185,205,47.44
Karthus,Diana,969,466,503,48.09
Karthus,Nilah,239,120,119,50.21
Karthus,Leona,426,227,199,53.29
Karthus,Gnar,272,114,158,41.91
Karthus,Kayn,844,375,469,44.43
Karthus,Katarina,423,230,193,54.37
Karthus,Ashe,1086,562,524,51.75
Karthus,Thresh,772,376,396,48.7
Karthus,Yorick,475,187,288,39.37
Karthus,Mordekaiser,697,345,352,49.5
Karthus,Ahri,636,311,325,48.9
Karthus,Jinx,1477,684,793,46.31
Karthus,Amumu,585,276,309,47.18
Karthus,Shaco,675,302,373,44.74
Karthus,MissFortune,1151,523,628,45.44
Karthus,Lux,1384,637,747,46.03
Karthus,Irelia,460,222,238,48.26
Karthus,MonkeyKing,321,153,168,47.66
Karthus,Vex,339,165,174,48.67
Karthus,Caitlyn,1298,615,683,47.38
Karthus,Rell,331,173,158,52.27
Karthus,Nasus,300,117,183,39
Karthus,Xerath,458,210,248,45.85
Karthus,Aatrox,530,232,298,43.77
Karthus,Yone,1005,488,517,48.56
Karthus,Samira,382,161,221,42.15
Karthus,Karma,665,294,371,44.21
Karthus,Nocturne,633,309,324,48.82
Karthus,Ryze,183,92,91,50.27
Karthus,Blitzcrank,437,226,211,51.72
Karthus,Urgot,242,107,135,44.21
Karthus,Ivern,105,51,54,48.57
Karthus,Kassadin,118,47,71,39.83
Karthus,Senna,447,239,208,53.47
Karthus,DrMundo,340,138,202,40.59
Karthus,TwistedFate,223,125,98,56.05
Karthus,Yasuo,1040,531,509,51.06
Karthus,Rammus,167,94,73,56.29
Karthus,Vladimir,363,152,211,41.87
Karthus,Braum,304,160,144,52.63
Karthus,Sett,850,403,447,47.41
Karthus,Darius,1105,549,556,49.68
Karthus,Ekko,460,199,261,43.26
Karthus,Swain,564,274,290,48.58
Karthus,Orianna,220,93,127,42.27
Karthus,Aphelios,361,154,207,42.66
Karthus,Brand,372,195,177,52.42
Karthus,Kaisa,966,577,389,59.73
Karthus,Gragas,337,133,204,39.47
Karthus,Talon,363,194,169,53.44
Karthus,Jhin,1124,585,539,52.05
Karthus,Tristana,538,270,268,50.19
Karthus,Rengar,257,139,118,54.09
Karthus,Briar,416,146,270,35.1
Karthus,Mel,1131,585,546,51.72
Karthus,Teemo,748,376,372,50.27
Karthus,Leblanc,359,159,200,44.29
Karthus,Bard,187,96,91,51.34
Karthus,LeeSin,785,393,392,50.06
Karthus,Renekton,232,105,127,45.26
Karthus,Nautilus,614,310,304,50.49
Karthus,Gwen,274,148,126,54.01
Karthus,MasterYi,668,323,345,48.35
Karthus,Elise,411,221,190,53.77
Karthus,Jax,431,192,239,44.55
Karthus,Viktor,437,226,211,51.72
Karthus,Zyra,580,239,341,41.21
Karthus,Hwei,392,194,198,49.49
Karthus,Viego,689,356,333,51.67
Karthus,Malzahar,544,214,330,39.34
Karthus,Lucian,392,206,186,52.55
Karthus,Veigar,550,267,283,48.55
Karthus,Soraka,385,170,215,44.16
Karthus,Ziggs,176,91,85,51.7
Karthus,Nunu,342,167,175,48.83
Karthus,Sona,193,96,97,49.74
Karthus,Varus,509,298,211,58.55
Karthus,Singed,151,70,81,46.36
Karthus,Garen,881,415,466,47.11
Karthus,Shen,307,151,156,49.19
Karthus,TahmKench,431,195,236,45.24
Karthus,Taliyah,211,94,117,44.55
Karthus,Janna,200,112,88,56
Karthus,Draven,285,126,159,44.21
Karthus,Pantheon,901,463,438,51.39
Karthus,Zed,536,277,259,51.68
Karthus,Smolder,342,161,181,47.08
Karthus,Riven,266,133,133,50
Karthus,Chogath,654,297,357,45.41
Karthus,Renata,77,38,39,49.35
Karthus,Lulu,656,299,357,45.58
Karthus,Annie,199,85,114,42.71
Karthus,Sivir,298,143,155,47.99
Karthus,Udyr,192,82,110,42.71
Karthus,Tryndamere,275,142,133,51.64
Karthus,Seraphine,410,184,226,44.88
Karthus,Trundle,270,111,159,41.11
Karthus,AurelionSol,238,129,109,54.2
Karthus,Vi,504,256,248,50.79
Karthus,Taric,110,66,44,60
Karthus,Malphite,484,212,272,43.8
Karthus,KSante,274,141,133,51.46
Karthus,Azir,227,125,102,55.07
Karthus,Rumble,159,105,54,66.04
Karthus,Anivia,235,93,142,39.57
Karthus,Pyke,439,227,212,51.71
Karthus,Lillia,333,181,152,54.35
Karthus,Nami,536,214,322,39.93
Karthus,Poppy,322,163,159,50.62
Karthus,Alistar,235,133,102,56.6
Karthus,Sejuani,200,108,92,54
Karthus,Camille,205,124,81,60.49
Karthus,Khazix,323,135,188,41.8
Karthus,Sion,407,195,212,47.91
Karthus,Milio,324,134,190,41.36
Karthus,Evelynn,225,130,95,57.78
Karthus,Jayce,304,154,150,50.66
Karthus,Xayah,333,162,171,48.65
Karthus,Rakan,292,131,161,44.86
Karthus,Kayle,382,163,219,42.67
Karthus,Volibear,550,290,260,52.73
Karthus,Akali,628,335,293,53.34
Karthus,Skarner,145,70,75,48.28
Karthus,Kennen,211,114,97,54.03
Karthus,Maokai,282,121,161,42.91
Karthus,Galio,480,217,263,45.21
Karthus,JarvanIV,277,157,120,56.68
Karthus,Naafiri,194,97,97,50
Karthus,Kindred,287,164,123,57.14
Karthus,Fizz,224,135,89,60.27
Karthus,Zeri,272,132,140,48.53
Karthus,Hecarim,247,91,156,36.84
Karthus,Quinn,230,112,118,48.7
Karthus,Yuumi,491,212,279,43.18
Karthus,Gangplank,275,124,151,45.09
Karthus,Twitch,431,176,255,40.84
Karthus,Corki,212,125,87,58.96
Karthus,Zac,284,113,171,39.79
Karthus,Heimerdinger,272,172,100,63.24
Karthus,Lissandra,140,53,87,37.86
Karthus,Nidalee,200,97,103,48.5
Karthus,Olaf,135,67,68,49.63
Karthus,KogMaw,179,78,101,43.58
Karthus,Sylas,709,362,347,51.06
Karthus,Zoe,260,138,122,53.08
Karthus,Velkoz,285,118,167,41.4
Karthus,Akshan,186,108,78,58.06
Karthus,Qiyana,170,84,86,49.41
Karthus,Kalista,131,61,70,46.56
Karthus,Shyvana,113,53,60,46.9
Karthus,XinZhao,323,166,157,51.39
Karthus,RekSai,103,58,45,56.31
Karthus,Belveth,137,66,71,48.18
Karthus,Zilean,221,107,114,48.42
Karthus,Graves,414,236,178,57
Karthus,Cassiopeia,143,64,79,44.76
Karthus,Ornn,197,103,94,52.28
Anivia,Ambessa,412,179,233,43.45
Anivia,Xayah,346,195,151,56.36
Anivia,AurelionSol,302,164,138,54.3
Anivia,Khazix,310,160,150,51.61
Anivia,Nautilus,718,407,311,56.69
Anivia,Malphite,491,255,236,51.93
Anivia,Rengar,216,133,83,61.57
Anivia,Akali,596,321,275,53.86
Anivia,Ashe,1194,614,580,51.42
Anivia,Rakan,303,133,170,43.89
Anivia,Teemo,730,404,326,55.34
Anivia,Gragas,378,192,186,50.79
Anivia,Qiyana,130,80,50,61.54
Anivia,Caitlyn,1595,774,821,48.53
Anivia,Soraka,390,213,177,54.62
Anivia,Yasuo,1204,608,596,50.5
Anivia,Belveth,149,47,102,31.54
Anivia,Yone,956,496,460,51.88
Anivia,Mordekaiser,864,432,432,50
Anivia,Alistar,244,126,118,51.64
Anivia,Sylas,813,405,408,49.82
Anivia,FiddleSticks,283,115,168,40.64
Anivia,Leblanc,352,167,185,47.44
Anivia,Aphelios,345,164,181,47.54
Anivia,Morgana,823,439,384,53.34
Anivia,Nasus,423,227,196,53.66
Anivia,Zed,686,344,342,50.15
Anivia,Malzahar,631,278,353,44.06
Anivia,Ezreal,1284,661,623,51.48
Anivia,Mel,1206,634,572,52.57
Anivia,Garen,958,458,500,47.81
Anivia,LeeSin,891,471,420,52.86
Anivia,Aurora,486,245,241,50.41
Anivia,MissFortune,1384,686,698,49.57
Anivia,Rell,345,196,149,56.81
Anivia,Heimerdinger,306,180,126,58.82
Anivia,Vi,588,277,311,47.11
Anivia,Vladimir,384,193,191,50.26
Anivia,Riven,316,161,155,50.95
Anivia,Katarina,522,306,216,58.62
Anivia,Kaisa,1140,583,557,51.14
Anivia,Kayle,539,263,276,48.79
Anivia,Trundle,375,189,186,50.4
Anivia,Senna,485,251,234,51.75
Anivia,Sett,979,504,475,51.48
Anivia,Warwick,923,463,460,50.16
Anivia,Smolder,414,215,199,51.93
Anivia,Seraphine,569,301,268,52.9
Anivia,Pantheon,920,531,389,57.72
Anivia,Shaco,595,284,311,47.73
Anivia,Jhin,1235,696,539,56.36
Anivia,Ahri,857,412,445,48.07
Anivia,Pyke,554,263,291,47.47
Anivia,Nunu,382,206,176,53.93
Anivia,Thresh,902,432,470,47.89
Anivia,Syndra,565,292,273,51.68
Anivia,Tristana,725,388,337,53.52
Anivia,Zyra,610,306,304,50.16
Anivia,Evelynn,245,119,126,48.57
Anivia,Talon,406,200,206,49.26
Anivia,Irelia,482,241,241,50
Anivia,Yuumi,523,278,245,53.15
Anivia,Zac,294,160,134,54.42
Anivia,Viego,867,414,453,47.75
Anivia,Milio,362,181,181,50
Anivia,Hwei,390,162,228,41.54
Anivia,Volibear,709,406,303,57.26
Anivia,Naafiri,199,95,104,47.74
Anivia,XinZhao,352,167,185,47.44
Anivia,Veigar,667,373,294,55.92
Anivia,Draven,329,168,161,51.06
Anivia,Karma,761,381,380,50.07
Anivia,Orianna,299,177,122,59.2
Anivia,Lux,1487,722,765,48.55
Anivia,Shyvana,193,83,110,43.01
Anivia,Leona,526,274,252,52.09
Anivia,Kennen,194,93,101,47.94
Anivia,Ekko,505,255,250,50.5
Anivia,Varus,522,286,236,54.79
Anivia,Camille,247,140,107,56.68
Anivia,Jinx,1583,780,803,49.27
Anivia,Urgot,340,166,174,48.82
Anivia,Lucian,448,224,224,50
Anivia,Ornn,294,167,127,56.8
Anivia,Kayn,934,481,453,51.5
Anivia,Akshan,269,141,128,52.42
Anivia,Aatrox,556,317,239,57.01
Anivia,Lillia,313,205,108,65.5
Anivia,Galio,535,245,290,45.79
Anivia,Chogath,809,436,373,53.89
Anivia,Yorick,607,301,306,49.59
Anivia,Jax,566,292,274,51.59
Anivia,Janna,268,149,119,55.6
Anivia,TahmKench,508,270,238,53.15
Anivia,Brand,398,210,188,52.76
Anivia,Sion,573,299,274,52.18
Anivia,RekSai,90,48,42,53.33
Anivia,Viktor,580,338,242,58.28
Anivia,KogMaw,222,98,124,44.14
Anivia,Vayne,704,371,333,52.7
Anivia,Ivern,119,53,66,44.54
Anivia,Diana,923,497,426,53.85
Anivia,Lulu,684,329,355,48.1
Anivia,Nocturne,661,327,334,49.47
Anivia,Samira,535,268,267,50.09
Anivia,Elise,462,257,205,55.63
Anivia,Blitzcrank,416,197,219,47.36
Anivia,Darius,1118,594,524,53.13
Anivia,DrMundo,417,225,192,53.96
Anivia,Maokai,307,186,121,60.59
Anivia,Gangplank,324,185,139,57.1
Anivia,Karthus,235,142,93,60.43
Anivia,Jayce,320,166,154,51.88
Anivia,Fiora,190,95,95,50
Anivia,Fizz,380,188,192,49.47
Anivia,Udyr,246,123,123,50
Anivia,Sejuani,276,116,160,42.03
Anivia,Gwen,352,191,161,54.26
Anivia,Nami,705,350,355,49.65
Anivia,Ryze,255,130,125,50.98
Anivia,Taliyah,168,90,78,53.57
Anivia,Kassadin,207,114,93,55.07
Anivia,MasterYi,707,343,364,48.51
Anivia,Sivir,349,159,190,45.56
Anivia,Skarner,176,87,89,49.43
Anivia,Briar,470,229,241,48.72
Anivia,Ziggs,243,125,118,51.44
Anivia,Tryndamere,353,178,175,50.42
Anivia,Kindred,290,122,168,42.07
Anivia,Rammus,199,89,110,44.72
Anivia,Illaoi,265,173,92,65.28
Anivia,Corki,200,128,72,64
Anivia,Lissandra,241,128,113,53.11
Anivia,JarvanIV,343,182,161,53.06
Anivia,Velkoz,457,225,232,49.23
Anivia,Renata,112,55,57,49.11
Anivia,Zilean,165,72,93,43.64
Anivia,Graves,378,234,144,61.9
Anivia,Gnar,333,161,172,48.35
Anivia,Swain,618,318,300,51.46
Anivia,Braum,384,179,205,46.61
Anivia,Vex,302,145,157,48.01
Anivia,Singed,190,109,81,57.37
Anivia,Neeko,311,175,136,56.27
Anivia,KSante,293,134,159,45.73
Anivia,Rumble,162,97,65,59.88
Anivia,Poppy,432,196,236,45.37
Anivia,Twitch,485,225,260,46.39
Anivia,Shen,416,192,224,46.15
Anivia,Xerath,555,320,235,57.66
Anivia,Hecarim,233,128,105,54.94
Anivia,Zeri,268,130,138,48.51
Anivia,Sona,189,101,88,53.44
Anivia,Zoe,271,129,142,47.6
Anivia,Annie,188,108,80,57.45
Anivia,Kalista,182,103,79,56.59
Anivia,Olaf,140,87,53,62.14
Anivia,Amumu,632,303,329,47.94
Anivia,Nilah,201,114,87,56.72
Anivia,Renekton,294,154,140,52.38
Anivia,Kled,94,36,58,38.3
Anivia,Bard,198,86,112,43.43
Anivia,Cassiopeia,271,132,139,48.71
Anivia,TwistedFate,208,102,106,49.04
Anivia,Quinn,171,86,85,50.29
Anivia,MonkeyKing,425,229,196,53.88
Anivia,Azir,181,98,83,54.14
Anivia,Taric,141,85,56,60.28
Anivia,Nidalee,160,104,56,65
KSante,Mordekaiser,1492,709,783,47.52
KSante,Vi,970,484,486,49.9
KSante,Azir,352,171,181,48.58
KSante,MissFortune,1900,860,1040,45.26
KSante,Nautilus,1139,533,606,46.8
KSante,Volibear,944,411,533,43.54
KSante,LeeSin,1837,854,983,46.49
KSante,Kayle,629,281,348,44.67
KSante,Ezreal,2488,1256,1232,50.48
KSante,Morgana,995,459,536,46.13
KSante,Sett,1634,752,882,46.02
KSante,Ambessa,921,463,458,50.27
KSante,Smolder,650,343,307,52.77
KSante,Swain,924,475,449,51.41
KSante,Malphite,771,403,368,52.27
KSante,FiddleSticks,470,191,279,40.64
KSante,Mel,1855,919,936,49.54
KSante,Soraka,528,235,293,44.51
KSante,Heimerdinger,317,134,183,42.27
KSante,Warwick,1099,552,547,50.23
KSante,Ashe,2095,1013,1082,48.35
KSante,Pyke,836,436,400,52.15
KSante,Sion,677,299,378,44.17
KSante,MasterYi,954,460,494,48.22
KSante,AurelionSol,346,175,171,50.58
KSante,Nami,843,365,478,43.3
KSante,Shyvana,226,119,107,52.65
KSante,Fizz,439,224,215,51.03
KSante,Nilah,317,141,176,44.48
KSante,Naafiri,276,109,167,39.49
KSante,Lux,2138,1001,1137,46.82
KSante,Aatrox,1088,509,579,46.78
KSante,Briar,653,302,351,46.25
KSante,Elise,771,382,389,49.55
KSante,Chogath,980,458,522,46.73
KSante,Poppy,764,314,450,41.1
KSante,Irelia,897,440,457,49.05
KSante,Jhin,1814,822,992,45.31
KSante,Leona,798,394,404,49.37
KSante,Aurora,722,368,354,50.97
KSante,Nocturne,1134,513,621,45.24
KSante,Leblanc,653,334,319,51.15
KSante,Janna,375,176,199,46.93
KSante,Akali,1148,521,627,45.38
KSante,Evelynn,339,161,178,47.49
KSante,Ahri,1310,596,714,45.5
KSante,Velkoz,506,222,284,43.87
KSante,Tristana,782,373,409,47.7
KSante,Vayne,1189,469,720,39.44
KSante,Zoe,408,164,244,40.2
KSante,Seraphine,719,310,409,43.12
KSante,Fiora,477,221,256,46.33
KSante,Shaco,955,478,477,50.05
KSante,Nunu,468,259,209,55.34
KSante,Pantheon,1666,780,886,46.82
KSante,Yorick,737,259,478,35.14
KSante,Quinn,265,137,128,51.7
KSante,TahmKench,726,351,375,48.35
KSante,Gwen,643,307,336,47.74
KSante,Khazix,518,223,295,43.05
KSante,Katarina,716,338,378,47.21
KSante,Aphelios,590,273,317,46.27
KSante,Alistar,416,200,216,48.08
KSante,Garen,1704,714,990,41.9
KSante,Diana,1511,728,783,48.18
KSante,Ryze,378,175,203,46.3
KSante,Darius,1852,835,1017,45.09
KSante,Qiyana,228,96,132,42.11
KSante,Ziggs,354,176,178,49.72
KSante,JarvanIV,557,218,339,39.14
KSante,Ekko,845,409,436,48.4
KSante,Jinx,2543,1124,1419,44.2
KSante,Hecarim,456,211,245,46.27
KSante,Vex,455,220,235,48.35
KSante,Veigar,837,354,483,42.29
KSante,Amumu,850,368,482,43.29
KSante,Samira,699,304,395,43.49
KSante,Kayn,1248,529,719,42.39
KSante,Nasus,552,210,342,38.04
KSante,Xerath,975,438,537,44.92
KSante,Thresh,1388,623,765,44.88
KSante,Vladimir,562,236,326,41.99
KSante,Caitlyn,2559,1219,1340,47.64
KSante,Yone,1842,837,1005,45.44
KSante,Lillia,632,241,391,38.13
KSante,Draven,494,232,262,46.96
KSante,Blitzcrank,795,379,416,47.67
KSante,Renekton,582,270,312,46.39
KSante,Lucian,672,310,362,46.13
KSante,Viego,1276,587,689,46
KSante,Viktor,894,375,519,41.95
KSante,Ornn,551,281,270,51
KSante,Sylas,1508,764,744,50.66
KSante,Shen,584,266,318,45.55
KSante,Zed,1024,507,517,49.51
KSante,Brand,536,208,328,38.81
KSante,Kaisa,1638,769,869,46.95
KSante,Riven,417,227,190,54.44
KSante,Rengar,423,245,178,57.92
KSante,Syndra,554,214,340,38.63
KSante,Twitch,676,299,377,44.23
KSante,Kled,186,88,98,47.31
KSante,Gragas,686,326,360,47.52
KSante,Teemo,747,304,443,40.7
KSante,Orianna,379,176,203,46.44
KSante,Rell,603,292,311,48.42
KSante,Singed,218,86,132,39.45
KSante,DrMundo,502,216,286,43.03
KSante,Yasuo,1908,899,1009,47.12
KSante,Xayah,473,221,252,46.72
KSante,Trundle,532,180,352,33.83
KSante,Malzahar,880,393,487,44.66
KSante,Varus,974,492,482,50.51
KSante,Sona,253,111,142,43.87
KSante,Jax,795,378,417,47.55
KSante,Milio,519,232,287,44.7
KSante,Kassadin,220,98,122,44.55
KSante,Zyra,884,449,435,50.79
KSante,Camille,327,176,151,53.82
KSante,KogMaw,302,119,183,39.4
KSante,Yuumi,805,394,411,48.94
KSante,Senna,648,283,365,43.67
KSante,Gnar,501,221,280,44.11
KSante,Akshan,249,103,146,41.37
KSante,Urgot,405,205,200,50.62
KSante,Zac,611,293,318,47.95
KSante,Tryndamere,393,214,179,54.45
KSante,Karma,1247,521,726,41.78
KSante,Rakan,454,238,216,52.42
KSante,Gangplank,386,182,204,47.15
KSante,Corki,423,210,213,49.65
KSante,Sejuani,456,207,249,45.39
KSante,Nidalee,320,131,189,40.94
KSante,Illaoi,375,159,216,42.4
KSante,Udyr,424,242,182,57.08
KSante,Taric,189,80,109,42.33
KSante,MonkeyKing,619,271,348,43.78
KSante,Braum,609,249,360,40.89
KSante,Galio,978,480,498,49.08
KSante,Ivern,176,66,110,37.5
KSante,Sivir,421,160,261,38
KSante,Zeri,513,220,293,42.88
KSante,Lulu,1334,597,737,44.75
KSante,Karthus,274,133,141,48.54
KSante,Annie,300,133,167,44.33
KSante,Taliyah,276,127,149,46.01
KSante,XinZhao,676,331,345,48.96
KSante,Jayce,594,249,345,41.92
KSante,Maokai,478,217,261,45.4
KSante,Rumble,302,170,132,56.29
KSante,Hwei,624,289,335,46.31
KSante,Renata,171,91,80,53.22
KSante,Graves,623,319,304,51.2
KSante,Lissandra,285,139,146,48.77
KSante,Kalista,304,170,134,55.92
KSante,Zilean,301,113,188,37.54
KSante,Belveth,239,116,123,48.54
KSante,TwistedFate,322,143,179,44.41
KSante,Talon,623,284,339,45.59
KSante,Anivia,293,159,134,54.27
KSante,Rammus,259,112,147,43.24
KSante,Olaf,212,99,113,46.7
KSante,Kindred,462,186,276,40.26
KSante,Kennen,200,73,127,36.5
KSante,Neeko,483,265,218,54.87
KSante,RekSai,174,74,100,42.53
KSante,Skarner,330,182,148,55.15
KSante,Bard,300,126,174,42
KSante,Cassiopeia,306,144,162,47.06
Tryndamere,Mordekaiser,1557,797,760,51.19
Tryndamere,Briar,813,397,416,48.83
Tryndamere,Zed,1073,585,488,54.52
Tryndamere,Jinx,2999,1477,1522,49.25
Tryndamere,Lulu,1159,591,568,50.99
Tryndamere,Nasus,850,361,489,42.47
Tryndamere,MonkeyKing,711,355,356,49.93
Tryndamere,Zoe,471,241,230,51.17
Tryndamere,Xayah,543,271,272,49.91
Tryndamere,Zac,372,192,180,51.61
Tryndamere,Jayce,417,199,218,47.72
Tryndamere,Rengar,466,226,240,48.5
Tryndamere,Swain,1052,484,568,46.01
Tryndamere,Ezreal,2140,1076,1064,50.28
Tryndamere,Sona,411,149,262,36.25
Tryndamere,Teemo,1441,670,771,46.5
Tryndamere,LeeSin,1300,763,537,58.69
Tryndamere,Chogath,1413,702,711,49.68
Tryndamere,Lucian,715,414,301,57.9
Tryndamere,Xerath,909,503,406,55.34
Tryndamere,Aatrox,848,399,449,47.05
Tryndamere,Twitch,875,459,416,52.46
Tryndamere,Veigar,1245,654,591,52.53
Tryndamere,Milio,709,335,374,47.25
Tryndamere,Darius,2274,1091,1183,47.98
Tryndamere,Aurora,848,479,369,56.49
Tryndamere,Brand,968,489,479,50.52
Tryndamere,Thresh,1472,774,698,52.58
Tryndamere,FiddleSticks,518,247,271,47.68
Tryndamere,Viktor,825,398,427,48.24
Tryndamere,Pyke,1046,500,546,47.8
Tryndamere,Gnar,421,208,213,49.41
Tryndamere,Jax,1113,558,555,50.13
Tryndamere,Bard,338,143,195,42.31
Tryndamere,Yone,2002,1021,981,51
Tryndamere,Kayn,1795,904,891,50.36
Tryndamere,Smolder,708,374,334,52.82
Tryndamere,Poppy,581,274,307,47.16
Tryndamere,Volibear,1400,655,745,46.79
Tryndamere,Ivern,152,80,72,52.63
Tryndamere,Irelia,875,469,406,53.6
Tryndamere,Caitlyn,2938,1390,1548,47.31
Tryndamere,Renekton,429,214,215,49.88
Tryndamere,Lillia,640,293,347,45.78
Tryndamere,Annie,366,146,220,39.89
Tryndamere,Kaisa,1505,788,717,52.36
Tryndamere,Singed,357,150,207,42.02
Tryndamere,Garen,2181,1121,1060,51.4
Tryndamere,KogMaw,362,184,178,50.83
Tryndamere,Lux,3057,1529,1528,50.02
Tryndamere,RekSai,124,57,67,45.97
Tryndamere,Leona,790,342,448,43.29
Tryndamere,Akshan,404,184,220,45.54
Tryndamere,Aphelios,584,281,303,48.12
Tryndamere,Braum,642,300,342,46.73
Tryndamere,Warwick,1862,808,1054,43.39
Tryndamere,Yasuo,2206,1137,1069,51.54
Tryndamere,Zilean,309,131,178,42.39
Tryndamere,Malphite,1442,673,769,46.67
Tryndamere,Samira,878,477,401,54.33
Tryndamere,Blitzcrank,792,361,431,45.58
Tryndamere,Ekko,952,469,483,49.26
Tryndamere,Zeri,413,201,212,48.67
Tryndamere,Heimerdinger,631,301,330,47.7
Tryndamere,Udyr,477,247,230,51.78
Tryndamere,Akali,1122,543,579,48.4
Tryndamere,MissFortune,2646,1283,1363,48.49
Tryndamere,Gragas,616,279,337,45.29
Tryndamere,Fiora,417,221,196,53
Tryndamere,Shaco,1104,541,563,49
Tryndamere,Ahri,1420,680,740,47.89
Tryndamere,Nami,1036,509,527,49.13
Tryndamere,Jhin,2170,1111,1059,51.2
Tryndamere,Urgot,577,269,308,46.62
Tryndamere,Gwen,583,297,286,50.94
Tryndamere,JarvanIV,563,270,293,47.96
Tryndamere,Hwei,770,358,412,46.49
Tryndamere,Rammus,412,210,202,50.97
Tryndamere,Seraphine,878,457,421,52.05
Tryndamere,Velkoz,698,337,361,48.28
Tryndamere,Vladimir,639,358,281,56.03
Tryndamere,Zyra,841,397,444,47.21
Tryndamere,Corki,464,242,222,52.16
Tryndamere,Ziggs,415,213,202,51.33
Tryndamere,Camille,389,203,186,52.19
Tryndamere,Varus,882,403,479,45.69
Tryndamere,Yorick,1530,713,817,46.6
Tryndamere,Nunu,743,310,433,41.72
Tryndamere,Nidalee,276,144,132,52.17
Tryndamere,MasterYi,1396,708,688,50.72
Tryndamere,Kassadin,254,116,138,45.67
Tryndamere,Tristana,1131,585,546,51.72
Tryndamere,Trundle,730,380,350,52.05
Tryndamere,Rell,513,229,284,44.64
Tryndamere,Malzahar,1093,473,620,43.28
Tryndamere,Morgana,1498,701,797,46.8
Tryndamere,Graves,584,291,293,49.83
Tryndamere,Cassiopeia,370,179,191,48.38
Tryndamere,Ashe,2031,1008,1023,49.63
Tryndamere,Karma,962,494,468,51.35
Tryndamere,Sett,1578,747,831,47.34
Tryndamere,Nocturne,1130,514,616,45.49
Tryndamere,Amumu,1144,520,624,45.45
Tryndamere,Ryze,381,183,198,48.03
Tryndamere,Senna,868,427,441,49.19
Tryndamere,Mel,2279,1134,1145,49.76
Tryndamere,Vi,944,481,463,50.95
Tryndamere,Shen,728,361,367,49.59
Tryndamere,Leblanc,510,245,265,48.04
Tryndamere,TahmKench,994,461,533,46.38
Tryndamere,Vayne,1263,605,658,47.9
Tryndamere,Diana,1585,812,773,51.23
Tryndamere,Qiyana,337,177,160,52.52
Tryndamere,Kindred,560,302,258,53.93
Tryndamere,Ambessa,751,371,380,49.4
Tryndamere,Vex,625,277,348,44.32
Tryndamere,Nautilus,1213,593,620,48.89
Tryndamere,Gangplank,470,235,235,50
Tryndamere,Riven,472,222,250,47.03
Tryndamere,Katarina,815,404,411,49.57
Tryndamere,Orianna,400,214,186,53.5
Tryndamere,Skarner,252,138,114,54.76
Tryndamere,Sylas,1152,574,578,49.83
Tryndamere,Janna,287,182,105,63.41
Tryndamere,KSante,393,179,214,45.55
Tryndamere,Yuumi,905,514,391,56.8
Tryndamere,Sejuani,468,236,232,50.43
Tryndamere,Galio,789,421,368,53.36
Tryndamere,Soraka,656,296,360,45.12
Tryndamere,Karthus,275,133,142,48.36
Tryndamere,Pantheon,1721,839,882,48.75
Tryndamere,Olaf,246,118,128,47.97
Tryndamere,Kayle,803,401,402,49.94
Tryndamere,Draven,566,328,238,57.95
Tryndamere,Fizz,780,422,358,54.1
Tryndamere,Alistar,347,173,174,49.86
Tryndamere,Sion,902,426,476,47.23
Tryndamere,Viego,1571,815,756,51.88
Tryndamere,Naafiri,422,220,202,52.13
Tryndamere,Khazix,526,242,284,46.01
Tryndamere,Talon,620,303,317,48.87
Tryndamere,Belveth,284,144,140,50.7
Tryndamere,Rakan,503,277,226,55.07
Tryndamere,Ornn,439,219,220,49.89
Tryndamere,XinZhao,629,326,303,51.83
Tryndamere,Renata,230,112,118,48.7
Tryndamere,AurelionSol,492,237,255,48.17
Tryndamere,Azir,348,181,167,52.01
Tryndamere,Shyvana,228,89,139,39.04
Tryndamere,Quinn,458,247,211,53.93
Tryndamere,Taliyah,264,135,129,51.14
Tryndamere,Anivia,353,175,178,49.58
Tryndamere,Sivir,543,276,267,50.83
Tryndamere,Evelynn,419,239,180,57.04
Tryndamere,Elise,519,237,282,45.66
Tryndamere,Neeko,609,319,290,52.38
Tryndamere,Syndra,693,360,333,51.95
Tryndamere,Hecarim,439,229,210,52.16
Tryndamere,Nilah,587,237,350,40.37
Tryndamere,TwistedFate,361,189,172,52.35
Tryndamere,Taric,264,130,134,49.24
Tryndamere,Illaoi,557,276,281,49.55
Tryndamere,Maokai,405,235,170,58.02
Tryndamere,Kalista,402,177,225,44.03
Tryndamere,Rumble,155,100,55,64.52
Tryndamere,Kennen,265,144,121,54.34
Tryndamere,DrMundo,637,298,339,46.78
Tryndamere,Kled,210,93,117,44.29
Tryndamere,Lissandra,295,119,176,40.34
Janna,Mordekaiser,708,366,342,51.69
Janna,Briar,508,250,258,49.21
Janna,Zed,719,416,303,57.86
Janna,Jinx,1765,925,840,52.41
Janna,Lillia,361,167,194,46.26
Janna,Aatrox,619,340,279,54.93
Janna,Darius,1204,580,624,48.17
Janna,Aurora,550,286,264,52
Janna,Ezreal,1457,785,672,53.88
Janna,Brand,384,215,169,55.99
Janna,Gwen,414,255,159,61.59
Janna,Nunu,424,192,232,45.28
Janna,Caitlyn,1449,682,767,47.07
Janna,Vladimir,412,211,201,51.21
Janna,Lux,1392,644,748,46.26
Janna,Malphite,531,305,226,57.44
Janna,MonkeyKing,444,200,244,45.05
Janna,Sylas,692,395,297,57.08
Janna,Swain,643,352,291,54.74
Janna,Senna,548,279,269,50.91
Janna,Gangplank,373,212,161,56.84
Janna,Chogath,867,444,423,51.21
Janna,Galio,489,260,229,53.17
Janna,MissFortune,1263,631,632,49.96
Janna,Soraka,374,195,179,52.14
Janna,KSante,375,199,176,53.07
Janna,FiddleSticks,398,182,216,45.73
Janna,Ahri,792,393,399,49.62
Janna,Blitzcrank,488,242,246,49.59
Janna,Gragas,467,266,201,56.96
Janna,Veigar,582,265,317,45.53
Janna,Kalista,211,115,96,54.5
Janna,Zyra,516,259,257,50.19
Janna,Renekton,315,133,182,42.22
Janna,Kayn,1009,557,452,55.2
Janna,Leblanc,387,229,158,59.17
Janna,Mel,1308,694,614,53.06
Janna,Fiora,266,141,125,53.01
Janna,Evelynn,233,144,89,61.8
Janna,Tristana,627,364,263,58.05
Janna,Ambessa,460,255,205,55.43
Janna,Elise,603,306,297,50.75
Janna,Shen,447,219,228,48.99
Janna,Kaisa,1108,595,513,53.7
Janna,MasterYi,691,363,328,52.53
Janna,Ashe,1252,646,606,51.6
Janna,Kennen,267,144,123,53.93
Janna,Shaco,510,259,251,50.78
Janna,Twitch,548,284,264,51.82
Janna,Yuumi,535,313,222,58.5
Janna,Akali,641,364,277,56.79
Janna,Khazix,365,175,190,47.95
Janna,Irelia,535,240,295,44.86
Janna,Yorick,580,265,315,45.69
Janna,Vi,627,351,276,55.98
Janna,Katarina,557,272,285,48.83
Janna,Draven,358,168,190,46.93
Janna,Nautilus,752,367,385,48.8
Janna,Viego,834,366,468,43.88
Janna,Talon,451,254,197,56.32
Janna,Renata,134,58,76,43.28
Janna,Jayce,336,181,155,53.87
Janna,Neeko,353,185,168,52.41
Janna,Teemo,605,270,335,44.63
Janna,Yone,1083,557,526,51.43
Janna,Corki,295,174,121,58.98
Janna,Nasus,435,235,200,54.02
Janna,Rengar,292,154,138,52.74
Janna,Yasuo,1319,690,629,52.31
Janna,TahmKench,581,300,281,51.64
Janna,Warwick,847,421,426,49.7
Janna,Ekko,561,270,291,48.13
Janna,Seraphine,506,257,249,50.79
Janna,Sion,607,342,265,56.34
Janna,Xayah,355,204,151,57.46
Janna,Rakan,315,183,132,58.1
Janna,Nami,903,432,471,47.84
Janna,Jax,552,306,246,55.43
Janna,Amumu,637,298,339,46.78
Janna,LeeSin,856,517,339,60.4
Janna,Nocturne,640,322,318,50.31
Janna,Vayne,828,433,395,52.29
Janna,Milio,498,263,235,52.81
Janna,Kayle,455,199,256,43.74
Janna,Ornn,264,145,119,54.92
Janna,Thresh,987,540,447,54.71
Janna,Qiyana,225,116,109,51.56
Janna,Viktor,609,304,305,49.92
Janna,Xerath,494,273,221,55.26
Janna,Kindred,306,195,111,63.73
Janna,Varus,555,321,234,57.84
Janna,Morgana,670,333,337,49.7
Janna,Samira,527,239,288,45.35
Janna,Rell,529,287,242,54.25
Janna,Leona,637,295,342,46.31
Janna,Zac,389,180,209,46.27
Janna,Pyke,586,312,274,53.24
Janna,Diana,977,492,485,50.36
Janna,Tryndamere,287,105,182,36.59
Janna,Ziggs,255,129,126,50.59
Janna,JarvanIV,403,200,203,49.63
Janna,Karthus,200,88,112,44
Janna,Sett,817,412,405,50.43
Janna,Anivia,268,119,149,44.4
Janna,Karma,815,432,383,53.01
Janna,Garen,1014,504,510,49.7
Janna,Zoe,285,162,123,56.84
Janna,Gnar,322,169,153,52.48
Janna,Jhin,1235,658,577,53.28
Janna,Annie,194,110,84,56.7
Janna,Lucian,500,267,233,53.4
Janna,Udyr,266,164,102,61.65
Janna,Quinn,282,150,132,53.19
Janna,Aphelios,435,238,197,54.71
Janna,Hwei,449,247,202,55.01
Janna,Lulu,999,525,474,52.55
Janna,Orianna,335,187,148,55.82
Janna,Volibear,746,363,383,48.66
Janna,Syndra,460,225,235,48.91
Janna,Naafiri,239,113,126,47.28
Janna,Bard,289,160,129,55.36
Janna,Malzahar,572,284,288,49.65
Janna,Sejuani,245,110,135,44.9
Janna,Zeri,300,144,156,48
Janna,Nidalee,155,89,66,57.42
Janna,Braum,360,174,186,48.33
Janna,Kassadin,144,78,66,54.17
Janna,Trundle,300,172,128,57.33
Janna,Urgot,366,150,216,40.98
Janna,DrMundo,287,120,167,41.81
Janna,Pantheon,1066,522,544,48.97
Janna,Riven,365,207,158,56.71
Janna,Lissandra,244,128,116,52.46
Janna,Sona,268,102,166,38.06
Janna,Olaf,177,103,74,58.19
Janna,Shyvana,186,109,77,58.6
Janna,Poppy,442,226,216,51.13
Janna,Singed,174,96,78,55.17
Janna,Ivern,102,45,57,44.12
Janna,Smolder,429,224,205,52.21
Janna,KogMaw,189,103,86,54.5
Janna,Fizz,333,176,157,52.85
Janna,AurelionSol,255,104,151,40.78
Janna,Graves,339,174,165,51.33
Janna,Sivir,357,168,189,47.06
Janna,Skarner,143,90,53,62.94
Janna,Kled,137,92,45,67.15
Janna,Cassiopeia,188,95,93,50.53
Janna,Zilean,258,133,125,51.55
Janna,Hecarim,292,157,135,53.77
Janna,Taliyah,204,126,78,61.76
Janna,Velkoz,368,175,193,47.55
Janna,Heimerdinger,252,104,148,41.27
Janna,Belveth,172,111,61,64.53
Janna,Alistar,305,146,159,47.87
Janna,Camille,328,171,157,52.13
Janna,Maokai,304,124,180,40.79
Janna,Rammus,214,129,85,60.28
Janna,Ryze,270,147,123,54.44
Janna,Azir,218,114,104,52.29
Janna,XinZhao,382,196,186,51.31
Janna,Vex,323,196,127,60.68
Janna,TwistedFate,204,105,99,51.47
Janna,Illaoi,262,153,109,58.4
Janna,Nilah,264,139,125,52.65
Janna,Taric,149,80,69,53.69
Janna,RekSai,99,47,52,47.47
Janna,Akshan,278,156,122,56.12
Janna,Rumble,153,90,63,58.82
Akshan,Darius,1339,678,661,50.63
Akshan,Samira,605,324,281,53.55
Akshan,Karma,748,321,427,42.91
Akshan,Rammus,232,113,119,48.71
Akshan,Blitzcrank,494,277,217,56.07
Akshan,DrMundo,431,208,223,48.26
Akshan,Ivern,156,87,69,55.77
Akshan,Mordekaiser,885,455,430,51.41
Akshan,Nilah,272,107,165,39.34
Akshan,Yuumi,578,275,303,47.58
Akshan,Teemo,936,482,454,51.5
Akshan,Amumu,710,280,430,39.44
Akshan,Garen,1059,518,541,48.91
Akshan,KogMaw,268,118,150,44.03
Akshan,Heimerdinger,394,208,186,52.79
Akshan,Vi,653,323,330,49.46
Akshan,Ahri,1052,493,559,46.86
Akshan,Maokai,324,163,161,50.31
Akshan,Kennen,176,90,86,51.14
Akshan,XinZhao,379,163,216,43.01
Akshan,Akali,748,461,287,61.63
Akshan,Kaisa,996,511,485,51.31
Akshan,Caitlyn,1822,921,901,50.55
Akshan,Evelynn,250,129,121,51.6
Akshan,Sylas,738,411,327,55.69
Akshan,Ezreal,1363,717,646,52.6
Akshan,Seraphine,600,303,297,50.5
Akshan,Yasuo,1168,568,600,48.63
Akshan,Yone,1260,630,630,50
Akshan,Thresh,911,507,404,55.65
Akshan,Tryndamere,404,220,184,54.46
Akshan,MasterYi,754,402,352,53.32
Akshan,Orianna,324,164,160,50.62
Akshan,Tristana,704,329,375,46.73
Akshan,Lux,1852,882,970,47.62
Akshan,TahmKench,664,368,296,55.42
Akshan,Nocturne,773,388,385,50.19
Akshan,Taric,154,71,83,46.1
Akshan,Sett,995,459,536,46.13
Akshan,Elise,513,229,284,44.64
Akshan,Katarina,527,285,242,54.08
Akshan,MissFortune,1609,828,781,51.46
Akshan,Morgana,902,492,410,54.55
Akshan,Udyr,329,119,210,36.17
Akshan,Lulu,804,407,397,50.62
Akshan,Sejuani,269,154,115,57.25
Akshan,Jinx,1858,954,904,51.35
Akshan,Nautilus,714,337,377,47.2
Akshan,Warwick,1087,503,584,46.27
Akshan,Gangplank,377,178,199,47.21
Akshan,Poppy,447,241,206,53.91
Akshan,Riven,277,137,140,49.46
Akshan,Malzahar,777,378,399,48.65
Akshan,Bard,261,118,143,45.21
Akshan,Nunu,521,260,261,49.9
Akshan,Viktor,589,275,314,46.69
Akshan,Lucian,461,228,233,49.46
Akshan,Malphite,821,392,429,47.75
Akshan,Volibear,829,468,361,56.45
Akshan,Aurora,679,358,321,52.72
Akshan,Kayn,1092,630,462,57.69
Akshan,Smolder,473,273,200,57.72
Akshan,Alistar,235,105,130,44.68
Akshan,Shaco,617,328,289,53.16
Akshan,Mel,1483,786,697,53
Akshan,Milio,407,176,231,43.24
Akshan,Ryze,238,122,116,51.26
Akshan,Twitch,638,355,283,55.64
Akshan,Olaf,157,57,100,36.31
Akshan,Lillia,419,213,206,50.84
Akshan,Viego,1040,546,494,52.5
Akshan,Vladimir,495,218,277,44.04
Akshan,Nami,784,373,411,47.58
Akshan,Rengar,239,115,124,48.12
Akshan,Rell,341,192,149,56.3
Akshan,Jax,633,307,326,48.5
Akshan,Zed,725,382,343,52.69
Akshan,Ashe,1242,638,604,51.37
Akshan,Talon,416,200,216,48.08
Akshan,Shen,460,216,244,46.96
Akshan,Veigar,740,328,412,44.32
Akshan,Singed,180,74,106,41.11
Akshan,Jhin,1387,653,734,47.08
Akshan,Zyra,466,240,226,51.5
Akshan,Hecarim,339,162,177,47.79
Akshan,Syndra,390,193,197,49.49
Akshan,Kindred,284,126,158,44.37
Akshan,Taliyah,210,98,112,46.67
Akshan,Draven,440,219,221,49.77
Akshan,Xerath,514,263,251,51.17
Akshan,Zeri,317,178,139,56.15
Akshan,Pyke,573,307,266,53.58
Akshan,Ziggs,245,127,118,51.84
Akshan,Hwei,504,319,185,63.29
Akshan,Gwen,364,191,173,52.47
Akshan,Gragas,373,202,171,54.16
Akshan,Kalista,204,117,87,57.35
Akshan,Diana,936,453,483,48.4
Akshan,Cassiopeia,231,107,124,46.32
Akshan,Nasus,484,252,232,52.07
Akshan,KSante,249,146,103,58.63
Akshan,Fizz,377,184,193,48.81
Akshan,Graves,417,211,206,50.6
Akshan,Annie,211,80,131,37.91
Akshan,Anivia,269,128,141,47.58
Akshan,FiddleSticks,335,147,188,43.88
Akshan,Xayah,363,150,213,41.32
Akshan,Aatrox,594,311,283,52.36
Akshan,Kayle,556,306,250,55.04
Akshan,Varus,571,268,303,46.94
Akshan,Velkoz,389,219,170,56.3
Akshan,Sion,530,219,311,41.32
Akshan,JarvanIV,383,179,204,46.74
Akshan,Illaoi,324,206,118,63.58
Akshan,Neeko,391,222,169,56.78
Akshan,Swain,724,356,368,49.17
Akshan,Urgot,369,176,193,47.7
Akshan,LeeSin,771,397,374,51.49
Akshan,Renekton,343,165,178,48.1
Akshan,Kassadin,132,68,64,51.52
Akshan,Soraka,429,222,207,51.75
Akshan,Leona,573,287,286,50.09
Akshan,TwistedFate,260,145,115,55.77
Akshan,Vex,408,185,223,45.34
Akshan,Belveth,221,114,107,51.58
Akshan,Ambessa,496,243,253,48.99
Akshan,Vayne,942,446,496,47.35
Akshan,Trundle,449,173,276,38.53
Akshan,Naafiri,300,136,164,45.33
Akshan,Lissandra,203,103,100,50.74
Akshan,Ekko,636,327,309,51.42
Akshan,Corki,280,164,116,58.57
Akshan,Zac,281,154,127,54.8
Akshan,Briar,576,291,285,50.52
Akshan,Senna,603,282,321,46.77
Akshan,Fiora,325,182,143,56
Akshan,Leblanc,339,180,159,53.1
Akshan,Pantheon,1140,562,578,49.3
Akshan,Yorick,757,320,437,42.27
Akshan,Chogath,981,504,477,51.38
Akshan,Rakan,359,169,190,47.08
Akshan,Brand,488,224,264,45.9
Akshan,AurelionSol,283,135,148,47.7
Akshan,Khazix,383,224,159,58.49
Akshan,Irelia,585,271,314,46.32
Akshan,Sivir,346,189,157,54.62
Akshan,Sona,207,118,89,57
Akshan,MonkeyKing,425,209,216,49.18
Akshan,Karthus,186,78,108,41.94
Akshan,RekSai,74,44,30,59.46
Akshan,Rumble,139,51,88,36.69
Akshan,Aphelios,464,250,214,53.88
Akshan,Jayce,323,135,188,41.8
Akshan,Ornn,289,114,175,39.45
Akshan,Galio,458,209,249,45.63
Akshan,Azir,240,129,111,53.75
Akshan,Qiyana,191,110,81,57.59
Akshan,Renata,197,82,115,41.62
Akshan,Zilean,212,106,106,50
Akshan,Quinn,271,161,110,59.41
Akshan,Gnar,262,138,124,52.67
Akshan,Janna,278,122,156,43.88
Akshan,Shyvana,170,99,71,58.24
Akshan,Camille,280,136,144,48.57
Akshan,Skarner,281,163,118,58.01
Akshan,Nidalee,211,119,92,56.4
Akshan,Zoe,370,211,159,57.03
Akshan,Kled,136,72,64,52.94
Akshan,Braum,378,168,210,44.44
Zilean,Chogath,782,406,376,51.92
Zilean,Morgana,744,416,328,55.91
Zilean,Yasuo,1149,546,603,47.52
Zilean,Jhin,1295,645,650,49.81
Zilean,Mel,1256,623,633,49.6
Zilean,Malphite,591,297,294,50.25
Zilean,Sett,811,385,426,47.47
Zilean,Sion,549,264,285,48.09
Zilean,Samira,440,228,212,51.82
Zilean,Alistar,255,146,109,57.25
Zilean,Poppy,363,204,159,56.2
Zilean,Khazix,336,162,174,48.21
Zilean,Irelia,533,266,267,49.91
Zilean,Tristana,519,264,255,50.87
Zilean,Neeko,296,180,116,60.81
Zilean,Jax,556,291,265,52.34
Zilean,Rammus,154,87,67,56.49
Zilean,Lux,1533,739,794,48.21
Zilean,Caitlyn,1600,814,786,50.88
Zilean,Nami,714,356,358,49.86
Zilean,Yone,1078,533,545,49.44
Zilean,Sylas,804,420,384,52.24
Zilean,Viktor,516,250,266,48.45
Zilean,Pyke,495,247,248,49.9
Zilean,Akali,532,278,254,52.26
Zilean,Warwick,763,373,390,48.89
Zilean,Aurora,518,249,269,48.07
Zilean,Xayah,257,135,122,52.53
Zilean,Nautilus,646,380,266,58.82
Zilean,Teemo,830,395,435,47.59
Zilean,Vi,552,285,267,51.63
Zilean,Bard,246,135,111,54.88
Zilean,Fiora,266,125,141,46.99
Zilean,Sejuani,249,105,144,42.17
Zilean,Ashe,1181,515,666,43.61
Zilean,Tryndamere,309,178,131,57.61
Zilean,Nocturne,847,436,411,51.48
Zilean,Seraphine,397,204,193,51.39
Zilean,Mordekaiser,768,337,431,43.88
Zilean,Galio,489,275,214,56.24
Zilean,Kayn,914,461,453,50.44
Zilean,Varus,550,280,270,50.91
Zilean,Blitzcrank,438,256,182,58.45
Zilean,Aatrox,644,336,308,52.17
Zilean,Kindred,301,176,125,58.47
Zilean,Swain,592,301,291,50.84
Zilean,Pantheon,988,488,500,49.39
Zilean,Nilah,206,100,106,48.54
Zilean,Naafiri,220,107,113,48.64
Zilean,Draven,274,147,127,53.65
Zilean,Veigar,621,313,308,50.4
Zilean,Nasus,449,209,240,46.55
Zilean,Fizz,295,136,159,46.1
Zilean,Darius,1134,587,547,51.76
Zilean,MasterYi,665,340,325,51.13
Zilean,Kassadin,127,66,61,51.97
Zilean,Rell,337,178,159,52.82
Zilean,Yorick,540,260,280,48.15
Zilean,Lillia,358,183,175,51.12
Zilean,Trundle,276,142,134,51.45
Zilean,Vayne,682,353,329,51.76
Zilean,Thresh,950,475,475,50
Zilean,Riven,295,137,158,46.44
Zilean,Singed,189,87,102,46.03
Zilean,Kennen,187,132,55,70.59
Zilean,Ekko,578,272,306,47.06
Zilean,Lucian,427,259,168,60.66
Zilean,Ambessa,363,195,168,53.72
Zilean,Qiyana,191,113,78,59.16
Zilean,Aphelios,363,177,186,48.76
Zilean,Velkoz,503,252,251,50.1
Zilean,Renekton,291,130,161,44.67
Zilean,Gwen,274,112,162,40.88
Zilean,Ornn,336,158,178,47.02
Zilean,MissFortune,1259,604,655,47.97
Zilean,Rakan,283,132,151,46.64
Zilean,Ahri,854,445,409,52.11
Zilean,Jinx,1615,827,788,51.21
Zilean,Soraka,359,179,180,49.86
Zilean,Zed,761,411,350,54.01
Zilean,Gangplank,265,137,128,51.7
Zilean,Quinn,224,111,113,49.55
Zilean,Viego,843,387,456,45.91
Zilean,Katarina,428,233,195,54.44
Zilean,Xerath,474,243,231,51.27
Zilean,Graves,402,210,192,52.24
Zilean,Diana,845,404,441,47.81
Zilean,Ezreal,1389,708,681,50.97
Zilean,Ziggs,220,114,106,51.82
Zilean,Malzahar,608,297,311,48.85
Zilean,Renata,130,66,64,50.77
Zilean,DrMundo,329,174,155,52.89
Zilean,Orianna,305,163,142,53.44
Zilean,Skarner,150,48,102,32
Zilean,Yuumi,549,251,298,45.72
Zilean,Lulu,948,466,482,49.16
Zilean,Belveth,157,86,71,54.78
Zilean,Leona,488,253,235,51.84
Zilean,Gragas,379,200,179,52.77
Zilean,Rengar,241,145,96,60.17
Zilean,Illaoi,256,131,125,51.17
Zilean,Kaisa,958,545,413,56.89
Zilean,Corki,293,155,138,52.9
Zilean,JarvanIV,389,179,210,46.02
Zilean,Twitch,550,311,239,56.55
Zilean,Sivir,365,175,190,47.95
Zilean,Ryze,245,118,127,48.16
Zilean,Senna,455,214,241,47.03
Zilean,Heimerdinger,332,186,146,56.02
Zilean,TahmKench,469,223,246,47.55
Zilean,Kled,138,73,65,52.9
Zilean,Evelynn,240,128,112,53.33
Zilean,Azir,221,119,102,53.85
Zilean,Volibear,684,351,333,51.32
Zilean,Shaco,580,323,257,55.69
Zilean,AurelionSol,219,108,111,49.32
Zilean,Smolder,416,229,187,55.05
Zilean,Gnar,270,143,127,52.96
Zilean,MonkeyKing,378,157,221,41.53
Zilean,Milio,365,169,196,46.3
Zilean,Braum,360,202,158,56.11
Zilean,Taric,79,45,34,56.96
Zilean,Sona,254,145,109,57.09
Zilean,Olaf,115,75,40,65.22
Zilean,Ivern,88,62,26,70.45
Zilean,Urgot,332,176,156,53.01
Zilean,Leblanc,280,144,136,51.43
Zilean,Kayle,457,245,212,53.61
Zilean,Syndra,414,232,182,56.04
Zilean,Amumu,636,304,332,47.8
Zilean,LeeSin,711,401,310,56.4
Zilean,Garen,956,484,472,50.63
Zilean,Shyvana,152,100,52,65.79
Zilean,Briar,496,240,256,48.39
Zilean,Elise,402,236,166,58.71
Zilean,Karma,757,376,381,49.67
Zilean,Annie,186,90,96,48.39
Zilean,Zac,314,151,163,48.09
Zilean,KSante,301,188,113,62.46
Zilean,Hwei,439,240,199,54.67
Zilean,Zyra,472,225,247,47.67
Zilean,Hecarim,232,149,83,64.22
Zilean,Talon,377,173,204,45.89
Zilean,Nunu,368,189,179,51.36
Zilean,Vex,288,139,149,48.26
Zilean,Anivia,165,93,72,56.36
Zilean,Shen,418,185,233,44.26
Zilean,TwistedFate,211,116,95,54.98
Zilean,Udyr,257,120,137,46.69
Zilean,Brand,445,228,217,51.24
Zilean,Vladimir,390,200,190,51.28
Zilean,Jayce,358,184,174,51.4
Zilean,Janna,258,125,133,48.45
Zilean,Zoe,295,174,121,58.98
Zilean,KogMaw,204,90,114,44.12
Zilean,Zeri,239,130,109,54.39
Zilean,Rumble,177,108,69,61.02
Zilean,Lissandra,196,108,88,55.1
Zilean,Kalista,214,115,99,53.74
Zilean,Maokai,310,172,138,55.48
Zilean,FiddleSticks,317,162,155,51.1
Zilean,Karthus,221,114,107,51.58
Zilean,Nidalee,190,88,102,46.32
Zilean,Cassiopeia,159,86,73,54.09
Zilean,XinZhao,317,158,159,49.84
Zilean,Akshan,212,106,106,50
Zilean,Taliyah,196,91,105,46.43
Zilean,RekSai,70,30,40,42.86
Zilean,Camille,205,118,87,57.56
Olaf,Chogath,652,318,334,48.77
Olaf,Graves,299,134,165,44.82
Olaf,Leblanc,241,111,130,46.06
Olaf,Caitlyn,1131,555,576,49.07
Olaf,Milio,324,161,163,49.69
Olaf,Trundle,361,181,180,50.14
Olaf,Amumu,488,215,273,44.06
Olaf,Fizz,218,112,106,51.38
Olaf,Kaisa,697,358,339,51.36
Olaf,Pantheon,731,401,330,54.86
Olaf,Gangplank,207,122,85,58.94
Olaf,Warwick,709,355,354,50.07
Olaf,Malzahar,467,233,234,49.89
Olaf,Tristana,436,214,222,49.08
Olaf,Senna,369,140,229,37.94
Olaf,Darius,820,371,449,45.24
Olaf,Nami,415,231,184,55.66
Olaf,Rell,240,116,124,48.33
Olaf,Mordekaiser,983,484,499,49.24
Olaf,Viego,661,281,380,42.51
Olaf,Irelia,253,129,124,50.99
Olaf,Udyr,175,93,82,53.14
Olaf,Aatrox,325,190,135,58.46
Olaf,Kayn,605,293,312,48.43
Olaf,Lux,1174,578,596,49.23
Olaf,Ezreal,1059,543,516,51.27
Olaf,Varus,506,263,243,51.98
Olaf,Briar,351,179,172,51
Olaf,Mel,948,492,456,51.9
Olaf,Jinx,1120,577,543,51.52
Olaf,Blitzcrank,411,207,204,50.36
Olaf,Fiora,114,61,53,53.51
Olaf,Shaco,431,204,227,47.33
Olaf,Nunu,287,131,156,45.64
Olaf,Nilah,195,79,116,40.51
Olaf,Heimerdinger,263,123,140,46.77
Olaf,Evelynn,124,63,61,50.81
Olaf,Zoe,168,96,72,57.14
Olaf,Jax,463,219,244,47.3
Olaf,Yasuo,888,473,415,53.27
Olaf,Rengar,140,85,55,60.71
Olaf,Ivern,76,47,29,61.84
Olaf,Cassiopeia,199,114,85,57.29
Olaf,LeeSin,773,435,338,56.27
Olaf,Katarina,329,166,163,50.46
Olaf,MissFortune,953,417,536,43.76
Olaf,Karma,458,194,264,42.36
Olaf,Yone,850,447,403,52.59
Olaf,Lulu,580,306,274,52.76
Olaf,Singed,125,43,82,34.4
Olaf,MonkeyKing,272,126,146,46.32
Olaf,Diana,571,271,300,47.46
Olaf,Volibear,521,251,270,48.18
Olaf,Talon,254,129,125,50.79
Olaf,Neeko,294,141,153,47.96
Olaf,Vladimir,286,123,163,43.01
Olaf,Akshan,157,100,57,63.69
Olaf,Pyke,417,238,179,57.07
Olaf,Ziggs,170,88,82,51.76
Olaf,Gragas,305,162,143,53.11
Olaf,Yuumi,350,168,182,48
Olaf,Camille,94,58,36,61.7
Olaf,Lillia,326,158,168,48.47
Olaf,Teemo,710,336,374,47.32
Olaf,Renekton,192,80,112,41.67
Olaf,TahmKench,425,204,221,48
Olaf,Kindred,255,133,122,52.16
Olaf,Ashe,925,478,447,51.68
Olaf,Vex,255,145,110,56.86
Olaf,Aphelios,292,141,151,48.29
Olaf,Soraka,245,120,125,48.98
Olaf,Ornn,226,149,77,65.93
Olaf,Draven,280,124,156,44.29
Olaf,Sett,680,304,376,44.71
Olaf,Thresh,617,359,258,58.18
Olaf,MasterYi,477,206,271,43.19
Olaf,Galio,382,190,192,49.74
Olaf,Swain,443,226,217,51.02
Olaf,Lucian,331,169,162,51.06
Olaf,Nasus,325,175,150,53.85
Olaf,Kayle,261,108,153,41.38
Olaf,Akali,482,202,280,41.91
Olaf,Samira,276,149,127,53.99
Olaf,Renata,80,47,33,58.75
Olaf,Sejuani,169,84,85,49.7
Olaf,Ryze,174,80,94,45.98
Olaf,Velkoz,232,109,123,46.98
Olaf,Tryndamere,246,128,118,52.03
Olaf,Nautilus,647,328,319,50.7
Olaf,Nidalee,157,89,68,56.69
Olaf,Zed,443,230,213,51.92
Olaf,Veigar,474,232,242,48.95
Olaf,Vayne,499,248,251,49.7
Olaf,DrMundo,208,110,98,52.88
Olaf,Rammus,145,72,73,49.66
Olaf,Annie,142,60,82,42.25
Olaf,Garen,737,317,420,43.01
Olaf,Ahri,625,317,308,50.72
Olaf,JarvanIV,179,92,87,51.4
Olaf,Viktor,398,213,185,53.52
Olaf,Morgana,626,349,277,55.75
Olaf,Sylas,561,316,245,56.33
Olaf,Jhin,859,440,419,51.22
Olaf,Leona,402,207,195,51.49
Olaf,Vi,479,238,241,49.69
Olaf,Kled,96,40,56,41.67
Olaf,Nocturne,547,257,290,46.98
Olaf,Orianna,244,121,123,49.59
Olaf,AurelionSol,189,94,95,49.74
Olaf,Zyra,446,228,218,51.12
Olaf,Kassadin,65,31,34,47.69
Olaf,Braum,260,108,152,41.54
Olaf,Khazix,205,108,97,52.68
Olaf,Xerath,350,171,179,48.86
Olaf,Sivir,289,125,164,43.25
Olaf,Zilean,115,40,75,34.78
Olaf,TwistedFate,154,81,73,52.6
Olaf,Urgot,211,102,109,48.34
Olaf,Brand,287,126,161,43.9
Olaf,Xayah,250,118,132,47.2
Olaf,Seraphine,343,173,170,50.44
Olaf,Elise,307,155,152,50.49
Olaf,Poppy,328,195,133,59.45
Olaf,Malphite,406,250,156,61.58
Olaf,Taliyah,149,63,86,42.28
Olaf,Smolder,329,179,150,54.41
Olaf,Hwei,328,173,155,52.74
Olaf,Illaoi,271,123,148,45.39
Olaf,Janna,177,74,103,41.81
Olaf,Ekko,439,209,230,47.61
Olaf,Maokai,258,114,144,44.19
Olaf,Belveth,89,48,41,53.93
Olaf,Syndra,294,134,160,45.58
Olaf,Sona,107,38,69,35.51
Olaf,XinZhao,278,127,151,45.68
Olaf,Gwen,218,99,119,45.41
Olaf,Yorick,349,138,211,39.54
Olaf,Shyvana,85,40,45,47.06
Olaf,Lissandra,181,85,96,46.96
Olaf,Karthus,135,68,67,50.37
Olaf,Gnar,225,110,115,48.89
Olaf,Twitch,341,158,183,46.33
Olaf,Jayce,292,143,149,48.97
Olaf,Ambessa,289,140,149,48.44
Olaf,Shen,368,190,178,51.63
Olaf,Kalista,178,99,79,55.62
Olaf,Riven,151,80,71,52.98
Olaf,KSante,212,113,99,53.3
Olaf,Alistar,193,109,84,56.48
Olaf,Aurora,347,199,148,57.35
Olaf,Anivia,140,53,87,37.86
Olaf,Naafiri,133,63,70,47.37
Olaf,Sion,288,141,147,48.96
Olaf,Kennen,118,68,50,57.63
Olaf,Zac,210,111,99,52.86
Olaf,Azir,135,68,67,50.37
Olaf,Hecarim,166,82,84,49.4
Olaf,Quinn,136,55,81,40.44
Olaf,Bard,151,77,74,50.99
Olaf,Skarner,173,87,86,50.29
Olaf,Corki,191,89,102,46.6
Olaf,FiddleSticks,285,159,126,55.79
Olaf,Rakan,231,92,139,39.83
Olaf,Qiyana,150,82,68,54.67
Olaf,Zeri,240,129,111,53.75
Olaf,KogMaw,111,46,65,41.44
Olaf,Taric,89,32,57,35.96
Olaf,Rumble,198,101,97,51.01
Olaf,RekSai,40,22,18,55
Annie,Shen,328,150,178,45.73
Annie,Warwick,936,483,453,51.6
Annie,Diana,956,477,479,49.9
Annie,Samira,492,245,247,49.8
Annie,Soraka,373,197,176,52.82
Annie,Kennen,157,84,73,53.5
Annie,Skarner,219,101,118,46.12
Annie,Malzahar,600,287,313,47.83
Annie,Jinx,1634,788,846,48.23
Annie,Yuumi,590,280,310,47.46
Annie,Tryndamere,366,220,146,60.11
Annie,Lux,1658,812,846,48.97
Annie,Sivir,349,147,202,42.12
Annie,Aatrox,603,285,318,47.26
Annie,Kayn,889,423,466,47.58
Annie,Veigar,711,340,371,47.82
Annie,Jhin,1280,637,643,49.77
Annie,Swain,684,305,379,44.59
Annie,Kled,120,63,57,52.5
Annie,Vi,570,268,302,47.02
Annie,Yasuo,1551,829,722,53.45
Annie,Zeri,314,152,162,48.41
Annie,Neeko,315,171,144,54.29
Annie,TahmKench,548,301,247,54.93
Annie,Gragas,412,225,187,54.61
Annie,Mel,1318,686,632,52.05
Annie,Gangplank,289,137,152,47.4
Annie,Sett,983,414,569,42.12
Annie,Viktor,529,287,242,54.25
Annie,Caitlyn,1558,810,748,51.99
Annie,Lulu,799,400,399,50.06
Annie,Yorick,638,305,333,47.81
Annie,Ekko,517,277,240,53.58
Annie,Yone,1167,576,591,49.36
Annie,Thresh,839,411,428,48.99
Annie,Ivern,124,48,76,38.71
Annie,Katarina,546,245,301,44.87
Annie,Xayah,363,204,159,56.2
Annie,Garen,945,442,503,46.77
Annie,Sion,471,252,219,53.5
Annie,Akali,702,380,322,54.13
Annie,Ezreal,1535,749,786,48.79
Annie,Varus,581,331,250,56.97
Annie,Viego,821,406,415,49.45
Annie,Fiora,255,121,134,47.45
Annie,Irelia,469,226,243,48.19
Annie,MasterYi,748,374,374,50
Annie,MissFortune,1322,655,667,49.55
Annie,Shaco,544,233,311,42.83
Annie,Rengar,218,141,77,64.68
Annie,Zed,732,391,341,53.42
Annie,Ashe,1394,664,730,47.63
Annie,Ambessa,411,199,212,48.42
Annie,Jax,597,296,301,49.58
Annie,Draven,372,187,185,50.27
Annie,Darius,1068,508,560,47.57
Annie,Sylas,722,392,330,54.29
Annie,Nidalee,215,120,95,55.81
Annie,Vex,405,205,200,50.62
Annie,Velkoz,385,170,215,44.16
Annie,Mordekaiser,792,352,440,44.44
Annie,Amumu,687,321,366,46.72
Annie,Kaisa,1041,585,456,56.2
Annie,Pyke,547,300,247,54.84
Annie,Kassadin,120,48,72,40
Annie,Galio,504,221,283,43.85
Annie,Poppy,353,202,151,57.22
Annie,Azir,206,114,92,55.34
Annie,Riven,320,153,167,47.81
Annie,Briar,452,198,254,43.81
Annie,Gnar,284,139,145,48.94
Annie,Teemo,898,437,461,48.66
Annie,Morgana,924,435,489,47.08
Annie,Aphelios,351,174,177,49.57
Annie,Pantheon,957,521,436,54.44
Annie,Braum,358,184,174,51.4
Annie,Cassiopeia,200,106,94,53
Annie,Maokai,247,125,122,50.61
Annie,Kayle,445,235,210,52.81
Annie,LeeSin,1009,537,472,53.22
Annie,Nilah,210,102,108,48.57
Annie,Rell,326,163,163,50
Annie,Renekton,352,185,167,52.56
Annie,RekSai,115,53,62,46.09
Annie,Ziggs,224,101,123,45.09
Annie,Kindred,262,126,136,48.09
Annie,Lillia,380,199,181,52.37
Annie,Fizz,348,128,220,36.78
Annie,Corki,236,118,118,50
Annie,Bard,178,79,99,44.38
Annie,Ornn,305,170,135,55.74
Annie,Belveth,160,85,75,53.13
Annie,Taliyah,219,123,96,56.16
Annie,Camille,205,117,88,57.07
Annie,Gwen,359,161,198,44.85
Annie,Nasus,432,229,203,53.01
Annie,Akshan,211,131,80,62.09
Annie,Aurora,535,289,246,54.02
Annie,Evelynn,206,91,115,44.17
Annie,Malphite,577,320,257,55.46
Annie,Xerath,639,336,303,52.58
Annie,Seraphine,458,229,229,50
Annie,Nautilus,686,329,357,47.96
Annie,Illaoi,264,140,124,53.03
Annie,Nocturne,700,288,412,41.14
Annie,Ryze,175,91,84,52
Annie,Sona,217,129,88,59.45
Annie,Twitch,384,199,185,51.82
Annie,Graves,381,218,163,57.22
Annie,Elise,388,228,160,58.76
Annie,Smolder,399,206,193,51.63
Annie,Karthus,199,114,85,57.29
Annie,Heimerdinger,288,128,160,44.44
Annie,Senna,462,217,245,46.97
Annie,Khazix,333,153,180,45.95
Annie,Qiyana,153,85,68,55.56
Annie,Janna,194,84,110,43.3
Annie,Vladimir,414,234,180,56.52
Annie,Nami,656,316,340,48.17
Annie,Sejuani,298,147,151,49.33
Annie,MonkeyKing,327,181,146,55.35
Annie,Orianna,330,192,138,58.18
Annie,Olaf,142,82,60,57.75
Annie,Lucian,431,244,187,56.61
Annie,Vayne,708,387,321,54.66
Annie,KogMaw,197,111,86,56.35
Annie,Talon,415,205,210,49.4
Annie,Trundle,352,172,180,48.86
Annie,KSante,300,167,133,55.67
Annie,Ahri,986,471,515,47.77
Annie,Blitzcrank,473,254,219,53.7
Annie,Zac,312,125,187,40.06
Annie,Nunu,418,206,212,49.28
Annie,Alistar,298,180,118,60.4
Annie,Singed,166,86,80,51.81
Annie,Rakan,312,145,167,46.47
Annie,Rammus,154,85,69,55.19
Annie,Lissandra,173,87,86,50.29
Annie,Leblanc,386,214,172,55.44
Annie,Hwei,380,218,162,57.37
Annie,Milio,338,127,211,37.57
Annie,Zilean,186,96,90,51.61
Annie,Leona,549,254,295,46.27
Annie,Zyra,607,308,299,50.74
Annie,Syndra,477,214,263,44.86
Annie,Naafiri,248,117,131,47.18
Annie,XinZhao,404,200,204,49.5
Annie,Chogath,791,351,440,44.37
Annie,Tristana,587,273,314,46.51
Annie,Quinn,238,117,121,49.16
Annie,Karma,700,352,348,50.29
Annie,Volibear,668,323,345,48.35
Annie,Shyvana,158,51,107,32.28
Annie,Zoe,229,118,111,51.53
Annie,Urgot,313,174,139,55.59
Annie,Rumble,184,98,86,53.26
Annie,Jayce,298,143,155,47.99
Annie,AurelionSol,253,121,132,47.83
Annie,Anivia,188,80,108,42.55
Annie,Kalista,167,91,76,54.49
Annie,Taric,130,53,77,40.77
Annie,DrMundo,393,165,228,41.98
Annie,TwistedFate,287,129,158,44.95
Annie,Hecarim,266,113,153,42.48
Annie,JarvanIV,395,169,226,42.78
Annie,Udyr,238,131,107,55.04
Annie,Renata,118,81,37,68.64
Annie,Brand,366,186,180,50.82
Annie,FiddleSticks,309,143,166,46.28
Camille,Gwen,344,174,170,50.58
Camille,Kayn,977,490,487,50.15
Camille,Thresh,926,454,472,49.03
Camille,Ezreal,1736,807,929,46.49
Camille,Yuumi,644,324,320,50.31
Camille,Sett,1083,544,539,50.23
Camille,Ryze,268,141,127,52.61
Camille,Caitlyn,1673,801,872,47.88
Camille,Lulu,964,474,490,49.17
Camille,Kalista,257,136,121,52.92
Camille,Gragas,434,240,194,55.3
Camille,Orianna,339,139,200,41
Camille,Gnar,298,162,136,54.36
Camille,Pyke,622,270,352,43.41
Camille,Aatrox,690,331,359,47.97
Camille,Chogath,747,358,389,47.93
Camille,Kaisa,1073,495,578,46.13
Camille,Morgana,713,312,401,43.76
Camille,Garen,1626,839,787,51.6
Camille,Rammus,213,98,115,46.01
Camille,Katarina,497,255,242,51.31
Camille,Milio,460,228,232,49.57
Camille,Shaco,607,315,292,51.89
Camille,Akali,675,345,330,51.11
Camille,Sivir,372,209,163,56.18
Camille,Renata,185,118,67,63.78
Camille,Renekton,404,227,177,56.19
Camille,Hecarim,280,155,125,55.36
Camille,Viktor,681,387,294,56.83
Camille,Jhin,1397,674,723,48.25
Camille,Leblanc,429,253,176,58.97
Camille,LeeSin,1014,505,509,49.8
Camille,TwistedFate,292,139,153,47.6
Camille,Zeri,323,166,157,51.39
Camille,Seraphine,559,286,273,51.16
Camille,Fiora,366,159,207,43.44
Camille,Nunu,440,207,233,47.05
Camille,Zed,774,406,368,52.45
Camille,Aphelios,412,195,217,47.33
Camille,Nami,757,389,368,51.39
Camille,Gangplank,290,102,188,35.17
Camille,Yone,1120,574,546,51.25
Camille,Lux,1677,796,881,47.47
Camille,Shen,512,241,271,47.07
Camille,Illaoi,333,162,171,48.65
Camille,Kindred,331,176,155,53.17
Camille,Talon,547,309,238,56.49
Camille,Varus,664,318,346,47.89
Camille,Mordekaiser,901,392,509,43.51
Camille,Sejuani,309,139,170,44.98
Camille,Yasuo,1252,589,663,47.04
Camille,Velkoz,465,223,242,47.96
Camille,Darius,1184,607,577,51.27
Camille,Warwick,998,455,543,45.59
Camille,Ashe,1386,684,702,49.35
Camille,Nautilus,708,314,394,44.35
Camille,Tryndamere,389,186,203,47.81
Camille,Zac,359,164,195,45.68
Camille,Galio,610,254,356,41.64
Camille,MissFortune,1336,634,702,47.46
Camille,Alistar,289,147,142,50.87
Camille,RekSai,60,21,39,35
Camille,Jax,691,297,394,42.98
Camille,Lucian,490,267,223,54.49
Camille,Riven,366,167,199,45.63
Camille,Khazix,389,176,213,45.24
Camille,Vex,364,171,193,46.98
Camille,Swain,611,233,378,38.13
Camille,Malzahar,581,316,265,54.39
Camille,Kled,111,51,60,45.95
Camille,Vi,664,335,329,50.45
Camille,Ahri,948,489,459,51.58
Camille,Aurora,617,312,305,50.57
Camille,Lissandra,156,73,83,46.79
Camille,Briar,546,246,300,45.05
Camille,Mel,1503,760,743,50.57
Camille,Jinx,1667,771,896,46.25
Camille,Pantheon,1172,547,625,46.67
Camille,Twitch,650,304,346,46.77
Camille,Vladimir,498,201,297,40.36
Camille,Braum,425,214,211,50.35
Camille,Karma,876,396,480,45.21
Camille,Neeko,341,153,188,44.87
Camille,Volibear,801,369,432,46.07
Camille,Olaf,94,36,58,38.3
Camille,Diana,1062,513,549,48.31
Camille,Yorick,512,181,331,35.35
Camille,Brand,433,208,225,48.04
Camille,FiddleSticks,353,171,182,48.44
Camille,Sylas,879,432,447,49.15
Camille,Poppy,436,207,229,47.48
Camille,Viego,833,362,471,43.46
Camille,Ziggs,259,115,144,44.4
Camille,Sona,226,69,157,30.53
Camille,Ekko,592,277,315,46.79
Camille,Vayne,831,402,429,48.38
Camille,TahmKench,574,293,281,51.05
Camille,Urgot,313,94,219,30.03
Camille,JarvanIV,413,176,237,42.62
Camille,Blitzcrank,492,250,242,50.81
Camille,Soraka,429,219,210,51.05
Camille,Shyvana,191,81,110,42.41
Camille,Senna,484,203,281,41.94
Camille,Trundle,276,160,116,57.97
Camille,Qiyana,204,90,114,44.12
Camille,Samira,469,218,251,46.48
Camille,Smolder,431,206,225,47.8
Camille,Tristana,608,311,297,51.15
Camille,Xerath,590,279,311,47.29
Camille,Malphite,522,240,282,45.98
Camille,Anivia,247,107,140,43.32
Camille,KSante,327,151,176,46.18
Camille,Zyra,573,264,309,46.07
Camille,Heimerdinger,220,97,123,44.09
Camille,Kayle,396,187,209,47.22
Camille,Amumu,624,287,337,45.99
Camille,Singed,191,94,97,49.21
Camille,Naafiri,254,92,162,36.22
Camille,MonkeyKing,494,203,291,41.09
Camille,Annie,205,88,117,42.93
Camille,Taliyah,199,92,107,46.23
Camille,Ivern,128,81,47,63.28
Camille,Kassadin,167,79,88,47.31
Camille,Irelia,494,255,239,51.62
Camille,Graves,524,248,276,47.33
Camille,Draven,371,175,196,47.17
Camille,Elise,566,283,283,50
Camille,Hwei,443,207,236,46.73
Camille,Rakan,303,119,184,39.27
Camille,Kennen,215,95,120,44.19
Camille,Maokai,249,124,125,49.8
Camille,Rengar,264,129,135,48.86
Camille,Cassiopeia,203,87,116,42.86
Camille,Belveth,152,73,79,48.03
Camille,KogMaw,201,105,96,52.24
Camille,Nocturne,759,316,443,41.63
Camille,Ambessa,686,375,311,54.66
Camille,MasterYi,729,344,385,47.19
Camille,DrMundo,352,165,187,46.88
Camille,Rumble,120,60,60,50
Camille,Zoe,341,203,138,59.53
Camille,Leona,529,275,254,51.98
Camille,Veigar,600,262,338,43.67
Camille,Rell,392,170,222,43.37
Camille,Ornn,326,145,181,44.48
Camille,Skarner,226,111,115,49.12
Camille,Nidalee,282,166,116,58.87
Camille,Karthus,205,81,124,39.51
Camille,Syndra,510,247,263,48.43
Camille,Teemo,754,328,426,43.5
Camille,Udyr,290,124,166,42.76
Camille,Sion,480,212,268,44.17
Camille,XinZhao,445,189,256,42.47
Camille,Fizz,377,138,239,36.6
Camille,Quinn,260,120,140,46.15
Camille,AurelionSol,278,118,160,42.45
Camille,Xayah,409,158,251,38.63
Camille,Lillia,381,242,139,63.52
Camille,Jayce,442,214,228,48.42
Camille,Evelynn,181,81,100,44.75
Camille,Nilah,281,115,166,40.93
Camille,Bard,286,123,163,43.01
Camille,Corki,364,165,199,45.33
Camille,Nasus,536,234,302,43.66
Camille,Azir,251,122,129,48.61
Camille,Janna,328,157,171,47.87
Camille,Taric,136,62,74,45.59
Camille,Akshan,280,144,136,51.43
Camille,Zilean,205,87,118,42.44
Lissandra,Sylas,794,381,413,47.98
Lissandra,Ekko,628,329,299,52.39
Lissandra,Talon,389,205,184,52.7
Lissandra,Jinx,1699,816,883,48.03
Lissandra,Pyke,501,273,228,54.49
Lissandra,Yone,1144,596,548,52.1
Lissandra,Yasuo,1573,793,780,50.41
Lissandra,Irelia,626,321,305,51.28
Lissandra,Morgana,793,362,431,45.65
Lissandra,Lux,1432,713,719,49.79
Lissandra,Fiora,242,136,106,56.2
Lissandra,Elise,486,272,214,55.97
Lissandra,Garen,878,481,397,54.78
Lissandra,Ashe,1095,576,519,52.6
Lissandra,Senna,396,175,221,44.19
Lissandra,LeeSin,799,406,393,50.81
Lissandra,Hwei,347,132,215,38.04
Lissandra,Aurora,492,250,242,50.81
Lissandra,Yorick,601,276,325,45.92
Lissandra,Kayn,900,477,423,53
Lissandra,Jhin,1277,631,646,49.41
Lissandra,Thresh,894,487,407,54.47
Lissandra,DrMundo,295,161,134,54.58
Lissandra,Zed,1055,610,445,57.82
Lissandra,Caitlyn,1544,751,793,48.64
Lissandra,Lulu,832,447,385,53.73
Lissandra,Poppy,354,195,159,55.08
Lissandra,Kalista,241,113,128,46.89
Lissandra,Neeko,387,212,175,54.78
Lissandra,Kled,139,86,53,61.87
Lissandra,Nocturne,718,331,387,46.1
Lissandra,Malzahar,534,244,290,45.69
Lissandra,Kaisa,985,522,463,52.99
Lissandra,Mel,1267,673,594,53.12
Lissandra,Zac,313,165,148,52.72
Lissandra,Amumu,616,316,300,51.3
Lissandra,Alistar,306,151,155,49.35
Lissandra,Camille,156,83,73,53.21
Lissandra,Karma,689,298,391,43.25
Lissandra,Kennen,186,75,111,40.32
Lissandra,Lucian,435,232,203,53.33
Lissandra,Nami,695,326,369,46.91
Lissandra,Teemo,753,358,395,47.54
Lissandra,Darius,1060,514,546,48.49
Lissandra,Seraphine,490,263,227,53.67
Lissandra,Velkoz,336,150,186,44.64
Lissandra,Shaco,599,318,281,53.09
Lissandra,Quinn,217,76,141,35.02
Lissandra,Briar,518,235,283,45.37
Lissandra,MasterYi,809,425,384,52.53
Lissandra,Milio,384,195,189,50.78
Lissandra,Diana,991,515,476,51.97
Lissandra,Yuumi,539,284,255,52.69
Lissandra,Trundle,421,195,226,46.32
Lissandra,Katarina,536,266,270,49.63
Lissandra,Draven,325,199,126,61.23
Lissandra,Chogath,770,341,429,44.29
Lissandra,Taric,135,76,59,56.3
Lissandra,Ivern,77,40,37,51.95
Lissandra,Rell,363,211,152,58.13
Lissandra,Viego,858,393,465,45.8
Lissandra,Gnar,320,195,125,60.94
Lissandra,Lillia,375,226,149,60.27
Lissandra,Smolder,362,183,179,50.55
Lissandra,TahmKench,530,263,267,49.62
Lissandra,Pantheon,970,513,457,52.89
Lissandra,Volibear,628,322,306,51.27
Lissandra,Tristana,605,307,298,50.74
Lissandra,Twitch,546,301,245,55.13
Lissandra,Ornn,232,98,134,42.24
Lissandra,Ezreal,1532,815,717,53.2
Lissandra,Blitzcrank,405,226,179,55.8
Lissandra,Sett,887,421,466,47.46
Lissandra,Khazix,366,214,152,58.47
Lissandra,Azir,201,87,114,43.28
Lissandra,Shen,438,246,192,56.16
Lissandra,Illaoi,326,150,176,46.01
Lissandra,Belveth,147,82,65,55.78
Lissandra,Xayah,348,172,176,49.43
Lissandra,Rakan,274,149,125,54.38
Lissandra,Sejuani,269,104,165,38.66
Lissandra,Leblanc,515,294,221,57.09
Lissandra,Swain,595,266,329,44.71
Lissandra,Sion,470,224,246,47.66
Lissandra,Aatrox,538,313,225,58.18
Lissandra,Vayne,789,414,375,52.47
Lissandra,Riven,302,150,152,49.67
Lissandra,Vi,540,270,270,50
Lissandra,Akali,751,301,450,40.08
Lissandra,Rumble,147,87,60,59.18
Lissandra,Vladimir,429,230,199,53.61
Lissandra,Ahri,847,417,430,49.23
Lissandra,Renata,133,85,48,63.91
Lissandra,MissFortune,1293,655,638,50.66
Lissandra,Gragas,387,203,184,52.45
Lissandra,Nasus,414,185,229,44.69
Lissandra,TwistedFate,240,141,99,58.75
Lissandra,Malphite,631,314,317,49.76
Lissandra,Gangplank,262,122,140,46.56
Lissandra,Braum,449,222,227,49.44
Lissandra,Varus,519,287,232,55.3
Lissandra,XinZhao,328,168,160,51.22
Lissandra,Gwen,333,158,175,47.45
Lissandra,Nunu,408,219,189,53.68
Lissandra,Mordekaiser,777,418,359,53.8
Lissandra,Viktor,529,264,265,49.91
Lissandra,Taliyah,159,82,77,51.57
Lissandra,Galio,506,269,237,53.16
Lissandra,Nautilus,691,373,318,53.98
Lissandra,Soraka,334,169,165,50.6
Lissandra,Zoe,227,142,85,62.56
Lissandra,Nilah,259,131,128,50.58
Lissandra,Ziggs,264,128,136,48.48
Lissandra,Cassiopeia,214,117,97,54.67
Lissandra,Leona,555,307,248,55.32
Lissandra,Syndra,351,206,145,58.69
Lissandra,FiddleSticks,274,172,102,62.77
Lissandra,Akshan,203,100,103,49.26
Lissandra,Qiyana,195,126,69,64.62
Lissandra,Rengar,270,151,119,55.93
Lissandra,Zyra,552,249,303,45.11
Lissandra,Renekton,343,186,157,54.23
Lissandra,Brand,395,204,191,51.65
Lissandra,Sivir,280,143,137,51.07
Lissandra,Nidalee,213,130,83,61.03
Lissandra,Kayle,432,204,228,47.22
Lissandra,Naafiri,245,131,114,53.47
Lissandra,Xerath,518,220,298,42.47
Lissandra,Graves,413,207,206,50.12
Lissandra,Zeri,231,138,93,59.74
Lissandra,Janna,244,116,128,47.54
Lissandra,Jayce,246,146,100,59.35
Lissandra,Aphelios,385,224,161,58.18
Lissandra,Annie,173,86,87,49.71
Lissandra,Warwick,926,422,504,45.57
Lissandra,Udyr,181,87,94,48.07
Lissandra,MonkeyKing,515,254,261,49.32
Lissandra,Samira,446,222,224,49.78
Lissandra,Rammus,229,117,112,51.09
Lissandra,KSante,285,146,139,51.23
Lissandra,AurelionSol,246,133,113,54.07
Lissandra,Shyvana,155,81,74,52.26
Lissandra,Ambessa,380,210,170,55.26
Lissandra,Maokai,260,119,141,45.77
Lissandra,Veigar,534,259,275,48.5
Lissandra,Urgot,319,150,169,47.02
Lissandra,JarvanIV,341,170,171,49.85
Lissandra,Anivia,241,113,128,46.89
Lissandra,Jax,497,242,255,48.69
Lissandra,Vex,260,105,155,40.38
Lissandra,Evelynn,257,134,123,52.14
Lissandra,Heimerdinger,278,138,140,49.64
Lissandra,Olaf,181,96,85,53.04
Lissandra,Karthus,140,87,53,62.14
Lissandra,Orianna,261,141,120,54.02
Lissandra,Corki,245,131,114,53.47
Lissandra,Zilean,196,88,108,44.9
Lissandra,Fizz,419,262,157,62.53
Lissandra,Ryze,177,100,77,56.5
Lissandra,Hecarim,234,133,101,56.84
Lissandra,RekSai,115,51,64,44.35
Lissandra,Singed,146,79,67,54.11
Lissandra,Sona,127,70,57,55.12
Lissandra,KogMaw,187,95,92,50.8
Lissandra,Bard,179,123,56,68.72
Lissandra,Kindred,245,112,133,45.71
Lissandra,Tryndamere,295,176,119,59.66
Lissandra,Skarner,156,86,70,55.13
Lissandra,Kassadin,149,62,87,41.61
Elise,Ryze,499,227,272,45.49
Elise,Nunu,770,360,410,46.75
Elise,Ahri,1742,862,880,49.48
Elise,Lucian,998,522,476,52.3
Elise,Alistar,550,238,312,43.27
Elise,Yorick,1050,457,593,43.52
Elise,Volibear,1236,613,623,49.6
Elise,Veigar,1273,619,654,48.63
Elise,Caitlyn,3453,1787,1666,51.75
Elise,Sona,434,172,262,39.63
Elise,Ornn,602,285,317,47.34
Elise,Warwick,1586,697,889,43.95
Elise,TwistedFate,469,250,219,53.3
Elise,Morgana,1422,642,780,45.15
Elise,Gwen,698,304,394,43.55
Elise,Pantheon,2296,1208,1088,52.61
Elise,Mel,2527,1282,1245,50.73
Elise,Tristana,1188,568,620,47.81
Elise,Poppy,819,419,400,51.16
Elise,KSante,771,389,382,50.45
Elise,Jax,1277,644,633,50.43
Elise,Velkoz,795,350,445,44.03
Elise,Xayah,755,414,341,54.83
Elise,Rakan,784,400,384,51.02
Elise,Sett,2003,940,1063,46.93
Elise,Talon,1007,529,478,52.53
Elise,Lissandra,486,214,272,44.03
Elise,Vayne,1634,812,822,49.69
Elise,Milio,848,381,467,44.93
Elise,Aurora,1116,480,636,43.01
Elise,Nocturne,1701,802,899,47.15
Elise,Nilah,534,235,299,44.01
Elise,Soraka,792,397,395,50.13
Elise,Ambessa,941,519,422,55.15
Elise,Sejuani,631,295,336,46.75
Elise,Karma,1705,787,918,46.16
Elise,Nidalee,485,230,255,47.42
Elise,Vex,656,321,335,48.93
Elise,Sivir,712,376,336,52.81
Elise,TahmKench,1107,505,602,45.62
Elise,Gragas,922,447,475,48.48
Elise,Samira,848,416,432,49.06
Elise,Malphite,1192,596,596,50
Elise,Viktor,1299,705,594,54.27
Elise,Blitzcrank,1020,524,496,51.37
Elise,Rumble,413,216,197,52.3
Elise,Akshan,513,284,229,55.36
Elise,Ezreal,3627,1892,1735,52.16
Elise,Aatrox,1282,650,632,50.7
Elise,Chogath,1777,839,938,47.21
Elise,Janna,603,297,306,49.25
Elise,Kayn,1948,929,1019,47.69
Elise,Graves,817,383,434,46.88
Elise,Malzahar,1078,474,604,43.97
Elise,Ivern,248,125,123,50.4
Elise,FiddleSticks,694,366,328,52.74
Elise,Azir,503,256,247,50.89
Elise,Viego,2075,1017,1058,49.01
Elise,Aphelios,723,324,399,44.81
Elise,Diana,2001,923,1078,46.13
Elise,Ashe,2627,1246,1381,47.43
Elise,Urgot,617,281,336,45.54
Elise,MasterYi,1419,724,695,51.02
Elise,Seraphine,1002,480,522,47.9
Elise,Garen,2013,856,1157,42.52
Elise,JarvanIV,810,394,416,48.64
Elise,Hwei,1020,555,465,54.41
Elise,Twitch,1026,501,525,48.83
Elise,Lulu,1811,925,886,51.08
Elise,Amumu,1228,542,686,44.14
Elise,Zed,1547,774,773,50.03
Elise,Ziggs,491,207,284,42.16
Elise,Rengar,588,315,273,53.57
Elise,Yasuo,2472,1178,1294,47.65
Elise,Nautilus,1461,748,713,51.2
Elise,MissFortune,2774,1206,1568,43.48
Elise,Pyke,1308,711,597,54.36
Elise,Renekton,832,428,404,51.44
Elise,Zeri,538,277,261,51.49
Elise,Shen,892,410,482,45.96
Elise,LeeSin,2507,1251,1256,49.9
Elise,Zac,753,377,376,50.07
Elise,Teemo,1503,667,836,44.38
Elise,AurelionSol,545,250,295,45.87
Elise,Fiora,578,259,319,44.81
Elise,Mordekaiser,1457,713,744,48.94
Elise,Briar,916,432,484,47.16
Elise,Rell,744,342,402,45.97
Elise,Kaisa,2349,1214,1135,51.68
Elise,Jinx,3347,1588,1759,47.45
Elise,XinZhao,938,439,499,46.8
Elise,Yuumi,1108,584,524,52.71
Elise,Lillia,722,384,338,53.19
Elise,Draven,630,325,305,51.59
Elise,Thresh,1899,942,957,49.61
Elise,Naafiri,437,205,232,46.91
Elise,Kindred,637,302,335,47.41
Elise,Irelia,1173,570,603,48.59
Elise,Shaco,1366,672,694,49.19
Elise,Lux,3169,1562,1607,49.29
Elise,Swain,1155,591,564,51.17
Elise,Renata,241,125,116,51.87
Elise,Singed,353,180,173,50.99
Elise,Cassiopeia,450,249,201,55.33
Elise,Vladimir,938,471,467,50.21
Elise,Belveth,346,185,161,53.47
Elise,Katarina,1078,582,496,53.99
Elise,Brand,907,503,404,55.46
Elise,Nasus,792,421,371,53.16
Elise,Vi,1258,636,622,50.56
Elise,Yone,2463,1174,1289,47.67
Elise,Darius,2333,1165,1168,49.94
Elise,Jhin,2621,1176,1445,44.87
Elise,Zyra,1158,519,639,44.82
Elise,Bard,514,265,249,51.56
Elise,Karthus,411,190,221,46.23
Elise,Nami,1447,665,782,45.96
Elise,Leblanc,847,466,381,55.02
Elise,Zoe,674,355,319,52.67
Elise,Ekko,1399,688,711,49.18
Elise,Kassadin,322,143,179,44.41
Elise,Sylas,1864,922,942,49.46
Elise,Smolder,844,434,410,51.42
Elise,Gangplank,702,353,349,50.28
Elise,Neeko,747,377,370,50.47
Elise,Braum,839,364,475,43.38
Elise,Quinn,466,204,262,43.78
Elise,Orianna,673,347,326,51.56
Elise,Leona,1038,551,487,53.08
Elise,Trundle,621,299,322,48.15
Elise,Skarner,427,251,176,58.78
Elise,Senna,1082,551,531,50.92
Elise,Sion,1075,469,606,43.63
Elise,MonkeyKing,809,415,394,51.3
Elise,Camille,566,283,283,50
Elise,Annie,388,160,228,41.24
Elise,Galio,1256,546,710,43.47
Elise,Varus,1287,639,648,49.65
Elise,Heimerdinger,552,267,285,48.37
Elise,Kled,301,123,178,40.86
Elise,Kayle,791,420,371,53.1
Elise,Illaoi,628,322,306,51.27
Elise,Gnar,634,371,263,58.52
Elise,Riven,679,342,337,50.37
Elise,Anivia,462,205,257,44.37
Elise,Rammus,330,151,179,45.76
Elise,Xerath,1308,614,694,46.94
Elise,Hecarim,583,296,287,50.77
Elise,Fizz,740,367,373,49.59
Elise,Syndra,924,465,459,50.32
Elise,Akali,1360,701,659,51.54
Elise,Taric,312,130,182,41.67
Elise,Kalista,482,283,199,58.71
Elise,DrMundo,725,334,391,46.07
Elise,Olaf,307,149,158,48.53
Elise,Taliyah,345,183,162,53.04
Elise,Jayce,757,365,392,48.22
Elise,Zilean,402,166,236,41.29
Elise,Corki,631,317,314,50.24
Elise,Maokai,699,302,397,43.2
Elise,Shyvana,328,143,185,43.6
Elise,Tryndamere,519,282,237,54.34
Elise,Udyr,527,267,260,50.66
Elise,Qiyana,436,225,211,51.61
Elise,Khazix,756,372,384,49.21
Elise,Kennen,532,309,223,58.08
Elise,RekSai,201,83,118,41.29
Elise,KogMaw,417,214,203,51.32
Elise,Evelynn,597,252,345,42.21
Jayce,Tryndamere,417,218,199,52.28
Jayce,Gragas,637,282,355,44.27
Jayce,Irelia,960,474,486,49.38
Jayce,Kalista,352,162,190,46.02
Jayce,Twitch,553,270,283,48.82
Jayce,DrMundo,525,217,308,41.33
Jayce,Shaco,847,417,430,49.23
Jayce,Leblanc,635,335,300,52.76
Jayce,Xayah,478,217,261,45.4
Jayce,Karma,1330,664,666,49.92
Jayce,Akali,985,501,484,50.86
Jayce,Naafiri,270,116,154,42.96
Jayce,Kayle,491,233,258,47.45
Jayce,MissFortune,1663,762,901,45.82
Jayce,Smolder,590,300,290,50.85
Jayce,Trundle,448,219,229,48.88
Jayce,Ahri,1312,622,690,47.41
Jayce,Ashe,2065,997,1068,48.28
Jayce,Nami,792,364,428,45.96
Jayce,TahmKench,666,314,352,47.15
Jayce,Jax,845,422,423,49.94
Jayce,Malzahar,768,338,430,44.01
Jayce,Jinx,2634,1298,1336,49.28
Jayce,Mordekaiser,941,427,514,45.38
Jayce,Sett,1225,602,623,49.14
Jayce,LeeSin,2012,1003,1009,49.85
Jayce,Nasus,549,211,338,38.43
Jayce,Kaisa,1477,717,760,48.54
Jayce,Bard,340,147,193,43.24
Jayce,Gangplank,565,266,299,47.08
Jayce,Rengar,301,150,151,49.83
Jayce,Yasuo,1761,770,991,43.73
Jayce,Kennen,357,153,204,42.86
Jayce,Aatrox,1071,483,588,45.1
Jayce,Diana,1479,681,798,46.04
Jayce,Mel,1852,915,937,49.41
Jayce,Rell,451,221,230,49
Jayce,Amumu,794,369,425,46.47
Jayce,Senna,746,380,366,50.94
Jayce,Yone,1902,1027,875,54
Jayce,Viego,1373,612,761,44.57
Jayce,Ezreal,2831,1483,1348,52.38
Jayce,Blitzcrank,759,405,354,53.36
Jayce,Morgana,954,430,524,45.07
Jayce,Vi,1077,596,481,55.34
Jayce,Yuumi,795,355,440,44.65
Jayce,Yorick,876,389,487,44.41
Jayce,Khazix,468,241,227,51.5
Jayce,Aurora,904,473,431,52.32
Jayce,Garen,1216,479,737,39.39
Jayce,Varus,998,522,476,52.3
Jayce,Swain,815,395,420,48.47
Jayce,Darius,1590,793,797,49.87
Jayce,Kayn,1094,525,569,47.99
Jayce,Janna,336,155,181,46.13
Jayce,Talon,675,318,357,47.11
Jayce,Caitlyn,2331,1037,1294,44.49
Jayce,Lillia,539,286,253,53.06
Jayce,Briar,606,273,333,45.05
Jayce,Veigar,737,357,380,48.44
Jayce,Viktor,893,425,468,47.59
Jayce,Kindred,447,212,235,47.43
Jayce,Katarina,713,373,340,52.31
Jayce,Aphelios,527,261,266,49.53
Jayce,Brand,520,243,277,46.73
Jayce,Renekton,451,221,230,49
Jayce,Warwick,1056,521,535,49.34
Jayce,Gwen,349,163,186,46.7
Jayce,Tristana,725,359,366,49.52
Jayce,Illaoi,376,213,163,56.65
Jayce,Rammus,217,95,122,43.78
Jayce,Kled,144,81,63,56.25
Jayce,Alistar,404,211,193,52.23
Jayce,Pantheon,1444,672,772,46.54
Jayce,MasterYi,967,471,496,48.71
Jayce,Ryze,328,142,186,43.29
Jayce,Pyke,855,429,426,50.18
Jayce,Galio,822,334,488,40.63
Jayce,Singed,274,126,148,45.99
Jayce,Lux,1901,889,1012,46.76
Jayce,AurelionSol,411,183,228,44.53
Jayce,Neeko,488,205,283,42.01
Jayce,Braum,582,312,270,53.61
Jayce,Nocturne,963,427,536,44.34
Jayce,Hwei,570,252,318,44.21
Jayce,Draven,439,183,256,41.69
Jayce,Graves,791,443,348,56.01
Jayce,Samira,643,316,327,49.14
Jayce,Thresh,1451,712,739,49.07
Jayce,Seraphine,671,306,365,45.6
Jayce,TwistedFate,381,196,185,51.44
Jayce,Vayne,979,445,534,45.45
Jayce,KogMaw,257,124,133,48.25
Jayce,Nunu,484,211,273,43.6
Jayce,Gnar,489,227,262,46.42
Jayce,Syndra,568,283,285,49.82
Jayce,Sejuani,411,171,240,41.61
Jayce,Chogath,1008,457,551,45.34
Jayce,Zed,1019,501,518,49.17
Jayce,Zac,461,222,239,48.16
Jayce,Xerath,916,448,468,48.91
Jayce,Lucian,697,334,363,47.92
Jayce,Lulu,1372,748,624,54.52
Jayce,Ambessa,812,374,438,46.06
Jayce,Udyr,323,136,187,42.11
Jayce,Corki,401,188,213,46.88
Jayce,Poppy,628,293,335,46.66
Jayce,Ziggs,317,145,172,45.74
Jayce,Milio,473,185,288,39.11
Jayce,Orianna,550,302,248,54.91
Jayce,Ivern,180,78,102,43.33
Jayce,Shen,469,239,230,50.96
Jayce,Hecarim,382,226,156,59.16
Jayce,Ekko,717,356,361,49.65
Jayce,KSante,594,345,249,58.08
Jayce,Teemo,1179,532,647,45.12
Jayce,Skarner,247,170,77,68.83
Jayce,Cassiopeia,308,182,126,59.09
Jayce,Soraka,544,300,244,55.15
Jayce,Belveth,192,82,110,42.71
Jayce,Anivia,320,154,166,48.13
Jayce,Velkoz,508,230,278,45.28
Jayce,Nilah,317,124,193,39.12
Jayce,Sona,274,104,170,37.96
Jayce,Fiora,351,184,167,52.42
Jayce,Vladimir,642,327,315,50.93
Jayce,Nautilus,1062,516,546,48.59
Jayce,Taliyah,309,139,170,44.98
Jayce,Karthus,304,150,154,49.34
Jayce,Rakan,503,272,231,54.08
Jayce,Lissandra,246,100,146,40.65
Jayce,Azir,425,188,237,44.24
Jayce,Elise,757,392,365,51.78
Jayce,Quinn,382,158,224,41.36
Jayce,Malphite,953,452,501,47.43
Jayce,Heimerdinger,485,192,293,39.59
Jayce,XinZhao,639,304,335,47.57
Jayce,Rumble,386,203,183,52.59
Jayce,Shyvana,170,92,78,54.12
Jayce,Riven,439,229,210,52.16
Jayce,Fizz,473,229,244,48.41
Jayce,Maokai,416,154,262,37.02
Jayce,Volibear,822,416,406,50.61
Jayce,Camille,442,228,214,51.58
Jayce,Jhin,1934,972,962,50.26
Jayce,Qiyana,316,172,144,54.43
Jayce,MonkeyKing,638,321,317,50.31
Jayce,Renata,162,83,79,51.23
Jayce,Zeri,494,267,227,54.05
Jayce,Zilean,358,174,184,48.6
Jayce,Sion,616,286,330,46.43
Jayce,Olaf,292,149,143,51.03
Jayce,Leona,699,338,361,48.35
Jayce,Sylas,1397,751,646,53.76
Jayce,Sivir,500,259,241,51.8
Jayce,Annie,298,155,143,52.01
Jayce,Zyra,945,387,558,40.95
Jayce,Kassadin,194,114,80,58.76
Jayce,Urgot,349,148,201,42.41
Jayce,Evelynn,301,155,146,51.5
Jayce,Akshan,323,188,135,58.2
Jayce,Zoe,396,166,230,41.92
Jayce,JarvanIV,551,246,305,44.65
Jayce,FiddleSticks,499,264,235,52.91
Jayce,Ornn,327,142,185,43.43
Jayce,Vex,478,202,276,42.26
Jayce,Taric,180,75,105,41.67
Jayce,Nidalee,371,187,184,50.4
Jayce,RekSai,122,79,43,64.75
Sion,Teemo,2300,1193,1107,51.87
Sion,Amumu,1682,745,937,44.29
Sion,Garen,2272,1060,1212,46.65
Sion,KogMaw,547,247,300,45.16
Sion,Yuumi,1196,581,615,48.58
Sion,Fiora,691,354,337,51.23
Sion,Kayn,2221,1068,1153,48.09
Sion,Malzahar,1639,812,827,49.54
Sion,Aphelios,1048,585,463,55.82
Sion,Zilean,549,285,264,51.91
Sion,KSante,677,378,299,55.83
Sion,Udyr,704,340,364,48.3
Sion,Veigar,1591,725,866,45.57
Sion,Ashe,2782,1525,1257,54.82
Sion,Nautilus,1686,889,797,52.73
Sion,Yasuo,2693,1429,1264,53.06
Sion,Belveth,382,176,206,46.07
Sion,Yone,2864,1427,1437,49.83
Sion,Mordekaiser,1907,956,951,50.13
Sion,Alistar,657,328,329,49.92
Sion,Poppy,869,456,413,52.47
Sion,Khazix,810,473,337,58.4
Sion,Irelia,1224,616,608,50.33
Sion,Tristana,1455,735,720,50.52
Sion,Neeko,814,459,355,56.39
Sion,Gnar,638,341,297,53.45
Sion,Volibear,1674,806,868,48.15
Sion,Mel,3161,1704,1457,53.91
Sion,Samira,1125,637,488,56.62
Sion,Seraphine,1233,708,525,57.42
Sion,Nasus,1130,548,582,48.5
Sion,Pantheon,2380,1286,1094,54.03
Sion,Zoe,627,360,267,57.42
Sion,Senna,1222,650,572,53.19
Sion,TahmKench,1304,659,645,50.54
Sion,Jax,1192,587,605,49.24
Sion,Jinx,3836,1899,1937,49.5
Sion,Akali,1532,799,733,52.15
Sion,Zac,788,366,422,46.45
Sion,Diana,2203,1101,1102,49.98
Sion,Vayne,2039,966,1073,47.38
Sion,Caitlyn,3751,1948,1803,51.93
Sion,Ornn,634,286,348,45.11
Sion,Shaco,1407,820,587,58.28
Sion,Hwei,1017,538,479,52.9
Sion,Karma,1538,755,783,49.09
Sion,Singed,558,224,334,40.14
Sion,Kindred,700,402,298,57.43
Sion,Katarina,1121,566,555,50.49
Sion,Kaisa,2402,1261,1141,52.5
Sion,Morgana,1734,868,866,50.06
Sion,Illaoi,653,324,329,49.62
Sion,Jhin,2917,1536,1381,52.66
Sion,Leona,1221,640,581,52.42
Sion,Darius,2970,1554,1416,52.32
Sion,Ekko,1332,703,629,52.78
Sion,Nami,1708,871,837,51
Sion,Viego,2207,1134,1073,51.38
Sion,Ezreal,3372,1755,1617,52.05
Sion,Blitzcrank,1068,561,507,52.53
Sion,Braum,833,422,411,50.66
Sion,Talon,938,529,409,56.4
Sion,Galio,1338,650,688,48.58
Sion,Lucian,1048,541,507,51.62
Sion,Milio,974,487,487,50
Sion,Briar,1197,619,578,51.71
Sion,Annie,471,219,252,46.5
Sion,Xerath,1180,551,629,46.69
Sion,Thresh,2288,1221,1067,53.37
Sion,Warwick,2237,1132,1105,50.6
Sion,Kalista,429,239,190,55.71
Sion,Skarner,475,294,181,61.89
Sion,Lillia,949,443,506,46.68
Sion,Lulu,1920,949,971,49.43
Sion,Renekton,607,328,279,54.04
Sion,Gragas,917,479,438,52.24
Sion,Viktor,1204,567,637,47.09
Sion,MasterYi,1608,816,792,50.75
Sion,Taliyah,477,248,229,51.99
Sion,Smolder,1136,564,572,49.65
Sion,Graves,899,436,463,48.5
Sion,Lux,3602,1893,1709,52.55
Sion,Soraka,893,449,444,50.28
Sion,DrMundo,767,385,382,50.2
Sion,Rengar,520,319,201,61.35
Sion,LeeSin,1923,1081,842,56.21
Sion,Zed,1729,956,773,55.29
Sion,MissFortune,3248,1726,1522,53.14
Sion,Vi,1476,737,739,49.93
Sion,Ryze,485,247,238,50.93
Sion,Janna,607,265,342,43.66
Sion,Vladimir,959,478,481,49.84
Sion,Draven,850,437,413,51.41
Sion,Swain,1461,676,785,46.27
Sion,Aurora,1182,629,553,53.21
Sion,Yorick,1555,776,779,49.9
Sion,Sett,2592,1312,1280,50.62
Sion,Varus,1346,733,613,54.46
Sion,Gwen,1155,606,549,52.47
Sion,AurelionSol,661,327,334,49.47
Sion,Sona,430,193,237,44.88
Sion,Malphite,1459,772,687,52.91
Sion,Qiyana,477,258,219,54.09
Sion,Ambessa,906,431,475,47.57
Sion,Vex,905,482,423,53.26
Sion,Pyke,1282,676,606,52.73
Sion,Trundle,1005,467,538,46.47
Sion,Zyra,1370,722,648,52.7
Sion,Syndra,1014,496,518,48.92
Sion,Shyvana,355,158,197,44.51
Sion,Nunu,1034,579,455,56
Sion,Nidalee,466,270,196,57.94
Sion,Sejuani,631,307,324,48.65
Sion,Lissandra,470,246,224,52.34
Sion,Aatrox,1407,656,751,46.62
Sion,Twitch,1325,650,675,49.06
Sion,Shen,1194,567,627,47.49
Sion,Riven,721,402,319,55.76
Sion,Xayah,804,399,405,49.63
Sion,Rakan,730,378,352,51.78
Sion,Azir,489,288,201,58.9
Sion,Gangplank,732,380,352,51.91
Sion,Elise,1075,603,472,56.09
Sion,Ziggs,546,245,301,44.87
Sion,Leblanc,674,332,342,49.26
Sion,JarvanIV,781,362,419,46.35
Sion,Corki,682,344,338,50.44
Sion,Akshan,530,311,219,58.68
Sion,XinZhao,924,486,438,52.6
Sion,Bard,513,239,274,46.59
Sion,Fizz,822,434,388,52.8
Sion,Sylas,1882,1017,865,54.04
Sion,Orianna,633,340,293,53.71
Sion,Anivia,573,274,299,47.82
Sion,Sivir,771,377,394,48.9
Sion,Velkoz,933,494,439,52.95
Sion,Kayle,1074,526,548,48.98
Sion,Brand,1093,576,517,52.7
Sion,Ahri,1961,1022,939,52.12
Sion,Tryndamere,902,476,426,52.77
Sion,Rammus,449,243,206,54.12
Sion,Zeri,683,356,327,52.12
Sion,Maokai,722,411,311,56.93
Sion,FiddleSticks,754,389,365,51.59
Sion,Kassadin,330,186,144,56.36
Sion,Chogath,2051,1005,1046,49
Sion,TwistedFate,521,326,195,62.57
Sion,Nilah,612,298,314,48.69
Sion,MonkeyKing,975,497,478,50.97
Sion,Ivern,247,120,127,48.58
Sion,Nocturne,1616,802,814,49.63
Sion,Cassiopeia,521,282,239,54.13
Sion,Urgot,805,420,385,52.17
Sion,Kled,283,161,122,56.89
Sion,Evelynn,661,364,297,55.07
Sion,Taric,366,159,207,43.44
Sion,Karthus,407,212,195,52.09
Sion,Rell,806,432,374,53.6
Sion,Camille,480,268,212,55.83
Sion,Kennen,430,205,225,47.67
Sion,Hecarim,635,358,277,56.38
Sion,RekSai,239,111,128,46.44
Sion,Quinn,589,280,309,47.54
Sion,Naafiri,490,288,202,58.78
Sion,Jayce,616,330,286,53.57
Sion,Rumble,359,209,150,58.22
Sion,Heimerdinger,777,399,378,51.35
Sion,Olaf,288,147,141,51.04
Sion,Renata,258,146,112,56.59
Shyvana,KSante,226,107,119,47.35
Shyvana,Kayn,809,471,338,58.22
Shyvana,Yasuo,894,455,439,50.89
Shyvana,MissFortune,1128,537,591,47.61
Shyvana,Lux,1280,654,626,51.09
Shyvana,Garen,915,465,450,50.82
Shyvana,Zed,424,252,172,59.43
Shyvana,Talon,302,188,114,62.25
Shyvana,Ashe,931,531,400,57.04
Shyvana,Milio,269,124,145,46.1
Shyvana,Aurora,433,239,194,55.2
Shyvana,Briar,399,160,239,40.1
Shyvana,Fizz,315,174,141,55.24
Shyvana,Jinx,1318,645,673,48.94
Shyvana,Soraka,286,144,142,50.35
Shyvana,Vladimir,329,157,172,47.72
Shyvana,Ekko,462,251,211,54.33
Shyvana,Qiyana,124,74,50,59.68
Shyvana,Twitch,456,221,235,48.46
Shyvana,Senna,443,221,222,49.89
Shyvana,Fiora,173,65,108,37.57
Shyvana,Amumu,641,334,307,52.11
Shyvana,Samira,372,220,152,59.14
Shyvana,Seraphine,488,254,234,52.05
Shyvana,Darius,1009,470,539,46.58
Shyvana,Gragas,313,166,147,53.04
Shyvana,Veigar,517,286,231,55.32
Shyvana,KogMaw,169,88,81,52.07
Shyvana,Thresh,628,360,268,57.32
Shyvana,Evelynn,228,110,118,48.25
Shyvana,Tristana,500,249,251,49.8
Shyvana,Sylas,522,261,261,50
Shyvana,Mordekaiser,764,397,367,51.96
Shyvana,Nidalee,120,69,51,57.5
Shyvana,Orianna,231,119,112,51.52
Shyvana,Caitlyn,1296,703,593,54.24
Shyvana,Yuumi,429,221,208,51.52
Shyvana,Volibear,683,371,312,54.32
Shyvana,Yone,892,478,414,53.59
Shyvana,Lulu,557,256,301,45.96
Shyvana,Sett,772,369,403,47.8
Shyvana,Shaco,500,261,239,52.2
Shyvana,Mel,1002,516,486,51.5
Shyvana,Graves,317,197,120,62.15
Shyvana,Kayle,357,217,140,60.78
Shyvana,Ezreal,1029,562,467,54.62
Shyvana,Malzahar,554,281,273,50.72
Shyvana,Warwick,764,394,370,51.57
Shyvana,Teemo,677,347,330,51.26
Shyvana,Hecarim,265,140,125,52.83
Shyvana,Vayne,629,310,319,49.28
Shyvana,Chogath,562,280,282,49.82
Shyvana,Ambessa,315,165,150,52.38
Shyvana,Aphelios,291,140,151,48.11
Shyvana,Velkoz,278,142,136,51.08
Shyvana,RekSai,57,17,40,29.82
Shyvana,LeeSin,531,246,285,46.33
Shyvana,Nilah,205,100,105,48.78
Shyvana,Poppy,314,198,116,63.06
Shyvana,Galio,436,222,214,50.92
Shyvana,Yorick,558,260,298,46.59
Shyvana,Viktor,391,182,209,46.55
Shyvana,Zoe,220,117,103,53.18
Shyvana,Anivia,193,110,83,56.99
Shyvana,Camille,191,110,81,57.59
Shyvana,Zac,268,129,139,48.13
Shyvana,Morgana,584,282,302,48.29
Shyvana,Varus,438,251,187,57.31
Shyvana,Sion,355,197,158,55.49
Shyvana,Karma,470,244,226,51.91
Shyvana,Rakan,263,117,146,44.49
Shyvana,Gangplank,238,119,119,50
Shyvana,Kalista,179,92,87,51.4
Shyvana,Sejuani,161,94,67,58.39
Shyvana,Leblanc,226,113,113,50
Shyvana,Swain,596,326,270,54.7
Shyvana,Lillia,323,166,157,51.39
Shyvana,Draven,302,157,145,51.99
Shyvana,Leona,463,216,247,46.65
Shyvana,TahmKench,360,174,186,48.33
Shyvana,Akali,550,299,251,54.36
Shyvana,Kaisa,713,411,302,57.64
Shyvana,Braum,261,141,120,54.02
Shyvana,Nasus,325,179,146,55.08
Shyvana,Nunu,316,158,158,50
Shyvana,Pyke,452,243,209,53.76
Shyvana,FiddleSticks,221,113,108,51.13
Shyvana,Lucian,333,121,212,36.34
Shyvana,Blitzcrank,404,234,170,57.92
Shyvana,Khazix,255,168,87,65.88
Shyvana,Zyra,386,174,212,45.08
Shyvana,Gwen,328,154,174,46.95
Shyvana,Diana,803,419,384,52.18
Shyvana,Riven,196,92,104,46.94
Shyvana,Jax,399,216,183,54.14
Shyvana,Malphite,494,259,235,52.43
Shyvana,Pantheon,775,418,357,53.94
Shyvana,Renekton,199,115,84,57.79
Shyvana,Ahri,633,297,336,46.92
Shyvana,TwistedFate,162,79,83,48.77
Shyvana,Rammus,136,76,60,55.88
Shyvana,Ryze,150,63,87,42
Shyvana,Maokai,223,101,122,45.29
Shyvana,Skarner,184,103,81,55.98
Shyvana,AurelionSol,193,108,85,55.96
Shyvana,Xerath,419,202,217,48.21
Shyvana,Urgot,287,109,178,37.98
Shyvana,Nocturne,605,290,315,47.93
Shyvana,XinZhao,322,160,162,49.69
Shyvana,Ornn,197,97,100,49.24
Shyvana,Heimerdinger,263,147,116,55.89
Shyvana,Sivir,271,140,131,51.66
Shyvana,DrMundo,316,161,155,50.95
Shyvana,Nautilus,536,325,211,60.63
Shyvana,Smolder,425,193,232,45.41
Shyvana,Nami,499,233,266,46.69
Shyvana,Tryndamere,228,139,89,60.96
Shyvana,Azir,135,79,56,58.52
Shyvana,Zilean,152,52,100,34.21
Shyvana,Janna,186,77,109,41.4
Shyvana,Jhin,938,479,459,51.07
Shyvana,Naafiri,241,156,85,64.73
Shyvana,Syndra,313,204,109,65.18
Shyvana,Kassadin,96,43,53,44.79
Shyvana,Alistar,240,147,93,61.25
Shyvana,Jayce,170,78,92,45.88
Shyvana,Belveth,124,65,59,52.42
Shyvana,Lissandra,155,74,81,47.74
Shyvana,Sona,173,84,89,48.55
Shyvana,Katarina,402,246,156,61.19
Shyvana,Elise,328,185,143,56.4
Shyvana,Hwei,311,163,148,52.41
Shyvana,MasterYi,532,245,287,46.05
Shyvana,Taric,71,54,17,76.06
Shyvana,Xayah,264,157,107,59.47
Shyvana,Rengar,139,81,58,58.27
Shyvana,Viego,677,385,292,56.87
Shyvana,Brand,369,213,156,57.72
Shyvana,Olaf,85,45,40,52.94
Shyvana,Annie,158,107,51,67.72
Shyvana,Illaoi,266,94,172,35.34
Shyvana,Gnar,231,106,125,45.89
Shyvana,Rell,252,144,108,57.14
Shyvana,Shen,343,154,189,44.9
Shyvana,Irelia,452,223,229,49.34
Shyvana,Vex,264,115,149,43.56
Shyvana,JarvanIV,277,134,143,48.38
Shyvana,Ivern,78,37,41,47.44
Shyvana,Neeko,299,151,148,50.5
Shyvana,Udyr,201,113,88,56.22
Shyvana,Trundle,228,118,110,51.75
Shyvana,Karthus,113,60,53,53.1
Shyvana,Kled,134,74,60,55.22
Shyvana,Vi,410,239,171,58.29
Shyvana,Corki,217,110,107,50.69
Shyvana,MonkeyKing,318,182,136,57.23
Shyvana,Zeri,186,76,110,40.86
Shyvana,Aatrox,306,180,126,58.82
Shyvana,Singed,125,49,76,39.2
Shyvana,Quinn,222,119,103,53.6
Shyvana,Ziggs,213,128,85,60.09
Shyvana,Kindred,231,125,106,54.11
Shyvana,Rumble,133,72,61,54.14
Shyvana,Akshan,170,71,99,41.76
Shyvana,Bard,150,84,66,56
Shyvana,Cassiopeia,146,92,54,63.01
Shyvana,Renata,83,33,50,39.76
Shyvana,Kennen,142,66,76,46.48
Shyvana,Taliyah,133,78,55,58.65
Quinn,Naafiri,260,130,130,50
Quinn,Volibear,715,367,348,51.33
Quinn,Lux,1768,939,829,53.11
Quinn,Ashe,1402,738,664,52.64
Quinn,Soraka,457,214,243,46.83
Quinn,Jax,577,325,252,56.33
Quinn,FiddleSticks,376,192,184,51.06
Quinn,Cassiopeia,228,113,115,49.56
Quinn,Caitlyn,1842,989,853,53.69
Quinn,Milio,481,234,247,48.65
Quinn,Nasus,426,208,218,48.83
Quinn,Kindred,308,149,159,48.38
Quinn,Malzahar,600,324,276,54
Quinn,Tristana,776,427,349,55.03
Quinn,Nautilus,616,324,292,52.6
Quinn,Yone,1159,609,550,52.55
Quinn,Graves,437,236,201,54
Quinn,Akali,810,408,402,50.37
Quinn,Zeri,250,127,123,50.8
Quinn,Taric,162,95,67,58.64
Quinn,Malphite,1116,550,566,49.28
Quinn,Ivern,123,74,49,60.16
Quinn,Yasuo,1335,702,633,52.58
Quinn,Jhin,1428,774,654,54.2
Quinn,Pyke,635,330,305,51.97
Quinn,KSante,265,128,137,48.3
Quinn,Darius,1500,739,761,49.27
Quinn,Sylas,834,404,430,48.44
Quinn,Mel,1553,865,688,55.7
Quinn,Pantheon,1108,565,543,50.99
Quinn,Warwick,1082,552,530,51.02
Quinn,Viego,984,504,480,51.22
Quinn,Ornn,287,152,135,52.96
Quinn,Shaco,669,349,320,52.17
Quinn,Irelia,559,273,286,48.84
Quinn,Evelynn,275,133,142,48.36
Quinn,Rammus,244,104,140,42.62
Quinn,Hwei,461,261,200,56.62
Quinn,Lulu,774,420,354,54.26
Quinn,Teemo,1056,464,592,43.94
Quinn,Ahri,872,450,422,51.61
Quinn,Yuumi,601,298,303,49.58
Quinn,Aurora,606,274,332,45.21
Quinn,KogMaw,243,113,130,46.5
Quinn,Kayle,502,269,233,53.59
Quinn,LeeSin,886,458,428,51.69
Quinn,Vex,381,199,182,52.23
Quinn,MissFortune,1617,822,795,50.83
Quinn,Kalista,170,95,75,55.88
Quinn,Vi,697,330,367,47.35
Quinn,Talon,426,239,187,56.1
Quinn,Briar,613,326,287,53.18
Quinn,Zoe,321,161,160,50.16
Quinn,Singed,198,79,119,39.9
Quinn,Ezreal,1527,815,712,53.37
Quinn,Velkoz,494,231,263,46.76
Quinn,Ambessa,449,256,193,57.02
Quinn,Lissandra,217,141,76,64.98
Quinn,Samira,504,263,241,52.18
Quinn,Thresh,924,483,441,52.27
Quinn,Rakan,295,140,155,47.46
Quinn,Morgana,901,523,378,58.05
Quinn,DrMundo,473,248,225,52.43
Quinn,Mordekaiser,841,432,409,51.37
Quinn,Seraphine,672,336,336,50
Quinn,Vladimir,422,204,218,48.34
Quinn,Sett,984,465,519,47.26
Quinn,Nami,700,349,351,49.86
Quinn,Nocturne,850,426,424,50.12
Quinn,Aphelios,385,194,191,50.39
Quinn,Karma,756,380,376,50.26
Quinn,Gnar,318,164,154,51.57
Quinn,Qiyana,172,110,62,63.95
Quinn,Diana,921,459,462,49.84
Quinn,Zilean,224,113,111,50.45
Quinn,Renekton,405,237,168,58.52
Quinn,Twitch,619,315,304,50.89
Quinn,Braum,364,175,189,48.08
Quinn,Zed,896,503,393,56.14
Quinn,MasterYi,841,448,393,53.27
Quinn,Elise,466,262,204,56.22
Quinn,Vayne,896,454,442,50.67
Quinn,Gragas,421,187,234,44.42
Quinn,Udyr,299,162,137,54.18
Quinn,Poppy,390,202,188,51.79
Quinn,Swain,666,328,338,49.25
Quinn,Sejuani,239,116,123,48.54
Quinn,Kennen,217,118,99,54.38
Quinn,Kayn,1064,596,468,56.02
Quinn,Veigar,711,339,372,47.68
Quinn,Varus,635,334,301,52.6
Quinn,Senna,598,317,281,53.01
Quinn,Gangplank,377,169,208,44.83
Quinn,Garen,1261,623,638,49.41
Quinn,Rengar,303,191,112,63.04
Quinn,Smolder,499,295,204,59.12
Quinn,Skarner,227,112,115,49.34
Quinn,Jinx,1932,962,970,49.79
Quinn,Yorick,696,325,371,46.7
Quinn,TwistedFate,319,150,169,47.02
Quinn,Leona,517,243,274,47
Quinn,Heimerdinger,384,161,223,41.93
Quinn,Khazix,413,206,207,49.88
Quinn,Janna,282,132,150,46.81
Quinn,Brand,486,241,245,49.59
Quinn,Ekko,632,300,332,47.47
Quinn,Nidalee,210,126,84,60
Quinn,Lucian,410,228,182,55.61
Quinn,Chogath,804,427,377,53.11
Quinn,MonkeyKing,450,211,239,46.89
Quinn,Nilah,249,145,104,58.23
Quinn,Xerath,617,300,317,48.62
Quinn,TahmKench,552,293,259,53.08
Quinn,Amumu,689,293,396,42.53
Quinn,AurelionSol,286,122,164,42.66
Quinn,Zyra,631,331,300,52.46
Quinn,Sivir,375,158,217,42.13
Quinn,Katarina,634,290,344,45.74
Quinn,Galio,610,305,305,50
Quinn,Fizz,387,187,200,48.32
Quinn,Kaisa,1053,491,562,46.63
Quinn,Lillia,433,240,193,55.43
Quinn,Ryze,221,94,127,42.53
Quinn,Nunu,431,231,200,53.6
Quinn,Fiora,243,147,96,60.49
Quinn,Viktor,584,319,265,54.62
Quinn,Tryndamere,458,211,247,46.07
Quinn,JarvanIV,389,201,188,51.67
Quinn,Maokai,323,173,150,53.56
Quinn,Azir,260,103,157,39.62
Quinn,Jayce,382,224,158,58.64
Quinn,Xayah,307,144,163,46.91
Quinn,Karthus,230,118,112,51.3
Quinn,Bard,282,124,158,43.97
Quinn,Urgot,343,129,214,37.61
Quinn,Blitzcrank,539,238,301,44.16
Quinn,Camille,260,140,120,53.85
Quinn,Aatrox,575,259,316,45.04
Quinn,Leblanc,379,217,162,57.26
Quinn,Kassadin,135,87,48,64.44
Quinn,Riven,310,155,155,50
Quinn,Ziggs,252,126,126,50
Quinn,Annie,238,121,117,50.84
Quinn,Draven,434,221,213,50.92
Quinn,Sion,589,309,280,52.46
Quinn,Corki,356,187,169,52.53
Quinn,Rell,387,186,201,48.06
Quinn,Illaoi,266,145,121,54.51
Quinn,Hecarim,234,109,125,46.58
Quinn,Rumble,128,77,51,60.16
Quinn,Belveth,169,97,72,57.4
Quinn,Zac,258,145,113,56.2
Quinn,Orianna,319,181,138,56.74
Quinn,Sona,196,97,99,49.49
Quinn,Shen,358,205,153,57.26
Quinn,Neeko,386,217,169,56.22
Quinn,XinZhao,343,155,188,45.19
Quinn,Alistar,285,128,157,44.91
Quinn,Gwen,393,237,156,60.31
Quinn,Syndra,469,238,231,50.75
Quinn,Olaf,136,81,55,59.56
Quinn,Kled,112,61,51,54.46
Quinn,Trundle,302,134,168,44.37
Quinn,Taliyah,216,104,112,48.15
Quinn,Renata,99,48,51,48.48
Quinn,Shyvana,222,103,119,46.4
Quinn,Anivia,171,85,86,49.71
Quinn,Akshan,271,110,161,40.59
Quinn,RekSai,95,63,32,66.32
Kled,Sett,562,237,325,42.17
Kled,Karthus,94,60,34,63.83
Kled,Zed,362,189,173,52.21
Kled,Ashe,773,405,368,52.39
Kled,Maokai,177,80,97,45.2
Kled,Nasus,239,121,118,50.63
Kled,Udyr,127,73,54,57.48
Kled,Jhin,761,376,385,49.41
Kled,Alistar,131,50,81,38.17
Kled,Yone,660,324,336,49.09
Kled,Khazix,193,106,87,54.92
Kled,Varus,342,141,201,41.23
Kled,Samira,233,120,113,51.5
Kled,Yuumi,260,124,136,47.69
Kled,Urgot,223,117,106,52.47
Kled,Shaco,331,143,188,43.2
Kled,Annie,120,57,63,47.5
Kled,Ezreal,855,476,379,55.67
Kled,Lux,888,468,420,52.7
Kled,Ornn,198,113,85,57.07
Kled,Yorick,347,173,174,49.86
Kled,Zoe,175,81,94,46.29
Kled,Blitzcrank,232,108,124,46.55
Kled,Pantheon,546,248,298,45.42
Kled,Trundle,246,111,135,45.12
Kled,Yasuo,650,282,368,43.38
Kled,Leona,344,161,183,46.8
Kled,Chogath,474,239,235,50.42
Kled,Nocturne,393,183,210,46.56
Kled,Cassiopeia,131,69,62,52.67
Kled,Soraka,201,104,97,51.74
Kled,Ambessa,209,107,102,51.2
Kled,Evelynn,98,47,51,47.96
Kled,Katarina,273,141,132,51.65
Kled,Jinx,906,453,453,50
Kled,Singed,123,57,66,46.34
Kled,MonkeyKing,240,116,124,48.33
Kled,Diana,518,262,256,50.58
Kled,MissFortune,726,371,355,51.1
Kled,Amumu,409,190,219,46.45
Kled,Skarner,148,76,72,51.35
Kled,Warwick,555,279,276,50.27
Kled,Xerath,281,145,136,51.6
Kled,Brand,253,145,108,57.31
Kled,Camille,111,60,51,54.05
Kled,Lillia,181,121,60,66.85
Kled,Leblanc,222,112,110,50.45
Kled,Renata,98,58,40,59.18
Kled,Kayn,531,300,231,56.5
Kled,Lissandra,139,53,86,38.13
Kled,Kalista,140,84,56,60
Kled,JarvanIV,233,94,139,40.34
Kled,Rumble,131,81,50,61.83
Kled,XinZhao,196,93,103,47.45
Kled,Smolder,211,126,85,59.72
Kled,Seraphine,323,177,146,54.8
Kled,Garen,562,319,243,56.76
Kled,Vayne,487,215,272,44.15
Kled,Thresh,475,236,239,49.68
Kled,Shen,328,174,154,53.05
Kled,Lucian,258,134,124,51.94
Kled,Senna,238,132,106,55.46
Kled,Qiyana,104,60,44,57.69
Kled,Velkoz,238,101,137,42.44
Kled,Teemo,454,202,252,44.49
Kled,Ziggs,147,56,91,38.1
Kled,Pyke,380,221,159,58.16
Kled,Aatrox,386,198,188,51.3
Kled,AurelionSol,165,82,83,49.7
Kled,Aphelios,224,112,112,50
Kled,Milio,190,103,87,54.21
Kled,Ahri,461,219,242,47.51
Kled,Lulu,468,252,216,53.85
Kled,Rakan,149,76,73,51.01
Kled,Poppy,257,119,138,46.3
Kled,Viego,437,203,234,46.45
Kled,Irelia,271,129,142,47.6
Kled,Mel,809,451,358,55.75
Kled,Zyra,320,153,167,47.81
Kled,Ryze,111,64,47,57.66
Kled,Belveth,95,64,31,67.37
Kled,Heimerdinger,177,73,104,41.24
Kled,Gangplank,189,89,100,47.09
Kled,Vex,171,99,72,57.89
Kled,KSante,186,98,88,52.69
Kled,Mordekaiser,520,214,306,41.15
Kled,Veigar,379,206,173,54.35
Kled,Riven,156,112,44,71.79
Kled,Talon,243,126,117,51.85
Kled,Sona,120,69,51,57.5
Kled,Kayle,268,148,120,55.22
Kled,LeeSin,433,229,204,52.89
Kled,Sylas,462,253,209,54.76
Kled,MasterYi,347,181,166,52.16
Kled,Sivir,147,67,80,45.58
Kled,Renekton,202,116,86,57.43
Kled,Sejuani,152,61,91,40.13
Kled,Ekko,342,188,154,54.97
Kled,Jayce,144,63,81,43.75
Kled,Kaisa,574,285,289,49.65
Kled,Vi,331,175,156,52.87
Kled,Rammus,111,49,62,44.14
Kled,Jax,296,139,157,46.96
Kled,Morgana,455,231,224,50.77
Kled,Darius,741,332,409,44.8
Kled,TwistedFate,137,78,59,56.93
Kled,Nami,411,202,209,49.15
Kled,Volibear,451,228,223,50.55
Kled,Hecarim,137,85,52,62.04
Kled,Kassadin,71,30,41,42.25
Kled,Orianna,168,84,84,50
Kled,Kennen,108,63,45,58.33
Kled,Elise,301,178,123,59.14
Kled,Nilah,142,86,56,60.56
Kled,Nunu,158,94,64,59.49
Kled,Ivern,86,58,28,67.44
Kled,Nautilus,436,218,218,50
Kled,Briar,367,192,175,52.32
Kled,Hwei,246,142,104,57.72
Kled,Zilean,138,65,73,47.1
Kled,Vladimir,225,102,123,45.33
Kled,Caitlyn,985,486,499,49.34
Kled,Gnar,161,82,79,50.93
Kled,Akali,421,223,198,52.97
Kled,TahmKench,303,194,109,64.03
Kled,Olaf,96,56,40,58.33
Kled,Malzahar,341,171,170,50.15
Kled,Gragas,206,107,99,51.94
Kled,Bard,95,39,56,41.05
Kled,Illaoi,155,83,72,53.55
Kled,FiddleSticks,198,94,104,47.47
Kled,Aurora,231,92,139,39.83
Kled,Sion,283,122,161,43.11
Kled,Fizz,221,113,108,51.13
Kled,Draven,191,85,106,44.5
Kled,Corki,167,102,65,61.08
Kled,Graves,221,117,104,52.94
Kled,Viktor,346,154,192,44.51
Kled,Neeko,166,75,91,45.18
Kled,Twitch,315,153,162,48.57
Kled,Janna,137,45,92,32.85
Kled,Naafiri,131,80,51,61.07
Kled,Swain,358,165,193,46.09
Kled,Braum,184,67,117,36.41
Kled,Gwen,210,122,88,58.1
Kled,RekSai,64,34,30,53.13
Kled,Fiora,152,79,73,51.97
Kled,Galio,272,132,140,48.53
Kled,Rengar,161,90,71,55.9
Kled,Shyvana,134,60,74,44.78
Kled,KogMaw,152,75,77,49.34
Kled,Rell,179,81,98,45.25
Kled,Xayah,191,113,78,59.16
Kled,Karma,401,176,225,43.89
Kled,Malphite,287,118,169,41.11
Kled,Zeri,133,74,59,55.64
Kled,Anivia,94,58,36,61.7
Kled,Quinn,112,51,61,45.54
Kled,Tristana,390,200,190,51.28
Kled,Taric,80,44,36,55
Kled,Nidalee,96,56,40,58.33
Kled,Tryndamere,210,117,93,55.71
Kled,Zac,192,74,118,38.54
Kled,Azir,157,96,61,61.15
Kled,DrMundo,252,125,127,49.6
Kled,Kindred,211,122,89,57.82
Kled,Syndra,259,128,131,49.42
Kled,Akshan,136,64,72,47.06
Kled,Taliyah,93,46,47,49.46
Rumble,Poppy,419,206,213,49.16
Rumble,Viego,731,339,392,46.37
Rumble,Zed,530,268,262,50.57
Rumble,Mel,954,491,463,51.47
Rumble,Lux,1032,495,537,47.97
Rumble,Yorick,354,153,201,43.22
Rumble,Shaco,523,255,268,48.76
Rumble,Kalista,121,54,67,44.63
Rumble,Blitzcrank,350,183,167,52.29
Rumble,Sett,756,364,392,48.15
Rumble,Elise,413,197,216,47.7
Rumble,Katarina,397,192,205,48.36
Rumble,MissFortune,1021,528,493,51.71
Rumble,Morgana,535,224,311,41.87
Rumble,Aatrox,563,293,270,52.04
Rumble,Rengar,155,72,83,46.45
Rumble,RekSai,79,39,40,49.37
Rumble,Twitch,338,175,163,51.78
Rumble,Sona,127,51,76,40.16
Rumble,Kayle,291,128,163,43.99
Rumble,Warwick,702,289,413,41.17
Rumble,Fizz,243,131,112,53.91
Rumble,Tristana,485,215,270,44.33
Rumble,Seraphine,318,144,174,45.28
Rumble,Mordekaiser,605,252,353,41.65
Rumble,Graves,311,156,155,50.16
Rumble,Yasuo,1078,471,607,43.69
Rumble,Ezreal,1481,701,780,47.33
Rumble,Maokai,221,99,122,44.8
Rumble,Kled,131,50,81,38.17
Rumble,Varus,520,241,279,46.35
Rumble,Ekko,420,197,223,46.9
Rumble,Thresh,689,354,335,51.38
Rumble,Yone,977,482,495,49.33
Rumble,LeeSin,955,474,481,49.63
Rumble,Vladimir,370,192,178,51.89
Rumble,Gangplank,255,127,128,49.8
Rumble,MasterYi,503,223,280,44.33
Rumble,Aurora,428,193,235,45.09
Rumble,Chogath,509,247,262,48.53
Rumble,Darius,837,367,470,43.85
Rumble,Evelynn,208,87,121,41.83
Rumble,Irelia,473,199,274,42.07
Rumble,Jhin,1040,483,557,46.44
Rumble,Ivern,93,48,45,51.61
Rumble,Vex,224,93,131,41.52
Rumble,Shen,337,171,166,50.74
Rumble,Lissandra,147,60,87,40.82
Rumble,Soraka,262,127,135,48.47
Rumble,Kayn,702,317,385,45.16
Rumble,Akali,543,278,265,51.2
Rumble,Kaisa,852,442,410,51.88
Rumble,Briar,326,149,177,45.71
Rumble,Sivir,245,98,147,40
Rumble,JarvanIV,296,130,166,43.92
Rumble,Teemo,805,374,431,46.46
Rumble,Malzahar,411,189,222,45.99
Rumble,Aphelios,251,144,107,57.37
Rumble,Sylas,800,426,374,53.25
Rumble,Nasus,314,152,162,48.41
Rumble,Caitlyn,1163,566,597,48.67
Rumble,Pantheon,851,408,443,47.94
Rumble,Alistar,248,100,148,40.32
Rumble,Ahri,642,310,332,48.29
Rumble,Ornn,216,104,112,48.15
Rumble,Jax,421,199,222,47.27
Rumble,Ashe,931,443,488,47.58
Rumble,Yuumi,407,202,205,49.63
Rumble,Gragas,312,124,188,39.74
Rumble,Neeko,199,91,108,45.73
Rumble,Karma,680,315,365,46.32
Rumble,Camille,120,60,60,50
Rumble,Kassadin,96,38,58,39.58
Rumble,Karthus,159,54,105,33.96
Rumble,TahmKench,413,194,219,46.97
Rumble,Lulu,736,369,367,50.14
Rumble,FiddleSticks,256,95,161,37.11
Rumble,Qiyana,157,94,63,59.87
Rumble,Samira,297,138,159,46.46
Rumble,Zac,267,166,101,62.17
Rumble,Lucian,385,208,177,54.03
Rumble,Renata,88,47,41,53.41
Rumble,Milio,293,136,157,46.42
Rumble,Pyke,474,223,251,47.05
Rumble,Talon,359,180,179,50.14
Rumble,Brand,270,123,147,45.56
Rumble,Braum,286,117,169,40.91
Rumble,Malphite,487,221,266,45.38
Rumble,Nocturne,511,228,283,44.62
Rumble,Udyr,193,103,90,53.37
Rumble,Illaoi,246,123,123,50
Rumble,Lillia,266,146,120,54.89
Rumble,Nami,432,204,228,47.22
Rumble,Volibear,388,188,200,48.45
Rumble,Vayne,559,304,255,54.38
Rumble,KSante,302,132,170,43.71
Rumble,Belveth,143,81,62,56.64
Rumble,Viktor,406,207,199,50.99
Rumble,Nautilus,558,269,289,48.21
Rumble,Gwen,235,123,112,52.34
Rumble,Jinx,1337,606,731,45.33
Rumble,Swain,441,226,215,51.25
Rumble,Skarner,181,90,91,49.72
Rumble,Senna,351,168,183,47.86
Rumble,Hwei,329,167,162,50.76
Rumble,Nidalee,209,95,114,45.45
Rumble,Taliyah,154,57,97,37.01
Rumble,Galio,572,282,290,49.3
Rumble,Urgot,212,89,123,41.98
Rumble,Sejuani,171,79,92,46.2
Rumble,TwistedFate,189,90,99,47.62
Rumble,Hecarim,224,120,104,53.57
Rumble,Draven,249,126,123,50.6
Rumble,Riven,257,140,117,54.47
Rumble,Jayce,386,183,203,47.41
Rumble,Orianna,265,95,170,35.85
Rumble,Zoe,226,105,121,46.46
Rumble,Garen,627,327,300,52.15
Rumble,Diana,810,389,421,48.02
Rumble,Singed,134,37,97,27.61
Rumble,Kennen,145,74,71,51.03
Rumble,Khazix,252,119,133,47.22
Rumble,Veigar,384,167,217,43.49
Rumble,Azir,170,102,68,60
Rumble,Leblanc,345,201,144,58.26
Rumble,DrMundo,296,143,153,48.31
Rumble,Vi,533,304,229,57.04
Rumble,Zyra,512,280,232,54.69
Rumble,Rammus,160,80,80,50
Rumble,Ambessa,320,144,176,45
Rumble,Heimerdinger,231,104,127,45.02
Rumble,Rakan,272,124,148,45.59
Rumble,Velkoz,273,119,154,43.59
Rumble,Gnar,248,125,123,50.4
Rumble,Ziggs,180,65,115,36.11
Rumble,Annie,184,86,98,46.74
Rumble,Anivia,162,65,97,40.12
Rumble,Trundle,199,108,91,54.27
Rumble,Tryndamere,155,55,100,35.48
Rumble,AurelionSol,156,93,63,59.62
Rumble,Syndra,303,164,139,54.13
Rumble,Zilean,177,69,108,38.98
Rumble,Sion,359,150,209,41.78
Rumble,Xerath,534,212,322,39.7
Rumble,Quinn,128,51,77,39.84
Rumble,Kindred,250,126,124,50.4
Rumble,Leona,453,215,238,47.46
Rumble,Akshan,139,88,51,63.31
Rumble,Cassiopeia,125,56,69,44.8
Rumble,Smolder,293,149,144,50.85
Rumble,Amumu,495,263,232,53.13
Rumble,KogMaw,175,59,116,33.71
Rumble,Ryze,153,74,79,48.37
Rumble,Naafiri,162,58,104,35.8
Rumble,Zeri,265,139,126,52.45
Rumble,Nunu,277,138,139,49.82
Rumble,Bard,168,80,88,47.62
Rumble,XinZhao,300,156,144,52
Rumble,Xayah,286,108,178,37.76
Rumble,Renekton,221,132,89,59.73
Rumble,MonkeyKing,296,119,177,40.2
Rumble,Shyvana,133,61,72,45.86
Rumble,Fiora,209,92,117,44.02
Rumble,Janna,153,63,90,41.18
Rumble,Taric,113,58,55,51.33
Rumble,Olaf,198,97,101,48.99
Rumble,Rell,303,144,159,47.52
Rumble,Nilah,102,60,42,58.82
Rumble,Corki,241,113,128,46.89
