Name,Games,Wins,Losses,Bans,WR
Nautilus,57772,28188,29584,70985,48.79
MasterYi,58813,29805,29008,120337,50.68
Darius,94727,47697,47030,174025,50.35
Sylas,66536,32508,34028,59022,48.86
Shaco,47548,23226,24322,205069,48.85
Vayne,62026,31760,30266,46082,51.2
Fizz,28797,14349,14448,50058,49.83
Chogath,63337,32489,30848,32128,51.3
Mel,105276,50542,54734,470656,48.01
Ashe,99821,49439,50382,45299,49.53
Sett,79232,40999,38233,37252,51.75
Warwick,76727,40007,36720,147737,52.14
Shen,32977,16559,16418,3924,50.21
Tristana,49247,24483,24764,15458,49.71
Blitzcrank,39207,18881,20326,123476,48.16
Malphite,49374,24918,24456,39214,50.47
Ekko,45914,22952,22962,12282,49.99
Hwei,34909,17476,17433,24212,50.06
Lucian,34520,16566,17954,6227,47.99
Maokai,23322,11897,11425,5020,51.01
Leblanc,28102,13632,14470,74803,48.51
None,0,0,0,237787,NaN
LeeSin,71605,34159,37446,68870,47.7
Yorick,48978,26465,22513,84016,54.03
Volibear,57684,29168,28516,33667,50.57
Diana,78019,39463,38556,66037,50.58
Rammus,16256,8303,7953,33153,51.08
Yone,95490,45729,49761,67172,47.89
Yasuo,100573,50454,50119,145786,50.17
Jhin,101048,50417,50631,34739,49.89
Lux,129490,65019,64471,140153,50.21
Mordekaiser,69574,36077,33497,113425,51.85
Qiyana,14240,6569,7671,2317,46.13
Irelia,44144,21807,22337,72629,49.4
Ezreal,115145,55533,59612,48813,48.23
Rell,26541,13267,13274,11539,49.99
Caitlyn,134826,67862,66964,190408,50.33
Morgana,62445,31898,30547,172628,51.08
Kalista,16412,7645,8767,6152,46.58
Shyvana,12990,6738,6252,3481,51.87
Sejuani,21273,10756,10517,3308,50.56
Pantheon,82101,40863,41238,30547,49.77
Singed,14026,7383,6643,4120,52.64
Zed,55224,26571,28653,111276,48.11
Teemo,64667,33715,30952,137130,52.14
Lulu,60009,29821,30188,104524,49.69
Sion,39467,20282,19185,9002,51.39
Urgot,25506,13403,12103,16954,52.55
Amumu,52918,28131,24787,53519,53.16
Zac,23702,11948,11754,10344,50.41
Poppy,31558,15920,15638,19936,50.45
Twitch,41388,20593,20795,52106,49.76
Fiora,20227,9833,10394,23908,48.61
Katarina,40280,19252,21028,37868,47.8
Viktor,42804,21407,21397,47028,50.01
Braum,28772,14835,13937,13180,51.56
Brand,36691,18385,18306,33748,50.11
Karma,54765,27672,27093,40318,50.53
Jayce,24241,11697,12544,14604,48.25
Kaisa,80635,38679,41956,12232,47.97
Pyke,46798,22063,24735,127156,47.15
Renekton,25752,12753,12999,17234,49.52
Kayn,75321,37782,37539,62122,50.16
Draven,27056,13191,13865,90270,48.75
Yuumi,42606,21039,21567,38721,49.38
Zoe,20805,9755,11050,10595,46.89
Taric,11189,5854,5335,3133,52.32
Akali,54961,26825,28136,70618,48.81
Gragas,29889,14163,15726,10257,47.39
Zyra,43894,22778,21116,43629,51.89
Aurora,40473,19675,20798,44107,48.61
Khazix,27272,12915,14357,17437,47.36
Nocturne,58589,30649,27940,119039,52.31
Gangplank,23424,11456,11968,9049,48.91
Gwen,27620,13116,14504,17888,47.49
Vi,48463,24193,24270,13222,49.92
Soraka,29083,14978,14105,13303,51.5
Samira,40275,19680,20595,62377,48.86
Illaoi,24633,12450,12183,85933,50.54
Jax,46632,23012,23620,29075,49.35
XinZhao,31817,16197,15620,7392,50.91
Kennen,15251,7370,7881,6492,48.32
Vladimir,32323,16152,16171,26896,49.97
Viego,70599,35534,35065,67865,50.33
Velkoz,31182,16149,15033,10957,51.79
Tryndamere,28447,14061,14386,20832,49.43
Aatrox,47139,22962,24177,54929,48.71
Varus,45265,22130,23135,8333,48.89
Kindred,24176,11508,12668,12053,47.6
Milio,29731,15600,14131,12803,52.47
KogMaw,16191,8442,7749,8965,52.14
Ambessa,32307,15477,16830,75408,47.91
Graves,31289,15439,15850,20754,49.34
Ahri,68097,33501,34596,32116,49.2
Nilah,19939,10301,9638,28135,51.66
Belveth,12450,6083,6367,12686,48.86
Sona,16603,8656,7947,1635,52.14
Renata,10083,4949,5134,1879,49.08
Ivern,8575,4097,4478,2974,47.78
Veigar,53405,27469,25936,27128,51.44
Jinx,132612,68431,64181,70579,51.6
Seraphine,43191,21545,21646,15242,49.88
Rakan,23438,11814,11624,2775,50.41
Vex,28067,14152,13915,30756,50.42
Corki,20037,9412,10625,9751,46.97
Lillia,30238,15064,15174,26188,49.82
Zeri,21764,10676,11088,2806,49.05
Briar,40465,21124,19341,51532,52.2
Nunu,32741,16237,16504,10173,49.59
Swain,51102,26828,24274,31835,52.5
Nami,50181,25837,24344,7818,51.49
Orianna,23014,11409,11605,4971,49.57
Kayle,35199,18126,17073,17173,51.5
Leona,43494,21810,21684,52230,50.14
Talon,30208,14343,15865,8989,47.48
Alistar,20901,10364,10537,7026,49.59
DrMundo,29834,15504,14330,22736,51.97
Garen,80012,41293,38719,62793,51.61
Heimerdinger,24669,12912,11757,34148,52.34
MissFortune,115397,58663,56734,90440,50.84
Ryze,17247,8782,8465,2439,50.92
TwistedFate,18144,8625,9519,1071,47.54
Udyr,19953,9709,10244,10840,48.66
Quinn,18376,9394,8982,9563,51.12
MonkeyKing,32796,16821,15975,18739,51.29
Azir,18282,8805,9477,3594,48.16
Neeko,27843,13434,14409,9971,48.25
FiddleSticks,25270,12742,12528,9510,50.42
Smolder,34732,16748,17984,9120,48.22
TahmKench,44421,21757,22664,62978,48.98
Aphelios,29789,14821,14968,7892,49.75
Malzahar,49503,25985,23518,85815,52.49
Evelynn,20595,9971,10624,16034,48.41
Trundle,29311,15110,14201,13653,51.55
Sivir,26623,13636,12987,5736,51.22
Rengar,18632,8176,10456,10417,43.88
Lissandra,16255,8293,7962,6787,51.02
Nasus,36509,18839,17670,29282,51.6
Naafiri,18600,9319,9281,10834,50.1
Senna,39435,19792,19643,9497,50.19
Galio,43597,22492,21105,28883,51.59
Gnar,21587,10353,11234,6249,47.96
Riven,23071,11011,12060,9928,47.73
Hecarim,20496,9900,10596,12103,48.3
AurelionSol,20731,10702,10029,8381,51.62
Ornn,22275,11372,10903,4123,51.05
Kassadin,10915,5579,5336,7138,51.11
Nidalee,14826,6548,8278,4761,44.17
JarvanIV,27405,14167,13238,6916,51.69
Xayah,27283,13679,13604,4371,50.14
Ziggs,19824,10118,9706,6520,51.04
Taliyah,13237,6669,6568,2226,50.38
Cassiopeia,16292,8142,8150,16669,49.98
Kled,9559,4822,4737,4478,50.44
Thresh,70032,34979,35053,28617,49.95
RekSai,6393,3082,3311,2627,48.21
Karthus,14453,7003,7450,9692,48.45
Skarner,14950,6926,8024,24304,46.33
KSante,25055,11617,13438,23284,46.37
Syndra,31827,16120,15707,23820,50.65
Zilean,15919,8107,7812,4986,50.93
Bard,16014,8008,8006,2967,50.01
Xerath,43647,22190,21457,47849,50.84
Anivia,16331,8390,7941,10825,51.37
Elise,35169,17193,17976,42517,48.89
Janna,16990,8774,8216,3691,51.64
Akshan,18224,9140,9084,14826,50.15
Olaf,11986,5958,6028,6238,49.71
Annie,16561,8266,8295,5942,49.91
Camille,18055,8622,9433,8518,47.75
Rumble,13004,6207,6797,3821,47.73
