Name,Role,Games,Wins,Losses,WR
Ambessa,TOP,3273,1641,1632,50.14
Ambessa,JUNGLE,337,176,161,52.23
Ambessa,MIDDLE,395,215,180,54.43
Ambessa,,3,0,3,0
Ambessa,UTILITY,23,3,20,13.04
Ambessa,BOTTOM,21,3,18,14.29
Volibear,JUNGLE,2534,1319,1215,52.05
Volibear,TOP,2814,1449,1365,51.49
Volibear,,3,0,3,0
Volibear,MIDDLE,92,60,32,65.22
Volibear,UTILITY,48,22,26,45.83
Volibear,BOTTOM,12,4,8,33.33
Veigar,MIDDLE,4148,2165,1983,52.19
Veigar,UTILITY,440,181,259,41.14
Veigar,BOTTOM,567,285,282,50.26
Veigar,TOP,121,62,59,51.24
Veigar,,10,0,10,0
Vayne,BOTTOM,5279,2791,2488,52.87
Vayne,TOP,1042,547,495,52.5
Vayne,JUNGLE,47,19,28,40.43
Vayne,MIDDLE,125,76,49,60.8
Vayne,,6,0,6,0
Vayne,UTILITY,23,9,14,39.13
Seraphine,UTILITY,3303,1731,1572,52.41
Seraphine,MIDDLE,136,53,83,38.97
Seraphine,BOTTOM,273,131,142,47.99
Seraphine,,8,0,8,0
Seraphine,TOP,14,0,14,0
Seraphine,JUNGLE,2,0,2,0
Yone,TOP,3347,1615,1732,48.25
Yone,MIDDLE,5447,2680,2767,49.2
Yone,UTILITY,80,27,53,33.75
Yone,BOTTOM,212,106,106,50
Yone,JUNGLE,53,24,29,45.28
Yone,,7,0,7,0
Viego,JUNGLE,6680,3397,3283,50.85
Viego,TOP,59,29,30,49.15
Viego,MIDDLE,120,63,57,52.5
Viego,BOTTOM,18,8,10,44.44
Viego,UTILITY,12,6,6,50
Viego,,6,0,6,0
Yasuo,MIDDLE,7148,3662,3486,51.23
Yasuo,TOP,1272,610,662,47.96
Yasuo,BOTTOM,1451,691,760,47.62
Yasuo,JUNGLE,64,35,29,54.69
Yasuo,UTILITY,88,27,61,30.68
Yasuo,,6,0,6,0
Ezreal,BOTTOM,12215,6027,6188,49.34
Ezreal,,9,0,9,0
Ezreal,MIDDLE,378,150,228,39.68
Ezreal,JUNGLE,83,35,48,42.17
Ezreal,TOP,124,58,66,46.77
Ezreal,UTILITY,81,42,39,51.85
Lux,UTILITY,7228,3508,3720,48.53
Lux,MIDDLE,4042,1918,2124,47.45
Lux,BOTTOM,457,243,214,53.17
Lux,TOP,68,26,42,38.24
Lux,,5,0,5,0
Lux,JUNGLE,15,6,9,40
Mordekaiser,TOP,5711,2870,2841,50.25
Mordekaiser,JUNGLE,490,241,249,49.18
Mordekaiser,MIDDLE,220,109,111,49.55
Mordekaiser,BOTTOM,41,22,19,53.66
Mordekaiser,UTILITY,94,42,52,44.68
Mordekaiser,,6,0,6,0
Evelynn,JUNGLE,1500,754,746,50.27
Evelynn,TOP,20,8,12,40
Evelynn,UTILITY,12,10,2,83.33
Evelynn,BOTTOM,3,0,3,0
Evelynn,MIDDLE,12,7,5,58.33
Riven,MIDDLE,143,58,85,40.56
Riven,TOP,1901,982,919,51.66
Riven,BOTTOM,20,8,12,40
Riven,JUNGLE,39,22,17,56.41
Riven,UTILITY,17,9,8,52.94
MissFortune,BOTTOM,9887,5030,4857,50.87
MissFortune,UTILITY,232,102,130,43.97
MissFortune,MIDDLE,85,43,42,50.59
MissFortune,TOP,31,8,23,25.81
MissFortune,,4,0,4,0
MissFortune,JUNGLE,11,6,5,54.55
Swain,UTILITY,2877,1555,1322,54.05
Swain,MIDDLE,930,515,415,55.38
Swain,BOTTOM,836,442,394,52.87
Swain,TOP,391,240,151,61.38
Swain,,6,3,3,50
Swain,JUNGLE,13,0,13,0
Ahri,TOP,97,45,52,46.39
Ahri,MIDDLE,7006,3522,3484,50.27
Ahri,BOTTOM,76,51,25,67.11
Ahri,UTILITY,131,52,79,39.69
Kayn,JUNGLE,6080,2983,3097,49.06
Kayn,TOP,384,180,204,46.88
Kayn,MIDDLE,49,30,19,61.22
Kayn,BOTTOM,6,0,6,0
Kayn,,11,0,11,0
Kayn,UTILITY,8,3,5,37.5
Mel,MIDDLE,5595,2710,2885,48.44
Mel,BOTTOM,2103,1014,1089,48.22
Mel,UTILITY,2845,1365,1480,47.98
Mel,TOP,266,125,141,46.99
Mel,,6,0,6,0
Mel,JUNGLE,7,2,5,28.57
Caitlyn,BOTTOM,12911,6470,6441,50.11
Caitlyn,MIDDLE,177,65,112,36.72
Caitlyn,TOP,104,58,46,55.77
Caitlyn,UTILITY,69,21,48,30.43
Caitlyn,,8,0,8,0
Caitlyn,JUNGLE,3,0,3,0
Pyke,UTILITY,4292,2002,2290,46.64
Pyke,MIDDLE,84,32,52,38.1
Pyke,TOP,17,6,11,35.29
Pyke,,8,0,8,0
Pyke,JUNGLE,18,9,9,50
Pyke,BOTTOM,48,29,19,60.42
Gangplank,TOP,1947,891,1056,45.76
Gangplank,MIDDLE,389,195,194,50.13
Gangplank,UTILITY,3,0,3,0
Gangplank,BOTTOM,20,12,8,60
Gangplank,JUNGLE,8,8,0,100
Gangplank,,2,0,2,0
Irelia,MIDDLE,1842,883,959,47.94
Irelia,TOP,1908,923,985,48.38
Irelia,BOTTOM,107,62,45,57.94
Irelia,JUNGLE,19,9,10,47.37
Irelia,UTILITY,6,0,6,0
Irelia,,2,0,2,0
Kaisa,BOTTOM,7971,3810,4161,47.8
Kaisa,MIDDLE,165,86,79,52.12
Kaisa,TOP,94,42,52,44.68
Kaisa,JUNGLE,51,19,32,37.25
Kaisa,,11,6,5,54.55
Kaisa,UTILITY,25,7,18,28
Nautilus,UTILITY,6799,3437,3362,50.55
Nautilus,JUNGLE,103,41,62,39.81
Nautilus,TOP,157,63,94,40.13
Nautilus,MIDDLE,44,20,24,45.45
Nautilus,BOTTOM,10,8,2,80
Nautilus,,7,2,5,28.57
Urgot,TOP,2347,1178,1169,50.19
Urgot,JUNGLE,57,19,38,33.33
Urgot,BOTTOM,41,18,23,43.9
Urgot,MIDDLE,61,44,17,72.13
Urgot,,3,0,3,0
Urgot,UTILITY,8,8,0,100
Diana,JUNGLE,5145,2524,2621,49.06
Diana,MIDDLE,2220,1097,1123,49.41
Diana,TOP,86,51,35,59.3
Diana,,6,0,6,0
Diana,BOTTOM,8,3,5,37.5
Diana,UTILITY,23,12,11,52.17
Syndra,MIDDLE,3495,1714,1781,49.04
Syndra,UTILITY,72,32,40,44.44
Syndra,BOTTOM,144,78,66,54.17
Syndra,TOP,30,10,20,33.33
Braum,UTILITY,4093,2141,1952,52.31
Braum,,3,0,3,0
Braum,TOP,13,5,8,38.46
Braum,BOTTOM,8,3,5,37.5
Braum,MIDDLE,5,0,5,0
Teemo,TOP,3371,1691,1680,50.16
Teemo,JUNGLE,726,360,366,49.59
Teemo,MIDDLE,235,105,130,44.68
Teemo,BOTTOM,188,78,110,41.49
Teemo,UTILITY,441,238,203,53.97
Teemo,,8,0,8,0
Ryze,BOTTOM,32,9,23,28.13
Ryze,MIDDLE,1596,784,812,49.12
Ryze,TOP,417,212,205,50.84
Ryze,UTILITY,5,5,0,100
Ryze,JUNGLE,6,3,3,50
Jax,TOP,3324,1576,1748,47.41
Jax,JUNGLE,966,516,450,53.42
Jax,BOTTOM,28,4,24,14.29
Jax,UTILITY,76,39,37,51.32
Jax,MIDDLE,119,50,69,42.02
Jax,,6,0,6,0
Sejuani,JUNGLE,3118,1712,1406,54.91
Sejuani,TOP,155,83,72,53.55
Sejuani,UTILITY,85,39,46,45.88
Sejuani,MIDDLE,45,33,12,73.33
Sejuani,BOTTOM,6,0,6,0
Sejuani,,2,0,2,0
Hwei,MIDDLE,2657,1259,1398,47.38
Hwei,BOTTOM,404,212,192,52.48
Hwei,UTILITY,389,196,193,50.39
Hwei,TOP,41,12,29,29.27
Hwei,JUNGLE,3,0,3,0
Zac,UTILITY,229,113,116,49.34
Zac,JUNGLE,2587,1262,1325,48.78
Zac,TOP,350,172,178,49.14
Zac,MIDDLE,68,39,29,57.35
Zac,BOTTOM,7,5,2,71.43
Darius,TOP,6506,3275,3231,50.34
Darius,JUNGLE,2405,1324,1081,55.05
Darius,MIDDLE,132,65,67,49.24
Darius,UTILITY,54,30,24,55.56
Darius,BOTTOM,68,17,51,25
Darius,,8,0,8,0
JarvanIV,JUNGLE,3590,1888,1702,52.59
JarvanIV,BOTTOM,38,7,31,18.42
JarvanIV,MIDDLE,45,14,31,31.11
JarvanIV,TOP,94,48,46,51.06
JarvanIV,UTILITY,153,68,85,44.44
JarvanIV,,6,0,6,0
Xerath,MIDDLE,2285,1171,1114,51.25
Xerath,UTILITY,2076,1073,1003,51.69
Xerath,BOTTOM,154,91,63,59.09
Xerath,,6,0,6,0
Xerath,TOP,20,13,7,65
Xerath,JUNGLE,3,0,3,0
Yuumi,UTILITY,4010,2069,1941,51.6
Yuumi,TOP,6,0,6,0
Yuumi,JUNGLE,18,0,18,0
Yuumi,BOTTOM,20,8,12,40
Yuumi,,6,0,6,0
Chogath,TOP,4052,2126,1926,52.47
Chogath,MIDDLE,1847,1000,847,54.14
Chogath,JUNGLE,327,184,143,56.27
Chogath,BOTTOM,226,94,132,41.59
Chogath,UTILITY,262,141,121,53.82
Chogath,,3,0,3,0
Sivir,BOTTOM,2851,1507,1344,52.86
Sivir,JUNGLE,6,0,6,0
Sivir,MIDDLE,29,15,14,51.72
Sivir,TOP,14,6,8,42.86
Sivir,UTILITY,8,5,3,62.5
Ashe,UTILITY,644,271,373,42.08
Ashe,TOP,131,66,65,50.38
Ashe,BOTTOM,9353,4597,4756,49.15
Ashe,MIDDLE,79,38,41,48.1
Ashe,JUNGLE,5,2,3,40
Ashe,,5,0,5,0
Malphite,TOP,4080,2136,1944,52.35
Malphite,MIDDLE,744,359,385,48.25
Malphite,UTILITY,648,291,357,44.91
Malphite,JUNGLE,283,129,154,45.58
Malphite,BOTTOM,34,13,21,38.24
Malphite,,5,0,5,0
Lissandra,MIDDLE,1823,901,922,49.42
Lissandra,TOP,93,45,48,48.39
Lissandra,BOTTOM,22,3,19,13.64
Lissandra,UTILITY,81,48,33,59.26
Lissandra,,2,0,2,0
Lulu,UTILITY,7110,3575,3535,50.28
Lulu,BOTTOM,19,9,10,47.37
Lulu,JUNGLE,10,2,8,20
Lulu,TOP,52,16,36,30.77
Lulu,MIDDLE,71,30,41,42.25
Sett,TOP,6592,3390,3202,51.43
Sett,MIDDLE,321,171,150,53.27
Sett,JUNGLE,150,77,73,51.33
Sett,UTILITY,346,160,186,46.24
Sett,BOTTOM,125,72,53,57.6
Sett,,9,0,9,0
Katarina,MIDDLE,3121,1480,1641,47.42
Katarina,BOTTOM,72,44,28,61.11
Katarina,TOP,65,28,37,43.08
Katarina,UTILITY,20,9,11,45
Katarina,,6,0,6,0
Katarina,JUNGLE,3,0,3,0
Jinx,BOTTOM,12837,6946,5891,54.11
Jinx,JUNGLE,14,6,8,42.86
Jinx,MIDDLE,35,23,12,65.71
Jinx,TOP,23,8,15,34.78
Jinx,,11,0,11,0
Jinx,UTILITY,3,0,3,0
Renata,UTILITY,1216,624,592,51.32
Renata,MIDDLE,6,2,4,33.33
Renata,TOP,3,0,3,0
Renata,BOTTOM,12,0,12,0
Vladimir,TOP,1291,623,668,48.26
Vladimir,MIDDLE,1755,951,804,54.19
Vladimir,BOTTOM,48,24,24,50
Vladimir,JUNGLE,5,0,5,0
Vladimir,,3,3,0,100
Velkoz,MIDDLE,837,423,414,50.54
Velkoz,UTILITY,1861,928,933,49.87
Velkoz,BOTTOM,126,60,66,47.62
Velkoz,TOP,18,13,5,72.22
Velkoz,JUNGLE,5,3,2,60
Xayah,BOTTOM,3074,1549,1525,50.39
Xayah,MIDDLE,21,9,12,42.86
Xayah,UTILITY,8,8,0,100
Xayah,,6,0,6,0
Xayah,TOP,6,6,0,100
Leblanc,UTILITY,342,143,199,41.81
Leblanc,MIDDLE,2664,1281,1383,48.09
Leblanc,BOTTOM,32,11,21,34.38
Leblanc,TOP,56,29,27,51.79
Viktor,MIDDLE,4596,2332,2264,50.74
Viktor,BOTTOM,224,124,100,55.36
Viktor,TOP,140,76,64,54.29
Viktor,UTILITY,42,32,10,76.19
Viktor,,3,0,3,0
Viktor,JUNGLE,2,0,2,0
Graves,JUNGLE,3140,1686,1454,53.69
Graves,TOP,60,32,28,53.33
Graves,MIDDLE,79,36,43,45.57
Graves,UTILITY,12,6,6,50
Graves,BOTTOM,35,14,21,40
Graves,,2,0,2,0
XinZhao,JUNGLE,3062,1557,1505,50.85
XinZhao,TOP,171,78,93,45.61
XinZhao,MIDDLE,95,51,44,53.68
XinZhao,UTILITY,45,21,24,46.67
XinZhao,BOTTOM,30,12,18,40
XinZhao,,2,0,2,0
Morgana,MIDDLE,335,189,146,56.42
Morgana,UTILITY,4524,2359,2165,52.14
Morgana,BOTTOM,58,31,27,53.45
Morgana,JUNGLE,207,110,97,53.14
Morgana,TOP,68,45,23,66.18
Morgana,,5,0,5,0
Karma,UTILITY,5314,2647,2667,49.81
Karma,TOP,356,184,172,51.69
Karma,MIDDLE,406,211,195,51.97
Karma,BOTTOM,61,27,34,44.26
Karma,JUNGLE,12,6,6,50
Karma,,3,0,3,0
Sion,TOP,3240,1649,1591,50.9
Sion,UTILITY,356,183,173,51.4
Sion,BOTTOM,249,136,113,54.62
Sion,JUNGLE,284,142,142,50
Sion,MIDDLE,388,219,169,56.44
Sion,,3,0,3,0
Nocturne,JUNGLE,5840,2970,2870,50.86
Nocturne,TOP,63,33,30,52.38
Nocturne,,10,0,10,0
Nocturne,BOTTOM,4,4,0,100
Nocturne,MIDDLE,44,24,20,54.55
Nocturne,UTILITY,24,14,10,58.33
Jhin,BOTTOM,9548,4713,4835,49.36
Jhin,,14,0,14,0
Jhin,MIDDLE,133,79,54,59.4
Jhin,TOP,77,23,54,29.87
Jhin,UTILITY,45,17,28,37.78
Jhin,JUNGLE,39,12,27,30.77
Soraka,UTILITY,2309,1130,1179,48.94
Soraka,BOTTOM,18,0,18,0
Soraka,MIDDLE,27,13,14,48.15
Soraka,TOP,38,22,16,57.89
Soraka,JUNGLE,2,0,2,0
Pantheon,JUNGLE,3156,1586,1570,50.25
Pantheon,UTILITY,2774,1336,1438,48.16
Pantheon,TOP,1650,783,867,47.45
Pantheon,MIDDLE,840,447,393,53.21
Pantheon,BOTTOM,109,56,53,51.38
Pantheon,,3,0,3,0
Neeko,MIDDLE,549,267,282,48.63
Neeko,UTILITY,1719,829,890,48.23
Neeko,TOP,57,34,23,59.65
Neeko,JUNGLE,118,54,64,45.76
Neeko,BOTTOM,58,22,36,37.93
Neeko,,2,0,2,0
Varus,BOTTOM,4395,2163,2232,49.22
Varus,MIDDLE,250,108,142,43.2
Varus,TOP,387,177,210,45.74
Varus,UTILITY,40,14,26,35
Varus,,9,0,9,0
Varus,JUNGLE,10,5,5,50
Twitch,JUNGLE,165,64,101,38.79
Twitch,BOTTOM,3381,1710,1671,50.58
Twitch,UTILITY,144,57,87,39.58
Twitch,MIDDLE,43,19,24,44.19
Twitch,TOP,36,16,20,44.44
Twitch,,3,0,3,0
Galio,MIDDLE,4792,2447,2345,51.06
Galio,BOTTOM,87,31,56,35.63
Galio,UTILITY,718,351,367,48.89
Galio,JUNGLE,39,16,23,41.03
Galio,TOP,244,119,125,48.77
Galio,,5,2,3,40
Hecarim,JUNGLE,1799,873,926,48.53
Hecarim,TOP,15,6,9,40
Hecarim,MIDDLE,6,3,3,50
Hecarim,BOTTOM,5,2,3,40
Hecarim,UTILITY,8,0,8,0
Hecarim,,3,0,3,0
Shen,TOP,2914,1478,1436,50.72
Shen,UTILITY,637,353,284,55.42
Shen,MIDDLE,183,99,84,54.1
Shen,JUNGLE,199,116,83,58.29
Shen,BOTTOM,8,3,5,37.5
Nami,UTILITY,5233,2720,2513,51.98
Nami,TOP,2,2,0,100
Nami,MIDDLE,10,5,5,50
Gragas,JUNGLE,1683,754,929,44.8
Gragas,TOP,1713,847,866,49.45
Gragas,MIDDLE,301,138,163,45.85
Gragas,UTILITY,201,84,117,41.79
Gragas,BOTTOM,31,16,15,51.61
Gragas,,2,0,2,0
Samira,BOTTOM,3876,1927,1949,49.72
Samira,JUNGLE,18,3,15,16.67
Samira,MIDDLE,66,34,32,51.52
Samira,TOP,16,5,11,31.25
Samira,UTILITY,20,8,12,40
Samira,,4,2,2,50
Lillia,JUNGLE,2822,1466,1356,51.95
Lillia,TOP,99,38,61,38.38
Lillia,,3,0,3,0
Lillia,UTILITY,13,3,10,23.08
Lillia,MIDDLE,6,3,3,50
Tryndamere,MIDDLE,127,61,66,48.03
Tryndamere,TOP,1575,807,768,51.24
Tryndamere,JUNGLE,160,55,105,34.38
Tryndamere,BOTTOM,27,14,13,51.85
Tryndamere,,2,0,2,0
Tryndamere,UTILITY,3,3,0,100
Yorick,TOP,2856,1508,1348,52.8
Yorick,BOTTOM,35,7,28,20
Yorick,JUNGLE,1209,619,590,51.2
Yorick,MIDDLE,128,70,58,54.69
Yorick,UTILITY,46,19,27,41.3
DrMundo,TOP,2377,1188,1189,49.98
DrMundo,MIDDLE,58,33,25,56.9
DrMundo,JUNGLE,260,133,127,51.15
DrMundo,UTILITY,41,17,24,41.46
DrMundo,,2,0,2,0
DrMundo,BOTTOM,15,6,9,40
TwistedFate,UTILITY,116,63,53,54.31
TwistedFate,MIDDLE,1572,775,797,49.3
TwistedFate,BOTTOM,68,28,40,41.18
TwistedFate,TOP,53,23,30,43.4
TwistedFate,JUNGLE,21,6,15,28.57
TwistedFate,,3,0,3,0
Vi,JUNGLE,5521,2818,2703,51.04
Vi,TOP,259,110,149,42.47
Vi,MIDDLE,98,73,25,74.49
Vi,UTILITY,78,41,37,52.56
Vi,BOTTOM,28,22,6,78.57
Vi,,8,0,8,0
Senna,UTILITY,2869,1420,1449,49.49
Senna,BOTTOM,159,53,106,33.33
Senna,TOP,39,10,29,25.64
Senna,MIDDLE,21,12,9,57.14
Senna,,2,0,2,0
Senna,JUNGLE,9,0,9,0
Udyr,JUNGLE,1589,707,882,44.49
Udyr,UTILITY,14,9,5,64.29
Udyr,TOP,315,128,187,40.63
Udyr,MIDDLE,32,20,12,62.5
Smolder,BOTTOM,2802,1436,1366,51.25
Smolder,MIDDLE,658,303,355,46.05
Smolder,UTILITY,25,8,17,32
Smolder,JUNGLE,6,3,3,50
Smolder,TOP,313,152,161,48.56
Smolder,,2,0,2,0
TahmKench,UTILITY,2616,1337,1279,51.11
TahmKench,TOP,1920,1004,916,52.29
TahmKench,BOTTOM,182,96,86,52.75
TahmKench,JUNGLE,28,9,19,32.14
TahmKench,MIDDLE,69,33,36,47.83
TahmKench,,3,0,3,0
Shaco,JUNGLE,3130,1438,1692,45.94
Shaco,TOP,191,95,96,49.74
Shaco,MIDDLE,36,14,22,38.89
Shaco,,3,0,3,0
Shaco,UTILITY,572,309,263,54.02
Shaco,BOTTOM,18,13,5,72.22
Azir,MIDDLE,2133,1042,1091,48.85
Azir,UTILITY,32,11,21,34.38
Azir,TOP,91,38,53,41.76
Azir,BOTTOM,51,14,37,27.45
Azir,,2,0,2,0
Azir,JUNGLE,2,0,2,0
Sylas,UTILITY,613,320,293,52.2
Sylas,MIDDLE,5922,2847,3075,48.07
Sylas,TOP,733,365,368,49.8
Sylas,JUNGLE,442,209,233,47.29
Sylas,BOTTOM,153,61,92,39.87
Sylas,,8,0,8,0
Renekton,TOP,2614,1266,1348,48.43
Renekton,JUNGLE,16,5,11,31.25
Renekton,MIDDLE,236,140,96,59.32
Renekton,BOTTOM,20,11,9,55
Renekton,UTILITY,9,3,6,33.33
Qiyana,MIDDLE,894,416,478,46.53
Qiyana,TOP,62,30,32,48.39
Qiyana,JUNGLE,187,88,99,47.06
Qiyana,BOTTOM,18,8,10,44.44
Qiyana,UTILITY,12,7,5,58.33
Qiyana,,2,0,2,0
Fiora,TOP,1840,933,907,50.71
Fiora,MIDDLE,52,17,35,32.69
Fiora,JUNGLE,7,7,0,100
Fiora,UTILITY,8,2,6,25
Fiora,BOTTOM,6,2,4,33.33
Fiora,,3,0,3,0
Nilah,BOTTOM,1783,940,843,52.72
Nilah,TOP,15,9,6,60
Nilah,JUNGLE,2,0,2,0
Nilah,MIDDLE,15,8,7,53.33
Nilah,,3,0,3,0
Nilah,UTILITY,8,2,6,25
Leona,UTILITY,5344,2652,2692,49.63
Leona,MIDDLE,8,6,2,75
Leona,TOP,27,8,19,29.63
Leona,BOTTOM,22,12,10,54.55
Leona,JUNGLE,10,3,7,30
Leona,,3,0,3,0
Garen,TOP,6808,3580,3228,52.59
Garen,MIDDLE,775,434,341,56
Garen,JUNGLE,303,169,134,55.78
Garen,UTILITY,35,8,27,22.86
Garen,BOTTOM,49,23,26,46.94
Garen,,7,0,7,0
Zed,JUNGLE,941,470,471,49.95
Zed,MIDDLE,4083,2028,2055,49.67
Zed,TOP,155,93,62,60
Zed,BOTTOM,72,35,37,48.61
Zed,,4,0,4,0
Zed,UTILITY,36,21,15,58.33
Akali,MIDDLE,4157,2028,2129,48.79
Akali,TOP,825,367,458,44.48
Akali,BOTTOM,20,0,20,0
Akali,UTILITY,36,18,18,50
Akali,,3,0,3,0
Maokai,TOP,455,211,244,46.37
Maokai,UTILITY,1571,789,782,50.22
Maokai,JUNGLE,464,231,233,49.78
Maokai,BOTTOM,19,13,6,68.42
Maokai,MIDDLE,20,2,18,10
Maokai,,3,0,3,0
Rakan,UTILITY,3003,1527,1476,50.85
Rakan,BOTTOM,9,6,3,66.67
Rakan,MIDDLE,41,14,27,34.15
Rakan,,3,0,3,0
Rakan,TOP,9,7,2,77.78
Rakan,JUNGLE,6,0,6,0
Draven,BOTTOM,2522,1231,1291,48.81
Draven,UTILITY,21,15,6,71.43
Draven,MIDDLE,50,18,32,36
Draven,JUNGLE,16,3,13,18.75
Draven,TOP,59,34,25,57.63
Draven,,2,0,2,0
Warwick,TOP,1805,984,821,54.52
Warwick,JUNGLE,5040,2587,2453,51.33
Warwick,MIDDLE,33,23,10,69.7
Warwick,BOTTOM,9,5,4,55.56
Warwick,UTILITY,19,7,12,36.84
Warwick,,3,0,3,0
Kayle,TOP,2337,1241,1096,53.1
Kayle,MIDDLE,398,221,177,55.53
Kayle,UTILITY,53,16,37,30.19
Kayle,JUNGLE,17,12,5,70.59
Kayle,BOTTOM,36,15,21,41.67
Kayle,,6,0,6,0
Kindred,JUNGLE,2132,956,1176,44.84
Kindred,TOP,9,2,7,22.22
Kindred,MIDDLE,28,8,20,28.57
Kindred,BOTTOM,45,14,31,31.11
Kindred,UTILITY,6,0,6,0
AurelionSol,MIDDLE,1863,985,878,52.87
AurelionSol,BOTTOM,95,66,29,69.47
AurelionSol,TOP,89,40,49,44.94
AurelionSol,UTILITY,56,22,34,39.29
AurelionSol,JUNGLE,14,11,3,78.57
LeeSin,JUNGLE,8587,4077,4510,47.48
LeeSin,TOP,226,92,134,40.71
LeeSin,MIDDLE,114,45,69,39.47
LeeSin,UTILITY,198,103,95,52.02
LeeSin,BOTTOM,36,14,22,38.89
LeeSin,,5,0,5,0
Elise,JUNGLE,2282,1133,1149,49.65
Elise,UTILITY,1858,939,919,50.54
Elise,TOP,84,25,59,29.76
Elise,MIDDLE,21,12,9,57.14
Elise,BOTTOM,14,7,7,50
Elise,,9,0,9,0
Malzahar,MIDDLE,4980,2561,2419,51.43
Malzahar,TOP,180,89,91,49.44
Malzahar,JUNGLE,20,7,13,35
Malzahar,BOTTOM,118,55,63,46.61
Malzahar,,10,0,10,0
Malzahar,UTILITY,56,23,33,41.07
Milio,UTILITY,3438,1813,1625,52.73
Milio,MIDDLE,13,3,10,23.08
Milio,TOP,20,5,15,25
Milio,BOTTOM,2,0,2,0
Ornn,TOP,2916,1483,1433,50.86
Ornn,JUNGLE,47,22,25,46.81
Ornn,BOTTOM,30,15,15,50
Ornn,MIDDLE,106,43,63,40.57
Ornn,UTILITY,112,52,60,46.43
Tristana,BOTTOM,4075,2004,2071,49.18
Tristana,MIDDLE,457,235,222,51.42
Tristana,TOP,59,21,38,35.59
Tristana,JUNGLE,22,11,11,50
Tristana,,6,0,6,0
Tristana,UTILITY,22,3,19,13.64
Poppy,JUNGLE,674,323,351,47.92
Poppy,UTILITY,2258,1134,1124,50.22
Poppy,TOP,885,458,427,51.75
Poppy,MIDDLE,35,19,16,54.29
Poppy,BOTTOM,20,15,5,75
Ziggs,BOTTOM,1275,663,612,52
Ziggs,UTILITY,180,97,83,53.89
Ziggs,MIDDLE,468,214,254,45.73
Ziggs,TOP,28,8,20,28.57
Ekko,MIDDLE,1806,934,872,51.72
Ekko,JUNGLE,2382,1232,1150,51.72
Ekko,UTILITY,38,22,16,57.89
Ekko,TOP,61,28,33,45.9
Ekko,BOTTOM,17,7,10,41.18
Ivern,JUNGLE,927,437,490,47.14
Ivern,UTILITY,139,55,84,39.57
Ivern,MIDDLE,31,15,16,48.39
Ivern,TOP,37,20,17,54.05
Ivern,BOTTOM,26,6,20,23.08
Lucian,BOTTOM,4118,1948,2170,47.3
Lucian,MIDDLE,207,70,137,33.82
Lucian,TOP,74,25,49,33.78
Lucian,JUNGLE,11,3,8,27.27
Lucian,UTILITY,25,8,17,32
Blitzcrank,UTILITY,4898,2410,2488,49.2
Blitzcrank,JUNGLE,50,12,38,24
Blitzcrank,BOTTOM,30,12,18,40
Blitzcrank,MIDDLE,21,5,16,23.81
Blitzcrank,TOP,28,8,20,28.57
Blitzcrank,,3,0,3,0
FiddleSticks,JUNGLE,1886,960,926,50.9
FiddleSticks,UTILITY,272,159,113,58.46
FiddleSticks,TOP,94,66,28,70.21
FiddleSticks,MIDDLE,44,26,18,59.09
FiddleSticks,BOTTOM,11,6,5,54.55
Aurora,MIDDLE,3235,1583,1652,48.93
Aurora,TOP,789,392,397,49.68
Aurora,JUNGLE,21,8,13,38.1
Aurora,BOTTOM,82,36,46,43.9
Aurora,UTILITY,79,29,50,36.71
Aurora,,3,0,3,0
Rammus,JUNGLE,1694,837,857,49.41
Rammus,TOP,135,62,73,45.93
Rammus,UTILITY,36,22,14,61.11
Rammus,BOTTOM,21,10,11,47.62
Rammus,MIDDLE,7,3,4,42.86
Annie,MIDDLE,1338,703,635,52.54
Annie,JUNGLE,6,6,0,100
Annie,BOTTOM,46,20,26,43.48
Annie,UTILITY,185,89,96,48.11
Annie,TOP,63,25,38,39.68
Olaf,TOP,1093,555,538,50.78
Olaf,JUNGLE,210,119,91,56.67
Olaf,MIDDLE,31,12,19,38.71
Olaf,BOTTOM,23,18,5,78.26
Olaf,,3,0,3,0
Olaf,UTILITY,10,10,0,100
Corki,TOP,29,6,23,20.69
Corki,BOTTOM,2058,952,1106,46.26
Corki,MIDDLE,388,201,187,51.8
Corki,JUNGLE,10,5,5,50
Corki,UTILITY,6,6,0,100
MonkeyKing,JUNGLE,2901,1522,1379,52.46
MonkeyKing,TOP,622,355,267,57.07
MonkeyKing,UTILITY,63,35,28,55.56
MonkeyKing,MIDDLE,86,46,40,53.49
MonkeyKing,BOTTOM,19,11,8,57.89
Quinn,TOP,1228,599,629,48.78
Quinn,MIDDLE,390,237,153,60.77
Quinn,BOTTOM,82,34,48,41.46
Quinn,JUNGLE,47,20,27,42.55
Quinn,UTILITY,42,13,29,30.95
Nasus,TOP,2603,1359,1244,52.21
Nasus,MIDDLE,250,118,132,47.2
Nasus,BOTTOM,24,14,10,58.33
Nasus,UTILITY,44,13,31,29.55
Nasus,JUNGLE,242,114,128,47.11
Kled,TOP,887,437,450,49.27
Kled,MIDDLE,51,33,18,64.71
Kled,UTILITY,29,13,16,44.83
Kled,JUNGLE,7,2,5,28.57
Kled,BOTTOM,2,2,0,100
Thresh,UTILITY,9117,4521,4596,49.59
Thresh,TOP,77,39,38,50.65
Thresh,JUNGLE,16,2,14,12.5
Thresh,MIDDLE,29,17,12,58.62
Thresh,BOTTOM,43,18,25,41.86
Thresh,,3,0,3,0
Nunu,MIDDLE,161,97,64,60.25
Nunu,JUNGLE,3166,1484,1682,46.87
Nunu,UTILITY,90,24,66,26.67
Nunu,TOP,19,12,7,63.16
Nunu,BOTTOM,2,2,0,100
Nunu,,3,0,3,0
Heimerdinger,TOP,1299,596,703,45.88
Heimerdinger,MIDDLE,546,295,251,54.03
Heimerdinger,UTILITY,188,83,105,44.15
Heimerdinger,BOTTOM,207,101,106,48.79
Heimerdinger,JUNGLE,15,5,10,33.33
Rell,UTILITY,3499,1722,1777,49.21
Rell,JUNGLE,38,18,20,47.37
Rell,TOP,57,31,26,54.39
Rell,MIDDLE,9,6,3,66.67
Rell,BOTTOM,3,0,3,0
Rengar,JUNGLE,1319,597,722,45.26
Rengar,TOP,180,82,98,45.56
Rengar,BOTTOM,84,34,50,40.48
Rengar,UTILITY,24,7,17,29.17
Rengar,MIDDLE,3,3,0,100
Anivia,MIDDLE,1433,781,652,54.5
Anivia,UTILITY,202,94,108,46.53
Anivia,BOTTOM,100,51,49,51
Anivia,TOP,105,59,46,56.19
RekSai,JUNGLE,688,330,358,47.97
RekSai,TOP,43,22,21,51.16
RekSai,UTILITY,5,2,3,40
RekSai,,3,0,3,0
RekSai,MIDDLE,6,3,3,50
KogMaw,BOTTOM,1531,791,740,51.67
KogMaw,MIDDLE,59,25,34,42.37
KogMaw,,3,0,3,0
KogMaw,TOP,10,5,5,50
KogMaw,UTILITY,17,7,10,41.18
KogMaw,JUNGLE,3,0,3,0
Aatrox,TOP,4860,2390,2470,49.18
Aatrox,JUNGLE,68,19,49,27.94
Aatrox,MIDDLE,186,96,90,51.61
Aatrox,BOTTOM,33,12,21,36.36
Aatrox,UTILITY,59,23,36,38.98
MasterYi,JUNGLE,4797,2361,2436,49.22
MasterYi,TOP,113,56,57,49.56
MasterYi,,11,0,11,0
MasterYi,MIDDLE,54,17,37,31.48
MasterYi,UTILITY,20,3,17,15
MasterYi,BOTTOM,15,7,8,46.67
Jayce,TOP,1994,980,1014,49.15
Jayce,MIDDLE,521,273,248,52.4
Jayce,BOTTOM,57,25,32,43.86
Jayce,UTILITY,24,0,24,0
Jayce,,6,0,6,0
Jayce,JUNGLE,9,6,3,66.67
Zoe,MIDDLE,1714,789,925,46.03
Zoe,UTILITY,346,185,161,53.47
Zoe,BOTTOM,53,31,22,58.49
Zoe,TOP,35,24,11,68.57
Zoe,JUNGLE,6,3,3,50
Kennen,TOP,1221,555,666,45.45
Kennen,MIDDLE,280,167,113,59.64
Kennen,UTILITY,57,34,23,59.65
Kennen,BOTTOM,41,19,22,46.34
Gnar,TOP,2650,1199,1451,45.25
Gnar,MIDDLE,40,29,11,72.5
Gnar,BOTTOM,23,9,14,39.13
Gnar,UTILITY,14,5,9,35.71
Gnar,JUNGLE,10,3,7,30
Gnar,,3,0,3,0
Amumu,UTILITY,423,217,206,51.3
Amumu,JUNGLE,5698,3107,2591,54.53
Amumu,,6,0,6,0
Amumu,TOP,29,22,7,75.86
Amumu,BOTTOM,8,0,8,0
Amumu,MIDDLE,23,8,15,34.78
Shyvana,JUNGLE,1192,662,530,55.54
Shyvana,TOP,65,45,20,69.23
Shyvana,MIDDLE,7,5,2,71.43
Shyvana,BOTTOM,3,3,0,100
Shyvana,UTILITY,6,3,3,50
Shyvana,,3,0,3,0
Zyra,UTILITY,2421,1259,1162,52
Zyra,JUNGLE,1366,680,686,49.78
Zyra,MIDDLE,192,87,105,45.31
Zyra,TOP,34,11,23,32.35
Zyra,BOTTOM,77,35,42,45.45
Kassadin,MIDDLE,1007,536,471,53.23
Kassadin,JUNGLE,5,0,5,0
Kassadin,TOP,36,19,17,52.78
Taliyah,UTILITY,77,40,37,51.95
Taliyah,MIDDLE,969,456,513,47.06
Taliyah,JUNGLE,289,162,127,56.06
Taliyah,BOTTOM,64,25,39,39.06
Taliyah,,3,0,3,0
Taliyah,TOP,14,10,4,71.43
Trundle,TOP,1916,931,985,48.59
Trundle,JUNGLE,700,358,342,51.14
Trundle,BOTTOM,26,13,13,50
Trundle,UTILITY,39,16,23,41.03
Trundle,,6,0,6,0
Trundle,MIDDLE,39,16,23,41.03
Belveth,JUNGLE,1011,509,502,50.35
Belveth,BOTTOM,9,0,9,0
Belveth,MIDDLE,13,2,11,15.38
Belveth,UTILITY,8,8,0,100
Belveth,TOP,7,2,5,28.57
Taric,UTILITY,1080,569,511,52.69
Taric,TOP,31,10,21,32.26
Taric,JUNGLE,47,29,18,61.7
Taric,BOTTOM,21,6,15,28.57
Zilean,UTILITY,1386,733,653,52.89
Zilean,MIDDLE,144,68,76,47.22
Zilean,BOTTOM,13,0,13,0
Zilean,TOP,56,41,15,73.21
Orianna,MIDDLE,2629,1341,1288,51.01
Orianna,BOTTOM,46,25,21,54.35
Orianna,UTILITY,54,32,22,59.26
Orianna,TOP,30,18,12,60
Orianna,,3,0,3,0
Talon,MIDDLE,1206,579,627,48.01
Talon,JUNGLE,1356,616,740,45.43
Talon,BOTTOM,7,2,5,28.57
Talon,UTILITY,18,2,16,11.11
Talon,TOP,52,21,31,40.38
Talon,,6,0,6,0
Cassiopeia,TOP,293,149,144,50.85
Cassiopeia,MIDDLE,1042,565,477,54.22
Cassiopeia,BOTTOM,135,72,63,53.33
Cassiopeia,UTILITY,10,8,2,80
Cassiopeia,,3,0,3,0
Illaoi,TOP,2429,1225,1204,50.43
Illaoi,BOTTOM,13,0,13,0
Illaoi,JUNGLE,5,3,2,60
Illaoi,UTILITY,46,24,22,52.17
Illaoi,MIDDLE,57,23,34,40.35
Briar,JUNGLE,2678,1415,1263,52.84
Briar,TOP,127,75,52,59.06
Briar,MIDDLE,84,45,39,53.57
Briar,UTILITY,52,22,30,42.31
Briar,BOTTOM,32,16,16,50
Karthus,JUNGLE,1112,534,578,48.02
Karthus,UTILITY,23,8,15,34.78
Karthus,BOTTOM,110,73,37,66.36
Karthus,MIDDLE,64,41,23,64.06
Karthus,TOP,20,5,15,25
Karthus,,3,0,3,0
Aphelios,BOTTOM,2904,1444,1460,49.72
Aphelios,TOP,28,9,19,32.14
Aphelios,MIDDLE,42,28,14,66.67
Aphelios,,3,0,3,0
Aphelios,UTILITY,7,2,5,28.57
Naafiri,MIDDLE,1151,579,572,50.3
Naafiri,TOP,129,67,62,51.94
Naafiri,JUNGLE,212,102,110,48.11
Naafiri,BOTTOM,33,11,22,33.33
Naafiri,UTILITY,27,13,14,48.15
Singed,JUNGLE,92,40,52,43.48
Singed,UTILITY,79,36,43,45.57
Singed,TOP,1076,603,473,56.04
Singed,MIDDLE,75,33,42,44
Singed,BOTTOM,31,10,21,32.26
Akshan,MIDDLE,1370,685,685,50
Akshan,BOTTOM,146,68,78,46.58
Akshan,TOP,110,43,67,39.09
Akshan,UTILITY,21,6,15,28.57
Alistar,UTILITY,2818,1424,1394,50.53
Alistar,MIDDLE,39,14,25,35.9
Alistar,TOP,94,41,53,43.62
Alistar,JUNGLE,12,3,9,25
Alistar,,3,0,3,0
Alistar,BOTTOM,11,6,5,54.55
Khazix,JUNGLE,2569,1238,1331,48.19
Khazix,UTILITY,8,8,0,100
Khazix,TOP,25,15,10,60
Khazix,MIDDLE,20,15,5,75
Khazix,,2,0,2,0
Gwen,TOP,1760,862,898,48.98
Gwen,JUNGLE,815,442,373,54.23
Gwen,MIDDLE,70,40,30,57.14
Gwen,UTILITY,7,0,7,0
Gwen,BOTTOM,7,2,5,28.57
KSante,TOP,3066,1450,1616,47.29
KSante,UTILITY,35,11,24,31.43
KSante,MIDDLE,136,51,85,37.5
KSante,BOTTOM,40,13,27,32.5
KSante,,3,0,3,0
KSante,JUNGLE,13,3,10,23.08
Bard,UTILITY,1649,829,820,50.27
Bard,MIDDLE,20,14,6,70
Bard,BOTTOM,17,8,9,47.06
Bard,TOP,24,13,11,54.17
Bard,JUNGLE,6,0,6,0
Skarner,JUNGLE,2295,1159,1136,50.5
Skarner,TOP,123,47,76,38.21
Skarner,,3,0,3,0
Skarner,UTILITY,40,25,15,62.5
Skarner,MIDDLE,10,3,7,30
Sona,UTILITY,935,467,468,49.95
Sona,BOTTOM,14,6,8,42.86
Sona,TOP,3,0,3,0
Sona,MIDDLE,8,3,5,37.5
Camille,UTILITY,266,122,144,45.86
Camille,TOP,1702,881,821,51.76
Camille,MIDDLE,80,37,43,46.25
Camille,JUNGLE,25,2,23,8
Camille,BOTTOM,12,3,9,25
Camille,,3,0,3,0
Vex,MIDDLE,2827,1459,1368,51.61
Vex,UTILITY,40,33,7,82.5
Vex,TOP,44,18,26,40.91
Vex,BOTTOM,34,22,12,64.71
Vex,,3,0,3,0
Fizz,TOP,67,38,29,56.72
Fizz,MIDDLE,2310,1093,1217,47.32
Fizz,JUNGLE,30,12,18,40
Fizz,UTILITY,43,21,22,48.84
Fizz,BOTTOM,12,5,7,41.67
Fizz,,2,0,2,0
Janna,UTILITY,1581,858,723,54.27
Janna,TOP,18,8,10,44.44
Janna,BOTTOM,3,0,3,0
Janna,MIDDLE,8,5,3,62.5
Nidalee,JUNGLE,1586,686,900,43.25
Nidalee,TOP,83,24,59,28.92
Nidalee,BOTTOM,23,14,9,60.87
Nidalee,UTILITY,138,54,84,39.13
Nidalee,MIDDLE,42,29,13,69.05
Nidalee,,3,0,3,0
Brand,UTILITY,1835,821,1014,44.74
Brand,MIDDLE,591,304,287,51.44
Brand,BOTTOM,286,155,131,54.2
Brand,JUNGLE,176,108,68,61.36
Brand,TOP,34,21,13,61.76
Brand,,5,0,5,0
Kalista,BOTTOM,1615,742,873,45.94
Kalista,TOP,66,29,37,43.94
Kalista,MIDDLE,19,15,4,78.95
Kalista,UTILITY,32,5,27,15.63
Kalista,JUNGLE,6,0,6,0
Zeri,BOTTOM,2260,1144,1116,50.62
Zeri,JUNGLE,36,24,12,66.67
Zeri,MIDDLE,62,45,17,72.58
Zeri,TOP,31,5,26,16.13
Zeri,UTILITY,3,0,3,0
Rumble,TOP,1295,604,691,46.64
Rumble,JUNGLE,137,62,75,45.26
Rumble,UTILITY,56,36,20,64.29
Rumble,MIDDLE,104,46,58,44.23
Rumble,BOTTOM,11,6,5,54.55
