Name,Role,Games,Wins,Losses,WR
Singed,TOP,7091,3670,3421,51.76
Singed,JUNGLE,486,211,275,43.42
Singed,MIDDLE,378,235,143,62.17
Singed,UTILITY,371,161,210,43.4
Singed,BOTTOM,179,97,82,54.19
Singed,,8,2,6,25
LeeSin,JUNGLE,45435,21988,23447,48.39
LeeSin,MIDDLE,494,239,255,48.38
LeeSin,TOP,1083,517,566,47.74
LeeSin,,33,3,30,9.09
LeeSin,UTILITY,864,366,498,42.36
LeeSin,BOTTOM,99,59,40,59.6
Yasuo,MIDDLE,47277,23748,23529,50.23
Yasuo,TOP,8335,4147,4188,49.75
Yasuo,BOTTOM,5078,2638,2440,51.95
Yasuo,,64,8,56,12.5
Yasuo,JUNGLE,205,79,126,38.54
Yasuo,UTILITY,311,103,208,33.12
Caitlyn,BOTTOM,83326,42016,41310,50.42
Caitlyn,MIDDLE,1196,563,633,47.07
Caitlyn,TOP,710,304,406,42.82
Caitlyn,UTILITY,373,129,244,34.58
Caitlyn,,82,6,76,7.32
Caitlyn,JUNGLE,19,2,17,10.53
Yuumi,UTILITY,23877,11698,12179,48.99
Yuumi,,23,0,23,0
Yuumi,JUNGLE,97,4,93,4.12
Yuumi,TOP,50,10,40,20
Yuumi,MIDDLE,73,10,63,13.7
Yuumi,BOTTOM,84,16,68,19.05
Chogath,TOP,21276,10799,10477,50.76
Chogath,MIDDLE,10821,5796,5025,53.56
Chogath,UTILITY,2032,1009,1023,49.66
Chogath,JUNGLE,1905,877,1028,46.04
Chogath,BOTTOM,546,299,247,54.76
Chogath,,15,0,15,0
Viego,JUNGLE,44246,22220,22026,50.22
Viego,MIDDLE,599,302,297,50.42
Viego,TOP,358,184,174,51.4
Viego,UTILITY,116,52,64,44.83
Viego,,40,0,40,0
Viego,BOTTOM,34,15,19,44.12
Galio,MIDDLE,21359,11056,10303,51.76
Galio,UTILITY,4426,2174,2252,49.12
Galio,TOP,1210,620,590,51.24
Galio,JUNGLE,107,31,76,28.97
Galio,BOTTOM,128,53,75,41.41
Galio,,23,2,21,8.7
Sivir,BOTTOM,16177,8167,8010,50.49
Sivir,TOP,77,35,42,45.45
Sivir,MIDDLE,176,93,83,52.84
Sivir,JUNGLE,10,3,7,30
Sivir,,11,0,11,0
Sivir,UTILITY,48,32,16,66.67
Pyke,UTILITY,24256,11792,12464,48.61
Pyke,MIDDLE,415,203,212,48.92
Pyke,TOP,36,11,25,30.56
Pyke,,33,5,28,15.15
Pyke,JUNGLE,40,11,29,27.5
Pyke,BOTTOM,65,39,26,60
Jax,TOP,21431,10495,10936,48.97
Jax,JUNGLE,7186,3534,3652,49.18
Jax,UTILITY,313,134,179,42.81
Jax,MIDDLE,486,239,247,49.18
Jax,,53,3,50,5.66
Jax,BOTTOM,82,36,46,43.9
Nocturne,JUNGLE,38959,20589,18370,52.85
Nocturne,TOP,466,224,242,48.07
Nocturne,MIDDLE,328,182,146,55.49
Nocturne,UTILITY,58,17,41,29.31
Nocturne,,38,0,38,0
Nocturne,BOTTOM,10,0,10,0
Syndra,MIDDLE,18456,9368,9088,50.76
Syndra,UTILITY,487,224,263,46
Syndra,BOTTOM,505,242,263,47.92
Syndra,JUNGLE,24,3,21,12.5
Syndra,TOP,266,141,125,53.01
Syndra,,11,0,11,0
Smolder,BOTTOM,14041,6827,7214,48.62
Smolder,MIDDLE,3139,1444,1695,46
Smolder,TOP,1640,717,923,43.72
Smolder,UTILITY,149,40,109,26.85
Smolder,JUNGLE,13,7,6,53.85
Smolder,,8,0,8,0
Zyra,UTILITY,19435,10169,9266,52.32
Zyra,JUNGLE,9245,4533,4712,49.03
Zyra,MIDDLE,928,466,462,50.22
Zyra,BOTTOM,326,193,133,59.2
Zyra,TOP,141,65,76,46.1
Zyra,,20,0,20,0
Gragas,TOP,9025,4356,4669,48.27
Gragas,JUNGLE,5393,2504,2889,46.43
Gragas,UTILITY,880,422,458,47.95
Gragas,MIDDLE,1417,760,657,53.63
Gragas,BOTTOM,29,19,10,65.52
Gragas,,8,0,8,0
Kayn,JUNGLE,42553,21587,20966,50.73
Kayn,,45,0,45,0
Kayn,TOP,1894,910,984,48.05
Kayn,MIDDLE,125,45,80,36
Kayn,UTILITY,70,29,41,41.43
Kayn,BOTTOM,25,15,10,60
Mel,MIDDLE,30303,14348,15955,47.35
Mel,UTILITY,19887,9308,10579,46.8
Mel,TOP,1384,650,734,46.97
Mel,BOTTOM,9890,4881,5009,49.35
Mel,JUNGLE,60,15,45,25
Mel,,53,3,50,5.66
Jinx,BOTTOM,88523,45490,43033,51.39
Jinx,MIDDLE,299,138,161,46.15
Jinx,UTILITY,117,44,73,37.61
Jinx,TOP,111,55,56,49.55
Jinx,,50,10,40,20
Jinx,JUNGLE,10,5,5,50
Thresh,UTILITY,40676,20628,20048,50.71
Thresh,TOP,192,75,117,39.06
Thresh,MIDDLE,100,31,69,31
Thresh,BOTTOM,93,43,50,46.24
Thresh,,52,0,52,0
Thresh,JUNGLE,24,6,18,25
Garen,TOP,43279,22341,20938,51.62
Garen,MIDDLE,4271,2205,2066,51.63
Garen,JUNGLE,1928,794,1134,41.18
Garen,,37,3,34,8.11
Garen,BOTTOM,180,96,84,53.33
Garen,UTILITY,164,56,108,34.15
Diana,JUNGLE,33045,16961,16084,51.33
Diana,MIDDLE,16578,8373,8205,50.51
Diana,TOP,607,272,335,44.81
Diana,UTILITY,141,66,75,46.81
Diana,BOTTOM,67,32,35,47.76
Diana,,29,0,29,0
Sylas,MIDDLE,33925,16534,17391,48.74
Sylas,JUNGLE,2486,1144,1342,46.02
Sylas,TOP,3976,1920,2056,48.29
Sylas,UTILITY,3566,1773,1793,49.72
Sylas,BOTTOM,393,167,226,42.49
Sylas,,23,0,23,0
Kaisa,BOTTOM,49713,24228,25485,48.74
Kaisa,JUNGLE,212,90,122,42.45
Kaisa,,46,6,40,13.04
Kaisa,MIDDLE,911,390,521,42.81
Kaisa,TOP,423,183,240,43.26
Kaisa,UTILITY,163,55,108,33.74
Yorick,TOP,20994,11039,9955,52.58
Yorick,MIDDLE,1064,603,461,56.67
Yorick,JUNGLE,8550,4654,3896,54.43
Yorick,UTILITY,186,89,97,47.85
Yorick,,38,0,38,0
Yorick,BOTTOM,111,59,52,53.15
Warwick,JUNGLE,33998,17858,16140,52.53
Warwick,TOP,11105,5699,5406,51.32
Warwick,UTILITY,161,62,99,38.51
Warwick,MIDDLE,256,127,129,49.61
Warwick,,54,0,54,0
Warwick,BOTTOM,9,3,6,33.33
Veigar,MIDDLE,23721,12351,11370,52.07
Veigar,BOTTOM,2931,1527,1404,52.1
Veigar,UTILITY,3142,1382,1760,43.98
Veigar,TOP,947,441,506,46.57
Veigar,,24,0,24,0
Veigar,JUNGLE,15,2,13,13.33
Tristana,BOTTOM,27739,13755,13984,49.59
Tristana,MIDDLE,2591,1231,1360,47.51
Tristana,TOP,383,163,220,42.56
Tristana,,30,0,30,0
Tristana,JUNGLE,69,15,54,21.74
Tristana,UTILITY,78,32,46,41.03
Riven,TOP,12985,6495,6490,50.02
Riven,JUNGLE,205,88,117,42.93
Riven,MIDDLE,918,437,481,47.6
Riven,BOTTOM,68,36,32,52.94
Riven,UTILITY,55,38,17,69.09
Riven,,10,3,7,30
Sejuani,JUNGLE,11250,5554,5696,49.37
Sejuani,UTILITY,371,149,222,40.16
Sejuani,TOP,650,318,332,48.92
Sejuani,MIDDLE,120,56,64,46.67
Sejuani,,7,0,7,0
Sejuani,BOTTOM,6,0,6,0
Lucian,BOTTOM,19899,9672,10227,48.61
Lucian,MIDDLE,1045,474,571,45.36
Lucian,UTILITY,111,55,56,49.55
Lucian,JUNGLE,19,3,16,15.79
Lucian,TOP,455,197,258,43.3
Lucian,,15,0,15,0
Soraka,UTILITY,16858,8748,8110,51.89
Soraka,BOTTOM,44,21,23,47.73
Soraka,MIDDLE,135,67,68,49.63
Soraka,TOP,163,93,70,57.06
Soraka,,14,0,14,0
Soraka,JUNGLE,16,3,13,18.75
Malphite,TOP,20159,10199,9960,50.59
Malphite,UTILITY,5303,2559,2744,48.26
Malphite,JUNGLE,1407,588,819,41.79
Malphite,MIDDLE,4656,2365,2291,50.79
Malphite,BOTTOM,130,48,82,36.92
Malphite,,39,6,33,15.38
Amumu,JUNGLE,29965,15737,14228,52.52
Amumu,UTILITY,2011,984,1027,48.93
Amumu,TOP,109,44,65,40.37
Amumu,,24,0,24,0
Amumu,BOTTOM,19,0,19,0
Amumu,MIDDLE,57,25,32,43.86
Ahri,MIDDLE,38455,18965,19490,49.32
Ahri,TOP,516,256,260,49.61
Ahri,UTILITY,803,394,409,49.07
Ahri,BOTTOM,227,107,120,47.14
Ahri,JUNGLE,15,5,10,33.33
Ahri,,28,0,28,0
Vladimir,TOP,8537,4246,4291,49.74
Vladimir,MIDDLE,12194,6047,6147,49.59
Vladimir,BOTTOM,172,65,107,37.79
Vladimir,,27,0,27,0
Vladimir,UTILITY,47,16,31,34.04
Vladimir,JUNGLE,14,5,9,35.71
Rammus,JUNGLE,8636,4431,4205,51.31
Rammus,TOP,584,269,315,46.06
Rammus,UTILITY,388,186,202,47.94
Rammus,MIDDLE,62,27,35,43.55
Rammus,BOTTOM,31,11,20,35.48
Rammus,,18,0,18,0
Katarina,MIDDLE,22880,11367,11513,49.68
Katarina,BOTTOM,245,84,161,34.29
Katarina,TOP,315,152,163,48.25
Katarina,JUNGLE,52,30,22,57.69
Katarina,UTILITY,208,99,109,47.6
Katarina,,28,0,28,0
Draven,BOTTOM,15196,7462,7734,49.11
Draven,MIDDLE,296,134,162,45.27
Draven,TOP,282,152,130,53.9
Draven,,11,0,11,0
Draven,JUNGLE,25,14,11,56
Draven,UTILITY,28,12,16,42.86
Senna,UTILITY,21564,10774,10790,49.96
Senna,TOP,343,168,175,48.98
Senna,BOTTOM,748,331,417,44.25
Senna,MIDDLE,150,70,80,46.67
Senna,,23,0,23,0
Senna,JUNGLE,21,10,11,47.62
Sion,TOP,17681,9125,8556,51.61
Sion,MIDDLE,1792,924,868,51.56
Sion,UTILITY,1716,826,890,48.14
Sion,BOTTOM,544,245,299,45.04
Sion,JUNGLE,1113,524,589,47.08
Sion,,17,0,17,0
MasterYi,JUNGLE,37114,18843,18271,50.77
MasterYi,TOP,499,257,242,51.5
MasterYi,,36,3,33,8.33
MasterYi,UTILITY,93,38,55,40.86
MasterYi,BOTTOM,83,50,33,60.24
MasterYi,MIDDLE,264,141,123,53.41
Annie,MIDDLE,8106,4137,3969,51.04
Annie,UTILITY,1722,859,863,49.88
Annie,BOTTOM,142,59,83,41.55
Annie,TOP,430,237,193,55.12
Annie,JUNGLE,19,5,14,26.32
Annie,,20,2,18,10
Ezreal,BOTTOM,73845,36039,37806,48.8
Ezreal,TOP,415,171,244,41.2
Ezreal,MIDDLE,1913,879,1034,45.95
Ezreal,,45,0,45,0
Ezreal,UTILITY,441,210,231,47.62
Ezreal,JUNGLE,188,53,135,28.19
Lux,UTILITY,53053,26618,26435,50.17
Lux,BOTTOM,2198,1124,1074,51.14
Lux,MIDDLE,21138,10836,10302,51.26
Lux,,51,0,51,0
Lux,TOP,304,119,185,39.14
Lux,JUNGLE,29,8,21,27.59
Pantheon,TOP,10391,5242,5149,50.45
Pantheon,JUNGLE,14975,7292,7683,48.69
Pantheon,UTILITY,17553,8693,8860,49.52
Pantheon,MIDDLE,5350,2824,2526,52.79
Pantheon,,42,3,39,7.14
Pantheon,BOTTOM,246,127,119,51.63
Belveth,JUNGLE,6761,3248,3513,48.04
Belveth,TOP,154,61,93,39.61
Belveth,MIDDLE,91,50,41,54.95
Belveth,UTILITY,67,38,29,56.72
Belveth,BOTTOM,18,11,7,61.11
KogMaw,BOTTOM,8612,4518,4094,52.46
KogMaw,MIDDLE,387,215,172,55.56
KogMaw,JUNGLE,14,12,2,85.71
KogMaw,TOP,124,35,89,28.23
KogMaw,UTILITY,261,108,153,41.38
KogMaw,,15,3,12,20
Darius,TOP,41289,20441,20848,49.51
Darius,JUNGLE,15003,7925,7078,52.82
Darius,MIDDLE,769,419,350,54.49
Darius,UTILITY,314,121,193,38.54
Darius,BOTTOM,157,60,97,38.22
Darius,,58,0,58,0
Viktor,,24,0,24,0
Viktor,MIDDLE,25515,12788,12727,50.12
Viktor,TOP,961,426,535,44.33
Viktor,UTILITY,205,81,124,39.51
Viktor,BOTTOM,1027,522,505,50.83
Viktor,JUNGLE,9,3,6,33.33
Leona,UTILITY,26567,13179,13388,49.61
Leona,JUNGLE,50,10,40,20
Leona,TOP,96,22,74,22.92
Leona,,14,0,14,0
Leona,MIDDLE,42,28,14,66.67
Leona,BOTTOM,16,3,13,18.75
Qiyana,MIDDLE,6020,2862,3158,47.54
Qiyana,UTILITY,194,92,102,47.42
Qiyana,JUNGLE,1080,466,614,43.15
Qiyana,TOP,364,171,193,46.98
Qiyana,BOTTOM,19,5,14,26.32
Qiyana,,6,0,6,0
Swain,UTILITY,17759,9096,8663,51.22
Swain,BOTTOM,3246,1730,1516,53.3
Swain,MIDDLE,5802,3054,2748,52.64
Swain,TOP,2859,1438,1421,50.3
Swain,JUNGLE,30,0,30,0
Swain,,14,0,14,0
Vi,JUNGLE,27727,13762,13965,49.63
Vi,TOP,1032,458,574,44.38
Vi,MIDDLE,437,183,254,41.88
Vi,UTILITY,399,228,171,57.14
Vi,BOTTOM,35,8,27,22.86
Vi,,17,0,17,0
Irelia,MIDDLE,12670,6408,6262,50.58
Irelia,TOP,13561,6712,6849,49.49
Irelia,BOTTOM,259,134,125,51.74
Irelia,,40,3,37,7.5
Irelia,JUNGLE,54,24,30,44.44
Irelia,UTILITY,42,24,18,57.14
Nautilus,UTILITY,33347,16338,17009,48.99
Nautilus,TOP,610,236,374,38.69
Nautilus,JUNGLE,281,101,180,35.94
Nautilus,,42,0,42,0
Nautilus,MIDDLE,167,85,82,50.9
Nautilus,BOTTOM,43,17,26,39.53
Aurora,TOP,3820,1925,1895,50.39
Aurora,MIDDLE,17218,8370,8848,48.61
Aurora,UTILITY,371,157,214,42.32
Aurora,BOTTOM,271,124,147,45.76
Aurora,JUNGLE,29,12,17,41.38
Aurora,,12,0,12,0
Corki,JUNGLE,20,6,14,30
Corki,BOTTOM,10140,4828,5312,47.61
Corki,MIDDLE,2191,1025,1166,46.78
Corki,TOP,256,119,137,46.48
Corki,UTILITY,33,22,11,66.67
Corki,,3,0,3,0
Orianna,MIDDLE,12773,6373,6400,49.89
Orianna,UTILITY,432,205,227,47.45
Orianna,BOTTOM,117,47,70,40.17
Orianna,TOP,134,69,65,51.49
Orianna,JUNGLE,10,2,8,20
Orianna,,5,0,5,0
Xayah,BOTTOM,14126,7103,7023,50.28
Xayah,MIDDLE,67,30,37,44.78
Xayah,,14,5,9,35.71
Xayah,TOP,17,6,11,35.29
Xayah,UTILITY,7,0,7,0
Xayah,JUNGLE,3,3,0,100
Nami,UTILITY,30707,15878,14829,51.71
Nami,MIDDLE,32,8,24,25
Nami,,23,0,23,0
Nami,BOTTOM,32,23,9,71.88
Nami,TOP,4,2,2,50
Nami,JUNGLE,5,2,3,40
Alistar,TOP,300,154,146,51.33
Alistar,UTILITY,12658,6330,6328,50.01
Alistar,JUNGLE,42,14,28,33.33
Alistar,,9,0,9,0
Alistar,BOTTOM,17,6,11,35.29
Alistar,MIDDLE,83,24,59,28.92
Hwei,BOTTOM,1759,918,841,52.19
Hwei,MIDDLE,14959,7542,7417,50.42
Hwei,TOP,343,178,165,51.9
Hwei,UTILITY,2955,1472,1483,49.81
Hwei,,28,0,28,0
Mordekaiser,TOP,33879,17646,16233,52.09
Mordekaiser,JUNGLE,3728,1905,1823,51.1
Mordekaiser,MIDDLE,1348,665,683,49.33
Mordekaiser,BOTTOM,155,71,84,45.81
Mordekaiser,UTILITY,443,218,225,49.21
Mordekaiser,,34,0,34,0
Yone,MIDDLE,35014,16834,18180,48.08
Yone,TOP,21255,10015,11240,47.12
Yone,BOTTOM,541,222,319,41.04
Yone,JUNGLE,301,104,197,34.55
Yone,UTILITY,254,94,160,37.01
Yone,,71,0,71,0
Shen,TOP,12390,6089,6301,49.14
Shen,JUNGLE,884,432,452,48.87
Shen,UTILITY,4716,2302,2414,48.81
Shen,,12,0,12,0
Shen,MIDDLE,940,495,445,52.66
Shen,BOTTOM,43,20,23,46.51
Akali,MIDDLE,28827,14275,14552,49.52
Akali,TOP,4977,2466,2511,49.55
Akali,UTILITY,124,59,65,47.58
Akali,,34,0,34,0
Akali,BOTTOM,47,11,36,23.4
Akali,JUNGLE,28,8,20,28.57
Varus,BOTTOM,24029,11652,12377,48.49
Varus,UTILITY,385,205,180,53.25
Varus,MIDDLE,1590,743,847,46.73
Varus,TOP,2102,1010,1092,48.05
Varus,JUNGLE,32,18,14,56.25
Varus,,27,0,27,0
Lulu,UTILITY,40649,20306,20343,49.95
Lulu,BOTTOM,44,5,39,11.36
Lulu,MIDDLE,183,80,103,43.72
Lulu,TOP,271,139,132,51.29
Lulu,JUNGLE,21,9,12,42.86
Lulu,,15,0,15,0
Renekton,TOP,14409,7020,7389,48.72
Renekton,MIDDLE,1339,725,614,54.14
Renekton,JUNGLE,78,34,44,43.59
Renekton,,16,0,16,0
Renekton,BOTTOM,55,18,37,32.73
Renekton,UTILITY,51,21,30,41.18
Poppy,TOP,4127,1995,2132,48.34
Poppy,JUNGLE,2926,1437,1489,49.11
Poppy,UTILITY,11289,5844,5445,51.77
Poppy,MIDDLE,159,65,94,40.88
Poppy,BOTTOM,38,25,13,65.79
Poppy,,19,0,19,0
Zac,JUNGLE,10926,5486,5440,50.21
Zac,TOP,2075,1063,1012,51.23
Zac,UTILITY,1535,825,710,53.75
Zac,MIDDLE,557,301,256,54.04
Zac,BOTTOM,18,15,3,83.33
Zac,,11,0,11,0
Sett,TOP,41912,21672,20240,51.71
Sett,UTILITY,1475,690,785,46.78
Sett,MIDDLE,1890,1050,840,55.56
Sett,BOTTOM,254,145,109,57.09
Sett,JUNGLE,816,379,437,46.45
Sett,,47,0,47,0
Zilean,BOTTOM,112,60,52,53.57
Zilean,MIDDLE,937,513,424,54.75
Zilean,UTILITY,8693,4429,4264,50.95
Zilean,TOP,319,150,169,47.02
Zilean,,5,0,5,0
Zilean,JUNGLE,8,0,8,0
Teemo,TOP,24768,12725,12043,51.38
Teemo,UTILITY,5041,2621,2420,51.99
Teemo,JUNGLE,5869,3030,2839,51.63
Teemo,MIDDLE,2044,1087,957,53.18
Teemo,BOTTOM,858,396,462,46.15
Teemo,,44,0,44,0
MonkeyKing,JUNGLE,16509,8438,8071,51.11
MonkeyKing,TOP,3975,1977,1998,49.74
MonkeyKing,MIDDLE,545,287,258,52.66
MonkeyKing,UTILITY,504,249,255,49.4
MonkeyKing,BOTTOM,89,44,45,49.44
MonkeyKing,,22,0,22,0
Blitzcrank,UTILITY,22234,10772,11462,48.45
Blitzcrank,MIDDLE,70,23,47,32.86
Blitzcrank,TOP,52,26,26,50
Blitzcrank,JUNGLE,90,27,63,30
Blitzcrank,BOTTOM,44,17,27,38.64
Blitzcrank,,39,0,39,0
Khazix,JUNGLE,15058,7225,7833,47.98
Khazix,TOP,45,12,33,26.67
Khazix,,17,0,17,0
Khazix,BOTTOM,9,3,6,33.33
Khazix,UTILITY,51,16,35,31.37
Khazix,MIDDLE,38,15,23,39.47
Vayne,BOTTOM,32932,16891,16041,51.29
Vayne,TOP,6479,3303,3176,50.98
Vayne,MIDDLE,479,227,252,47.39
Vayne,,38,0,38,0
Vayne,JUNGLE,186,80,106,43.01
Vayne,UTILITY,69,32,37,46.38
Morgana,UTILITY,32320,16340,15980,50.56
Morgana,JUNGLE,1646,802,844,48.72
Morgana,TOP,414,189,225,45.65
Morgana,MIDDLE,2283,1158,1125,50.72
Morgana,BOTTOM,274,157,117,57.3
Morgana,,42,0,42,0
Nasus,TOP,17280,8927,8353,51.66
Nasus,JUNGLE,2178,1127,1051,51.74
Nasus,MIDDLE,1684,857,827,50.89
Nasus,UTILITY,242,96,146,39.67
Nasus,,34,0,34,0
Nasus,BOTTOM,82,38,44,46.34
Jhin,BOTTOM,62290,31016,31274,49.79
Jhin,TOP,511,238,273,46.58
Jhin,MIDDLE,956,487,469,50.94
Jhin,UTILITY,447,193,254,43.18
Jhin,,51,3,48,5.88
Jhin,JUNGLE,105,38,67,36.19
Seraphine,UTILITY,20507,10212,10295,49.8
Seraphine,BOTTOM,1480,728,752,49.19
Seraphine,MIDDLE,685,339,346,49.49
Seraphine,TOP,57,28,29,49.12
Seraphine,,24,0,24,0
Seraphine,JUNGLE,6,6,0,100
Illaoi,TOP,13762,6801,6961,49.42
Illaoi,BOTTOM,43,20,23,46.51
Illaoi,,21,0,21,0
Illaoi,JUNGLE,25,16,9,64
Illaoi,MIDDLE,450,256,194,56.89
Illaoi,UTILITY,229,89,140,38.86
Milio,UTILITY,17931,9457,8474,52.74
Milio,BOTTOM,14,8,6,57.14
Milio,MIDDLE,25,8,17,32
Milio,TOP,16,8,8,50
Milio,,2,0,2,0
Rakan,TOP,46,18,28,39.13
Rakan,UTILITY,11957,5956,6001,49.81
Rakan,MIDDLE,195,105,90,53.85
Rakan,,6,0,6,0
Rakan,BOTTOM,8,0,8,0
Rakan,JUNGLE,16,6,10,37.5
Ekko,JUNGLE,15016,7451,7565,49.62
Ekko,MIDDLE,13751,6964,6787,50.64
Ekko,BOTTOM,76,40,36,52.63
Ekko,UTILITY,288,140,148,48.61
Ekko,TOP,486,215,271,44.24
Ekko,,25,0,25,0
Ashe,BOTTOM,57944,29090,28854,50.2
Ashe,UTILITY,4141,1869,2272,45.13
Ashe,TOP,794,356,438,44.84
Ashe,MIDDLE,512,235,277,45.9
Ashe,JUNGLE,38,10,28,26.32
Ashe,,44,0,44,0
Tryndamere,TOP,14378,7216,7162,50.19
Tryndamere,JUNGLE,1639,773,866,47.16
Tryndamere,MIDDLE,1441,734,707,50.94
Tryndamere,UTILITY,76,18,58,23.68
Tryndamere,BOTTOM,82,24,58,29.27
Tryndamere,,31,0,31,0
Lillia,JUNGLE,16508,8169,8339,49.49
Lillia,TOP,501,257,244,51.3
Lillia,MIDDLE,91,59,32,64.84
Lillia,BOTTOM,17,11,6,64.71
Lillia,UTILITY,67,17,50,25.37
Lillia,,14,0,14,0
FiddleSticks,JUNGLE,11230,5651,5579,50.32
FiddleSticks,UTILITY,2733,1324,1409,48.44
FiddleSticks,TOP,761,371,390,48.75
FiddleSticks,BOTTOM,54,22,32,40.74
FiddleSticks,MIDDLE,442,219,223,49.55
FiddleSticks,,9,0,9,0
Nilah,BOTTOM,9222,4895,4327,53.08
Nilah,JUNGLE,33,21,12,63.64
Nilah,MIDDLE,39,14,25,35.9
Nilah,TOP,46,14,32,30.43
Nilah,,8,0,8,0
Nilah,UTILITY,21,6,15,28.57
Rell,UTILITY,14643,7454,7189,50.9
Rell,,6,0,6,0
Rell,JUNGLE,65,30,35,46.15
Rell,TOP,117,38,79,32.48
Rell,MIDDLE,19,5,14,26.32
Rell,BOTTOM,3,3,0,100
Trundle,JUNGLE,5623,2915,2708,51.84
Trundle,TOP,11952,6005,5947,50.24
Trundle,UTILITY,241,108,133,44.81
Trundle,MIDDLE,244,158,86,64.75
Trundle,BOTTOM,68,46,22,67.65
Trundle,,15,0,15,0
Zed,MIDDLE,27694,13563,14131,48.97
Zed,JUNGLE,6271,2986,3285,47.62
Zed,BOTTOM,157,57,100,36.31
Zed,TOP,1045,512,533,49
Zed,UTILITY,300,139,161,46.33
Zed,,20,3,17,15
Gangplank,TOP,12491,6194,6297,49.59
Gangplank,MIDDLE,2032,1020,1012,50.2
Gangplank,UTILITY,114,45,69,39.47
Gangplank,BOTTOM,53,31,22,58.49
Gangplank,JUNGLE,29,8,21,27.59
Gangplank,,9,0,9,0
Evelynn,JUNGLE,10422,5185,5237,49.75
Evelynn,MIDDLE,70,38,32,54.29
Evelynn,UTILITY,165,78,87,47.27
Evelynn,TOP,52,22,30,42.31
Evelynn,,14,0,14,0
Evelynn,BOTTOM,14,6,8,42.86
Elise,UTILITY,9467,4956,4511,52.35
Elise,JUNGLE,11731,5753,5978,49.04
Elise,MIDDLE,116,57,59,49.14
Elise,BOTTOM,54,15,39,27.78
Elise,TOP,396,138,258,34.85
Elise,,10,0,10,0
Gwen,TOP,9218,4338,4880,47.06
Gwen,UTILITY,32,11,21,34.38
Gwen,JUNGLE,5624,2810,2814,49.96
Gwen,MIDDLE,354,174,180,49.15
Gwen,BOTTOM,23,5,18,21.74
Gwen,,15,0,15,0
Skarner,JUNGLE,6839,3079,3760,45.02
Skarner,UTILITY,289,130,159,44.98
Skarner,TOP,496,232,264,46.77
Skarner,BOTTOM,6,3,3,50
Skarner,MIDDLE,17,5,12,29.41
Skarner,,6,0,6,0
DrMundo,MIDDLE,419,222,197,52.98
DrMundo,TOP,14556,7419,7137,50.97
DrMundo,JUNGLE,1958,991,967,50.61
DrMundo,UTILITY,338,170,168,50.3
DrMundo,BOTTOM,104,45,59,43.27
DrMundo,,8,0,8,0
Samira,BOTTOM,20977,10271,10706,48.96
Samira,JUNGLE,28,14,14,50
Samira,UTILITY,28,18,10,64.29
Samira,MIDDLE,276,106,170,38.41
Samira,TOP,84,39,45,46.43
Samira,,22,3,19,13.64
Volibear,JUNGLE,17177,8639,8538,50.29
Volibear,TOP,17394,8725,8669,50.16
Volibear,MIDDLE,431,183,248,42.46
Volibear,UTILITY,222,61,161,27.48
Volibear,BOTTOM,71,28,43,39.44
Volibear,,43,0,43,0
Briar,JUNGLE,20343,10770,9573,52.94
Briar,BOTTOM,71,29,42,40.85
Briar,TOP,951,442,509,46.48
Briar,UTILITY,162,61,101,37.65
Briar,MIDDLE,541,305,236,56.38
Briar,,23,0,23,0
Rengar,JUNGLE,8771,4068,4703,46.38
Rengar,TOP,1001,450,551,44.96
Rengar,BOTTOM,111,51,60,45.95
Rengar,,17,3,14,17.65
Rengar,UTILITY,237,115,122,48.52
Rengar,MIDDLE,9,6,3,66.67
Ziggs,BOTTOM,6410,3453,2957,53.87
Ziggs,MIDDLE,3330,1517,1813,45.56
Ziggs,TOP,234,80,154,34.19
Ziggs,,9,0,9,0
Ziggs,UTILITY,1169,551,618,47.13
Ziggs,JUNGLE,4,4,0,100
Xerath,UTILITY,16546,8420,8126,50.89
Xerath,BOTTOM,647,326,321,50.39
Xerath,MIDDLE,11602,5792,5810,49.92
Xerath,TOP,121,71,50,58.68
Xerath,JUNGLE,7,4,3,57.14
Xerath,,24,0,24,0
Malzahar,MIDDLE,29439,15329,14110,52.07
Malzahar,TOP,1892,961,931,50.79
Malzahar,BOTTOM,566,280,286,49.47
Malzahar,,41,0,41,0
Malzahar,UTILITY,520,225,295,43.27
Malzahar,JUNGLE,115,44,71,38.26
Sona,UTILITY,9727,5108,4619,52.51
Sona,MIDDLE,30,23,7,76.67
Sona,TOP,17,5,12,29.41
Sona,,12,0,12,0
Sona,JUNGLE,11,0,11,0
Sona,BOTTOM,19,10,9,52.63
Gnar,TOP,12252,6088,6164,49.69
Gnar,MIDDLE,184,80,104,43.48
Gnar,BOTTOM,61,21,40,34.43
Gnar,JUNGLE,46,18,28,39.13
Gnar,UTILITY,62,20,42,32.26
Gnar,,5,0,5,0
Hecarim,JUNGLE,12973,6302,6671,48.58
Hecarim,UTILITY,12,0,12,0
Hecarim,TOP,40,14,26,35
Hecarim,BOTTOM,8,2,6,25
Hecarim,,8,0,8,0
Hecarim,MIDDLE,16,2,14,12.5
Kayle,TOP,16913,8686,8227,51.36
Kayle,UTILITY,365,177,188,48.49
Kayle,MIDDLE,3330,1755,1575,52.7
Kayle,JUNGLE,100,41,59,41
Kayle,BOTTOM,173,71,102,41.04
Kayle,,20,0,20,0
Azir,MIDDLE,9779,4731,5048,48.38
Azir,TOP,482,251,231,52.07
Azir,BOTTOM,99,46,53,46.46
Azir,JUNGLE,8,5,3,62.5
Azir,UTILITY,139,40,99,28.78
Azir,,3,0,3,0
MissFortune,BOTTOM,69731,35569,34162,51.01
MissFortune,UTILITY,2071,919,1152,44.37
MissFortune,MIDDLE,643,292,351,45.41
MissFortune,,93,11,82,11.83
MissFortune,TOP,162,69,93,42.59
MissFortune,JUNGLE,23,8,15,34.78
Karthus,JUNGLE,7622,3715,3907,48.74
Karthus,BOTTOM,515,288,227,55.92
Karthus,MIDDLE,624,291,333,46.63
Karthus,,15,0,15,0
Karthus,TOP,272,149,123,54.78
Karthus,UTILITY,258,117,141,45.35
Karma,UTILITY,33994,17241,16753,50.72
Karma,MIDDLE,2156,1046,1110,48.52
Karma,TOP,2217,1219,998,54.98
Karma,BOTTOM,112,38,74,33.93
Karma,JUNGLE,9,3,6,33.33
Karma,,27,0,27,0
Talon,MIDDLE,8766,4397,4369,50.16
Talon,JUNGLE,9092,4281,4811,47.09
Talon,BOTTOM,39,19,20,48.72
Talon,TOP,244,117,127,47.95
Talon,UTILITY,80,27,53,33.75
Talon,,28,0,28,0
Ornn,TOP,11690,5941,5749,50.82
Ornn,UTILITY,541,252,289,46.58
Ornn,MIDDLE,239,108,131,45.19
Ornn,BOTTOM,47,22,25,46.81
Ornn,,9,0,9,0
Ornn,JUNGLE,85,21,64,24.71
Zoe,MIDDLE,8837,4304,4533,48.7
Zoe,UTILITY,2407,1268,1139,52.68
Zoe,TOP,237,113,124,47.68
Zoe,BOTTOM,68,39,29,57.35
Zoe,,5,0,5,0
Zoe,JUNGLE,15,11,4,73.33
Ambessa,TOP,16040,7573,8467,47.21
Ambessa,MIDDLE,1724,834,890,48.38
Ambessa,JUNGLE,1347,594,753,44.1
Ambessa,,12,0,12,0
Ambessa,BOTTOM,45,16,29,35.56
Ambessa,UTILITY,66,20,46,30.3
KSante,TOP,15390,7192,8198,46.73
KSante,MIDDLE,572,286,286,50
KSante,,15,0,15,0
KSante,JUNGLE,47,18,29,38.3
KSante,UTILITY,96,29,67,30.21
KSante,BOTTOM,58,31,27,53.45
Urgot,TOP,14930,7784,7146,52.14
Urgot,JUNGLE,255,131,124,51.37
Urgot,MIDDLE,384,236,148,61.46
Urgot,UTILITY,130,72,58,55.38
Urgot,BOTTOM,123,57,66,46.34
Urgot,,14,0,14,0
Bard,UTILITY,9187,4609,4578,50.17
Bard,MIDDLE,51,22,29,43.14
Bard,JUNGLE,12,12,0,100
Bard,BOTTOM,36,14,22,38.89
Bard,TOP,52,17,35,32.69
Bard,,7,0,7,0
Kindred,JUNGLE,13183,6527,6656,49.51
Kindred,UTILITY,36,21,15,58.33
Kindred,MIDDLE,100,54,46,54
Kindred,TOP,72,32,40,44.44
Kindred,BOTTOM,188,99,89,52.66
Kindred,,16,0,16,0
Neeko,UTILITY,9570,4662,4908,48.71
Neeko,MIDDLE,3198,1616,1582,50.53
Neeko,TOP,405,185,220,45.68
Neeko,JUNGLE,393,190,203,48.35
Neeko,BOTTOM,250,113,137,45.2
Neeko,,17,0,17,0
Twitch,BOTTOM,22052,11102,10950,50.34
Twitch,UTILITY,1291,556,735,43.07
Twitch,JUNGLE,992,379,613,38.21
Twitch,MIDDLE,512,243,269,47.46
Twitch,TOP,107,37,70,34.58
Twitch,,19,0,19,0
Aphelios,BOTTOM,15672,7819,7853,49.89
Aphelios,MIDDLE,236,110,126,46.61
Aphelios,,5,0,5,0
Aphelios,TOP,110,46,64,41.82
Aphelios,UTILITY,22,11,11,50
Aphelios,JUNGLE,3,0,3,0
Fizz,MIDDLE,17598,8731,8867,49.61
Fizz,JUNGLE,73,31,42,42.47
Fizz,TOP,390,195,195,50
Fizz,BOTTOM,131,72,59,54.96
Fizz,,22,0,22,0
Fizz,UTILITY,259,119,140,45.95
Ivern,JUNGLE,3087,1544,1543,50.02
Ivern,UTILITY,712,329,383,46.21
Ivern,TOP,224,109,115,48.66
Ivern,MIDDLE,78,53,25,67.95
Ivern,BOTTOM,6,3,3,50
Ivern,,6,0,6,0
Leblanc,MIDDLE,16257,8025,8232,49.36
Leblanc,TOP,365,166,199,45.48
Leblanc,UTILITY,2604,1287,1317,49.42
Leblanc,,13,0,13,0
Leblanc,BOTTOM,78,28,50,35.9
Leblanc,JUNGLE,9,3,6,33.33
Aatrox,TOP,26035,12947,13088,49.73
Aatrox,UTILITY,136,58,78,42.65
Aatrox,MIDDLE,729,389,340,53.36
Aatrox,JUNGLE,190,84,106,44.21
Aatrox,,39,0,39,0
Aatrox,BOTTOM,78,30,48,38.46
Jayce,MIDDLE,3161,1555,1606,49.19
Jayce,TOP,12013,5928,6085,49.35
Jayce,BOTTOM,193,100,93,51.81
Jayce,,6,0,6,0
Jayce,UTILITY,89,46,43,51.69
Jayce,JUNGLE,62,26,36,41.94
Shaco,JUNGLE,21213,10296,10917,48.54
Shaco,UTILITY,6706,3519,3187,52.48
Shaco,TOP,1140,515,625,45.18
Shaco,MIDDLE,235,114,121,48.51
Shaco,,33,0,33,0
Shaco,BOTTOM,40,13,27,32.5
Janna,UTILITY,10530,5408,5122,51.36
Janna,BOTTOM,8,0,8,0
Janna,TOP,40,19,21,47.5
Janna,MIDDLE,27,8,19,29.63
Janna,JUNGLE,20,4,16,20
Janna,,5,0,5,0
Lissandra,MIDDLE,9213,4811,4402,52.22
Lissandra,UTILITY,603,261,342,43.28
Lissandra,TOP,502,258,244,51.39
Lissandra,BOTTOM,111,46,65,41.44
Lissandra,,3,0,3,0
Lissandra,JUNGLE,7,0,7,0
Anivia,MIDDLE,7332,3803,3529,51.87
Anivia,BOTTOM,285,170,115,59.65
Anivia,UTILITY,1469,773,696,52.62
Anivia,TOP,678,352,326,51.92
Anivia,JUNGLE,21,3,18,14.29
Anivia,,15,0,15,0
Kennen,MIDDLE,1433,690,743,48.15
Kennen,TOP,6122,3122,3000,51
Kennen,UTILITY,334,164,170,49.1
Kennen,BOTTOM,178,71,107,39.89
Kennen,JUNGLE,5,2,3,40
Kennen,,3,0,3,0
Fiora,TOP,10684,5352,5332,50.09
Fiora,BOTTOM,51,27,24,52.94
Fiora,JUNGLE,22,9,13,40.91
Fiora,MIDDLE,221,95,126,42.99
Fiora,UTILITY,49,18,31,36.73
Fiora,,4,0,4,0
Rumble,TOP,6666,3199,3467,47.99
Rumble,JUNGLE,741,369,372,49.8
Rumble,UTILITY,300,127,173,42.33
Rumble,MIDDLE,923,439,484,47.56
Rumble,BOTTOM,25,13,12,52
Rumble,,5,0,5,0
Akshan,MIDDLE,9278,4598,4680,49.56
Akshan,BOTTOM,553,284,269,51.36
Akshan,TOP,696,342,354,49.14
Akshan,JUNGLE,36,11,25,30.56
Akshan,UTILITY,124,56,68,45.16
Akshan,,7,0,7,0
TwistedFate,MIDDLE,9458,4544,4914,48.04
TwistedFate,JUNGLE,88,27,61,30.68
TwistedFate,BOTTOM,470,238,232,50.64
TwistedFate,UTILITY,524,243,281,46.37
TwistedFate,TOP,404,171,233,42.33
TwistedFate,,10,0,10,0
TahmKench,TOP,8665,4168,4497,48.1
TahmKench,UTILITY,13399,6493,6906,48.46
TahmKench,,12,3,9,25
TahmKench,BOTTOM,356,176,180,49.44
TahmKench,MIDDLE,370,176,194,47.57
TahmKench,JUNGLE,70,35,35,50
Graves,JUNGLE,19107,9527,9580,49.86
Graves,MIDDLE,337,156,181,46.29
Graves,TOP,389,187,202,48.07
Graves,BOTTOM,173,65,108,37.57
Graves,UTILITY,63,24,39,38.1
Graves,,11,0,11,0
XinZhao,JUNGLE,18452,9325,9127,50.54
XinZhao,TOP,936,409,527,43.7
XinZhao,MIDDLE,549,282,267,51.37
XinZhao,UTILITY,166,103,63,62.05
XinZhao,BOTTOM,51,27,24,52.94
XinZhao,,8,0,8,0
Maokai,UTILITY,9853,4975,4878,50.49
Maokai,TOP,2236,1156,1080,51.7
Maokai,JUNGLE,1916,938,978,48.96
Maokai,BOTTOM,30,15,15,50
Maokai,MIDDLE,83,38,45,45.78
Maokai,,10,0,10,0
JarvanIV,JUNGLE,16489,8449,8040,51.24
JarvanIV,UTILITY,892,459,433,51.46
JarvanIV,TOP,247,111,136,44.94
JarvanIV,BOTTOM,63,35,28,55.56
JarvanIV,MIDDLE,221,109,112,49.32
JarvanIV,,11,3,8,27.27
Brand,UTILITY,15730,7914,7816,50.31
Brand,MIDDLE,4318,2254,2064,52.2
Brand,JUNGLE,1226,603,623,49.18
Brand,BOTTOM,1305,667,638,51.11
Brand,TOP,553,240,313,43.4
Brand,,33,0,33,0
Vex,MIDDLE,15355,7729,7626,50.34
Vex,UTILITY,478,254,224,53.14
Vex,TOP,249,111,138,44.58
Vex,BOTTOM,88,54,34,61.36
Vex,,14,0,14,0
Vex,JUNGLE,10,2,8,20
Zeri,BOTTOM,12075,5956,6119,49.33
Zeri,MIDDLE,381,178,203,46.72
Zeri,JUNGLE,119,38,81,31.93
Zeri,,11,0,11,0
Zeri,TOP,117,74,43,63.25
Zeri,UTILITY,11,5,6,45.45
Velkoz,UTILITY,13064,6687,6377,51.19
Velkoz,MIDDLE,4932,2567,2365,52.05
Velkoz,BOTTOM,550,304,246,55.27
Velkoz,TOP,206,91,115,44.17
Velkoz,,17,3,14,17.65
Velkoz,JUNGLE,2,0,2,0
Renata,UTILITY,4999,2410,2589,48.21
Renata,BOTTOM,32,21,11,65.63
Renata,,6,0,6,0
Renata,MIDDLE,12,9,3,75
Renata,JUNGLE,3,0,3,0
Renata,TOP,11,3,8,27.27
Kalista,BOTTOM,6939,3343,3596,48.18
Kalista,JUNGLE,21,8,13,38.1
Kalista,MIDDLE,115,55,60,47.83
Kalista,TOP,421,193,228,45.84
Kalista,UTILITY,41,9,32,21.95
Kalista,,6,3,3,50
Shyvana,JUNGLE,7075,3541,3534,50.05
Shyvana,TOP,348,151,197,43.39
Shyvana,MIDDLE,76,50,26,65.79
Shyvana,UTILITY,25,4,21,16
Shyvana,,2,0,2,0
Shyvana,BOTTOM,3,0,3,0
Camille,MIDDLE,218,103,115,47.25
Camille,TOP,9477,4551,4926,48.02
Camille,UTILITY,999,490,509,49.05
Camille,JUNGLE,138,83,55,60.14
Camille,BOTTOM,20,11,9,55
Camille,,3,0,3,0
Braum,UTILITY,17527,9110,8417,51.98
Braum,,14,0,14,0
Braum,TOP,89,27,62,30.34
Braum,JUNGLE,19,6,13,31.58
Braum,BOTTOM,12,5,7,41.67
Braum,MIDDLE,15,3,12,20
Quinn,TOP,7690,3998,3692,51.99
Quinn,BOTTOM,524,249,275,47.52
Quinn,UTILITY,453,240,213,52.98
Quinn,MIDDLE,2380,1277,1103,53.66
Quinn,JUNGLE,298,138,160,46.31
Quinn,,11,0,11,0
Kassadin,MIDDLE,6390,3210,3180,50.23
Kassadin,TOP,167,102,65,61.08
Kassadin,BOTTOM,19,3,16,15.79
Kassadin,JUNGLE,11,5,6,45.45
Kassadin,UTILITY,19,3,16,15.79
Heimerdinger,TOP,8163,4285,3878,52.49
Heimerdinger,BOTTOM,796,439,357,55.15
Heimerdinger,UTILITY,1527,782,745,51.21
Heimerdinger,MIDDLE,3449,1838,1611,53.29
Heimerdinger,JUNGLE,81,29,52,35.8
Heimerdinger,,18,3,15,16.67
Ryze,MIDDLE,7955,4115,3840,51.73
Ryze,TOP,2672,1389,1283,51.98
Ryze,BOTTOM,89,48,41,53.93
Ryze,UTILITY,57,25,32,43.86
Ryze,JUNGLE,27,6,21,22.22
Ryze,,8,0,8,0
Taliyah,MIDDLE,5243,2731,2512,52.09
Taliyah,JUNGLE,1660,840,820,50.6
Taliyah,UTILITY,412,218,194,52.91
Taliyah,,9,0,9,0
Taliyah,BOTTOM,192,112,80,58.33
Taliyah,TOP,98,39,59,39.8
AurelionSol,MIDDLE,10112,5091,5021,50.35
AurelionSol,UTILITY,282,131,151,46.45
AurelionSol,TOP,497,241,256,48.49
AurelionSol,BOTTOM,482,263,219,54.56
AurelionSol,,8,0,8,0
AurelionSol,JUNGLE,143,76,67,53.15
Nunu,JUNGLE,14949,7543,7406,50.46
Nunu,UTILITY,453,195,258,43.05
Nunu,MIDDLE,830,417,413,50.24
Nunu,TOP,57,20,37,35.09
Nunu,,15,0,15,0
Nunu,BOTTOM,59,12,47,20.34
Olaf,TOP,5939,2969,2970,49.99
Olaf,JUNGLE,1151,548,603,47.61
Olaf,MIDDLE,105,47,58,44.76
Olaf,UTILITY,29,12,17,41.38
Olaf,BOTTOM,52,29,23,55.77
Olaf,,2,0,2,0
Naafiri,MIDDLE,7486,3836,3650,51.24
Naafiri,TOP,897,457,440,50.95
Naafiri,JUNGLE,1317,614,703,46.62
Naafiri,UTILITY,178,76,102,42.7
Naafiri,BOTTOM,120,58,62,48.33
Naafiri,,12,0,12,0
Nidalee,JUNGLE,7602,3399,4203,44.71
Nidalee,UTILITY,868,437,431,50.35
Nidalee,MIDDLE,135,64,71,47.41
Nidalee,TOP,488,225,263,46.11
Nidalee,BOTTOM,34,18,16,52.94
Nidalee,,3,0,3,0
Udyr,JUNGLE,10129,5094,5035,50.29
Udyr,TOP,1891,814,1077,43.05
Udyr,UTILITY,80,29,51,36.25
Udyr,MIDDLE,133,42,91,31.58
Udyr,BOTTOM,20,11,9,55
Udyr,,12,0,12,0
Taric,UTILITY,6298,3215,3083,51.05
Taric,TOP,141,79,62,56.03
Taric,JUNGLE,169,74,95,43.79
Taric,MIDDLE,21,12,9,57.14
Taric,,8,0,8,0
Taric,BOTTOM,38,21,17,55.26
Kled,TOP,4712,2379,2333,50.49
Kled,UTILITY,142,76,66,53.52
Kled,BOTTOM,50,28,22,56
Kled,MIDDLE,521,264,257,50.67
Kled,JUNGLE,40,16,24,40
Kled,,6,0,6,0
RekSai,JUNGLE,3244,1531,1713,47.19
RekSai,TOP,194,100,94,51.55
RekSai,UTILITY,74,42,32,56.76
RekSai,MIDDLE,37,24,13,64.86
RekSai,BOTTOM,6,0,6,0
RekSai,,6,0,6,0
Cassiopeia,MIDDLE,5978,3042,2936,50.89
Cassiopeia,TOP,2104,1020,1084,48.48
Cassiopeia,BOTTOM,597,306,291,51.26
Cassiopeia,UTILITY,100,42,58,42
Cassiopeia,,9,0,9,0
Cassiopeia,JUNGLE,8,3,5,37.5
