Name,Role,Games,Wins,Losses,WR
Sett,TOP,21760,11476,10284,52.74
Sett,JUNGLE,836,414,422,49.52
Sett,MIDDLE,892,501,391,56.17
Sett,UTILITY,1124,499,625,44.4
Sett,BOTTOM,619,303,316,48.95
Sett,,64,0,64,0
Warwick,JUNGLE,18350,9685,8665,52.78
Warwick,TOP,5435,2807,2628,51.65
Warwick,MIDDLE,139,60,79,43.17
Warwick,UTILITY,171,55,116,32.16
Warwick,BOTTOM,92,42,50,45.65
Warwick,,48,3,45,6.25
Shen,MIDDLE,700,375,325,53.57
Shen,TOP,6442,3353,3089,52.05
Shen,UTILITY,1957,1006,951,51.41
Shen,BOTTOM,90,59,31,65.56
Shen,JUNGLE,855,379,476,44.33
Shen,,7,0,7,0
Tristana,BOTTOM,12270,6290,5980,51.26
Tristana,TOP,160,90,70,56.25
Tristana,MIDDLE,1054,529,525,50.19
Tristana,UTILITY,142,55,87,38.73
Tristana,JUNGLE,77,49,28,63.64
Tristana,,13,0,13,0
Blitzcrank,UTILITY,11022,5360,5662,48.63
Blitzcrank,BOTTOM,143,39,104,27.27
Blitzcrank,JUNGLE,181,51,130,28.18
Blitzcrank,MIDDLE,156,71,85,45.51
Blitzcrank,TOP,136,48,88,35.29
Blitzcrank,,10,0,10,0
Malphite,TOP,7355,3932,3423,53.46
Malphite,UTILITY,1636,792,844,48.41
Malphite,JUNGLE,806,388,418,48.14
Malphite,MIDDLE,1856,1029,827,55.44
Malphite,BOTTOM,203,84,119,41.38
Malphite,,30,0,30,0
Ekko,JUNGLE,5924,2955,2969,49.88
Ekko,MIDDLE,5452,2731,2721,50.09
Ekko,UTILITY,190,87,103,45.79
Ekko,TOP,279,113,166,40.5
Ekko,BOTTOM,104,33,71,31.73
Ekko,,19,0,19,0
Hwei,MIDDLE,7831,3857,3974,49.25
Hwei,BOTTOM,1429,793,636,55.49
Hwei,UTILITY,1953,964,989,49.36
Hwei,TOP,133,70,63,52.63
Hwei,JUNGLE,19,3,16,15.79
Hwei,,6,0,6,0
Lucian,BOTTOM,7920,3857,4063,48.7
Lucian,MIDDLE,405,159,246,39.26
Lucian,TOP,153,72,81,47.06
Lucian,JUNGLE,12,3,9,25
Lucian,UTILITY,45,20,25,44.44
Lucian,,6,0,6,0
Maokai,UTILITY,4573,2376,2197,51.96
Maokai,TOP,879,470,409,53.47
Maokai,JUNGLE,1097,624,473,56.88
Maokai,MIDDLE,55,35,20,63.64
Maokai,BOTTOM,53,24,29,45.28
Maokai,,5,0,5,0
Yone,TOP,9708,4516,5192,46.52
Yone,BOTTOM,1076,508,568,47.21
Yone,MIDDLE,17212,8693,8519,50.51
Yone,UTILITY,494,162,332,32.79
Yone,JUNGLE,370,126,244,34.05
Yone,,48,3,45,6.25
Darius,JUNGLE,7936,4206,3730,53
Darius,TOP,18779,9204,9575,49.01
Darius,BOTTOM,436,237,199,54.36
Darius,UTILITY,357,146,211,40.9
Darius,,42,0,42,0
Darius,MIDDLE,414,227,187,54.83
Yasuo,MIDDLE,19832,10074,9758,50.8
Yasuo,BOTTOM,4898,2457,2441,50.16
Yasuo,TOP,3882,1889,1993,48.66
Yasuo,JUNGLE,284,132,152,46.48
Yasuo,UTILITY,346,154,192,44.51
Yasuo,,32,0,32,0
Jhin,BOTTOM,25221,12858,12363,50.98
Jhin,MIDDLE,768,413,355,53.78
Jhin,TOP,395,181,214,45.82
Jhin,UTILITY,296,125,171,42.23
Jhin,JUNGLE,122,21,101,17.21
Jhin,,30,0,30,0
Lux,UTILITY,25641,12710,12931,49.57
Lux,MIDDLE,12072,6307,5765,52.24
Lux,BOTTOM,2746,1424,1322,51.86
Lux,JUNGLE,64,31,33,48.44
Lux,,51,3,48,5.88
Lux,TOP,328,138,190,42.07
Mordekaiser,TOP,19313,10169,9144,52.65
Mordekaiser,MIDDLE,664,383,281,57.68
Mordekaiser,UTILITY,370,162,208,43.78
Mordekaiser,JUNGLE,2561,1353,1208,52.83
Mordekaiser,BOTTOM,468,221,247,47.22
Mordekaiser,,49,0,49,0
Qiyana,JUNGLE,806,364,442,45.16
Qiyana,MIDDLE,4144,1923,2221,46.4
Qiyana,TOP,257,71,186,27.63
Qiyana,BOTTOM,58,29,29,50
Qiyana,UTILITY,112,37,75,33.04
Qiyana,,5,0,5,0
Irelia,MIDDLE,6770,3373,3397,49.82
Irelia,TOP,6442,3069,3373,47.64
Irelia,BOTTOM,285,123,162,43.16
Irelia,JUNGLE,75,45,30,60
Irelia,UTILITY,49,15,34,30.61
Irelia,,13,0,13,0
Ezreal,BOTTOM,22975,10861,12114,47.27
Ezreal,MIDDLE,1525,658,867,43.15
Ezreal,TOP,277,108,169,38.99
Ezreal,JUNGLE,299,109,190,36.45
Ezreal,,41,0,41,0
Ezreal,UTILITY,291,133,158,45.7
Rell,UTILITY,7670,3824,3846,49.86
Rell,MIDDLE,47,18,29,38.3
Rell,TOP,271,98,173,36.16
Rell,,6,0,6,0
Rell,BOTTOM,15,3,12,20
Rell,JUNGLE,73,17,56,23.29
Sejuani,JUNGLE,4702,2422,2280,51.51
Sejuani,TOP,334,157,177,47.01
Sejuani,UTILITY,318,178,140,55.97
Sejuani,MIDDLE,61,45,16,73.77
Sejuani,BOTTOM,38,10,28,26.32
Sejuani,,5,0,5,0
Pantheon,UTILITY,8407,4201,4206,49.97
Pantheon,JUNGLE,8313,4094,4219,49.25
Pantheon,TOP,5188,2633,2555,50.75
Pantheon,MIDDLE,2484,1267,1217,51.01
Pantheon,BOTTOM,565,279,286,49.38
Pantheon,,55,0,55,0
Singed,TOP,3090,1757,1333,56.86
Singed,BOTTOM,255,122,133,47.84
Singed,JUNGLE,337,177,160,52.52
Singed,UTILITY,310,145,165,46.77
Singed,MIDDLE,155,84,71,54.19
Singed,,13,0,13,0
Shaco,JUNGLE,10580,5060,5520,47.83
Shaco,UTILITY,2383,1264,1119,53.04
Shaco,TOP,923,427,496,46.26
Shaco,MIDDLE,221,98,123,44.34
Shaco,BOTTOM,118,51,67,43.22
Shaco,,6,0,6,0
Zed,MIDDLE,11117,5094,6023,45.82
Zed,JUNGLE,2463,1245,1218,50.55
Zed,TOP,470,186,284,39.57
Zed,BOTTOM,278,97,181,34.89
Zed,,19,0,19,0
Zed,UTILITY,99,42,57,42.42
Zac,JUNGLE,4104,2059,2045,50.17
Zac,UTILITY,488,266,222,54.51
Zac,TOP,524,220,304,41.98
Zac,MIDDLE,170,98,72,57.65
Zac,,9,0,9,0
Zac,BOTTOM,44,24,20,54.55
Poppy,UTILITY,5049,2598,2451,51.46
Poppy,TOP,2121,1029,1092,48.51
Poppy,JUNGLE,1766,905,861,51.25
Poppy,BOTTOM,100,42,58,42
Poppy,MIDDLE,82,31,51,37.8
Poppy,,10,0,10,0
Twitch,BOTTOM,10950,5663,5287,51.72
Twitch,JUNGLE,643,279,364,43.39
Twitch,UTILITY,521,234,287,44.91
Twitch,MIDDLE,369,166,203,44.99
Twitch,TOP,141,68,73,48.23
Twitch,,19,0,19,0
Fiora,TOP,6837,3187,3650,46.61
Fiora,UTILITY,58,17,41,29.31
Fiora,JUNGLE,61,23,38,37.7
Fiora,MIDDLE,161,66,95,40.99
Fiora,BOTTOM,160,78,82,48.75
Fiora,,3,0,3,0
Katarina,MIDDLE,12306,5563,6743,45.21
Katarina,UTILITY,164,68,96,41.46
Katarina,TOP,234,119,115,50.85
Katarina,BOTTOM,441,171,270,38.78
Katarina,,36,0,36,0
Katarina,JUNGLE,84,38,46,45.24
Mel,BOTTOM,6937,3496,3441,50.4
Mel,MIDDLE,16262,8235,8027,50.64
Mel,UTILITY,8787,4024,4763,45.79
Mel,TOP,753,335,418,44.49
Mel,JUNGLE,87,31,56,35.63
Mel,,51,0,51,0
Viktor,UTILITY,167,81,86,48.5
Viktor,MIDDLE,8779,4407,4372,50.2
Viktor,BOTTOM,838,453,385,54.06
Viktor,TOP,256,82,174,32.03
Viktor,JUNGLE,10,0,10,0
Viktor,,6,0,6,0
Pyke,UTILITY,16399,7458,8941,45.48
Pyke,MIDDLE,579,255,324,44.04
Pyke,TOP,69,15,54,21.74
Pyke,JUNGLE,140,62,78,44.29
Pyke,BOTTOM,262,127,135,48.47
Pyke,,37,7,30,18.92
Renekton,TOP,6166,3180,2986,51.57
Renekton,MIDDLE,522,244,278,46.74
Renekton,BOTTOM,64,27,37,42.19
Renekton,,9,0,9,0
Renekton,UTILITY,60,32,28,53.33
Renekton,JUNGLE,88,27,61,30.68
Kayn,JUNGLE,22271,11245,11026,50.49
Kayn,TOP,1554,663,891,42.66
Kayn,MIDDLE,119,49,70,41.18
Kayn,UTILITY,77,26,51,33.77
Kayn,,21,3,18,14.29
Kayn,BOTTOM,29,14,15,48.28
Draven,BOTTOM,8088,3933,4155,48.63
Draven,MIDDLE,231,92,139,39.83
Draven,JUNGLE,35,12,23,34.29
Draven,TOP,139,69,70,49.64
Draven,,13,0,13,0
Draven,UTILITY,42,10,32,23.81
Yuumi,UTILITY,13964,7142,6822,51.15
Yuumi,JUNGLE,125,25,100,20
Yuumi,BOTTOM,45,20,25,44.44
Yuumi,,39,0,39,0
Yuumi,MIDDLE,88,27,61,30.68
Yuumi,TOP,81,10,71,12.35
Aurora,TOP,2213,1005,1208,45.41
Aurora,MIDDLE,11172,5435,5737,48.65
Aurora,UTILITY,394,200,194,50.76
Aurora,BOTTOM,643,343,300,53.34
Aurora,JUNGLE,102,56,46,54.9
Aurora,,19,0,19,0
Volibear,JUNGLE,9157,4793,4364,52.34
Volibear,TOP,7042,3563,3479,50.6
Volibear,MIDDLE,282,137,145,48.58
Volibear,,41,0,41,0
Volibear,UTILITY,165,88,77,53.33
Volibear,BOTTOM,156,97,59,62.18
Vayne,BOTTOM,12355,6260,6095,50.67
Vayne,TOP,2451,1276,1175,52.06
Vayne,MIDDLE,312,176,136,56.41
Vayne,UTILITY,68,6,62,8.82
Vayne,JUNGLE,110,67,43,60.91
Vayne,,25,0,25,0
Khazix,JUNGLE,9213,4275,4938,46.4
Khazix,MIDDLE,98,49,49,50
Khazix,UTILITY,55,13,42,23.64
Khazix,TOP,48,28,20,58.33
Khazix,BOTTOM,13,3,10,23.08
Khazix,,3,0,3,0
Chogath,TOP,11817,6032,5785,51.05
Chogath,UTILITY,1181,533,648,45.13
Chogath,MIDDLE,4530,2336,2194,51.57
Chogath,JUNGLE,1751,924,827,52.77
Chogath,BOTTOM,718,339,379,47.21
Chogath,,28,0,28,0
Gangplank,MIDDLE,1363,714,649,52.38
Gangplank,TOP,4707,2246,2461,47.72
Gangplank,UTILITY,93,29,64,31.18
Gangplank,JUNGLE,14,0,14,0
Gangplank,BOTTOM,138,60,78,43.48
Gangplank,,12,3,9,25
Gwen,TOP,6351,2894,3457,45.57
Gwen,JUNGLE,2915,1368,1547,46.93
Gwen,MIDDLE,304,134,170,44.08
Gwen,UTILITY,36,9,27,25
Gwen,,14,0,14,0
Gwen,BOTTOM,75,27,48,36
Vi,JUNGLE,11382,5837,5545,51.28
Vi,TOP,766,334,432,43.6
Vi,MIDDLE,346,168,178,48.55
Vi,UTILITY,216,109,107,50.46
Vi,BOTTOM,98,42,56,42.86
Vi,,16,0,16,0
Soraka,UTILITY,9022,4723,4299,52.35
Soraka,MIDDLE,127,46,81,36.22
Soraka,TOP,214,82,132,38.32
Soraka,BOTTOM,74,30,44,40.54
Soraka,,17,0,17,0
Soraka,JUNGLE,5,0,5,0
Jax,TOP,8679,4443,4236,51.19
Jax,JUNGLE,3277,1644,1633,50.17
Jax,,23,0,23,0
Jax,UTILITY,187,93,94,49.73
Jax,MIDDLE,246,128,118,52.03
Jax,BOTTOM,150,78,72,52
XinZhao,JUNGLE,6964,3708,3256,53.25
XinZhao,TOP,759,397,362,52.31
XinZhao,UTILITY,143,74,69,51.75
XinZhao,MIDDLE,283,119,164,42.05
XinZhao,BOTTOM,101,34,67,33.66
Kennen,MIDDLE,809,379,430,46.85
Kennen,TOP,4152,1853,2299,44.63
Kennen,UTILITY,357,192,165,53.78
Kennen,BOTTOM,204,98,106,48.04
Kennen,,12,0,12,0
Kennen,JUNGLE,43,24,19,55.81
Kalista,BOTTOM,6682,3091,3591,46.26
Kalista,TOP,207,88,119,42.51
Kalista,MIDDLE,98,47,51,47.96
Kalista,JUNGLE,32,8,24,25
Kalista,UTILITY,93,9,84,9.68
Kalista,,19,0,19,0
Lulu,UTILITY,11109,5490,5619,49.42
Lulu,MIDDLE,170,78,92,45.88
Lulu,TOP,142,41,101,28.87
Lulu,JUNGLE,19,8,11,42.11
Lulu,BOTTOM,106,30,76,28.3
Lulu,,18,3,15,16.67
Vladimir,TOP,2931,1488,1443,50.77
Vladimir,MIDDLE,5074,2575,2499,50.75
Vladimir,BOTTOM,158,89,69,56.33
Vladimir,JUNGLE,43,17,26,39.53
Vladimir,,3,0,3,0
Vladimir,UTILITY,21,3,18,14.29
Viego,JUNGLE,17451,8909,8542,51.05
Viego,BOTTOM,82,33,49,40.24
Viego,MIDDLE,318,135,183,42.45
Viego,TOP,352,133,219,37.78
Viego,UTILITY,73,45,28,61.64
Viego,,35,3,32,8.57
Velkoz,MIDDLE,2725,1392,1333,51.08
Velkoz,UTILITY,6164,3343,2821,54.23
Velkoz,BOTTOM,534,274,260,51.31
Velkoz,TOP,125,58,67,46.4
Velkoz,,10,0,10,0
Velkoz,JUNGLE,6,3,3,50
Kaisa,BOTTOM,19722,9381,10341,47.57
Kaisa,JUNGLE,77,29,48,37.66
Kaisa,MIDDLE,644,225,419,34.94
Kaisa,TOP,285,88,197,30.88
Kaisa,UTILITY,68,34,34,50
Kaisa,,54,0,54,0
Karma,UTILITY,8338,4211,4127,50.5
Karma,MIDDLE,857,403,454,47.02
Karma,BOTTOM,122,19,103,15.57
Karma,TOP,745,417,328,55.97
Karma,,27,0,27,0
Karma,JUNGLE,9,0,9,0
Aatrox,TOP,13549,6441,7108,47.54
Aatrox,JUNGLE,301,104,197,34.55
Aatrox,MIDDLE,440,231,209,52.5
Aatrox,UTILITY,243,104,139,42.8
Aatrox,BOTTOM,180,34,146,18.89
Aatrox,,13,0,13,0
Sylas,JUNGLE,889,403,486,45.33
Sylas,MIDDLE,10872,5484,5388,50.44
Sylas,UTILITY,1145,650,495,56.77
Sylas,TOP,1146,532,614,46.42
Sylas,BOTTOM,207,99,108,47.83
Sylas,,37,0,37,0
Diana,MIDDLE,6637,3340,3297,50.32
Diana,JUNGLE,12811,6483,6328,50.6
Diana,TOP,256,121,135,47.27
Diana,UTILITY,142,44,98,30.99
Diana,,22,0,22,0
Diana,BOTTOM,196,84,112,42.86
Varus,BOTTOM,10320,5178,5142,50.17
Varus,MIDDLE,843,430,413,51.01
Varus,UTILITY,147,105,42,71.43
Varus,TOP,615,292,323,47.48
Varus,,15,0,15,0
Varus,JUNGLE,69,30,39,43.48
Kindred,BOTTOM,237,104,133,43.88
Kindred,JUNGLE,7830,3582,4248,45.75
Kindred,MIDDLE,140,52,88,37.14
Kindred,UTILITY,56,14,42,25
Kindred,TOP,90,43,47,47.78
Kindred,,8,0,8,0
Illaoi,TOP,6947,3706,3241,53.35
Illaoi,UTILITY,146,43,103,29.45
Illaoi,BOTTOM,107,43,64,40.19
Illaoi,MIDDLE,311,195,116,62.7
Illaoi,JUNGLE,33,6,27,18.18
Illaoi,,9,0,9,0
Milio,UTILITY,8083,4217,3866,52.17
Milio,TOP,36,9,27,25
Milio,MIDDLE,123,60,63,48.78
Milio,,9,0,9,0
Milio,BOTTOM,14,7,7,50
Milio,JUNGLE,5,5,0,100
KogMaw,BOTTOM,4579,2461,2118,53.75
KogMaw,UTILITY,172,71,101,41.28
KogMaw,MIDDLE,283,151,132,53.36
KogMaw,TOP,100,32,68,32
KogMaw,JUNGLE,18,8,10,44.44
KogMaw,,3,0,3,0
MasterYi,JUNGLE,15142,7808,7334,51.57
MasterYi,MIDDLE,102,46,56,45.1
MasterYi,TOP,287,134,153,46.69
MasterYi,,21,0,21,0
MasterYi,UTILITY,70,16,54,22.86
MasterYi,BOTTOM,92,25,67,27.17
Ashe,BOTTOM,22833,11428,11405,50.05
Ashe,MIDDLE,454,182,272,40.09
Ashe,UTILITY,2338,1107,1231,47.35
Ashe,TOP,413,169,244,40.92
Ashe,,34,0,34,0
Ashe,JUNGLE,59,19,40,32.2
Graves,JUNGLE,6870,3269,3601,47.58
Graves,TOP,328,127,201,38.72
Graves,UTILITY,70,49,21,70
Graves,MIDDLE,324,133,191,41.05
Graves,BOTTOM,266,128,138,48.12
Graves,,23,0,23,0
Ahri,MIDDLE,19104,9379,9725,49.09
Ahri,UTILITY,881,398,483,45.18
Ahri,BOTTOM,468,213,255,45.51
Ahri,TOP,245,108,137,44.08
Ahri,JUNGLE,25,6,19,24
Ahri,,20,0,20,0
Nilah,BOTTOM,8437,4263,4174,50.53
Nilah,,9,3,6,33.33
Nilah,TOP,85,36,49,42.35
Nilah,UTILITY,39,17,22,43.59
Nilah,JUNGLE,59,16,43,27.12
Nilah,MIDDLE,115,57,58,49.57
Belveth,JUNGLE,4131,2082,2049,50.4
Belveth,UTILITY,75,21,54,28
Belveth,TOP,81,42,39,51.85
Belveth,MIDDLE,15,9,6,60
Belveth,,9,0,9,0
Sona,UTILITY,5561,2934,2627,52.76
Sona,MIDDLE,105,30,75,28.57
Sona,BOTTOM,89,42,47,47.19
Sona,TOP,60,25,35,41.67
Sona,,6,0,6,0
Sona,JUNGLE,6,3,3,50
Ivern,JUNGLE,2581,1249,1332,48.39
Ivern,UTILITY,515,207,308,40.19
Ivern,TOP,101,44,57,43.56
Ivern,BOTTOM,48,9,39,18.75
Ivern,MIDDLE,57,17,40,29.82
Veigar,MIDDLE,13003,6788,6215,52.2
Veigar,UTILITY,1442,659,783,45.7
Veigar,BOTTOM,2496,1404,1092,56.25
Veigar,TOP,340,203,137,59.71
Veigar,,19,7,12,36.84
Veigar,JUNGLE,39,12,27,30.77
Jinx,BOTTOM,29911,15381,14530,51.42
Jinx,JUNGLE,73,35,38,47.95
Jinx,MIDDLE,268,149,119,55.6
Jinx,TOP,126,63,63,50
Jinx,UTILITY,174,78,96,44.83
Jinx,,27,0,27,0
Yorick,TOP,8559,4855,3704,56.72
Yorick,MIDDLE,497,264,233,53.12
Yorick,JUNGLE,4293,2453,1840,57.14
Yorick,UTILITY,168,91,77,54.17
Yorick,BOTTOM,228,130,98,57.02
Yorick,,16,5,11,31.25
Seraphine,BOTTOM,1362,687,675,50.44
Seraphine,UTILITY,14362,7227,7135,50.32
Seraphine,MIDDLE,874,386,488,44.16
Seraphine,TOP,53,12,41,22.64
Seraphine,,32,0,32,0
Seraphine,JUNGLE,13,5,8,38.46
Rakan,UTILITY,7658,3957,3701,51.67
Rakan,MIDDLE,346,144,202,41.62
Rakan,BOTTOM,33,20,13,60.61
Rakan,TOP,51,35,16,68.63
Rakan,JUNGLE,35,9,26,25.71
Rakan,,16,10,6,62.5
Lillia,JUNGLE,9186,4609,4577,50.17
Lillia,UTILITY,161,66,95,40.99
Lillia,MIDDLE,103,58,45,56.31
Lillia,TOP,586,275,311,46.93
Lillia,,8,0,8,0
Lillia,BOTTOM,53,33,20,62.26
Zeri,BOTTOM,6175,2961,3214,47.95
Zeri,JUNGLE,86,51,35,59.3
Zeri,MIDDLE,232,100,132,43.1
Zeri,UTILITY,18,9,9,50
Zeri,TOP,144,86,58,59.72
Zeri,,3,0,3,0
Leblanc,TOP,162,66,96,40.74
Leblanc,MIDDLE,4742,2221,2521,46.84
Leblanc,BOTTOM,146,50,96,34.25
Leblanc,UTILITY,614,317,297,51.63
Leblanc,JUNGLE,18,5,13,27.78
Briar,JUNGLE,14027,7258,6769,51.74
Briar,BOTTOM,181,99,82,54.7
Briar,TOP,728,376,352,51.65
Briar,UTILITY,194,75,119,38.66
Briar,,30,0,30,0
Briar,MIDDLE,241,136,105,56.43
Zoe,MIDDLE,5301,2219,3082,41.86
Zoe,UTILITY,1378,647,731,46.95
Zoe,TOP,132,44,88,33.33
Zoe,BOTTOM,229,72,157,31.44
Zoe,,18,0,18,0
Zoe,JUNGLE,24,6,18,25
Nunu,JUNGLE,11866,5964,5902,50.26
Nunu,MIDDLE,522,243,279,46.55
Nunu,UTILITY,366,173,193,47.27
Nunu,TOP,90,22,68,24.44
Nunu,BOTTOM,74,29,45,39.19
Nunu,,19,0,19,0
Swain,UTILITY,9277,4872,4405,52.52
Swain,TOP,1294,682,612,52.7
Swain,BOTTOM,2721,1515,1206,55.68
Swain,MIDDLE,2995,1657,1338,55.33
Swain,,3,0,3,0
Swain,JUNGLE,49,29,20,59.18
Nami,UTILITY,13936,7123,6813,51.11
Nami,MIDDLE,83,38,45,45.78
Nami,,22,0,22,0
Nami,BOTTOM,55,33,22,60
Nami,TOP,25,3,22,12
Nami,JUNGLE,12,0,12,0
Kayle,TOP,8851,4519,4332,51.06
Kayle,MIDDLE,1687,879,808,52.1
Kayle,BOTTOM,230,120,110,52.17
Kayle,UTILITY,593,340,253,57.34
Kayle,JUNGLE,80,33,47,41.25
Kayle,,10,0,10,0
Caitlyn,BOTTOM,34319,17542,16777,51.11
Caitlyn,MIDDLE,823,388,435,47.14
Caitlyn,UTILITY,248,119,129,47.98
Caitlyn,,60,3,57,5
Caitlyn,TOP,356,166,190,46.63
Caitlyn,JUNGLE,42,10,32,23.81
Renata,UTILITY,3683,1843,1840,50.04
Renata,BOTTOM,76,30,46,39.47
Renata,MIDDLE,21,7,14,33.33
Renata,TOP,3,0,3,0
Ambessa,TOP,6616,3203,3413,48.41
Ambessa,MIDDLE,898,484,414,53.9
Ambessa,JUNGLE,1245,597,648,47.95
Ambessa,UTILITY,84,47,37,55.95
Ambessa,BOTTOM,161,71,90,44.1
Ambessa,,17,0,17,0
Rammus,JUNGLE,4120,2188,1932,53.11
Rammus,TOP,299,171,128,57.19
Rammus,BOTTOM,42,17,25,40.48
Rammus,UTILITY,138,57,81,41.3
Rammus,MIDDLE,42,12,30,28.57
Rammus,,3,0,3,0
Talon,JUNGLE,4968,2286,2682,46.01
Talon,MIDDLE,4053,1893,2160,46.71
Talon,TOP,133,64,69,48.12
Talon,,11,0,11,0
Talon,BOTTOM,102,26,76,25.49
Talon,UTILITY,47,13,34,27.66
Alistar,UTILITY,4452,2190,2262,49.19
Alistar,TOP,178,72,106,40.45
Alistar,MIDDLE,120,67,53,55.83
Alistar,BOTTOM,19,9,10,47.37
Alistar,JUNGLE,46,10,36,21.74
Garen,TOP,18291,9575,8716,52.35
Garen,JUNGLE,1501,702,799,46.77
Garen,MIDDLE,1660,904,756,54.46
Garen,BOTTOM,484,303,181,62.6
Garen,UTILITY,218,97,121,44.5
Garen,,22,3,19,13.64
Morgana,UTILITY,17418,9073,8345,52.09
Morgana,MIDDLE,1256,687,569,54.7
Morgana,JUNGLE,1034,514,520,49.71
Morgana,BOTTOM,338,129,209,38.17
Morgana,TOP,184,112,72,60.87
Morgana,,39,3,36,7.69
Ryze,MIDDLE,3411,1687,1724,49.46
Ryze,TOP,719,399,320,55.49
Ryze,BOTTOM,176,73,103,41.48
Ryze,JUNGLE,15,3,12,20
Ryze,UTILITY,56,24,32,42.86
Ryze,,6,0,6,0
Brand,JUNGLE,738,378,360,51.22
Brand,UTILITY,6343,3144,3199,49.57
Brand,MIDDLE,2229,1167,1062,52.36
Brand,TOP,220,108,112,49.09
Brand,BOTTOM,1053,501,552,47.58
Brand,,16,0,16,0
DrMundo,TOP,7630,4165,3465,54.59
DrMundo,UTILITY,243,108,135,44.44
DrMundo,BOTTOM,142,80,62,56.34
DrMundo,JUNGLE,1463,808,655,55.23
DrMundo,MIDDLE,214,119,95,55.61
DrMundo,,6,0,6,0
Gragas,JUNGLE,3440,1488,1952,43.26
Gragas,UTILITY,745,354,391,47.52
Gragas,TOP,3816,1829,1987,47.93
Gragas,MIDDLE,1033,529,504,51.21
Gragas,,20,0,20,0
Gragas,BOTTOM,152,63,89,41.45
TwistedFate,MIDDLE,4073,1902,2171,46.7
TwistedFate,UTILITY,397,179,218,45.09
TwistedFate,TOP,296,149,147,50.34
TwistedFate,JUNGLE,72,41,31,56.94
TwistedFate,BOTTOM,500,236,264,47.2
TwistedFate,,19,0,19,0
Leona,UTILITY,10935,5782,5153,52.88
Leona,MIDDLE,70,16,54,22.86
Leona,TOP,118,45,73,38.14
Leona,JUNGLE,98,29,69,29.59
Leona,BOTTOM,44,15,29,34.09
Leona,,30,0,30,0
MonkeyKing,TOP,1304,723,581,55.44
MonkeyKing,JUNGLE,5737,2932,2805,51.11
MonkeyKing,MIDDLE,217,116,101,53.46
MonkeyKing,BOTTOM,53,23,30,43.4
MonkeyKing,UTILITY,127,63,64,49.61
MonkeyKing,,23,0,23,0
Teemo,TOP,12669,6855,5814,54.11
Teemo,JUNGLE,3456,1872,1584,54.17
Teemo,MIDDLE,1231,686,545,55.73
Teemo,UTILITY,2404,1270,1134,52.83
Teemo,BOTTOM,1287,698,589,54.23
Teemo,,27,3,24,11.11
Azir,MIDDLE,4951,2400,2551,48.48
Azir,,13,0,13,0
Azir,TOP,201,80,121,39.8
Azir,UTILITY,72,43,29,59.72
Azir,BOTTOM,208,104,104,50
Azir,JUNGLE,16,0,16,0
MissFortune,BOTTOM,30812,15924,14888,51.68
MissFortune,TOP,153,66,87,43.14
MissFortune,,78,0,78,0
MissFortune,MIDDLE,672,303,369,45.09
MissFortune,UTILITY,670,307,363,45.82
MissFortune,JUNGLE,39,6,33,15.38
Neeko,UTILITY,7759,3650,4109,47.04
Neeko,MIDDLE,2464,1222,1242,49.59
Neeko,JUNGLE,425,201,224,47.29
Neeko,BOTTOM,463,211,252,45.57
Neeko,,11,0,11,0
Neeko,TOP,385,178,207,46.23
FiddleSticks,JUNGLE,6136,3186,2950,51.92
FiddleSticks,TOP,388,168,220,43.3
FiddleSticks,UTILITY,950,466,484,49.05
FiddleSticks,MIDDLE,204,92,112,45.1
FiddleSticks,BOTTOM,56,26,30,46.43
Smolder,BOTTOM,9394,4642,4752,49.41
Smolder,TOP,785,383,402,48.79
Smolder,UTILITY,80,18,62,22.5
Smolder,MIDDLE,1645,755,890,45.9
Smolder,JUNGLE,26,13,13,50
Smolder,,6,0,6,0
Nautilus,UTILITY,14619,7126,7493,48.74
Nautilus,,38,7,31,18.42
Nautilus,MIDDLE,273,133,140,48.72
Nautilus,JUNGLE,462,177,285,38.31
Nautilus,BOTTOM,165,53,112,32.12
Nautilus,TOP,605,344,261,56.86
TahmKench,TOP,6220,3142,3078,50.51
TahmKench,UTILITY,9306,4484,4822,48.18
TahmKench,JUNGLE,150,52,98,34.67
TahmKench,MIDDLE,388,213,175,54.9
TahmKench,BOTTOM,608,333,275,54.77
TahmKench,,59,3,56,5.08
Aphelios,BOTTOM,10287,5165,5122,50.21
Aphelios,MIDDLE,260,146,114,56.15
Aphelios,,40,3,37,7.5
Aphelios,UTILITY,43,8,35,18.6
Aphelios,JUNGLE,13,3,10,23.08
Aphelios,TOP,114,27,87,23.68
Malzahar,BOTTOM,356,201,155,56.46
Malzahar,JUNGLE,107,40,67,37.38
Malzahar,MIDDLE,10333,5749,4584,55.64
Malzahar,UTILITY,279,170,109,60.93
Malzahar,TOP,488,251,237,51.43
Malzahar,,3,0,3,0
Amumu,UTILITY,921,483,438,52.44
Amumu,JUNGLE,13454,7451,6003,55.38
Amumu,TOP,106,33,73,31.13
Amumu,BOTTOM,36,14,22,38.89
Amumu,MIDDLE,13,6,7,46.15
Amumu,,16,0,16,0
Trundle,TOP,5329,2742,2587,51.45
Trundle,BOTTOM,118,67,51,56.78
Trundle,JUNGLE,2714,1567,1147,57.74
Trundle,UTILITY,155,74,81,47.74
Trundle,,12,3,9,25
Trundle,MIDDLE,114,91,23,79.82
Vex,BOTTOM,296,145,151,48.99
Vex,,17,0,17,0
Vex,MIDDLE,8171,4115,4056,50.36
Vex,UTILITY,289,139,150,48.1
Vex,TOP,135,65,70,48.15
Vex,JUNGLE,17,6,11,35.29
LeeSin,JUNGLE,12764,5891,6873,46.15
LeeSin,BOTTOM,219,92,127,42.01
LeeSin,TOP,447,208,239,46.53
LeeSin,MIDDLE,417,213,204,51.08
LeeSin,UTILITY,562,252,310,44.84
LeeSin,,22,0,22,0
Akali,MIDDLE,13345,6417,6928,48.09
Akali,TOP,2217,1061,1156,47.86
Akali,UTILITY,99,40,59,40.4
Akali,JUNGLE,30,8,22,26.67
Akali,,21,0,21,0
Akali,BOTTOM,171,67,104,39.18
Naafiri,TOP,489,267,222,54.6
Naafiri,MIDDLE,5048,2552,2496,50.55
Naafiri,JUNGLE,1169,511,658,43.71
Naafiri,UTILITY,84,39,45,46.43
Naafiri,BOTTOM,245,137,108,55.92
Naafiri,,3,0,3,0
Senna,UTILITY,11939,6216,5723,52.06
Senna,MIDDLE,223,86,137,38.57
Senna,BOTTOM,1022,495,527,48.43
Senna,TOP,258,123,135,47.67
Senna,JUNGLE,39,24,15,61.54
Senna,,6,0,6,0
Galio,MIDDLE,8121,4419,3702,54.41
Galio,UTILITY,1546,820,726,53.04
Galio,TOP,560,272,288,48.57
Galio,BOTTOM,88,24,64,27.27
Galio,JUNGLE,131,55,76,41.98
Galio,,13,0,13,0
Gnar,TOP,5738,2665,3073,46.44
Gnar,BOTTOM,141,65,76,46.1
Gnar,MIDDLE,157,61,96,38.85
Gnar,UTILITY,108,42,66,38.89
Gnar,JUNGLE,93,48,45,51.61
Riven,TOP,5900,2469,3431,41.85
Riven,,9,0,9,0
Riven,MIDDLE,463,209,254,45.14
Riven,JUNGLE,218,116,102,53.21
Riven,UTILITY,66,20,46,30.3
Riven,BOTTOM,54,21,33,38.89
AurelionSol,MIDDLE,6104,3221,2883,52.77
AurelionSol,UTILITY,102,49,53,48.04
AurelionSol,BOTTOM,456,265,191,58.11
AurelionSol,,15,7,8,46.67
AurelionSol,JUNGLE,168,96,72,57.14
AurelionSol,TOP,245,138,107,56.33
Heimerdinger,TOP,4335,2251,2084,51.93
Heimerdinger,BOTTOM,814,439,375,53.93
Heimerdinger,MIDDLE,2348,1313,1035,55.92
Heimerdinger,UTILITY,776,424,352,54.64
Heimerdinger,JUNGLE,83,29,54,34.94
Heimerdinger,,24,0,24,0
Nocturne,JUNGLE,12431,6478,5953,52.11
Nocturne,BOTTOM,30,12,18,40
Nocturne,TOP,149,39,110,26.17
Nocturne,UTILITY,9,0,9,0
Nocturne,MIDDLE,108,63,45,58.33
Nocturne,,18,0,18,0
Ornn,TOP,5490,2932,2558,53.41
Ornn,UTILITY,461,236,225,51.19
Ornn,MIDDLE,114,60,54,52.63
Ornn,JUNGLE,240,94,146,39.17
Ornn,BOTTOM,139,88,51,63.31
Ornn,,9,3,6,33.33
Udyr,JUNGLE,4810,2437,2373,50.67
Udyr,UTILITY,43,28,15,65.12
Udyr,TOP,803,368,435,45.83
Udyr,MIDDLE,32,10,22,31.25
Udyr,,16,0,16,0
Udyr,BOTTOM,34,12,22,35.29
Kassadin,MIDDLE,3070,1613,1457,52.54
Kassadin,,10,0,10,0
Kassadin,TOP,93,45,48,48.39
Kassadin,JUNGLE,27,16,11,59.26
Kassadin,UTILITY,25,12,13,48
Kassadin,BOTTOM,36,15,21,41.67
Taric,UTILITY,2948,1682,1266,57.06
Taric,TOP,117,32,85,27.35
Taric,JUNGLE,178,86,92,48.31
Taric,MIDDLE,42,15,27,35.71
Taric,BOTTOM,44,24,20,54.55
Taric,,6,0,6,0
Nidalee,JUNGLE,2960,1240,1720,41.89
Nidalee,UTILITY,387,170,217,43.93
Nidalee,BOTTOM,89,30,59,33.71
Nidalee,TOP,216,90,126,41.67
Nidalee,MIDDLE,166,68,98,40.96
Nidalee,,3,0,3,0
Nasus,TOP,9340,4953,4387,53.03
Nasus,MIDDLE,621,338,283,54.43
Nasus,JUNGLE,1538,763,775,49.61
Nasus,UTILITY,225,75,150,33.33
Nasus,,22,0,22,0
Nasus,BOTTOM,100,47,53,47
JarvanIV,JUNGLE,4728,2506,2222,53
JarvanIV,UTILITY,435,248,187,57.01
JarvanIV,TOP,192,116,76,60.42
JarvanIV,MIDDLE,104,71,33,68.27
JarvanIV,BOTTOM,94,35,59,37.23
JarvanIV,,3,0,3,0
Fizz,MIDDLE,7254,3765,3489,51.9
Fizz,JUNGLE,118,47,71,39.83
Fizz,TOP,233,99,134,42.49
Fizz,UTILITY,124,66,58,53.23
Fizz,BOTTOM,122,55,67,45.08
Fizz,,9,0,9,0
Ziggs,BOTTOM,4091,2098,1993,51.28
Ziggs,MIDDLE,1984,1152,832,58.06
Ziggs,UTILITY,528,250,278,47.35
Ziggs,TOP,105,28,77,26.67
Ziggs,JUNGLE,9,3,6,33.33
Zyra,BOTTOM,275,150,125,54.55
Zyra,UTILITY,7309,4045,3264,55.34
Zyra,JUNGLE,1365,696,669,50.99
Zyra,TOP,74,32,42,43.24
Zyra,MIDDLE,664,357,307,53.77
Zyra,,22,0,22,0
Taliyah,JUNGLE,888,401,487,45.16
Taliyah,BOTTOM,234,131,103,55.98
Taliyah,MIDDLE,2764,1366,1398,49.42
Taliyah,TOP,70,19,51,27.14
Taliyah,UTILITY,251,119,132,47.41
Cassiopeia,MIDDLE,4197,2030,2167,48.37
Cassiopeia,BOTTOM,557,297,260,53.32
Cassiopeia,TOP,1110,540,570,48.65
Cassiopeia,UTILITY,94,57,37,60.64
Cassiopeia,JUNGLE,48,11,37,22.92
Cassiopeia,,7,0,7,0
Evelynn,JUNGLE,7831,3624,4207,46.28
Evelynn,MIDDLE,135,54,81,40
Evelynn,TOP,73,48,25,65.75
Evelynn,UTILITY,200,122,78,61
Evelynn,BOTTOM,55,15,40,27.27
Evelynn,,17,0,17,0
Hecarim,JUNGLE,5526,2667,2859,48.26
Hecarim,BOTTOM,17,7,10,41.18
Hecarim,TOP,11,5,6,45.45
Hecarim,UTILITY,20,7,13,35
Hecarim,MIDDLE,10,10,0,100
Hecarim,,19,0,19,0
Thresh,UTILITY,18472,9208,9264,49.85
Thresh,MIDDLE,214,75,139,35.05
Thresh,TOP,514,177,337,34.44
Thresh,BOTTOM,314,121,193,38.54
Thresh,JUNGLE,67,13,54,19.4
Thresh,,29,5,24,17.24
RekSai,TOP,121,64,57,52.89
RekSai,JUNGLE,1735,866,869,49.91
RekSai,MIDDLE,71,30,41,42.25
RekSai,UTILITY,154,68,86,44.16
RekSai,,3,0,3,0
RekSai,BOTTOM,3,0,3,0
Sivir,BOTTOM,6933,3647,3286,52.6
Sivir,MIDDLE,172,75,97,43.6
Sivir,JUNGLE,13,0,13,0
Sivir,TOP,56,30,26,53.57
Sivir,UTILITY,36,21,15,58.33
Sivir,,6,0,6,0
Xayah,BOTTOM,9734,4891,4843,50.25
Xayah,,8,0,8,0
Xayah,TOP,13,3,10,23.08
Xayah,UTILITY,31,20,11,64.52
Xayah,MIDDLE,136,46,90,33.82
Xayah,JUNGLE,12,0,12,0
Samira,TOP,92,30,62,32.61
Samira,BOTTOM,14311,6995,7316,48.88
Samira,,12,0,12,0
Samira,UTILITY,47,33,14,70.21
Samira,MIDDLE,351,178,173,50.71
Samira,JUNGLE,47,14,33,29.79
Skarner,JUNGLE,4148,1954,2194,47.11
Skarner,UTILITY,278,127,151,45.68
Skarner,TOP,365,156,209,42.74
Skarner,BOTTOM,29,3,26,10.34
Skarner,MIDDLE,6,3,3,50
Urgot,TOP,6376,3438,2938,53.92
Urgot,BOTTOM,189,112,77,59.26
Urgot,JUNGLE,249,102,147,40.96
Urgot,UTILITY,99,47,52,47.47
Urgot,MIDDLE,230,157,73,68.26
Urgot,,10,0,10,0
Orianna,MIDDLE,6150,2951,3199,47.98
Orianna,UTILITY,399,215,184,53.88
Orianna,BOTTOM,143,90,53,62.94
Orianna,TOP,71,38,33,53.52
Orianna,JUNGLE,12,3,9,25
Orianna,,6,0,6,0
Rengar,JUNGLE,5917,2385,3532,40.31
Rengar,BOTTOM,309,112,197,36.25
Rengar,TOP,466,214,252,45.92
Rengar,UTILITY,144,42,102,29.17
Rengar,MIDDLE,26,7,19,26.92
Rengar,,14,0,14,0
Syndra,MIDDLE,7495,3843,3652,51.27
Syndra,BOTTOM,528,320,208,60.61
Syndra,UTILITY,182,92,90,50.55
Syndra,,11,0,11,0
Syndra,TOP,112,50,62,44.64
Syndra,JUNGLE,9,3,6,33.33
Braum,TOP,129,38,91,29.46
Braum,UTILITY,6736,3446,3290,51.16
Braum,MIDDLE,30,17,13,56.67
Braum,JUNGLE,43,23,20,53.49
Braum,,10,3,7,30
Braum,BOTTOM,26,8,18,30.77
Corki,BOTTOM,4155,1901,2254,45.75
Corki,UTILITY,16,6,10,37.5
Corki,MIDDLE,616,293,323,47.56
Corki,TOP,75,32,43,42.67
Corki,,13,3,10,23.08
Corki,JUNGLE,28,7,21,25
Bard,UTILITY,4599,2350,2249,51.1
Bard,MIDDLE,156,49,107,31.41
Bard,JUNGLE,32,3,29,9.38
Bard,TOP,96,35,61,36.46
Bard,BOTTOM,70,33,37,47.14
Xerath,UTILITY,4469,2321,2148,51.94
Xerath,MIDDLE,5241,2744,2497,52.36
Xerath,BOTTOM,393,150,243,38.17
Xerath,,17,0,17,0
Xerath,JUNGLE,10,0,10,0
Xerath,TOP,26,14,12,53.85
Karthus,JUNGLE,2978,1434,1544,48.15
Karthus,UTILITY,141,52,89,36.88
Karthus,,13,0,13,0
Karthus,MIDDLE,262,109,153,41.6
Karthus,TOP,79,25,54,31.65
Karthus,BOTTOM,342,162,180,47.37
Anivia,MIDDLE,3232,1685,1547,52.13
Anivia,UTILITY,804,293,511,36.44
Anivia,BOTTOM,358,172,186,48.04
Anivia,TOP,260,147,113,56.54
Anivia,,9,0,9,0
Anivia,JUNGLE,28,7,21,25
KSante,TOP,5032,2270,2762,45.11
KSante,MIDDLE,293,168,125,57.34
KSante,JUNGLE,69,22,47,31.88
KSante,,13,0,13,0
KSante,BOTTOM,73,30,43,41.1
KSante,UTILITY,104,43,61,41.35
Tryndamere,MIDDLE,588,344,244,58.5
Tryndamere,TOP,7092,3349,3743,47.22
Tryndamere,JUNGLE,979,512,467,52.3
Tryndamere,UTILITY,58,40,18,68.97
Tryndamere,,28,0,28,0
Tryndamere,BOTTOM,161,111,50,68.94
Janna,UTILITY,4628,2422,2206,52.33
Janna,BOTTOM,13,0,13,0
Janna,TOP,55,30,25,54.55
Janna,MIDDLE,44,12,32,27.27
Janna,JUNGLE,7,0,7,0
Janna,,3,0,3,0
Akshan,MIDDLE,4738,2501,2237,52.79
Akshan,BOTTOM,522,237,285,45.4
Akshan,TOP,489,264,225,53.99
Akshan,JUNGLE,48,25,23,52.08
Akshan,UTILITY,78,20,58,25.64
Akshan,,8,0,8,0
Zilean,UTILITY,3473,1747,1726,50.3
Zilean,MIDDLE,462,233,229,50.43
Zilean,BOTTOM,81,39,42,48.15
Zilean,TOP,216,94,122,43.52
Zilean,JUNGLE,8,0,8,0
Zilean,,6,0,6,0
Olaf,TOP,2560,1215,1345,47.46
Olaf,JUNGLE,614,336,278,54.72
Olaf,MIDDLE,57,34,23,59.65
Olaf,UTILITY,25,16,9,64
Olaf,,10,0,10,0
Olaf,BOTTOM,72,38,34,52.78
Annie,MIDDLE,3479,1673,1806,48.09
Annie,UTILITY,638,274,364,42.95
Annie,BOTTOM,202,86,116,42.57
Annie,TOP,130,85,45,65.38
Annie,JUNGLE,29,6,23,20.69
Annie,,6,0,6,0
Camille,TOP,4168,1911,2257,45.85
Camille,JUNGLE,104,51,53,49.04
Camille,MIDDLE,114,55,59,48.25
Camille,UTILITY,681,300,381,44.05
Camille,BOTTOM,40,22,18,55
Camille,,5,0,5,0
Lissandra,MIDDLE,3312,1694,1618,51.15
Lissandra,TOP,116,45,71,38.79
Lissandra,UTILITY,227,117,110,51.54
Lissandra,BOTTOM,107,58,49,54.21
Lissandra,JUNGLE,27,6,21,22.22
Lissandra,,6,0,6,0
Elise,JUNGLE,5174,2389,2785,46.17
Elise,UTILITY,3460,1559,1901,45.06
Elise,MIDDLE,134,71,63,52.99
Elise,TOP,284,121,163,42.61
Elise,BOTTOM,69,18,51,26.09
Elise,,6,0,6,0
Jayce,TOP,4160,1840,2320,44.23
Jayce,MIDDLE,1448,678,770,46.82
Jayce,BOTTOM,324,170,154,52.47
Jayce,UTILITY,107,47,60,43.93
Jayce,JUNGLE,61,23,38,37.7
Jayce,,6,0,6,0
Sion,TOP,7999,4183,3816,52.29
Sion,MIDDLE,895,481,414,53.74
Sion,UTILITY,1246,619,627,49.68
Sion,JUNGLE,1128,618,510,54.79
Sion,BOTTOM,798,405,393,50.75
Sion,,18,3,15,16.67
Shyvana,JUNGLE,3745,2104,1641,56.18
Shyvana,MIDDLE,56,16,40,28.57
Shyvana,TOP,332,140,192,42.17
Shyvana,UTILITY,20,0,20,0
Shyvana,BOTTOM,32,14,18,43.75
Quinn,BOTTOM,455,229,226,50.33
Quinn,UTILITY,271,122,149,45.02
Quinn,TOP,3333,1597,1736,47.91
Quinn,MIDDLE,1042,574,468,55.09
Quinn,JUNGLE,122,67,55,54.92
Quinn,,8,0,8,0
Kled,TOP,2608,1306,1302,50.08
Kled,BOTTOM,56,33,23,58.93
Kled,JUNGLE,55,30,25,54.55
Kled,UTILITY,121,69,52,57.02
Kled,MIDDLE,272,134,138,49.26
Rumble,TOP,2045,974,1071,47.63
Rumble,MIDDLE,263,119,144,45.25
Rumble,JUNGLE,295,154,141,52.2
Rumble,UTILITY,123,56,67,45.53
Rumble,BOTTOM,15,3,12,20
